time,open,high,low,close,Long Stop,Long Stop Start,Buy Label,Short Stop,Short Stop Start,Sell Label,Basis,Upper,Lower,ATR Trailing Stoploss,VWAP,Upper Band #1,Lower Band #1,Volume,Volume MA,RSI,RSI-based MA,Regular Bullish,Regular Bullish Label,Regular Bearish,Regular Bearish Label,ATR,ADX,OnBalanceVolume,Histogram,MACD,Signal
2021-10-14T09:30:00-04:00,147.94,149.33,147.64,148.65,142.237062597315,NaN,NaN,NaN,NaN,NaN,144.50239999999994,152.57303770467408,136.4317622953258,144.4459367952811,148.54,148.54,148.54,24167,55459.5,64.77919424056418,52.18077812762239,NaN,NaN,NaN,NaN,2.0530274920349845,18.933472334251807,2172279,0.938749190783768,0.6548887192562916,-0.28386047152747645
2021-10-14T13:30:00-04:00,148.73,148.77,148.1,148.19,142.37969611561886,NaN,NaN,NaN,NaN,NaN,144.44599999999994,152.37206030762457,136.51993969237532,144.5277494362249,148.42551672640383,148.51642212303358,148.33461132977408,38329,55517.333333333336,63.10341830420265,53.76322425426211,NaN,NaN,NaN,NaN,1.9542398140324868,19.931212704980553,2133950,0.969021992411718,0.9274170189871711,-0.04160497342454694
2021-10-15T09:30:00-04:00,149.06,149.5,148.28,149.27,142.93130083763617,NaN,NaN,NaN,NaN,NaN,144.39259999999996,152.15017055785376,136.63502944214616,145.4511995489799,149.01666666666665,149.01666666666665,149.01666666666665,59379,53410.666666666664,65.36859030808057,55.15636324539573,NaN,NaN,NaN,NaN,1.9082226844587378,21.090657221067374,2193329,1.006501045439432,1.216521333374743,0.21002028793531108
2021-10-15T13:30:00-04:00,149.12,149.5,149.11,149.43,143.56396898138,NaN,NaN,NaN,NaN,NaN,144.38599999999994,152.12583462356355,136.64616537643633,146.06595963918392,149.1265542238148,149.28207791541283,148.97103053221676,29644,53207.9,65.70450809445992,56.4492373222047,NaN,NaN,NaN,NaN,1.7997782069973984,22.167284271719424,2222973,0.9855258531562954,1.4419276043806804,0.456401751224385
2021-10-18T09:30:00-04:00,149.12,151.965,149.12,151.965,144.67447039131727,NaN,NaN,NaN,NaN,NaN,144.47909999999993,152.4654437667133,136.49275623328657,147.79526771134715,151.01666666666668,151.01666666666668,151.01666666666668,20552,52582.166666666664,70.57451063887925,57.44647939969334,NaN,NaN,NaN,NaN,1.874436906497584,23.896206969576344,2243525,1.078332965394809,1.8043179579678963,0.7259849925730872
2021-10-18T13:30:00-04:00,152,152.07,151.36,151.55,146.01688082807556,NaN,NaN,NaN,NaN,NaN,144.56129999999993,152.7498966587754,136.37270334122445,148.37921416907773,151.3691875801899,151.68937105866874,151.04900410171106,24913,52116.96666666667,68.85083253717751,58.49570802659647,NaN,NaN,NaN,NaN,1.7912628417477552,25.529531602545408,2218612,1.0468716723833396,2.0345745830522617,0.9877029106689221
2021-10-19T09:30:00-04:00,152.48,154.64,152.23,154.55,147.5745226086176,NaN,NaN,NaN,NaN,NaN,144.70689999999993,153.330314843328,136.08348515667186,150.14237133526217,153.80666666666667,153.80666666666667,153.80666666666667,46633,46772.7,73.82723730629537,60.10798581060156,NaN,NaN,NaN,NaN,1.8840297816229137,27.658597202244845,2265245,1.15472189304283,2.4311052769724597,1.2763833839296297
2021-10-19T13:30:00-04:00,154.63,154.76,153.67,154.23,148.47227158095313,NaN,NaN,NaN,NaN,NaN,144.86029999999994,153.87415564784067,135.8464443521592,150.61689706820974,153.96215807192385,154.1623884485556,153.76192769529212,28122,45228,72.49677868937987,61.738285340863584,NaN,NaN,NaN,NaN,1.8273133686498486,29.66121427882958,2237123,1.1297296961326402,2.68854550409543,1.5588158079627896
2021-10-20T09:30:00-04:00,155,155.72,154.17,154.49,149.2519410545462,NaN,NaN,NaN,NaN,NaN,145.00989999999993,154.40185751481778,135.61794248518208,151.6305176545678,154.79333333333332,154.79333333333332,154.79333333333332,44369,43886.6,72.92373318591402,63.27391879901122,NaN,NaN,NaN,NaN,1.807505270889146,31.72562851158617,2281492,1.0572239402506949,2.880345733276158,1.8231217930254633
2021-10-20T13:30:00-04:00,154.47,155.17,154.46,154.94,149.28389827933955,NaN,NaN,NaN,NaN,NaN,145.14829999999992,154.91026406673026,135.38633593326958,151.6305176545678,154.80872282222336,154.83588587172903,154.78155977271769,14242,41859.4,73.68515053382077,65.08822871659707,NaN,NaN,NaN,NaN,1.7291120372542055,33.642584584860145,2295734,0.9684542065403896,3.0336895512009505,2.065235344660561
2021-10-21T09:30:00-04:00,154.31,156.67,154.31,156.41,149.88849381209684,NaN,NaN,NaN,NaN,NaN,145.31189999999992,155.53810181495217,135.08569818504768,152.5887312989234,155.79666666666665,155.79666666666665,155.79666666666665,24608,39429.63333333333,76.05409431500149,66.86515350208244,NaN,NaN,NaN,NaN,1.7741754631646185,35.733340187147114,2320342,0.9370306967981294,3.2365237156582225,2.299493018860093
2021-10-21T13:30:00-04:00,156.24,156.37,155.48,155.59,150.45128954791062,NaN,NaN,NaN,NaN,NaN,145.44449999999995,156.02236977609888,134.866630223901,152.63998503913874,155.80152005683894,155.80909200702263,155.79394810665525,10110,38026.13333333333,72.15212208585191,68.38525143014495,NaN,NaN,NaN,NaN,1.7138772157957176,37.67475610355645,2310232,0.794919828921409,3.293142805011854,2.498222976090445
2021-10-22T09:30:00-04:00,154.42,155.04,151.68,152.93,150.45128954791062,NaN,NaN,NaN,NaN,NaN,145.51489999999995,156.24318532245994,134.78661467753997,152.63998503913874,153.21666666666667,153.21666666666667,153.21666666666667,92572,37352.333333333336,61.185721019057986,68.57568343427228,NaN,NaN,NaN,NaN,1.870743128953166,36.73434417223236,2217660,0.4716456713472672,3.0877800652745293,2.616134393927262
2021-10-22T13:30:00-04:00,152.91,153.26,152.68,152.96,150.45128954791062,NaN,NaN,NaN,NaN,NaN,145.56569999999994,156.40983869517234,134.72156130482753,152.63998503913874,153.14017713667366,153.25538015007487,153.02497412327244,40809,38111.933333333334,61.257241406449815,68.71165233322394,NaN,NaN,NaN,NaN,1.778547191170796,35.861104521717145,2258469,0.22236297881261669,2.894088117443033,2.6717251386304164
2021-10-25T09:30:00-04:00,154.08,157.5,153.49,157.46,150.45128954791062,NaN,NaN,NaN,NaN,NaN,145.82769999999994,157.16447294648404,134.49092705351583,152.63998503913874,156.15,156.15,156.15,107327,38367.9,70.14403968642533,69.0948555793569,NaN,NaN,NaN,NaN,1.9757938203728815,36.310653274588596,2365796,0.3172826608314421,3.068328464669719,2.751045803838277
2021-10-25T13:30:00-04:00,157.34,158.85,157.34,158.22,152.21803286817502,NaN,NaN,NaN,NaN,NaN,146.10549999999995,157.95116625395585,134.25983374604405,153.56462587203123,156.78886878085473,157.716805196859,155.86093236485044,50874,38840.26666666667,71.33973557697422,69.68316395598345,NaN,NaN,NaN,NaN,1.9425228332033893,37.03467882671298,2416670,0.3835646622917044,3.230501631702907,2.846936969411203
2021-10-26T09:30:00-04:00,159.78,161,156.37,156.69,152.44380410143978,NaN,NaN,NaN,NaN,NaN,146.33949999999996,158.54457144592402,134.1344285540759,154.456700697625,158.02,158.02000190734864,158.01999809265138,90968,40542,65.6404096155134,69.70257962080008,NaN,NaN,NaN,NaN,2.1344854879745756,38.13883984129393,2325702,0.2814058367446366,3.1986942653419987,2.917288428597362
2021-10-26T13:30:00-04:00,156.77,157.79,156.71,156.93,152.44380410143978,NaN,NaN,NaN,NaN,NaN,146.57989999999995,159.1314663548463,134.0283336451536,154.456700697625,157.75788567201215,158.15923710563465,157.35653423838966,38799,41311.2,66.09794274699536,69.73068209598118,NaN,NaN,NaN,NaN,2.0605936674049627,39.16413221197624,2364501,0.1913427826478573,3.156466906907184,2.9651241242593267
2021-10-27T09:30:00-04:00,156.5,157.09,154,154.79,152.44380410143978,NaN,NaN,NaN,NaN,NaN,146.74629999999993,159.50649416937455,133.98610583062532,154.456700697625,155.29333333333332,155.29333333333332,155.29333333333332,111101,42649.23333333333,58.60432625674525,68.87566892582875,NaN,NaN,NaN,NaN,2.1341226911617515,38.57320580226244,2253400,-0.038739770912372684,2.916699410618861,2.9554391815312337
2021-10-27T13:30:00-04:00,154.75,154.95,153.31,153.31,152.44380410143978,NaN,NaN,NaN,NaN,NaN,146.86689999999993,159.7582988209249,133.97550117907497,154.456700697625,155.01700589080565,155.5832510411311,154.4507607404802,26458,42364.8,54.04121313373653,67.8178389684401,NaN,NaN,NaN,NaN,2.0988282132216254,37.67491628497861,2226942,-0.30231457256297833,2.577545965827511,2.8798605383904894
2021-10-28T09:30:00-04:00,153.98,156.8,153.4,155.65,152.44380410143978,NaN,NaN,NaN,NaN,NaN,146.99669999999995,160.1066784301925,133.8867215698074,154.456700697625,155.28333333333333,155.28333524068196,155.2833314259847,23050,41556.86666666667,59.421072770890284,66.78882721591117,NaN,NaN,NaN,NaN,2.1981976265629384,37.355850816735305,2249992,-0.3285921279784141,2.469120378417472,2.797712506395886
2021-10-28T13:30:00-04:00,155.81,156.52,154.84,156.51,152.44380410143978,NaN,NaN,NaN,NaN,NaN,147.14769999999993,160.5160281243442,133.77937187565567,154.456700697625,155.51690996325996,155.83740471948343,155.1964152070365,12243,39568.5,61.217878913470365,65.98319151763192,NaN,NaN,NaN,NaN,2.161183510379872,37.059575739080806,2262235,-0.29846006831193383,2.4246374210059685,2.7230974893179023
2021-10-29T09:30:00-04:00,156.03,157.72,155.58,157.67,152.44380410143978,NaN,NaN,NaN,NaN,NaN,147.35609999999994,161.0453344986896,133.66686550131027,154.456700697625,156.98999999999998,156.9900026973983,156.98999730260167,27045,39430.333333333336,63.56159115185981,65.31446708662806,NaN,NaN,NaN,NaN,2.1596704024955944,37.11029323373825,2289280,-0.21472557709328832,2.454690517951292,2.66941609504458
2021-10-29T13:30:00-04:00,157.58,157.58,156.57,157,152.44380410143978,NaN,NaN,NaN,NaN,NaN,147.55289999999994,161.50558892938255,133.60021107061732,154.456700697625,157.02403389179588,157.05376144999408,156.99430633359768,35448,40371.6,61.258860506084226,64.42687494178972,NaN,NaN,NaN,NaN,2.0839796594601943,37.15738805020587,2253832,-0.21808054238537,2.396815417062868,2.614895959448238
2021-11-01T09:30:00-04:00,157.9,160.51,157.9,160.05,152.81695571853768,NaN,NaN,NaN,NaN,NaN,147.84029999999993,162.21252020566436,133.4680797943355,154.59853110251404,159.48666666666668,159.48666666666668,159.48666666666668,54802,40935.066666666666,67.10178683660533,63.787424407618566,NaN,NaN,NaN,NaN,2.185838255213037,37.92146276925464,2308634,-0.0379468599198427,2.567462384548435,2.6054092444682775
2021-11-01T13:30:00-04:00,159.88,161.29,159.09,161.29,153.79232136769508,NaN,NaN,NaN,NaN,NaN,148.13969999999995,162.98856533173858,133.2908346682613,155.46082488201125,159.97411843403736,160.50700131570093,159.4412355523738,45856,41889.76666666667,69.13960764543282,63.57224480473149,NaN,NaN,NaN,NaN,2.186849808412105,38.79632583764979,2354490,0.1323275639623369,2.7708186994211985,2.6384911354588616
2021-11-02T09:30:00-04:00,160.42,160.56,158.19,158.19,153.79232136769508,NaN,NaN,NaN,NaN,NaN,148.48569999999992,163.448519521739,133.52288047826084,155.46082488201125,158.98,158.98,158.98,57543,42514.96666666667,59.25726364639164,63.43449784954104,NaN,NaN,NaN,NaN,2.252074822096954,39.04788402023957,2296947,0.010226066650933952,2.6512737187725293,2.6410476521215953
2021-11-02T13:30:00-04:00,158.05,159.13,157.72,158.96,153.79232136769508,NaN,NaN,NaN,NaN,NaN,148.85929999999993,163.91645298587753,133.80214701412234,155.46082488201125,158.81643250648077,159.0031303844205,158.62973462854103,44168,42737.566666666666,60.75764558379565,63.39881243363717,NaN,NaN,NaN,NaN,2.1919266205185997,38.99110361650453,2341115,-0.041779179849557924,2.588823677309648,2.630602857159206
2021-11-03T09:30:00-04:00,158.38,159.14,157.37,158.56,153.79232136769508,NaN,NaN,NaN,NaN,NaN,149.27069999999992,164.24126472014805,134.3001352798518,155.46082488201125,158.35666666666665,158.35666666666665,158.35666666666665,25615,42414.7,59.53119464233493,62.640752073345006,NaN,NaN,NaN,NaN,2.16178900476727,38.71723009337205,2315500,-0.12169469684040646,2.478484486108698,2.6001791829491046
2021-11-03T13:30:00-04:00,158.56,160.73,158.19,160.69,153.79232136769508,NaN,NaN,NaN,NaN,NaN,149.73589999999993,164.6512619721453,134.82053802785455,155.46082488201125,159.1704902314614,159.9249950581145,158.4159854048083,29801,42651.566666666666,63.729786439490965,62.097184277810484,NaN,NaN,NaN,NaN,2.1888040758553218,38.920256855529814,2345301,-0.053178470918930465,2.5337060943004417,2.586884565219372
2021-11-04T09:30:00-04:00,160.87,161.97,159.16,159.76,154.04312836852242,NaN,NaN,NaN,NaN,NaN,150.15669999999992,164.99214183501647,135.32125816498336,156.07665589733745,160.29666666666665,160.29666666666665,160.29666666666665,68156,44117.86666666667,60.76544659606754,61.74897263356434,NaN,NaN,NaN,NaN,2.2331752132942273,39.42844688720478,2277145,-0.09038068471113059,2.473908709330459,2.5642893940415896
2021-11-04T13:30:00-04:00,159.94,160.74,159.79,160.34,154.04312836852242,NaN,NaN,NaN,NaN,NaN,150.58629999999994,165.33210764963775,135.84049235036213,156.07665589733745,160.29351442773753,160.29684283854357,160.2901860169315,61132,44877.96666666667,61.95401475544153,61.452977777024785,NaN,NaN,NaN,NaN,2.1436626980589266,39.90033763090296,2338277,-0.09532429866137182,2.4451340207148746,2.5404583193762464
2021-11-05T09:30:00-04:00,160.19,160.77,156.63,156.63,154.04312836852242,NaN,NaN,NaN,NaN,NaN,150.91909999999996,165.44271520972276,136.39548479027715,156.07665589733745,158.01,158.01,158.01,51262,44607.4,51.25747751547402,60.92820286693399,NaN,NaN,NaN,NaN,2.2862582196261476,38.413366539316904,2287015,-0.3533502091903906,2.0987705578882583,2.452120767078649
2021-11-05T13:30:00-04:00,156.75,157.82,156.75,157.63,154.04312836852242,NaN,NaN,NaN,NaN,NaN,151.25769999999994,165.60082702447005,136.91457297552984,156.07665589733745,157.87839514105625,158.1293117109644,157.6274785711481,14102,44089.333333333336,53.58371936058296,60.89552474028016,NaN,NaN,NaN,NaN,2.2079540610814226,37.03260766855842,2301117,-0.45509050241529003,1.8832576390595364,2.3383481414748264
2021-11-08T09:30:00-05:00,157.715,160.63,157.64,160.31,154.04312836852242,NaN,NaN,NaN,NaN,NaN,151.74629999999993,165.61742148458538,137.8751785154145,156.07665589733745,159.52666666666667,159.52666666666667,159.52666666666667,67075,45640.1,59.2031574718344,60.879959361776166,NaN,NaN,NaN,NaN,2.264528771004178,36.674679828552115,2368192,-0.34528968565673646,1.906736034403906,2.2520257200606424
2021-11-08T13:30:00-05:00,160.44,160.52,159.43,159.47,154.04312836852242,NaN,NaN,NaN,NaN,NaN,152.19689999999994,165.5696398673617,138.82416013263818,156.07665589733745,159.61452777749358,159.74445674364398,159.48459881134318,30672,45832.066666666666,56.878803931974495,60.57002543452645,NaN,NaN,NaN,NaN,2.1806338587895944,36.342318262831974,2337520,-0.3325061312442914,1.836393056005278,2.1688991872495693
2021-11-09T09:30:00-05:00,161.61,162.04,156.64,157.28,154.04312836852242,NaN,NaN,NaN,NaN,NaN,152.56309999999993,165.461344979846,139.66485502015388,156.07665589733745,158.6533333333333,158.6533333333333,158.6533333333333,131569,48663.26666666667,51.23146792308042,59.6893023467565,NaN,NaN,NaN,NaN,2.410588583161766,34.56733696092654,2205951,-0.4665972498014561,1.5856526249977492,2.0522498747992053
2021-11-09T13:30:00-05:00,157.61,158.41,157.1,158.38,154.04312836852242,NaN,NaN,NaN,NaN,NaN,152.94589999999994,165.36705480783172,140.52474519216815,156.07665589733745,158.53290682427047,158.79480708614008,158.27100656240086,27818,48653.13333333333,53.71715510598082,59.150609103891966,NaN,NaN,NaN,NaN,2.331975112935926,32.91914003772863,2233769,-0.4746937064555623,1.4588827417297523,1.9335764481853146
2021-11-10T09:30:00-05:00,155.53,158.35,154.12,155.35,154.04312836852242,NaN,NaN,NaN,NaN,NaN,153.23569999999992,165.1824990708863,141.28890092911354,156.07665589733745,155.94000000000003,155.94000000000003,155.94000000000003,112025,50908.333333333336,46.66202541015146,57.69062614485955,NaN,NaN,NaN,NaN,2.469691176297645,31.03310905440119,2121744,-0.6658797489037465,1.1012267620556315,1.767106510959378
2021-11-10T13:30:00-05:00,155.46,155.46,151.8,153.64,NaN,NaN,NaN,160.84772992207579,160.84772992207579,160.84772992207579,153.47929999999994,164.94264820373684,142.01595179626304,156.07665589733745,155.20285412326365,156.27847756050892,154.12723068601838,52614,52187.4,43.21264558623294,55.83870028348814,NaN,NaN,NaN,NaN,2.5547132351335273,30.07817449536328,2069130,-0.8760435175471784,0.672052114025405,1.5480956315725833
2021-11-11T09:30:00-05:00,155.07,155.82,154.01,154.52,NaN,NaN,NaN,160.84772992207579,NaN,NaN,153.66849999999994,164.8792555945232,142.4577444054767,155.53532471786997,154.78333333333333,154.78333333333333,154.78333333333333,39754,52692.26666666667,45.44756969890257,54.8522935729532,NaN,NaN,NaN,NaN,2.5279480040525617,29.027220641150226,2108884,-0.9198005956090389,0.3983448870612847,1.3181454826703236
2021-11-11T13:30:00-05:00,154.49,154.86,153.65,153.77,NaN,NaN,NaN,160.84772992207579,NaN,NaN,153.86029999999994,164.7383598288541,142.98224017114578,155.20252500443954,154.46106569427874,154.80531595174298,154.1168154368145,34839,53516.566666666666,43.863135904896986,53.64554288160328,NaN,NaN,NaN,NaN,2.433808860905951,28.175928952603112,2074045,-0.958889745919435,0.11953330027102993,1.078423046190465
2021-11-12T09:30:00-05:00,154.44,155.27,154.06,155.12,NaN,NaN,NaN,160.84772992207579,NaN,NaN,154.10049999999993,164.53998432635186,143.661015673648,155.20252500443954,154.8166666666667,154.8166666666667,154.8166666666667,45488,51947.1,47.41673300047183,52.780224192898785,NaN,NaN,NaN,NaN,2.3671082279840974,27.17920919674381,2119533,-0.8568014139854763,0.0074212787086196386,0.8642226926940959
2021-11-12T13:30:00-05:00,155.48,156.69,155.33,156.67,NaN,NaN,NaN,160.84772992207579,NaN,NaN,154.38349999999994,164.3063032833535,144.4606967166464,155.20252500443954,155.2611833109802,155.91742651555816,154.6049401064022,20871,51282.5,51.23373302460538,51.88764894897838,NaN,NaN,NaN,NaN,2.310171925985233,25.56660997394352,2140404,-0.6568610537969194,0.04314637544794664,0.700007429244866
2021-11-15T09:30:00-05:00,156.89,157.84,154.84,155.36,NaN,NaN,NaN,160.84772992207579,NaN,NaN,154.62749999999994,164.02019977163724,145.23480022836264,155.20252500443954,156.01333333333335,156.01333333333335,156.01333333333335,79430,50352.6,48.058544667843194,50.98001309696236,NaN,NaN,NaN,NaN,2.3594453598434306,23.92287435787595,2060974,-0.5870915413816443,-0.0338569974821894,0.5532345438994549
2021-11-15T13:30:00-05:00,155.49,156.34,154.67,155.85,NaN,NaN,NaN,160.84772992207579,NaN,NaN,154.90349999999995,163.58579146021432,146.22120853978558,155.08602000355162,155.92076983553952,156.08762398745654,155.7539156836225,24445,49471.63333333333,49.323654550192934,50.077844510873184,NaN,NaN,NaN,NaN,2.3101992627117585,22.317616587174243,2085419,-0.48635813240072556,-0.05471312160145203,0.43164501079927353
2021-11-16T09:30:00-05:00,154.06,156.54,153.91,155.95,NaN,NaN,NaN,160.84772992207579,NaN,NaN,155.16149999999993,163.1591937300773,147.16380626992256,152.19181600284128,155.46666666666667,155.46666666666667,155.46666666666667,60611,48459.73333333333,49.59348404375299,49.95898783432168,NaN,NaN,NaN,NaN,2.3330421725180606,20.97736324081716,2146030,-0.3952781450006693,-0.06245267045156311,0.3328254745491062
2021-11-16T13:30:00-05:00,155.95,156.27,155.69,156.13,NaN,NaN,NaN,160.84772992207579,NaN,NaN,155.42509999999996,162.62444343951555,148.22575656048437,152.01370717939906,155.57931102604718,155.80462762717755,155.3539944249168,15149,47671.4,50.108438024276516,49.71075345315693,NaN,NaN,NaN,NaN,2.2078248744810574,19.732842276342723,2161179,-0.3090169667172822,-0.05344573384749651,0.25557123286978567
2021-11-17T09:30:00-05:00,155.81,156.2,153.96,154.51,NaN,NaN,NaN,160.84772992207579,NaN,NaN,155.59909999999994,162.26096330992468,148.9372366900752,152.01370717939906,154.89,154.89,154.89,49294,45611.166666666664,45.593877687954674,48.738662040022675,NaN,NaN,NaN,NaN,2.210123097732409,19.370836322731112,2111885,-0.3444655608347846,-0.17501071817369507,0.1694548426610895
2021-11-17T13:30:00-05:00,154.82,155.11,154.21,154.35,NaN,NaN,NaN,160.84772992207579,NaN,NaN,155.76289999999995,161.8678318063429,149.65796819365698,152.01370717939906,154.78880010548522,154.94207071428323,154.6355294966872,21490,45445.566666666666,45.16110602376152,47.90168361800746,NaN,NaN,NaN,NaN,2.1165428764658087,19.034687937234615,2090395,-0.3603823126382225,-0.28102304813668866,0.07935926450153387
2021-11-18T09:30:00-05:00,154.55,155.1,150.52,150.59,NaN,NaN,NaN,159.60404683473556,NaN,NaN,155.80169999999993,161.7479100904807,149.85548990951915,152.01370717939906,152.07000000000002,152.07000000000002,152.07000000000002,83662,47465.96666666667,36.413856591693225,46.843282808622654,NaN,NaN,NaN,NaN,2.292504099575393,20.074350134151008,2006733,-0.5921447071983722,-0.6608216194964314,-0.06867691229805918
2021-11-18T13:30:00-05:00,150.58,151.07,149.98,150.93,NaN,NaN,NaN,157.1588628877021,NaN,NaN,155.85649999999995,161.56693264561366,150.14606735438625,152.01370717939906,151.63854350891748,152.2883118897478,150.98877512808716,36888,48287.46666666667,37.591001451306475,45.69141469043164,NaN,NaN,NaN,NaN,2.2066109496057225,21.199946094672026,2043621,-0.6840435621027383,-0.923731364926482,-0.23968780282374375
2021-11-19T09:30:00-05:00,151.41,152.5,150.98,151,NaN,NaN,NaN,157.1588628877021,NaN,NaN,155.89109999999994,161.4607087079888,150.32149129201107,152.01370717939906,151.49333333333334,151.49333333333334,151.49333333333334,59527,49370.2,37.84611850287529,45.06170705419763,NaN,NaN,NaN,NaN,2.161138738919599,21.39279998568495,2103148,-0.6991328657130862,-1.1136038849651015,-0.41447101925201535
2021-11-19T13:30:00-05:00,150.83,150.85,149.67,149.93,NaN,NaN,NaN,156.69021391214181,NaN,NaN,155.90109999999996,161.42588534968613,150.3763146503138,152.01370717939906,151.0129056462607,151.65677190861598,150.3690393839054,33142,49293.333333333336,35.459951521139445,44.50794319240524,NaN,NaN,NaN,NaN,2.1017716861396285,22.00540757400649,2070006,-0.7364470959226456,-1.3350298891553223,-0.5985827932326767
2021-11-22T09:30:00-05:00,150.44,150.6,142.42,144.78,NaN,NaN,NaN,153.76338600704446,NaN,NaN,155.75739999999993,162.01004207836505,149.50475792163482,151.41053807585232,145.9333333333333,145.9333333333333,145.9333333333333,155984,52666.066666666666,26.725836165899295,43.17067651147643,NaN,NaN,NaN,NaN,2.53593085141537,24.185934602400412,1914022,-1.044432962426279,-1.9041239962655254,-0.8596910338392465
2021-11-22T13:30:00-05:00,144.8,146.48,143.89,143.89,NaN,NaN,NaN,152.46186846126972,NaN,NaN,155.60419999999993,162.59364128240048,148.6147587175994,151.41053807585232,145.48602863728098,146.05851274207063,144.91354453249133,95227,54311.76666666667,25.55441210229469,41.86291052557626,NaN,NaN,NaN,NaN,2.539792933457129,26.210709700194773,1818795,-1.2316817168817644,-2.399293179941452,-1.1676114630596877
2021-11-23T09:30:00-05:00,142.77,143.92,138.02,138.42,NaN,NaN,NaN,148.72064716757563,NaN,NaN,155.2815999999999,163.76516279873982,146.79803720126,151.41053807585232,140.12,140.12,140.12,59732,54384.73333333333,19.80791075314933,39.89085179362466,NaN,NaN,NaN,NaN,2.7798077239244754,28.878376473964718,1759063,-1.622916547958094,-3.196257148007305,-1.5733406000492112
2021-11-23T13:30:00-05:00,138.23,140.55,137.77,140.4,NaN,NaN,NaN,146.93743593268584,NaN,NaN,155.00499999999994,164.45451321498203,145.55548678501785,151.19243046068183,139.96481039671028,140.21129197850573,139.71832881491483,23679,53701.76666666667,26.27097751537231,38.107797828679445,NaN,NaN,NaN,NaN,2.77982145792987,31.382933661802365,1782742,-1.642356173126776,-3.626285816457681,-1.9839296433309053
2021-11-24T09:30:00-05:00,139.32,142.93,137.82,142.74,NaN,NaN,NaN,146.93743593268584,NaN,NaN,154.76999999999992,164.82413347833295,144.7158665216669,150.6539443685455,141.16333333333333,141.16333333333333,141.16333333333333,166475,58397.1,33.13016560411937,37.041485038413455,NaN,NaN,NaN,NaN,2.9462627823634517,32.56651278583577,1949217,-1.4010250879213952,-3.7352110032326493,-2.334185915311254
2021-11-24T13:30:00-05:00,142.79,143.01,141.53,142.65,NaN,NaN,NaN,146.93743593268584,NaN,NaN,154.52419999999992,165.1351928583592,143.91320714164064,149.24515549483638,141.4587807707944,141.9851798442792,140.93238169730958,52442,59151.8,33.002991443976256,35.87572338796941,NaN,NaN,NaN,NaN,2.841529726480347,33.628371578174615,1896775,-1.1607826511922426,-3.7851642293015573,-2.6243815781093147
2021-11-26T09:30:00-05:00,142.24,143.44,140.47,141.72,NaN,NaN,NaN,146.93743593268584,NaN,NaN,154.23039999999995,165.41428122970288,143.046518770297,147.5318995166953,141.87666666666667,141.87666666666667,141.87666666666667,138184,61486.066666666666,31.650958540019133,34.59411442341699,NaN,NaN,NaN,NaN,2.8507061745888933,34.79386455462743,1758591,-0.9847776428950907,-3.8553536317281782,-2.8705759888330875
2021-11-29T09:30:00-05:00,143.98,144.1,140.24,142.08,NaN,NaN,NaN,146.93743593268584,NaN,NaN,153.96019999999993,165.64137561892383,142.27902438107603,147.5318995166953,142.14000000000001,142.14000000000001,142.14000000000001,48230,61056,32.79862671277655,33.357699329738416,NaN,NaN,NaN,NaN,2.9227985906896854,35.54348213356272,1806821,-0.7736925898497655,-3.8376917261452945,-3.063999136295529
2021-11-29T13:30:00-05:00,142.42,142.9,141.78,142.54,NaN,NaN,NaN,146.93743593268584,NaN,NaN,153.75239999999994,165.86131873620937,141.6434812637905,146.2105196133562,142.24954713708053,142.38074162876126,142.1183526453998,33627,60468.166666666664,34.316311075683046,32.552158857433305,NaN,NaN,NaN,NaN,2.79402726278328,36.23955559971691,1840448,-0.5435403033558996,-3.7434245154904033,-3.1998842121345037
2021-11-30T09:30:00-05:00,142.93,144.27,137.52,138.57,NaN,NaN,NaN,146.93743593268584,NaN,NaN,153.46459999999993,166.29755707777966,140.6316429222202,142.79841569068498,140.12,140.12,140.12,216589,67217.73333333334,28.362838449232612,31.352282602109806,NaN,NaN,NaN,NaN,3.0765967440130457,37.62306115716179,1623859,-0.5949754199108064,-3.9436034870230117,-3.3486280671122053
2021-11-30T13:30:00-05:00,138.67,139.88,138.67,139.37,NaN,NaN,NaN,146.93743593268584,NaN,NaN,153.10279999999995,166.47354241170245,139.73205758829744,138.94373255254797,139.88612198801786,140.25425492404588,139.51798905198984,87419,67895.86666666667,30.962051080900707,30.962867922767487,NaN,NaN,NaN,NaN,2.9504112622978282,38.9077448890749,1711278,-0.514441425896436,-3.9916798494827503,-3.4772384235863143
2021-12-01T09:30:00-05:00,140.93,141.175,134.14,134.94,NaN,NaN,NaN,146.53315106842538,NaN,NaN,152.63719999999995,166.8571066326089,138.417293367391,135.68865270625514,136.75166666666667,136.75166666666667,136.75166666666667,160613,72227.23333333334,25.454417648839197,30.09596907973411,NaN,NaN,NaN,NaN,3.2421676007051277,40.699080275429466,1550665,-0.6880073407820988,-4.337247599563938,-3.649240258781839
2021-12-01T13:30:00-05:00,135.03,135.06,130.34,130.34,NaN,NaN,NaN,141.8158487471333,NaN,NaN,152.11019999999994,167.5877328731718,136.63266712682807,135.68865270625514,134.761248543241,137.1421185623266,132.38037852415542,112253,71583.36666666667,21.23115805780961,28.909186190800845,NaN,NaN,NaN,NaN,3.3477270577976186,42.73715285535374,1438412,-1.0210204387204431,-4.925515807182393,-3.9044953684619497
2021-12-02T09:30:00-05:00,130.26,133.19,127.94,129.41,NaN,NaN,NaN,139.98240107680905,NaN,NaN,151.5597999999999,168.22436575612298,134.89523424387684,135.68865270625514,130.17999999999998,130.17999999999998,130.17999999999998,201497,77372.66666666667,20.490945563852037,27.83997147956603,NaN,NaN,NaN,NaN,3.48360369652636,44.82775145895344,1236915,-1.1999769067970778,-5.4044665019582965,-4.204489595161219
2021-12-02T13:30:00-05:00,129.47,131.2,129.03,130.78,NaN,NaN,NaN,139.40024648240865,NaN,NaN,151.0795999999999,168.70045853073452,133.4587414692653,135.68865270625514,130.22258341193574,130.29228315537307,130.15288366849842,75212,76145.56666666667,24.658118203395276,27.69227733938717,NaN,NaN,NaN,NaN,3.3897748610601903,46.769021590867446,1312127,-1.1234768531995787,-5.608835661660692,-4.485358808461113
2021-12-03T09:30:00-05:00,130.13,130.16,121.46,124.02,NaN,NaN,NaN,135.94409891502644,NaN,NaN,150.49379999999994,169.65891910320718,131.3286808967927,135.68865270625514,125.21333333333332,125.21333333333332,125.21333333333332,305000,84558.43333333333,19.2866547736144,27.244580387338576,NaN,NaN,NaN,NaN,3.8133623709844633,49.06748050477359,1007127,-1.4071488358850512,-6.244294853317427,-4.837146017432376
2021-12-03T13:30:00-05:00,123.85,124.26,122.47,124.21,NaN,NaN,NaN,133.28254896434342,NaN,NaN,149.86499999999995,170.3310785691864,129.39892143081352,135.68865270625514,124.72515844838624,125.45075654751217,123.9995603492603,138057,87835.2,19.815362251614957,27.245112637228974,NaN,NaN,NaN,NaN,3.668836487342716,51.201763781972154,1145184,-1.4549591787760265,-6.655844990902409,-5.200885812126383
2021-12-06T09:30:00-05:00,121.32,124.81,118.11,124.66,NaN,NaN,NaN,131.84038764778236,NaN,NaN,149.22799999999995,170.78091571922675,127.67508428077313,135.61092216500413,122.52666666666669,122.52666666666669,122.52666666666669,316743,97232,21.133038778617504,26.87811701317506,NaN,NaN,NaN,NaN,3.8853481668182366,53.397285699578845,1461927,-1.3325209791969232,-6.866537036122537,-5.534016056925614
2021-12-06T13:30:00-05:00,124.65,125.31,123.91,125.07,NaN,NaN,NaN,131.84038764778236,NaN,NaN,148.57599999999994,171.021825625272,126.13017437472789,135.0637377320033,123.09188471789355,124.0638584465236,122.1199109892635,107110,99286.06666666667,22.384513405386997,26.11057042755132,NaN,NaN,NaN,NaN,3.7078232977597914,55.211848036941106,1569037,-1.1093083259012317,-6.9206514643021535,-5.811343138400922
2021-12-07T09:30:00-05:00,129.18,131.59,129,130.96,NaN,NaN,NaN,131.84038764778236,NaN,NaN,148.05519999999993,170.89986965924703,125.21053034075283,131.85999018560264,130.51666666666668,130.51666666666668,130.51666666666668,231524,106307.83333333333,37.68303196619852,26.444859036281482,NaN,NaN,NaN,NaN,3.908693062205521,54.48096225525855,1800561,-0.48238423768323724,-6.4143234355049685,-5.931939197821731
2021-12-07T13:30:00-05:00,131.04,131.42,129.42,130.07,NaN,NaN,NaN,131.84038764778236,NaN,NaN,147.45559999999992,170.58152109646895,124.32967890353089,131.2414921484821,130.4509786466585,130.54945975293984,130.3524975403772,103006,107093.7,36.51192877614973,26.792071196005093,NaN,NaN,NaN,NaN,3.7723578434765552,53.80228260083902,1697555,-0.06687034932323499,-6.015527134475775,-5.94865678515254
2021-12-08T09:30:00-05:00,130.76,134.74,128.69,134.61,121.03565479591404,121.03565479591404,121.03565479591404,NaN,NaN,NaN,146.9219999999999,169.97755932958722,123.8664406704126,124.75319371878568,132.68,132.68,132.68,202332,113023.26666666666,45.77034491291535,27.718622496015005,NaN,NaN,NaN,NaN,3.9350465689425165,52.095872369063464,1899887,0.5410361224124731,-5.272361632136949,-5.813397754549422
2021-12-08T13:30:00-05:00,134.63,135.01,133.7,134.52,123.98244321428157,NaN,NaN,NaN,NaN,NaN,146.4485999999999,169.53127159927837,123.36592840072144,125.38850106079941,133.00992416333682,133.6895702837685,132.33027804290515,47679,112592.2,45.62829200909563,28.526621134115906,NaN,NaN,NaN,NaN,3.74754324258948,50.42765038554921,1852208,0.9409541621390485,-4.637205051875611,-5.57815921401466
2021-12-09T09:30:00-05:00,133.79,134.99,128.97,128.97,123.98244321428157,NaN,NaN,NaN,NaN,NaN,145.8487999999999,169.1573390842103,122.5402609157895,125.38850106079941,130.9766666666667,130.9766666666667,130.9766666666667,132371,116499.6,37.8309239297102,29.202912954150015,NaN,NaN,NaN,NaN,3.9098615824045178,49.61877237684437,1719837,0.8389556482967109,-4.529464653643771,-5.368420301940482
2021-12-09T13:30:00-05:00,129.01,129.01,127.22,127.64,123.98244321428157,NaN,NaN,NaN,NaN,NaN,145.23039999999992,168.7964175540992,121.66438244590061,125.38850106079941,129.71310642641748,131.20286058224653,128.22335227058844,95226,118030.66666666667,36.2329811178327,29.579407956788014,NaN,NaN,NaN,NaN,3.758442897947052,49.10589925743988,1624611,0.6951108847418199,-4.499531696013207,-5.194642580755027
2021-12-10T09:30:00-05:00,128.83,130.39,125.01,125.85,123.98244321428157,NaN,NaN,NaN,NaN,NaN,144.53359999999992,168.28950697405804,120.77769302594179,125.38850106079941,127.08333333333333,127.08333333333333,127.08333333333333,176253,123189.43333333333,34.142729377968706,30.200001651725838,NaN,NaN,NaN,NaN,3.874268405236547,48.91467625116132,1448358,0.5016378590924981,-4.567595256889405,-5.069233115981903
2021-12-10T13:30:00-05:00,125.74,125.74,124.54,125.3,123.98244321428157,NaN,NaN,NaN,NaN,NaN,143.84439999999992,167.792054969957,119.89674503004284,125.38850106079941,126.45974491935985,127.34840660547384,125.57108323324586,86788,123293.63333333333,33.50317881856435,31.076574563208318,NaN,NaN,NaN,NaN,3.6911063762910783,48.79691446787132,1361570,0.36519154490728223,-4.6127436848478,-4.977935229755082
2021-12-13T09:30:00-05:00,124.38,125.39,119.89,121.29,NaN,NaN,NaN,133.34273945464275,133.34273945464275,133.34273945464275,143.06339999999992,167.35286326620113,118.7739367337987,125.38850106079941,122.19,122.19,122.19,263448,130845.63333333333,29.207451738217856,31.699182147091594,NaN,NaN,NaN,NaN,3.8203130636988583,49.22524827433463,1098122,0.04999974772259108,-4.915435545101843,-4.965435292824434
2021-12-13T13:30:00-05:00,121.33,122.45,121.13,121.97,NaN,NaN,NaN,132.18625129761352,NaN,NaN,142.37019999999993,167.04663069489817,117.69376930510168,125.38850106079941,122.11113389288452,122.25464212807182,121.96762565769723,79565,131513.56666666668,30.82715525888979,32.13982765105549,NaN,NaN,NaN,NaN,3.641719273434655,49.62298680890771,1177687,-0.06151249672665493,-5.042325913732753,-4.9808134170060985
2021-12-14T09:30:00-05:00,119.31,122.1,118.83,119.43,NaN,NaN,NaN,130.83460351135835,NaN,NaN,141.60619999999994,166.70725077960057,116.50514922039932,125.38850106079941,120.12,120.12,120.12,164190,135881.83333333334,28.229066495192484,32.77857134545392,NaN,NaN,NaN,NaN,3.615167896760751,50.23671441926686,1013497,-0.24486936540085225,-5.286900123757164,-5.0420307583563115
2021-12-14T13:30:00-05:00,119.4,121.39,118.5,120.7,NaN,NaN,NaN,130.2373488062966,NaN,NaN,140.81399999999994,166.00390655004705,115.62409344995282,125.38850106079941,120.15228885292944,120.19014263351175,120.11443507234713,119463,134664.46666666667,31.344720082404663,33.60209690479604,NaN,NaN,NaN,NaN,3.563370189849269,50.841105935914385,1132960,-0.2199417766777909,-5.316957979203551,-5.09701620252576
2021-12-15T09:30:00-05:00,119.55,119.55,115.4,116.6,NaN,NaN,NaN,128.02224204237405,NaN,NaN,139.95659999999992,165.4644923033659,114.44870769663395,125.38850106079941,117.18333333333332,117.18333333333332,117.18333333333332,109632,135144.63333333333,27.23433784997323,34.03790398132145,NaN,NaN,NaN,NaN,3.687415176288607,51.711206980368296,1023328,-0.4079718334925406,-5.606980994391435,-5.199009160898894
2021-12-15T13:30:00-05:00,116.62,122.2,116.59,121.57,NaN,NaN,NaN,128.02224204237405,NaN,NaN,139.24239999999992,164.7698282480652,113.71497175193461,124.28280084863954,119.16774785859636,120.54239798903573,117.79309772815698,228464,140769.03333333333,37.87024777905993,35.14402786515523,NaN,NaN,NaN,NaN,3.8247426636965636,51.495455192883654,1251792,-0.13986670941308255,-5.373842547665248,-5.2339758382521655
2021-12-16T09:30:00-05:00,123.465,123.465,117.26,118.36,NaN,NaN,NaN,128.02224204237405,NaN,NaN,138.44199999999992,164.02858210859966,112.8554178914002,120.1313925431293,119.69500000000002,119.69500000000002,119.69500000000002,177122,145883.8,34.375392781893495,34.90776792341916,NaN,NaN,NaN,NaN,3.9947610448610944,50.83587147918839,1074670,-0.12162910988859998,-5.386012225612916,-5.264383115724316
2021-12-16T13:30:00-05:00,118.35,118.73,116.49,118.04,NaN,NaN,NaN,128.02224204237405,NaN,NaN,137.69579999999993,163.44215542052717,111.94944457947271,120.1313925431293,118.92604938945172,119.87566021887221,117.97643856003123,116139,144205.93333333332,34.038162357151606,34.731070322062145,NaN,NaN,NaN,NaN,3.8694209702281595,50.33707769838499,958531,-0.07624941334257596,-5.359694882402536,-5.28344546905996
2021-12-17T09:30:00-05:00,116.43,122.07,114.59,121.79,NaN,NaN,NaN,128.02224204237405,NaN,NaN,137.05879999999996,162.77171306406336,111.34588693593658,116.87811403450345,119.48333333333332,119.48333524068195,119.48333142598469,219801,149784.56666666668,41.30501046456226,34.4121178614655,NaN,NaN,NaN,NaN,4.127319472354719,48.70181749844759,1178332,0.24367522468198022,-4.978851438207485,-5.222526662889465
2021-12-17T13:30:00-05:00,121.73,122.25,120.98,121.54,NaN,NaN,NaN,128.02224204237405,NaN,NaN,136.39919999999995,161.97826920589736,110.82013079410254,115.55049122760276,120.21182929696685,121.21382320630848,119.20983538762523,116186,149051.3,40.980873936157835,34.08015942768422,NaN,NaN,NaN,NaN,3.9232252243293817,47.12349192084692,1062146,0.4630822946321249,-4.643673794599309,-5.106756089231434
2021-12-20T09:30:00-05:00,118.83,120.56,117.6,118.4,NaN,NaN,NaN,128.02224204237405,NaN,NaN,135.69179999999997,161.26649927565256,110.11710072434737,113.91839298208221,118.85333333333334,118.85333333333334,118.85333333333334,118603,151397.06666666668,37.04837407724787,34.0242630096512,NaN,NaN,NaN,NaN,3.9244234225915697,46.27329890726229,943543,0.4224967124479191,-4.578635198671535,-5.001131911119454
2021-12-20T13:30:00-05:00,118.31,119.68,118.22,118.6,NaN,NaN,NaN,128.02224204237405,NaN,NaN,134.96139999999997,160.36032281495505,109.5624771850449,113.63971438566577,118.84653447309938,118.85600826339045,118.83706068280831,61083,152312.26666666666,37.46002607446005,34.11190907798173,NaN,NaN,NaN,NaN,3.748393178120744,45.48383396607655,1004626,0.43326837776420124,-4.459546438914202,-4.892814816678404
2021-12-21T09:30:00-05:00,120.49,122.85,119.2,122.78,NaN,NaN,NaN,128.02224204237405,NaN,NaN,134.28359999999995,159.13188936084057,109.43531063915933,113.70766441233037,121.61000000000003,121.61000000000003,121.61000000000003,103862,148554.7,45.48381831379653,34.921986859112295,NaN,NaN,NaN,NaN,3.7842222368264054,43.657160982838136,1108488,0.7286718980835483,-3.9819749440739685,-4.710646842157517
2021-12-21T13:30:00-05:00,123,123.88,122.72,123.83,NaN,NaN,NaN,128.02224204237405,NaN,NaN,133.65299999999996,157.9233915914034,109.38260840859652,115.9861315298643,122.40618650072791,123.32938845990026,121.48298454155557,77249,148215.7,47.312455872079674,35.90836379150624,NaN,NaN,NaN,NaN,3.596777791338805,41.63455748626653,1185737,0.9855815318169459,-3.478669927386335,-4.464251459203281
2021-12-22T09:30:00-05:00,123.44,125.35,122.9,123.06,NaN,NaN,NaN,128.02224204237405,NaN,NaN,132.99719999999996,156.59575929161898,109.39864070838094,117.80990522389145,123.77,123.77000134869915,123.76999865130084,155444,148043.4,46.09147483337921,37.11436544116062,NaN,NaN,NaN,NaN,3.514865091957461,39.300567767223654,1030293,1.0865018278436294,-3.1061241743987438,-4.192626002242373
2021-12-22T13:30:00-05:00,123.07,123.96,122.55,123.83,NaN,NaN,NaN,128.02224204237405,NaN,NaN,132.35479999999995,155.15431341235336,109.55528658764655,117.80990522389145,123.68227510027923,123.8260413209792,123.53850887957925,57877,146230.86666666667,47.54918228704246,38.30879594317154,NaN,NaN,NaN,NaN,3.3645175853890708,37.224262476142364,1088170,1.1801634651676371,-2.7174216707828265,-3.8975851359504636
2021-12-23T09:30:00-05:00,123.72,126.32,121.84,126.28,NaN,NaN,NaN,128.02224204237405,NaN,NaN,131.75779999999995,153.57805711672736,109.93754288327253,118.69033934329053,124.81333333333333,124.81333333333333,124.81333333333333,143334,144292.1,51.996947196359365,40.0065017075406,NaN,NaN,NaN,NaN,3.444194900718422,34.570185104412026,1231504,1.368889461997366,-2.186473308453756,-3.555362770451122
2021-12-23T13:30:00-05:00,126.33,126.48,125.63,126.14,NaN,NaN,NaN,128.02224204237405,NaN,NaN,131.19039999999993,152.06975859551477,110.3110414044851,119.95127147463242,125.12250263475055,125.66753415298035,124.57747111652074,46121,143322.4,51.72701566498724,41.46237996343935,NaN,NaN,NaN,NaN,3.258895264952821,32.14388958556728,1185383,1.4388989037843514,-1.7567391407206827,-3.195638044505034
2021-12-27T09:30:00-05:00,126.08,127.05,125.22,126.49,NaN,NaN,NaN,128.02224204237405,NaN,NaN,130.63319999999993,150.47164406802372,110.79475593197614,120.91201717970594,126.25333333333333,126.25333333333333,126.25333333333333,97182,136395.13333333333,52.392406316421145,43.25938485389992,NaN,NaN,NaN,NaN,3.1568313174561906,30.06851124748442,1282565,1.4588202117784386,-1.372112779781986,-2.8309329915604247
2021-12-27T13:30:00-05:00,126.26,126.28,125.5,125.84,NaN,NaN,NaN,128.02224204237405,NaN,NaN,130.13819999999996,149.17920404495695,111.09719595504296,120.91201717970594,126.13840812732683,126.31294687749084,125.96386937716281,42134,133197.7,50.98681071613669,44.196282206548254,NaN,NaN,NaN,NaN,3.002057651923605,28.14137421926462,1240431,1.3791603298267838,-1.106982579276945,-2.486142909103729
2021-12-28T09:30:00-05:00,124.94,126.31,122.89,123.13,NaN,NaN,NaN,128.02224204237405,NaN,NaN,129.58219999999994,147.76649444988408,111.3979055501158,120.91201717970594,124.11,124.11000134869916,124.10999865130084,20090,123309.26666666666,45.5053633571937,44.99128010478399,NaN,NaN,NaN,NaN,3.0319106767862047,26.77416751301644,1220341,1.106653017037475,-1.102826637806885,-2.20947965484436
2021-12-28T13:30:00-05:00,123.03,123.29,122.39,122.76,NaN,NaN,NaN,128.02224204237405,NaN,NaN,129.01739999999992,146.23419961433265,111.8006003856672,120.91201717970594,123.59832755763146,124.23209400672086,122.96456110854207,13095,120175.43333333333,44.79724504823325,45.75978601128982,NaN,NaN,NaN,NaN,2.8796313427300477,25.658159891737075,1207246,0.8743690015627308,-1.1165184028909465,-1.9908874044536773
2021-12-29T09:30:00-05:00,119.24,119.24,116.72,118.19,NaN,NaN,NaN,127.5808682934379,NaN,NaN,128.38259999999994,144.7898534252414,111.97534657475848,120.91201717970594,118.05,118.05,118.05,69926,114788.83333333333,37.114945699292775,45.46049567091343,NaN,NaN,NaN,NaN,3.1053719611064734,26.042770385509566,1137320,0.4094458296569008,-1.4790801173825514,-1.8885259470394522
2021-12-29T13:30:00-05:00,118.2,118.69,117.67,118.07,NaN,NaN,NaN,127.48355609828165,NaN,NaN,127.84839999999993,143.8188253468744,111.87797465312545,120.91201717970594,118.08638569916117,118.13190579893804,118.0408655993843,44678,112844.56666666667,36.93582841631244,45.17156384806733,NaN,NaN,NaN,NaN,2.9564168210274393,26.399908701155457,1092642,0.10613637651034469,-1.7558554764015213,-1.861991852911866
2021-12-30T09:30:00-05:00,117.86,122.42,117.83,122.39,NaN,NaN,NaN,127.48355609828165,NaN,NaN,127.41839999999993,142.78432925143417,112.0524707485657,120.91201717970594,120.88,120.88,120.88,160118,111437.43333333333,46.87547431772243,45.8734995795298,NaN,NaN,NaN,NaN,3.073101333811194,25.365927929956605,1252760,0.2031317751122932,-1.6080771340214994,-1.8112089091337926
2021-12-30T13:30:00-05:00,122.5,122.58,120.87,120.96,NaN,NaN,NaN,127.48355609828165,NaN,NaN,127.06919999999992,142.2111311000978,111.92726889990206,120.91201717970594,121.01778453260827,121.26740083178379,120.76816823343276,48786,111474.33333333333,44.38185234523652,46.36791574172812,NaN,NaN,NaN,NaN,2.9757369528246795,24.352282922045163,1203974,0.1785312951681104,-1.5880447901736545,-1.766576085341765
2021-12-31T09:30:00-05:00,120.74,122.13,119.8,119.88,NaN,NaN,NaN,127.48355609828165,NaN,NaN,126.65879999999991,141.4413002702558,111.87629972974402,120.91201717970594,120.60333333333334,120.60333333333334,120.60333333333334,107583,110648.06666666667,42.54121905298667,46.157730080241706,NaN,NaN,NaN,NaN,2.9296128847657736,23.702868943046848,1096391,0.10093574546519646,-1.6404064035102692,-1.7413421489754657
2021-12-31T13:30:00-05:00,119.76,120,118.51,118.61,NaN,NaN,NaN,127.48355609828165,NaN,NaN,126.17619999999992,140.39185890981153,111.96054109018831,120.91201717970594,120.22328155230517,120.89388446119712,119.55267864341322,34554,108625.66666666667,40.41843418796878,45.66529995994807,NaN,NaN,NaN,NaN,2.826783392996789,23.44093796066545,1061837,-0.018163809447842016,-1.764046910785268,-1.745883101337426
2022-01-03T09:30:00-05:00,120.6,121.49,117.79,120.27,NaN,NaN,NaN,127.48355609828165,NaN,NaN,125.72859999999991,139.23279727936927,112.22440272063055,120.87461374376475,119.85000000000001,119.85000134869917,119.84999865130085,191394,109130.36666666667,44.328785677982346,45.53939359170544,NaN,NaN,NaN,NaN,2.8891560077827316,22.636073811046057,1253231,0.02999327869247237,-1.7083915029718355,-1.7383847816643079
2022-01-03T13:30:00-05:00,120.21,121.18,120.21,120.73,NaN,NaN,NaN,127.48355609828165,NaN,NaN,125.30879999999992,138.0837483850274,112.53385161497245,120.2756909950118,119.97022730267099,120.2677842187613,119.67267038658068,31246,107278.96666666666,45.398198249266194,45.385751874721414,NaN,NaN,NaN,NaN,2.752073435798252,21.88869995782805,1284477,0.10380955893250499,-1.6086228329986767,-1.7124323919311817
2022-01-04T09:30:00-05:00,120.54,120.75,114.05,114.76,NaN,NaN,NaN,126.71614210840772,NaN,NaN,124.76239999999993,136.9445761996823,112.58022380031755,118.01255279600944,116.51999999999998,116.52000233601544,116.51999766398453,160747,103855.6,35.78938053003286,44.22806854141238,NaN,NaN,NaN,NaN,3.034068190384091,22.694117726173367,1123730,-0.22074522903720228,-1.9883639282276846,-1.7676186991904823
2022-01-04T13:30:00-05:00,114.69,116.49,113.83,116.17,NaN,NaN,NaN,124.41540837620735,NaN,NaN,124.23499999999991,135.54498302386546,112.92501697613437,115.85471762524547,116.18826380830656,116.66725003144482,115.7092775851683,77105,103773.6,39.06954216048668,43.32396329109091,NaN,NaN,NaN,NaN,3.0073490339280844,23.485491741065328,1200835,-0.30650010454046117,-2.150743829866059,-1.8442437253255977
2022-01-05T09:30:00-05:00,114.53,116.27,111.67,112.38,NaN,NaN,NaN,123.43198072274339,NaN,NaN,123.71119999999992,134.7394434793635,112.68295652063634,115.85471762524547,113.44,113.44000134869916,113.43999865130084,230749,105992.23333333334,34.03642436421002,42.01282172307583,NaN,NaN,NaN,NaN,3.1211098172189353,24.635921485663175,970086,-0.569237685070743,-2.5557908316640265,-1.9865531465932835
2022-01-05T13:30:00-05:00,112.28,112.8,108.48,108.84,NaN,NaN,NaN,120.26098159898233,NaN,NaN,123.10059999999993,133.9729130271396,112.22828697286023,115.85471762524547,112.18680775377071,113.82704030776121,110.54657519978021,134699,106500.1,30.131853131387487,40.52318189559374,NaN,NaN,NaN,NaN,3.2067448302747255,26.23316342399856,835387,-0.9118796344789049,-3.126402689691915,-2.21452305521301
2022-01-06T09:30:00-05:00,108.05,110.21,104.9,109.02,NaN,NaN,NaN,117.46275516266495,NaN,NaN,122.58219999999992,133.61757895317237,111.54682104682745,115.85471762524547,108.04333333333334,108.04333333333334,108.04333333333334,209947,109843.93333333333,30.568010243113378,39.45622810173086,NaN,NaN,NaN,NaN,3.3569773423979585,28.20487442212095,1045334,-1.047162169574924,-3.523475767181665,-2.476313597606741
2022-01-06T13:30:00-05:00,108.81,110.09,108.51,108.72,NaN,NaN,NaN,117.46275516266495,NaN,NaN,122.14979999999993,133.62106321902326,110.67853678097659,115.58477410019637,108.18421801398277,108.5447161191816,107.82371990878394,32065,103297.3,30.229302370276628,38.4156607675911,NaN,NaN,NaN,NaN,3.230050389369533,30.035748920377465,1013269,-1.0736298911948716,-3.8183509616003306,-2.744721070405459
2022-01-07T09:30:00-05:00,108.08,110.92,105.88,107.16,NaN,NaN,NaN,117.46275516266495,NaN,NaN,121.70479999999992,133.72796380326434,109.6816361967355,115.38704433930054,107.98666666666668,107.98666666666668,107.98666666666668,303928,107524.16666666667,28.463146396013954,37.79767510307119,NaN,NaN,NaN,NaN,3.3593325044145668,32.06247232766993,709341,-1.1084703508333535,-4.130309008947151,-3.0218386581137975
2022-01-07T13:30:00-05:00,107.22,107.56,106.21,106.76,NaN,NaN,NaN,116.5386157552066,NaN,NaN,121.22439999999993,133.67077917468808,108.7780208253118,115.38704433930054,107.77116365837162,108.21832160164189,107.32400571510135,70592,106005.93333333333,28.011235030509553,37.16020414694241,NaN,NaN,NaN,NaN,3.2158087540992413,33.94442977729865,638749,-1.0701773678110351,-4.359560367877592,-3.2893830000665565
2022-01-10T09:30:00-05:00,104.61,104.62,101.53,103.65,NaN,NaN,NaN,113.00299685724268,NaN,NaN,120.81699999999994,134.1711000445593,107.46289995544059,115.38704433930054,103.26666666666667,103.26666666666667,103.26666666666667,804529,125496.86666666667,24.72437800460348,35.57798298171962,NaN,NaN,NaN,NaN,3.3596795573778673,36.196187944133875,-165780,-1.1585598594553468,-4.73758282438574,-3.579022964930393
2022-01-10T13:30:00-05:00,103.75,106.77,103.6,106.69,NaN,NaN,NaN,113.00299685724268,NaN,NaN,120.46659999999994,134.3549275364632,106.57827246353668,112.76563547144043,103.67398643919915,104.57941697349445,102.76855590490386,162818,127051.26666666666,33.000349240922716,34.765018474268636,NaN,NaN,NaN,NaN,3.346131017565163,37.37149575994286,-2962,-0.9265877035009185,-4.737257594306541,-3.810669890805623
2022-01-11T09:30:00-05:00,106.37,110.67,105.52,110.31,NaN,NaN,NaN,113.00299685724268,NaN,NaN,120.17959999999994,134.3005744479653,106.05862555203457,108.77250837715235,108.83333333333333,108.83333333333333,108.83333333333333,233538,130882.43333333333,41.27930358701924,34.674881655270966,NaN,NaN,NaN,NaN,3.4749788020247943,37.029668191514,230576,-0.4668576986434494,-4.394242014109935,-3.9273843154664854
2022-01-11T13:30:00-05:00,110.46,110.76,109.9,110.17,NaN,NaN,NaN,113.00299685724268,NaN,NaN,119.88159999999995,134.20461608461292,105.55858391538698,107.79600670172188,109.24027418979597,109.88969735088966,108.59085102870228,91699,131902.96666666667,41.067949758407735,34.72127562458803,NaN,NaN,NaN,NaN,3.2881946018801664,36.68142161995962,138877,-0.12736364584237503,-4.086588872769454,-3.959225226927079
2022-01-12T09:30:00-05:00,111.96,113.05,108.11,109.95,100.5362818165024,100.5362818165024,100.5362818165024,NaN,NaN,NaN,119.46139999999994,133.69217566965608,105.23062433034382,104.01268063265431,110.37,110.37,110.37,126047,132642.46666666667,40.715162204306225,34.4631596621826,NaN,NaN,NaN,NaN,3.4061807017458685,35.58484631798871,12830,0.11415687673853991,-3.816529131003904,-3.9306860077424437
2022-01-12T13:30:00-05:00,109.93,110.15,108.77,108.85,100.5362818165024,NaN,NaN,NaN,NaN,NaN,119.03699999999994,133.24260692121533,104.83139307878454,104.01268063265431,109.84438696563835,110.40018679444402,109.28858713683267,112727,133825.06666666668,38.91511759453195,34.000082472558724,NaN,NaN,NaN,NaN,3.2614535087640215,34.56659782330144,-99897,0.22518885297952718,-3.6491999415180345,-3.8743887944975617
2022-01-13T09:30:00-05:00,109.3,109.35,104.11,104.86,100.5362818165024,NaN,NaN,NaN,NaN,NaN,118.44199999999994,132.4798306016303,104.40416939836955,104.01268063265431,106.10666666666667,106.10666666666667,106.10666666666667,161237,134018.16666666666,33.18420921329765,33.81399880707763,NaN,NaN,NaN,NaN,3.40277825813802,34.531394738362344,-261134,0.06366635731168291,-3.7948058478579583,-3.858472205169641
2022-01-13T13:30:00-05:00,104.93,105.39,102.82,103.02,100.5362818165024,NaN,NaN,NaN,NaN,NaN,117.81199999999994,131.7339240049659,103.890075995034,104.01268063265431,105.40531186894569,106.48495839427798,104.3256653436134,68042,134357,30.922633157660997,33.23207673544723,NaN,NaN,NaN,NaN,3.3432940968424476,34.71564730348085,-329176,-0.123157856263588,-4.012419525499126,-3.8892616692355384
2022-01-14T09:30:00-05:00,102.18,104.1,99.98,100.15,NaN,NaN,NaN,112.08944187574618,112.08944187574618,112.08944187574618,117.23559999999993,131.6399966399173,102.83120336008255,104.01268063265431,101.41000000000001,101.41000000000001,101.41000000000001,214532,136730.26666666666,27.746250707237465,32.78277861709205,NaN,NaN,NaN,NaN,3.3987730899251294,35.329074813720815,-543708,-0.38149855452500026,-4.366134862391789,-3.9846363078667886
2022-01-14T13:30:00-05:00,100.2,102.8,100.19,102.57,NaN,NaN,NaN,111.4490126995759,NaN,NaN,116.73419999999994,131.39800910405125,102.07039089594865,104.01268063265431,101.53936702230673,101.74090333854983,101.33783070606364,88396,138139.43333333332,33.91084722532642,33.052706766659114,NaN,NaN,NaN,NaN,3.3452892977876196,35.89868607322936,-455312,-0.3326567996220815,-4.40045730739439,-4.067800507772309
2022-01-18T09:30:00-05:00,100.63,102.44,98.85,99,NaN,NaN,NaN,110.65383030414063,NaN,NaN,116.19719999999994,131.44141676046536,100.9529832395345,104.01268063265431,100.09666666666666,100.09666666666666,100.09666666666666,366834,147127.83333333334,29.86307285580827,33.00235409613732,NaN,NaN,NaN,NaN,3.3720543479456464,36.634670314715414,-822146,-0.4753490138199101,-4.661986775047197,-4.186637761227287
2022-01-18T13:30:00-05:00,99.11,100.44,98.77,99.01,NaN,NaN,NaN,109.3866107448615,NaN,NaN,115.67139999999993,131.42841088912675,99.91438911087312,104.01268063265431,99.88226791506716,100.20159269317965,99.56294313695467,165367,151235.6,29.88831838663181,32.977998097305544,NaN,NaN,NaN,NaN,3.2504790373781,37.330674865858185,-656779,-0.501060194541596,-4.812963004404281,-4.311902809862685
2022-01-19T09:30:00-05:00,99.58,101.6,97.84,100.27,NaN,NaN,NaN,109.3866107448615,NaN,NaN,115.25099999999995,131.49991393293885,99.00208606706103,104.01268063265431,99.90333333333334,99.90333333333334,99.90333333333334,176677,156455.16666666666,33.15324433011992,33.31300509259883,NaN,NaN,NaN,NaN,3.2868733918510924,37.468050514247594,-480102,-0.37118800989100187,-4.775887822226437,-4.404699812335435
2022-01-19T13:30:00-05:00,100.23,100.46,97.76,97.81,NaN,NaN,NaN,108.88018664976018,NaN,NaN,114.76779999999995,131.6146619226265,97.9209380773734,104.01268063265431,99.3695021424286,99.97766099266956,98.76134329218765,136130,160556.33333333334,30.196654823889475,33.46910650641168,NaN,NaN,NaN,NaN,3.2449538638617277,37.611242729825086,-616232,-0.3871629973422852,-4.888653559013292,-4.501490561671007
2022-01-20T09:30:00-05:00,99.46,103.34,99.46,101.14,NaN,NaN,NaN,108.88018664976018,NaN,NaN,114.40199999999996,131.6182709086503,97.18572909134963,102.23014450612345,101.31333333333335,101.31333333333335,101.31333333333335,95446,161407,38.2273810544451,34.43360672425751,NaN,NaN,NaN,NaN,3.408171445014461,36.52346915951012,-520786,-0.1233280352079289,-4.655650605680918,-4.5323225704729895
2022-01-20T13:30:00-05:00,101.18,101.6,97.71,97.96,NaN,NaN,NaN,108.88018664976018,NaN,NaN,113.94719999999994,131.66799503408504,96.22640496591484,100.39411560489874,99.87646339987003,100.9394994354977,98.81342736424237,174380,165730.4,34.18296450273414,34.51807924295833,NaN,NaN,NaN,NaN,3.4425877703705714,35.924946367498436,-695166,-0.11311618408855928,-4.673717800583688,-4.560601616495129
2022-01-21T09:30:00-05:00,95.98,96.93,91.67,92.89,NaN,NaN,NaN,104.8486953947623,NaN,NaN,113.47299999999994,132.1287385273285,94.81726147267139,96.940292483919,93.83,93.83,93.83,355721,172250.5,28.928046302452614,33.63584657977499,NaN,NaN,NaN,NaN,3.645974358201244,36.47908810707764,-1050887,-0.38276327751797634,-5.0390557133925995,-4.656292435874623
2022-01-21T13:30:00-05:00,92.8,93.72,91.075,91.16,NaN,NaN,NaN,102.82739105863675,NaN,NaN,112.86479999999995,132.38764907076964,93.34195092923025,95.2802339871352,93.14149520260092,94.03382501559504,92.2491653896068,211774,177683.43333333332,27.38125266835422,32.658225359056885,NaN,NaN,NaN,NaN,3.5744761897582977,37.08386371477347,-1262661,-0.5996617973280616,-5.4058696825347,-4.806207885206638
2022-01-24T09:30:00-05:00,86.93,88.53,82.76,87.59,NaN,NaN,NaN,96.74625964688053,NaN,NaN,112.24939999999994,132.9452022449011,91.55359775509876,94.41918718970817,86.29333333333334,86.29333333333334,86.29333333333334,503438,190878.6,24.473148769205707,31.498081542263993,NaN,NaN,NaN,NaN,3.9191564619184187,38.63777973256261,-1766099,-0.8881861051762661,-5.916440516676971,-5.028254411500705
2022-01-24T13:30:00-05:00,87.37,93.03,87.36,92.99,NaN,NaN,NaN,96.74625964688053,NaN,NaN,111.74839999999995,133.06280127613383,90.43399872386605,94.35619925832358,88.69066442149439,91.1072537356274,86.27407510736138,495446,206241.66666666666,35.61268582314739,31.26219355859367,NaN,NaN,NaN,NaN,4.044216714638532,38.626010890419906,-1270653,-0.6320103481237362,-5.818267346655375,-5.186256998531639
2022-01-25T09:30:00-05:00,90.47,91.99,87.75,89.47,NaN,NaN,NaN,96.74625964688053,NaN,NaN,111.10199999999995,133.10817731456441,89.09582268543548,94.35619925832358,89.73666666666668,89.73666666666668,89.73666666666668,372901,212291.9,32.27137539773946,31.19699114319665,NaN,NaN,NaN,NaN,4.1296298064500645,38.61508267985882,-1643554,-0.615669381307959,-5.955843725166588,-5.340174343858629
2022-01-25T13:30:00-05:00,89.55,92.21,89.3,89.45,NaN,NaN,NaN,96.74625964688053,NaN,NaN,110.46019999999994,133.07463768569215,87.84576231430775,94.35619925832358,89.9425519371075,90.22131885857544,89.66378501563955,203405,218030.53333333333,32.25285917769101,31.292007287484516,NaN,NaN,NaN,NaN,4.042513391703631,38.53354901527102,-1846959,-0.5257437767043083,-5.997354064739014,-5.4716102880347055
2022-01-26T09:30:00-05:00,92.77,93.53,91.03,92.82,NaN,NaN,NaN,96.74625964688053,NaN,NaN,109.94859999999996,132.97503594132695,86.92216405867298,94.35619925832358,92.46,92.46,92.46,160810,218032.63333333333,38.64130959396178,32.0702257793934,NaN,NaN,NaN,NaN,4.045191006581943,38.020308859433314,-1686149,-0.17687063873885744,-5.6926985864582775,-5.51582794771942
2022-01-26T13:30:00-05:00,92.73,93.9,86.7,87.38,NaN,NaN,NaN,96.74625964688053,NaN,NaN,109.32419999999995,133.0606034647213,85.58779653527858,94.35619925832358,90.5662940274395,92.09844602278626,89.03414203209273,245660,223651.13333333333,33.199000019673406,32.01937955041818,NaN,NaN,NaN,NaN,4.2705345061118045,38.210619220017534,-1931809,-0.2458132041579537,-5.8230944529168625,-5.577281248758909
2022-01-27T09:30:00-05:00,88.89,89.01,84.53,84.57,NaN,NaN,NaN,96.74625964688053,NaN,NaN,108.55999999999995,132.96528205122897,84.15471794877094,92.46795940665885,86.03666666666668,86.03666666666668,86.03666666666668,193233,222400.6,30.78693009024525,32.08536935287796,NaN,NaN,NaN,NaN,4.285496327103819,38.67704708348007,-2125042,-0.4046197609661242,-6.083055949966564,-5.67843618900044
2022-01-27T13:30:00-05:00,84.49,85.98,83.58,83.96,NaN,NaN,NaN,96.56529709543918,NaN,NaN,107.76259999999995,132.7192298397847,82.8059701602152,86.4793675253271,85.27216581998582,86.03716565713975,84.50716598283188,192981,224343.33333333334,30.272738697426902,32.11282794650618,NaN,NaN,NaN,NaN,4.150818018024975,39.23343300509595,-2318023,-0.4701053538186075,-6.266067881273699,-5.795962527455091
2022-01-28T09:30:00-05:00,84.24,87.64,81.81,85.86,NaN,NaN,NaN,96.56529709543918,NaN,NaN,107.01859999999995,132.32228163252213,81.71491836747775,84.03699402026167,85.10333333333334,85.10333333333334,85.10333333333334,176624,223232.56666666668,33.97183868089563,32.17129897156159,NaN,NaN,NaN,NaN,4.270759588166048,39.97556866803809,-2141399,-0.31241251002779613,-6.186478164989836,-5.87406565496204
2022-01-28T13:30:00-05:00,86.09,87.38,84.36,87.34,NaN,NaN,NaN,96.56529709543918,NaN,NaN,106.28879999999994,131.7154750134586,80.86212498654128,82.30443260055935,85.92635883970311,86.52376802571753,85.3289496536887,335222,233337.8,36.78507296410022,32.64190026729093,NaN,NaN,NaN,NaN,4.181419617582759,40.66469464077009,-1806177,-0.049193632778882446,-5.935557695935643,-5.88636406315676
2022-01-31T09:30:00-05:00,88.62,94.42,88.59,93.28,NaN,NaN,NaN,96.56529709543918,NaN,NaN,105.62879999999994,130.65558297824234,80.60201702175755,82.30443260055935,92.09666666666665,92.09666666666665,92.09666666666665,478061,239142.23333333334,46.616052561204405,33.24109108920231,NaN,NaN,NaN,NaN,4.3884610734697045,39.01911222440073,-1328116,0.5511074522353496,-5.197479747862573,-5.748587200097923
2022-01-31T13:30:00-05:00,93.35,94.83,92.98,94.83,NaN,NaN,NaN,96.56529709543918,NaN,NaN,105.00259999999994,129.50655357814802,80.49864642185187,84.09070628771283,92.70253376133775,93.65926974755129,91.7457977751242,191714,243179.63333333333,48.85137931970306,34.28883500470009,NaN,NaN,NaN,NaN,4.207142425364725,37.379874142707884,-1136402,1.049800730361591,-4.436336287145934,-5.4861370175075255
2022-02-01T09:30:00-05:00,96.14,97.2,93.01,96.76,83.05546061830177,83.05546061830177,83.05546061830177,NaN,NaN,NaN,104.40799999999994,128.23084852825207,80.58515147174784,86.51356503017027,95.65666666666668,95.65666666666668,95.65666666666668,220690,223718.33333333334,51.57063118917092,35.90616249660854,NaN,NaN,NaN,NaN,4.205917966410102,35.22665964250982,-915712,1.480523881943209,-3.635482165078514,-5.116006047021723
2022-02-01T13:30:00-05:00,96.71,97.15,95.24,97.01,84.43271240837895,NaN,NaN,NaN,NaN,NaN,103.83139999999995,126.93616626499454,80.72663373500535,87.64585202413622,95.8861543474284,96.25114808133928,95.52116061351752,87243,221199.16666666666,51.927150255033055,37.65944089565703,NaN,NaN,NaN,NaN,4.041923825952238,33.22724617804019,-828469,1.7354773670448331,-2.9466593382156816,-4.682136705260515
2022-02-02T09:30:00-05:00,97.18,97.2,90.78,92.08,84.43271240837895,NaN,NaN,NaN,NaN,NaN,103.21039999999995,125.87183012609817,80.54896987390173,87.64585202413622,93.35333333333334,93.35333333333334,93.35333333333334,178969,219380.2,44.90653614998896,39.118968565712976,NaN,NaN,NaN,NaN,4.211786409812793,32.31459977521504,-1007438,1.5323657448954435,-2.7666795241412103,-4.299045269036654
2022-02-02T13:30:00-05:00,92.08,92.62,91.34,92.04,84.43271240837895,NaN,NaN,NaN,NaN,NaN,102.59599999999995,124.76439516067913,80.42760483932076,87.64585202413622,93.1115559798131,93.62996611000632,92.59314584961989,38928,217621.16666666666,44.85354843704954,39.7790301809917,NaN,NaN,NaN,NaN,4.002373094826164,31.467142401163102,-1046366,1.3613710391460927,-2.597331470104038,-3.9587025092501307
2022-02-03T09:30:00-05:00,88.32,90.02,87.53,87.89,84.43271240837895,NaN,NaN,NaN,NaN,NaN,101.98999999999995,124.0765635172161,79.9034364827838,87.64585202413622,88.48,88.48,88.48,191977,219818.83333333334,39.62897066486884,40.30457270007236,NaN,NaN,NaN,NaN,4.0386321594814385,31.383005850611635,-1238343,0.954076981153082,-2.766106282808778,-3.72018326396186
2022-02-03T13:30:00-05:00,87.89,88.18,86.28,86.54,84.43271240837895,NaN,NaN,NaN,NaN,NaN,101.35939999999995,123.37386230458584,79.34493769541406,87.64585202413622,87.98380543138403,88.68248913065544,87.28512173211261,96826,219288.8,38.07526866915321,40.720459092319665,NaN,NaN,NaN,NaN,3.885872719518479,31.513366142661305,-1335169,0.5965410188539315,-2.9745069903944454,-3.571048009248377
2022-02-04T09:30:00-05:00,88.1,91.96,86.52,91.71,84.43271240837895,NaN,NaN,NaN,NaN,NaN,100.74579999999995,122.08113485652464,79.41046514347525,87.64585202413622,90.06333333333333,90.06333333333333,90.06333333333333,73640,216368.9,46.69449784832177,41.29568682477395,NaN,NaN,NaN,NaN,3.996881810981445,30.49268902438933,-1261529,0.7036666233464342,-2.6914647300653343,-3.3951313534117684
2022-02-04T13:30:00-05:00,91.84,93.17,91.65,92.11,84.43271240837895,NaN,NaN,NaN,NaN,NaN,100.16879999999993,120.83621034188961,79.50138965811026,87.64585202413622,91.24968241760823,92.371246857537,90.12811797767945,82393,216847.26666666666,47.30561263024939,42.303302011243666,NaN,NaN,NaN,NaN,3.819961681625627,29.21231713254248,-1179136,0.7904033397273325,-2.407127178752603,-3.1975305184799354
2022-02-07T09:30:00-05:00,92.36,95.46,91.84,93.52,84.43271240837895,NaN,NaN,NaN,NaN,NaN,99.64159999999994,119.6036665703737,79.67953342962618,87.64585202413622,93.60666666666667,93.60666666666667,93.60666666666667,141137,214400.76666666666,49.5032594594802,43.64018268047473,NaN,NaN,NaN,NaN,3.805678704366653,27.42119488604638,-1037999,0.9224681654024143,-2.0444453117269177,-2.966913477129332
2022-02-07T13:30:00-05:00,93.48,93.92,91.91,92.36,84.43271240837895,NaN,NaN,NaN,NaN,NaN,99.11659999999992,118.42564766579758,79.80755233420226,87.64585202413622,93.33744617202369,93.74184320329631,92.93304914075107,62552,213539.3,47.73928218554195,44.8877929296258,NaN,NaN,NaN,NaN,3.677415939769035,25.758009942871425,-1100551,0.9099068278865334,-1.829529942271165,-2.7394367701576985
2022-02-08T09:30:00-05:00,91.13,93.15,90.17,92.38,84.43271240837895,NaN,NaN,NaN,NaN,NaN,98.55879999999993,116.98237170149254,80.13522829850733,87.64585202413622,91.89999999999999,91.89999999999999,91.89999999999999,231607,209031.73333333334,47.77383663699926,45.87364992649035,NaN,NaN,NaN,NaN,3.6276005154998185,24.637569931628317,-868944,0.8805860808150126,-1.6387041691389328,-2.5192902499539453
2022-02-08T13:30:00-05:00,92.52,93.52,91.63,93.32,84.43271240837895,NaN,NaN,NaN,NaN,NaN,98.01059999999993,115.36273342964047,80.65846657035938,86.84679026641213,92.12750904011052,92.52538630389711,91.72963177632394,75727,206043.73333333334,49.46506738062147,46.77936381338473,NaN,NaN,NaN,NaN,3.5034861929641172,23.487246372470015,-793217,0.8990031194392984,-1.3955363506548224,-2.294539470094121
2022-02-09T09:30:00-05:00,95.19,97.21,94.23,96.97,84.87300097904466,NaN,NaN,NaN,NaN,NaN,97.65479999999994,114.33512960825533,80.97447039174455,89.5128692931224,96.13666666666666,96.13666666666666,96.13666666666666,156737,205379.06666666668,55.4920755273275,47.413365453822095,NaN,NaN,NaN,NaN,3.5310943220381086,22.212124691012455,-636480,1.1172726846927494,-0.8979486142281843,-2.0152212989209337
2022-02-09T13:30:00-05:00,96.83,97.77,96.43,97.77,86.5633191163608,NaN,NaN,NaN,NaN,NaN,97.28679999999993,113.10665306632261,81.46694693367725,90.94229543449792,96.47078467323361,97.00449982086626,95.93706952560096,61426,202888.93333333332,56.71070698988037,47.974746001691905,NaN,NaN,NaN,NaN,3.374587584749672,21.168889599041492,-575054,1.2649370582367845,-0.4340499761249532,-1.6989870343617377
2022-02-10T09:30:00-05:00,95.57,100.17,95.48,96.96,87.12771370198078,NaN,NaN,NaN,NaN,NaN,96.97839999999992,112.19915812041044,81.7576418795894,92.36283634759835,97.53666666666668,97.53666666666668,97.53666666666668,260995,208407.23333333334,55.06669944563666,48.22446516286802,NaN,NaN,NaN,NaN,3.4685456144104094,20.78051658617417,-836049,1.2549771688296363,-0.13026557332469224,-1.3852427421543285
2022-02-10T13:30:00-05:00,96.93,97.52,94.29,95.02,87.12771370198078,NaN,NaN,NaN,NaN,NaN,96.70199999999994,111.54844442282487,81.85555557717501,92.36283634759835,96.79309103728121,97.73102369086928,95.85515838369315,164036,208062.43333333332,51.23569405766784,48.17507543448479,NaN,NaN,NaN,NaN,3.4515066419525224,20.04912643032815,-1000085,1.071769252017256,-0.04553117713275867,-1.1173004291500146
2022-02-11T09:30:00-05:00,95.7,97,94.05,94.05,87.12771370198078,NaN,NaN,NaN,NaN,NaN,96.40259999999994,110.84151785972972,81.96368214027015,92.36283634759835,95.03333333333335,95.03333333333335,95.03333333333335,157932,201469.46666666667,49.38566187911981,48.49501298656556,NaN,NaN,NaN,NaN,3.415684738955914,19.29380546244764,-1158017,0.8490372447165166,-0.05600387325436884,-0.9050411179708855
2022-02-11T13:30:00-05:00,93.77,93.77,91.13,92.22,87.12771370198078,NaN,NaN,NaN,NaN,NaN,96.07259999999992,110.1192655459591,82.02593445404075,92.36283634759835,93.54837989055999,94.86932252011381,92.22743726100616,199585,201063.16666666666,46.010260744999705,48.5776352942763,NaN,NaN,NaN,NaN,3.380278686173349,18.116428441746567,-1357602,0.5563899645699651,-0.20955366225842909,-0.7659436268283942
2022-02-14T09:30:00-05:00,91.8,94.9,90.87,92.78,87.12771370198078,NaN,NaN,NaN,NaN,NaN,95.78499999999993,109.49670375992851,82.07329624007134,92.36283634759835,92.85000000000001,92.85000000000001,92.85000000000001,93733,187406.33333333334,47.19953999114992,49.11839024615352,NaN,NaN,NaN,NaN,3.4266873514466814,16.9497463003962,-1263869,0.3865182911384115,-0.2827957629053799,-0.6693140540437914
2022-02-14T13:30:00-05:00,92.66,92.9,91.3,91.98,87.12771370198078,NaN,NaN,NaN,NaN,NaN,95.48939999999993,108.87534391740952,82.10345608259034,92.36283634759835,92.52101736385654,92.91046146468061,92.13157326303248,66888,173121.06666666668,45.65242323996584,49.65961557264013,NaN,NaN,NaN,NaN,3.2962096834862047,15.866398597713719,-1330757,0.2148319670958101,-0.40077409517402884,-0.6156060622698389
2022-02-15T09:30:00-05:00,94.2,95.66,93.33,95.38,87.12771370198078,NaN,NaN,NaN,NaN,NaN,95.32399999999993,108.50532739901531,82.14267260098454,92.36283634759835,94.79,94.79,94.79,220253,168032.8,52.74219822994916,50.091594171327806,NaN,NaN,NaN,NaN,3.323623277522904,15.648570339530155,-1110504,0.31855287853549485,-0.21741496410047034,-0.5359678426359652
2022-02-15T13:30:00-05:00,95.34,96.74,95.14,96.6,87.12771370198078,NaN,NaN,NaN,NaN,NaN,95.12219999999992,107.90421379439255,82.3401862056073,92.36283634759835,95.17681097795416,95.79350239765489,94.56011955825343,86653,164141.06666666668,55.01014301500506,50.64191777023892,NaN,NaN,NaN,NaN,3.2005073291284107,15.72778840906218,-1023851,0.44960793451302505,0.02604207550531612,-0.42356585900770893
2022-02-16T09:30:00-05:00,94.35,94.36,91.99,92.26,87.12771370198078,NaN,NaN,NaN,NaN,NaN,94.76119999999992,106.80530338049435,82.71709661950548,92.36283634759835,92.87,92.87,92.87,127583,163033.5,46.46699167706815,50.425041500066634,NaN,NaN,NaN,NaN,3.3011853770478097,14.764478143564874,-1151434,0.2350744218886458,-0.12972283164690168,-0.3647972535355475
2022-02-16T13:30:00-05:00,92.22,93.97,91.94,93.19,87.12771370198078,NaN,NaN,NaN,NaN,NaN,94.42159999999993,105.63775432133625,83.20544567866361,92.36283634759835,92.94116321963129,93.02215162649539,92.8601748127672,98505,158128.33333333334,48.31916963313623,50.466462032037654,NaN,NaN,NaN,NaN,3.2103864215443947,13.854488011445177,-1052929,0.15096219702026448,-0.17609450726021691,-0.3270567042804814
2022-02-17T09:30:00-05:00,91.86,92.05,88.11,88.18,87.12771370198078,NaN,NaN,NaN,NaN,NaN,93.98619999999991,104.42027562940011,83.55212437059971,89.78233255320386,89.44666666666667,89.44666666666667,89.44666666666667,318151,162292.26666666666,40.241676651432186,49.928450604497144,NaN,NaN,NaN,NaN,3.343930248576938,13.805346553008041,-1371080,-0.22641618600684865,-0.6100769367890422,-0.3836607507821935
2022-02-17T13:30:00-05:00,88.35,88.61,86.98,87.36,NaN,NaN,NaN,97.84649893605649,97.84649893605649,97.84649893605649,93.55639999999993,103.25015779355107,83.86264220644878,89.78233255320386,89.03103719900137,89.78866491486627,88.27340948313648,95749,159051.2,39.08986335105816,49.18736460238547,NaN,NaN,NaN,NaN,3.2215066593928703,14.039892815098712,-1466829,-0.49991325734855896,-1.0085523224678923,-0.5086390651193333
2022-02-18T09:30:00-05:00,85.84,86.08,81.71,82.01,NaN,NaN,NaN,94.26006716623574,NaN,NaN,93.09939999999993,102.77294033226886,83.425859667731,89.78233255320386,83.26666666666667,83.26666666666667,83.26666666666667,579787,172489.96666666667,32.54482023217089,47.54827493844572,NaN,NaN,NaN,NaN,3.3949704694362373,15.352836945828338,-2046616,-0.9819169802875246,-1.736035290478739,-0.7541183101912144
2022-02-18T13:30:00-05:00,82.05,84.03,81.95,82.5,NaN,NaN,NaN,93.16756411322504,NaN,NaN,92.68899999999992,102.3852873307279,82.99271266927194,89.78233255320386,83.0993740249874,83.3129669424252,82.88578110754959,355671,173171.6,33.64073532032364,45.90041981919167,NaN,NaN,NaN,NaN,3.3010440073336484,16.571999352934416,-1690945,-1.1944080572581033,-2.2471283817638437,-1.0527203245057404
2022-02-22T09:30:00-05:00,80.66,83.53,79.88,80.54,NaN,NaN,NaN,91.91767483535116,NaN,NaN,92.2967999999999,102.33459054573484,82.25900945426497,89.78233255320386,81.31666666666666,81.31666666666666,81.31666666666666,404393,170716,31.440374102063515,44.21282515179359,NaN,NaN,NaN,NaN,3.3259694353812455,18.07911784082921,-2095338,-1.3804656744705213,-2.778302417593892,-1.3978367431233707
2022-02-22T13:30:00-05:00,80.53,82.69,79.82,80.75,NaN,NaN,NaN,91.39482597919884,NaN,NaN,91.86039999999991,101.97072419658434,81.75007580341548,89.78233255320386,81.23455149792188,81.34474944651282,81.12435354933095,224545,171810.36666666667,31.953920299740716,42.83555559765593,NaN,NaN,NaN,NaN,3.293400189996871,19.48935622246617,-1870793,-1.3985711724718897,-3.146050708713233,-1.7474795362413431
2022-02-23T09:30:00-05:00,81.51,82.31,79.07,79.07,NaN,NaN,NaN,90.81074298014435,NaN,NaN,91.46179999999991,101.97810938305061,80.94549061694921,89.78233255320386,80.14999999999999,80.14999999999999,80.14999999999999,207878,171383.3,30.016827031398222,41.45206739424725,NaN,NaN,NaN,NaN,3.2895858907113804,20.938947234551637,-2078671,-1.4278861738133402,-3.532337253508018,-2.104451079694678
2022-02-23T13:30:00-05:00,79.1,79.61,77.98,78.02,NaN,NaN,NaN,88.67798193559233,NaN,NaN,91.04199999999992,101.98660451546915,80.09739548453068,86.65809283405046,79.63930577747968,80.3897132823851,78.88889827257425,96280,171684.53333333333,28.840068455834214,40.22562508787828,NaN,NaN,NaN,NaN,3.1710440413748526,22.48734083776344,-2174951,-1.419230764246179,-3.8784895350024016,-2.4592587707562226
2022-02-24T09:30:00-05:00,73.53,79.86,73.35,78.57,NaN,NaN,NaN,86.92648275670176,NaN,NaN,90.60799999999992,101.77323748068176,79.44276251931808,86.65809283405046,77.25999999999999,77.25999999999999,77.25999999999999,301502,175768.96666666667,30.379699143287,39.02420788445951,NaN,NaN,NaN,NaN,3.409540895562363,24.650999855603594,-1873449,-1.281886991501664,-4.061617510133303,-2.779730518631639
2022-02-24T13:30:00-05:00,78.86,83.59,78.86,83.18,NaN,NaN,NaN,86.92648275670176,NaN,NaN,90.3153999999999,101.47714625047678,79.15365374952302,83.66047426724037,78.93901197699572,81.15990310630293,76.7181208476885,172323,180215.46666666667,41.75499373674431,38.745820062800824,NaN,NaN,NaN,NaN,3.524573688736481,25.20675416596438,-1701126,-0.8090622384901387,-3.791058316744312,-2.9819960782541735
2022-02-25T09:30:00-05:00,84.19,85,81.23,84.09,NaN,NaN,NaN,86.92648275670176,NaN,NaN,89.97439999999989,100.83009650275997,79.1187034972398,81.0833794137923,83.44000000000001,83.44000000000001,83.44000000000001,216904,181046.36666666667,43.71015228466289,38.1006739238518,NaN,NaN,NaN,NaN,3.5421041395410175,25.23632989998474,-1484222,-0.38503210087997974,-3.463286204354148,-3.078254103474168
2022-02-25T13:30:00-05:00,84.18,85.38,83.83,85.36,NaN,NaN,NaN,86.92648275670176,NaN,NaN,89.7223999999999,100.40855744596868,79.0362425540311,77.23370353103384,83.90326122615303,84.56784814551911,83.23867430678696,105394,181331.96666666667,46.41364091048993,37.48663805924358,NaN,NaN,NaN,NaN,3.399810986716659,25.131830318533545,-1378828,0.010038081631537299,-3.0657065014347467,-3.075744583066284
2022-02-28T09:30:00-05:00,86.24,90.02,85.29,88.35,77.17548063654243,77.17548063654243,77.17548063654243,NaN,NaN,NaN,89.63159999999989,100.28565865198959,78.97754134801019,80.82192372825675,87.88666666666666,87.88666666666666,87.88666666666666,177751,184802.33333333334,52.230604784956384,37.89832470980702,NaN,NaN,NaN,NaN,3.4948244876654684,23.602102133064776,-1201077,0.4759899964928782,-2.4807570874501863,-2.9567470839430645
2022-02-28T13:30:00-05:00,88.25,89.18,87.22,89.08,77.92954969851777,NaN,NaN,NaN,NaN,NaN,89.58999999999989,100.23610276110605,78.94389723889373,80.8415389826054,88.13292261860994,88.43083751190319,87.83500772531669,121451,186104.26666666666,53.55618602346498,38.27239730911622,NaN,NaN,NaN,NaN,3.3851941671179353,22.18164024655806,-1079626,0.8166304409448517,-1.9359590327619998,-2.7525894737068515
2022-03-01T09:30:00-05:00,89.62,90.73,87.27,88.09,78.72457016676697,NaN,NaN,NaN,NaN,NaN,89.5999999999999,100.23950675548606,78.96049324451373,82.32923118608431,88.69666666666666,88.69666831847903,88.69666501485429,192188,187805.96666666667,51.470208838847284,39.07443532250301,NaN,NaN,NaN,NaN,3.3905374408952262,20.76946676137221,-1271814,0.9492435007223801,-1.5660350978038764,-2.5152785985262565
2022-03-01T13:30:00-05:00,88.02,89.34,87.08,87.8,78.72457016676697,NaN,NaN,NaN,NaN,NaN,89.49619999999987,100.10260552873802,78.88979447126172,82.32923118608431,88.43841394449709,88.74546941448064,88.13135847451353,135951,190252.6,50.845468352394946,39.91412139402706,NaN,NaN,NaN,NaN,3.309784766545568,19.40155905476358,-1407765,0.9870260769418833,-1.2814960023489022,-2.2685220792907854
2022-03-02T09:30:00-05:00,87.75,87.785,84.17,86.41,78.72457016676697,NaN,NaN,NaN,NaN,NaN,89.43499999999987,100.07655872041492,78.79344127958483,82.32923118608431,86.12166666666667,86.12166666666667,86.12166666666667,112918,186296.3,47.847646717291425,41.00718042867853,NaN,NaN,NaN,NaN,3.332657283220884,18.72164909803729,-1520683,0.8909410558771889,-1.1548457594442993,-2.045786815321488
2022-03-02T13:30:00-05:00,86.55,87.19,86.04,86.74,78.72457016676697,NaN,NaN,NaN,NaN,NaN,89.38079999999987,100.04907284240733,78.7125271575924,82.32923118608431,86.32540354744489,86.58519291332833,86.06561418156146,69448,186087,48.622132473728925,42.07728022535034,NaN,NaN,NaN,NaN,3.1767531915622484,18.09030413822002,-1451235,0.8237231007394457,-1.0161329393971812,-1.8398560401366268
2022-03-03T09:30:00-05:00,87.01,87.01,82.1,83.17,78.72457016676697,NaN,NaN,NaN,NaN,NaN,89.18779999999988,99.94896743852817,78.42663256147159,82.32923118608431,84.09333333333335,84.09333333333335,84.09333333333335,93308,183972.7,41.45063749159078,42.792299038888004,NaN,NaN,NaN,NaN,3.3005565350220887,18.475438639958565,-1544543,0.5273558190999235,-1.1806612662617226,-1.708017085361646
2022-03-03T13:30:00-05:00,83.01,83.01,81.22,81.68,78.72457016676697,NaN,NaN,NaN,NaN,NaN,89.07379999999988,100.02818972467357,78.11941027532619,82.32923118608431,83.11355959334766,84.17206309342292,82.0550560932724,79944,184589.96666666667,38.87353067670412,43.28655692295682,NaN,NaN,NaN,NaN,3.2040882110919395,19.02450328372161,-1624487,0.2344370317524178,-1.414970795671124,-1.6494078274235418
2022-03-04T09:30:00-05:00,82.03,82.49,77.87,78.69,NaN,NaN,NaN,90.23829120056475,90.23829120056475,90.23829120056475,88.95619999999988,100.22325206520459,77.68914793479517,82.32923118608431,79.68333333333334,79.68333333333334,79.68333333333334,210043,182891.56666666668,34.26912272462779,43.59029232961607,NaN,NaN,NaN,NaN,3.3052247674425144,20.196598162687426,-1834530,-0.13722584446677755,-1.8209401330070136,-1.683714288540236
2022-03-04T13:30:00-05:00,78.73,79.01,77.06,77.6,NaN,NaN,NaN,87.9020052369027,NaN,NaN,88.82899999999987,100.45663277714067,77.20136722285906,82.32923118608431,78.9082774287496,79.79665906614218,78.01989579135702,159873,182752.8,32.74639150803269,43.869315404773104,NaN,NaN,NaN,NaN,3.208422998339478,21.43098811642945,-1994403,-0.4171944812380226,-2.2052073900877645,-1.7880129088497418
2022-03-07T09:30:00-05:00,78.29,79.42,74.65,75.28,NaN,NaN,NaN,87.10395954431621,NaN,NaN,88.61739999999985,100.82410229669144,76.41069770330826,82.32923118608431,76.45,76.45,76.45,176452,183370.13333333333,29.719429924870454,43.82215331774335,NaN,NaN,NaN,NaN,3.319964212743801,22.988528735408114,-2170855,-0.7025593824533378,-2.666212136916414,-1.9636527544630762
2022-03-07T13:30:00-05:00,75.28,75.87,73.73,73.73,NaN,NaN,NaN,84.7030977468473,NaN,NaN,88.34519999999986,101.24122434241033,75.4491756575894,82.32923118608431,75.49071000362852,76.49307618534337,74.48834382191367,161612,182104.36666666667,27.866118769886782,42.83009082011067,NaN,NaN,NaN,NaN,3.2356810546906725,24.58273831216821,-2332467,-0.9256063819289753,-3.1206607318742954,-2.19505434994532
2022-03-08T09:30:00-05:00,73.36,77.26,71.7,76.32,NaN,NaN,NaN,84.69113875835424,NaN,NaN,88.00599999999986,101.25241355235597,74.75958644764374,81.48938494886745,75.09333333333333,75.09333333333333,75.09333333333333,148525,183930.76666666666,35.14408754870597,42.2182290532566,NaN,NaN,NaN,NaN,3.4017038364984815,26.37473334516789,-2183942,-0.8315864632318859,-3.2345374289851776,-2.4029509657532917
2022-03-08T13:30:00-05:00,75.8,75.92,74.21,74.4,NaN,NaN,NaN,84.69113875835424,NaN,NaN,87.59739999999987,101.23133402360585,73.96346597639388,80.13860636727517,75.00780993175464,75.12641262218034,74.88920724132893,77229,184275.46666666667,32.52430602722367,41.22613370445187,NaN,NaN,NaN,NaN,3.30943927674859,28.038728732953306,-2261171,-0.829686132385052,-3.4400586312346064,-2.6103724988495545
2022-03-09T09:30:00-05:00,77.4,79.82,77.35,79.48,NaN,NaN,NaN,84.69113875835424,NaN,NaN,87.25179999999988,100.81504131762138,73.68855868237837,80.13860636727517,78.88333333333333,78.88333333333333,78.88333333333333,298877,186896.26666666666,44.34547555256832,40.662910187852724,NaN,NaN,NaN,NaN,3.46019361412369,27.970362629115346,-1962294,-0.4370095237853229,-3.156634403581208,-2.719624879795885
2022-03-09T13:30:00-05:00,79.52,79.52,78.43,79.09,NaN,NaN,NaN,84.69113875835424,NaN,NaN,86.89339999999987,100.35293616437171,73.43386383562803,78.91388509382014,78.9283022679176,78.99013879771722,78.86646573811798,158062,189276.56666666668,43.71233135156051,39.95977771128811,NaN,NaN,NaN,NaN,3.2908940702577114,27.906879818408676,-2120356,-0.1680732595547303,-2.9297164542392977,-2.7616431946845674
2022-03-10T09:30:00-05:00,77.08,77.23,74.36,75.29,NaN,NaN,NaN,84.69113875835424,NaN,NaN,86.5575999999999,100.31721892495628,72.79798107504351,75.55810807505611,75.62666666666667,75.62666666666667,75.62666666666667,93887,188153.36666666667,38.016819376337935,38.99882132110888,NaN,NaN,NaN,NaN,3.393687350953589,28.652396639520987,-2214243,-0.20802828995492684,-3.021678557128226,-2.813650267173299
2022-03-10T13:30:00-05:00,75.28,76.51,75.18,76.22,NaN,NaN,NaN,84.69113875835424,NaN,NaN,86.24119999999989,100.20799699286891,72.27440300713087,74.21848646004489,75.78902605216422,75.96044022590894,75.6176118784195,84230,187677.53333333333,40.07471316513515,38.22948166487604,NaN,NaN,NaN,NaN,3.246281111599761,29.344662259125275,-2130013,-0.13716420248461159,-2.9851055202790633,-2.8479413177944517
2022-03-11T09:30:00-05:00,77.03,77.03,72.73,73.35,NaN,NaN,NaN,84.69113875835424,NaN,NaN,85.9503999999999,100.366027608953,71.5347723910468,71.49839868366561,74.36999999999999,74.36999999999999,74.36999999999999,161204,182445.96666666667,36.09229195993927,37.38981346792231,NaN,NaN,NaN,NaN,3.321546746485492,30.416139994094454,-2291217,-0.24275014896288605,-3.151379003998059,-2.908628855035173
2022-03-11T13:30:00-05:00,73.23,73.31,71.53,71.63,NaN,NaN,NaN,82.25398977226591,NaN,NaN,85.65219999999991,100.61324022586682,70.691159774133,71.49839868366561,73.75078246701992,74.7443137715993,72.75725116244054,62618,181341.6,33.916962911694455,36.33944421349128,NaN,NaN,NaN,NaN,3.2142934074508136,31.605214964876232,-2353835,-0.3794529784449101,-3.3829450780913106,-3.0034920996464005
2022-03-14T09:30:00-04:00,70.95,72.25,68.14,68.14,NaN,NaN,NaN,80.14244478261745,NaN,NaN,85.1807999999999,100.81864734034734,69.54295265965247,71.49839868366561,69.50999999999999,69.50999999999999,69.50999999999999,193801,168475.4,29.96987264656235,35.519389581703535,NaN,NaN,NaN,NaN,3.2782724497757556,33.198456862325024,-2547636,-0.640585494011265,-3.804223967160482,-3.163638473149217
2022-03-14T13:30:00-04:00,68.15,68.9,67.9,68.48,NaN,NaN,NaN,78.03165183795304,NaN,NaN,84.70819999999992,100.89835438592235,68.5180456140775,71.49839868366561,69.14707115937802,69.65839841986683,68.6357438988892,97634,159874.16666666666,30.81459264793841,34.943751151077414,NaN,NaN,NaN,NaN,3.115538703363202,34.710045390300365,-2450002,-0.7201374519050345,-4.06381028803051,-3.3436728361254753
2022-03-15T09:30:00-04:00,68.96,71.44,67.95,69.67,NaN,NaN,NaN,78.03165183795304,NaN,NaN,84.23119999999992,100.75666381315831,67.70573618684152,71.49839868366561,69.68666666666667,69.68666666666667,69.68666666666667,242436,154475.6,33.82333809292376,34.91190939166998,NaN,NaN,NaN,NaN,3.1422859388372584,35.009366213306166,-2207566,-0.6258216357966964,-4.125949880871346,-3.5001282450746496
2022-03-15T13:30:00-04:00,69.67,71.62,69.61,71.39,NaN,NaN,NaN,78.03165183795304,NaN,NaN,83.8117999999999,100.5537500369583,67.0698499630415,71.49839868366561,70.05447618397034,70.60327801783016,69.50567435011051,108896,150620.63333333333,38.01895662590981,35.288521185804065,NaN,NaN,NaN,NaN,3.0614083717774543,35.212046039693575,-2098670,-0.3922233223302207,-3.9904073979874255,-3.5981840756572048
2022-03-16T09:30:00-04:00,73.6,77.53,73.39,76.02,NaN,NaN,NaN,78.03165183795304,NaN,NaN,83.48459999999992,100.18335741964054,66.78584258035929,71.49839868366561,75.64666666666666,75.64666666666666,75.64666666666666,191249,150066.33333333334,47.64198074782263,36.5687033874435,NaN,NaN,NaN,NaN,3.2813077737933507,33.31783393375593,-1907421,0.10303231053474349,-3.4693936874887754,-3.572425998023519
2022-03-16T13:30:00-04:00,76.03,78.32,73.74,78.31,65.94631629031085,65.94631629031085,65.94631629031085,NaN,NaN,NaN,83.18439999999991,99.70382282768996,66.66497717230986,69.17943258399983,76.34849981188674,76.90515003028193,75.79184959349155,304020,156991,51.641133383185,38.2669187169648,NaN,NaN,NaN,NaN,3.3740715042366825,31.32953429245791,-1603401,0.5867593985977919,-2.838976749776279,-3.425736148374071
2022-03-17T09:30:00-04:00,77.43,81.24,76.68,81.12,68.712847368024,NaN,NaN,NaN,NaN,NaN,82.8673999999999,98.91815988730768,66.81664011269213,71.64754606719987,79.68,79.68,79.68,168452,152556,56.074716603331034,39.76196364943802,NaN,NaN,NaN,NaN,3.4587806825054903,29.493026141497165,-1434949,1.0697506866731943,-2.088547790032578,-3.1582984767057725
2022-03-17T13:30:00-04:00,81.16,82.23,81,82.14,71.66589976038655,NaN,NaN,NaN,NaN,NaN,82.55479999999993,98.03095416826767,67.07864583173219,73.9410368537599,80.56234296530144,81.60311890101875,79.52156702958413,121070,150847.56666666668,57.59449249634776,41.55269125437546,NaN,NaN,NaN,NaN,3.2995820623265266,28.037139714728333,-1313879,1.410289791708128,-1.3954362370706122,-2.80572602877874
2022-03-18T09:30:00-04:00,81.72,86,81.29,85.78,73.50585886218717,NaN,NaN,NaN,NaN,NaN,82.33119999999991,97.28254543243516,67.37985456756466,77.01382948300792,84.35666666666667,84.35666666666667,84.35666666666667,111262,147326.16666666666,62.57134829232488,42.854539307215205,NaN,NaN,NaN,NaN,3.4003262007317745,27.540572997206432,-1202617,1.807678949065238,-0.5461273424471926,-2.3538062915124307
2022-03-18T13:30:00-04:00,85.785,86.24,84.97,86.17,75.75354709572409,NaN,NaN,NaN,NaN,NaN,82.1541999999999,96.70465956112756,67.60374043887225,78.41606358640634,84.96431465903237,85.67406921736385,84.25456010070089,81552,146531.43333333332,63.07143252277625,44.23733224801634,NaN,NaN,NaN,NaN,3.2481600435366476,27.129933018318397,-1121065,2.0083413481780807,0.15662039371017045,-1.8517209544679103
2022-03-21T09:30:00-04:00,84.91,86.14,82.13,82.93,75.75354709572409,NaN,NaN,NaN,NaN,NaN,81.9317999999999,96.08260814088058,67.78099185911921,78.41606358640634,83.73333333333333,83.73333333333333,83.73333333333333,127273,144848.83333333334,56.337044676424945,45.545919769451125,NaN,NaN,NaN,NaN,3.3047200404268873,25.85785806442565,-1248338,1.8389446360773511,0.4469598406287787,-1.3919847954485725
2022-03-21T13:30:00-04:00,82.97,84.11,82.86,83.94,75.75354709572409,NaN,NaN,NaN,NaN,NaN,81.7661999999999,95.62226517883084,67.91013482116895,78.41606358640634,83.70851688547312,83.7507432659554,83.66629050499083,43959,142265.76666666666,57.847976619749176,46.815438587637836,NaN,NaN,NaN,NaN,3.1579543232535383,24.67664560723952,-1204379,1.7135158422866146,0.7499100074096958,-0.9636058348769188
2022-03-22T09:30:00-04:00,84.17,88.54,84.09,87.53,76.45484547835282,NaN,NaN,NaN,NaN,NaN,81.6611999999999,95.2589884319477,68.06341156805209,80.44134455624004,86.71999999999998,86.71999999999998,86.71999999999998,143479,140642.13333333333,62.7784035793929,48.72158941759881,NaN,NaN,NaN,NaN,3.260957585878286,24.592091030593924,-1060900,1.782964595960598,1.265099910073829,-0.5178646858867691
2022-03-22T13:30:00-04:00,87.57,88.83,87.39,87.92,78.50167068388224,NaN,NaN,NaN,NaN,NaN,81.57999999999988,94.97735317142963,68.18264682857014,81.63107564499202,87.14441989142318,87.7632344665459,86.52560531630047,67493,138360.2,63.28087717235389,50.81901186478877,NaN,NaN,NaN,NaN,3.13088918688698,24.573130990739788,-993407,1.7626379413664084,1.6854327408212413,-0.07720520054516705
2022-03-23T09:30:00-04:00,86.47,89.77,85.47,87.41,78.50167068388224,NaN,NaN,NaN,NaN,NaN,81.4205999999999,94.33846942804466,68.50273057195513,81.86086051599362,87.54999999999998,87.55000190734862,87.54999809265135,109621,138250.3,62.10027914927554,53.11404090069686,NaN,NaN,NaN,NaN,3.2143971021093383,23.915246148624206,-1103028,1.625654051081166,1.9548623633062903,0.3292083122251244
2022-03-23T13:30:00-04:00,87.56,87.71,86.55,86.77,78.50167068388224,NaN,NaN,NaN,NaN,NaN,81.22399999999989,93.49481480587224,68.95318519412754,81.86086051599362,87.40958512778279,87.64645575630973,87.17271449925585,38521,137219.4,60.5730524703552,55.23964517372662,NaN,NaN,NaN,NaN,3.067654451958671,23.30435308094545,-1141549,1.4107310966601823,2.092622183050352,0.6818910863901699
2022-03-24T09:30:00-04:00,87.52,87.66,84.42,87.45,78.50167068388224,NaN,NaN,NaN,NaN,NaN,81.1277999999999,93.12336003861463,69.13223996138515,81.86086051599362,86.50999999999999,86.50999999999999,86.50999999999999,79822,136769.86666666667,61.65215940924915,57.22741812489273,NaN,NaN,NaN,NaN,3.0799648482473367,22.03758849053887,-1061727,1.2392480378920567,2.230951133755241,0.9917030958631841
2022-03-24T13:30:00-04:00,87.49,87.89,86.94,87.89,78.50167068388224,NaN,NaN,NaN,NaN,NaN,81.02179999999989,92.6779988246604,69.36560117533936,81.86086051599362,86.90586407471774,87.41989432719737,86.39183382223811,47341,135683.1,62.3698475261149,58.96676747490738,NaN,NaN,NaN,NaN,2.927824501943956,20.927240367165588,-1014386,1.0858409531827555,2.3490042873416286,1.263163334158873
2022-03-25T09:30:00-04:00,88.08,88.31,84.07,84.65,78.50167068388224,NaN,NaN,NaN,NaN,NaN,80.95119999999989,92.47512963532905,69.42727036467072,81.86086051599362,85.67666666666666,85.67666666666666,85.67666666666666,110938,132379.6,54.30959863687401,59.4430258955539,NaN,NaN,NaN,NaN,3.021551323233674,19.851856345467446,-1125324,0.7144815376730225,2.156265256250151,1.4417837185771287
2022-03-25T13:30:00-04:00,84.69,85.49,84.41,85.28,78.50167068388224,NaN,NaN,NaN,NaN,NaN,80.90959999999988,92.35544183710479,69.46375816289498,81.86086051599362,85.51067930635432,85.78418811500318,85.23717049770546,40859,128412.46666666666,55.51347658666932,59.719621838659926,NaN,NaN,NaN,NaN,2.8828690858598405,18.853285468176313,-1084465,0.47132700888449697,2.03094247968275,1.559615470798253
2022-03-28T09:30:00-04:00,86.84,89.03,86.01,87.77,78.50167068388224,NaN,NaN,NaN,NaN,NaN,81.02479999999987,92.62749571435997,69.42210428563978,82.19606013910463,87.60333333333334,87.60333333333334,87.60333333333334,78548,125149,59.99954506458328,59.99996672874937,NaN,NaN,NaN,NaN,2.9448070082984232,18.164337181708156,-1005917,0.43890198665228275,2.1082429541136065,1.6693409674613238
2022-03-28T13:30:00-04:00,87.96,89.38,87.85,89.16,79.64706919328164,NaN,NaN,NaN,NaN,NaN,81.15799999999989,92.97629090858801,69.33970909141176,83.1078481112837,87.97636748696048,88.52953980208743,87.42319517183354,35720,120952.6,62.28588840817471,60.33506643673701,NaN,NaN,NaN,NaN,2.8494636505628215,17.621482828729505,-970197,0.4690581332580903,2.2556636340339367,1.7866055007758463
2022-03-29T09:30:00-04:00,90.72,93.54,89.79,93.11,82.50742968449612,NaN,NaN,NaN,NaN,NaN,81.40939999999988,93.69014356706538,69.12865643293438,86.33227848902696,92.14666666666666,92.14666666666666,92.14666666666666,119061,119970.46666666666,67.90074260147085,60.71573745881887,NaN,NaN,NaN,NaN,2.958787675522621,18.14288828547614,-851136,0.6991622500639232,2.66055831335575,1.961396063291827
2022-03-29T13:30:00-04:00,93.17,94.67,93.1,93.94,84.92959197156446,NaN,NaN,NaN,NaN,NaN,81.67319999999988,94.4428824956621,68.90351750433766,88.11882279122156,92.71594303113568,93.53810678273288,91.89377927953848,57082,119298.9,68.94691913804138,61.13541507419495,NaN,NaN,NaN,NaN,2.8595885558424343,18.867584426684918,-794054,0.8418227996182526,3.013674562814643,2.1718517631963903
2022-03-30T09:30:00-04:00,92.53,94.15,91.6,92.39,84.92959197156446,NaN,NaN,NaN,NaN,NaN,81.93959999999988,95.03260451997232,68.84659548002745,88.11882279122156,92.71333333333332,92.71333333333332,92.71333333333332,82757,112094.9,64.70569902124797,61.73317609882516,NaN,NaN,NaN,NaN,2.837475087567976,18.988369935618596,-876811,0.768392189210132,3.1323419997090554,2.3639498104989234
2022-03-30T13:30:00-04:00,92.46,92.49,89.93,90.59,84.92959197156446,NaN,NaN,NaN,NaN,NaN,82.19099999999987,95.45490787060965,68.9270921293901,88.11882279122156,91.93622764688563,92.78767199381235,91.0847832999589,68937,109124.06666666667,60.083420736054066,61.89285067856123,NaN,NaN,NaN,NaN,2.8176554384559767,18.520324230163183,-945748,0.5456634428715343,3.0460291140883413,2.500365671216807
2022-03-31T09:30:00-04:00,90.05,90.37,87.6,87.95,84.92959197156446,NaN,NaN,NaN,NaN,NaN,82.37859999999988,95.6975651309709,69.05963486902886,88.11882279122156,88.64,88.64,88.64,116094,109864.3,53.99148979144173,61.265213979421866,NaN,NaN,NaN,NaN,2.8299657642805505,17.347414442489807,-1061842,0.18618281127260605,2.7330941853075643,2.5469113740349583
2022-03-31T13:30:00-04:00,87.99,88.76,87.13,87.13,84.92959197156446,NaN,NaN,NaN,NaN,NaN,82.45759999999987,95.84134211347573,69.07385788652401,88.11882279122156,88.28239676104572,88.74909050910473,87.8157030129867,68163,109328.73333333334,52.22042151801534,60.47518143268339,NaN,NaN,NaN,NaN,2.744253923974797,16.115496725018485,-1130005,-0.12444288410086646,2.3913577689088754,2.515800653009742
2022-04-01T09:30:00-04:00,87.66,89.34,86.66,87.05,84.92959197156446,NaN,NaN,NaN,NaN,NaN,82.51679999999988,95.95497573333624,69.07862426666351,88.11882279122156,87.68333333333334,87.68333333333334,87.68333333333334,117185,107861.43333333333,52.041065073389525,59.75666614154868,NaN,NaN,NaN,NaN,2.7396643579765976,15.152535089186584,-1247190,-0.3406550379593858,2.0899818555605094,2.430636893519895
2022-04-01T13:30:00-04:00,87.01,87.95,87.01,87.95,84.92959197156446,NaN,NaN,NaN,NaN,NaN,82.56859999999986,96.07003341130982,69.0671665886899,88.11882279122156,87.66952749502258,87.69082705563378,87.64822793441138,49233,107415.26666666666,53.95698592835679,59.28408995997736,NaN,NaN,NaN,NaN,2.611116903835412,14.258356427342674,-1197957,-0.4230386824314274,1.901838540480611,2.3248772229120385
2022-04-04T09:30:00-04:00,89.24,92.66,88.81,92.49,84.92959197156446,NaN,NaN,NaN,NaN,NaN,82.65139999999987,96.3430780622427,68.95972193775704,88.11882279122156,91.32,91.32,91.32,160173,106294.33333333333,62.16751169505253,59.320900837534744,NaN,NaN,NaN,NaN,2.761037124990025,14.768887963469298,-1037784,-0.18396203610787065,2.0949246777772004,2.278886713885071
2022-04-04T13:30:00-04:00,92.46,92.72,91.73,92.47,84.92959197156446,NaN,NaN,NaN,NaN,NaN,82.71919999999987,96.57018918633955,68.8682108136602,88.11882279122156,91.55993233729293,91.98321204739202,91.13665262719385,51465,104755.36666666667,62.11496295840325,59.30269479698392,NaN,NaN,NaN,NaN,2.6345344732050227,15.257762047178991,-1089249,-0.04652236040661739,2.220733763376799,2.2672561237834166
2022-04-05T09:30:00-04:00,92.44,92.57,87.78,88.73,84.92959197156446,NaN,NaN,NaN,NaN,NaN,82.73199999999989,96.6039855824639,68.86001441753587,88.11882279122156,89.69333333333333,89.69333333333333,89.69333333333333,212450,103755.83333333333,53.07947336784677,59.21482870633911,NaN,NaN,NaN,NaN,2.7884962965475206,14.343076066640853,-1301699,-0.21728725929651027,1.9956470496627787,2.212934308959289
2022-04-05T13:30:00-04:00,88.69,89.09,87.8,88.18,84.92959197156446,NaN,NaN,NaN,NaN,NaN,82.73959999999988,96.62309521410552,68.85610478589425,87.63405823297725,89.2526785346173,89.88103506503646,88.62432200419815,104482,103608.7,51.884202389595444,58.95559483511955,NaN,NaN,NaN,NaN,2.6814608467941268,13.493724798998299,-1406181,-0.3682034472548805,1.7526799998906881,2.1208834471455686
2022-04-06T09:30:00-04:00,85.82,86.21,81.91,82.56,NaN,NaN,NaN,92.96473409269105,92.96473409269105,92.96473409269105,82.66259999999987,96.50646351276609,68.81873648723365,86.82837804914047,83.56,83.56,83.56,161471,102616.1,41.58060495206586,57.63995625565402,NaN,NaN,NaN,NaN,2.9377850720231184,13.92173246972572,-1567652,-0.8214839172042239,1.0940285506402887,1.9155124678445126
2022-04-06T13:30:00-04:00,82.53,84.52,81.85,83.57,NaN,NaN,NaN,92.0490643612051,NaN,NaN,82.59919999999987,96.3967480952268,68.80165190477294,86.82837804914047,83.44681293859796,83.56972821135928,83.32389766583664,136923,97046.2,43.74283223671513,56.31545224340692,NaN,NaN,NaN,NaN,2.9186575668786103,14.332646046020711,-1430729,-1.0155353109632,0.6460933291405127,1.6616286401037126
2022-04-07T09:30:00-04:00,83.53,85.14,80.05,82.01,NaN,NaN,NaN,91.75024325387758,NaN,NaN,82.57599999999988,96.37353195321863,68.77846804678113,86.82837804914047,82.39999999999999,82.39999999999999,82.39999999999999,69424,93745.26666666666,41.205995013545014,54.408684558555066,NaN,NaN,NaN,NaN,3.0737534549587098,15.118050457522372,-1500153,-1.1986312327682853,0.16333959914335594,1.3619708319116413
2022-04-07T13:30:00-04:00,82.24,83.5,81.35,82.71,NaN,NaN,NaN,91.45727765142861,NaN,NaN,82.59659999999987,96.39179487938098,68.80140512061875,86.82837804914047,82.44247170935078,82.49985427663587,82.3850891420657,38032,90977.33333333333,42.80877254289994,52.54167408747354,NaN,NaN,NaN,NaN,3.0077710653188023,15.847354553916773,-1462121,-1.2183024429571732,-0.16090722178482508,1.057395221172348
2022-04-08T09:30:00-04:00,81.62,82.24,80.07,80.89,NaN,NaN,NaN,90.13671957636367,NaN,NaN,82.64059999999986,96.39966008999532,68.8815399100044,86.82837804914047,81.06666666666666,81.06666666666666,81.06666666666666,105982,90801.33333333333,39.772887299869545,50.76075896451793,NaN,NaN,NaN,NaN,2.981501703510317,16.81719298053615,-1568103,-1.2925547677403462,-0.5582982385030846,0.7342565292372616
2022-04-08T13:30:00-04:00,80.85,81.14,80.16,80.2,NaN,NaN,NaN,89.35709595925624,NaN,NaN,82.69259999999986,96.39460091081973,68.99059908917998,86.82837804914047,80.90699416964284,81.16191724694198,80.6520710923437,41579,89468.9,38.65369183488409,49.23006404300578,NaN,NaN,NaN,NaN,2.8385372961167232,17.717757233825566,-1609682,-1.322065094291444,-0.9183248386270435,0.4037402556644005
2022-04-11T09:30:00-04:00,78.49,80.31,77.18,79.67,NaN,NaN,NaN,87.48313705201733,NaN,NaN,82.78039999999986,96.3468715884457,69.21392841155402,86.82837804914047,79.05333333333334,79.05333333333334,79.05333333333334,165689,90749.43333333333,37.774410251265216,48.07170121870746,NaN,NaN,NaN,NaN,2.859356060679814,19.204411855927013,-1775371,-1.3087609430789127,-1.2322109231842404,0.0765500198946723
2022-04-11T13:30:00-04:00,79.8,80.23,79.04,79.18,NaN,NaN,NaN,87.48313705201733,NaN,NaN,82.88939999999984,96.24926072382942,69.52953927617025,85.46170243931238,79.18598572935012,79.38459054328874,78.9873809154115,73917,91748.03333333334,36.93781933683489,46.98008677719457,NaN,NaN,NaN,NaN,2.740116342059827,20.584876862164073,-1849288,-1.263783294771955,-1.5031790985702713,-0.23939580379831643
2022-04-12T09:30:00-04:00,80.95,83.04,79.97,80.03,NaN,NaN,NaN,87.48313705201733,NaN,NaN,82.96359999999986,96.21748200340205,69.70971799659766,82.7583619514499,81.01333333333334,81.01333333333334,81.01333333333334,184657,93120.63333333333,39.44326745531607,46.08024409018933,NaN,NaN,NaN,NaN,2.8201080319126963,20.643182493594246,-1664631,-1.1129150274685689,-1.6305395881340274,-0.5176245606654586
2022-04-12T13:30:00-04:00,80.01,80.18,78.16,78.33,NaN,NaN,NaN,87.48313705201733,NaN,NaN,83.04219999999985,96.13767542627271,69.946724573727,78.00968956115992,80.41998748710665,81.37277902792323,79.46719594629008,71612,93257.93333333333,36.33409074975252,44.821465863146166,NaN,NaN,NaN,NaN,2.762957458204647,21.14084002159297,-1736243,-1.0637838197583236,-1.847354335363363,-0.7835705156050394
2022-04-13T09:30:00-04:00,78.26,81.39,77.57,81.22,NaN,NaN,NaN,87.48313705201733,NaN,NaN,83.07699999999983,96.14364164964073,70.01035835035893,76.62475164892793,80.05999999999999,80.05999999999999,80.05999999999999,85999,92470.53333333334,44.36321456411488,43.549730353793485,NaN,NaN,NaN,NaN,2.8384604969043155,21.11244040084918,-1650244,-0.7856473136906823,-1.7656296577183923,-0.97998234402771
2022-04-13T13:30:00-04:00,81.2,81.43,80.47,81.11,NaN,NaN,NaN,87.48313705201733,NaN,NaN,83.11739999999983,96.14692144018035,70.08787855981932,76.27880131914235,80.41019630924005,80.86595325840452,79.95443936007558,50775,92879,44.135062458882736,42.26545174668487,NaN,NaN,NaN,NaN,2.704284747125436,21.069578099191386,-1701019,-0.5682174407343332,-1.6902541449456265,-1.1220367042112933
2022-04-14T09:30:00-04:00,80.74,80.93,77.99,78.16,NaN,NaN,NaN,87.48313705201733,NaN,NaN,83.17479999999985,96.09067627070306,70.25892372929664,76.16568193300526,79.02666666666667,79.02666666666667,79.02666666666667,87547,93136.5,38.4274205246239,41.218876543597524,NaN,NaN,NaN,NaN,2.7339786937593336,21.67258845875899,-1788566,-0.5801824253115826,-1.8472647358507714,-1.2670823105391888
2022-04-14T13:30:00-04:00,78.2,78.61,77.67,77.76,NaN,NaN,NaN,86.32469811802962,NaN,NaN,83.20559999999985,96.06219871661676,70.34900128338293,76.16568193300526,78.71862970353705,79.18473843761504,78.25252096945906,38236,92833,37.715203921793794,40.20680522446884,NaN,NaN,NaN,NaN,2.6058373584908097,22.310510443667674,-1826802,-0.5712430423700812,-1.9811361135017904,-1.4098930711317093
2022-04-18T09:30:00-04:00,77.22,77.51,74.78,75.75,NaN,NaN,NaN,84.36403002175555,NaN,NaN,83.25359999999984,95.9799177769583,70.52728222304137,76.16568193300526,76.01333333333334,76.01333333333334,76.01333333333334,106582,92687.8,34.27726776825344,39.685138282767944,NaN,NaN,NaN,NaN,2.632563261455752,23.551825368528853,-1933384,-0.6511142843804432,-2.2237859266072633,-1.57267164222682
2022-04-18T13:30:00-04:00,75.76,77.35,75.76,76.55,NaN,NaN,NaN,84.36403002175555,NaN,NaN,83.35199999999985,95.790120758383,70.9138792416167,76.16568193300526,76.21153771844392,76.4718171638127,75.95125827307514,61806,93386.03333333334,36.74859435360847,39.18554986254604,NaN,NaN,NaN,NaN,2.5588087427803403,24.704474941614237,-1871578,-0.6016516665871583,-2.324736225460768,-1.7230845588736097
2022-04-19T09:30:00-04:00,76.21,80.42,76.09,79.87,NaN,NaN,NaN,84.36403002175555,NaN,NaN,83.58659999999985,95.2889181361691,71.8842818638306,76.16568193300526,78.79333333333334,78.79333428700765,78.79333237965902,102173,94173.53333333334,45.84887516646958,39.5171841591835,NaN,NaN,NaN,NaN,2.6853224040103156,24.388964469392878,-1769405,-0.3115262045697129,-2.112492314585751,-1.800966110016038
2022-04-19T13:30:00-04:00,79.97,80.09,79.42,79.73,NaN,NaN,NaN,84.36403002175555,NaN,NaN,83.81159999999986,94.75120098724372,72.87199901275599,76.16568193300526,79.11233830003387,79.56217593682571,78.66250066324203,51383,94695.63333333333,45.55125687952217,39.71307589751366,NaN,NaN,NaN,NaN,2.5413708037238645,24.095990459473047,-1820788,-0.10586587590882734,-1.9332984549020722,-1.8274325789932448
2022-04-20T09:30:00-04:00,79.27,79.28,75.34,76.35,NaN,NaN,NaN,84.36403002175555,NaN,NaN,83.94519999999984,94.34032981352888,73.5500701864708,75.25594914969868,76.99,76.99,76.99,237597,98646.83333333333,38.97355355930127,39.655980630330205,NaN,NaN,NaN,NaN,2.6734157463150168,24.827912047087693,-2058385,-0.17045565176383204,-2.040502143698035,-1.8700464919342028
2022-04-20T13:30:00-04:00,76.31,76.65,75.12,75.15,NaN,NaN,NaN,83.95632541688693,NaN,NaN,84.02039999999984,94.10077218361116,73.94002781638852,75.25594914969868,76.55337662596531,77.18488401641773,75.9218692355129,113579,100530.06666666667,36.93438103491545,39.533172716046735,NaN,NaN,NaN,NaN,2.5917431930068013,25.555086780718216,-2171964,-0.26153604470245084,-2.1969665478122664,-1.9354305031098156
2022-04-21T09:30:00-04:00,77.01,78.13,72.5,73.48,NaN,NaN,NaN,83.78717426157388,NaN,NaN,83.96959999999984,94.23464122544677,73.70455877455292,75.25594914969868,74.70333333333333,74.70333333333333,74.70333333333333,155067,102940.4,34.248737087903066,39.28133891866373,NaN,NaN,NaN,NaN,2.808761536363458,26.76434642209146,-2327031,-0.3938438669646174,-2.427735336815587,-2.03389146985097
2022-04-21T13:30:00-04:00,73.35,73.45,71.24,71.88,NaN,NaN,NaN,80.73752997695689,NaN,NaN,83.84099999999984,94.53843464575154,73.14356535424814,74.43075931975895,73.44820019628352,74.70486592725504,72.191534465312,154689,105798.8,31.8585504394552,38.91853399742232,NaN,NaN,NaN,NaN,2.7681357123374974,28.118228811371832,-2481720,-0.539691562240979,-2.7085059226521935,-2.1688143604112144
2022-04-22T09:30:00-04:00,71.82,73.51,69.65,69.79,NaN,NaN,NaN,80.11741497800432,NaN,NaN,83.61439999999985,94.99121231980709,72.2375876801926,74.42593681389862,70.98333333333335,70.98333333333335,70.98333333333335,131349,106307.3,29.010465490858437,38.17333385710391,NaN,NaN,NaN,NaN,2.846126018599105,29.65064340653815,-2613069,-0.7164207994553666,-3.064340359730423,-2.347919560275056
2022-04-22T13:30:00-04:00,69.86,70.99,69.67,70.16,NaN,NaN,NaN,78.65935066082228,NaN,NaN,83.37479999999984,95.35436542784933,71.39523457215034,74.42593681389862,70.72786801642849,71.06862870498108,70.3871073278759,73823,106495.96666666666,30.200122341566754,37.73519325651922,NaN,NaN,NaN,NaN,2.7371170172705965,31.073599816335456,-2539246,-0.7446172293251858,-3.2786910969315386,-2.534073867606353
2022-04-25T09:30:00-04:00,69.2,72.14,69.2,71.69,NaN,NaN,NaN,78.65935066082228,NaN,NaN,83.09299999999985,95.48865682003662,70.69734317996307,74.42593681389862,71.01,71.01,71.01,241938,110654.4,35.04740430355463,37.06977823790777,NaN,NaN,NaN,NaN,2.751608658894125,31.794491513455274,-2297308,-0.6025124463492144,-3.287214425542871,-2.6847019791936564
2022-04-25T13:30:00-04:00,71.71,72.69,71.18,72.37,NaN,NaN,NaN,78.65935066082228,NaN,NaN,82.81699999999984,95.5366221642046,70.09737783579507,74.42593681389862,71.31502952040425,71.79808084119037,70.83197819961813,96472,112229.03333333334,37.136900463832475,36.5699095239756,NaN,NaN,NaN,NaN,2.6629223261159725,32.180232488918875,-2200836,-0.41398729648894195,-3.202186099804834,-2.788198803315892
2022-04-26T09:30:00-04:00,71.67,71.9,68,68.17,NaN,NaN,NaN,78.35212588935718,NaN,NaN,82.52179999999984,95.88600454198917,69.15759545801052,74.42593681389862,69.35666666666667,69.35666666666667,69.35666666666667,141083,111592.7,30.59106947999193,36.01017016364475,NaN,NaN,NaN,NaN,2.7848564456791176,33.207090025167936,-2341919,-0.5167361984967225,-3.434119051436795,-2.9173828529400727
2022-04-26T13:30:00-04:00,68.11,69.38,67.79,67.79,NaN,NaN,NaN,76.82202925802277,NaN,NaN,82.19879999999985,96.1768477263499,68.2207522736498,72.55374945111889,68.96963996257044,69.47106594271395,68.46821398242693,84051,112678.9,30.074561042196393,35.46440995795922,NaN,NaN,NaN,NaN,2.699509556702037,34.200642135088266,-2425970,-0.551702543966706,-3.6070110328984555,-3.0553084889317494
2022-04-27T09:30:00-04:00,66.99,69.15,66.2,67.2,NaN,NaN,NaN,75.93989156447628,NaN,NaN,81.79219999999985,96.2990228306585,67.2853771693412,70.50399956089511,67.51666666666667,67.51666666666667,67.51666666666667,288415,115211.06666666667,29.248819376178645,35.10523507281102,NaN,NaN,NaN,NaN,2.71740173122332,35.420840075975164,-2714385,-0.5544953702625159,-3.748427701759894,-3.193932331497378
2022-04-27T13:30:00-04:00,67.3,67.62,66.08,66.16,NaN,NaN,NaN,74.94921467518189,NaN,NaN,81.35699999999984,96.39812934590087,66.31587065409882,70.39819964871609,67.29624801048755,67.68232789563329,66.9101681253418,94007,114861.9,27.79986852303537,34.466040370627226,NaN,NaN,NaN,NaN,2.633301607564512,36.576022619974424,-2808392,-0.5644301950814801,-3.899470075349228,-3.335039880267748
2022-04-28T09:30:00-04:00,65.5,66.19,62.66,66,NaN,NaN,NaN,72.63743218994635,NaN,NaN,80.92879999999984,96.46707668179845,65.39052331820123,66.3561316608913,64.95,64.95,64.95,347408,121059.8,27.57355556952207,33.16066039941669,NaN,NaN,NaN,NaN,2.6973514927384756,38.21361793577561,-3155800,-0.5208746915310902,-3.9861332446816107,-3.4652585531505204
2022-04-28T13:30:00-04:00,65.93,67.35,65.75,66.59,NaN,NaN,NaN,72.63743218994635,NaN,NaN,80.52519999999984,96.47841271218172,64.57198728781796,66.3561316608913,65.45564470663413,66.20404091900318,64.70724849426509,158587,121781.93333333333,29.841658182089887,32.03854620674296,NaN,NaN,NaN,NaN,2.6189692432571556,39.09259601519765,-2997213,-0.39702531125947127,-3.9615401922248594,-3.564514880965388
2022-04-29T09:30:00-04:00,66.14,69.02,65.83,66.13,NaN,NaN,NaN,72.63743218994635,NaN,NaN,80.09879999999984,96.42421706175122,63.77338293824845,66.3561316608913,66.99333333333333,66.99333333333333,66.99333333333333,267373,128380.23333333334,29.07710585507442,31.331657085012466,NaN,NaN,NaN,NaN,2.659757154453073,39.045398740141685,-3264586,-0.2954453197893274,-3.9338215307020477,-3.6383762109127202
2022-04-29T13:30:00-04:00,66.28,66.39,63.99,64.09,NaN,NaN,NaN,72.63743218994635,NaN,NaN,79.62279999999984,96.39358557015495,62.852014429844736,66.3561316608913,65.90806759934215,66.99306756680085,64.82306763188345,267504,136029.3,25.907099875108187,30.543994145026232,NaN,NaN,NaN,NaN,2.641203071992139,39.38415958631012,-3532090,-0.31330686998170787,-4.030009798389855,-3.7167029284081474
2022-05-02T09:30:00-04:00,63.72,66.76,63.21,65.35,NaN,NaN,NaN,72.63743218994635,NaN,NaN,79.23679999999985,96.41057276663796,62.06302723336174,66.3561316608913,65.10666666666667,65.10666666666667,65.10666666666667,391888,145559.5,30.91674279359914,30.305994552575953,NaN,NaN,NaN,NaN,2.706117138278415,39.85209637639912,-3140202,-0.19378335221462573,-3.9589321186764295,-3.7651487664618037
2022-05-02T13:30:00-04:00,65.31,67.48,64.66,67.46,NaN,NaN,NaN,72.63743218994635,NaN,NaN,78.88039999999984,96.27592262394326,61.48487737605642,64.64790532871304,65.5061656249732,66.1467531908025,64.86557805914391,152418,149254.13333333333,38.42487748472474,30.775017912952347,NaN,NaN,NaN,NaN,2.7142516284013856,39.905264497692905,-2987784,0.060271529956842596,-3.6898093540157504,-3.750080883972593
2022-05-03T09:30:00-04:00,66.61,68.89,66.35,67.22,NaN,NaN,NaN,72.63743218994635,NaN,NaN,78.46939999999984,95.9760763995946,60.96272360040508,62.783324262970424,67.48666666666666,67.48666666666666,67.48666666666666,213395,150844.33333333334,37.920051573143375,31.411416918829843,NaN,NaN,NaN,NaN,2.701805083515573,39.235309623620054,-3201179,0.23522120732217733,-3.456054374819871,-3.6912755821420484
2022-05-03T13:30:00-04:00,67.27,67.85,66.29,66.87,NaN,NaN,NaN,72.63743218994635,NaN,NaN,78.02359999999983,95.5538407330911,60.493359266908556,62.49540129449015,67.2877995754465,67.52564611025308,67.04995304063992,149182,153353.16666666666,37.15344987143974,31.90808317096363,NaN,NaN,NaN,NaN,2.620247577550174,38.62944423871696,-3350361,0.34386206392758334,-3.2614480022325694,-3.6053100661601527
2022-05-04T09:30:00-04:00,66.79,66.79,64.05,66.3,NaN,NaN,NaN,72.63743218994635,NaN,NaN,77.48739999999984,94.77747706634412,60.19732293365555,62.49540129449015,65.71333333333332,65.71333333333332,65.71333333333332,251735,155589.1,35.88123706784529,31.967642654127246,NaN,NaN,NaN,NaN,2.634515607725162,38.64183966906004,-3602096,0.3904230858325226,-3.1172812088694997,-3.5077042947020223
2022-05-04T13:30:00-04:00,66.27,70.28,64.42,70.05,NaN,NaN,NaN,72.63743218994635,NaN,NaN,77.00959999999982,93.76679974697828,60.252400253021364,62.49540129449015,67.24035398948351,68.4820263752031,65.99868160376391,380732,165893.1,48.39976796968957,32.77213319025989,NaN,NaN,NaN,NaN,2.8649073500305073,37.03515326278275,-3221364,0.6704353188319936,-2.6696601461620304,-3.340095464994024
2022-05-05T09:30:00-04:00,68.13,68.17,63.53,64.32,NaN,NaN,NaN,72.63743218994635,NaN,NaN,76.44819999999983,92.98605364066697,59.91034635933269,62.49540129449015,65.33999999999999,65.33999999999999,65.33999999999999,155594,168212.93333333332,36.63112217691108,33.203565525754115,NaN,NaN,NaN,NaN,3.1259853964568998,35.80018148773447,-3376958,0.47557203359370037,-2.7456304230018986,-3.221202456595599
2022-05-05T13:30:00-04:00,64.25,64.53,62.88,63.97,NaN,NaN,NaN,72.50459187840144,NaN,NaN,75.91579999999982,92.31165317817053,59.5199468218291,62.49540129449015,64.68902279556445,65.45261524063217,63.92543035049674,113084,170289.9,36.05443536912601,33.63069940624909,NaN,NaN,NaN,NaN,3.0205578681385497,34.840534778898245,-3490042,0.3355361352761923,-2.801782287500359,-3.137318422776551
2022-05-06T09:30:00-04:00,63.33,63.33,59.25,61.91,NaN,NaN,NaN,70.33324679301955,NaN,NaN,75.39499999999983,91.88276237092583,58.90723762907381,62.23051167755426,61.49666666666667,61.49666666666667,61.49666666666667,56640,169259.66666666666,32.78310957468729,33.88314870614256,NaN,NaN,NaN,NaN,3.141946591842939,34.85940151247447,-3546682,0.12731293423332124,-2.9781772549848995,-3.1054901892182207
2022-05-06T13:30:00-04:00,61.78,61.81,60.26,60.92,NaN,NaN,NaN,69.89219012060957,NaN,NaN,74.87079999999983,91.49886054355454,58.24273945644512,62.23051167755426,61.387395143487865,61.594024027750415,61.180766259225315,15840,168513.13333333333,31.312700154751965,34.13406525126518,NaN,NaN,NaN,NaN,3.035378978139872,34.876920622223814,-3562522,-0.04473861452401762,-3.161413457373243,-3.1166748428492252
2022-05-09T09:30:00-04:00,58.45,59.28,54.53,55.34,NaN,NaN,NaN,66.23095420603642,NaN,NaN,74.23659999999984,91.3694076438193,57.10379235618037,62.23051167755426,56.38333333333334,56.38333333333334,56.38333333333334,344405,176440.56666666668,24.61201769725487,33.92252683181752,NaN,NaN,NaN,NaN,3.2749947654155953,35.9640157007934,-3906927,-0.47792035447347114,-3.714075285941064,-3.236154931467593
2022-05-09T13:30:00-04:00,55.45,55.45,53.71,54.205,NaN,NaN,NaN,63.71931992394385,NaN,NaN,73.56169999999983,91.13348848154382,55.98991151845585,62.23051167755426,56.0756061504499,56.78179632684726,55.369415974052544,65397,176560.26666666666,23.50997836842258,33.47026398798414,NaN,NaN,NaN,NaN,3.1653522821716247,37.09600457295171,-3972324,-0.7673065438919044,-4.195288111332474,-3.427981567440569
2022-05-10T09:30:00-04:00,56.28,57.56,51.1,53.06,NaN,NaN,NaN,63.71931992394385,NaN,NaN,72.77309999999983,90.41518954631266,55.131010453687004,62.23051167755426,53.906666666666666,53.906666666666666,53.906666666666666,230465,180836.66666666666,22.41937296443882,32.99471163865302,NaN,NaN,NaN,NaN,3.4006842620165085,38.509988152411545,-4202789,-0.9502836955974141,-4.6158361869373365,-3.6655524913399224
2022-05-10T13:30:00-04:00,53.07,54.86,52.94,53.33,NaN,NaN,NaN,63.33004150094884,NaN,NaN,71.99029999999983,89.54015816581193,54.44044183418774,62.23051167755426,53.84203867326596,53.93441504743388,53.74966229909804,112804,182884.03333333333,23.32265925584032,32.81010873727676,NaN,NaN,NaN,NaN,3.2949211004439007,39.82297290476711,-4089985,-0.9645058762353989,-4.871184836634171,-3.9066789603987724
2022-05-11T09:30:00-04:00,50.75,53.07,48.89,48.9,NaN,NaN,NaN,60.586857796360256,NaN,NaN,71.19369999999984,89.2407160203872,53.146683979612476,62.23051167755426,50.286666666666676,50.286666666666676,50.286666666666676,389481,187946.83333333334,19.343192103545363,31.98342654513005,NaN,NaN,NaN,NaN,3.3767124504121933,41.53318215229455,-4479466,-1.169954876076849,-5.369122555494833,-4.199167679417984
2022-05-11T13:30:00-04:00,48.86,49.47,47.67,47.95,NaN,NaN,NaN,57.98563698743479,NaN,NaN,70.38909999999983,88.9159475127343,51.86225248726536,58.47040934204341,49.81402108666085,50.64206767627895,48.985974497042754,126896,188390.73333333334,18.609870027257273,30.568068869596665,NaN,NaN,NaN,NaN,3.264090132525608,43.24853461375365,-4606362,-1.2597391315502575,-5.773841593855806,-4.514102462305549
2022-05-12T09:30:00-04:00,46.43,52.49,45.1,49.99,NaN,NaN,NaN,57.98563698743479,NaN,NaN,69.73769999999983,88.78989643086096,50.6855035691387,55.94532747363473,49.19333333333334,49.19333333333334,49.19333333333334,242680,191311.16666666666,25.17029388832134,29.657371892109374,NaN,NaN,NaN,NaN,3.5587979802023506,43.470602708403206,-4363682,-1.0786343119042403,-5.86239535218585,-4.783761040281609
2022-05-12T13:30:00-04:00,49.97,50.55,48.61,50.54,NaN,NaN,NaN,57.98563698743479,NaN,NaN,69.07709999999983,88.45281037046405,49.70138962953561,54.10226197890778,49.296798285415484,49.546618693899255,49.04697787693171,41626,187542.4,26.8815089079731,28.923661823290328,NaN,NaN,NaN,NaN,3.4431695530450397,43.67680879629208,-4322056,-0.829865175180414,-5.821092509257127,-4.991227334076713
2022-05-13T09:30:00-04:00,53.43,56.99,53.43,56.51,NaN,NaN,NaN,57.98563698743479,NaN,NaN,68.56709999999984,87.89665044381802,49.23754955618166,53.60280958312623,55.64333333333333,55.64333400768291,55.64333265898375,395700,196354.1,42.30450567550398,29.38246672383738,NaN,NaN,NaN,NaN,3.6579431563989653,41.538982387613,-3926356,-0.20394307611601192,-5.246156179221728,-5.042213103105716
2022-05-13T13:30:00-04:00,56.49,56.62,54.99,56.41,NaN,NaN,NaN,57.98563698743479,NaN,NaN,68.04109999999983,87.23346028111466,48.848739718885,49.51924766650098,55.76912327486075,55.94198324525749,55.59626330446402,209541,200878.03333333333,42.14414821132523,28.935636741097067,NaN,NaN,NaN,NaN,3.513090073799039,39.553857865268135,-4135897,0.23865093050690156,-4.74389943997209,-4.982550370478991
2022-05-16T09:30:00-04:00,55.41,56.66,53.5,54.22,NaN,NaN,NaN,57.98563698743479,NaN,NaN,67.50769999999984,86.72443533251945,48.29096466748023,47.56896342642165,54.79333333333333,54.79333333333333,54.79333333333333,259164,201452.23333333334,38.6856960796787,29.082392019866184,NaN,NaN,NaN,NaN,3.4878693542419645,38.058092277359336,-4395061,0.4092140801400843,-4.471032770303886,-4.88024685044397
2022-05-16T13:30:00-04:00,54.27,54.79,52.97,53.16,NaN,NaN,NaN,57.98563698743479,NaN,NaN,66.96689999999984,86.2462677168133,47.68753228318637,47.56896342642165,54.51919993175888,55.01013584199274,54.02826402152501,80807,200930.06666666668,37.09879195085436,29.156988918561066,NaN,NaN,NaN,NaN,3.368735828938967,36.79213885923481,-4475868,0.47151363502938093,-4.290854806657244,-4.7623684416866245
2022-05-17T09:30:00-04:00,55.13,56.34,52.76,55.01,NaN,NaN,NaN,57.98563698743479,NaN,NaN,66.47369999999984,85.68955104126545,47.25784895873423,48.00373659290986,54.703333333333326,54.703333333333326,54.703333333333326,235558,204079.23333333334,41.60129521236903,29.78685932125262,NaN,NaN,NaN,NaN,3.3838261268718983,35.07973712040659,-4240310,0.6473245472929188,-3.9532127575704763,-4.600537304863395
2022-05-17T13:30:00-04:00,55.05,55.64,54.15,55.64,NaN,NaN,NaN,57.98563698743479,NaN,NaN,66.00289999999984,85.10357643723904,46.90222356276063,48.22598927432789,54.857445415067986,55.067347254568915,54.647543575567056,126981,205510.23333333334,43.09511465208487,30.6284603567764,NaN,NaN,NaN,NaN,3.2485528320953345,33.48964979149468,-4113329,0.8057329473024719,-3.5933711207353056,-4.3991040680377775
2022-05-18T09:30:00-04:00,54.28,56.19,53.01,53.27,NaN,NaN,NaN,57.98563698743479,NaN,NaN,65.46769999999984,84.46558043019796,46.469819569801714,48.66879141946231,54.156666666666666,54.156666666666666,54.156666666666666,466441,211444.43333333332,39.048501033550416,31.659637737940365,NaN,NaN,NaN,NaN,3.243656201231382,32.32813578781276,-4579770,0.7516403398650242,-3.4595536432064975,-4.211193983071522
2022-05-18T13:30:00-04:00,53.24,53.68,52.77,53.13,NaN,NaN,NaN,57.98563698743479,NaN,NaN,64.96369999999983,83.90692578760272,46.02047421239694,48.66879141946231,53.97774996464926,54.35237676118497,53.603123168113555,106390,211857.2,38.81663031769658,32.75297002003136,NaN,NaN,NaN,NaN,3.076966472571997,31.316621846579075,-4686160,0.7077920915917311,-3.326453868581858,-4.034245960173589
2022-05-19T09:30:00-04:00,53.28,56.98,52.73,55.72,NaN,NaN,NaN,57.98563698743479,NaN,NaN,64.45369999999984,82.98744487900633,45.91995512099335,49.67742650845587,55.14333333333333,55.14333400768291,55.14333265898375,627782,221203,45.289123743635365,34.386523647116825,NaN,NaN,NaN,NaN,3.1607545816739977,29.16397245849281,-4058378,0.845272427680456,-2.977655425573019,-3.822927853253475
2022-05-19T13:30:00-04:00,55.74,56.65,55.24,55.58,NaN,NaN,NaN,57.98563698743479,NaN,NaN,63.94309999999984,82.01411733605774,45.87208266394194,50.102941206764704,55.237343603794294,55.47205417654646,55.00263303104213,100715,219273.93333333332,45.01193292323767,35.93575748050235,NaN,NaN,NaN,NaN,3.0357006829829976,27.165083740984137,-4159093,0.9130502920696584,-2.6816149881664018,-3.59466528023606
2022-05-20T09:30:00-04:00,56.65,57.23,51.76,51.8,NaN,NaN,NaN,57.98563698743479,NaN,NaN,63.41589999999984,81.33451263491392,45.49728736508576,50.102941206764704,53.596666666666664,53.596666666666664,53.596666666666664,240467,218377.06666666668,38.21162098495291,37.2835024006029,NaN,NaN,NaN,NaN,3.209579205627069,26.3644387941279,-4399560,0.6992096473069771,-2.7206532211023386,-3.4198628684093157
2022-05-20T13:30:00-04:00,51.96,54.43,51.96,54.39,NaN,NaN,NaN,57.98563698743479,NaN,NaN,62.94849999999984,80.56269657549265,45.33430342450703,50.102941206764704,53.59575794332591,53.597242295045604,53.59427359160621,90125,212464.43333333332,44.40887480497478,39.12628845615415,NaN,NaN,NaN,NaN,3.1681806909394212,25.620982772047107,-4309435,0.7249907351151572,-2.513624449515369,-3.2386151846305262
2022-05-23T09:30:00-04:00,54.58,54.85,52.32,53.82,NaN,NaN,NaN,57.98563698743479,NaN,NaN,62.509899999999845,79.91813167240409,45.101668327595604,50.102941206764704,53.663333333333334,53.663333333333334,53.663333333333334,176727,205292.4,43.37773134500789,40.42681970306033,NaN,NaN,NaN,NaN,3.12259635587232,24.760832073466013,-4486162,0.6962943772305388,-2.368247213092353,-3.0645415903228916
2022-05-23T13:30:00-04:00,53.81,54.35,53.54,54.02,NaN,NaN,NaN,57.98563698743479,NaN,NaN,62.05929999999984,79.15405615620462,44.964543843795056,50.102941206764704,53.74214188714783,53.87614624658928,53.60813752770638,61124,202249.26666666666,43.87020454896632,41.64029796313127,NaN,NaN,NaN,NaN,2.9574109018814405,23.962120710497857,-4425038,0.6825095276959945,-2.2114046807028984,-2.893914208398893
2022-05-24T09:30:00-04:00,52.68,52.69,49.84,50.48,NaN,NaN,NaN,57.98563698743479,NaN,NaN,61.47149999999985,78.09068725449862,44.85231274550109,50.102941206764704,51.00333333333333,51.00333333333333,51.00333333333333,191724,201526.9,37.63137185252739,41.306502690061514,NaN,NaN,NaN,NaN,3.0447386946041948,24.289497537919523,-4616762,0.4385599073531776,-2.345714324207421,-2.7842742315605986
2022-05-24T13:30:00-04:00,50.4,50.96,49.76,50.57,NaN,NaN,NaN,57.98563698743479,NaN,NaN,60.888299999999845,76.94054241157883,44.83605758842086,50.102941206764704,50.844395644994684,51.1010336894716,50.58775760051777,73534,199005.3,37.87327197740241,41.00144010192417,NaN,NaN,NaN,NaN,2.91297164498961,24.61398910240496,-4543228,0.2937942628240453,-2.417031403030542,-2.7108256658545873
2022-05-25T09:30:00-04:00,50.73,52.95,50.62,52.47,NaN,NaN,NaN,57.98563698743479,NaN,NaN,60.41069999999985,76.00898093220806,44.812419067791645,50.102941206764704,52.01333333333333,52.01333333333333,52.01333333333333,221196,197987.33333333334,42.907626272807235,41.30300654429049,NaN,NaN,NaN,NaN,2.8749022417760663,24.021396973817044,-4322032,0.3336244220786413,-2.293795138256286,-2.627419560334927
2022-05-25T13:30:00-04:00,52.47,53.57,51.7,53.02,NaN,NaN,NaN,57.98563698743479,NaN,NaN,59.96809999999986,75.11778077419729,44.81841922580242,50.102941206764704,52.32505182946429,52.69467386786006,51.955429791068525,157321,190540.3,44.31432961312856,41.818402091595786,NaN,NaN,NaN,NaN,2.803123510220633,23.20888809814336,-4164711,0.40015344846848855,-2.1272277497493164,-2.527381198217805
2022-05-26T09:30:00-04:00,52.01,55.58,51.97,55.06,NaN,NaN,NaN,57.98563698743479,NaN,NaN,59.59969999999985,74.30654852849463,44.89285147150507,50.102941206764704,54.20333333333335,54.20333333333335,54.20333333333335,109855,189015.66666666666,49.30377424998989,42.36857916571156,NaN,NaN,NaN,NaN,2.8607575452048732,21.655748072475966,-4054856,0.5741055344748771,-1.8097492801242083,-2.3838548145990854
2022-05-26T13:30:00-04:00,55.08,55.57,54.57,55.03,NaN,NaN,NaN,57.98563698743479,NaN,NaN,59.26269999999986,73.59599092846713,44.92940907153259,49.82555979047163,54.46910244758533,54.86426876962137,54.07393612554929,49690,186902.53333333333,49.233910987518996,42.80706461824257,NaN,NaN,NaN,NaN,2.7278462919759536,20.21354662007053,-4104546,0.6728583905825269,-1.542781826370927,-2.215640216953454
2022-05-27T09:30:00-04:00,55.81,57.85,55.73,57.58,NaN,NaN,NaN,57.98563698743479,NaN,NaN,59.01849999999986,73.03867435697852,44.998325643021204,51.844447832377305,57.05333333333334,57.05333333333334,57.05333333333334,119637,189002.43333333332,55.06271122604397,43.950936774849254,NaN,NaN,NaN,NaN,2.734428699691957,19.502171916712154,-3984909,0.882417030614483,-1.1126189286853503,-1.9950359592998332
2022-05-27T13:30:00-04:00,57.6,58.145,57.46,58.14,49.55695559666372,49.55695559666372,49.55695559666372,NaN,NaN,NaN,58.77809999999986,72.4333268219932,45.122873178006515,52.99805826590185,57.30470591543626,57.69638333357332,56.913028497299194,49277,190117,56.25069138890381,45.19622685136405,NaN,NaN,NaN,NaN,2.5880409354282463,18.943142592284605,-3935632,1.0214328212511867,-0.7182449327358498,-1.7396777539870365
2022-05-31T09:30:00-04:00,59,59.59,56.65,57.84,49.84834397863355,NaN,NaN,NaN,NaN,NaN,58.50109999999985,71.6499148956506,45.3522851043491,54.00244661272147,58.02666666666667,58.02666666666667,58.02666666666667,167796,184230.03333333333,55.40565707748951,45.91883637521078,NaN,NaN,NaN,NaN,2.6131808686119435,18.910511849202447,-4103428,1.0517350401737287,-0.4250089537698756,-1.4767439939436042
2022-05-31T13:30:00-04:00,57.85,58.3,56.54,57.36,49.84834397863355,NaN,NaN,NaN,NaN,NaN,58.200899999999855,70.74072897650841,45.6610710234913,54.00244661272147,57.81648708381854,58.11235374557406,57.52062042206301,84678,184872.73333333334,54.00765924117105,46.561388255063164,NaN,NaN,NaN,NaN,2.5522393779968047,18.827048160574396,-4188106,0.9984249097018822,-0.22871285681625153,-1.2271377665181338
2022-06-01T09:30:00-04:00,57.67,58.6,54.66,55.07,49.84834397863355,NaN,NaN,NaN,NaN,NaN,57.93889999999985,70.17843843737933,45.69936156262037,54.00244661272147,56.109999999999985,56.1100009536743,56.10999904632567,195885,183720.06666666668,47.80971742773248,47.24696657240457,NaN,NaN,NaN,NaN,2.651365136711319,17.877954664940066,-4383991,0.7777171997603891,-0.2549912668176475,-1.0327084665780366
2022-06-01T13:30:00-04:00,55.02,56.23,54.89,55.37,49.84834397863355,NaN,NaN,NaN,NaN,NaN,57.690499999999844,69.6204579630478,45.7605420369519,54.00244661272147,55.97121677489348,56.22784801713458,55.71458553265237,57287,181869.5,48.64124580762562,47.54927878687963,NaN,NaN,NaN,NaN,2.5576961983747957,16.996653561851048,-4326704,0.6271729673681709,-0.24874225736782307,-0.8759152247359939
2022-06-02T09:30:00-04:00,55.43,59.5,55.19,59.49,49.84834397863355,NaN,NaN,NaN,NaN,NaN,57.536299999999855,69.16614932146935,45.90645067853036,54.00244661272147,58.06,58.06,58.06,203608,175673.73333333334,58.435486530234364,48.62483272868151,NaN,NaN,NaN,NaN,2.6828607556337394,17.344957490621052,-4123096,0.7708516425627321,0.08764932846742113,-0.683202314095311
2022-06-02T13:30:00-04:00,59.51,59.77,58.76,59.24,51.17818651612712,NaN,NaN,NaN,NaN,NaN,57.39789999999985,68.77592831601677,46.01987168398293,54.00244661272147,58.3710594776397,58.89591803917072,57.84620091610867,71515,173827.7,57.71623341678925,49.61383479066887,NaN,NaN,NaN,NaN,2.563370701659901,17.752884972368015,-4194611,0.8107715449124611,0.3302621170452653,-0.4805094278671957
2022-06-03T09:30:00-04:00,57.25,58.05,55.49,55.95,51.17818651612712,NaN,NaN,NaN,NaN,NaN,57.19689999999985,68.31202247166348,46.08177752833622,54.00244661272147,56.49666666666667,56.49666666666667,56.49666666666667,147956,170670.23333333334,49.14362733761838,50.43613875388966,NaN,NaN,NaN,NaN,2.6481299372556224,16.682023159254975,-4342567,0.5877111809800555,0.2541295483578736,-0.3335816326221818
2022-06-03T13:30:00-04:00,55.92,55.96,55.42,55.68,51.17818651612712,NaN,NaN,NaN,NaN,NaN,56.97869999999985,67.7713435705103,46.1860564294894,54.00244661272147,56.24948799711962,56.62247248426906,55.876503509970185,64979,171448.66666666666,48.50687473238176,51.195681807816754,NaN,NaN,NaN,NaN,2.4975492274516493,15.659849511270583,-4407546,0.4029029058496554,0.17004699968988746,-0.23285590615976795
2022-06-06T09:30:00-04:00,57.32,58.12,55.95,56.49,51.17818651612712,NaN,NaN,NaN,NaN,NaN,56.78589999999985,67.25737891943051,46.31442108056918,54.00244661272147,56.85333333333333,56.85333333333333,56.85333333333333,171986,163991.53333333333,50.575819681558364,51.74340990844184,NaN,NaN,NaN,NaN,2.4934385683479596,15.490297429785043,-4235560,0.31976303377954135,0.16684788606465872,-0.15291514771488263
2022-06-06T13:30:00-04:00,56.56,57.33,56.36,56.75,51.17818651612712,NaN,NaN,NaN,NaN,NaN,56.63909999999984,66.90057078932065,46.377629210679025,54.00244661272147,56.839592541981254,56.85858786527154,56.82059721869097,89996,160006.7,51.2528712319002,52.23902002406838,NaN,NaN,NaN,NaN,2.3846215277516767,15.33285621126276,-4145564,0.26887675684426743,0.18318079834045164,-0.08569595850381577
2022-06-07T09:30:00-04:00,55.59,57.55,54.67,57.11,51.17818651612712,NaN,NaN,NaN,NaN,NaN,56.47429999999985,66.43103159425715,46.51756840574255,53.912182506056574,56.443333333333335,56.443333333333335,56.443333333333335,224987,158867.46666666667,52.22867696844842,52.447941646815416,NaN,NaN,NaN,NaN,2.4200057043408423,14.441385205683366,-3920577,0.24664289307080733,0.22260765783469338,-0.024035235236113936
2022-06-07T13:30:00-04:00,57.13,58.03,56.94,57.92,51.17818651612712,NaN,NaN,NaN,NaN,NaN,56.28349999999984,65.74411525483839,46.82288474516128,53.912182506056574,56.71189624025676,57.20845299891919,56.215339481594334,65813,158367.66666666666,54.43860698946901,52.81970564695471,NaN,NaN,NaN,NaN,2.3250052968879253,13.803718931859944,-3854764,0.2716891423303318,0.3155761926768008,0.04388705034646902
2022-06-08T09:30:00-04:00,58,60.43,57.91,59.02,51.650991519698984,NaN,NaN,NaN,NaN,NaN,56.119499999999846,65.0875638378683,47.15143616213139,55.255901032694155,59.12,59.120000674349576,59.11999932565042,198000,157115.73333333334,57.32575748808912,52.98135180852936,NaN,NaN,NaN,NaN,2.3389334899673595,14.079300374788858,-3656764,0.3429445726924662,0.47256776621205177,0.12962319351958557
2022-06-08T13:30:00-04:00,59,59.45,58.55,59,51.70003735971267,NaN,NaN,NaN,NaN,NaN,55.96209999999984,64.43234157625265,47.49185842374704,55.255901032694155,59.089093540718295,59.14156797152726,59.03661910990933,68686,155172.56666666668,57.25471703942491,53.05306792642373,NaN,NaN,NaN,NaN,2.236152526398263,14.335197428937136,-3725450,0.3671702716180044,0.5885860330420911,0.2214157614240867
2022-06-09T09:30:00-04:00,58.51,59.12,56.79,56.79,51.70003735971267,NaN,NaN,NaN,NaN,NaN,55.77189999999984,63.71578743374926,47.828012566250415,55.255901032694155,57.56666666666666,57.56666734101624,57.566665992317084,124821,143785.23333333334,49.896494917583254,52.65955634357328,NaN,NaN,NaN,NaN,2.2428559173698153,13.744412295198641,-3850271,0.22005115574703787,0.49647970610788406,0.2764285503608462
2022-06-09T13:30:00-04:00,56.82,56.82,55.64,55.66,51.70003735971267,NaN,NaN,NaN,NaN,NaN,55.48409999999984,62.30069025907226,48.66750974092742,55.255901032694155,56.98008100401567,57.72266974530207,56.237492262729276,77885,142835.06666666668,46.59882317261242,52.13035376724766,NaN,NaN,NaN,NaN,2.1669376375576856,12.82089553454138,-3928156,0.04167019244643033,0.3285162909188841,0.2868460984724538
2022-06-10T09:30:00-04:00,53.97,54.79,51.76,52.06,51.70003735971267,NaN,NaN,NaN,NaN,NaN,55.23889999999985,61.63558016709264,48.84221983290706,55.255901032694155,52.870000000000005,52.870000000000005,52.870000000000005,307528,132159.93333333332,37.985609448343595,51.42863176871988,NaN,NaN,NaN,NaN,2.290727806303565,13.314529445786768,-4235684,-0.30467867075088995,-0.09400223996615864,0.2106764307847313
2022-06-10T13:30:00-04:00,52.1,52.85,51.86,52.23,51.70003735971267,NaN,NaN,NaN,NaN,NaN,55.004099999999845,60.947390566687375,49.060809433312315,55.255901032694155,52.67910642759061,52.94334823475457,52.41486462042665,160496,134152.63333333333,38.56310762673039,50.70876475579879,NaN,NaN,NaN,NaN,2.1978186772818824,13.7729037919432,-4075188,-0.49686336288793986,-0.41040277282519355,0.08646059006274633
2022-06-13T09:30:00-04:00,48.37,49.57,46.92,47.71,NaN,NaN,NaN,55.77125764299045,55.77125764299045,55.77125764299045,54.720099999999846,60.67334062675729,48.766859373242404,55.255901032694155,48.06666666666667,48.06666666666667,48.06666666666667,294553,135955.5,30.44509578916511,48.70945113143671,NaN,NaN,NaN,NaN,2.420117343190319,15.45838734878417,-4369741,-0.8805186913244514,-1.014187774092818,-0.1336690827683666
2022-06-13T13:30:00-04:00,47.68,48.03,47.02,47.25,NaN,NaN,NaN,54.84688229558179,NaN,NaN,54.446699999999844,60.49080245115642,48.40259754884327,55.255901032694155,47.98974294733179,48.19662720720458,47.782858687459004,40722,134308.73333333334,29.758512923302177,46.71247109618763,NaN,NaN,NaN,NaN,2.3193946758195816,17.023479222993636,-4410463,-1.1029656636059406,-1.5123761622757925,-0.4094104986698518
2022-06-14T09:30:00-04:00,47.82,48.22,46.07,47.83,NaN,NaN,NaN,54.42725128214625,NaN,NaN,54.29649999999985,60.61152596986503,47.98147403013468,55.255901032694155,47.373333333333335,47.373333333333335,47.373333333333335,106729,131975.46666666667,31.845524422445678,45.476892316532435,NaN,NaN,NaN,NaN,2.3072950561181824,18.68577917673912,-4303734,-1.143825071286379,-1.8391918377778254,-0.6953667664914465
2022-06-14T13:30:00-04:00,47.81,47.81,46.595,47.25,NaN,NaN,NaN,54.3221489511396,NaN,NaN,54.15739999999985,60.773572682153066,47.54122731784664,55.255901032694155,47.348246360764044,47.40533510357579,47.2911576179523,20610,130625,30.858141538297133,44.21626851695496,NaN,NaN,NaN,NaN,2.230702552109741,20.229343419502786,-4324344,-1.1401484750620339,-2.120552360318989,-0.980403885256955
2022-06-15T09:30:00-04:00,47.67,49.65,47.33,49.08,NaN,NaN,NaN,54.3221489511396,NaN,NaN,54.077799999999854,60.83904638214479,47.31655361785492,54.86072082615532,48.68666666666667,48.68666666666667,48.68666666666667,208058,131169.46666666667,37.448138407091555,43.278576997350186,NaN,NaN,NaN,NaN,2.242795226959045,20.710886807738284,-4116286,-0.9523511088417533,-2.1708427713091467,-1.2184916624673934
2022-06-15T13:30:00-04:00,49,51.04,48.15,50.1,NaN,NaN,NaN,54.3221489511396,NaN,NaN,54.01319999999985,60.86293393936364,47.163466060636054,54.283576660924254,49.34084203114489,49.866563822207176,48.8151202400826,322152,139456.73333333334,40.83312207960659,42.53430920075779,NaN,NaN,NaN,NaN,2.2890241393191135,20.50753233736431,-3794134,-0.70851676613222,-2.1041376201326685,-1.3956208540004484
2022-06-16T09:30:00-04:00,47.96,48.46,46.17,46.88,NaN,NaN,NaN,54.3221489511396,NaN,NaN,53.97279999999985,60.96503459561169,46.98056540438801,52.360861328739404,47.169999999999995,47.169999999999995,47.169999999999995,370192,144423.26666666666,34.48818818235863,41.267131430322806,NaN,NaN,NaN,NaN,2.4062367007963195,20.900242236639993,-4164326,-0.7113137728965169,-2.2847630701210946,-1.5734492972245777
2022-06-16T13:30:00-04:00,46.89,47.01,45.965,46.41,NaN,NaN,NaN,53.69605400786567,NaN,NaN,53.94199999999985,61.05264666539342,46.831353334606284,49.272689062991525,46.9621310857992,47.28466944848098,46.63959272311742,153760,144304.56666666668,33.66588638816059,39.78336567308649,NaN,NaN,NaN,NaN,2.309005507882296,21.322677013050793,-4318086,-0.691428104280362,-2.4377344275750303,-1.7463063232946683
2022-06-17T09:30:00-04:00,46.79,48.53,46.46,48.36,NaN,NaN,NaN,53.69605400786567,NaN,NaN,53.90939999999986,61.106641038068936,46.71215896193079,47.94115125039322,47.78333333333333,47.78333428700765,47.783332379659015,365696,152832.6,40.052270477093245,38.549545172301066,NaN,NaN,NaN,NaN,2.295505114462133,20.98775529111825,-3952390,-0.5023531628306328,-2.3742477768329593,-1.8718946140023265
2022-06-17T13:30:00-04:00,48.37,48.58,47.73,48.11,NaN,NaN,NaN,53.69605400786567,NaN,NaN,53.860799999999855,61.18017466181815,46.54142533818156,45.32573635338308,47.89057546261769,48.054126122918944,47.727024802316436,157234,156417.4,39.52685788496427,37.283269518411025,NaN,NaN,NaN,NaN,2.1922547491434092,20.65313125493521,-4109624,-0.35639917969720836,-2.317393588623837,-1.9609944089266285
2022-06-21T09:30:00-04:00,49.32,51.92,49.29,51.39,NaN,NaN,NaN,53.69605400786567,NaN,NaN,53.75839999999985,61.06991350679652,46.44688649320319,46.051766088276565,50.866666666666674,50.866666666666674,50.866666666666674,251439,160810.8,48.98286740132594,37.218010410106935,NaN,NaN,NaN,NaN,2.3078079813474517,19.42099741409335,-3858185,-0.019035067719012755,-1.9847882435753945,-1.9657531758563818
2022-06-21T13:30:00-04:00,51.43,51.6,50.66,50.73,NaN,NaN,NaN,53.69605400786567,NaN,NaN,53.64479999999985,60.96448768733121,46.32511231266849,46.43541287062125,50.90960098198511,50.97074103072141,50.8484609332488,123991,163301.26666666666,47.37750771724965,37.27363073472388,NaN,NaN,NaN,NaN,2.2101074112512054,18.276873133311618,-3982176,0.1692178098991437,-1.754230913482452,-1.9234487233815958
2022-06-22T09:30:00-04:00,49.67,52.69,49.65,51.94,NaN,NaN,NaN,53.69605400786567,NaN,NaN,53.59919999999985,60.932381399642836,46.26601860035686,47.038330296496994,51.42666666666667,51.42666666666667,51.42666666666667,266234,166582.53333333333,50.575632369299946,38.17291808622076,NaN,NaN,NaN,NaN,2.2693854533046904,17.63028938917799,-3715942,0.373095477388238,-1.4570793766462984,-1.8301748540345364
2022-06-22T13:30:00-04:00,51.92,52.25,50.92,51.1,NaN,NaN,NaN,53.69605400786567,NaN,NaN,53.55799999999986,60.92366412484746,46.19233587515225,47.0636642371976,51.42565434733523,51.42718719020298,51.424121504467486,116119,167630.56666666668,48.37753798999296,38.8739488264538,NaN,NaN,NaN,NaN,2.202286492354355,17.02989019819676,-3832061,0.44440228535566284,-1.2746719973399578,-1.7190742826956207
2022-06-23T09:30:00-04:00,51.63,53.78,50.87,52.3,45.31894902797265,45.31894902797265,45.31894902797265,NaN,NaN,NaN,53.503799999999856,60.86581047541148,46.14178952458823,48.17593138975808,52.31666666666666,52.31666666666666,52.31666666666666,272594,170187.53333333333,51.612888617816424,40.38593402850032,NaN,NaN,NaN,NaN,2.252837457186187,17.051668297751903,-3559467,0.5580533776830621,-1.0215075605917932,-1.5795609382748552
2022-06-23T13:30:00-04:00,52.3,54.53,52.18,54.29,46.34695134488299,NaN,NaN,NaN,NaN,NaN,53.476799999999855,60.81714488563503,46.13645511436468,48.87174511180646,52.70548488932536,53.31681539757593,52.094154381074794,110270,171953.63333333333,56.48359715975295,42.294868616818235,NaN,NaN,NaN,NaN,2.2597776388157453,17.33783599640593,-3449197,0.7414313069284697,-0.6527718046142681,-1.3942031115427378
2022-06-24T09:30:00-04:00,55.03,56.86,54.77,55.92,48.77504446557012,NaN,NaN,NaN,NaN,NaN,53.52979999999986,60.90160736590874,46.15799263409098,51.04839608944517,55.85,55.85,55.85,259183,173806.13333333333,60.03245895890174,44.308221083707956,NaN,NaN,NaN,NaN,2.281936378900335,18.341976198682186,-3190014,0.9342354617530937,-0.22640878435137068,-1.1606442461044644
2022-06-24T13:30:00-04:00,55.9,56.67,55.63,56.67,49.288224262589665,NaN,NaN,NaN,NaN,NaN,53.60059999999986,61.02350876678868,46.177691233211036,51.500716871556136,55.96364612957892,56.16582688674034,55.7614653724175,81891,174152,61.5848357307758,46.502984954599285,NaN,NaN,NaN,NaN,2.193226637550311,19.274392100795858,-3108123,1.0645518240114853,0.1700455339098923,-0.894506290101593
2022-06-27T09:30:00-04:00,56.77,57.22,53.93,55.16,49.288224262589665,NaN,NaN,NaN,NaN,NaN,53.58939999999986,61.00116514469149,46.177634855308234,51.500716871556136,55.436666666666675,55.436666666666675,55.436666666666675,171723,174944.23333333334,56.80130684082376,47.88535412843731,NaN,NaN,NaN,NaN,2.271567592011003,19.203949780920198,-3279846,1.0022164002603722,0.3582642102238722,-0.6439521900365
2022-06-27T13:30:00-04:00,55.17,55.31,54.82,55.11,49.288224262589665,NaN,NaN,NaN,NaN,NaN,53.579999999999856,60.98282972923632,46.17717027076339,51.500716871556136,55.35952768447188,55.50636937158713,55.21268599735663,47389,174357.9,56.64441172464102,49.01473196022547,NaN,NaN,NaN,NaN,2.144312764010217,19.138539055321367,-3327235,0.9132878305113131,0.49765759810264143,-0.4156302324086717
2022-06-28T09:30:00-04:00,54.99,55.89,52.5,52.64,49.288224262589665,NaN,NaN,NaN,NaN,NaN,53.596799999999845,60.98719748863816,46.20640251136153,51.500716871556136,53.67666666666667,53.67666666666667,53.67666666666667,220200,175965.03333333333,49.38709304897255,50.078939450697895,NaN,NaN,NaN,NaN,2.233290423723773,17.925682944741112,-3547435,0.6558326604757195,0.40416059318597775,-0.2516720672897418
2022-06-28T13:30:00-04:00,52.62,52.72,51.93,52.11,49.288224262589665,NaN,NaN,NaN,NaN,NaN,53.55119999999985,60.949589705879674,46.15281029412003,51.500716871556136,53.307771374357834,53.93145176475466,52.684090983961006,77037,175533.06666666668,47.96697307404076,51.10044564254648,NaN,NaN,NaN,NaN,2.1301982506006465,16.745197036037954,-3624472,0.42855600023282453,0.2840229330012889,-0.14453306723153564
2022-06-29T09:30:00-04:00,51.76,52.19,50.41,50.87,49.288224262589665,NaN,NaN,NaN,NaN,NaN,53.49219999999985,60.92803032620214,46.056369673797555,51.500716871556136,51.156666666666666,51.156666666666666,51.156666666666666,230156,175705.36666666667,44.72650996095959,51.434319891394075,NaN,NaN,NaN,NaN,2.1051840898434575,16.289319333941357,-3854628,0.18582155623686894,0.08774387806455053,-0.09807767817231841
2022-06-29T13:30:00-04:00,50.86,51.44,50.73,51.28,49.288224262589665,NaN,NaN,NaN,NaN,NaN,53.43739999999984,60.8972110539122,45.97758894608748,51.500716871556136,51.155142863527175,51.1579422762468,51.15234345080755,68194,175784.73333333334,46.02489972041727,51.89846573678358,NaN,NaN,NaN,NaN,2.005528083426068,15.86600432485166,-3786434,0.05099863389009596,-0.034329385809698465,-0.08532801969979442
2022-06-30T09:30:00-04:00,50.3,50.39,47.86,49.47,NaN,NaN,NaN,55.729390685275874,55.729390685275874,55.729390685275874,53.417199999999845,60.91431095289842,45.92008904710127,51.500716871556136,49.24,49.24,49.24,217786,176444.26666666666,41.40128711890487,51.35692428803922,NaN,NaN,NaN,NaN,2.1065617917527772,16.535943562545842,-4004220,-0.15091124678462497,-0.27396707818057564,-0.12305583139595067
2022-06-30T13:30:00-04:00,49.48,49.89,48.57,49.02,NaN,NaN,NaN,55.71419110867242,NaN,NaN,53.38619999999985,60.94272924563022,45.82967075436949,51.500716871556136,49.21041138379811,49.24903266144772,49.1717901061485,127828,178415.66666666666,40.31687570562421,50.85259343006597,NaN,NaN,NaN,NaN,2.0503788066275788,17.15802999754759,-4132048,-0.297149503614072,-0.49449271091354063,-0.19734320729946866
2022-07-01T09:30:00-04:00,49.42,51.16,49.06,49.64,NaN,NaN,NaN,55.71419110867242,NaN,NaN,53.32959999999986,60.954813922249215,45.7043860777505,51.500716871556136,49.95333333333334,49.95333333333334,49.95333333333334,218801,181548.33333333334,42.54961016816374,50.27930612998482,NaN,NaN,NaN,NaN,2.056780320439894,17.033268839278698,-3913247,-0.3318656499748155,-0.6121752697679881,-0.2803096197931726
2022-07-01T13:30:00-04:00,49.62,50.34,49.55,50.32,NaN,NaN,NaN,55.71419110867242,NaN,NaN,53.27559999999985,60.946921304708056,45.60427869529164,51.43957349724491,49.978410624223365,50.026335705532894,49.930485542913836,59908,180949.1,44.98070796982197,50.03667541425831,NaN,NaN,NaN,NaN,1.966296011837045,16.917419192314732,-3853339,-0.2902765715032783,-0.6431553341722704,-0.35287876266899215
2022-07-05T09:30:00-04:00,49.37,53.08,48.53,53.07,NaN,NaN,NaN,55.71419110867242,NaN,NaN,53.23579999999984,60.8903077856169,45.581292214382785,50.440658797795926,51.56,51.56,51.56,220143,178036.26666666666,53.542651089127624,50.17451559078055,NaN,NaN,NaN,NaN,2.150846296705827,15.961843195600153,-3633196,-0.07027686147495821,-0.4407248395126899,-0.3704479780377317
2022-07-05T13:30:00-04:00,53.08,54.21,53,54.21,NaN,NaN,NaN,55.71419110867242,NaN,NaN,53.21939999999985,60.861965443623355,45.57683455637635,50.29952703823674,52.12134513246192,53.09399462732603,51.148695637597804,73325,175130.56666666668,56.56050978685604,50.18000934985934,NaN,NaN,NaN,NaN,2.083642989798268,15.542841566803684,-3559871,0.14742816412929227,-0.18616277287611638,-0.33359093700540865
2022-07-06T09:30:00-04:00,53.96,55.1,52.52,53.08,NaN,NaN,NaN,55.71419110867242,NaN,NaN,53.12939999999985,60.66974313278025,45.58905686721945,49.687898375541366,53.56666666666666,53.56666666666666,53.56666666666666,205377,172158.03333333333,52.89276566451491,49.67003125740314,NaN,NaN,NaN,NaN,2.1190970619555345,15.503814380712969,-3765248,0.20708035333548003,-0.07474049533605864,-0.28182084867153867
2022-07-06T13:30:00-04:00,53.09,53.45,52.39,52.84,NaN,NaN,NaN,55.71419110867242,NaN,NaN,53.023399999999846,60.42678042789014,45.620019572109555,49.687898375541366,53.348812701465924,53.66381744177139,53.033807961160456,98231,174075,52.119719787237955,48.993951547150424,NaN,NaN,NaN,NaN,2.0434472718158534,15.397742054152994,-3863479,0.2208667631353042,-0.00573739475240842,-0.22660415788771263
2022-07-07T09:30:00-04:00,52.84,55.38,52.67,55.22,NaN,NaN,NaN,55.71419110867242,NaN,NaN,52.97099999999985,60.27367704339066,45.66832295660903,50.137254960346475,54.42333333333334,54.42333333333334,54.42333333333334,78990,173150.36666666667,58.58409487762422,49.12129354977903,NaN,NaN,NaN,NaN,2.091058180971864,16.03414448297827,-3784489,0.37188156376069437,0.23824779681315533,-0.13363376694753903
2022-07-07T13:30:00-04:00,55.25,55.92,55.25,55.89,49.30903637496269,49.30903637496269,49.30903637496269,NaN,NaN,NaN,52.94159999999985,60.18495652581482,45.698243474184885,51.375803968277175,54.649503022744206,55.13383243462614,54.16517361086227,17225,173037.53333333333,60.212631790354216,49.37616641161569,NaN,NaN,NaN,NaN,1.9916968823310168,16.813244392827322,-3767264,0.4910162173749989,0.4801365047712096,-0.010879712603789296
2022-07-08T09:30:00-04:00,54.61,57.45,54.22,55.95,49.403852903373476,NaN,NaN,NaN,NaN,NaN,52.959199999999846,60.22739134586207,45.691008654137626,52.19964317462174,55.873333333333335,55.873333333333335,55.873333333333335,160431,171449.96666666667,60.362943555868476,50.160155733536826,NaN,NaN,NaN,NaN,2.0801471050216587,18.03763459514211,-3606833,0.543875876850155,0.6689651334589044,0.12508925660874942
2022-07-08T13:30:00-04:00,55.93,56.37,55.73,55.99,49.823905044129226,NaN,NaN,NaN,NaN,NaN,52.971599999999846,60.258292923409606,45.684907076590086,52.19964317462174,55.90499159454889,55.9679006459961,55.842082543101675,40629,162065.86666666667,60.47016119264419,51.05324059915136,NaN,NaN,NaN,NaN,1.9772794546629686,19.17456835443441,-3566204,0.5499087068482851,0.8124751401691057,0.2625664333208207
2022-07-11T09:30:00-04:00,54.79,55.21,52.07,52.65,49.823905044129226,NaN,NaN,NaN,NaN,NaN,52.83479999999985,59.879666772342944,45.78993322765676,52.19964317462174,53.31,53.31,53.31,97090,152962.46666666667,48.63914768123984,51.33271472202852,NaN,NaN,NaN,NaN,2.1160452079013283,18.218008602293555,-3663294,0.3093180795176692,0.6492140327179072,0.339895953200238
2022-07-11T13:30:00-04:00,52.64,52.77,51.88,52.03,49.823905044129226,NaN,NaN,NaN,NaN,NaN,52.69059999999984,59.496234618466346,45.884965381533334,52.19964317462174,52.90165565010546,53.42665844783947,52.37665285237145,58736,149795,46.80837552228241,51.3886772793046,NaN,NaN,NaN,NaN,2.0284705501940907,17.241968017200797,-3722030,0.09963985237777362,0.464445768672455,0.3648059162946814
2022-07-12T09:30:00-04:00,52.38,53.76,50.88,52.12,49.823905044129226,NaN,NaN,NaN,NaN,NaN,52.61399999999984,59.35709602482911,45.87090397517057,52.19964317462174,52.25333333333333,52.25333333333333,52.25333333333333,184069,143740.76666666666,47.11953220659601,51.79712335699683,NaN,NaN,NaN,NaN,2.0892940823230837,16.146660058910538,-3537961,-0.034587960119861705,0.32157096614485425,0.35615892626471596
2022-07-12T13:30:00-04:00,52.15,52.4,51.34,51.84,49.823905044129226,NaN,NaN,NaN,NaN,NaN,52.53719999999985,59.22611984105557,45.84828015894413,52.19964317462174,52.1645453232548,52.3289836801863,52.0001069663233,53664,140288.43333333332,46.21378372650187,52.2183310727738,NaN,NaN,NaN,NaN,2.015773076442863,15.129588383355298,-3591625,-0.1380221733600967,0.1836312095645951,0.3216533829246918
2022-07-13T09:30:00-04:00,49.97,52.37,49.45,51.58,NaN,NaN,NaN,57.28732777492975,57.28732777492975,57.28732777492975,52.438999999999844,59.03645435755847,45.84154564244122,52.19964317462174,51.133333333333326,51.133333333333326,51.133333333333326,193761,138365.83333333334,45.342199765488594,52.417801758296996,NaN,NaN,NaN,NaN,2.080360713839801,15.021028965647815,-3785386,-0.21514242905349573,0.05272534660782213,0.26786777566131786
2022-07-13T13:30:00-04:00,51.53,51.69,50.97,51.06,NaN,NaN,NaN,57.28732777492975,NaN,NaN,52.32519999999984,58.816729545497566,45.83367045450211,52.19964317462174,51.147963359621656,51.18465802501239,51.11126869423092,30800,135259.46666666667,43.572244409370605,52.31719721826476,NaN,NaN,NaN,NaN,1.9831920914226722,14.920223792062295,-3816186,-0.2878290741819247,-0.09191856706608803,0.19591050711583669
2022-07-14T09:30:00-04:00,50.78,50.99,49.03,49.91,NaN,NaN,NaN,56.191284191619886,NaN,NaN,52.18119999999983,58.560237720539995,45.80216227945967,52.19964317462174,49.97666666666667,49.97666666666667,49.97666666666667,143964,131183.8,39.8659413366508,51.34028937880213,NaN,NaN,NaN,NaN,1.98653551346391,15.593984666391766,-3960150,-0.3934755715781618,-0.29593395735686556,0.09754161422129623
2022-07-14T13:30:00-04:00,49.95,50.45,49.76,49.97,NaN,NaN,NaN,56.09940763745534,NaN,NaN,52.02219999999984,58.21473135963546,45.829668640364225,52.19964317462174,49.99475636284534,50.02911094876058,49.96040177693009,39916,128643.7,40.15197615814045,50.1682512624653,NaN,NaN,NaN,NaN,1.893925833930774,16.219619763983413,-3920234,-0.4361263182324113,-0.4476162835692179,-0.011489965336806601
2022-07-15T09:30:00-04:00,50.73,51.59,49.69,51.21,NaN,NaN,NaN,56.09940763745534,NaN,NaN,51.86599999999983,57.72987994420719,46.00212005579247,51.84971453969739,50.830000000000005,50.830000000000005,50.830000000000005,159954,124889.03333333334,45.88127009218067,49.66743015015571,NaN,NaN,NaN,NaN,1.8943597029357193,16.10660341904766,-3760280,-0.36075786273207233,-0.462437293751897,-0.1016794310198247
2022-07-15T13:30:00-04:00,51.2,51.73,51.16,51.71,NaN,NaN,NaN,56.09940763745534,NaN,NaN,51.720199999999835,57.21842588114327,46.2219741188564,49.63377163175791,50.992777695026774,51.28940945468426,50.69614593536929,48167,122818.93333333333,48.04121788646461,49.376108585814755,NaN,NaN,NaN,NaN,1.7997625812974538,15.91791631746609,-3712113,-0.2617710277930203,-0.42889321576110007,-0.16712218796807976
2022-07-18T09:30:00-04:00,53.06,54.37,52.95,53.76,NaN,NaN,NaN,56.09940763745534,NaN,NaN,51.65959999999983,56.99743021086986,46.321769789129796,50.09971014272432,53.69333333333332,53.6933340076829,53.69333265898374,162238,119587.43333333333,55.82576324098495,49.17908489748338,NaN,NaN,NaN,NaN,1.8612081112047782,15.212909013970352,-3549875,-0.053655695600766856,-0.23419180746903834,-0.18053611186827148
2022-07-18T13:30:00-04:00,53.77,53.78,51.95,52.27,NaN,NaN,NaN,56.09940763745534,NaN,NaN,51.59179999999983,56.80942350501391,46.37417649498575,50.09971014272432,53.3555126922027,53.83790921580838,52.87311616859702,79564,119509.86666666667,49.96617032621342,48.44719479290189,NaN,NaN,NaN,NaN,1.8589789604044369,14.19084026690561,-3629439,-0.013842722839148947,-0.19783951541720768,-0.18399679257805873
2022-07-19T09:30:00-04:00,53.52,54.01,51.63,53.85,NaN,NaN,NaN,56.09940763745534,NaN,NaN,51.62759999999982,56.8820161388375,46.37318386116215,50.09971014272432,53.16333333333334,53.16333333333334,53.16333333333334,113319,117563.06666666667,55.321507164171244,48.08709219349495,NaN,NaN,NaN,NaN,1.8961947489469768,13.39814673317151,-3516120,0.11434630805556617,-0.041063907508601005,-0.15541021556416718
2022-07-19T13:30:00-04:00,53.84,54.51,53.84,54.5,NaN,NaN,NaN,56.09940763745534,NaN,NaN,51.67299999999982,56.986348097017576,46.35965190298206,50.45101159307485,53.453244383982145,53.943807284574774,52.96268148338952,39577,117302.66666666667,57.344254047038916,47.863813111666,NaN,NaN,NaN,NaN,1.808609409736478,12.484123650917729,-3476543,0.23159681352115621,0.1340858013372781,-0.09751101218387812
2022-07-20T09:30:00-04:00,54.95,58.58,54.95,57.43,50.72159750130303,50.72159750130303,50.72159750130303,NaN,NaN,NaN,51.867399999999826,57.29653593125791,46.438264068741745,53.292809274459884,56.98666666666667,56.98666666666667,56.98666666666667,138704,114586.13333333333,65.02987784742874,49.03457955210807,NaN,NaN,NaN,NaN,1.970851594755301,13.332777776384633,-3337839,0.4808212154374746,0.5035155071129651,0.022694291675490544
2022-07-20T13:30:00-04:00,57.38,58.19,57.11,57.79,51.73402488760744,NaN,NaN,NaN,NaN,NaN,52.078199999999825,57.59166669891786,46.56473330108179,53.42024741956791,57.13135984600607,57.4173599180063,56.84535977400584,35502,113201.63333333333,65.84418051007923,50.39427990837927,NaN,NaN,NaN,NaN,1.907219337987065,14.120813750032472,-3302337,0.6345922590961108,0.8159346155456291,0.18134235644951824
2022-07-21T09:30:00-04:00,57.12,59.07,56.8,58.43,51.97838739271619,NaN,NaN,NaN,NaN,NaN,52.29019999999982,57.947265656334565,46.63313434366508,54.11919793565433,58.1,58.1,58.1,182093,111599.53333333334,67.3018981344577,51.8358774746551,NaN,NaN,NaN,NaN,1.9331322424165605,15.158121542864086,-3120244,0.7368966365801338,1.1024631521746855,0.36556651559455167
2022-07-21T13:30:00-04:00,58.5,58.8,58.02,58.79,52.61777887486545,NaN,NaN,NaN,NaN,NaN,52.52099999999983,58.277458981012195,46.764541018987465,54.44935834852346,58.189051051917524,58.364992906394654,58.01310919744039,46648,110881.33333333333,68.12594742483623,53.40103202453612,NaN,NaN,NaN,NaN,1.8507656536725199,16.121335921922014,-3073596,0.7820312579006722,1.343105587970392,0.5610743300697197
2022-07-22T09:30:00-04:00,58.51,59.28,55.28,55.45,52.61777887486545,NaN,NaN,NaN,NaN,NaN,52.64839999999983,58.37648709431657,46.92031290568309,54.44935834852346,56.669999999999995,56.669999999999995,56.669999999999995,108321,107232.5,54.422299688155746,54.04961059044092,NaN,NaN,NaN,NaN,2.0042823926959112,15.457323059561038,-3181917,0.5510591886383416,1.2498983158676467,0.6988391272293051
2022-07-22T13:30:00-04:00,55.35,56.13,55.19,55.78,52.61777887486545,NaN,NaN,NaN,NaN,NaN,52.76199999999982,58.508683217307194,47.01531678269245,54.44935834852346,56.4812288189152,56.86525158756872,56.097206050261676,26174,103844.03333333334,55.377360538987624,54.892833171127855,NaN,NaN,NaN,NaN,1.9282622217890608,14.795235419122887,-3155743,0.3920915831802466,1.1889536062046133,0.7968620230243667
2022-07-25T09:30:00-04:00,55.32,55.56,54.05,55.16,52.61777887486545,NaN,NaN,NaN,NaN,NaN,52.92759999999982,58.45994787048706,47.39525212951258,54.44935834852346,54.923333333333325,54.923333333333325,54.923333333333325,80185,99223.5,53.12498954792685,55.83990804336185,NaN,NaN,NaN,NaN,1.914100634518414,13.867030887237059,-3235928,0.22506788857917326,1.0781968837483333,0.8531289951691601
2022-07-25T13:30:00-04:00,55.15,55.25,54.31,54.82,52.61777887486545,NaN,NaN,NaN,NaN,NaN,53.09579999999983,58.32856919422987,47.86303080576978,54.44935834852346,54.88404903010208,54.94374578829813,54.82435227190602,34724,98384.03333333334,51.8788409059385,56.67754123963315,NaN,NaN,NaN,NaN,1.8445220177670987,13.00512667905736,-3270652,0.07910642206454477,0.952012022749841,0.8729056006852962
2022-07-26T09:30:00-04:00,53.14,53.21,51.13,51.46,NaN,NaN,NaN,58.16497662413287,58.16497662413287,58.16497662413287,53.157799999999824,58.23582526973619,48.07977473026346,54.44935834852346,51.93333333333334,51.93333333333334,51.93333333333334,118633,95000.36666666667,41.51499351980993,56.36566434160666,NaN,NaN,NaN,NaN,1.976341873640877,13.5777484555761,-3389285,-0.238911750930893,0.57426591202168,0.813177662952573
2022-07-26T13:30:00-04:00,51.45,51.57,50.96,51.12,NaN,NaN,NaN,57.0706595048541,NaN,NaN,53.217999999999826,58.123673450208436,48.312326549791216,54.44935834852346,51.6745455067687,52.018774311287395,51.33031670225001,67050,94791.2,40.63047492652341,55.83632555875372,NaN,NaN,NaN,NaN,1.8787460255236716,14.172331713709191,-3456335,-0.4548268231910503,0.24464413396376017,0.6994709571548104
2022-07-27T09:30:00-04:00,52.6,53.75,52.06,53.44,NaN,NaN,NaN,57.0706595048541,NaN,NaN,53.25899999999982,58.13706560022341,48.38093439977624,54.44935834852346,53.083333333333336,53.083333333333336,53.083333333333336,90132,90949.7,48.667385370088404,55.32501285368968,NaN,NaN,NaN,NaN,1.9324070237005524,13.563191567975712,-3366203,-0.4246353970184388,0.16867671088176195,0.5933121079002007
2022-07-27T13:30:00-04:00,53.4,55.41,53.27,54.97,NaN,NaN,NaN,57.0706595048541,NaN,NaN,53.34379999999982,58.19037551680399,48.497224483195644,54.44935834852346,53.80369163890928,54.53691017824938,53.07047309956918,86998,90575.26666666666,53.16974523032576,55.553839632554855,NaN,NaN,NaN,NaN,1.9472350934362268,12.93513964715041,-3279205,-0.2912199944035343,0.2292871148957829,0.5205071092993172
2022-07-28T09:30:00-04:00,54.32,55.51,52.67,54.96,NaN,NaN,NaN,57.0706595048541,NaN,NaN,53.40419999999982,58.25456260913376,48.55383739086588,54.44935834852346,54.38,54.38,54.38,122010,92009.26666666666,53.13694048912803,55.39779915576605,NaN,NaN,NaN,NaN,2.011004015333639,12.075387534899855,-3401215,-0.1977151120031186,0.27336321929541896,0.47107833129853754
2022-07-28T13:30:00-04:00,54.97,55.41,54.78,55.4,NaN,NaN,NaN,57.0706595048541,NaN,NaN,53.49019999999982,58.32655646329787,48.653843536701764,53.799486678818774,54.594013314140334,54.95314538072769,54.23488124755298,43328,92879.36666666667,54.46808531921021,55.19235853234972,NaN,NaN,NaN,NaN,1.912360871381236,11.277046287810053,-3357887,-0.10495846947093967,0.339880244459863,0.44483871393080265
2022-07-29T09:30:00-04:00,53.93,54.78,53.01,53.52,NaN,NaN,NaN,57.0706595048541,NaN,NaN,53.51459999999981,58.3389867340923,48.69021326590732,51.27558934305502,53.77,53.77,53.77,85755,90390.16666666667,48.1718897289985,53.98821652389041,NaN,NaN,NaN,NaN,1.9464779519968618,11.216307309706384,-3443642,-0.16535102414112213,0.23814993375439997,0.4035009578955221
2022-07-29T13:30:00-04:00,53.55,54.6,53.55,54.54,NaN,NaN,NaN,57.0706595048541,NaN,NaN,53.5195999999998,58.347707637583284,48.69149236241631,50.98117717955521,53.87832262033182,54.073501039418716,53.68314420124493,26414,89916.33333333333,51.450910707830495,52.96012582372979,NaN,NaN,NaN,NaN,1.8845866697113716,11.15990683003869,-3417228,-0.1331205576126634,0.23710026087969283,0.3702208184923562
2022-08-01T09:30:00-04:00,53.9,56.42,53.37,55.33,NaN,NaN,NaN,57.0706595048541,NaN,NaN,53.507799999999804,58.315223076877054,48.700376923122555,51.31349656860535,55.040000000000006,55.040000000000006,55.040000000000006,54604,88500.13333333333,53.88444709325516,52.00173646364389,NaN,NaN,NaN,NaN,1.9678304790177026,10.549159683900976,-3362624,-0.05890000411648649,0.2965958133467481,0.3554958174632346
2022-08-01T13:30:00-04:00,55.09,55.63,54.77,55.44,NaN,NaN,NaN,57.0706595048541,NaN,NaN,53.483199999999805,58.23794573874274,48.72845426125687,51.31349656860535,55.10666084679179,55.21415472910894,54.99916696447464,20999,87242.23333333334,54.22848187425166,51.00906035288785,NaN,NaN,NaN,NaN,1.888699730516438,9.982037333915958,-3341625,-0.0055134080224137905,0.3486040574352174,0.3541174654576312
2022-08-02T09:30:00-04:00,54.55,58.05,54.55,57.53,50.29460521111022,50.29460521111022,50.29460521111022,NaN,NaN,NaN,53.5305999999998,58.39720195209061,48.66399804790899,52.68783780390742,56.709999999999994,56.71000095367431,56.70999904632568,185218,87280.53333333334,60.290141601895165,51.42819191815495,NaN,NaN,NaN,NaN,2.003792606908121,10.526799430169108,-3156407,0.15838779413953924,0.5521022081320552,0.393714413992516
2022-08-02T13:30:00-04:00,57.46,57.87,56.99,57.18,51.57757770151431,NaN,NaN,NaN,NaN,NaN,53.571999999999804,58.526073879151745,48.61792612084786,53.14027024312594,56.8875648941941,57.17308259531686,56.602047193071336,71636,87879.6,58.88377570134256,51.67865014403744,NaN,NaN,NaN,NaN,1.9235217064146835,11.03264994811846,-3228043,0.2268893409734033,0.6773260902092701,0.45043674923586685
2022-08-03T09:30:00-04:00,58.13,61.12,57.94,60.95,53.4063241696273,NaN,NaN,NaN,NaN,NaN,53.73819999999981,59.09708598871913,48.379314011280485,55.36621619450075,60.00333333333333,60.00333333333333,60.00333333333333,119169,85393.2,67.64002615297096,52.71543847296916,NaN,NaN,NaN,NaN,2.067555870242206,12.64095130229918,-3108874,0.4944169159933005,1.0684578942274925,0.574040978234192
2022-08-03T13:30:00-04:00,60.9,61.07,60.48,60.89,54.849218525553326,NaN,NaN,NaN,NaN,NaN,53.91379999999981,59.61240458709738,48.21519541290224,56.1719729556006,60.19537139942723,60.53985973697679,59.850883061877674,37033,85600.96666666666,67.39403415172879,53.82366656195419,NaN,NaN,NaN,NaN,1.9620161652249057,14.134373988324137,-3145907,0.6271173835709437,1.3579377076978716,0.7308203241269279
2022-08-04T09:30:00-04:00,62.16,63.28,60.72,61.8,55.99448131984636,NaN,NaN,NaN,NaN,NaN,54.13239999999982,60.17534174720271,48.08945825279693,58.08157836448048,61.93333333333333,61.933334287007646,61.933332379659014,103346,84247.03333333334,69.22225573151206,55.80275671993291,NaN,NaN,NaN,NaN,2.00472929628027,16.14946261108337,-3042561,0.7288282609845308,1.6418556503575914,0.9130273893730606
2022-08-04T13:30:00-04:00,61.75,61.8,61.24,61.73,55.99448131984636,NaN,NaN,NaN,NaN,NaN,54.341399999999815,60.690369062776234,47.992430937223396,58.08157836448048,61.82371334725342,61.983774753823006,61.66365194068383,48473,84532.26666666666,68.9022142506008,57.82216667165273,NaN,NaN,NaN,NaN,1.9015343465459646,18.02061633221694,-3091034,0.741581153813248,1.8400038316396206,1.0984226778263726
2022-08-05T09:30:00-04:00,60.13,63.21,59.68,61.99,55.99448131984636,NaN,NaN,NaN,NaN,NaN,54.59179999999982,61.13704644609246,48.04655355390718,58.08157836448048,61.626666666666665,61.626666666666665,61.626666666666665,136005,83733.96666666666,69.46688032422755,59.30784488266267,NaN,NaN,NaN,NaN,2.0178533217926815,18.76396728624093,-2955029,0.7172779931953284,1.995020169320533,1.2777421761252046
2022-08-05T13:30:00-04:00,62.02,62.19,61.32,61.81,55.99448131984636,NaN,NaN,NaN,NaN,NaN,54.84759999999982,61.500652905252316,48.19454709474733,58.08157836448048,61.661044079042426,61.72317469951104,61.59891345857381,41638,83516.33333333333,68.53901714484267,60.405650019413876,NaN,NaN,NaN,NaN,1.9358637988074896,19.45422174354892,-2996667,0.6413082342940843,2.07937746899281,1.4380692346987256
2022-08-08T09:30:00-04:00,62.67,64.78,62.42,63.17,57.59091737912813,NaN,NaN,NaN,NaN,NaN,55.11819999999982,61.99872868899532,48.23767131100431,59.54476649809121,63.45666666666667,63.45666666666667,63.45666666666667,195013,84608.83333333333,71.62307530497701,61.72608822054594,NaN,NaN,NaN,NaN,2.00973067032124,20.90516845924997,-2801654,0.6337548439227967,2.2302627896022216,1.596507945679425
2022-08-08T13:30:00-04:00,63.16,63.36,62.54,62.83,57.59091737912813,NaN,NaN,NaN,NaN,NaN,55.368399999999816,62.4399773176914,48.29682268230823,59.54476649809121,63.24923542408496,63.51450514634144,62.983965701828474,119244,85931.5,69.78139347572865,62.819895946011556,NaN,NaN,NaN,NaN,1.9247499081554373,22.252476123829513,-2920898,0.55954498513067,2.2959391770927624,1.7363941919620924
2022-08-09T09:30:00-04:00,61.71,61.93,59.08,59.21,57.59091737912813,NaN,NaN,NaN,NaN,NaN,55.491199999999814,62.61193775953647,48.37046224046316,59.54476649809121,60.07333333333334,60.07333333333334,60.07333333333334,89131,85125.23333333334,53.892199008831575,63.22848946599962,NaN,NaN,NaN,NaN,2.0551249147157633,21.53587382048701,-3010029,0.23684909317924419,2.0324555584361477,1.7956064652569035
2022-08-09T13:30:00-04:00,59.26,59.63,58.87,59.4,57.59091737912813,NaN,NaN,NaN,NaN,NaN,55.59499999999982,62.7889410617608,48.40105893823884,59.54476649809121,59.9133418757026,60.22659809785726,59.600085653547936,23250,84581,54.478084155652994,63.444716140844086,NaN,NaN,NaN,NaN,1.9626159922360664,20.768507644442792,-2986779,0.017928693656067862,1.8180173323269884,1.8000886386709205
2022-08-10T09:30:00-04:00,62.04,62.73,60.71,62.41,57.59091737912813,NaN,NaN,NaN,NaN,NaN,55.78159999999983,63.185857542798146,48.37734245720151,59.54476649809121,61.95,61.95,61.95,173445,85739.03333333334,62.588464012253084,64.06643163505822,NaN,NaN,NaN,NaN,2.0602862785049187,21.127640411455932,-2813334,0.05545388025972264,1.8694059889955739,1.8139521087358512
2022-08-10T13:30:00-04:00,62.37,62.99,62.22,62.96,57.59091737912813,NaN,NaN,NaN,NaN,NaN,55.983999999999824,63.60563237109248,48.362367628907165,59.54476649809121,62.103493779922,62.411943963902345,61.79504359594165,42951,85987.33333333333,63.85565450483274,64.75408682295686,NaN,NaN,NaN,NaN,1.9681229728974248,21.540433310953585,-2770383,0.09462921618014919,1.9322386289610378,1.8376094127808886
2022-08-11T09:30:00-04:00,64.12,65.72,62.18,62.56,57.80444536484443,NaN,NaN,NaN,NaN,NaN,56.13079999999982,63.96762878721258,48.29397121278706,60.107106148875616,63.48666666666668,63.48666666666668,63.48666666666668,106275,83460.06666666667,62.205416612949705,64.89089218088932,NaN,NaN,NaN,NaN,2.0803999034047513,22.67931363614943,-2876658,0.07194273812852758,1.927537835441548,1.8555950973130204
2022-08-11T13:30:00-04:00,62.6,62.67,61.25,61.47,57.80444536484443,NaN,NaN,NaN,NaN,NaN,56.242399999999826,64.2199931809089,48.26480681909075,60.107106148875616,63.03832578632875,63.78444008239109,62.2922114902664,38374,83184.26666666666,57.82032273195938,64.81493125450483,NaN,NaN,NaN,NaN,2.0332284817329835,23.24174645130564,-2915032,-0.03252642387809557,1.8149370674654008,1.8474634913434964
2022-08-12T09:30:00-04:00,62.28,63.25,61.25,63.22,57.80444536484443,NaN,NaN,NaN,NaN,NaN,56.38779999999983,64.60032340271148,48.175276597288175,60.107106148875616,62.57333333333333,62.57333333333333,62.57333333333333,93967,82705.8,62.40281984592655,64.44084508971594,NaN,NaN,NaN,NaN,2.030855018752056,23.926469180750868,-2821065,-0.0014626421527279554,1.8456351886525866,1.8470978308053145
2022-08-12T13:30:00-04:00,63.28,63.99,63.14,63.83,57.80444536484443,NaN,NaN,NaN,NaN,NaN,56.544599999999825,65.01604871672409,48.073151283275564,60.107106148875616,62.7213949701244,63.09285737662736,62.349932563621444,14929,82330.96666666666,63.87605016432731,64.18956051918725,NaN,NaN,NaN,NaN,1.946508231698338,24.76890013367965,-2806136,0.040173345131071514,1.897314512219154,1.8571411670880824
2022-08-15T09:30:00-04:00,63.4,64.52,62.98,63.83,57.910365450619445,NaN,NaN,NaN,NaN,NaN,56.76819999999982,65.40522420050372,48.13117579949592,60.10743867857945,63.776666666666664,63.77666734101624,63.776665992317085,87274,82567.26666666666,63.87605016432732,63.807688692959765,NaN,NaN,NaN,NaN,1.9174719294341709,25.69875783402133,-2806136,0.047232820679049325,1.916182192936894,1.8689493722578447
2022-08-15T13:30:00-04:00,63.84,64.22,63.54,63.93,58.21307611195492,NaN,NaN,NaN,NaN,NaN,57.00619999999983,65.76284765992581,48.24955234007385,60.34995094286356,63.7971883331117,63.8423708649076,63.752005801315796,18004,82009.93333333333,64.14318261329191,63.467757861723456,NaN,NaN,NaN,NaN,1.82908107733173,26.56219712719575,-2788132,0.03852445238513269,1.9171049377392606,1.878580485354128
2022-08-16T09:30:00-04:00,63.28,63.51,60.84,63.06,58.21307611195492,NaN,NaN,NaN,NaN,NaN,57.224999999999824,66.02893480212603,48.421065197873624,60.34995094286356,62.470000000000006,62.470000000000006,62.470000000000006,93881,81184.86666666667,59.98701903717802,62.79062491264849,NaN,NaN,NaN,NaN,1.9191467146651777,25.793028880711212,-2882013,-0.04160132682193307,1.8265788268267116,1.8681801536486446
2022-08-16T13:30:00-04:00,63.09,64.11,62.72,63.04,58.21307611195492,NaN,NaN,NaN,NaN,NaN,57.448999999999835,66.2634111544722,48.634588845527475,60.34995094286356,62.81760218702634,63.22282621511049,62.41237815894219,69080,81252.53333333334,59.89094661701315,62.172905589232094,NaN,NaN,NaN,NaN,1.8813505207605221,25.300103195227315,-2951093,-0.10794999777266412,1.7332426564328145,1.8411926542054786
2022-08-17T09:30:00-04:00,61.58,62.08,59.86,60.35,58.21307611195492,NaN,NaN,NaN,NaN,NaN,57.62439999999983,66.31280805672044,48.93599194327922,60.34995094286356,60.76333333333333,60.76333333333333,60.76333333333333,82752,81006.53333333334,48.61361533904992,60.529372734523015,NaN,NaN,NaN,NaN,1.9741111978490562,23.493241985073894,-3033845,-0.33233245972024283,1.425777079555175,1.7581095392754178
2022-08-17T13:30:00-04:00,60.44,61.56,60.11,60.17,58.21307611195492,NaN,NaN,NaN,NaN,NaN,57.80659999999983,66.31699045873235,49.29620954126732,60.34995094286356,60.6908401862409,60.7657982791218,60.61588209335999,77399,80686.56666666667,47.96280470502837,58.97090210804443,NaN,NaN,NaN,NaN,1.936674683716981,21.81544228993143,-3111244,-0.48306515172963715,1.1542780996133715,1.6373432513430086
2022-08-18T09:30:00-04:00,60.14,60.14,58.89,59.42,58.21307611195492,NaN,NaN,NaN,NaN,NaN,57.99679999999983,66.21274687422488,49.780853125774776,60.34995094286356,59.48333333333333,59.48333333333333,59.48333333333333,57192,78525.96666666666,45.244867121884546,58.35323554469107,NaN,NaN,NaN,NaN,1.889769349165768,20.777415838989473,-3168436,-0.6150090031670661,0.868581997384176,1.483591000551242
2022-08-18T13:30:00-04:00,59.45,59.86,59.29,59.6,58.21307611195492,NaN,NaN,NaN,NaN,NaN,58.189399999999836,66.08906218012412,50.289737819875555,60.34995094286356,59.512598428443034,59.55809638135525,59.46710047553082,23662,77870.43333333333,46.035256239528856,57.75017640782506,NaN,NaN,NaN,NaN,1.795500109939642,19.81353413454337,-3144774,-0.6675075013429241,0.6492066238725869,1.316714125215511
2022-08-19T09:30:00-04:00,57.78,57.89,55.93,55.97,NaN,NaN,NaN,62.736503269865636,62.736503269865636,62.736503269865636,58.28459999999983,65.9569860278331,50.61221397216656,60.34995094286356,56.596666666666664,56.596666666666664,56.596666666666664,91398,78058.53333333334,35.04782847453849,55.78298815513116,NaN,NaN,NaN,NaN,1.9293929592296677,20.168885506566475,-3236172,-0.9090830477095033,0.18036031557863197,1.0894433632881353
2022-08-19T13:30:00-04:00,55.98,56.23,55.8,55.99,NaN,NaN,NaN,61.63529857578084,NaN,NaN,58.37019999999982,65.8400985160505,50.900301483949136,60.34995094286356,56.39728753317059,56.67636037292519,56.11821469341599,46651,78733.1,35.13968131695623,53.731847213139986,NaN,NaN,NaN,NaN,1.8222934621418343,20.540787510919788,-3189521,-1.0214981784368906,-0.18742935975797792,0.8340688186789127
2022-08-22T09:30:00-04:00,54.68,55.64,53.96,54.1,NaN,NaN,NaN,60.44164864051807,NaN,NaN,58.376999999999825,65.83070055744726,50.923299442552384,60.34995094286356,54.56666666666666,54.56666666666666,54.56666666666666,132196,81319.5,30.718703827622292,51.48279629990231,NaN,NaN,NaN,NaN,1.8371296434174178,21.452873168456918,-3321717,-1.166628612900022,-0.624216947446115,0.5424116654539071
2022-08-22T13:30:00-04:00,54.08,54.27,53.88,54.24,NaN,NaN,NaN,59.51339188413089,NaN,NaN,58.41639999999983,65.76058056423481,51.07221943576485,59.70216860343268,54.4428588513721,54.639669346224274,54.24604835651993,52314,82363.33333333333,31.40711901682222,49.59613889167823,NaN,NaN,NaN,NaN,1.7337632403161738,22.32340754681931,-3269403,-1.1924475486093702,-0.9481477703078056,0.24429977830156452
2022-08-23T09:30:00-04:00,53.99,55.21,53.36,53.8,NaN,NaN,NaN,59.51339188413089,NaN,NaN,58.41539999999983,65.76208056744598,51.06871943255368,59.70216860343268,54.123333333333335,54.123333333333335,54.123333333333335,119237,80163.96666666666,30.3852241708571,47.30916777203041,NaN,NaN,NaN,NaN,1.7420658660078756,22.5686879366442,-3388640,-1.1764272929176607,-1.2262343378455114,-0.04980704492785071
2022-08-23T13:30:00-04:00,53.86,53.94,53.34,53.4,NaN,NaN,NaN,58.91785293574736,NaN,NaN,58.39339999999983,65.79324390106234,50.99355609893732,56.963734882746145,54.01007254388257,54.23585024789752,53.78429483986763,30006,78776.3,29.447199825573207,44.849964176405116,NaN,NaN,NaN,NaN,1.6604897327215984,22.80360612000594,-3418646,-1.1297888285711355,-1.4620430806417701,-0.3322542520706346
2022-08-24T09:30:00-04:00,53.62,55.21,53.45,54.36,NaN,NaN,NaN,58.91785293574736,NaN,NaN,58.33199999999982,65.81329828305834,50.8507017169413,56.74198790619692,54.339999999999996,54.339999999999996,54.339999999999996,60119,76807.96666666666,34.660618570398896,42.76314763398165,NaN,NaN,NaN,NaN,1.6711690375271986,22.262079643100346,-3358527,-0.9770372895153789,-1.5535508639648583,-0.5765135744494794
2022-08-24T13:30:00-04:00,54.35,54.53,54.2,54.26,NaN,NaN,NaN,58.91785293574736,NaN,NaN,58.261399999999824,65.82796329915296,50.69483670084669,55.97947225996602,54.33708332351486,54.341628624700434,54.33253802232929,24755,76398.7,34.37566577456603,40.63689643121552,NaN,NaN,NaN,NaN,1.5753712491323986,21.75923362883087,-3383282,-0.8312034771005976,-1.6155179208252264,-0.7843144437246288
2022-08-25T09:30:00-04:00,54.95,55.41,54.14,54.98,NaN,NaN,NaN,58.91785293574736,NaN,NaN,58.19239999999982,65.8142743731506,50.57052562684905,55.97947225996602,54.84333333333334,54.84333333333334,54.84333333333334,48222,74561.23333333334,38.308274263371004,39.08841466165787,NaN,NaN,NaN,NaN,1.5535590170515126,20.76895348403966,-3335060,-0.6431254459615019,-1.5882212511765061,-0.9450958052150042
2022-08-25T13:30:00-04:00,54.99,55.57,54.72,55.56,NaN,NaN,NaN,58.91785293574736,NaN,NaN,58.127799999999816,65.78299879820871,50.47260120179092,52.95057780797282,54.99521014108989,55.20439721209944,54.78602307008035,25419,73792.76666666666,41.35695865973807,37.764558378995375,NaN,NaN,NaN,NaN,1.5033048015478332,19.754629565452948,-3309641,-0.4458975780612717,-1.502467777791594,-1.0565701997303223
2022-08-26T09:30:00-04:00,55.67,55.69,52.41,52.78,NaN,NaN,NaN,58.91785293574736,NaN,NaN,58.07439999999981,65.84002493042865,50.30877506957097,52.67904795335333,53.626666666666665,53.626666666666665,53.626666666666665,202592,76012.33333333333,32.95148755381712,36.64583496576445,NaN,NaN,NaN,NaN,1.6302116014372738,19.88399896196308,-3512233,-0.46668484013102995,-1.6399262498941098,-1.17324140976308
2022-08-26T13:30:00-04:00,52.8,52.8,52.4,52.49,NaN,NaN,NaN,57.56310456566899,NaN,NaN,58.00859999999982,65.90551788991733,50.111682110082306,52.67904795335333,53.391016782442975,53.832654087205036,52.949379477680914,57680,76547.06666666667,32.21592111735198,35.521057566644714,NaN,NaN,NaN,NaN,1.5423393441917541,20.008317040969636,-3569913,-0.4630604073267417,-1.752066918921507,-1.2890065115947653
2022-08-29T09:30:00-04:00,51.425,53.21,51.42,52.41,NaN,NaN,NaN,57.29659981268404,NaN,NaN,57.95359999999982,65.96656425551092,49.940635744488716,52.67904795335333,52.34666666666667,52.34666666666667,52.34666666666667,104184,73519.43333333333,32.00368293824512,34.57525869638476,NaN,NaN,NaN,NaN,1.5600293910352003,20.533246065783505,-3674097,-0.42986807812771266,-1.8263416092544063,-1.3964735311266936
2022-08-29T13:30:00-04:00,52.42,52.72,51.86,51.87,NaN,NaN,NaN,57.162436184834775,NaN,NaN,57.89459999999982,66.04131291749576,49.74788708250387,52.67904795335333,52.29808846487424,52.38290515739105,52.21327177235743,34176,70683.83333333333,30.54108204715672,33.46853196835817,NaN,NaN,NaN,NaN,1.510027291675543,21.02068016025353,-3708273,-0.4082595300908405,-1.9067979437402442,-1.4985384136494038
2022-08-30T09:30:00-04:00,52.8,53.36,50.76,50.84,NaN,NaN,NaN,57.065507267342284,NaN,NaN,57.88219999999981,66.06983583948966,49.69456416050997,52.67904795335333,51.653333333333336,51.653333333333336,51.653333333333336,77970,70311.8,27.920061677801513,32.959405768591246,NaN,NaN,NaN,NaN,1.5878824851272901,21.924415442267293,-3786243,-0.4253843766849703,-2.0302688845056167,-1.6048845078206464
2022-08-30T13:30:00-04:00,50.82,51.76,50.82,51.67,NaN,NaN,NaN,56.196166027917634,NaN,NaN,57.893199999999815,66.04586968790565,49.74053031209398,52.67904795335333,51.577969650084356,51.68822565649353,51.46771364367518,36429,70751.1,32.916143568179564,32.800581643678626,NaN,NaN,NaN,NaN,1.541605164761055,22.763598204137217,-3749814,-0.34621846014559,-2.037657583002634,-1.691439122857044
2022-08-31T09:30:00-04:00,52.48,53.45,51.15,51.46,NaN,NaN,NaN,56.196166027917634,NaN,NaN,57.853599999999815,66.11096980884922,49.59623019115041,52.67904795335333,52.02,52.02,52.02,108063,68571.7,32.30601078423727,32.91396071200827,NaN,NaN,NaN,NaN,1.5957762244209799,22.26211484017542,-3857877,-0.2764306353635877,-2.0369774170615287,-1.760546781697941
2022-08-31T13:30:00-04:00,51.38,51.9,51.24,51.45,NaN,NaN,NaN,56.196166027917634,NaN,NaN,57.78319999999982,66.19626169239781,49.370138307601835,52.67904795335333,51.83293299541175,52.07098502342679,51.59488096739671,66731,69364.36666666667,32.27533105604097,32.97597585766675,NaN,NaN,NaN,NaN,1.5289350655337668,21.79645171649661,-3924608,-0.20278563580756015,-2.014028826457391,-1.811243190649831
2022-09-01T09:30:00-04:00,50.54,50.68,48.64,49.76,NaN,NaN,NaN,54.68195563340958,NaN,NaN,57.67919999999982,66.35378618264247,49.004613817357175,52.67904795335333,49.69333333333333,49.69333333333333,49.69333333333333,121849,69883.5,27.518998740217825,32.77124546976395,NaN,NaN,NaN,NaN,1.6204397037099265,22.52626987719519,-4046457,-0.2373351121287457,-2.107912080810763,-1.8705769686820175
2022-09-01T13:30:00-04:00,49.78,50.82,49.47,50.81,NaN,NaN,NaN,54.68195563340958,NaN,NaN,57.587399999999825,66.45159928476835,48.7232007152313,51.73723836268266,49.963112451181956,50.29306775157587,49.633157150788044,81457,71319.6,34.024373024707145,33.09818641255922,NaN,NaN,NaN,NaN,1.6011225820163604,23.099533260790142,-3965000,-0.16248631562649396,-2.073684863215135,-1.911198547588641
2022-09-02T09:30:00-04:00,51.84,51.84,49.83,49.87,NaN,NaN,NaN,54.68195563340958,NaN,NaN,57.514399999999824,66.56944691098224,48.45935308901741,49.625232552116906,50.51333333333333,50.51333333333333,50.51333333333333,205590,75040.36666666667,31.314684438291707,32.85919111740871,NaN,NaN,NaN,NaN,1.6303281118723352,22.886363971175953,-4170590,-0.14961931052590582,-2.0982226857460233,-1.9486033752201175
2022-09-02T13:30:00-04:00,49.88,50.18,49.65,50,NaN,NaN,NaN,54.68195563340958,NaN,NaN,57.42359999999982,66.68483254000726,48.16236745999238,49.625232552116906,50.40184635670379,50.62793976819665,50.17575294521094,49989,76209.03333333334,32.11982624593996,32.69805972250685,NaN,NaN,NaN,NaN,1.551733246738597,22.773815281482133,-4120601,-0.10764988819966481,-2.0831657354696986,-1.9755158472700338
2022-09-06T09:30:00-04:00,50.06,50.18,48.58,49.21,NaN,NaN,NaN,54.246283995035895,NaN,NaN,57.301199999999824,66.82784191833026,47.77455808166938,49.42218604169352,49.32333333333333,49.32333333333333,49.32333333333333,138861,77928.6,29.83133335317497,32.09256394320713,NaN,NaN,NaN,NaN,1.5551808719715543,23.16071420714612,-4259462,-0.10810663587512703,-2.1106491421139424,-2.0025425062388154
2022-09-06T13:30:00-04:00,49.19,49.71,49.07,49.13,NaN,NaN,NaN,54.12236199526154,NaN,NaN,57.17499999999983,66.9605789813422,47.38942101865746,49.42174883335482,49.31736146819885,49.326514289023734,49.30820864737396,59114,79298.93333333333,29.60132946566634,31.25287614363058,NaN,NaN,NaN,NaN,1.489810809687872,23.519977495262687,-4318576,-0.0895744033068544,-2.1145105103723836,-2.024936107065529
2022-09-07T09:30:00-04:00,48.7,49.86,48.64,49.71,NaN,NaN,NaN,53.93361826820419,NaN,NaN,57.01859999999982,67.02398495811563,47.01321504188401,49.403519253347085,49.403333333333336,49.403333333333336,49.403333333333336,155898,81366.16666666667,33.59859040804784,31.299097776075634,NaN,NaN,NaN,NaN,1.470538608995881,24.054404076136603,-4162678,-0.017787919749939984,-2.0471710067529543,-2.0293830870030143
2022-09-07T13:30:00-04:00,49.7,50.85,49.7,50.79,NaN,NaN,NaN,53.93361826820419,NaN,NaN,56.890799999999814,67.04678096887194,46.734819031127685,49.403519253347085,49.80968378043209,50.31844529687736,49.30092226398682,99452,82378.56666666667,40.386318415003124,31.882697583050714,NaN,NaN,NaN,NaN,1.4476429940676037,23.722662933419496,-4063226,0.11556350470683752,-1.8849287061194673,-2.000492210826305
2022-09-08T09:30:00-04:00,49.88,51.79,49.66,51.47,NaN,NaN,NaN,53.93361826820419,NaN,NaN,56.701199999999815,66.9008467703588,46.50155322964083,48.33281540267767,50.97333333333333,50.97333333333333,50.97333333333333,83920,82417.5,44.250503521310634,32.75747048184111,NaN,NaN,NaN,NaN,1.4963827802056322,22.70691647881961,-3979306,0.25472168125535544,-1.6820901092571106,-1.936811790512466
2022-09-08T13:30:00-04:00,51.48,52.075,51.26,52.07,NaN,NaN,NaN,53.93361826820419,NaN,NaN,56.52479999999982,66.73364341343743,46.31595658656221,48.77688641855264,51.22121013107097,51.60052755391024,50.8418927082317,35837,81032.1,47.48511005495725,33.96775819668401,NaN,NaN,NaN,NaN,1.447712581619516,21.557411397826357,-3943469,0.3845385406149384,-1.456138614743793,-1.8406771553587313
2022-09-09T09:30:00-04:00,53.33,54.85,53.25,54.79,49.27541025878261,49.27541025878261,49.27541025878261,NaN,NaN,NaN,56.38459999999982,66.49184509251093,46.277354907488714,50.82150913484211,54.29666666666666,54.29666666666666,54.29666666666666,143224,83899.83333333333,59.0769180837665,36.193247939967215,NaN,NaN,NaN,NaN,1.5428759686466935,21.195115757478984,-3800245,0.6361122352273054,-1.0455368613245994,-1.6816490965519049
2022-09-09T13:30:00-04:00,54.81,54.915,54.33,54.74,49.98516433792886,NaN,NaN,NaN,NaN,NaN,56.24479999999981,66.24523698245682,46.24436301754281,51.39970730787368,54.402206761860796,54.56768613535632,54.236727388365274,58259,85053.06666666667,58.81989109968367,38.04351562078894,NaN,NaN,NaN,NaN,1.474456256600501,20.89112373432892,-3858504,0.7725880893455586,-0.7159139848699567,-1.4885020742155153
2022-09-12T09:30:00-04:00,55.19,56.24,54.95,55.75,50.963906868023,NaN,NaN,NaN,NaN,NaN,56.11999999999982,65.98536567999828,46.25463432000136,52.67776584629895,55.64666666666667,55.64666666666667,55.64666666666667,86554,84891.6,62.38039280911021,40.191685765422726,NaN,NaN,NaN,NaN,1.4762808097004654,21.241327297499986,-3771950,0.8956543961818719,-0.36893407898817543,-1.2645884751700474
2022-09-12T13:30:00-04:00,55.83,56.21,55.61,56.18,51.4075929194765,NaN,NaN,NaN,NaN,NaN,56.00739999999982,65.7380179125525,46.276782087447145,53.06021267703916,55.76662484865135,55.93394268654144,55.59930701076125,44490,84819.56666666667,63.81484446671986,42.44450815189979,NaN,NaN,NaN,NaN,1.4136893232932892,21.566516320444542,-3727460,0.964808896850778,-0.05857735410657483,-1.0233862509573528
2022-09-13T09:30:00-04:00,52.71,53.62,52.23,53.09,51.4075929194765,NaN,NaN,NaN,NaN,NaN,55.80579999999982,65.35038094627963,46.261219053720005,53.06021267703916,52.98,52.98,52.98,128115,84683.53333333334,49.27465774126969,43.99848379483206,NaN,NaN,NaN,NaN,1.594854371629483,20.338027570747577,-3855575,0.7697101573868748,-0.0612485542237593,-0.8309587116106341
2022-09-13T13:30:00-04:00,53.08,53.21,52.05,52.26,51.4075929194765,NaN,NaN,NaN,NaN,NaN,55.59439999999982,64.97410844749903,46.21469155250062,53.06021267703916,52.78121731545284,53.014832201559116,52.54760242934657,92759,86031.7,46.22777621747476,44.870155451458324,NaN,NaN,NaN,NaN,1.56379334508452,19.289945624606347,-3948334,0.5616835998346742,-0.1288542118172913,-0.6905378116519655
2022-09-14T09:30:00-04:00,52.23,53.5,51.41,53.27,51.4075929194765,NaN,NaN,NaN,NaN,NaN,55.475599999999815,64.81952308187991,46.13167691811972,53.06021267703916,52.72666666666667,52.72666666666667,52.72666666666667,75495,84573.63333333333,50.258463559508954,46.22328253154527,NaN,NaN,NaN,NaN,1.6013795347213404,18.649425459533912,-3872839,0.472603543136223,-0.09978338273168674,-0.5723869258679097
2022-09-14T13:30:00-04:00,53.28,53.49,52.63,53.46,51.4075929194765,NaN,NaN,NaN,NaN,NaN,55.356799999999815,64.64902164178659,46.06457835821305,53.06021267703916,52.91283174097665,53.1413478230914,52.6843156588619,50105,85243.6,51.00252993805235,47.57204708098186,NaN,NaN,NaN,NaN,1.548423853669816,18.054656734823794,-3822734,0.4093389291630384,-0.060713264414111734,-0.4700521935771501
2022-09-15T09:30:00-04:00,52.73,55.51,52.73,55.05,51.4075929194765,NaN,NaN,NaN,NaN,NaN,55.20959999999981,64.2807868771451,46.138413122854516,53.06021267703916,54.43,54.43,54.43,140315,87916.8,56.82317828371217,49.500036004591664,NaN,NaN,NaN,NaN,1.6363935784076864,17.233935531294467,-3682419,0.45398313329051543,0.0974267230359942,-0.3565564102545212
2022-09-15T13:30:00-04:00,55.03,55.04,53.61,54.12,51.4075929194765,NaN,NaN,NaN,NaN,NaN,55.03279999999982,63.833418196472614,46.23218180352702,53.06021267703916,54.369924746905596,54.45241115690439,54.2874383369068,74427,89572.53333333334,52.86719470992056,51.161883522038394,NaN,NaN,NaN,NaN,1.62236546566428,16.471837270874374,-3756846,0.40206693889824824,0.14602726336828908,-0.25603967552995915
2022-09-16T09:30:00-04:00,52.6,52.85,51.7,51.72,51.4075929194765,NaN,NaN,NaN,NaN,NaN,54.815999999999825,63.39551886763368,46.23648113236597,53.06021267703916,52.089999999999996,52.090000674349575,52.08999932565042,119094,91934.93333333333,44.296577357172445,51.92602544697586,NaN,NaN,NaN,NaN,1.6793393609739742,15.920435403723562,-3875940,0.19762173240157827,-0.009012510027986309,-0.20663424242956457
2022-09-16T13:30:00-04:00,51.77,52.14,51.46,51.87,51.4075929194765,NaN,NaN,NaN,NaN,NaN,54.62399999999982,63.02715083763753,46.22084916236211,53.06021267703916,51.977794249251005,52.10944303591925,51.84614546258276,86514,93971.43333333333,44.89783307378492,52.24827649403171,NaN,NaN,NaN,NaN,1.6079579780472617,15.532769277108379,-3789426,0.07057627448225995,-0.11841389932673962,-0.18899017380899957
2022-09-19T09:30:00-04:00,51.17,51.77,50.69,51.22,NaN,NaN,NaN,56.021804621433944,56.021804621433944,56.021804621433944,54.383999999999816,62.47091684142285,46.29708315857678,53.06021267703916,51.22666666666667,51.22666666666667,51.22666666666667,90190,90224.7,42.74472114551921,52.14072061004661,NaN,NaN,NaN,NaN,1.5773895510438858,15.568177697160705,-3879616,-0.0525115763340836,-0.25462964422660406,-0.20211806789252046
2022-09-19T13:30:00-04:00,51.19,51.985,50.98,51.94,NaN,NaN,NaN,56.021804621433944,NaN,NaN,54.14619999999981,61.79549580027402,46.4969041997256,50.96915769001219,51.363720243576054,51.556541043699774,51.170899443452335,45565,89820.86666666667,45.8428592733495,52.02341698278891,NaN,NaN,NaN,NaN,1.5365045831121797,15.449750384903243,-3834051,-0.0791165232223762,-0.3010137219204907,-0.2218971986981145
2022-09-20T09:30:00-04:00,51.3,51.7,50.55,50.68,NaN,NaN,NaN,55.81144801250489,NaN,NaN,53.8831999999998,61.07306335336722,46.69333664663239,50.96915769001219,50.97666666666667,50.97666666666667,50.97666666666667,95008,89515,41.600508155682,50.77510198792573,NaN,NaN,NaN,NaN,1.5260399700327383,15.572435563451084,-3929059,-0.1700318316334813,-0.4344369882399661,-0.26440515660648484
2022-09-20T13:30:00-04:00,50.64,50.79,50.21,50.33,NaN,NaN,NaN,55.05251855739103,NaN,NaN,53.611199999999805,60.26951527040377,46.95288472959584,50.96915769001219,50.77081302914755,51.03045294633419,50.51117311196091,59722,90366.53333333334,40.47989310181798,49.46510213093533,NaN,NaN,NaN,NaN,1.4584656864589711,15.871022067713145,-3988781,-0.23802808703874329,-0.5619402654049139,-0.32391217836617064
2022-09-21T09:30:00-04:00,50.5,51.06,49.88,50.57,NaN,NaN,NaN,54.97649498660053,NaN,NaN,53.36139999999981,59.499892336077984,47.22290766392164,50.96915769001219,50.50333333333333,50.50333333333333,50.50333333333333,79617,90421.43333333333,41.64079380268051,47.983702201904634,NaN,NaN,NaN,NaN,1.4385752802833305,16.32936926495237,-3909164,-0.2498997121580438,-0.6362868185637254,-0.3863871064056816
2022-09-21T13:30:00-04:00,50.69,51.99,49.37,49.39,NaN,NaN,NaN,54.97649498660053,NaN,NaN,53.08839999999981,58.669682089277465,47.50711791072215,50.96915769001219,50.304714243861156,50.408960554570655,50.20046793315166,289019,98841.1,37.74296440048444,46.12142505431638,NaN,NaN,NaN,NaN,1.5229627602630929,15.990732349483828,-4198183,-0.3160226867507476,-0.7814154648441161,-0.4653927780933685
2022-09-22T09:30:00-04:00,49.08,49.48,47.16,47.26,NaN,NaN,NaN,53.08352125845213,NaN,NaN,52.82659999999981,58.24653595534967,47.40666404464994,50.68732615200975,47.96666666666666,47.96666666666666,47.96666666666666,134087,99708.56666666667,31.932407372739576,44.88269288513566,NaN,NaN,NaN,NaN,1.579893991672872,16.83160600194058,-4332270,-0.47258958157776076,-1.0561297550655695,-0.5835401734878087
2022-09-22T13:30:00-04:00,47.31,47.76,47.01,47.15,NaN,NaN,NaN,52.03427029215886,NaN,NaN,52.56619999999981,57.79767534067501,47.33472465932461,48.39052479186319,47.72481146710892,48.04282167787959,47.406801256338255,77556,100069.4,31.66132046159855,43.84223175971592,NaN,NaN,NaN,NaN,1.520615849410524,17.68050495580148,-4409826,-0.5476486699132377,-1.2681010108793558,-0.7204523409661181
2022-09-23T09:30:00-04:00,46.49,47.07,45.45,45.66,NaN,NaN,NaN,50.929758006151644,NaN,NaN,52.290999999999805,57.49898195082245,47.08301804917716,48.39052479186319,46.06,46.06,46.06,132621,100428.46666666666,28.172486265366317,42.26466195299145,NaN,NaN,NaN,NaN,1.5334290030240576,19.124390993661493,-4542447,-0.6545056967403307,-1.5385844618915314,-0.8840787651512008
2022-09-23T13:30:00-04:00,45.69,46.21,45.26,46.13,NaN,NaN,NaN,50.322041733144744,NaN,NaN,52.02159999999981,57.08081790004033,46.962382099959285,48.39052479186319,46.001673327471124,46.09041164666838,45.91293500827387,57296,99623.1,30.76414975012642,40.81906336813961,NaN,NaN,NaN,NaN,1.4917555028080538,20.5388190581776,-4485151,-0.6491170615080031,-1.6954750920362045,-1.0463580305282014
2022-09-26T09:30:00-04:00,46.15,47.59,45.7,45.94,NaN,NaN,NaN,50.322041733144744,NaN,NaN,51.82099999999981,57.03122110856038,46.610778891439246,48.39052479186319,46.410000000000004,46.410000000000004,46.410000000000004,121832,96831.16666666667,30.28837199497245,38.923720061801056,NaN,NaN,NaN,NaN,1.5202015383217642,20.711298618528176,-4606983,-0.6142976900534525,-1.814230143095017,-1.1999324530415645
2022-09-26T13:30:00-04:00,45.94,46.34,45.58,45.61,NaN,NaN,NaN,50.322041733144744,NaN,NaN,51.61339999999982,56.967808441656736,46.258991558342906,48.19426295474717,46.25848293515016,46.50928614314637,46.007679727153956,44465,96647.03333333334,29.436850566019586,37.250124051522405,NaN,NaN,NaN,NaN,1.4659014284416385,20.93007989549632,-4651448,-0.5703913565300334,-1.9129216487041063,-1.342530292174073
2022-09-27T09:30:00-04:00,47.1,47.8,45.72,45.9,NaN,NaN,NaN,50.322041733144744,NaN,NaN,51.44939999999981,56.98825245877576,45.91054754122386,48.19426295474717,46.47333333333333,46.47333333333333,46.47333333333333,141036,96719.53333333334,31.265634182992358,36.31934239622383,NaN,NaN,NaN,NaN,1.5176227549815213,20.050426131463336,-4510412,-0.4822241449338509,-1.9453104733413866,-1.4630863284075357
2022-09-27T13:30:00-04:00,45.89,46.55,45.86,46.5,NaN,NaN,NaN,50.322041733144744,NaN,NaN,51.29459999999982,56.94435781428577,45.64484218571386,48.19426295474717,46.43335144554226,46.5054511651944,46.361251725890114,43370,96194.73333333334,35.018083358252866,35.61364598797154,NaN,NaN,NaN,NaN,1.4585068439114124,19.233604779146994,-4467042,-0.3500543812049435,-1.900654304913715,-1.5505999237087715
2022-09-28T09:30:00-04:00,46.5,47.78,46.36,47.54,NaN,NaN,NaN,50.322041733144744,NaN,NaN,51.169399999999825,56.8687563285762,45.470043671423454,48.19426295474717,47.22666666666667,47.22666666666667,47.22666666666667,115464,94846.93333333333,41.027812498578825,35.49100965604723,NaN,NaN,NaN,NaN,1.4557563550605972,18.073594283140082,-4351578,-0.16835561086192152,-1.7610444372861735,-1.592688826424252
2022-09-28T13:30:00-04:00,47.61,48.46,47.36,48.19,NaN,NaN,NaN,50.322041733144744,NaN,NaN,51.06519999999982,56.78807793335513,45.342322066644506,45.28341036379773,47.40212363374698,47.72691037988785,47.077336887606116,33697,92655.1,44.48361010794641,35.39392042994701,NaN,NaN,NaN,NaN,1.4303451868419832,17.410968518718484,-4317881,0.010356859109249328,-1.5797427525376904,-1.5900996116469397
2022-09-29T09:30:00-04:00,47.02,47.16,45.33,45.74,NaN,NaN,NaN,50.322041733144744,NaN,NaN,50.892799999999816,56.72654739255011,45.05905260744952,45.16630679368058,46.076666666666654,46.07666734101623,46.076665992317075,99531,93175.46666666666,35.93562628827095,34.98928601084622,NaN,NaN,NaN,NaN,1.5324633877818417,16.79253509528859,-4417412,-0.020029192334290347,-1.6151361020648025,-1.5951069097305122
2022-09-29T13:30:00-04:00,45.62,45.9,45.27,45.77,NaN,NaN,NaN,50.08912611198422,NaN,NaN,50.72299999999982,56.648342521752014,44.79765747824763,45.16630679368058,45.91558823652616,46.12371671680693,45.70745975624539,59617,93968.13333333333,36.09755393412462,34.676261784582415,NaN,NaN,NaN,NaN,1.4680017172259954,16.251569110638094,-4357795,-0.021567802213177334,-1.6220666624969837,-1.6004988602838064
2022-09-30T09:30:00-04:00,45.53,47.52,45.34,46.68,NaN,NaN,NaN,50.08912611198422,NaN,NaN,50.55699999999982,56.46101253386905,44.65298746613058,45.16630679368058,46.51333333333335,46.51333333333335,46.51333333333335,99532,92511.73333333334,40.971399095455595,34.62844787692349,NaN,NaN,NaN,NaN,1.5188587374241387,15.44113649079064,-4258263,0.051263963428635595,-1.536418905998012,-1.5876828694266476
2022-09-30T13:30:00-04:00,46.64,46.64,45.57,45.62,NaN,NaN,NaN,50.08912611198422,NaN,NaN,50.35819999999981,56.24435282167268,44.472047178326946,45.16630679368058,46.253284982981775,46.537190627834654,45.969379338128896,83507,93353.33333333333,37.393714811562155,34.60350147771475,NaN,NaN,NaN,NaN,1.4896545418938432,14.688591915218005,-4341770,0.041054039486400296,-1.5363653200686471,-1.5774193595550474
2022-10-03T09:30:00-04:00,45.84,46.05,44.59,45.93,NaN,NaN,NaN,49.851858745594086,NaN,NaN,50.22119999999982,56.193739346047444,44.24866065395219,45.16630679368058,45.52333333333333,45.52333333333333,45.52333333333333,151732,95525.93333333333,39.069417853734144,35.113287940642934,NaN,NaN,NaN,NaN,1.487536360329997,13.91232948846875,-4190038,0.06666704335173934,-1.4940855553653734,-1.5607525987171127
2022-10-03T13:30:00-04:00,45.94,46.63,45.9,46.14,NaN,NaN,NaN,49.851858745594086,NaN,NaN,50.094199999999816,56.137990982494706,44.050409017504926,45.16630679368058,45.69336307207153,45.99354752380373,45.39317862033933,48680,95665.6,40.23638404332471,35.72579248219481,NaN,NaN,NaN,NaN,1.4334266203064259,13.019044506560611,-4141358,0.10685677431640994,-1.4271816308216003,-1.5340384051380103
2022-10-04T09:30:00-04:00,47.99,49.89,47.99,48.92,44.20438077105993,44.20438077105993,44.20438077105993,NaN,NaN,NaN,50.024399999999815,56.04014488821495,44.008655111784684,45.35635335049808,48.93333333333334,48.93333333333334,48.93333333333334,239722,99385.83333333333,53.05456731416338,37.50308398568031,NaN,NaN,NaN,NaN,1.5988961474273953,13.834514455679559,-3901636,0.3178439511290756,-1.1367334662266657,-1.4545774173557413
2022-10-04T13:30:00-04:00,48.99,49.58,48.96,49.56,44.65963619055721,NaN,NaN,NaN,NaN,NaN,49.978199999999816,55.9719803630168,43.984419636982835,45.62308268039847,49.03709961928934,49.22202649262078,48.85217274595791,75478,98809.8,55.42486109520048,39.26456336747132,NaN,NaN,NaN,NaN,1.5318321368968668,14.591736551290008,-3826158,0.48752913042693935,-0.845166004322067,-1.3326951347490064
2022-10-05T09:30:00-04:00,48.38,48.76,47.28,48.68,44.65963619055721,NaN,NaN,NaN,NaN,NaN,49.93499999999982,55.93444564106412,43.93555435893551,45.62308268039847,48.24,48.24,48.24,148337,101237.86666666667,51.56930116150711,40.7846297365095,NaN,NaN,NaN,NaN,1.5852726985470906,14.20605187704887,-3974495,0.5243178138368283,-0.677297867452971,-1.2016156812897993
2022-10-05T13:30:00-04:00,48.65,49.12,48.34,48.8,44.65963619055721,NaN,NaN,NaN,NaN,NaN,49.87759999999981,55.864453009727754,43.890746990271865,45.62308268039847,48.33075597732086,48.52659116552475,48.134920789116975,31858,100629.63333333333,52.059049244850954,42.40050107071175,NaN,NaN,NaN,NaN,1.527753220079441,14.026238350445002,-3942637,0.5385036621436805,-0.5284861036101987,-1.0669897657538792
2022-10-06T09:30:00-04:00,48.8,49.96,47.98,49,44.65963619055721,NaN,NaN,NaN,NaN,NaN,49.82839999999981,55.8028474020687,43.85395259793092,45.90245833236402,48.98,48.98,48.98,136626,100506.66666666667,52.91368323642932,43.946790288814384,NaN,NaN,NaN,NaN,1.5600565615023385,14.266882192218503,-3806011,0.5416569000196814,-0.3899186407292774,-0.9315755407489588
2022-10-06T13:30:00-04:00,48.98,49.11,48.42,48.71,44.65963619055721,NaN,NaN,NaN,NaN,NaN,49.7735999999998,55.73780222327262,43.80939777672699,45.90245833236402,48.923995119852854,49.023650820980336,48.82433941872537,43150,99464.1,51.48060517142201,45.12268470404075,NaN,NaN,NaN,NaN,1.4979096642521714,14.490337188151035,-3849161,0.5052246125631425,-0.3000447750450306,-0.8052693876081731
2022-10-07T09:30:00-04:00,47.61,47.61,45.72,45.99,44.65963619055721,NaN,NaN,NaN,NaN,NaN,49.69819999999981,55.75577402266677,43.640625977332846,45.90245833236402,46.44,46.44,46.44,99983,98827.06666666667,40.42250202662772,45.079448241758534,NaN,NaN,NaN,NaN,1.6044875453770164,13.840606769824538,-3949144,0.28966229327182513,-0.44319152101839165,-0.7328538142902168
2022-10-07T13:30:00-04:00,45.98,46.02,45.66,45.92,44.65963619055721,NaN,NaN,NaN,NaN,NaN,49.60039999999981,55.74035434511412,43.4604456548855,45.90245833236402,46.249605105526385,46.51962274135146,45.97958746970131,49711,97600.3,40.18328272106739,44.7722819998386,NaN,NaN,NaN,NaN,1.5155955778500871,13.26853430009125,-3998855,0.14158148348674382,-0.555876959931787,-0.6974584434185308
2022-10-10T09:30:00-04:00,45.92,45.92,43.88,44.17,NaN,NaN,NaN,49.55099480874035,49.55099480874035,49.55099480874035,49.48639999999981,55.81098537455892,43.161814625440705,45.90245833236402,44.65666666666667,44.65666666666667,44.65666666666667,80114,97264.43333333333,34.66077869344987,44.681221457351384,NaN,NaN,NaN,NaN,1.5530530365750808,13.603145885673964,-4078969,-0.06397695078657839,-0.7774296319017537,-0.7134526811151753
2022-10-10T13:30:00-04:00,44.19,44.8,44.19,44.39,NaN,NaN,NaN,49.020495044706685,NaN,NaN,49.37419999999981,55.85546418533339,42.89293581466623,45.90245833236402,44.579900411190685,44.67583948350742,44.483961338873954,51293,97455.36666666667,35.8542927592723,44.66384565914764,NaN,NaN,NaN,NaN,1.4871206768197176,13.913856643715055,-4027676,-0.16891891963583405,-0.9246013306599679,-0.7556824110241338
2022-10-11T09:30:00-04:00,44.1,44.75,42.24,43.92,NaN,NaN,NaN,48.15706345176548,NaN,NaN,49.26839999999981,55.927207532891046,42.60959246710857,45.90245833236402,43.63666666666668,43.63666666666668,43.63666666666668,97834,97549.56666666667,34.4082663039443,44.195050459753986,NaN,NaN,NaN,NaN,1.560183485618309,15.02610689056096,-4125510,-0.2489443934542338,-1.066862902841926,-0.8179185093876923
2022-10-11T13:30:00-04:00,43.85,44.08,42.93,43.46,NaN,NaN,NaN,48.111969658503405,NaN,NaN,49.15499999999981,56.00961508766799,42.30038491233163,45.90245833236402,43.58060133649041,43.65187260590614,43.50933006707468,60541,97576.86666666667,33.00524986298835,43.881588677713,NaN,NaN,NaN,NaN,1.5308846652170012,16.05891069120359,-4186051,-0.3079520520595078,-1.202858574462077,-0.8949065224025692
2022-10-12T09:30:00-04:00,43.46,44.11,42.54,43.88,NaN,NaN,NaN,47.936652855844166,NaN,NaN,49.03839999999981,56.04787742417958,42.02892257582004,45.90245833236402,43.51,43.51,43.51,82947,97687.86666666667,35.587774173444814,43.63289984340661,NaN,NaN,NaN,NaN,1.5336786177015012,17.17696939648613,-4103104,-0.2938314431238288,-1.2621958263073552,-0.9683643831835264
2022-10-12T13:30:00-04:00,43.78,44.15,43.63,44.01,NaN,NaN,NaN,47.936652855844166,NaN,NaN,48.90279999999981,56.032776201929636,41.77282379806998,45.90245833236402,43.65590075452993,43.85587897016885,43.45592253889101,44152,89525.63333333333,36.4049317833508,43.35922468197991,NaN,NaN,NaN,NaN,1.4612730021513938,18.18247163242741,-4058952,-0.25245309968931373,-1.2839307577951686,-1.031477658105855
2022-10-13T09:30:00-04:00,41.67,44.24,41.02,44.2,NaN,NaN,NaN,47.338716755015035,NaN,NaN,48.757399999999805,55.96809074084337,41.54670925915624,45.51896666589121,43.153333333333336,43.153333333333336,43.153333333333336,295479,94905.36666666667,37.649931885021665,42.258893579898356,NaN,NaN,NaN,NaN,1.5868963591405798,20.079936605996213,-3763473,-0.19175480596903904,-1.2711711655671536,-1.0794163595981145
2022-10-13T13:30:00-04:00,44.22,44.4,43.705,43.91,NaN,NaN,NaN,47.338716755015035,NaN,NaN,48.59419999999981,55.86671273220481,41.32168726779481,43.242173332712966,43.30514318372069,43.63109587748528,42.979190489956096,64094,94456.63333333333,36.47615885061562,40.90541484814229,NaN,NaN,NaN,NaN,1.5231894763448242,21.709612534019136,-3827567,-0.15232447719695186,-1.2698219560943045,-1.1174974788973526
2022-10-14T09:30:00-04:00,44.82,45.31,42.07,42.24,NaN,NaN,NaN,47.338716755015035,NaN,NaN,48.343199999999804,55.609318017213994,41.077081982785614,42.34573866617038,43.20666666666667,43.20666666666667,43.20666666666667,209047,97004.16666666667,30.5664271138359,39.40520955902292,NaN,NaN,NaN,NaN,1.645818799463051,23.726221456543232,-4036614,-0.21601269758795882,-1.3875133508823012,-1.1715006532943424
2022-10-14T13:30:00-04:00,42.23,42.46,41.62,41.69,NaN,NaN,NaN,46.75799688844799,NaN,NaN,48.08219999999981,55.34798754438094,40.816412455618675,41.9605909329363,43.07147459435709,43.46545377703308,42.6774954116811,24615,95914.8,28.905429540289447,37.75137958012567,NaN,NaN,NaN,NaN,1.5882603137871192,25.724952080499335,-4061229,-0.26902686499497763,-1.5077842345380645,-1.238757369543087
2022-10-17T09:30:00-04:00,43.76,45.22,43.51,44.84,NaN,NaN,NaN,46.75799688844799,NaN,NaN,47.86399999999981,54.84530073840678,40.88269926159285,41.31747274634904,44.52333333333333,44.52333333333333,44.52333333333333,208255,98795.56666666667,46.752166128588776,37.31127121527992,NaN,NaN,NaN,NaN,1.7269560056594677,25.532715987697586,-3852974,-0.07583312975593826,-1.3335487817380098,-1.2577156519820716
2022-10-17T13:30:00-04:00,44.85,45.05,44.57,44.8,NaN,NaN,NaN,46.75799688844799,NaN,NaN,47.63639999999981,54.25077314944371,41.02202685055591,40.82499683690457,44.575687079676506,44.68565365054121,44.4657205088118,47203,98886.83333333333,46.592221405272234,36.962100946269224,NaN,NaN,NaN,NaN,1.637887719540934,25.354211044381675,-3900177,0.05814590564702682,-1.185033269923288,-1.2431791755703148
2022-10-18T09:30:00-04:00,46.86,47,44.66,45.41,40.90639752217159,40.90639752217159,40.90639752217159,NaN,NaN,NaN,47.48279999999981,53.93824488320281,41.02735511679681,42.396583656650805,45.69,45.69,45.69,149367,99164.53333333334,49.43332521421137,37.60573117395377,NaN,NaN,NaN,NaN,1.6880385967165819,24.009912229333512,-3750810,0.1893358671472325,-1.0065093416362743,-1.1958452087835068
2022-10-18T13:30:00-04:00,45.43,45.64,44.89,45.45,40.90639752217159,NaN,NaN,NaN,NaN,NaN,47.34659999999981,53.67932593438796,41.01387406561166,42.396583656650805,45.61375793067209,45.7617053269094,45.46581053443477,39667,99041.1,49.622574129993076,38.279966274591324,NaN,NaN,NaN,NaN,1.6210358398082545,22.76163475821736,-3711143,0.27509289347955,-0.8519790919340693,-1.1270719854136193
2022-10-19T09:30:00-04:00,44.87,45.36,43.69,43.72,40.90639752217159,NaN,NaN,NaN,NaN,NaN,47.1555999999998,53.33643639648189,40.97476360351771,42.396583656650805,44.25666666666666,44.25666666666666,44.25666666666666,97768,98451.23333333334,42.256539906940134,38.822520646983484,NaN,NaN,NaN,NaN,1.6309618512505224,22.185689905411092,-3808911,0.2142936538966731,-0.8592049180427779,-1.073498571939451
2022-10-19T13:30:00-04:00,43.75,44.14,43.67,43.98,40.90639752217159,NaN,NaN,NaN,NaN,NaN,46.9659999999998,52.939781382012185,40.99221861798742,42.396583656650805,44.1792200286123,44.318148979345544,44.040291077879054,30382,98340.73333333334,43.6112879930579,39.376591735111035,NaN,NaN,NaN,NaN,1.5480360047326278,21.66042184958635,-3778529,0.19133171512252556,-0.834333928036294,-1.0256656431588196
2022-10-20T09:30:00-04:00,43.72,45.79,43.55,44.64,40.90639752217159,NaN,NaN,NaN,NaN,NaN,46.757799999999804,52.30012917103189,41.21547082896772,42.396583656650805,44.660000000000004,44.660000000000004,44.660000000000004,176636,100910.9,47.009930627417,40.27671061535908,NaN,NaN,NaN,NaN,1.597462004394583,20.171193199897626,-3601893,0.2183801480841815,-0.7526904580535927,-0.9710706061377742
2022-10-20T13:30:00-04:00,44.51,44.57,44,44.36,40.90639752217159,NaN,NaN,NaN,NaN,NaN,46.56259999999981,51.728720107011654,41.39647989298797,42.396583656650805,44.60073560256206,44.73199972675075,44.46947147837337,36006,100123.86666666667,45.75012261028765,41.1870586687376,NaN,NaN,NaN,NaN,1.5290718612235417,18.788338025186672,-3637899,0.2148698531168196,-0.7024832897417497,-0.9173531428585693
2022-10-21T09:30:00-04:00,43.95,44.49,43.08,44.32,40.90639752217159,NaN,NaN,NaN,NaN,NaN,46.41459999999981,51.40214642685871,41.42705357314091,42.396583656650805,43.96333333333333,43.96333333333333,43.96333333333333,193854,103267.93333333333,45.562274514410504,41.89952297880658,NaN,NaN,NaN,NaN,1.5205667282790034,18.02271416419743,-3831753,0.20721646242444902,-0.6583325648280081,-0.8655490272524571
2022-10-21T13:30:00-04:00,44.38,44.93,44.28,44.86,40.90639752217159,NaN,NaN,NaN,NaN,NaN,46.27439999999981,51.02933707214631,41.519462927853304,42.396583656650805,44.038611883083554,44.26005161024621,43.8171721559209,22403,101231.13333333333,48.62884077248836,42.77265933517354,NaN,NaN,NaN,NaN,1.4583833905447887,17.031405652738705,-3809350,0.23390941976426893,-0.5731622525471209,-0.8070716723113899
2022-10-24T09:30:00-04:00,44.23,44.725,42.89,44.23,40.90639752217159,NaN,NaN,NaN,NaN,NaN,46.1345999999998,50.70722499665921,41.56197500334039,42.396583656650805,43.94833333333333,43.94833333333333,43.94833333333333,138877,100802.63333333333,45.4145934882634,43.32727802111939,NaN,NaN,NaN,NaN,1.4949274340773038,16.863906915913077,-3948227,0.2055309201702319,-0.5501580220986,-0.7556889422688319
2022-10-24T13:30:00-04:00,44.12,44.95,44.06,44.78,40.90639752217159,NaN,NaN,NaN,NaN,NaN,45.9913999999998,50.26661416540442,41.71618583459518,42.396583656650805,44.01265278390369,44.206465714496275,43.818839853311104,15295,99689.8,48.60823195948604,44.19385467175299,NaN,NaN,NaN,NaN,1.4517183316432107,16.55427483150924,-3932932,0.2189587428865869,-0.4819905136605982,-0.7009492565471851
2022-10-25T09:30:00-04:00,45.25,47.41,45.25,46.97,41.70275625892724,NaN,NaN,NaN,NaN,NaN,45.9171999999998,49.98824515328335,41.84615484671625,43.51343083308608,46.54333333333333,46.54333333333333,46.54333333333333,194623,98186.5,58.915684933169594,46.21880165884826,NaN,NaN,NaN,NaN,1.5358813079544098,15.934354022706145,-3738309,0.3620479672439517,-0.24838929749224548,-0.6104372647361972
2022-10-25T13:30:00-04:00,46.97,47.76,46.9,47.62,42.79581279261237,NaN,NaN,NaN,NaN,NaN,45.8629999999998,49.766305778449066,41.959694221550535,44.212744666468865,46.664876555518624,46.96916330307481,46.36058980796244,31052,96705.63333333333,61.390838226153726,48.539187993552844,NaN,NaN,NaN,NaN,1.4876040716719519,15.536591957613055,-3707257,0.47980108977525804,-0.010685902517124646,-0.4904869922923827
2022-10-26T09:30:00-04:00,47.03,49.06,46.63,47.14,43.18554857476635,NaN,NaN,NaN,NaN,NaN,45.7943999999998,49.478821604550035,42.10997839544956,45.007195733175095,47.60999999999999,47.60999999999999,47.60999999999999,122385,95840.56666666667,58.58399844099734,49.3843188730106,NaN,NaN,NaN,NaN,1.5549180665525266,15.79197206071239,-3829642,0.5022936974116081,0.13738012947212752,-0.3649135679394806
2022-10-26T13:30:00-04:00,47.15,47.7,47.05,47.13,43.18554857476635,NaN,NaN,NaN,NaN,NaN,45.74919999999979,49.30942884658834,42.18897115341124,45.007195733175095,47.51544554928312,47.66036517727251,47.37052592129373,52100,96515.3,58.52396527460021,50.23658629224831,NaN,NaN,NaN,NaN,1.4902810617987752,16.029110727876056,-3881742,0.49274923320941094,0.2510229735722831,-0.24172625963712785
2022-10-27T09:30:00-04:00,47.905,48.76,47.11,48.04,43.37990066419827,NaN,NaN,NaN,NaN,NaN,45.764799999999795,49.35805421311626,42.17154578688333,45.08120526923206,47.97,47.97,47.97,271688,101017.36666666667,62.309048379079606,51.15628080402462,NaN,NaN,NaN,NaN,1.5016895573845768,16.73740483803529,-3610054,0.5212140651618442,0.4097913218151774,-0.11142274334666677
2022-10-27T13:30:00-04:00,48.02,48.05,47.54,47.76,43.37990066419827,NaN,NaN,NaN,NaN,NaN,45.77699999999979,49.393053650055705,42.16094634994387,45.08120526923206,47.95064030579143,48.0075526227832,47.89372798879966,31438,100626.96666666666,60.48013856779536,51.93182112101049,NaN,NaN,NaN,NaN,1.430854588999964,17.395106511754573,-3641492,0.4948792418264146,0.5071763089363515,0.012297067109936888
2022-10-28T09:30:00-04:00,47.38,48.25,46.68,48.13,43.37990066419827,NaN,NaN,NaN,NaN,NaN,45.82639999999979,49.50171170924034,42.15108829075925,45.08120526923206,47.68666666666667,47.68666666666667,47.68666666666667,220564,104646.33333333333,62.06471397107855,53.346690697020385,NaN,NaN,NaN,NaN,1.440793546928538,17.34339314930696,-3420928,0.4759311227433646,0.6072109705391426,0.13127984779577803
2022-10-28T13:30:00-04:00,48.14,48.63,47.96,48.58,43.97415430608003,NaN,NaN,NaN,NaN,NaN,45.8753999999998,49.6300668773779,42.1207331226217,45.62025709784682,47.757539084583605,47.96925595758605,47.54582221158116,24716,103813.16666666667,63.957526317900914,54.79999343450917,NaN,NaN,NaN,NaN,1.3857368650050712,17.49687162898644,-3396212,0.46662680829979,0.7145633581705155,0.24793654987072553
2022-10-31T09:30:00-04:00,48.39,49.01,47.67,48.6,44.03282911034913,NaN,NaN,NaN,NaN,NaN,45.9285999999998,49.760015425150286,42.09718457484931,45.93220567827745,48.42666666666667,48.42666666666667,48.42666666666667,80163,103814.8,64.04339702068664,56.016669605457004,NaN,NaN,NaN,NaN,1.3824699460761372,17.841664566410806,-3316049,0.4353496589838674,0.7921236236005598,0.35677396461669236
2022-10-31T13:30:00-04:00,48.7,48.74,48.14,48.28,44.24679142351506,NaN,NaN,NaN,NaN,NaN,45.9819999999998,49.86819917143727,42.09580082856233,45.97776454262196,48.41209667015619,48.431345437938816,48.39284790237356,45929,103636,61.517957340546474,57.14294351476121,NaN,NaN,NaN,NaN,1.3265792356421273,18.16182943687629,-3361978,0.3692497066716729,0.8183360979562835,0.4490863912846106
2022-11-01T09:30:00-04:00,49.47,50.1,48.19,48.52,44.881937267900746,NaN,NaN,NaN,NaN,NaN,46.0343999999998,49.9848858637997,42.0839141361999,46.93521163409757,48.93666666666667,48.93666666666667,48.93666666666667,225240,107882.86666666667,62.705776048788955,58.367479338645374,NaN,NaN,NaN,NaN,1.3682521473819755,19.165987034637453,-3136738,0.319684861761265,0.8486924684861918,0.5290076067249269
2022-11-01T13:30:00-04:00,48.51,48.63,48.2,48.22,44.881937267900746,NaN,NaN,NaN,NaN,NaN,46.06879999999979,50.064599074038135,42.073000925961445,46.93521163409757,48.87893980514126,49.05367971153729,48.70419989874522,24582,106684.23333333334,60.20420099245342,59.1942907829286,NaN,NaN,NaN,NaN,1.3012341368546916,20.098419089701387,-3161320,0.2478920079771778,0.8388726166963991,0.5909806087192213
2022-11-02T09:30:00-04:00,48.11,48.195,46.77,47.19,44.881937267900746,NaN,NaN,NaN,NaN,NaN,46.06179999999979,50.04848120622668,42.0751187937729,46.93521163409757,47.385000000000005,47.385000000000005,47.385000000000005,110820,107613.33333333333,52.46530754549001,59.69791321558764,NaN,NaN,NaN,NaN,1.311860269936499,19.694278790670136,-3272140,0.11877867827010358,0.7394539565568508,0.6206752782867472
2022-11-02T13:30:00-04:00,47.18,48.79,45.65,45.65,44.881937267900746,NaN,NaN,NaN,NaN,NaN,46.0109999999998,49.95238706549886,42.06961293450073,46.93521163409757,46.958474445966026,47.29264163184209,46.624307260089964,180543,112159.7,43.46838889713405,59.330781568276784,NaN,NaN,NaN,NaN,1.442441679226749,18.486315731710228,-3452683,-0.07231141035167099,0.5302860153471585,0.6025974256988295
2022-11-03T09:30:00-04:00,44.48,46.73,44.44,45.78,NaN,NaN,NaN,50.076375816207026,50.076375816207026,50.076375816207026,46.0117999999998,49.95298294932886,42.07061705067074,46.93521163409757,45.65,45.65,45.65,213408,109424,44.33615383130701,58.289386489572315,NaN,NaN,NaN,NaN,1.502981559281981,17.745010480510377,-3239275,-0.18548976165809927,0.37073522362620537,0.5562249852843046
2022-11-03T13:30:00-04:00,45.78,45.94,45.26,45.32,NaN,NaN,NaN,49.97994964274307,NaN,NaN,46.00279999999981,49.9482034825449,42.05739651745472,46.93521163409757,45.626857157825796,45.6795975556985,45.57411675995309,41092,108657.26666666666,41.886077639939025,56.896189304842686,NaN,NaN,NaN,NaN,1.444197162190411,17.056655604396227,-3280367,-0.281131202187483,0.2048109825499509,0.4859421847374339
2022-11-04T09:30:00-04:00,45.82,46,42.64,42.68,NaN,NaN,NaN,48.95904284080021,NaN,NaN,45.9227999999998,49.97091074948302,41.87468925051659,46.93521163409757,43.77333333333333,43.77333333333333,43.77333333333333,308512,111972.76666666666,31.222187161003916,54.94177421341458,NaN,NaN,NaN,NaN,1.5810402220339532,17.796936701909367,-3588879,-0.49924891668143373,-0.13811896111435829,0.36112995556707544
2022-11-04T13:30:00-04:00,42.65,43.45,42.41,43.38,NaN,NaN,NaN,47.49999543894565,NaN,NaN,45.8779999999998,49.98763550696167,41.768364493037936,46.93521163409757,43.65795949541293,43.91618692452891,43.399732066296956,61586,113205.13333333333,35.88336327573252,53.3245883563526,NaN,NaN,NaN,NaN,1.5423944918886714,18.58533894941234,-3527293,-0.568409409500648,-0.3493818063087346,0.21902760319191342
2022-11-07T09:30:00-05:00,43.91,44.17,42.64,43.16,NaN,NaN,NaN,47.49999543894565,NaN,NaN,45.8225999999998,50.002027348343255,41.64317265165635,46.93521163409757,43.32333333333333,43.32333333333333,43.32333333333333,188748,112554.9,35.078725746807805,51.37956531119033,NaN,NaN,NaN,NaN,1.5415091710394806,18.75027824703096,-3716041,-0.5979976249297938,-0.5284694279703288,0.06952819695946497
2022-11-07T13:30:00-05:00,43.19,43.82,42.99,43.51,NaN,NaN,NaN,47.49999543894565,NaN,NaN,45.7699999999998,49.99804162705162,41.541958372947974,46.93521163409757,43.341362610191354,43.383533225663975,43.29919199471873,34500,112131.46666666666,37.48060918332155,49.73674178372791,NaN,NaN,NaN,NaN,1.4906870873938034,18.903436166248248,-3681541,-0.5634926144624822,-0.6348375711186378,-0.07134495665615559
2022-11-08T09:30:00-05:00,43.32,44.45,41.88,42.68,NaN,NaN,NaN,47.49999543894565,NaN,NaN,45.645199999999804,49.86231795425253,41.428082045747075,45.88316930727806,43.00333333333334,43.00333333333334,43.00333333333334,138042,111753.96666666666,34.24499500081359,47.74961900013756,NaN,NaN,NaN,NaN,1.5677808668656747,19.60648607310653,-3819583,-0.5646445510145663,-0.7771506454243635,-0.21250609440979717
2022-11-08T13:30:00-05:00,42.68,42.94,41.57,42.47,NaN,NaN,NaN,46.85497171027247,NaN,NaN,45.5033999999998,49.66082152783188,41.34597847216772,45.27253544582245,42.76753444657359,43.08995673443603,42.445112158711154,73832,112892.8,33.45799295645105,45.57108090289114,NaN,NaN,NaN,NaN,1.553653662089555,20.406848970018018,-3893415,-0.5472312940364471,-0.8965452119553561,-0.349313917918909
2022-11-09T09:30:00-05:00,41.34,41.34,39.61,39.61,NaN,NaN,NaN,45.25588208707828,NaN,NaN,45.321999999999804,49.69508129355912,40.94891870644049,44.882028356657955,40.18666666666667,40.18666666666667,40.18666666666667,133360,114079.2,25.023510908837963,42.78394618061624,NaN,NaN,NaN,NaN,1.6469641147974436,21.96466955851018,-4026775,-0.6869641234301841,-1.208019072206639,-0.521054948776455
2022-11-09T13:30:00-05:00,39.5,39.61,39.06,39.15,NaN,NaN,NaN,43.973569264938355,NaN,NaN,45.128999999999806,49.7175304837253,40.540469516274314,42.45862268532636,40.07518541681753,40.374169484053354,39.77620134958171,18541,113684.5,23.97657023256569,40.10241853004618,NaN,NaN,NaN,NaN,1.5686095351690545,23.607060839116798,-4045316,-0.7631399261635786,-1.4749798564809282,-0.7118399303173496
2022-11-10T09:30:00-05:00,42.83,44.28,41.87,43.52,37.94772933801339,37.94772933801339,37.94772933801339,NaN,NaN,NaN,45.019399999999806,49.49320180160855,40.54559819839106,42.18289814826109,43.223333333333336,43.223333333333336,43.223333333333336,180556,113815.16666666667,46.7637131306101,38.96369975017626,NaN,NaN,NaN,NaN,1.822994568371265,21.999051001388985,-3864760,-0.4855074879382898,-1.3187242902402119,-0.8332168023019221
2022-11-10T13:30:00-05:00,43.53,44.51,43.35,44.5,38.8776052771946,NaN,NaN,NaN,NaN,NaN,44.9351999999998,49.284738347925796,40.58566165207381,41.31431851860887,43.45570817399487,43.848600916636634,43.06281543135311,63160,114720.3,50.35729217295996,38.26034912021244,NaN,NaN,NaN,NaN,1.7756378134876027,20.463543198502187,-3801600,-0.21590416043118021,-1.1030970028408973,-0.8871928424097171
2022-11-11T09:30:00-05:00,43.75,47.65,43.31,47.65,40.065441400958484,NaN,NaN,NaN,NaN,NaN,44.968399999999804,49.374609000952574,40.56219099904703,41.29826421298881,46.20333333333334,46.20333333333334,46.20333333333334,122692,112348.23333333334,59.7598883368275,38.78139060530798,NaN,NaN,NaN,NaN,1.958806541095631,20.377140725046452,-3678908,0.17351004384007018,-0.6703052876096294,-0.8438153314496996
2022-11-11T13:30:00-05:00,47.8,48.08,47.37,47.7,42.45973951909673,NaN,NaN,NaN,NaN,NaN,45.003999999999806,49.46876158378861,40.539238416211,42.64361137039104,46.70123955672955,47.41228630444908,45.99019280901001,60161,113606.83333333333,59.88975323786319,39.954345201074354,NaN,NaN,NaN,NaN,1.8696060738745146,20.452880542257297,-3618747,0.41937542615817924,-0.31959604875197556,-0.7389714749101548
2022-11-14T09:30:00-05:00,47.08,47.45,45.86,47.04,42.45973951909673,NaN,NaN,NaN,NaN,NaN,45.0613999999998,49.55549569992427,40.56730430007533,42.64361137039104,46.78333333333333,46.78333333333333,46.78333333333333,68823,111271.7,57.26273369563443,40.87767233424059,NaN,NaN,NaN,NaN,1.8674913543120495,19.71842516063919,-3687570,0.5161121355268021,-0.0938313055016522,-0.6099434410284543
2022-11-14T13:30:00-05:00,47.11,47.16,46.12,46.16,42.45973951909673,NaN,NaN,NaN,NaN,NaN,45.0967999999998,49.59706388560449,40.596536114395114,42.64361137039104,46.71189973673394,46.84060650518804,46.58319296827984,21200,111468.53333333334,53.86976920379269,41.73365030308729,NaN,NaN,NaN,NaN,1.8083848290040458,19.036430877708085,-3708770,0.4990905736427395,0.013919776024970076,-0.48517079761776943
2022-11-15T09:30:00-05:00,48.57,49.3,48.07,48.11,43.313416856344375,NaN,NaN,NaN,NaN,NaN,45.18059999999981,49.745668078361476,40.61553192163814,43.94176902164021,48.49333333333334,48.49333333333334,48.49333333333334,45419,106495.06666666667,59.584454337981455,43.75952653001425,NaN,NaN,NaN,NaN,1.9035001983609,19.252159891863915,-3663351,0.5911262898332156,0.25373706467375,-0.33738922515946557
2022-11-15T13:30:00-05:00,48.07,48.72,47.58,48.19,43.313416856344375,NaN,NaN,NaN,NaN,NaN,45.275199999999806,49.889496462091934,40.66090353790768,43.94176902164021,48.31045023557126,48.47447826614788,48.14642220499464,56461,107342.03333333334,59.80445533863951,45.468175963079034,NaN,NaN,NaN,NaN,1.84896446990655,19.177007283570806,-3606890,0.6260060030796093,0.44511827869004605,-0.18088772438956324
2022-11-16T09:30:00-05:00,47,47.22,45.37,46.28,43.313416856344375,NaN,NaN,NaN,NaN,NaN,45.32319999999981,49.92836655942807,40.718033440571546,43.94176902164021,46.29,46.29,46.29,41823,104656.63333333333,52.46188427867764,46.70983014392687,NaN,NaN,NaN,NaN,1.9183241506275106,17.983889615382502,-3648713,0.49480904346590326,0.43762357994281587,-0.05718546352308741
2022-11-16T13:30:00-05:00,46.16,46.16,45.42,45.73,43.313416856344375,NaN,NaN,NaN,NaN,NaN,45.35759999999981,49.94868973557172,40.76651026442791,43.94176902164021,46.081530726256986,46.336372999537836,45.826688452976136,27987,103852.86666666667,50.53771094566439,47.64248026980851,NaN,NaN,NaN,NaN,1.8427295684398313,16.875994637779073,-3676700,0.35206025705133215,0.38288985779107776,0.030829600739745625
2022-11-17T09:30:00-05:00,44.19,45.45,43.98,45.31,43.313416856344375,NaN,NaN,NaN,NaN,NaN,45.37979999999981,49.959004280229436,40.800595719770186,43.94176902164021,44.913333333333334,44.91333381017049,44.913332856496176,71933,97194.36666666667,49.05798497388541,48.70055098217079,NaN,NaN,NaN,NaN,1.8361060278369863,16.162601883449064,-3748633,0.2170480164150981,0.30213962125861826,0.08509160484352016
2022-11-17T13:30:00-05:00,45.25,45.39,44.39,44.79,43.313416856344375,NaN,NaN,NaN,NaN,NaN,45.397399999999806,49.96060906381415,40.834190936185465,43.94176902164021,44.90089534370637,44.92434989181232,44.877440795600414,20229,96820.73333333334,47.21474404337839,49.68317605980845,NaN,NaN,NaN,NaN,1.776384168705773,15.500165754428345,-3768862,0.08708599482675886,0.19394909837696872,0.10686310355020986
2022-11-18T09:30:00-05:00,45.6,45.6,43.45,43.81,43.313416856344375,NaN,NaN,NaN,NaN,NaN,45.42879999999981,49.925797469431444,40.93180253056818,43.94176902164021,44.28666666666667,44.28666666666667,44.28666666666667,30290,90478.26666666666,43.86939483574382,51.02931062601601,NaN,NaN,NaN,NaN,1.803071013798218,15.315291980066249,-3799152,-0.0624524353316694,0.028797559385623117,0.09124999471729252
2022-11-18T13:30:00-05:00,43.82,43.97,43.53,43.89,43.313416856344375,NaN,NaN,NaN,NaN,NaN,45.472799999999815,49.864426650806344,41.081173349193286,43.94176902164021,44.096992445703485,44.3356638896904,43.85832100171657,19130,90292.06666666667,44.21686326030734,52.47504584228328,NaN,NaN,NaN,NaN,1.7057087985269166,15.143623475301446,-3780022,-0.14863286213465413,-0.09454108295102515,0.05409177918362899
2022-11-21T09:30:00-05:00,42.97,43.24,41.59,41.9,NaN,NaN,NaN,47.56816563795256,47.56816563795256,47.56816563795256,45.41399999999982,49.91530114523221,40.91269885476742,43.94176902164021,42.24333333333334,42.2433338101705,42.24333285649618,81920,90350.63333333333,37.92736421411732,51.8438780625338,NaN,NaN,NaN,NaN,1.748158170060708,15.818268592733512,-3861942,-0.32234779924795,-0.3488429698763085,-0.02649517062835851
2022-11-21T13:30:00-05:00,41.91,42.33,41.86,42.17,NaN,NaN,NaN,47.078021745318345,NaN,NaN,45.36139999999982,49.95077557409177,40.772024425907865,43.94176902164021,42.20860358385221,42.26407592173435,42.153131245970066,32110,89890,39.191197950096374,51.04629990375782,NaN,NaN,NaN,NaN,1.6568611579135146,16.44472477320614,-3829832,-0.3968586314780109,-0.5225684599758722,-0.12570982849786125
2022-11-22T09:30:00-05:00,41.7,42.52,41.19,42.42,NaN,NaN,NaN,46.792884393258426,NaN,NaN,45.301599999999816,49.96421962421038,40.63898037578925,43.86341521731217,42.04333333333334,42.04333333333334,42.04333333333334,52483,84131.43333333333,40.401205718236554,49.66353685957275,NaN,NaN,NaN,NaN,1.633513932348264,17.30096727249947,-3777349,-0.40565610390030415,-0.6327799583732414,-0.2271238544729373
2022-11-22T13:30:00-05:00,42.45,42.57,41.98,42.54,NaN,NaN,NaN,46.792884393258426,NaN,NaN,45.243399999999816,49.96937352511303,40.517426474886605,41.92473217384973,42.11772342385821,42.25289347749188,41.98255337022454,15896,83841.9,41.00799899348685,48.31484012783159,NaN,NaN,NaN,NaN,1.5589772228948167,18.058626779173046,-3761453,-0.38017626141262767,-0.7023441812387219,-0.3221679198260942
2022-11-23T09:30:00-05:00,42.73,43.96,42.64,43.46,NaN,NaN,NaN,46.792884393258426,NaN,NaN,45.238199999999814,49.97143346562058,40.50496653437905,41.49378573907978,43.35333333333333,43.35333333333333,43.35333333333333,28431,81095.6,45.58239708911475,47.480530370223036,NaN,NaN,NaN,NaN,1.54905027840233,17.76779844552599,-3733022,-0.2826271277923287,-0.6754518295665051,-0.3928247017741764
2022-11-23T13:30:00-05:00,43.6,44.31,43.58,44.17,NaN,NaN,NaN,46.792884393258426,NaN,NaN,45.24199999999982,49.97149045881981,40.51250954117983,41.329158946830475,43.64106399568164,43.971263189366724,43.31086480199656,21588,75797.1,48.87706619199726,47.12390872652337,NaN,NaN,NaN,NaN,1.4991181156593065,17.264338219693293,-3711434,-0.15777759048885204,-0.5900466898852414,-0.4322690993963894
2022-11-25T09:30:00-05:00,43.73,43.86,43.41,43.76,NaN,NaN,NaN,46.792884393258426,NaN,NaN,45.224399999999825,49.96924505121782,40.47955494878183,41.329158946830475,43.67666666666667,43.67666666666667,43.67666666666667,22116,69420.7,47.103545793998386,46.232415259096,NaN,NaN,NaN,NaN,1.446323964540785,16.891053189907048,-3733550,-0.09347768453492067,-0.5491162050650402,-0.45563852053011955
2022-11-28T09:30:00-05:00,43.17,43.98,42.82,42.92,NaN,NaN,NaN,46.792884393258426,NaN,NaN,45.19559999999982,49.97841115663863,40.412788843361014,41.329158946830475,43.24,43.24,43.24,50280,69726.96666666666,43.612004230542844,45.07581160851767,NaN,NaN,NaN,NaN,1.4258722527878718,16.87320453390244,-3783830,-0.09772836268021151,-0.5777989738803839,-0.4800706112001724
2022-11-28T13:30:00-05:00,42.93,42.93,42.36,42.57,NaN,NaN,NaN,46.792884393258426,NaN,NaN,45.160599999999825,49.99387534494627,40.32732465505338,41.329158946830475,43.091078201737815,43.35594385244611,42.82621255102952,15895,59973.066666666666,42.20811446189658,44.343399478747585,NaN,NaN,NaN,NaN,1.364738520445881,17.10722506619764,-3799725,-0.11322899334348069,-0.6216068528795233,-0.5083778595360426
2022-11-29T09:30:00-05:00,42.73,43.42,42.35,42.35,NaN,NaN,NaN,46.792884393258426,NaN,NaN,45.11039999999983,50.006847626602784,40.21395237339687,41.329158946830475,42.70666666666667,42.70666666666667,42.70666666666667,27287,58829.76666666667,41.30799449864105,43.68413401824592,NaN,NaN,NaN,NaN,1.343685768985461,16.92926610103723,-3827012,-0.12641393954827795,-0.66639528397139,-0.5399813444231121
2022-11-29T13:30:00-05:00,42.22,42.5,42.19,42.29,NaN,NaN,NaN,46.52081868995617,NaN,NaN,45.071599999999826,50.025743897795635,40.11745610220402,41.329158946830475,42.61124168656403,42.776031144999145,42.44645222812891,9150,52843.166666666664,41.05087199874695,43.1121973771646,NaN,NaN,NaN,NaN,1.2698510712007853,16.861220168158074,-3836162,-0.1269573337796539,-0.6986780116476794,-0.5717206778680255
2022-11-30T09:30:00-05:00,42.49,43.05,42.25,42.61,NaN,NaN,NaN,46.52081868995617,NaN,NaN,45.02819999999983,50.02959610909431,40.02680389090535,41.329158946830475,42.63666666666666,42.63666666666666,42.63666666666666,29992,52692.9,43.08562344397624,42.81726019149302,NaN,NaN,NaN,NaN,1.236290280400729,16.33650655409914,-3806170,-0.09500868882289826,-0.6904815388966483,-0.5954728500737501
2022-11-30T13:30:00-05:00,42.58,45.25,42.56,45.24,NaN,NaN,NaN,46.52081868995617,NaN,NaN,44.99359999999982,49.96462767645353,40.022572323546115,42.18034720236634,43.844835990903306,44.626068132779025,43.06360384902759,71730,50482.5,56.40446483803374,43.71262233451373,NaN,NaN,NaN,NaN,1.3401266889435337,16.003958936449926,-3734440,0.10326588349921839,-0.4663904956997271,-0.5696563791989455
2022-12-01T09:30:00-05:00,45.39,46.36,44.85,45.77,NaN,NaN,NaN,46.52081868995617,NaN,NaN,44.956599999999824,49.87615544333667,40.03704455666298,43.149277761893075,45.660000000000004,45.660000000000004,45.660000000000004,42897,49451.333333333336,58.51152409703465,44.73366953713711,NaN,NaN,NaN,NaN,1.3522604968761383,16.295461600477456,-3691543,0.2611439862568199,-0.24322639637792065,-0.5043703826347405
2022-12-01T13:30:00-05:00,45.82,46.05,45.68,45.99,NaN,NaN,NaN,46.52081868995617,NaN,NaN,44.93359999999982,49.822768043754046,40.044431956245596,43.29642220951446,45.73802488418548,45.8527343238443,45.62331544452665,19847,45667.566666666666,59.3889499965446,46.26663995016763,NaN,NaN,NaN,NaN,1.2820990328135569,16.566142645645872,-3671696,0.3650474577211362,-0.04806106048332026,-0.4131085182044565
2022-12-02T09:30:00-05:00,45.01,46.38,44.85,45.86,NaN,NaN,NaN,46.52081868995617,NaN,NaN,44.90819999999982,49.764547088096656,40.05185291190299,43.41213776761157,45.696666666666665,45.696666666666665,45.696666666666665,25976,45915.4,58.60029308904743,47.653003888664124,NaN,NaN,NaN,NaN,1.2998062447554457,16.16362429156642,-3697672,0.4065056849528645,0.09502358798662414,-0.31148209696624035
2022-12-02T13:30:00-05:00,45.93,46.4,45.825,46.24,NaN,NaN,NaN,46.52081868995617,NaN,NaN,44.87219999999983,49.66137160269522,40.08302839730444,43.73821021408926,45.866866731203615,46.08831717925903,45.6454162831482,15344,40408.333333333336,60.26148212994793,49.071595060929226,NaN,NaN,NaN,NaN,1.2480343701300565,15.802417687766344,-3682328,0.43827163395041224,0.23635744547177495,-0.2019141884786373
2022-12-05T09:30:00-05:00,45.89,46.41,44.21,44.21,NaN,NaN,NaN,46.52081868995617,NaN,NaN,44.801199999999824,49.52178579416417,40.08061420583548,43.73821021408926,44.94333333333334,44.94333333333334,44.94333333333334,12256,38711.53333333333,48.95947308267834,49.63955749587147,NaN,NaN,NaN,NaN,1.3160319151207662,15.043214036066214,-3694584,0.3074979476766357,0.18245824611715733,-0.12503970155947836
2022-12-05T13:30:00-05:00,44.27,44.3,43.55,43.84,NaN,NaN,NaN,46.52081868995617,NaN,NaN,44.715399999999825,49.34594244771205,40.0848575522876,43.73821021408926,44.13799761703196,44.57885182624178,43.69714340782213,40899,35985.1,47.221102616907274,49.756607890713795,NaN,NaN,NaN,NaN,1.2756010640407116,14.748574385386352,-3735483,0.18693941157267643,0.1086345629063672,-0.07830484866630924
2022-12-06T09:30:00-05:00,43.53,43.6,41.99,41.99,NaN,NaN,NaN,46.52081868995617,NaN,NaN,44.583599999999834,49.14121474458529,40.025985255414376,43.73821021408926,42.52666666666667,42.52666666666667,42.52666666666667,15806,34506.6,39.642028459774416,49.09696233841216,NaN,NaN,NaN,NaN,1.316629559466375,15.325099669241805,-3751289,-0.015772803812158037,-0.0980208534315068,-0.08224804961934876
2022-12-06T13:30:00-05:00,41.91,42.38,41.83,42.2,NaN,NaN,NaN,46.1392475593217,NaN,NaN,44.45559999999983,48.91321399854917,39.9979860014505,43.73821021408926,42.30331549067316,42.49624348454654,42.110387496799774,21184,32918.63333333333,40.80349931688378,48.64695901861826,NaN,NaN,NaN,NaN,1.261870305218777,15.9406150260673,-3730105,-0.12785050761767972,-0.2420611841414484,-0.11421067652376868
2022-12-07T09:30:00-05:00,41.79,42.48,41.36,42.01,NaN,NaN,NaN,45.92359994298889,NaN,NaN,44.330199999999834,48.70236374808398,39.958036251915686,43.73821021408926,41.949999999999996,41.949999999999996,41.949999999999996,27619,33132.6,40.052529266227744,48.392710806881475,NaN,NaN,NaN,NaN,1.251736711988864,16.751100831093627,-3757724,-0.20248062537315817,-0.3673114582402164,-0.1648308328670582
2022-12-07T13:30:00-05:00,42,42,41.6,41.62,NaN,NaN,NaN,45.677527218307574,NaN,NaN,44.192199999999836,48.46102895418167,39.923371045818,43.73821021408926,41.85081795253926,41.9556566449599,41.74597926011862,24719,32442.6,38.48674446472584,48.12689866422641,NaN,NaN,NaN,NaN,1.1916126611325164,17.503694792903786,-3782443,-0.26202912604029155,-0.49236724041742264,-0.2303381143771311
2022-12-08T09:30:00-05:00,41.52,43.12,41.08,42.68,NaN,NaN,NaN,45.677527218307574,NaN,NaN,44.08139999999983,48.21163972186374,39.95116027813592,43.73821021408926,42.29333333333333,42.29333333333333,42.29333333333333,41501,31943.933333333334,44.802789248801034,48.37652686066641,NaN,NaN,NaN,NaN,1.252211756765908,17.217173116399113,-3740942,-0.21587030057482537,-0.5001759900956628,-0.28430568952083746
2022-12-08T13:30:00-05:00,42.79,42.94,42.42,42.75,NaN,NaN,NaN,45.677527218307574,NaN,NaN,43.99259999999983,48.041806954461734,39.94339304553793,43.73821021408926,42.40910688039287,42.593670257300055,42.224543503485684,16330,31094.166666666668,45.20292807991982,48.6731022950359,NaN,NaN,NaN,NaN,1.1999109169969142,16.951117273930482,-3724612,-0.16856336798381133,-0.4950098995006016,-0.32644653151679026
2022-12-09T09:30:00-05:00,42.62,43.39,42.21,42.69,NaN,NaN,NaN,45.677527218307574,NaN,NaN,43.93339999999983,47.970483323398405,39.89631667660125,43.73821021408926,42.76333333333333,42.76333333333333,42.76333333333333,33299,31271.233333333334,44.90245776401577,48.80287617503872,NaN,NaN,NaN,NaN,1.1984887086399918,16.314354051322038,-3757911,-0.1309288379502534,-0.490107578954607,-0.3591787410043536
2022-12-09T13:30:00-05:00,42.84,42.84,42.43,42.43,NaN,NaN,NaN,45.677527218307574,NaN,NaN,43.86639999999983,47.88984481260286,39.8429551873968,43.1805681712714,42.71214390438955,42.79843930822673,42.625848500552365,11717,29264.033333333333,43.551490547921176,47.88480658288783,NaN,NaN,NaN,NaN,1.1421680865942785,15.72307391604277,-3769628,-0.11379476616426937,-0.5014221987096903,-0.3876274325454209
2022-12-12T09:30:00-05:00,42.04,43.11,42.04,42.87,NaN,NaN,NaN,45.677527218307574,NaN,NaN,43.81739999999982,47.82849622921998,39.806303770779664,41.34145453701712,42.67333333333334,42.67333333333334,42.67333333333334,12240,28997.733333333334,46.48581174606565,47.02582712924719,NaN,NaN,NaN,NaN,1.1370132232661159,15.476802913775083,-3757388,-0.06547645484095105,-0.4694730010966097,-0.4039965462556587
2022-12-12T13:30:00-05:00,42.91,43.2,42.72,43.2,NaN,NaN,NaN,45.677527218307574,NaN,NaN,43.827799999999826,47.829732113374924,39.82586788662473,40.998850225418984,42.78682687425961,42.95633650380207,42.61731724471715,5487,28170.966666666667,48.64210743023974,46.25819551736827,NaN,NaN,NaN,NaN,1.0900837073185365,15.157297962210547,-3751901,-0.007016100971375783,-0.4127666724698784,-0.40575057149850263
2022-12-13T09:30:00-05:00,45.89,46.75,42.85,43.47,40.82409165376777,40.82409165376777,40.82409165376777,NaN,NaN,NaN,43.82959999999982,47.830805738282365,39.82839426171728,43.03908018033518,44.356666666666655,44.35666749257284,44.35666584076047,228455,35148.46666666667,50.40298600649929,45.67267358290054,NaN,NaN,NaN,NaN,1.2907920139386408,15.864079484105813,-3523446,0.05092343161545154,-0.3420962819791882,-0.3930197135946397
2022-12-13T13:30:00-05:00,43.48,43.83,43.16,43.43,40.82409165376777,NaN,NaN,NaN,NaN,NaN,43.834999999999816,47.83330414051571,39.836695859483925,43.03908018033518,44.2873592813405,44.524884038038785,44.049834524642215,19451,33066.166666666664,50.128771650015075,44.94890854861963,NaN,NaN,NaN,NaN,1.246449727228738,16.52037661157999,-3542897,0.08559969688861291,-0.2860200924838736,-0.3716197893724865
2022-12-14T09:30:00-05:00,43.19,43.98,43.15,43.7,40.82409165376777,NaN,NaN,NaN,NaN,NaN,43.83879999999982,47.83622244953712,39.841377550462525,43.03908018033518,43.60999999999999,43.60999999999999,43.60999999999999,24526,32813.36666666667,52.026036577232865,45.16794879823067,NaN,NaN,NaN,NaN,1.2167033181409708,17.213672613536197,-3518371,0.12346558652775325,-0.21728780621279498,-0.3407533927405482
2022-12-14T13:30:00-05:00,43.94,44.12,42.61,43.13,40.82409165376777,NaN,NaN,NaN,NaN,NaN,43.847799999999815,47.83676335406402,39.85883664593561,43.03908018033518,43.42536008068512,43.58538614348168,43.265334017888556,32651,32152.3,47.88443729801578,45.21532984688128,NaN,NaN,NaN,NaN,1.2376530811309012,17.341134734866884,-3551022,0.1074574377678369,-0.20643159553075208,-0.31388903329858897
2022-12-15T09:30:00-05:00,41.96,42.2,40.97,40.98,40.82409165376777,NaN,NaN,NaN,NaN,NaN,43.81799999999982,47.86946294566085,39.76653705433879,43.03908018033518,41.38333333333333,41.38333333333333,41.38333333333333,25547,32474,36.18379431525018,44.96831312227241,NaN,NaN,NaN,NaN,1.3035350039072657,16.118646965938936,-3576569,-0.042555567005824024,-0.367083492055869,-0.32452792505004496
2022-12-15T13:30:00-05:00,40.94,41.2,40.91,40.98,40.82409165376777,NaN,NaN,NaN,NaN,NaN,43.84539999999983,47.8000311281915,39.890768871808156,43.03908018033518,41.26550331776635,41.43208470807932,41.09892192745338,12782,31952.366666666665,36.18379431525018,44.63833419358429,NaN,NaN,NaN,NaN,1.2311396464853186,14.995370604396197,-3576569,-0.13139131987516373,-0.4887670748939996,-0.3573757550188359
2022-12-16T09:30:00-05:00,40.69,41.08,39.81,40.04,NaN,NaN,NaN,44.277333884299836,44.277333884299836,44.277333884299836,43.86319999999982,47.7403875167527,39.986012483246945,43.03908018033518,40.31,40.31,40.31,40989,32599.066666666666,32.194829303286156,44.07706991051703,NaN,NaN,NaN,NaN,1.2339153860220813,14.725688548299756,-3617558,-0.23691457608454147,-0.6535189751245127,-0.41660439903997126
2022-12-16T13:30:00-05:00,40.04,40.5,39.94,40.29,NaN,NaN,NaN,43.95450052592257,NaN,NaN,43.79859999999982,47.80208450228834,39.79511549771131,43.03908018033518,40.28135687715099,40.314358589789826,40.248355164512155,30877,32891.1,34.270244425151745,43.77589133626174,NaN,NaN,NaN,NaN,1.18577857273479,14.475269496210204,-3586681,-0.27088253645256727,-0.7552075696056804,-0.4843250331531131
2022-12-19T09:30:00-05:00,40.3,40.3,39.17,39.66,NaN,NaN,NaN,43.45384141110791,NaN,NaN,43.70179999999982,47.863685515011646,39.539914484987996,43.03908018033518,39.71,39.71,39.71,11366,31593.966666666667,31.64185716750329,42.835824759026195,NaN,NaN,NaN,NaN,1.181794388968019,14.756956457456782,-3598047,-0.3137625150968739,-0.8765281770242055,-0.5627656619273316
2022-12-19T13:30:00-05:00,39.62,39.62,39.09,39.31,NaN,NaN,NaN,42.98253043787574,NaN,NaN,43.53499999999982,47.719013862317475,39.35098613768216,43.03908018033518,39.44668510109338,39.61429111712345,39.27907908506331,28053,31999.233333333334,30.253626083904678,41.768017473596544,NaN,NaN,NaN,NaN,1.1380947897560172,15.07091710806298,-3626100,-0.34139646069743157,-0.9895112377991211,-0.6481147771016895
2022-12-20T09:30:00-05:00,38.97,39.82,38.7,39.07,NaN,NaN,NaN,42.87536996342684,NaN,NaN,43.36239999999982,47.556911766590254,39.16788823340939,40.922011315414515,39.196666666666665,39.196666666666665,39.196666666666665,11680,31479,29.304207644320016,40.65385675076113,NaN,NaN,NaN,NaN,1.1368023047734443,15.622760587246434,-3637780,-0.3502278164483299,-1.0858995476621018,-0.7356717312137719
2022-12-20T13:30:00-05:00,39.26,39.32,39.06,39.07,NaN,NaN,NaN,42.676489510543796,NaN,NaN,43.20299999999982,47.43198238351315,38.974017616486485,40.922011315414515,39.180517141630745,39.202717081778474,39.158317201483015,6181,31380.033333333333,29.304207644320016,39.636193686218185,NaN,NaN,NaN,NaN,1.0741735687181981,16.13518667505964,-3637780,-0.330696639532839,-1.1490425306298206,-0.8183458910969816
2022-12-21T09:30:00-05:00,39.12,39.94,38.75,39.6,NaN,NaN,NaN,42.676489510543796,NaN,NaN,43.07179999999982,47.33260497559624,38.8109950244034,40.91860905233161,39.43,39.43,39.43,37033,31614.733333333334,34.56357813824505,38.78460557137386,NaN,NaN,NaN,NaN,1.0824468852383267,15.937983670393427,-3600747,-0.2598351468253727,-1.1431398246286975,-0.8833046778033248
2022-12-21T13:30:00-05:00,39.58,39.88,39.45,39.54,NaN,NaN,NaN,42.676489510543796,NaN,NaN,42.90039999999983,47.024009991265196,38.77679000873446,38.55888724186529,39.471993982822156,39.551714382254964,39.39227358338935,10276,29566.266666666666,34.252909275528395,37.75680570318019,NaN,NaN,NaN,NaN,1.0358435362927318,15.754866594631945,-3611023,-0.19757568794730573,-1.130274287737457,-0.9326985997901512
2022-12-22T09:30:00-05:00,38.87,38.89,37.07,37.1,NaN,NaN,NaN,41.55298735510388,NaN,NaN,42.67859999999983,46.83318303082986,38.52401696916981,38.14210979349223,37.68666666666667,37.68666666666667,37.68666666666667,24918,28966.966666666667,24.57796915178045,35.912161642128844,NaN,NaN,NaN,NaN,1.1382832837003938,17.160339631907874,-3635941,-0.29540728586544485,-1.3019577071219572,-1.0065504212565124
2022-12-22T13:30:00-05:00,37.19,38.05,37.19,38.02,NaN,NaN,NaN,41.16012429350825,NaN,NaN,42.51339999999983,46.73832529638824,38.28847470361141,37.998687834793785,37.7177326304059,37.75098875985939,37.68447650095241,21744,29030.2,32.33823867249835,34.64140928659193,NaN,NaN,NaN,NaN,1.124834477721794,18.46542173794981,-3614197,-0.2733517192957726,-1.348240070376228,-1.0748883510804554
2022-12-23T09:30:00-05:00,37.8,38.03,37.08,37.58,NaN,NaN,NaN,41.06375500743969,NaN,NaN,42.35039999999984,46.69356375008546,38.007236249914214,37.79760648301135,37.56333333333333,37.56333333333333,37.56333333333333,25765,29023.166666666668,30.7107479951202,33.11888867358389,NaN,NaN,NaN,NaN,1.112346300741666,19.73938391708042,-3639962,-0.2634783888005341,-1.404236337081123,-1.140757948280589
2022-12-23T13:30:00-05:00,37.58,37.79,37.58,37.78,NaN,NaN,NaN,41.062902507101526,NaN,NaN,42.19979999999984,46.64307535046559,37.75652464953409,37.79760648301135,37.60182935100672,37.668318292444276,37.535340409569166,8637,28799.6,32.3766926059638,32.011192624151604,NaN,NaN,NaN,NaN,1.0478929935458328,20.922348797701698,-3631325,-0.22031439877951442,-1.416150946754982,-1.1958365479754676
2022-12-27T09:30:00-05:00,37.12,37.22,36.28,36.63,NaN,NaN,NaN,40.17890693859691,NaN,NaN,42.03659999999984,46.68216151181508,37.39103848818459,37.79760648301135,36.71,36.71,36.71,19600,29044.4,28.181000416701664,31.439564488541,NaN,NaN,NaN,NaN,1.0801863511497019,22.729693993234605,-3650925,-0.24419890107099596,-1.5010851743142126,-1.2568862732432167
2022-12-27T13:30:00-05:00,36.61,36.68,36.47,36.47,NaN,NaN,NaN,39.87668389593342,NaN,NaN,41.88979999999984,46.760365453831426,37.01923454616825,37.79760648301135,36.650239867659224,36.73140604953653,36.569073685781916,10625,28035.266666666666,27.64423740983071,30.829596138153892,NaN,NaN,NaN,NaN,1.0180301832104375,24.407943103372308,-3661550,-0.2451199684500307,-1.563286233805755,-1.3181662653557242
2022-12-28T09:30:00-05:00,36.16,36.96,36.02,36.53,NaN,NaN,NaN,39.76978917339099,NaN,NaN,41.74259999999984,46.803614617648904,36.681585382350775,37.79760648301135,36.50333333333334,36.50333333333334,36.50333333333334,27239,28416.366666666665,28.196553142775855,30.544004983831723,NaN,NaN,NaN,NaN,1.0124565986954062,26.192420875126,-3634311,-0.217001151796953,-1.5894177051019156,-1.3724165533049626
2022-12-28T13:30:00-05:00,36.51,36.56,36.23,36.45,NaN,NaN,NaN,39.57070784732775,NaN,NaN,41.633599999999845,46.906672364386246,36.360527635613444,37.79760648301135,36.47600134631935,36.517387833454464,36.43461485918424,11880,28106.233333333334,27.890850309266455,30.088333975554207,NaN,NaN,NaN,NaN,0.9637096987885918,27.849435948897284,-3646191,-0.18059461667638987,-1.59815982415045,-1.4175652074740601
2022-12-29T09:30:00-05:00,37.05,38.32,36.87,38.09,NaN,NaN,NaN,39.57070784732775,NaN,NaN,41.55199999999984,46.91485446381435,36.189145536185336,37.79760648301135,37.76,37.76,37.76,19431,27833.3,41.81718210172444,30.81514289942715,NaN,NaN,NaN,NaN,1.0284447203036922,27.13934025479816,-3626760,-0.03072399748184207,-1.4559702043263627,-1.4252462068445206
2022-12-29T13:30:00-05:00,38.03,38.37,38.01,38.29,NaN,NaN,NaN,39.57070784732775,NaN,NaN,41.469399999999844,46.90298947290409,36.0358105270956,36.21080618859828,37.89494735434296,38.10545820695673,37.68443650172919,7985,27275.5,43.25642433235347,31.743914202887776,NaN,NaN,NaN,NaN,0.9806986688534284,26.426013023728828,-3618775,0.09057983624570687,-1.312021411537387,-1.4026012477830938
2022-12-30T09:30:00-05:00,37.35,38.28,37.35,37.64,NaN,NaN,NaN,39.57070784732775,NaN,NaN,41.37139999999985,46.900136579007125,35.84266342099258,36.21080618859828,37.75666666666667,37.75666666666667,37.75666666666667,16133,26429.9,39.809776386615994,32.49431197019463,NaN,NaN,NaN,NaN,0.9777916210781833,26.25755578223376,-3634908,0.13316815084982458,-1.236141059220813,-1.3693092100706377
2022-12-30T13:30:00-05:00,37.88,38.56,37.75,38.54,NaN,NaN,NaN,39.57070784732775,NaN,NaN,41.27299999999985,46.82462714886839,35.72137285113131,36.342115960702905,37.95578077615009,38.21116350017854,37.70039805212164,9807,26212.466666666667,46.20166212014329,33.701273004182006,NaN,NaN,NaN,NaN,0.9736636481440275,25.7756087484071,-3625101,0.2228004149794387,-1.0908086913463393,-1.313609106325778
2023-01-03T09:30:00-05:00,39.35,39.71,37.2,37.27,35.10512767598091,35.10512767598091,35.10512767598091,NaN,NaN,NaN,41.134999999999856,46.73454462434674,35.53545537565297,36.680692768562324,38.06,38.06,38.06,5805,25296,39.78170237927153,34.07399616425533,NaN,NaN,NaN,NaN,1.0834019589908825,24.13500440201397,-3630906,0.19822810618495623,-1.0658239735945827,-1.264052079779539
2023-01-03T13:30:00-05:00,37.36,37.94,37.36,37.755,35.10512767598091,NaN,NaN,NaN,NaN,NaN,41.01489999999986,46.641613602099255,35.38818639790047,36.680692768562324,37.741369439121655,37.87538819155431,37.607350686689,32813,25999.2,43.036996872018214,34.70143099257603,NaN,NaN,NaN,NaN,1.0538732476343906,22.6115860803632,-3598093,0.21491090267129498,-0.9954134514404203,-1.2103243541117152
2023-01-04T09:30:00-05:00,38.19,39.2,37.87,39.05,35.19848410146194,NaN,NaN,NaN,NaN,NaN,40.93749999999986,46.56372937677171,35.311270623228005,36.680692768562324,38.70666666666666,38.70666666666666,38.70666666666666,9552,25909.6,50.70034267820839,36.56731481589231,NaN,NaN,NaN,NaN,1.0818108728033626,21.90343682092834,-3588541,0.30777954241773053,-0.8255999260895521,-1.1333794685072827
2023-01-04T13:30:00-05:00,39.08,39.23,38.53,38.97,35.599689369577305,NaN,NaN,NaN,NaN,NaN,40.865499999999855,46.49845668366538,35.23254331633433,36.680692768562324,38.81597211463981,38.91735140311237,38.714592826167255,11104,26096.833333333332,50.25059220175924,37.84676863941094,NaN,NaN,NaN,NaN,1.054538667603122,21.26989094420492,-3599645,0.35508088561703355,-0.6895283614859906,-1.0446092471030242
2023-01-05T09:30:00-05:00,38.01,38.01,37.27,37.93,35.599689369577305,NaN,NaN,NaN,NaN,NaN,40.777099999999855,46.45266308748748,35.10153691251223,36.680692768562324,37.73666666666667,37.73666666666667,37.73666666666667,8707,18771.9,44.69935221918185,38.84595465541535,NaN,NaN,NaN,NaN,1.1006430484886132,20.01762954472566,-3608352,0.3092676571247853,-0.6580246756970425,-0.9672923328218278
2023-01-05T13:30:00-05:00,37.85,37.92,37.49,37.55,35.599689369577305,NaN,NaN,NaN,NaN,NaN,40.68229999999985,46.41170597619434,34.95289402380536,36.680692768562324,37.694101022586814,37.735757990196866,37.65244405497676,9091,18426.566666666666,42.837242504682656,39.59313679103813,NaN,NaN,NaN,NaN,1.053454259310855,18.854815388066353,-3617443,0.24890839873629056,-0.6561568344014646,-0.9050652331377551
2023-01-06T09:30:00-05:00,37.37,38.21,36.55,38.21,35.599689369577305,NaN,NaN,NaN,NaN,NaN,40.594299999999855,46.337715015480796,34.85088498451891,36.680692768562324,37.656666666666666,37.656667143503824,37.65666618982951,12585,18028.533333333333,46.96938882026008,40.93516453414944,NaN,NaN,NaN,NaN,1.0967789550743654,18.557359820555792,-3604858,0.24839916045659172,-0.5945662825670155,-0.8429654430236072
2023-01-06T13:30:00-05:00,38.43,38.57,38.32,38.41,35.599689369577305,NaN,NaN,NaN,NaN,NaN,40.45769999999985,46.07617566872459,34.83922433127512,36.680692768562324,38.009504090422915,38.39621175543787,37.62279642540796,10477,17289.4,48.19156478661476,42.402830775348306,NaN,NaN,NaN,NaN,1.044151886854768,17.913961305493558,-3594381,0.25550717311682447,-0.5235814766275766,-0.7790886497444011
2023-01-09T09:30:00-05:00,39.57,40.9,39.57,40.86,36.79815147336482,NaN,NaN,NaN,NaN,NaN,40.359499999999855,45.77096939380141,34.9480306061983,37.63642495047808,40.443333333333335,40.443333333333335,40.443333333333335,4582,16590.566666666666,60.270762904588324,44.69384575833491,NaN,NaN,NaN,NaN,1.1474267520794275,17.81496308836571,-3589799,0.4100243083848617,-0.26655826426332396,-0.6765825726481857
2023-01-09T13:30:00-05:00,40.5,40.5,40,40.04,36.852099133666414,NaN,NaN,NaN,NaN,NaN,40.240499999999855,45.40763856985174,35.07336143014797,37.63642495047808,40.30177970663437,40.43307463849507,40.17048477477367,5326,16342.033333333333,55.59844161384361,46.67295942294756,NaN,NaN,NaN,NaN,1.1268962697880398,17.723036172461285,-3595125,0.4392162933340438,-0.12756220598063095,-0.5667784993146747
2023-01-10T09:30:00-05:00,39.76,40.59,39.69,40.47,36.852099133666414,NaN,NaN,NaN,NaN,NaN,40.13269999999986,45.04500585774647,35.22039414225325,37.70731196830597,40.25,40.25,40.25,8482,15258.466666666667,57.46076448904242,47.79035816489885,NaN,NaN,NaN,NaN,1.1106893933746087,17.34277863645334,-3586643,0.46709762692173806,0.01709353433749783,-0.45000409258424023
2023-01-10T13:30:00-05:00,40.53,41.09,40.53,41.09,37.51228454121258,NaN,NaN,NaN,NaN,NaN,40.029699999999856,44.631623254472004,35.42777674552771,38.473849574644774,40.63617943402594,40.9573792809003,40.31497958715158,12261,14637.933333333332,60.061838730994076,48.990744907658886,NaN,NaN,NaN,NaN,1.0756401509907083,17.352428846030495,-3574382,0.5037566301986683,0.17969169516409522,-0.3240649350345731
2023-01-11T09:30:00-05:00,41.4,41.91,40.91,41.7,38.12581706206655,NaN,NaN,NaN,NaN,NaN,39.97949999999985,44.4508327990713,35.508167200928405,39.317079659715816,41.50666666666666,41.50666734101624,41.50666599231708,30712,15282.8,62.491867094147004,50.610894243911105,NaN,NaN,NaN,NaN,1.0702372830628006,17.908859801970145,-3543670,0.5422092413592927,0.3536966166645428,-0.18851262469474994
2023-01-11T13:30:00-05:00,41.78,41.94,41.61,41.93,38.59509810469989,NaN,NaN,NaN,NaN,NaN,39.94129999999985,44.31154704565459,35.571052954345106,39.70066372777265,41.60225089245617,41.74871115339175,41.455790631520586,13081,14783.733333333334,63.3962077235075,51.83907607272283,NaN,NaN,NaN,NaN,1.0173631914154577,18.44504104973012,-3530589,0.5542837849870675,0.5043421065390845,-0.04994167844798306
2023-01-12T09:30:00-05:00,42.15,42.46,40.73,42.25,38.59509810469989,NaN,NaN,NaN,NaN,NaN,39.946499999999844,44.32709185499564,35.565908145004045,39.80353098221812,41.81333333333333,41.81333381017049,41.813332856496174,10500,14744.4,64.67243245877658,53.61698536411605,NaN,NaN,NaN,NaN,1.0682658206000681,18.017696301229137,-3520089,0.5536723642616581,0.6421487768790897,0.0884764126174315
2023-01-12T13:30:00-05:00,42.05,42.96,42.05,42.92,39.25833319043936,NaN,NaN,NaN,NaN,NaN,39.960899999999846,44.37562884332139,35.546171156678305,40.379824785774495,42.08681992337165,42.47694676787319,41.69669307887011,5160,14710.366666666667,67.2473153801965,55.34629382898593,NaN,NaN,NaN,NaN,1.056961119128635,17.99254091243561,-3514929,0.566215929554028,0.7962463245599665,0.2300303950059385
2023-01-13T09:30:00-05:00,42.08,43.79,42.04,43.3,39.57727259087394,NaN,NaN,NaN,NaN,NaN,39.98669999999985,44.46366665612471,35.50973334387499,40.8508598286196,43.04333333333333,43.04333333333333,43.04333333333333,14812,13969.666666666666,68.64325982880142,56.627930768314,NaN,NaN,NaN,NaN,1.1064638963337325,18.5340834775141,-3500117,0.5665495876637308,0.9382173795856019,0.37166779192187116
2023-01-13T13:30:00-05:00,43.33,44,43.32,43.92,40.378532927652394,NaN,NaN,NaN,NaN,NaN,40.032699999999856,44.62171087817947,35.44368912182024,41.298687862895676,43.28972674240098,43.62526658456424,42.95418690023772,7987,13893.366666666667,70.82790836421876,58.09773906563254,NaN,NaN,NaN,NaN,1.0774307608813234,19.17253207583466,-3492130,0.573237779791857,1.0882150166616924,0.5149772368698354
2023-01-17T09:30:00-05:00,44.56,45.18,43.76,45.11,41.14405415821365,NaN,NaN,NaN,NaN,NaN,40.08129999999986,44.83011408775378,35.332485912245936,42.30895029031654,44.68333333333334,44.68333333333334,44.68333333333334,12797,13489.333333333334,74.5001278360527,60.226365895409025,NaN,NaN,NaN,NaN,1.1018999922469432,20.458027977326942,-3479333,0.6186278081737245,1.288261997086991,0.6696341889132665
2023-01-17T13:30:00-05:00,45.14,45.49,45.08,45.37,42.05432442374939,NaN,NaN,NaN,NaN,NaN,40.133699999999855,45.05387512290477,35.21352487709494,42.98816023225323,44.959281688697615,45.27185163135252,44.64671174604271,9974,13097,75.23368427741852,62.54039745060445,NaN,NaN,NaN,NaN,1.0524785642293046,21.81527921949799,-3469359,0.6251355721882285,1.4510536541485521,0.8259180819603237
2023-01-18T09:30:00-05:00,46.09,46.41,43.97,43.97,42.05432442374939,NaN,NaN,NaN,NaN,NaN,40.15929999999985,45.14529077817551,35.1733092218242,43.18852818580258,44.78333333333333,44.78333333333333,44.78333333333333,44215,13712,64.47782138179966,63.790999776428706,NaN,NaN,NaN,NaN,1.1515872382129255,21.848057471103957,-3513574,0.4995694060704359,1.4503798395483685,0.9508104334779326
2023-01-18T13:30:00-05:00,44.17,44.34,43.85,43.85,42.05432442374939,NaN,NaN,NaN,NaN,NaN,40.18769999999986,45.240827035811634,35.13457296418808,43.18852818580258,44.57006982600732,44.914644312996984,44.225495339017655,16937,13988.666666666666,63.637999206211155,64.89431652068559,NaN,NaN,NaN,NaN,1.1043310069120025,21.75496401274153,-3530511,0.3783522351167625,1.4237507273738856,1.0453984922571231
2023-01-19T09:30:00-05:00,43.05,43.51,42.38,42.58,42.05432442374939,NaN,NaN,NaN,NaN,NaN,40.18189999999986,45.22335093797903,35.140449062020686,43.18852818580258,42.82333333333333,42.82333333333333,42.82333333333333,7985,13601.5,55.412011482486825,64.54726284767834,NaN,NaN,NaN,NaN,1.1304502207040021,20.31455463831083,-3538496,0.19196267981425708,1.2853518420249443,1.0933891622106873
2023-01-19T13:30:00-05:00,42.98,43.28,42.8,42.8,42.05432442374939,NaN,NaN,NaN,NaN,NaN,40.17389999999985,45.19740606250784,35.150393937491856,43.18852818580258,42.887004459308805,42.95517856192232,42.818830356695294,6965,13479.5,56.46190347003691,64.6089386945493,NaN,NaN,NaN,NaN,1.0997037763680022,18.977031647768037,-3531531,0.06914598239486369,1.179821640204267,1.1106756578094032
2023-01-20T09:30:00-05:00,43.42,44.33,43.09,44.26,42.05432442374939,NaN,NaN,NaN,NaN,NaN,40.18969999999985,45.25933210105552,35.120067898944185,43.18852818580258,43.89333333333333,43.893334159239515,43.89333250742715,13789,13031.166666666666,62.73327867812235,64.98554685091214,NaN,NaN,NaN,NaN,1.130439220913145,18.54519118810952,-3517742,0.0715900803626075,1.2001632582626627,1.1285731779000552
2023-01-20T13:30:00-05:00,44.3,45.19,44.3,45.09,42.05432442374939,NaN,NaN,NaN,NaN,NaN,40.222899999999846,45.39763017268093,35.048169827318766,43.18852818580258,44.45010527178982,44.92782682498652,43.97238371859313,18730,13259.5,65.75337660225969,65.39208527028826,NaN,NaN,NaN,NaN,1.1161221337050633,18.718087534377673,-3499012,0.1120487980405327,1.268634175450721,1.1565853774101884
2023-01-23T09:30:00-05:00,45.61,47.11,45.22,47.1,42.691551302836324,NaN,NaN,NaN,NaN,NaN,40.29089999999985,45.72925257776216,34.85254742223754,43.833372892739035,46.47666666666667,46.47666666666667,46.47666666666667,44756,14103.666666666666,71.72855065807262,66.05184838199723,NaN,NaN,NaN,NaN,1.1806848384404156,19.90369099854707,-3454256,0.24926289148065717,1.4681639917610099,1.2189011002803527
2023-01-23T13:30:00-05:00,47.17,47.25,46.68,47.25,43.57170806179831,NaN,NaN,NaN,NaN,NaN,40.37329999999986,46.098507982252826,34.64809201774689,44.34369831419123,46.618245910885506,46.868332316088505,46.368159505682506,14344,14315.633333333333,72.11949357218526,66.67494022833135,NaN,NaN,NaN,NaN,1.1370644928375289,21.069559927286313,-3439912,0.32065941522050356,1.619725369305982,1.2990659540854785
2023-01-24T09:30:00-05:00,46.63,47.73,46.31,46.64,43.58731224080748,NaN,NaN,NaN,NaN,NaN,40.48649999999986,46.47307038712912,34.499929612870595,44.694958651352984,46.89333333333334,46.89333333333334,46.89333333333334,6400,13991.2,68.00130902259744,66.91271712574712,NaN,NaN,NaN,NaN,1.1572741719205621,22.37693413965804,-3446312,0.29782776544739087,1.671350660894717,1.3735228954473262
2023-01-24T13:30:00-05:00,46.68,46.74,46.23,46.5,43.58731224080748,NaN,NaN,NaN,NaN,NaN,40.596899999999856,46.81491926340316,34.37888073659655,44.694958651352984,46.70130757476534,46.90274366223647,46.49987148729421,5816,13858.166666666666,67.05492649997213,66.89897506287396,NaN,NaN,NaN,NaN,1.1110403024976652,23.503527160611366,-3452128,0.24644808710052368,1.681583004322981,1.4351349172224572
2023-01-25T09:30:00-05:00,45.18,46.12,44.34,46.11,43.58731224080748,NaN,NaN,NaN,NaN,NaN,40.71829999999986,47.12232548714877,34.31427451285094,44.694958651352984,45.52333333333333,45.52333333333333,45.52333333333333,26886,14560.866666666667,64.36749560738103,66.5935633327725,NaN,NaN,NaN,NaN,1.185965995176403,22.747997103015656,-3479014,0.16335234415444577,1.6393253474155145,1.4759730032610687
2023-01-25T13:30:00-05:00,46.27,46.89,46.25,46.69,43.58731224080748,NaN,NaN,NaN,NaN,NaN,40.84629999999985,47.46326510796708,34.22933489203262,44.694958651352984,45.72369615337944,46.145101348086726,45.30229095867216,6078,13669.7,66.5167242685832,66.28562161165567,NaN,NaN,NaN,NaN,1.1569684240923743,22.507706140278025,-3472936,0.12626442338233135,1.633803532488983,1.5075391091066517
2023-01-26T09:30:00-05:00,48.49,48.65,46.74,47.11,44.147492836488624,NaN,NaN,NaN,NaN,NaN,40.99529999999985,47.83061664519306,34.15998335480664,45.29308706359418,47.5,47.5,47.5,12752,13776.366666666667,68.0209328014816,65.82282196632916,NaN,NaN,NaN,NaN,1.2143278223714904,23.173524115248554,-3460184,0.10945891594859103,1.6443627540423904,1.5349038380937994
2023-01-26T13:30:00-05:00,47.27,47.83,47.22,47.82,44.147492836488624,NaN,NaN,NaN,NaN,NaN,41.165499999999845,48.24395922500477,34.08704077499492,45.29308706359418,47.56047375432986,47.6221288817622,47.498818626897524,12268,13815.166666666666,70.43861199088118,65.48031680300507,NaN,NaN,NaN,NaN,1.1790186922020982,23.79178366343547,-3447916,0.12450464822558538,1.690534648375781,1.5660300001501957
2023-01-27T09:30:00-05:00,47.66,50,47.41,50,45.02576310101546,NaN,NaN,NaN,NaN,NaN,41.38409999999985,48.85444288102326,33.913757118976434,46.26857572070028,49.13666666666666,49.13666666666666,49.13666666666666,51623,15245.7,76.35062495269666,66.32837420092628,NaN,NaN,NaN,NaN,1.27980307133052,25.24640796293749,-3396293,0.2522535928783074,1.8813469912480798,1.6290933983697724
2023-01-27T13:30:00-05:00,50.1,50.7,50.1,50.2,46.792546596423854,NaN,NaN,NaN,NaN,NaN,41.606699999999854,49.442325210540204,33.771074789459504,47.36486057656022,49.59287709709253,50.17408605972757,49.011668134457494,31806,16002.866666666667,76.80886262441018,67.26915015936906,NaN,NaN,NaN,NaN,1.2383885662354832,26.83289562206374,-3364487,0.31701200552746767,2.025358405279107,1.7083463997516393
2023-01-30T09:30:00-05:00,49.63,49.95,48.36,48.97,46.792546596423854,NaN,NaN,NaN,NaN,NaN,41.79409999999985,49.87319987313287,33.71500012686683,47.36486057656022,49.09333333333334,49.09333333333334,49.09333333333334,43940,17048.033333333333,68.07299973703039,68.17350646326504,NaN,NaN,NaN,NaN,1.2813608115043775,26.86720892882108,-3408427,0.24691263630212545,2.016987195129296,1.7700745588271707
2023-01-30T13:30:00-05:00,48.91,48.91,47.89,47.93,46.792546596423854,NaN,NaN,NaN,NaN,NaN,41.96189999999985,50.193831216917125,33.729968783082576,47.36486057656022,48.686613337131284,49.111220027447274,48.262006646815294,40316,18042.666666666668,61.68470589080894,68.54656377903447,NaN,NaN,NaN,NaN,1.2669778963969218,26.551508357070734,-3448743,0.10752433907767744,1.9044799826742675,1.79695564359659
2023-01-31T09:30:00-05:00,48.31,49.9,48.31,49.61,46.792546596423854,NaN,NaN,NaN,NaN,NaN,42.21209999999986,50.59677175028651,33.82742824971321,47.36486057656022,49.27333333333333,49.27333333333333,49.27333333333333,36655,19111.766666666666,67.0620431709128,68.85576124280522,NaN,NaN,NaN,NaN,1.3171937609399988,26.700303804702624,-3412088,0.10535302486708797,1.92864692468045,1.823293899813362
2023-01-31T13:30:00-05:00,49.65,49.98,49.49,49.78,46.792546596423854,NaN,NaN,NaN,NaN,NaN,42.44729999999985,51.00635350141328,33.88824649858642,47.36486057656022,49.489601528113106,49.72691125703094,49.25229179919527,30443,19949,67.55820608314113,68.98467763429674,NaN,NaN,NaN,NaN,1.258108492301427,26.873618543145238,-3381645,0.092695687934647,1.9391635097316708,1.8464678217970238
2023-02-01T09:30:00-05:00,49.87,50.27,49.21,49.77,46.792546596423854,NaN,NaN,NaN,NaN,NaN,42.691099999999864,51.375232032624254,34.00696796737547,47.36486057656022,49.75,49.75,49.75,11600,20052.933333333334,67.49379994134122,68.68219544024451,NaN,NaN,NaN,NaN,1.243957885708468,27.167246460366172,-3393245,0.062430981915034156,1.9245065491908164,1.8620755672757823
2023-02-01T13:30:00-05:00,49.81,52.52,49.4,52.24,47.05208477268623,NaN,NaN,NaN,NaN,NaN,42.98029999999985,51.9493919072142,34.0112080927855,48.477943610981804,50.997263870372265,51.694177092258734,50.3003506484858,37155,20882.733333333334,74.06949646524728,68.8214813611775,NaN,NaN,NaN,NaN,1.3779608938721493,28.325575711024737,-3356090,0.18084235739414,2.0881285140184573,1.9072861566243173
2023-02-02T09:30:00-05:00,54.26,56.28,54.17,56.24,50.94380819210958,NaN,NaN,NaN,NaN,NaN,43.37249999999985,52.894516225571934,33.85048377442777,51.02635488878544,55.56333333333333,55.56333333333333,55.56333333333333,24954,20690.8,80.83191453520251,69.73795318350645,NaN,NaN,NaN,NaN,1.5681065443098527,30.389241033260294,-3331136,0.4834625497820344,2.5116143438518606,2.028151794069826
2023-02-02T13:30:00-05:00,56.28,56.76,54.53,55.67,51.25431691065005,NaN,NaN,NaN,NaN,NaN,43.75649999999985,53.67444782200706,33.838552177992646,51.44208391102835,55.60387158818951,55.64864985111458,55.55909332526445,20452,20936.5,77.72140692946434,70.49984464275589,NaN,NaN,NaN,NaN,1.6153846482877203,32.4048158293262,-3351588,0.5929287767573173,2.7693127650164726,2.1763839882591554
2023-02-03T09:30:00-05:00,52.95,56.2,52.95,54.51,51.25431691065005,NaN,NaN,NaN,NaN,NaN,44.11609999999986,54.26113214189358,33.97106785810614,51.44208391102835,54.553333333333335,54.553333333333335,54.553333333333335,28499,21536.466666666667,71.67645647301481,71.02191327601544,NaN,NaN,NaN,NaN,1.7321428876957403,33.10609159365651,-3380087,0.5365876134519043,2.847118505074036,2.3105308916221317
2023-02-03T13:30:00-05:00,54.41,54.41,53.51,53.69,51.25431691065005,NaN,NaN,NaN,NaN,NaN,44.46089999999985,54.71162518215447,34.210174817845235,51.44208391102835,54.34475174711523,54.65943328847505,54.030070205755415,12521,21781.833333333332,67.66975276105887,71.10427245404942,NaN,NaN,NaN,NaN,1.6798469671460445,33.75727623196323,-3392608,0.399750101007752,2.8102185178818218,2.4104684168740698
2023-02-06T09:30:00-05:00,52.67,53.55,52.28,52.87,51.25431691065005,NaN,NaN,NaN,NaN,NaN,44.75649999999986,55.10723992524459,34.40576007475513,51.44208391102835,52.9,52.9,52.9,31369,22333.733333333334,63.82735573237415,70.80473123482746,NaN,NaN,NaN,NaN,1.6605721837784697,33.495295625601116,-3423977,0.21872117357113252,2.6838698838379855,2.465148710266853
2023-02-06T13:30:00-05:00,52.63,53.04,52.3,52.72,51.25431691065005,NaN,NaN,NaN,NaN,NaN,45.045099999999856,55.46300736952745,34.62719263047226,51.44208391102835,52.84679428279734,52.93909652903521,52.75449203655947,10423,22414.933333333334,63.121289244842664,70.28206532439613,NaN,NaN,NaN,NaN,1.5948170277942935,33.25202791969343,-3434400,0.06174308382007876,2.5423275650419512,2.4805844812218725
2023-02-07T09:30:00-05:00,52.52,53.7,51.49,52.01,51.25431691065005,NaN,NaN,NaN,NaN,NaN,45.332499999999854,55.71018495378692,34.95481504621279,51.44208391102835,52.4,52.4,52.4,30033,22989.466666666667,59.751965703865544,69.09644680662248,NaN,NaN,NaN,NaN,1.6387586686661297,32.45773597174755,-3464433,-0.10780997266832992,2.34582201538646,2.45363198805479
2023-02-07T13:30:00-05:00,52.005,53.8,51.63,53.53,51.25431691065005,NaN,NaN,NaN,NaN,NaN,45.63229999999986,56.07364573893886,35.19095426106086,51.44208391102835,52.66830586874819,52.96056956895983,52.37604216853655,25311,23500.7,64.16234881395482,68.19312439158996,NaN,NaN,NaN,NaN,1.6767044780471199,31.76504887950074,-3439122,-0.13379741224703867,2.2863852227459915,2.42018263499303
2023-02-08T09:30:00-05:00,53.29,54.21,52.47,52.69,51.25431691065005,NaN,NaN,NaN,NaN,NaN,45.94069999999986,56.28632245783473,35.59507754216499,51.44208391102835,53.12333333333334,53.12333333333334,53.12333333333334,45033,23527.966666666667,60.234138542202004,67.63320573481649,NaN,NaN,NaN,NaN,1.6812255867580401,31.311599060536192,-3484155,-0.21874313519275912,2.146753716002081,2.36549685119484
2023-02-08T13:30:00-05:00,52.64,52.84,52.28,52.31,51.25431691065005,NaN,NaN,NaN,NaN,NaN,46.23179999999986,56.45813517150971,36.005464828490005,51.44208391102835,52.99230764690606,53.25223497018283,52.73238032362929,11443,23344.833333333332,58.48959395622921,67.40498345377509,NaN,NaN,NaN,NaN,1.6011380448467516,30.73936324389838,-3495598,-0.3063350875697828,1.9825779917326116,2.2889130793023944
2023-02-09T09:30:00-05:00,53.05,53.37,51.32,51.79,51.25431691065005,NaN,NaN,NaN,NaN,NaN,46.48659999999986,56.61889814800453,36.35430185199519,51.44208391102835,52.16,52.16,52.16,26124,23949.466666666667,56.09533803747018,66.62164737281489,NaN,NaN,NaN,NaN,1.6331996130719835,29.467307007095954,-3521722,-0.39923020371060547,1.7898753246641377,2.189105528374743
2023-02-09T13:30:00-05:00,51.74,51.895,50.24,50.47,NaN,NaN,NaN,55.67857310681047,55.67857310681047,55.67857310681047,46.716599999999865,56.6765860321214,36.75661396787833,50.320667128822684,51.460469998479155,52.10406720346873,50.81687279348958,30862,24746.033333333333,50.4497842727771,65.39961724350319,NaN,NaN,NaN,NaN,1.6347567835668417,27.540204985688117,-3552584,-0.5407237293331297,1.5132008667083312,2.053924596041461
2023-02-10T09:30:00-05:00,49.56,50.32,48.51,48.99,NaN,NaN,NaN,54.08375160195545,NaN,NaN,46.93779999999986,56.59402724670747,37.28157275329225,49.5815201638181,49.27333333333333,49.27333333333333,49.27333333333333,41102,25656.466666666667,44.98335100715174,63.79172803391822,NaN,NaN,NaN,NaN,1.657988441883496,26.402448267774698,-3593686,-0.7142388795455468,1.1611259966095275,1.8753648761550743
2023-02-10T13:30:00-05:00,48.97,48.97,48.55,48.88,NaN,NaN,NaN,53.27653562004838,NaN,NaN,47.16439999999986,56.453568023028566,37.87523197697115,49.5815201638181,49.15161024862494,49.358489643629895,48.94473085361999,14229,25506.433333333334,44.596572906677906,61.68651920830611,NaN,NaN,NaN,NaN,1.5709892674632466,25.345959886855095,-3607915,-0.8096705184822661,0.8632767280522415,1.6729472465345077
2023-02-13T09:30:00-05:00,48.91,49.95,48.31,49.93,NaN,NaN,NaN,53.27653562004838,NaN,NaN,47.39879999999985,56.35794338762692,38.43965661237279,49.5815201638181,49.39666666666667,49.39666734101625,49.39666599231709,55191,25854.266666666666,49.09586730590741,59.41965869192789,NaN,NaN,NaN,NaN,1.5759186055015861,23.70411517608535,-3552724,-0.775284348154391,0.703841811341519,1.47912615949591
2023-02-13T13:30:00-05:00,49.96,50.05,49.43,49.64,NaN,NaN,NaN,53.27653562004838,NaN,NaN,47.623399999999855,56.2258662603267,39.02093373967301,49.5815201638181,49.51438298175225,49.664832065629824,49.363933897874674,33788,26502.4,47.93794199029114,57.292268339129805,NaN,NaN,NaN,NaN,1.5076387051086155,22.113547945544212,-3586512,-0.7450821094997289,0.5477735226212488,1.2928556321209776
2023-02-14T09:30:00-05:00,48.94,51.44,48.83,50.53,NaN,NaN,NaN,53.27653562004838,NaN,NaN,47.81679999999986,56.235184110983354,39.39841588901636,49.5815201638181,50.26666666666667,50.26666666666667,50.26666666666667,61282,28331.8,51.702684651415765,55.865570351872734,NaN,NaN,NaN,NaN,1.5863787976008574,21.293896135675645,-3525230,-0.6420824932717113,0.4902525155313384,1.1323350088030497
2023-02-14T13:30:00-05:00,50.62,51.5,50.25,51.36,NaN,NaN,NaN,53.27653562004838,NaN,NaN,48.04319999999985,56.21817492595915,39.86822507404055,49.5815201638181,50.53081194657062,50.89635146102827,50.16527243211298,32000,29204.6,54.97279018649063,54.95864445368928,NaN,NaN,NaN,NaN,1.5623517406293677,20.567916758018022,-3493230,-0.501219925128711,0.5058101023921608,1.007030027520872
2023-02-15T09:30:00-05:00,51.99,54.07,51.95,54.03,48.315040778547015,48.315040778547015,48.315040778547015,NaN,NaN,NaN,48.31439999999986,56.36518198438258,40.26361801561713,49.67615128599508,53.35,53.35,53.35,44039,29776.366666666665,63.527769348418154,54.93724542626386,NaN,NaN,NaN,NaN,1.6443266162986987,21.17894012868242,-3449191,-0.22544295781884982,0.7252263302473096,0.9506692880661595
2023-02-15T13:30:00-05:00,54.04,55.03,54.04,55.03,49.917084379522144,NaN,NaN,NaN,NaN,NaN,48.59319999999986,56.589246463100224,40.5971535368995,51.01492102879607,54.16246801623825,54.82332166456895,53.50161436790755,66564,31792.566666666666,66.1238122941867,55.15171135835986,NaN,NaN,NaN,NaN,1.5983032865630773,22.12758490863027,-3382627,0.014377388364129717,0.9686410235213216,0.9542636351571919
2023-02-16T09:30:00-05:00,53.99,55.76,53.34,54.77,49.917084379522144,NaN,NaN,NaN,NaN,NaN,48.854599999999856,56.78645800175849,40.92274199824122,51.337936823036856,54.623333333333335,54.623333333333335,54.623333333333335,76826,33928.36666666667,64.83171537498924,55.51455062058299,NaN,NaN,NaN,NaN,1.6569959089514286,23.28040802095088,-3459453,0.1386460168024526,1.1275711561602577,0.9889251393578051
2023-02-16T13:30:00-05:00,54.79,55.32,53.49,53.49,49.917084379522144,NaN,NaN,NaN,NaN,NaN,49.08579999999986,56.86934067504366,41.302259324956054,51.337936823036856,54.44792577464708,54.69496587409181,54.20088567520236,38732,34810.5,58.74568032319492,55.12764572838585,NaN,NaN,NaN,NaN,1.6693533440263264,24.350886625248588,-3498185,0.11856468090878014,1.1371309904937803,1.0185663095850002
2023-02-17T09:30:00-05:00,53.34,53.5,52.1,52.23,49.917084379522144,NaN,NaN,NaN,NaN,NaN,49.28539999999985,56.86674363817277,41.704056361826936,51.337936823036856,52.60999999999999,52.60999999999999,52.60999999999999,69243,35397.833333333336,53.42868051853949,54.64154158383853,NaN,NaN,NaN,NaN,1.6501138194530172,24.222035729680808,-3567428,0.010066401091112454,1.0311493109488907,1.0210829098577783
2023-02-17T13:30:00-05:00,52.225,53.08,52.18,53.07,49.917084379522144,NaN,NaN,NaN,NaN,NaN,49.48839999999986,56.91916885389797,42.05763114610174,51.337936823036856,52.671185349029926,52.7515215876517,52.59084911040815,40165,35676.46666666667,56.27026748359395,54.48301826436459,NaN,NaN,NaN,NaN,1.5965342609206588,24.10238846951073,-3527263,-0.014168096491536719,1.0033727892433575,1.0175408857348942
2023-02-21T09:30:00-05:00,51.65,52.71,50.56,50.74,49.917084379522144,NaN,NaN,NaN,NaN,NaN,49.63719999999986,56.861421524846975,42.41297847515274,51.337936823036856,51.336666666666666,51.33666762034098,51.33666571299235,45567,35730.7,47.59530100569226,53.87587276209473,NaN,NaN,NaN,NaN,1.6617818137120401,22.82529017518001,-3572830,-0.18658697776528932,0.7843071635282826,0.9708941412935719
2023-02-21T13:30:00-05:00,50.75,50.91,50.35,50.37,49.917084379522144,NaN,NaN,NaN,NaN,NaN,49.766199999999856,56.80543733369339,42.72696266630632,51.337936823036856,51.025710403295044,51.41300637695199,50.6384144296381,29374,35365.96666666667,46.372708375691154,53.58465305516002,NaN,NaN,NaN,NaN,1.5830831127326082,21.50089694908491,-3602204,-0.3173385867153925,0.5742209078993312,0.8915594946147237
2023-02-22T09:30:00-05:00,50.75,51.69,50.03,50.94,49.917084379522144,NaN,NaN,NaN,NaN,NaN,49.882799999999854,56.80178031794156,42.96381968205815,51.337936823036856,50.88666666666666,50.88666666666666,50.88666666666666,43807,35604.36666666667,48.56468982217033,53.840462970518495,NaN,NaN,NaN,NaN,1.5885771761088503,20.736386944051134,-3558397,-0.3544078583855469,0.44854967163279014,0.802957530018337
2023-02-22T13:30:00-05:00,50.95,51.21,50.51,51.03,49.917084379522144,NaN,NaN,NaN,NaN,NaN,49.995999999999846,56.80019635225692,43.19180364774277,51.337936823036856,50.90010635214657,50.91502497870621,50.88518772558694,35552,35774.666666666664,48.91971297450297,54.149258689648846,NaN,NaN,NaN,NaN,1.5251073778153612,20.02648479651977,-3522845,-0.3606403349359746,0.3521571113483688,0.7127974462843434
2023-02-23T09:30:00-05:00,51.51,51.51,49.3,49.75,NaN,NaN,NaN,55.04180935170718,55.04180935170718,55.04180935170718,50.11159999999985,56.69517515033183,43.528024849667865,51.337936823036856,50.18666666666667,50.18666666666667,50.18666666666667,59300,37364.666666666664,44.242500291070954,53.802589617160535,NaN,NaN,NaN,NaN,1.5740282793999785,18.68805098430591,-3582145,-0.4338264161507329,0.17051442609592726,0.6043408422466602
2023-02-23T13:30:00-05:00,49.75,50.96,49.71,50.75,NaN,NaN,NaN,54.93149983572049,NaN,NaN,50.249599999999845,56.5870505410352,43.91214945896449,51.337936823036856,50.305359050875154,50.446558442058006,50.1641596596923,41902,37522.9,48.393762173168625,53.83514820165178,NaN,NaN,NaN,NaN,1.55088340229998,17.445219587250183,-3540243,-0.3986481326899505,0.10603067638422203,0.5046788090741725
2023-02-24T09:30:00-05:00,49.44,49.79,48.72,49.24,NaN,NaN,NaN,53.91938620682409,NaN,NaN,50.38279999999984,56.33830439845933,44.42729560154035,50.86734945842949,49.25,49.25,49.25,35300,37867.76666666667,43.167455161452324,53.22548895236868,NaN,NaN,NaN,NaN,1.5851060164214101,16.952526855296387,-3575543,-0.45666700501521496,-0.06615494719484616,0.3905120578203688
2023-02-24T13:30:00-05:00,49.17,49.37,48.81,49.3,NaN,NaN,NaN,53.6187322883321,NaN,NaN,50.51279999999984,56.0710659742106,44.95453402578909,49.23787956674359,49.2172308690013,49.2605368252169,49.173924912785694,20212,37859.76666666667,43.42888745832298,52.40092447178528,NaN,NaN,NaN,NaN,1.5118841581055948,16.495026461339293,-3555331,-0.4688240352269095,-0.1955179862132681,0.2733060490136414
2023-02-27T09:30:00-05:00,50.01,50.14,49.33,49.85,NaN,NaN,NaN,53.6187322883321,NaN,NaN,50.624599999999845,55.8925851328632,45.356614867136486,49.22030365339487,49.77333333333333,49.77333333333333,49.77333333333333,24427,37724.03333333333,45.88623189392965,51.14081465360753,NaN,NaN,NaN,NaN,1.463892432526624,15.454215563476218,-3530904,-0.41925925960081295,-0.25076802548737476,0.1684912341134382
2023-02-27T13:30:00-05:00,49.8,50.02,49.43,49.7,NaN,NaN,NaN,53.6187322883321,NaN,NaN,50.71679999999985,55.750239285425494,45.683360714574206,48.3672429227159,49.74020782666373,49.768132956051176,49.71228269727628,34372,38452.4,45.30818741769893,49.653984305286976,NaN,NaN,NaN,NaN,1.4014715444890082,14.487748301174792,-3565276,-0.3773235072782134,-0.3031631499843286,0.07416035729388483
2023-02-28T09:30:00-05:00,50.05,50.85,50.05,50.79,NaN,NaN,NaN,53.6187322883321,NaN,NaN,50.79059999999985,55.71682112374855,45.864378876251145,48.000094712824804,50.563333333333325,50.56333428700764,50.56333237965901,24703,38230.2,50.21600617613533,48.6100050767974,NaN,NaN,NaN,NaN,1.383509291311222,13.962411140125983,-3540573,-0.2623739206641067,-0.2538070435362485,0.008566877127858169
2023-02-28T13:30:00-05:00,50.84,51.17,50.5,50.53,NaN,NaN,NaN,53.6187322883321,NaN,NaN,50.85619999999985,55.67833710299344,46.034062897006265,48.55507577025985,50.639809292623355,50.72438080514409,50.55523778010262,20200,38556.1,49.08453775313531,47.919923464650296,NaN,NaN,NaN,NaN,1.332544341931849,13.710619042928743,-3560773,-0.19324236742047823,-0.23298608214773964,-0.039743714727261396
2023-03-01T09:30:00-05:00,50.51,50.78,49.51,49.68,NaN,NaN,NaN,53.6187322883321,NaN,NaN,50.91699999999985,55.59960483065426,46.23439516934545,48.55507577025985,49.99,49.99,49.99,17300,38131.666666666664,45.47691185342286,47.35193998857054,NaN,NaN,NaN,NaN,1.3280768889367172,12.821794861935002,-3578073,-0.19366464331431854,-0.2818245188701596,-0.08815987555584104
2023-03-01T13:30:00-05:00,49.6,49.7,49.38,49.56,NaN,NaN,NaN,53.551907143947645,NaN,NaN,50.978199999999845,55.5057082595253,46.45069174047439,48.55507577025985,49.814836829836835,50.031570620289145,49.598103039384526,11300,37664.63333333333,44.974350950969125,46.54508880766876,NaN,NaN,NaN,NaN,1.2560713968698087,12.10059379089409,-3589373,-0.19063147994645907,-0.32644922548891486,-0.1358177455424558
2023-03-02T09:30:00-05:00,48.51,49.21,48.15,49.02,NaN,NaN,NaN,52.701820455586386,NaN,NaN,51.03639999999985,55.38330650463826,46.68949349536144,48.55507577025985,48.79333333333333,48.79333333333333,48.79333333333333,32163,37235.63333333333,42.68821064239528,46.194582353147545,NaN,NaN,NaN,NaN,1.267066297093394,12.339595435872452,-3621536,-0.21196044872800557,-0.40076830645246275,-0.18880785772445718
2023-03-02T13:30:00-05:00,49,50.15,49,50.03,NaN,NaN,NaN,52.701820455586386,NaN,NaN,51.103199999999845,55.28021796022806,46.92618203977163,48.55507577025985,49.168063045460464,49.62558394571284,48.71054214520809,21576,37573.4,48.01124969013156,46.31162101846472,NaN,NaN,NaN,NaN,1.25870441872958,11.760205451201236,-3599960,-0.1480405505246596,-0.37385854588028167,-0.22581799535562208
2023-03-03T09:30:00-05:00,50.17,51.45,50.01,51.39,NaN,NaN,NaN,52.701820455586386,NaN,NaN,51.188799999999844,55.20739406261305,47.17020593738664,48.61992562839875,50.95000000000001,50.95000000000001,50.95000000000001,57690,38625.6,54.182201061406154,46.712871821267285,NaN,NaN,NaN,NaN,1.2716541031060389,11.55943675196643,-3542270,-0.01136550403027528,-0.24002487539346617,-0.2286593713631909
2023-03-03T13:30:00-05:00,51.41,51.75,51.28,51.48,NaN,NaN,NaN,52.701820455586386,NaN,NaN,51.261999999999844,55.164120449200524,47.359879550799164,49.250940502719,51.13243425588115,51.392558643822696,50.872309867939606,28376,38542.73333333333,54.56653337970562,47.11621613592462,NaN,NaN,NaN,NaN,1.2143930957413218,11.571130380206128,-3513894,0.08272379936369531,-0.12525462215857175,-0.20797842152226706
2023-03-06T09:30:00-05:00,51.81,52.53,51.31,51.68,NaN,NaN,NaN,52.701820455586386,NaN,NaN,51.29559999999984,55.18257756104586,47.40862243895381,49.9207524021752,51.84,51.84,51.84,48117,38776.566666666666,55.460639020664196,47.91751175946699,NaN,NaN,NaN,NaN,1.214793588902656,12.07755940814947,-3465777,0.15202026599404553,-0.017953089029710156,-0.16997335502375568
2023-03-06T13:30:00-05:00,51.65,51.65,50.99,51.01,NaN,NaN,NaN,52.701820455586386,NaN,NaN,51.31179999999984,55.18711199261055,47.43648800738914,49.9207524021752,51.68020008757695,51.95236290661587,51.40803726853803,16588,38855.2,51.78410234696466,48.15967891473813,NaN,NaN,NaN,NaN,1.177308332552466,12.26338003337711,-3482365,0.14627657511216993,0.012872363866456737,-0.1334042112457132
2023-03-07T09:30:00-05:00,50.97,51.85,50.22,51.34,NaN,NaN,NaN,52.701820455586386,NaN,NaN,51.359199999999845,55.17631899736807,47.54208100263162,49.9207524021752,51.13666666666666,51.13666666666666,51.13666666666666,56405,38895.666666666664,53.42189773500544,48.89213909856335,NaN,NaN,NaN,NaN,1.2096434516558614,11.780583252439866,-3425960,0.15728453095237158,0.06320145244475128,-0.0940830785076203
2023-03-07T13:30:00-05:00,51.48,51.48,50.51,50.63,NaN,NaN,NaN,52.701820455586386,NaN,NaN,51.41319999999984,55.109213939377156,47.717186060622524,49.9207524021752,51.05212954715073,51.17507228543338,50.929186808868074,26669,38658.36666666667,49.52413517418526,49.32751393541066,NaN,NaN,NaN,NaN,1.192526062251871,11.33227195585528,-3452629,0.11148618555791143,0.045274653439769,-0.06621153211814243
2023-03-08T09:30:00-05:00,50.45,51.08,49.78,50.4,NaN,NaN,NaN,52.701820455586386,NaN,NaN,51.42899999999985,55.1007194882051,47.757280511794605,49.9207524021752,50.419999999999995,50.419999999999995,50.419999999999995,49623,38269.73333333333,48.29485437094649,49.49955839805471,NaN,NaN,NaN,NaN,1.2002027720910229,10.73897963128365,-3502252,0.06286195507851458,0.01236591173000079,-0.050496043348513785
2023-03-08T13:30:00-05:00,50.36,50.93,50.25,50.79,NaN,NaN,NaN,52.701820455586386,NaN,NaN,51.44919999999985,55.09543387073138,47.80296612926832,49.9207524021752,50.47737001470715,50.57879117403816,50.37594885537614,15878,37732.333333333336,50.536863149063244,49.8730352360093,NaN,NaN,NaN,NaN,1.1630454312273781,10.188065329895709,-3486374,0.05443915353949135,0.017552898575850406,-0.036886254963640945
2023-03-09T09:30:00-05:00,50.69,51.7,49.35,49.4,NaN,NaN,NaN,52.701820455586386,NaN,NaN,51.44179999999985,55.10310619315911,47.780493806840596,49.9207524021752,50.150000000000006,50.150000000000006,50.150000000000006,19171,36903.4,43.32600339417762,49.38089218015518,NaN,NaN,NaN,NaN,1.2478279004254225,10.394302204080095,-3505545,-0.042064153434375404,-0.0894664467566102,-0.04740229332223479
2023-03-09T13:30:00-05:00,49.3,49.3,48.48,48.6,NaN,NaN,NaN,52.701820455586386,NaN,NaN,51.36899999999985,55.10785811446033,47.63014188553937,49.9207524021752,49.28247530028335,49.933891248811975,48.63105935175473,34001,35817.96666666667,39.80567163523668,48.71811602887671,NaN,NaN,NaN,NaN,1.2244116218236065,11.190397616108969,-3539546,-0.1509674576293272,-0.2361116153588938,-0.0851441577295666
2023-03-10T09:30:00-05:00,47.94,48.54,45.96,46.48,NaN,NaN,NaN,51.26596134347588,NaN,NaN,51.17379999999986,54.894109427999666,47.45349057200005,49.9207524021752,46.99333333333333,46.99333333333333,46.99333333333333,96036,36458.3,32.31291454023747,47.77783050650631,NaN,NaN,NaN,NaN,1.3255250774076346,13.235321665197471,-3635582,-0.345829179560314,-0.5174306321799591,-0.1716014526196451
2023-03-10T13:30:00-05:00,46.5,47.14,46.16,46.84,NaN,NaN,NaN,50.617054009681524,NaN,NaN,50.99719999999986,54.685184902363645,47.30921509763607,49.9207524021752,46.921635009657194,47.04384336048053,46.79942665883386,33056,36269.1,34.56536729136586,47.034331673677514,NaN,NaN,NaN,NaN,1.300844714735661,15.134179710779655,-3602526,-0.4252969780575275,-0.7032226751915545,-0.277925697134027
2023-03-13T09:30:00-04:00,46.12,48.63,45.21,47.77,NaN,NaN,NaN,50.617054009681524,NaN,NaN,50.86239999999986,54.519523591029255,47.20527640897046,49.217601921740155,47.20333333333334,47.20333333333334,47.20333333333334,56838,35855.6,40.10995953611157,46.850170880371536,NaN,NaN,NaN,NaN,1.4522129493973996,15.52164070869075,-3545688,-0.39092686136892474,-0.7665842738451829,-0.37565741247625817
2023-03-13T13:30:00-04:00,47.8,48.68,47.64,47.86,NaN,NaN,NaN,50.617054009681524,NaN,NaN,50.74579999999986,54.40663288884685,47.08496711115287,49.089081537392126,47.390419560224984,47.74435356265717,47.0364855577928,15881,35046.13333333333,40.63421432735514,46.32323978303037,NaN,NaN,NaN,NaN,1.4227691672975855,15.838769255273549,-3529807,-0.3397229193729002,-0.8003110616923834,-0.4605881423194832
2023-03-14T09:30:00-04:00,49.55,49.92,48.84,49.03,NaN,NaN,NaN,50.617054009681524,NaN,NaN,50.66899999999986,54.30941810786382,47.028581892135904,48.786265229913695,49.26333333333334,49.26333333333334,49.26333333333334,27120,34431.23333333333,47.11527500854214,45.818459350682936,NaN,NaN,NaN,NaN,1.4682856553477581,15.132080164341025,-3502687,-0.21095468287429398,-0.7242814959123507,-0.5133268130380567
2023-03-14T13:30:00-04:00,49.02,49.26,48.59,49.22,NaN,NaN,NaN,50.617054009681524,NaN,NaN,50.59899999999985,54.213482535587445,46.98451746441225,48.457807797715816,49.176926084117966,49.292128198223025,49.061723970012906,15257,33960.666666666664,48.10605891787053,45.35699688912329,NaN,NaN,NaN,NaN,1.4112652513943462,14.642083245663459,-3487430,-0.10238139513554567,-0.6413035569574888,-0.5389221618219431
2023-03-15T09:30:00-04:00,48.39,49.24,48.11,48.78,NaN,NaN,NaN,50.617054009681524,NaN,NaN,50.53439999999986,54.16113662678445,46.90766337321528,48.457807797715816,48.71,48.71,48.71,35855,33695.6,45.95872102564188,44.67828846090741,NaN,NaN,NaN,NaN,1.3911748762947502,14.505951305947438,-3523285,-0.052129281486401724,-0.6040837636799452,-0.5519544821935435
2023-03-15T13:30:00-04:00,48.71,49.62,48.37,49.53,NaN,NaN,NaN,50.617054009681524,NaN,NaN,50.45439999999985,53.98858088955067,46.92021911044903,48.457807797715816,48.99929513034064,49.22367963207683,48.77491062860445,59600,34497.2,50.0514829104239,44.55452992972592,NaN,NaN,NaN,NaN,1.381090956559411,14.058738498120555,-3463685,0.03499578439730111,-0.5082097516969171,-0.5432055360942182
2023-03-16T09:30:00-04:00,50.24,51.47,49.68,51.36,46.36503358832143,46.36503358832143,46.36503358832143,NaN,NaN,NaN,50.42779999999985,53.91396990981026,46.941630090189435,47.69224456901608,50.836666666666666,50.836666666666666,50.836666666666666,15621,33041.23333333333,58.34171606750276,44.90594552490431,NaN,NaN,NaN,NaN,1.4210130310908815,13.801527735810604,-3448064,0.20950817692438328,-0.2813203149387391,-0.4908284918631224
2023-03-16T13:30:00-04:00,51.42,51.66,50.99,51.44,47.21503206157955,NaN,NaN,NaN,NaN,NaN,50.41039999999985,53.867381249596924,46.95341875040278,48.30279565521286,51.08734084784238,51.35036972517577,50.82431197050899,14188,32117.433333333334,58.66470583154204,45.55884342900122,NaN,NaN,NaN,NaN,1.367369243155818,13.682623405764978,-3433876,0.317486601638094,-0.0939702398155049,-0.4114568414535989
2023-03-17T09:30:00-04:00,51.7,52.1,50.63,51.35,47.24139424059866,NaN,NaN,NaN,NaN,NaN,50.40159999999985,53.84670867173502,46.95649132826468,48.67923652417029,51.36000000000001,51.36000000000001,51.36000000000001,7362,31186.166666666668,58.118770741699635,46.260551741197865,NaN,NaN,NaN,NaN,1.3747000115018309,13.852598240763534,-3441238,0.36652979781908307,0.04670540582025495,-0.3198243919988281
2023-03-17T13:30:00-04:00,51.48,51.655,51.15,51.39,47.39746722966236,NaN,NaN,NaN,NaN,NaN,50.41999999999985,53.876182865541516,46.96381713445819,48.67923652417029,51.37939814814815,51.398563416919686,51.36023287937661,7542,30763.833333333332,58.30448941549095,46.81538218879985,NaN,NaN,NaN,NaN,1.3125785821088432,14.010432016119337,-3433696,0.38352350988273504,0.15957999535459066,-0.22394351452814437
2023-03-20T09:30:00-04:00,51.29,51.48,50.28,50.75,47.39746722966236,NaN,NaN,NaN,NaN,NaN,50.45519999999985,53.88818177100688,47.02221822899282,48.67923652417029,50.83666666666666,50.83666734101624,50.83666599231708,13143,30387.7,54.16577215621936,47.58965138608854,NaN,NaN,NaN,NaN,1.304537254815354,13.386589615804894,-3446839,0.33526824868230815,0.19514179632474082,-0.14012645235756732
2023-03-20T13:30:00-04:00,50.66,50.96,50.5,50.9,47.39746722966236,NaN,NaN,NaN,NaN,NaN,50.49559999999985,53.90091387100623,47.09028612899346,48.67923652417029,50.82423312182015,50.84584525279817,50.80262099084213,4350,29386.966666666667,54.97251919476914,48.67299764034086,NaN,NaN,NaN,NaN,1.2442131651856858,12.807307386941483,-3442489,0.29829762591221287,0.23274558003269874,-0.0655520458795141
2023-03-21T09:30:00-04:00,51.66,53.27,51.58,53.27,48.40950333526513,NaN,NaN,NaN,NaN,NaN,50.562399999999855,54.05073842395839,47.074061576041316,49.98657528030015,52.70666666666667,52.70666666666667,52.70666666666667,19046,29198.4,65.35000976498117,51.03279015639398,NaN,NaN,NaN,NaN,1.3246265105295656,13.774792379538384,-3423443,0.41133339007349745,0.4486146917123577,0.03728130163886026
2023-03-21T13:30:00-04:00,53.39,53.7,53.03,53.53,49.44066227457126,NaN,NaN,NaN,NaN,NaN,50.64019999999985,54.215218858700965,47.06518114129874,50.73826022424012,52.99691371865139,53.34734138008205,52.646486057220734,13066,28960.6,66.26847013437157,53.29729750232296,NaN,NaN,NaN,NaN,1.2778674740631681,14.897788135792384,-3410377,0.4768719472612044,0.6333712357153658,0.1564992884541614
2023-03-22T09:30:00-04:00,53.54,53.54,52.54,52.69,49.44066227457126,NaN,NaN,NaN,NaN,NaN,50.68339999999985,54.3039604207177,47.062839579282,50.73826022424012,52.923333333333325,52.923333333333325,52.923333333333325,8110,28654.266666666666,60.67291962181893,54.76608036558777,NaN,NaN,NaN,NaN,1.2580197973443705,15.480024297911662,-3418487,0.4379182179980566,0.7038970609517321,0.2659788429536755
2023-03-22T13:30:00-04:00,52.68,53.81,51.01,51.03,49.44066227457126,NaN,NaN,NaN,NaN,NaN,50.67679999999985,54.293603981427324,47.05999601857238,50.73826022424012,52.08829003229329,52.42811081604193,51.748469248544644,48971,29909.966666666667,51.43078095554871,55.537263696173014,NaN,NaN,NaN,NaN,1.3681612403912013,14.760171513139161,-3467458,0.28218417826441555,0.6187090657841949,0.3365248875197794
2023-03-23T09:30:00-04:00,50.08,52.03,50.08,50.49,49.44066227457126,NaN,NaN,NaN,NaN,NaN,50.60599999999984,54.0937637534777,47.118236246521974,50.73826022424012,50.86666666666667,50.86666666666667,50.86666666666667,67372,31083.6,48.825271757678514,55.65940632111134,NaN,NaN,NaN,NaN,1.40972115179183,13.966141543591066,-3534830,0.13225096669310676,0.5018385958861629,0.3695876291930561
2023-03-23T13:30:00-04:00,50.58,50.71,49.5,50.26,49.44066227457126,NaN,NaN,NaN,NaN,NaN,50.51059999999984,53.76204991658672,47.25915008341296,50.73826022424012,50.68055469155002,50.99280752989003,50.36830185321001,23934,31162.2,47.716463379905825,55.63157806839956,NaN,NaN,NaN,NaN,1.3954553552352706,13.60392447534691,-3558764,0.01329539761543963,0.3862068762123556,0.372911478596916
2023-03-24T09:30:00-04:00,49.75,50.22,49.31,49.56,NaN,NaN,NaN,53.84954493234311,53.84954493234311,53.84954493234311,50.40639999999985,53.43119555673903,47.38160444326067,50.73826022424012,49.696666666666665,49.696666666666665,49.696666666666665,9253,29547.633333333335,44.41082347309505,55.52101395750337,NaN,NaN,NaN,NaN,1.3636371155756082,13.390336523480057,-3568017,-0.11003274268290741,0.23537055024328168,0.3454032929261891
2023-03-24T13:30:00-04:00,49.67,50.09,49.46,49.94,NaN,NaN,NaN,53.759792889963876,NaN,NaN,50.335399999999844,53.231248642465566,47.43955135753412,50.73826022424012,49.76977087808371,49.83612600193947,49.703415754227954,11231,28976.133333333335,46.57456606360525,55.27266275415918,NaN,NaN,NaN,NaN,1.311234464463065,13.192004853889408,-3556786,-0.16046259720608014,0.14482504641858895,0.3052876436246691
2023-03-27T09:30:00-04:00,50.69,50.96,49.2,49.51,NaN,NaN,NaN,53.759792889963876,NaN,NaN,50.28099999999985,53.13432157319595,47.42767842680375,50.73826022424012,49.88999999999999,49.88999999999999,49.88999999999999,21058,28074.166666666668,44.46541704442036,54.28149853822472,NaN,NaN,NaN,NaN,1.343289145572846,12.288416890385427,-3577844,-0.21388418314940277,0.03793241468791564,0.2518165978373184
2023-03-27T13:30:00-04:00,49.56,50.23,49.52,49.72,NaN,NaN,NaN,53.759792889963876,NaN,NaN,50.21399999999984,52.95742559586929,47.470574404130396,50.73826022424012,49.86304218287416,49.895760127565914,49.830324238182406,14296,27997.766666666666,45.75733516001289,53.35954349025835,NaN,NaN,NaN,NaN,1.2987684923176428,11.449370924274586,-3563548,-0.22504969041623846,-0.02949551518297966,0.1955541752332588
2023-03-28T09:30:00-04:00,49.69,49.81,49.12,49.18,NaN,NaN,NaN,53.33722454488687,NaN,NaN,50.182799999999844,52.93704919716215,47.428550802837535,50.73826022424012,49.370000000000005,49.370000000000005,49.370000000000005,7460,26366.266666666666,42.98798596797687,52.27877314927815,NaN,NaN,NaN,NaN,1.2552850285806687,10.999211349320127,-3571008,-0.25649490595980373,-0.12506445721649584,0.13143044874330786
2023-03-28T13:30:00-04:00,49.17,49.37,48.91,49.26,NaN,NaN,NaN,52.89894161102838,NaN,NaN,50.160599999999846,52.92632568416822,47.39487431583147,50.6706081793921,49.280290101181635,49.37514269645279,49.18543750591048,6673,25699.733333333334,43.53322991564533,51.22368318500347,NaN,NaN,NaN,NaN,1.198478955110621,10.754054729212852,-3564335,-0.25885108426722253,-0.1921334065907203,0.06671767767650222
2023-03-29T09:30:00-04:00,50.32,51.12,50,50.68,NaN,NaN,NaN,52.89894161102838,NaN,NaN,50.155399999999844,52.91621787883015,47.394582121169535,50.11448654351368,50.6,50.6,50.6,9095,24348.8,52.2606182583884,51.087600763729824,NaN,NaN,NaN,NaN,1.2457304583170052,10.876812574483353,-3555240,-0.1567456593261412,-0.12921439648117428,0.027531262844966917
2023-03-29T13:30:00-04:00,50.71,51.215,50.7,51.14,NaN,NaN,NaN,52.89894161102838,NaN,NaN,50.157599999999846,52.921375851994476,47.393824148005216,48.632488342461585,50.73094443185538,50.92493406154193,50.53695480216882,4144,23957.666666666668,54.70300757918596,51.068349934045315,NaN,NaN,NaN,NaN,1.1949639970086479,11.058160617313197,-3551096,-0.0554259625240434,-0.04175119031008734,0.013674772213956065
2023-03-30T09:30:00-04:00,52,52.25,51.18,51.38,NaN,NaN,NaN,52.89894161102838,NaN,NaN,50.19019999999984,52.97236747160725,47.40803252839243,49.62899067396926,51.60333333333333,51.60333333333333,51.60333333333333,19574,23971.1,55.96872698099114,50.39825830661746,NaN,NaN,NaN,NaN,1.1888951400794585,11.920610217342524,-3531522,0.026176350113613554,0.04639520985597301,0.020218859742359454
2023-03-30T13:30:00-04:00,51.34,51.46,51.07,51.37,NaN,NaN,NaN,52.89894161102838,NaN,NaN,50.20259999999984,53.00012121709024,47.40507878290944,49.62899067396926,51.5192234037316,51.65501318631863,51.383433621144576,7510,23088.066666666666,55.89863912955219,49.6575560919875,NaN,NaN,NaN,NaN,1.1318312015023544,12.609918645828202,-3539032,0.07512838312506276,0.1141293386486879,0.03900095552362515
2023-03-31T09:30:00-04:00,51.77,53.64,51.5,53.42,48.81890168282435,48.81890168282435,48.81890168282435,NaN,NaN,NaN,50.286199999999845,53.210610067016574,47.361789932983115,50.67155403134033,52.853333333333325,52.85333428700764,52.85333237965901,60941,21918.233333333334,65.45032151085867,49.99879908406177,NaN,NaN,NaN,NaN,1.213128972823615,14.443277446413653,-3478091,0.2323428616303155,0.3294295325615195,0.09708667093120402
2023-03-31T13:30:00-04:00,53.36,53.65,53.28,53.55,49.833951606332334,NaN,NaN,NaN,NaN,NaN,50.371199999999845,53.42040616555666,47.32199383444303,51.090243225072264,53.08655152273675,53.39455950534457,52.77854354012893,34939,21981,65.95390257787123,51.03616491422766,NaN,NaN,NaN,NaN,1.152905474764785,16.150316373106328,-3443152,0.3261132299214189,0.5047282083329776,0.17861497841155874
2023-04-03T09:30:00-04:00,52.95,53.21,51.67,52.08,49.833951606332334,NaN,NaN,NaN,NaN,NaN,50.41579999999985,53.49826158776832,47.33333841223138,51.090243225072264,52.31999999999999,52.31999999999999,52.31999999999999,135404,24599.866666666665,56.01208503109527,51.54950871947171,NaN,NaN,NaN,NaN,1.2048407979958715,16.21209984662425,-3578556,0.27235092126777594,0.5190536299962787,0.24670270872850275
2023-04-03T13:30:00-04:00,52.06,52.75,52,52.66,49.833951606332334,NaN,NaN,NaN,NaN,NaN,50.47499999999984,53.61338748405441,47.33661251594527,51.090243225072264,52.33542944033287,52.380996406671095,52.28986247399464,15525,24588,58.659925911729346,52.331184614601966,NaN,NaN,NaN,NaN,1.1723521695675951,16.269470214890884,-3563031,0.2591417659314258,0.570629916142785,0.3114881502113592
2023-04-04T09:30:00-04:00,53.25,53.25,52.07,52.6,49.833951606332334,NaN,NaN,NaN,NaN,NaN,50.511199999999846,53.704559710409534,47.31784028959016,51.090243225072264,52.64,52.64,52.64,26246,24558.866666666665,58.26917024921693,53.3210665271821,NaN,NaN,NaN,NaN,1.1728984431699097,16.634547165383847,-3589277,0.23060904585218606,0.5997494575265918,0.36914041167440576
2023-04-04T13:30:00-04:00,52.67,52.67,52.21,52.62,49.833951606332334,NaN,NaN,NaN,NaN,NaN,50.55299999999985,53.80050550423943,47.305494495760264,51.090243225072264,52.613087529237966,52.668255135890824,52.55791992258511,6246,24258.5,58.36872155169276,54.16350620490264,NaN,NaN,NaN,NaN,1.1219771258006304,16.9735471908416,-3583031,0.19854735303603283,0.6173246029694468,0.418777249933414
2023-04-05T09:30:00-04:00,52,52.16,50.2,50.68,49.833951606332334,NaN,NaN,NaN,NaN,NaN,50.57299999999984,53.81105682471307,47.334943175286604,51.090243225072264,51.01333333333333,51.01333333333333,51.01333333333333,29694,24053.133333333335,46.724917521014454,54.32489909608792,NaN,NaN,NaN,NaN,1.2146930453862994,15.941515141826443,-3612725,0.040419344730610596,0.4693014308466772,0.4288820861160666
2023-04-05T13:30:00-04:00,50.73,50.78,50.36,50.68,49.833951606332334,NaN,NaN,NaN,NaN,NaN,50.595399999999835,53.820586407026916,47.37021359297275,51.090243225072264,50.89525188796482,51.07985026293899,50.710653512990646,12150,22471.466666666667,46.724917521014454,54.39401212187375,NaN,NaN,NaN,NaN,1.1579292564301353,14.983199667740937,-3612725,-0.06472111237995193,0.34798069564112666,0.4127018080210786
2023-04-06T09:30:00-04:00,50.24,51.42,49.59,51.4,NaN,NaN,NaN,54.174147591341736,54.174147591341736,54.174147591341736,50.64299999999984,53.84393798753875,47.44206201246092,51.090243225072264,50.803333333333335,50.803333333333335,50.803333333333335,24855,22779.266666666666,50.93764379113158,54.961844823527656,NaN,NaN,NaN,NaN,1.2059343095422683,14.65354462864128,-3587870,-0.08504213198736671,0.3063991430368702,0.3914412750242369
2023-04-06T13:30:00-04:00,51.33,51.42,51.11,51.28,NaN,NaN,NaN,54.174147591341736,NaN,NaN,50.66799999999985,53.8689223670783,47.4670776329214,51.090243225072264,50.95131113309155,51.16847208108301,50.73415018510009,11541,22691.033333333333,50.2248058457758,55.439814532822695,NaN,NaN,NaN,NaN,1.1419390017178208,14.347436378048743,-3599411,-0.10454771935243506,0.2607566258336931,0.36530434518612814
2023-04-10T09:30:00-04:00,50.55,51.33,50.13,51.3,NaN,NaN,NaN,54.174147591341736,NaN,NaN,50.66619999999985,53.865597168228,47.466802831771695,51.090243225072264,50.919999999999995,50.919999999999995,50.919999999999995,19262,23087.7,50.349518022484915,55.303307373115295,NaN,NaN,NaN,NaN,1.1460862158808334,14.742844271299363,-3580149,-0.11334693612971836,0.2236206750239802,0.33696761115369855
2023-04-10T13:30:00-04:00,51.41,51.72,51.26,51.7,NaN,NaN,NaN,54.174147591341736,NaN,NaN,50.67059999999985,53.87506291288616,47.466137087113545,50.447804531237,51.227601046188695,51.54736074650114,50.90784134587625,17825,23430.466666666667,52.89170762167412,55.17392880472159,NaN,NaN,NaN,NaN,1.097080057603631,14.737375062785246,-3562324,-0.09046528491008043,0.223886005016098,0.31435128992617845
2023-04-11T09:30:00-04:00,51.82,52.58,51.72,51.98,NaN,NaN,NaN,54.174147591341736,NaN,NaN,50.676599999999844,53.889712161139926,47.46348783885976,50.447804531237,52.093333333333334,52.093333333333334,52.093333333333334,48659,24614.333333333332,54.64242879147302,55.079193219756014,NaN,NaN,NaN,NaN,1.0815743392033714,13.96516707631608,-3513665,-0.05637810433201407,0.24387865951116083,0.3002567638431749
2023-04-11T13:30:00-04:00,52.18,52.55,52.11,52.19,NaN,NaN,NaN,54.174147591341736,NaN,NaN,50.70019999999985,53.9399839187301,47.46041608126961,50.447804531237,52.16584731188261,52.25814779313808,52.07354683062714,30033,25470.433333333334,55.96424482852781,55.08387934111141,NaN,NaN,NaN,NaN,1.0450333149745592,13.248116803166138,-3483632,-0.02139316073490416,0.2735153129245447,0.29490847365944883
2023-04-12T09:30:00-04:00,53.16,53.5,51,51.98,NaN,NaN,NaN,54.174147591341736,NaN,NaN,50.712999999999845,53.96781612384869,47.458183876151,50.50742980957659,52.16,52.16,52.16,29396,25815.433333333334,54.261317011770416,54.28466473403368,NaN,NaN,NaN,NaN,1.1489595067620908,13.426102308271851,-3513028,-0.014434144685965489,0.276865792801992,0.29129993748795746
2023-04-12T13:30:00-04:00,51.96,51.98,50.77,50.82,NaN,NaN,NaN,54.174147591341736,NaN,NaN,50.71679999999985,53.971663290533634,47.461936709466066,50.50742980957659,51.74606926947228,52.225833960687865,51.266304578256694,21882,26109.3,45.944737496967804,52.85543865682629,NaN,NaN,NaN,NaN,1.1533195419933695,13.752105879552612,-3534910,-0.08599992248360983,0.18380003438344517,0.269799956867055
2023-04-13T09:30:00-04:00,51.51,52.69,51.5,52.36,NaN,NaN,NaN,54.174147591341736,NaN,NaN,50.75599999999985,54.04172183851023,47.470278161489475,50.50742980957659,52.18333333333334,52.18333333333334,52.18333333333334,19947,26503.866666666665,55.6607886518594,52.83034605830944,NaN,NaN,NaN,NaN,1.2045110032795574,13.367598591197643,-3514963,-0.03052821993021637,0.23163968195428453,0.2621679018845009
2023-04-13T13:30:00-04:00,52.43,52.58,52.06,52.1,NaN,NaN,NaN,54.174147591341736,NaN,NaN,50.78219999999985,54.08940979680209,47.474990203197606,50.50742980957659,52.2109122727573,52.24231399665107,52.179510548863526,15386,25384.366666666665,53.89932985826771,52.490303483062185,NaN,NaN,NaN,NaN,1.15561736018816,13.010556109153743,-3530349,-0.013142019011603001,0.24574037811999716,0.25888239713160016
2023-04-14T09:30:00-04:00,51.97,52.6,51.12,51.39,NaN,NaN,NaN,54.174147591341736,NaN,NaN,50.82199999999985,54.10955471438326,47.53444528561645,50.50742980957659,51.70333333333334,51.70333333333334,51.70333333333334,16379,23684.6,49.31020740902558,51.85037756590566,NaN,NaN,NaN,NaN,1.178787548746149,13.40730428286408,-3546728,-0.04922648145865183,0.19734929530828538,0.2465757767669372
2023-04-14T13:30:00-04:00,51.31,51.88,51.3,51.83,NaN,NaN,NaN,54.174147591341736,NaN,NaN,50.88659999999985,54.12351608789343,47.649683912106276,50.50742980957659,51.69141045751635,51.707387760959364,51.67543315407333,9121,23190.833333333332,52.03569047749205,51.39801820346275,NaN,NaN,NaN,NaN,1.136017009549996,13.775713301309395,-3537607,-0.04343120215713031,0.1922867740705243,0.2357179762276546
2023-04-17T09:30:00-04:00,51,51.59,50.75,51.43,NaN,NaN,NaN,54.174147591341736,NaN,NaN,50.98559999999985,53.97032688198846,48.000873118011235,50.50742980957659,51.25666666666667,51.25666666666667,51.25666666666667,34236,24023.6,49.433515655108415,51.59148949875517,NaN,NaN,NaN,NaN,1.132015794582139,14.526185100630922,-3571843,-0.06519815930215045,0.15422027709996655,0.219418436402117
2023-04-17T13:30:00-04:00,51.48,51.7,51.18,51.65,NaN,NaN,NaN,54.174147591341736,NaN,NaN,51.081799999999845,53.82625095421054,48.337349045789146,50.50742980957659,51.33165450021591,51.447299399161864,51.21600960126996,14395,24129.066666666666,50.88819872596101,51.88886672767993,NaN,NaN,NaN,NaN,1.088300380683415,15.09081351703745,-3557448,-0.06338398106064586,0.1401884600763097,0.20357244113695555
2023-04-18T09:30:00-04:00,52.46,52.49,51.78,52,NaN,NaN,NaN,54.174147591341736,NaN,NaN,51.16639999999985,53.7535583175493,48.579241682450395,50.50742980957659,52.09,52.09,52.09,30245,24435.3,53.19508979541697,52.05011287084317,NaN,NaN,NaN,NaN,1.0705646392060284,14.711667732949948,-3527203,-0.038443945012187314,0.15551750987172142,0.19396145488390873
2023-04-18T13:30:00-04:00,51.85,52.09,51.74,52.01,NaN,NaN,NaN,54.174147591341736,NaN,NaN,51.24939999999985,53.667701585837094,48.83109841416261,50.50742980957659,52.04899686841028,52.113772316914805,51.98422141990575,12119,24362.733333333334,53.26263928125572,52.26710097337746,NaN,NaN,NaN,NaN,1.019095736405598,14.395701293923452,-3515084,-0.021926851384674706,0.16655289065306533,0.18847974203774004
2023-04-19T09:30:00-04:00,51.02,51.64,50.72,51.59,NaN,NaN,NaN,54.174147591341736,NaN,NaN,51.30059999999985,53.63574850921028,48.96545149078941,50.10556689920105,51.31666666666666,51.31666666666666,51.31666666666666,17839,24708.7,49.99883230186124,52.24205199333291,NaN,NaN,NaN,NaN,1.0384460409480551,14.956624054602921,-3532923,-0.03894656794020457,0.13979653211248433,0.1787431000526889
2023-04-19T13:30:00-04:00,51.62,51.72,51.31,51.38,NaN,NaN,NaN,54.174147591341736,NaN,NaN,51.34379999999985,53.60203963300281,49.085560366996894,50.10556689920105,51.3899592282632,51.46655161164901,51.31336684487739,16335,25030.766666666666,48.401784749345644,51.921343216738016,NaN,NaN,NaN,NaN,0.9935570380231938,15.380245139576113,-3549258,-0.06260382922876903,0.1004883135167276,0.16309214274549663
2023-04-20T09:30:00-04:00,50.5,51,50.05,50.64,NaN,NaN,NaN,53.7515163868451,NaN,NaN,51.38099999999986,53.52760010250234,49.234399897497376,50.10556689920105,50.56333333333333,50.56333333333333,50.56333333333333,38520,26011.6,43.16906219655829,51.101817031386965,NaN,NaN,NaN,NaN,1.0175886781643946,16.67136101349114,-3587778,-0.12286189726996682,0.009514771158038116,0.13237666842800494
2023-04-20T13:30:00-04:00,50.59,50.61,49.78,49.89,NaN,NaN,NaN,53.392129278352144,NaN,NaN,51.38819999999985,53.51221389827486,49.26418610172484,50.10556689920105,50.427949357730334,50.6407911949805,50.21510752048017,15585,26392.966666666667,38.612770470837056,49.86242600583762,NaN,NaN,NaN,NaN,1.0063323440097949,18.03835189706638,-3603363,-0.20325996393169396,-0.12169828648661252,0.08156167744508144
2023-04-21T09:30:00-04:00,49.97,50.15,49.51,49.58,NaN,NaN,NaN,52.96907794751795,NaN,NaN,51.35259999999985,53.53614504420326,49.16905495579645,50.10556689920105,49.74666666666668,49.74666666666668,49.74666666666668,15068,26242.766666666666,36.88009947210352,48.62091046728998,NaN,NaN,NaN,NaN,0.9801657480090953,19.47591979647452,-3618431,-0.26352374939340373,-0.24784300929667324,0.015680740096730497
2023-04-21T13:30:00-04:00,49.58,49.95,49.58,49.75,NaN,NaN,NaN,52.811847131721684,NaN,NaN,51.31879999999987,53.54773567427529,49.08986432572445,50.10556689920105,49.75532992406633,49.76169058984747,49.74896925828519,27952,26924.166666666668,38.5096360642483,48.089831793524304,NaN,NaN,NaN,NaN,0.9365824802941602,20.810804274496363,-3590479,-0.2767755276869851,-0.33028866951200087,-0.05351314182501578
2023-04-24T09:30:00-04:00,49.52,50.06,48.34,48.79,NaN,NaN,NaN,52.34289953482525,NaN,NaN,51.26759999999986,53.60622715285285,48.928972847146866,50.10556689920105,49.06333333333333,49.06333333333333,49.06333333333333,18216,25500,33.283987941467416,46.491488885639164,NaN,NaN,NaN,NaN,0.992540874558863,22.772362523117806,-3608695,-0.3313495432462663,-0.4677000708828487,-0.13635052763658237
2023-04-24T13:30:00-04:00,48.81,49.13,48.78,49,NaN,NaN,NaN,52.00276773778773,NaN,NaN,51.21979999999986,53.64264952897624,48.79695047102347,50.10556689920105,49.010783937438525,49.057078335316,48.96448953956105,23471,25117.733333333334,35.35064165147078,45.16658258515367,NaN,NaN,NaN,NaN,0.9466450978046586,24.59380946826629,-3585224,-0.33354079720316837,-0.5532765241405428,-0.21973572693737448
2023-04-25T09:30:00-04:00,48.61,48.75,47.53,47.64,NaN,NaN,NaN,51.24968738607011,NaN,NaN,51.15759999999986,53.77719251794268,48.53800748205704,50.007453519360844,47.973333333333336,47.973333333333336,47.973333333333336,26350,21482.6,29.070202793895874,43.72086796978727,NaN,NaN,NaN,NaN,0.9840275908186114,26.877990530043157,-3611574,-0.4022182071056746,-0.7225084858194677,-0.3202902787137931
2023-04-25T13:30:00-04:00,47.63,47.8,47.38,47.43,NaN,NaN,NaN,50.61561068670329,NaN,NaN,51.08819999999985,53.90764871208242,48.26875128791728,49.66617025239094,47.79301437005682,48.008012863338315,47.57801587677532,18535,21582.933333333334,28.236019974436346,42.020891505283295,NaN,NaN,NaN,NaN,0.9437399057601388,29.062029412516736,-3630109,-0.4346606181481933,-0.8636160513990347,-0.42895543325084146
2023-04-26T09:30:00-04:00,48.41,48.41,47.46,47.72,NaN,NaN,NaN,50.61561068670329,NaN,NaN,50.97719999999985,53.88008970511531,48.074310294884384,49.66617025239094,47.86333333333334,47.86333333333334,47.86333333333334,24379,21520.7,31.17322320923992,40.71658490200697,NaN,NaN,NaN,NaN,0.9463299124915573,30.171241192401393,-3605730,-0.4097914377180645,-0.941194730398422,-0.5314032926803576
2023-04-26T13:30:00-04:00,47.74,47.75,46.55,46.7,NaN,NaN,NaN,50.198004778587084,NaN,NaN,50.84059999999985,53.889262421466725,47.79193757853298,48.691936201912746,47.32201963484292,47.73952848447836,46.90451078520747,40981,22678.533333333333,26.989114378162185,39.00950744859278,NaN,NaN,NaN,NaN,0.9644492044564463,31.660416340724453,-3646711,-0.4329712876177281,-1.0726174022025177,-0.6396461145847896
2023-04-27T09:30:00-04:00,47.33,47.86,46.99,47.86,NaN,NaN,NaN,50.198004778587084,NaN,NaN,50.74399999999985,53.8575368955678,47.630463104431904,48.3335489615302,47.56999999999999,47.56999999999999,47.56999999999999,25134,22526.533333333333,37.296643144146216,37.87390411635915,NaN,NaN,NaN,NaN,0.9784171184238427,32.88272225057778,-3621577,-0.3449428765610001,-1.0708247102860398,-0.7258818337250397
2023-04-27T13:30:00-04:00,47.83,48.01,47.65,47.71,NaN,NaN,NaN,50.198004778587084,NaN,NaN,50.677599999999856,53.90348669361786,47.451713306381855,48.05207133537933,47.656518286059146,47.76398274115695,47.54905383096134,16291,22664.566666666666,36.577526686548644,36.682110359594354,NaN,NaN,NaN,NaN,0.9342444671078539,33.79049373062827,-3637868,-0.2746408217771721,-1.0691828609465048,-0.7945420391693327
2023-04-28T09:30:00-04:00,47.18,47.8,46.57,47.67,NaN,NaN,NaN,50.19468935523056,NaN,NaN,50.62119999999985,53.95503536487089,47.28736463512882,48.05207133537933,47.34666666666667,47.34666666666667,47.34666666666667,28119,22773.366666666665,36.376108290808396,35.70905864451915,NaN,NaN,NaN,NaN,0.9553698623144357,35.18613339722679,-3665987,-0.21148874856212085,-1.0589029748719838,-0.847414226309863
2023-04-28T13:30:00-04:00,47.6,47.79,47.47,47.65,NaN,NaN,NaN,50.19468935523056,NaN,NaN,50.56899999999985,54.004020232846244,47.13397976715346,47.681657068303466,47.43381311309569,47.56677162669618,47.300854599495196,12080,22791.333333333332,36.26856832429803,34.84240032844432,NaN,NaN,NaN,NaN,0.9099863007205474,36.482084516211124,-3678067,-0.1543703023938996,-1.0403771043022374,-0.8860068019083378
2023-05-01T09:30:00-04:00,47.51,47.77,46.86,47.22,NaN,NaN,NaN,50.19468935523056,NaN,NaN,50.52219999999985,54.072752159885134,46.971647840114564,47.05232565464277,47.28333333333333,47.28333333333333,47.28333333333333,10041,22483.966666666667,33.94501416242856,34.183539754577914,NaN,NaN,NaN,NaN,0.9099872792405085,37.9695631462341,-3688108,-0.1298412611199291,-1.0483083783082492,-0.9184671171883201
2023-05-01T13:30:00-04:00,47.15,47.25,46.77,47.05,NaN,NaN,NaN,49.85131415465724,NaN,NaN,50.46439999999985,54.14277390161252,46.786026098387175,46.35286052371421,47.09555275849032,47.212006204858405,46.97909931212224,26108,22760.066666666666,33.0436999749716,33.78574900487324,NaN,NaN,NaN,NaN,0.8792739021519005,39.391534735114774,-3714216,-0.11013595325701497,-1.0561370587595889,-0.9460011055025739
2023-05-02T09:30:00-04:00,46.85,46.85,45.96,46.34,NaN,NaN,NaN,49.26579987490008,NaN,NaN,50.40099999999985,54.248380927340634,46.55361907265906,46.217830735177095,46.383333333333326,46.38333428700764,46.38333237965901,26471,22020.466666666667,29.51846483040282,33.25991795903747,NaN,NaN,NaN,NaN,0.8943257662839074,41.05687428662857,-3740687,-0.12869756919041087,-1.1068730669905875,-0.9781754978001767
2023-05-02T13:30:00-04:00,46.32,46.5,46.16,46.19,NaN,NaN,NaN,49.10712715331371,NaN,NaN,50.33039999999985,54.35083571768818,46.30996428231152,46.217830735177095,46.347858976859065,46.395702531082414,46.30001542263572,14553,21504.466666666667,28.818952764952485,32.56772629480206,NaN,NaN,NaN,NaN,0.8547310686922,42.603261013034235,-3755240,-0.1342399014960589,-1.1459753746702503,-1.0117354731741914
2023-05-03T09:30:00-04:00,45.99,46.42,45.79,46.1,NaN,NaN,NaN,48.841803191799464,NaN,NaN,50.26879999999985,54.449057676275714,46.088542323723985,45.85960933641068,46.10333333333333,46.10333333333333,46.10333333333333,16249,21066.233333333334,28.384326497738257,32.21775047739283,NaN,NaN,NaN,NaN,0.8386788494999001,44.19171532451335,-3771489,-0.12719644111303396,-1.1707310245654838,-1.0435345834524499
2023-05-03T13:30:00-04:00,46.12,46.8,45.495,45.63,NaN,NaN,NaN,48.841803191799464,NaN,NaN,50.19619999999984,54.5658148846397,45.82658511535998,45.85960933641068,46.01458030432444,46.07384978970927,45.95531081893961,36436,21551.366666666665,26.165106706483442,31.56164083846517,NaN,NaN,NaN,NaN,0.8719875031070501,44.96546633959217,-3807925,-0.1365944853643315,-1.2142776901578642,-1.0776832047935327
2023-05-04T09:30:00-04:00,46.15,47.1,46.15,46.39,NaN,NaN,NaN,48.841803191799464,NaN,NaN,50.11039999999984,54.60532328745044,45.615476712549246,45.85960933641068,46.54666666666666,46.54666666666666,46.54666666666666,27569,21805.433333333334,35.01315696582722,31.986137565031697,NaN,NaN,NaN,NaN,0.9147026814565464,45.150281337815116,-3780356,-0.0769980322282755,-1.1739307450788772,-1.0969327128506017
2023-05-04T13:30:00-04:00,46.63,46.77,46.38,46.49,NaN,NaN,NaN,48.841803191799464,NaN,NaN,50.017399999999846,54.614520507455154,45.42027949254454,45.761749975302834,46.54666666666667,46.54666666666667,46.54666666666667,17994,21892.366666666665,36.09825687097854,32.54772591478471,NaN,NaN,NaN,NaN,0.8772239184953646,45.321895264736426,-3762362,-0.01922547335632374,-1.1209645545460063,-1.1017390811896826
2023-05-05T09:30:00-04:00,47.45,48.83,47.45,48.75,NaN,NaN,NaN,48.841803191799464,NaN,NaN,49.96479999999984,54.5585370233901,45.37106297660958,45.973026829069205,48.343333333333334,48.343333333333334,48.343333333333334,32688,22436,54.56311447754101,34.218432433949076,NaN,NaN,NaN,NaN,0.9817079243171241,42.55805091710249,-3729674,0.17226534351374156,-0.8864074017975057,-1.0586727453112472
2023-05-05T13:30:00-04:00,48.83,48.94,48.66,48.82,45.917856170671214,45.917856170671214,45.917856170671214,NaN,NaN,NaN,49.913799999999846,54.50061744132712,45.32698255867257,46.51442146325536,48.46306123992317,48.66588914341818,48.260233336428165,11390,22511.633333333335,54.99687518868952,36.21898677755817,NaN,NaN,NaN,NaN,0.9315859297230438,39.87205451741387,-3718284,0.29737659757573043,-0.6869519983415842,-0.9843285959173146
2023-05-08T09:30:00-04:00,48.81,49.42,48.45,49.33,46.051589981095255,NaN,NaN,NaN,NaN,NaN,49.831999999999844,54.31038363699036,45.35361636300933,46.99453717060429,49.06666666666666,49.06666666666666,49.06666666666666,21302,22080.5,58.13284536125697,37.70728693592322,NaN,NaN,NaN,NaN,0.9343297918856834,37.18525850805591,-3696982,0.4017258796417674,-0.48217124636510533,-0.8838971260068728
2023-05-08T13:30:00-04:00,49.41,49.45,48.94,49.31,46.3731086183182,NaN,NaN,NaN,NaN,NaN,49.747199999999836,54.09956402890043,45.39483597109924,47.25462973648343,49.12990347452853,49.21077729049414,49.04902965856292,13024,22034.8,57.96226888710225,39.234768521677054,NaN,NaN,NaN,NaN,0.9040205210367064,34.72251427127917,-3710006,0.45285282172821517,-0.31783109884660377,-0.7706839205748189
2023-05-09T09:30:00-04:00,48.87,49.68,48.87,49.61,46.470921862940095,NaN,NaN,NaN,NaN,NaN,49.697799999999845,53.99889993374529,45.3967000662544,47.518703789186745,49.386666666666656,49.386667341016235,49.38666599231708,7090,21262.966666666667,59.86466264813632,40.912522404343335,NaN,NaN,NaN,NaN,0.8973047695340847,32.69013096726892,-3702916,0.48733038265430717,-0.16152094225693503,-0.6488513249112422
2023-05-09T13:30:00-04:00,49.59,49.76,49.51,49.66,46.92428905098827,NaN,NaN,NaN,NaN,NaN,49.63779999999984,53.85481371115438,45.420786288845306,47.905963031349394,49.49337316302705,49.619871085411056,49.36687524064305,5045,21027.166666666668,60.188038919262375,42.621056018269364,NaN,NaN,NaN,NaN,0.8510687145673643,30.893498404845694,-3697871,0.4924999228327016,-0.033226421370365244,-0.5257263442030669
2023-05-10T09:30:00-04:00,50.17,50.84,49.55,49.62,47.43159409412517,NaN,NaN,NaN,NaN,NaN,49.57819999999984,53.70942875668554,45.44697124331414,48.711770425079514,50.00333333333333,50.00333333333333,50.00333333333333,34318,21576.466666666667,59.773121338827394,44.46592081658356,NaN,NaN,NaN,NaN,0.8824209492411245,30.31075456181736,-3732189,0.4721626708685294,0.06447699438259491,-0.4076856764859345
2023-05-10T13:30:00-04:00,49.64,50.29,49.54,49.97,47.43159409412517,NaN,NaN,NaN,NaN,NaN,49.52519999999984,53.5659786180467,45.484421381952984,48.711770425079514,49.9743226349526,50.00880637409434,49.93983889581086,24289,21841.6,62.22685555687749,46.55043192957684,NaN,NaN,NaN,NaN,0.8729623100096155,29.755290141773376,-3707900,0.4607171027450433,0.16821070194536958,-0.2925064007996737
2023-05-11T09:30:00-04:00,50.14,50.33,49.55,50.13,47.43159409412517,NaN,NaN,NaN,NaN,NaN,49.51419999999984,53.54532706821124,45.483072931788435,48.711770425079514,50.00333333333333,50.00333333333333,50.00333333333333,16756,21116.133333333335,63.328093814029984,48.96540542840735,NaN,NaN,NaN,NaN,0.8663221450089288,29.278231074222965,-3691144,0.44226924179029076,0.2603301514381897,-0.18193909035210104
2023-05-11T13:30:00-04:00,49.9,50.15,49.69,50.11,47.43159409412517,NaN,NaN,NaN,NaN,NaN,49.502799999999844,53.52388649994791,45.481713500051775,48.711770425079514,49.99078160306417,50.00045055716627,49.981112648962075,28237,21537.866666666665,63.08052942304858,51.41266090398564,NaN,NaN,NaN,NaN,0.8372991346511481,28.835247654354735,-3719381,0.4079043461496598,0.32794134233497374,-0.07996300381468609
2023-05-12T09:30:00-04:00,50.2,50.2,48.25,48.53,47.43159409412517,NaN,NaN,NaN,NaN,NaN,49.44539999999984,53.43835822167747,45.45244177832222,48.711770425079514,48.99333333333334,48.99333333333334,48.99333333333334,34487,22185.166666666668,47.33694106175923,52.76641908713,NaN,NaN,NaN,NaN,0.916777767890352,27.115358324090984,-3753868,0.2648791740759147,0.2511359637802073,-0.013743210295707409
2023-05-12T13:30:00-04:00,48.5,48.51,48.19,48.47,47.43159409412517,NaN,NaN,NaN,NaN,NaN,49.389199999999846,53.3563064316529,45.422093568346796,48.711770425079514,48.611094003471116,48.90180145731969,48.32038654962254,59623,23240.866666666665,46.85866662422878,54.2445305098261,NaN,NaN,NaN,NaN,0.8755793558981843,25.586659595696165,-3813491,0.15764459747684295,0.1833125365503463,0.025667939073503336
2023-05-15T09:30:00-04:00,48.42,49.69,48.32,49.55,47.43159409412517,NaN,NaN,NaN,NaN,NaN,49.35419999999985,53.28395946338452,45.42444053661518,48.711770425079514,49.18666666666667,49.18666666666667,49.18666666666667,21856,23362.2,55.562051168272774,55.71230866714363,NaN,NaN,NaN,NaN,0.9108951161911708,24.675637327273535,-3791635,0.15085711927056625,0.21423933816171115,0.0633822188911449
2023-05-15T13:30:00-04:00,49.55,49.55,49.37,49.46,47.43159409412517,NaN,NaN,NaN,NaN,NaN,49.30939999999984,53.181822311688414,45.436977688311266,48.711770425079514,49.29166215810039,49.42460844213201,49.15871587406876,13632,23034.233333333334,54.75722773084821,57.045092299991474,NaN,NaN,NaN,NaN,0.8586883221775157,23.829688078023953,-3805267,0.132373246619816,0.2288487771659149,0.09647553054609889
2023-05-16T09:30:00-04:00,48.83,49.15,48.53,48.6,47.43159409412517,NaN,NaN,NaN,NaN,NaN,49.24179999999984,53.04272975994837,45.44087024005131,48.711770425079514,48.760000000000005,48.760000000000005,48.760000000000005,23355,22934.4,47.65390616578562,56.551577420580365,NaN,NaN,NaN,NaN,0.8637820134505503,22.230608438425527,-3828622,0.05808594913059617,0.1690829669593441,0.11099701782874793
2023-05-16T13:30:00-04:00,48.64,48.81,48.5,48.57,47.43159409412517,NaN,NaN,NaN,NaN,NaN,49.16939999999984,52.879771215938284,45.459028784061395,48.711770425079514,48.719213029006184,48.78065150063503,48.65777455737734,10293,22659.666666666668,47.42279832120269,56.01057193004559,NaN,NaN,NaN,NaN,0.8242261553469398,20.779838218345688,-3838915,0.005552680273947619,0.11793786817118246,0.11238518789723484
2023-05-17T09:30:00-04:00,48.71,50,48.48,50,47.43159409412517,NaN,NaN,NaN,NaN,NaN,49.12979999999984,52.760752470091674,45.498847529908005,48.27834645764071,49.49333333333333,49.49333333333333,49.49333333333333,26870,22742.7,57.90294503317205,55.99415047803952,NaN,NaN,NaN,NaN,0.873924287107873,20.40623095407544,-3812045,0.06256942937145346,0.19059697461155167,0.1280275452400982
2023-05-17T13:30:00-04:00,49.99,50.14,49.93,50.06,47.43159409412517,NaN,NaN,NaN,NaN,NaN,49.11459999999984,52.723418554605104,45.505781445394575,48.27834645764071,49.7981243535925,50.071505946081835,49.52474276110316,33399,22489.966666666667,58.278719630988505,56.01675410260283,NaN,NaN,NaN,NaN,0.826501123743025,20.187520544697097,-3778646,0.09768828736646612,0.25013790444818085,0.15244961708171473
2023-05-18T09:30:00-04:00,50.04,51,49.86,50.35,47.78813921652399,NaN,NaN,NaN,NaN,NaN,49.074399999999834,52.58105004813188,45.56774995186779,48.93027763394138,50.403333333333336,50.403333333333336,50.403333333333336,72314,24062.633333333335,60.13114572686132,56.03578860822604,NaN,NaN,NaN,NaN,0.8488939006185232,20.712234309579255,-3706332,0.1316963941946651,0.31707010982504613,0.18537371563038102
2023-05-18T13:30:00-04:00,50.36,50.77,49.95,50.75,47.78813921652399,NaN,NaN,NaN,NaN,NaN,49.04739999999983,52.48046699032596,45.61433300967371,48.93027763394138,50.42565885742836,50.46355938154501,50.38775833331171,25092,24356,62.597900198322655,56.20792155673035,NaN,NaN,NaN,NaN,0.846830050574343,21.199468519826972,-3681240,0.16994532285279643,0.39780536919637655,0.22786004634358012
2023-05-19T09:30:00-04:00,50.6,50.84,49.88,50.03,47.78813921652399,NaN,NaN,NaN,NaN,NaN,49.02019999999984,52.39972775400115,45.64067224599853,48.93027763394138,50.25,50.25,50.25,46151,24957.066666666666,55.894179074854165,55.930854252160835,NaN,NaN,NaN,NaN,0.8549136183904614,21.651900286485564,-3727391,0.13698412118897574,0.3990901978297998,0.2621060766408241
2023-05-19T13:30:00-04:00,49.98,50.1,49.84,50.05,47.78813921652399,NaN,NaN,NaN,NaN,NaN,48.98459999999984,52.281474180199176,45.6877258198005,48.93027763394138,50.14822988505747,50.27242572297892,50.02403404713601,30989,25587.366666666665,56.03502529101698,55.48858066174222,NaN,NaN,NaN,NaN,0.8124197885054283,22.007244394266383,-3696402,0.10803052676969466,0.3971442351029424,0.28911370833324773
2023-05-22T09:30:00-04:00,50.15,52.13,50,51.97,48.33087926443208,NaN,NaN,NaN,NaN,NaN,48.99539999999985,52.32759497629722,45.663205023702474,49.59612171886239,51.366666666666674,51.366666666666674,51.366666666666674,87972,28185.066666666666,66.94724034550063,55.74709112827584,NaN,NaN,NaN,NaN,0.9065326607550407,23.803894541243388,-3608430,0.20411395602476345,0.5442561533642021,0.3401421973394386
2023-05-22T13:30:00-04:00,51.98,52.25,51.73,51.98,49.30924838877607,NaN,NaN,NaN,NaN,NaN,49.001999999999846,52.356433484220645,45.64756651577905,49.96289737508991,51.48837378988175,51.734637454582604,51.24211012518089,21487,28031.033333333333,66.99319114599339,56.026566965629044,NaN,NaN,NaN,NaN,0.8789231849868236,25.538275873874444,-3586943,0.2511743623318073,0.6541101502541977,0.40293578792239043
2023-05-23T09:30:00-04:00,51.5,52.63,51.42,51.53,49.30924838877607,NaN,NaN,NaN,NaN,NaN,48.99259999999984,52.315865406202406,45.669334593797274,50.19531790007193,51.86000000000001,51.86000000000001,51.86000000000001,23224,27922.8,62.76458520127813,57.12854154702325,NaN,NaN,NaN,NaN,0.9025715289163363,27.35765379429373,-3610167,0.23511250079132917,0.6968264139115519,0.4617139131202227
2023-05-23T13:30:00-04:00,51.36,51.6,50.93,50.97,49.30924838877607,NaN,NaN,NaN,NaN,NaN,48.971799999999845,52.23167653754871,45.71192346245098,50.19531790007193,51.529650736399155,51.8759331646788,51.18336830811951,21136,28142.233333333334,57.86933141474257,57.91501760348852,NaN,NaN,NaN,NaN,0.8859592768508838,28.264545968467413,-3631303,0.1727730020008763,0.677680165621318,0.5049071636204417
2023-05-24T09:30:00-04:00,50.13,50.8,49.89,50.35,49.30924838877607,NaN,NaN,NaN,NaN,NaN,48.94699999999985,52.145107565429605,45.7488924345701,50.19531790007193,50.346666666666664,50.346666666666664,50.346666666666664,16903,28164.033333333333,52.94576165991849,57.728139781463206,NaN,NaN,NaN,NaN,0.899819328504392,27.68373627581034,-3648206,0.08047267181767892,0.6054980033925403,0.5250253315748614
2023-05-24T13:30:00-04:00,50.35,51,50.35,50.74,49.30924838877607,NaN,NaN,NaN,NaN,NaN,48.93419999999985,52.09819517067556,45.770204829324136,50.19531790007193,50.47325931800158,50.64143104153195,50.30508759447121,9578,27268.766666666666,55.50996230417787,57.781906536701044,NaN,NaN,NaN,NaN,0.8819750907540781,27.307652342912586,-3638628,0.03850443574136031,0.5731558762515618,0.5346514405102015
2023-05-25T09:30:00-04:00,51.34,51.34,49.9,50.05,49.30924838877607,NaN,NaN,NaN,NaN,NaN,48.92239999999984,52.06518999617564,45.77961000382404,50.19531790007193,50.43000000000001,50.43000000000001,50.43000000000001,79560,29001.8,50.28851134049074,57.970092620608554,NaN,NaN,NaN,NaN,0.9218340128430729,26.391462644623605,-3718188,-0.03872741087990239,0.48624217691032356,0.524969587790226
2023-05-25T13:30:00-04:00,50,50.29,49.94,50.1,49.30924838877607,NaN,NaN,NaN,NaN,NaN,48.926599999999844,52.07510722725212,45.77809277274757,50.19531790007193,50.379978049013275,50.49618832710763,50.26376777091892,14741,28893.366666666665,50.65075962738662,58.20066128533597,NaN,NaN,NaN,NaN,0.8809887262114249,25.540715067640978,-3703447,-0.08669984557339638,0.41659478082348045,0.5032946263968768
2023-05-26T09:30:00-04:00,50.24,51.83,50.19,51.55,49.30924838877607,NaN,NaN,NaN,NaN,NaN,48.96599999999984,52.194515448323486,45.73748455167619,50.19531790007193,51.19,51.19,51.19,62432,29884.833333333332,59.79954126170053,58.33613244451657,NaN,NaN,NaN,NaN,0.9416323886248943,26.000986540217596,-3641015,-0.02427591759188552,0.47294972940701996,0.4972256469989055
2023-05-26T13:30:00-04:00,51.53,51.64,51.09,51.12,49.30924838877607,NaN,NaN,NaN,NaN,NaN,48.993399999999845,52.270946911953956,45.71585308804573,50.19531790007193,51.225869681699095,51.27127015408591,51.18046920931228,38971,30804.2,56.45693499186503,58.20600497029346,NaN,NaN,NaN,NaN,0.9136586465802587,26.42838147903874,-3679986,-0.01585193192457207,0.4774107320931904,0.4932626640177625
2023-05-30T09:30:00-04:00,52.5,53.28,51.75,51.88,49.60433320074047,NaN,NaN,NaN,NaN,NaN,49.05519999999985,52.430155383417244,45.680244616582456,50.31510777318173,52.303333333333335,52.303333333333335,52.303333333333335,47973,31693.233333333334,60.64416068228647,58.24264889568098,NaN,NaN,NaN,NaN,1.0026830289673834,27.805545168369015,-3632013,0.03426348650666622,0.5360920221510952,0.501828535644429
2023-05-30T13:30:00-04:00,51.83,52.5,51.79,52.33,49.60433320074047,NaN,NaN,NaN,NaN,NaN,49.12179999999985,52.618982157117,45.6246178428827,50.31510777318173,52.26222689478351,52.31001688435027,52.21443690521675,35493,32442.2,62.91797216054837,58.2655111786971,NaN,NaN,NaN,NaN,0.981777098326856,29.084340022747128,-3596520,0.08802158505107438,0.611855516958272,0.5238339319071976
2023-05-31T09:30:00-04:00,51.81,52.61,51.7,52.44,49.60433320074047,NaN,NaN,NaN,NaN,NaN,49.217799999999855,52.809261630040744,45.626338369958965,50.31510777318173,52.25,52.25,52.25,22331,32950.23333333333,63.47351557664704,58.806892357396585,NaN,NaN,NaN,NaN,0.9766501627320804,30.33172106158194,-3574189,0.11934613186796295,0.6730165967421513,0.5536704648741884
2023-05-31T13:30:00-04:00,52.5,53.17,52.5,53.15,49.99726190571539,NaN,NaN,NaN,NaN,NaN,49.33219999999985,53.0507379707697,45.61366202923,50.695775179869045,52.679362123211206,53.01388870237543,52.34483554404698,36787,34008.3,66.91852016700639,59.58428484853869,NaN,NaN,NaN,NaN,0.9590322939655035,31.78821959034586,-3537402,0.17298626288148777,0.7699032934760481,0.5969170305945604
2023-06-01T09:30:00-04:00,52.56,54.1,52.26,53.95,50.220340910001056,NaN,NaN,NaN,NaN,NaN,49.45679999999986,53.363642080255396,45.54995791974432,51.200620143895236,53.43666666666667,53.43666666666667,53.43666666666667,31166,33903.23333333333,70.31574581218128,59.82489238187303,NaN,NaN,NaN,NaN,1.0219585586822535,33.572105675199204,-3506236,0.24315078449987537,0.9008555112194045,0.6577047267195292
2023-06-01T13:30:00-04:00,53.89,54.41,53.69,53.8,51.126689050455546,NaN,NaN,NaN,NaN,NaN,49.598799999999855,53.60926558893795,45.58833441106176,51.73049611511618,53.69278207041397,53.957633092593085,53.42793104823485,29144,34065.066666666666,68.88729737805387,59.96018568416306,NaN,NaN,NaN,NaN,1.0003900902049496,35.35873176561665,-3535380,0.2588133634051307,0.9812214309759426,0.7224080675708119
2023-06-02T09:30:00-04:00,54.5,54.84,53.46,54.64,51.171385002707574,NaN,NaN,NaN,NaN,NaN,49.73439999999986,53.953583162657516,45.5152168373422,52.00639689209295,54.31333333333333,54.31333333333333,54.31333333333333,28779,34465.833333333336,72.28300879066506,60.64007308340499,NaN,NaN,NaN,NaN,1.027505083761739,37.19295003365752,-3506601,0.30208372140021345,1.1000127193210787,0.7979289979208652
2023-06-02T13:30:00-04:00,54.62,54.62,54.17,54.25,51.48768568440268,NaN,NaN,NaN,NaN,NaN,49.86519999999987,54.22828008636694,45.5021199136328,52.118117513674356,54.32780842294259,54.3443303710116,54.311286474873576,22090,34260.933333333334,68.54256287333686,61.40244675901886,NaN,NaN,NaN,NaN,0.9876832920644718,38.896152711124046,-3528691,0.2812055604082143,1.1494359484311332,0.8682303880229189
2023-06-05T09:30:00-04:00,54.1,54.62,53.79,54.45,51.48768568440268,NaN,NaN,NaN,NaN,NaN,50.00079999999986,54.5018040479933,45.49979595200642,52.20349401093949,54.28666666666666,54.28666734101624,54.28666599231708,20846,33806.23333333333,69.41658652702851,62.57893424952672,NaN,NaN,NaN,NaN,0.9764201997741522,39.81941248123379,-3507845,0.25822631547538066,1.1910132823671447,0.932786966891764
2023-06-05T13:30:00-04:00,54.3,54.96,53.79,54.75,51.48768568440268,NaN,NaN,NaN,NaN,NaN,50.14279999999986,54.78399301904725,45.50160698095247,52.44179520875159,54.39593179353974,54.50256680552689,54.289296781552586,21887,32548.366666666665,70.73028091778201,63.66609986478415,NaN,NaN,NaN,NaN,0.9902473283617129,40.856573148534196,-3485958,0.24092797819895762,1.233946939640461,0.9930189614415034
2023-06-06T09:30:00-04:00,53.75,55.11,53.32,54.97,51.48768568440268,NaN,NaN,NaN,NaN,NaN,50.29779999999986,55.054406000085734,45.541193999913986,52.44179520875159,54.46666666666667,54.46666666666667,54.46666666666667,51332,33530.9,71.69062054209313,65.19482195061289,NaN,NaN,NaN,NaN,1.047372519193019,41.02386273150996,-3434626,0.2224425945058357,1.271072204573798,1.0486296100679624
2023-06-06T13:30:00-04:00,54.95,55.3,54.94,55.2,52.180430360751984,NaN,NaN,NaN,NaN,NaN,50.460799999999864,55.31854571586986,45.60305428412987,52.79234893360101,54.63583322357349,54.929799096968885,54.3418673501781,16999,33643.13333333333,72.69911352753778,66.76970437205226,NaN,NaN,NaN,NaN,0.9982744821078032,41.3028208965785,-3417627,0.20431341244426449,1.304021375623293,1.0997079631790285
2023-06-07T09:30:00-04:00,55.83,56.56,54.46,54.51,52.41768352617236,NaN,NaN,NaN,NaN,NaN,50.62419999999987,55.46611051549387,45.78228948450587,53.50387914688081,55.17666666666667,55.17666666666667,55.17666666666667,104539,36349.26666666667,65.19556766523698,67.15513482944773,NaN,NaN,NaN,NaN,1.076969161957246,42.264830799584935,-3522166,0.12817993003773154,1.259932875726193,1.1317529456884614
2023-06-07T13:30:00-04:00,54.5,54.83,54.07,54.26,52.41768352617236,NaN,NaN,NaN,NaN,NaN,50.78559999999986,55.56309417164005,46.00810582835967,53.50387914688081,55.031485446141346,55.33745207409765,54.725518818185044,23537,36790.73333333333,62.67159987195231,67.59903946373967,NaN,NaN,NaN,NaN,1.0543285075317281,42.53659996941915,-3545703,0.04746914294846083,1.1910893743740374,1.1436202314255766
2023-06-08T09:30:00-04:00,54.02,54.97,53.89,54.64,52.41768352617236,NaN,NaN,NaN,NaN,NaN,50.95639999999986,55.661703832916146,46.251096167083574,53.50387914688081,54.5,54.5,54.5,20111,36565.433333333334,64.89618161196961,67.90275524443133,NaN,NaN,NaN,NaN,1.056162185565176,42.505326796786086,-3525592,0.008217319214977703,1.1538918804442986,1.1456745612293209
2023-06-08T13:30:00-04:00,54.58,54.84,54.33,54.81,52.41768352617236,NaN,NaN,NaN,NaN,NaN,51.13999999999985,55.714212937769645,46.56578706223006,53.50387914688081,54.553292654617806,54.62870298350687,54.47788232572874,10044,35786.933333333334,65.87594154845928,68.11403877213924,NaN,NaN,NaN,NaN,1.0171506008819493,42.47628742219824,-3515548,-0.016411622354411737,1.1251600332863063,1.141571655640718
2023-06-09T09:30:00-04:00,55.52,56.45,54.58,54.95,52.41768352617236,NaN,NaN,NaN,NaN,NaN,51.31119999999985,55.80146438420506,46.82093561579464,53.51905289856238,55.32666666666667,55.326667620340984,55.32666571299235,56356,35255,66.70021357873306,68.34451720085967,NaN,NaN,NaN,NaN,1.0780684151046676,43.35906046221228,-3459192,-0.03246125936864286,1.1009950814299145,1.1334563407985574
2023-06-09T13:30:00-04:00,54.93,55,54.57,54.66,52.41768352617236,NaN,NaN,NaN,NaN,NaN,51.47459999999987,55.84418983888114,47.10501016111859,53.51905289856238,55.149997608415084,55.418036774402836,54.88195844242733,24483,35234.7,63.2898655241969,68.08532758351615,NaN,NaN,NaN,NaN,1.0317778140257627,44.162529593475384,-3483675,-0.06965981566865276,1.0463815712127413,1.116041386881394
2023-06-12T09:30:00-04:00,55,55.33,54.63,55.01,52.41768352617236,NaN,NaN,NaN,NaN,NaN,51.59979999999986,56.00850319255626,47.19109680744346,53.51905289856238,54.99,54.99,54.99,35847,34891.23333333333,65.5774110241843,67.74687509865922,NaN,NaN,NaN,NaN,1.008079398738208,45.06949728825545,-3447828,-0.0771620214114439,1.0195888601170893,1.0967508815285332
2023-06-12T13:30:00-04:00,55.04,55.41,55.01,55.31,52.41768352617236,NaN,NaN,NaN,NaN,NaN,51.729599999999856,56.18519596014454,47.27400403985517,53.51905289856238,55.10152315812486,55.22728133318225,54.97576498306748,28191,34797.96666666667,67.44971538873492,67.64419067085072,NaN,NaN,NaN,NaN,0.964645155971193,45.95109045324372,-3419637,-0.06867286725285249,1.0109097974624675,1.07958266471532
2023-06-13T09:30:00-04:00,56.13,56.56,55.77,56.49,53.22009461289086,NaN,NaN,NaN,NaN,NaN,51.87279999999986,56.46873044334352,47.27686955665621,54.240404067251156,56.27333333333334,56.27333333333334,56.27333333333334,41575,33251.4,73.54491024185253,67.73432648879268,NaN,NaN,NaN,NaN,0.9850276448303935,47.27245405344683,-3378062,0.005710409514254611,1.086720676608138,1.0810102670938835
2023-06-13T13:30:00-04:00,56.49,56.62,55.96,56.48,53.388953948668544,NaN,NaN,NaN,NaN,NaN,52.01619999999986,56.72926590661032,47.3031340933894,54.43432325380092,56.31748740830154,56.35727111931316,56.277703697289915,51211,34242.2,73.41943832369218,68.08267473524663,NaN,NaN,NaN,NaN,0.9618113844853652,48.522796896912965,-3429273,0.04153951634901065,1.1329346625301469,1.0913951461811362
2023-06-14T09:30:00-04:00,56.49,57.1,56.1,56.59,53.69445604191088,NaN,NaN,NaN,NaN,NaN,52.15579999999986,56.987510405234914,47.3240895947648,54.85145860304074,56.596666666666664,56.59666762034098,56.59666571299235,25707,34324.96666666667,73.94599577500678,68.40620396724508,NaN,NaN,NaN,NaN,0.9645391427364105,49.868607010062775,-3403566,0.05888883810127288,1.1650061938077272,1.1061173557064543
2023-06-14T13:30:00-04:00,56.5,56.69,55.5,56.56,53.69445604191088,NaN,NaN,NaN,NaN,NaN,52.29379999999986,57.22560354840454,47.36199645159518,54.85145860304074,56.35114701442564,56.50873375183512,56.19356027701616,62400,35700.433333333334,73.51824579506876,68.6053443156227,NaN,NaN,NaN,NaN,0.9806434896838095,50.04271942805063,-3465966,0.05467721595361863,1.1744638756484775,1.119786659694859
2023-06-15T09:30:00-04:00,55.89,56.77,55.58,56.69,53.69445604191088,NaN,NaN,NaN,NaN,NaN,52.43519999999986,57.45684314144825,47.413556858551466,54.85145860304074,56.346666666666664,56.346666666666664,56.346666666666664,50602,36823.73333333333,74.21432806221803,68.78560913848877,NaN,NaN,NaN,NaN,0.9955975261349664,50.247844911971065,-3415364,0.0472585978423532,1.1788599069978005,1.1316013091554473
2023-06-15T13:30:00-04:00,56.8,57.4,56.8,57.17,54.17335907251471,NaN,NaN,NaN,NaN,NaN,52.579199999999865,57.721305156456076,47.437094843543655,55.03694680475685,56.66497653841518,57.0469444593269,56.28300861750346,35141,37675.833333333336,76.65439388628158,69.06812916411333,NaN,NaN,NaN,NaN,0.9751977028396118,50.76659711356331,-3380223,0.0604472634432871,1.207160388459556,1.146713125016269
2023-06-16T09:30:00-04:00,57.63,57.85,56.86,57.32,54.426388205582235,NaN,NaN,NaN,NaN,NaN,52.722999999999864,57.98386114624329,47.462138853756436,55.46455744380548,57.343333333333334,57.343333333333334,57.343333333333334,41132,36394.9,77.37491709356055,69.93808269470786,NaN,NaN,NaN,NaN,0.9762550097796396,51.46025502355507,-3339091,0.0646632030011065,1.2275421287676522,1.1628789257665457
2023-06-16T13:30:00-04:00,57.26,57.46,56.94,57.37,54.426388205582235,NaN,NaN,NaN,NaN,NaN,52.86819999999987,58.23230990193649,47.504090098063244,55.46455744380548,57.281813205417606,57.321145358685506,57.24248105214971,100628,39257.8,77.62283692907403,71.00602819878799,NaN,NaN,NaN,NaN,0.9436653662239513,52.10436593997599,-3238463,0.05650505828613994,1.2335102486242207,1.1770051903380807
2023-06-20T09:30:00-04:00,57.03,58.02,56.35,57.25,54.426388205582235,NaN,NaN,NaN,NaN,NaN,53.042599999999865,58.398197908735675,47.687002091264056,55.46455744380548,57.20666666666667,57.20666666666667,57.20666666666667,34632,38331.13333333333,75.48498513423093,71.76237130752095,NaN,NaN,NaN,NaN,0.9955464114936692,51.602040598911856,-3273095,0.030040951394862292,1.2145563795816585,1.1845154281867962
2023-06-20T13:30:00-04:00,57.22,57.79,57.22,57.59,54.59815422350648,NaN,NaN,NaN,NaN,NaN,53.22499999999985,58.56643838306311,47.883561616936596,55.46455744380548,57.37504810674427,57.53830341108741,57.211792802401135,36841,38260.13333333333,77.38544411898587,72.58447863398713,NaN,NaN,NaN,NaN,0.9651502392441215,51.135595639352296,-3236254,0.022777970221229626,1.2129878909633334,1.1902099207421037
2023-06-21T09:30:00-04:00,57.88,57.88,56.02,56.17,54.59815422350648,NaN,NaN,NaN,NaN,NaN,53.35739999999986,58.65591271207837,48.05888728792136,55.46455744380548,56.69,56.69,56.69,66485,38877.2,57.378879743745465,71.91866907434516,NaN,NaN,NaN,NaN,1.0290680792981128,48.78918890647057,-3302739,-0.08444038378630525,1.0846594410092223,1.1690998247955275
2023-06-21T13:30:00-04:00,56.28,56.77,56.09,56.09,54.59815422350648,NaN,NaN,NaN,NaN,NaN,53.48999999999987,58.72317265146616,48.25682734853358,55.46455744380548,56.54592458151299,56.72766733933811,56.36418182368787,41782,39086.833333333336,56.49276011588735,71.43316154518018,NaN,NaN,NaN,NaN,1.0041346450625332,46.61038265450897,-3344521,-0.1629801395109074,0.9653746504068934,1.1283547899178008
2023-06-22T09:30:00-04:00,55.69,56.1,55.16,55.95,54.59815422350648,NaN,NaN,NaN,NaN,NaN,53.63699999999986,58.72333659917024,48.55066340082948,55.46455744380548,55.73666666666666,55.73666666666666,55.73666666666666,41613,39729.566666666666,54.895056350111986,70.67013621131788,NaN,NaN,NaN,NaN,0.9995535989866384,43.38461701112281,-3386134,-0.22288511677628575,0.8497483939474435,1.0726335107237293
2023-06-22T13:30:00-04:00,56.02,56.15,55.87,56.09,54.59815422350648,NaN,NaN,NaN,NaN,NaN,53.78739999999987,58.70753790051174,48.867262099488,55.46455744380548,55.81104042412193,55.940580655088745,55.68150019315511,13717,38960.566666666666,56.22821670030989,69.8686005907161,NaN,NaN,NaN,NaN,0.9481569133447357,40.44680050152974,-3372417,-0.24959291188743826,0.7606423708644314,1.0102352827518697
2023-06-23T09:30:00-04:00,55.25,56.25,54.63,56.19,54.59815422350648,NaN,NaN,NaN,NaN,NaN,53.911199999999866,58.75482449412164,49.06757550587809,55.46455744380548,55.69,55.69,55.69,46871,39484.066666666666,57.20129003263259,68.70119914720038,NaN,NaN,NaN,NaN,0.996145705248683,38.70541399453509,-3325546,-0.2560771234274156,0.6901388784676001,0.9462160018950158
2023-06-23T13:30:00-04:00,56.16,56.23,55.69,55.93,54.59815422350648,NaN,NaN,NaN,NaN,NaN,54.02859999999986,58.776765136140256,49.28043486385947,55.46455744380548,55.79057691552961,55.91720346133194,55.66395036972729,29570,39498.26666666667,53.849396599055446,67.30333902401205,NaN,NaN,NaN,NaN,0.9635638691594913,37.088412238040064,-3355116,-0.27193637890830924,0.6062955282596292,0.8782319071679384
2023-06-26T09:30:00-04:00,55.8,56.98,55.17,55.65,54.59815422350648,NaN,NaN,NaN,NaN,NaN,54.134599999999864,58.78517795978723,49.4840220402125,55.45031676403551,55.93333333333334,55.93333333333334,55.93333333333334,27790,39465.3,50.42266904474262,65.62310140042175,NaN,NaN,NaN,NaN,1.024023592790956,34.661205965644086,-3382906,-0.2934969171898515,0.5113607606806241,0.8048576778704756
2023-06-26T13:30:00-04:00,55.51,55.91,55.29,55.33,54.59815422350648,NaN,NaN,NaN,NaN,NaN,54.226199999999864,58.7860454184387,49.66635458156103,55.45031676403551,55.81215572963486,56.00350490591012,55.6208065533596,11145,39100.46666666667,46.76037390154586,63.71182483659869,NaN,NaN,NaN,NaN,0.9951647647344589,32.40737156984782,-3394051,-0.3193844377449261,0.405627130689318,0.7250115684342441
2023-06-27T09:30:00-04:00,56.19,57.42,55.87,57.31,54.59815422350648,NaN,NaN,NaN,NaN,NaN,54.37179999999986,58.85058678216089,49.89301321783883,55.449253411228405,56.86666666666667,56.86666666666667,56.86666666666667,35819,39599.566666666666,64.12375740968545,62.991069789989226,NaN,NaN,NaN,NaN,1.0733672815391406,31.393659530412837,-3358232,-0.19911839183780855,0.47611357863698345,0.675231970474792
2023-06-27T13:30:00-04:00,57.33,57.91,57.33,57.77,54.59815422350648,NaN,NaN,NaN,NaN,NaN,54.52619999999986,58.93003449280945,50.122365507190274,55.16776012338506,57.22948934237586,57.62927335340922,56.829705331342495,29502,39853.4,66.83031938167014,62.28935018251697,NaN,NaN,NaN,NaN,1.0395553328577731,30.846086359653953,-3328730,-0.09009968470429741,0.5626073645944203,0.6527070492987177
2023-06-28T09:30:00-04:00,57.6,59.3,57.53,58.18,55.253194572769594,NaN,NaN,NaN,NaN,NaN,54.65039999999986,59.108801435498705,50.19199856450102,56.221208098708054,58.33666666666667,58.33666666666667,58.33666666666667,38142,39413.73333333333,69.07007482788471,61.696147163540125,NaN,NaN,NaN,NaN,1.0917299519393604,31.26784785716266,-3290588,0.003168939826123429,0.6566682240813719,0.6534992842552485
2023-06-28T13:30:00-04:00,58.34,58.46,58.13,58.38,55.253194572769594,NaN,NaN,NaN,NaN,NaN,54.778399999999856,59.28995380773194,50.26684619226777,56.221208098708054,58.33296588125363,58.33893647525404,58.32699528725322,14654,39335.566666666666,70.12964687048172,61.16091930221211,NaN,NaN,NaN,NaN,1.0373206696579775,31.65948353342075,-3275934,0.06826749023716039,0.738833647051699,0.6705661568145386
2023-06-29T09:30:00-04:00,58.53,58.97,57.9,58.24,55.36523513758552,NaN,NaN,NaN,NaN,NaN,54.912599999999856,59.428851206483216,50.396348793516495,56.33257318317315,58.37,58.370000953674314,58.36999904632568,21948,36582.53333333333,68.36416660011132,60.65228940691785,NaN,NaN,NaN,NaN,1.0396549075395505,32.32915772268356,-3297882,0.09044340923505179,0.7836204183583533,0.6931770091233015
2023-06-29T13:30:00-04:00,58.27,58.27,57.88,58.2,55.36523513758552,NaN,NaN,NaN,NaN,NaN,55.05719999999986,59.521941945516986,50.592458054482734,56.33257318317315,58.25953159125363,58.38515826392155,58.133904918585706,16971,36363.666666666664,67.83868768620555,59.97037823314782,NaN,NaN,NaN,NaN,0.9932509855724397,32.92226283273536,-3314853,0.0907293836521903,0.8065887386885393,0.715859355036349
2023-06-30T09:30:00-04:00,59.15,59.34,58.34,58.99,55.83674317288268,NaN,NaN,NaN,NaN,NaN,55.229999999999855,59.62081040356577,50.83918959643394,56.92604683723082,58.89,58.89000095367432,58.889999046325684,41751,37085,72.35778231851337,61.04029984563124,NaN,NaN,NaN,NaN,1.003733058031551,34.0715425124373,-3273102,0.13004204398396957,0.878411910016311,0.7483698660323415
2023-06-30T13:30:00-04:00,58.9,59.07,58.585,58.63,55.894618483206195,NaN,NaN,NaN,NaN,NaN,55.38779999999985,59.687986582005905,51.08761341799379,56.92604683723082,58.82337752183511,58.88749717639116,58.75925786727907,45074,38252.666666666664,67.69008358611418,61.840108664933155,NaN,NaN,NaN,NaN,0.9666806967435831,35.13873078644623,-3318176,0.11806833484545776,0.8959552845891636,0.7778869497437059
2023-07-03T09:30:00-04:00,59.12,60.45,59.1,60.31,56.72724946124228,NaN,NaN,NaN,NaN,NaN,55.592999999999854,59.83352496750837,51.35247503249134,57.80106997582773,59.95333333333335,59.95333333333335,59.95333333333335,62242,38448.86666666667,75.60037091045405,63.31905970495759,NaN,NaN,NaN,NaN,1.027632075547613,36.76456502903115,-3255934,0.2044959370938646,1.0335068711110367,0.8290109340171721
2023-07-05T09:30:00-04:00,59.67,60.09,59.23,60.09,56.72724946124228,NaN,NaN,NaN,NaN,NaN,55.79279999999985,59.91910205390537,51.66649794609433,57.80106997582773,59.80333333333334,59.80333333333334,59.80333333333334,26187,38505.666666666664,73.07725763964305,64.52256262919568,NaN,NaN,NaN,NaN,1.0313726415799267,38.27426825428857,-3282121,0.22634924838522275,1.1119474944987005,0.8855982461134777
2023-07-05T13:30:00-04:00,59.93,60.2,59.83,59.89,57.04698762894182,NaN,NaN,NaN,NaN,NaN,55.95959999999985,60.060567612657195,51.85863238734251,57.88768478452974,59.88337637407049,59.96823171305882,59.79852103508215,23301,38087.46666666667,70.76506646740307,65.49140380310784,NaN,NaN,NaN,NaN,0.9841317386099322,39.72382679774951,-3305422,0.2073435159813728,1.1447776410901938,0.937434125108821
2023-07-06T09:30:00-04:00,59.01,59.07,57.38,58,57.04698762894182,NaN,NaN,NaN,NaN,NaN,56.09719999999986,59.996112751019645,52.19828724898007,57.88768478452974,58.15,58.15000067434958,58.14999932565042,48527,38765.333333333336,53.528731029959296,65.46849911960098,NaN,NaN,NaN,NaN,1.0931223287092227,37.94859893829274,-3353949,0.055400008792618194,1.0066841360995937,0.9512841273069755
2023-07-06T13:30:00-04:00,57.9,58.41,57.9,58.31,57.04698762894182,NaN,NaN,NaN,NaN,NaN,56.225799999999865,59.98136992213682,52.47023007786291,57.88768478452974,58.17326413604616,58.20114030896537,58.14538796312694,33798,38506.1,55.445637086151514,65.8272825511302,NaN,NaN,NaN,NaN,1.0514707338014209,36.30017306879716,-3320151,-0.031628597904511,0.9117483799263368,0.9433769778308478
2023-07-07T09:30:00-04:00,58.51,59.85,58.51,59.72,57.04698762894182,NaN,NaN,NaN,NaN,NaN,56.37359999999986,60.085674913045466,52.661525086954256,57.88768478452974,59.35999999999999,59.35999999999999,59.35999999999999,67677,39054.96666666667,62.93467762817238,66.98258996017495,NaN,NaN,NaN,NaN,1.0863656813870335,35.7310967551101,-3252474,-0.003136101041215311,0.9394568515293287,0.942592952570544
2023-07-07T13:30:00-04:00,59.71,59.71,58.85,58.98,57.04698762894182,NaN,NaN,NaN,NaN,NaN,56.50439999999986,60.11226287988621,52.896537120113514,57.88768478452974,59.30614930566342,59.38857034485036,59.22372826647648,28890,39161.066666666666,57.47448088688823,66.507641637118,NaN,NaN,NaN,NaN,1.070910989859388,35.202668749543555,-3281364,-0.04093166764846601,0.8914283680099615,0.9323600356584275
2023-07-10T09:30:00-04:00,58.79,59.73,58.33,59.73,57.04698762894182,NaN,NaN,NaN,NaN,NaN,56.63599999999987,60.2248159607396,53.04718403926014,57.88768478452974,59.26333333333333,59.26333333333333,59.26333333333333,25150,37919.4,61.15313134649723,66.10212820603422,NaN,NaN,NaN,NaN,1.0944173477265744,34.142588522660645,-3256214,-0.02311239153156719,0.9034695462439686,0.9265819377755358
2023-07-10T13:30:00-04:00,59.75,60.4,59.66,60.4,57.04698762894182,NaN,NaN,NaN,NaN,NaN,56.764999999999866,60.42140315064674,53.10859684935299,57.88768478452974,59.724234721263706,60.16895052474,59.279518917787414,27014,37133.13333333333,64.13765995868631,65.74981285823434,NaN,NaN,NaN,NaN,1.069101822888962,33.60961567348012,-3229200,0.023578339377310575,0.956054861997174,0.9324765226198635
2023-07-11T09:30:00-04:00,60.77,63.27,60.67,62.95,58.57371704411604,NaN,NaN,NaN,NaN,NaN,56.94799999999986,60.896717260081076,52.99928273991864,59.655411232124614,62.29666666666666,62.29666666666666,62.29666666666666,124256,40103.63333333333,72.72614130585265,65.93527674647513,NaN,NaN,NaN,NaN,1.1977374069683222,34.51806513393328,-3104944,0.20584100172212183,1.1897777747725158,0.983936773050394
2023-07-11T13:30:00-04:00,62.99,63.03,62.39,62.84,59.38082081483803,NaN,NaN,NaN,NaN,NaN,57.11199999999986,61.335255616235195,52.888744383764525,59.81832898569969,62.42646943164362,62.63244962052265,62.220489242764586,49344,40377.36666666667,71.9259377561836,66.18968897190886,NaN,NaN,NaN,NaN,1.1578990207562991,35.3616253472112,-3154288,0.2932988752560457,1.3505603671204511,1.0572614918644054
2023-07-12T09:30:00-04:00,64.2,64.2,62.49,63.07,59.93396532325448,NaN,NaN,NaN,NaN,NaN,57.28839999999987,61.74888851136923,52.827911488630505,60.775663188559754,63.25333333333334,63.25333333333334,63.25333333333334,138860,41651.76666666667,72.60468192198016,66.53011713160704,NaN,NaN,NaN,NaN,1.1973348049879922,36.57601985599819,-3015428,0.33777977582239216,1.4794862116423957,1.1417064358200035
2023-07-12T13:30:00-04:00,63.02,63.25,62.85,63.08,59.93396532325448,NaN,NaN,NaN,NaN,NaN,57.46099999999987,62.13172628185984,52.7902737181399,60.775663188559754,63.210290639631125,63.290720198669966,63.129861080592285,39769,41823,72.63565915978097,66.54996547741187,NaN,NaN,NaN,NaN,1.1403823189174211,37.703671899871836,-2975659,0.3381820255512833,1.5644339677591077,1.2262519422078244
2023-07-13T09:30:00-04:00,63.71,65.81,63.66,65.75,61.20267294949427,NaN,NaN,NaN,NaN,NaN,57.68099999999987,62.831798384722575,52.530201615277164,62.09342444067824,65.07333333333334,65.07333333333334,65.07333333333334,91653,43650.066666666666,79.34975452747338,67.38279911608039,NaN,NaN,NaN,NaN,1.2539264389947484,39.506156506958526,-2884006,0.4799197447967116,1.8261516232037138,1.3462318784070022
2023-07-13T13:30:00-04:00,65.76,66.93,65.74,66.72,62.80096054269909,NaN,NaN,NaN,NaN,NaN,57.915999999999876,63.595625339761405,52.23637466023835,63.36173955254259,65.76075586365116,66.45571455447654,65.06579717282577,89676,44423.1,81.1584456167354,67.77980445224334,NaN,NaN,NaN,NaN,1.2493602647808386,41.43056370110103,-2794330,0.5932298100925333,2.087769141022669,1.4945393309301356
2023-07-14T09:30:00-04:00,66.74,67.84,65.61,65.72,63.0475077907582,NaN,NaN,NaN,NaN,NaN,58.12639999999987,64.15658508505855,52.096214914941186,63.87039164203407,66.39,66.39,66.39,106031,46564.73333333333,73.96588414260891,67.84327777388377,NaN,NaN,NaN,NaN,1.319405960153636,43.400887988360495,-2900361,0.555709183313049,2.189175810071447,1.633466626758398
2023-07-14T13:30:00-04:00,65.65,65.75,64.55,65.13,63.0475077907582,NaN,NaN,NaN,NaN,NaN,58.338799999999864,64.58863537703698,52.08896462296274,63.87039164203407,66.08318411603683,66.62017680564045,65.54619142643321,34614,46331.433333333334,70.02288608061619,67.79026488911327,NaN,NaN,NaN,NaN,1.3108769629998052,44.17319501357452,-2934975,0.4505163626005928,2.196612080009139,1.746095717408546
2023-07-17T09:30:00-04:00,65.13,66.8,64.7,66.69,63.0475077907582,NaN,NaN,NaN,NaN,NaN,58.58739999999987,65.14954210148362,52.025257898516124,63.87039164203407,66.06333333333333,66.06333333333333,66.06333333333333,47803,47467.63333333333,73.97352811676457,69.2506075381708,NaN,NaN,NaN,NaN,1.3672428942141044,45.16977442460836,-2887172,0.4446034625313624,2.301850045572749,1.8572465830413867
2023-07-17T13:30:00-04:00,66.75,66.82,66.51,66.57,63.0475077907582,NaN,NaN,NaN,NaN,NaN,58.825999999999866,65.65865570624362,51.9933442937561,63.87039164203407,66.31998999517008,66.60357711614415,66.036402874196,39155,47210.433333333334,73.17465123349496,70.51696569155247,NaN,NaN,NaN,NaN,1.2917255446273816,46.100402706927,-2926327,0.3930002409030471,2.3484968841701956,1.9554966432671486
2023-07-18T09:30:00-04:00,66.77,67,66.03,66.45,63.0475077907582,NaN,NaN,NaN,NaN,NaN,59.05879999999986,66.11770715621515,51.999892843784586,63.87039164203407,66.49333333333334,66.49333333333334,66.49333333333334,79470,48873.76666666667,72.33339737571333,71.18830281637682,NaN,NaN,NaN,NaN,1.2687451485825687,46.475680868163884,-3005797,0.3145686099933509,2.3487074057588373,2.0341387957654864
2023-07-18T13:30:00-04:00,66.44,66.91,66.3,66.58,63.05782269101545,NaN,NaN,NaN,NaN,NaN,59.29139999999987,66.55684259904818,52.02595740095156,64.03367873326172,66.52050785524827,66.56600048421205,66.47501522628448,28356,48892.63333333333,72.6995673478375,72.27580899215891,NaN,NaN,NaN,NaN,1.2216919236838137,46.82415344645529,-2977441,0.23867041805472677,2.3324768183338946,2.093806400279168
2023-07-19T09:30:00-04:00,67.33,68.33,66.6,66.85,63.840421659605674,NaN,NaN,NaN,NaN,NaN,59.53519999999987,66.97855326583823,52.09184673416151,65.15394298660938,67.26,67.26,67.26,64246,50662.666666666664,73.48449897359019,73.1566209655227,NaN,NaN,NaN,NaN,1.2594282148492557,47.59684298877353,-2913195,0.17672933999318952,2.3147180752706547,2.137988735277465
2023-07-19T13:30:00-04:00,66.79,67.53,66.76,67.51,63.840421659605674,NaN,NaN,NaN,NaN,NaN,59.78519999999986,67.4404666733477,52.129933326652015,65.15394298660938,67.26183163249948,67.2648075366443,67.25885572835466,24338,50279.96666666667,75.35019401801625,73.95751625547483,NaN,NaN,NaN,NaN,1.2244690566457372,48.31434042092618,-2888857,0.15126945115472568,2.327075549220872,2.1758060980661464
2023-07-20T09:30:00-04:00,66.5,66.75,64.48,64.62,63.840421659605674,NaN,NaN,NaN,NaN,NaN,59.97139999999986,67.63509729047725,52.307702709522474,65.15394298660938,65.28333333333335,65.28333333333335,65.28333333333335,76723,51854,56.57761156676178,72.80404984553977,NaN,NaN,NaN,NaN,1.3534355525996133,46.79619033042463,-2965580,-0.07688756582396028,2.079696640786196,2.156584206610156
2023-07-20T13:30:00-04:00,64.61,64.73,63.65,63.86,NaN,NaN,NaN,67.97978869368819,67.97978869368819,67.97978869368819,60.11879999999986,67.79248452831284,52.445115471686876,65.15394298660938,64.77335764102719,65.36799664327884,64.17871863877554,56431,52463.63333333333,52.84876172903722,71.44139441502931,NaN,NaN,NaN,NaN,1.3339044416996413,44.74502740834802,-3022011,-0.28402398173650534,1.8015542294395246,2.08557821117603
2023-07-21T09:30:00-04:00,64.63,65.01,63.58,64.32,NaN,NaN,NaN,67.97978869368819,NaN,NaN,60.275600000000026,67.96584229527195,52.585357704728104,65.15394298660938,64.30333333333333,64.30333333333333,64.30333333333333,24595,52795,54.79092110702667,70.16898292824692,NaN,NaN,NaN,NaN,1.3407684101496675,42.98686307272447,-2997416,-0.3886217609746059,1.5998010099577726,1.9884227709323785
2023-07-21T13:30:00-04:00,64.32,64.53,63.8,63.97,NaN,NaN,NaN,67.90377440891837,NaN,NaN,60.42320000000002,68.1081124289084,52.73828757109165,65.15394298660938,64.20006369469233,64.30171772358753,64.09840966579713,25383,52909.5,53.00204889395823,68.76658219497385,NaN,NaN,NaN,NaN,1.2971420951389772,41.354281903931174,-3022799,-0.47427368091030453,1.395580669794498,1.8698543507048024
2023-07-24T09:30:00-04:00,63.75,64.06,62.68,63.41,NaN,NaN,NaN,67.12701193578573,NaN,NaN,60.56020000000003,68.20889504163853,52.91150495836153,65.15394298660938,63.383333333333326,63.38333428700764,63.38333237965901,50753,54035.566666666666,50.17912932674811,66.68296610920777,NaN,NaN,NaN,NaN,1.3030605169147649,38.94547096697673,-3073552,-0.5558814318486585,1.1750025608939794,1.7308839927426378
2023-07-24T13:30:00-04:00,63.33,63.57,63.19,63.36,NaN,NaN,NaN,67.01805684779546,NaN,NaN,60.693600000000025,68.30018847052924,53.087011529470814,65.15394298660938,63.38010744507621,63.38478211377302,63.375432776379405,24169,53449.5,49.923460846026074,64.45189576844281,NaN,NaN,NaN,NaN,1.2371276228494248,36.70871795409047,-3097721,-0.5968623880799875,0.9848060076426535,1.581668395722641
2023-07-25T09:30:00-04:00,63.68,64.1,63.51,63.83,NaN,NaN,NaN,67.01805684779546,NaN,NaN,60.82680000000002,68.4151409939191,53.238459006080944,65.15394298660938,63.813333333333325,63.813334007682904,63.81333265898375,16547,52498.6,52.37963590913619,62.91002089462334,NaN,NaN,NaN,NaN,1.2016185069316083,34.98814837136317,-3081174,-0.5756854117168331,0.8620616310765996,1.4377470427934327
2023-07-25T13:30:00-04:00,63.85,63.87,63.01,63.07,NaN,NaN,NaN,66.96843609478884,NaN,NaN,60.94180000000003,68.48824042181384,53.39535957818622,65.15394298660938,63.63119624427519,63.870544320701946,63.39184816784843,9582,50743.26666666667,48.257780329686774,61.35537048384266,NaN,NaN,NaN,NaN,1.177217185007922,32.971950263341846,-3090756,-0.5938428024902123,0.6954435396806673,1.2892863421708796
2023-07-26T09:30:00-04:00,62.9,64.15,62.74,63.67,NaN,NaN,NaN,66.96843609478884,NaN,NaN,61.06780000000003,68.58179258982801,53.55380741017204,64.60415438928752,63.52,63.52,63.52,19719,50527.666666666664,51.50246363695679,59.750294449570674,NaN,NaN,NaN,NaN,1.193844528935928,31.30237390803329,-3071037,-0.547556861462491,0.6048402653427658,1.1523971268052569
2023-07-26T13:30:00-04:00,63.67,64.43,63.57,64.11,NaN,NaN,NaN,66.96843609478884,NaN,NaN,61.20500000000003,68.68558420178466,53.72441579821539,62.89432351143,63.85967229538006,64.10486626831839,63.61447832244173,37843,51012.4,53.79091023466626,58.36574152108291,NaN,NaN,NaN,NaN,1.169998491154791,29.9568968184785,-3033194,-0.4722683074133971,0.5620617425385106,1.0343300499519077
2023-07-27T09:30:00-04:00,65.45,65.62,63.67,63.67,NaN,NaN,NaN,66.96843609478884,NaN,NaN,61.32660000000003,68.76572856186709,53.88747143813296,62.55196861392089,64.32000000000001,64.32000000000001,64.32000000000001,28524,50345.63333333333,51.18962636450874,56.85547216313973,NaN,NaN,NaN,NaN,1.2257128846437344,29.500240883925322,-3061718,-0.43783137696508123,0.4870408287455561,0.9248722057106373
2023-07-27T13:30:00-04:00,63.65,63.66,62.09,62.32,NaN,NaN,NaN,66.54769094559212,NaN,NaN,61.449600000000025,68.74561421051175,54.153585789488304,62.55196861392089,63.45917167105067,64.2728821627282,62.64546117937314,31923,50283.13333333333,44.13704810372136,54.815292217131436,NaN,NaN,NaN,NaN,1.2510191071691819,27.721730716543654,-3093641,-0.48788086136247755,0.3150211290075404,0.802901990370018
2023-07-28T09:30:00-04:00,63.79,65.41,63.79,65.17,NaN,NaN,NaN,66.54769094559212,NaN,NaN,61.631200000000035,68.83600355318485,54.42639644681522,62.55196861392089,64.79,64.79,64.79,96939,51258.53333333333,57.461372621291105,53.67078319196721,NaN,NaN,NaN,NaN,1.3823748852285258,27.12460666566828,-2996702,-0.3191149499309692,0.4040083029563064,0.7231232528872756
2023-07-28T13:30:00-04:00,65.16,65.55,64.9,65.49,NaN,NaN,NaN,66.54769094559212,NaN,NaN,61.82200000000003,68.9193741623215,54.72462583767855,62.55196861392089,65.08655111063429,65.34588201896075,64.82722020230783,126762,54520.933333333334,58.653839455567294,52.47818643750657,NaN,NaN,NaN,NaN,1.3300623934264877,26.64590561956509,-2869940,-0.18277813743974813,0.4946505810875905,0.6774287185273387
2023-07-31T09:30:00-04:00,66.05,67.22,66.05,66.9,62.73626588588197,62.73626588588197,62.73626588588197,NaN,NaN,NaN,62.03820000000003,69.08235864670776,54.994041353292296,63.445054344262,66.72333333333333,66.72333333333333,66.72333333333333,37321,54926.63333333333,63.50800182342116,52.97321431298224,NaN,NaN,NaN,NaN,1.358629365324596,27.02310107945374,-2832619,-0.00393641499623576,0.6725081997820439,0.6764446147782797
2023-07-31T13:30:00-04:00,66.91,67.28,66.91,67.27,63.32166289106916,NaN,NaN,NaN,NaN,NaN,62.25980000000004,69.25103507257336,55.268564927426716,64.0700434754096,66.87863707685021,67.08518333550073,66.67209081819969,21100,54729.5,64.67984372661164,53.818291598523274,NaN,NaN,NaN,NaN,1.2887272678014103,27.40039986125292,-2811519,0.12580998445167513,0.8337070953428736,0.7078971108911984
2023-08-01T09:30:00-04:00,66.3,66.34,65.05,66.2,63.32166289106916,NaN,NaN,NaN,NaN,NaN,62.46520000000004,69.30225461730275,55.628145382697326,64.0700434754096,65.86333333333333,65.86333333333333,65.86333333333333,21163,51293.066666666666,58.79938877045616,54.10461071733967,NaN,NaN,NaN,NaN,1.355246748672738,26.270705265859025,-2832682,0.1257986836248257,0.8651454654222306,0.7393467817974049
2023-08-01T13:30:00-04:00,66.14,66.55,66.14,66.42,63.32166289106916,NaN,NaN,NaN,NaN,NaN,62.68060000000004,69.32102216730095,56.04017783269913,64.0700434754096,66.03659660251029,66.27694335743789,65.79624984758269,10998,50014.86666666667,59.61243129678729,54.57678088897031,NaN,NaN,NaN,NaN,1.2877291237675421,25.339714471383566,-2821684,0.12649642817652018,0.8974673170180552,0.770970888841535
2023-08-02T09:30:00-04:00,65,65.1,62.53,63.24,NaN,NaN,NaN,67.95647961737495,67.95647961737495,67.95647961737495,62.838800000000035,69.1394052280701,56.53819477192996,64.0700434754096,63.623333333333335,63.623333333333335,63.623333333333335,99287,48695.76666666667,45.60369998847657,54.249964507665204,NaN,NaN,NaN,NaN,1.4736056149270034,24.663138079103835,-2920971,-0.08966635621483421,0.6588879435729922,0.7485542997878264
2023-08-02T13:30:00-04:00,63.27,63.67,63.09,63.23,NaN,NaN,NaN,67.41232145294882,NaN,NaN,62.957200000000036,69.05706759200429,56.857332407995784,64.0700434754096,63.55038400226003,63.67717858236208,63.42358942215798,32865,48465.63333333333,45.567436120298396,53.938819884398946,NaN,NaN,NaN,NaN,1.4097766424322171,24.034888571986944,-2953836,-0.2279151464457978,0.4636603667305792,0.691575513176377
2023-08-03T09:30:00-04:00,62.32,63.35,62.32,63.21,NaN,NaN,NaN,66.82448865963296,NaN,NaN,63.06600000000004,68.98322772926514,57.14877227073493,64.0700434754096,62.96,62.96,62.96,56960,47309.2,45.48952487835532,53.446669096486026,NaN,NaN,NaN,NaN,1.3826497394013446,23.810758078625078,-3010796,-0.310200436469656,0.303824967589307,0.614025404058963
2023-08-03T13:30:00-04:00,63.17,63.17,62.63,62.77,NaN,NaN,NaN,66.78723917510419,NaN,NaN,63.157800000000044,68.9090646122378,57.40653538776228,64.0700434754096,62.92541313835649,62.97417505693872,62.87665121977426,28657,45275.23333333333,43.71852551836735,53.12243660996321,NaN,NaN,NaN,NaN,1.3253176151583914,23.60263690621763,-3039453,-0.379191767145425,0.14003569512718173,0.5192274622726067
2023-08-04T09:30:00-04:00,63.21,63.5,61.94,62.54,NaN,NaN,NaN,66.643273758054,NaN,NaN,63.24100000000004,68.83150087201282,57.65049912798726,64.0700434754096,62.660000000000004,62.660000000000004,62.660000000000004,42513,43157.96666666667,42.780926736307,52.49946968848824,NaN,NaN,NaN,NaN,1.342080642647078,23.739880664132524,-3081966,-0.4219680979501703,-0.008232660165106154,0.41373543778506416
2023-08-04T13:30:00-04:00,62.54,62.54,61.46,61.64,NaN,NaN,NaN,65.89221585996063,NaN,NaN,63.30900000000004,68.73481422461015,57.88318577538993,64.0700434754096,62.279808777429466,62.66968540905151,61.88993214580742,40427,43351.73333333333,39.2350390588358,51.45976460450034,NaN,NaN,NaN,NaN,1.323360596743715,24.090650002752525,-3122393,-0.48786705286661913,-0.19609837829820975,0.2917686745684094
2023-08-07T09:30:00-04:00,61.98,61.98,60.34,61.2,NaN,NaN,NaN,65.09893332087151,NaN,NaN,63.36900000000004,68.63138919123044,58.10661080876964,64.0700434754096,61.17333333333333,61.17333333333333,61.17333333333333,52536,43509.5,37.59447330560187,50.48868224314986,NaN,NaN,NaN,NaN,1.3459776969763062,24.902687062513063,-3174929,-0.5343362154520662,-0.37615159474667337,0.15818462070539283
2023-08-07T13:30:00-04:00,61.23,61.68,61.15,61.62,NaN,NaN,NaN,65.09893332087151,NaN,NaN,63.42160000000003,68.55894773594156,58.28425226405851,63.40262782426215,61.25258254343832,61.387811304539625,61.11735378233702,18043,42805.76666666667,40.16632844156845,50.20505941013894,NaN,NaN,NaN,NaN,1.287693575763713,25.656721475147847,-3156886,-0.5100901191293826,-0.47942802820633545,0.03066209092304717
2023-08-08T09:30:00-04:00,60.99,60.99,59.98,60.43,NaN,NaN,NaN,64.36661073244697,NaN,NaN,63.45760000000004,68.48416711483881,58.43103288516127,63.40262782426215,60.46666666666667,60.46666666666667,60.46666666666667,28818,41117.36666666667,35.67963674307131,48.64922113312324,NaN,NaN,NaN,NaN,1.3128583203520192,26.834638279558444,-3185704,-0.5443759291236311,-0.6498078204814917,-0.1054318913578606
2023-08-08T13:30:00-04:00,60.49,61.02,60.39,60.93,NaN,NaN,NaN,64.36661073244697,NaN,NaN,63.470000000000034,68.46842695255071,58.47157304744935,60.637102259409716,60.61237158185902,60.76865428867475,60.45608887504329,25049,41007.13333333333,38.77424695761026,47.229250240412014,NaN,NaN,NaN,NaN,1.264082726041161,27.899446245076103,-3160655,-0.5044584905211075,-0.736005004509245,-0.2315465139881375
2023-08-09T09:30:00-04:00,60.72,60.72,58.6,59.04,NaN,NaN,NaN,63.596488291341146,NaN,NaN,63.44900000000004,68.51245218205698,58.385547817943106,60.18191708545422,59.45333333333333,59.45333333333333,59.45333333333333,40259,40207.566666666666,32.42387864251599,45.00895572749022,NaN,NaN,NaN,NaN,1.340219674181078,29.53295473153375,-3200914,-0.5714988849287903,-0.9459201201491254,-0.3744212352203351
2023-08-09T13:30:00-04:00,59.04,59.17,58.48,58.52,NaN,NaN,NaN,62.67664791446201,NaN,NaN,63.42160000000004,68.57580505606643,58.26739494393366,60.18191708545422,59.06912371113805,59.43361786803786,58.70462955423824,44732,40887.36666666667,30.923270874930097,42.59777195237012,NaN,NaN,NaN,NaN,1.2937754117395726,31.088685439136487,-3245646,-0.6133312477045625,-1.1410852948510382,-0.5277540471464757
2023-08-10T09:30:00-04:00,59.14,60.13,58.32,58.32,NaN,NaN,NaN,62.67664791446201,NaN,NaN,63.42800000000005,68.55598907954943,58.30001092045066,60.18191708545422,58.92333333333334,58.92333333333334,58.92333333333334,88262,41272,30.341633220399927,40.56507512736609,NaN,NaN,NaN,NaN,1.3306485966153174,31.59283703244255,-3333908,-0.6153512246334382,-1.2969430779382733,-0.6815918533048352
2023-08-10T13:30:00-04:00,58.38,58.7,58.04,58.36,NaN,NaN,NaN,62.205055227846586,NaN,NaN,63.42900000000005,68.55301444181971,58.304985558180384,60.18191708545422,58.681227490599305,58.957193092384436,58.405261888814174,67932,41655.36666666667,30.622693325750404,38.49437955800632,NaN,NaN,NaN,NaN,1.2827451254285092,32.1785174865035,-3265976,-0.5755929296491691,-1.4010830153662965,-0.8254900857171275
2023-08-11T09:30:00-04:00,57.66,58.47,57.56,58.01,NaN,NaN,NaN,61.79982544476265,NaN,NaN,63.39480000000005,68.63880189168324,58.15079810831686,59.34553366836337,58.013333333333335,58.013333333333335,58.013333333333335,39225,42143.03333333333,29.50104663962614,37.34419003308843,NaN,NaN,NaN,NaN,1.256120473612187,32.923698305030356,-3305201,-0.5353100149016544,-1.4946276043441955,-0.9593175894425411
2023-08-11T13:30:00-04:00,58.02,58.16,57.88,57.95,NaN,NaN,NaN,61.670969742727976,NaN,NaN,63.374200000000044,68.69494143705371,58.05345856294638,58.71454154775256,58.00601102503264,58.01428280067676,57.99773924938852,30737,42321.5,29.302897972726498,36.18243730826187,NaN,NaN,NaN,NaN,1.1863975826398874,33.615651922233866,-3335938,-0.4770827732923637,-1.5556710560579958,-1.0785882827656321
2023-08-14T09:30:00-04:00,57.29,58.29,57.04,58.22,NaN,NaN,NaN,61.32047111805853,NaN,NaN,63.34400000000005,68.7633623241093,57.9246376758908,58.71454154775256,57.85,57.85000067434958,57.84999932565042,41966,42028.6,31.531545822206738,35.18543880425125,NaN,NaN,NaN,NaN,1.1909406124513242,34.61387855311098,-3293972,-0.38851354626253065,-1.5642302155937955,-1.1757166693312648
2023-08-14T13:30:00-04:00,58.14,58.45,58.06,58.45,NaN,NaN,NaN,61.32047111805853,NaN,NaN,63.30500000000006,68.83547303582377,57.77452696417635,58.15110659056164,58.06188287639861,58.29574308805539,57.82802266474184,34449,42371.26666666667,33.45595659915594,34.45239816716472,NaN,NaN,NaN,NaN,1.1337305687048012,35.35643933741526,-3259523,-0.2872367014202104,-1.5347625461065277,-1.2475258446863173
2023-08-15T09:30:00-04:00,58.08,58.28,57.63,57.86,NaN,NaN,NaN,61.32047111805853,NaN,NaN,63.20320000000005,68.93961343000791,57.4667865699922,58.15110659056164,57.923333333333325,57.923333333333325,57.923333333333325,21750,42544.7,31.045420379416683,33.61414771310113,NaN,NaN,NaN,NaN,1.111321242368744,36.235190991729766,-3281273,-0.23497988126511404,-1.54125069626771,-1.306270815002596
2023-08-15T13:30:00-04:00,57.8,57.86,57.3,57.3,NaN,NaN,NaN,60.99086852219572,NaN,NaN,63.092400000000055,69.06187241889712,57.12292758110298,57.25988527244931,57.68332263519343,57.90057717783557,57.46606809255128,26545,43110.13333333333,28.91582774068644,32.877061190376175,NaN,NaN,NaN,NaN,1.0719411536281196,37.19433477171831,-3307818,-0.21373715517563796,-1.5734422589721433,-1.3597051037965053
2023-08-16T09:30:00-04:00,57.05,57.3,56.25,56.54,NaN,NaN,NaN,60.17401086209591,NaN,NaN,62.961800000000046,69.20688214837719,56.7167178516229,56.73452657436756,56.69666666666666,56.696667834674386,56.69666549865893,21043,43154.26666666667,26.28100606740911,32.06895638764812,NaN,NaN,NaN,NaN,1.070373928368968,38.50201235267175,-3328861,-0.22532342375948966,-1.6413593834958675,-1.4160359597363779
2023-08-16T13:30:00-04:00,56.61,56.98,56.3,56.31,NaN,NaN,NaN,59.977237641091556,NaN,NaN,62.82640000000005,69.34301846051915,56.30978153948095,56.73452657436756,56.60373418830372,56.68651281392878,56.52095556267866,26522,42776.9,25.523044808693143,31.023007556728455,NaN,NaN,NaN,NaN,1.042490076342613,39.716284392128514,-3355383,-0.22254197937236198,-1.6942134339518304,-1.4716714545794685
2023-08-17T09:30:00-04:00,55.94,56,54.95,55.29,NaN,NaN,NaN,58.84599956649649,NaN,NaN,62.61720000000005,69.41067103033356,55.82372896966654,56.18464326788877,55.413333333333334,55.413333333333334,55.413333333333334,54849,43654.4,22.433096179504105,30.076826087902223,NaN,NaN,NaN,NaN,1.065169356603855,41.312496162590335,-3410232,-0.2608096749841162,-1.7976835483096139,-1.5368738733254976
2023-08-17T13:30:00-04:00,55.2,55.24,54.42,54.49,NaN,NaN,NaN,58.166408677110276,NaN,NaN,62.37260000000005,69.43301110417659,55.3121888958235,56.18464326788877,55.03537976918308,55.382451452034594,54.68830808633157,65044,44758.433333333334,20.351964277537363,28.760948753611302,NaN,NaN,NaN,NaN,1.051228688275008,42.95371236606253,-3475276,-0.3081657964092923,-1.922081118837113,-1.6139153224278207
2023-08-18T09:30:00-04:00,53.16,54.66,53.16,54.34,NaN,NaN,NaN,57.29929919178708,NaN,NaN,62.14500000000005,69.48717978532105,54.80282021467905,56.18464326788877,54.053333333333335,54.053333333333335,54.053333333333335,28335,42471.63333333333,19.977730914049573,27.871938201577983,NaN,NaN,NaN,NaN,1.0832837819696501,44.81087610649643,-3503611,-0.3165520272578315,-2.00960535650011,-1.6930533292422785
2023-08-18T13:30:00-04:00,54.34,54.75,54.26,54.49,NaN,NaN,NaN,57.29929919178708,NaN,NaN,61.93220000000005,69.52835512216407,54.33604487783604,56.18464326788877,54.27337547227246,54.49668455363063,54.050066390914296,27512,39163.3,21.531604299071134,27.20110487473091,NaN,NaN,NaN,NaN,1.040906368971818,46.41533506713644,-3476099,-0.2802062803392036,-2.043311179666283,-1.7631048993270793
2023-08-21T09:30:00-04:00,54.69,55.2,54.29,54.89,NaN,NaN,NaN,57.29929919178708,NaN,NaN,61.696200000000054,69.41858708172403,53.97381291827608,56.18464326788877,54.79333333333333,54.79333400768291,54.79333265898375,23036,38687.13333333333,25.676235394322376,26.867862172868232,NaN,NaN,NaN,NaN,1.03155591404526,47.29773402814427,-3453063,-0.20113563772328824,-2.0145244464811896,-1.8133888087579013
2023-08-21T13:30:00-04:00,54.86,55.31,54.84,55.19,NaN,NaN,NaN,57.29929919178708,NaN,NaN,61.46860000000005,69.27335445866039,53.66384554133971,56.05771461431101,54.95871633526302,55.11862575740999,54.79880691311605,24640,38805.13333333333,28.71727010780222,26.731760514443362,NaN,NaN,NaN,NaN,0.9914447773277413,47.96732773754759,-3428423,-0.10535420952489716,-1.9450815706640228,-1.8397273611391256
2023-08-22T09:30:00-04:00,55.92,55.92,54.6,54.98,NaN,NaN,NaN,57.29929919178708,NaN,NaN,61.239200000000054,69.11871149754718,53.359688502452926,55.802171691448805,55.166666666666664,55.16666734101624,55.166665992317085,22842,38861.1,27.858006464238557,26.61440050191568,NaN,NaN,NaN,NaN,1.014913007518617,47.7709640836653,-3451265,-0.036426690395120476,-1.8852607241330261,-1.8488340337379057
2023-08-22T13:30:00-04:00,55,55.32,54.87,54.95,NaN,NaN,NaN,57.29929919178708,NaN,NaN,61.006600000000056,68.92825902825768,53.084940971742434,55.128737353159046,55.108056140350875,55.168040049550356,55.048072231151394,21808,39221.433333333334,27.73035513003127,26.502076013151733,NaN,NaN,NaN,NaN,0.9745620784101446,47.58862640506031,-3473073,0.023626227609955697,-1.819301249225461,-1.8429274768354167
2023-08-23T09:30:00-04:00,54.93,56.37,54.93,56.3,NaN,NaN,NaN,57.29929919178708,NaN,NaN,60.79560000000006,68.64513110446568,52.94606889553444,54.90298988252724,55.86666666666667,55.86666666666667,55.86666666666667,31835,36973.03333333333,40.862495464067074,27.16857241614176,NaN,NaN,NaN,NaN,1.0078076442379913,46.0982701182096,-3441238,0.1629831714816503,-1.639198512483354,-1.8021816839650042
2023-08-23T13:30:00-04:00,56.36,56.5,56.18,56.33,NaN,NaN,NaN,57.29929919178708,NaN,NaN,60.57200000000005,68.2793876248685,52.8646123751316,54.42795171215983,56.020509585992194,56.2410510293913,55.79996814259309,15491,36393.9,41.11854870072606,27.715900423396768,NaN,NaN,NaN,NaN,0.9586785267924205,44.56322791023563,-3425747,0.2601302332628461,-1.4770188923864467,-1.7371491256492928
2023-08-24T09:30:00-04:00,56.65,56.74,54.4,54.72,NaN,NaN,NaN,57.29929919178708,NaN,NaN,60.37400000000006,68.16346570696436,52.584534293035766,54.42795171215983,55.28666666666667,55.28666666666667,55.28666666666667,33569,35614.2,32.88852665461427,27.847550871625167,NaN,NaN,NaN,NaN,1.0573443463072478,44.20177315892029,-3459316,0.22047449110303075,-1.4615560117705044,-1.6820305028735352
2023-08-24T13:30:00-04:00,54.77,54.95,54.4,54.4,NaN,NaN,NaN,57.29929919178708,NaN,NaN,60.18480000000006,68.08514858977587,52.28445141022425,54.42795171215983,54.83402026572665,55.170877116198916,54.497163415254384,60613,36679.4,31.537394536511755,28.034805642755543,NaN,NaN,NaN,NaN,1.021105464428159,43.866136604127476,-3519929,0.17897450163789963,-1.4583123758261607,-1.6372868774640603
2023-08-25T09:30:00-04:00,54.57,55.55,53.94,54.64,NaN,NaN,NaN,57.29929919178708,NaN,NaN,59.991200000000056,67.95092224640867,52.03147775359144,54.42795171215983,54.71,54.71,54.71,39596,36582.166666666664,33.736145491352985,28.567315601608676,NaN,NaN,NaN,NaN,1.0631693598261476,42.84003768514009,-3480333,0.17382404435989285,-1.4200068220141944,-1.5938308663740872
2023-08-25T13:30:00-04:00,54.67,55.33,54.66,55.03,NaN,NaN,NaN,57.29929919178708,NaN,NaN,59.81240000000006,67.80814342759776,51.81665657240237,54.42795171215983,54.799180782478146,54.93520928502198,54.66315227993431,17019,35801.9,37.26220715287457,29.40582719762164,NaN,NaN,NaN,NaN,1.036514405552851,41.88723154608037,-3463314,0.20090323454511716,-1.3427018231926908,-1.543605057737808
2023-08-28T09:30:00-04:00,55.51,55.7,54.99,55.31,NaN,NaN,NaN,57.29929919178708,NaN,NaN,59.650400000000054,67.6761864013427,51.624613598657405,54.42795171215983,55.333333333333336,55.333333333333336,55.333333333333336,27860,34979.36666666667,39.74140023448019,30.64213463011993,NaN,NaN,NaN,NaN,1.0131919480133618,40.55129747425357,-3435454,0.23928596534249302,-1.2444976010596918,-1.4837835664021848
2023-08-28T13:30:00-04:00,55.29,55.29,54.93,55.16,NaN,NaN,NaN,57.29929919178708,NaN,NaN,59.486400000000046,67.53735448751146,51.43544551248863,54.42795171215983,55.260154560699846,55.358990183061714,55.16131893833798,15273,34887.03333333333,38.855566387237936,31.963820495098542,NaN,NaN,NaN,NaN,0.9679639517266933,39.35713026699553,-3450727,0.25475447367755644,-1.1653404743052391,-1.4200949479827956
2023-08-29T09:30:00-04:00,54.94,58.22,54.85,58.22,53.2470743735719,53.2470743735719,53.2470743735719,NaN,NaN,NaN,59.374200000000044,67.33576174628955,51.41263825371054,54.81807149890594,57.096666666666664,57.096666666666664,57.096666666666664,198696,40549.63333333333,58.95501233093621,34.74791202487616,NaN,NaN,NaN,NaN,1.1395379551747864,37.56404970190895,-3252031,0.45932397040574413,-0.8459399849756153,-1.3052639553813594
2023-08-29T13:30:00-04:00,58.26,58.27,58,58.23,54.85708726380095,NaN,NaN,NaN,NaN,NaN,59.27740000000005,67.17429843925967,51.38050156074043,55.41345719912476,57.2864543605285,57.69517610412741,56.87773261692959,42842,41142.73333333333,59.002441815747595,37.42440041892447,NaN,NaN,NaN,NaN,1.0774281012337306,35.93347061727216,-3209189,0.5760036652261331,-0.5852593738486931,-1.1612630390748262
2023-08-30T09:30:00-04:00,58,58.67,57.5,58.49,54.85708726380095,NaN,NaN,NaN,NaN,NaN,59.17380000000006,66.97277930757468,51.37482069242544,55.7997657592998,58.21999999999999,58.22000067434957,58.21999932565041,23254,40575.9,60.287358832540136,39.89662352165432,NaN,NaN,NaN,NaN,1.0840403797170357,33.951612516424326,-3185935,0.646120779600387,-0.35361206457434236,-0.9997328441747294
2023-08-30T13:30:00-04:00,58.53,58.53,58.095,58.46,55.11419521350458,NaN,NaN,NaN,NaN,NaN,59.06080000000006,66.73311890890734,51.38848109109277,56.01631260743984,58.281356655290104,58.35155319141192,58.21116011916829,17766,39677.03333333333,60.05348164053614,42.13492434542103,NaN,NaN,NaN,NaN,1.0376803525943905,32.1113157084942,-3203701,0.6633979531589257,-0.17048540272607227,-0.833883355884998
2023-08-31T09:30:00-04:00,58.68,59.11,58.14,58.36,55.4397999765271,NaN,NaN,NaN,NaN,NaN,58.954600000000056,66.51496211831011,51.39423788169001,56.614050085951874,58.53666666666667,58.53666666666667,58.53666666666667,14516,37218.833333333336,59.228665803076815,44.37568572676662,NaN,NaN,NaN,NaN,1.032846041694791,30.870111475984558,-3218217,0.6406711229127366,-0.03304445224407715,-0.6737155751568138
2023-08-31T13:30:00-04:00,58.41,58.69,58.35,58.41,55.4397999765271,NaN,NaN,NaN,NaN,NaN,58.87640000000005,66.37655120914124,51.37624879085885,56.614050085951874,58.51519024497298,58.54134693567501,58.48903355427095,9786,35280.63333333333,59.52798072005887,46.64694469748287,NaN,NaN,NaN,NaN,0.9833570387165915,29.717564688654168,-3208431,0.6021743665729797,0.07900238305941087,-0.5231719835135689
2023-09-01T09:30:00-04:00,58.75,59.04,58.17,58.3,55.53989006125713,NaN,NaN,NaN,NaN,NaN,58.739000000000054,66.02148446616802,51.45651553383209,56.8715920550092,58.50333333333333,58.50333333333333,58.50333333333333,20716,34663.666666666664,58.51029636080944,47.907501904393044,NaN,NaN,NaN,NaN,0.9752601073796919,28.936840260399816,-3229147,0.5442280862526203,0.15711312430220659,-0.3871149619504137
2023-09-01T13:30:00-04:00,58.32,58.37,58,58.28,55.53989006125713,NaN,NaN,NaN,NaN,NaN,58.59480000000005,65.61777514163191,51.57182485836819,56.8715920550092,58.383340443446535,58.524760626389266,58.241920260503804,14914,34136.23333333333,58.31508958423959,49.13582625321544,NaN,NaN,NaN,NaN,0.9320272425668567,28.00603639299874,-3244061,0.48163204471619336,0.21492509394482795,-0.2667069507713654
2023-09-05T09:30:00-04:00,57.81,58.86,57.7,58.74,55.53989006125713,NaN,NaN,NaN,NaN,NaN,58.431600000000046,65.04213868909201,51.82106131090807,56.8715920550092,58.43333333333334,58.43333333333334,58.43333333333334,19328,33381.63333333333,61.49687638038223,51.179279805056005,NaN,NaN,NaN,NaN,0.9483110109549381,27.56238478944487,-3224733,0.44893775264119473,0.294465240030128,-0.15447251261106673
2023-09-05T13:30:00-04:00,58.71,58.98,58.625,58.85,55.89127600087362,NaN,NaN,NaN,NaN,NaN,58.26320000000004,64.3746979374932,52.151702062506885,57.10987513216471,58.586387694034045,58.774802904511844,58.397972483556245,12754,32658.466666666667,62.2391323587773,53.37226107807498,NaN,NaN,NaN,NaN,0.9059316530295851,27.25172671002216,-3211979,0.41333978436557717,0.3622022178459048,-0.05113756651967241
2023-09-06T09:30:00-04:00,59.14,59.88,58.46,58.74,56.19746800083391,NaN,NaN,NaN,NaN,NaN,58.11400000000004,63.79203909813814,52.43596090186194,57.673900105731775,59.026666666666664,59.02666783467439,59.026665498658936,23762,32725.533333333333,60.97328306434292,55.317770904717115,NaN,NaN,NaN,NaN,0.9426508206703292,27.66400328977418,-3235741,0.36280598140233,0.4023699102332401,0.03956392883091009
2023-09-06T13:30:00-04:00,58.74,59.01,58.72,59,56.19746800083391,NaN,NaN,NaN,NaN,NaN,57.96560000000004,63.132384934558914,52.79881506544116,57.673900105731775,58.985166978480336,59.0410186227658,58.929315334194875,13119,32278,62.894271636349266,57.14863265353673,NaN,NaN,NaN,NaN,0.8960329049081628,28.04683154240105,-3222622,0.32834537945937975,0.4499956531551348,0.12165027369575504
2023-09-07T09:30:00-04:00,57.86,58.99,57.6,58.92,56.19746800083391,NaN,NaN,NaN,NaN,NaN,57.87920000000005,62.83027396834077,52.928126031659325,57.673900105731775,58.50333333333332,58.50333428700764,58.50333237965901,6554,31795.033333333333,61.88490530109137,58.7303115868661,NaN,NaN,NaN,NaN,0.9320305545575797,26.92303405956091,-3229176,0.2833192589883607,0.4757993474312059,0.1924800884428452
2023-09-07T13:30:00-04:00,59,59.23,58.86,59.17,56.19746800083391,NaN,NaN,NaN,NaN,NaN,57.79800000000004,62.52341723025457,53.0725827697455,57.673900105731775,58.87704024564097,59.15693101458365,58.59714947669829,11684,31300.433333333334,63.838006696692965,60.51477160897004,NaN,NaN,NaN,NaN,0.8918855149463238,26.096729103358594,-3217492,0.2544453069882796,0.5105367221781947,0.2560914151899151
2023-09-08T09:30:00-04:00,59.2,59.57,58.49,58.86,56.19746800083391,NaN,NaN,NaN,NaN,NaN,57.71100000000004,62.18831392689688,53.2336860731032,57.673900105731775,58.973333333333336,58.973333333333336,58.973333333333336,16208,30012.4,59.74946724285363,60.571518388392704,NaN,NaN,NaN,NaN,0.9053222638787292,24.880837097169074,-3233700,0.2008910174805627,0.5072051870406185,0.30631416956005575
2023-09-08T13:30:00-04:00,58.87,59,58.5,58.71,56.19746800083391,NaN,NaN,NaN,NaN,NaN,57.62980000000004,61.8786031067567,53.38099689324338,57.673900105731775,58.89211073739379,59.00447430332504,58.779747171462546,8469,28126.566666666666,57.81981167720207,60.487044807068024,NaN,NaN,NaN,NaN,0.8763706736016771,23.75179451999309,-3242169,0.1444279298568215,0.48684908188108267,0.34242115202426116
2023-09-11T09:30:00-04:00,59.35,59.67,58.79,59.31,56.41753560148675,NaN,NaN,NaN,NaN,NaN,57.56520000000004,61.60657053980276,53.52382946019732,57.673900105731775,59.25666666666667,59.25666734101625,59.25666599231709,30228,28189.666666666668,62.971260215044495,60.678752048675484,NaN,NaN,NaN,NaN,0.8823441969158431,23.369810860782568,-3211941,0.136635619677148,0.5132156766206961,0.3765800569435481
2023-09-11T13:30:00-04:00,59.38,59.74,59.38,59.47,56.81673852869189,NaN,NaN,NaN,NaN,NaN,57.52180000000005,61.43166995179904,53.61193004820106,57.89870443945356,59.369185643660714,59.503702062214856,59.23466922510657,21150,27977.6,64.22596678693024,60.97678670198934,NaN,NaN,NaN,NaN,0.8500338971361401,23.081631101141262,-3190791,0.131366503370007,0.5407881861560568,0.40942168278604985
2023-09-12T09:30:00-04:00,59.11,60.42,59.03,59.59,56.91688677738772,NaN,NaN,NaN,NaN,NaN,57.489600000000046,61.30310224334308,53.67609775665701,58.25196355156285,59.68000000000001,59.68000000000001,59.68000000000001,35591,28396.1,65.1789623880315,61.40180788662896,NaN,NaN,NaN,NaN,0.8886029044835587,23.42860826370894,-3155200,0.1251029744968009,0.565800400907051,0.44069742641025006
2023-09-12T13:30:00-04:00,59.63,59.63,58.9,58.93,56.91688677738772,NaN,NaN,NaN,NaN,NaN,57.43580000000004,61.087153918751845,53.78444608124824,58.25196355156285,59.48384420072646,59.73846474852631,59.229223652926606,21123,28278.866666666665,56.29617528650842,61.17096464137536,NaN,NaN,NaN,NaN,0.8772741255918762,23.554429681524418,-3176323,0.06848159886329436,0.526299424989368,0.45781782612607363
2023-09-13T09:30:00-04:00,58.69,58.96,57.81,58.61,56.91688677738772,NaN,NaN,NaN,NaN,NaN,57.39940000000004,60.965934250499025,53.83286574950106,58.25196355156285,58.459999999999994,58.46000116800772,58.459998831992266,23077,28286.7,52.556298392866864,60.74567907223661,NaN,NaN,NaN,NaN,0.8967545451924563,22.218158441446185,-3199400,0.004807008828937198,0.4638265871622451,0.4590195783333079
2023-09-13T13:30:00-04:00,58.57,58.63,58.07,58.12,56.91688677738772,NaN,NaN,NaN,NaN,NaN,57.34320000000003,60.771299041741415,53.91510095825865,58.25196355156285,58.38289679612721,58.474808133881744,58.29098545837268,16240,28101.1,47.36725374543121,59.963690798036005,NaN,NaN,NaN,NaN,0.8727006491072811,20.97733514708782,-3215640,-0.07081043111600988,0.3705065394382956,0.44131697055430547
2023-09-14T09:30:00-04:00,58.43,58.83,57.89,58.34,56.91688677738772,NaN,NaN,NaN,NaN,NaN,57.329200000000036,60.73511213039724,53.92328786960283,58.25196355156285,58.35333333333333,58.35333333333333,58.35333333333333,34871,28202.3,49.7654063492356,59.1257286529541,NaN,NaN,NaN,NaN,0.877507745599618,20.052316783664764,-3180769,-0.10447749425312736,0.3107201027378963,0.41519759699102365
2023-09-14T13:30:00-04:00,58.39,58.64,58.34,58.44,56.91688677738772,NaN,NaN,NaN,NaN,NaN,57.32760000000003,60.73134748769469,53.92385251230537,58.25196355156285,58.40424878792381,58.46355705914026,58.34494051670737,25700,28542.6,50.86139389682782,58.31303304852914,NaN,NaN,NaN,NaN,0.8362571923425023,19.193371160486212,-3155069,-0.11750598515420368,0.26831511554826903,0.3858211007024727
2023-09-15T09:30:00-04:00,58.24,58.47,57.28,57.35,56.91688677738772,NaN,NaN,NaN,NaN,NaN,57.308200000000035,60.70013794754339,53.91626205245668,58.25196355156285,57.699999999999996,57.700000674349575,57.69999932565042,24731,28248,40.491434224437974,56.85004384567879,NaN,NaN,NaN,NaN,0.8615245357466091,18.564169046980414,-3179800,-0.19259084382557085,0.14508254592050918,0.33767338974608
2023-09-15T13:30:00-04:00,57.28,57.76,57.26,57.73,56.91688677738772,NaN,NaN,NaN,NaN,NaN,57.29560000000003,60.67647837107296,53.9147216289271,58.25196355156285,57.612396877360865,57.66285534752669,57.56193840719504,74544,28712.366666666665,44.72276432881821,55.552079037998006,NaN,NaN,NaN,NaN,0.8357013546218514,18.00200126103423,-3105256,-0.2083844399181548,0.07719283984838654,0.28557727976654135
2023-09-18T09:30:00-04:00,57.48,57.54,56.75,57.28,NaN,NaN,NaN,59.820066706669486,59.820066706669486,59.820066706669486,57.28100000000004,60.65571124690433,53.90628875309575,58.25196355156285,57.19,57.19,57.19,26601,28279.2,41.00448206061105,54.060620235106555,NaN,NaN,NaN,NaN,0.8460084007202903,18.032218853616147,-3131857,-0.23868120556239125,-0.012774227186447717,0.22590697837594353
2023-09-18T13:30:00-04:00,57.24,57.35,56.74,56.74,NaN,NaN,NaN,59.68165458363906,NaN,NaN,57.25680000000004,60.62932769298966,53.88427230701042,58.25196355156285,57.03490772658972,57.154081888370065,56.91573356480938,45052,29213.633333333335,37.02625610875047,52.14549519311066,NaN,NaN,NaN,NaN,0.829150657811698,18.070910098104545,-3176909,-0.28167965738628986,-0.1261925933569188,0.15548706402937107
2023-09-19T09:30:00-04:00,56.505,56.73,55.53,56.15,NaN,NaN,NaN,58.81180664801909,NaN,NaN,57.21540000000004,60.59043590499179,53.84036409500828,57.53057084125028,56.13666666666666,56.13666666666666,56.13666666666666,36512,29502.033333333333,33.23254189503392,50.25142909683782,NaN,NaN,NaN,NaN,0.8563541822537196,19.22409639188538,-3213421,-0.33293410841262555,-0.2606805714864109,0.07225353692621467
2023-09-19T13:30:00-04:00,56.24,56.45,56.01,56.03,NaN,NaN,NaN,58.81180664801909,NaN,NaN,57.16700000000004,60.53923546034178,53.794764539658296,56.78047381657612,56.147806800725036,56.16095851753652,56.13465508391355,26197,29866.166666666668,32.50309538457877,48.4430922187933,NaN,NaN,NaN,NaN,0.8266145978070256,20.294912236110438,-3239618,-0.3559232906039733,-0.372650576328752,-0.016727285724778662
2023-09-20T09:30:00-04:00,56.3,56.63,55.95,56.26,NaN,NaN,NaN,58.81180664801909,NaN,NaN,57.13500000000003,60.51068778176921,53.75931221823086,56.78047381657612,56.28000000000001,56.28000000000001,56.28000000000001,13015,23676.8,35.42860372786372,46.4757596125661,NaN,NaN,NaN,NaN,0.8161421265350952,20.981709850369953,-3226603,-0.3368438154491725,-0.43778205503624434,-0.1009382395870718
2023-09-20T13:30:00-04:00,56.21,56.41,55.02,55.03,NaN,NaN,NaN,58.3802039225493,NaN,NaN,57.08960000000005,60.51587018198818,53.66332981801192,56.78047381657612,55.69021178727962,56.03669196404923,55.34373161051001,37712,23505.8,28.35150100083142,43.913297770701895,NaN,NaN,NaN,NaN,0.8571319746397308,22.37769996163891,-3264315,-0.38480275247196216,-0.5819416801770245,-0.19713892770506236
2023-09-21T09:30:00-04:00,53.9,54.19,53.51,53.89,NaN,NaN,NaN,56.60133101697887,NaN,NaN,57.03660000000004,60.57537404760221,53.497825952397875,56.78047381657612,53.86333333333332,53.86333333333332,53.86333333333332,59152,24702.4,23.638425183296718,40.94611654179227,NaN,NaN,NaN,NaN,0.904479690736893,24.563452354719665,-3323467,-0.465645347716622,-0.7791956123508399,-0.31355026463421787
2023-09-21T13:30:00-04:00,53.95,53.96,53.37,53.37,NaN,NaN,NaN,56.37172506166165,NaN,NaN,56.97780000000003,60.65779628260468,53.29780371739538,56.387379053260894,53.77774508742597,53.91215428272642,53.64333589212552,23985,24909.7,21.85383232020635,38.485949187056406,NaN,NaN,NaN,NaN,0.882016855684258,26.661858110338027,-3347452,-0.5222326289388703,-0.9663410508078059,-0.4441084218689355
2023-09-22T09:30:00-04:00,54.04,54.05,53.14,53.14,NaN,NaN,NaN,56.3027830134043,NaN,NaN,56.93480000000003,60.74076634772136,53.1288336522787,55.84390324260871,53.44333333333333,53.44333333333333,53.44333333333333,26794,25318.966666666667,21.095230192678628,36.238730029900104,NaN,NaN,NaN,NaN,0.8840156517068108,28.72540363219182,-3374246,-0.5409533541424002,-1.1203001145469358,-0.5793467604045356
2023-09-22T13:30:00-04:00,53.11,53.16,52.69,52.77,NaN,NaN,NaN,55.573792876431376,NaN,NaN,56.90040000000003,60.82342528158895,52.97737471841111,55.51712259408697,53.17663151623473,53.461043499988286,52.89221953248117,23561,25778.133333333335,19.89858028160738,34.27668192534126,NaN,NaN,NaN,NaN,0.8544431051563243,30.85939363463357,-3397807,-0.542660215097565,-1.2576720292764918,-0.7150118141789268
2023-09-25T09:30:00-04:00,52.25,53,52.14,52.69,NaN,NaN,NaN,55.215665927502684,NaN,NaN,56.86740000000003,60.90218834141066,52.83261165858941,55.42669807526958,52.60999999999999,52.60999999999999,52.60999999999999,27004,25987.733333333334,19.639174872575765,32.124808248436985,NaN,NaN,NaN,NaN,0.8548400262165867,33.08589192389097,-3424811,-0.5138696841772477,-1.3573489194004864,-0.8434792352232388
2023-09-25T13:30:00-04:00,52.71,52.76,52.4,52.76,NaN,NaN,NaN,55.15449929443437,NaN,NaN,56.832800000000034,60.97673830069688,52.68886169930319,54.74206941453802,52.626591635081674,52.64150695265231,52.61167631751104,33415,26604.433333333334,20.61437010073817,29.96430654871629,NaN,NaN,NaN,NaN,0.819494310058259,35.15335462105856,-3391396,-0.45672936353893456,-1.414390939646907,-0.9576615761079724
2023-09-26T09:30:00-04:00,52.34,53.04,52.25,52.25,NaN,NaN,NaN,55.15449929443437,NaN,NaN,56.78000000000004,61.08572641954634,52.47427358045373,54.74206941453802,52.51333333333333,52.51333333333333,52.51333333333333,12637,26381.4,18.822218252011695,28.4165054078287,NaN,NaN,NaN,NaN,0.8173875736255262,36.53351832446245,-3404033,-0.42078860036774124,-1.4836473265676489,-1.0628587261999076
2023-09-26T13:30:00-04:00,52.25,52.25,52.01,52.17,NaN,NaN,NaN,54.611330968689174,NaN,NaN,56.71960000000004,61.19426282081466,52.24493717918543,54.74206941453802,52.29934567901235,52.48206052760647,52.116630830418224,17333,26534.033333333333,18.549792421207854,26.54700741442796,NaN,NaN,NaN,NaN,0.7761456040808458,37.949275054646506,-3421366,-0.37161872552936615,-1.5273821331116153,-1.1557634075822492
2023-09-27T09:30:00-04:00,52.72,53,52,52,NaN,NaN,NaN,54.611330968689174,NaN,NaN,56.660000000000046,61.30201163289996,52.01798836710013,54.204655531630415,52.33333333333334,52.33333333333334,52.33333333333334,89590,28728.3,17.955078101893818,24.900621417376726,NaN,NaN,NaN,NaN,0.7921352037893568,37.90213831334459,-3510956,-0.32163126137425024,-1.557802484300062,-1.2361712229258117
2023-09-27T13:30:00-04:00,52.01,53.02,51.86,52.56,NaN,NaN,NaN,54.611330968689174,NaN,NaN,56.61220000000005,61.37140210119055,51.852997898809555,51.743463632194775,52.3613663175635,52.41903481978714,52.30369781533986,21170,28996.666666666668,26.333516302111732,24.1368542883311,NaN,NaN,NaN,NaN,0.8184112606615458,37.96553758060729,-3489786,-0.22643181625523434,-1.5192109932448545,-1.2927791769896202
2023-09-28T09:30:00-04:00,52.5,53.98,52.18,53.53,NaN,NaN,NaN,54.611330968689174,NaN,NaN,56.556800000000045,61.3931133728058,51.72048662719429,51.743463632194775,53.23,53.23,53.23,38077,30047.433333333334,38.121044157872156,24.48603302139097,NaN,NaN,NaN,NaN,0.8885247420428638,36.535884977794716,-3451709,-0.08120356351550306,-1.394283631383999,-1.313080067868496
2023-09-28T13:30:00-04:00,53.57,53.68,53.21,53.47,NaN,NaN,NaN,54.611330968689174,NaN,NaN,56.499600000000044,61.41233766447803,51.586862335522056,51.743463632194775,53.30910716506676,53.415921599019015,53.20229273111451,20885,30354.133333333335,37.718996880365175,24.858597413947138,NaN,NaN,NaN,NaN,0.8586301176112306,35.20835041804018,-3472594,0.022221557249757495,-1.285303121306299,-1.3075246785560566
2023-09-29T09:30:00-04:00,54.46,54.82,53.92,54.15,51.68391509317033,51.68391509317033,51.68391509317033,NaN,NaN,NaN,56.48820000000004,61.420011334589326,51.55638866541076,52.34727713245105,54.296666666666674,54.296666666666674,54.296666666666674,24725,30638.033333333333,44.82169039859134,25.52953217614197,NaN,NaN,NaN,NaN,0.8937279663532857,32.85497049707162,-3447869,0.14119799282337908,-1.1310271875268327,-1.2722251803502118
2023-09-29T13:30:00-04:00,54.16,54.42,53.95,54.18,51.68391509317033,NaN,NaN,NaN,NaN,NaN,56.483800000000045,61.423441914145414,51.544158085854676,52.34727713245105,54.23471058469776,54.29112984733625,54.178291322059266,29816,31349.6,45.11905283048606,26.727214449688734,NaN,NaN,NaN,NaN,0.8634616830423366,30.669689141886515,-3418053,0.22188144961929757,-0.9948733683260897,-1.2167548179453873
2023-10-02T09:30:00-04:00,54.44,54.91,53.68,53.93,51.68391509317033,NaN,NaN,NaN,NaN,NaN,56.46960000000004,61.43437989038644,51.50482010961365,52.52445736476867,54.17333333333334,54.17333333333334,54.17333333333334,16034,30876.466666666667,43.03758803639235,28.11286893919556,NaN,NaN,NaN,NaN,0.8896429913964552,29.189914005740476,-3434087,0.2559593904726636,-0.8968055798545578,-1.1527649703272214
2023-10-02T13:30:00-04:00,53.99,54.16,53.65,53.98,51.68391509317033,NaN,NaN,NaN,NaN,NaN,56.44860000000004,61.44633230175297,51.450867698247116,52.52445736476867,54.01953773187989,54.13688554535941,53.902189918400374,27541,31089.5,43.59801390262604,29.666024766511253,NaN,NaN,NaN,NaN,0.8625256348681368,27.77529546802329,-3406546,0.2776013907806165,-0.8057632318514507,-1.0833646226320672
2023-10-03T09:30:00-04:00,53.26,53.92,52.59,52.75,51.68391509317033,NaN,NaN,NaN,NaN,NaN,56.39740000000004,61.49225043548713,51.30254956451295,52.52445736476867,53.08666666666666,53.086667620340975,53.08666571299234,22160,30641.8,34.583891486455556,30.629500573209608,NaN,NaN,NaN,NaN,0.9002023752346979,26.403708848694297,-3428706,0.20799495565186632,-0.8233709280672343,-1.0313658837191007
2023-10-03T13:30:00-04:00,52.68,52.68,52.15,52.42,51.68391509317033,NaN,NaN,NaN,NaN,NaN,56.34260000000005,61.54726838136529,51.1379316186348,52.52445736476867,52.750852315356674,53.085851325553264,52.415853305160084,22268,30679.966666666667,32.63438073778842,31.53920060579397,NaN,NaN,NaN,NaN,0.8787593484322196,25.576598599318878,-3450974,0.1418064881748904,-0.8541077735004876,-0.995914261675378
2023-10-04T09:30:00-04:00,52.82,53.12,52.15,52.92,51.68391509317033,NaN,NaN,NaN,NaN,NaN,56.236600000000045,61.499564351008345,50.973635648991745,52.52445736476867,52.73,52.73,52.73,26663,30799.5,38.308732025994956,32.87274040246676,NaN,NaN,NaN,NaN,0.885276537829918,24.246076485048995,-3424311,0.13387550073901822,-0.8285698857516053,-0.9624453864906235
2023-10-04T13:30:00-04:00,52.91,53.55,52.79,53.4,51.68391509317033,NaN,NaN,NaN,NaN,NaN,56.14000000000004,61.430300558568035,50.84969944143205,52.52445736476867,52.935220579369386,53.18803503005809,52.68240612868068,17569,30843.8,43.250641494687144,34.489616930605976,NaN,NaN,NaN,NaN,0.8763282136992094,22.532108798531464,-3406742,0.1612934460019192,-0.7608285789882245,-0.9221220249901437
2023-10-05T09:30:00-04:00,53.26,53.5,52.52,52.86,51.68391509317033,NaN,NaN,NaN,NaN,NaN,56.02740000000004,61.35238234363126,50.70241765636882,52.52445736476867,52.96,52.96,52.96,14484,30164.233333333334,39.4243918908105,35.961200761948746,NaN,NaN,NaN,NaN,0.8837333412921229,21.216558046299568,-3421226,0.14396848597734124,-0.7421614175184672,-0.8861299034958084
2023-10-05T13:30:00-04:00,52.93,53.47,52.89,53.19,51.68391509317033,NaN,NaN,NaN,NaN,NaN,55.92200000000005,61.2588215259631,50.585178474036994,52.52445736476867,53.055401357853796,53.16587707543433,52.94492564027326,10801,29667.6,42.757172206159105,37.69029931801669,NaN,NaN,NaN,NaN,0.864180959771257,19.99497520494138,-3410425,0.15470097698530627,-0.6927536822641756,-0.8474546592494818
2023-10-06T09:30:00-04:00,52.53,54.78,52.53,54.73,51.68391509317033,NaN,NaN,NaN,NaN,NaN,55.84940000000004,61.15022470564603,50.548575294354045,52.52445736476867,54.01333333333333,54.01333333333333,54.01333333333333,35537,30027.8,55.156538680894755,40.34754650223105,NaN,NaN,NaN,NaN,0.9631680340733101,19.73633558360147,-3374888,0.2593234982241108,-0.5233002864693432,-0.7826237846934541
2023-10-06T13:30:00-04:00,54.77,54.98,54.63,54.79,52.07401925001189,NaN,NaN,NaN,NaN,NaN,55.777000000000044,61.034663739721886,50.5193362602782,52.55698792265212,54.31214970449998,54.693958105367805,53.930341303632154,21767,28268.566666666666,55.56042904008686,42.435183126372124,NaN,NaN,NaN,NaN,0.9193703173537875,19.68337854711614,-3353121,0.32226879285725385,-0.37978779362188675,-0.7020565864791406
2023-10-09T09:30:00-04:00,53.72,54.51,53.72,54.42,52.07401925001189,NaN,NaN,NaN,NaN,NaN,55.699400000000054,60.92022508421617,50.47857491578394,52.55698792265212,54.21666666666666,54.21666666666666,54.21666666666666,18187,27988.1,52.42472082874391,43.456874317148674,NaN,NaN,NaN,NaN,0.9301295803999456,18.502678695878384,-3371308,0.3276158017103932,-0.2925368343411492,-0.6201526360515424
2023-10-09T13:30:00-04:00,54.63,55,54.63,54.76,52.10827993647777,NaN,NaN,NaN,NaN,NaN,55.62900000000004,60.80345919879437,50.45454080120571,52.73127227049736,54.39628482502088,54.66445613040935,54.12811351963241,8159,26758.333333333332,54.94129993812175,44.68703882127414,NaN,NaN,NaN,NaN,0.9051203246570922,17.9020653762929,-3363149,0.3411448604898334,-0.1937215604392506,-0.534866420929084
2023-10-10T09:30:00-04:00,54.9,56.53,54.9,55.84,52.88994903027424,NaN,NaN,NaN,NaN,NaN,55.57100000000005,60.66912396867598,50.47287603132411,53.830017816397884,55.75666666666667,55.75666666666667,55.75666666666667,19802,26201.333333333332,61.8453810385095,45.90301672412544,NaN,NaN,NaN,NaN,0.966897444324443,18.591397683882825,-3343347,0.4055405871150124,-0.02794068703531849,-0.4334812741503309
2023-10-10T13:30:00-04:00,55.89,55.99,55.74,55.83,53.13426952889814,NaN,NaN,NaN,NaN,NaN,55.51060000000004,60.52273473082976,50.49846526917032,53.830017816397884,55.78208102239593,55.824634889166546,55.73952715562531,7063,25563.533333333333,61.75103310729075,47.09101531532578,NaN,NaN,NaN,NaN,0.9156904840155543,19.231491969502038,-3350410,0.4279572627044782,0.1014653042302669,-0.3264919584742113
2023-10-11T09:30:00-04:00,55.95,56.42,54.87,55.03,53.13426952889814,NaN,NaN,NaN,NaN,NaN,55.43640000000005,60.364242140327455,50.50855785967264,53.830017816397884,55.44,55.44,55.44,36444,26344.5,54.577787390289366,47.915315269175565,NaN,NaN,NaN,NaN,0.9609983065858722,18.79156205056921,-3386854,0.37149580761341977,0.13787780104256342,-0.23361800657085635
2023-10-11T13:30:00-04:00,54.91,55.32,54.88,55.27,53.13426952889814,NaN,NaN,NaN,NaN,NaN,55.361800000000045,60.18338096893395,50.54021903106614,53.830017816397884,55.40493672509277,55.49823817904465,55.31163527114089,5147,25259,56.22081583472456,48.81694397861117,NaN,NaN,NaN,NaN,0.9237841418297383,18.383055697274433,-3381707,0.3340785273880831,0.1839801526642475,-0.15009837472383558
2023-10-12T09:30:00-04:00,55.29,55.33,54,54.03,53.13426952889814,NaN,NaN,NaN,NaN,NaN,55.26400000000004,59.99035335115668,50.5376466488434,53.830017816397884,54.45333333333333,54.45333428700765,54.45333237965902,26491,24170.3,46.80127726388111,49.68961439128443,NaN,NaN,NaN,NaN,0.9527995602704712,17.085418109871767,-3408198,0.2153476676889424,0.11908620988734242,-0.09626145780159998
2023-10-12T13:30:00-04:00,54.02,54.11,53.59,53.92,53.13426952889814,NaN,NaN,NaN,NaN,NaN,55.15900000000005,59.76532999251959,50.55267000748051,53.830017816397884,54.224167446816615,54.50771499245259,53.94061990118064,17304,23947.6,46.0639682942288,50.64887064531588,NaN,NaN,NaN,NaN,0.9218853059654373,16.277348008526754,-3425502,0.1234982387592457,0.058111340647457155,-0.06538689811178855
2023-10-13T09:30:00-04:00,53.9,53.92,52.53,52.55,NaN,NaN,NaN,56.03916536876471,56.03916536876471,56.03916536876471,55.03280000000005,59.5718889658591,50.493711034141,53.830017816397884,53,53,53,14850,23549.466666666667,38.02846363718516,50.62885147468661,NaN,NaN,NaN,NaN,0.9553220698250489,16.430411572585076,-3440352,-0.027379265183049825,-0.09961097959060083,-0.07223171440755101
2023-10-13T13:30:00-04:00,52.53,52.87,52.48,52.65,NaN,NaN,NaN,55.414430579275404,NaN,NaN,54.91160000000004,59.37445175196164,50.44874824803845,53.830017816397884,52.82043157720344,52.986598127586866,52.65426502682002,17342,23342.166666666668,38.86675191972963,50.31571650504679,NaN,NaN,NaN,NaN,0.9149419219804026,16.612004936544462,-3423010,-0.11347080621391065,-0.21407022217493932,-0.10059941596102867
2023-10-16T09:30:00-04:00,53.44,54.15,52.95,53.85,NaN,NaN,NaN,55.414430579275404,NaN,NaN,54.80240000000004,59.09330118273402,50.511498817266066,53.830017816397884,53.65,53.65,53.65,41042,23810.1,47.963303386103725,50.92563875471059,NaN,NaN,NaN,NaN,0.9567317846960881,15.44361501196133,-3381968,-0.08398464684461789,-0.20558022451680102,-0.12159557767218314
2023-10-16T13:30:00-04:00,53.98,54.28,53.98,54.04,NaN,NaN,NaN,55.414430579275404,NaN,NaN,54.69380000000004,58.77647537773787,50.61112462226221,53.830017816397884,53.71391211639769,53.87099710535687,53.5568271274385,6794,22922.733333333334,49.25091407311529,51.38947745949317,NaN,NaN,NaN,NaN,0.9191080857892248,14.443461359109829,-3375174,-0.0478667596316924,-0.18142902721179865,-0.13356226758010625
2023-10-17T09:30:00-04:00,53.45,55.3,53.39,55.12,NaN,NaN,NaN,55.414430579275404,NaN,NaN,54.60440000000004,58.44275623151225,50.76604376848783,53.81701140249465,54.60333333333333,54.60333333333333,54.60333333333333,12979,22934.133333333335,55.926738173795705,51.44449170898611,NaN,NaN,NaN,NaN,0.9898860796614227,14.39520207183153,-3362195,0.047421225611392434,-0.07428573556586571,-0.12170696117725814
2023-10-17T13:30:00-04:00,54.97,54.98,54.67,54.91,NaN,NaN,NaN,55.414430579275404,NaN,NaN,54.52400000000004,58.15961934200837,50.88838065799172,53.81701140249465,54.73500249200735,54.85982445450644,54.610180529508256,14442,22837.766666666666,54.427484417858004,51.363567093112614,NaN,NaN,NaN,NaN,0.9513227882570351,14.350389876501682,-3376637,0.09236785945183626,-0.00624713686246281,-0.09861499631429907
2023-10-18T09:30:00-04:00,54.35,54.72,53.11,53.45,NaN,NaN,NaN,55.414430579275404,NaN,NaN,54.420800000000035,57.8750399221812,50.96656007781887,53.01760912199572,53.76,53.76,53.76,32413,20931.866666666665,45.32933182088513,50.85675359255127,NaN,NaN,NaN,NaN,1.011942589095818,13.81735545480926,-3409050,0.02342272788257775,-0.06933658646107688,-0.09275931434365463
2023-10-18T13:30:00-04:00,53.25,53.33,52.86,52.89,NaN,NaN,NaN,55.414430579275404,NaN,NaN,54.31620000000004,57.62992150911769,51.00247849088238,52.82308729759657,53.432449368637286,53.79702361378805,53.06787512348652,26164,21098.333333333332,42.401563671999526,49.96105814497111,NaN,NaN,NaN,NaN,0.9818038327318312,13.52446401875532,-3435214,-0.055910825770915246,-0.1626478465572987,-0.10673702078638345
2023-10-19T09:30:00-04:00,53.19,53.59,52.67,53.17,NaN,NaN,NaN,55.414430579275404,NaN,NaN,54.212800000000044,57.33494808104743,51.09065191895266,52.56789526123293,53.14333333333334,53.14333333333334,53.14333333333334,33386,20941.966666666667,44.33742974394069,48.71049019535906,NaN,NaN,NaN,NaN,0.9773892732509862,12.99459249818495,-3401828,-0.08386257546626413,-0.21156524011921363,-0.1277026646529495
2023-10-19T13:30:00-04:00,53.06,53.08,52.24,52.45,NaN,NaN,NaN,55.414430579275404,NaN,NaN,54.093000000000046,57.01009787288412,51.175902127115975,52.56789526123293,52.95072769403005,53.21431484872941,52.68714053933069,17826,20840,40.56218505284673,47.19700104861306,NaN,NaN,NaN,NaN,0.97400432516163,12.873898050832311,-3419654,-0.14177045300902003,-0.3049157309142245,-0.1631452779052045
2023-10-20T09:30:00-04:00,52.4,52.75,51.66,52.47,NaN,NaN,NaN,55.094033392650054,NaN,NaN,53.995400000000046,56.79422892653104,51.19657107346905,52.56789526123293,52.29333333333333,52.29333333333333,52.29333333333333,12414,20429.633333333335,40.713198213699016,46.20667325028518,NaN,NaN,NaN,NaN,0.9822897305072281,13.233422112815116,-3407240,-0.16787042974618505,-0.3729833150879358,-0.20511288534175076
2023-10-20T13:30:00-04:00,52.49,52.63,51.87,52.02,NaN,NaN,NaN,55.094033392650054,NaN,NaN,53.88120000000004,56.522728769479244,51.23967123052084,52.56789526123293,52.237735218249675,52.29757352880417,52.17789690769518,10717,19793,38.35212939489786,44.93033850458327,NaN,NaN,NaN,NaN,0.966411892613855,13.56726588465629,-3417957,-0.20227731789932263,-0.45795953271590406,-0.25568221481658143
2023-10-23T09:30:00-04:00,51.59,53.07,51.02,52.69,NaN,NaN,NaN,55.055834144955945,NaN,NaN,53.78940000000004,56.265956997120625,51.31284300287946,52.56789526123293,52.26,52.26,52.26,20969,19957.5,43.59686546893442,44.70145194780137,NaN,NaN,NaN,NaN,1.0438110431414365,14.535827512213448,-3396988,-0.16815033686493674,-0.4658701358977524,-0.29771979903281565
2023-10-23T13:30:00-04:00,52.76,52.92,52.27,52.3,NaN,NaN,NaN,55.055834144955945,NaN,NaN,53.70060000000003,56.06338957167007,51.33781042832999,52.56789526123293,52.40640524302334,52.52136065030938,52.2914498357373,34012,20173.2,41.389519389388404,44.367562740312756,NaN,NaN,NaN,NaN,1.015681682917048,15.435206166373666,-3431000,-0.1601201220991727,-0.4978699516567815,-0.3377498295576088
2023-10-24T09:30:00-04:00,53.69,55.13,53.62,53.96,51.16114078940998,51.16114078940998,51.16114078940998,NaN,NaN,NaN,53.65680000000004,55.915232872588525,51.398367127411554,52.56789526123293,54.23666666666668,54.23666666666668,54.23666666666668,41569,20820.166666666668,52.429762733230476,45.39622696145886,NaN,NaN,NaN,NaN,1.1452758484229737,14.69226528410841,-3389431,-0.03767665500607231,-0.3848456483151992,-0.34716899330912687
2023-10-24T13:30:00-04:00,53.9,54.13,53.71,54.08,51.16114078940998,NaN,NaN,NaN,NaN,NaN,53.61780000000003,55.77608557887737,51.45951442112269,51.89031620898634,54.18622577048246,54.28985243365568,54.082599107309235,9849,20406.2,53.11726501486748,46.4141207539687,NaN,NaN,NaN,NaN,1.0934704306784757,14.002391607719247,-3379582,0.0518668036582664,-0.2823354887362939,-0.3342022923945603
2023-10-25T09:30:00-04:00,53.72,53.72,52.29,52.41,51.16114078940998,NaN,NaN,NaN,NaN,NaN,53.54080000000003,55.58840480561847,51.4931951943816,51.57164241426465,52.80666666666666,52.806667620340974,52.80666571299234,23546,20302.3,43.66041333622339,46.10677146469153,NaN,NaN,NaN,NaN,1.1432225427728702,13.832666806261887,-3403128,0.001743325181072064,-0.3320231359182202,-0.33376646109929226
2023-10-25T13:30:00-04:00,52.29,52.29,51.76,51.89,51.16114078940998,NaN,NaN,NaN,NaN,NaN,53.47800000000004,55.53165625166176,51.424343748338316,51.57164241426465,52.428691669932306,52.84050987312064,52.016873466743974,19835,20377.833333333332,41.20068649353321,45.5317552090071,NaN,NaN,NaN,NaN,1.1079923611462366,14.053401028439588,-3422963,-0.05990678813173711,-0.40864994626396367,-0.34874315813222656
2023-10-26T09:30:00-04:00,51.75,52.2,50.21,50.38,NaN,NaN,NaN,54.50135745993596,54.50135745993596,54.50135745993596,53.40780000000004,55.63311360486305,51.182486395137026,51.57164241426465,50.93,50.93,50.93,65478,22077.633333333335,35.029227053364764,44.03907584326203,NaN,NaN,NaN,NaN,1.1709929067786484,15.20064759911948,-3488441,-0.18859271953108675,-0.584484057546085,-0.39589133801499826
2023-10-26T13:30:00-04:00,50.27,51.32,50.24,50.77,NaN,NaN,NaN,54.0737957572116,NaN,NaN,53.35580000000004,55.70052374491979,51.01107625508028,51.57164241426465,50.90260537792217,50.961342447987676,50.84386830785667,14243,22192.366666666665,37.62786846992865,42.8391032755528,NaN,NaN,NaN,NaN,1.1644934134373162,16.26594798617938,-3474198,-0.23086607163033912,-0.6844739275529221,-0.453607855922583
2023-10-27T09:30:00-04:00,51.36,51.42,50.25,50.34,NaN,NaN,NaN,54.0737957572116,NaN,NaN,53.29980000000003,55.791599317760834,50.80800068223923,51.57164241426465,50.669999999999995,50.669999999999995,50.669999999999995,25789,21867.433333333334,35.92188067364425,42.1671424793213,NaN,NaN,NaN,NaN,1.1648867410489367,17.14602818290118,-3499987,-0.268565947997531,-0.7893152909194967,-0.5207493429219657
2023-10-27T13:30:00-04:00,50.33,50.42,49.94,50.06,NaN,NaN,NaN,53.3989130763023,NaN,NaN,53.24560000000003,55.894101946382655,50.59709805361741,51.57164241426465,50.456195202072784,50.71620299288679,50.19618741125878,17438,21723.133333333335,34.814984791470124,41.625243987854915,NaN,NaN,NaN,NaN,1.1159662595454416,18.1556569244669,-3517425,-0.2912382028701139,-0.8847970965096081,-0.5935588936394942
2023-10-30T09:30:00-04:00,50.71,51.14,50.16,50.42,NaN,NaN,NaN,53.3989130763023,NaN,NaN,53.20020000000003,55.96069702770929,50.439702972290775,51.57164241426465,50.57333333333333,50.57333333333333,50.57333333333333,33905,22247.066666666666,37.48233245405252,41.135594181434335,NaN,NaN,NaN,NaN,1.1133972410064814,18.28471604906807,-3483520,-0.2617958230396613,-0.9208036724390709,-0.6590078493994096
2023-10-30T13:30:00-04:00,50.35,50.93,50.35,50.71,NaN,NaN,NaN,53.3989130763023,NaN,NaN,53.159200000000034,56.00423171159646,50.31416828840361,51.57164241426465,50.582300590417006,50.609256877952994,50.55534430288102,3752,22100.166666666668,39.62554507260808,41.06869132570301,NaN,NaN,NaN,NaN,1.075297438077447,18.40455666476916,-3479768,-0.20510296883821777,-0.9153865604471818,-0.710283591608964
2023-10-31T09:30:00-04:00,50.84,51.58,50.4,51.39,NaN,NaN,NaN,53.3989130763023,NaN,NaN,53.14200000000003,56.01902902314056,50.2649709768595,51.07331393141172,51.123333333333335,51.123333333333335,51.123333333333335,40855,22801.933333333334,44.435647729065934,41.33458057680065,NaN,NaN,NaN,NaN,1.0827761925004864,17.80639639634513,-3438913,-0.10894561828525795,-0.8464656144655365,-0.7375199961802785
2023-10-31T13:30:00-04:00,51.42,51.94,51.35,51.77,NaN,NaN,NaN,53.3989130763023,NaN,NaN,53.134000000000036,56.023991003444465,50.24400899655561,50.37965114512937,51.281009077289156,51.533916890920885,51.028101263657426,15880,23095.833333333332,46.977893129478055,41.95070655784209,NaN,NaN,NaN,NaN,1.0475778930361657,16.881113998170242,-3423033,-0.011990403225777824,-0.7525080002125009,-0.740517596986723
2023-11-01T09:30:00-04:00,51.8,51.92,51.28,51.43,NaN,NaN,NaN,53.3989130763023,NaN,NaN,53.12260000000003,56.034805514725036,50.21039448527502,49.70227106397749,51.54333333333333,51.54333333333333,51.54333333333333,9807,22207.933333333334,44.99427321750562,42.050521397025754,NaN,NaN,NaN,NaN,1.0184651863907253,16.088240979613456,-3432840,0.03446095587051112,-0.6974414021485842,-0.7319023580190953
2023-11-01T13:30:00-04:00,51.38,52.06,51.03,51.99,NaN,NaN,NaN,53.3989130763023,NaN,NaN,53.11120000000003,56.03655848059545,50.18584151940461,49.770816851182,51.60209410986375,51.67531492399321,51.528873295734286,6316,22246.9,48.82693213064147,42.58176516425811,NaN,NaN,NaN,NaN,1.0192891016485306,15.59544458921689,-3426524,0.10417977341702189,-0.601677641247818,-0.7058574146648399
2023-11-02T09:30:00-04:00,54.46,55.62,54.46,55.46,51.62950211053149,51.62950211053149,51.62950211053149,NaN,NaN,NaN,53.149800000000035,56.14631127813498,50.15328872186509,51.97365348094559,55.18,55.18,55.18,68539,23648.5,65.06869602441087,43.48454611362814,NaN,NaN,NaN,NaN,1.205768451530778,16.607890470662667,-3357985,0.37029936246627715,-0.24298321158199343,-0.6132825740482706
2023-11-02T13:30:00-04:00,55.54,55.79,55.43,55.68,52.30543383278006,NaN,NaN,NaN,NaN,NaN,53.19400000000003,56.27218388014648,50.115816119853584,52.692922784756476,55.25662823357298,55.42652892919449,55.086727537951475,13942,23536.433333333334,65.80961984554644,44.391142887248066,NaN,NaN,NaN,NaN,1.1453564192785797,17.638406557037197,-3344043,0.5373173270201566,0.058364084726925114,-0.47895324229323144
2023-11-03T09:30:00-04:00,56.79,58.57,56.79,58.22,54.1315504767446,NaN,NaN,NaN,NaN,NaN,53.27540000000003,56.6512630540932,49.89953694590687,54.64733822780518,57.85999999999999,57.86000067434957,57.85999932565041,54725,24865.6,72.94480370125441,46.48288505617886,NaN,NaN,NaN,NaN,1.2699738179015385,19.781911378502457,-3289318,0.7802972807524113,0.4964183586472828,-0.28387892210512855
2023-11-03T13:30:00-04:00,58.3,58.43,58,58.15,54.769207273256214,NaN,NaN,NaN,NaN,NaN,53.35480000000003,56.988903443765835,49.72069655623423,55.07687058224415,57.966740037762094,58.122260380244306,57.81121969527988,25779,25146.833333333332,72.49578646643096,48.71824933995726,NaN,NaN,NaN,NaN,1.2099756880514287,21.772308712720196,-3315097,0.8898087690885552,0.8283820392555654,-0.061426729832989746
2023-11-06T09:30:00-05:00,58.5,58.65,56.74,56.85,54.769207273256214,NaN,NaN,NaN,NaN,NaN,53.413200000000025,57.17403914040408,49.652360859595966,55.07687058224415,57.41333333333333,57.413334501341055,57.4133321653256,11602,24165.5,64.5490550384993,50.82680848175259,NaN,NaN,NaN,NaN,1.2599774246191835,22.435259153372073,-3326699,0.8294002551802593,0.9753235891423344,0.1459233339620751
2023-11-06T13:30:00-05:00,56.89,57.55,56.89,57.54,54.769207273256214,NaN,NaN,NaN,NaN,NaN,53.48440000000002,57.416367771993656,49.55243222800639,55.07687058224415,57.3711699271193,57.41448746454049,57.3278523896981,10992,24305.433333333334,66.63931884734484,52.89905493728232,NaN,NaN,NaN,NaN,1.2199790371463843,23.05085599112024,-3315707,0.790762669927209,1.1343766713710863,0.3436140014438773
2023-11-07T09:30:00-05:00,57.78,58.68,57.4,58.35,54.769207273256214,NaN,NaN,NaN,NaN,NaN,53.59640000000003,57.75103261432261,49.44176738567745,55.431997738109004,58.14333333333334,58.14333333333334,58.14333333333334,27044,24774.266666666666,68.95354558277029,55.258459573648466,NaN,NaN,NaN,NaN,1.2242662487787856,24.137911372439532,-3288663,0.7736519386253556,1.310678924725572,0.5370269861002163
2023-11-07T13:30:00-05:00,58.36,58.97,58.34,58.87,55.22825564643015,NaN,NaN,NaN,NaN,NaN,53.72540000000003,58.11955103973397,49.33124896026609,56.05659819048721,58.37698991466254,58.662829510315284,58.09115031900979,18071,24895.233333333334,70.37437370824927,57.79841592484697,NaN,NaN,NaN,NaN,1.1818186595803009,25.271278606334164,-3270592,0.7506603633756807,1.475352440319817,0.7246920769441364
2023-11-08T09:30:00-05:00,58.9,58.94,57.78,58.35,55.22825564643015,NaN,NaN,NaN,NaN,NaN,53.834000000000024,58.407887624329604,49.260112375670445,56.05659819048721,58.35666666666666,58.35666666666666,58.35666666666666,20877,24510.7,67.06888770241372,59.91174129972991,NaN,NaN,NaN,NaN,1.1802601838959934,25.771332870428953,-3291469,0.6571067682552731,1.5460755372632278,0.8889687690079546
2023-11-08T13:30:00-05:00,58.49,58.65,58.44,58.58,55.23079698362747,NaN,NaN,NaN,NaN,NaN,53.93760000000003,58.69831517316404,49.17688482683602,56.17142284191181,58.44221884165227,58.54116963929063,58.34326804401391,15606,24158.766666666666,67.78954179701256,61.923455351473095,NaN,NaN,NaN,NaN,1.1173844564748507,26.235668972802685,-3275863,0.5705960687589409,1.6022138549566307,1.0316177861976898
2023-11-09T09:30:00-05:00,59.5,60.04,58.46,58.61,55.87098802982622,NaN,NaN,NaN,NaN,NaN,54.05260000000002,58.9785635565034,49.126636443496636,57.267138273529454,59.03666666666667,59.03666666666667,59.03666666666667,34971,24211.6,67.888252104846,63.59864137831453,NaN,NaN,NaN,NaN,1.1504284238695042,27.33051589471675,-3240892,0.4789707169920199,1.6303311824377147,1.1513604654456948
2023-11-09T13:30:00-05:00,58.53,58.58,57.73,57.91,55.87098802982622,NaN,NaN,NaN,NaN,NaN,54.14700000000002,59.1829019053194,49.11109809468064,57.267138273529454,58.34790182319046,58.782773209854945,57.91303043652598,87726,26541.6,63.03421158568188,64.74552126804338,NaN,NaN,NaN,NaN,1.1311121078788255,27.6190788538012,-3328618,0.34126418687577886,1.5779406990404183,1.2366765121646395
2023-11-10T09:30:00-05:00,57.55,58.81,57.41,58.77,55.87098802982622,NaN,NaN,NaN,NaN,NaN,54.227800000000016,59.42556612017139,49.03003387982864,57.267138273529454,58.33000000000001,58.33000000000001,58.33000000000001,23053,26896.233333333334,66.22897099903673,66.2622853952956,NaN,NaN,NaN,NaN,1.150318385887481,27.57855478420333,-3305565,0.28067141621191594,1.5875157824295343,1.3068443662176183
2023-11-10T13:30:00-05:00,58.79,59.06,58.72,58.91,55.87098802982622,NaN,NaN,NaN,NaN,NaN,54.310200000000016,59.669133461053896,48.951266538946136,57.267138273529454,58.50607415159218,58.76832068771621,58.24382761546815,10392,26885.4,66.73301207899411,67.54129110589221,NaN,NaN,NaN,NaN,1.0924385011812325,27.68116270836125,-3295173,0.22500000431377853,1.5880943716098415,1.363094367296063
2023-11-13T09:30:00-05:00,58.42,59.24,57.88,59.04,55.87098802982622,NaN,NaN,NaN,NaN,NaN,54.40260000000002,59.92281131479594,48.8823886852041,57.267138273529454,58.72,58.72,58.72,9634,26507.566666666666,67.22222854096034,67.69511485707432,NaN,NaN,NaN,NaN,1.1115500368111444,26.95862934658173,-3285539,0.17418059499095273,1.580820111034754,1.4066395160438012
2023-11-13T13:30:00-05:00,59,59.3,58.99,59.14,55.94002455619673,NaN,NaN,NaN,NaN,NaN,54.49020000000002,60.167105480981874,48.81329451901817,57.267138273529454,58.88014326277749,59.08544332763369,58.674843197921284,5862,25569.233333333334,67.616730897548,67.82419421793158,NaN,NaN,NaN,NaN,1.0542964627532052,26.327628506059575,-3279677,0.12675484157159822,1.565083068008299,1.4383282264367008
2023-11-14T09:30:00-05:00,60.75,61.5,60.54,60.97,57.63888707636961,NaN,NaN,NaN,NaN,NaN,54.592800000000025,60.542456850609035,48.643143149391015,58.5159717355761,61.00333333333332,61.00333450134105,61.003332165325595,19694,24840.066666666666,73.82525546276274,67.88708362946788,NaN,NaN,NaN,NaN,1.147561001127976,26.976785593072925,-3259983,0.19405796076882353,1.6809006773977302,1.4868427166289067
2023-11-14T13:30:00-05:00,60.77,60.97,60.4,60.85,57.63888707636961,NaN,NaN,NaN,NaN,NaN,54.693200000000026,60.88737847983069,48.499021520169364,58.5159717355761,60.89441675351099,61.024103085327624,60.76473042169435,13891,24974.8,72.83909609972068,67.91160574613143,NaN,NaN,NaN,NaN,1.106306643904549,27.441579448676016,-3273874,0.20485603214213488,1.7429127568065752,1.5380567246644403
2023-11-15T09:30:00-05:00,61.3,62.9,61.1,62.15,58.565535538592975,NaN,NaN,NaN,NaN,NaN,54.83560000000002,61.37211057981267,48.29908942018737,59.73722191076871,62.050000000000004,62.050000000000004,62.050000000000004,62040,26257.933333333334,76.50122886621418,68.76533244811107,NaN,NaN,NaN,NaN,1.173713312197081,28.703601061717958,-3211834,0.2698259557654603,1.8753391693712658,1.6055132136058055
2023-11-15T13:30:00-05:00,62.14,62.7,62.1,62.29,59.03982937774784,NaN,NaN,NaN,NaN,NaN,54.97600000000002,61.83730250025468,48.11469749974536,59.86977752861497,62.11283786279741,62.238299410721766,61.98737631487306,15563,26115.533333333333,76.8630265491311,69.49559728395295,NaN,NaN,NaN,NaN,1.1327337898972896,29.87547827382833,-3196271,0.2907004381800147,1.968888761330824,1.6781883231508092
2023-11-16T09:30:00-05:00,61.78,61.79,60.65,60.95,59.03982937774784,NaN,NaN,NaN,NaN,NaN,55.114400000000025,62.17020289974141,48.05859710025864,59.86977752861497,61.129999999999995,61.129999999999995,61.129999999999995,15611,24453.3,66.33546365354229,69.30859143186522,NaN,NaN,NaN,NaN,1.1689670906189118,29.593750884165342,-3211882,0.18772976990253798,1.9128505355289818,1.7251207656264438
2023-11-16T13:30:00-05:00,61.13,61.27,60.89,61.21,59.03982937774784,NaN,NaN,NaN,NaN,NaN,55.260200000000026,62.50986922279901,48.01053077720104,59.86977752861497,61.12700396195582,61.13032018602661,61.123687737885035,12742,24403.266666666666,67.27212249623207,69.08700205957828,NaN,NaN,NaN,NaN,1.112612298431847,29.332146879478277,-3199140,0.1142136410214667,1.867887816903277,1.7536741758818104
2023-11-17T09:30:00-05:00,61.5,62.25,61.01,62.14,59.03982937774784,NaN,NaN,NaN,NaN,NaN,55.45200000000003,62.9091758729427,47.994824127057356,59.86977752861497,61.79999999999999,61.79999999999999,61.79999999999999,34644,24698.433333333334,70.44025783384788,69.32781421182358,NaN,NaN,NaN,NaN,1.1217114199724294,29.58587068695353,-3164496,0.1055104025273026,1.8855621790409387,1.780051776513636
2023-11-17T13:30:00-05:00,62.19,62.28,61.92,62.27,59.03982937774784,NaN,NaN,NaN,NaN,NaN,55.644400000000026,63.29633534734829,47.99246465265176,59.90330087572069,61.91536921314378,62.0822173397336,61.74852108655395,16564,24669.3,70.86482711772669,69.54747744901745,NaN,NaN,NaN,NaN,1.0673034614029702,29.83626145177326,-3147932,0.08659225563253714,1.8882920960543075,1.8016998404217703
2023-11-20T09:30:00-05:00,62.38,63.84,62.35,63.79,59.78641244883013,NaN,NaN,NaN,NaN,NaN,55.843200000000024,63.80840577511961,47.87799422488044,61.15364070057655,63.32666666666667,63.32666666666667,63.32666666666667,30047,24540.7,75.32707321743821,70.0788218142026,NaN,NaN,NaN,NaN,1.1032103570170437,30.77281929455268,-3117885,0.1507725140090701,1.990165482933108,1.8393929689240378
2023-11-20T13:30:00-05:00,63.79,63.86,63.52,63.62,60.485439155701485,NaN,NaN,NaN,NaN,NaN,56.03480000000001,64.27347876786101,47.79612123213901,61.540912560461244,63.46729546001574,63.63473897950757,63.299851940523915,21194,25122.1,73.96268301263464,70.8594269161278,NaN,NaN,NaN,NaN,1.048695331515826,31.65075195703543,-3139079,0.1554773148196491,2.033739612448599,1.87826229762895
2023-11-21T09:30:00-05:00,62.88,63.12,62.24,62.67,60.485439155701485,NaN,NaN,NaN,NaN,NaN,56.185800000000015,64.62616405849911,47.745435941500915,61.540912560461244,62.67666666666667,62.67666666666667,62.67666666666667,25397,24606.833333333332,66.69282421994475,70.8925592890498,NaN,NaN,NaN,NaN,1.0723599506932666,31.21180226935301,-3164476,0.07252527559809341,1.9689188921265668,1.8963936165284734
2023-11-21T13:30:00-05:00,62.69,62.94,62.66,62.7,60.485439155701485,NaN,NaN,NaN,NaN,NaN,56.341600000000014,64.96756207735709,47.71563792264294,61.540912560461244,62.695282219446185,62.73173576446989,62.65882867442248,6623,24298.266666666666,66.80378874813256,70.89761476541683,NaN,NaN,NaN,NaN,1.0157628113580333,30.804206130790767,-3157853,0.0013561209751948855,1.898088767747467,1.896732646772272
2023-11-22T09:30:00-05:00,63.18,63.43,62.41,63.27,60.485439155701485,NaN,NaN,NaN,NaN,NaN,56.53800000000002,65.33710449989091,47.738895500109116,61.540912560461244,63.03666666666667,63.03666666666667,63.03666666666667,15589,24491,68.92231251853237,71.01904933524341,NaN,NaN,NaN,NaN,1.0160654676896026,30.700681263933916,-3142264,-0.024238497579370355,1.8664345247980592,1.8906730223774295
2023-11-22T13:30:00-05:00,63.4,63.64,63.1,63.44,60.485439155701485,NaN,NaN,NaN,NaN,NaN,56.74900000000002,65.69285442636463,47.80514557363539,61.56922178476493,63.189503262702544,63.36600452095593,63.013002004449156,11689,24670.1,69.54653623770062,71.15689257382574,NaN,NaN,NaN,NaN,0.9820607914260595,30.722093515670146,-3130575,-0.045397988742202466,1.8339255364496765,1.879323525191879
2023-11-24T09:30:00-05:00,63.34,64.5,63.34,64.32,60.83583736503491,NaN,NaN,NaN,NaN,NaN,56.972,66.1018674689181,47.8421325310819,62.26337742781194,64.05333333333333,64.05333333333333,64.05333333333333,21367,23097.7,72.61310560508726,71.07031044113464,NaN,NaN,NaN,NaN,0.9947707348956264,31.20112442023278,-3109208,-0.0172543999774748,1.8577555252200355,1.8750099251975103
2023-11-27T09:30:00-05:00,63.95,65.46,63.73,65.22,61.41511748480605,NaN,NaN,NaN,NaN,NaN,57.227399999999996,66.54941936063274,47.90538063936725,62.80570194224955,64.80333333333333,64.80333333333333,64.80333333333333,104946,26131.166666666668,75.34727574266137,71.24946612991612,NaN,NaN,NaN,NaN,1.0472871109745099,32.09606911130019,-3004262,0.04163175024245325,1.9270496130005768,1.8854178627581235
2023-11-27T13:30:00-05:00,65.22,65.39,64.97,65.15,62.08738487186033,NaN,NaN,NaN,NaN,NaN,57.481,66.96011240570598,48.00188759429402,63.056561553799646,64.96000452950453,65.14138876683998,64.77862029216908,78297,26916.9,74.72242838170716,71.12240895245132,NaN,NaN,NaN,NaN,1.002480888762045,32.927089181577074,-3082559,0.05470181201765856,1.9537951277801966,1.899093315762538
2023-11-28T09:30:00-05:00,65.17,66.88,64.93,66.5,62.68704919586668,NaN,NaN,NaN,NaN,NaN,57.7706,67.44736012723314,48.093839872766864,64.03824924303971,66.10333333333334,66.10333333333334,66.10333333333334,32260,27132.933333333334,78.43646918698288,71.23479771229789,NaN,NaN,NaN,NaN,1.070160825279041,34.31557837065418,-3050299,0.12886648905178832,2.0601764270772733,1.931309938025485
2023-11-28T13:30:00-05:00,66.53,67.11,66.53,67.02,63.66513786878182,NaN,NaN,NaN,NaN,NaN,58.0572,67.96125172845979,48.15314827154021,64.53159939443178,66.57547099486068,66.95878183055868,66.19216015916268,48944,28377.666666666668,79.67524011195351,72.1876388878987,NaN,NaN,NaN,NaN,1.0372921949019667,35.68953310001902,-3001355,0.184173878645169,2.161527286331946,1.9773534076867771
2023-11-29T09:30:00-05:00,67.68,68.5,67.45,68.1,64.76172251110992,NaN,NaN,NaN,NaN,NaN,58.373200000000004,68.52740184160272,48.218998158397284,65.69727951554542,68.01666666666667,68.01666666666667,68.01666666666667,51989,29744.233333333334,81.9894521508674,73.23887672037264,NaN,NaN,NaN,NaN,1.068914180980398,37.42767711524778,-2949366,0.26008070325734733,2.3024542867584614,2.042373583501114
2023-11-29T13:30:00-05:00,68.09,68.09,67.39,67.53,64.76172251110992,NaN,NaN,NaN,NaN,NaN,58.64460000000001,69.03511660698369,48.25408339301633,65.69727951554542,67.95239691219714,68.08711729005051,67.81767653434378,11832,29237.166666666668,77.0059161435767,73.7078523139247,NaN,NaN,NaN,NaN,1.0432774537675118,38.96810234555474,-2961198,0.23902777165489208,2.341158298069729,2.102130526414837
2023-11-30T09:30:00-05:00,67.71,67.73,66.15,66.49,64.76172251110992,NaN,NaN,NaN,NaN,NaN,58.89280000000001,69.42720082017026,48.35839917982977,65.69727951554542,66.79,66.79,66.79,37912,29898.533333333333,68.79013359770576,73.5596599196375,NaN,NaN,NaN,NaN,1.0816147784984038,38.975554841217885,-2999110,0.1277668781064074,2.261839124047846,2.1340722459414385
2023-11-30T13:30:00-05:00,66.46,66.78,66.3,66.65,64.76172251110992,NaN,NaN,NaN,NaN,NaN,59.17760000000001,69.76537374899944,48.58982625100058,65.69727951554542,66.70268557182924,66.80758203813066,66.59778910552781,26268,30078.233333333334,69.33223226058412,73.13145699414791,NaN,NaN,NaN,NaN,1.0386422943199467,38.98247501576223,-2972842,0.04208785153992434,2.186682060366344,2.14459420882642
2023-12-01T09:30:00-05:00,67.07,69.36,66.89,69,64.76172251110992,NaN,NaN,NaN,NaN,NaN,59.51980000000001,70.24836858299388,48.79123141700615,65.97764568956741,68.41666666666667,68.41666666666667,68.41666666666667,62778,31650.633333333335,75.94190819792946,73.27283022166898,NaN,NaN,NaN,NaN,1.1580249875828073,39.99922956589134,-2910064,0.11659923677865924,2.290343254799744,2.1737440180210847
2023-12-01T13:30:00-05:00,68.97,69.48,68.89,69.48,65.87796198571155,NaN,NaN,NaN,NaN,NaN,59.90180000000001,70.66154251736556,49.142057482634456,66.47911655165393,68.91316576065388,69.34187062936694,68.48446089194083,84203,33291.7,77.03084117702502,74.01126000431758,NaN,NaN,NaN,NaN,1.1174517741840355,40.98177033423593,-2825861,0.16800407420921415,2.3837491107826025,2.2157450365733884
2023-12-04T09:30:00-05:00,69.79,70.42,68.94,69.98,66.32146371363375,NaN,NaN,NaN,NaN,NaN,60.286000000000016,71.08581703548734,49.48618296451269,67.27929324132315,69.78000000000002,69.78000000000002,69.78000000000002,26683,31256.933333333334,78.14075334861585,74.82104319006638,NaN,NaN,NaN,NaN,1.1433480760280332,42.18612608972121,-2799178,0.20312488660875339,2.46965114483433,2.2665262582255767
2023-12-04T13:30:00-05:00,69.98,70.23,69.62,70.08,66.63594263574132,NaN,NaN,NaN,NaN,NaN,60.680800000000005,71.44056493423562,49.92103506576438,67.41243459305852,69.84773161343163,69.94118202371074,69.75428120315253,14017,30955.733333333334,78.36591618468096,75.495586309077,NaN,NaN,NaN,NaN,1.1052517848831738,43.304456434100395,-2785161,0.2002080683408778,2.516786343651674,2.316578275310796
2023-12-05T09:30:00-05:00,69.75,70.67,69.48,70.13,66.77317251593489,NaN,NaN,NaN,NaN,NaN,61.082200000000014,71.72395420877596,50.44044579122407,67.82094767444681,70.09333333333333,70.09333333333333,70.09333333333333,20399,31289.3,78.48524699017253,76.13406564853928,NaN,NaN,NaN,NaN,1.1113052288200898,44.480792322155565,-2764762,0.16995570663887616,2.5290229086093916,2.3590672019705154
2023-12-05T13:30:00-05:00,70.05,70.52,69.99,70.29,67.03098285611965,NaN,NaN,NaN,NaN,NaN,61.47960000000001,71.9821383293755,50.97706167062452,67.97575813955744,70.13020095201338,70.20113166419529,70.05927023983148,5511,31151.866666666665,78.88658220441955,76.58217111992016,NaN,NaN,NaN,NaN,1.069783426761512,45.57310421820679,-2759251,0.13078841426594412,2.5225527198029454,2.3917643055370013
2023-12-06T09:30:00-05:00,70.79,71.5,70.42,70.64,67.71752908993241,NaN,NaN,NaN,NaN,NaN,61.878200000000014,72.22721323991803,51.529186760082,68.85960651164596,70.85333333333334,70.85333333333334,70.85333333333334,18472,31572.2,79.77534285063794,76.89846162763276,NaN,NaN,NaN,NaN,1.0797988962785465,46.891311583242576,-2740779,0.09991389311990773,2.516656671936886,2.416742778816978
2023-12-06T13:30:00-05:00,70.59,70.74,69.72,69.74,67.71752908993241,NaN,NaN,NaN,NaN,NaN,62.24520000000001,72.37968389608483,52.1107161039152,68.85960651164596,70.5012542991297,70.8924181956178,70.1100904026416,14965,31414.566666666666,71.44681407598446,76.664489177224,NaN,NaN,NaN,NaN,1.0755275465443643,47.23381839742636,-2755744,-0.004144190007579596,2.4115625413075037,2.4157067313150833
2023-12-07T09:30:00-05:00,69.37,70.27,69.13,70.23,67.71752908993241,NaN,NaN,NaN,NaN,NaN,62.61440000000002,72.53834611835428,52.690453881645745,68.85960651164596,69.87666666666667,69.87666666666667,69.87666666666667,7535,31202.7,73.09380122847728,76.28287003733075,NaN,NaN,NaN,NaN,1.0801327217911953,46.85920164574362,-2748209,-0.05990141716459885,2.3408299598593345,2.4007313770239334
2023-12-07T13:30:00-05:00,70.3,70.3,69.73,70,67.71752908993241,NaN,NaN,NaN,NaN,NaN,62.98580000000001,72.59254020883255,53.37905979116748,68.85960651164596,69.93482290731319,70.00094413757667,69.86870167704971,5829,29329,71.02294126774345,75.66484869131575,NaN,NaN,NaN,NaN,1.043694670234681,46.52579822729907,-2754038,-0.1282739080625923,2.240388991945693,2.3686629000082853
2023-12-08T09:30:00-05:00,69.75,71.81,69.75,71.5,67.71752908993241,NaN,NaN,NaN,NaN,NaN,63.37600000000001,72.74654704913218,54.005452950867856,68.85960651164596,71.02,71.02,71.02,17330,29387.9,75.83199003492754,75.2250299687486,NaN,NaN,NaN,NaN,1.116287908075061,46.872845028353375,-2736708,-0.0902722823339075,2.255822547090901,2.3460948294248083
2023-12-08T13:30:00-05:00,71.45,71.98,71.45,71.93,68.48352326547996,NaN,NaN,NaN,NaN,NaN,63.70540000000001,73.0976182342618,54.31318176573823,69.34265986173615,71.33042088756109,71.70675613663568,70.9540856384865,11791,29260.566666666666,77.00988845284043,75.22531370512459,NaN,NaN,NaN,NaN,1.074410200355414,47.2607885443521,-2724917,-0.055668680621381306,2.2765089786480814,2.3321776592694627
2023-12-11T09:30:00-05:00,71,71.32,70.45,70.65,68.48352326547996,NaN,NaN,NaN,NaN,NaN,64.00480000000002,73.30860759904239,54.700992400957645,69.34265986173615,70.80666666666666,70.80666666666666,70.80666666666666,23516,29619.7,66.60370385518334,75.06914015208727,NaN,NaN,NaN,NaN,1.1033809003300274,46.456917580050714,-2748433,-0.13401019745748588,2.1646649124476056,2.2986751099050915
2023-12-11T13:30:00-05:00,70.65,70.99,70.6,70.86,68.48352326547996,NaN,NaN,NaN,NaN,NaN,64.25760000000001,73.60573312699405,54.90946687300596,69.34265986173615,70.81179349027408,70.8167918816927,70.80679509885547,24740,29289.566666666666,67.38244030985986,74.92986929846411,NaN,NaN,NaN,NaN,1.0524251217350256,45.71046597034227,-2723693,-0.18364297928775475,2.0691213857953983,2.252764365083153
2023-12-12T09:30:00-05:00,70.8,71.34,70.19,70.86,68.48352326547996,NaN,NaN,NaN,NaN,NaN,64.51180000000001,73.87300905866354,55.150590941336475,69.34265986173615,70.79666666666667,70.79666666666667,70.79666666666667,33372,29849.833333333332,67.38244030985986,74.31847873503057,NaN,NaN,NaN,NaN,1.0593947558968098,44.54696217260564,-2723693,-0.22566299966390568,1.970685615503271,2.1963486151671767
2023-12-12T13:30:00-05:00,70.96,71.24,70.95,71.15,68.48352326547996,NaN,NaN,NaN,NaN,NaN,64.79780000000001,74.07864331513048,55.51695668486955,69.34265986173615,70.91451856868721,71.06758946129219,70.76144767608224,19782,29507.666666666668,68.55671104788539,73.7131837258063,NaN,NaN,NaN,NaN,1.0108665590470374,43.46656578899305,-2703911,-0.24168727561112346,1.8942395206532723,2.1359267962643957
2023-12-13T09:30:00-05:00,71.2,71.37,70.32,70.38,68.48352326547996,NaN,NaN,NaN,NaN,NaN,65.05460000000001,74.22788138454318,55.88131861545683,69.34265986173615,70.69,70.69,70.69,12242,29209.266666666666,62.158017140587305,72.57155971094713,NaN,NaN,NaN,NaN,1.0136618048293926,41.72904938128273,-2716153,-0.307673773004816,1.7513345800083755,2.0590083530131915
2023-12-13T13:30:00-05:00,70.39,73.43,70.35,73.37,68.50118639330007,NaN,NaN,NaN,NaN,NaN,65.355,74.61370768520152,56.09629231479849,70.04028190679496,71.99410004130836,72.70655997155507,71.28164011106165,41016,29729.9,72.78156639567925,72.17267758316129,NaN,NaN,NaN,NaN,1.1612573901987224,41.378020803250635,-2675137,-0.16086083492210212,1.8579323093605637,2.018793144282666
2023-12-14T09:30:00-05:00,74.83,75.76,74.48,74.8,71.55931428451372,NaN,NaN,NaN,NaN,NaN,65.67360000000001,75.11234293325128,56.234857066748724,71.85322552543596,75.01333333333334,75.01333333333334,75.01333333333334,29699,30499.1,76.2199757302789,72.01087249316889,NaN,NaN,NaN,NaN,1.2490247194702424,42.00100606341734,-2645438,0.012445568721945577,2.034350105185098,2.0219045364631523
2023-12-14T13:30:00-05:00,74.7,75.12,74,75.05,71.55931428451372,NaN,NaN,NaN,NaN,NaN,66.0076,75.56721217623429,56.4479878237657,71.85322552543596,74.89802270314857,75.0399506472549,74.75609475904224,19604,30632.933333333334,76.77241825401359,71.85986078242561,NaN,NaN,NaN,NaN,1.2398086680795113,42.101663287673766,-2625834,0.11793934598838529,2.169328718948634,2.051389372960249
2023-12-15T09:30:00-05:00,75.01,75.01,73.66,73.83,71.55931428451372,NaN,NaN,NaN,NaN,NaN,66.3126,75.87794060867706,56.74725939132294,71.85322552543596,74.16666666666667,74.16666666666667,74.16666666666667,13665,30698.8,68.41914042668726,71.04870346642913,NaN,NaN,NaN,NaN,1.250536620359546,41.858328057378685,-2639499,0.08131855122759024,2.1530375619947364,2.071719010767146
2023-12-15T13:30:00-05:00,73.84,74.14,73.47,73.96,71.55931428451372,NaN,NaN,NaN,NaN,NaN,66.6196,76.16166263655839,57.07753736344162,71.85322552543596,73.96096680208463,74.10744043019025,73.814493173979,26950,30884.9,68.80859326419763,70.86025912273007,NaN,NaN,NaN,NaN,1.2090697189052928,41.440150631553955,-2612549,0.0435113232378006,2.126108164814397,2.0825968415765965
2023-12-18T09:30:00-05:00,73.43,74.6,73.17,74.45,71.55931428451372,NaN,NaN,NaN,NaN,NaN,66.9504,76.40819505804654,57.49260494195346,71.85322552543596,74.07333333333332,74.07333333333332,74.07333333333332,25029,28221,70.2955223498615,70.66038205997181,NaN,NaN,NaN,NaN,1.2248504532692,41.27196070715134,-2587520,0.02981756711707728,2.1198688004729433,2.090051233355866
2023-12-18T13:30:00-05:00,74.41,74.77,74.28,74.38,71.55931428451372,NaN,NaN,NaN,NaN,NaN,67.2626,76.64995388488178,57.87524611511823,71.87321214017486,74.20612397491557,74.3956643073366,74.01658364249454,12285,26020.6,69.78372727722181,70.57186677493455,NaN,NaN,NaN,NaN,1.1723611351785423,41.19760315513692,-2599805,-0.0038503346728142596,2.0852383150148484,2.0890886496876626
2023-12-19T09:30:00-05:00,74.8,76.35,74.8,75.76,72.0135731706267,NaN,NaN,NaN,NaN,NaN,67.5996,76.97314401280592,58.226055987194066,73.04756971213988,75.63666666666666,75.63666666666666,75.63666666666666,19244,25586.733333333334,73.82905388439025,70.42879990703902,NaN,NaN,NaN,NaN,1.2293353398086464,41.80480592885024,-2580561,0.04427167126793119,2.1444282387725764,2.100156567504645
2023-12-19T13:30:00-05:00,75.83,76.55,75.82,76.51,72.67772893559822,NaN,NaN,NaN,NaN,NaN,67.949,77.32264838256751,58.57535161743249,73.51305576971191,75.95228420550741,76.2803712158398,75.62419719517501,17809,24548.9,75.73072886724916,70.33743136521107,NaN,NaN,NaN,NaN,1.197954244108028,42.44458071815681,-2562752,0.1008293394719737,2.226193241844612,2.1253639023726385
2023-12-20T09:30:00-05:00,76.32,77,75.88,76.73,72.9394230748892,NaN,NaN,NaN,NaN,NaN,68.3008,77.64589654524812,58.95570345475187,74.01044461576953,76.53666666666668,76.53666666666668,76.53666666666668,28693,23772.366666666665,76.27531113539561,71.02826045665482,NaN,NaN,NaN,NaN,1.1923860838145977,43.210009123802074,-2534059,0.12565629864865446,2.282434275683457,2.1567779770348023
2023-12-20T13:30:00-05:00,76.74,76.8,74.18,74.21,72.9394230748892,NaN,NaN,NaN,NaN,NaN,68.56559999999999,77.81463208773842,59.31656791226157,74.01044461576953,75.77138715350473,76.50749793510833,75.03527637190113,31012,24411.7,59.739339378500034,70.4823246758434,NaN,NaN,NaN,NaN,1.2943585063992684,42.11101260625383,-2565071,-0.045853201074359085,2.0994614756918537,2.145314676766213
2023-12-21T09:30:00-05:00,75.55,75.8,74.6,75.17,72.9394230748892,NaN,NaN,NaN,NaN,NaN,68.85199999999999,78.01406876202167,59.68993123797831,74.01044461576953,75.18999999999998,75.19000134869914,75.18999865130083,15636,23669.166666666668,63.027687060748384,70.17127087233544,NaN,NaN,NaN,NaN,1.315475755942178,41.09051583995903,-2549435,-0.10924179937905532,2.0087624275423934,2.1180042269214487
2023-12-21T13:30:00-05:00,75.25,75.92,75.2,75.84,72.9394230748892,NaN,NaN,NaN,NaN,NaN,69.1258,78.28859790457096,59.96300209542903,74.01044461576953,75.41623816380853,75.64784122035391,75.18463510726315,14920,23290.9,65.1660796499371,69.92908291533912,NaN,NaN,NaN,NaN,1.2750846305177368,40.21179660900827,-2534515,-0.11979751460585764,1.968257333664127,2.0880548482699846
2023-12-22T09:30:00-05:00,76,76.79,75.84,76.76,72.9394230748892,NaN,NaN,NaN,NaN,NaN,69.4152,78.61009444420165,60.22030555579835,74.01044461576953,76.46333333333332,76.46333333333332,76.46333333333332,25451,22046.666666666668,67.91062136450343,70.3399832170474,NaN,NaN,NaN,NaN,1.2518642997664702,39.876359691819985,-2509064,-0.08045779550503251,1.9874826038886937,2.067940399393726
2023-12-22T13:30:00-05:00,76.72,76.86,75.8,76.44,72.9394230748892,NaN,NaN,NaN,NaN,NaN,69.725,78.80119061060351,60.648809389396476,74.01044461576953,76.43761465332449,76.48033102682153,76.39489827982744,9226,19547.433333333334,65.96382665361872,69.85300180690022,NaN,NaN,NaN,NaN,1.2381597069260082,39.60227941113361,-2518290,-0.09085736142692946,1.9543686976100645,2.045226059036994
2023-12-26T09:30:00-05:00,76.56,77.38,76.53,76.82,73.37071578814478,NaN,NaN,NaN,NaN,NaN,70.0372,78.99343049279146,61.080969507208536,74.45141319335629,76.91,76.91,76.91,14255,19133.166666666668,67.16748947777043,69.20639564600677,NaN,NaN,NaN,NaN,1.216862585002722,39.62642316874347,-2504035,-0.08700793818328689,1.9364661363078852,2.023474074491172
2023-12-26T13:30:00-05:00,76.89,77.43,76.76,77.15,73.58227416141092,NaN,NaN,NaN,NaN,NaN,70.3374,79.22062446862648,61.45417553137353,74.75213055468504,76.9779961401379,77.07392531584891,76.8820669644269,7162,18904.666666666668,68.21860887400722,68.5954092617206,NaN,NaN,NaN,NaN,1.177800971788242,39.675766451168165,-2496873,-0.07742189220664075,1.9266967092328713,2.004118601439512
2023-12-27T09:30:00-05:00,77.99,78.41,77.59,78.23,74.47512533589224,NaN,NaN,NaN,NaN,NaN,70.65659999999998,79.50425153925114,61.80894846074883,75.63770444374802,78.07666666666667,78.07666666666667,78.07666666666667,15702,18748.1,71.44104801035448,68.81125980341112,NaN,NaN,NaN,NaN,1.183672330946224,40.22026254284715,-2481171,-0.016703050591658997,1.9832397881999384,1.9999428387915974
2023-12-27T13:30:00-05:00,78.3,78.35,77.8,78.35,74.6353469115335,NaN,NaN,NaN,NaN,NaN,70.94779999999999,79.83063764570811,62.064962354291865,75.85716355499842,78.11411646586345,78.15847854953894,78.06975438218795,11190,18937.4,71.78338895588348,69.02374520996011,NaN,NaN,NaN,NaN,1.138410021592922,40.72586605654906,-2469981,0.01165496707799285,2.0145115476390885,2.0028565805610956
2023-12-28T09:30:00-05:00,77.88,78.41,77.75,78.25,74.70669477919108,NaN,NaN,NaN,NaN,NaN,71.24039999999998,80.10224988363127,62.378550116368686,76.08573084399873,78.13666666666667,78.13666666666667,78.13666666666667,15211,18828.7,71.01938270837366,69.07544952128241,NaN,NaN,NaN,NaN,1.1042378771934274,41.22636448316932,-2485192,0.004176823018990028,2.0080776093348334,2.0039007863158433
2023-12-28T13:30:00-05:00,78.25,78.29,77.61,78.05,74.70669477919108,NaN,NaN,NaN,NaN,NaN,71.54799999999999,80.26507657417402,62.83092342582596,76.090584675199,78.02427336024809,78.09210686959013,77.95643985090605,41759,19721.833333333332,69.42782929605116,69.05002823691306,NaN,NaN,NaN,NaN,1.0739351716796117,41.477113205416174,-2526951,-0.03176200248738392,1.9641982832066134,1.9959602856939973
2023-12-29T09:30:00-05:00,78,78.12,75.58,76.14,74.70669477919108,NaN,NaN,NaN,NaN,NaN,71.81679999999999,80.25020732088845,63.38339267911153,76.090584675199,76.61333333333333,76.61333333333333,76.61333333333333,30718,20494.6,56.423391854739656,67.8067666633666,NaN,NaN,NaN,NaN,1.1786540879882115,39.2234496350627,-2557669,-0.19271127223055418,1.7550711954058045,1.9477824676363586
2023-12-29T13:30:00-05:00,76.25,76.48,75.84,75.9,74.70669477919108,NaN,NaN,NaN,NaN,NaN,72.06939999999999,80.21538739012138,63.923412609878596,76.090584675199,76.38517361306938,76.65191204485453,76.11843518128424,22475,21049.466666666667,55.02860124647264,66.32804326188257,NaN,NaN,NaN,NaN,1.1401787959890535,37.13076203402018,-2580144,-0.3165627133442175,1.5520790759560867,1.8686417893003042
2024-01-02T09:30:00-05:00,75.25,75.39,73.27,73.83,NaN,NaN,NaN,77.96872452636491,77.96872452636491,77.96872452636491,72.27719999999998,80.05376997911158,64.50063002088838,76.090584675199,74.16333333333334,74.16333333333334,74.16333333333334,32897,21568.366666666665,44.752836011502126,64.07643789589017,NaN,NaN,NaN,NaN,1.2465945962755502,35.81872770043661,-2613041,-0.526734271307844,1.2102239501654992,1.7369582214733432
2024-01-02T13:30:00-05:00,73.73,73.86,72.5,72.92,NaN,NaN,NaN,76.83878250243924,NaN,NaN,72.44919999999998,79.8872372034577,65.01116279654225,76.090584675199,73.4851212100975,74.00059699785095,72.96964542234406,56947,23073.566666666666,41.11778014273958,62.74632652190728,NaN,NaN,NaN,NaN,1.2546949822558682,35.05108377304839,-2669988,-0.7047630418737973,0.8560044191310965,1.5607674610048938
2024-01-03T09:30:00-05:00,70.98,71.35,70.25,70.95,NaN,NaN,NaN,74.65656511596472,NaN,NaN,72.56379999999999,79.72416076186202,65.40343923813795,76.090584675199,70.85000000000001,70.85000000000001,70.85000000000001,82627,25043.933333333334,34.57119985981588,60.71372029326925,NaN,NaN,NaN,NaN,1.3557881978090207,35.38942282007402,-2752615,-0.9193531997918802,0.4115759612650436,1.3309291610569238
2024-01-03T13:30:00-05:00,70.94,71.14,70.32,70.43,NaN,NaN,NaN,74.52308488342086,NaN,NaN,72.66939999999998,79.5391346790118,65.79966532098817,76.090584675199,70.76017250886176,70.8683070079213,70.65203800980221,57018,26119.866666666665,33.074284987765196,58.42144924597125,NaN,NaN,NaN,NaN,1.317517612251234,35.70359479231211,-2809633,-1.0509791518750335,0.01720522121313195,1.0681843730881655
2024-01-04T09:30:00-05:00,70.23,71.66,69.96,71.6,NaN,NaN,NaN,74.52308488342086,NaN,NaN,72.77139999999997,79.4195732949752,66.12322670502475,76.090584675199,71.07333333333334,71.07333333333334,71.07333333333334,19153,25645.9,39.42924522189446,56.3870652357849,NaN,NaN,NaN,NaN,1.3448377828047173,35.49598400711229,-2790480,-1.0134574511846552,-0.19863744089265367,0.8148200102920016
2024-01-04T13:30:00-05:00,71.51,71.65,70.99,71.05,NaN,NaN,NaN,74.52308488342086,NaN,NaN,72.85199999999998,79.31442926460487,66.38957073539508,76.090584675199,71.14022777362254,71.21772140456063,71.06273414268445,14272,25462.233333333334,37.62078412034755,54.362562197694096,NaN,NaN,NaN,NaN,1.295920798318667,35.30320256371247,-2804752,-0.9793407354560418,-0.40935590902805075,0.5699848264279911
2024-01-05T09:30:00-05:00,70.26,71.66,70.26,70.93,NaN,NaN,NaN,74.52308488342086,NaN,NaN,72.90859999999998,79.25203630534887,66.56516369465109,76.090584675199,70.95,70.95,70.95,7851,25315.866666666665,37.21967135620158,52.223432331867755,NaN,NaN,NaN,NaN,1.3033550270101901,35.48560975853765,-2812603,-0.9194729418716578,-0.5793563509115813,0.34011659096007657
2024-01-05T13:30:00-05:00,71.1,71.5,70.8,71.03,NaN,NaN,NaN,74.52308488342086,NaN,NaN,72.97859999999997,79.15820906207057,66.79899093792937,75.0904677401592,71.04485998755446,71.12346775287324,70.96625222223568,11433,24329.766666666666,37.81468905858343,50.0517237736232,NaN,NaN,NaN,NaN,1.2602582393666053,35.654987868018175,-2801170,-0.8304676893704234,-0.6979680207529526,0.13249966861747073
2024-01-08T09:30:00-05:00,71.84,73.4,71.53,73.4,NaN,NaN,NaN,74.52308488342086,NaN,NaN,73.11679999999997,79.01232567970165,67.22127432029829,73.73637419212736,72.77666666666667,72.77666666666667,72.77666666666667,15976,23872.333333333332,49.927357788695154,48.51503161493325,NaN,NaN,NaN,NaN,1.3395255079832766,33.98875373316738,-2785194,-0.5811065438003089,-0.5938835111329155,-0.012776967332606526
2024-01-08T13:30:00-05:00,73.4,73.8,73.4,73.68,NaN,NaN,NaN,74.52308488342086,NaN,NaN,73.25739999999998,78.85721829705372,67.65758170294623,71.88009935370188,73.20518865679672,73.6301740631162,72.78020325047724,16243,23760.3,51.13827701709518,47.040380762162656,NaN,NaN,NaN,NaN,1.2724165431273278,32.11824293007078,-2768951,-0.37636381238488004,-0.48323173281370657,-0.10686792042882653
2024-01-09T09:30:00-05:00,73.12,73.39,72.6,73.12,NaN,NaN,NaN,74.52308488342086,NaN,NaN,73.33979999999998,78.80626868096891,67.87333131903105,70.68327920894814,73.03666666666668,73.03666666666668,73.03666666666668,21167,24010.366666666665,48.60650973681591,45.439461264194236,NaN,NaN,NaN,NaN,1.2586725043325195,30.907240685650056,-2790118,-0.263069019209251,-0.4357041944403903,-0.1726351752311393
2024-01-09T13:30:00-05:00,73.1,73.25,72.57,72.77,NaN,NaN,NaN,74.52308488342086,NaN,NaN,73.40559999999998,78.7627532141634,68.04844678583656,70.68327920894814,72.99095774778536,73.06733558493553,72.91457991063518,7581,23364.733333333334,47.039034141217215,43.84026161027753,NaN,NaN,NaN,NaN,1.2173387540230542,29.802218067812134,-2797699,-0.19902982544050202,-0.42142245703176684,-0.22239263159126482
2024-01-10T09:30:00-05:00,72.59,73.04,71.46,73.04,NaN,NaN,NaN,74.52308488342086,NaN,NaN,73.46679999999996,78.73519852706934,68.19840147293058,70.68327920894814,72.51333333333334,72.51333333333334,72.51333333333334,14062,22999.166666666668,48.420883349857625,43.268653859928804,NaN,NaN,NaN,NaN,1.243243128735694,29.46196388888163,-2783637,-0.1291995466988375,-0.38389206496481165,-0.25469251826597417
2024-01-10T13:30:00-05:00,73.05,73.32,72.34,72.63,NaN,NaN,NaN,74.52308488342086,NaN,NaN,73.51779999999997,78.70277875019997,68.33282124979996,70.68327920894814,72.64182847728661,72.7667796036049,72.51687735096831,14871,23085.366666666665,46.4393750318014,42.655137701738,NaN,NaN,NaN,NaN,1.224440048111715,28.8787674093557,-2798508,-0.10250168618352573,-0.38281962599538133,-0.2803179398118556
2024-01-11T09:30:00-05:00,73.18,73.51,70.39,71.45,NaN,NaN,NaN,74.52308488342086,NaN,NaN,73.54419999999996,78.67305030392103,68.41534969607889,70.68327920894814,71.78333333333335,71.78333333333335,71.78333333333335,36708,23667.5,41.21214892490795,42.40223148126699,NaN,NaN,NaN,NaN,1.3598371875323072,29.367588013231334,-2835216,-0.1531439148258496,-0.4717478333441676,-0.318603918518318
2024-01-11T13:30:00-05:00,71.29,71.7,71.25,71.39,NaN,NaN,NaN,74.52308488342086,NaN,NaN,73.56619999999997,78.6482498069213,68.48415019307863,70.68327920894814,71.67929899856938,71.83486811470699,71.52372988243177,16416,23621.066666666666,40.95968723907628,42.39093913100532,NaN,NaN,NaN,NaN,1.2948488169942856,29.821492859687282,-2851632,-0.17778183428242955,-0.5408312113713549,-0.3630493770889254
2024-01-12T09:30:00-05:00,71.12,72,70.11,70.5,NaN,NaN,NaN,74.52308488342086,NaN,NaN,73.56339999999996,78.65204557225518,68.47475442774474,70.68327920894814,70.87,70.87,70.87,8973,22963.733333333334,37.308750089726495,42.58647843314179,NaN,NaN,NaN,NaN,1.337359615780408,30.750467157305998,-2860605,-0.23739265628517092,-0.659790197445389,-0.4223975411602181
2024-01-12T13:30:00-05:00,70.5,70.65,70.13,70.2,NaN,NaN,NaN,74.17140050091588,NaN,NaN,73.57259999999997,78.63515873645186,68.51004126354808,70.68327920894814,70.56565343137255,70.8353473352456,70.2959595274995,11427,22310.9,36.13939989313287,42.805415212096634,NaN,NaN,NaN,NaN,1.278976786081808,31.613086147951954,-2872032,-0.27760543073887123,-0.7694043295838071,-0.4917988988449359
2024-01-16T09:30:00-05:00,69.34,70.29,68.54,69.69,NaN,NaN,NaN,73.26315502360153,NaN,NaN,73.56179999999996,78.65504680729569,68.46855319270423,70.68327920894814,69.50666666666667,69.50666666666667,69.50666666666667,34636,22944.233333333334,34.178222105330136,42.43034213234204,NaN,NaN,NaN,NaN,1.3126213013616788,33.03350333034034,-2906668,-0.31632085517736475,-0.8871999678166418,-0.570879112639277
2024-01-16T13:30:00-05:00,69.7,69.75,69.35,69.72,NaN,NaN,NaN,73.26315502360153,NaN,NaN,73.55619999999996,78.66568903903595,68.44671096096397,70.4832986937268,69.53981083637348,69.58688398141707,69.49273769132988,17171,23019.266666666666,34.40372440385684,42.20055215259271,NaN,NaN,NaN,NaN,1.2474340655501308,34.35246214255812,-2889497,-0.31688574543594406,-0.9669862944342071,-0.6501005489982631
2024-01-17T09:30:00-05:00,68.38,68.46,67.39,68.09,NaN,NaN,NaN,71.80106687067824,NaN,NaN,73.48799999999996,78.79275107804605,68.18324892195386,70.4832986937268,67.98,67.98,67.98,26213,23044.666666666668,28.658732994934212,41.58905655535933,NaN,NaN,NaN,NaN,1.3247602037251214,36.19456566491452,-2915710,-0.3987240827125027,-1.1485056523888915,-0.7497815696763888
2024-01-17T13:30:00-05:00,68.03,68.89,67.92,68.84,NaN,NaN,NaN,71.80106687067824,NaN,NaN,73.42619999999995,78.87222885045958,67.98017114954033,70.42731116398514,68.19279781969448,68.46850027735304,67.91709536203591,15616,23257.666666666668,34.11074569014457,41.32448917189941,NaN,NaN,NaN,NaN,1.299420189173327,37.4429478361376,-2900094,-0.3744181284559982,-1.2178042302463865,-0.8433861017903883
2024-01-18T09:30:00-05:00,69.635,69.93,68.08,68.14,NaN,NaN,NaN,71.80106687067824,NaN,NaN,73.37599999999996,78.96778683427996,67.78421316571996,70.42731116398514,68.71666666666665,68.71666666666665,68.71666666666665,31792,23842.233333333334,31.677487319189453,40.020926995506144,NaN,NaN,NaN,NaN,1.33874731851809,37.55705110332481,-2931886,-0.37653938479289617,-1.3140603327815086,-0.9375209479886124
2024-01-18T13:30:00-05:00,68.07,68.85,68.07,68.76,NaN,NaN,NaN,71.80106687067824,NaN,NaN,73.33399999999996,79.03129760500799,67.63670239499193,69.63584893118812,68.6669059168634,68.73984231780656,68.59396951592024,14798,24096.766666666666,36.03010932974238,38.94177216069522,NaN,NaN,NaN,NaN,1.298836795766798,37.66729290463212,-2917088,-0.3100159793238424,-1.3250409221434154,-1.015024942819573
2024-01-19T09:30:00-05:00,69,69.79,68.14,68.98,NaN,NaN,NaN,71.80106687067824,NaN,NaN,73.29639999999996,79.08263160269543,67.5101683973045,68.3955433159604,68.97000000000001,68.97000000000001,68.97000000000001,73664,26028.833333333332,37.55041992130191,38.152051459587085,NaN,NaN,NaN,NaN,1.3239198817834554,36.86880733200827,-2843424,-0.2287751729427263,-1.300993908997981,-1.0722187360552546
2024-01-19T13:30:00-05:00,69.07,69.97,69.07,69.96,NaN,NaN,NaN,71.80106687067824,NaN,NaN,73.27259999999997,79.10356672602599,67.44163327397395,68.3955433159604,69.18447881236494,69.50606718020111,68.86289044452877,32766,26748.033333333333,43.94165858121871,37.930810348158616,NaN,NaN,NaN,NaN,1.3000684616560654,35.96152741687501,-2810658,-0.09354571271091516,-1.1891508769438985,-1.0956051642329834
2024-01-22T09:30:00-05:00,70.73,72.41,70.5,70.5,67.44821837558901,67.44821837558901,67.44821837558901,NaN,NaN,NaN,73.27499999999996,79.10129934006387,67.44870065993605,68.60745156127503,71.13666666666667,71.13666666666667,71.13666666666667,30831,27268.7,47.151200182330705,37.84011869333527,NaN,NaN,NaN,NaN,1.3822064286806324,33.54085034717985,-2779827,0.04056727558089923,-1.0448960697568594,-1.0854633453377587
2024-01-22T13:30:00-05:00,70.51,71.29,70.44,71.05,67.44821837558901,NaN,NaN,NaN,NaN,NaN,73.22859999999997,79.08799247362936,67.36920752637059,68.60745156127503,71.08124491663683,71.17380299099824,70.98868684227543,11054,26245.2,50.27397130247661,38.11401842695493,NaN,NaN,NaN,NaN,1.3441916837748735,31.252505349656406,-2768773,0.16749577204411814,-0.876093630282611,-1.0435894023267291
2024-01-23T09:30:00-05:00,71.46,71.61,70.48,70.75,67.44821837558901,NaN,NaN,NaN,NaN,NaN,73.14759999999997,79.0297908299567,67.26540917004324,68.60745156127503,70.94666666666667,70.94666666666667,70.94666666666667,19828,25882.2,48.587522998143264,38.64083086075745,NaN,NaN,NaN,NaN,1.3288922777909538,29.345521352223265,-2788601,0.22864059570150486,-0.757788657699848,-0.9864292534013529
2024-01-23T13:30:00-05:00,70.69,71.11,70.53,70.93,67.44821837558901,NaN,NaN,NaN,NaN,NaN,73.06519999999996,78.95390952247031,67.17649047752961,68.60745156127503,70.90001708571198,70.9449868409202,70.85504733050377,21337,25844.266666666666,49.67826338536435,39.26358629977803,NaN,NaN,NaN,NaN,1.275399972234457,27.574750497463924,-2767264,0.2754595354582068,-0.6421048340785944,-0.9175643695368012
2024-01-24T09:30:00-05:00,72.14,72.14,70.67,70.76,67.56137905924683,NaN,NaN,NaN,NaN,NaN,73.00379999999997,78.92327144938025,67.08432855061969,69.03627615949826,71.19,71.19,71.19,12465,25163.2,48.62894137902846,40.07217139187102,NaN,NaN,NaN,NaN,1.28929997421771,26.637022165390096,-2779729,0.2878809522005408,-0.5577131792861252,-0.845594131486666
2024-01-24T13:30:00-05:00,70.73,70.76,69.83,69.83,67.56137905924683,NaN,NaN,NaN,NaN,NaN,72.92119999999997,78.8999579178308,66.94244208216914,69.03627615949826,70.37766569820229,70.81705618400008,69.9382752124045,42605,24685.133333333335,43.2472412526031,40.5798743461189,NaN,NaN,NaN,NaN,1.263635690345017,25.084266047612708,-2822334,0.22893395329337152,-0.5594266898699516,-0.7883606431633231
2024-01-25T09:30:00-05:00,70.06,70.22,69.08,69.44,67.56137905924683,NaN,NaN,NaN,NaN,NaN,72.82099999999997,78.86152216286177,66.78047783713816,69.03627615949826,69.58,69.58,69.58,11132,22301.966666666667,41.18865697035317,41.08061969362054,NaN,NaN,NaN,NaN,1.2548045696060872,23.499074421262325,-2833466,0.16228446485448034,-0.5855050620952227,-0.747789526949703
2024-01-25T13:30:00-05:00,69.31,69.45,68.95,69.36,67.56137905924683,NaN,NaN,NaN,NaN,NaN,72.72059999999998,78.82071725789122,66.62048274210873,69.03627615949826,69.40053432642486,69.56306901618963,69.23799963666009,13572,20853.766666666666,40.76005411615986,41.53464324449933,NaN,NaN,NaN,NaN,1.2008899574913667,22.12194959387913,-2847038,0.11371467817743941,-0.6056461792279038,-0.7193608574053432
2024-01-26T09:30:00-05:00,69.84,70.7,69.75,70.19,67.56137905924683,NaN,NaN,NaN,NaN,NaN,72.60919999999997,78.68662292752639,66.53177707247356,69.03627615949826,70.21333333333332,70.21333333333332,70.21333333333332,11829,20609.633333333335,46.93022844442679,42.83975006232024,NaN,NaN,NaN,NaN,1.2108263890991264,21.16368494046098,-2835209,0.13683790209847335,-0.5483134797822515,-0.6851513818807249
2024-01-26T13:30:00-05:00,70.44,70.49,69.9,70.02,67.56137905924683,NaN,NaN,NaN,NaN,NaN,72.47939999999997,78.4949377614995,66.46386223850044,69.03627615949826,70.18643289615686,70.22302160111013,70.14984419120358,6394,20347.033333333333,45.87626310597764,43.680144163451175,NaN,NaN,NaN,NaN,1.1664816470206165,20.273867762286983,-2841603,0.13955521345469268,-0.510707365062359,-0.6502625785170517
2024-01-29T09:30:00-05:00,70.29,71.88,70.255,71.57,67.56137905924683,NaN,NaN,NaN,NaN,NaN,72.37619999999997,78.27237216845201,66.48002783154793,69.03627615949826,71.235,71.235,71.235,17680,20674.666666666668,55.65505568633972,45.392827618247615,NaN,NaN,NaN,NaN,1.2160186722334296,20.34679714019537,-2823923,0.23878835539787313,-0.35177713426971025,-0.5905654896675834
2024-01-29T13:30:00-05:00,71.63,72.66,71.63,72.66,68.47095028019966,NaN,NaN,NaN,NaN,NaN,72.34519999999996,78.21873554854572,66.4716644514542,69.7771873740444,71.71874687343671,72.25655895078434,71.18093479608909,14304,20770.366666666665,60.99241030935143,47.17584911679112,NaN,NaN,NaN,NaN,1.2070173385024705,20.84694763474451,-2809619,0.36341341253495385,-0.1362987239988911,-0.49971213653384494
2024-01-30T09:30:00-05:00,72.67,72.84,71.33,71.62,68.47095028019966,NaN,NaN,NaN,NaN,NaN,72.27419999999998,78.09502205878397,66.45337794121599,69.77874989923552,71.93,71.93,71.93,19266,20880.033333333333,54.27952113285876,48.37078491761661,NaN,NaN,NaN,NaN,1.228658957180866,21.03050736836965,-2828885,0.3606606621543965,-0.048886308840849324,-0.40954697099524584
2024-01-30T13:30:00-05:00,71.61,71.65,71.37,71.45,68.47095028019966,NaN,NaN,NaN,NaN,NaN,72.18639999999996,77.92123078739306,66.45156921260687,69.77874989923552,71.77845242956309,71.98753199548948,71.5693728636367,10122,20676,53.247862246442615,49.03551375084688,NaN,NaN,NaN,NaN,1.1608976030965183,21.200955692450144,-2839007,0.33291362238180267,0.006595056982007463,-0.3263185653997952
2024-01-31T09:30:00-05:00,70.51,71.36,70.17,71.36,68.47095028019966,NaN,NaN,NaN,NaN,NaN,72.07839999999997,77.66613995100182,66.49066004899812,69.77874989923552,70.96333333333332,70.96333333333332,70.96333333333332,28905,20933.933333333334,52.67704148197317,49.43021670082134,NaN,NaN,NaN,NaN,1.169404917161053,20.25471792353928,-2867912,0.29530182753133555,0.04280871901437422,-0.25249310851696133
2024-01-31T13:30:00-05:00,71.19,72,69.47,69.5,68.47095028019966,NaN,NaN,NaN,NaN,NaN,71.93959999999997,77.4310245292117,66.44817547078824,69.77874989923552,70.6087839790969,70.92691342149901,70.29065453669479,35902,21877.966666666667,42.52983680533011,48.87706423673945,NaN,NaN,NaN,NaN,1.2665902802209779,18.813429035513373,-2903814,0.13984835019108693,-0.07768267077810265,-0.21753102096918958
2024-02-01T09:30:00-05:00,70.05,70.71,69.08,70.36,68.47095028019966,NaN,NaN,NaN,NaN,NaN,71.81039999999997,77.13798100454892,66.48281899545103,69.77874989923552,70.05,70.05,70.05,20761,22101.266666666666,47.55974470171015,48.80365150127994,NaN,NaN,NaN,NaN,1.2925481173480506,17.763961307273963,-2883053,0.09194842030143452,-0.10259549559239645,-0.19454391589383097
2024-02-01T13:30:00-05:00,70.35,70.57,70.09,70.33,68.47095028019966,NaN,NaN,NaN,NaN,NaN,71.67399999999998,76.79289831897646,66.5551016810235,69.77874989923552,70.14545777777778,70.27818302194588,70.01273253360968,10739,21963.533333333333,47.40388314554903,48.64119576986456,NaN,NaN,NaN,NaN,1.2345089661089035,16.789455559623082,-2893792,0.0569646739241986,-0.12333807348858272,-0.18030274741278132
2024-02-02T09:30:00-05:00,70.03,71.39,70,70.95,68.47095028019966,NaN,NaN,NaN,NaN,NaN,71.52839999999998,76.2951353356383,66.76166466436165,69.77874989923552,70.77999999999999,70.77999999999999,70.77999999999999,23622,21527.333333333332,50.97935706473344,48.80908260455777,NaN,NaN,NaN,NaN,1.245615468529696,15.985942181623415,-2870170,0.07326209440432169,-0.0887251294073792,-0.1619872238117009
2024-02-02T13:30:00-05:00,70.98,71.9,70.9,71.76,68.47095028019966,NaN,NaN,NaN,NaN,NaN,71.39659999999998,75.74790253602569,67.04529746397426,69.77874989923552,71.07367598621217,71.435718310974,70.71163366145034,15543,21498.233333333334,55.25860515084769,49.667037168718096,NaN,NaN,NaN,NaN,1.2280715064918606,15.634611862380071,-2854627,0.13280559607038164,0.004019771276276174,-0.12878582479410547
2024-02-05T09:30:00-05:00,71.18,71.5,69.17,69.8,68.47095028019966,NaN,NaN,NaN,NaN,NaN,71.22759999999998,75.13477199007454,67.32042800992542,69.77874989923552,70.15666666666668,70.15666666666668,70.15666666666668,26056,22067.666666666668,45.01790830034227,49.940555120860175,NaN,NaN,NaN,NaN,1.3253521131710138,15.12445873509777,-2880683,0.039255915267459224,-0.07971593070978145,-0.11897184597724067
2024-02-05T13:30:00-05:00,69.84,70.13,69.61,69.75,68.47095028019966,NaN,NaN,NaN,NaN,NaN,71.06159999999998,74.46847859484635,67.65472140515362,69.77874989923552,70.09347706753341,70.22250811138854,69.96444602367829,6249,21895.066666666666,44.789869887735215,50.228399104544124,NaN,NaN,NaN,NaN,1.267826962230227,14.650745116907062,-2886932,-0.023543311827792276,-0.14840098576198102,-0.12485767393418874
2024-02-06T09:30:00-05:00,70.33,71.4,70.32,70.91,68.47095028019966,NaN,NaN,NaN,NaN,NaN,70.95699999999997,74.03948017025762,67.87451982974231,69.06099991938842,70.87666666666667,70.87666666666667,70.87666666666667,25060,21575.866666666665,50.99227219601366,50.51854508680033,NaN,NaN,NaN,NaN,1.2951250363566396,14.008080533044845,-2861872,0.013496322170114067,-0.10798727122154617,-0.12148359339166023
2024-02-06T13:30:00-05:00,70.94,71.44,70.85,71.27,68.47095028019966,NaN,NaN,NaN,NaN,NaN,70.86439999999997,73.60676441050867,68.12203558949128,68.86656996286817,70.94813190862196,71.07869585540337,70.81756796184055,7508,21253.766666666666,52.765756389152,51.01065174988422,NaN,NaN,NaN,NaN,1.2447589623311655,13.440993039403665,-2854364,0.06008644937941303,-0.04637553166739394,-0.10646198104680697
2024-02-07T09:30:00-05:00,71.69,73,71.42,73,68.47095028019966,NaN,NaN,NaN,NaN,NaN,70.84779999999998,73.52749040003238,68.16810959996758,69.71345364543264,72.47333333333334,72.47333428700766,72.47333237965903,7057,20615.233333333334,60.216419217223134,51.336463430661595,NaN,NaN,NaN,NaN,1.2794190364503684,13.96152661542804,-2847307,0.19751355951277755,0.140429968344165,-0.05708359116861257
2024-02-07T13:30:00-05:00,72.97,73.13,72.75,72.82,69.25269321726338,NaN,NaN,NaN,NaN,NaN,70.84579999999997,73.51944347661137,68.17215652338857,70.3107629163461,72.7233300084101,72.9334892587014,72.5131707581188,9986,20427.566666666666,59.17060381967476,51.2063343956847,NaN,NaN,NaN,NaN,1.215174819561056,14.523089684479942,-2857293,0.2623294632906943,0.2708282379447553,0.008498774654061
2024-02-08T09:30:00-05:00,73.43,75.01,73.25,74.56,70.31166170738777,NaN,NaN,NaN,NaN,NaN,70.91799999999998,73.78684506378828,68.04915493621168,71.65961033307688,74.27333333333333,74.27333333333333,74.27333333333333,20035,20035.666666666668,65.422297191762,52.002246971320645,NaN,NaN,NaN,NaN,1.28480518959241,16.033106435619757,-2837258,0.4001683254778614,0.5087091815013878,0.10854085602352635
2024-02-08T13:30:00-05:00,74.59,74.78,74.5,74.64,70.95704072068834,NaN,NaN,NaN,NaN,NaN,71.00219999999997,74.05033461645401,67.95406538354594,71.95968826646151,74.44166936645068,74.62438825462664,74.25895047827473,17005,20109.233333333334,65.6824725275825,52.89043341997349,NaN,NaN,NaN,NaN,1.2130333903358093,17.435264847392443,-2820253,0.469701435885586,0.6956676508805089,0.22596621499492286
2024-02-09T09:30:00-05:00,76.3,76.8,75.82,76.8,72.4999025061116,NaN,NaN,NaN,NaN,NaN,71.10619999999997,74.55705934805026,67.65534065194969,73.4637506131692,76.47333333333334,76.47333333333334,76.47333333333334,16244,18195.233333333334,71.84284772419178,54.25941958013197,NaN,NaN,NaN,NaN,1.2806738624546798,19.567835274510077,-2804009,0.6244469799921972,1.0065249399851695,0.3820779599929722
2024-02-09T13:30:00-05:00,76.81,76.81,76.24,76.49,72.81036148310652,NaN,NaN,NaN,NaN,NaN,71.21499999999997,74.98058786911476,67.4494121308852,73.85600049053537,76.49258350897362,76.51256944815162,76.47259756979562,15070,17605.366666666665,69.9033825270025,56.214672845965715,NaN,NaN,NaN,NaN,1.2299114437079175,21.55170345282696,-2819079,0.6654371389654761,1.2138743836998174,0.5484372447343413
2024-02-12T09:30:00-05:00,76.75,78.25,76.74,77.9,73.70920868841986,NaN,NaN,NaN,NaN,NaN,71.35439999999997,75.55803682542029,67.15076317457965,75.00680039242829,77.63000000000001,77.63000000000001,77.63000000000001,16917,17141.566666666666,73.41835842923584,58.06171668364612,NaN,NaN,NaN,NaN,1.2677749120144952,23.882424497799427,-2802162,0.7412285704013838,1.474972957736071,0.7337443873346873
2024-02-12T13:30:00-05:00,77.68,77.68,76.96,77.46,73.70920868841986,NaN,NaN,NaN,NaN,NaN,71.48299999999998,76.01932670781368,66.94667329218628,75.00680039242829,77.51111575875487,77.6421604866562,77.38007103085354,13923,17237.2,70.64562460740467,59.72184107377866,NaN,NaN,NaN,NaN,1.244362418299175,26.046665468131003,-2816085,0.7151075652191774,1.627628843858659,0.9125212786394816
2024-02-13T09:30:00-05:00,74.18,75.52,73.58,75.21,NaN,NaN,NaN,78.65089662893976,78.65089662893976,78.65089662893976,71.51919999999997,76.14416156092469,66.89423843907525,75.00680039242829,74.77,74.77,74.77,17226,17150.466666666667,58.48252762074672,60.25778182777962,NaN,NaN,NaN,NaN,1.4326222455635194,25.179448126234043,-2833311,0.5093392790888001,1.5491953775004816,1.0398560984116816
2024-02-13T13:30:00-05:00,75.19,75.27,73.8,74.38,NaN,NaN,NaN,78.64994678216976,NaN,NaN,71.53319999999997,76.18837937785781,66.87802062214212,75.00680039242829,74.64906986630866,74.79064154811803,74.5074981844993,12569,16858.2,54.73855643121844,60.22063549066324,NaN,NaN,NaN,NaN,1.435292085166125,24.374174880186867,-2845880,0.29121846655650163,1.4038791816073086,1.112660715050807
2024-02-14T09:30:00-05:00,76.38,77.39,76.23,77.05,NaN,NaN,NaN,78.64994678216976,NaN,NaN,71.61179999999996,76.49845069756745,66.72514930243247,75.00680039242829,76.89,76.89,76.89,14003,16909.466666666667,62.95453451383739,61.501823077341456,NaN,NaN,NaN,NaN,1.5477712219399735,24.608384880689268,-2831877,0.29948766077328703,1.4870202910174157,1.1875326302441287
2024-02-14T13:30:00-05:00,77.15,77.95,77.14,77.87,NaN,NaN,NaN,78.64994678216976,NaN,NaN,71.71379999999996,76.89681362529848,66.53078637470145,75.00680039242829,77.30413514102145,77.68441824953364,76.92385203250926,16607,16042.866666666667,65.05266369705934,62.949165492293204,NaN,NaN,NaN,NaN,1.5015018489442615,25.0504010210281,-2815270,0.33047496947039523,1.6006263420821227,1.2701513726117275
2024-02-15T09:30:00-05:00,78.12,79.12,77.71,78.65,74.15265287850542,74.15265287850542,74.15265287850542,NaN,NaN,NaN,71.82599999999996,77.3506212539892,66.30137874601073,75.00680039242829,78.49333333333333,78.49333333333333,78.49333333333333,13480,16121.133333333333,66.96905253746996,64.09036408811151,NaN,NaN,NaN,NaN,1.4949660025911007,25.90106099374324,-2801790,0.3707712204184026,1.7336153981347309,1.3628441777163283
2024-02-15T13:30:00-05:00,78.66,78.79,78.44,78.66,74.49866865675519,NaN,NaN,NaN,NaN,NaN,71.94659999999996,77.79021478539048,66.10298521460945,75.25232886565817,78.55509284107235,78.62310923072069,78.48707645142402,11114,16039.2,66.99404171607122,65.10667018289146,NaN,NaN,NaN,NaN,1.4131827166917368,26.690959539835873,-2790676,0.36480507621376823,1.8188505229835386,1.4540454467697703
2024-02-16T09:30:00-05:00,78.37,79,77,77.9,74.49866865675519,NaN,NaN,NaN,NaN,NaN,72.07559999999997,78.14988831716364,66.00131168283629,75.25232886565817,77.96666666666667,77.96666666666667,77.96666666666667,16888,16207.833333333334,63.08766875747811,65.31175943576682,NaN,NaN,NaN,NaN,1.4550982369280412,26.321101679478488,-2807564,0.28018424841599066,1.8042757572897585,1.5240915088737679
2024-02-16T13:30:00-05:00,77.93,78.15,77.04,77.07,74.49866865675519,NaN,NaN,NaN,NaN,NaN,72.18919999999997,78.41842767604675,65.9599723239532,75.25232886565817,77.7461306580001,78.01431632804781,77.47794498795238,11420,16375.366666666667,59.038882610554005,65.30235077797248,NaN,NaN,NaN,NaN,1.4304483628617526,25.977662237718054,-2818984,0.1455943193141127,1.7060844080164088,1.560490088702296
2024-02-20T09:30:00-05:00,76.08,76.32,73.71,74.25,NaN,NaN,NaN,79.44630396034844,79.44630396034844,79.44630396034844,72.26419999999996,78.50056572372358,66.02783427627634,75.25232886565817,74.75999999999999,74.75999999999999,74.75999999999999,17564,16371.5,47.811711357765276,64.04445178982985,NaN,NaN,NaN,NaN,1.568273479800199,24.60113929053798,-2836548,-0.1405888378415634,1.3847540414003419,1.5253428792419053
2024-02-20T13:30:00-05:00,74.14,75.05,74.09,75.05,NaN,NaN,NaN,78.93079014396896,NaN,NaN,72.36119999999997,78.61696551990467,66.10543448009527,75.25232886565817,74.75360858461401,74.76589240599871,74.74132476322931,4755,16053.2,50.67724247545177,62.972649643249085,NaN,NaN,NaN,NaN,1.5248253741001843,23.322939411013625,-2831793,-0.2754451260795583,1.1810364716424573,1.4564815977220156
2024-02-21T09:30:00-05:00,72.9,73.38,72.24,72.4,NaN,NaN,NaN,77.35575422833402,NaN,NaN,72.41539999999996,78.62443755505075,66.20636244494918,75.25232886565817,72.67333333333333,72.67333333333333,72.67333333333333,27357,16322.9,42.376807061427144,60.86793245305161,NaN,NaN,NaN,NaN,1.616623561664457,23.00337311799964,-2859150,-0.5279264201114853,0.796573572582659,1.3244999926941443
2024-02-21T13:30:00-05:00,72.36,72.6,71.95,72.49,NaN,NaN,NaN,76.70276539977338,NaN,NaN,72.47079999999997,78.6318957986404,66.30970420135954,75.25232886565817,72.57262418879056,72.72347507131076,72.42177330627035,12193,16391.933333333334,42.719948068234146,58.926258563139584,NaN,NaN,NaN,NaN,1.5475790215455667,22.831256429937476,-2846957,-0.664833652400922,0.493457927192992,1.158291579593914
2024-02-22T09:30:00-05:00,74,74.3,73.36,74.24,NaN,NaN,NaN,76.70276539977338,NaN,NaN,72.59379999999996,78.64472375096821,66.5428762490317,75.25232886565817,73.96666666666665,73.96666666666665,73.96666666666665,18871,16057.466666666667,49.070675071687816,57.18713832331473,NaN,NaN,NaN,NaN,1.566323377149455,21.642015344963635,-2828086,-0.6146717861735791,0.38995184687694007,1.0046236330505192
2024-02-22T13:30:00-05:00,74.21,74.57,74.15,74.37,NaN,NaN,NaN,76.70276539977338,NaN,NaN,72.70439999999996,78.67849897474322,66.73030102525671,75.25232886565817,74.13392798038613,74.32981223373058,73.93804372704169,13759,15319.366666666667,49.51843256169712,55.67805317719275,NaN,NaN,NaN,NaN,1.484443135924493,20.3857950067315,-2814327,-0.5518718550913875,0.31478381418628487,0.8666556692776723
2024-02-23T09:30:00-05:00,75.38,76.05,74.5,75.5,NaN,NaN,NaN,76.70276539977338,NaN,NaN,72.85159999999996,78.73052147932157,66.97267852067836,75.25232886565817,75.35000000000001,75.35000000000001,75.35000000000001,13957,15092.566666666668,53.35709812308906,55.31195107021721,NaN,NaN,NaN,NaN,1.4984114833584574,19.425963780154174,-2800370,-0.4193672145498647,0.34244665109034145,0.7618138656402061
2024-02-23T13:30:00-05:00,75.5,75.53,74.85,74.93,NaN,NaN,NaN,76.70276539977338,NaN,NaN,72.97499999999997,78.7635310744631,67.18646892553683,75.16986309252653,75.29052960687295,75.39604091421698,75.18501829952892,4434,14882.4,51.240483651331616,55.06208872879672,NaN,NaN,NaN,NaN,1.4399535202614253,18.5346919269038,-2804804,-0.35765333051338033,0.31474720249848076,0.6724005330118611
2024-02-26T09:30:00-05:00,75.39,77.1,75.39,76.94,71.88824490243388,71.88824490243388,71.88824490243388,NaN,NaN,NaN,73.13419999999996,78.91231469599113,67.3560853040088,74.53089047402123,76.47666666666667,76.47666666666667,76.47666666666667,12977,14527.566666666668,57.62419709946931,54.68135034205614,NaN,NaN,NaN,NaN,1.4920996973856084,18.4722231947504,-2791827,-0.178080128052313,0.4498003729464699,0.6278805009987829
2024-02-26T13:30:00-05:00,76.91,77.55,76.81,77.16,72.92037013414144,NaN,NaN,NaN,NaN,NaN,73.27819999999996,79.09147679024758,67.46492320975233,74.20729159779198,76.69685798109694,77.02076496481772,76.37295099737617,5997,14209.366666666667,58.268206711413775,54.19674627165289,NaN,NaN,NaN,NaN,1.4383782904294933,18.61603448991334,-2785830,-0.04787624972069415,0.5680351888479152,0.6159114385686093
2024-02-27T09:30:00-05:00,78.06,78.7,77.38,77.82,73.76398967349863,NaN,NaN,NaN,NaN,NaN,73.42459999999997,79.31876825006077,67.53043174993917,75.2558332782336,77.96666666666665,77.96666666666665,77.96666666666665,22105,14077.666666666666,60.221334061272906,53.71476638049596,NaN,NaN,NaN,NaN,1.4456369839702443,19.239661832844348,-2763725,0.07274728197275537,0.7068455410345535,0.6340982590617982
2024-02-27T13:30:00-05:00,77.825,78.42,77.825,78.35,73.95903559743053,NaN,NaN,NaN,NaN,NaN,73.57059999999996,79.58272296614348,67.55847703385643,75.36466662258687,78.06254483423045,78.17664633496732,77.94844333349359,15608,14389.633333333333,61.76872110960907,53.34152919432008,NaN,NaN,NaN,NaN,1.3852343422580848,19.818744365566,-2748117,0.17258065107606868,0.849824072906884,0.6772434218308153
2024-02-28T09:30:00-05:00,78.73,80.1,78.34,78.7,75.00578397936549,NaN,NaN,NaN,NaN,NaN,73.72959999999995,79.8543771681944,67.60482283180549,76.7757332980695,79.04666666666667,79.04666666666667,79.04666666666667,14718,14044.9,62.797905044568346,53.320831786255106,NaN,NaN,NaN,NaN,1.412003317811078,21.018382738463696,-2733399,0.24226919316458373,0.980079913286545,0.7378107201219612
2024-02-28T13:30:00-05:00,78.89,79.24,78.55,78.75,75.00578397936549,NaN,NaN,NaN,NaN,NaN,73.88599999999995,80.11531649541384,67.65668350458607,76.7757332980695,78.99031296766218,79.0802851878716,78.90034074745276,5774,13987.1,62.951343169773885,53.60029325477081,NaN,NaN,NaN,NaN,1.3604316522531437,22.13233265615441,-2727625,0.2697128735088956,1.0749518120080808,0.8052389384991852
2024-02-29T09:30:00-05:00,79.8,80.46,78.77,79.49,75.45219160103343,NaN,NaN,NaN,NaN,NaN,74.06059999999997,80.4177281692308,67.70347183076913,77.20146931076448,79.57333333333332,79.57333333333332,79.57333333333332,15334,14263,65.23659760631489,54.84492798681007,NaN,NaN,NaN,NaN,1.385400819949347,23.605904224524977,-2712291,0.3126591076968921,1.1960628231203003,0.8834037154234082
2024-02-29T13:30:00-05:00,79.44,80.08,79.33,79.88,75.6291374373501,NaN,NaN,NaN,NaN,NaN,74.26159999999996,80.70588970174627,67.81731029825364,77.20146931076448,79.63665014349073,79.72621115891043,79.54708912807102,7664,14185.6,66.41246355621797,55.96887234972194,NaN,NaN,NaN,NaN,1.340015047095822,24.974220680869074,-2704627,0.34002193405126824,1.3084311329874936,0.9684091989362253
2024-03-01T09:30:00-05:00,79.99,80.56,79.07,80.55,75.72122209928872,NaN,NaN,NaN,NaN,NaN,74.48379999999996,81.01335360189576,67.95424639810416,77.42954035888927,80.06,80.06,80.06,10957,13883,68.39055896138092,57.826997485432926,NaN,NaN,NaN,NaN,1.35072825801755,26.418092622901785,-2693670,0.3732769448057438,1.435005379943405,1.0617284351376612
2024-03-01T13:30:00-05:00,80.54,80.7,80.34,80.57,76.56321200386652,NaN,NaN,NaN,NaN,NaN,74.70799999999996,81.28805227943025,68.12794772056967,78.01563228711142,80.3462467794468,80.57971429208968,80.11277926680393,16471,13865.2,68.45029058548505,59.66487909380799,NaN,NaN,NaN,NaN,1.2799619538734393,27.810270432202156,-2677199,0.3661495248317168,1.5194153411773073,1.1532658163455904
2024-03-04T09:30:00-05:00,81.45,81.45,80.42,81.16,77.01761145823622,NaN,NaN,NaN,NaN,NaN,74.92739999999996,81.62081623986036,68.23398376013957,78.78750582968914,81.01,81.01,81.01,14844,13818.533333333333,70.23706592171611,61.1767641545243,NaN,NaN,NaN,NaN,1.2621075285967651,29.375239323854295,-2662355,0.36962635029184776,1.6152987542104,1.2456724039185523
2024-03-04T13:30:00-05:00,81.25,82.14,81.25,81.38,77.82203821013456,NaN,NaN,NaN,NaN,NaN,75.15459999999996,81.93690192191636,68.37229807808356,79.52000466375131,81.24955474712327,81.53513359168247,80.96397590256407,10445,13664.366666666667,70.89888542430263,62.70393935899612,NaN,NaN,NaN,NaN,1.2419569908398536,31.062779763359245,-2651910,0.3551124615833561,1.6895629808977475,1.3344505193143914
2024-03-05T09:30:00-05:00,80.4,81.26,78.44,79.12,77.82203821013456,NaN,NaN,NaN,NaN,NaN,75.30559999999996,82.098126669807,68.51307333019291,79.52000466375131,79.60666666666667,79.60666762034099,79.60666571299235,24566,13919.333333333334,56.90121406366905,62.95709049760898,NaN,NaN,NaN,NaN,1.3632457772084352,30.19808358542253,-2676476,0.17100600440156444,1.548208024816347,1.3772020204147826
2024-03-05T13:30:00-05:00,79.08,79.22,77.6,78.21,NaN,NaN,NaN,82.54247138291457,82.54247138291457,82.54247138291457,75.41659999999996,82.21395549754699,68.61924450245293,79.52000466375131,79.02582726746273,79.65544569687977,78.3962088380457,20907,14152.133333333333,52.41395681203332,63.04091000908767,NaN,NaN,NaN,NaN,1.3815853645506901,28.827190585100464,-2697383,-0.02398253555943297,1.3472238509654915,1.3712063865249244
2024-03-06T09:30:00-05:00,80.83,81.2,79.26,81.12,NaN,NaN,NaN,82.54247138291457,NaN,NaN,75.60659999999996,82.49926347358074,68.71393652641918,79.52000466375131,80.52666666666667,80.52666666666667,80.52666666666667,9678,13900.533333333333,62.577194044157096,63.394695505136795,NaN,NaN,NaN,NaN,1.4964721242256416,28.47635478239837,-2687705,0.02826800411576791,1.4065413916696343,1.3782733875538664
2024-03-06T13:30:00-05:00,80.95,80.95,80.09,80.53,NaN,NaN,NaN,82.54247138291457,NaN,NaN,75.78819999999996,82.71163116092268,68.86476883907724,79.52000466375131,80.5247887154501,80.52644193539031,80.52313549550989,12488,13897.833333333334,59.78903392565675,63.50332602043987,NaN,NaN,NaN,NaN,1.463152686780953,28.15057867988929,-2700193,0.0093178975990853,1.389920759552723,1.3806028619536377
2024-03-07T09:30:00-05:00,81.07,81.62,80.67,81.62,NaN,NaN,NaN,82.54247138291457,NaN,NaN,75.99339999999995,82.98750793168355,68.99929206831635,79.52000466375131,81.30333333333334,81.30333333333334,81.30333333333334,30952,14462.8,63.063334064506805,63.706326020670865,NaN,NaN,NaN,NaN,1.4364989234394565,28.14079839392405,-2669241,0.053926439172456764,1.4480109109192085,1.3940844717467518
2024-03-07T13:30:00-05:00,81.66,81.83,81.52,81.71,NaN,NaN,NaN,82.54247138291457,NaN,NaN,76.23759999999996,83.16004414640068,69.31515585359924,79.52000466375131,81.45389768439502,81.64110535187125,81.26669001691879,20021,14576.6,63.328855227619535,63.81776417195733,NaN,NaN,NaN,NaN,1.3560347146223528,28.223532921452556,-2649220,0.07209328349091448,1.484201076110395,1.4121077926194805
2024-03-08T09:30:00-05:00,82.37,84.95,81.72,82.25,78.98188097686588,78.98188097686588,78.98188097686588,NaN,NaN,NaN,76.47539999999995,83.39076400777545,69.56003599222446,80.78094267405953,82.97333333333334,82.97333333333334,82.97333333333334,19715,14784.433333333332,64.95659036776456,63.97195598075706,NaN,NaN,NaN,NaN,1.4906036635778999,29.422565202103897,-2629505,0.10128828177423621,1.5387181448372758,1.4374298630630395
2024-03-08T13:30:00-05:00,82.1,82.84,81.75,82.3,78.98188097686588,NaN,NaN,NaN,NaN,NaN,76.71479999999995,83.59126797709665,69.83833202290326,80.78094267405953,82.73285824832156,83.0567304571943,82.40898603944882,10869,14776.266666666666,65.11101215337268,64.1262180510141,NaN,NaN,NaN,NaN,1.4619891161794787,30.53595231985157,-2618636,0.10436355150609833,1.5678843024456626,1.4635207509395642
2024-03-11T09:30:00-04:00,83,83.92,82.68,83.58,78.98188097686588,NaN,NaN,NaN,NaN,NaN,76.96739999999996,83.90587454128324,70.02892545871667,80.78094267405953,83.39333333333333,83.39333428700765,83.39333237965901,21809,14940.3,68.89039866766734,64.38720384111072,NaN,NaN,NaN,NaN,1.4732756078809448,31.891517458468304,-2596827,0.16916413153542287,1.6749759153588428,1.50581178382342
2024-03-11T13:30:00-04:00,83.64,83.84,82.45,82.57,78.98188097686588,NaN,NaN,NaN,NaN,NaN,77.18359999999996,84.1332207205888,70.23397927941112,80.78094267405953,83.20656497950422,83.42404062801465,82.98908933099379,16085,15095.8,63.08349314987277,64.14942024065749,NaN,NaN,NaN,NaN,1.467327350175163,32.95334871261734,-2612912,0.1227279773415817,1.659221755500397,1.5364937781588153
2024-03-12T09:30:00-04:00,82.7,83.2,81.32,81.77,78.98188097686588,NaN,NaN,NaN,NaN,NaN,77.42299999999996,84.16016409181408,70.68583590818584,80.78094267405953,82.09666666666665,82.09666666666665,82.09666666666665,12747,14935.233333333334,58.851936893190846,63.46809009292963,NaN,NaN,NaN,NaN,1.4968039680197947,33.00760469335424,-2625659,0.022127040601309433,1.564152578910452,1.5420255383091426
2024-03-12T13:30:00-04:00,81.7,82.66,81.7,82.49,78.98188097686588,NaN,NaN,NaN,NaN,NaN,77.67779999999998,84.19498134165522,71.16061865834473,80.78094267405953,82.14610281254204,82.22846875238298,82.0637368727011,4592,14929.8,61.36385439670458,62.96191607944531,NaN,NaN,NaN,NaN,1.4584608274469517,33.05798524689565,-2621067,-0.010197248152288285,1.529278978118782,1.5394762262710704
2024-03-13T09:30:00-04:00,82.29,84.04,82.28,83.38,78.98188097686588,NaN,NaN,NaN,NaN,NaN,77.92719999999997,84.34294692767901,71.51145307232093,80.78094267405953,83.23333333333332,83.23333428700764,83.233332379659,7263,14260,64.26761107057408,62.53552644722088,NaN,NaN,NaN,NaN,1.47999933977217,33.63417944847002,-2613804,0.012839680383722962,1.5555258267507241,1.5426861463670012
2024-03-13T13:30:00-04:00,83.3,83.4,82.69,82.83,78.98188097686588,NaN,NaN,NaN,NaN,NaN,78.15839999999997,84.42940675809083,71.88739324190911,80.78094267405953,83.13123784039915,83.25820767336936,83.00426800742895,4696,14010.1,61.206216368190645,61.843192943212884,NaN,NaN,NaN,NaN,1.4249993869313013,34.169216921360515,-2618500,-0.0225583865949468,1.5144881631233176,1.5370465497182644
2024-03-14T09:30:00-04:00,83,83.22,80.46,80.69,78.98188097686588,NaN,NaN,NaN,NaN,NaN,78.31219999999998,84.44529877957456,72.1791012204254,80.78094267405953,81.45666666666666,81.45666666666666,81.45666666666666,9285,13690.566666666668,51.02214079138053,61.423259138049424,NaN,NaN,NaN,NaN,1.520356573579066,32.919654705349984,-2627785,-0.1941454218686165,1.2943647723824938,1.4885101942511103
2024-03-14T13:30:00-04:00,80.62,81.03,79.75,80.72,78.98188097686588,NaN,NaN,NaN,NaN,NaN,78.47019999999998,84.4338988388097,72.50650116119026,80.78094267405953,81.01170286306814,81.48887081281435,80.53453491332192,8074,13501.066666666668,51.1448644989852,61.33260968711742,NaN,NaN,NaN,NaN,1.5031882468948472,31.292050167511704,-2619711,-0.3031713609553017,1.109545993056983,1.4127173540122848
2024-03-15T09:30:00-04:00,79.3,80.8,79.3,79.91,78.98188097686588,NaN,NaN,NaN,NaN,NaN,78.57719999999998,84.44768350990135,72.7067164900986,80.21530503634867,80.00333333333333,80.00333333333333,80.00333333333333,10331,13380.2,47.6716075484246,60.267924937422244,NaN,NaN,NaN,NaN,1.5029605149737866,29.49072871583868,-2630042,-0.42018574582805135,0.8874851717272207,1.307670917555272
2024-03-15T13:30:00-04:00,79.96,80.69,79.85,80.17,78.98188097686588,NaN,NaN,NaN,NaN,NaN,78.68779999999998,84.46503849603067,72.91056150396929,80.21530503634867,80.1157332062409,80.23232182310507,79.99914458937674,9602,13552.466666666667,48.87184726987223,59.488125890580484,NaN,NaN,NaN,NaN,1.4556061924756594,27.81807308214231,-2620440,-0.4668304577509741,0.7241328453665545,1.1909633031175286
2024-03-18T09:30:00-04:00,80.31,80.55,79.18,79.88,78.98188097686588,NaN,NaN,NaN,NaN,NaN,78.74939999999998,84.51046852589172,72.98833147410824,80.21530503634867,79.87,79.87,79.87,11765,13512.066666666668,47.561473366616156,58.380850126445445,NaN,NaN,NaN,NaN,1.449491464441683,25.850642605908718,-2632205,-0.5009593431367316,0.5647641241966141,1.0657234673333458
2024-03-18T13:30:00-04:00,79.87,80.61,79.87,80.2,78.98188097686588,NaN,NaN,NaN,NaN,NaN,78.82359999999998,84.56187815289671,73.08532184710326,80.21530503634867,80.08552360130061,80.25993593384742,79.9111112687538,17965,13911,49.18067898627068,57.370266109206234,NaN,NaN,NaN,NaN,1.3988135026958481,24.025691764984376,-2614240,-0.48538389574818286,0.4589935976481172,0.9443774933963001
2024-03-19T09:30:00-04:00,78.5,79.52,77.5,79.47,NaN,NaN,NaN,82.91047916168498,82.91047916168498,82.91047916168498,78.85499999999998,84.58989982475902,73.12010017524094,80.21530503634867,78.83,78.83,78.83,20701,13864.2,45.71292634904758,55.99571867929787,NaN,NaN,NaN,NaN,1.4917553953604306,23.69368558999066,-2634941,-0.5053734851260152,0.312660636988781,0.8180341221147962
2024-03-19T13:30:00-04:00,79.42,79.54,79,79.18,NaN,NaN,NaN,82.91047916168498,NaN,NaN,78.88939999999998,84.61103530470214,73.16776469529782,80.21530503634867,79.05893525333335,79.26253315029079,78.8553373563759,26174,14216.4,44.37434321200963,54.514528040629095,NaN,NaN,NaN,NaN,1.4237728671204002,23.37021726507298,-2661115,-0.5173750427544184,0.1713153186717733,0.6886903614261917
2024-03-20T09:30:00-04:00,79.46,80.22,79.08,79.83,NaN,NaN,NaN,82.91047916168498,NaN,NaN,78.98179999999998,84.61124926613786,73.3523507338621,79.98524402907893,79.71,79.71,79.71,7705,13982.633333333333,48.04649970392049,53.02567811464717,NaN,NaN,NaN,NaN,1.4035033766118001,22.549075144079747,-2653410,-0.4625729089884162,0.1104742251906714,0.5730471341790876
2024-03-20T13:30:00-04:00,79.88,82.23,79.74,82.13,NaN,NaN,NaN,82.91047916168498,NaN,NaN,79.1368,84.67695947784959,73.5966405221504,79.10819522326314,80.79768134676532,81.58436725552487,80.01099543800576,14729,14281.133333333333,58.48907475396288,52.697505372082176,NaN,NaN,NaN,NaN,1.4811102782823866,21.39290819931934,-2638681,-0.26241889153959286,0.24502351975459646,0.5074424112941893
2024-03-21T09:30:00-04:00,83.27,84.23,82.8,83.65,79.045527594411,79.045527594411,79.045527594411,NaN,NaN,NaN,79.2688,84.91723431757904,73.62036568242095,80.08587923398946,83.56,83.56,83.56,18693,14393.1,63.68412487257455,53.042661656323865,NaN,NaN,NaN,NaN,1.5253166869765025,21.313911078106244,-2619988,-0.030833205707890166,0.4689009041593266,0.4997341098672168
2024-03-21T13:30:00-04:00,83.45,83.63,82.64,82.64,79.045527594411,NaN,NaN,NaN,NaN,NaN,79.3642,85.07568609733094,73.65271390266905,80.08587923398946,83.43207767722474,83.67520326158855,83.18895209286093,5175,14310.133333333333,58.44966556543278,52.83450531123303,NaN,NaN,NaN,NaN,1.488508352192467,21.131874404159674,-2625163,0.046924722259134244,0.5583900126911345,0.5114652904320003
2024-03-22T09:30:00-04:00,81.89,82.31,80.89,81.58,79.045527594411,NaN,NaN,NaN,NaN,NaN,79.4228,85.16382017415052,73.68177982584947,80.08587923398946,81.59333333333332,81.59333333333332,81.59333333333332,9702,14268.3,53.48131853011664,52.0640558440575,NaN,NaN,NaN,NaN,1.507186327035862,19.862784853903477,-2634865,0.020892358537741407,0.5375807386041771,0.5166883800664357
2024-03-22T13:30:00-04:00,81.68,81.7,81.23,81.44,79.045527594411,NaN,NaN,NaN,NaN,NaN,79.47840000000001,85.24259341798991,73.7142065820101,80.08587923398946,81.54234384423192,81.608439498478,81.47624818998584,5774,13911.733333333334,52.84243808737532,51.46664310971354,NaN,NaN,NaN,NaN,1.4331015893904433,18.68434455723701,-2640639,-0.010164456938078326,0.5039828088938378,0.5141472658319162
2024-03-25T09:30:00-04:00,81.71,83.74,81.71,83.71,79.045527594411,NaN,NaN,NaN,NaN,NaN,79.5946,85.46018806599989,73.72901193400011,80.08587923398946,83.05333333333333,83.05333333333333,83.05333333333333,17768,14009.2,60.98144123777082,52.178021713027135,NaN,NaN,NaN,NaN,1.495022904433983,18.619679101416782,-2622871,0.11108128480641977,0.6529988718399409,0.5419175870335211
2024-03-25T13:30:00-04:00,83.75,83.85,83.44,83.72,79.36749517017542,NaN,NaN,NaN,NaN,NaN,79.7276,85.65937822916622,73.79582177083377,80.56180650739365,83.17566508760056,83.42157738300037,82.92975279220076,4397,13807.6,61.01336355928219,52.88291450304835,NaN,NaN,NaN,NaN,1.4175212684029839,18.610065843221843,-2618474,0.1769503197489961,0.7631054867197662,0.5861551669707701
2024-03-26T09:30:00-04:00,84.5,84.69,83.66,84.19,79.95147266244018,NaN,NaN,NaN,NaN,NaN,79.9264,85.77623932770824,74.07656067229176,81.54444520591493,84.17999999999999,84.17999999999999,84.17999999999999,5820,13182.733333333334,62.563606589536,53.94662872027059,NaN,NaN,NaN,NaN,1.3898411778027708,18.985206089246166,-2612654,0.2336101638221516,0.8781678717484596,0.644557707926308
2024-03-26T13:30:00-04:00,84.3,84.51,83.38,83.42,79.95147266244018,NaN,NaN,NaN,NaN,NaN,80.0938,85.85423455305268,74.33336544694733,81.54444520591493,84.00539508730392,84.20812924492846,83.80266092967939,4317,12629.733333333334,58.46216558884328,54.63165145733995,NaN,NaN,NaN,NaN,1.371281093674002,19.128902532583798,-2616971,0.20186131486604109,0.8968843515088594,0.6950230366428183
2024-03-27T09:30:00-04:00,84.9,85,82.3,82.9,79.95147266244018,NaN,NaN,NaN,NaN,NaN,80.3038,85.67972989537677,74.92787010462322,81.54444520591493,83.4,83.4,83.4,24099,13110.433333333332,55.8016896043119,55.22023833146108,NaN,NaN,NaN,NaN,1.4661895869830022,18.50471612036449,-2641070,0.1318582701904385,0.8598458743808663,0.7279876041904279
2024-03-27T13:30:00-04:00,82.83,83,82.51,82.92,79.95147266244018,NaN,NaN,NaN,NaN,NaN,80.5124,85.45099179928854,75.57380820071145,81.54444520591493,83.22719462457087,83.4956969033831,82.95869234575864,9982,13026.9,55.88484369179541,55.699107238998565,NaN,NaN,NaN,NaN,1.3964617593413586,17.925114451875128,-2631088,0.07570891881280506,0.8226237527064342,0.7469148338936291
2024-03-28T09:30:00-04:00,83.39,84.08,83.13,83.35,79.95147266244018,NaN,NaN,NaN,NaN,NaN,80.6946,85.35867754652581,76.03052245347418,81.54444520591493,83.52,83.52,83.52,19760,12653.833333333334,57.726340306359525,56.55720823594942,NaN,NaN,NaN,NaN,1.3795716336741184,17.977591148595355,-2611328,0.05717892201026653,0.8183884864064623,0.7612095643961958
2024-03-28T13:30:00-04:00,83.38,83.5,83.185,83.28,79.95147266244018,NaN,NaN,NaN,NaN,NaN,80.8728,85.22725710048931,76.51834289951069,81.54444520591493,83.44102667966132,83.53811559016407,83.34393776915857,13074,12422.266666666666,57.30696315547609,57.48096680333988,NaN,NaN,NaN,NaN,1.3035308026973955,18.02631950983557,-2624402,0.031160226660927548,0.8001598477223553,0.7689996210614277
2024-04-01T09:30:00-04:00,83.3,83.3,81.44,81.44,79.95147266244018,NaN,NaN,NaN,NaN,NaN,80.9916,85.06851326373281,76.9146867362672,81.54444520591493,82.06,82.06,82.06,17224,12339.233333333334,47.53188490150517,57.444208603167354,NaN,NaN,NaN,NaN,1.3432786025047245,16.821972433743575,-2641626,-0.11121658227016451,0.629978893223722,0.7411954754938865
2024-04-01T13:30:00-04:00,81.58,82.12,81.51,82.03,79.95147266244018,NaN,NaN,NaN,NaN,NaN,81.1336,84.83324703181269,77.43395296818731,81.54444520591493,82.03909663364988,82.09554394930508,81.98264931799467,2362,12055.666666666666,50.4504630109175,56.870022050092686,NaN,NaN,NaN,NaN,1.2959015594686731,15.703650148801005,-2639264,-0.16373036680761666,0.5365325169843658,0.7002628837919824
2024-04-02T09:30:00-04:00,79.22,80.13,78.5,79.9,NaN,NaN,NaN,83.63842777551396,83.63842777551396,83.63842777551396,81.1928,84.71248871350824,77.67311128649177,81.54444520591493,79.51,79.51,79.51,12424,11742.833333333334,41.47979584520794,55.28399854813792,NaN,NaN,NaN,NaN,1.455480019506625,16.144557419286794,-2651688,-0.3303777601897112,0.28729068355484344,0.6176684437445547
2024-04-02T13:30:00-04:00,79.88,80.31,79.84,80.24,NaN,NaN,NaN,83.63842777551396,NaN,NaN,81.2544,84.59274967611202,77.91605032388799,81.54444520591493,79.6409903504317,79.8940823205966,79.38789838026679,3328,11317.6,43.21549103090986,54.19584322424344,NaN,NaN,NaN,NaN,1.385088589541866,16.428124433401575,-2648360,-0.40144332935367877,0.11586428205245625,0.517307611406135
2024-04-03T09:30:00-04:00,79.65,80.96,79.56,80.76,NaN,NaN,NaN,83.63842777551396,NaN,NaN,81.31320000000001,84.50799186176451,78.11840813823551,81.42855616473194,80.42666666666666,80.42666666666666,80.42666666666666,25362,11738.1,45.86028996792574,53.6514840412298,NaN,NaN,NaN,NaN,1.3861536902888751,16.23477943315425,-2622998,-0.39647253822110695,0.021716938629751326,0.4181894768508583
2024-04-03T13:30:00-04:00,80.77,80.86,80.34,80.6,NaN,NaN,NaN,83.63842777551396,NaN,NaN,81.35820000000001,84.44637794823913,78.27002205176089,81.18484493178555,80.45089441372994,80.51099842715638,80.3907904003035,4121,11722.4,45.16326325309485,53.1029715530669,NaN,NaN,NaN,NaN,1.3242855695539553,16.055244790067448,-2627119,-0.38659657689201127,-0.0650562442641558,0.3215403326278555
2024-04-04T09:30:00-04:00,81.66,82.15,81.19,81.86,NaN,NaN,NaN,83.63842777551396,NaN,NaN,81.4214,84.41735196223163,78.42544803776838,80.86230075634276,81.73333333333333,81.73333333333333,81.73333333333333,7080,11716.3,51.4245642017475,52.420337479065246,NaN,NaN,NaN,NaN,1.3404080288715308,15.00200591472052,-2620039,-0.2826616497045228,-0.03178672950279804,0.25087492020172475
2024-04-04T13:30:00-04:00,81.88,82,79.8,79.8,NaN,NaN,NaN,83.63842777551396,NaN,NaN,81.4424,84.37725416332663,78.50754583667339,80.86230075634276,81.06225072111894,81.65802522731988,80.466476214918,8983,11859.2,42.81683004627181,51.12058508527879,NaN,NaN,NaN,NaN,1.4018074553807074,14.816402900195285,-2629022,-0.3364512263678766,-0.16968911275812104,0.16676211360975557
2024-04-05T09:30:00-04:00,79,80.77,79,80.61,NaN,NaN,NaN,83.63842777551396,NaN,NaN,81.46480000000001,84.35648529407851,78.57311470592151,80.7683406050742,80.12666666666667,80.12666666666667,80.12666666666667,7760,11808.366666666667,46.60167702243328,49.980447259057165,NaN,NaN,NaN,NaN,1.4281069228535137,15.051595928639856,-2621262,-0.3023561923630885,-0.21118312684410512,0.09117306551898342
2024-04-05T13:30:00-04:00,80.39,80.46,79.99,80.08,NaN,NaN,NaN,83.63842777551396,NaN,NaN,81.4688,84.35224693726018,78.58535306273983,80.18467248405936,80.15308004052685,80.17804005602537,80.12812002502832,8690,11828.9,44.52504293050738,48.984938497747464,NaN,NaN,NaN,NaN,1.3703849997925488,15.269989455052668,-2629952,-0.29979064361416186,-0.2835652389987189,0.01622540461544296
2024-04-08T09:30:00-04:00,81.71,82.11,81.18,81.71,NaN,NaN,NaN,83.63842777551396,NaN,NaN,81.492,84.3641476285168,78.6198523714832,79.2877379872475,81.66666666666667,81.66666666666667,81.66666666666667,16232,12025.6,51.659572451144825,48.689072986806956,NaN,NaN,NaN,NaN,1.417500356950224,14.335560626727775,-2613720,-0.17859221833639588,-0.2070148683050519,-0.028422649968656018
2024-04-08T13:30:00-04:00,81.75,81.9,81.59,81.68,NaN,NaN,NaN,83.63842777551396,NaN,NaN,81.5142,84.37463378528403,78.65376621471597,78.94766038366126,81.68911281421681,81.71682777082702,81.6613978576066,10647,12060.433333333332,51.52822191353828,48.37788571693145,NaN,NaN,NaN,NaN,1.3383931885966367,13.467876714711805,-2624367,-0.09492070022130696,-0.14707352524528972,-0.05215282502398276
2024-04-09T09:30:00-04:00,81.73,82,80.8,81.43,NaN,NaN,NaN,83.63842777551396,NaN,NaN,81.51960000000001,84.37835766024186,78.66084233975816,78.94766038366126,81.41000000000001,81.41000000000001,81.41000000000001,18081,12270.966666666667,50.378663287824025,47.85305164417891,NaN,NaN,NaN,NaN,1.3285079608397343,13.148709920438478,-2642448,-0.05298006230259357,-0.11837790290222472,-0.06539784059963115
2024-04-09T13:30:00-04:00,81.46,81.64,81.13,81.58,NaN,NaN,NaN,83.63842777551396,NaN,NaN,81.5236,84.38212482235052,78.66507517764948,78.94766038366126,81.41573945997159,81.42976219145392,81.40171672848926,3029,11773.1,51.083802060620116,47.4085401374035,NaN,NaN,NaN,NaN,1.2700431064940394,12.852340754327532,-2639419,-0.013746311366968564,-0.08258072980834186,-0.0688344184413733
2024-04-10T09:30:00-04:00,79.6,81.06,79.6,80.82,NaN,NaN,NaN,83.63842777551396,NaN,NaN,81.55760000000001,84.34039732643133,78.77480267356869,78.94766038366126,80.49333333333331,80.49333468203247,80.49333198463415,13709,11540.033333333333,47.40790047750654,47.39968410711787,NaN,NaN,NaN,NaN,1.3207543131730368,13.456342218150688,-2653128,-0.036308626255853654,-0.11422020126119037,-0.07791157500533671
2024-04-10T13:30:00-04:00,80.29,80.85,80.1,80.76,NaN,NaN,NaN,83.63842777551396,NaN,NaN,81.6086,84.23308779002706,78.98411220997293,78.94766038366126,80.51370221579444,80.54756551378178,80.4798389178071,4960,10832.9,47.11962689437407,47.16176724165049,NaN,NaN,NaN,NaN,1.2799861479463914,14.017200720272188,-2658088,-0.05166564480978855,-0.1424936310175724,-0.09082798620778385
2024-04-11T09:30:00-04:00,81.29,81.55,80.23,81.55,NaN,NaN,NaN,83.63842777551396,NaN,NaN,81.6172,84.23804273469479,78.9963572653052,78.90920950689159,81.11,81.11,81.11,5588,10762.333333333334,51.3171281779933,47.86443383684944,NaN,NaN,NaN,NaN,1.2828442802359346,13.957755427269438,-2652500,-0.007338712221463359,-0.10000137648461305,-0.09266266426314969
2024-04-11T13:30:00-04:00,81.7,82.12,81.64,82.05,NaN,NaN,NaN,83.63842777551396,NaN,NaN,81.6476,84.25250786017526,79.04269213982474,79.4415882140228,81.4442968805514,81.85000328126031,81.0385904798425,3794,10397.833333333334,53.81584437100405,48.62160193257045,NaN,NaN,NaN,NaN,1.231926831647654,13.454134471993592,-2648706,0.05358287752197098,-0.025684067360685958,-0.07926694488265694
2024-04-12T09:30:00-04:00,81.16,81.18,79.5,79.5,NaN,NaN,NaN,83.63842777551396,NaN,NaN,81.60520000000001,84.27863745765474,78.93176254234528,79.4415882140228,80.06,80.06,80.06,23292,10551.133333333333,41.98130123655171,48.34453130890087,NaN,NaN,NaN,NaN,1.3260749151013926,14.204536164287978,-2671998,-0.07305393438464672,-0.17058436286346534,-0.09753042847881863
2024-04-12T13:30:00-04:00,79.51,79.8,78.87,79.17,NaN,NaN,NaN,83.30985433629176,NaN,NaN,81.5544,84.31311030737216,78.79568969262785,79.4415882140228,79.63607000764362,80.02459124981414,79.24754876547311,27731,11303,40.73292531943656,48.028078599353854,NaN,NaN,NaN,NaN,1.297783849737007,15.19945481348631,-2699729,-0.16876848952894144,-0.3084910403899954,-0.13972255086105398
2024-04-15T09:30:00-04:00,79.21,79.35,76.49,76.49,NaN,NaN,NaN,82.10417913918756,NaN,NaN,81.4392,84.53282916976161,78.34557083023839,79.4415882140228,77.44333333333333,77.44333333333333,77.44333333333333,11075,11348.766666666666,32.325849403308226,46.66388468517962,NaN,NaN,NaN,NaN,1.409370717612935,17.06034736691754,-2710804,-0.38967091050231883,-0.6268111889889525,-0.2371402784866337
2024-04-15T13:30:00-04:00,76.41,76.52,75.72,75.78,NaN,NaN,NaN,80.22308008740633,NaN,NaN,81.3088,84.77367665581279,77.84392334418722,79.4415882140228,76.70908072870681,77.4272376437187,75.99092381369492,11577,11542.2,30.528185108279615,45.78612433246589,NaN,NaN,NaN,NaN,1.3658442377834397,19.039244269262102,-2722381,-0.5508496540058567,-0.9257023459939546,-0.3748526919880979
2024-04-16T09:30:00-04:00,75.42,75.61,74.3,75.44,NaN,NaN,NaN,79.07339462888785,NaN,NaN,81.146,84.91987228188717,77.37212771811284,79.4415882140228,75.11666666666666,75.11666666666666,75.11666666666666,18673,11572.366666666667,29.67707643888737,44.57722429078404,NaN,NaN,NaN,NaN,1.3739982207989085,21.29559685882663,-2741054,-0.6412774640420578,-1.17644952204067,-0.5351720579986123
2024-04-16T13:30:00-04:00,75,75.84,74.75,75.33,NaN,NaN,NaN,79.07339462888785,NaN,NaN,81.0012,85.08801908579275,76.91438091420724,79.4415882140228,75.18011972701765,75.26972882586924,75.09051062816607,9363,11737.9,29.391576929018527,43.49626243353483,NaN,NaN,NaN,NaN,1.3537126335989866,23.19518551117092,-2750417,-0.6664799206916279,-1.3682719588631471,-0.7017920381715193
2024-04-17T09:30:00-04:00,75.71,76,73.73,74.57,NaN,NaN,NaN,79.06892981681726,NaN,NaN,80.8572,85.31597658556672,76.3984234144333,79.4415882140228,74.76666666666667,74.76666666666667,74.76666666666667,20416,12224.433333333332,27.428269751862985,41.76545509787184,NaN,NaN,NaN,NaN,1.4191617311990588,25.25644328816518,-2770833,-0.6894416739680646,-1.5635941306316,-0.8741524566635354
2024-04-17T13:30:00-04:00,74.61,75.31,74.33,74.36,NaN,NaN,NaN,78.96647846150736,NaN,NaN,80.6946,85.48404040155015,75.90515959844984,79.4415882140228,74.72664845119527,74.77564196073845,74.6776549416521,13621,12534.566666666668,26.893697673773943,40.005846223602965,NaN,NaN,NaN,NaN,1.3877930361134119,27.17046836680271,-2784454,-0.6731242125962145,-1.7155577224088034,-1.042433509812589
2024-04-18T09:30:00-04:00,74.5,75.71,73.89,74.61,NaN,NaN,NaN,78.96647846150736,NaN,NaN,80.5192,85.53921568125031,75.49918431874968,79.4415882140228,74.73666666666666,74.73666666666666,74.73666666666666,18778,12357.2,28.675870173824293,38.455646715460134,NaN,NaN,NaN,NaN,1.4186649621053105,29.079395895521277,-2765676,-0.6021523771404365,-1.7951239812381345,-1.192971604097698
2024-04-18T13:30:00-04:00,74.61,74.64,74.07,74.36,NaN,NaN,NaN,78.44772107753046,NaN,NaN,80.3498,85.6122564454251,75.0873435545749,77.76227057121824,74.6504473904511,74.80960002589674,74.49129475500547,5511,12208.166666666666,27.942299853067652,36.80268227206352,NaN,NaN,NaN,NaN,1.358046036240646,30.851971457902806,-2771187,-0.5311811045684478,-1.856947984808258,-1.3257668802398102
2024-04-19T09:30:00-04:00,74.04,74.78,72.86,73.35,NaN,NaN,NaN,77.98850648309727,NaN,NaN,80.20299999999999,85.81706840001146,74.58893159998851,76.60081645697458,73.66333333333333,73.66333333333333,73.66333333333333,11690,11939.166666666666,25.14381843815572,35.21239069782418,NaN,NaN,NaN,NaN,1.3981856050805999,32.85750671200138,-2782877,-0.5112213715010294,-1.964793594616097,-1.4535722231150676
2024-04-19T13:30:00-04:00,73.28,73.63,72.51,72.92,NaN,NaN,NaN,77.20175618841103,NaN,NaN,80.047,86.0171259618201,74.0768740381799,75.36065316557966,73.44706227522241,73.75097214696314,73.14315240348168,5920,11700.7,24.03992986036556,33.563840909680714,NaN,NaN,NaN,NaN,1.3783152047176992,34.81628656700754,-2788797,-0.4861015833972768,-2.0611992023616637,-1.5750976189643868
2024-04-22T09:30:00-04:00,73.6,74,72.55,73.83,NaN,NaN,NaN,77.20175618841103,NaN,NaN,79.9254,86.14422974200191,73.70657025799808,72.92852253246373,73.46,73.46,73.46,10725,11484.066666666668,30.94902890275118,32.108976675734844,NaN,NaN,NaN,NaN,1.3834355472378639,36.22190017664542,-2778072,-0.3724408002120341,-2.0406486192294295,-1.6682078190173955
2024-04-22T13:30:00-04:00,73.93,74.42,73.93,74.13,NaN,NaN,NaN,77.20175618841103,NaN,NaN,79.8046,86.23092238220308,73.37827761779691,72.4044544207768,73.65563318777292,73.9697524124048,73.34151396314104,4160,11544,33.10909807505341,30.629923368881236,NaN,NaN,NaN,NaN,1.3267615795780168,37.06074421526343,-2773912,-0.24732242971199514,-1.9773608561573894,-1.7300384264453943
2024-04-23T09:30:00-04:00,74.69,76.71,74.69,76.31,NaN,NaN,NaN,77.20175618841103,NaN,NaN,79.7332,86.2334885351344,73.2329114648656,72.95383118831622,75.90333333333332,75.90333333333332,75.90333333333332,11538,11514.466666666667,46.26389077211719,30.93582262142163,NaN,NaN,NaN,NaN,1.4162786096081583,35.73840767273274,-2762374,-0.001040671360620582,-1.7313392656461701,-1.7302985942855496
2024-04-23T13:30:00-04:00,76.25,76.69,76.18,76.43,NaN,NaN,NaN,77.20175618841103,NaN,NaN,79.6578,86.22182838506978,73.0937716149302,73.43006495065298,76.09501300138312,76.34966792264345,75.8403580801228,6537,11621.433333333332,46.8831305745916,31.375122996789848,NaN,NaN,NaN,NaN,1.3515444232075748,34.51052374038282,-2755837,0.1768114388731472,-1.5092842956941155,-1.6860957345672627
2024-04-24T09:30:00-04:00,77.38,77.57,75.26,76.16,72.35413647770659,72.35413647770659,72.35413647770659,NaN,NaN,NaN,79.5916,86.22823210973748,72.95496789026252,73.80705196052239,76.33,76.33,76.33,15003,11276.133333333333,45.60958078810086,32.32396095284646,NaN,NaN,NaN,NaN,1.4200055358356045,33.86359687162567,-2770840,0.2771579919408871,-1.339648244641154,-1.616806236582041
2024-04-24T13:30:00-04:00,76.19,76.38,75.45,75.88,72.35413647770659,NaN,NaN,NaN,NaN,NaN,79.5256,86.2424434967626,72.80875650323739,73.80705196052239,76.16696662685501,76.37428528283006,75.95964797087997,9278,11448.033333333333,44.2666460967861,33.30527959488264,NaN,NaN,NaN,NaN,1.385005140418775,33.26287906492259,-2780118,0.32239535541739706,-1.2138120423102947,-1.5362073977276918
2024-04-25T09:30:00-04:00,73.42,75.33,73.28,75.15,72.35413647770659,NaN,NaN,NaN,NaN,NaN,79.432,86.2588001289036,72.6051998710964,73.80705196052239,74.58666666666667,74.58666666666667,74.58666666666667,8216,11485.9,40.88655184480462,34.10595640959102,NaN,NaN,NaN,NaN,1.4717904875317191,33.70749645864247,-2788334,0.30126717620907906,-1.159623427466343,-1.4608906036754221
2024-04-25T13:30:00-04:00,75.5,75.83,75.26,75.71,72.35413647770659,NaN,NaN,NaN,NaN,NaN,79.3036,86.16400670514483,72.44319329485518,73.80705196052239,75.02203771838482,75.52366312284666,74.52041231392299,6189,11392.766666666666,44.394246434572935,35.17757565998777,NaN,NaN,NaN,NaN,1.415234024136596,33.67569564304836,-2782145,0.3212880721170097,-1.0592805135291599,-1.3805685856461696
2024-04-26T09:30:00-04:00,75.72,76.42,75.2,76.34,72.35413647770659,NaN,NaN,NaN,NaN,NaN,79.1574,85.95232611880381,72.36247388119618,73.80705196052239,75.98666666666666,75.98666666666666,75.98666666666666,13587,11587,48.123671756834966,36.6558186603429,NaN,NaN,NaN,NaN,1.4012887366982676,33.13529775161047,-2768558,0.36978583863228454,-0.9183362873558139,-1.2881221259880984
2024-04-26T13:30:00-04:00,76.2,76.37,75.945,76.24,72.35413647770659,NaN,NaN,NaN,NaN,NaN,79.0294,85.7981593072883,72.26064069271169,73.80705196052239,76.0425409706069,76.13175867684889,75.9533232643649,5329,11474.966666666667,47.57819744529783,38.13328292973746,NaN,NaN,NaN,NaN,1.3315538269341065,32.63349970956101,-2773887,0.38616031158295727,-0.8054217365094019,-1.1915820480923591
2024-04-29T09:30:00-04:00,76.83,77.56,76.5,77.4,72.98267165061377,NaN,NaN,NaN,NaN,NaN,78.9458,85.68969334435172,72.20190665564829,74.49423454913918,77.15333333333334,77.15333333333334,77.15333333333334,4981,11099.933333333332,54.08034519957577,39.94788828871971,NaN,NaN,NaN,NaN,1.3307285535816706,31.16280388910014,-2768906,0.46107226847730254,-0.615241712495731,-1.0763139809730335
2024-04-29T13:30:00-04:00,77.39,77.42,76.5,77.01,72.98267165061377,NaN,NaN,NaN,NaN,NaN,78.85719999999999,85.58407153437629,72.13032846562369,74.50738763931135,77.07777854379717,77.1651827004284,76.99037438716593,3722,10869.1,51.75601914833562,41.648868238381716,NaN,NaN,NaN,NaN,1.3013907997544085,29.797157770100757,-2772628,0.4687791217989288,-0.4903400787243726,-0.9591192005233014
2024-04-30T09:30:00-04:00,76.2,76.55,74.76,74.79,72.98267165061377,NaN,NaN,NaN,NaN,NaN,78.6788,85.35434419055068,72.00325580944931,74.50738763931135,75.36666666666667,75.36666666666667,75.36666666666667,10773,10625.5,40.96340413067292,42.77883864499008,NaN,NaN,NaN,NaN,1.3691485997719508,29.52838120564244,-2783401,0.3161043449651153,-0.5639887693169072,-0.8800931142820225
2024-04-30T13:30:00-04:00,74.85,75.02,74.11,74.11,72.98267165061377,NaN,NaN,NaN,NaN,NaN,78.4866,85.12376398471477,71.84943601528522,74.50738763931135,74.91395531724754,75.39001965521776,74.43789097927733,9742,10849.266666666666,38.32700405707142,43.79934394475479,NaN,NaN,NaN,NaN,1.3363522712168112,29.596549519416783,-2793143,0.16846767007880603,-0.669508526683515,-0.837976196762321
2024-05-01T09:30:00-04:00,73.46,73.81,73.07,73.39,72.98267165061377,NaN,NaN,NaN,NaN,NaN,78.2706,84.85399172159671,71.68720827840329,74.50738763931135,73.42333333333333,73.42333333333333,73.42333333333333,5686,10581.833333333334,35.70657876672665,44.13916893503875,NaN,NaN,NaN,NaN,1.315184251844182,30.12610468313272,-2798829,0.028791459894189297,-0.8019868718945844,-0.8307783317887737
2024-05-01T13:30:00-04:00,73.86,76.1,73.86,74.13,72.98267165061377,NaN,NaN,NaN,NaN,NaN,78.0848,84.60041354286687,71.56918645713313,74.50738763931135,74.40741840118253,74.94093962753146,73.87389717483359,19345,11061.333333333334,40.22968086427049,44.6477819914114,NaN,NaN,NaN,NaN,1.4148139481410258,28.835597764312666,-2779484,-0.0054650598805815465,-0.8376096566395006,-0.832144596758919
2024-05-02T09:30:00-04:00,75.55,75.75,73.97,75.75,72.98267165061377,NaN,NaN,NaN,NaN,NaN,77.9418,84.34122458663228,71.54237541336772,74.50738763931135,75.15666666666665,75.15666801536581,75.1566653179675,14763,11367.166666666666,48.73278601965913,44.824131651950104,NaN,NaN,NaN,NaN,1.4408986661309524,27.637269911122615,-2764721,0.0843212234840478,-0.7267430674038593,-0.8110642908879071
2024-05-02T13:30:00-04:00,75.73,76.33,75.65,76.31,72.98267165061377,NaN,NaN,NaN,NaN,NaN,77.80959999999999,84.06365079608418,71.5555492039158,74.50738763931135,75.70280789389037,76.16659934866082,75.23901643911991,20471,11923.066666666668,51.31134713676042,45.14043283496216,NaN,NaN,NaN,NaN,1.3865487614073124,26.118104020422344,-2744250,0.17930947863774915,-0.5869274425907207,-0.7662369212284699
2024-05-03T09:30:00-04:00,78,78.1,76.25,76.47,72.98267165061377,NaN,NaN,NaN,NaN,NaN,77.67199999999998,83.73213993237843,71.61186006762154,74.50738763931135,76.94,76.94,76.94,13372,11592.4,52.05336184301768,45.600702910313366,NaN,NaN,NaN,NaN,1.4196524213067896,24.884179309681254,-2730878,0.24664303953465017,-0.4579331218101572,-0.7045761613448074
2024-05-03T13:30:00-04:00,76.38,76.79,76.31,76.69,72.98267165061377,NaN,NaN,NaN,NaN,NaN,77.54019999999998,83.38972851433378,71.69067148566619,74.50738763931135,76.84666957089958,76.99942060470558,76.69391853709358,4992,10834.433333333332,53.111490707233635,46.23247752534534,NaN,NaN,NaN,NaN,1.3525343912134478,23.738392078278814,-2725886,0.29638034775740907,-0.334100726648046,-0.6304810744054551
2024-05-06T09:30:00-04:00,77.46,78.68,77.46,78.31,73.8986294283601,NaN,NaN,NaN,NaN,NaN,77.47759999999998,83.22495077753273,71.73024922246724,75.10696641040366,78.14999999999999,78.14999999999999,78.14999999999999,10394,10811.733333333334,60.09515076935434,47.60452030567031,NaN,NaN,NaN,NaN,1.3980676489839163,23.654113093427906,-2715492,0.4211505723966208,-0.10404285890967913,-0.5251934313062999
2024-05-06T13:30:00-04:00,78.29,78.57,78.1,78.55,74.28914627252556,NaN,NaN,NaN,NaN,NaN,77.40799999999999,83.01573751168863,71.80026248831135,75.47657312832291,78.29227220102052,78.41984630659123,78.16469809544982,12927,10856.733333333334,61.02139156809875,48.79217352949359,NaN,NaN,NaN,NaN,1.3317771026279224,23.57585403606635,-2702565,0.49738105065506,0.09653288201252508,-0.4008481686425349
2024-05-07T09:30:00-04:00,78.12,78.4,77.59,77.83,74.28914627252556,NaN,NaN,NaN,NaN,NaN,77.36659999999999,82.93052898588716,71.80267101411282,75.47657312832291,77.94,77.94,77.94,5962,10433.033333333333,56.76460577378966,49.40938310213321,NaN,NaN,NaN,NaN,1.305221595297356,23.109519241344003,-2708527,0.476793039328739,0.19514313051838883,-0.2816499088103502
2024-05-07T13:30:00-04:00,77.82,77.9,77.31,77.35,74.28914627252556,NaN,NaN,NaN,NaN,NaN,77.30879999999998,82.81184009071414,71.80575990928581,75.47657312832291,77.74768139661757,77.95693571129969,77.53842708193544,5036,10288.8,54.05723971840823,49.87217183592681,NaN,NaN,NaN,NaN,1.2541343384904022,22.459962397141418,-2713563,0.41082986352461065,0.23188742059541312,-0.17894244292919753
2024-05-08T09:30:00-04:00,76.2,76.86,75.93,76.51,74.28914627252556,NaN,NaN,NaN,NaN,NaN,77.22379999999998,82.64161637193479,71.80598362806518,75.47657312832291,76.43333333333334,76.43333333333334,76.43333333333334,9656,9930.133333333333,49.59898503084846,49.552074681017714,NaN,NaN,NaN,NaN,1.265981885741087,20.87258127037071,-2723219,0.29597358902778914,0.19102454335553887,-0.10494904567225025
2024-05-08T13:30:00-04:00,76.56,76.71,76.36,76.37,74.28914627252556,NaN,NaN,NaN,NaN,NaN,77.13919999999999,82.4749778664408,71.80342213355918,75.47657312832291,76.4530074677529,76.47605209200017,76.42996284350562,7038,9710.7,48.8754899773742,49.346322597377615,NaN,NaN,NaN,NaN,1.200554608188152,19.398584509797914,-2730257,0.20049080418088525,0.14566445955385632,-0.05482634462702893
2024-05-09T09:30:00-04:00,75.54,75.81,74.85,75.58,74.28914627252556,NaN,NaN,NaN,NaN,NaN,77.01359999999998,82.19230989340033,71.83489010659963,75.47657312832291,75.41333333333334,75.41333333333334,75.41333333333334,6931,9315.8,44.89577483909041,49.627206219407434,NaN,NaN,NaN,NaN,1.2233721361747132,18.948109597827347,-2737188,0.08021787209985225,0.045445995497786384,-0.03477187660206586
2024-05-09T13:30:00-04:00,75.63,75.75,75.41,75.6,74.28914627252556,NaN,NaN,NaN,NaN,NaN,76.92959999999998,82.06083292786498,71.79836707213498,75.47657312832291,75.5024720256033,75.58910342983272,75.41584062137387,7338,9376.7,45.01783397621732,50.10512264220357,NaN,NaN,NaN,NaN,1.1602741264479484,18.52981146528325,-2729850,0.0022213367741082193,-0.03199520563443059,-0.03421654240853881
2024-05-10T09:30:00-04:00,75.99,76.1,74.08,74.08,NaN,NaN,NaN,78.88499068876854,78.88499068876854,78.88499068876854,76.79899999999998,81.88105824445198,71.71694175554798,75.47657312832291,74.75333333333333,74.75333333333333,74.75333333333333,10393,9333.466666666667,38.108912903297536,50.27671793767291,NaN,NaN,NaN,NaN,1.2216831174159517,18.88375936753836,-2740243,-0.14347272998543692,-0.21355745489033495,-0.07008472490489803
2024-05-10T13:30:00-04:00,74.05,74.15,73.88,73.91,NaN,NaN,NaN,77.67430929382452,NaN,NaN,76.67559999999999,81.73256693285589,71.61863306714409,75.47657312832291,74.49776417788658,74.86152859844367,74.13399975732949,5130,9307.133333333333,37.41726089065536,50.0758307967004,NaN,NaN,NaN,NaN,1.1537057518862415,19.316258838070553,-2745373,-0.237479924673963,-0.3669346307473518,-0.12945470607338877
2024-05-13T09:30:00-04:00,74.69,75.57,74.64,74.75,NaN,NaN,NaN,77.67430929382452,NaN,NaN,76.53639999999997,81.41127724563438,71.66152275436556,75.47657312832291,74.98666666666666,74.98666666666666,74.98666666666666,4697,9106.2,42.92903428702554,49.66127710151229,NaN,NaN,NaN,NaN,1.1898696267515096,18.585919714398027,-2740676,-0.22916567156296447,-0.41591179552709434,-0.18674612396412987
2024-05-13T13:30:00-04:00,74.73,74.86,74.65,74.81,NaN,NaN,NaN,77.67430929382452,NaN,NaN,76.39899999999997,81.06920556292785,71.7287944370721,75.44525850265835,74.87065527065526,74.97691181780344,74.76439872350709,5599,9154.166666666666,43.31307418008776,49.08997189032139,NaN,NaN,NaN,NaN,1.1198789391264012,17.907747670987824,-2735077,-0.20640962701065538,-0.4447581577274491,-0.2383485307167937
2024-05-14T09:30:00-04:00,75,76.92,75,75.75,NaN,NaN,NaN,77.67430929382452,NaN,NaN,76.28539999999998,80.73152408283917,71.83927591716079,75.24120680212667,75.89,75.89,75.89,17699,9359.533333333333,49.09273282294924,48.87849838888793,NaN,NaN,NaN,NaN,1.190601872045944,17.349674953284527,-2717378,-0.11916466337305398,-0.3873043599331112,-0.2681396965600572
2024-05-14T13:30:00-04:00,75.78,76.07,75.69,75.97,NaN,NaN,NaN,77.67430929382452,NaN,NaN,76.17319999999998,80.35446763553777,71.99193236446219,74.26537235336107,75.89312371871276,75.90038434918868,75.88586308823683,3276,9250.833333333334,50.36817003093031,48.682546912009116,NaN,NaN,NaN,NaN,1.1327017383283762,16.83146457256004,-2714102,-0.04174993734646798,-0.3203271182431422,-0.2785771808966742
2024-05-15T09:30:00-04:00,77.54,77.65,76.54,77.4,NaN,NaN,NaN,77.67430929382452,NaN,NaN,76.10479999999998,80.08691851154605,72.12268148845392,74.78879896586214,77.19666666666667,77.19666666666667,77.19666666666667,11985,9150.233333333334,57.77376127658455,48.516733376811274,NaN,NaN,NaN,NaN,1.171794471304921,17.219011131604077,-2702117,0.1027597081005171,-0.15012754577102783,-0.2528872538715449
2024-05-15T13:30:00-04:00,77.41,78.08,77.41,77.99,74.1648907412148,74.1648907412148,74.1648907412148,NaN,NaN,NaN,76.04939999999998,79.84355847850341,72.25524152149654,75.4510391726897,77.47372177815174,77.78642800679931,77.16101554950417,9408,9154.566666666668,60.39921235672273,48.47229200457013,NaN,NaN,NaN,NaN,1.1366662947831405,17.790651274474587,-2692709,0.22790666702266793,0.03199607990678999,-0.19591058711587794
2024-05-16T09:30:00-04:00,77.7,78,77.13,77.24,74.1648907412148,NaN,NaN,NaN,NaN,NaN,75.96319999999997,79.4357770027463,72.49062299725364,75.46183133815177,77.45666666666666,77.45666666666666,77.45666666666666,31841,9942.066666666668,55.66148307865496,48.39349752634622,NaN,NaN,NaN,NaN,1.1176187022986308,18.088485743225792,-2724550,0.24832194385579864,0.11449184270387036,-0.13383010115192828
2024-05-16T13:30:00-04:00,77.16,77.34,76.78,76.78,74.1648907412148,NaN,NaN,NaN,NaN,NaN,75.85779999999998,78.87504984712777,72.8405501528722,75.46183133815177,77.31463245461438,77.53694540185961,77.09231950736915,12997,10169,52.91967299604867,48.31224276046339,NaN,NaN,NaN,NaN,1.0777887949915859,18.069943178669163,-2737547,0.21996437536584992,0.14112536805538411,-0.07883900731046581
2024-05-17T09:30:00-04:00,77.31,78.21,76.89,77.85,74.1648907412148,NaN,NaN,NaN,NaN,NaN,75.82479999999998,78.71542274259274,72.93417725740723,75.64657205641713,77.64999999999999,77.64999999999999,77.64999999999999,12744,10140.9,58.09098433486299,48.918814139321576,NaN,NaN,NaN,NaN,1.102946738206472,18.54071662079255,-2724803,0.2596631652486752,0.24573994925037823,-0.013923215998297003
2024-05-17T13:30:00-04:00,77.68,77.96,77.47,77.92,74.31705109470919,NaN,NaN,NaN,NaN,NaN,75.79979999999998,78.59428740201108,73.00531259798888,75.6642576451337,77.70229942613699,77.76739955552239,77.63719929675159,8225,10237.433333333332,58.41280930978875,49.60005123449404,NaN,NaN,NaN,NaN,1.0591648283345807,18.977863388478553,-2716578,0.27552779722828424,0.33048653053705834,0.05495873330877407
2024-05-20T09:30:00-04:00,77.965,78.33,77.43,78.04,74.51377604494968,NaN,NaN,NaN,NaN,NaN,75.83079999999998,78.68889122317539,72.97270877682458,76.04340611610696,77.93333333333334,77.93333333333334,77.93333333333334,5445,10252.9,58.99414375674647,50.607077585755185,NaN,NaN,NaN,NaN,1.0477959120249671,19.59577369227399,-2711133,0.2781848901625428,0.40268984601195257,0.12450495584940977
2024-05-20T13:30:00-04:00,77.96,79.02,77.9,79.02,75.09405895199743,NaN,NaN,NaN,NaN,NaN,75.89559999999999,78.88982152820947,72.90137847179051,76.63072489288558,78.30565700907229,78.66197985310018,77.9493341650444,5945,10327,63.48350978344749,51.92605442912877,NaN,NaN,NaN,NaN,1.052953346880326,20.54853302451769,-2705188,0.32667361554097774,0.532846975275632,0.2061733597346542
2024-05-21T09:30:00-04:00,78.93,78.96,78.13,78.23,75.21069263599753,NaN,NaN,NaN,NaN,NaN,75.95139999999998,79.01281407849329,72.88998592150666,76.63072489288558,78.44,78.44,78.44,1727,10025.466666666667,57.97347705434254,53.344951868489126,NaN,NaN,NaN,NaN,1.04131382210316,21.433238118743983,-2706915,0.28764504091462445,0.5657296608779347,0.2780846199633103
2024-05-21T13:30:00-04:00,78.35,78.63,78.35,78.4,75.25270660708856,NaN,NaN,NaN,NaN,NaN,76.01279999999998,79.14424321998618,72.88135678001379,76.63072489288558,78.44973246135554,78.45972888181787,78.43973604089321,1637,9755.3,58.80213345457944,54.872442765912275,NaN,NaN,NaN,NaN,0.9955056919529336,22.25474999195411,-2705278,0.2564176165427955,0.5986066406418047,0.3421890240990092
2024-05-22T09:30:00-04:00,78,78.77,78,78.42,75.25270660708856,NaN,NaN,NaN,NaN,NaN,76.08979999999998,79.26458437692887,72.9150156230711,76.71689114515742,78.39666666666666,78.39666666666666,78.39666666666666,1304,9609.233333333334,58.90479503302029,56.013568533483316,NaN,NaN,NaN,NaN,0.9793981425277237,22.59612974043138,-2703974,0.2215597180148543,0.6191386716175771,0.3975789536027228
2024-05-22T13:30:00-04:00,78,78,77.35,77.77,75.25270660708856,NaN,NaN,NaN,NaN,NaN,76.15799999999997,79.32771923046865,72.9882807695313,76.71689114515742,77.87788645734221,78.17592242639037,77.57985048829406,3951,9096.1,54.179426760731005,56.789736574957836,NaN,NaN,NaN,NaN,0.9858697037757439,22.173306637639772,-2707925,0.14299080308851053,0.5763174574633609,0.4333266543748504
2024-05-23T09:30:00-04:00,78.12,78.12,76.18,76.67,75.25270660708856,NaN,NaN,NaN,NaN,NaN,76.19919999999998,79.34079154569719,73.05760845430277,76.71689114515742,76.99000000000001,76.99000000000001,76.99000000000001,13149,9042.3,47.2687144370851,56.659449547396115,NaN,NaN,NaN,NaN,1.054021867791762,20.64326932277559,-2721074,0.012099528573914164,0.4484510650922431,0.4363515365183289
2024-05-23T13:30:00-04:00,76.76,76.76,75.37,75.61,75.25270660708856,NaN,NaN,NaN,NaN,NaN,76.22419999999997,79.3264987348097,73.12190126519023,76.71689114515742,76.57817272471121,77.1014307825123,76.05491466691012,8145,8631.433333333332,41.74320794179335,56.04338082674348,NaN,NaN,NaN,NaN,1.0780203058066362,19.779628443609724,-2729219,-0.14219972110081358,0.25860188514231197,0.40080160624312555
2024-05-24T09:30:00-04:00,75.85,77.24,75.74,77.22,75.25270660708856,NaN,NaN,NaN,NaN,NaN,76.30159999999997,79.30472200218354,73.29847799781639,76.71689114515742,76.73333333333333,76.73333333333333,76.73333333333333,6778,8411.633333333333,51.09430260053018,55.566276635596736,NaN,NaN,NaN,NaN,1.1174474268204475,18.546113416834235,-2722441,-0.13236475016110855,0.23534566854173988,0.36771041870284843
2024-05-24T13:30:00-04:00,77.2,77.4,76.99,77.39,75.25270660708856,NaN,NaN,NaN,NaN,NaN,76.39099999999996,79.24874806447353,73.5332519355264,76.71689114515742,76.96444223657338,77.22579646085713,76.70308801228963,5300,8421.9,51.97095527982278,54.96425827296103,NaN,NaN,NaN,NaN,1.0669154677618449,17.257275045298908,-2717141,-0.11176494483390181,0.22800423766047118,0.339769182494373
2024-05-28T09:30:00-04:00,77.13,77.37,76.2,77,75.25270660708856,NaN,NaN,NaN,NaN,NaN,76.45439999999996,79.22127884808891,73.68752115191101,76.71689114515742,76.85666666666667,76.85666666666667,76.85666666666667,5721,8266.133333333333,49.76696520055268,54.54322128166801,NaN,NaN,NaN,NaN,1.07570722006457,16.730920673948564,-2722862,-0.12098098251780776,0.18854295434711332,0.3095239368649211
2024-05-28T13:30:00-04:00,76.99,77.39,76.46,77.39,75.25270660708856,NaN,NaN,NaN,NaN,NaN,76.51959999999997,79.21708315286607,73.82211684713387,76.71689114515742,76.99194417643004,77.10108615980081,76.88280219305926,8789,8128.2,51.960923018263074,54.4747391403976,NaN,NaN,NaN,NaN,1.06529956148853,16.222027632700605,-2714073,-0.09834837513917655,0.1865884679409504,0.28493684308012696
2024-05-29T09:30:00-04:00,76.32,76.86,76.08,76.69,75.25270660708856,NaN,NaN,NaN,NaN,NaN,76.52719999999998,79.22441942748303,73.82998057251693,76.71689114515742,76.54333333333334,76.54333333333334,76.54333333333334,5734,8120.6,47.91576579026734,53.74793781578363,NaN,NaN,NaN,NaN,1.0827781642393493,16.071492307109644,-2719807,-0.1262771904440188,0.12709035502510346,0.25336754546912227
2024-05-29T13:30:00-04:00,76.61,76.82,76.4,76.58,75.25270660708856,NaN,NaN,NaN,NaN,NaN,76.53019999999998,79.22731398349976,73.8330860165002,76.71689114515742,76.5803194023824,76.60729917150367,76.55333963326113,10776,8311.933333333332,47.292702718333594,52.953644487822544,NaN,NaN,NaN,NaN,1.0354368667936806,15.93170950477518,-2730583,-0.14649261838815525,0.07025177248392822,0.21674439087208347
2024-05-30T09:30:00-04:00,76.11,76.21,75.39,76.12,75.25270660708856,NaN,NaN,NaN,NaN,NaN,76.52939999999998,79.22697642338265,73.83182357661731,75.82251291612593,75.90666666666667,75.90666666666667,75.90666666666667,6712,8213.8,44.67643649804086,51.93095111220072,NaN,NaN,NaN,NaN,1.0464770905941319,16.61934237903249,-2737295,-0.18281601445699214,-0.011775627199156702,0.17104038725783544
2024-05-30T13:30:00-04:00,76.17,76.27,75.1,75.46,NaN,NaN,NaN,78.95535905944303,78.95535905944303,78.95535905944303,76.52099999999997,79.22920752528228,73.81279247471767,75.40801033290076,75.75364641946808,75.90190568770011,75.60538715123606,7150,8217.533333333333,41.158275148301335,50.336291495404566,NaN,NaN,NaN,NaN,1.0553001555516939,17.468271559535033,-2744445,-0.23967829852639627,-0.12855748590015992,0.11112081262623635
2024-05-31T09:30:00-04:00,75.78,76.37,73.48,74.18,NaN,NaN,NaN,78.4407972840138,NaN,NaN,76.50159999999998,79.2622038759645,73.74099612403546,74.72718322588491,74.67666666666668,74.67666666666668,74.67666666666668,17888,8582.766666666666,35.34505687494858,48.719975768305,NaN,NaN,NaN,NaN,1.1863501444408586,19.238530537368444,-2762333,-0.34545382104145983,-0.32069646367558846,0.024757357365871382
2024-05-31T13:30:00-04:00,74.19,74.9,73.91,74.89,NaN,NaN,NaN,77.89598831655861,NaN,NaN,76.48519999999999,79.2740183590867,73.69638164091329,74.72718322588491,74.63620090936935,74.68924575631445,74.58315606242425,10410,8685.166666666666,40.375617857130415,47.40379608277293,NaN,NaN,NaN,NaN,1.1723251341236551,20.88234244535661,-2751923,-0.3485577759979379,-0.410939862631551,-0.062382086633613096
2024-06-03T09:30:00-04:00,76.3,76.37,74.52,74.78,NaN,NaN,NaN,77.89598831655861,NaN,NaN,76.454,79.28323028401387,73.62476971598612,74.72718322588491,75.22333333333333,75.22333333333333,75.22333333333333,29306,9315.6,39.85818827049449,46.04332417116394,NaN,NaN,NaN,NaN,1.2207304816862516,20.6986686816383,-2781229,-0.33868251769261415,-0.48573523374938077,-0.14705271605676662
2024-06-03T13:30:00-04:00,75.05,75.47,75.01,75.43,NaN,NaN,NaN,77.89598831655861,NaN,NaN,76.43779999999998,79.2809877602421,73.59461223975786,74.72718322588491,75.23087667789555,75.25425541863498,75.20749793715612,3051,9246.3,44.393073720530516,45.34429895400676,NaN,NaN,NaN,NaN,1.1828211615658049,20.528114472471295,-2778178,-0.2719164668547333,-0.48694829962518327,-0.21503183277044996
2024-06-04T09:30:00-04:00,75.27,76.04,75.23,75.8,NaN,NaN,NaN,77.89598831655861,NaN,NaN,76.40579999999999,79.24095386530983,73.57064613469014,74.72718322588491,75.69,75.69,75.69,6431,9304.1,46.849859460332645,45.31438074138158,NaN,NaN,NaN,NaN,1.156191078596819,19.77514606675454,-2771747,-0.19024154936378157,-0.45283376947517695,-0.2625922201113954
2024-06-04T13:30:00-04:00,75.82,76.39,75.81,75.85,NaN,NaN,NaN,77.89598831655861,NaN,NaN,76.38259999999998,79.21658182068717,73.5486181793128,74.38179726456634,75.84218217054263,76.00513440080253,75.67922994028272,5609,9304.433333333332,47.189416176721174,45.703395615305,NaN,NaN,NaN,NaN,1.1157488586970465,18.72668832010584,-2766138,-0.12349163067244018,-0.4169567584519456,-0.2934651277795054
2024-06-05T09:30:00-04:00,76.74,77.25,75.97,77.07,NaN,NaN,NaN,77.89598831655861,NaN,NaN,76.42819999999998,79.23141726592623,73.62498273407373,74.4085224612467,76.76333333333334,76.76333333333334,76.76333333333334,19954,9379.6,54.78056565218624,45.966700118994716,NaN,NaN,NaN,NaN,1.136052511647258,17.81519525092168,-2746184,0.00535257595252564,-0.28677440783884833,-0.292126983791374
2024-06-05T13:30:00-04:00,77.23,77.49,77.11,77.47,NaN,NaN,NaN,77.89598831655861,NaN,NaN,76.49539999999998,79.23344078859077,73.75735921140918,75.00681796899735,76.89153846153847,77.1357347374503,76.64734218562664,5500,9453.733333333334,56.96478091095633,46.32340194978997,NaN,NaN,NaN,NaN,1.084905903672454,17.174774285850944,-2740684,0.114019369137984,-0.14960277236889397,-0.26362214150687796
2024-06-06T09:30:00-04:00,77.3,78.64,77.3,78.63,74.61086416973352,74.61086416973352,74.61086416973352,NaN,NaN,NaN,76.60019999999997,79.25462570813197,73.94577429186798,75.9834543751979,78.19,78.19,78.19,9978,9386.833333333334,62.605796272081434,47.24046131204203,NaN,NaN,NaN,NaN,1.1031269105529933,17.469590330767716,-2730706,0.25258440891429285,0.05210836963598808,-0.20047603927830476
2024-06-06T13:30:00-04:00,78.72,78.86,78.24,78.27,75.2590067074729,NaN,NaN,NaN,NaN,NaN,76.68299999999998,79.28174200335256,74.0842579966474,76.4247635001583,78.30171674819474,78.43328612542379,78.17014737096568,7194,9313.033333333333,59.97821593977694,47.81312509215015,NaN,NaN,NaN,NaN,1.068617845513494,17.897234263242108,-2737900,0.3050467421121806,0.18083238836192095,-0.12421435375025962
2024-06-07T09:30:00-04:00,78,78.35,77.78,77.78,75.2590067074729,NaN,NaN,NaN,NaN,NaN,76.72359999999998,79.32619488971807,74.12100511028189,76.4247635001583,77.97,77.97,77.97,3195,8358.166666666666,56.50217496541803,48.426440033232346,NaN,NaN,NaN,NaN,1.0330022851196725,17.78230549657365,-2741095,0.291799845191018,0.24053545273851284,-0.05126439245250512
2024-06-07T13:30:00-04:00,77.7,77.7,76.84,76.95,75.2590067074729,NaN,NaN,NaN,NaN,NaN,76.73639999999997,79.33702687827197,74.13577312172798,76.4247635001583,77.24292384658145,77.4834822890038,77.0023654041591,29187,8897.833333333334,51.09988420017141,48.698381567649335,NaN,NaN,NaN,NaN,1.0263592647539814,16.734466856778855,-2770282,0.2156990234863963,0.21835938690549028,0.002660363419093967
2024-06-10T09:30:00-04:00,76.6,77.56,76.6,77.46,75.2590067074729,NaN,NaN,NaN,NaN,NaN,76.75619999999998,79.36347870393415,74.14892129606581,76.4247635001583,77.20666666666666,77.20666666666666,77.20666666666666,2673,8562.133333333333,54.00963888713377,49.36503888115597,NaN,NaN,NaN,NaN,1.0216193172715546,15.539339786879957,-2767609,0.18921595804448726,0.23918031097470305,0.04996435293021578
2024-06-10T13:30:00-04:00,77.43,77.88,77.43,77.62,75.2590067074729,NaN,NaN,NaN,NaN,NaN,76.77479999999997,79.39316969123803,74.15643030876191,76.4247635001583,77.43898984593838,77.65687451417834,77.22110517769842,3039,8389.266666666666,54.916004410627075,50.347733828464946,NaN,NaN,NaN,NaN,0.9807893660378714,14.726187505209696,-2764570,0.17245318324502396,0.26553083198649574,0.09307764874147179
2024-06-11T09:30:00-04:00,76.81,76.81,76,76.48,75.2590067074729,NaN,NaN,NaN,NaN,NaN,76.73819999999996,79.32062270745877,74.15577729254116,76.4247635001583,76.43,76.43,76.43,10438,8555.7,47.70248631735345,51.23040736006529,NaN,NaN,NaN,NaN,1.026447268463738,14.617941625276988,-2775008,0.07930561200979472,0.19220966375371518,0.11290405174392046
2024-06-11T13:30:00-04:00,76.66,77.2,76.66,77.18,75.2590067074729,NaN,NaN,NaN,NaN,NaN,76.71079999999998,79.24435667787091,74.17724332212904,76.4247635001583,76.60347648537068,76.87012330325695,76.33682966748441,4418,8504.8,51.88206979891945,52.0522967844788,NaN,NaN,NaN,NaN,1.0045581778591852,14.139918520606045,-2770590,0.060408227684119103,0.18841433634906934,0.12800610866495024
2024-06-12T09:30:00-04:00,78.91,79.4,78.89,79.24,75.84853061955303,NaN,NaN,NaN,NaN,NaN,76.73899999999998,79.35190413141964,74.12609586858031,76.43236525038841,79.17666666666668,79.17666666666668,79.17666666666668,11188,8820.166666666666,61.60648868937971,53.605746814399176,NaN,NaN,NaN,NaN,1.0913754508692433,14.267050868956064,-2759402,0.17569439438279752,0.34762410164344715,0.17192970726064963
2024-06-12T13:30:00-04:00,79.07,79.34,78.23,78.34,75.84853061955303,NaN,NaN,NaN,NaN,NaN,76.75879999999997,79.40471954526215,74.11288045473778,76.43236525038841,78.91338173101879,79.18329821423907,78.6434652477985,10645,9120.433333333332,56.257213841600205,54.45318539447557,NaN,NaN,NaN,NaN,1.0927057758071543,13.833442782800235,-2770047,0.1797399919720611,0.396604697225726,0.2168647052536649
2024-06-13T09:30:00-04:00,79,79,77.01,77.33,75.84853061955303,NaN,NaN,NaN,NaN,NaN,76.77519999999997,79.42491014263773,74.12548985736221,76.43236525038841,77.77999999999999,77.77999999999999,77.77999999999999,3457,9192.2,50.91437114494383,54.743507657662086,NaN,NaN,NaN,NaN,1.1567982203923572,13.164853733319179,-2773504,0.10642047220151593,0.34989029550555983,0.2434698233040439
2024-06-13T13:30:00-04:00,77.26,77.3,77.11,77.18,75.84853061955303,NaN,NaN,NaN,NaN,NaN,76.79139999999995,79.44090715417255,74.14189284582736,76.43236525038841,77.51254751461987,77.80320731209977,77.22188771713996,2927,9158.066666666668,50.152569466946225,54.95516146410673,NaN,NaN,NaN,NaN,1.089884061792903,12.544021044515343,-2776431,0.04309416316277381,0.29733752725751117,0.25424336409473736
2024-06-14T09:30:00-04:00,77,77.1,76.23,76.5,75.84853061955303,NaN,NaN,NaN,NaN,NaN,76.80979999999995,79.43809371265954,74.18150628734037,76.43236525038841,76.61,76.61,76.61,4122,8857.166666666666,46.738453885268804,54.38072490932692,NaN,NaN,NaN,NaN,1.0798923430934102,12.576309158016926,-2780553,-0.044570507366623324,0.1985302298864582,0.2431007372530815
2024-06-14T13:30:00-04:00,76.66,76.81,76.3,76.76,75.84853061955303,NaN,NaN,NaN,NaN,NaN,76.83299999999997,79.43854869461263,74.2274513053873,76.43236525038841,76.61905529176721,76.62527935102504,76.61283123250938,8725,8876.5,48.19070537169909,53.7540052279514,NaN,NaN,NaN,NaN,1.039185747158167,12.606290977696968,-2771828,-0.08280427528722617,0.13959539314404878,0.22239966843127495
2024-06-17T09:30:00-04:00,76.56,77.5,76,77.38,75.84853061955303,NaN,NaN,NaN,NaN,NaN,76.89899999999996,79.38678536051836,74.41121463948156,76.43236525038841,76.96,76.96,76.96,4827,8811.466666666667,51.58106901286095,52.96652470943565,NaN,NaN,NaN,NaN,1.0721010509325837,12.028438918123394,-2767001,-0.06488834712833619,0.14128923452085473,0.20617758164919092
2024-06-17T13:30:00-04:00,77.5,78.1,77.5,77.69,75.84853061955303,NaN,NaN,NaN,NaN,NaN,76.97459999999995,79.32013604960812,74.62906395039178,76.43236525038841,77.43568736797636,77.83047471185522,77.0409000240975,7008,8868.4,53.22911335693871,52.48444595351864,NaN,NaN,NaN,NaN,1.0469509758659705,11.336857303734845,-2759993,-0.03235364194075996,0.16573552922324097,0.19808917116400093
2024-06-18T09:30:00-04:00,77,77.43,76.8,77.04,75.84853061955303,NaN,NaN,NaN,NaN,NaN,77.02039999999995,79.27818284164199,74.76261715835791,76.43236525038841,77.09000000000002,77.09000000000002,77.09000000000002,4131,8815.4,49.43001298961056,51.97929152667525,NaN,NaN,NaN,NaN,1.035740191875544,10.916619591798638,-2764124,-0.05355291030186979,0.1311480332866637,0.18470094358853348
2024-06-18T13:30:00-04:00,77.01,77.22,76.75,76.75,75.84853061955303,NaN,NaN,NaN,NaN,NaN,77.05919999999995,79.22865648493269,74.88974351506721,76.43236525038841,77.03255596187945,77.11759471464137,76.94751720911754,1885,8585.266666666666,47.79112922859032,51.74295188584803,NaN,NaN,NaN,NaN,0.9953301781701479,10.5657582311338,-2766009,-0.0842238747160384,0.07942110019348547,0.16364497490952387
2024-06-20T09:30:00-04:00,77,77.17,76.07,76.07,75.84853061955303,NaN,NaN,NaN,NaN,NaN,77.06559999999995,79.22141505700584,74.90978494299405,76.41089220031073,76.43666666666667,76.43666666666667,76.43666666666667,7939,8658.766666666666,44.09896176796427,51.035046377335924,NaN,NaN,NaN,NaN,1.0028065940151378,10.767989365592605,-2773948,-0.14392061772472892,-0.01625579724638726,0.12766482047834166
2024-06-20T13:30:00-04:00,76.01,76.71,76,76.67,75.84853061955303,NaN,NaN,NaN,NaN,NaN,77.07959999999996,79.21577587291225,74.94342412708767,75.66171376024857,76.44523133753222,76.4564780585325,76.43398461653194,4604,8453.033333333333,47.92205556369017,50.53547860255471,NaN,NaN,NaN,NaN,0.9818918372997704,11.009242847045284,-2769344,-0.13666612063444544,-0.04316783031471516,0.09349829031973028
2024-06-21T09:30:00-04:00,76,76.25,75.52,75.89,NaN,NaN,NaN,78.96663079075876,78.96663079075876,78.96663079075876,77.04939999999995,79.20916817274797,74.88963182725193,75.59465436495825,75.88666666666666,75.88666666666666,75.88666666666666,3994,8362.433333333332,43.73461705171209,50.25205936929462,NaN,NaN,NaN,NaN,0.99389956320693,11.601202748683361,-2773338,-0.1755850623708745,-0.12598303764386287,0.04960202472701165
2024-06-21T13:30:00-04:00,75.81,76.65,75.81,76.64,NaN,NaN,NaN,78.96663079075876,NaN,NaN,77.02239999999995,79.16816628737106,74.87663371262883,75.59465436495825,76.0949274746043,76.33281951668813,75.85703543252048,3061,8226.133333333333,48.403220080359,50.00357010368316,NaN,NaN,NaN,NaN,0.982906737263578,11.715500424901515,-2770277,-0.14336320628401888,-0.12960198312801197,0.013761223156006926
2024-06-24T09:30:00-04:00,75.93,76.63,75,75.13,NaN,NaN,NaN,78.95582474943102,NaN,NaN,76.98019999999995,79.18924862780668,74.77115137219323,75.59465436495825,75.58666666666666,75.58666666666666,75.58666666666666,7058,7865.133333333333,41.022940375517315,48.53331665269299,NaN,NaN,NaN,NaN,1.0298419703161796,12.443193111193427,-2777335,-0.21214196576938543,-0.2514162340557249,-0.03927426828633944
2024-06-24T13:30:00-04:00,75.12,75.76,75.08,75.19,NaN,NaN,NaN,78.51078726082052,NaN,NaN,76.94839999999995,79.21313613474518,74.68366386525472,75.59465436495825,75.495751390368,75.61346770090961,75.37803507982639,4210,7658.466666666666,41.40525089878209,47.47246215677741,NaN,NaN,NaN,NaN,1.0048532581507388,13.118907748464483,-2773125,-0.23994321151898973,-0.3392032826850766,-0.09926007116608687
2024-06-25T09:30:00-04:00,75.4,76.56,75.4,76.1,NaN,NaN,NaN,78.51078726082052,NaN,NaN,76.91339999999995,79.17540834658423,74.65139165341567,75.59465436495825,76.02,76.02,76.02,9334,6992.733333333334,47.01520396670203,47.19395021547443,NaN,NaN,NaN,NaN,1.0309351682828292,12.849447482122125,-2763791,-0.1858112649242106,-0.33152415232135013,-0.14571288739713953
2024-06-25T13:30:00-04:00,76.16,76.53,76.16,76.5,NaN,NaN,NaN,78.51078726082052,NaN,NaN,76.88499999999995,79.13134547655021,74.63865452344969,75.02557879357329,76.1551300723642,76.33579234697024,75.97446779775817,5222,7065.1,49.31243786091152,47.133940815043374,NaN,NaN,NaN,NaN,0.9880112276911991,12.599234377661364,-2758569,-0.11528637385546209,-0.2898208547164671,-0.17453448086100504
2024-06-26T09:30:00-04:00,76.3,77.15,76.3,76.9,NaN,NaN,NaN,78.51078726082052,NaN,NaN,76.86219999999994,79.08420014401929,74.6401998559806,75.02557879357329,76.78333333333333,76.78333333333333,76.78333333333333,5323,7028.166666666667,51.57354584022448,47.47930452611164,NaN,NaN,NaN,NaN,0.9781532828561141,11.70505089052489,-2753246,-0.037920973135186886,-0.22193569727998863,-0.18401472414480174
2024-06-26T13:30:00-04:00,76.89,77.19,76.88,76.97,NaN,NaN,NaN,78.51078726082052,NaN,NaN,76.82119999999995,78.95638201566537,74.68601798433453,75.1990286299187,76.8798229734642,76.99332348701536,76.76632245991304,3847,6969.433333333333,51.97727436645763,47.74977374002297,NaN,NaN,NaN,NaN,0.9304280483663918,10.905055172135611,-2749399,0.018702904874544013,-0.16063609305162174,-0.17933899792616576
2024-06-27T09:30:00-04:00,77.02,78.23,77.02,78.19,NaN,NaN,NaN,78.51078726082052,NaN,NaN,76.82039999999995,78.95349900380134,74.68730099619856,76.00722290393496,77.81333333333333,77.81333333333333,77.81333333333333,6439,6518.933333333333,58.47501955581846,48.242198778805644,NaN,NaN,NaN,NaN,0.953968902054507,11.162898330510087,-2742960,0.1327057667144683,-0.013456789533080382,-0.14616255624754868
2024-06-27T13:30:00-04:00,78.25,78.3,77.97,78.12,NaN,NaN,NaN,78.51078726082052,NaN,NaN,76.81479999999995,78.93269797677392,74.69690202322597,76.35677832314796,77.94065868078125,78.09592602846317,77.78539133309934,4330,6479.933333333333,57.99018534135944,48.58227534912141,NaN,NaN,NaN,NaN,0.9093996947648992,11.464016477990722,-2747290,0.19406919599431577,0.09642393874534605,-0.09764525724896972
2024-06-28T09:30:00-04:00,78.39,78.77,77.77,78.15,75.38159826587697,75.38159826587697,75.38159826587697,NaN,NaN,NaN,76.80939999999995,78.91222252223409,74.70657747776582,76.71542265851836,78.23,78.23,78.23,4785,6306.833333333333,58.15033380650488,49.20515540747101,NaN,NaN,NaN,NaN,0.915871145138835,12.155139110394131,-2742505,0.2251619198076121,0.18380714251054542,-0.041354777297066686
2024-06-28T13:30:00-04:00,78.06,78.115,77.64,77.98,75.38159826587697,NaN,NaN,NaN,NaN,NaN,76.81359999999995,78.9249020058761,74.7022979941238,76.71542265851836,78.04725728443417,78.20466820430926,77.88984636455908,6449,6282,56.828280755702124,49.85066623083613,NaN,NaN,NaN,NaN,0.88688034905749,12.624906876785538,-2748954,0.22237489759056134,0.236613844691135,0.014238947100573662
2024-07-01T09:30:00-04:00,78.75,79.03,78.28,78.87,75.81364635382593,NaN,NaN,NaN,NaN,NaN,76.85759999999995,79.04540825485738,74.66979174514252,76.98607050145176,78.72666666666667,78.72666666666667,78.72666666666667,9285,6485,61.733327382713746,51.11026377474682,NaN,NaN,NaN,NaN,0.8985317526962405,13.821181243063856,-2739669,0.2656386935047003,0.3462873139814491,0.08064862047674874
2024-07-01T13:30:00-04:00,78.96,79.5,78.96,79.29,76.43188970137928,NaN,NaN,NaN,NaN,NaN,76.93119999999995,79.19253638365082,74.66986361634908,77.5498564011614,78.97598263125248,79.23735765798894,78.71460760451602,8448,5793.7,63.82228166953918,52.24599421087889,NaN,NaN,NaN,NaN,0.8793509132179373,15.272724094763248,-2731221,0.3048985440890323,0.4617718005880391,0.15687325649900682
2024-07-02T09:30:00-04:00,79.27,79.83,78.7,79.41,76.43998562404387,NaN,NaN,NaN,NaN,NaN,76.97499999999995,79.33949825544777,74.61050174455214,77.70488512092913,79.31333333333333,79.31333333333333,79.31333333333333,6585,5924.1,64.4199110012073,53.723515207271404,NaN,NaN,NaN,NaN,0.8972544194166557,16.84914221720892,-2724636,0.3197505084665786,0.5565613920822301,0.23681088361565147
2024-07-02T13:30:00-04:00,79.37,79.77,79.37,79.63,76.81884991386005,NaN,NaN,NaN,NaN,NaN,77.01979999999995,79.49628295774902,74.54331704225088,77.8699080967433,79.36158350050151,79.46656509071384,79.25660191028918,1391,5869.166666666667,65.54370178733281,54.9478353291981,NaN,NaN,NaN,NaN,0.8617362466011798,18.31295904519419,-2723245,0.3241785084087571,0.6420340191265979,0.31785551071784074
2024-07-03T09:30:00-04:00,79.54,80.58,79.44,80.21,77.22844764504823,NaN,NaN,NaN,NaN,NaN,77.08399999999995,79.7166108713633,74.45138912863659,78.48992647739465,80.07666666666665,80.07666666666665,80.07666666666665,13412,5968.3,68.3792713528032,56.901858970432805,NaN,NaN,NaN,NaN,0.8816122289868098,20.216021860138977,-2709833,0.34407633689382383,0.7479509318351205,0.4038745949412967
2024-07-05T09:30:00-04:00,79.3,80.35,78.95,80.15,77.22844764504823,NaN,NaN,NaN,NaN,NaN,77.13919999999995,79.90741051223004,74.37098948776985,78.48992647739465,79.81666666666668,79.81666666666668,79.81666666666668,4329,5965.333333333333,67.75805828754139,58.784202355344185,NaN,NaN,NaN,NaN,0.9186399269163228,21.223671117855858,-2714162,0.3309997527458475,0.817624285873606,0.48662453312775855
2024-07-05T13:30:00-04:00,80.17,80.64,80.17,80.54,77.62151944517825,NaN,NaN,NaN,NaN,NaN,77.21619999999994,80.13995892303413,74.29244107696576,78.49735294553258,80.2382693644297,80.53704387330511,79.93949485555429,8620,5879.733333333334,69.68584765809211,60.403534047586334,NaN,NaN,NaN,NaN,0.8880227892794422,22.368870739478037,-2705542,0.3259044750561382,0.8940051269479312,0.568100651891793
2024-07-08T09:30:00-04:00,80.74,80.85,79.91,80.2,77.62151944517825,NaN,NaN,NaN,NaN,NaN,77.28859999999995,80.3229474026591,74.2542525973408,78.66588235642605,80.32,80.32,80.32,9937,5856.133333333333,65.98192129814905,61.594211435960446,NaN,NaN,NaN,NaN,0.8917354471880533,23.026966170439916,-2715479,0.27874913169766,0.9165370665138681,0.6377879348162081
2024-07-08T13:30:00-04:00,80.33,80.52,80.23,80.38,77.67282040356118,NaN,NaN,NaN,NaN,NaN,77.37379999999995,80.50964410327083,74.23795589672906,78.66588235642605,80.34878093068554,80.37711072835395,80.32045113301712,10256,6082.766666666666,66.98247531333622,62.69484925546842,NaN,NaN,NaN,NaN,0.8508972009603347,23.638054784904522,-2705223,0.24025317456515283,0.9381044030226491,0.6978512284574963
2024-07-09T09:30:00-04:00,80.56,81.05,80.1,80.57,77.86610129430838,NaN,NaN,NaN,NaN,NaN,77.47599999999994,80.68785055692487,74.26414944307501,79.04916470811268,80.57333333333332,80.57333333333332,80.57333333333332,12152,6390.266666666666,68.05068875125352,63.84295028295384,NaN,NaN,NaN,NaN,0.857975972320311,24.640597052296847,-2693071,0.20929336569843016,0.959467935580534,0.7501745698821038
2024-07-09T13:30:00-04:00,80.61,80.96,80.46,80.75,78.05605123547619,NaN,NaN,NaN,NaN,NaN,77.60739999999994,80.80667444274786,74.40812555725202,79.10933176649014,80.62457405501074,80.69571122316958,80.5534368868519,6305,6463.033333333334,69.07156945650769,64.59984670443164,NaN,NaN,NaN,NaN,0.8324062600117174,25.57152915773258,-2686766,0.1835648343504216,0.9796306128201309,0.7960657784697093
2024-07-10T09:30:00-04:00,81.02,81.02,79.64,80.33,78.05605123547619,NaN,NaN,NaN,NaN,NaN,77.71619999999996,80.90842026809099,74.52397973190892,79.10933176649014,80.33,80.33,80.33,4922,6336.266666666666,63.93784058381884,65.02467922175018,NaN,NaN,NaN,NaN,0.8715200985823087,25.081356209678816,-2691688,0.12375491885267231,0.9507594270355497,0.8270045081828774
2024-07-10T13:30:00-04:00,80.37,80.66,80.33,80.6,78.05605123547619,NaN,NaN,NaN,NaN,NaN,77.83259999999994,81.01248631243733,74.65271368756255,79.10933176649014,80.45784049259639,80.55388687187761,80.36179411331517,8720,6466.033333333334,65.70263266495056,65.56412914021057,NaN,NaN,NaN,NaN,0.8328400915407151,24.62619561505747,-2682968,0.08947091217864078,0.9388431484061783,0.8493722362275375
2024-07-11T09:30:00-04:00,81.48,82.19,79.26,79.76,78.05605123547619,NaN,NaN,NaN,NaN,NaN,77.91919999999995,81.06833788837828,74.77006211162161,79.20385786444295,80.40333333333332,80.40333333333332,80.40333333333332,8081,6501.8,56.44742517908081,65.53692517045191,NaN,NaN,NaN,NaN,0.982637227859235,25.53691295267107,-2691049,0.001941745773229031,0.8517994184440738,0.8498576726708448
2024-07-11T13:30:00-04:00,79.91,79.93,79.31,79.5,78.05605123547619,NaN,NaN,NaN,NaN,NaN,77.99319999999994,81.1134241970767,74.8729758029232,79.20385786444295,79.89293714626153,80.29258940291194,79.49328488961112,13180,6803.433333333333,53.91580679284594,64.97853084260421,NaN,NaN,NaN,NaN,0.9567345687264329,26.3825790518837,-2704229,-0.07736221230073381,0.7531549072949275,0.8305171195956613
2024-07-12T09:30:00-04:00,79.83,81.07,79.77,81.02,78.05605123547619,NaN,NaN,NaN,NaN,NaN,78.09659999999994,81.26811221975055,74.92508778024933,79.20385786444295,80.61999999999999,80.61999999999999,80.61999999999999,6793,6967.033333333334,64.06308960528506,64.9957314094432,NaN,NaN,NaN,NaN,1.0005392423888302,27.908493898236227,-2697436,-0.0335817588894709,0.7885399209838226,0.8221216798732935
2024-07-12T13:30:00-04:00,81.05,81.32,80.78,80.83,78.15340408803002,NaN,NaN,NaN,NaN,NaN,78.17179999999995,81.41976475350677,74.92383524649313,79.20385786444295,80.87174108238419,81.03426517339302,80.70921699137536,16298,7245.666666666667,62.21886192854092,64.83851361853844,NaN,NaN,NaN,NaN,0.9676435822181989,29.465877611187814,-2713734,-0.024001090118954016,0.792120317224601,0.816121407343555
2024-07-15T09:30:00-04:00,82.43,84.04,82.25,83.67,79.94234026584685,NaN,NaN,NaN,NaN,NaN,78.29579999999994,81.88283016993529,74.7087698300646,80.33475618127585,83.32000000000001,83.32000000000001,83.32000000000001,15916,7622.733333333334,74.18263172407826,65.4555800425917,NaN,NaN,NaN,NaN,1.1278118977740423,32.01120318232942,-2697818,0.1570638064172416,1.012451165365107,0.8553873589478653
2024-07-15T13:30:00-04:00,83.5,83.68,83.15,83.38,80.28564298103562,NaN,NaN,NaN,NaN,NaN,78.39079999999994,82.24951448024169,74.5320855197582,80.45080494502068,83.34989093937197,83.38985896854945,83.3099229101945,8902,7786.333333333333,71.68634875426284,65.69179985698166,NaN,NaN,NaN,NaN,1.0851110479330395,34.37471978410377,-2706720,0.23601270570854938,1.150403241083552,0.9143905353750027
2024-07-16T09:30:00-04:00,84,84.14,82.48,84.01,80.28564298103562,NaN,NaN,NaN,NaN,NaN,78.50559999999994,82.67235251965204,74.33884748034785,80.72664395601653,83.54333333333334,83.54333333333334,83.54333333333334,5767,7876.533333333334,73.75269691766239,66.11998833056174,NaN,NaN,NaN,NaN,1.1261745445092506,35.621364098990874,-2700953,0.30499297450014873,1.2956317535001887,0.9906387790000399
2024-07-16T13:30:00-04:00,84.01,84.63,83.97,84.62,81.14258998891881,NaN,NaN,NaN,NaN,NaN,78.64239999999994,83.14081316021883,74.14398683978105,81.56931516481323,83.91012300123002,84.33688650264621,83.48335949981383,4260,7783.266666666666,75.6088502990219,66.54305994777101,NaN,NaN,NaN,NaN,1.0928763627585896,36.98385358985837,-2696693,0.36213754518546204,1.4433107104818674,1.0811731652964054
2024-07-17T09:30:00-04:00,83.24,84.35,82.05,82.37,81.14258998891881,NaN,NaN,NaN,NaN,NaN,78.75079999999994,83.34113565657533,74.16046434342455,81.56931516481323,82.92333333333333,82.92333333333333,82.92333333333333,7516,7893.466666666666,59.02746909906165,66.04631336212192,NaN,NaN,NaN,NaN,1.1983851939901196,36.03009000594991,-2704209,0.22552421353422014,1.3630784322141807,1.1375542186799605
2024-07-17T13:30:00-04:00,82.55,83.02,82.46,82.72,81.14258998891881,NaN,NaN,NaN,NaN,NaN,78.85599999999995,83.56280188663366,74.14919811336624,81.56931516481323,82.79832400370151,82.8884596799694,82.70818832743362,14457,8064.233333333334,60.47938665019434,65.58180702904035,NaN,NaN,NaN,NaN,1.1592148229908246,35.14445239232063,-2689752,0.1400405896251573,1.3126049557114072,1.17256436608625
2024-07-18T09:30:00-04:00,83.47,83.62,81.32,81.97,81.14258998891881,NaN,NaN,NaN,NaN,NaN,78.94299999999994,83.71555193790752,74.17044806209236,81.56931516481323,82.30333333333333,82.30333333333333,82.30333333333333,7160,8128.833333333333,55.90748361153632,64.71443523334626,NaN,NaN,NaN,NaN,1.2406994784914807,33.249282709636624,-2696912,0.020566657771677432,1.1982726883008468,1.1777060305291693
2024-07-18T13:30:00-04:00,81.89,81.91,80.39,80.73,NaN,NaN,NaN,84.67170525563948,84.67170525563948,84.67170525563948,79.02799999999995,83.77336742518678,74.28263257481312,81.56931516481323,81.67111706051736,82.31762225299138,81.02461186804334,6847,8179.633333333333,49.27519939969653,63.3004088007169,NaN,NaN,NaN,NaN,1.2649352300278032,31.007333622361504,-2703759,-0.14526625051453568,0.9961232173859997,1.1413894679005354
2024-07-19T09:30:00-04:00,81,81.9,81,81.54,NaN,NaN,NaN,84.67170525563948,NaN,NaN,79.11519999999994,83.88171862893883,74.34868137106106,81.56931516481323,81.48,81.48,81.48,2808,8145,53.182272444191725,62.532153933600675,NaN,NaN,NaN,NaN,1.2581541421686744,28.925523755606044,-2700951,-0.20030553003242413,0.8910075553600052,1.0913130853924293
2024-07-19T13:30:00-04:00,81.39,81.92,81.18,81.63,NaN,NaN,NaN,84.67170525563948,NaN,NaN,79.16299999999995,83.98122083346327,74.34477916653664,81.56931516481323,81.54032445218013,81.58714671375841,81.49350219060184,4661,8085.733333333334,53.60983461841146,61.668382644562165,NaN,NaN,NaN,NaN,1.2211431320137687,26.974956585511666,-2696290,-0.22850844061531506,0.8056775346232854,1.0341859752386005
2024-07-22T09:30:00-04:00,82.2,82.52,81.44,82.39,NaN,NaN,NaN,84.67170525563948,NaN,NaN,79.24399999999994,84.1397026053495,74.34829739465039,81.56931516481323,82.11666666666666,82.11666666666666,82.11666666666666,7719,8198.7,57.16714482042096,61.71979119037218,NaN,NaN,NaN,NaN,1.211061479727071,25.454826180612915,-2688571,-0.19513374016426077,0.7902688000332745,0.9854025401975353
2024-07-22T13:30:00-04:00,82.35,82.88,82.33,82.73,NaN,NaN,NaN,84.67170525563948,NaN,NaN,79.35199999999995,84.3118741919555,74.3921258080444,81.56931516481323,82.34688869348572,82.60959669219186,82.08418069477959,5928,8236.8,58.69319030787708,62.06103287001726,NaN,NaN,NaN,NaN,1.1638428026037084,24.342508868302403,-2682643,-0.1512716125584873,0.7963130244994261,0.9475846370579134
2024-07-23T09:30:00-04:00,83,83.37,82.49,82.73,NaN,NaN,NaN,84.67170525563948,NaN,NaN,79.46299999999994,84.47164572514663,74.45435427485324,81.56931516481323,82.86333333333334,82.86333333333334,82.86333333333334,9094,8324.966666666667,58.69319030787708,61.677468634488115,NaN,NaN,NaN,NaN,1.143568316703444,23.7031541352865,-2682643,-0.12448872108909537,0.7919737356965442,0.9164624567856395
2024-07-23T13:30:00-04:00,82.64,82.86,82.33,82.39,NaN,NaN,NaN,84.67170525563948,NaN,NaN,79.58079999999994,84.58220594633404,74.57939405366584,80.68046836969718,82.7585393315157,82.91442026191241,82.602658401119,4110,8152.466666666666,56.364223241630796,61.25928015685168,NaN,NaN,NaN,NaN,1.0997420083674838,22.936010171832464,-2686753,-0.13122903809879882,0.7524261591621411,0.8836551972609399
2024-07-24T09:30:00-04:00,80.83,80.83,78.8,79.19,NaN,NaN,NaN,83.41392493038342,NaN,NaN,79.62939999999995,84.56703896614765,74.69176103385225,80.68046836969718,79.60666666666667,79.60666666666667,79.60666666666667,4651,8025.9,40.19727658175415,58.83175478954281,NaN,NaN,NaN,NaN,1.277617579198378,23.06145131962586,-2691404,-0.34084713517102383,0.4575962782971601,0.7984434134681839
2024-07-24T13:30:00-04:00,79.17,79.28,77.69,77.72,NaN,NaN,NaN,82.13715561536598,NaN,NaN,79.63619999999993,84.56235207236149,74.71004792763837,80.68046836969718,78.79358389813103,79.47051842686659,78.11664936939547,6710,8030.066666666667,35.20215795832513,56.22574116126155,NaN,NaN,NaN,NaN,1.299930609255637,23.72354663405588,-2698114,-0.5554551493928038,0.10412447672717917,0.659579626119983
2024-07-25T09:30:00-04:00,77.32,79.23,76.14,78.81,NaN,NaN,NaN,81.5925121783039,NaN,NaN,79.65859999999994,84.55926935836594,74.75793064163393,80.68046836969718,78.06,78.06,78.06,7379,8229.666666666666,41.051607380868106,53.88994905149053,NaN,NaN,NaN,NaN,1.4277927085945203,24.978049491829363,-2690735,-0.5973014262689997,-0.08704715671626673,0.510254269552733
2024-07-25T13:30:00-04:00,78.55,78.83,77.52,77.52,NaN,NaN,NaN,81.5925121783039,NaN,NaN,79.66819999999994,84.55015811534872,74.78624188465116,80.68046836969718,78.01827758026288,78.06897823506719,77.96757692545856,4997,7949.166666666667,36.81579665554695,51.11901664838518,NaN,NaN,NaN,NaN,1.419378943694912,26.14294500261903,-2695732,-0.6791950112604022,-0.33873949452276975,0.3404555167376324
2024-07-26T09:30:00-04:00,78.89,79.65,78,79.07,NaN,NaN,NaN,81.5925121783039,NaN,NaN,79.71459999999993,84.52835730173673,74.90084269826313,80.68046836969718,78.90666666666667,78.90666762034098,78.90666571299235,3043,7906.3,44.258212637299565,50.064069758259315,NaN,NaN,NaN,NaN,1.4701375905738474,26.466700338531695,-2692689,-0.5991062880252895,-0.40842734329397956,0.19067894473131
2024-07-26T13:30:00-04:00,78.7,78.93,78.45,78.78,NaN,NaN,NaN,81.5925121783039,NaN,NaN,79.76879999999994,84.47706276242336,75.06053723757653,80.68046836969718,78.81863286450194,78.91181562085524,78.72545010814864,2716,7709.5,43.23217453160066,48.83212603550262,NaN,NaN,NaN,NaN,1.409413476961429,26.76733029330774,-2695405,-0.5377475923322832,-0.481505545684044,0.0562420466482392
2024-07-29T09:30:00-04:00,79.64,80.42,78.5,79.27,NaN,NaN,NaN,81.5925121783039,NaN,NaN,79.82079999999993,84.4477451520439,75.19385484795598,80.68046836969718,79.39666666666666,79.39666666666666,79.39666666666666,4722,7535.666666666667,45.52996304767078,48.09087456665508,NaN,NaN,NaN,NaN,1.4458839428927557,25.771058176582933,-2690683,-0.4403416259445315,-0.4941849857824252,-0.05384335983789368
2024-07-29T13:30:00-04:00,78.88,79.1,78.62,78.89,NaN,NaN,NaN,81.5925121783039,NaN,NaN,79.88079999999995,84.37829235019007,75.38330764980984,80.68046836969718,79.18994339379906,79.44711988085982,78.9327669067383,3051,7295.5,44.04115503880794,47.71701425516304,NaN,NaN,NaN,NaN,1.3890350898289867,24.845948353909904,-2693734,-0.37996585023465,-0.5288006726312062,-0.1488348223965562
2024-07-30T09:30:00-04:00,79.19,79.19,76.65,77.05,NaN,NaN,NaN,81.5925121783039,NaN,NaN,79.88899999999994,84.36426758976744,75.41373241023244,80.44337469575774,77.63,77.63,77.63,3137,6995,37.62548001217024,46.60581479573294,NaN,NaN,NaN,NaN,1.4712468691269156,25.0656534313651,-2696871,-0.43827264871852867,-0.696675633294717,-0.2584029845761884
2024-07-30T13:30:00-04:00,77.07,77.45,76.94,77.17,NaN,NaN,NaN,81.16061487649326,NaN,NaN,79.92979999999994,84.26580643911159,75.5937935608883,77.1016997566062,77.37294267345298,77.5917659178873,77.15411942901866,4329,6929.133333333333,38.25719059170424,45.50919736525385,NaN,NaN,NaN,NaN,1.4025863784749935,25.26966528900206,-2692542,-0.4418293136170671,-0.8106896265975223,-0.3688603129804552
2024-07-31T09:30:00-04:00,78.39,79,78.28,78.86,NaN,NaN,NaN,81.16061487649326,NaN,NaN,80.00319999999995,84.1352337655948,75.8711662344051,76.32435086099578,78.71333333333332,78.71333333333332,78.71333333333332,2120,6835.733333333334,46.478308979358104,44.74570909089221,NaN,NaN,NaN,NaN,1.4331159228696368,24.21189605963397,-2690422,-0.30968245864723115,-0.7559633862894941,-0.44628092764226296
2024-07-31T13:30:00-04:00,78.57,79.4,78.22,78.26,NaN,NaN,NaN,81.16061487649326,NaN,NaN,80.04639999999995,84.05770155436078,76.03509844563912,76.32435086099578,78.65594687915006,78.69693819007831,78.61495556822182,4155,6683.566666666667,44.22677247907155,43.712393531691816,NaN,NaN,NaN,NaN,1.4150362140932347,22.941314422902,-2694577,-0.2448432441146795,-0.7523349827856123,-0.5074917386709328
2024-08-01T09:30:00-04:00,78.79,78.87,75.24,75.24,NaN,NaN,NaN,81.16061487649326,NaN,NaN,80.02119999999995,84.13580353375842,75.90659646624148,76.32435086099578,76.45,76.45,76.45,3173,6519.966666666666,35.0287630466275,42.02207729874541,NaN,NaN,NaN,NaN,1.5732479130865757,23.277033360048634,-2697750,-0.3794708325687477,-0.9818302793818674,-0.6023594468131197
2024-08-01T13:30:00-04:00,75.04,75.33,74.54,75.21,NaN,NaN,NaN,79.17116230446727,NaN,NaN,79.98739999999994,84.22978764848551,75.74501235151436,76.32435086099578,75.63630984521238,76.34062557861351,74.93199411181125,4235,6221.8,34.95100108312104,40.49256143028043,NaN,NaN,NaN,NaN,1.5173016335803913,23.86914630019746,-2701985,-0.4403832425711173,-1.1528385000270163,-0.712455257455899
2024-08-02T09:30:00-04:00,73.8,74.3,72.07,72.99,NaN,NaN,NaN,77.65679129062785,NaN,NaN,79.90779999999994,84.50793267635005,75.30766732364982,76.32435086099578,73.12,73.12,73.12,7388,6241.633333333333,29.69719282829969,39.74255544789082,NaN,NaN,NaN,NaN,1.6332086597532205,25.25437957801679,-2709373,-0.5906562389054568,-1.45077555608772,-0.8601193171822632
2024-08-02T13:30:00-04:00,72.91,73.08,72.56,72.79,NaN,NaN,NaN,77.15943714105384,NaN,NaN,79.79979999999995,84.79294969132896,74.80665030867094,76.32435086099578,73.05560643431636,73.18136602265943,72.92984684597329,1937,5762.933333333333,29.270314901803573,39.318852372425,NaN,NaN,NaN,NaN,1.553693755485133,26.540667621706167,-2711310,-0.6588032548106102,-1.683623385695526,-1.0248201308849159
2024-08-05T09:30:00-04:00,65,69.83,64.45,69.13,NaN,NaN,NaN,72.41946272555141,NaN,NaN,79.61999999999993,85.42379737758213,73.81620262241773,75.7893776901311,67.80333333333333,67.80333333333333,67.80333333333333,10962,5597.8,22.80889090172458,38.015801195343315,NaN,NaN,NaN,NaN,2.038429915807624,29.33279726651602,-2722272,-0.8912104889752552,-2.138833242103985,-1.2476227531287296
2024-08-05T13:30:00-04:00,69.3,69.76,67.61,67.73,NaN,NaN,NaN,72.41946272555141,NaN,NaN,79.41159999999994,86.09345885514118,72.72974114485869,75.7893776901311,68.05340841069345,68.33329782206324,67.77351899932366,8751,5592.766666666666,20.907647785480535,36.87950484748143,NaN,NaN,NaN,NaN,2.046399207535651,31.925489079553742,-2731023,-1.0681305052403967,-2.5827858846792253,-1.5146553794388287
2024-08-06T09:30:00-04:00,69,71.04,68,70.88,NaN,NaN,NaN,72.41946272555141,NaN,NaN,79.26959999999994,86.3566077860846,72.18259221391529,75.7893776901311,69.97333333333334,69.97333333333334,69.97333333333334,15264,5909.333333333333,34.198083801274095,36.16092421633676,NaN,NaN,NaN,NaN,2.1366564069973903,33.5367056137151,-2715759,-0.908192912840678,-2.6498965204896763,-1.7417036076489982
2024-08-06T13:30:00-04:00,70.93,71.27,70.31,70.48,NaN,NaN,NaN,72.41946272555141,NaN,NaN,79.10179999999994,86.60385592088093,71.59974407911895,75.7893776901311,70.19293248084162,70.52220988107203,69.86365508061121,6789,5993.633333333333,33.42988480004426,35.46076066408273,NaN,NaN,NaN,NaN,2.0526095207832906,34.89096570944227,-2722548,-0.7699864414199415,-2.704186659423925,-1.9342002180039837
2024-08-07T09:30:00-04:00,72.13,72.62,71.14,71.27,66.41392023970373,66.41392023970373,66.41392023970373,NaN,NaN,NaN,78.94139999999993,86.75690152965404,71.12589847034582,75.7893776901311,71.67666666666666,71.67666666666666,71.67666666666666,14627,6230.666666666667,36.46541092329043,34.81329265519842,NaN,NaN,NaN,NaN,2.0588516978701987,35.329790924748,-2707921,-0.5749476524390129,-2.65288478355275,-2.077937131113737
2024-08-07T13:30:00-04:00,71.17,71.17,69.52,69.76,66.41392023970373,NaN,NaN,NaN,NaN,NaN,78.74839999999993,86.97393036344921,70.52286963655065,74.16650215210487,71.17490147481793,71.89202063168025,70.4577823179556,7161,5987.466666666666,33.33639456710431,34.04866690721958,NaN,NaN,NaN,NaN,2.0367908623080417,36.11015353974894,-2715082,-0.49998192822179544,-2.7029145413909816,-2.202932613169186
2024-08-08T09:30:00-04:00,71.1,73.04,70.78,73.04,66.41392023970373,NaN,NaN,NaN,NaN,NaN,78.61659999999993,86.99123753006822,70.24196246993165,71.1722017216839,72.28666666666668,72.28666666666668,72.28666666666668,5813,5942.566666666667,44.480684541545735,34.53832437360354,NaN,NaN,NaN,NaN,2.1255915150003246,35.79903672483731,-2709269,-0.19737933229812032,-2.4496567785418364,-2.252277446243716
2024-08-08T13:30:00-04:00,73.05,73.36,72.9,73.17,67.66882281554247,NaN,NaN,NaN,NaN,NaN,78.47579999999994,86.97435149069707,69.9772485093028,69.40376137734712,72.88202235399066,73.2764497588588,72.48759494912252,13244,6155.8,44.874029911655875,35.01095575360009,NaN,NaN,NaN,NaN,2.006620692500301,35.3412792211162,-2696025,0.031462943045112546,-2.212948767437325,-2.2444117104824377
2024-08-09T09:30:00-04:00,73.32,74.02,73.15,73.91,68.25342177847237,NaN,NaN,NaN,NaN,NaN,78.35099999999993,86.93042678738071,69.77157321261915,69.38831330457735,73.69333333333334,73.69333333333334,73.69333333333334,7372,6307.933333333333,47.16856851630815,35.060260006239375,NaN,NaN,NaN,NaN,1.92543350017885,34.561994616320135,-2688653,0.2409344527232511,-1.9432436445783736,-2.1841780973016247
2024-08-09T13:30:00-04:00,74,74.08,73.49,73.78,68.6153116976327,NaN,NaN,NaN,NaN,NaN,78.21579999999993,86.86574990968309,69.56585009031677,70.07965064366188,73.72948817832604,73.77361031826517,73.6853660383869,4950,6317.566666666667,46.80003110454581,35.244064193773255,NaN,NaN,NaN,NaN,1.8300453930232181,33.80514773985933,-2693603,0.3712133932088584,-1.7201613557905517,-2.09137474899941
2024-08-12T09:30:00-04:00,73.79,73.9,72.53,73.23,68.6153116976327,NaN,NaN,NaN,NaN,NaN,78.07639999999994,86.81811585903031,69.33468414096956,70.07965064366188,73.22000000000001,73.22000000000001,73.22000000000001,3844,6188.4,45.19128468561724,35.969958596558236,NaN,NaN,NaN,NaN,1.7971850078072742,33.43101833797842,-2697447,0.41737703898831735,-1.5696534502640134,-1.9870304892523307
2024-08-12T13:30:00-04:00,73.28,73.3,72.95,72.98,68.6153116976327,NaN,NaN,NaN,NaN,NaN,77.92839999999994,86.75921636996408,69.0975836300358,70.07965064366188,73.14693491476427,73.21858793659332,73.07528189293522,3997,6124.033333333334,44.44344049290987,36.64798998297173,NaN,NaN,NaN,NaN,1.6938146501067541,33.083612464803295,-2701444,0.42659288548319174,-1.453789382398341,-1.8803822678815327
2024-08-13T09:30:00-04:00,73.6,75.7,73.6,75.7,69.56702353792042,NaN,NaN,NaN,NaN,NaN,77.83099999999993,86.65054579329481,69.01145420670505,71.71342112955489,75,75,75,2781,5913.6,53.46618527612456,38.34577515781636,NaN,NaN,NaN,NaN,1.7671136036705573,31.39023828542736,-2698663,0.6007336273441664,-1.1294652337013247,-1.730198861045491
2024-08-13T13:30:00-04:00,75.43,75.73,75.24,75.52,70.56624974074221,NaN,NaN,NaN,NaN,NaN,77.72639999999993,86.52902666253831,68.92377333746154,72.29573690364391,75.33441716590312,75.56735281842505,75.10148151338119,5732,5967.666666666667,52.85443656629536,40.03035527670863,NaN,NaN,NaN,NaN,1.6758912034083753,29.802152452993464,-2704395,0.682676934528283,-0.8768526928851372,-1.5595296274134203
2024-08-14T09:30:00-04:00,76,76,74.61,74.99,70.56624974074221,NaN,NaN,NaN,NaN,NaN,77.61959999999993,86.422857542525,68.81634245747487,72.55758952291512,75.2,75.2,75.2,4012,5946.366666666667,51.00395088143511,42.044288132402244,NaN,NaN,NaN,NaN,1.65547040316492,28.60901133527997,-2708407,0.6786449310892706,-0.711223463551832,-1.3898683946411026
2024-08-14T13:30:00-04:00,75,75.25,74.83,75.14,70.56624974074221,NaN,NaN,NaN,NaN,NaN,77.51039999999993,86.2985110234239,68.72228897657597,72.55758952291512,75.14053601340035,75.2037510374447,75.077320989356,3550,5841.033333333334,51.52126653517631,44.230975185951934,NaN,NaN,NaN,NaN,1.5672225172245686,27.501094583117442,-2704857,0.6627858751753968,-0.5613860506718567,-1.2241719258472534
2024-08-15T09:30:00-04:00,76.42,77.8,76.42,77.68,72.24185986560984,NaN,NaN,NaN,NaN,NaN,77.46879999999992,86.23358284043775,68.70401715956208,74.09885729466568,77.3,77.3,77.3,8307,5871.966666666666,59.34834867805649,46.02742267715068,NaN,NaN,NaN,NaN,1.645278051708528,25.968007675260445,-2696550,0.7913588032621037,-0.23497342176962377,-1.0263322250317275
2024-08-15T13:30:00-04:00,77.6,77.79,77.11,77.2,72.7104116899003,NaN,NaN,NaN,NaN,NaN,77.42279999999991,86.16858027622683,68.67701972377299,74.48908583573255,77.32189706278632,77.35320717019357,77.29058695537907,4063,5840.833333333333,57.46031880364672,47.74388224883656,NaN,NaN,NaN,NaN,1.5763296194436336,24.544426975107523,-2700613,0.8091858839434544,-0.014849870102409568,-0.8240357540458639
2024-08-16T09:30:00-04:00,77.18,78.12,77.18,77.96,72.99766570399575,NaN,NaN,NaN,NaN,NaN,77.36159999999991,86.04846305636505,68.67473694363477,75.00926866858603,77.75333333333333,77.75333333333333,77.75333333333333,4925,5903.566666666667,59.64913890130735,49.39986281869492,NaN,NaN,NaN,NaN,1.5308775037690883,23.388746951182107,-2695688,0.8339546927704743,0.2184076119172289,-0.6155470808532454
2024-08-16T13:30:00-04:00,78.07,78.14,77.9,78.08,73.54640817199595,NaN,NaN,NaN,NaN,NaN,77.30659999999992,85.93958290048316,68.67361709951668,75.53141493486883,77.84198690977092,77.9744805648256,77.70949325471625,2205,5886.533333333334,59.99911451141035,51.30434281471678,NaN,NaN,NaN,NaN,1.4386719677855815,22.326178372886922,-2693483,0.819031964148529,0.4082428743324158,-0.4107890898161132
2024-08-19T09:30:00-04:00,78.13,78.73,77.96,78.73,73.96975325508703,NaN,NaN,NaN,NaN,NaN,77.20779999999992,85.65836238602104,68.7572376139788,76.25813194789507,78.47333333333334,78.47333333333334,78.47333333333334,3753,5854.233333333334,61.925469503975364,52.55039888346175,NaN,NaN,NaN,NaN,1.3909096843723263,21.658201226156343,-2689730,0.8119702452033665,0.6041737166880949,-0.20779652851527156
2024-08-19T13:30:00-04:00,78.83,79.4,78.72,79.38,74.79090083440126,NaN,NaN,NaN,NaN,NaN,77.12779999999992,85.41732330595896,68.83827669404089,77.08250555831604,78.8638175046555,79.20770382899008,78.51993118032092,4839,5913.833333333333,63.80274100076835,53.90244967554121,NaN,NaN,NaN,NaN,1.340130421202875,21.387807855297538,-2684891,0.8083551973730869,0.8026474682010871,-0.005707729171999798
2024-08-20T09:30:00-04:00,79.61,80.05,78.32,78.43,74.87404170556484,NaN,NaN,NaN,NaN,NaN,77.01619999999991,85.07925539110596,68.95314460889387,77.33100444665283,78.93333333333334,78.93333333333334,78.93333333333334,7006,6042.8,59.20793307219663,54.7624042866761,NaN,NaN,NaN,NaN,1.3679782482598128,21.46253234186944,-2691897,0.7031392958888301,0.8732163906890378,0.17007709480020772
2024-08-20T13:30:00-04:00,78.69,79.06,78.69,78.82,74.87404170556484,NaN,NaN,NaN,NaN,NaN,76.90019999999993,84.68440913388339,69.11599086611646,77.33100444665283,78.90071871839034,78.93862308098709,78.86281435579359,5187,6071.4,60.46661981854448,55.738589194818864,NaN,NaN,NaN,NaN,1.3152655162412545,21.531919365114774,-2686710,0.6236706119166101,0.9496653596959703,0.3259947477793602
2024-08-21T09:30:00-04:00,79.05,79.79,78.87,79.36,75.18776320692996,NaN,NaN,NaN,NaN,NaN,76.83999999999992,84.49963236715972,69.18036763284012,77.33100444665283,79.34000000000002,79.34000000000002,79.34000000000002,6299,6210.7,62.205556385960776,56.95389431627198,NaN,NaN,NaN,NaN,1.2906036936525944,21.970105260786394,-2680411,0.5726568428965277,1.0418158014000198,0.46915895850349215
2024-08-21T13:30:00-04:00,79.44,80.56,79.44,80.52,75.88241033388766,NaN,NaN,NaN,NaN,NaN,76.79599999999992,84.3444875306274,69.24751246937244,77.97827427668625,79.91167306382202,80.29843413729132,79.52491199035272,13762,6530.933333333333,65.69623957602752,58.471951393637525,NaN,NaN,NaN,NaN,1.2841320012488378,22.744732323884595,-2666649,0.5804140401588425,1.1946765087020452,0.6142624685432028
2024-08-22T09:30:00-04:00,80.5,80.72,79.04,79.54,75.88241033388766,NaN,NaN,NaN,NaN,NaN,76.74739999999991,84.19259690539049,69.30220309460934,77.97827427668625,79.76666666666667,79.76666666666667,79.76666666666667,5353,6603.6,60.603700269879326,58.98177389319143,NaN,NaN,NaN,NaN,1.3124082868739202,23.10074601607834,-2672002,0.48670841383247976,1.2226479858338024,0.7359395720013227
2024-08-22T13:30:00-04:00,79.5,79.5,78.63,78.77,75.88241033388766,NaN,NaN,NaN,NaN,NaN,76.70819999999992,84.08947326685845,69.32692673314139,77.97827427668625,79.14320952027592,79.47497284514439,78.81144619540744,18904,7092.566666666667,56.87333058565082,59.26883775171682,NaN,NaN,NaN,NaN,1.283664837811498,23.06131831034412,-2690906,0.34661246159111436,1.1692051489902155,0.8225926873991012
2024-08-23T09:30:00-04:00,79.75,81.35,79.6,81.25,76.21475789839722,NaN,NaN,NaN,NaN,NaN,76.70239999999993,84.06891837437712,69.33588162562273,77.97827427668625,80.73333333333333,80.73333333333333,80.73333333333333,8396,7126.166666666667,64.46093050329594,60.230050581849746,NaN,NaN,NaN,NaN,1.3762602065392482,23.935472658828797,-2682510,0.3914014206052061,1.3118444631556088,0.9204430425504027
2024-08-23T13:30:00-04:00,81.33,81.9,81.33,81.9,77.45976890301554,NaN,NaN,NaN,NaN,NaN,76.70779999999992,84.08914003010557,69.32645996989427,78.76424514373069,81.3748508875901,81.83853616760588,80.91116560757432,16071,7597.3,66.14229686833151,61.27440989136083,NaN,NaN,NaN,NaN,1.324384477500731,24.978582185608104,-2666439,0.43204634114025575,1.4605009689757225,1.0284546278354667
2024-08-26T09:30:00-04:00,81.61,82,80.58,81.01,77.45976890301554,NaN,NaN,NaN,NaN,NaN,76.68019999999993,83.98628348159482,69.37411651840503,78.78139611498455,81.19666666666666,81.19666762034097,81.19666571299234,5362,7410.633333333333,61.82899528030342,61.451598934378474,NaN,NaN,NaN,NaN,1.3312141576792502,25.269405957637225,-2671801,0.3686992614583733,1.4893287046584334,1.12062944320006
2024-08-26T13:30:00-04:00,80.99,80.99,80.52,80.76,77.45976890301554,NaN,NaN,NaN,NaN,NaN,76.64079999999993,83.836369570231,69.44523042976886,78.78139611498455,80.97108818806991,81.19101745073857,80.75115892540126,5641,7306.966666666666,60.63287892715715,61.678210371772074,NaN,NaN,NaN,NaN,1.2711274321307329,25.48538201408969,-2677442,0.2834957339395934,1.4749991106245517,1.1915033766849583
2024-08-27T09:30:00-04:00,80.07,80.49,79.7,80.39,77.45976890301554,NaN,NaN,NaN,NaN,NaN,76.59399999999992,83.65981290440354,69.52818709559631,78.78139611498455,80.19333333333333,80.19333333333333,80.19333333333333,3886,6927.7,58.819255323342354,61.618932973346,NaN,NaN,NaN,NaN,1.2560469012642521,24.957615468301487,-2681328,0.18075525427004036,1.4174474445225087,1.2366921902524683
2024-08-27T13:30:00-04:00,80.43,80.68,80.39,80.42,77.45976890301554,NaN,NaN,NaN,NaN,NaN,76.55459999999992,83.51183187482158,69.59736812517826,78.78139611498455,80.37287404606876,80.52195729573717,80.22379079640035,5636,6889.266666666666,58.92653181436012,61.5423199235567,NaN,NaN,NaN,NaN,1.1870435511739488,24.581312905021132,-2675692,0.0975238661940474,1.3585970229950277,1.2610731568009803
2024-08-28T09:30:00-04:00,79.96,79.96,77.9,78.31,77.45976890301554,NaN,NaN,NaN,NaN,NaN,76.53699999999992,83.47189177998021,69.60210822001963,78.78139611498455,78.72333333333334,78.72333333333334,78.72333333333334,7305,6645.2,49.215634979308575,60.63447460036622,NaN,NaN,NaN,NaN,1.282254726090095,23.260205752431066,-2682997,-0.10590855151664691,1.1286874674051717,1.2345960189218186
2024-08-28T13:30:00-04:00,78.25,78.61,77.66,78.32,77.45976890301554,NaN,NaN,NaN,NaN,NaN,76.54899999999992,83.49410734258555,69.60389265741429,78.78139611498455,78.40938921449371,78.66781327071585,78.15096515827157,10781,6765.866666666667,49.258314111480445,59.59558696541707,NaN,NaN,NaN,NaN,1.2585222456550884,22.18013465403941,-2672216,-0.23848154812346678,0.9364940837674851,1.1749756318909519
2024-08-29T09:30:00-04:00,78.9,80.38,78.9,80.07,77.45976890301554,NaN,NaN,NaN,NaN,NaN,76.57419999999992,83.5609590082981,69.58744099170174,78.78139611498455,79.78333333333333,79.78333333333333,79.78333333333333,2819,6666.066666666667,56.19610236610275,59.38045620069608,NaN,NaN,NaN,NaN,1.315770656679725,21.1573535745778,-2669397,-0.2081052540781172,0.9148440642933053,1.1229493183714225
2024-08-29T13:30:00-04:00,80.09,80.09,78.71,78.71,77.45976890301554,NaN,NaN,NaN,NaN,NaN,76.59799999999991,83.60556048850374,69.59043951149609,78.78139611498455,79.32797045835237,79.59617538387994,79.0597655328248,8126,6495.466666666666,50.42584867463075,58.6632582618451,NaN,NaN,NaN,NaN,1.3203584669168882,20.078064233692537,-2677523,-0.27518649753617175,0.7789661964512078,1.0541526939873795
2024-08-30T09:30:00-04:00,79.15,79.51,78.06,78.43,77.45976890301554,NaN,NaN,NaN,NaN,NaN,76.58519999999992,83.5769725821165,69.59342741788333,78.78139611498455,78.66666666666667,78.66666666666667,78.66666666666667,3522,6367.133333333333,49.303392679177655,57.74167513993201,NaN,NaN,NaN,NaN,1.3296185764228248,18.65389948694975,-2681045,-0.3302854451910575,0.6412958874985577,0.9715813326896152
2024-08-30T13:30:00-04:00,78.5,79.27,78.42,79.23,77.45976890301554,NaN,NaN,NaN,NaN,NaN,76.59419999999992,83.59839770138132,69.59000229861851,78.78139611498455,78.90148128437113,79.03137320639898,78.77158936234328,11510,6585.8,52.55307437314218,56.80287762544021,NaN,NaN,NaN,NaN,1.2953601066783367,17.331460793545737,-2669535,-0.3053098798268523,0.5899439829060498,0.8952538627329021
2024-09-03T09:30:00-04:00,78.88,79,77.23,77.27,NaN,NaN,NaN,82.10645583301016,82.10645583301016,82.10645583301016,76.55419999999991,83.51955206863497,69.58884793136485,78.30627481087208,77.83333333333333,77.83333333333333,77.83333333333333,6877,6686.9,44.950701469822135,55.68480628257898,NaN,NaN,NaN,NaN,1.345691527629884,16.88968344822495,-2676412,-0.4068953105727372,0.38663472451698055,0.7935300350897178
2024-09-03T13:30:00-04:00,77.45,77.46,76.18,76.55,NaN,NaN,NaN,80.91550493057487,NaN,NaN,76.50739999999992,83.44071760126678,69.57408239873305,78.30627481087208,77.12210497304187,77.65019225469123,76.59401769139251,12474,6969.466666666666,42.517490463548405,54.65938913100024,NaN,NaN,NaN,NaN,1.3409992756563198,17.081166967585524,-2688886,-0.502420145791667,0.16550485285013394,0.667924998641801
2024-09-04T09:30:00-04:00,75.75,77.47,75.75,77.03,NaN,NaN,NaN,80.7538910700942,NaN,NaN,76.50699999999992,83.44019464605145,69.57380535394839,78.30627481087208,76.75,76.75,76.75,4555,7028.6,44.66786520156747,53.24559875230535,NaN,NaN,NaN,NaN,1.3680707559665826,17.489541494920353,-2684331,-0.5114124337154575,0.02865945649747914,0.5400718902129367
2024-09-04T13:30:00-04:00,76.95,76.99,76.07,76.36,NaN,NaN,NaN,80.61644147599901,NaN,NaN,76.49079999999992,83.42150713852715,69.5600928614727,76.9482527031665,76.57551582475203,76.70904195605088,76.44198969345318,7778,7096.8,42.2897556673352,51.541845809377044,NaN,NaN,NaN,NaN,1.338922844826113,17.868746413159833,-2692109,-0.5379211078224395,-0.13232949456511278,0.40559161325732673
2024-09-05T09:30:00-04:00,76.82,77.75,76.42,76.73,NaN,NaN,NaN,80.61644147599901,NaN,NaN,76.44819999999993,83.34624110164843,69.55015889835143,76.9482527031665,76.96666666666668,76.96666666666668,76.96666666666668,3513,7080.166666666667,44.060938672724674,50.27269890883571,NaN,NaN,NaN,NaN,1.3425712130528193,17.554124639966652,-2688596,-0.5064226835547159,-0.22743674118606805,0.27898594236864777
2024-09-05T13:30:00-04:00,76.81,77.5,76.81,77.33,NaN,NaN,NaN,80.61644147599901,NaN,NaN,76.42959999999992,83.31299911381262,69.54620088618722,76.9482527031665,77.0911133051246,77.21444161356426,76.96778499668493,3577,7081.066666666667,46.906612804660256,49.29225132865735,NaN,NaN,NaN,NaN,1.3016732692633322,17.261975850572988,-2685019,-0.42438543084609687,-0.25149584618897336,0.1728895846571235
2024-09-06T09:30:00-04:00,77.31,78.06,73.83,74.39,NaN,NaN,NaN,80.34889599072378,NaN,NaN,76.41259999999993,83.31184727488663,69.51335272511322,76.6546021625332,75.42666666666666,75.42666666666666,75.42666666666666,7759,7062.8,36.979701237416435,47.732283179662645,NaN,NaN,NaN,NaN,1.5108394643159515,18.578486769802655,-2692778,-0.5399192175909286,-0.5020094373315374,0.037909780259391346
2024-09-06T13:30:00-04:00,74.19,74.49,73.94,74.1,NaN,NaN,NaN,78.49371890023633,NaN,NaN,76.39039999999991,83.31208992082377,69.46871007917606,76.06634538402125,74.5893091955979,75.1771266030313,74.00149178816451,15745,7452.2,36.16663938209074,46.10657657735769,NaN,NaN,NaN,NaN,1.442208074007669,19.80096119480163,-2708523,-0.6028828380382785,-0.7156937672884567,-0.11281092925017827
2024-09-09T09:30:00-04:00,75.52,76.58,75.35,76.54,NaN,NaN,NaN,78.49371890023633,NaN,NaN,76.46139999999993,83.31460364209525,69.6081963579046,76.06634538402125,76.15666666666668,76.156667620341,76.15666571299236,2951,7386.4,46.77101057663112,45.93196054859502,NaN,NaN,NaN,NaN,1.5163360687214074,19.260984171867776,-2705572,-0.45399952551666334,-0.6803103361460074,-0.2263108106293441
2024-09-09T13:30:00-04:00,76.44,76.44,75.91,76.26,NaN,NaN,NaN,78.49371890023633,NaN,NaN,76.53079999999991,83.30369047896349,69.75790952103634,75.437076307217,76.1844296499657,76.20733865791617,76.16152064201522,4334,7457.366666666667,45.8301158052569,45.68708924100763,NaN,NaN,NaN,NaN,1.453026349527022,18.75957693628634,-2709906,-0.35268865765832424,-0.6671716327022494,-0.3144829750439252
2024-09-10T09:30:00-04:00,76.5,76.5,75.46,76.2,NaN,NaN,NaN,78.49371890023633,NaN,NaN,76.67219999999992,83.10796542767324,70.2364345723266,74.38183716434887,76.05333333333333,76.05333333333333,76.05333333333333,2775,7424.766666666666,45.61833740819013,44.93153460115672,NaN,NaN,NaN,NaN,1.4235244674179495,18.553323112137342,-2712681,-0.2716624247526663,-0.654061005984758,-0.38239858123209175
2024-09-10T13:30:00-04:00,76.26,77.09,76.26,77.02,NaN,NaN,NaN,78.49371890023633,NaN,NaN,76.8579999999999,82.76508320578317,70.95091679421664,74.38183716434887,76.5432291163689,76.89092440720083,76.19553382553698,5509,7447.1,49.081355955187966,44.8354994069108,NaN,NaN,NaN,NaN,1.385415576888096,17.905004502183,-2707172,-0.15081901929785624,-0.570922355354412,-0.4201033360565558
2024-09-11T09:30:00-04:00,76.81,77.85,75.66,77.85,NaN,NaN,NaN,78.49371890023633,NaN,NaN,76.99739999999991,82.65740962543698,71.33739037456284,74.38183716434887,77.11999999999999,77.11999999999999,77.11999999999999,1706,7270.433333333333,52.38643577697122,45.05571677103892,NaN,NaN,NaN,NaN,1.4428858928246604,16.74686735635371,-2705466,-0.010371868783556892,-0.4330681720360019,-0.422696303252445
2024-09-11T13:30:00-04:00,77.82,78.78,77.82,78.68,74.07414824533052,74.07414824533052,74.07414824533052,NaN,NaN,NaN,77.16139999999992,82.52390838321355,71.79889161678628,75.29883463783108,78.09636983256777,78.66425350428965,77.5284861608459,5043,7265.633333333333,55.49726726469359,45.26601626329259,NaN,NaN,NaN,NaN,1.4083940433371853,16.05228900106035,-2700423,0.1350236972254787,-0.25391668172059667,-0.38894037894607536
2024-09-12T09:30:00-04:00,78.99,80.3,78.83,80.24,75.31032332508823,NaN,NaN,NaN,NaN,NaN,77.3407999999999,82.49921966497874,72.18238033502107,76.70506771026487,79.79,79.79,79.79,9435,7370.166666666667,60.69511457168847,46.39061719914019,NaN,NaN,NaN,NaN,1.4235087545273857,16.277709828342026,-2690988,0.3221781066433331,0.013782254358090995,-0.3083958522852421
2024-09-12T13:30:00-04:00,80.26,80.51,79.98,80.22,76.11144499212968,NaN,NaN,NaN,NaN,NaN,77.54999999999991,82.29340974405957,72.80659025594025,77.3690541682119,79.9673134773531,80.18585397848257,79.74877297622363,6211,7118.466666666666,60.59739515318734,47.682038962685816,NaN,NaN,NaN,NaN,1.3596867006325726,16.59740557905352,-2697199,0.42412898880004213,0.22176538371481058,-0.20236360508523155
2024-09-13T09:30:00-04:00,80.42,81.38,80.16,81.16,76.65797021976014,NaN,NaN,NaN,NaN,NaN,77.71239999999992,82.38249646153393,73.0423035384659,78.25724333456951,80.89999999999999,80.89999999999999,80.89999999999999,8346,7218.233333333334,63.56640543050998,49.031934693324565,NaN,NaN,NaN,NaN,1.3497090791588173,17.33931767476097,-2688853,0.5276297985345932,0.45717364308301,-0.07045615545158324
2024-09-13T13:30:00-04:00,81.19,81.3,80.89,80.92,77.11397157340741,NaN,NaN,NaN,NaN,NaN,77.86739999999992,82.43753401992035,73.29726598007949,78.59679466765562,80.97173327260997,81.03998197119621,80.90348457402372,9220,6895.433333333333,62.27614738198216,50.45953410151363,NaN,NaN,NaN,NaN,1.2825870020760444,18.028236049346464,-2698073,0.5501689710303502,0.6172550583363545,0.06708608730600432
2024-09-16T09:30:00-04:00,80.2,81,79.9,80.83,77.11397157340741,NaN,NaN,NaN,NaN,NaN,78.00579999999992,82.50677605415012,73.50482394584972,78.59679466765562,80.57666666666667,80.57666666666667,80.57666666666667,1829,6676.533333333334,61.76980867228373,51.72445338719643,NaN,NaN,NaN,NaN,1.2695450733563265,17.815259948846055,-2699902,0.5291001203258627,0.7284612377133328,0.19936111738747003
2024-09-16T13:30:00-04:00,81,81.25,80.72,80.77,77.14220343775345,NaN,NaN,NaN,NaN,NaN,78.14559999999992,82.54597300237553,73.7452269976243,78.8149485872996,80.78010889946631,80.94474023394096,80.61547756499166,2793,6233.933333333333,61.41133164305771,52.76050473279624,NaN,NaN,NaN,NaN,1.2167204252594461,17.768764223692145,-2702695,0.4825116731901958,0.8025007088752147,0.31998903568501896
2024-09-17T09:30:00-04:00,81.405,82.49,81.4,81.85,78.04233055421919,NaN,NaN,NaN,NaN,NaN,78.31799999999993,82.60858877079036,74.02741122920949,79.68195886983968,81.91333333333333,81.91333333333333,81.91333333333333,8721,6345.9,65.3134736819225,54.78434562168953,NaN,NaN,NaN,NaN,1.2526689663123427,18.420869655242303,-2693974,0.49402267583765824,0.9375173804820918,0.4434947046444335
2024-09-17T13:30:00-04:00,81.85,81.91,81.42,81.61,78.04233055421919,NaN,NaN,NaN,NaN,NaN,78.49059999999992,82.59881500898352,74.38238499101631,79.68195886983968,81.78509523809522,81.91833118042727,81.65185929576317,8079,6427.166666666667,63.770233722137135,56.75603093169285,NaN,NaN,NaN,NaN,1.1981926115757464,19.026396127396023,-2702053,0.4559805684079402,1.0134704151543588,0.5574898467464185
2024-09-18T09:30:00-04:00,82,82.1,81.38,81.96,78.04233055421919,NaN,NaN,NaN,NaN,NaN,78.61579999999992,82.75762006369567,74.47397993630418,79.74685367669738,81.81333333333333,81.81333333333333,81.81333333333333,5082,6467.033333333334,65.0665576780757,58.062855724653176,NaN,NaN,NaN,NaN,1.164035996463193,19.695476768067017,-2696971,0.4254869114198091,1.08934848602118,0.6638615746013709
2024-09-18T13:30:00-04:00,82.09,83.42,81.63,81.67,78.73199739506236,NaN,NaN,NaN,NaN,NaN,78.73879999999991,82.87083221672313,74.6067677832767,80.64248294135791,82.11446039833255,82.30889129040841,81.9200295062567,12190,6685.5,63.05342978478944,59.293092437476936,NaN,NaN,NaN,NaN,1.2087477110015368,20.99562794424625,-2709161,0.35950992923679825,1.1132489861473687,0.7537390569105704
2024-09-19T09:30:00-04:00,83.99,84.98,83.61,84.52,80.22304296801407,NaN,NaN,NaN,NaN,NaN,78.92939999999993,83.22799029915903,74.63080970084083,81.10298635308634,84.37,84.37,84.37,31802,7502.066666666667,72.16726173294225,61.18944417495923,NaN,NaN,NaN,NaN,1.3588371602157128,22.843953258364404,-2677359,0.47431937721304784,1.3466382784268802,0.8723189012138324
2024-09-19T13:30:00-04:00,84.59,84.75,83.94,84.25,80.34767737855888,NaN,NaN,NaN,NaN,NaN,79.11159999999991,83.52306571561388,74.70013428438594,81.24338908246906,84.34089574762044,84.36921859106913,84.31257290417174,33581,8262.066666666668,70.39561915870368,62.71189154663892,NaN,NaN,NaN,NaN,1.3196345059145906,24.56025533575983,-2710940,0.49623157530470363,1.492608370344712,0.9963767950400083
2024-09-20T09:30:00-04:00,84.1,84.3,83.11,83.75,80.34767737855888,NaN,NaN,NaN,NaN,NaN,79.23299999999992,83.81113280716393,74.65486719283591,81.24338908246906,83.72,83.72,83.72,2744,8259.566666666668,67.11002292553322,63.763576342964775,NaN,NaN,NaN,NaN,1.3103748983492627,25.29506163078354,-2713684,0.4429598284398355,1.5500765805898027,1.1071167521499672
2024-09-20T13:30:00-04:00,83.9,84.36,83.6,84.04,80.34767737855888,NaN,NaN,NaN,NaN,NaN,79.36979999999993,84.10291481373784,74.63668518626201,81.2597690127802,83.85609290129237,83.99603837131677,83.71614743126797,2595,8075.2,68.04169894940915,64.65960717758732,NaN,NaN,NaN,NaN,1.27106240561003,26.006855405285794,-2711089,0.39476319379469627,1.6005707443933375,1.2058075505986412
2024-09-23T09:30:00-04:00,84.36,84.88,84.36,84.64,80.7820384300182,NaN,NaN,NaN,NaN,NaN,79.50339999999991,84.4424259930511,74.56437400694873,81.97981521022416,84.62666666666667,84.62666666666667,84.62666666666667,4235,8098.966666666666,69.93902654984869,65.31988660459875,NaN,NaN,NaN,NaN,1.2402722337807413,26.92589599510856,-2706854,0.371157819009313,1.6697548243602824,1.2985970053509694
2024-09-23T13:30:00-04:00,84.75,84.75,84.48,84.54,80.91467304683557,NaN,NaN,NaN,NaN,NaN,79.63259999999993,84.75065714700631,74.51454285299354,82.29485216817933,84.61265917602998,84.63047484871295,84.59484350334701,2618,7802.566666666667,69.20161774129039,65.9344739323204,NaN,NaN,NaN,NaN,1.1709670742249738,27.779290828515418,-2709472,0.31868489382503706,1.6969531226322658,1.3782682288072288
2024-09-24T09:30:00-04:00,84.87,85.33,83.91,85.03,80.91467304683557,NaN,NaN,NaN,NaN,NaN,79.75859999999992,85.08742577685082,74.42977422314901,82.65588173454347,84.75666666666667,84.75666666666667,84.75666666666667,25040,8408,70.82485684723193,66.45293474780054,NaN,NaN,NaN,NaN,1.1887551403517616,28.865729185642508,-2684432,0.28779513906976084,1.7380121526444299,1.450217013574669
2024-09-24T13:30:00-04:00,85.06,85.64,85.05,85.6,81.70540457366629,NaN,NaN,NaN,NaN,NaN,79.88299999999992,85.45550141319205,74.3104985868078,83.19570538763477,85.05183993121751,85.38593982949207,84.71774003294296,19545,8643.7,72.63187726489664,67.1926297394373,NaN,NaN,NaN,NaN,1.1474154874694928,30.026506508472234,-2664887,0.27650205915954573,1.7958445875241011,1.5193425283645554
2024-09-25T09:30:00-04:00,85.56,85.75,85.16,85.18,81.90038618395418,NaN,NaN,NaN,NaN,NaN,80.01799999999992,85.76740275159386,74.26859724840597,83.49956431010781,85.36333333333334,85.36333428700766,85.36333237965903,11004,8858.666666666666,69.2293662628194,67.72545528161841,NaN,NaN,NaN,NaN,1.1076000955073864,31.159481068953042,-2675891,0.21427410599844032,1.787185160862606,1.5729110548641656
2024-09-25T13:30:00-04:00,85,85.24,84.95,84.99,81.90038618395418,NaN,NaN,NaN,NaN,NaN,80.14139999999992,86.04542982377541,74.23737017622443,83.49956431010781,85.24950153287159,85.3963732479036,85.10262981783958,6610,8819.733333333334,67.68464050104322,68.17354877147451,NaN,NaN,NaN,NaN,1.0492000886854296,31.91881316564193,-2682501,0.13757294183496827,1.7448772321578758,1.6073042903229076
2024-09-26T09:30:00-04:00,86,86.18,84.12,84.72,81.90038618395418,NaN,NaN,NaN,NaN,NaN,80.24859999999993,86.28514206976388,74.21205793023597,83.59372115846901,85.00666666666667,85.00666762034099,85.00666571299236,6927,8933.533333333333,65.449712069968,68.18328008490633,NaN,NaN,NaN,NaN,1.1214000823507562,33.119772394861805,-2689428,0.05040208150801995,1.6703068922079325,1.6199048106999125
2024-09-26T13:30:00-04:00,84.97,85.35,84.96,85.11,81.90038618395418,NaN,NaN,NaN,NaN,NaN,80.34039999999993,86.52836374908793,74.15243625091193,83.59372115846901,85.06618286445013,85.13246495283094,84.99990077606931,5585,9000.466666666667,67.13765430436933,68.42381012649436,NaN,NaN,NaN,NaN,1.0863000764685589,34.23494882199454,-2683843,0.0032434405794745658,1.6239591114242558,1.6207156708447812
2024-09-27T09:30:00-04:00,85.8,86.24,85.4,86.04,82.34249265949043,NaN,NaN,NaN,NaN,NaN,80.47039999999993,86.85560785566356,74.08519214433629,83.76778154142016,85.89333333333333,85.89333428700765,85.89333237965901,4850,8903.5,70.80099256990523,68.8334126187679,NaN,NaN,NaN,NaN,1.0894214995779472,35.69450015379715,-2678993,0.018089963492167183,1.6433281252099903,1.625238161717823
2024-09-27T13:30:00-04:00,86,86.21,85.62,85.96,82.5151066295136,NaN,NaN,NaN,NaN,NaN,80.61419999999993,87.16154399890725,74.0668560010926,83.93722523313613,85.91473664635366,85.93281111283727,85.89666217987005,6801,8605.366666666667,70.07731083412035,69.33511840800581,NaN,NaN,NaN,NaN,1.0537485353223788,37.04979781904244,-2685794,0.006524771455242329,1.633394126036876,1.6268693545816337
2024-09-30T09:30:00-04:00,85.22,85.87,84.89,85.11,82.5151066295136,NaN,NaN,NaN,NaN,NaN,80.69139999999993,87.35687163822824,74.02592836177162,83.93722523313613,85.29,85.29,85.29,3684,8629.8,62.7395540075038,68.66171071333164,NaN,NaN,NaN,NaN,1.0549093542279226,37.21212410485614,-2689478,-0.0701429777685727,1.539190632370918,1.6093336101394906
2024-09-30T13:30:00-04:00,85.09,85.17,84.31,85.09,82.5151066295136,NaN,NaN,NaN,NaN,NaN,80.75519999999993,87.52595976829991,73.98444023169995,83.93722523313613,85.0362796279628,85.24975437439105,84.82280488153455,5204,8658.8,62.57352946476403,68.10299002090738,NaN,NaN,NaN,NaN,1.0409872574973567,36.58411008585677,-2694682,-0.13046816748580192,1.4462484007822383,1.5767165682680402
2024-10-01T09:30:00-04:00,85.33,85.5,82.5,82.54,NaN,NaN,NaN,87.61100511871473,87.61100511871473,87.61100511871473,80.78579999999992,87.5746945668664,73.99690543313345,83.93722523313613,83.51333333333334,83.51333333333334,83.51333333333334,2151,8638,45.89687725465178,66.58776533013014,NaN,NaN,NaN,NaN,1.1809167391046884,34.09091285842914,-2696833,-0.3385491374986489,1.1535301463947292,1.492079283893378
2024-10-01T13:30:00-04:00,83.5,83.76,83.22,83.22,NaN,NaN,NaN,87.10323215877317,NaN,NaN,80.83499999999992,87.65800373736032,74.01199626263953,83.93722523313613,83.44282100825576,83.49777015613911,83.38787186037241,3542,8572.433333333332,49.74337066497736,65.28074188124216,NaN,NaN,NaN,NaN,1.1837084005972105,31.77580114724634,-2693291,-0.42142994371320386,0.9652918542518734,1.3867217979650772
2024-10-02T09:30:00-04:00,82.45,83.22,82.07,82.88,NaN,NaN,NaN,86.25081251519255,NaN,NaN,80.88479999999993,87.73039565268282,74.03920434731704,83.93722523313613,82.72333333333333,82.72333333333333,82.72333333333333,3291,8625.266666666666,47.909295490463585,63.70718966271465,NaN,NaN,NaN,NaN,1.18130065769741,30.352283580170496,-2696582,-0.48562645697920503,0.779688726741071,1.265315183720276
2024-10-02T13:30:00-04:00,82.85,83,82.51,82.62,NaN,NaN,NaN,86.25081251519255,NaN,NaN,80.92879999999992,87.79014288897093,74.06745711102892,83.93722523313613,82.71493477282951,82.7213725510022,82.70849699465681,5601,8643.866666666667,46.49744052958335,62.085462719021294,NaN,NaN,NaN,NaN,1.1319220392904519,29.03044583931436,-2702183,-0.5285344760618504,0.6046470886429631,1.1331815647048136
2024-10-03T09:30:00-04:00,82.19,83,82,82.65,NaN,NaN,NaN,85.98560603140479,NaN,NaN,81.01559999999992,87.85199104791644,74.1792089520834,83.93722523313613,82.55,82.55,82.55,2236,8403.9,46.6926451185288,60.36173330982821,NaN,NaN,NaN,NaN,1.122499036483991,28.206247799235705,-2699947,-0.5361382106649902,0.4630088013735758,0.999147012038566
2024-10-03T13:30:00-04:00,82.56,82.66,82.34,82.66,NaN,NaN,NaN,85.87080575725003,NaN,NaN,81.10239999999992,87.90983189169279,74.29496810830705,83.93722523313613,82.55204783258594,82.55367032831676,82.55042533685513,3562,8315.6,46.76237157487903,58.513911474826955,NaN,NaN,NaN,NaN,1.0651776767351342,27.440921047734097,-2696385,-0.5212696892261787,0.34755990050584273,0.8688295897320214
2024-10-04T09:30:00-04:00,83.84,84.39,83.2,84.35,NaN,NaN,NaN,85.87080575725003,NaN,NaN,81.18799999999992,88.04878013057086,74.32721986942897,83.93722523313613,83.98,83.98000095367432,83.97999904632569,1282,8080.133333333333,56.99906596250155,57.640318596232824,NaN,NaN,NaN,NaN,1.112664985539768,25.920249998209528,-2695103,-0.38469367124567255,0.38796250067493077,0.7726561719206033
2024-10-04T13:30:00-04:00,84.2,84.65,84.2,84.62,NaN,NaN,NaN,85.87080575725003,NaN,NaN,81.30619999999993,88.1957188685438,74.41668113145606,83.51678018650892,84.34454505005563,84.57481637264655,84.1142737274647,3213,7879.9,58.37610268315628,56.97542303781233,NaN,NaN,NaN,NaN,1.0653317722869275,24.719640170982142,-2691890,-0.2687375807713478,0.4367341959564186,0.7054717767277664
2024-10-07T09:30:00-04:00,84.88,84.88,84.01,84.28,NaN,NaN,NaN,85.87080575725003,NaN,NaN,81.42319999999992,88.31205992309548,74.53434007690437,82.85742414920713,84.39,84.39,84.39,1917,7882.833333333333,55.94647248212594,56.296620210109324,NaN,NaN,NaN,NaN,1.0513795028378605,23.794176398963277,-2693807,-0.21010053887671676,0.44284610313187045,0.6529466420085872
2024-10-07T13:30:00-04:00,84.25,84.29,83.59,83.66,NaN,NaN,NaN,85.87080575725003,NaN,NaN,81.51179999999994,88.39950230483433,74.62409769516555,82.50369241147891,84.0020552986225,84.24757962821926,83.75653096902573,4786,7949.266666666666,51.71925316098238,55.195305842724544,NaN,NaN,NaN,NaN,1.0262809669208708,22.501682357368843,-2698593,-0.20785390104845225,0.39312926569802187,0.6009831667464741
2024-10-08T09:30:00-04:00,83.67,84.87,83.67,84.61,NaN,NaN,NaN,85.87080575725003,NaN,NaN,81.65859999999992,88.49107540500738,74.82612459499246,82.50369241147891,84.38333333333334,84.38333333333334,84.38333333333334,6184,7864.7,57.071590410515,54.21463425991095,NaN,NaN,NaN,NaN,1.039403754997952,21.80443303927783,-2692409,-0.14040197521392228,0.42548069772907127,0.5658826729429935
2024-10-08T13:30:00-04:00,84.65,85.18,84.65,85.09,NaN,NaN,NaN,85.87080575725003,NaN,NaN,81.82939999999992,88.56884853530534,75.08995146469451,82.9703305146772,84.67749614854456,84.97249496061228,84.38249733647685,6149,7800.366666666667,59.513778205018596,53.46009621497511,NaN,NaN,NaN,NaN,1.0058749153552415,21.413816819144788,-2686260,-0.0652908769970647,0.48426907669666264,0.5495599536937273
2024-10-09T09:30:00-04:00,85.25,85.72,84.8,85.48,NaN,NaN,NaN,85.87080575725003,NaN,NaN,81.99839999999993,88.67143032812098,75.32536967187889,83.49226441174176,85.33333333333333,85.33333428700765,85.33333237965901,4679,7786.933333333333,61.43355997109473,53.36681092666017,NaN,NaN,NaN,NaN,0.9997409928298673,21.479897814588227,-2681581,0.005088615574541433,0.5559207231619041,0.5508321075873627
2024-10-09T13:30:00-04:00,85.49,85.53,85.12,85.3,NaN,NaN,NaN,85.87080575725003,NaN,NaN,82.17719999999991,88.71403230930954,75.64036769069028,83.5428115293934,85.32795387658608,85.33574612019476,85.3201616329774,2230,7454.933333333333,60.01898541044013,53.18434349420847,NaN,NaN,NaN,NaN,0.9576166361991623,21.541258738928565,-2683811,0.03242535373665745,0.5913637997581844,0.558938446021527
2024-10-10T09:30:00-04:00,84.77,86.02,84.4,85.72,82.22167964302733,82.22167964302733,82.22167964302733,NaN,NaN,NaN,82.35699999999991,88.77815410187554,75.93584589812428,83.62024922351473,85.38,85.38,85.38,9744,6719.666666666667,62.205775362052236,54.34926478759422,NaN,NaN,NaN,NaN,1.004929733613507,20.725491483550147,-2674067,0.06956738467580537,0.6458976768662836,0.5763302921904783
2024-10-10T13:30:00-04:00,85.72,85.74,85.14,85.26,82.3197019061468,NaN,NaN,NaN,NaN,NaN,82.51559999999992,88.82298761770896,76.20821238229088,83.62024922351473,85.38,85.38,85.38,3688,5723.233333333334,58.435906290472936,54.97016018941533,NaN,NaN,NaN,NaN,0.9760061812125418,19.96799331784162,-2677755,0.05459003423013531,0.6445678349781474,0.5899778007480121
2024-10-11T09:30:00-04:00,85.04,86.25,85.04,86.2,82.5015336376856,NaN,NaN,NaN,NaN,NaN,82.75179999999993,88.69855802770081,76.80504197229905,83.86915950304943,85.83,85.83,85.83,16071,6167.466666666666,63.32690778382321,56.071418210369586,NaN,NaN,NaN,NaN,0.9927200254116455,19.751395474419734,-2661684,0.09695071032621527,0.7111661886557812,0.6142154783295659
2024-10-11T13:30:00-04:00,86.23,86.37,86.12,86.14,83.21032756324533,NaN,NaN,NaN,NaN,NaN,82.99259999999992,88.47549093088939,77.50970906911046,84.34032760243956,85.92352941176469,86.08721638622524,85.75984243730414,5247,6255.866666666667,62.81877522316314,57.237227831339574,NaN,NaN,NaN,NaN,0.9396685950250995,19.66211721044655,-2666931,0.10899049990023568,0.7504536032048605,0.6414631033046249
2024-10-14T09:30:00-04:00,86.57,87.39,86.3,87.31,83.77781267400691,NaN,NaN,NaN,NaN,NaN,83.20799999999991,88.50298026436693,77.9130197356329,85.14126208195164,87,87,87,12098,6517.966666666666,68.1804669420414,58.77207224730476,NaN,NaN,NaN,NaN,0.9618351239518781,20.435922045148143,-2654833,0.17964191465107882,0.8660154966184734,0.6863735819673946
2024-10-14T13:30:00-04:00,87.29,87.44,87.18,87.26,84.34677573427932,NaN,NaN,NaN,NaN,NaN,83.42799999999993,88.45738723902073,78.39861276097912,85.51100966556132,87.09852921264022,87.23707125185571,86.95998717342472,6119,6634.666666666667,67.73096225994033,60.26982872480914,NaN,NaN,NaN,NaN,0.9117040436696005,21.192727832154215,-2660952,0.2050593065408466,0.9426977151434528,0.7376384086026062
2024-10-15T09:30:00-04:00,87.19,88,85.74,86.96,84.34677573427932,NaN,NaN,NaN,NaN,NaN,83.64319999999992,88.32593157889993,78.96046842109992,85.51100966556132,86.89999999999999,86.89999999999999,86.89999999999999,10925,6164.166666666667,64.96351289436144,60.83871779137055,NaN,NaN,NaN,NaN,1.0080108976932007,20.089462402022992,-2671877,0.1843706799535768,0.9681017585445773,0.7837310785910004
2024-10-15T13:30:00-04:00,86.99,87.41,86.7,87.1,84.34677573427932,NaN,NaN,NaN,NaN,NaN,83.84479999999992,88.22795181576289,79.46164818423695,85.51100966556132,86.97868977384464,87.06345522108715,86.89392432660212,9415,5826.5,65.66849285391527,61.35960280356762,NaN,NaN,NaN,NaN,0.9867244050008288,19.065001645472574,-2662462,0.16352778020475633,0.9881408038469459,0.8246130236421896
2024-10-16T09:30:00-04:00,87.86,87.99,86.74,87.43,84.34677573427932,NaN,NaN,NaN,NaN,NaN,84.03639999999992,88.18591324374728,79.88688675625255,85.51100966556132,87.38666666666666,87.38666666666666,87.38666666666666,2163,5531.8,67.3368348063278,62.17320011243918,NaN,NaN,NaN,NaN,1.0055298046436267,18.670382679384183,-2660299,0.15543344750913968,1.0189048330286141,0.8634713855194744
2024-10-16T13:30:00-04:00,87.54,87.65,87.39,87.54,84.50549408159611,NaN,NaN,NaN,NaN,NaN,84.21359999999991,88.18595398221689,80.24124601778294,85.51100966556132,87.4998018689378,87.55493220835953,87.44467152951606,9109,5615.1,67.89685439553861,63.32874305776463,NaN,NaN,NaN,NaN,0.9522776757405109,18.303950782302106,-2651190,0.1413598376491224,1.0401711825808775,0.8988113449317551
2024-10-17T09:30:00-04:00,87.71,87.76,86.83,87.63,84.50549408159611,NaN,NaN,NaN,NaN,NaN,84.36139999999992,88.28094080984405,80.44185919015578,85.51430044721113,87.40666666666668,87.40666666666668,87.40666666666668,4367,5529.766666666666,68.37462035865511,64.13610233977464,NaN,NaN,NaN,NaN,0.9506864131876177,17.276430264596247,-2646823,0.12267775364420241,1.0521585369870081,0.9294807833428057
2024-10-17T13:30:00-04:00,87.62,87.8,87,87.05,84.50549408159611,NaN,NaN,NaN,NaN,NaN,84.49799999999992,88.30514486197167,80.69085513802817,85.6034403577689,87.34708767361113,87.40871899192288,87.28545635529937,4081,5479.633333333333,61.9736627631588,64.3118083796418,NaN,NaN,NaN,NaN,0.9399230979599305,16.366751455475605,-2650904,0.05904907086689226,1.003292121926421,0.9442430510595288
2024-10-18T09:30:00-04:00,87.7,88.6,87.6,88.55,85.04711407679014,NaN,NaN,NaN,NaN,NaN,84.64579999999992,88.4966556763439,80.79494432365594,86.06775228621512,88.25,88.25,88.25,3913,5448.4,69.83794223213465,64.91212139828751,NaN,NaN,NaN,NaN,0.983500019534221,16.35674453904514,-2646991,0.10319040739580143,1.0732310603042805,0.9700406529084791
2024-10-18T13:30:00-04:00,88.46,88.8,88.46,88.71,85.66951798239059,NaN,NaN,NaN,NaN,NaN,84.80159999999992,88.66720289735402,80.93599710264583,86.6042018289721,88.40173448680977,88.59841189650085,88.2050570771187,2329,5299.333333333333,70.53786806060154,65.66347015901333,NaN,NaN,NaN,NaN,0.9375357324246341,16.538375435016416,-2644662,0.12681508104528882,1.1285595042150902,1.0017444231698014
2024-10-21T09:30:00-04:00,88.2,88.3,87,87.49,85.66951798239059,NaN,NaN,NaN,NaN,NaN,84.93479999999992,88.70152640897012,81.16807359102972,86.6042018289721,87.59666666666668,87.59666666666668,87.59666666666668,3980,5309.2,59.24799100032302,65.45219984746124,NaN,NaN,NaN,NaN,0.9927117515371597,15.710193752061622,-2648642,0.047984450155009295,1.0617249858635631,1.0137405357085538
2024-10-21T13:30:00-04:00,87.54,87.88,87.38,87.81,85.66951798239059,NaN,NaN,NaN,NaN,NaN,85.07559999999992,88.73382724280881,81.41737275719103,86.6042018289721,87.64820582058206,87.69461742091164,87.60179422025249,4908,5299.333333333333,61.01072536003976,65.63611549528744,NaN,NaN,NaN,NaN,0.9575180549987913,14.9411679036036,-2643734,0.007239087212039141,1.0227893947236026,1.0155503075115635
2024-10-22T09:30:00-04:00,87.41,87.48,86.96,87.3,85.66951798239059,NaN,NaN,NaN,NaN,NaN,85.18459999999992,88.77605922433105,81.59314077566879,86.6042018289721,87.24666666666667,87.24666666666667,87.24666666666667,2548,5312.566666666667,56.79427232650506,65.16949867690757,NaN,NaN,NaN,NaN,0.9498381939274497,14.652847958835977,-2646282,-0.06048438867454964,0.9399448216683766,1.0004292103429262
2024-10-22T13:30:00-04:00,87.23,87.55,87.23,87.36,85.66951798239059,NaN,NaN,NaN,NaN,NaN,85.29959999999991,88.79274290575667,81.80645709424316,86.6042018289721,87.33512701976842,87.39813082659148,87.27212321294536,5023,5361.933333333333,57.16929888116349,64.76596465247903,NaN,NaN,NaN,NaN,0.90484975150406,14.296951892683976,-2641259,-0.10505312205498041,0.8691128077742007,0.9741659298291812
2024-10-23T09:30:00-04:00,87.23,87.23,85.1,85.26,NaN,NaN,NaN,89.21943028501076,89.21943028501076,89.21943028501076,85.36559999999992,88.72603368630269,82.00516631369715,86.6042018289721,85.86333333333333,85.86333333333333,85.86333333333333,6889,5481.866666666667,43.07609462859537,62.97279520151859,NaN,NaN,NaN,NaN,1.001646197825199,15.690821831790155,-2648148,-0.27037926129525913,0.6361918532101072,0.9065711145053663
2024-10-23T13:30:00-04:00,85.19,85.46,84.72,85.38,NaN,NaN,NaN,88.1065016356921,NaN,NaN,85.4397999999999,88.63008397482851,82.2495160251713,86.6042018289721,85.6814190193165,85.98142324402023,85.38141479461275,2533,5379.6,43.92674150010661,61.272493718673324,NaN,NaN,NaN,NaN,0.9829571836948272,17.21602826632072,-2645615,-0.3604356709574956,0.4560265258084968,0.8164621967659924
2024-10-24T09:30:00-04:00,87.33,88.14,87.27,87.74,84.44924843865755,84.44924843865755,84.44924843865755,NaN,NaN,NaN,85.50419999999991,88.74717909953876,82.26122090046107,86.6042018289721,87.71666666666665,87.71666666666665,87.71666666666665,14281,5781.1,57.407237456370915,60.73275975881686,NaN,NaN,NaN,NaN,1.1098888134309113,15.988917174479617,-2631334,-0.2548204937772276,0.4979365795444579,0.7527570733216855
2024-10-24T13:30:00-04:00,87.74,88.38,87.74,88.27,84.86496441871857,NaN,NaN,NaN,NaN,NaN,85.58459999999992,88.89778387054449,82.27141612945536,86.6042018289721,87.88362855990093,88.08644532961871,87.68081179018314,9678,5984.966666666666,59.74763700989718,60.30984148424414,NaN,NaN,NaN,NaN,1.0763253267572748,15.031037795399202,-2621656,-0.1483042161973771,0.5673768030749642,0.7156810192723413
2024-10-25T09:30:00-04:00,88.75,89.71,88.65,88.89,85.93382967241318,NaN,NaN,NaN,NaN,NaN,85.68739999999993,89.0844147129556,82.29038528704424,86.6042018289721,89.08333333333333,89.08333333333333,89.08333333333333,6596,6162.1,62.35365561291404,59.95390011328601,NaN,NaN,NaN,NaN,1.102302089131755,15.058522455834545,-2615060,-0.04072530057364021,0.664774393555291,0.7054996941289312
2024-10-25T13:30:00-04:00,88.81,88.98,88.29,88.57,85.93382967241318,NaN,NaN,NaN,NaN,NaN,85.77799999999992,89.23552975403534,82.3204702459645,86.54408296153807,88.86330269311402,89.09782543884705,88.62877994738099,5806,6248.533333333334,60.18776114443268,59.40325059534988,NaN,NaN,NaN,NaN,1.072851939908058,14.779099809496572,-2620866,0.001984408675821614,0.7079802049737083,0.7059957962978867
2024-10-28T09:30:00-04:00,89.68,90.22,89.51,90.02,86.59241505275665,NaN,NaN,NaN,NaN,NaN,85.88559999999993,89.52485302226106,82.2463469777388,87.09281309538437,89.91666666666667,89.91666666666667,89.91666666666667,14357,6663.2,65.95799268301502,59.230634332804165,NaN,NaN,NaN,NaN,1.1140768013431972,15.285394733845045,-2606509,0.11474918465045025,0.8494322771109495,0.7346830924604992
2024-10-28T13:30:00-04:00,90.09,90.16,89.62,89.74,86.6925325503586,NaN,NaN,NaN,NaN,NaN,85.98959999999992,89.76379651847142,82.21540348152843,87.38825047630749,89.88263317582049,89.92072458953336,89.84454176210761,11461,6885.7,64.02814828421454,59.37738329859386,NaN,NaN,NaN,NaN,1.0730713155329683,15.755525735025769,-2617970,0.15484570835693678,0.9282402279066702,0.7733945195497334
2024-10-29T09:30:00-04:00,90,90.94,89.51,90.84,86.97787197988775,NaN,NaN,NaN,NaN,NaN,86.10579999999993,90.10567417802514,82.10592582197472,88.007600381046,90.42999999999999,90.42999999999999,90.42999999999999,15339,7190.866666666667,67.99050055457118,59.24542317876789,NaN,NaN,NaN,NaN,1.0985662215663272,16.643574179051328,-2602631,0.23500870470765511,1.0671554004343022,0.8321466957266471
2024-10-29T13:30:00-04:00,90.85,91.04,90.66,90.66,87.6986505262565,NaN,NaN,NaN,NaN,NaN,86.20699999999992,90.40185637418516,82.01214362581469,88.5040803048368,90.62340952721992,90.80110445161256,90.44571460282728,18172,7591.633333333333,66.6958469515014,58.970993099546455,NaN,NaN,NaN,NaN,1.0472400628830187,17.52485164560901,-2620803,0.2538600711014187,1.1494717846034206,0.8956117135020019
2024-10-30T09:30:00-04:00,90.71,91.58,90.14,91.46,87.6986505262565,NaN,NaN,NaN,NaN,NaN,86.33259999999991,90.76620586431068,81.89899413568915,88.83126424386944,91.06,91.06,91.06,2741,7527.033333333334,69.47764471936719,59.701682650906754,NaN,NaN,NaN,NaN,1.0752943441056602,18.649377128558548,-2618062,0.2952569879537046,1.2646829484441326,0.9694259604904281
2024-10-30T13:30:00-04:00,91.3,91.5,90.65,90.65,87.90027868198165,NaN,NaN,NaN,NaN,NaN,86.4457999999999,91.02320029274856,81.86839970725126,88.87601139509556,90.9638022524499,91.01794134546043,90.90966315943936,8654,7741.166666666667,63.67806241362996,59.892206726163195,NaN,NaN,NaN,NaN,1.0592018909552554,19.693579362725973,-2626716,0.24519553512062497,1.2759203793912093,1.0307248442705843
2024-10-31T09:30:00-04:00,88.81,88.83,86.7,87.28,NaN,NaN,NaN,91.33405216719933,91.33405216719933,91.33405216719933,86.49699999999991,91.05326030863573,81.9407396913641,88.87601139509556,87.60333333333334,87.60333333333334,87.60333333333334,8506,7699.9,46.34474497401648,59.14581191527116,NaN,NaN,NaN,NaN,1.2656874701727374,19.13430323327954,-2635222,-0.02349801750378111,1.0013523223908578,1.024850339894639
2024-10-31T13:30:00-04:00,87.08,87.39,86.73,86.97,NaN,NaN,NaN,90.55682252323574,NaN,NaN,86.53419999999991,91.07490142599707,81.99349857400276,88.87601139509556,87.40461770881345,87.67745903992588,87.13177637770102,4512,7727.366666666667,45.12785034783145,58.285708448604574,NaN,NaN,NaN,NaN,1.2224240794461132,18.61497539879356,-2639734,-0.21980496662901994,0.750094131608364,0.969899098237384
2024-11-01T09:30:00-04:00,86.85,88.17,86.85,87.73,NaN,NaN,NaN,90.55682252323574,NaN,NaN,86.5679999999999,91.11863248351948,82.01736751648032,88.87601139509556,87.58333333333333,87.58333333333333,87.58333333333333,5095,7361.5,48.68523941027646,58.68636164729609,NaN,NaN,NaN,NaN,1.2293937880571058,17.557640431710418,-2634639,-0.29166478012172636,0.605318123085226,0.8969829032069524
2024-11-01T13:30:00-04:00,87.51,87.51,87.17,87.42,NaN,NaN,NaN,90.55682252323574,NaN,NaN,86.5971999999999,91.15058825931433,82.04381174068547,88.87601139509556,87.44828108827443,87.55326780585699,87.34329437069186,8431,7467.633333333333,47.33716332208808,58.92996320600905,NaN,NaN,NaN,NaN,1.181579946053027,16.5758293908475,-2643070,-0.3493766670289049,0.46026206942082126,0.8096387364497262
2024-11-04T09:30:00-05:00,86.5,87.72,86.4,87.09,NaN,NaN,NaN,90.51823003265272,NaN,NaN,86.6367999999999,91.17216757496757,82.10143242503221,88.87601139509556,87.07000000000001,87.07000000000001,87.07000000000001,3866,7193.233333333334,45.88075035587942,58.10664269883108,NaN,NaN,NaN,NaN,1.1914670927635245,16.187207419172342,-2646936,-0.3956756083476751,0.31504422601513227,0.7107198343628074
2024-11-04T13:30:00-05:00,87.15,87.2,86.52,86.58,NaN,NaN,NaN,90.2537650311685,NaN,NaN,86.6665999999999,91.18045176540602,82.15274823459379,88.87601139509556,86.96962386062074,87.11235458467847,86.82689313656302,1912,7053,43.6458107478814,56.95651225154425,NaN,NaN,NaN,NaN,1.154933728994702,15.826344159759698,-2648848,-0.44297942420662506,0.15699555410452604,0.5999749783111511
2024-11-05T09:30:00-05:00,87.67,89.71,87.67,89.61,NaN,NaN,NaN,90.2537650311685,NaN,NaN,86.80799999999991,91.23808622941547,82.37791377058434,88.87601139509556,88.99666666666667,88.99666762034099,88.99666571299235,5654,6877.3,57.03624467076796,56.5766971842481,NaN,NaN,NaN,NaN,1.2960098912093656,15.674641854381433,-2643194,-0.2615091621387011,0.27308852563777464,0.5345976877764758
2024-11-05T13:30:00-05:00,89.54,89.89,89.36,89.46,NaN,NaN,NaN,90.2537650311685,NaN,NaN,86.9327999999999,91.30270991212184,82.56289008787796,88.87601139509556,89.29923265397038,89.58545807104463,89.01300723689613,6318,6774.066666666667,56.32275831226197,56.300625553378765,NaN,NaN,NaN,NaN,1.2412948989801253,15.638363095914482,-2649512,-0.14850484978141498,0.34896662554970703,0.497471475331122
2024-11-06T09:30:00-05:00,93.63,95.48,93,95.41,90.00950902013041,90.00950902013041,90.00950902013041,NaN,NaN,NaN,87.18339999999989,92.00832795387326,82.35847204612652,89.79447673915183,94.63,94.63,94.63,16350,7246.966666666666,71.5341579404442,56.698923071766544,NaN,NaN,NaN,NaN,1.5826309776244027,17.79837111893899,-2633162,0.3052886807984144,0.8790823263291401,0.5737936455307256
2024-11-06T13:30:00-05:00,95.46,96.31,95.33,96.21,91.64816770103356,NaN,NaN,NaN,NaN,NaN,87.45519999999989,92.73126101557463,82.17913898442515,91.27158139132146,95.2771814695888,95.93705697699774,94.61730596217986,15727,7467.566666666667,72.90072020978714,57.332678209307446,NaN,NaN,NaN,NaN,1.5395859077940888,20.0156323367757,-2617435,0.6195369011265387,1.348214771938899,0.7286778708123604
2024-11-07T09:30:00-05:00,96.11,97.84,96,97.61,92.68688735098658,NaN,NaN,NaN,NaN,NaN,87.75439999999989,93.57515068698757,81.93364931301221,92.88926511305718,97.14999999999999,97.14999999999999,97.14999999999999,45387,8834.9,75.14910271191057,57.84400693483168,NaN,NaN,NaN,NaN,1.5610440572373683,22.432583957918535,-2572048,0.8667259618241601,1.8120853230925604,0.9453593612684004
2024-11-07T13:30:00-05:00,97.6,98.17,97.36,97.63,93.61384701685083,NaN,NaN,NaN,NaN,NaN,88.05379999999988,94.31866570008278,81.78893429991699,93.80441209044574,97.23691613915186,97.44182534848721,97.0320069298165,8166,8971.066666666668,75.18078285758313,58.4500737852661,NaN,NaN,NaN,NaN,1.5073980531489848,24.75024792748033,-2563882,0.9688817615388428,2.1564615631919537,1.187579801653111
2024-11-08T09:30:00-05:00,96.79,98.03,96.79,98.03,93.61384701685083,NaN,NaN,NaN,NaN,NaN,88.32739999999988,95.0959765830103,81.55882341698947,93.9175296723566,97.61666666666667,97.61666666666667,97.61666666666667,22371,9586.333333333334,75.84404318222208,58.90481653261287,NaN,NaN,NaN,NaN,1.4882981922097713,26.462628491528466,-2541511,0.9968207819366204,2.4336057790738863,1.436784997137266
2024-11-08T13:30:00-05:00,98.12,98.88,98.1,98.88,94.43033374882482,NaN,NaN,NaN,NaN,NaN,88.61259999999989,95.9130984049086,81.31210159509118,95.16502373788526,97.98101659691974,98.46352417027649,97.498509023563,12756,9933.9,77.23618840288457,59.873254103273915,NaN,NaN,NaN,NaN,1.4427054641947874,28.272466717632742,-2528755,1.003223545780043,2.6908144293623195,1.6875908835822766
2024-11-11T09:30:00-05:00,102,104.88,102,103.98,98.74668221478733,NaN,NaN,NaN,NaN,NaN,89.00659999999989,97.37721394164512,80.63598605835466,98.90801899030822,103.61999999999999,103.62000134869915,103.61999865130083,21466,10516.766666666666,83.41299709574874,62.520986397683366,NaN,NaN,NaN,NaN,1.7682265024665882,31.0315051762102,-2507289,1.2647306796140452,3.268504233099833,2.0037735534857877
2024-11-11T13:30:00-05:00,104.16,104.92,104.16,104.8,99.93183302320608,NaN,NaN,NaN,NaN,NaN,89.42939999999987,98.7578385917514,80.10096140824835,99.67241519224658,103.94531378422407,104.41611468118894,103.4745128872592,10249,10694.8,84.15734421858647,65.30880738845158,NaN,NaN,NaN,NaN,1.7090674665761174,33.59877494207938,-2497040,1.3964014761024472,3.7492753986138467,2.3528739225113995
2024-11-12T09:30:00-05:00,104.5,106.12,104.25,104.69,100.53129515851491,NaN,NaN,NaN,NaN,NaN,89.83099999999989,99.98714986104801,79.67485013895177,100.98693215379727,105.02,105.02,105.02,12100,11013.2,83.61527253793564,67.80380975471294,NaN,NaN,NaN,NaN,1.7205626475349665,36.14213106180833,-2509140,1.3772578621854281,4.074446250243184,2.6971883880577563
2024-11-12T13:30:00-05:00,105,105.9,105,105.37,100.84282719676423,NaN,NaN,NaN,NaN,NaN,90.2365999999999,101.1914167378586,79.28178326214119,101.1885457230378,105.21756837282514,105.41919339218337,105.01594335346691,11618,11233.033333333333,84.28897796508882,70.44322508635585,NaN,NaN,NaN,NaN,1.6840938869967552,38.50381888727092,-2497522,1.3118671426192101,4.337022316331769,3.025155173712559
2024-11-13T09:30:00-05:00,106,107.75,106,106.27,102.1526986878204,NaN,NaN,NaN,NaN,NaN,90.65239999999989,102.40280531045921,78.90199468954056,102.79083657843024,106.67333333333333,106.67333333333333,106.67333333333333,23150,11775.066666666668,85.15877676047708,73.24879840096996,NaN,NaN,NaN,NaN,1.7338014664969867,40.933991370596516,-2474372,1.2319673982185266,4.565114421485717,3.3331470232671903
2024-11-13T13:30:00-05:00,106.5,106.5,103.97,104.61,102.1526986878204,NaN,NaN,NaN,NaN,NaN,91.03859999999987,103.31739212952482,78.75980787047493,102.79083657843024,106.0727789974387,106.86539952207673,105.28015847280068,13290,12133.633333333333,76.72186026518703,75.6113733664918,NaN,NaN,NaN,NaN,1.7906727903186306,41.79780617482427,-2487662,0.9809810324925343,4.559373313882858,3.578392281390324
2024-11-14T09:30:00-05:00,104.805,104.91,102.89,103.74,102.1526986878204,NaN,NaN,NaN,NaN,NaN,91.39899999999989,104.0833300177847,78.71466998221507,102.79083657843024,103.84666666666668,103.84666666666668,103.84666666666668,24798,12484.2,72.65893164945119,76.7272795792549,NaN,NaN,NaN,NaN,1.8070533052958708,41.93517068845264,-2512460,0.6840981072559753,4.433514915460293,3.7494168082043178
2024-11-14T13:30:00-05:00,103.5,103.76,102.45,102.45,102.1526986878204,NaN,NaN,NaN,NaN,NaN,91.74279999999987,104.67239460463007,78.81320539536968,102.79083657843024,103.36610598676172,103.84610565930411,102.88610631421933,24856,12990.133333333333,66.99380223502122,77.48949700230914,NaN,NaN,NaN,NaN,1.7715494977747372,41.795923372754956,-2537316,0.3456485844303061,4.1814775387422,3.835828954311894
2024-11-15T09:30:00-05:00,102,102.35,100.81,101.52,NaN,NaN,NaN,106.44568400166484,106.44568400166484,106.44568400166484,92.04919999999989,105.16364140785535,78.93475859214442,102.79083657843024,101.56,101.56,101.56,16310,13313.933333333332,63.169882081256326,76.89204872665286,NaN,NaN,NaN,NaN,1.7621531050765415,40.72206045753391,-2553626,0.021074562695376997,3.8621721576811154,3.8410975949857384
2024-11-15T13:30:00-05:00,101.5,102.47,101.29,102.42,NaN,NaN,NaN,106.44568400166484,NaN,NaN,92.37479999999988,105.69303185862441,79.05656814137535,102.79083657843024,101.65813728872025,101.85672660595908,101.45954797148143,3983,13253.166666666666,65.23776579999114,76.34469484023886,NaN,NaN,NaN,NaN,1.7205707404282167,39.76355522633651,-2549643,-0.1610495656215205,3.6397856379588376,3.800835203580358
2024-11-18T09:30:00-05:00,103.17,104.75,102.43,104.21,NaN,NaN,NaN,106.44568400166484,NaN,NaN,92.71279999999987,106.35361759426762,79.07198240573213,102.79083657843024,103.79666666666667,103.79666666666667,103.79666666666667,21870,13503.6,68.96947146863818,75.90329260857655,NaN,NaN,NaN,NaN,1.7641014018262011,39.55547156067591,-2527773,-0.1871768273700658,3.5668641693677756,3.7540409967378414
2024-11-18T13:30:00-05:00,104.2,105,103.18,104.77,NaN,NaN,NaN,106.44568400166484,NaN,NaN,93.06299999999989,107.02125160971349,79.10474839028629,102.79083657843024,103.9901456640539,104.24149195149934,103.73879937660845,12959,13553.533333333333,70.05259640854527,75.53699357650241,NaN,NaN,NaN,NaN,1.7680941588386148,39.43113488416569,-2514814,-0.192227753725148,3.513756304581406,3.705984058306554
2024-11-19T09:30:00-05:00,103.86,106.23,103.7,106.18,NaN,NaN,NaN,106.44568400166484,NaN,NaN,93.44739999999989,107.76614509026778,79.12865490973199,102.79083657843024,105.37,105.37000134869916,105.36999865130085,12276,13451.433333333332,72.64194417831347,75.30827221908037,NaN,NaN,NaN,NaN,1.8225160046358566,39.648180221578436,-2502538,-0.12912052328684842,3.5445834041979936,3.673703927484842
2024-11-19T13:30:00-05:00,106.15,106.52,105.99,106.38,101.36143751496354,101.36143751496354,101.36143751496354,NaN,NaN,NaN,93.83299999999988,108.48184719013993,79.18415280985984,102.79083657843024,105.85198837724442,106.31494600717599,105.38903074731286,13306,13289.233333333334,72.99857061123308,75.0055852339624,NaN,NaN,NaN,NaN,1.7301934328761526,39.92637052050795,-2489232,-0.10352634734111188,3.5442959933084524,3.6478223406495642
2024-11-20T09:30:00-05:00,106.44,107.05,104.43,105.43,101.36143751496354,NaN,NaN,NaN,NaN,NaN,94.19299999999987,109.07754513917334,79.3084548608264,102.35792183870096,105.63666666666667,105.63666666666667,105.63666666666667,27938,14129.133333333333,68.4351961488577,73.93574230918446,NaN,NaN,NaN,NaN,1.7937510448135696,39.184834373290435,-2517170,-0.17594067210162256,3.427896500522536,3.6038371726241585
2024-11-20T13:30:00-05:00,105.38,105.97,104.69,105.76,101.36143751496354,NaN,NaN,NaN,NaN,NaN,94.55739999999986,109.66306718023692,79.4517328197628,102.35792183870096,105.59539642627863,105.66637228969725,105.52442056286,9446,14155.533333333333,69.15648729698738,72.86425252907024,NaN,NaN,NaN,NaN,1.7570545416126004,38.49626509373131,-2507724,-0.22390113373422027,3.3239607554563833,3.5478618891906035
2024-11-21T09:30:00-05:00,107.22,107.26,105,107.21,101.36143751496354,NaN,NaN,NaN,NaN,NaN,94.94899999999986,110.32871820288311,79.5692817971166,102.61506997676862,106.49,106.49000134869915,106.48999865130084,7054,14107.133333333333,72.16616069009673,72.04645882565319,NaN,NaN,NaN,NaN,1.7929792172117007,38.2872820531115,-2500670,-0.18203412160849286,3.3203192371799872,3.50235335878848
2024-11-21T13:30:00-05:00,107.35,107.35,106.36,106.36,101.89338302689204,NaN,NaN,NaN,NaN,NaN,95.33519999999986,110.87110898016887,79.79929101983085,103.13905598141488,106.58433792690234,106.68417750285695,106.48449835094772,6298,14166.666666666666,67.978579613232,70.88143037194912,NaN,NaN,NaN,NaN,1.735623558839436,38.12260982429546,-2506968,-0.2324254613317729,3.211821532123764,3.444246993455537
2024-11-22T09:30:00-05:00,106.07,108.65,106.05,108.34,102.25936561657878,NaN,NaN,NaN,NaN,NaN,95.73099999999985,111.56086759262689,79.90113240737281,103.98124478513192,107.67999999999999,107.67999999999999,107.67999999999999,12637,14418.066666666668,72.04751667771693,69.94491179460911,NaN,NaN,NaN,NaN,1.7973647332080485,38.38282625382069,-2494331,-0.15686721811146143,3.2481629708162103,3.4050301889276717
2024-11-22T13:30:00-05:00,108.36,108.65,108.06,108.21,103.41530354309793,NaN,NaN,NaN,NaN,NaN,96.12099999999985,112.1986487086916,80.04335129130811,104.61999582810553,108.0867503471258,108.38583401319603,107.78766668105557,23373,14916.133333333333,71.40595610797237,69.56520435480807,NaN,NaN,NaN,NaN,1.7111243951217594,38.624455795522685,-2517704,-0.14062484284892474,3.2292491353665156,3.3698739782154403
2024-11-25T09:30:00-05:00,109.5,109.5,107.5,108.39,103.51210792750257,NaN,NaN,NaN,NaN,NaN,96.53899999999985,112.7832182945228,80.2947817054769,105.27599666248442,108.46333333333334,108.46333333333334,108.46333333333334,11116,15157.8,71.78065244948216,69.50247012623886,NaN,NaN,NaN,NaN,1.7317583668987766,39.11552770199421,-2506588,-0.14230796838770843,3.191989017730805,3.334296986118513
2024-11-25T13:30:00-05:00,108.37,108.39,107.55,107.85,103.51210792750257,NaN,NaN,NaN,NaN,NaN,96.93979999999985,113.29129925358862,80.58830074641108,105.27599666248442,108.2779798869128,108.53194695431003,108.02401281951558,5921,15291.433333333332,68.86517641583751,69.63613971058288,NaN,NaN,NaN,NaN,1.6680613406917215,39.571523043717754,-2512509,-0.20076258763493504,3.0833437515748443,3.2841063392097793
2024-11-26T09:30:00-05:00,107.18,108.02,107.08,107.83,103.51210792750257,NaN,NaN,NaN,NaN,NaN,97.35039999999985,113.74402117898616,80.95677882101354,105.27599666248442,107.64333333333335,107.64333333333335,107.64333333333335,6893,15332.733333333334,68.75379322450519,70.03499050652923,NaN,NaN,NaN,NaN,1.6160569592137413,39.58450089777101,-2519402,-0.2580934278269025,2.9614895544261515,3.219582982253054
2024-11-26T13:30:00-05:00,107.29,107.29,106.09,106.37,103.51210792750257,NaN,NaN,NaN,NaN,NaN,97.73059999999987,114.06143630926744,81.3997636907323,105.27599666248442,107.04283776701675,107.56812851996044,106.51754701407306,9008,15422.4,60.99773207862808,69.7321309550033,NaN,NaN,NaN,NaN,1.6249100335556166,38.77579030821738,-2528410,-0.40302371646913215,2.7158033366666388,3.118827053135771
2024-11-27T09:30:00-05:00,107.38,107.62,106.2,106.9,103.51210792750257,NaN,NaN,NaN,NaN,NaN,98.16339999999985,114.29510523410663,82.03169476589308,105.27599666248442,106.90666666666668,106.90666666666668,106.90666666666668,1877,14939.966666666667,62.645133536472144,69.28039253127716,NaN,NaN,NaN,NaN,1.6102736025873585,38.17174811434728,-2526533,-0.46734643352980054,2.53464401122352,3.0019904447533206
2024-11-27T13:30:00-05:00,106.98,107.72,106.98,107.49,103.51210792750257,NaN,NaN,NaN,NaN,NaN,98.60559999999985,114.52211226117382,82.68908773882589,105.27599666248442,107.27339498726712,107.48601487336478,107.06077510116947,5584,14601.866666666667,64.44551606363231,68.87988679235481,NaN,NaN,NaN,NaN,1.5538254881168323,37.65698624158819,-2520949,-0.4728797463492036,2.410890761816816,2.8837705081660197
2024-11-29T09:30:00-05:00,107.83,109,107.74,108.24,103.70427888892237,NaN,NaN,NaN,NaN,NaN,99.01559999999985,114.84733378250473,83.18386621749497,105.57972526909032,108.32666666666667,108.32666666666667,108.32666666666667,17807,13682.533333333333,66.64619611725502,68.45161907370777,NaN,NaN,NaN,NaN,1.5506950961084875,37.73766193601056,-2503142,-0.42998631932235565,2.346287609013075,2.7762739283354305
2024-12-02T09:30:00-05:00,109.47,110.65,109.39,109.85,105.23772075760772,NaN,NaN,NaN,NaN,NaN,99.44719999999985,115.26023211405399,83.63416788594571,106.70878021527226,109.96333333333332,109.96333468203248,109.96333198463417,30774,14436.133333333333,70.82138811220733,68.29610603806307,NaN,NaN,NaN,NaN,1.612074017815025,38.406803768530835,-2472368,-0.303125277582287,2.3973673313575716,2.7004926089398587
2024-12-02T13:30:00-05:00,109.9,110.46,109.79,110.13,105.46873345044372,NaN,NaN,NaN,NaN,NaN,99.87199999999984,115.66894856610323,84.07505143389646,106.9720241722178,110.00828933217147,110.08123980382109,109.93533886052185,11687,14080,71.48980604188874,68.51429245899386,NaN,NaN,NaN,NaN,1.5447830165425225,39.02814975587109,-2460681,-0.21447183615287413,2.432402813748766,2.64687464990164
2024-12-03T09:30:00-05:00,109.01,111.02,109.01,110.62,105.46873345044372,NaN,NaN,NaN,NaN,NaN,100.31299999999985,116.05429613469308,84.57170386530662,107.22461933777424,110.21666666666664,110.21666857401527,110.21666475931801,10515,14005.3,72.66971983828937,68.76523764051544,NaN,NaN,NaN,NaN,1.5780128010751988,38.87648738663731,-2450166,-0.14052300418706487,2.471220894667809,2.611743898854874
2024-12-03T13:30:00-05:00,110.6,111.27,110.6,111.18,106.33941415629273,NaN,NaN,NaN,NaN,NaN,100.73619999999984,116.48560247247846,84.98679752752122,107.8986954702194,110.5953082214653,110.99473758545467,110.19587885747593,9449,13604.733333333334,73.99434945233685,68.89582255210402,NaN,NaN,NaN,NaN,1.513154743855542,38.84100672524924,-2440717,-0.07487973970504935,2.518144224223562,2.5930239639286112
2024-12-04T09:30:00-05:00,112.57,114.11,112.32,113.89,108.42875896737034,NaN,NaN,NaN,NaN,NaN,101.21919999999986,117.07098240577697,85.36741759422274,109.94795637617553,113.44000000000001,113.44000000000001,113.44000000000001,11186,13635.966666666667,79.23849904173085,69.70010251128251,NaN,NaN,NaN,NaN,1.6143579764372884,39.786847013598894,-2429531,0.11949527087056477,2.7423930525168174,2.6228977816462526
2024-12-04T13:30:00-05:00,113.87,115,113.8,115,109.66767901430805,NaN,NaN,NaN,NaN,NaN,101.70239999999987,117.73111451364986,85.67368548634988,111.07036510094042,114.12914725306626,114.69878474932783,113.5595097568047,16372,13778.366666666667,80.9343846232219,70.3348787931043,NaN,NaN,NaN,NaN,1.5847609781203396,40.904064676910004,-2413159,0.281986770703468,2.975381245025588,2.69339447432212
2024-12-05T09:30:00-05:00,116.27,116.73,115.35,115.42,111.28687542274858,NaN,NaN,NaN,NaN,NaN,102.19759999999988,118.36045349064575,86.03474650935401,112.72129208075233,115.83333333333333,115.83333333333333,115.83333333333333,63130,15495.433333333332,81.548541741898,71.05934919552756,NaN,NaN,NaN,NaN,1.595135193968887,42.34741906408107,-2350029,0.37129933783869484,3.1575186466204883,2.7862193087817935
2024-12-05T13:30:00-05:00,115.45,115.96,114.93,115.03,111.28687542274858,NaN,NaN,NaN,NaN,NaN,102.66899999999987,118.92627271100814,86.4117272889916,112.72129208075233,115.76924759307695,115.94142436589271,115.5970708202612,8746,15015.3,79.0036130624628,71.5752749535976,NaN,NaN,NaN,NaN,1.5547683943996797,43.31642526798068,-2358775,0.35752428132990577,3.233124660444176,2.87560037911427
2024-12-06T09:30:00-05:00,116.66,118.5,116.29,118.42,112.45690508560358,NaN,NaN,NaN,NaN,NaN,103.22439999999986,119.69728834904473,86.751511650955,113.7874269316815,117.73666666666668,117.73666666666668,117.73666666666668,13867,15034.533333333333,83.75058717586536,72.63851857931387,NaN,NaN,NaN,NaN,1.6915706519425595,44.76297313644563,-2344908,0.5202739097584788,3.525942766312369,3.00566885655389
2024-12-06T13:30:00-05:00,118.2,118.82,117.935,118.75,113.54318212716704,NaN,NaN,NaN,NaN,NaN,103.85379999999985,120.24639290777732,87.46120709222238,114.6074415453452,118.09321699009192,118.47483573213668,117.71159824804715,12105,14611.433333333332,84.12680178857427,73.73659061960451,NaN,NaN,NaN,NaN,1.6339584625180905,46.16608682510414,-2332803,0.5886663256381377,3.741501763601562,3.1528354379634242
2024-12-09T09:30:00-05:00,118.78,118.98,114.54,116.21,113.54318212716704,NaN,NaN,NaN,NaN,NaN,104.43859999999984,120.46227548848039,88.41492451151929,114.6074415453452,116.57666666666667,116.57666666666667,116.57666666666667,31845,14844.4,70.58137842005563,74.42113678684935,NaN,NaN,NaN,NaN,1.8343900009096554,45.02395266325889,-2364648,0.40983384045379756,3.6651277385306713,3.2552938980768737
2024-12-09T13:30:00-05:00,116.22,116.44,115.07,115.45,113.54318212716704,NaN,NaN,NaN,NaN,NaN,104.99299999999985,120.57807709317174,89.40792290682796,114.6074415453452,116.3150687161483,116.73113195644599,115.89900547585061,12589,14720.366666666667,67.10004533518426,74.73934477247164,NaN,NaN,NaN,NaN,1.8012192865589662,43.96339951297401,-2377237,0.19808161857701911,3.5028959212981476,3.3048143027211285
2024-12-10T09:30:00-05:00,115.86,117.33,114,114.25,113.54318212716704,NaN,NaN,NaN,NaN,NaN,105.52959999999985,120.49266811319531,90.56653188680438,114.6074415453452,115.19333333333333,115.19333333333333,115.19333333333333,13946,15052.466666666667,61.907822667882314,74.55808095848947,NaN,NaN,NaN,NaN,1.9104179089476114,42.3210103145982,-2391183,-0.0517348952788681,3.2401456836225435,3.2918805789014116
2024-12-10T13:30:00-05:00,114.17,114.36,113.16,113.83,NaN,NaN,NaN,119.06738113101233,119.06738113101233,119.06738113101233,106.06439999999986,120.24394817898308,91.88485182101665,114.6074415453452,114.74095776111163,115.39914154888889,114.08277397333437,6588,14543.066666666668,60.15336399513015,74.09430723548056,NaN,NaN,NaN,NaN,1.859673772594211,40.30844971720909,-2397771,-0.2624178833918327,2.963858224661621,3.2262761080534537
2024-12-11T09:30:00-05:00,115.65,117.21,115.39,117.21,NaN,NaN,NaN,119.06738113101233,NaN,NaN,106.67699999999985,120.06076165359038,93.29323834640932,114.6074415453452,116.60333333333334,116.60333333333334,116.60333333333334,13750,14569.433333333332,68.0103966933895,73.89352213413643,NaN,NaN,NaN,NaN,1.9682685031231955,39.48773938593832,-2384021,-0.19442315939243082,2.9832471588129152,3.177670318205346
2024-12-11T13:30:00-05:00,117.25,117.46,117.1,117.25,NaN,NaN,NaN,119.06738113101233,NaN,NaN,107.22979999999986,120.01820067561663,94.44139932438308,114.6074415453452,117.00035250281904,117.32754545107117,116.67315955456691,20245,14835.066666666668,68.09058549218955,73.65072066630077,NaN,NaN,NaN,NaN,1.8533921814715384,38.80643560558451,-2363776,-0.16803090755644412,2.967631683759791,3.135662591316235
2024-12-12T09:30:00-05:00,116.57,118.08,116.57,117.62,NaN,NaN,NaN,119.06738113101233,NaN,NaN,107.79299999999985,119.8615397625446,95.7244602374551,114.6074415453452,117.42333333333333,117.42333468203249,117.42333198463417,10797,14751.433333333332,68.8679749392755,73.37916745922836,NaN,NaN,NaN,NaN,1.828864168509286,38.37748135767061,-2352979,-0.14765499926372883,2.951093842236574,3.098748841500303
2024-12-12T13:30:00-05:00,117.56,117.56,116.12,116.56,NaN,NaN,NaN,119.06738113101233,NaN,NaN,108.21599999999984,119.9980059412703,96.43399405872937,114.6074415453452,117.14873424687688,117.48101032218545,116.81645817156831,7374,14065.966666666667,64.05347355485105,72.66910489512223,NaN,NaN,NaN,NaN,1.8053738707586224,37.68664949114691,-2360353,-0.22304088097868657,2.8199477402769446,3.042988621255631
2024-12-13T09:30:00-05:00,117,117.15,115.21,116.63,NaN,NaN,NaN,119.06738113101233,NaN,NaN,108.62439999999984,120.12573081691582,97.12306918308386,114.6074415453452,116.32999999999998,116.33000134869914,116.32999865130083,10280,14093.766666666666,64.23130719979417,71.59716262069819,NaN,NaN,NaN,NaN,1.8149900228472933,36.46662288206562,-2350073,-0.2818742295692913,2.690645834294017,2.9725200638633082
2024-12-13T13:30:00-05:00,116.6,117.13,116.51,117.08,NaN,NaN,NaN,119.06738113101233,NaN,NaN,109.01379999999983,120.31373337326082,97.71386662673885,113.42035798117037,116.5763901424406,116.8616564738762,116.29112381100501,7669,14114.266666666666,65.41580386489704,70.48869256653212,NaN,NaN,NaN,NaN,1.7296335926439144,35.33374103077585,-2342404,-0.3023554690855872,2.5945757275063244,2.8969311965919116
2024-12-16T09:30:00-05:00,117.82,120.3,117.58,120.25,113.61048391899169,113.61048391899169,113.61048391899169,NaN,NaN,NaN,109.46619999999984,120.71798804635623,98.21441195364346,115.52861062908738,119.37666666666667,119.37666666666667,119.37666666666667,13938,14368.933333333332,72.35972225614603,69.83234831754984,NaN,NaN,NaN,NaN,1.836088336026492,35.43132572353858,-2328466,-0.12345151436052548,2.742616803641255,2.8660683180017803
2024-12-16T13:30:00-05:00,120.26,120.37,119.83,119.95,114.93909828631024,NaN,NaN,NaN,NaN,NaN,109.90459999999985,121.0474823632008,98.76171763679889,116.28288850326992,119.71162177753742,120.04828409354259,119.37495946153224,13797,14407.6,70.90870311689048,69.25414046429468,NaN,NaN,NaN,NaN,1.7435105977388858,35.54363107891423,-2342263,-0.050121146023935026,2.8034168854718615,2.8535380314957965
2024-12-17T09:30:00-05:00,119.99,120.38,118.16,120,114.93909828631024,NaN,NaN,NaN,NaN,NaN,110.32699999999984,121.36693496358208,99.2870650364176,116.28288850326992,119.51333333333332,119.51333333333332,119.51333333333332,29970,14627.5,71.01303389475531,68.34431522992966,NaN,NaN,NaN,NaN,1.777545555043251,34.57409374841521,-2312293,-0.02435593684984516,2.82309311043349,2.847449047283335
2024-12-17T13:30:00-05:00,119.855,120.22,119.59,119.86,114.93909828631024,NaN,NaN,NaN,NaN,NaN,110.64459999999984,121.84835737688631,99.44084262311337,116.40124864209274,119.68074461971933,119.86791222482064,119.49357701461803,23977,15056.2,70.25330466516809,67.35335114968636,NaN,NaN,NaN,NaN,1.6955780153973041,33.673809084380395,-2336270,-0.04182414680702884,2.795168863774549,2.836993010581578
2024-12-18T09:30:00-05:00,119.43,119.43,118.09,119.17,114.93909828631024,NaN,NaN,NaN,NaN,NaN,110.93199999999985,122.25788327681883,99.60611672318086,116.40124864209274,118.89666666666666,118.89666666666666,118.89666666666666,9871,15187.866666666667,66.47839114245859,67.060280629858,NaN,NaN,NaN,NaN,1.7008938714403534,31.944128639510943,-2346141,-0.12047890328336575,2.6863943814773705,2.8068732847607363
2024-12-18T13:30:00-05:00,119.19,119.19,111.32,112.14,NaN,NaN,NaN,121.18476267920606,121.18476267920606,121.18476267920606,111.08099999999985,122.26968017239403,99.89231982760566,116.40124864209274,115.27536450097398,117.23339023119063,113.31733877075733,33764,16083.566666666668,41.821769502763374,65.2546894989708,NaN,NaN,NaN,NaN,2.141544309194614,31.588082140039013,-2379905,-0.637690382245224,2.009760306954206,2.64745068919943
2024-12-19T09:30:00-05:00,114.25,114.94,110.69,111.6,NaN,NaN,NaN,119.05477346651489,NaN,NaN,111.20559999999983,122.27523281053811,100.13596718946155,116.40124864209274,112.41000000000001,112.41000000000001,112.41000000000001,22789,16542.933333333334,40.576813155369685,63.73104596236276,NaN,NaN,NaN,NaN,2.2921482871092844,31.42580958464574,-2402694,-0.9870375746775144,1.4136537208525368,2.4006912955300512
2024-12-19T13:30:00-05:00,111.45,112.21,111,111.14,NaN,NaN,NaN,117.72614739985511,NaN,NaN,111.30299999999983,122.28254261343073,100.32345738656892,116.40124864209274,112.08167523243057,112.5370812313647,111.62626923349644,11845,16875.2,39.49817082775172,62.25567502183572,NaN,NaN,NaN,NaN,2.2148519808871923,31.275127926066265,-2414539,-1.2055022558932924,0.8938134756634355,2.099315731556728
2024-12-20T09:30:00-05:00,109.29,113.77,108.99,113.01,NaN,NaN,NaN,117.72614739985511,NaN,NaN,111.47099999999983,122.29166855606161,100.65033144393806,116.40124864209274,111.92333333333335,111.92333333333335,111.92333333333335,14340,17167.066666666666,45.80520988501767,60.66959024980917,NaN,NaN,NaN,NaN,2.3980768393952503,31.67371483368644,-2400199,-1.179037294924671,0.6255191129008892,1.8045564078255603
2024-12-20T13:30:00-05:00,113.15,113.76,112.36,112.66,NaN,NaN,NaN,117.72614739985511,NaN,NaN,111.64939999999984,122.24615377462987,101.05264622536981,116.40124864209274,112.53682734079352,113.02587139841529,112.04778328317175,22567,17325.733333333334,44.86255623746545,59.01044530304316,NaN,NaN,NaN,NaN,2.3267856365813038,32.043831247905175,-2422766,-1.1394304654811793,0.380268325974086,1.5196987914552653
2024-12-23T09:30:00-05:00,112.68,112.78,110.75,111.85,NaN,NaN,NaN,117.72614739985511,NaN,NaN,111.83739999999983,122.10300845542689,101.57179154457278,116.40124864209274,111.79333333333335,111.79333333333335,111.79333333333335,25775,17159.1,42.6737863204805,57.13943183027209,NaN,NaN,NaN,NaN,2.305586662539782,32.79411897688272,-2448541,-1.1204219557667412,0.11917134674683894,1.2395933025135801
2024-12-23T13:30:00-05:00,111.88,112.24,111.35,111.86,NaN,NaN,NaN,117.72614739985511,NaN,NaN,112.04419999999983,121.87760192609558,102.21079807390409,116.40124864209274,111.80481165362403,111.81647679975022,111.79314650749784,24956,17601.4,42.710947321194936,55.614965670725226,NaN,NaN,NaN,NaN,2.204473329501226,33.49081472521902,-2423585,-1.060436378686288,-0.08595217084427986,0.9744842078420082
2024-12-24T09:30:00-05:00,112.76,115.26,112.74,115.26,NaN,NaN,NaN,117.72614739985511,NaN,NaN,112.30099999999985,121.77988706547991,102.82211293451978,116.40124864209274,114.42,114.42,114.42,30092,18253.966666666667,53.70037788654236,54.86275643406439,NaN,NaN,NaN,NaN,2.2898680916797103,32.46828442834785,-2393493,-0.7591528833574197,0.0255431036452336,0.7846959870026533
2024-12-26T09:30:00-05:00,114.2,114.74,113.29,114.5,NaN,NaN,NaN,117.72614739985511,NaN,NaN,112.50679999999984,121.71709809724558,103.2965019027541,115.4899989136742,114.17666666666666,114.17666666666666,114.17666666666666,25267,18781.233333333334,51.33012215792829,53.85663631213804,NaN,NaN,NaN,NaN,2.267020370845445,31.518792009824626,-2418760,-0.5861735247599229,0.05197908105274962,0.6381526058126725
2024-12-26T13:30:00-05:00,114.5,114.69,114.14,114.33,NaN,NaN,NaN,117.72614739985511,NaN,NaN,112.69799999999982,121.65124745554101,103.74475254445863,112.10299913093935,114.26468243750669,114.36829969457214,114.16106518044124,18231,19016.066666666666,50.79009340090293,52.315948536763536,NaN,NaN,NaN,NaN,2.144376058642199,30.63712047833877,-2436991,-0.4636921475279292,0.05853742140276097,0.5222295689306902
2024-12-27T09:30:00-05:00,113.98,113.98,110.41,111.13,NaN,NaN,NaN,117.72614739985511,NaN,NaN,112.79699999999983,121.56736943350403,104.02663056649563,109.60492114902065,111.83999999999999,111.83999999999999,111.83999999999999,18663,19092.433333333334,41.86214270291597,50.241194221479645,NaN,NaN,NaN,NaN,2.271206340167756,30.983862222069057,-2455654,-0.5715932760607698,-0.1922620261452721,0.3793312499154977
2024-12-27T13:30:00-05:00,111.19,111.94,111.19,111.68,NaN,NaN,NaN,117.72614739985511,NaN,NaN,112.90299999999984,121.4867066585558,104.31929334144387,109.60492114902065,111.741742395755,111.85836033124083,111.62512446026916,13249,17429.733333333334,43.69413564486722,48.28984434648764,NaN,NaN,NaN,NaN,2.166834458727202,31.30583669839004,-2442405,-0.5776183244865045,-0.34269165569263293,0.23492666879387158
2024-12-30T09:30:00-05:00,109.82,110.67,108.19,110.43,NaN,NaN,NaN,115.85031812484266,NaN,NaN,113.00299999999983,121.34935369488583,104.65664630511382,109.60492114902065,109.76333333333334,109.76333333333334,109.76333333333334,29718,18128.8,40.56550919042459,46.1692875268631,NaN,NaN,NaN,NaN,2.261346283103831,32.334971193457434,-2472123,-0.6330288624444819,-0.5563594092617308,0.07666945318275109
2024-12-30T13:30:00-05:00,110.46,110.64,109.63,109.63,NaN,NaN,NaN,115.85031812484266,NaN,NaN,113.08039999999983,121.22600883913168,104.93479116086797,109.60492114902065,109.85411316209387,109.95519524691116,109.75303107727657,23969,18465.533333333333,38.65771551915011,44.18209641091249,NaN,NaN,NaN,NaN,2.171964405739272,33.2905960817343,-2496092,-0.6863278069799935,-0.7812403055422408,-0.09491249856224729
2024-12-31T09:30:00-05:00,110.38,110.4,108.2,108.54,NaN,NaN,NaN,115.58138490300747,NaN,NaN,113.10699999999983,121.18415321138158,105.02984678861807,109.60492114902065,109.04666666666668,109.04666666666668,109.04666666666668,41725,19452.866666666665,36.16225248766041,43.777845195548004,NaN,NaN,NaN,NaN,2.173966948186467,34.490285385277524,-2537817,-0.7524520695269452,-1.0354775854709288,-0.2830255159439836
2024-12-31T13:30:00-05:00,108.44,108.88,107.69,107.98,NaN,NaN,NaN,114.44314013468895,NaN,NaN,113.13939999999982,121.12046099213217,105.15833900786748,109.60492114902065,108.74401356203047,109.15594997936375,108.3320771446972,22523,19142.133333333335,34.915225039762035,43.37344604443316,NaN,NaN,NaN,NaN,2.1036835947445764,35.71126732347657,-2560340,-0.7876102975326882,-1.2675383878598439,-0.47992809032715567
2025-01-02T09:30:00-05:00,109.48,110.43,107.53,108.29,NaN,NaN,NaN,114.44314013468895,NaN,NaN,113.13839999999982,121.12187829959764,105.154921700402,109.60492114902065,108.75,108.75,108.75,15620,19243.166666666668,36.22627923519745,43.139739502107865,NaN,NaN,NaN,NaN,2.160563337977107,35.87672713759103,-2544720,-0.744200071884854,-1.4101781801832232,-0.6659781082983691
2025-01-02T13:30:00-05:00,107.89,109.38,107.89,109.32,NaN,NaN,NaN,114.44314013468895,NaN,NaN,113.16059999999982,121.09515975843314,105.2260402415665,109.60492114902065,108.79340101656527,108.84849306351617,108.73830896961437,9694,19101.433333333334,40.51390536533007,42.76178917927303,NaN,NaN,NaN,NaN,2.1126659566930277,36.03036839355446,-2535026,-0.6061753969225885,-1.4236973544516047,-0.8175219575290162
2025-01-03T09:30:00-05:00,110,112.05,110,112.05,NaN,NaN,NaN,114.44314013468895,NaN,NaN,113.2337999999998,121.05772422254736,105.40987577745224,109.60492114902065,111.36666666666667,111.36666666666667,111.36666666666667,5169,19054.133333333335,50.091561508013605,43.13528955574076,NaN,NaN,NaN,NaN,2.156761245500669,34.67857053120998,-2529857,-0.306212074816694,-1.2002870510498838,-0.8940749762331898
2025-01-03T13:30:00-05:00,112.23,113.33,112.18,113.2,NaN,NaN,NaN,114.44314013468895,NaN,NaN,113.34079999999982,121.01212722807155,105.66947277192808,108.39928360025655,111.96852928484563,112.71861168838947,111.21844688130179,3328,18706.733333333334,53.48876477753957,43.907788016959266,NaN,NaN,NaN,NaN,2.094135442250621,32.81623539101394,-2526529,-0.020607308537860858,-0.9198341119055158,-0.8992268033676549
2025-01-06T09:30:00-05:00,114.89,116.6,114.89,115.7,109.39038445852881,109.39038445852881,109.39038445852881,NaN,NaN,NaN,113.49819999999981,121.03251583092649,105.96388416907314,110.95542688020524,115.73,115.73,115.73,18828,18659.5,59.88191103603241,45.134285425161934,NaN,NaN,NaN,NaN,2.187411482089862,31.14870554931205,-2507701,0.32722673371062094,-0.4901933862293788,-0.8174201199399997
2025-01-06T13:30:00-05:00,115.88,115.88,115.07,115.73,109.39038445852881,NaN,NaN,NaN,NaN,NaN,113.68539999999983,120.96271512029922,106.40808487970044,110.9593415041642,115.6807833962264,115.75788429478501,115.60368249766779,7672,18555.333333333332,59.95304748285057,45.580904682041094,NaN,NaN,NaN,NaN,2.0890249476548717,29.600284982017445,-2500029,0.5374553997453662,-0.14560087025829205,-0.6830562700036582
2025-01-07T09:30:00-05:00,115.8,116.25,111.25,112.23,109.39038445852881,NaN,NaN,NaN,NaN,NaN,113.79199999999983,120.82051221811074,106.76348778188893,110.9593415041642,113.24333333333334,113.24333333333334,113.24333333333334,13109,18746.5,49.02996963035834,45.41660807292896,NaN,NaN,NaN,NaN,2.2969517371080954,28.248313537317156,-2513138,0.4239138249201325,-0.15316398885349258,-0.5770778137736251
2025-01-07T13:30:00-05:00,112.23,112.23,110.25,110.98,109.39038445852881,NaN,NaN,NaN,NaN,NaN,113.86179999999982,120.70547350478877,107.01812649521086,110.9593415041642,112.33224082042456,113.36862578022583,111.29585586062329,10131,18741.533333333333,45.81920847677792,45.06154486406289,NaN,NaN,NaN,NaN,2.2743123273146604,27.307577658100847,-2523269,0.25601493080045945,-0.2570591502730508,-0.5130740810735103
2025-01-08T09:30:00-05:00,110.9,111.56,109,111.46,NaN,NaN,NaN,116.87977552387498,116.87977552387498,116.87977552387498,113.92619999999982,120.61592333061277,107.23647666938687,110.9593415041642,110.67333333333333,110.67333333333333,110.67333333333333,8375,18765.066666666666,47.24778331678187,45.446233479339014,NaN,NaN,NaN,NaN,2.2947185896493276,26.81166629734642,-2514894,0.17266850808358508,-0.29723844596902893,-0.469906954052614
2025-01-08T13:30:00-05:00,111.04,111.86,110.82,111.03,NaN,NaN,NaN,116.87977552387498,NaN,NaN,113.94979999999981,120.58997890121609,107.30962109878354,110.9593415041642,110.9477733553773,111.22934730076624,110.66619940998835,7956,18565.666666666668,46.075744712222566,45.616348412721536,NaN,NaN,NaN,NaN,2.2050958332458044,26.215030075140966,-2522850,0.08821947305942451,-0.35963261272833336,-0.44785208578775787
2025-01-10T09:30:00-05:00,109.2,110.02,107.17,109.99,NaN,NaN,NaN,115.27016736782824,NaN,NaN,113.9469999999998,120.59373423571043,107.30026576428918,110.9593415041642,109.06,109.06,109.06,23673,18894.866666666665,43.279396550782764,45.81019750988998,NaN,NaN,NaN,NaN,2.323303273728247,26.661839053187542,-2546523,-0.03162354498925918,-0.48738151702433186,-0.4557579720350727
2025-01-10T13:30:00-05:00,109.99,110.13,109.34,109.38,NaN,NaN,NaN,115.27016736782824,NaN,NaN,113.92219999999979,120.62739952277124,107.21700047722834,110.9593415041642,109.3120582343242,109.58914858712706,109.03496788152134,19589,18548.833333333332,41.68151864320972,46.02618344732281,NaN,NaN,NaN,NaN,2.213781611319086,27.02425596146532,-2566112,-0.13985478496759957,-0.6305764532445721,-0.49072166827697256
2025-01-13T09:30:00-05:00,106.49,107.62,105.97,107.2,NaN,NaN,NaN,113.44495621738069,NaN,NaN,113.8425999999998,120.76703650849389,106.91816349150572,110.9593415041642,106.93,106.93,106.93,12234,18157.4,36.49571975269773,46.05000253768261,NaN,NaN,NaN,NaN,2.2992257819391506,28.114992172049302,-2578346,-0.3350093018147302,-0.9094832955453853,-0.5744739937306551
2025-01-13T13:30:00-05:00,107,108.28,106.8,108.23,NaN,NaN,NaN,113.44495621738069,NaN,NaN,113.7293999999998,120.82985678531796,106.62894321468164,110.9593415041642,107.08232869379016,107.40598294114552,106.7586744464348,2710,17918.7,40.2765111894713,46.43295154837614,NaN,NaN,NaN,NaN,2.240709654657783,28.806717716268064,-2575636,-0.3687970675498897,-1.0354703281680173,-0.6666732606181276
2025-01-14T09:30:00-05:00,110.35,111.25,108.97,110,NaN,NaN,NaN,113.44495621738069,NaN,NaN,113.6293999999998,120.79598960455817,106.46281039544144,110.9593415041642,110.07333333333334,110.07333333333334,110.07333333333334,9007,17093.466666666667,46.20375031016033,47.145628053730626,NaN,NaN,NaN,NaN,2.2963732507536556,28.142172712539587,-2566629,-0.25160643502806423,-0.9811813044032078,-0.7295748693751436
2025-01-14T13:30:00-05:00,110.02,110.635,108.82,109.42,NaN,NaN,NaN,113.44495621738069,NaN,NaN,113.5093999999998,120.75256440239775,106.26623559760185,109.81347320333136,109.90356914551141,110.12103423406684,109.68610405695598,5489,16516.8,44.640335787131015,47.440373083859264,NaN,NaN,NaN,NaN,2.2619894471283954,27.5663198382433,-2572118,-0.19532684203286288,-0.9737334219162221,-0.7784065798833593
2025-01-15T09:30:00-05:00,112.88,114.06,112.3,113.5,106.23942116696088,106.23942116696088,106.23942116696088,NaN,NaN,NaN,113.47879999999981,120.70892546503595,106.24867453496367,107.18718785819202,113.28666666666668,113.28666666666668,113.28666666666668,7478,16371.233333333334,55.93570834094156,47.857812143354124,NaN,NaN,NaN,NaN,2.431847343762082,25.746064414590137,-2564640,0.11766012494144307,-0.6313314237065555,-0.7489915486479986
2025-01-15T13:30:00-05:00,113.45,114.18,113.38,113.51,107.0458111139172,NaN,NaN,NaN,NaN,NaN,113.38059999999979,120.47164946817958,106.28955053182,108.2817502865536,113.51875565396772,113.7181144432168,113.31939686471863,10135,16231.066666666668,55.95942669766974,48.034287994791995,NaN,NaN,NaN,NaN,2.3152868192076483,24.014823733676455,-2554505,0.3151329437194976,-0.3550753689986266,-0.6702083127181242
2025-01-16T09:30:00-05:00,113.76,114.35,112.5,114.24,107.0458111139172,NaN,NaN,NaN,NaN,NaN,113.29039999999979,120.2188260377209,106.36197396227868,108.70640022924287,113.69666666666666,113.69666666666666,113.69666666666666,4643,15633.6,57.74739113482826,47.88182228756312,NaN,NaN,NaN,NaN,2.2820520464071015,22.706387936657123,-2549862,0.4750823470455148,-0.07635537891123079,-0.5514377259567456
2025-01-16T13:30:00-05:00,113.72,114.37,113.4,113.47,107.3760179777634,NaN,NaN,NaN,NaN,NaN,113.2355999999998,120.11395231433808,106.35724768566153,109.3701201833943,113.72720568921676,113.75158435259654,113.70282702583698,7286,15017.3,55.20167084402786,47.54243824193293,NaN,NaN,NaN,NaN,2.1883340430923086,21.48356263950802,-2557148,0.5063186839946526,0.08146062903657025,-0.4248580549580824
2025-01-17T09:30:00-05:00,115.84,116.76,115.01,116.76,109.2232444333196,NaN,NaN,NaN,NaN,NaN,113.26179999999981,120.18353468432284,106.34006531567678,111.11509614671544,116.17666666666668,116.17666666666668,116.17666666666668,9496,14501.966666666667,62.75641339214437,48.522898510631926,NaN,NaN,NaN,NaN,2.2670244685857157,20.439965225703954,-2547652,0.7131884165279099,0.466627465701805,-0.24656095082610488
2025-01-17T13:30:00-05:00,116.65,116.71,115.67,115.745,109.68241514089598,NaN,NaN,NaN,NaN,NaN,113.2916999999998,120.24310377478923,106.34029622521038,111.64907691737235,116.13698676481522,116.19848710743382,116.07548642219662,3953,13630.666666666666,59.42679117433622,49.49486870331466,NaN,NaN,NaN,NaN,2.182951292258165,19.470910484314462,-2551605,0.7429367622140803,0.6821100019414956,-0.06082676027258477
2025-01-21T09:30:00-05:00,117.45,118.28,114.8,118.17,109.85366899812797,NaN,NaN,NaN,NaN,NaN,113.3784999999998,120.46175638390791,106.2952436160917,112.49126153389788,117.08333333333333,117.08333333333333,117.08333333333333,9568,13107.366666666667,64.30020165240586,50.71289858443067,NaN,NaN,NaN,NaN,2.275597628525439,19.11977880139316,-2542037,0.8779488569693241,1.0366093109390704,0.15866045396974626
2025-01-21T13:30:00-05:00,118.185,118.33,117.63,117.83,111.50213858912215,NaN,NaN,NaN,NaN,NaN,113.39089999999979,120.50305457932268,106.2787454206769,113.3490092271183,117.38751646242103,117.79373603351326,116.98129689132881,5365,12678.5,63.15481540558773,51.93283220538532,NaN,NaN,NaN,NaN,2.1630549407736224,18.810945788222007,-2547402,0.8934038097477115,1.2754152161543857,0.3820114064066742
2025-01-22T09:30:00-05:00,118.25,118.5,117.595,118.09,111.74067774416207,NaN,NaN,NaN,NaN,NaN,113.4076999999998,120.56009294503313,106.25530705496648,114.06270738169464,118.06166666666667,118.06166666666667,118.06166666666667,11997,12456.3,63.68750574949024,53.39055429100728,NaN,NaN,NaN,NaN,2.0731938735755064,18.5863954474905,-2535405,0.8693668382701857,1.4687199542444063,0.5993531159742206
2025-01-22T13:30:00-05:00,118.08,118.27,117.5,117.55,111.75985148306378,NaN,NaN,NaN,NaN,NaN,113.40629999999982,120.55542101171513,106.25717898828451,114.33516590535571,117.92928369625655,118.07296797612264,117.78559941639045,10184,12354.133333333333,61.69255606170807,54.8199141066143,NaN,NaN,NaN,NaN,1.9801085968915415,18.327360325347318,-2545589,0.7688015575854398,1.5603550629560203,0.7915535053705806
2025-01-23T09:30:00-05:00,116.65,118.5,116.65,118.36,111.75985148306378,NaN,NaN,NaN,NaN,NaN,113.44229999999982,120.67225247841564,106.212347521584,114.42713272428458,117.83666666666666,117.83666666666666,117.83666666666666,6478,11579.466666666667,63.537568407499315,56.75147472481441,NaN,NaN,NaN,NaN,1.9708151256850024,17.6298978729534,-2539111,0.7099432053706145,1.6789825120838486,0.9690393067132341
2025-01-23T13:30:00-05:00,118.52,118.8,117.86,118.54,112.38004029758498,NaN,NaN,NaN,NaN,NaN,113.4804999999998,120.79708287728432,106.16391712271526,115.07170617942766,118.1503063063063,118.43015240706409,117.87046020554853,8137,11051.733333333334,63.95305473654978,58.44265640674859,NaN,NaN,NaN,NaN,1.897185473850359,17.117530850703915,-2530974,0.6384881676282765,1.7671495162485797,1.1286613486203032
2025-01-24T09:30:00-05:00,119.2,120.41,119.2,120.01,113.87049301133113,NaN,NaN,NaN,NaN,NaN,113.53909999999979,121.01525454362526,106.06294545637432,116.49236494354213,119.87333333333332,119.87333524068195,119.87333142598469,7504,9911.033333333333,67.23650778583881,59.94499622643991,NaN,NaN,NaN,NaN,1.8952436542896185,17.325544544460318,-2523470,0.6437531052258196,1.9333527301525777,1.289599624926758
2025-01-24T13:30:00-05:00,119.75,119.75,118.63,118.63,113.87049301133113,NaN,NaN,NaN,NaN,NaN,113.50669999999978,120.87956745033267,106.13383254966689,116.49236494354213,119.50980967158004,119.93889723032575,119.08072211283434,5386,9339.8,61.566863551503296,61.15403392389508,NaN,NaN,NaN,NaN,1.858440536126075,17.182918513324918,-2528856,0.5134810548997224,1.9314509435514111,1.4179698886516887
2025-01-27T09:30:00-05:00,114.07,117.05,114.07,114.16,113.87049301133113,NaN,NaN,NaN,NaN,NaN,113.39089999999979,120.53361592324408,106.24818407675549,116.49236494354213,115.09333333333332,115.09333333333332,115.09333333333332,5087,8988.7,47.57333153713024,60.55672129505141,NaN,NaN,NaN,NaN,2.0514090692599267,16.938975473889673,-2533943,0.10671921408611085,1.5513689062593272,1.4446496921732164
2025-01-27T13:30:00-05:00,114.24,115.81,113.8,115.81,NaN,NaN,NaN,121.00559064820271,121.00559064820271,121.00559064820271,113.30709999999979,120.23270815814458,106.38149184185501,116.49236494354213,115.12743219157534,115.14813359053774,115.10673079261294,13802,9125.633333333333,51.917700018995376,60.26802653228896,NaN,NaN,NaN,NaN,2.048451278598504,16.80997776418248,-2520141,-0.06169707518207712,1.36752834819562,1.429225423377697
2025-01-28T09:30:00-05:00,116.27,119.34,115.5,118.95,NaN,NaN,NaN,121.00559064820271,NaN,NaN,113.2888999999998,120.1500128222876,106.427787177712,116.49236494354213,117.93,117.93,117.93,4369,9098.966666666667,58.89791273825733,60.35020664681961,NaN,NaN,NaN,NaN,2.1764190444128966,16.027414981036188,-2515772,0.023334609118607075,1.458393684775956,1.435059075657349
2025-01-28T13:30:00-05:00,118.56,119.66,118.55,119.32,NaN,NaN,NaN,121.00559064820271,NaN,NaN,113.29189999999979,120.16341945061332,106.42038054938625,116.49236494354213,118.58120513100833,119.20391502119855,117.95849524081811,4778,9147.3,59.64140461257431,60.66733048743007,NaN,NaN,NaN,NaN,2.100246255526261,15.418327380585453,-2510994,0.08593695868060025,1.5424802740080992,1.456543315327499
2025-01-29T09:30:00-05:00,119.2,119.29,118.14,119.12,NaN,NaN,NaN,121.00559064820271,NaN,NaN,113.4314999999998,120.48494008269385,106.37805991730575,116.49236494354213,118.85000000000001,118.85000000000001,118.85000000000001,7835,8780.866666666667,59.01992914714083,60.40043875564411,NaN,NaN,NaN,NaN,2.0345143801315273,14.671862598562043,-2518829,0.09462738105915647,1.5748275416514446,1.480200160592288
2025-01-29T13:30:00-05:00,119.2,120.68,118,119.79,NaN,NaN,NaN,121.00559064820271,NaN,NaN,113.59529999999978,120.84856034553877,106.34203965446079,116.49236494354213,119.17472807293306,119.49469314184235,118.85476300402378,8070,8794.133333333333,60.5046723203844,60.47743026607612,NaN,NaN,NaN,NaN,2.0806204958364187,14.516296993310466,-2510759,0.12437697820415794,1.6356713833474856,1.5112944051433277
2025-01-30T09:30:00-05:00,121.13,122.47,120.9,121.585,115.34393048496375,115.34393048496375,115.34393048496375,NaN,NaN,NaN,113.8041999999998,121.35799199079126,106.25040800920833,116.88082769648634,121.65166666666667,121.65166666666667,121.65166666666667,12115,8761,64.24250652418834,60.47330918548916,NaN,NaN,NaN,NaN,2.1234333175623883,14.990396239030929,-2498644,0.23727792657021252,1.8078918133560933,1.5706138867858808
2025-01-30T13:30:00-05:00,121.7,122.51,121.06,121.69,115.53443364473812,NaN,NaN,NaN,NaN,NaN,113.9777999999998,121.84314377126331,106.11245622873629,117.31366215718907,121.70150972637128,121.7523334131582,121.65068603958437,11652,8811.7,64.45442527367636,60.5661384617812,NaN,NaN,NaN,NaN,2.0753309377365037,15.444011951830342,-2486992,0.2879854204560368,1.9305956623559268,1.64261024189989
2025-01-31T09:30:00-05:00,122.6,123.59,122.445,122.82,116.79195938815911,NaN,NaN,NaN,NaN,NaN,114.1809999999998,122.41594407996534,105.94605592003425,118.48292972575126,122.95166666666667,122.95166666666667,122.95166666666667,19363,9177.966666666667,66.73902991089415,60.78410447331005,NaN,NaN,NaN,NaN,2.062807299326754,16.228290039320754,-2467629,0.36180981972787385,2.0948725165597324,1.7330626968318585
2025-01-31T13:30:00-05:00,122.52,122.64,120.13,120.45,116.79195938815911,NaN,NaN,NaN,NaN,NaN,114.35299999999981,122.74378732897756,105.96221267102206,118.48292972575126,122.01661648122693,122.9557741263305,121.07745883612337,19194,9552.566666666668,58.27865481597783,60.54025438432932,NaN,NaN,NaN,NaN,2.107606777946271,15.784374370765248,-2486823,0.22206698932031355,2.0106464334822505,1.788579444161937
2025-02-03T09:30:00-05:00,115.97,118.69,115.23,118.3,NaN,NaN,NaN,123.69440787153272,123.69440787153272,123.69440787153272,114.48179999999982,122.91317325944736,106.05042674055228,118.48292972575126,117.40666666666668,117.40666666666668,117.40666666666668,33149,9868.433333333332,51.85640846933296,59.70588581731744,NaN,NaN,NaN,NaN,2.3299205795215374,15.735878123852084,-2519972,-0.03067634262975849,1.7502340158747387,1.7809103585044972
2025-02-03T13:30:00-05:00,118.15,119.39,118.14,118.5,NaN,NaN,NaN,123.69440787153272,NaN,NaN,114.54659999999981,123.05039243397516,106.04280756602446,118.48292972575126,117.63496750301051,118.12263623307433,117.1472987729467,7265,9457.633333333333,52.38209152251507,58.87938844488639,NaN,NaN,NaN,NaN,2.252783395269999,15.411838656244846,-2512707,-0.19095554910224832,1.5422159221266867,1.733171471228935
2025-02-04T09:30:00-05:00,120,121.54,120,121.07,NaN,NaN,NaN,123.69440787153272,NaN,NaN,114.67799999999981,123.37567946064547,105.98032053935415,118.48292972575126,120.87000000000002,120.87000000000002,120.87000000000002,12039,9451.133333333333,58.63280229255589,58.26483805250904,NaN,NaN,NaN,NaN,2.309013152750714,14.31261937701879,-2500668,-0.13319484263044457,1.5666779179408792,1.6998727605713237
2025-02-04T13:30:00-05:00,121.2,121.7,120.85,121.47,NaN,NaN,NaN,123.69440787153272,NaN,NaN,114.82079999999982,123.72298363325109,105.91861636674855,118.48292972575126,121.05865900954655,121.28904458331932,120.82827343577377,8073,9629.9,59.52338613791695,58.11887538011001,NaN,NaN,NaN,NaN,2.204797927554235,13.3492102188922,-2492595,-0.07997960703395357,1.5998982517788818,1.6798778588128354
2025-02-05T09:30:00-05:00,121,121.795,120.5,121.04,NaN,NaN,NaN,123.69440787153272,NaN,NaN,115.01899999999982,124.0243459678192,106.01365403218044,118.48292972575126,121.11166666666668,121.11166666666668,121.11166666666668,4277,9472.233333333334,58.07592148150544,58.86906037613681,NaN,NaN,NaN,NaN,2.139812361300361,12.470366347669756,-2496872,-0.08518938637169393,1.573391125848218,1.658580512219912
2025-02-05T13:30:00-05:00,121.16,121.59,120.92,121.59,NaN,NaN,NaN,123.69440787153272,NaN,NaN,115.21719999999983,124.35511292583287,106.0792870741668,118.48292972575126,121.28215407464808,121.40218878944309,121.16211935985307,8628,9576.866666666667,59.43471597228752,59.40599008708625,NaN,NaN,NaN,NaN,2.0348257640646206,11.654297038677486,-2488244,-0.06401025356305934,1.5785676952660879,1.6425779488291472
2025-02-06T09:30:00-05:00,119.95,120.66,119.58,119.91,NaN,NaN,NaN,123.69440787153272,NaN,NaN,115.40679999999982,124.53292004304811,106.28067995695153,118.48292972575126,120.05,120.05,120.05,12409,9741.233333333334,53.708537810468066,59.035320449387015,NaN,NaN,NaN,NaN,2.0330524952028624,11.434392436260913,-2500653,-0.16956880499551885,1.4306169425847486,1.6001857475802674
2025-02-06T13:30:00-05:00,120.04,120.5,119.13,120.45,NaN,NaN,NaN,123.69440787153272,NaN,NaN,115.62319999999981,124.70415518324614,106.54224481675348,118.48292972575126,120.04506555675583,120.05459384509174,120.03553726841992,3328,9514.333333333334,55.20252662588115,58.71825773605178,NaN,NaN,NaN,NaN,1.9856916026883726,11.40510271785683,-2497325,-0.20696883261797283,1.3414747068078015,1.5484435394257743
2025-02-07T09:30:00-05:00,121.95,123.35,121.32,122.55,NaN,NaN,NaN,123.69440787153272,NaN,NaN,115.90339999999982,124.95737182236195,106.84942817763769,118.4364934430832,122.40666666666665,122.40666666666665,122.40666666666665,11441,9740.933333333332,60.53651538680985,58.82658532459958,NaN,NaN,NaN,NaN,2.050999345353488,11.027938088660706,-2485884,-0.09966056732716755,1.4238678302668148,1.5235283975939824
2025-02-07T13:30:00-05:00,122.7,122.7,120.93,121.12,NaN,NaN,NaN,123.69440787153272,NaN,NaN,116.16619999999983,125.04610778331174,107.28629221668793,118.4364934430832,122.16458451602286,122.53969854717943,121.78947048486629,4765,9656.9,55.675117739295914,58.481617140236104,NaN,NaN,NaN,NaN,2.0309279635425246,10.509003216835097,-2490649,-0.13232643077305184,1.3581203591276676,1.4904467899007194
2025-02-10T09:30:00-05:00,122.1,123.11,121.92,122.85,NaN,NaN,NaN,123.69440787153272,NaN,NaN,116.45739999999984,125.23946495991196,107.67533504008772,118.4364934430832,122.62666666666667,122.62666666666667,122.62666666666667,8149,9612,59.87339305104327,58.16953760644003,NaN,NaN,NaN,NaN,2.028004537575201,10.196087603007205,-2482500,-0.04904755145554707,1.4291373505812857,1.4781849020368327
2025-02-10T13:30:00-05:00,122.71,122.92,121.99,122.05,NaN,NaN,NaN,123.69440787153272,NaN,NaN,116.71199999999982,125.38910527769005,108.03489472230959,118.5768846428586,122.4686454120073,122.62190706572662,122.315383758288,8663,9769,57.17646599461574,57.64968337222142,NaN,NaN,NaN,NaN,1.9495756420341157,9.905523104452737,-2491163,-0.058809270230144595,1.4046733142491519,1.4634825844792965
2025-02-11T09:30:00-05:00,121.04,121.5,119.1,119.38,NaN,NaN,NaN,123.69440787153272,NaN,NaN,116.85859999999983,125.4630702428513,108.25412975714835,118.5768846428586,119.99333333333334,119.99333333333334,119.99333333333334,7778,9709.333333333334,49.209543001344095,56.39757716439641,NaN,NaN,NaN,NaN,2.0210345247459647,10.028552891760949,-2498941,-0.24558030108060125,1.156507208128545,1.4020875092091463
2025-02-11T13:30:00-05:00,119.59,120,119.37,119.37,NaN,NaN,NaN,123.69440787153272,NaN,NaN,116.98199999999983,125.54994841255032,108.41405158744934,118.5768846428586,119.8552959981732,120.05023477309871,119.6603572232477,3900,9660.5,49.18190210936111,55.747809113923786,NaN,NaN,NaN,NaN,1.9216749158355384,10.142794837118572,-2502841,-0.36319178050135337,0.9480977835824547,1.311289564083808
2025-02-12T09:30:00-05:00,117.82,121.38,117.8,121.35,NaN,NaN,NaN,123.69440787153272,NaN,NaN,117.09499999999981,125.74101272264414,108.44898727735549,118.5768846428586,120.17666666666666,120.17666666666666,120.17666666666666,46366,10806.133333333333,54.61742947742721,55.94502490021624,NaN,NaN,NaN,NaN,2.0401267075615714,10.85081432622171,-2456475,-0.303465066303102,0.9319582312049306,1.2354232975080326
2025-02-12T13:30:00-05:00,121.33,121.75,120.87,121.1,NaN,NaN,NaN,123.69440787153272,NaN,NaN,117.20239999999981,125.91110489568531,108.49369510431431,118.5768846428586,120.36021068660514,120.76205651186832,119.95836486134196,9673,10789.1,53.834462999690416,56.04876572001449,NaN,NaN,NaN,NaN,1.957260514164316,11.305624257352878,-2466148,-0.27733891305076463,0.8887496561945767,1.1660885692453413
2025-02-13T09:30:00-05:00,121.32,123.23,121.32,122.24,NaN,NaN,NaN,123.69440787153272,NaN,NaN,117.40259999999982,126.10509578914643,108.70010421085321,118.5768846428586,122.26333333333334,122.26333333333334,122.26333333333334,26787,11466.066666666668,56.87068810598493,55.9229004209737,NaN,NaN,NaN,NaN,1.9695990488668655,10.954416409193225,-2439361,-0.18430385238392155,0.9357087537654394,1.120012606149361
2025-02-13T13:30:00-05:00,122.32,124.14,122.28,124.06,117.19931444616158,117.19931444616158,117.19931444616158,NaN,NaN,NaN,117.6641999999998,126.36508440563047,108.96331559436912,119.38904636781751,123.25374977579347,123.74087141843384,122.76662813315309,110735,14886,61.25211253346587,56.046380877798626,NaN,NaN,NaN,NaN,1.9646276882335183,10.190212366794833,-2328626,-0.01039255924747673,1.1070219070900151,1.1174144663374919
2025-02-14T09:30:00-05:00,125.21,126.09,124.5,125.25,119.28070924406332,NaN,NaN,NaN,NaN,NaN,117.93999999999981,126.7107073831096,109.16929261689003,121.27423709425402,125.28000000000002,125.28000000000002,125.28000000000002,18653,15257.633333333333,63.83881071650991,56.45801582315609,NaN,NaN,NaN,NaN,1.9692971390739815,10.284906331209982,-2309973,0.1649122307465074,1.3235547547706261,1.1586425240241187
2025-02-14T13:30:00-05:00,125.35,125.99,125.1,125.69,119.68272246024225,NaN,NaN,NaN,NaN,NaN,118.23319999999981,127.04038996275968,109.42601003723995,121.6923896754032,125.49191904819745,125.63851924866755,125.34531884772734,38978,16377.366666666667,64.7751584738665,56.8394760018403,NaN,NaN,NaN,NaN,1.892204486282983,10.37283644102405,-2270995,0.28366155460994236,1.5132194672865467,1.2295579126766043
2025-02-18T09:30:00-05:00,126,126.01,123.21,123.3,119.68272246024225,NaN,NaN,NaN,NaN,NaN,118.49939999999982,127.09596411365187,109.90283588634777,121.6923896754032,124.17333333333332,124.17333524068195,124.17333142598468,11981,16607.166666666668,56.25435537511851,57.02132011360105,NaN,NaN,NaN,NaN,1.9570470229770565,9.738080633216107,-2282976,0.1794874615175388,1.4539172395735278,1.274429778055989
2025-02-18T13:30:00-05:00,123.02,123.95,122.72,123.95,119.68272246024225,NaN,NaN,NaN,NaN,NaN,118.79079999999982,127.11455548896902,110.46704451103062,121.6923896754032,123.98793191656827,124.27611104827062,123.69975278486592,4959,16312.4,57.877244887603055,57.21237141800975,NaN,NaN,NaN,NaN,1.9051150927644098,9.370512026794533,-2278017,0.1346468772952334,1.4427383746750309,1.3080914973797975
2025-02-19T09:30:00-05:00,123.85,123.98,122.47,122.93,119.68272246024225,NaN,NaN,NaN,NaN,NaN,119.1053999999998,126.81979688894384,111.39100311105577,121.6923896754032,123.12666666666667,123.12666666666667,123.12666666666667,16795,16726.6,54.46275938587497,56.77853170365726,NaN,NaN,NaN,NaN,1.876892586138381,9.14523942560921,-2294812,0.02246361842698663,1.3361710204135306,1.313707401986544
2025-02-19T13:30:00-05:00,122.66,123,121.45,121.77,119.68272246024225,NaN,NaN,NaN,NaN,NaN,119.37619999999981,126.4701869072425,112.28221309275712,121.6923896754032,122.83145346760946,123.30453598695233,122.3583709482666,6540,16785.333333333332,50.79279353165478,56.42979426025432,NaN,NaN,NaN,NaN,1.853543115699925,9.402355609932055,-2301352,-0.13503356452580095,1.1449154463292928,1.2799490108550937
2025-02-20T09:30:00-05:00,121.54,121.67,117.86,119,NaN,NaN,NaN,125.79610259762477,125.79610259762477,125.79610259762477,119.5561999999998,126.12684093069694,112.98555906930267,121.6923896754032,119.50999999999999,119.50999999999999,119.50999999999999,12721,16948.2,43.29098003302496,55.24533618753873,NaN,NaN,NaN,NaN,2.00043289314993,10.942218934999634,-2314073,-0.4151150445744425,0.7610552051370405,1.176170249711483
2025-02-20T13:30:00-05:00,119.17,120.74,119.15,120.66,NaN,NaN,NaN,125.79610259762477,NaN,NaN,119.7809999999998,125.68432516469674,113.87767483530287,121.6923896754032,119.73966435305087,120.05887423591938,119.42045447018236,6585,16898.7,48.2259997045678,54.60601716682102,NaN,NaN,NaN,NaN,1.9818305436392205,12.372092022562384,-2307488,-0.47368927132546945,0.5840586605546463,1.0577479318801157
2025-02-21T09:30:00-05:00,121.28,121.28,116,116.05,NaN,NaN,NaN,125.08176910238124,NaN,NaN,119.83199999999981,125.55881377383106,114.10518622616856,121.6923896754032,117.77666666666666,117.77666801536581,117.7766653179675,11653,16883.3,38.26658214549678,53.82437710568907,NaN,NaN,NaN,NaN,2.217414076236419,14.563897307800197,-2319141,-0.7894136037324533,0.07098092721454918,0.8603945309470025
2025-02-21T13:30:00-05:00,116,116.37,114.76,114.77,NaN,NaN,NaN,121.93350687045482,NaN,NaN,119.8571999999998,125.48270874500662,114.231691254993,121.6923896754032,116.23134751086442,117.43102628005545,115.0316687416734,19335,17139.4,36.04100176944637,52.88574136712373,NaN,NaN,NaN,NaN,2.1740273565052464,16.88037706707331,-2338476,-1.035451795527022,-0.433920213461775,0.6015315820652469
2025-02-24T09:30:00-05:00,115,115,110.595,113.5,NaN,NaN,NaN,119.47721110361597,NaN,NaN,119.84239999999981,125.53048904291626,114.15431095708337,121.6923896754032,113.03166666666668,113.03166666666668,113.03166666666668,22825,17254.8,33.93229917981047,51.4082320601511,NaN,NaN,NaN,NaN,2.3333825453263004,19.788883315832713,-2361301,-1.2219161551273472,-0.925863611843937,0.29605254328341013
2025-02-24T13:30:00-05:00,113.75,113.75,112.33,112.38,NaN,NaN,NaN,119.47721110361597,NaN,NaN,119.82059999999981,125.61360013465786,114.02759986534177,121.17191174032257,112.99003806942832,113.07417157231384,112.9059045665428,5588,16801.266666666666,32.1460381696875,49.859058858008034,NaN,NaN,NaN,NaN,2.2681409349458503,22.489639118252157,-2366889,-1.3489083773388426,-1.390082928390143,-0.04117455105130052
2025-02-25T09:30:00-05:00,110.58,110.645,105.55,107.07,NaN,NaN,NaN,115.29996404275752,NaN,NaN,119.62679999999982,126.38442229191067,112.86917770808897,119.63662351380644,107.755,107.755,107.755,18965,16328.466666666667,25.336230893353445,47.60659762853436,NaN,NaN,NaN,NaN,2.5939880110211466,25.82781493414485,-2385854,-1.6962890502167154,-2.161535863822195,-0.4652468136054794
2025-02-25T13:30:00-05:00,107.5,108.19,106.73,107.26,NaN,NaN,NaN,114.5341702226322,NaN,NaN,119.45709999999983,126.97905562072248,111.93514437927718,119.63662351380644,107.5962685779658,107.77574615306474,107.41679100286686,14834,16580.766666666666,25.940778175086336,45.08435946007868,NaN,NaN,NaN,NaN,2.512988867376779,28.92754962033092,-2371020,-1.8087313285802644,-2.72616097433081,-0.9174296457505455
2025-02-26T09:30:00-05:00,108.145,109.76,107.96,108.69,NaN,NaN,NaN,114.5341702226322,NaN,NaN,119.26749999999981,127.36552006666656,111.16947993333306,118.75029881104516,108.80333333333333,108.80333333333333,108.80333333333333,11032,16547.2,30.501789050685687,42.70314362680552,NaN,NaN,NaN,NaN,2.5120610911355805,30.976926475680806,-2359988,-1.6847679950409424,-3.0233896395517235,-1.338621644510781
2025-02-26T13:30:00-05:00,108.2,108.24,107.25,107.96,NaN,NaN,NaN,114.5341702226322,NaN,NaN,119.07009999999983,127.7583399805782,110.38186001942145,116.31523904883612,108.50623946784923,108.95886276489863,108.05361617079983,4753,16436.533333333333,29.5028979443112,40.183696446123,NaN,NaN,NaN,NaN,2.4354852989116105,32.97775858694316,-2364741,-1.5531347934744641,-3.280040136353861,-1.726905342879397
2025-02-27T09:30:00-05:00,109.69,110.33,106.27,108.62,NaN,NaN,NaN,114.5341702226322,NaN,NaN,118.88069999999982,128.04593562381947,109.71546437618015,115.5861912390689,108.40666666666668,108.40666666666668,108.40666666666668,11798,16687.233333333334,31.68130071774128,38.42847825631035,NaN,NaN,NaN,NaN,2.551522063275067,33.78027346768492,-2352943,-1.331348236090498,-3.3910906379925194,-2.0597424019020214
2025-02-27T13:30:00-05:00,108.79,108.79,105.23,105.28,NaN,NaN,NaN,114.37237278476424,NaN,NaN,118.63529999999983,128.55585047062053,108.71474952937915,114.51695299125512,107.7346964784796,108.66983135513904,106.79956160182017,6092,16602.7,27.115006919805154,36.23117554432478,NaN,NaN,NaN,NaN,2.623556201612562,34.71450373507237,-2359035,-1.3169179630004062,-3.7058898556525293,-2.388971892652123
2025-02-28T09:30:00-05:00,104.17,107,103.25,104.85,NaN,NaN,NaN,112.6640831127295,NaN,NaN,118.36509999999981,129.01037998505163,107.71982001494798,110.1545623930041,105.03333333333335,105.03333333333335,105.03333333333335,11470,16571.4,26.58377498884778,34.23981951596569,NaN,NaN,NaN,NaN,2.70401647292595,35.91847293844349,-2370505,-1.2445001263749984,-3.944597050620871,-2.7000969242458726
2025-02-28T13:30:00-05:00,105.32,107.12,105.13,107.03,NaN,NaN,NaN,112.6640831127295,NaN,NaN,118.13489999999982,129.24283995123037,107.02696004876928,107.82514991440328,105.61269430579607,106.299413912734,104.92597469885814,8164,16732.6,33.67799746817647,33.017334082860096,NaN,NaN,NaN,NaN,2.673015296288383,36.97416714666021,-2362341,-0.9701325009035573,-3.9127625503753194,-2.942630049471762
2025-03-03T09:30:00-05:00,110.3,110.78,106.21,106.21,NaN,NaN,NaN,112.6640831127295,NaN,NaN,117.85889999999984,129.44236257213785,106.2754374278618,107.30011993152262,107.73333333333333,107.73333333333333,107.73333333333333,13825,16812.066666666666,32.409394526553186,32.24007797525497,NaN,NaN,NaN,NaN,2.808514203696356,36.24385828933297,-2376166,-0.7728113277450097,-3.9086442091530245,-3.1358328814080147
2025-03-03T13:30:00-05:00,106,106.81,102.98,103.77,NaN,NaN,NaN,112.6640831127295,NaN,NaN,117.56169999999983,129.79507624861253,105.32832375138713,103.03795929916133,105.96605752850925,107.56467645824904,104.36743859876947,16896,17216.433333333334,28.91864956383364,30.860981536631105,NaN,NaN,NaN,NaN,2.8814774748609016,36.25225485329552,-2393062,-0.735748502258132,-4.05551850923068,-3.319770006972548
2025-03-04T09:30:00-05:00,101.45,103.25,98.49,102.81,NaN,NaN,NaN,109.18457436670457,NaN,NaN,117.33469999999983,130.2161853817454,104.45321461825426,103.03795929916133,101.51666666666667,101.51666666666667,101.51666666666667,24592,17764.533333333333,27.656500864115117,30.10311858796098,NaN,NaN,NaN,NaN,3.0528005123708373,37.00636004830287,-2417654,-0.7049483368137537,-4.20095542798974,-3.4960070911759864
2025-03-04T13:30:00-05:00,102.4,106.22,102.4,103.65,NaN,NaN,NaN,109.18457436670457,NaN,NaN,117.09149999999983,130.5262231084278,103.65677689157182,103.03795929916133,102.81973336812595,104.10629551196794,101.53317122428396,25227,18316.666666666668,30.514230403776764,29.708349204698866,NaN,NaN,NaN,NaN,3.10760047577292,36.60857734548716,-2392427,-0.5632095661958116,-4.200019048920751,-3.6368094827249395
2025-03-05T09:30:00-05:00,104.13,105.67,102.92,105.2,NaN,NaN,NaN,109.18457436670457,NaN,NaN,116.81649999999983,130.64493393158168,102.988066068418,103.03795929916133,104.59666666666666,104.59666801536582,104.5966653179675,23295,18833.9,35.57172267614163,29.825450883008237,NaN,NaN,NaN,NaN,3.0820575846462828,36.23920769287258,-2369132,-0.3127725978235296,-4.027775230004352,-3.715002632180822
2025-03-05T13:30:00-05:00,104.92,107.04,104.92,106.86,NaN,NaN,NaN,109.18457436670457,NaN,NaN,116.56729999999983,130.6529782882515,102.48162171174816,103.03795929916133,105.4090664276863,106.24699854164889,104.5711343137237,21897,19433.8,40.561363321217975,30.426545536688984,NaN,NaN,NaN,NaN,3.013339185742977,35.39821128357939,-2347235,0.0003987903953732719,-3.7145041441866056,-3.714902934581979
2025-03-06T09:30:00-05:00,104.36,106.52,102.65,103.22,NaN,NaN,NaN,109.18457436670457,NaN,NaN,116.24929999999982,130.8003332292978,101.69826677070185,102.48882012893648,104.13000000000001,104.13000000000001,104.13000000000001,10337,18232.833333333332,34.29028990412773,31.06612118031572,NaN,NaN,NaN,NaN,3.0988149581899074,35.083815808785026,-2357572,-0.001760591212763174,-3.717103673597933,-3.7153430823851696
2025-03-06T13:30:00-05:00,102.5,102.98,101.21,101.58,NaN,NaN,NaN,109.18457436670457,NaN,NaN,115.88509999999982,130.96535682672987,100.80484317326979,102.48882012893648,103.21555593322759,104.3026002236874,102.12851164276778,7315,18154.233333333334,31.897456089055268,31.49159817417064,NaN,NaN,NaN,NaN,3.021042461176343,35.06679215657952,-2364887,-0.07381065164536693,-3.8076063969418783,-3.7337957452965114
2025-03-07T09:30:00-05:00,101.01,102.915,96.67,99.15,NaN,NaN,NaN,108.69392889376836,NaN,NaN,115.43639999999984,131.13400479054414,99.73879520945553,102.48882012893648,99.57833333333335,99.57833333333335,99.57833333333335,21238,17969.266666666666,28.701551116640033,31.363009750310244,NaN,NaN,NaN,NaN,3.25132514252089,35.79200509468975,-2386125,-0.2361375773432144,-4.028967716975529,-3.792830139632315
2025-03-07T13:30:00-05:00,99.34,101.28,99.34,100.73,NaN,NaN,NaN,108.69392889376836,NaN,NaN,115.01719999999983,131.1381657477493,98.89623425225037,102.48882012893648,99.76789032178826,100.12747154543395,99.40830909814257,5902,14474.833333333334,33.37573442896881,31.639640927785788,NaN,NaN,NaN,NaN,3.1712304894836834,36.46541710864925,-2380223,-0.1900918103448932,-4.030444902563431,-3.840353092218538
2025-03-10T09:30:00-04:00,96.31,96.4,91.88,92.43,NaN,NaN,NaN,103.73466971518977,NaN,NaN,114.40939999999982,131.5660805227622,97.25271947723743,98.8046821798499,93.57000000000001,93.57000000000001,93.57000000000001,25665,14708.566666666668,24.34624284972915,31.115708222927775,NaN,NaN,NaN,NaN,3.5768568830919922,38.001631928859766,-2405888,-0.6459411324386997,-4.647779507766913,-4.001838375328213
2025-03-10T13:30:00-04:00,92.32,92.82,90.6,91.55,NaN,NaN,NaN,101.17127563722659,NaN,NaN,113.83139999999983,132.04953426671656,95.61326573328309,98.8046821798499,92.75665546645162,93.70252537149608,91.81078556140716,18977,14041.866666666667,23.616716071651098,30.865830305202486,NaN,NaN,NaN,NaN,3.479938534299707,39.55192483549751,-2424865,-0.9174729023039898,-5.1486795032082,-4.23120660090421
2025-03-11T09:30:00-04:00,92.18,94.66,91.44,91.88,NaN,NaN,NaN,101.17127563722659,NaN,NaN,113.30299999999983,132.47942396277568,94.12657603722397,98.8046821798499,92.66000000000001,92.66000000000001,92.66000000000001,17370,14221.5,24.52998706388388,30.71913116770507,NaN,NaN,NaN,NaN,3.461371496135442,40.30686559761732,-2407495,-0.9799333776460841,-5.456123322961815,-4.476189945315731
2025-03-11T13:30:00-04:00,92,95.18,91.85,93.62,NaN,NaN,NaN,101.17127563722659,NaN,NaN,112.80539999999985,132.69453641564405,92.91626358435563,98.8046821798499,93.0781908075444,93.52238250850093,92.63399910658788,15396,14569.4,29.32807548903955,30.408422454909577,NaN,NaN,NaN,NaN,3.451987817840054,40.815538240722255,-2392099,-0.8158613622659177,-5.496016648148128,-4.68015528588221
2025-03-12T09:30:00-04:00,97.3,97.49,94.1,96.65,NaN,NaN,NaN,101.17127563722659,NaN,NaN,112.31699999999984,132.56642162137257,92.0675783786271,98.8046821798499,96.08,96.08,96.08,22750,14767.9,36.85644482255549,30.72606890462402,NaN,NaN,NaN,NaN,3.4818458308514777,40.4556245676606,-2369349,-0.4342197971258752,-5.222930032289554,-4.788710235163679
2025-03-12T13:30:00-04:00,96.86,97,95.65,96.2,NaN,NaN,NaN,101.17127563722659,NaN,NaN,111.81159999999983,132.38089220367362,91.24230779632603,97.82674574387993,96.17064280900063,96.27171004242797,96.06957557557328,18299,15159.866666666667,36.23901870465935,31.248952414683004,NaN,NaN,NaN,NaN,3.3295711286478,40.121419014103346,-2387648,-0.1573119300305832,-4.985350147701908,-4.828038217671325
2025-03-13T09:30:00-04:00,95.5,95.5,91.75,92.06,NaN,NaN,NaN,101.17127563722659,NaN,NaN,111.23199999999984,132.35424003272618,90.10975996727349,95.02039659510395,93.10333333333334,93.10333333333334,93.10333333333334,11455,15117.666666666666,31.080428141331254,31.49351864876987,NaN,NaN,NaN,NaN,3.409601762315815,40.42583947746533,-2399103,-0.1956937175802258,-5.072655364646607,-4.8769616470663815
2025-03-13T13:30:00-04:00,91.97,93.25,91.55,92.21,NaN,NaN,NaN,101.17127563722659,NaN,NaN,110.64439999999985,132.21131434953313,89.07748565046657,93.42481727608316,92.74206604194555,93.12476374802665,92.35936833586445,10208,15238.433333333332,31.46111446064785,31.561153224260664,NaN,NaN,NaN,NaN,3.2874873507218285,40.737700782698944,-2388895,-0.15545711241451166,-5.0712830375845215,-4.91582592517001
2025-03-14T09:30:00-04:00,94.82,96.53,94.78,96.03,NaN,NaN,NaN,101.17127563722659,NaN,NaN,110.16679999999984,131.94839165534276,88.38520834465692,92.62285382086652,95.78000000000002,95.78000000000002,95.78000000000002,10251,15191.7,40.47804408557299,31.91160475350576,NaN,NaN,NaN,NaN,3.3612382542416985,39.83947716308503,-2378644,0.16651185329896911,-4.707686108546298,-4.874197961845267
2025-03-14T13:30:00-04:00,95.97,96.44,95.84,96.2,NaN,NaN,NaN,101.17127563722659,NaN,NaN,109.68179999999984,131.60537222352463,87.75822777647505,89.33445343109825,95.97047146401985,96.16047087908291,95.7804720489568,10302,14890.6,40.850984461521676,31.93229197781317,NaN,NaN,NaN,NaN,3.164006950367291,39.00541237344354,-2368342,0.4148730721997236,-4.355606621595612,-4.770479693795336
2025-03-17T09:30:00-04:00,95.93,97.08,95.54,96.66,NaN,NaN,NaN,101.17127563722659,NaN,NaN,109.16399999999985,131.07036181569396,87.25763818430573,90.62556274487861,96.42666666666668,96.42666666666668,96.42666666666668,5553,14314.866666666667,41.91156938050457,32.47666908326865,NaN,NaN,NaN,NaN,3.0480064539124845,37.99902618639752,-2362789,0.6216404187804629,-3.9934291703197573,-4.61506958910022
2025-03-17T13:30:00-04:00,96.83,98.31,96.83,97.39,NaN,NaN,NaN,101.17127563722659,NaN,NaN,108.68939999999984,130.56729291865432,86.81150708134535,92.32145019590288,97.17608847690941,97.67632899715366,96.67584795666517,12463,14544.033333333333,43.63871333757638,33.31533031530587,NaN,NaN,NaN,NaN,2.948148850061593,36.62002671508506,-2350326,0.8073123709950476,-3.605929125356411,-4.413241496351459
2025-03-18T09:30:00-04:00,95.86,95.87,93.63,94.54,NaN,NaN,NaN,101.17127563722659,NaN,NaN,108.12319999999985,129.97118624679376,86.27521375320595,92.32145019590288,94.67999999999999,94.68000134869915,94.67999865130083,12236,14319.733333333334,38.78961445391743,34.03590626796855,NaN,NaN,NaN,NaN,3.0061382179143368,36.050848684521,-2362562,0.7397216434999665,-3.488589441976501,-4.228311085476467
2025-03-18T13:30:00-04:00,94.43,94.91,94.08,94.54,NaN,NaN,NaN,101.17127563722659,NaN,NaN,107.57299999999985,129.3759224646627,85.77007753533701,92.32145019590288,94.60329984301414,94.68789365249444,94.51870603353385,10059,14160.566666666668,38.789614453917444,34.4226119840363,NaN,NaN,NaN,NaN,2.8506997737775985,35.52232622756866,-2362562,0.6971283591244894,-3.356900636570856,-4.0540289956953455
2025-03-19T09:30:00-04:00,95.8,97.77,95.8,97.23,NaN,NaN,NaN,101.17127563722659,NaN,NaN,107.12999999999985,128.85528996354452,85.40471003645517,92.32145019590288,96.93333333333334,96.93333333333334,96.93333333333334,7662,14048.233333333334,45.427635992744484,35.92842577996597,NaN,NaN,NaN,NaN,2.8777926470791977,33.99633746371871,-2354900,0.8425164172889579,-3.000883474084148,-3.843399891373106
2025-03-19T13:30:00-04:00,97.11,99.6,96.83,97.98,NaN,NaN,NaN,101.17127563722659,NaN,NaN,106.70219999999985,128.28850502517952,85.11589497482016,93.24193000024182,97.72124177705687,98.29335783019084,97.14912572392291,14532,14374.2,47.14856898219834,37.60927241643363,NaN,NaN,NaN,NaN,2.8700931722878265,31.99195844172066,-2340368,0.9723795237574984,-2.627925486676233,-3.6003050104337313
2025-03-20T09:30:00-04:00,97.81,99.86,97.68,98.48,NaN,NaN,NaN,101.17127563722659,NaN,NaN,106.24479999999986,127.53741439654797,84.95218560345174,93.68354400019346,98.67333333333335,98.67333333333335,98.67333333333335,6596,14200.8,48.31865667247147,39.30846310276132,NaN,NaN,NaN,NaN,2.8208008028386957,30.04825884325843,-2333772,1.0675335870604403,-2.265888026608181,-3.333421613668621
2025-03-20T13:30:00-04:00,97.9,98.61,97.75,98.22,NaN,NaN,NaN,101.17127563722659,NaN,NaN,105.78719999999984,126.76422249224355,84.81017750775614,93.68354400019346,98.54684829536997,98.75830598237359,98.33539060836635,2360,14076.4,47.72694071212981,40.62266776155348,NaN,NaN,NaN,NaN,2.680743602635932,28.24339493040065,-2336132,1.085010011813928,-1.977159098901211,-3.062169110715139
2025-03-21T09:30:00-04:00,97,99.905,96.7,99.4,NaN,NaN,NaN,101.17127563722659,NaN,NaN,105.33039999999984,125.8440282349097,84.81677176508998,94.00556816012381,98.66833333333334,98.66833333333334,98.66833333333334,23200,14467.4,50.67899084567008,41.609992477490245,NaN,NaN,NaN,NaN,2.7181904881619365,26.327960186659116,-2312932,1.1423079331321047,-1.6342841943000082,-2.776592127432113
2025-03-21T13:30:00-04:00,99.37,100.21,99.37,100.08,NaN,NaN,NaN,101.17127563722659,NaN,NaN,104.85079999999984,124.70099852394658,85.00060147605309,95.07045452809905,98.95920462002888,99.47860049878011,98.43980874127766,7276,14437.8,52.34903925757672,42.76070823127005,NaN,NaN,NaN,NaN,2.5840340247217974,24.653574384618185,-2305656,1.187049162557039,-1.2927806742358143,-2.4798298367928533
2025-03-24T09:30:00-04:00,102.77,104.75,102.77,104.5,95.44267392553444,95.44267392553444,95.44267392553444,NaN,NaN,NaN,104.43579999999986,123.41107700562156,85.46052299437815,98.30336362247925,104.00666666666666,104.00666666666666,104.00666666666666,14024,14444.433333333332,61.47940429806023,44.93206367103641,NaN,NaN,NaN,NaN,2.7330315943845265,24.429202488266437,-2291632,1.4575472291102365,-0.6578958004050577,-2.115443029515294
2025-03-24T13:30:00-04:00,104.65,105.2,104.58,105.09,96.85527965619197,NaN,NaN,NaN,NaN,NaN,104.02379999999985,122.003708738369,86.0438912616307,99.6926908979834,104.3406404031997,104.79422236162867,103.88705844477073,7603,14134.666666666666,62.51198348797139,47.1499828872738,NaN,NaN,NaN,NaN,2.5878150519284895,24.333330317742384,-2284029,1.60762165452484,-0.10591596135924419,-1.7135376158840843
2025-03-25T09:30:00-04:00,105.59,106.24,105,105.08,97.78140330818324,NaN,NaN,NaN,NaN,NaN,103.65939999999983,120.77983990556561,86.53896009443406,101.21415271838671,105.44,105.44,105.44,6544,13533.066666666668,62.48141218971296,48.72165203756952,NaN,NaN,NaN,NaN,2.491542548219311,24.505577456688414,-2290573,1.6323950320712288,0.3269561742049518,-1.305438857866277
2025-03-25T13:30:00-04:00,104.96,105.85,104.75,105.84,97.78140330818324,NaN,NaN,NaN,NaN,NaN,103.29719999999985,119.42259713123602,87.17180286876368,101.27932217470938,105.46013357619914,105.4801331301982,105.44013402220008,6632,12913.233333333334,63.925358043380754,50.36982157913088,NaN,NaN,NaN,NaN,2.392146651917931,24.555418216251322,-2283941,1.6227525215734193,0.7230017941004974,-0.8997507274729221
2025-03-26T09:30:00-04:00,105.22,105.31,101.63,101.68,97.78140330818324,NaN,NaN,NaN,NaN,NaN,102.87219999999986,117.99434973606817,87.75005026393156,101.27932217470938,102.87333333333333,102.87333333333333,102.87333333333333,34036,13271.266666666666,52.10460921342704,51.09789585291106,NaN,NaN,NaN,NaN,2.5219933196380793,23.345278574816916,-2317977,1.274362788301177,0.6932027579035491,-0.5811600303976279
2025-03-26T13:30:00-04:00,101.52,101.93,101,101.7,97.78140330818324,NaN,NaN,NaN,NaN,NaN,102.47079999999987,116.59789104663957,88.34370895336016,101.27932217470938,102.56093207448204,103.12475751532345,101.99710663364063,10449,12889.666666666666,52.15042037411846,51.70587492694978,NaN,NaN,NaN,NaN,2.4082795110925024,21.993707556216933,-2307528,0.9957693281092601,0.6635516297389472,-0.33221769837031284
2025-03-27T09:30:00-04:00,101.01,102.52,100,101.18,97.78140330818324,NaN,NaN,NaN,NaN,NaN,102.11439999999986,115.43140997071266,88.79739002928706,101.27932217470938,101.23333333333333,101.23333333333333,101.23333333333333,12187,12951.333333333334,50.79018092625253,52.56305824640229,NaN,NaN,NaN,NaN,2.4162595460144662,20.46652354826726,-2319715,0.7387960510589765,0.5912773654534078,-0.1475186856055687
2025-03-27T13:30:00-04:00,100.7,101.5,100.24,100.27,97.78140330818324,NaN,NaN,NaN,NaN,NaN,101.70659999999985,113.93094267190118,89.48225732809853,101.27932217470938,101.06043126326963,101.32025115018753,100.80061137635174,5397,12887.4,48.41049413692895,53.25026393804597,NaN,NaN,NaN,NaN,2.333669578442005,19.048424112314,-2325112,0.4822720952281828,0.4553214334296598,-0.026950661798522985
2025-03-28T09:30:00-04:00,99,99.46,96,96.015,NaN,NaN,NaN,105.42467059648025,105.42467059648025,105.42467059648025,101.30589999999985,112.92163100411958,89.69016899588013,101.27932217470938,97.15833333333332,97.15833333333332,97.15833333333332,7582,12432.2,39.16928946998673,52.80323918642041,NaN,NaN,NaN,NaN,2.471978894267576,19.092532799624998,-2332694,0.02490789375463016,0.004184205394764717,-0.020723688359865444
2025-03-28T13:30:00-04:00,96.1,96.71,95.88,96.3,NaN,NaN,NaN,103.7530946602766,NaN,NaN,100.93649999999987,111.97649750906037,89.89650249093937,101.27932217470938,96.67515902902497,97.10280115027508,96.24751690777485,9679,12558.1,39.995522796318504,52.292307316000425,NaN,NaN,NaN,NaN,2.3546946875341774,19.16682365783613,-2323015,-0.2446878719619348,-0.326583528312284,-0.08189565635034916
2025-03-31T09:30:00-04:00,93.17,94.57,91.07,94.02,NaN,NaN,NaN,100.6522721757186,NaN,NaN,100.54689999999988,111.15228106623445,89.94151893376531,101.27932217470938,93.21999999999998,93.21999999999998,93.21999999999998,96923,14933.366666666667,35.8056049710964,51.39851790875935,NaN,NaN,NaN,NaN,2.5600736384245937,20.37952350019272,-2419938,-0.5455959788372229,-0.7638906298968777,-0.2182946510596549
2025-03-31T13:30:00-04:00,94.04,95.01,93.67,94.49,NaN,NaN,NaN,100.6522721757186,NaN,NaN,100.18909999999987,110.37218041606552,90.00601958393422,101.27932217470938,93.59783565720352,94.14492608398365,93.05074523042339,46229,15841.766666666666,37.26460223578541,50.65120801759189,NaN,NaN,NaN,NaN,2.472925521394266,21.317259784729174,-2373709,-0.6736138552433967,-1.0603119701139008,-0.3866981148705041
2025-04-01T09:30:00-04:00,95.28,97.4,93.93,96.3,NaN,NaN,NaN,100.6522721757186,NaN,NaN,99.97369999999987,110.02018213257094,89.9272178674288,101.27932217470938,95.87666666666667,95.87666666666667,95.87666666666667,50820,16956.766666666666,42.66860175169246,50.07903736802206,NaN,NaN,NaN,NaN,2.544145127008961,21.21756305399189,-2322889,-0.5995056042613279,-1.136080120197164,-0.536574515935836
2025-04-01T13:30:00-04:00,96.45,97.06,95.49,96.84,NaN,NaN,NaN,100.6522721757186,NaN,NaN,99.76529999999985,109.62919748730518,89.90140251269453,99.5484577397675,96.10286858257467,96.38841685736793,95.81732030778142,31891,17506.6,44.212571743312594,49.4978611170032,NaN,NaN,NaN,NaN,2.4745633322226075,21.124987518307268,-2290998,-0.4822755279494829,-1.1394189258726897,-0.6571433979232068
2025-04-02T09:30:00-04:00,94.67,100.11,94.67,99.81,NaN,NaN,NaN,100.6522721757186,NaN,NaN,99.58769999999986,109.1165217970568,90.0588782029429,97.2006129534512,98.19666666666667,98.19666666666667,98.19666666666667,75063,19250.366666666665,51.88715394308091,48.812700377361814,NaN,NaN,NaN,NaN,2.6863802370638497,19.91776585868927,-2215935,-0.18798679468386592,-0.8921268912780391,-0.7041400965941732
2025-04-02T13:30:00-04:00,99.65,99.65,98,99.22,NaN,NaN,NaN,100.6522721757186,NaN,NaN,99.41289999999987,108.6367499749328,90.18905002506693,97.2006129534512,98.51309745407987,98.88774255976246,98.13845234839728,53548,20425.333333333332,50.40374314458248,47.94782606711975,NaN,NaN,NaN,NaN,2.6237816487021464,18.796774317615412,-2269483,-0.02491065038266249,-0.7352784095725013,-0.7103677591898389
2025-04-03T09:30:00-04:00,92.84,93.5,90.32,91.95,NaN,NaN,NaN,100.6522721757186,NaN,NaN,99.07949999999987,108.15191538952398,90.00708461047576,96.61449036276096,91.92333333333333,91.92333333333333,91.92333333333333,93149,23148.466666666667,36.54100183680599,46.09493961334068,NaN,NaN,NaN,NaN,3.072082959509136,19.647781445322245,-2362632,-0.37886995367977994,-1.1839552012895638,-0.8050852476097838
2025-04-03T13:30:00-04:00,91.9,92.34,91,91.13,NaN,NaN,NaN,100.2276339238934,NaN,NaN,98.79649999999987,107.95991819410584,89.6330818058939,93.41659229020875,91.76365436852834,91.97269227486026,91.5546164621964,54353,24619.966666666667,35.35970487847574,44.054535815847466,NaN,NaN,NaN,NaN,2.9483627481156267,20.43800234962144,-2416985,-0.6258544744356396,-1.5874033406543333,-0.9615488662186937
2025-04-04T09:30:00-04:00,87.4,88.27,82.5,85.27,NaN,NaN,NaN,94.73046874553461,NaN,NaN,98.40489999999987,108.15479938204788,88.65500061795186,92.67078058345959,85.34666666666665,85.34666666666665,85.34666666666665,96281,27487.633333333335,28.314989030775948,42.35527723137239,NaN,NaN,NaN,NaN,3.3541939803930814,22.46838181755422,-2513266,-1.113056513936418,-2.352869508639216,-1.2398129947027983
2025-04-04T13:30:00-04:00,84.89,86.46,84.5,85.25,NaN,NaN,NaN,94.66794743891938,NaN,NaN,97.96929999999988,108.07841826224485,87.8601817377549,92.67078058345959,85.3593566492563,85.38298001380076,85.33573328471184,27783,28070.333333333332,28.2942699537724,40.65126648706195,NaN,NaN,NaN,NaN,3.254608696079289,24.35373418063466,-2541049,-1.3500502667873922,-2.9273758281870386,-1.5773255613996464
2025-04-07T09:30:00-04:00,79.86,89.81,78.69,85.83,NaN,NaN,NaN,94.5366771007867,NaN,NaN,97.56169999999989,107.94851849461317,87.17488150538661,92.67078058345959,84.77666666666666,84.77666666666666,84.77666666666666,97973,31151,29.89632514097474,39.15884821668497,NaN,NaN,NaN,NaN,3.816422360645054,26.732547546345202,-2443076,-1.3764270728325418,-3.2978594024403236,-1.9214323296077818
2025-04-07T13:30:00-04:00,85.51,86.62,84.3,85.11,NaN,NaN,NaN,94.5366771007867,NaN,NaN,97.18849999999988,107.9889181863508,86.38808181364895,92.67078058345959,84.84473852481835,85.0289673908559,84.66050965878081,13376,31181.433333333334,29.02926574662878,37.77447476023496,NaN,NaN,NaN,NaN,3.709535049170408,28.941445671647852,-2456452,-1.349236348431032,-3.607977765146572,-2.25874141671554
2025-04-08T09:30:00-04:00,89.49,90,83.98,83.98,NaN,NaN,NaN,94.5366771007867,NaN,NaN,96.81189999999988,108.1039671074895,85.51983289251027,92.67078058345959,85.98666666666668,85.98666666666668,85.98666666666668,40960,32138.9,27.67278230429271,36.953295676971095,NaN,NaN,NaN,NaN,3.87456825994395,29.821811448495833,-2497412,-1.3129859760294584,-3.8999738867523632,-2.586987910722905
2025-04-08T13:30:00-04:00,83.92,85.5,81.5,82.78,NaN,NaN,NaN,94.06404927032172,NaN,NaN,96.39449999999988,108.1768875763805,84.61211242361927,92.67078058345959,85.23214011171738,86.45198931730441,84.01229090613036,15671,32325.966666666667,26.26897020956322,35.97282763506001,NaN,NaN,NaN,NaN,3.8835276699479535,30.95776518910206,-2513083,-1.274432172036284,-4.18002812576826,-2.905595953731976
2025-04-09T09:30:00-04:00,82.79,91.78,82.24,89.02,NaN,NaN,NaN,94.06404927032172,NaN,NaN,96.07089999999988,107.7565109279766,84.38528907202316,92.67078058345959,87.67999999999999,87.68000095367431,87.67999904632568,52330,33814.9,42.58076011808465,36.45676728841631,NaN,NaN,NaN,NaN,4.2875614078088145,30.227330702834145,-2460753,-0.7587475683442442,-3.854030414162281,-3.095282845818037
2025-04-09T13:30:00-04:00,88.74,96.15,88.71,95.12,80.54816998303332,80.54816998303332,80.54816998303332,NaN,NaN,NaN,95.83609999999987,107.10965051259774,84.56254948740201,83.64329957341414,90.76689270822506,93.57789743376631,87.9558879826838,63106,35434.03333333333,53.42773446783029,37.61127673356237,NaN,NaN,NaN,NaN,4.512735592965329,28.566916421397053,-2397647,0.02175520423809596,-3.068088840520417,-3.089844044758513
2025-04-10T09:30:00-04:00,92.49,92.8,87.46,89.42,80.54816998303332,NaN,NaN,NaN,NaN,NaN,95.56009999999989,106.77258348761664,84.34761651238314,83.64329957341414,89.89333333333333,89.89333333333333,89.89333333333333,37397,36460.73333333333,44.89350374631531,37.770198304606865,NaN,NaN,NaN,NaN,4.737540193467806,27.250301599529447,-2435044,0.17422761208242044,-2.8720595296554876,-3.046287141737908
2025-04-10T13:30:00-04:00,89.4,91.81,89.4,90.61,80.54816998303332,NaN,NaN,NaN,NaN,NaN,95.34069999999988,106.50261668308283,84.17878331691693,80.87495677655876,90.07449848388126,90.384998611016,89.76399835674651,12731,36806.433333333334,46.8039456314958,37.95529643947709,NaN,NaN,NaN,NaN,4.57128732250582,26.027730693509525,-2422313,0.36437650244423736,-2.5908165136826113,-2.9551930161268487
2025-04-11T09:30:00-04:00,90.63,91.875,88.9,90.62,80.54816998303332,NaN,NaN,NaN,NaN,NaN,95.17009999999989,106.35463870126418,83.9855612987356,80.87495677655876,90.465,90.465,90.465,30332,37044.166666666664,46.82063008329726,37.593401878063965,NaN,NaN,NaN,NaN,4.45726679946969,24.991853674054955,-2391981,0.49203703203464233,-2.340146726083546,-2.8321837581181883
2025-04-11T13:30:00-04:00,90.67,92.41,90.43,92.3,80.54816998303332,NaN,NaN,NaN,NaN,NaN,95.0014999999999,106.09952689670872,83.90347310329106,81.24118229567847,90.93133319564917,91.53521449458437,90.32745189671398,18088,37404.566666666666,49.67624427200805,37.54143767288008,NaN,NaN,NaN,NaN,4.28031917093614,23.890358757542753,-2373893,0.6792929384347284,-1.983067585074778,-2.6623605235095065
2025-04-14T09:30:00-04:00,94.92,95.5,91.42,92.17,81.70725270370029,NaN,NaN,NaN,NaN,NaN,94.99629999999988,106.09938404183669,83.89321595816307,84.52494583654278,93.03000000000002,93.03000000000002,93.03000000000002,41175,38309.6,49.45494254689049,38.46386200931469,NaN,NaN,NaN,NaN,4.266010658726416,22.269556773347805,-2415068,0.7770275909021058,-1.691076034881874,-2.46810362578398
2025-04-14T13:30:00-04:00,91.97,93.5,91.95,92.7,81.70725270370029,NaN,NaN,NaN,NaN,NaN,95.01929999999987,106.09847145097473,83.94012854902502,84.52494583654278,92.93923679398269,93.08136764326788,92.79710594469749,16791,38615.86666666667,50.42460248152086,39.539926123817914,NaN,NaN,NaN,NaN,4.072009897388815,20.7645263594525,-2398277,0.8538772988016357,-1.4007570022819351,-2.2546343010835708
2025-04-15T09:30:00-04:00,92.85,94.5,92.85,93,82.51919099655336,NaN,NaN,NaN,NaN,NaN,95.04169999999988,106.09990159158299,83.98349840841676,85.95596533538739,93.45,93.45,93.45,14446,38879.26666666667,50.99764621389232,41.16011592261194,NaN,NaN,NaN,NaN,3.9097234761467567,19.61809000038504,-2383831,0.8969839176147736,-1.1334044040651037,-2.0303883216798773
2025-04-15T13:30:00-04:00,93.09,93.6,92.86,93.55,82.51919099655336,NaN,NaN,NaN,NaN,NaN,95.04029999999987,106.09923890208677,83.98136109791298,86.39477226830991,93.40284076364469,93.4587041673989,93.34697735989047,10295,39001.36666666667,52.091010023945216,42.85988307048142,NaN,NaN,NaN,NaN,3.683314656421988,18.553541952679538,-2373536,0.93059130987733,-0.8671491843332149,-1.7977404942105448
2025-04-16T09:30:00-04:00,91.44,92.83,91.42,92.07,82.51919099655336,NaN,NaN,NaN,NaN,NaN,94.94869999999987,106.02864094028021,83.86875905971954,86.39477226830991,92.10666666666668,92.10666666666668,92.10666666666668,12209,38273.8,48.92739550047828,44.21924523901739,NaN,NaN,NaN,NaN,3.5723636095347024,17.311054677017477,-2385745,0.8248121525482484,-0.7667253035252344,-1.5915374560734827
2025-04-16T13:30:00-04:00,91.74,92,89.59,91.32,82.51919099655336,NaN,NaN,NaN,NaN,NaN,94.85109999999987,105.97113260607156,83.73106739392819,86.39477226830991,91.34956247834728,91.88562995738694,90.81349499930762,24353,38737.26666666667,47.357769258633965,45.528424061303475,NaN,NaN,NaN,NaN,3.49433763742508,16.660618001088615,-2410098,0.6819203053691816,-0.7391370743620058,-1.4210573797311874
2025-04-17T09:30:00-04:00,91.72,92,90.35,91.35,82.51919099655336,NaN,NaN,NaN,NaN,NaN,94.83689999999987,105.97295475741268,83.70084524258706,86.39477226830991,91.23333333333333,91.23333333333333,91.23333333333333,27600,39251.03333333333,47.430417207646514,46.939683697257315,NaN,NaN,NaN,NaN,3.3625992347518605,16.0566410877261,-2382498,0.5714811133946847,-0.7067059879878315,-1.2781871013825161
2025-04-17T13:30:00-04:00,91.51,92.2,91.23,91.575,82.51919099655336,NaN,NaN,NaN,NaN,NaN,94.82419999999988,105.97364937833693,83.67475062166282,86.76485872109974,91.35842909751082,91.55532426556037,91.16153392946127,11141,39442.5,48.00991996426249,48.49260867973584,NaN,NaN,NaN,NaN,3.191699289412442,15.426593817930456,-2371357,0.4983139453136931,-0.6552946697403996,-1.1536086150540927
2025-04-21T09:30:00-04:00,90.48,91.47,88.62,88.79,82.51919099655336,NaN,NaN,NaN,NaN,NaN,94.67939999999987,105.94984642239619,83.40895357760355,86.76485872109974,89.62666666666667,89.62666666666667,89.62666666666667,13224,39630.566666666666,41.85903564333528,48.44105693153945,NaN,NaN,NaN,NaN,3.174792197311553,15.582221406051264,-2384581,0.2591167772127929,-0.8297126435381017,-1.0888294207508946
2025-04-21T13:30:00-04:00,88.85,89.75,88.51,89.74,82.51919099655336,NaN,NaN,NaN,NaN,NaN,94.55019999999989,105.89581712028456,83.20458287971522,86.76485872109974,89.46935409215233,89.61563387802775,89.32307430627691,15294,39817.73333333333,44.472391988315735,47.80138961157412,NaN,NaN,NaN,NaN,3.0365927546464415,15.756441457561602,-2369287,0.16616272725122805,-0.8811260116868596,-1.0472887389380876
2025-04-22T09:30:00-04:00,91.2,94.33,91.2,92.83,83.05904246021586,NaN,NaN,NaN,NaN,NaN,94.47359999999988,105.81292026887397,83.13427973112579,87.81060766520307,92.78666666666668,92.78666666666668,92.78666666666668,37027,37821.2,52.02581135185294,48.31084015482681,NaN,NaN,NaN,NaN,3.1475504150288387,14.899676553465921,-2332260,0.30593491754078317,-0.6648700920121087,-0.9708050095528918
2025-04-22T13:30:00-04:00,92.83,93.65,92.64,93.34,83.74249507566061,NaN,NaN,NaN,NaN,NaN,94.39259999999989,105.70526162139112,83.07993837860866,87.92948613216245,92.91189301585491,93.10510494429312,92.71868108741671,15554,36798.7,53.15837588275318,48.76472802991663,NaN,NaN,NaN,NaN,2.994868242526779,14.104109142519933,-2316706,0.41890145717475324,-0.4471781880844503,-0.8660796452592036
2025-04-23T09:30:00-04:00,97.59,99.24,96.61,98.02,88.14533620858512,NaN,NaN,NaN,NaN,NaN,94.46219999999988,105.82036185128993,83.10403814870983,91.71358890572996,97.95666666666666,97.95666666666666,97.95666666666666,63623,37225.46666666667,62.01929380579575,49.85034686723795,NaN,NaN,NaN,NaN,3.202377653774865,14.789298046084673,-2253083,0.7743097385772771,0.1018075279623929,-0.6725022106148842
2025-04-23T13:30:00-04:00,97.85,98,96.43,96.86,88.14533620858512,NaN,NaN,NaN,NaN,NaN,94.50859999999987,105.88659192125307,83.13060807874668,91.71358890572996,97.80462246777164,98.13270869520396,97.47653624033931,13664,36617.9,59.038193110609114,50.5190574985666,NaN,NaN,NaN,NaN,3.087207821362374,15.362531022302353,-2266747,0.8885847522316942,0.4382287296747336,-0.4503560225569606
2025-04-24T09:30:00-04:00,96.91,100.05,96.91,99.88,88.92722782641742,NaN,NaN,NaN,NaN,NaN,94.56159999999987,106.01424763101113,83.10895236898861,93.00209689966718,98.94666666666666,98.94666666666666,98.94666666666666,18423,34729.9,63.902891122611074,51.55105382540379,NaN,NaN,NaN,NaN,3.09455011983649,16.338285385072986,-2248324,1.1104641905083104,0.9377242155784273,-0.17273997492988302
2025-04-24T13:30:00-04:00,99.81,100.515,99.69,100.46,90.87144474339846,NaN,NaN,NaN,NaN,NaN,94.61119999999988,106.14383847695281,83.07856152304696,94.46417751973375,99.56049840027771,100.19755888654717,98.92343791400825,17104,33515.1,64.7682898225749,52.57560292119336,NaN,NaN,NaN,NaN,2.9324393969910263,17.34203877366594,-2231220,1.2299106384720635,1.3646483231601962,0.13473768468813285
2025-04-25T09:30:00-04:00,100.85,103.38,100.8,103.38,92.88035634597126,NaN,NaN,NaN,NaN,NaN,94.7091999999999,106.4530185203997,82.9653814796001,97.07934201578699,102.52,102.52,102.52,12443,30824.9,68.82099996111708,53.8486996174237,NaN,NaN,NaN,NaN,2.9315508686345244,18.837766008575755,-2218777,1.4254226105892713,1.9165159479247222,0.4910933373354508
2025-04-25T13:30:00-04:00,103.08,103.25,101.88,103.18,93.56943105751802,NaN,NaN,NaN,NaN,NaN,94.80839999999989,106.7512727599389,82.86552724006089,97.4594736126296,102.63886092491884,102.76371008093635,102.51401176890134,11278,29389.066666666666,68.24197771417737,55.002340166726,NaN,NaN,NaN,NaN,2.82929723516063,20.22665558384915,-2230055,1.4560019813911755,2.31109581407442,0.8550938326832447
2025-04-28T09:30:00-04:00,103.69,104,101.01,101.4,93.56943105751802,NaN,NaN,NaN,NaN,NaN,94.84839999999987,106.8656842922226,82.83111570777714,97.87257889010368,102.13666666666666,102.13666666666666,102.13666666666666,20531,26864.066666666666,63.14961131829847,56.01821272514173,NaN,NaN,NaN,NaN,2.8407760040777275,21.13712248456016,-2250586,1.2774513399502498,2.451908007621057,1.1744566676708073
2025-04-28T13:30:00-04:00,101.27,103.29,101.27,103.23,93.56943105751802,NaN,NaN,NaN,NaN,NaN,94.91139999999989,107.06992672654441,82.75287327345536,97.87257889010368,102.30941500902324,102.53217552549668,102.0866544925498,12347,26349.533333333333,65.96183552572737,57.347074601362685,NaN,NaN,NaN,NaN,2.782149146643605,21.982556035220377,-2238239,1.2046521743985774,2.680271885669029,1.4756197112704517
2025-04-29T09:30:00-04:00,102.72,103.87,102.72,103.44,94.67993106909039,NaN,NaN,NaN,NaN,NaN,94.89019999999988,106.98530793007218,82.79509206992758,98.56545048966635,103.34333333333332,103.34333333333332,103.34333333333332,14090,23553.433333333334,66.27985244351837,58.69346283249639,NaN,NaN,NaN,NaN,2.6655670647404905,22.905621842917753,-2224149,1.0958219763747499,2.845397181738889,1.7495752053641391
2025-04-29T13:30:00-04:00,103.44,104.14,103.4,104.1,95.44561602049538,NaN,NaN,NaN,NaN,NaN,94.87039999999988,106.90172691601784,82.83907308398192,99.52636039173308,103.66813613142435,103.93046031507565,103.40581194777305,21601,23827.6,67.3134754370823,60.07228822341209,NaN,NaN,NaN,NaN,2.5280265601161696,23.82899552286122,-2202548,0.9963336328200392,2.994992246389188,1.9986586135691489
2025-04-30T09:30:00-04:00,100.79,102,99.5,101.53,95.44561602049538,NaN,NaN,NaN,NaN,NaN,94.79939999999988,106.62910035800134,82.96969964199842,99.52636039173308,101.00999999999999,101.00999999999999,101.00999999999999,12967,22894.5,59.646383308954405,61.3428130566706,NaN,NaN,NaN,NaN,2.676024662965014,22.92630408942339,-2215515,0.6995140260127748,2.8730511460851176,2.173537120072343
2025-04-30T13:30:00-04:00,101.72,102.9,101.72,102.78,95.44561602049538,NaN,NaN,NaN,NaN,NaN,94.73819999999989,106.36878205938498,83.1076179406148,99.52636039173308,101.80834390538593,102.53330456931664,101.08338324145521,15725,22896.3,61.91836993540405,62.58895433860547,NaN,NaN,NaN,NaN,2.5827371870389415,22.36174451361299,-2199790,0.5367599224217061,2.844487023099475,2.307727100677769
2025-05-01T09:30:00-04:00,105.34,105.63,103.8,104.35,96.33643688634557,NaN,NaN,NaN,NaN,NaN,94.79159999999989,106.57272395996618,83.0104760400336,99.82281652056733,104.59333333333332,104.59333333333332,104.59333333333332,23495,21935.133333333335,64.6132434564994,63.48805663179451,NaN,NaN,NaN,NaN,2.601827387964731,22.58723069564709,-2176295,0.48576558599788555,2.914934083175126,2.4291684971772405
2025-05-01T13:30:00-04:00,104.23,104.36,103.16,103.2,96.33643688634557,NaN,NaN,NaN,NaN,NaN,94.82159999999988,106.68032243372369,82.96287756627606,99.82281652056733,104.18591736748377,104.68549370393127,103.68634103103626,15626,20352.466666666667,61.19709649131547,64.06225096097754,NaN,NaN,NaN,NaN,2.5016968602529652,22.525486073611276,-2191921,0.3328021102526719,2.8451711349930804,2.5123690247404085
2025-05-02T09:30:00-04:00,103.37,105.8,103.14,105.24,96.33643688634557,NaN,NaN,NaN,NaN,NaN,94.90279999999989,106.98799874226725,82.81760125773252,100.2734025731631,104.72666666666667,104.72666666666667,104.72666666666667,38766,20398.1,64.75675177445807,64.25778367302485,NaN,NaN,NaN,NaN,2.513004227377753,22.84987843769761,-2153155,0.32676477586018127,2.920824994565635,2.5940602187054536
2025-05-02T13:30:00-04:00,105.18,105.53,104.47,104.76,97.07293829868955,NaN,NaN,NaN,NaN,NaN,94.99259999999987,107.30066146231451,82.68453853768523,100.57872205853047,104.76136395385757,104.83555452232302,104.68717338539211,8479,20256.366666666665,63.28564338522316,64.5611729783544,NaN,NaN,NaN,NaN,2.409218211136485,23.151099918634916,-2161634,0.2515691116378642,2.9085216082527836,2.6569524966149194
2025-05-05T09:30:00-04:00,103.32,104.25,102.8,104.22,97.07293829868955,NaN,NaN,NaN,NaN,NaN,95.15669999999987,107.73082543440327,82.58257456559647,100.57872205853047,103.75666666666666,103.75666666666666,103.75666666666666,39134,20549.766666666666,61.59048437910392,64.39600106810391,NaN,NaN,NaN,NaN,2.3771311960553083,22.667462787149955,-2200768,0.1325657903494979,2.8226597345517916,2.6900939442022938
2025-05-05T13:30:00-04:00,104.34,104.58,103.58,103.58,97.07293829868955,NaN,NaN,NaN,NaN,NaN,95.30229999999987,108.09274255841498,82.51185744158477,100.57872205853047,103.82788394889664,103.90589339016643,103.74987450762686,32616,21034.033333333333,59.55442619871456,64.02358223782817,NaN,NaN,NaN,NaN,2.278764682051358,22.32339168237538,-2233384,-0.01434088158018021,2.6721678422270685,2.6865087238072487
2025-05-06T09:30:00-04:00,100.96,102.12,100.37,101.43,97.07293829868955,NaN,NaN,NaN,NaN,NaN,95.45049999999986,108.34933409460376,82.55166590539596,100.57872205853047,101.30666666666667,101.30666666666667,101.30666666666667,36977,20894.1,53.192741932700336,62.90727809294126,NaN,NaN,NaN,NaN,2.3452814904762604,20.76316359272426,-2270361,-0.26736772921446894,2.3522990622891626,2.6196667915036316
2025-05-06T13:30:00-04:00,101.49,102.42,101.13,102.03,97.07293829868955,NaN,NaN,NaN,NaN,NaN,95.60129999999987,108.62736384293106,82.57523615706867,100.57872205853047,101.51372653217801,101.7814938522069,101.24595921214912,22111,21071.433333333334,54.648688351327735,61.936328852737724,NaN,NaN,NaN,NaN,2.269904241156528,19.35640581277756,-2248250,-0.3975366009945551,2.122746040260438,2.520282641254993
2025-05-07T09:30:00-04:00,102.39,103.2,101.94,102.3,97.07293829868955,NaN,NaN,NaN,NaN,NaN,95.72129999999987,108.88076394197363,82.56183605802612,100.57872205853047,102.48,102.48,102.48,14500,21073.233333333334,55.322163420609016,61.37722543147419,NaN,NaN,NaN,NaN,2.197768223931062,18.342489434385392,-2233750,-0.4640305690439499,1.9402444299500559,2.4042749989940058
2025-05-07T13:30:00-04:00,102.29,102.98,101.36,102.57,97.07293829868955,NaN,NaN,NaN,NaN,NaN,95.83589999999985,109.13143363953937,82.54036636046034,100.57872205853047,102.37025951858432,102.45595964569547,102.28455939147317,23776,21522.6,56.02542677543658,60.667481949310556,NaN,NaN,NaN,NaN,2.156499065078844,17.16011514626344,-2209974,-0.48607099781100427,1.7966862517302502,2.2827572495412545
2025-05-08T09:30:00-04:00,104.54,106.73,104.35,106.66,98.05481034861415,NaN,NaN,NaN,NaN,NaN,95.97289999999984,109.5672205920759,82.37857940792378,101.15205263624912,105.91333333333334,105.91333333333334,105.91333333333334,23397,21895.533333333333,65.01027276106696,60.57679768627831,NaN,NaN,NaN,NaN,2.29960627471607,17.34264940233216,-2186577,-0.2342020837584804,1.9900046448431539,2.2242067286016343
2025-05-08T13:30:00-04:00,106.66,106.87,105.84,106.01,99.06959169640443,NaN,NaN,NaN,NaN,NaN,96.10869999999986,109.9632214006158,82.25417859938392,101.8926421089993,105.99080629910992,106.12975152234654,105.8518610758733,7274,21326.233333333334,62.8137365637427,60.255387766754055,NaN,NaN,NaN,NaN,2.208920112236351,17.553922940255507,-2193851,-0.1258174173733364,2.066934956884964,2.1927523742583004
2025-05-09T09:30:00-04:00,107.06,108.8,106.34,106.61,100.23529207384058,NaN,NaN,NaN,NaN,NaN,96.40189999999986,110.51014225621759,82.29365774378212,103.42311368719943,107.25,107.25,107.25,34056,21541.433333333334,64.0221462707145,60.56794226402263,NaN,NaN,NaN,NaN,2.250425818505182,18.30572724861795,-2159795,-0.032988757866856844,2.1515164269247293,2.184505184791586
2025-05-09T13:30:00-04:00,106.56,106.88,106.405,106.69,100.23529207384058,NaN,NaN,NaN,NaN,NaN,96.71309999999987,111.02740346052902,82.39879653947072,103.42311368719943,107.14509050793959,107.37106716147301,106.91911385440616,7340,21414.733333333334,64.18924324357772,60.73014750032075,NaN,NaN,NaN,NaN,2.1236096886119546,19.003831249240214,-2152455,0.01211346904152899,2.1996470210934973,2.1875335520519683
2025-05-12T09:30:00-04:00,112.57,112.73,110.26,112.47,103.92646447223906,NaN,NaN,NaN,NaN,NaN,97.25709999999987,111.85512618027904,82.65907381972069,106.07879275980764,111.82000000000001,111.82000000000001,111.82000000000001,28865,21936.1,73.6951201740288,61.37885298014428,NaN,NaN,NaN,NaN,2.403351853711101,20.96438545563329,-2123590,0.3886704340640721,2.6733715946320586,2.2847011605679866
2025-05-12T13:30:00-04:00,112.5,112.61,111.74,112.24,104.83185245077364,NaN,NaN,NaN,NaN,NaN,97.79689999999987,112.57398291781965,83.01981708218008,106.85403420784611,111.89107956940893,112.03846002703393,111.74369911178393,6714,21650.1,72.8662438163671,62.21236350336225,NaN,NaN,NaN,NaN,2.293826721303166,22.784900075855436,-2130304,0.5688070511705328,2.9957099745311524,2.4269029233606196
2025-05-13T09:30:00-04:00,113.79,118.01,113.79,117.86,108.10381370301121,NaN,NaN,NaN,NaN,NaN,98.43749999999987,113.84744513293649,83.02755486706326,110.52022736627688,116.55333333333334,116.5533346820325,116.55333198463418,23178,21188.466666666667,79.06293645126317,63.23423383741975,NaN,NaN,NaN,NaN,2.5421248126386544,25.2967626085974,-2107126,0.9884250473731715,3.662434232577084,2.6740091852039125
2025-05-13T13:30:00-04:00,117.88,118.54,117.54,117.91,110.46182217105616,NaN,NaN,NaN,NaN,NaN,99.09349999999988,114.96389838819765,83.22310161180211,112.0481818930215,117.17420618725671,117.88879934779675,116.45961302671668,17497,21253.233333333334,79.10864894731557,64.36444852042635,NaN,NaN,NaN,NaN,2.431973040307322,27.695867901776754,-2089629,1.1784310556360325,4.147048004748953,2.9686169491129206
2025-05-14T09:30:00-04:00,118.85,120,118.31,118.45,111.6362847996445,NaN,NaN,NaN,NaN,NaN,99.78289999999988,115.95908472817695,83.60671527182282,113.76154551441721,118.92,118.92000134869916,118.91999865130084,24954,19964.266666666666,79.626021571933,65.65270117705701,NaN,NaN,NaN,NaN,2.407546394571085,30.105033087947277,-2064675,1.243145061781223,4.52254827633945,3.2794032145582266
2025-05-14T13:30:00-04:00,118.5,119.56,118.5,119.465,111.70168094511521,NaN,NaN,NaN,NaN,NaN,100.51659999999988,116.86831568246299,84.16488431753677,114.01423641153377,119.00855296887262,119.12995881207927,118.88714712566598,13276,19951.333333333332,80.5986049504418,67.15585680218037,NaN,NaN,NaN,NaN,2.314864509244579,32.34211504653419,-2051399,1.2534160644267578,4.846173295091674,3.5927572306649163
2025-05-15T09:30:00-04:00,118.08,118.81,115.91,118.48,111.70168094511521,NaN,NaN,NaN,NaN,NaN,101.10579999999989,117.87574136662687,84.33585863337291,114.01423641153377,117.73333333333333,117.73333333333333,117.73333333333333,28353,20282.333333333332,76.76868266944408,68.83985256909065,NaN,NaN,NaN,NaN,2.4034456157271094,33.11920096716843,-2079752,1.0985327078980953,4.965923115537535,3.86739040763944
2025-05-15T13:30:00-04:00,118.25,118.36,116.93,117.68,111.70168094511521,NaN,NaN,NaN,NaN,NaN,101.55699999999987,118.86383541263726,84.25016458736249,114.01423641153377,117.70665126011775,117.74317101614616,117.67013150408934,15135,20216.7,73.70531121971003,70.20103991683223,NaN,NaN,NaN,NaN,2.342485214603744,33.84078075061452,-2094887,0.8575555296471586,4.939334819698388,4.081779290051229
2025-05-16T09:30:00-04:00,118.42,120.14,118.35,119.92,111.89234712929301,NaN,NaN,NaN,NaN,NaN,102.16699999999987,119.86529347705917,84.46870652294058,114.31296904270529,119.47000000000001,119.47000000000001,119.47000000000001,41101,21171.966666666667,76.52942399200444,71.71584424336048,NaN,NaN,NaN,NaN,2.3508791278463335,34.84527550357365,-2053786,0.7672999892230115,5.040904276579994,4.273604287356982
2025-05-16T13:30:00-04:00,119.97,120.18,119.55,120.07,112.76064953250697,NaN,NaN,NaN,NaN,NaN,102.75619999999988,120.83373352202975,84.67866647797001,115.20337523416423,119.56323395847505,119.74899140717635,119.37747650977376,10354,21141.166666666668,76.70981499052928,73.19330054443853,NaN,NaN,NaN,NaN,2.2279591901430247,35.78543236475182,-2043432,0.6411174467313847,5.0750010957712135,4.433883649039829
2025-05-19T09:30:00-04:00,116.87,119.93,116.87,119.77,112.76064953250697,NaN,NaN,NaN,NaN,NaN,103.33919999999989,121.6916446720348,84.98675532796499,115.20337523416423,118.85666666666667,118.85666666666667,118.85666666666667,26141,21328.166666666668,75.46063151990651,73.9397547414985,NaN,NaN,NaN,NaN,2.297390676561379,35.33000575243226,-2069573,0.4688520676859742,5.019948733647297,4.551096665961323
2025-05-19T13:30:00-04:00,119.59,119.86,119.37,119.78,112.76064953250697,NaN,NaN,NaN,NaN,NaN,103.88879999999989,122.52958491480688,85.2480150851929,115.20337523416423,119.04407717067043,119.38657463476969,118.70157970657118,7827,21177.5,75.47496819032986,74.84412842911186,NaN,NaN,NaN,NaN,2.16829134252128,34.90710961242124,-2061746,0.2954481623683378,4.920406868921745,4.624958706553407
2025-05-20T09:30:00-04:00,119.87,120.22,118.75,120.2,112.76064953250697,NaN,NaN,NaN,NaN,NaN,104.4493999999999,123.33113113250208,85.56766886749772,115.71696811989209,119.72333333333334,119.72333333333334,119.72333333333334,20929,21405.466666666667,76.10636320877512,75.70728678183048,NaN,NaN,NaN,NaN,2.118413389484046,34.212948487809456,-2040817,0.15591262613350487,4.819849489220289,4.663936863086784
2025-05-20T13:30:00-04:00,120.18,120.36,118.82,119.96,112.85016954413756,NaN,NaN,NaN,NaN,NaN,104.99459999999988,124.06114723226285,85.9280527677369,115.98757449591366,119.7206137452024,119.7250634332032,119.7161640572016,7818,20946.033333333333,74.91941280833069,76.47372746502711,NaN,NaN,NaN,NaN,2.077098147378043,33.61041751851055,-2048635,0.00244479634889494,4.666992858522903,4.664548062174008
2025-05-21T09:30:00-04:00,119,121.66,118.57,118.57,113.26016183758584,NaN,NaN,NaN,NaN,NaN,105.5059999999999,124.6298277549263,86.3821722450735,116.61705959673093,119.59999999999998,119.59999999999998,119.59999999999998,22015,21247.633333333335,68.27771903328212,76.08677024068807,NaN,NaN,NaN,NaN,2.149448279708183,33.43765753103866,-2070650,-0.2251063734641905,4.38316509534377,4.608271468807961
2025-05-21T13:30:00-04:00,118,119.36,117.58,118.47,113.26016183758584,NaN,NaN,NaN,NaN,NaN,106.00439999999988,125.15477144705315,86.8540285529466,116.61705959673093,119.1877009405112,119.73167467403664,118.64372720698577,12647,21145.033333333333,67.81196066392269,75.72575001551347,NaN,NaN,NaN,NaN,2.123059116871884,32.74827500145416,-2083297,-0.40432508795799205,4.10286510886047,4.5071901968184624
2025-05-22T09:30:00-04:00,119.29,121.11,118.91,121,113.26016183758584,NaN,NaN,NaN,NaN,NaN,106.58299999999988,125.76251135978472,87.40348864021504,116.61705959673093,120.33999999999999,120.33999999999999,120.33999999999999,26236,21236.4,72.8568056327021,75.28245495704482,NaN,NaN,NaN,NaN,2.1599834656667496,32.63635072506519,-2057061,-0.37509302015179635,4.038323921628717,4.413416941780513
2025-05-22T13:30:00-04:00,120.86,121.36,119.9,120.09,113.90417766509039,NaN,NaN,NaN,NaN,NaN,107.15839999999987,126.19750989936541,88.11929010063433,116.61705959673093,120.40168890302492,120.45628064760152,120.34709715844832,33501,21832.233333333334,68.68684075320697,74.53804008603707,NaN,NaN,NaN,NaN,2.109984646690553,32.60472079319982,-2090562,-0.4354182843271257,3.8691440863716053,4.304562370698731
2025-05-23T09:30:00-04:00,117.41,119.7,117.41,119.69,113.90417766509039,NaN,NaN,NaN,NaN,NaN,107.72519999999987,126.53406747893418,88.91633252106557,116.61705959673093,118.93333333333334,118.93333333333334,118.93333333333334,57287,22449.6,66.87496212328833,73.62725012541958,NaN,NaN,NaN,NaN,2.1507000290698,31.288685169737185,-2147849,-0.5151745842507456,3.6605941403852995,4.175768724636045
2025-05-23T13:30:00-04:00,119.7,119.89,118.76,118.76,113.90417766509039,NaN,NaN,NaN,NaN,NaN,108.26889999999989,126.74770096651555,89.79009903348422,116.61705959673093,118.97921388663603,119.06420812564421,118.89421964762785,16693,22723.4,62.731629757935366,72.35103761166913,NaN,NaN,NaN,NaN,2.0777928841362425,30.134532678892267,-2164542,-0.6355780986433857,3.381296101331813,4.016874199975199
2025-05-27T09:30:00-04:00,121.23,122.86,120.94,122.8,115.01111376374926,NaN,NaN,NaN,NaN,NaN,108.94909999999989,127.00881823590012,90.88938176409965,116.97235623092544,122.2,122.2,122.2,20625,22106.433333333334,71.10637126998479,71.94658679742203,NaN,NaN,NaN,NaN,2.222236249555082,30.01531225304837,-2143917,-0.4565243481911523,3.4462187647362583,3.9027431129274106
2025-05-27T13:30:00-04:00,122.61,122.82,122.09,122.82,115.77969950176066,NaN,NaN,NaN,NaN,NaN,109.61069999999987,127.22534027563759,91.99605972436214,117.74488498474035,122.37482852689011,122.5626770420444,122.18698001173583,17865,21614.733333333334,71.14094501538649,71.76341778282749,NaN,NaN,NaN,NaN,2.1156479460154327,29.90460757190761,-2126052,-0.3546693762685207,3.4594063925917595,3.81407576886028
2025-05-28T09:30:00-04:00,122.99,122.99,121.42,122.17,115.77969950176066,NaN,NaN,NaN,NaN,NaN,110.19749999999988,127.4888199322698,92.90618006772995,118.14490798779228,122.19333333333333,122.19333333333333,122.19333333333333,32780,21474.833333333332,68.281287094873,71.17426514731811,NaN,NaN,NaN,NaN,2.076673092728616,29.439493538691508,-2158832,-0.3484899805820101,3.378463293132768,3.726953273714778
2025-05-28T13:30:00-04:00,122.18,122.41,121.34,121.41,115.77969950176066,NaN,NaN,NaN,NaN,NaN,110.75889999999988,127.64240239612926,93.87539760387051,118.14490798779228,121.81771804528638,122.00930194787317,121.6261341426996,126002,24937.866666666665,64.99172969117498,70.33725905450709,NaN,NaN,NaN,NaN,2.004767871819429,28.963078040889055,-2284834,-0.40882778053115265,3.215918548050837,3.6247463285819896
2025-05-29T09:30:00-04:00,123.27,123.27,120.91,121.24,115.77969950176066,NaN,NaN,NaN,NaN,NaN,111.22329999999987,127.9563778531661,94.49022214683363,118.56114111218706,121.80666666666667,121.80666801536583,121.80666531796751,18767,25080.1,64.24613503090458,69.53622359100694,NaN,NaN,NaN,NaN,2.0301415952608983,28.82548174210368,-2303601,-0.4691100400140482,3.0383587785644295,3.5074688185784777
2025-05-29T13:30:00-04:00,121.3,121.46,120.12,120.31,115.77969950176066,NaN,NaN,NaN,NaN,NaN,111.69229999999989,128.10013803065158,95.2844619693482,118.56114111218706,121.3538741012697,121.9263815783736,120.7813666241658,11739,24678.866666666665,60.17882648943572,68.44364204094309,NaN,NaN,NaN,NaN,1.9808457670279762,28.227448199911613,-2315340,-0.5736296199839361,2.7904317935985574,3.3640614135824936
2025-05-30T09:30:00-04:00,119.85,121.12,118.25,119,115.77969950176066,NaN,NaN,NaN,NaN,NaN,112.07469999999988,128.25314225010868,95.89625774989108,118.56114111218706,119.45666666666666,119.45666666666666,119.45666666666666,31543,24950.4,54.90589511485625,66.92932289137744,NaN,NaN,NaN,NaN,2.0443567836688357,26.668113414763596,-2346883,-0.7233405006367346,2.4598857877865754,3.18322628842331
2025-05-30T13:30:00-04:00,119.01,120.84,118.96,120.59,115.77969950176066,NaN,NaN,NaN,NaN,NaN,112.47729999999989,128.48049883148684,96.47410116851295,118.56114111218706,119.71703182319011,120.04493809636774,119.38912555001248,19887,25370.833333333332,59.53979833963828,65.83077900075656,NaN,NaN,NaN,NaN,2.0326170134067767,25.22015968569758,-2326996,-0.7068084569183699,2.2997157172753475,3.0065241741937174
2025-06-02T09:30:00-04:00,120.18,121.9,119.42,121.23,115.77969950176066,NaN,NaN,NaN,NaN,NaN,112.8342999999999,128.8061655153395,96.8624344846603,118.56114111218706,120.85,120.85000190734863,120.84999809265136,26725,25126.466666666667,61.26522216806985,65.32988636752711,NaN,NaN,NaN,NaN,2.0645729410205784,24.352004258816354,-2300271,-0.6459610270952476,2.1990728903246577,2.8450339174199053
2025-06-02T13:30:00-04:00,121.23,121.8,121.07,121.73,115.77969950176066,NaN,NaN,NaN,NaN,NaN,113.2052999999999,129.12460154372678,97.28599845627302,118.56114111218706,121.4590709586995,121.6717468993084,121.2463950180906,219188,32188.066666666666,62.606857320486796,64.95809327156742,NaN,NaN,NaN,NaN,1.9692463023762516,23.545859933855212,-2081083,-0.567989491699536,2.1350470527954855,2.7030365444950215
2025-06-03T09:30:00-04:00,122.55,124.83,121.87,124.73,116.94329315079875,NaN,NaN,NaN,NaN,NaN,113.6718999999999,129.5473397595816,97.79646024041818,119.67139929571316,123.81,123.81,123.81,26557,32111.133333333335,69.4451727023563,64.71440520511415,NaN,NaN,NaN,NaN,2.05001442363509,23.983780047945697,-2054526,-0.3225335729190655,2.2998695783461898,2.6224031512652553
2025-06-03T13:30:00-04:00,124.72,124.93,123.84,124.4,118.12087073485336,NaN,NaN,NaN,NaN,NaN,114.0952999999999,129.96341978906452,98.22718021093527,120.25811943657054,124.04074010248968,124.32462082488745,123.75685938009191,17545,32472.166666666668,67.97262766161036,64.66338998428581,NaN,NaN,NaN,NaN,1.9814419648040125,24.424302488608095,-2072071,-0.19674659346217904,2.3764699094375317,2.5732165028997107
2025-06-04T09:30:00-04:00,124.52,124.7,122.8,124.43,118.12087073485336,NaN,NaN,NaN,NaN,NaN,114.51509999999989,130.3439959172806,98.68620408271919,120.25811943657054,123.97666666666667,123.97666666666667,123.97666666666667,26676,32588.766666666666,68.03897739614925,64.7465339323473,NaN,NaN,NaN,NaN,1.9756246816037262,24.180362963027726,-2045395,-0.12913696385836548,2.411795298076754,2.5409322619351196
2025-06-04T13:30:00-04:00,124.33,124.74,124.33,124.475,118.52417147535192,NaN,NaN,NaN,NaN,NaN,114.92259999999992,130.70701462202751,99.13818537797232,120.78499643940513,124.1292325256541,124.3718329091937,123.88663214211451,10550,32357.2,68.14557895107794,65.13324458900034,NaN,NaN,NaN,NaN,1.8637943472034597,23.970215446630476,-2034845,-0.10028438434372422,2.4155767815054645,2.5158611658491887
2025-06-05T09:30:00-04:00,124.52,125.79,122.33,123.59,118.52417147535192,NaN,NaN,NaN,NaN,NaN,115.3637999999999,130.85670425453216,99.87089574546764,120.89599715152411,123.90333333333334,123.90333524068197,123.9033314259847,39055,32827.23333333333,63.649312589539115,64.60059754039709,NaN,NaN,NaN,NaN,1.9778090366889276,22.605115711656197,-2073900,-0.15635833182398162,2.320413251069212,2.4767715828931935
2025-06-05T13:30:00-04:00,123.58,123.58,120.19,121.42,118.52417147535192,NaN,NaN,NaN,NaN,NaN,115.73659999999991,130.89378330561723,100.57941669438257,120.89599715152411,122.16947836682424,123.04239975446208,121.29655697918639,154082,37520.76666666667,54.205287274228034,63.390907701742904,NaN,NaN,NaN,NaN,2.0793941054968617,21.652353623037683,-2227982,-0.3443724178791179,2.046306060544296,2.390678478423414
2025-06-06T09:30:00-04:00,124.79,130.55,124.61,130.55,120.23467477772672,NaN,NaN,NaN,NaN,NaN,116.2605999999999,131.61717756663577,100.90402243336402,121.49283817697543,128.57000000000002,128.57000000000002,128.57000000000002,188566,42861.2,72.61563082815655,63.700503682691725,NaN,NaN,NaN,NaN,2.5830088122470864,21.9482518027544,-2039416,0.11669647792113835,2.536549075824837,2.4198525979036987
2025-06-06T13:30:00-04:00,130.585,131.01,129.5,129.6,123.03764410601187,NaN,NaN,NaN,NaN,NaN,116.78859999999992,132.1280316765675,101.44916832343232,123.00927054158034,128.98831534044965,129.6505399563723,128.32609072452698,75242,44864.76666666667,69.48539129139675,64.021479511279,NaN,NaN,NaN,NaN,2.5063653256580083,22.341199867180038,-2114658,0.31687999236277165,2.8159525883571632,2.4990725959943916
2025-06-09T09:30:00-04:00,131.48,131.6,129.99,130.92,123.63297846482952,NaN,NaN,NaN,NaN,NaN,117.3021999999999,132.7795747334649,101.82482526653489,124.19941643326426,130.83666666666667,130.83666666666667,130.83666666666667,53076,45263.933333333334,71.33441818625364,64.52778545094678,NaN,NaN,NaN,NaN,2.4701963738252934,22.860917518698635,-2061582,0.4871955166092219,3.108066991755919,2.6208714751466973
2025-06-09T13:30:00-04:00,130.93,131.5,130.76,131.3,124.19261580733725,NaN,NaN,NaN,NaN,NaN,117.8329999999999,133.37367772010282,102.29232227989696,125.20953314661142,130.9611349067599,131.12868054604834,130.79358926747145,29292,45895.2,71.86299443935586,65.36236887594109,NaN,NaN,NaN,NaN,2.346610918552059,23.343512480823048,-2032290,0.5687631209059214,3.331825376279099,2.7630622553731774
2025-06-10T09:30:00-04:00,131.93,132.11,129.3,130.85,124.19261580733725,NaN,NaN,NaN,NaN,NaN,118.3655999999999,133.8287269334536,102.90247306654621,125.67262651728915,130.75333333333333,130.75333333333333,130.75333333333333,34954,46188.96666666667,70.21190260556367,66.45565512527732,NaN,NaN,NaN,NaN,2.3797101386554833,23.060432383882443,-2067244,0.5361643525395672,3.4332676960476363,2.897103343508069
2025-06-10T13:30:00-04:00,130.74,131.85,130.37,131.49,124.22137101453664,NaN,NaN,NaN,NaN,NaN,118.9237999999999,134.22585274595883,103.62174725404098,125.96010121383131,130.8951994232894,131.1152962716733,130.6751025749055,14522,46412.13333333333,71.22450931641436,67.29027733790419,NaN,NaN,NaN,NaN,2.3154451287515196,22.797572293866168,-2052722,0.5020564214098004,3.5246738702703198,3.0226174488605193
2025-06-11T09:30:00-04:00,132.29,133.66,132.07,133.42,125.9935814229668,NaN,NaN,NaN,NaN,NaN,119.5635999999999,134.55839857017463,104.56880142982517,127.86308097106505,133.04999999999998,133.04999999999998,133.04999999999998,40114,47051.63333333333,74.08541958221697,68.20600572462898,NaN,NaN,NaN,NaN,2.305056190983553,23.14070761907493,-2012608,0.5499710685925803,3.7100812846012445,3.1601102160086643
2025-06-11T13:30:00-04:00,133.39,133.42,131.39,132.34,125.9935814229668,NaN,NaN,NaN,NaN,NaN,120.16979999999988,134.72448350188802,105.61511649811176,127.86308097106505,132.8340093923614,133.14600586002982,132.52201292469297,19225,47431.86666666667,69.89753696402506,68.72676855631029,NaN,NaN,NaN,NaN,2.2854093201990135,23.098195877008585,-2031833,0.45343945043553946,3.7269095290530885,3.273470078617549
2025-06-12T09:30:00-04:00,131.45,131.91,130.82,130.82,125.9935814229668,NaN,NaN,NaN,NaN,NaN,120.7401999999999,134.67092675204356,106.80947324795623,127.86308097106505,131.18333333333334,131.18333333333334,131.18333333333334,10427,47045.6,64.38149772481319,68.36507748648577,NaN,NaN,NaN,NaN,2.2307372258990847,22.75644554722289,-2042260,0.24231880617873047,3.576368586340962,3.3340497801622315
2025-06-12T13:30:00-04:00,131,131.1,129.62,129.79,125.9935814229668,NaN,NaN,NaN,NaN,NaN,121.28459999999988,134.43827170641435,108.13092829358541,127.86308097106505,130.49356535497373,130.96598997410837,130.02114073583908,22228,47364.96666666667,60.87569306994227,67.85815358708092,NaN,NaN,NaN,NaN,2.1771131383348634,21.82549356025633,-2064488,0.0011616350485272875,3.3355018239728906,3.3343401889243633
2025-06-13T09:30:00-04:00,127.5,130.92,127.495,130.475,125.9935814229668,NaN,NaN,NaN,NaN,NaN,121.76089999999988,134.47932736977052,109.04247263022926,127.86308097106505,129.63,129.63,129.63,49294,48133.566666666666,62.34426686797313,67.45138854935405,NaN,NaN,NaN,NaN,2.266247914168086,20.525253712720822,-2015194,-0.13673534597168535,3.1634210064597568,3.300156352431442
2025-06-13T13:30:00-04:00,130.5,131.02,129.18,130.1,125.9935814229668,NaN,NaN,NaN,NaN,NaN,122.24269999999987,134.348312286875,110.13708771312476,127.86308097106505,129.79872719470487,130.02418875525828,129.57326563415145,27607,47937.1,60.994480510152066,66.94059580357363,NaN,NaN,NaN,NaN,2.2358016345846514,19.272545143828516,-2042801,-0.2700171288387754,2.962634941382973,3.2326520702217483
2025-06-16T09:30:00-04:00,133.21,136.57,132.94,136.14,127.44281429265033,NaN,NaN,NaN,NaN,NaN,122.83329999999987,134.70978544141514,110.95681455858461,128.96060125807887,135.21666666666667,135.21666666666667,135.21666666666667,39625,47348.36666666667,71.64353333595835,67.51161157117501,NaN,NaN,NaN,NaN,2.538244374971462,19.654157415113264,-2003176,0.016586393426642587,3.2533850620050515,3.236798668578409
2025-06-16T13:30:00-04:00,136.25,136.25,135.45,135.98,128.7610954611662,NaN,NaN,NaN,NaN,NaN,123.41909999999987,134.93676585555139,111.90143414444834,129.7624810064631,135.4538493689559,135.7767084625008,135.130990275411,21385,47504.76666666667,71.08985153395821,68.71765187544143,NaN,NaN,NaN,NaN,2.4140840624735014,20.008511667020535,-2024561,0.15563434077676552,3.431341594549366,3.2757072537726004
2025-06-17T09:30:00-04:00,135.82,136.2,133.93,134,128.7610954611662,NaN,NaN,NaN,NaN,NaN,123.84969999999987,135.30748223043804,112.3919177695617,129.87498480517047,134.71,134.71,134.71,28011,47750.96666666667,64.45169502386602,68.1345136037064,NaN,NaN,NaN,NaN,2.4037923437253927,19.63925073758263,-2052572,0.07840531893818481,3.3737139024453313,3.2953085835071465
2025-06-17T13:30:00-04:00,133.95,134.5,133.24,134.1,128.7610954611662,NaN,NaN,NaN,NaN,NaN,124.28689999999987,135.60674450247154,112.96705549752821,129.87498480517047,134.38167907714845,134.75959927515123,134.00375887914566,21141,47860.166666666664,64.63132473322328,67.78779456383687,NaN,NaN,NaN,NaN,2.32209289060215,18.993389607892837,-2031431,0.0022285948921227927,3.2980943271222998,3.295865732230177
2025-06-18T09:30:00-04:00,134.54,138.03,134,137.21,128.85389228642563,NaN,NaN,NaN,NaN,NaN,124.67389999999986,136.40402877849803,112.94377122150168,131.46299027530912,136.41333333333333,136.41333333333333,136.41333333333333,35120,47938.166666666664,69.75072727442206,67.67467378442034,NaN,NaN,NaN,NaN,2.444086255559139,19.473442766625574,-1996311,0.12279082913916506,3.449354268654133,3.326563439514968
2025-06-18T13:30:00-04:00,137.23,139.57,136.86,139.22,131.00985172795177,NaN,NaN,NaN,NaN,NaN,125.10009999999986,137.35311717782787,112.84708282217184,132.9613922202473,137.75478431040085,138.78761675750437,136.72195186329733,59244,45712.9,72.51925768087939,67.72154973024344,NaN,NaN,NaN,NaN,2.4630800944477707,20.30970795561568,-1937067,0.2898658641013885,3.6888957696417037,3.3990299055403153
2025-06-20T09:30:00-04:00,142.32,142.57,139.57,141.01,133.73554028577215,NaN,NaN,NaN,NaN,NaN,125.55129999999984,138.43672553585898,112.6658744641407,135.60811377619783,141.04999999999998,141.04999999999998,141.04999999999998,82021,47821.36666666667,74.73676461084851,68.04475415919235,NaN,NaN,NaN,NaN,2.5264315162729294,21.743678480850832,-1855046,0.4626353230600686,3.977324059365401,3.5146887363053323
2025-06-20T13:30:00-04:00,140.99,141.86,140.21,141.46,133.80892481823707,NaN,NaN,NaN,NaN,NaN,125.99119999999986,139.5020711132977,112.48032888670203,135.60811377619783,141.09785516151464,141.15926800466403,141.03644231836526,49804,49090.2,75.27687685672284,68.3342089835001,NaN,NaN,NaN,NaN,2.463829265110578,23.075222539997764,-1805242,0.5433469671353452,4.193872445224514,3.6505254780891687
2025-06-23T09:30:00-04:00,140.92,145.52,139.15,143.38,134.5687464174081,NaN,NaN,NaN,NaN,NaN,126.48919999999985,140.67467854110518,112.30372145889451,137.21939281676663,142.68333333333334,142.68333333333334,142.68333333333334,128113,52309.2,77.48832270049937,68.57727349194884,NaN,NaN,NaN,NaN,2.7428414604598226,24.98923874996157,-1677129,0.6547010867119378,4.468901836479091,3.8142007497671533
2025-06-23T13:30:00-04:00,143.51,144.17,142.87,143.74,135.9294852166168,NaN,NaN,NaN,NaN,NaN,127.01039999999986,141.7664242396163,112.25437576038341,137.21939281676663,143.00390601142627,143.43859474503327,142.56921727781926,69677,53968.86666666667,77.88770855742992,69.14800003433491,NaN,NaN,NaN,NaN,2.639781356141263,26.76653951635653,-1607452,0.6783761975726175,4.662170996732925,3.9837947991603078
2025-06-24T09:30:00-04:00,145.5,147.72,144.16,146.38,138.15178134313422,NaN,NaN,NaN,NaN,NaN,127.53959999999987,143.11562809961953,111.9635719003802,139.89761140273063,146.08666666666667,146.08666666666667,146.08666666666667,41947,54476.26666666667,80.60513445292588,70.30683122920011,NaN,NaN,NaN,NaN,2.735511259274029,28.960511777207998,-1565505,0.7898128328908562,4.9710608402738785,4.181248007383022
2025-06-24T13:30:00-04:00,146.33,147.17,146.13,146.675,139.07397310026448,NaN,NaN,NaN,NaN,NaN,128.07169999999988,144.39069563208832,111.75270436791143,140.3920891221845,146.24220690313402,146.49661681517793,145.9877969910901,15679,47692.63333333333,80.88777725543503,71.73626581387816,NaN,NaN,NaN,NaN,2.6144033121830264,30.99777173371293,-1549826,0.7989624340908303,5.179951049996561,4.38098861590573
2025-06-25T09:30:00-04:00,148.31,149.03,144.905,145.58,139.17333795934337,NaN,NaN,NaN,NaN,NaN,128.58789999999988,145.44772076892048,111.72807923107926,141.54517129774763,146.505,146.505,146.505,28572,47759.8,76.43510421562027,72.74275419585297,NaN,NaN,NaN,NaN,2.7223030755985245,33.14602791333415,-1578398,0.6529933170134132,5.197230262172496,4.544236945159083
2025-06-25T13:30:00-04:00,145.3,145.52,145,145.21,139.17333795934337,NaN,NaN,NaN,NaN,NaN,129.09649999999988,146.3914723619358,111.80152763806396,141.54517129774763,146.1520386522141,146.7183758786944,145.5857014257338,11098,47544.9,74.9340736507854,73.73843942018392,NaN,NaN,NaN,NaN,2.5692814273414877,35.14083722298243,-1589496,0.46223023719975487,5.122024741658777,4.659794504459022
2025-06-26T09:30:00-04:00,146.06,148.31,145.875,148.11,139.49257136378188,NaN,NaN,NaN,NaN,NaN,129.65469999999988,147.55606747961212,111.75333252038762,141.73770963055847,147.43166666666667,147.43166666666667,147.43166666666667,16258,47197.63333333333,78.49819547534602,74.22805814442589,NaN,NaN,NaN,NaN,2.6071898968170957,37.3493727774873,-1573238,0.461021529684837,5.236071416565068,4.775049886880231
2025-06-26T13:30:00-04:00,148.09,148.495,147.79,147.98,140.79188630179178,NaN,NaN,NaN,NaN,NaN,130.21509999999986,148.6148042900187,111.81539570998103,142.88466770444677,147.73036368919887,148.05735675771544,147.4033706206823,13566,47298.166666666664,77.96303068571456,74.71899951240849,NaN,NaN,NaN,NaN,2.47131918990159,39.42213272696936,-1586804,0.3842669102047651,5.255383524636187,4.871116614431422
2025-06-27T09:30:00-04:00,148.55,148.55,145.81,146.6,140.79188630179178,NaN,NaN,NaN,NaN,NaN,130.77569999999986,149.42832866300995,112.12307133698975,142.88466770444677,146.98666666666668,146.98666666666668,146.98666666666668,19671,46652.03333333333,72.32609242502488,75.28145646963412,NaN,NaN,NaN,NaN,2.490510676337191,40.22263058376515,-1606475,0.18353727886697602,5.100538213015142,4.917000934148166
2025-06-27T13:30:00-04:00,146.53,146.53,144.16,145.5,140.79188630179178,NaN,NaN,NaN,NaN,NaN,131.31629999999984,150.0774711585434,112.55512884145628,142.88466770444677,146.21756086891858,147.01213905279212,145.42298268504504,18430,42130.3,68.09944135463145,75.52917908544899,NaN,NaN,NaN,NaN,2.4869027708845346,40.123974734709336,-1624905,-0.06692428185878274,4.8333455818246875,4.90026986368347
2025-06-30T09:30:00-04:00,147.05,147.92,146.5,147.5,140.79188630179178,NaN,NaN,NaN,NaN,NaN,131.84629999999984,150.90664709128242,112.78595290871726,142.88466770444677,147.30666666666664,147.30666666666664,147.30666666666664,34377,36990.666666666664,71.3748883603736,75.64519059158839,NaN,NaN,NaN,NaN,2.4821240015356385,40.3219502409419,-1590528,-0.13743995176549273,4.728469923976604,4.865909875742097
2025-06-30T13:30:00-04:00,147.53,147.82,147.04,147.57,140.79188630179178,NaN,NaN,NaN,NaN,NaN,132.39589999999984,151.65234107201942,113.13945892798026,142.88466770444677,147.3811859210003,147.46553729307283,147.2968345489278,26830,35376.933333333334,71.48524403641375,75.57133247412655,NaN,NaN,NaN,NaN,2.3605437157116644,40.50578463958643,-1563698,-0.21432731321668186,4.598000734221245,4.812328047437926
2025-07-01T09:30:00-04:00,146.345,147.42,143.08,144.84,140.79188630179178,NaN,NaN,NaN,NaN,NaN,132.89889999999986,152.11534465451814,113.68245534548159,142.88466770444677,145.11333333333334,145.11333333333334,145.11333333333334,30355,34619.566666666666,61.523451981542834,74.62752442917615,NaN,NaN,NaN,NaN,2.5126477360179726,38.84259570592521,-1594053,-0.46937872833881045,4.225604637014413,4.694983365353224
2025-07-01T13:30:00-04:00,144.81,145.09,143.75,144.4,140.79188630179178,NaN,NaN,NaN,NaN,NaN,133.41169999999983,152.45925192774584,114.36414807225381,142.88466770444677,144.88142382987473,145.21090013345685,144.55194752629262,15039,34144.46666666667,60.07048116545282,73.54135330837116,NaN,NaN,NaN,NaN,2.4288871834452608,37.29820598181123,-1609092,-0.6755174448475483,3.850586559293788,4.526104004141336
2025-07-02T09:30:00-04:00,144.56,147.2,144.29,146.61,140.79188630179178,NaN,NaN,NaN,NaN,NaN,133.88789999999983,153.04068372352643,114.73511627647324,142.88466770444677,146.03333333333333,146.03333333333333,146.03333333333333,30876,34008.53333333333,64.59345455184531,72.620291297753,NaN,NaN,NaN,NaN,2.4632523846277414,36.455017914943156,-1578216,-0.6695360472976564,3.6891839450192663,4.358719992316923
2025-07-02T13:30:00-04:00,146.43,146.71,146.13,146.37,140.79188630179178,NaN,NaN,NaN,NaN,NaN,134.35889999999984,153.55801750993174,115.15978249006791,142.88466770444677,146.16927088455444,146.34764654467278,145.9908952244361,17932,34122.2,63.7489410796467,71.6103793350542,NaN,NaN,NaN,NaN,2.328734357154332,35.67205756713708,-1596148,-0.6857426947168861,3.501541623920815,4.187284318637701
2025-07-03T09:30:00-04:00,147.17,148.2,146.82,148.19,140.79188630179178,NaN,NaN,NaN,NaN,NaN,134.87929999999983,154.13913520283015,115.61946479716951,143.17551210276582,147.73666666666665,147.73666666666665,147.73666666666665,38016,34052.26666666667,67.24617676177506,70.65616807140057,NaN,NaN,NaN,NaN,2.2931104745004505,35.347636211889544,-1558132,-0.5819794658538795,3.4598099863203515,4.041789452174231
2025-07-07T09:30:00-04:00,147.07,148.22,145.75,147.66,140.79188630179178,NaN,NaN,NaN,NaN,NaN,135.40429999999984,154.59785860803737,116.2107413919623,143.17551210276582,147.21,147.21,147.21,40597,34764.666666666664,65.27140755342637,69.54071309268566,NaN,NaN,NaN,NaN,2.3057454406075615,34.52867900023384,-1598729,-0.5571059437039727,3.345407022544265,3.9025129662482376
2025-07-07T13:30:00-04:00,147.8,148.5,146.85,148.5,140.79188630179178,NaN,NaN,NaN,NaN,NaN,135.94949999999983,155.05115744117964,116.84784255882003,143.47132774577014,147.46667905465193,147.81889825252168,147.1144598567822,21560,35135.76666666667,66.9290233235453,68.86170731468032,NaN,NaN,NaN,NaN,2.2589064805641645,33.85160898479354,-1577169,-0.4942829159400497,3.2846593213231756,3.7789422372632253
2025-07-08T09:30:00-04:00,148.68,149.69,146.825,147.83,141.23816605760993,NaN,NaN,NaN,NaN,NaN,136.49989999999983,155.35157743093907,117.64822256906056,144.23456219661608,148.115,148.115,148.115,31656,35450.03333333333,64.29305054729178,68.10163423585935,NaN,NaN,NaN,NaN,2.3021988748095823,33.574066513221446,-1608825,-0.5062052618029513,3.146185660009536,3.6523909218124873
2025-07-08T13:30:00-04:00,147.83,148.3,147.19,147.78,141.23816605760993,NaN,NaN,NaN,NaN,NaN,137.07549999999983,155.50753767900258,118.64346232099709,144.23456219661608,147.97163814505276,148.14719072950308,147.79608556060245,21111,34510.6,64.09018986757332,67.0724909781613,NaN,NaN,NaN,NaN,2.2170418123231843,33.31634850390449,-1629936,-0.5236308749723699,2.997852328097025,3.521483203069395
2025-07-09T09:30:00-04:00,148.6,149.16,147.57,148.86,141.60798291612807,NaN,NaN,NaN,NaN,NaN,137.64089999999985,155.74696314912651,119.53483685087318,144.4295198058343,148.53,148.53,148.53,19227,34231.26666666667,66.54560779552091,66.2569607717189,NaN,NaN,NaN,NaN,2.172253111442957,33.33772913336882,-1610709,-0.4702849292390403,2.9336270415205945,3.403911970759635
2025-07-09T13:30:00-04:00,148.76,150.06,148.7,149.99,142.7446655108495,NaN,NaN,NaN,NaN,NaN,138.21609999999984,156.0251065180559,120.40709348194378,145.59561584466744,149.10742121959817,149.631636588638,148.58320585055833,23328,33688.03333333333,68.93876078594131,66.01500851178436,NaN,NaN,NaN,NaN,2.1142350320541756,33.62062404764094,-1587381,-0.37111446641025436,2.9400188877468167,3.311133354157071
2025-07-10T09:30:00-04:00,150.96,151.28,148.42,150.6,143.12627162399272,NaN,NaN,NaN,NaN,NaN,138.79349999999985,156.29643429685873,121.29056570314097,146.27849267573393,150.1,150.10000190734863,150.09999809265136,29324,33952.666666666664,70.17891812906511,66.16354256710105,NaN,NaN,NaN,NaN,2.167503958336021,34.21883482217659,-1558057,-0.2807601038148899,2.9601832243884587,3.2409433282033486
2025-07-10T13:30:00-04:00,150.74,151,150.31,150.72,144.14280473199304,NaN,NaN,NaN,NaN,NaN,139.31329999999983,156.65771381079753,121.96888618920212,146.65379414058714,150.31927105569056,150.59921125094695,150.03933086043418,17991,33618.666666666664,70.42904448913448,66.09598229058396,NaN,NaN,NaN,NaN,2.0619679613120194,34.77431625567399,-1540066,-0.23129877324245607,2.9518198616502787,3.1831186348927347
2025-07-11T09:30:00-04:00,150.68,151.43,149.5,150.6,144.14280473199304,NaN,NaN,NaN,NaN,NaN,139.83729999999986,156.9290826115406,122.74551738845912,146.98803531246972,150.51,150.51,150.51,18302,33524.03333333333,69.7985703479871,65.97550559855348,NaN,NaN,NaN,NaN,2.0525416783611616,34.7369548771889,-1558368,-0.22485031021699253,2.9020557471214943,3.126906057338487
2025-07-11T13:30:00-04:00,150.51,150.51,148.71,149.33,144.14280473199304,NaN,NaN,NaN,NaN,NaN,140.33529999999985,157.0492203552055,123.62137964479419,146.98803531246972,150.04829185796027,150.54372669659287,149.55285701932766,15895,32883.2,63.33643222705558,66.10500418751869,NaN,NaN,NaN,NaN,2.0409315584782206,34.182704585589455,-1574263,-0.3185773524103972,2.7286843668254903,3.0472617192358875
2025-07-14T09:30:00-04:00,150.23,152.8,150.12,152.58,144.83708392402212,NaN,NaN,NaN,NaN,NaN,140.89739999999986,157.3279201670593,124.46687983294044,147.46614259998063,151.83333333333334,151.83333524068198,151.8333314259847,55039,32743.033333333333,70.78947201154006,66.87064639081063,NaN,NaN,NaN,NaN,2.143007875729776,34.42261493540139,-1519224,-0.18099719144102844,2.821015229934602,3.0020124213756305
2025-07-14T13:30:00-04:00,152.58,152.82,152.1,152.625,146.03994374565747,NaN,NaN,NaN,NaN,NaN,141.47809999999984,157.46723329609094,125.48896670390873,148.1929140799845,151.9934205684999,152.28238113519947,151.7044600018003,16893,30572.1,70.87774697007748,67.31952442068436,NaN,NaN,NaN,NaN,2.0413644560347923,34.65145094265421,-1502331,-0.10977341939723617,2.8647956471290854,2.9745690665263216
2025-07-15T09:30:00-04:00,153.34,154,152.23,153.13,146.74540084812762,NaN,NaN,NaN,NaN,NaN,142.11229999999986,157.36742034826773,126.85717965173198,149.4133312639876,153.12,153.12,153.12,27003,29812.066666666666,71.90388990409872,67.90202076528807,NaN,NaN,NaN,NaN,2.0219812806037365,35.218024866294286,-1475328,-0.054267893033551395,2.906734200234382,2.9610020932679335
2025-07-15T13:30:00-04:00,153.34,153.5,151.25,151.995,146.74540084812762,NaN,NaN,NaN,NaN,NaN,142.5411999999999,157.677294418314,127.40510558168577,149.4133312639876,152.82992546102972,153.24066268640226,152.41918823565717,13468,25990.566666666666,66.25347046842307,67.83111317290579,NaN,NaN,NaN,NaN,2.038268331989184,35.068234121056044,-1488796,-0.11606123111508637,2.8159255543740755,2.931986785489162
2025-07-16T09:30:00-04:00,153.35,156.65,153.1,156.64,148.14365035955427,NaN,NaN,NaN,NaN,NaN,143.08199999999988,158.26210592848747,127.90189407151229,150.48703200895207,155.46333333333334,155.46333333333334,155.46333333333334,66615,25888.5,74.93461847961858,68.52134252477666,NaN,NaN,NaN,NaN,2.2251777368470997,35.82154666248946,-1422181,0.12099470780517274,3.0832301702456277,2.962235462440455
2025-07-16T13:30:00-04:00,156.6,157.8,156.3,157.2,150.42007534321093,NaN,NaN,NaN,NaN,NaN,143.60759999999988,158.88643794534525,128.3287620546545,152.11962560716165,156.17254070469744,156.98356534603772,155.36151606335716,50939,26188.233333333334,75.74472339562118,69.1510353870678,NaN,NaN,NaN,NaN,2.1733793270723067,36.78684518771412,-1371242,0.27196579173402613,3.3021927021079875,3.0302269103739614
2025-07-17T09:30:00-04:00,157.44,159.32,156.41,158.51,151.13961737306497,NaN,NaN,NaN,NaN,NaN,144.15179999999987,159.5760223479873,128.72757765201243,153.3207004857293,158.08,158.08,158.08,44673,27154.7,77.57091544793319,70.09945430854218,NaN,NaN,NaN,NaN,2.2259950894242846,38.00436279624637,-1326569,0.4083097854185045,3.540614142147092,3.1323043567285875
2025-07-17T13:30:00-04:00,158.54,159.8,158.375,158.92,152.473498401562,NaN,NaN,NaN,NaN,NaN,144.71319999999986,160.20316136341683,129.2232386365829,154.28806038858346,158.47661992732336,158.94581348804982,158.0074263665969,31922,27266.366666666665,78.12600813696521,71.10201275635589,NaN,NaN,NaN,NaN,2.168781154465408,39.231528961275906,-1294647,0.4699719068354584,3.7197692402729103,3.249797333437452
2025-07-18T09:30:00-04:00,160,162.88,159,159.82,154.08663483785463,NaN,NaN,NaN,NaN,NaN,145.27979999999988,160.86581141537235,129.6937885846274,156.49044831086675,160.56666666666666,160.56666666666666,160.56666666666666,51133,28600.866666666665,79.33502452992953,72.01554252309936,NaN,NaN,NaN,NaN,2.2967253577178792,40.90999609685464,-1243514,0.5117919414763641,3.889537260282907,3.377745318806543
2025-07-18T13:30:00-04:00,159.74,160.18,158.97,160.18,154.08663483785463,NaN,NaN,NaN,NaN,NaN,145.81499999999988,161.57212169148013,130.05787830851963,156.49044831086675,160.39419609461788,160.72054813412424,160.06784405511152,14281,28534.966666666667,79.81560331023081,72.7924598462629,NaN,NaN,NaN,NaN,2.2191021178808885,42.44808076926319,-1229233,0.5033550493898957,4.006939130543913,3.503584081154017
2025-07-21T09:30:00-04:00,161.65,162.5,160.28,161.56,154.6716445526733,NaN,NaN,NaN,NaN,NaN,146.39939999999987,162.28106057313062,130.51773942686913,156.76668691895472,161.44666666666666,161.44666666666666,161.44666666666666,40755,29441.266666666666,81.58365295800822,73.60708376261597,NaN,NaN,NaN,NaN,2.2263091094608245,44.21974887446574,-1188478,0.5278071342118777,4.163342998918864,3.6355358647069864
2025-07-21T13:30:00-04:00,161.41,161.475,159.24,159.25,154.6716445526733,NaN,NaN,NaN,NaN,NaN,146.96799999999988,162.6117698781369,131.32423012186285,156.76668691895472,161.0205385261086,161.68375167395155,160.35732537826564,16825,29346.4,70.4579764951744,73.60915033447597,NaN,NaN,NaN,NaN,2.233001315927908,45.169484299846786,-1205303,0.33490141519270766,4.054162633697871,3.7192612185051632
2025-07-22T09:30:00-04:00,159.29,159.48,154.63,157.3,NaN,NaN,NaN,164.13982386832865,164.13982386832865,164.13982386832865,147.5181999999999,162.6327618209758,132.403638179024,156.76668691895472,157.13666666666668,157.13666666666668,157.13666666666668,46076,30267.933333333334,62.686482828016025,73.10114408304946,NaN,NaN,NaN,NaN,2.4199297933616286,43.604870773420004,-1251379,0.038083523104470274,3.766865622385751,3.728782099281281
2025-07-22T13:30:00-04:00,157.3,157.77,156.86,157.01,NaN,NaN,NaN,164.13982386832865,NaN,NaN,148.0488999999999,162.58483124502547,133.5129687549743,156.76668691895472,157.15822079380928,157.19268675803065,157.1237548295879,18020,29722.7,61.5983264447846,72.97699367003011,NaN,NaN,NaN,NaN,2.3120776652643693,42.1520153560237,-1269399,-0.20245429969394735,3.4757142246638466,3.678168524357794
2025-07-23T09:30:00-04:00,157.95,157.95,155.65,155.91,NaN,NaN,NaN,163.68747381391103,NaN,NaN,148.5650999999999,162.32730033134678,134.802899668653,156.76668691895472,156.50333333333333,156.50333333333333,156.50333333333333,26998,29728.3,57.519704711528554,72.02915314860071,NaN,NaN,NaN,NaN,2.3112149748883417,40.25632200960631,-1296397,-0.4463383486376129,3.1202455885607776,3.5665839371983905
2025-07-23T13:30:00-04:00,155.92,157.68,155.92,157.68,NaN,NaN,NaN,163.61577045873324,NaN,NaN,148.9958999999999,162.52186269254412,135.46993730745567,156.76668691895472,156.70186565085606,156.9806469024465,156.42308439926563,13692,29172.866666666665,61.89214858873459,71.3873246927905,NaN,NaN,NaN,NaN,2.272556762396318,38.49603533079014,-1282705,-0.49536095191882845,2.947382747299855,3.4427436992186835
2025-07-24T09:30:00-04:00,157.16,157.3,155.3,156.51,NaN,NaN,NaN,163.13050816515445,NaN,NaN,149.40649999999988,162.5686100512083,136.24438994879145,156.76668691895472,156.37,156.37,156.37,18742,29296.3,57.66682443614589,70.37039144507959,NaN,NaN,NaN,NaN,2.2802312793680093,36.56765986962785,-1301447,-0.6061732340956514,2.6850271565991193,3.2912003906947707
2025-07-24T13:30:00-04:00,156.6,157,155.91,155.91,NaN,NaN,NaN,163.12366688492014,NaN,NaN,149.84469999999988,162.36939103970715,137.3200089602926,156.76668691895472,156.32827909703897,156.37615797420054,156.2804002198774,14231,28741.466666666667,55.57161443472415,69.6074017283868,NaN,NaN,NaN,NaN,2.195214759413152,34.7770255128343,-1315678,-0.7121474672060928,2.401016056687155,3.1131635238932476
2025-07-25T09:30:00-04:00,156.17,158.32,155.9,157.87,NaN,NaN,NaN,163.12366688492014,NaN,NaN,150.32009999999988,162.20642213765586,138.4337778623439,156.76668691895472,157.36333333333334,157.36333333333334,157.36333333333334,12475,28559.566666666666,60.60676717307035,68.58398377791907,NaN,NaN,NaN,NaN,2.2112708480264973,33.62481357335451,-1303203,-0.6445376129729188,2.307491507677099,2.952029120650018
2025-07-25T13:30:00-04:00,157.85,157.95,157.36,157.45,NaN,NaN,NaN,163.12366688492014,NaN,NaN,150.72489999999988,162.16806660545183,139.28173339454793,156.76668691895472,157.44005385114633,157.54611143511877,157.3339962671739,6528,27509.966666666667,59.06208618114101,67.39236683402763,NaN,NaN,NaN,NaN,2.095465787453174,32.554902486694694,-1309731,-0.6220898442438232,2.1744168153452392,2.7965066595890624
2025-07-28T09:30:00-04:00,159.09,159.3,157.75,158.39,NaN,NaN,NaN,163.12366688492014,NaN,NaN,151.1082999999999,162.2648838158504,139.9517161841494,155.72834953516377,158.48,158.48,158.48,27179,27062.7,61.43135999882667,66.23954144480574,NaN,NaN,NaN,NaN,2.0779325169208063,32.06939043519553,-1282552,-0.540915653520738,2.12036209268814,2.661277746208878
2025-07-28T13:30:00-04:00,158.62,158.72,158,158.46,NaN,NaN,NaN,163.12366688492014,NaN,NaN,151.4572999999999,162.41849997263557,140.4961000273642,154.73310332699955,158.45876789451265,158.49604139055728,158.421494398468,8819,26638,61.60954358397969,65.05979397673535,NaN,NaN,NaN,NaN,1.9809373371407486,31.618557815946303,-1273733,-0.48147667575436515,2.0594319015159215,2.5409085772702866
2025-07-29T09:30:00-04:00,158.755,159,154.88,156.46,NaN,NaN,NaN,163.12366688492014,NaN,NaN,151.7572999999999,162.42474509430926,141.08985490569054,154.73310332699955,156.78,156.78,156.78,35540,26767.466666666667,53.94167849703354,63.245983545814205,NaN,NaN,NaN,NaN,2.1337275273449814,29.494758933757687,-1309273,-0.5697819791868026,1.8286811032867831,2.3984630824735858
2025-07-29T13:30:00-04:00,156.46,156.77,155.48,155.73,NaN,NaN,NaN,162.51887694878235,NaN,NaN,152.0042999999999,162.45411358877382,141.55448641122595,154.73310332699955,156.60878523051636,156.93339954737533,156.2841709136574,9887,26393.333333333332,51.42582533528977,61.218142261889845,NaN,NaN,NaN,NaN,2.07346127539177,27.5226599717254,-1319160,-0.6637143444347111,1.568820151930197,2.232534496364908
2025-07-30T09:30:00-04:00,156.01,158.34,156,158.16,NaN,NaN,NaN,162.51887694878235,NaN,NaN,152.29269999999988,162.60935763898976,141.97604236101,154.73310332699955,157.5,157.5,157.5,19554,26404.233333333334,58.38391680385066,59.56101825087859,NaN,NaN,NaN,NaN,2.1117854700066445,26.39038370808825,-1299606,-0.5530729963016956,1.5411932509877886,2.094266247289484
2025-07-30T13:30:00-04:00,158.24,158.66,155.92,157.77,NaN,NaN,NaN,162.51887694878235,NaN,NaN,152.5204999999999,162.8078279815544,142.23317201844543,154.73310332699955,157.46752401778036,157.4913800376679,157.44366799789282,36238,26834.566666666666,56.973331560861105,58.59782932699907,NaN,NaN,NaN,NaN,2.156657936434742,25.47414553152348,-1335844,-0.4987140569002819,1.470873676164132,1.9695877330644138
2025-07-31T09:30:00-04:00,161.1,161.44,158.69,158.78,NaN,NaN,NaN,162.51887694878235,NaN,NaN,152.7625999999999,163.05801572546147,142.46718427453834,155.18463463855295,159.63666666666666,159.63666666666666,159.63666666666666,48839,27485.066666666666,59.68955300199923,58.38376291085501,NaN,NaN,NaN,NaN,2.2647537981179737,25.654192511086215,-1287005,-0.3920000267878425,1.4795876995796107,1.8715877263674532
2025-07-31T13:30:00-04:00,158.68,159.49,157.5,158.6,NaN,NaN,NaN,162.51887694878235,NaN,NaN,153.0229999999999,163.23687252711144,142.80912747288838,155.18463463855295,159.0243293974897,159.5745078352151,158.47415095976433,60498,28901.966666666667,58.9750052518601,58.19638282564612,NaN,NaN,NaN,NaN,2.2451285268238332,25.167995296079404,-1347503,-0.3331145384879748,1.4551945532574848,1.7883090917454596
2025-08-01T09:30:00-04:00,151.71,153,148.28,150.63,NaN,NaN,NaN,158.44969783453666,NaN,NaN,153.1313999999999,163.12394062589078,143.13885937410902,155.18463463855295,150.63666666666666,150.63666666666666,150.63666666666666,159733,33616.333333333336,37.54395515033858,56.769543571275406,NaN,NaN,NaN,NaN,2.82190506062213,25.195187534085843,-1507236,-0.8036742939279395,0.7837162243355351,1.5873905182634747
2025-08-01T13:30:00-04:00,150.86,150.93,149.45,150.16,NaN,NaN,NaN,157.84652975114864,NaN,NaN,153.1723999999999,163.0987953658966,143.2460046341032,155.18463463855295,150.5141490456558,150.71648328926332,150.3118148020483,58567,35038.73333333333,36.69705750438539,54.96989420810761,NaN,NaN,NaN,NaN,2.7260546991491217,25.220437469377536,-1565803,-1.1009483362269967,0.21120509797972886,1.3121534342067256
2025-08-04T09:30:00-04:00,152.2,154.86,151.48,154.77,NaN,NaN,NaN,157.84652975114864,NaN,NaN,153.3081999999999,163.13199066552605,143.48440933447378,155.18463463855295,153.70333333333335,153.70333333333335,153.70333333333335,38134,34475.23333333333,48.878126779698974,54.342130089789976,NaN,NaN,NaN,NaN,2.867050792067043,23.845988924677457,-1527669,-0.9473236379611119,0.12799888675533566,1.0753225247164475
2025-08-04T13:30:00-04:00,154.8,154.9,154.37,154.74,NaN,NaN,NaN,157.84652975114864,NaN,NaN,153.4709999999999,163.11282845730548,143.8291715426943,155.18463463855295,154.17642208386334,154.65964683450738,153.6931973332193,36551,35130.5,48.81230103075809,53.85932198950668,NaN,NaN,NaN,NaN,2.700118592633683,22.55680339739494,-1564220,-0.8130924229244041,0.0589569960609424,0.8720494189853465
2025-08-05T09:30:00-04:00,154.08,155.1,152.18,153.47,NaN,NaN,NaN,157.84652975114864,NaN,NaN,153.6303999999999,162.99951283740873,144.26128716259106,155.18463463855295,153.58333333333334,153.58333333333334,153.58333333333334,17072,34799.46666666667,45.98872323656008,52.81517599404167,NaN,NaN,NaN,NaN,2.7158244074455618,21.974577784123596,-1581292,-0.7753339905906884,-0.09711806925301403,0.6782159213376744
2025-08-05T13:30:00-04:00,153.485,154,152.77,152.96,NaN,NaN,NaN,157.84652975114864,NaN,NaN,153.73959999999988,162.94622736077062,144.53297263922914,155.18463463855295,153.45896896748152,153.62272912407383,153.29520881088922,9846,34678.73333333333,44.86633725976658,51.80119392822921,NaN,NaN,NaN,NaN,2.609694092628021,21.433939714657345,-1591138,-0.7497536213826776,-0.25897610539067273,0.4907775159920049
2025-08-06T09:30:00-04:00,153.49,155.71,153.47,155.66,NaN,NaN,NaN,157.84652975114864,NaN,NaN,153.90139999999988,162.9516590106643,144.85114098933548,155.18463463855295,154.9466666666667,154.9466666666667,154.9466666666667,26082,33327.63333333333,51.600859615994914,51.099015329455504,NaN,NaN,NaN,NaN,2.619715943154591,20.30737287158308,-1565056,-0.5265836504196477,-0.16745204703255467,0.359131603387093
2025-08-06T13:30:00-04:00,155.66,157.18,155.66,157.09,NaN,NaN,NaN,157.84652975114864,NaN,NaN,154.1463999999999,162.8591345971348,145.43366540286496,155.18463463855295,155.6229860886942,156.45369702443432,154.7922751529541,17288,32205.933333333334,54.75321136339917,50.60927731369976,NaN,NaN,NaN,NaN,2.541164804357835,18.951131759613666,-1547768,-0.27111552606425715,0.020237195806771524,0.2913527218710287
2025-08-07T09:30:00-04:00,159.3,159.7,156.36,156.43,150.4879564288012,150.4879564288012,150.4879564288012,NaN,NaN,NaN,154.3869999999999,162.6633513700235,146.11064862997628,153.49070771084237,157.49666666666664,157.49666936406496,157.49666396926833,29145,31688.333333333332,53.036242757891195,50.54460333233244,NaN,NaN,NaN,NaN,2.5982244611894165,18.45813869526617,-1576913,-0.14155659635546847,0.11440697642669306,0.25596357278216153
2025-08-07T13:30:00-04:00,156.34,157.91,155.49,157.83,150.4879564288012,NaN,NaN,NaN,NaN,NaN,154.6113999999999,162.6367580705213,146.58604192947848,153.10012542574134,157.2188473064325,157.41759471995445,157.02009989291057,56949,32522.566666666666,56.17557828912411,50.88387140046347,NaN,NaN,NaN,NaN,2.5854941425330287,17.689393214235036,-1519964,0.034080219815395996,0.2985638475514065,0.26448362773601053
2025-08-08T09:30:00-04:00,157.8,159.36,157.22,158.07,150.81119583698623,NaN,NaN,NaN,NaN,NaN,154.84539999999987,162.57266648693533,147.1181335130644,153.10012542574134,158.21666666666667,158.21666666666667,158.21666666666667,25481,31667.5,56.70981318242833,50.764292570361874,NaN,NaN,NaN,NaN,2.553673132352099,17.405374046120677,-1494483,0.15528442467075543,0.4585891585744548,0.3033047339036994
2025-08-08T13:30:00-04:00,158.11,158.865,158.11,158.64,151.2402323898505,NaN,NaN,NaN,NaN,NaN,155.05439999999987,162.61378453580048,147.49501546419927,153.45796421797957,158.39610899994216,158.55586214149577,158.23635585838855,32149,32263.1,58.01875302701491,50.83896553223001,NaN,NaN,NaN,NaN,2.428053622898379,17.141641961443057,-1462334,0.25672350303471064,0.6242091126970877,0.36748560966237703
2025-08-11T09:30:00-04:00,160.02,163.12,159.61,161.31,153.8362445539482,NaN,NaN,NaN,NaN,NaN,155.32739999999987,162.78411569527228,147.87068430472746,156.55437137438363,161.34666666666666,161.34666666666666,161.34666666666666,90782,33930.666666666664,63.574659621439395,51.11647314790431,NaN,NaN,NaN,NaN,2.574621221262782,18.015883932468377,-1371552,0.47388854814386494,0.9598462948422082,0.48595774669834324
2025-08-11T13:30:00-04:00,161.37,161.4,159.51,159.77,153.8362445539482,NaN,NaN,NaN,NaN,NaN,155.55279999999988,162.85000855122712,148.25559144877263,156.55437137438363,160.96288261673402,161.49443500261157,160.43133023085647,47324,34947.3,58.74553300077742,51.10008227282698,NaN,NaN,NaN,NaN,2.525719705458299,18.785403205086983,-1418876,0.482451784180128,1.0890224769235033,0.6065706927433753
2025-08-12T09:30:00-04:00,162.1,162.42,159.57,161.82,153.8362445539482,NaN,NaN,NaN,NaN,NaN,155.83259999999987,162.99548998659878,148.66971001340096,156.55437137438363,161.27,161.27,161.27,151802,38471.5,62.79673104784177,52.9038519797915,NaN,NaN,NaN,NaN,2.5488825836398488,19.74332838425635,-1267074,0.5878243564943317,1.34135113836129,0.7535267818669582
2025-08-12T13:30:00-04:00,162.02,162.52,161.89,162.33,154.95567860763654,NaN,NaN,NaN,NaN,NaN,156.12359999999987,163.1348777836935,149.11232221630624,157.06359814368443,161.51796971379983,161.94305179393052,161.09288763366914,51657,39592.73333333333,63.75044079764753,54.83623650073879,NaN,NaN,NaN,NaN,2.416819541951289,20.65717326618417,-1215417,0.6487323680261123,1.5644422418995987,0.9157098738734863
2025-08-13T09:30:00-04:00,163.18,164.71,161.5,162.65,155.74746594365308,NaN,NaN,NaN,NaN,NaN,156.39939999999987,163.33052361454548,149.46827638545426,158.73987851494752,162.95333333333335,162.95333333333335,162.95333333333335,68142,40964.2,64.36766631577768,55.94263218188728,NaN,NaN,NaN,NaN,2.473475288954769,22.016437199152026,-1147275,0.6649740072537915,1.7469273829407257,1.0819533756869342
2025-08-13T13:30:00-04:00,162.78,162.78,161.74,162.54,155.74746594365308,NaN,NaN,NaN,NaN,NaN,156.65039999999988,163.54377329325067,149.7570267067491,158.73987851494752,162.62849889624727,162.9274692137173,162.32952857877723,80442,43189.2,63.964478502470726,57.024930572723896,NaN,NaN,NaN,NaN,2.371084196886571,23.278610851193605,-1227717,0.6234110103717982,1.861217138651682,1.2378061282798838
2025-08-14T09:30:00-04:00,160.79,161.88,159.07,160.29,155.74746594365308,NaN,NaN,NaN,NaN,NaN,156.8441999999999,163.58953241879843,150.09886758120135,158.73987851494752,160.41333333333333,160.41333333333333,160.41333333333333,153437,47679.03333333333,56.20882095042727,57.754937552285824,NaN,NaN,NaN,NaN,2.4495781828232444,23.150321117458006,-1381154,0.40980530804879556,1.7500627633408783,1.3402574552920827
2025-08-14T13:30:00-04:00,160.3,160.38,159.71,159.945,155.74746594365308,NaN,NaN,NaN,NaN,NaN,157.02869999999987,163.59620175029346,150.46119824970629,158.73987851494752,160.28262844891134,160.4708199163939,160.09443698142877,74014,49671.8,55.10551468449493,58.486307368337854,NaN,NaN,NaN,NaN,2.3224654554787256,23.031194936132092,-1455168,0.22020275523942123,1.6155108993413592,1.395308144101938
2025-08-15T09:30:00-04:00,159.73,160.02,158.4,159.75,155.74746594365308,NaN,NaN,NaN,NaN,NaN,157.21169999999987,163.55869192059805,150.86470807940168,158.73987851494752,159.39000000000001,159.39000000000001,159.39000000000001,15771,49781.666666666664,54.45489272750566,58.690166876302904,NaN,NaN,NaN,NaN,2.2722893515159597,22.321523003061337,-1470939,0.06465495359954732,1.476126836101372,1.4114718825018246
2025-08-15T13:30:00-04:00,159.84,159.92,159.25,159.75,155.74746594365308,NaN,NaN,NaN,NaN,NaN,157.42009999999985,163.39139181669694,151.44880818330276,158.73987851494752,159.499488595866,159.62352244743246,159.37545474429956,12289,49973.7,54.45489272750566,58.66885840231051,NaN,NaN,NaN,NaN,2.1578401121219617,21.662541922352787,-1470939,-0.04909683423807931,1.3501008397042256,1.3991976739423049
2025-08-18T09:30:00-04:00,158.61,159.92,157.7,159.9,155.74746594365308,NaN,NaN,NaN,NaN,NaN,157.56649999999985,163.4135899599849,151.7194100400148,158.73987851494752,159.17333333333332,159.17333333333332,159.17333333333332,18072,49670.13333333333,54.929627252503195,58.80410015192566,NaN,NaN,NaN,NaN,2.16228010411325,20.35156229351374,-1452867,-0.12100408247429839,1.2479425708494318,1.3689466533237302
2025-08-18T13:30:00-04:00,159.92,160.23,159.75,159.785,155.74746594365308,NaN,NaN,NaN,NaN,NaN,157.70969999999986,163.41467165988897,152.00472834011074,158.73987851494752,159.4850039822199,159.85391446215382,159.11609350228596,12899,49806.13333333333,54.46093749232915,58.681625809297444,NaN,NaN,NaN,NaN,2.0421172395337313,19.260597186650877,-1465766,-0.17955037530929152,1.144508684187116,1.3240590594964075
2025-08-19T09:30:00-04:00,159.72,159.72,153.67,154.33,NaN,NaN,NaN,163.7339161396736,163.7339161396736,163.7339161396736,157.73369999999986,163.3711014616788,152.09629853832092,158.73987851494752,155.90666666666667,155.90666666666667,155.90666666666667,57364,50533.6,37.92878660242362,57.34012391072569,NaN,NaN,NaN,NaN,2.333037436709894,19.61427856317555,-1523130,-0.5670302798915952,0.6152712096319135,1.1823014895235087
2025-08-19T13:30:00-04:00,154.47,154.84,153.74,154.175,NaN,NaN,NaN,161.1589654060521,NaN,NaN,157.77729999999985,163.26831309779482,152.2862869022049,158.73987851494752,155.12565902570006,155.95185192723693,154.2994661241632,51261,51912.73333333333,37.57971114830309,55.88019234796055,NaN,NaN,NaN,NaN,2.244963334087758,19.942696984234175,-1574391,-0.8008410679958032,0.1812501545287546,0.9820912225245578
2025-08-20T09:30:00-04:00,153.09,153.7,149.1,152.75,NaN,NaN,NaN,158.6487851603224,NaN,NaN,157.69949999999983,163.3603689262498,152.03863107374985,157.48390281195802,151.85,151.85000190734863,151.84999809265136,94303,54404.36666666667,34.441380071315905,53.79924380866602,NaN,NaN,NaN,NaN,2.4471088102243477,21.31892629314798,-1668694,-1.0053014373516123,-0.27453557416495755,0.7307658631866547
2025-08-20T13:30:00-04:00,152.88,153.91,151.93,153.61,NaN,NaN,NaN,158.6487851603224,NaN,NaN,157.62769999999986,163.4020204656603,151.8533795343394,156.37879909873791,152.48296025855876,153.1327368718795,151.83318364523802,89485,56179.26666666667,37.81649663427926,52.30431263963044,NaN,NaN,NaN,NaN,2.4137438952083223,22.501861656933322,-1579209,-1.0325327352809555,-0.5599000559145395,0.47263267936641584
2025-08-21T09:30:00-04:00,152.63,153.62,151.67,152.12,NaN,NaN,NaN,158.6487851603224,NaN,NaN,157.49989999999985,163.46998793571416,151.52981206428555,156.37879909873791,152.47,152.47,152.47,28783,55510.73333333333,34.502291302442515,50.28328122924478,NaN,NaN,NaN,NaN,2.380619331264872,23.65610872625841,-1607992,-1.0948709341107499,-0.8959559882720214,0.19891494583872837
2025-08-21T13:30:00-04:00,152.17,153.18,152.17,152.56,NaN,NaN,NaN,158.6487851603224,NaN,NaN,157.37269999999984,163.48564567619908,151.2597543238006,156.37879909873791,152.51489880529326,152.58883953494765,152.44095807563886,10613,53847.9,36.27826608584729,48.320983035544764,NaN,NaN,NaN,NaN,2.286289379031667,24.72790957634599,-1597379,-1.050282063403067,-1.1139376334151052,-0.06365557001203836
2025-08-22T09:30:00-04:00,152.51,159.44,152,158.77,148.07237130846312,148.07237130846312,148.07237130846312,NaN,NaN,NaN,157.35169999999982,163.4380284860568,151.26537151394285,156.37879909873791,156.73666666666668,156.73666666666668,156.73666666666668,47086,50093,54.875449780127504,47.642967568712606,NaN,NaN,NaN,NaN,2.6544115662436907,23.148826824539366,-1550293,-0.5703890738123334,-0.776641912277455,-0.2062528384651217
2025-08-22T13:30:00-04:00,158.8,158.88,157.92,158.45,150.96908170353294,NaN,NaN,NaN,NaN,NaN,157.31709999999984,163.35822277314,151.27597722685968,156.37879909873791,157.25476660497634,158.03064053177494,156.47889267817774,20996,48840.63333333333,54.000862109031296,46.93128068346693,NaN,NaN,NaN,NaN,2.5333821686548563,21.682535697861788,-1571289,-0.25824199190009034,-0.5290553283402346,-0.27081333644014427
2025-08-25T09:30:00-04:00,157.5,158.175,155.75,157.27,150.96908170353294,NaN,NaN,NaN,NaN,NaN,157.23129999999983,163.14955305644835,151.3130469435513,156.37879909873791,157.06500000000003,157.06500000000003,157.06500000000003,17317,48146.73333333333,50.78653164070933,46.54397430420136,NaN,NaN,NaN,NaN,2.545283442322366,20.979040618069824,-1588606,-0.12189266612156002,-0.4231791690920943,-0.3012865029705343
2025-08-25T13:30:00-04:00,157.37,157.52,156.3,156.31,150.96908170353294,NaN,NaN,NaN,NaN,NaN,157.17249999999984,163.0677337527986,151.27726624720108,153.58153927899033,156.92335976816022,157.0971997147368,156.74951982158365,11496,47311.566666666666,48.2692363197458,46.05566870671929,NaN,NaN,NaN,NaN,2.45062033929934,20.325795186834434,-1600102,-0.08855992100072252,-0.4119864042214374,-0.3234264832207149
2025-08-26T09:30:00-04:00,156.17,157.2,155.82,156.55,150.96908170353294,NaN,NaN,NaN,NaN,NaN,157.15749999999983,163.05517589819624,151.25982410180342,151.91710028220132,156.52333333333334,156.52333333333334,156.52333333333334,17731,47333.53333333333,48.9504791988879,45.66249631181802,NaN,NaN,NaN,NaN,2.3741474579208153,19.868434255759595,-1582371,-0.044760287897292694,-0.3793768430923308,-0.3346165551950381
2025-08-26T13:30:00-04:00,156.58,157.69,155.99,157.47,150.96908170353294,NaN,NaN,NaN,NaN,NaN,157.16669999999985,163.06486195438256,151.26853804561713,152.35439627558966,156.79956886302483,157.0625859304884,156.53655179556125,19558,47657.26666666667,51.58265749337928,45.457336652237565,NaN,NaN,NaN,NaN,2.3259940680693276,19.237148080088787,-1562813,0.04680176781977047,-0.276114345420325,-0.32291611324009545
2025-08-27T09:30:00-04:00,157.54,158.17,156.4,157.31,150.96908170353294,NaN,NaN,NaN,NaN,NaN,157.19469999999984,163.08201497714782,151.30738502285186,153.01651702047172,157.29333333333332,157.29333333333332,157.29333333333332,15829,47315.5,51.08929021597132,45.18302686391386,NaN,NaN,NaN,NaN,2.2862802060643745,18.444082559933385,-1578642,0.09447080284039494,-0.2048276096896018,-0.2992984125299967
2025-08-27T13:30:00-04:00,157.3,157.78,156.56,157.09,150.96908170353294,NaN,NaN,NaN,NaN,NaN,157.18289999999982,163.06864178504114,151.2971582149585,153.0472136163774,157.22093407850443,157.29588897242235,157.1459791845865,14768,47231.5,50.37581952920688,44.89123272369084,NaN,NaN,NaN,NaN,2.2101173342026335,17.707664576931943,-1593410,0.1080852753542818,-0.16419181833714447,-0.2722770936914263
2025-08-28T09:30:00-04:00,158.07,159.98,158.07,159.5,152.118380540662,NaN,NaN,NaN,NaN,NaN,157.24269999999984,163.160549680428,151.32485031957168,154.74877089310192,159.1833333333333,159.1833333333333,159.1833333333333,17202,46833.4,57.394992667967884,46.28167601408686,NaN,NaN,NaN,NaN,2.258680381759587,16.802360239662402,-1576208,0.2672354223239134,0.0617671842134655,-0.2054682381104479
2025-08-28T13:30:00-04:00,159.57,159.82,159.23,159.44,152.85186324335916,NaN,NaN,NaN,NaN,NaN,157.31329999999983,163.2500643072783,151.37653569272135,155.34001671448152,159.35530549800237,159.51122273942954,159.1993882565752,20927,45632.666666666664,57.17815156372886,47.6815646151887,NaN,NaN,NaN,NaN,2.139488925919617,15.96172049791211,-1597135,0.3510228836473227,0.2333103664487055,-0.11771251719861721
2025-08-29T09:30:00-04:00,158.61,159,156.08,156.63,152.85186324335916,NaN,NaN,NaN,NaN,NaN,157.28849999999983,163.22611475680162,151.35088524319804,155.34001671448152,157.23666666666668,157.23666666666668,157.23666666666668,12593,45203.066666666666,48.02669788608332,48.651944459100655,NaN,NaN,NaN,NaN,2.226668288353929,15.723957362152463,-1609728,0.20688356879568764,0.14089194379599235,-0.0659916249996953
2025-08-29T13:30:00-04:00,156.66,156.84,156.37,156.75,152.85186324335916,NaN,NaN,NaN,NaN,NaN,157.27449999999985,163.21382630861095,151.33517369138875,155.34001671448152,156.84856326574004,157.1238256873122,156.57330084416787,25034,44965.9,48.40646284270292,49.408370616845204,NaN,NaN,NaN,NaN,2.1011919820429337,15.503177307518506,-1584694,0.11395441286065186,0.07645139107611953,-0.037503021784532325
2025-09-02T09:30:00-04:00,152.995,155.81,152,154.3,NaN,NaN,NaN,160.83527981811142,160.83527981811142,160.83527981811142,157.19269999999983,163.18077956194423,151.20462043805543,155.34001671448152,154.03666666666666,154.03666666666666,154.03666666666666,38616,43227.03333333333,41.706028792388864,49.92292329469852,NaN,NaN,NaN,NaN,2.2903925547541526,16.627289609647704,-1623310,-0.10627682882778669,-0.17034905781926568,-0.06407222899147899
2025-09-02T13:30:00-04:00,154.4,155.05,154.11,155,NaN,NaN,NaN,160.83527981811142,NaN,NaN,157.1234999999998,163.13133596648646,151.11566403351316,155.34001671448152,154.28293830227744,154.61101740730527,153.95485919724962,21759,42374.86666666667,44.08739377541658,50.48071812966776,NaN,NaN,NaN,NaN,2.1939359437002843,17.671108175910533,-1601551,-0.19348579859488277,-0.30592947723508246,-0.11244367864019969
2025-09-03T09:30:00-04:00,155.78,157.02,155.28,156.2,NaN,NaN,NaN,160.83527981811142,NaN,NaN,157.11829999999983,163.12887355334618,151.1077264466535,155.34001671448152,156.16666666666666,156.16666666666666,156.16666666666666,12158,37720.066666666666,48.00844920909082,49.990218088879416,NaN,NaN,NaN,NaN,2.181511947721693,17.701101944433553,-1589393,-0.16039752190818407,-0.31294058102542976,-0.1525430591172457
2025-09-03T13:30:00-04:00,156.25,156.26,155.02,155.98,NaN,NaN,NaN,160.83527981811142,NaN,NaN,157.12329999999983,163.12966016570772,151.11693983429194,155.34001671448152,156.00732912138827,156.20850333786427,155.80615490491226,7627,36252.4,47.35280969888124,49.515357202440136,NaN,NaN,NaN,NaN,2.1142610943129996,17.81110228849739,-1597020,-0.14389930805243992,-0.3324171941827956,-0.18851788613035567
2025-09-04T09:30:00-04:00,155.51,155.81,153.72,154.99,NaN,NaN,NaN,160.83527981811142,NaN,NaN,157.05989999999983,163.0880325433492,151.03176745665047,155.34001671448152,154.84000000000003,154.84000000000003,154.84000000000003,15095,34484.166666666664,44.413409298258806,49.06013417797938,NaN,NaN,NaN,NaN,2.1246710161477846,18.31871920432992,-1612115,-0.18747591331726893,-0.4228627777769418,-0.23538686445967288
2025-09-04T13:30:00-04:00,155.2,155.65,155.06,155.53,NaN,NaN,NaN,160.83527981811142,NaN,NaN,157.01509999999985,163.05474088006645,150.97545911993325,155.34001671448152,155.09731541663623,155.38247551535184,154.81215531792063,12291,32212.466666666667,46.36897469645515,48.9244012048872,NaN,NaN,NaN,NaN,2.020051657851514,18.790077769031548,-1599824,-0.16835357253936317,-0.44582883013387686,-0.2774752575945137
2025-09-05T09:30:00-04:00,157.28,157.86,152.68,154.85,NaN,NaN,NaN,160.83527981811142,NaN,NaN,156.93649999999982,162.98450570437757,150.88849429562208,155.34001671448152,155.13,155.13,155.13,33299,28207.866666666665,44.25748543344208,48.58918736449821,NaN,NaN,NaN,NaN,2.245762253719264,19.924233347778568,-1633123,-0.18840900977534425,-0.512986519813694,-0.3245775100383498
2025-09-05T13:30:00-04:00,154.72,155.79,154.49,155.76,NaN,NaN,NaN,160.83527981811142,NaN,NaN,156.87969999999984,162.91748284142102,150.84191715857867,153.73601337158524,155.25529287351662,155.36229046746635,155.1482952795669,45660,27262.733333333334,47.69037738346106,48.3111673566469,NaN,NaN,NaN,NaN,2.1782078070250295,20.97737781375794,-1587463,-0.13006947239621464,-0.48716435053361806,-0.3570948781374034
2025-09-08T09:30:00-04:00,157.28,158.53,157.2,158.21,NaN,NaN,NaN,160.83527981811142,NaN,NaN,157.03129999999982,162.80882258673068,151.25377741326895,152.77388250952944,157.98000000000002,157.98000000000002,157.98000000000002,30367,27749.266666666666,55.61562844026427,48.63447722981069,NaN,NaN,NaN,NaN,2.2204786779518138,20.533863610486996,-1557096,0.07292391827483063,-0.2659399802938651,-0.33886389856869575
2025-09-08T13:30:00-04:00,158.22,158.71,157.73,158.18,NaN,NaN,NaN,160.83527981811142,NaN,NaN,157.19169999999983,162.6327692368487,151.75063076315095,153.61510600762355,158.07422128150856,158.18593150452054,157.96251105849657,21603,28059.733333333334,55.50473615381389,49.00082841728262,NaN,NaN,NaN,NaN,2.131873058098114,20.03721394534008,-1578699,0.19750827818023065,-0.09197855084340745,-0.2894868290236381
2025-09-09T09:30:00-04:00,158.55,160.05,158.37,159.1,NaN,NaN,NaN,160.83527981811142,NaN,NaN,157.27829999999983,162.70023641055937,151.8563635894403,155.03908480609883,159.17333333333332,159.17333333333332,159.17333333333332,22625,28211.5,58.25372795201812,49.06216665185764,NaN,NaN,NaN,NaN,2.113167839662535,18.954646305391204,-1556074,0.3265930779339163,0.11875451839375728,-0.207838559540159
2025-09-09T13:30:00-04:00,159.06,159.97,158.9,159.74,NaN,NaN,NaN,160.83527981811142,NaN,NaN,157.37829999999983,162.793718214705,151.96288178529466,155.42626784487908,159.3954684896683,159.57257037876414,159.21836660057247,35594,28968,60.10046199361199,49.270903111135006,NaN,NaN,NaN,NaN,2.03865585111521,17.949404925438674,-1520480,0.43311851013435937,0.33355957812779025,-0.09955893200656914
2025-09-10T09:30:00-04:00,161.73,162.25,160.27,160.28,154.83738773909465,154.83738773909465,154.83738773909465,NaN,NaN,NaN,157.51449999999986,162.87212606012355,152.15687393987616,157.36001427590327,160.9333333333333,160.9333333333333,160.9333333333333,39523,28373.3,61.642296369784745,50.24344585997081,NaN,NaN,NaN,NaN,2.072323290321266,17.302267426131287,-1480957,0.512550997541913,0.5411298149208221,0.02857881737890912
2025-09-10T13:30:00-04:00,160.33,160.6,158.74,159.485,154.83738773909465,NaN,NaN,NaN,NaN,NaN,157.64499999999984,162.8687140044351,152.42128599556457,157.36001427590327,160.4085529934904,161.05658041977142,159.76052556720936,25919,27528.566666666666,58.0836733493696,50.93467518187558,NaN,NaN,NaN,NaN,2.057157341012603,16.105474951542078,-1506876,0.48447338118657357,0.6341705438621261,0.14969716267555253
2025-09-11T09:30:00-04:00,160.36,162.54,159.91,162.19,154.83738773909465,NaN,NaN,NaN,NaN,NaN,157.77559999999983,163.11941011640045,152.4317898835992,157.36001427590327,161.54666666666665,161.54666666666665,161.54666666666665,18406,24998.666666666668,65.40237837372229,52.62727158054225,NaN,NaN,NaN,NaN,2.1284318166545586,15.675968418840288,-1488470,0.6127400001820875,0.915622162903162,0.30288216272107443
2025-09-11T13:30:00-04:00,162.22,162.51,161.83,161.99,155.86250731139705,NaN,NaN,NaN,NaN,NaN,157.87359999999984,163.34179715812385,152.40540284187583,157.84912730926249,161.73970203445114,162.00706060261814,161.47234346628414,9595,22335.666666666668,64.5055781476089,54.08571332141314,NaN,NaN,NaN,NaN,2.0249724011792316,15.277140924188624,-1498065,0.6454893370908066,1.1097438340845827,0.4642544969937761
2025-09-12T09:30:00-04:00,162.61,162.95,161.67,162.54,156.1146660699699,NaN,NaN,NaN,NaN,NaN,157.99579999999983,163.60086498090192,152.39073501909775,158.58130184740997,162.38666666666666,162.38666666666666,162.38666666666666,32112,22446.633333333335,65.89071339449687,55.363017906085,NaN,NaN,NaN,NaN,1.9717600868092866,15.080709075364412,-1465953,0.6630455648032341,1.2930614529978186,0.6300158881945845
2025-09-12T13:30:00-04:00,162.37,163.42,162.37,163.22,156.83809033951673,NaN,NaN,NaN,NaN,NaN,158.10359999999983,163.8959615356913,152.31123846430836,159.400041477928,162.55731324233824,162.8331969156659,162.28142956901058,12286,22502.4,67.57546816534892,56.80749351083268,NaN,NaN,NaN,NaN,1.905920080608622,15.087065423716805,-1453667,0.6769438008776832,1.4761956392916886,0.7992518384140054
2025-09-15T09:30:00-04:00,164.8,165.69,164.4,165.2,158.92658623317507,NaN,NaN,NaN,NaN,NaN,158.24619999999985,164.3698210072262,152.1225789927735,161.2390331823424,165.09666666666666,165.09666666666666,165.09666666666666,27721,21856.9,71.92397918759912,58.77253421721413,NaN,NaN,NaN,NaN,1.946211503422292,15.91579799117884,-1425946,0.7692407812688681,1.7608028150000905,0.9915620337312224
2025-09-15T13:30:00-04:00,165.37,165.66,164.625,165.59,159.16105958621253,NaN,NaN,NaN,NaN,NaN,158.38519999999983,164.84457735700477,151.9258226429949,161.58172654587392,165.14850243656971,165.23464782585168,165.06235704728775,10037,21491.6,72.70059137278244,60.65336397980894,NaN,NaN,NaN,NaN,1.8811249674635566,16.68533537525073,-1415909,0.8026148747240696,1.9948306271363094,1.1922157524122399
2025-09-16T09:30:00-04:00,166.46,166.81,164.86,166.2,159.85953415047564,NaN,NaN,NaN,NaN,NaN,158.48299999999983,165.25696693232004,151.70903306767963,162.57238123669916,165.95666666666668,165.95666666666668,165.95666666666668,13267,21356.6,73.9159209404774,62.771823658882894,NaN,NaN,NaN,NaN,1.8860446126447303,17.786833651348807,-1402642,0.8095182834349077,2.2041136067058744,1.3945953232709667
2025-09-16T13:30:00-04:00,166.33,166.94,166.17,166.8,160.7461462345449,NaN,NaN,NaN,NaN,NaN,158.62359999999984,165.77963550579156,151.46756449420812,163.16490498935931,166.31024796777385,166.64997660693376,165.97051932861393,14371,21452.433333333334,75.09057665849971,64.72898074995707,NaN,NaN,NaN,NaN,1.8063271403129646,18.85288824964766,-1388271,0.7969852591235476,2.390826897175401,1.5938416380518536
2025-09-17T09:30:00-04:00,166.69,167.34,165.08,165.62,160.7461462345449,NaN,NaN,NaN,NaN,NaN,158.69959999999983,166.0673914845734,151.33180851542627,163.18992399148746,166.01333333333335,166.01333333333335,166.01333333333335,10771,21220.433333333334,68.5521726366586,65.6530196211281,NaN,NaN,NaN,NaN,1.8387323445763235,19.1365510508067,-1399042,0.6575149247698637,2.4157352940141834,1.7582203692443197
2025-09-17T13:30:00-04:00,165.78,167.6,163.57,166.9,160.7461462345449,NaN,NaN,NaN,NaN,NaN,158.79099999999983,166.4445139641974,151.13748603580225,163.18992399148746,166.0196104659201,166.0244446078234,166.0147763240168,18161,21173.866666666665,71.45565408204085,66.79237090171574,NaN,NaN,NaN,NaN,1.9952514628208717,18.522359972059224,-1380881,0.6012868525329682,2.50982893491053,1.9085420823775618
2025-09-18T09:30:00-04:00,168.2,171.01,168.2,170.57,163.18698021019162,NaN,NaN,NaN,NaN,NaN,158.94939999999986,167.21887099638954,150.67992900361017,164.68695135455198,169.92666666666665,169.92666666666665,169.92666666666665,44898,22142.833333333332,77.78791172748129,68.18766974282025,NaN,NaN,NaN,NaN,2.1463049297622367,19.202421800076102,-1335983,0.7513347481388477,2.8477105175511213,2.0963757694122735
2025-09-18T13:30:00-04:00,170.55,171.22,170.16,170.53,164.41916292791018,NaN,NaN,NaN,NaN,NaN,159.10919999999984,167.93979666388125,150.27860333611844,165.63156108364157,170.1614209752122,170.49543590554083,169.82740604488356,22178,22389.833333333332,77.58588918452278,69.4366288278853,NaN,NaN,NaN,NaN,2.0687117204935057,19.899753140984963,-1358161,0.7843306888950359,3.0767891305310684,2.2924584416360325
2025-09-19T09:30:00-04:00,173,174.88,172.27,173.33,166.99601915845972,NaN,NaN,NaN,NaN,NaN,159.36999999999986,169.05371416348734,149.68628583651238,168.23424886691328,173.49333333333334,173.49333524068197,173.4933314259847,148916,26780.3,81.2556716941967,70.83758420820044,NaN,NaN,NaN,NaN,2.231660883315398,21.53081521702917,-1209245,0.9216855472353673,3.4445653756802415,2.522879828444874
2025-09-19T13:30:00-04:00,173.31,173.97,172.62,173.47,166.99601915845972,NaN,NaN,NaN,NaN,NaN,159.64049999999986,170.09803264399144,149.18296735600828,168.23424886691328,173.4674970749346,173.52180696287658,173.41318718699264,33701,27206.1,81.41947829692644,72.50442741874022,NaN,NaN,NaN,NaN,2.1686851059357264,23.045372859070216,-1175544,0.9453944911519536,3.704622942384816,2.7592284512328624