time,open,high,low,close,Long Stop,Long Stop Start,Buy Label,Short Stop,Short Stop Start,Sell Label,Basis,Upper,Lower,ATR Trailing Stoploss,VWAP,Upper Band #1,Lower Band #1,Volume,Volume MA,RSI,RSI-based MA,Regular Bullish,Regular Bullish Label,Regular Bearish,Regular Bearish Label,ATR,ADX,OnBalanceVolume,Histogram,MACD,Signal
2025-08-19T15:25:00-04:00,154.18,154.24,154.17,154.19,NaN,NaN,NaN,154.49045099260215,NaN,NaN,154.68690000000046,155.99950182820223,153.3742981717987,154.14637020586014,156.28166374596162,157.99317208670877,154.57015540521448,1893,687.6,45.41600313048095,41.31994835221359,NaN,NaN,NaN,NaN,0.20205998822750884,29.456332441419086,517314,0.01595626933147737,-0.201403528687905,-0.21735979801938238
2025-08-19T15:30:00-04:00,154.22,154.29,154.21,154.23,NaN,NaN,NaN,154.49045099260215,NaN,NaN,154.65490000000045,155.93200373869675,153.37779626130416,153.9920961646881,156.19075451407676,157.9157631430591,154.4657458850944,3463,773.8,46.538314898789125,41.53118700434114,NaN,NaN,NaN,NaN,0.19476998906840068,28.16339888610933,520777,0.030130292738006548,-0.1796969320968742,-0.20982722483488075
2025-08-19T15:35:00-04:00,154.27,154.35,154.261,154.261,NaN,NaN,NaN,154.49045099260215,NaN,NaN,154.61812000000046,155.83093917108994,153.40530082891098,153.9771415454004,155.98474875604757,157.71738481453025,154.25211269756488,9442,1076.2666666666667,47.440275667601625,41.60743736954798,NaN,NaN,NaN,NaN,0.18942927556351524,26.681041960684848,530219,0.041326118614130214,-0.15816957656721797,-0.1994956951813482
2025-08-19T15:40:00-04:00,154.26,154.31,154.21,154.31,NaN,NaN,NaN,154.49045099260215,NaN,NaN,154.58492000000047,155.73726979661694,153.432570203384,153.9771415454004,155.8295950091695,157.55304532210064,154.10614469623837,8701,1340.4333333333334,48.907581142656824,41.95607831852486,NaN,NaN,NaN,NaN,0.1830414701661209,25.51229746659202,538920,0.051122891647850416,-0.13559208062153516,-0.18671497226938558
2025-08-19T15:45:00-04:00,154.33,154.34,154.19,154.19,NaN,NaN,NaN,154.49045099260215,NaN,NaN,154.55512000000047,155.66907638233792,153.44116361766302,153.98062845932645,155.79652719509875,157.51698125429564,154.07607313590185,2035,1399.2666666666667,45.553604343393985,42.1422911013119,NaN,NaN,NaN,NaN,0.18068136515425554,24.273302605666046,536885,0.04862749783690129,-0.12593059997325895,-0.17455809781016024
2025-08-19T15:50:00-04:00,154.14,154.14,153.88,153.89,NaN,NaN,NaN,154.49045099260215,NaN,NaN,154.51372000000046,155.56801536931573,153.4594246306852,153.98062845932645,155.68415328849966,157.40766184684193,153.96064473015738,6413,1572.9333333333334,38.45378006440953,41.82137357845718,NaN,NaN,NaN,NaN,0.1899184105003803,24.292885276288406,530472,0.026960413262495597,-0.14085758123204073,-0.16781799449453633
2025-08-19T15:55:00-04:00,153.92,154.175,153.92,154.175,NaN,NaN,NaN,154.49045099260215,NaN,NaN,154.47962000000047,155.46284342414017,153.49639657586076,153.98062845932645,155.61975609973155,157.33702095585227,153.90249124361083,4388,1708.7,46.91789042677556,42.29599255241386,NaN,NaN,NaN,NaN,0.1967099526074978,24.122217714105805,534860,0.03168459380948038,-0.12821225223268584,-0.15989684604216622
2025-08-20T09:30:00-04:00,153.09,153.7,152.89,152.89,NaN,NaN,NaN,154.08010784450454,NaN,NaN,154.42382000000046,155.44418861465417,153.40345138534676,153.98062845932645,153.16,153.16,153.16,5747,1883.6,28.13221506759247,41.25251868636942,NaN,NaN,NaN,NaN,0.2744449559926783,26.207282502440442,529113,-0.04756328909201646,-0.2193509574071868,-0.17178766831517034
2025-08-20T09:35:00-04:00,153.02,153.22,152.65,152.65,NaN,NaN,NaN,153.76214839702706,NaN,NaN,154.36242000000047,155.431709789432,153.29313021056893,153.98062845932645,153.10354829464032,153.225522679955,152.98157390932565,1231,1918.6333333333334,26.035465863914695,40.039157051482256,NaN,NaN,NaN,NaN,0.2955560305646294,28.449116903736755,527882,-0.10849106453484164,-0.3074014989837224,-0.19891043444888074
2025-08-20T09:40:00-04:00,152.62,152.77,151.92,151.92,NaN,NaN,NaN,153.25045983352584,NaN,NaN,154.28702000000047,155.49403108435942,153.0800089156415,153.98062845932645,152.81786082306138,153.24881213232558,152.38690951379718,3244,2006.2666666666667,20.926476772715915,38.89436384076432,NaN,NaN,NaN,NaN,0.3351591712385861,31.23034226841333,524638,-0.18576559906403767,-0.4311174332789278,-0.24535183421489015
2025-08-20T09:45:00-04:00,151.87,151.87,150.5,150.5,NaN,NaN,NaN,152.24293893200195,NaN,NaN,154.19102000000046,155.76748538743257,152.61455461256836,153.98062845932645,152.50581793013598,153.30455663017506,151.7070792300969,2059,2061.5666666666666,14.83017889063575,37.570998190746366,NaN,NaN,NaN,NaN,0.4126478018644005,34.57244158250135,522579,-0.31284589736646656,-0.6364092059229733,-0.3235633085565068
2025-08-20T09:50:00-04:00,150.45,150.45,149.44,149.52,NaN,NaN,NaN,151.09939625327456,NaN,NaN,154.08222000000046,156.11595084890178,152.04848915109915,153.98062845932645,151.91178980581498,153.23475313971284,150.58882647191712,3460,2145.9666666666667,12.190685364587978,35.884342050632696,NaN,NaN,NaN,NaN,0.45888724458837205,38.001870572604965,519119,-0.43568891311466146,-0.8681744499498336,-0.43248553683517216
2025-08-20T09:55:00-04:00,149.61,150.42,149.61,150.11,NaN,NaN,NaN,151.09939625327456,NaN,NaN,153.9802200000005,156.27259359210007,151.6878464079009,153.98062845932645,151.62154615027,153.01257672077006,150.23051557976996,2901,2234.5666666666666,21.27510000059047,34.801694032234245,NaN,NaN,NaN,NaN,0.49039529854634384,41.18634034912975,522020,-0.44824969301614703,-0.992797653105356,-0.5445479600892089
2025-08-20T10:00:00-04:00,150.29,151.18,150.29,150.82,149.42010589319403,149.42010589319403,149.42010589319403,NaN,NaN,NaN,153.89022000000048,156.31466531507067,151.4657746849303,153.98062845932645,151.57037547080978,152.9345203229541,150.20623061866544,1182,2236.6666666666665,30.58227269577928,33.79998888070887,NaN,NaN,NaN,NaN,0.5317956343644616,42.222859630974405,523202,-0.3823494757926218,-1.0224848048299862,-0.6401353290373644
2025-08-20T10:05:00-04:00,150.74,150.745,149.73,149.75,149.42010589319403,NaN,NaN,NaN,NaN,NaN,153.78322000000048,156.44524317904342,151.12119682095755,153.69750276746115,151.46290782964246,152.83269260247684,150.09312305680808,1535,2277.8333333333335,25.65898476136981,32.38877328291522,NaN,NaN,NaN,NaN,0.5716673747670004,43.516426176220875,521667,-0.38345001369381104,-1.1194478461546282,-0.7359978324608172
2025-08-20T10:10:00-04:00,149.81,150,149.66,150,149.42010589319403,NaN,NaN,NaN,NaN,NaN,153.6806200000005,156.51684554494284,150.84439445505814,153.67850221396893,151.39409637025759,152.77182190863738,150.0163708318778,975,2296.733333333333,28.553061340888462,31.104112314493737,NaN,NaN,NaN,NaN,0.5551197051407863,44.756946838324836,522642,-0.34137435848703657,-1.1627157805696129,-0.8213414220825763
2025-08-20T10:15:00-04:00,149.91,149.91,149.13,149.66,NaN,NaN,NaN,150.96194067647727,150.96194067647727,150.96194067647727,153.57622000000046,156.6058615177071,150.54657848229382,152.6603017711751,151.21511026293467,152.6318902743683,149.79833025150106,2425,2374.0333333333333,27.01286606166616,29.645011628355487,NaN,NaN,NaN,NaN,0.5776111547735877,46.19308313936314,520217,-0.3113167377112227,-1.2104873442216046,-0.8991706065103819
2025-08-20T10:20:00-04:00,149.59,150.315,149.56,150.2,NaN,NaN,NaN,150.96194067647727,NaN,NaN,153.49222000000046,156.65578184794967,150.32865815205125,152.10324141694008,151.18571614275584,152.5970300959365,149.77440218957517,627,2391.5,33.17799466680398,28.52146973722314,NaN,NaN,NaN,NaN,0.5902817865754739,46.61698535052683,520844,-0.23349836025993176,-1.1910435568352966,-0.9575451965753649
2025-08-20T10:25:00-04:00,150.32,150.35,149.73,149.75,NaN,NaN,NaN,150.96194067647727,NaN,NaN,153.39822000000046,156.71781771746763,150.0786222825333,151.45159313355208,151.1224103081735,152.52417942130924,149.72064119503776,1363,2398.366666666667,30.840149512711662,27.470508677888688,NaN,NaN,NaN,NaN,0.5924045161057975,46.93304702835885,519481,-0.19247113092343593,-1.1981341102296597,-1.0056629793062237
2025-08-20T10:30:00-04:00,149.7,150.13,149.61,150.045,NaN,NaN,NaN,150.96194067647727,NaN,NaN,153.31052000000048,156.74611674551485,149.8749232544861,150.10527450684165,150.92637617306707,152.2821106732345,149.57064167289963,5254,2523.4,34.11755015992483,27.1607779704255,NaN,NaN,NaN,NaN,0.587232764955382,47.31633048463802,524735,-0.1286717554339809,-1.1665026735986999,-1.037830918164719
2025-08-20T10:35:00-04:00,150.08,150.18,149.75,149.75,NaN,NaN,NaN,150.96194067647727,NaN,NaN,153.22352000000046,156.79246535091386,149.65457464908707,149.04226054750293,150.8148538484409,152.13483975556855,149.49486794131323,3873,2635.1666666666665,32.4609365733822,26.12813840946883,NaN,NaN,NaN,NaN,0.5760018531728553,47.54831842618668,520862,-0.09130286128641663,-1.1519594947727398,-1.0606566334863232
2025-08-20T10:40:00-04:00,149.73,149.74,149.45,149.57,NaN,NaN,NaN,150.96194067647727,NaN,NaN,153.13342000000048,156.83676363700923,149.43007636299174,149.04226054750293,150.71338166227696,152.02209856096135,149.40466476359256,3231,2695.9666666666667,31.457247330481792,26.36564071396092,NaN,NaN,NaN,NaN,0.5562874350890807,48.00582278122336,517631,-0.06491189095227812,-1.1417964971766708,-1.0768846062243926
2025-08-20T10:45:00-04:00,149.52,149.65,149.1,149.45,NaN,NaN,NaN,150.8466823819023,NaN,NaN,153.04902000000047,156.88941501064625,149.2086249893547,149.04226054750293,150.66723783441475,151.97530526526464,149.35917040356486,1424,2725.3333333333335,30.774095948316713,26.70411429141821,NaN,NaN,NaN,NaN,0.5558383325827186,48.691488266913964,516207,-0.04280812170167425,-1.1303947583514855,-1.0875866366498113
2025-08-20T10:50:00-04:00,149.5,149.61,149.2,149.31,NaN,NaN,NaN,150.8466823819023,NaN,NaN,152.95502000000045,156.92463369377882,148.98540630622207,148.5402534631717,150.5791746185034,151.88331309094127,149.27503614606553,2960,2806.0666666666666,29.956719792412386,27.349131649967955,NaN,NaN,NaN,NaN,0.545421308826812,49.32817764648381,513247,-0.02572898805005286,-1.1197478717123772,-1.0940188836623244
2025-08-20T10:55:00-04:00,149.48,149.6,149.28,149.6,NaN,NaN,NaN,150.8466823819023,NaN,NaN,152.86982000000046,156.93968121997116,148.79995878002975,148.5402534631717,150.5264170604363,151.81972475899366,149.23310936187895,2221,2856.5333333333333,33.874672101008855,28.709452593566034,NaN,NaN,NaN,NaN,0.5293197867677535,49.91938921322724,515468,0.01480572195334462,-1.0755117312206437,-1.0903174531739883
2025-08-20T11:00:00-04:00,149.6,150.08,149.6,150.08,NaN,NaN,NaN,150.8466823819023,NaN,NaN,152.78942000000046,156.91731219018666,148.66152780981426,148.84124785481208,150.49788439756225,151.76691292531925,149.22885586980524,2257,2868.3333333333335,39.86998562443398,30.686545469269323,NaN,NaN,NaN,NaN,0.5257969448557723,49.12202618333569,517725,0.08000864721535139,-0.9903066441547992,-1.0703152913701506
2025-08-20T11:05:00-04:00,150.11,150.76,150.11,150.74,NaN,NaN,NaN,150.8466823819023,NaN,NaN,152.71762000000047,156.8606879238698,148.57455207613114,149.42899828384967,150.49881781684022,151.75249580791296,149.24513982576747,1183,2902,46.98723089258232,32.523126247268735,NaN,NaN,NaN,NaN,0.5368114487946442,46.85227475470441,518908,0.16855991040984053,-0.85961540335785,-1.0281753137676906
2025-08-20T11:10:00-04:00,150.73,151.08,150.73,151.03,149.4584877310585,149.4584877310585,149.4584877310585,NaN,NaN,NaN,152.64322000000047,156.77120616831223,148.5152338316887,149.84019862707973,150.5055310621242,151.75096676010972,149.26009536413866,748,2914.1,49.79895146585239,33.89574615941682,NaN,NaN,NaN,NaN,0.5234677738807426,44.13673031458905,519656,0.24310673820273254,-0.7242918910142748,-0.9673986292170074
2025-08-20T11:15:00-04:00,151.09,151.55,151.04,151.55,149.84332919782858,NaN,NaN,NaN,NaN,NaN,152.57862000000046,156.67177541627765,148.48546458372326,150.29815890166378,150.55924989655037,151.78395996691933,149.3345398261814,3266,3015.9,54.4628349048684,35.953164026809574,NaN,NaN,NaN,NaN,0.5232200757464046,41.15310172188208,522922,0.31909196254744554,-0.5685336760327004,-0.887625638580146
2025-08-20T11:20:00-04:00,151.55,151.91,151.55,151.91,150.29522332520003,NaN,NaN,NaN,NaN,NaN,152.52362000000048,156.57713872596685,148.4701012740341,150.728527121331,150.57132978228069,151.79603970735297,149.3466198572084,527,3000.9333333333334,57.41267898768327,38.01456528729492,NaN,NaN,NaN,NaN,0.5115614989073747,38.92828437664904,523449,0.38105737362557124,-0.41130392154818196,-0.7923612951737532
2025-08-20T11:25:00-04:00,151.94,152.2,151.84,152.2,150.60134953769088,NaN,NaN,NaN,NaN,NaN,152.4754200000005,156.48563956677575,148.46520043322525,151.0748216970648,150.6185539799379,151.85223947148853,149.38486848838727,1735,2995.6666666666665,59.678620193660336,40.347833439580214,NaN,NaN,NaN,NaN,0.5007356775568469,37.27100338353592,525184,0.4256513648136928,-0.2602970891566372,-0.68594845397033
2025-08-20T11:30:00-04:00,152.18,152.77,152.04,152.77,150.9512881950686,NaN,NaN,NaN,NaN,NaN,152.44202000000047,156.41386780143714,148.4701721985638,151.50485735765187,150.6767598941206,151.93502388011865,149.41849590812257,1744,2938.366666666667,63.76009320420375,42.53226904939448,NaN,NaN,NaN,NaN,0.517111700588502,36.445993510797656,526928,0.4739183961570721,-0.09355045877398993,-0.567468854931062
2025-08-20T11:35:00-04:00,152.56,152.57,152.09,152.09,150.9512881950686,NaN,NaN,NaN,NaN,NaN,152.38982000000047,156.30985968726938,148.46978031273156,151.50485735765187,150.72444353986097,151.99250740798078,149.45637967174116,1787,2683.2,56.42251527332075,44.35958088943799,NaN,NaN,NaN,NaN,0.5287465791178951,35.67991291468356,525141,0.44110514470987516,-0.0160874240437181,-0.45719256875359326
2025-08-20T11:40:00-04:00,152.19,152.53,152.18,152.27,150.9512881950686,NaN,NaN,NaN,NaN,NaN,152.3476200000005,156.22626293558088,148.4689770644201,151.50485735765187,150.805679461583,152.0902092049375,149.5211497182285,3149,2498.133333333333,57.80670462903797,46.0516633515175,NaN,NaN,NaN,NaN,0.5224075377523311,34.96855236114904,528290,0.4130702906898326,0.05914529460869744,-0.35392499608113515
2025-08-20T11:45:00-04:00,152.32,152.37,152.095,152.13,150.9512881950686,NaN,NaN,NaN,NaN,NaN,152.29862000000048,156.12476349727677,148.4724765027242,151.50485735765187,150.8256155636671,152.1116027348036,149.5396283925306,902,2460.366666666667,56.30857935700658,47.75506640749067,NaN,NaN,NaN,NaN,0.5047355707700222,34.11393309350679,527388,0.36813695380767664,0.10624619617846065,-0.261890757629216
2025-08-20T11:50:00-04:00,152,152,151.35,151.39,150.9512881950686,NaN,NaN,NaN,NaN,NaN,152.2386200000005,156.02558602331268,148.45165397668833,151.50485735765187,150.84341928419047,152.11929056741306,149.5675480009679,1523,2297.366666666667,49.06969492542824,49.01309837855827,NaN,NaN,NaN,NaN,0.5243973157150207,31.83178323304835,525865,0.2758377981389334,0.08290649004445072,-0.19293130809448264
2025-08-20T11:55:00-04:00,151.49,151.5,151.24,151.31,150.9512881950686,NaN,NaN,NaN,NaN,NaN,152.17542000000049,155.91651569160533,148.43432430839565,151.50485735765187,150.84976016689362,152.11887154408342,149.58064878970382,818,2178.366666666667,48.34609022119222,50.268240826620804,NaN,NaN,NaN,NaN,0.5055117931639471,29.594961385110004,525047,0.20018010712190884,0.05729382580790343,-0.1428862813140054
2025-08-20T12:00:00-04:00,151.44,151.92,151.44,151.92,150.9512881950686,NaN,NaN,NaN,NaN,NaN,152.1256200000005,155.81230253877848,148.43893746122254,151.50485735765187,150.87731413195627,152.1367621142032,149.61786614970933,2040,2054.8,53.925327272359084,51.980284218045576,NaN,NaN,NaN,NaN,0.5129752365093784,28.14322274427407,527087,0.18249700200911978,0.08523497119739432,-0.09726203081172546
2025-08-20T12:05:00-04:00,152,152.01,151.89,151.95,150.9512881950686,NaN,NaN,NaN,NaN,NaN,152.0738200000005,155.69556324183065,148.45207675817034,151.50485735765187,150.88285641881083,152.14139847545667,149.624314362165,350,2025.4333333333334,54.18740649744212,53.431193817790806,NaN,NaN,NaN,NaN,0.4849055767587088,26.93759489060401,527437,0.16464802917956128,0.10854800566272615,-0.056100023516835136
2025-08-20T12:10:00-04:00,151.95,152.255,151.95,152.21,150.9512881950686,NaN,NaN,NaN,NaN,NaN,152.02982000000048,155.58989650897644,148.46974349102453,151.50485735765187,150.9087047398732,152.1669182836195,149.6504911961269,1424,1964.7666666666667,56.496953398032275,54.618834373047825,NaN,NaN,NaN,NaN,0.47205517841880157,26.201702063727613,528861,0.16193356284292243,0.1463169300368179,-0.015616632806104529
2025-08-20T12:15:00-04:00,152.24,152.65,152.24,152.64,151.05229780313226,NaN,NaN,NaN,NaN,NaN,151.9956200000005,155.49827512743175,148.49296487256927,151.62336755054812,150.92769288282494,152.19037811516776,149.66500765048212,830,1923.8,60.08120979885714,55.554118580638885,NaN,NaN,NaN,NaN,0.4697655228174584,26.084618663918434,529691,0.17932733228625788,0.20854253255171784,0.02921520026545995
2025-08-20T12:20:00-04:00,152.72,152.79,152.6,152.79,151.33969335753537,NaN,NaN,NaN,NaN,NaN,151.9644200000005,155.4099582647344,148.5188817352666,151.8736940404385,150.95273248524293,152.2241886539518,149.68127631653405,988,1841.4,61.279676203049846,56.37417034758156,NaN,NaN,NaN,NaN,0.4497822711876398,26.1646280799198,530679,0.19013507508573896,0.26688404412263367,0.0767489690368947
2025-08-20T12:25:00-04:00,152.79,152.97,152.73,152.94,151.52357093219283,NaN,NaN,NaN,NaN,NaN,151.9390200000005,155.33635475503044,148.54168524497058,152.1169552323508,151.00098961624042,152.2920349823743,149.70994425010653,1823,1805.4666666666667,62.492374446365936,56.94770888625995,NaN,NaN,NaN,NaN,0.43479782324566624,26.479424378068444,532502,0.19581490794438766,0.3215176039673793,0.1257026960229916
2025-08-20T12:30:00-04:00,152.94,152.96,152.58,152.59,151.52357093219283,NaN,NaN,NaN,NaN,NaN,151.90482000000048,155.2402613125964,148.56937868740457,152.1169552323508,151.04478928279866,152.3474849452005,149.74209362039682,1915,1829.9,57.93303898356627,56.98487745739446,NaN,NaN,NaN,NaN,0.4308836930138326,26.40002466101737,530587,0.16562778627900845,0.33273742887175217,0.16710964259274372
2025-08-20T12:35:00-04:00,152.59,152.59,152.29,152.47,151.52357093219283,NaN,NaN,NaN,NaN,NaN,151.86802000000048,155.13643166283913,148.59960833716184,152.1169552323508,151.09098639675904,152.39636301457006,149.78560977894801,2540,1863.4,56.41335142677012,56.75164397404516,NaN,NaN,NaN,NaN,0.42153485779855965,25.640156637089262,528047,0.1288429746259948,0.32816336087523723,0.19932038624924242
2025-08-20T12:40:00-04:00,152.46,152.5,152.34,152.5,151.52357093219283,NaN,NaN,NaN,NaN,NaN,151.83802000000048,155.054732545098,148.62130745490296,152.1169552323508,151.1070422619276,152.41292728428266,149.80115723957255,926,1861.7666666666667,56.71901929043966,56.248710123062004,NaN,NaN,NaN,NaN,0.40285379652723374,24.93456490058459,528973,0.09913016968930471,0.3232330983608733,0.2241029286715686
2025-08-20T12:45:00-04:00,152.58,152.69,152.47,152.47,151.52357093219283,NaN,NaN,NaN,NaN,NaN,151.8118200000005,154.9858935388063,148.6377464611947,152.1169552323508,151.13976765404323,152.44835943481158,149.83117587327487,1823,1841.7,56.29386938264401,56.23952113087081,NaN,NaN,NaN,NaN,0.38979281106100266,24.61041508331,527150,0.07135255834995297,0.31329362660900983,0.24194106825905687
2025-08-20T12:50:00-04:00,152.47,152.66,152.47,152.66,151.52357093219283,NaN,NaN,NaN,NaN,NaN,151.7878200000005,154.91741873941714,148.65822126058384,152.1169552323508,151.16798067573637,152.47930021267268,149.85666113880006,1580,1873.4666666666667,58.41965048245486,56.28330297754345,NaN,NaN,NaN,NaN,0.3755218959852166,24.30941882441216,528730,0.06012129627951801,0.3170926886084544,0.2569713923289364
2025-08-20T12:55:00-04:00,152.61,152.61,152.19,152.33,151.52357093219283,NaN,NaN,NaN,NaN,NaN,151.7568200000005,154.83316257353928,148.6804774264617,152.1169552323508,151.19616569704803,152.5048801211859,149.88745127291017,1948,1892.9666666666667,53.54811991776172,56.08612730331168,NaN,NaN,NaN,NaN,0.38227033198627247,23.29077248451636,526782,0.02652751291060379,0.2901307834671911,0.26360327055658733
2025-08-20T13:00:00-04:00,152.34,152.7,152.32,152.7,151.52357093219283,NaN,NaN,NaN,NaN,NaN,151.72762000000048,154.73920068491992,148.71603931508105,152.1169552323508,151.2137749546994,152.52326885030402,149.90428105909479,1082,1753.9,57.79742484523395,56.7095365832978,NaN,NaN,NaN,NaN,0.38210816541582415,22.530523489529713,527864,0.025290279165596508,0.29521611951358295,0.26992584034798645
2025-08-20T13:05:00-04:00,152.68,152.81,152.51,152.81,151.52357093219283,NaN,NaN,NaN,NaN,NaN,151.70002000000048,154.64539428483602,148.75464571516494,152.1169552323508,151.23570985533905,152.54794984978568,149.92346986089242,1259,1666.7666666666667,58.998284550817466,57.47040760684246,NaN,NaN,NaN,NaN,0.37624329645755183,22.05316782447997,529123,0.02774812745717059,0.3046109996694497,0.2768628722122791
2025-08-20T13:10:00-04:00,152.78,152.805,152.53,152.53,151.52357093219283,NaN,NaN,NaN,NaN,NaN,151.6660200000005,154.53196681000102,148.80007318999995,152.1169552323508,151.27868332073368,152.59256852298435,149.964798118483,2748,1650.6666666666667,54.72931221488525,57.52783510273718,NaN,NaN,NaN,NaN,0.3693687752820125,21.609908992648062,526375,0.007441004630537151,0.28616412800045055,0.2787231233699134
2025-08-20T13:15:00-04:00,152.59,152.71,152.56,152.71,151.52357093219283,NaN,NaN,NaN,NaN,NaN,151.63500000000047,154.42036891620427,148.84963108379668,152.08756418588064,151.3404424324081,152.65596736757632,150.0249174972399,4148,1741.4666666666667,56.888906417794594,57.72079938276236,NaN,NaN,NaN,NaN,0.35584243419044065,21.198311505947004,530523,0.0032689376737048415,0.2828092954620445,0.27954035778833963
2025-08-20T13:20:00-04:00,152.83,152.84,152.69,152.74,151.6460340661597,NaN,NaN,NaN,NaN,NaN,151.60360000000048,154.30166748606186,148.9055325139391,152.19656733376246,151.34628008744903,152.66222297146908,150.03033720342899,384,1655.6,57.25490113702777,57.77493850697632,NaN,NaN,NaN,NaN,0.34113940317683816,21.12448918273438,530907,-0.00015138235085415674,0.27935112984977195,0.2795025122006261
2025-08-20T13:25:00-04:00,152.65,152.76,152.63,152.75,151.6460340661597,NaN,NaN,NaN,NaN,NaN,151.5748000000005,154.19133049654417,148.95826950345682,152.19656733376246,151.36286395978917,152.67933430692634,150.046393612652,1144,1619.7,57.384772685185695,57.582335855999794,NaN,NaN,NaN,NaN,0.32605801723563516,20.84251394452199,532051,-0.0041972313798882,0.27425597297576587,0.27845320435565407
2025-08-20T13:30:00-04:00,152.88,153.28,152.84,153.28,151.9512521140009,NaN,NaN,NaN,NaN,NaN,151.5626000000005,154.14125099603092,148.98394900397005,152.55120309360797,151.3892008176028,152.71330363347454,150.0650980017311,1424,1591.9333333333334,63.68275133952431,57.753984080033675,NaN,NaN,NaN,NaN,0.3406253017188042,21.695026108677258,533475,0.024771691745652136,0.30941781903771925,0.2846461272920671
2025-08-20T13:35:00-04:00,153.27,153.31,153.24,153.27,152.20710429063723,NaN,NaN,NaN,NaN,NaN,151.54450000000045,154.06151748094584,149.02748251905507,152.69196247488637,151.4178681014203,152.751945891458,150.08379031138261,1479,1601.8,63.492089049294854,57.82539226595717,NaN,NaN,NaN,NaN,0.3212949230246034,22.54218780707138,531996,0.03839703747830464,0.33264242413994793,0.2942453866616433
2025-08-20T13:40:00-04:00,153.24,153.33,153.17,153.33,152.20882682288098,NaN,NaN,NaN,NaN,NaN,151.55330000000046,154.09205529332144,149.0145447066795,152.7555699799091,151.4460414176004,152.78930718816963,150.1027756470312,1496,1626.7333333333333,64.18494749158455,58.27195715938706,NaN,NaN,NaN,NaN,0.30977385709427635,23.059376527585542,533492,0.046070784869391423,0.35183386774838254,0.3057630828789911
2025-08-20T13:45:00-04:00,153.29,153.48,153.26,153.27,152.3461528763864,NaN,NaN,NaN,NaN,NaN,151.56570000000048,154.13167116884358,148.99972883115737,152.91045598392725,151.477442271352,152.83124285346253,150.12364168924148,1667,1573.4333333333334,62.89939828459475,58.73524622066025,NaN,NaN,NaN,NaN,0.3033614387303994,23.84654806349554,531825,0.041848790907060895,0.3580740715128172,0.31622528060575633
2025-08-20T13:50:00-04:00,153.24,153.3,153.14,153.23,152.3461528763864,NaN,NaN,NaN,NaN,NaN,151.59190000000046,154.19824064530425,148.98555935469668,152.91045598392725,151.51250463749435,152.87483883280203,150.15017044218666,2057,1624.4333333333334,62.007747301232115,59.11301250714542,NaN,NaN,NaN,NaN,0.2931213359639441,24.097855674330386,529768,0.03157307204000426,0.35569162065576165,0.3241185486157574
2025-08-20T13:55:00-04:00,153.2,153.2,153.01,153.06,152.3461528763864,NaN,NaN,NaN,NaN,NaN,151.64310000000046,154.26217837976867,149.02402162023225,152.91045598392725,151.54121936256885,152.90747110677933,150.17496761835838,1899,1629.9,58.22970672283435,59.2512866028733,NaN,NaN,NaN,NaN,0.2878983833950909,23.82900358888517,527869,0.009673408131584627,0.33621030878023817,0.32653690064865354
2025-08-20T14:00:00-04:00,153.12,153.12,152.44,152.68,152.3461528763864,NaN,NaN,NaN,NaN,NaN,151.70630000000045,154.26930667953943,149.14329332046148,152.91045598392725,151.57098196311597,152.93316684834537,150.20879707788657,2641,1659.8,50.781592340844696,58.70571102132971,NaN,NaN,NaN,NaN,0.3159056417240135,22.45172500657138,525228,-0.03178765982154785,0.2868023258717187,0.3185899856932666
2025-08-20T14:05:00-04:00,152.67,152.67,152.45,152.58,152.3461528763864,NaN,NaN,NaN,NaN,NaN,151.7557000000005,154.28877245046672,149.22262754953428,152.91045598392725,151.57931710377088,152.93881851148242,150.21981569605933,903,1630.3333333333333,49.0051759394528,58.381215022879076,NaN,NaN,NaN,NaN,0.3097695244580138,21.17282346585143,524325,-0.06539458279359123,0.23684675720127757,0.3022413399948688
2025-08-20T14:10:00-04:00,152.56,152.65,152.33,152.43,NaN,NaN,NaN,153.50363789680705,153.50363789680705,153.50363789680705,151.7879000000005,154.31349703027388,149.2623029697271,152.91045598392725,151.58480704146623,152.94190380883788,150.2277102740946,669,1547.6666666666667,46.38407753579309,57.56597592934759,NaN,NaN,NaN,NaN,0.3105002727110123,20.312935144321138,523656,-0.09535878512532792,0.1830428585882089,0.2784016437135368
2025-08-20T14:15:00-04:00,152.38,152.42,152,152,NaN,NaN,NaN,153.23619981058852,NaN,NaN,151.83290000000048,154.2909269240475,149.37487307595345,152.91045598392725,151.59557141652508,152.94162638905706,150.2495164439931,2146,1589.1333333333334,39.81051175192089,56.1954207294264,NaN,NaN,NaN,NaN,0.3190359675173691,20.323126300500878,521510,-0.1391206316397419,0.10450085416385946,0.24362148580360135
2025-08-20T14:20:00-04:00,152.06,152.15,151.94,152.11,NaN,NaN,NaN,153.05319072828908,NaN,NaN,151.8751000000005,154.2776307405599,149.47256925944106,152.91045598392725,151.6034764996935,152.9395611021008,150.2673918972862,1889,1601.3333333333333,42.07217642359448,55.291339601477056,NaN,NaN,NaN,NaN,0.3112476841232719,20.46789940530073,523399,-0.1544578833935023,0.05054913156172347,0.20500701495522577
2025-08-20T14:25:00-04:00,152.09,152.15,151.93,152,NaN,NaN,NaN,153.0323638770032,NaN,NaN,151.92190000000048,154.23968074013735,149.6041192598636,152.91045598392725,151.60483298652613,152.93898900273567,150.2706769703166,362,1586.1333333333334,40.43589026739709,54.116124162162954,NaN,NaN,NaN,NaN,0.304729992400181,20.625938679615235,523037,-0.16486299102667568,-0.0010717238281188202,0.16379126719855686
2025-08-20T14:30:00-04:00,151.93,152.26,151.93,152.26,NaN,NaN,NaN,153.0323638770032,NaN,NaN,151.96310000000048,154.22965411569226,149.6965458843087,152.91045598392725,151.61574654495175,152.93868648087252,150.29280660903098,2307,1595.0333333333333,45.80147537294306,53.298022321871194,NaN,NaN,NaN,NaN,0.30653499294302405,20.35206879981945,525344,-0.1476429816233651,-0.020762459830649505,0.12688052179271558
2025-08-20T14:35:00-04:00,152.21,152.39,152.05,152.31,NaN,NaN,NaN,153.0323638770032,NaN,NaN,152.01430000000047,154.19250661080738,149.83609338919356,152.76436478714183,151.6202276656729,152.93955585723208,150.30089947411372,820,1610.7,46.79407424320559,52.54154386172975,NaN,NaN,NaN,NaN,0.30892535058994913,19.617463846609077,526164,-0.12707598657816704,-0.03196446142999321,0.09511152514817382
2025-08-20T14:40:00-04:00,152.49,152.59,152.35,152.5,NaN,NaN,NaN,153.0323638770032,NaN,NaN,152.06340000000048,154.17137574923717,149.9554242507638,152.66149182971344,151.6268945048118,152.94325966706228,150.3105293425613,907,1593.4666666666667,50.503677981679985,51.60018147902658,NaN,NaN,NaN,NaN,0.3068592541192386,18.250693626912014,527071,-0.09626521682745647,-0.025219995886146762,0.0710452209413097
2025-08-20T14:45:00-04:00,152.5,152.72,152.5,152.72,NaN,NaN,NaN,153.0323638770032,NaN,NaN,152.12280000000047,154.13172823151888,150.11387176848206,152.34919346377075,151.63808667393832,152.9515125305278,150.32466081734884,1298,1609.0666666666666,54.46270536271177,50.95522550141351,NaN,NaN,NaN,NaN,0.3006550216821501,17.324970312654827,528369,-0.05851506119277746,-0.0020986055496621248,0.056416455643115336
2025-08-20T14:50:00-04:00,152.73,152.785,152.6,152.65,NaN,NaN,NaN,153.0323638770032,NaN,NaN,152.18440000000047,154.06096776040246,150.30783223959847,152.1265740060638,151.6559551886139,152.96504789119444,150.34686248603333,2067,1645.0333333333333,53.00981804448487,50.15700196947781,NaN,NaN,NaN,NaN,0.2923939487048538,16.668379702238706,526302,-0.03676811330811815,0.010456314007967649,0.047224427316085796
2025-08-20T14:55:00-04:00,152.57,152.57,152.3,152.3,NaN,NaN,NaN,153.0323638770032,NaN,NaN,152.24140000000048,153.9476895883699,150.53511041163105,152.1265740060638,151.6653494976509,152.96865262835033,150.3620463669515,1560,1636.2666666666667,46.35167873291244,48.97502200150051,NaN,NaN,NaN,NaN,0.29650866665450665,15.899395131147234,524742,-0.043976820852030064,-0.007746598748951783,0.03623022210307828
2025-08-20T15:00:00-04:00,152.37,152.63,152.37,152.52,NaN,NaN,NaN,153.0323638770032,NaN,NaN,152.30560000000048,153.79345031484485,150.81774968515612,152.1265740060638,151.69323057459223,152.98357444488713,150.40288670429734,4178,1711.7,50.55558591848116,48.157010474161154,NaN,NaN,NaN,NaN,0.2989009047506122,14.979614874736855,528920,-0.03248017944665052,-0.004370002205234869,0.02811017724141565
2025-08-20T15:05:00-04:00,152.52,152.82,152.5,152.82,NaN,NaN,NaN,153.0323638770032,NaN,NaN,152.3700000000005,153.64775427972774,151.09224572027324,152.1265740060638,151.7060067282311,152.9932534532011,150.4187600032611,1599,1680.3333333333333,55.658208798771234,47.97333205101379,NaN,NaN,NaN,NaN,0.3004079829827108,14.318315123390338,530519,-0.004682618638025483,0.0222569039438838,0.02693952258190928
2025-08-20T15:10:00-04:00,152.87,153.22,152.87,153.12,152.07530443746253,152.07530443746253,152.07530443746253,NaN,NaN,NaN,152.4308000000005,153.54585221374407,151.3157477862569,152.42710871288375,151.72834815134397,153.01669506525113,150.4400012374368,2126,1720.3333333333333,60.09333843525243,48.638456772042915,NaN,NaN,NaN,NaN,0.30752169848394617,14.790970296033043,532645,0.031885521215477,0.06679642410125552,0.03491090288577853
2025-08-20T15:15:00-04:00,153.14,153.31,153.14,153.31,152.27347241757786,NaN,NaN,NaN,NaN,NaN,152.4822000000005,153.51462851537434,151.44977148462664,152.580686970307,151.76599093040375,153.06015243026198,150.4718294305455,3285,1769.0666666666666,62.64189871826134,49.61250839910066,NaN,NaN,NaN,NaN,0.2991272914493784,15.442381987133908,535930,0.06494131121025223,0.11608754189859383,0.05114623068834159
2025-08-20T15:20:00-04:00,153.21,153.55,153.21,153.55,152.4253600349607,NaN,NaN,NaN,NaN,NaN,152.53260000000049,153.52166671128919,151.54353328871179,152.7965495762456,151.81030340823744,153.11510181147662,150.50550500499827,3626,1837.2666666666667,65.62795006260619,50.987070722444464,NaN,NaN,NaN,NaN,0.3020467706315659,16.577322934853093,539556,0.09710565803184526,0.17252830322814816,0.0754226451963029
2025-08-20T15:25:00-04:00,153.48,153.5,153.28,153.37,152.4419345788261,NaN,NaN,NaN,NaN,NaN,152.5690000000005,153.54460852772002,151.59339147228098,152.7965495762456,151.9014649572531,153.22014749966675,150.58278241483944,8410,2052.6666666666665,61.64800179601673,52.54689143987988,NaN,NaN,NaN,NaN,0.2997577155864547,17.63119667202091,531146,0.10000041509261612,0.20042316406207306,0.10042274896945694
2025-08-20T15:30:00-04:00,153.36,153.63,153.28,153.61,152.50230118887947,NaN,NaN,NaN,NaN,NaN,152.6030000000005,153.6025699071904,151.60343009281058,152.86479172879717,151.93574808645508,153.26075395587807,150.61074221703208,3167,2122.1666666666665,64.72012771395788,54.16460224633441,NaN,NaN,NaN,NaN,0.3033464501874218,18.89295532303257,534313,0.11097331001845434,0.23913938649252486,0.12816607647407052
2025-08-20T15:35:00-04:00,153.61,153.71,153.48,153.48,152.6542420439304,NaN,NaN,NaN,NaN,NaN,152.6286000000005,153.6508798830928,151.60632011690817,152.98283338303773,151.9710040440157,153.30267906680785,150.63932902122355,3297,2190.1,61.830953349973164,55.692821037946985,NaN,NaN,NaN,NaN,0.29810741803117874,20.234896344826776,531016,0.10256874174102917,0.256377003650357,0.1538082619093278
2025-08-20T15:40:00-04:00,153.43,153.55,153.43,153.55,152.6542420439304,NaN,NaN,NaN,NaN,NaN,152.64420000000047,153.69795587278233,151.5904441272186,152.98283338303773,152.02049946047407,153.35842662788934,150.6825722930588,5037,2266.4,62.794085200990025,56.90657888280748,NaN,NaN,NaN,NaN,0.2853854596003806,21.24297265251316,536053,0.09498909414225373,0.272544629587145,0.17755553544489125
2025-08-20T15:45:00-04:00,153.54,153.73,153.46,153.73,152.685383763168,NaN,NaN,NaN,NaN,NaN,152.67700000000048,153.76136340744998,151.59263659255097,153.08161336514414,152.06483213995162,153.41052125396726,150.71914302593598,4408,2275.0666666666666,65.22411590379221,58.22301042999224,NaN,NaN,NaN,NaN,0.28428649820035207,22.58130891212211,540461,0.09512727215542663,0.29646462563917453,0.2013373534837479
2025-08-20T15:50:00-04:00,153.69,153.8,153.63,153.8,152.82354813756945,NaN,NaN,NaN,NaN,NaN,152.7076000000005,153.82998004231501,151.58521995768598,153.19629069211533,152.15135781417797,153.51344307967162,150.78927254868432,8752,2554,66.15002498654704,59.3406066446256,NaN,NaN,NaN,NaN,0.27612317690032806,23.97272696419587,549213,0.09285883290781655,0.31741089461851857,0.22455206171070202
2025-08-20T15:55:00-04:00,153.82,153.91,153.53,153.61,152.82354813756945,NaN,NaN,NaN,NaN,NaN,152.73720000000048,153.8750438554594,151.59935614454156,153.23703255369225,152.26813064509102,153.63893970791557,150.89732158226647,14009,2982.8333333333335,61.37350769521597,59.83423538266162,NaN,NaN,NaN,NaN,0.28354294997887575,25.494175791704272,535204,0.07239665126265424,0.3150478757890198,0.2426512245263656
2025-08-21T09:30:00-04:00,152.63,153,152.37,152.64,NaN,NaN,NaN,153.715806345727,153.715806345727,153.715806345727,152.7622000000005,153.83353031292228,151.6908696870787,153.23703255369225,152.67,152.67,152.67,5069,3104.3333333333335,43.93254305210408,59.18585859749156,NaN,NaN,NaN,NaN,0.35186131069467097,24.448252162986257,530135,-0.008339138662298962,0.2322273011984919,0.24056643986079085
2025-08-21T09:35:00-04:00,152.63,153.26,152.62,153.26,NaN,NaN,NaN,153.715806345727,NaN,NaN,152.80120000000048,153.79758257682195,151.804817423179,153.23703255369225,152.71484126984126,152.83682271169693,152.5928598279856,685,3077.866666666667,53.10561923511907,59.66828291907775,NaN,NaN,NaN,NaN,0.37244264564505064,22.801643184408015,530820,-0.021131862991789874,0.21415161112105352,0.2352834741128434
2025-08-21T09:40:00-04:00,152.84,152.84,152.5,152.69,NaN,NaN,NaN,153.715806345727,NaN,NaN,152.81660000000048,153.7813267796615,151.85187322033946,153.23703255369225,152.7123310061157,152.8306127174296,152.5940492948018,405,3041.5,45.70254100581496,59.321636853887306,NaN,NaN,NaN,NaN,0.40012531381326066,21.55911429578638,530415,-0.06656343048637958,0.15207918600486892,0.2186426164912485
2025-08-21T09:45:00-04:00,152.21,152.3,151.8,152.18,NaN,NaN,NaN,153.24634274678607,NaN,NaN,152.8212000000005,153.77143904328574,151.87096095671524,153.23703255369225,152.63610193621867,152.86771018799806,152.40449368443927,865,3014.766666666667,40.29057202755183,58.22394851308592,NaN,NaN,NaN,NaN,0.4351163628265982,21.780393336451482,529550,-0.1260900233656658,0.06103008728416626,0.18712011064983206
2025-08-21T09:50:00-04:00,152.67,152.72,152.34,152.34,NaN,NaN,NaN,153.24634274678607,NaN,NaN,152.8238000000005,153.7680278535397,151.87957214646127,153.23703255369225,152.61469071310117,152.83837144330957,152.39100998289277,1016,2980.0666666666666,42.58754334436069,56.973534578022225,NaN,NaN,NaN,NaN,0.44260805119612634,20.95106671930102,530566,-0.1482854033018181,0.0017633565225594339,0.15004875982437754
2025-08-21T09:55:00-04:00,152.26,152.26,151.94,151.94,NaN,NaN,NaN,153.24634274678607,NaN,NaN,152.80980000000048,153.78477068642684,151.83482931357412,153.23703255369225,152.55336957727727,152.828511973686,152.27822718086853,973,2949.2,38.590675954689885,55.25559009490998,NaN,NaN,NaN,NaN,0.439564618967832,20.86434004281099,529593,-0.18131870300737057,-0.07659961893483569,0.10471908407253488
2025-08-21T10:00:00-04:00,152.02,152.06,151.67,152.06,NaN,NaN,NaN,153.07785031724134,NaN,NaN,152.7952000000005,153.79252634546526,151.79787365453575,153.23703255369225,152.5153750781413,152.82087505809037,152.2098750981922,585,2880.6666666666665,40.39787033200863,53.453441542724434,NaN,NaN,NaN,NaN,0.4360242890415593,21.19576212763537,530178,-0.18581489351708452,-0.12754953282382075,0.058265360693263754
2025-08-21T10:05:00-04:00,152.93,153,152.9,153,NaN,NaN,NaN,153.07785031724134,NaN,NaN,152.7964000000005,153.79456439496872,151.79823560503226,153.23703255369225,152.53983412166602,152.85401854730185,152.2256496960302,550,2868.9,52.251723442524025,52.78227880318924,NaN,NaN,NaN,NaN,0.4720225541100192,19.762609495850878,530728,-0.11943488504313787,-0.09102824561065859,0.028406639432479282
2025-08-21T10:10:00-04:00,153.07,153.07,153.07,153.07,NaN,NaN,NaN,153.07785031724134,NaN,NaN,152.80600000000047,153.80527173452506,151.80672826547587,153.23703255369225,152.54500748113455,152.861968989694,152.2280459725751,100,2849.9333333333334,53.00133819604349,51.945222409052505,NaN,NaN,NaN,NaN,0.4433066573878745,18.55001013824766,530828,-0.06735994913750888,-0.055793296989406826,0.011566652148102059
2025-08-21T10:15:00-04:00,153.08,153.11,153.05,153.05,151.89104744665931,151.89104744665931,151.89104744665931,NaN,NaN,NaN,152.81760000000048,153.8144635610672,151.82073643893375,152.0754591321109,152.55604095019743,152.87856837833036,152.2335135220645,220,2785.733333333333,52.74654309940413,51.296335962583285,NaN,NaN,NaN,NaN,0.4159276104315979,17.494808271167976,530608,-0.03257107256629094,-0.029147188559761616,0.0034238840065293243
2025-08-21T10:20:00-04:00,153.12,153.27,153.12,153.27,152.0300907445384,NaN,NaN,NaN,NaN,NaN,152.83300000000048,153.83354585072132,151.83245414927964,152.33236730568873,152.60290656722603,152.95731010258007,152.248503031872,795,2749.266666666667,55.292560664409805,50.76051278139899,NaN,NaN,NaN,NaN,0.40193278111505515,16.804087120573996,531403,0.0049500218840255765,0.009611411361561295,0.004661389477535719
2025-08-21T10:25:00-04:00,153.3,153.62,153.17,153.62,152.22167752887756,NaN,NaN,NaN,NaN,NaN,152.85600000000048,153.8748149976246,151.83718500237634,152.64489384455098,152.6889640648326,153.11364052968054,152.26428759998464,1241,2778.5666666666666,59.07081312371205,50.3209911542504,NaN,NaN,NaN,NaN,0.4053661538925524,16.756306682539936,532644,0.050501713992512506,0.06778853196817636,0.017286817975663848
2025-08-21T10:30:00-04:00,153.34,153.34,153.08,153.08,152.22167752887756,NaN,NaN,NaN,NaN,NaN,152.86440000000047,153.88353814539084,151.8452618546101,152.64489384455098,152.69399171744348,153.11923097196797,152.268752462919,133,2706.1,51.79752803558519,49.29581280061027,NaN,NaN,NaN,NaN,0.41498285718594097,16.509872378575707,532511,0.041786109744324076,0.06951945515606894,0.027733345411744867
2025-08-21T10:35:00-04:00,153.17,153.17,152.98,152.98,152.22167752887756,NaN,NaN,NaN,NaN,NaN,152.87740000000048,153.88546198191793,151.86933801808303,152.64489384455098,152.6968160648875,153.12148670444356,152.27214542533147,103,2682.2,50.55609832463411,48.52314070271156,NaN,NaN,NaN,NaN,0.3989126531012307,16.051822131130493,532408,0.027498234931728503,0.0621061390764055,0.034607904144676994
2025-08-21T10:40:00-04:00,152.87,153,152.82,153,152.22167752887756,NaN,NaN,NaN,NaN,NaN,152.88340000000048,153.89073795688458,151.87606204311638,152.64489384455098,152.70948189484128,153.1264613650183,152.29250242466426,700,2675.3,50.810022705419804,49.01438924937697,NaN,NaN,NaN,NaN,0.38327603502257185,15.26057204873402,533108,0.01806220850787789,0.05718566477952436,0.03912345627164647
2025-08-21T10:45:00-04:00,152.88,152.97,152.8,152.8,152.22167752887756,NaN,NaN,NaN,NaN,NaN,152.88320000000047,153.8906001386565,151.87579986134443,152.64489384455098,152.7134460372623,153.12546146967537,152.3014306048492,372,2644.4333333333334,48.14717016131052,48.660214315533494,NaN,NaN,NaN,NaN,0.3701848896638159,14.479166020036196,532736,-0.0019191747111053092,0.036724487882764834,0.03864366259387014
2025-08-21T10:50:00-04:00,152.95,152.98,152.95,152.98,152.22167752887756,NaN,NaN,NaN,NaN,NaN,152.89220000000046,153.89484681688114,151.88955318311977,152.64489384455098,152.7171079550861,153.12730274705783,152.3069131631144,200,2582.2,50.65373645686692,49.01387113346578,NaN,NaN,NaN,NaN,0.3566002546878275,13.77640485857812,532936,-0.0032076397076708854,0.03463411295928154,0.03784175266695242
2025-08-21T11:00:00-04:00,153.41,153.41,153.355,153.355,152.28681273896382,NaN,NaN,NaN,NaN,NaN,152.90510000000046,153.91461174307722,151.8955882569237,152.64489384455098,152.72198885504477,153.1345266414434,152.30945106864615,105,2533.7,55.48194841436589,50.09896944680963,NaN,NaN,NaN,NaN,0.3618430936386975,14.03635985234013,533041,0.019739553063945897,0.0625161939968848,0.0427766409329389
2025-08-21T11:05:00-04:00,153.12,153.2,153.03,153.2,152.28681273896382,NaN,NaN,NaN,NaN,NaN,152.91430000000045,153.9260074870763,151.9025925129246,152.64489384455098,152.77523382222498,153.1854537898076,152.36501385464234,2042,2462.5,53.16639716018402,50.854601862225586,NaN,NaN,NaN,NaN,0.3592114440930754,13.45312476540022,530999,0.02280590458076668,0.07128402165889725,0.048478117078130566
2025-08-21T11:10:00-04:00,152.98,152.98,152.54,152.54,152.28681273896382,NaN,NaN,NaN,NaN,NaN,152.91010000000048,153.92623481357978,151.89396518642118,152.64489384455098,152.77377827824782,153.18076923217725,152.36678732431838,270,2418.2,44.62584304886392,51.28568522609516,NaN,NaN,NaN,NaN,0.3806963409435698,13.113891187403674,530729,-0.01902931275610415,0.02469147613300038,0.04372078888910453
2025-08-21T11:15:00-04:00,152.56,152.82,152.56,152.82,152.28681273896382,NaN,NaN,NaN,NaN,NaN,152.90090000000046,153.91178810429128,151.89001189570965,152.64489384455098,152.7704545623836,153.1605222371377,152.3803868876295,1471,2396.366666666667,48.411981113154084,51.8581217104627,NaN,NaN,NaN,NaN,0.37350374516188634,12.798888579264023,532200,-0.026782916698687716,0.010242143015744887,0.0370250597144326
2025-08-21T11:20:00-04:00,152.94,153.28,152.94,153.28,152.28681273896382,NaN,NaN,NaN,NaN,NaN,152.90110000000047,153.91228403833566,151.88991596166528,152.62991617198597,152.7721077422346,153.1621977524197,152.3820177320495,75,2289.366666666667,53.97908187424737,51.9815044555858,NaN,NaN,NaN,NaN,0.379682049078895,12.275075839188874,532275,-0.0012201457334372334,0.03549987754763606,0.036720023281073294
2025-08-21T11:25:00-04:00,153.15,153.15,153.1,153.1,152.28681273896382,NaN,NaN,NaN,NaN,NaN,152.89650000000046,153.90191384483748,151.89108615516344,152.62991617198597,152.77694604428356,153.1664035007111,152.387488587856,256,2177.0333333333333,51.631119514723856,51.8836316926344,NaN,NaN,NaN,NaN,0.3654190455732601,11.788678294833378,532019,0.0030441169997662554,0.04052516953078111,0.03748105253101486
2025-08-21T11:30:00-04:00,153.12,153.37,153.12,153.37,152.28681273896382,NaN,NaN,NaN,NaN,NaN,152.89850000000047,153.9072700428786,151.88972995712234,152.62991617198597,152.80143264929595,153.19674567324847,152.40611962534342,920,1927.3666666666666,54.806648825555364,52.030782101645194,NaN,NaN,NaN,NaN,0.35860339946088515,11.79231070184097,532939,0.022446358254494835,0.0655390003491334,0.04309264209463857
2025-08-21T11:35:00-04:00,153.27,153.27,153.26,153.26,152.28681273896382,NaN,NaN,NaN,NaN,NaN,152.8991000000005,153.9086933633677,151.88950663663329,152.62991617198597,152.839091810145,153.23847626688436,152.43970735340562,1700,1878.4666666666667,53.27215907068053,51.88646770209311,NaN,NaN,NaN,NaN,0.3408460137851086,11.795683651205161,531239,0.02601782158627365,0.07561491907748064,0.049597097491206985
2025-08-21T11:40:00-04:00,153.25,153.45,153.25,153.45,152.31590242257013,NaN,NaN,NaN,NaN,NaN,152.9069000000005,153.92731342570633,151.88648657429465,152.781974211193,152.87893383115536,153.28872307011306,152.46914459219767,1647,1823.4666666666667,55.58530498347969,51.63750283493365,NaN,NaN,NaN,NaN,0.33078558422902865,12.177480482364041,532886,0.03856563726670396,0.09780414407458693,0.05923850680788297
2025-08-21T11:50:00-04:00,152.84,152.84,152.84,152.84,152.31590242257013,NaN,NaN,NaN,NaN,NaN,152.91010000000048,153.92864894795133,151.89155105204964,152.781974211193,152.87881650861178,153.28799342070775,152.4696395965158,68,1657.8333333333333,47.46197592115061,51.32782054104547,NaN,NaN,NaN,NaN,0.3507294710698113,11.456455023558448,532818,0.004939849523694598,0.06541331871250122,0.060473469188806625
2025-08-21T11:55:00-04:00,152.645,152.7,152.645,152.7,152.31590242257013,NaN,NaN,NaN,NaN,NaN,152.91250000000048,153.9284886807345,151.89651131926647,152.781974211193,152.87572072465034,153.28241158920233,152.46902986009835,360,1522.9,45.80737838036656,50.98862625931207,NaN,NaN,NaN,NaN,0.33960593742196715,10.9397649765254,532458,-0.025880895878310405,0.028122349340918618,0.05400324521922902
2025-08-21T12:00:00-04:00,152.5,152.63,152.5,152.58,152.31590242257013,NaN,NaN,NaN,NaN,NaN,152.91550000000046,153.9266463788218,151.90435362117913,152.781974211193,152.8703107816673,153.27539756161167,152.46522400172296,413,1244.9333333333334,44.379259040396526,50.5292859975247,NaN,NaN,NaN,NaN,0.3296340847489687,10.7824429252467,532045,-0.05199247960760639,-0.010987354290278972,0.04100512531732742
2025-08-21T12:05:00-04:00,152.43,152.43,152.43,152.43,152.31590242257013,NaN,NaN,NaN,NaN,NaN,152.92410000000046,153.9109772767594,151.93722272324152,152.781974211193,152.8638052823392,153.26938258160277,152.45822798307563,350,789.6333333333333,42.591746060221695,50.13246999030407,NaN,NaN,NaN,NaN,0.31680307869547136,10.792281048430198,531695,-0.07557966820213627,-0.05346945993534291,0.02211020826679335
2025-08-21T12:10:00-04:00,152.27,152.57,152.27,152.49,NaN,NaN,NaN,153.4169607162636,153.4169607162636,153.4169607162636,152.93170000000046,153.89904194543612,151.9643580545648,152.781974211193,152.85416278270435,153.2599732354786,152.4483523299301,556,639.2,43.5708246097844,49.626547715512466,NaN,NaN,NaN,NaN,0.31560285878865074,11.155215368221928,532251,-0.08277416467602566,-0.08135749757823874,0.0014166670977869313
2025-08-21T12:15:00-04:00,152.57,152.72,152.57,152.72,NaN,NaN,NaN,153.4169607162636,NaN,NaN,152.94610000000048,153.87833449804717,152.0138655019538,152.781974211193,152.8514977710933,153.25496116399603,152.44803437819058,356,628.2333333333333,47.28241445753008,49.040866718595616,NaN,NaN,NaN,NaN,0.30948836887517495,11.052283399197261,532607,-0.06827923000061084,-0.08393237040297663,-0.015653140402365782
2025-08-21T12:20:00-04:00,152.68,152.69,152.6,152.65,NaN,NaN,NaN,153.4169607162636,NaN,NaN,152.95390000000046,153.86941797328015,152.03838202672077,152.781974211193,152.8382436730918,153.23167554285797,152.44481180332562,1702,671.4666666666667,46.284604758539245,48.549310118478125,NaN,NaN,NaN,NaN,0.2959534853840914,10.956703713674356,530905,-0.059939305471003373,-0.09057727224112,-0.030637966770116626
2025-08-21T12:25:00-04:00,152.54,152.54,152.54,152.54,NaN,NaN,NaN,153.4169607162636,NaN,NaN,152.95850000000047,153.86327897819027,152.05372102181067,152.781974211193,152.8371140905705,153.230227302075,152.444000879066,100,645.9666666666667,44.688635582723684,48.55379529946811,NaN,NaN,NaN,NaN,0.282671093570943,11.023147664481463,530805,-0.058310507434406335,-0.10352610106312454,-0.04521559362871821
2025-08-21T12:30:00-04:00,152.37,152.37,152.37,152.37,NaN,NaN,NaN,153.4169607162636,NaN,NaN,152.95590000000047,153.86666163697225,152.04513836302868,152.781974211193,152.83693724050028,153.2300810648563,152.44379341614425,10,612.4333333333333,42.26319212145305,48.11459608577518,NaN,NaN,NaN,NaN,0.27462315831587475,11.515383558121936,530795,-0.06466965613964833,-0.12605266380327862,-0.06138300766363029
2025-08-21T12:35:00-04:00,152.35,152.35,152.35,152.35,NaN,NaN,NaN,153.4169607162636,NaN,NaN,152.94850000000048,153.87272129350302,152.02427870649794,152.1106421180952,152.83418752901906,153.2279141321216,152.4404609259165,150,585,41.97455913613124,47.25713017590975,NaN,NaN,NaN,NaN,0.2564357898647416,12.022839462985395,530645,-0.0659820932270169,-0.14386062419740142,-0.07787853097038452
2025-08-21T12:40:00-04:00,152.45,152.45,152.45,152.45,NaN,NaN,NaN,153.4169607162636,NaN,NaN,152.9445000000005,153.87556014808519,152.0134398519158,152.1106421180952,152.83404295086493,153.22776598112367,152.44031992060619,10,565.8333333333334,44.03268909091272,46.71438514563753,NaN,NaN,NaN,NaN,0.24526180487440247,12.119370489294155,530655,-0.05625404292712492,-0.14819608462929068,-0.09194204170216576
2025-08-21T12:45:00-04:00,152.48,152.52,152.38,152.38,NaN,NaN,NaN,153.27377082728373,NaN,NaN,152.94610000000048,153.87299004705656,152.0192099529444,152.14770800925743,152.8272294788776,153.22112583009877,152.43333312765643,452,562.5666666666667,42.88598218242712,45.86290895684265,NaN,NaN,NaN,NaN,0.23774310452623193,12.209006442295149,530203,-0.05083677800037302,-0.15548801420263203,-0.10465123620225901
2025-08-21T12:50:00-04:00,152.46,152.62,152.46,152.57,NaN,NaN,NaN,153.27377082728373,NaN,NaN,152.9471000000005,153.87225531633612,152.02194468366486,152.20216640740594,152.82446703544957,153.21736206624425,152.4315720046549,272,568.3,46.92613834945376,45.409621762469314,NaN,NaN,NaN,NaN,0.23790431134578746,11.897178808514445,530475,-0.03169695191792182,-0.1442724260996613,-0.11257547418173947
2025-08-21T12:55:00-04:00,152.56,152.56,152.26,152.26,NaN,NaN,NaN,153.23409697279365,NaN,NaN,152.9359000000005,153.88029756423447,151.9915024357665,152.20216640740594,152.82107195674837,153.21452274137462,152.42762117212212,201,567.6666666666666,41.738336791954715,44.42055260593181,NaN,NaN,NaN,NaN,0.2430540033925171,12.233516871930442,530274,-0.036796019807365576,-0.15857049894094644,-0.12177447913358086
2025-08-21T13:00:00-04:00,152.06,152.26,152.04,152.26,NaN,NaN,NaN,152.96663801948483,NaN,NaN,152.91870000000048,153.8802296351834,151.95717036481756,152.20216640740594,152.8154241605094,153.21162672868775,152.41922159233104,247,549.4,41.738336791954715,44.01172123956068,NaN,NaN,NaN,NaN,0.24140728886448007,13.148852062153852,530274,-0.03695291393270014,-0.16796562154945605,-0.1310127076167559
2025-08-21T13:05:00-04:00,152.37,152.43,152.32,152.39,NaN,NaN,NaN,152.96663801948483,NaN,NaN,152.90030000000047,153.86637330951115,151.9342266904898,152.20216640740594,152.80715661315796,153.20405388774654,152.41025933856938,537,525.9333333333333,44.711081785228224,43.93341433990793,NaN,NaN,NaN,NaN,0.23630676823130406,13.304807000575073,530811,-0.025623405177264108,-0.16304196408833604,-0.13741855891107194
2025-08-21T13:10:00-04:00,152.19,152.19,152.19,152.19,NaN,NaN,NaN,152.96663801948483,NaN,NaN,152.87310000000048,153.84105225054583,151.90514774945512,152.20216640740594,152.80709115550056,153.2040182672395,152.41016404376163,3,521.6,41.225967965883235,43.70817926315698,NaN,NaN,NaN,NaN,0.23371342764335296,13.813321728894469,530808,-0.028689781331167175,-0.1732807855750309,-0.14459100424386373
2025-08-21T13:15:00-04:00,152.06,152.06,151.94,151.94,NaN,NaN,NaN,152.7915096448581,NaN,NaN,152.8445000000005,153.83624643903192,151.85275356096906,152.20216640740594,152.79849672287918,153.20216553354365,152.3948279122147,297,528.0666666666667,37.310957893559774,43.33098010839541,NaN,NaN,NaN,NaN,0.2348767542402563,14.915034874390301,530511,-0.043743968122589905,-0.19927096439710112,-0.15552699627451122
2025-08-21T13:20:00-04:00,151.91,151.91,151.91,151.91,NaN,NaN,NaN,152.7915096448581,NaN,NaN,152.81050000000047,153.81146003883717,151.80953996116378,152.20216640740594,152.79539897264252,153.20175243014586,152.38904551513917,100,508.06666666666666,36.85861583137305,42.851536624223165,NaN,NaN,NaN,NaN,0.22024270036595237,16.009376720487232,530411,-0.05138312963991232,-0.21975590832440162,-0.1683727786844893
2025-08-21T13:25:00-04:00,152.04,152.12,152.04,152.12,NaN,NaN,NaN,152.7915096448581,NaN,NaN,152.78330000000048,153.78392302559564,151.78267697440532,152.20216640740594,152.79293541326476,153.20069419491924,152.38517663161028,101,499.03333333333336,42.14606495653327,42.48465451700911,NaN,NaN,NaN,NaN,0.21951107891124205,16.13114749008144,530512,-0.03854088763603994,-0.21654888822953922,-0.17800800059349928
2025-08-21T13:30:00-04:00,152.17,152.35,152.17,152.35,NaN,NaN,NaN,152.7915096448581,NaN,NaN,152.7593000000005,153.7426290595232,151.7759709404778,152.20216640740594,152.78905160823248,153.19761186341185,152.38049135305312,224,499.8333333333333,47.346640555259626,42.56051421677485,NaN,NaN,NaN,NaN,0.2202602875604383,15.387828018863955,530736,-0.012170314487191136,-0.19322089370248818,-0.18105057921529705
2025-08-21T13:35:00-04:00,152.42,152.55,152.42,152.5,NaN,NaN,NaN,152.7915096448581,NaN,NaN,152.73470000000052,153.68048731187423,151.7889126881268,152.20216640740594,152.78371537888535,153.1905449431397,152.37688581463098,527,513.9,50.47347219824904,42.97371683216952,NaN,NaN,NaN,NaN,0.21881312416326537,14.537362546253016,531263,0.01621949101937764,-0.160776215441075,-0.17699570646045265
2025-08-21T13:40:00-04:00,152.59,152.59,152.47,152.49,NaN,NaN,NaN,152.7915096448581,NaN,NaN,152.7085000000005,153.60614636652204,151.81085363347896,152.14737258217596,152.7826526597419,153.18901987703188,152.37628544245192,118,449.76666666666665,50.259189396225096,43.54485949465323,NaN,NaN,NaN,NaN,0.2117550438658896,13.874562374659877,531145,0.0341388780204,-0.13432210893495267,-0.16846098695535267
2025-08-21T13:45:00-04:00,152.57,152.63,152.54,152.63,NaN,NaN,NaN,152.7915096448581,NaN,NaN,152.6889000000005,153.5489634623858,151.8288365376152,152.20589806574077,152.7818004318978,153.18740955481945,152.37619130897616,139,445.4,53.25148615910662,44.35035428200862,NaN,NaN,NaN,NaN,0.20662968358975364,13.390661372229657,531284,0.05405108583495352,-0.10089712966166076,-0.15494821549661428
2025-08-21T13:50:00-04:00,152.58,152.58,152.58,152.58,NaN,NaN,NaN,152.7915096448581,NaN,NaN,152.6877000000005,153.54820034244133,151.82719965755965,152.21571845259263,152.78175302593016,153.18732629546508,152.37617975639523,7,396.6,52.04723758570455,44.922822031636606,NaN,NaN,NaN,NaN,0.19544184904762715,12.941324727115882,531277,0.061919974807674444,-0.07754824698702123,-0.13946822179469567
2025-08-21T13:55:00-04:00,152.49,152.6,152.49,152.6,NaN,NaN,NaN,152.7915096448581,NaN,NaN,152.6745000000005,153.51958993564776,151.82941006435325,152.2535747620741,152.77934627724306,153.18332284532912,152.375369709157,332,405.1666666666667,52.50986618377934,45.61024231744748,NaN,NaN,NaN,NaN,0.18933885982993842,12.154748460353504,531609,0.06615395300505773,-0.05677578053837351,-0.12292973354343124
2025-08-21T14:00:00-04:00,152.65,152.75,152.65,152.66,NaN,NaN,NaN,152.7915096448581,NaN,NaN,152.67390000000051,153.51898766366955,151.82881233633148,152.39785980965928,152.77834821721714,153.18025755255775,152.37643888187654,328,407.56666666666666,53.94534990020186,46.11161457107234,NaN,NaN,NaN,NaN,0.1865289412706575,11.982971221795017,531937,0.07028961572721203,-0.03506771388441621,-0.10535732961162823
2025-08-21T14:05:00-04:00,152.67,152.67,152.48,152.48,NaN,NaN,NaN,152.7915096448581,NaN,NaN,152.67990000000052,153.51507780101088,151.84472219899015,152.39785980965928,152.777410616961,153.17879092366306,152.37603031025893,122,380.96666666666664,49.145933775755296,46.640728641343806,NaN,NaN,NaN,NaN,0.18677687403703896,11.12814731798738,531815,0.058670414371800816,-0.03201931164687721,-0.09068972601867803
2025-08-21T14:10:00-04:00,152.44,152.57,152.44,152.57,NaN,NaN,NaN,152.7915096448581,NaN,NaN,152.6845000000005,153.51465721362493,151.85434278637607,152.39785980965928,152.7764305103149,153.1773310153387,152.3755300052911,120,328.3,51.4707705936636,47.335902484323015,NaN,NaN,NaN,NaN,0.182721383034393,10.489209178994873,531935,0.054882514658479445,-0.022086582695578727,-0.07696909735405817
2025-08-21T14:20:00-04:00,152.7,152.7,152.64,152.64,NaN,NaN,NaN,152.7915096448581,NaN,NaN,152.6985000000005,153.5011163462807,151.89588365372032,152.39785980965928,152.77602988595297,153.17629814051307,152.37576163139286,106,276.93333333333334,53.26051465693491,47.946576260873485,NaN,NaN,NaN,NaN,0.17895556996050746,10.105460266545048,532041,0.05480024943023448,-0.008468785566265069,-0.06326903499649955
2025-08-21T14:25:00-04:00,152.7,152.7,152.7,152.7,NaN,NaN,NaN,152.7915096448581,NaN,NaN,152.7113000000005,153.49291578752428,151.92968421247673,152.39785980965928,152.77579369188618,153.17546212386293,152.37612525990943,96,277.8666666666667,54.79927446765663,48.916098153857305,NaN,NaN,NaN,NaN,0.1704587435347571,9.74912199069878,532137,0.056281839094780794,0.007083263871976442,-0.04919857522280435
2025-08-21T14:30:00-04:00,152.62,152.62,152.62,152.62,NaN,NaN,NaN,152.7915096448581,NaN,NaN,152.7037000000005,153.48131895508502,151.926081044916,152.39785980965928,152.77529116401095,153.17441226488722,152.37617006313468,100,269.2,52.32569789875663,49.98857958279994,NaN,NaN,NaN,NaN,0.16399740471084476,9.053993026771542,532037,0.04960320470041868,0.012805430652718996,-0.03679777404769968
2025-08-21T14:35:00-04:00,152.78,152.78,152.78,152.78,NaN,NaN,NaN,152.7915096448581,NaN,NaN,152.69790000000052,153.46880100487948,151.92699899512155,152.46545496194332,152.7752914677676,153.17439969702534,152.37618323850987,2,255.5,56.55000035831853,51.395107049010335,NaN,NaN,NaN,NaN,0.16371187580292704,9.084130262352637,532039,0.053363188585604605,0.029906211684306072,-0.023456976901298533
2025-08-21T14:40:00-04:00,152.78,152.78,152.74,152.74,NaN,NaN,NaN,152.7915096448581,NaN,NaN,152.6917000000005,153.45613341064862,151.9272665893524,152.50836396955467,152.77486233213162,153.17006305023892,152.37966161402431,618,264.43333333333334,55.23238351089043,52.329844088607274,NaN,NaN,NaN,NaN,0.15487531324557452,8.917894679137888,531421,0.05058363334586431,0.03977256478103186,-0.010811068564832455
2025-08-21T14:45:00-04:00,152.6,152.6,152.52,152.52,NaN,NaN,NaN,152.7915096448581,NaN,NaN,152.6767000000005,153.42440478087136,151.92899521912963,152.50836396955467,152.77484790032887,153.1700402878063,152.37965551285143,2,245.96666666666667,48.534271372030744,52.41467486123378,NaN,NaN,NaN,NaN,0.15952707658517626,8.776212133623087,531419,0.03224846073360232,0.02949950735217044,-0.002748953381431876
2025-08-21T14:50:00-04:00,152.83,152.83,152.83,152.83,152.1911904080273,152.1911904080273,152.1911904080273,NaN,NaN,NaN,152.6609000000005,153.3600128373245,151.96178716267653,152.50836396955467,152.77502348305754,153.1695985322485,152.38044843386658,101,237.46666666666667,56.533327127702925,52.847521641909054,NaN,NaN,NaN,NaN,0.1702751425433781,8.617748319401722,531520,0.03887434961857598,0.0458439836417881,0.00696963402321212
2025-08-21T14:55:00-04:00,152.86,152.94,152.8,152.94,152.28850623297717,NaN,NaN,NaN,NaN,NaN,152.6581000000005,153.351574988225,151.964625011776,152.536522352412,152.7765075116202,153.16882108474474,152.38419393849566,403,194.16666666666666,58.970214828303554,53.469737744200366,NaN,NaN,NaN,NaN,0.16811263236170726,8.877873516632837,531923,0.04794587295999285,0.06690197522320318,0.01895610226321033
2025-08-21T15:00:00-04:00,152.97,153.12,152.97,153.12,152.4653923132964,NaN,NaN,NaN,NaN,NaN,152.66090000000048,153.36065335606492,151.96114664393605,152.7072178819296,152.7785756376973,153.17027462825234,152.38687664714223,228,198.43333333333334,62.659357158180235,54.141728529848486,NaN,NaN,NaN,NaN,0.16896173005015722,9.727900812238964,532151,0.06243268647968438,0.0969969603628158,0.03456427388313142
2025-08-21T15:05:00-04:00,153.13,153.18,153.13,153.18,152.59355629905565,NaN,NaN,NaN,NaN,NaN,152.6645000000005,153.37299206016618,151.9560079398348,152.8197743055437,152.78362187112387,153.17519810638157,152.39204563586617,430,212.43333333333334,63.82690651080725,54.9831334530701,NaN,NaN,NaN,NaN,0.16117874933228898,10.70779180198802,532581,0.07175385988899975,0.12425659874438111,0.052502738855381356
2025-08-21T15:15:00-04:00,153.16,153.18,153.16,153.18,152.63134919455314,NaN,NaN,NaN,NaN,NaN,152.6721000000005,153.39426366517353,151.9499363348275,152.88181944443494,152.78481872269694,153.17638741548362,152.39325002991026,101,210.8,63.82690651080725,55.791493476429245,NaN,NaN,NaN,NaN,0.15109455295141191,11.61769057818357,532581,0.07335607744956826,0.14419783566734168,0.07084175821777342
2025-08-21T15:20:00-04:00,153.05,153.06,152.98,153.03,152.63134919455314,NaN,NaN,NaN,NaN,NaN,152.67310000000052,153.3971024580684,151.94909754193264,152.88181944443494,152.7892460731943,153.17849710061031,152.3999950457783,622,231.2,58.52150430436118,56.11836164815491,NaN,NaN,NaN,NaN,0.15458779916916945,11.537730639389917,531959,0.06029636922152777,0.14621221974468313,0.08591585052315535
2025-08-21T15:25:00-04:00,152.98,153.06,152.9,152.9,152.63134919455314,NaN,NaN,NaN,NaN,NaN,152.66400000000053,153.36454835614038,151.96345164386068,152.88181944443494,152.79602944822722,153.1785470557591,152.41351184069532,1445,264.3,54.308255134896356,56.487098888093556,NaN,NaN,NaN,NaN,0.15497438494279997,11.08618393827646,530514,0.03987038709753575,0.13575383439507505,0.0958834472975393
2025-08-21T15:30:00-04:00,152.87,152.9,152.8,152.82,152.63134919455314,NaN,NaN,NaN,NaN,NaN,152.65640000000053,153.34160081674165,151.97119918325942,152.88181944443494,152.7967264502445,153.17623993539536,152.41721296509365,563,274,51.83506976869731,56.51312025773881,NaN,NaN,NaN,NaN,0.15104764316117097,10.37611907403836,529951,0.018998141453027168,0.11963112411382326,0.1006329826607961
2025-08-21T15:35:00-04:00,152.82,152.82,152.63,152.68,NaN,NaN,NaN,153.25471734894353,153.25471734894353,153.25471734894353,152.65920000000054,153.34361905237273,151.97478094762835,152.88181944443494,152.79354615892305,153.16639268880016,152.42069962904594,1352,312.3666666666667,47.737961675163724,56.118652187612305,NaN,NaN,NaN,NaN,0.1538299543639443,10.420458047298519,528599,-0.0049320163505041925,0.09446796222266585,0.09939997857317004
2025-08-21T15:40:00-04:00,152.58,152.64,152.57,152.61,NaN,NaN,NaN,153.1256392876279,NaN,NaN,152.65500000000054,153.337996339139,151.97200366086207,152.88181944443494,152.79149083040497,153.16279327672564,152.4201883840843,410,317.8,45.78914513120655,55.475071520723006,NaN,NaN,NaN,NaN,0.15069924333794926,10.693650529150297,528189,-0.025045878308818437,0.068092630687147,0.09313850899596543
2025-08-21T15:45:00-04:00,152.65,152.65,152.5,152.58,NaN,NaN,NaN,153.09242841091753,NaN,NaN,152.64100000000056,153.30046948316235,151.98153051683877,152.88181944443494,152.7861633574873,153.1543516744794,152.41797504049524,948,331.5,44.94236452591314,54.947690565519906,NaN,NaN,NaN,NaN,0.150649297385239,11.215888524369412,527241,-0.039103566909195114,0.04425905035947153,0.08336261726866664
2025-08-21T15:50:00-04:00,152.55,152.69,152.55,152.57,NaN,NaN,NaN,153.09242841091753,NaN,NaN,152.63040000000055,153.27692869949482,151.98387130050628,152.88181944443494,152.78479151521447,153.15193507221628,152.41764795821265,289,341.03333333333336,44.64598092857631,54.09740346339545,NaN,NaN,NaN,NaN,0.14988863328629237,11.479378703956533,526952,-0.04726295789556978,0.02428391989920442,0.0715468777947742
2025-08-21T15:55:00-04:00,152.7,152.7,152.48,152.56,NaN,NaN,NaN,153.09242841091753,NaN,NaN,152.61420000000055,153.22541636043115,152.00298363956995,152.88181944443494,152.78021702710936,153.1444962332484,152.41593782097033,880,360.46666666666664,44.33113953547921,53.31874317943751,NaN,NaN,NaN,NaN,0.15489658805155712,12.010799912149832,526072,-0.051189959606848044,0.007559428286214143,0.05874938789306219
2025-08-22T09:30:00-04:00,152.51,152.6,152,152.4,NaN,NaN,NaN,152.87787795957058,NaN,NaN,152.59700000000055,153.18241267433285,152.01158732566824,152.88181944443494,152.33333333333334,152.33333333333334,152.33333333333334,2844,451.93333333333334,39.52806154027819,52.675442477169476,NaN,NaN,NaN,NaN,0.18668968890501692,14.000612068113114,523228,-0.061714299096811864,-0.01839348597795265,0.043320813118859214
2025-08-22T09:35:00-04:00,152.87,152.89,152.73,152.73,152.19157103859172,152.19157103859172,152.19157103859172,NaN,NaN,NaN,152.58260000000055,153.11653347831512,152.048666521686,152.72145555554795,152.4018728266269,152.56356732204523,152.2401783312086,511,465.6,51.257934609714574,52.2986287258846,NaN,NaN,NaN,NaN,0.20835471112608575,14.410511969779419,523739,-0.04441070418624116,-0.012192567113942232,0.032218137072298925
2025-08-22T09:40:00-04:00,152.69,153.31,152.69,153.22,152.325135991383,NaN,NaN,NaN,NaN,NaN,152.59020000000055,153.14881958366618,152.03158041633492,152.70916444443836,152.56308418271047,152.88265557104086,152.24351279438008,1060,493.46666666666664,62.79727526821756,52.571990185878455,NaN,NaN,NaN,NaN,0.23775794604565137,13.539087944746148,524799,-0.0002601349590976923,0.03189296837342681,0.0321531033325245
2025-08-22T09:45:00-04:00,153.47,153.6,153.35,153.6,152.77899344632016,NaN,NaN,NaN,NaN,NaN,152.60820000000055,153.23379654671913,151.98260345328197,152.69209134146473,152.80956779755908,153.30958428647708,152.3095513086411,1539,527.2,68.93869717984589,53.02051447314029,NaN,NaN,NaN,NaN,0.24791809275667595,13.567812702712034,526338,0.05138380174332255,0.09638285551167769,0.04499905376835514
2025-08-22T09:50:00-04:00,153.63,153.64,153.29,153.38,152.77899344632016,NaN,NaN,NaN,NaN,NaN,152.62420000000054,153.2859684181604,151.9624315818407,152.73867307317178,152.87897485685835,153.38990783659318,152.36804187712352,741,547.9666666666667,62.505374776810335,52.92611934928336,NaN,NaN,NaN,NaN,0.2552096575597701,13.382617441207604,525597,0.06660946314047658,0.12826088269395086,0.061651419553474286
2025-08-22T10:00:00-04:00,153.19,156.24,153.11,155.84,153.56845270625453,NaN,NaN,NaN,NaN,NaN,152.69240000000056,153.80757933950494,151.57722066049618,153.95393845853744,153.73252252252254,154.87048366262,152.5945613824251,4294,686.4666666666667,82.34507770158253,54.24884586291017,NaN,NaN,NaN,NaN,0.46055182487692903,16.69852290143218,529891,0.22909022337698542,0.3480141987747061,0.11892397539772065
2025-08-22T10:05:00-04:00,155.93,157.2,155.93,157.16,155.32329576506112,NaN,NaN,NaN,NaN,NaN,152.78580000000056,154.45978011913306,151.11181988086807,154.69115076682994,154.45397402117135,156.08271470922514,152.82523333311755,3433,800.6666666666666,86.47926359951907,56.245828669707166,NaN,NaN,NaN,NaN,0.5247981231000044,20.291641484777873,533324,0.4020758371109535,0.6215187717864126,0.21944293467545903
2025-08-22T10:10:00-04:00,157.18,157.82,157.02,157.82,156.12564595755836,NaN,NaN,NaN,NaN,NaN,152.88780000000054,155.07588149740104,150.69971850260004,155.41292061346397,154.6054364791488,156.32870446370572,152.8821684945919,741,814.3,87.99319543042125,58.65189583367323,NaN,NaN,NaN,NaN,0.5444554000214314,23.88912432462516,534065,0.529541427503168,0.881369719054419,0.351828291551251
2025-08-22T10:15:00-04:00,157.89,158.41,157.21,157.21,156.41084386857844,NaN,NaN,NaN,NaN,NaN,152.97900000000055,155.47788375065596,150.48011624934514,155.88433649077118,154.91552420944723,156.78600321386915,153.0450452050253,1745,861.5333333333333,79.16979338350913,60.60437609187407,NaN,NaN,NaN,NaN,0.591280014305614,27.44326986789573,532320,0.5395386271819852,1.0262515755287325,0.4867129483467473
2025-08-22T10:20:00-04:00,157.27,157.35,156.41,156.95,NaN,NaN,NaN,158.34373994362969,158.34373994362969,158.34373994362969,153.06720000000055,155.798388869203,150.3360111307981,155.88433649077118,155.04756188688276,156.92141549322773,153.1737082805378,1203,897.5666666666667,75.68616610664796,62.60067640840866,NaN,NaN,NaN,NaN,0.6161885847123558,29.136699961942707,531117,0.49649131024317683,1.1073270861507183,0.6108357759075415
2025-08-22T10:25:00-04:00,157.02,157.4,156.67,157.12,NaN,NaN,NaN,158.34373994362969,NaN,NaN,153.16220000000055,156.11150850188133,150.21289149811977,155.88433649077118,155.22035101889713,157.09885801758455,153.34184402020972,1698,950.1666666666666,76.41685768109073,64.78837016197181,NaN,NaN,NaN,NaN,0.6243179715186173,30.73933236414713,532815,0.44876332073346614,1.171789926824374,0.723026606090908
2025-08-22T10:30:00-04:00,157.26,157.91,157.18,157.91,NaN,NaN,NaN,158.34373994362969,NaN,NaN,153.27340000000058,156.49822771000746,150.0485722899937,155.88433649077118,155.32451748026423,157.22780483209846,153.42123012843,881,976,79.5000234264404,67.25677436915234,NaN,NaN,NaN,NaN,0.6361524021244298,32.52745755222667,533696,0.43914768559634765,1.2719612130863425,0.8328135274899948
2025-08-22T10:35:00-04:00,158.01,158.18,158,158,NaN,NaN,NaN,158.34373994362969,NaN,NaN,153.38440000000057,156.86049702960938,149.90830297039176,156.22024822661987,155.46974218154082,157.4207307069895,153.51875365609214,1160,1011.4666666666667,79.823645401376,69.76946468863802,NaN,NaN,NaN,NaN,0.6099986591155427,34.33669162679648,534856,0.40825093222566244,1.343127192772073,0.9348762605464105
2025-08-22T10:40:00-04:00,158.15,158.57,158.08,158.43,156.81218556631615,156.81218556631615,156.81218556631615,NaN,NaN,NaN,153.50540000000058,157.24446771257817,149.76633228742298,156.7171985812959,155.7258074024638,157.76140399306217,153.69021081186543,2124,1078.9333333333334,81.33937410477809,72.41291001501652,NaN,NaN,NaN,NaN,0.6071416120358606,36.222240244391735,536980,0.3864027643389192,1.4178797159700594,1.0314769516311402
2025-08-22T10:45:00-04:00,158.55,158.65,158.49,158.49,157.0959498587563,NaN,NaN,NaN,NaN,NaN,153.62380000000056,157.6040329378153,149.6435670621858,157.05775886503673,155.74634092477572,157.78861601186404,153.7040658376874,176,1084.7333333333333,81.54767794522544,75.41431118679847,NaN,NaN,NaN,NaN,0.5794886397475848,38.01478420616355,537156,0.3468781659225624,1.465074659034343,1.1181964931117807
2025-08-22T10:50:00-04:00,158.74,159,158.6,159,157.32340668335831,NaN,NaN,NaN,NaN,NaN,153.75860000000057,157.9933439307773,149.52385606922383,157.47120709202937,155.85652579159012,157.9434558871001,153.76959569608013,884,1093.6,83.25837207635644,77.70005672013004,NaN,NaN,NaN,NaN,0.5745251654798995,39.86007838568071,538040,0.3262736112714728,1.5260385072011218,1.199764895929649
2025-08-22T10:55:00-04:00,158.94,158.95,158.75,158.75,157.40643365229656,NaN,NaN,NaN,NaN,NaN,153.88840000000056,158.3245160669301,149.45228393307102,157.60196567362348,155.90776905462874,158.01227470586218,153.8032634033953,441,1108.2333333333333,79.37371605655858,78.88408820501152,NaN,NaN,NaN,NaN,0.5513447965170496,41.5735658380895,537599,0.26936283025264474,1.5364684337454548,1.26710560349281
2025-08-22T11:00:00-04:00,159.12,159.4,159.12,159.4,157.79341394082854,NaN,NaN,NaN,NaN,NaN,154.02860000000058,158.70311646261388,149.35408353738728,157.99657253889882,155.96302607867366,158.09415273575488,153.83189942159245,421,1118.9,81.75701531864628,79.79968235778298,NaN,NaN,NaN,NaN,0.5583915967658322,43.394205287177186,538020,0.24950133215588588,1.5789822686876676,1.3294809365317817
2025-08-22T11:05:00-04:00,159.39,159.39,158.99,159,157.79341394082854,NaN,NaN,NaN,NaN,NaN,154.16480000000058,159.01079338002648,149.31880661997468,158.06225803111903,156.13230860136454,158.32447020166697,153.94014700106212,1464,1154.2666666666667,75.94175035587836,80.75942347057357,NaN,NaN,NaN,NaN,0.5477921969968439,44.76366142792711,536556,0.18632556836710035,1.562387896990657,1.3760623286235567
2025-08-22T11:10:00-04:00,159.22,159.33,159.01,159.18,157.79341394082854,NaN,NaN,NaN,NaN,NaN,154.30960000000056,159.3111980805392,149.3080019194619,158.10280642489525,156.22926070084804,158.4513763971619,154.00714500453418,901,1176.7,76.74340588014675,80.35930405475672,NaN,NaN,NaN,NaN,0.5322356114970702,46.03529927290918,537457,0.1359026112643087,1.5459405927039427,1.410037981439634
2025-08-22T11:15:00-04:00,159.18,159.26,159.18,159.26,157.83964467562106,NaN,NaN,NaN,NaN,NaN,154.45660000000055,159.59755494624034,149.31564505376076,158.2382451399162,156.312158758559,158.5579766984068,154.0663408187112,802,1189.1,77.10849614479699,79.68996352227657,NaN,NaN,NaN,NaN,0.49993306781870694,47.216105843249665,538259,0.08942460513756778,1.5218187378615937,1.432394132724026
2025-08-22T11:20:00-04:00,159.23,159.44,159.17,159.17,157.9505699176383,NaN,NaN,NaN,NaN,NaN,154.59760000000057,159.8597677053519,149.33543229464922,158.48759611193293,156.37906954065508,158.64224883111441,154.11589025019575,675,1208.2333333333333,75.66932902685124,78.809687350593,NaN,NaN,NaN,NaN,0.48350927726022863,48.43147379715421,537584,0.03680285212581258,1.4783976978812916,1.441594845755479
2025-08-22T11:25:00-04:00,158.99,159.04,158.96,159.04,157.9505699176383,NaN,NaN,NaN,NaN,NaN,154.73140000000058,160.09735342499795,149.3654465750032,158.48759611193293,156.47968940349517,158.75593044454618,154.20344836244416,1181,1226.8666666666666,73.53439220371196,78.40715869489318,NaN,NaN,NaN,NaN,0.463972900313068,48.93928160174439,536403,-0.019547750860286817,1.4171601571801204,1.4367079080404073
2025-08-22T11:30:00-04:00,159.18,159.28,159.16,159.28,157.9505699176383,NaN,NaN,NaN,NaN,NaN,154.86700000000056,160.3421032866301,149.391896713371,158.48759611193293,156.53558136341556,158.82195750879723,154.2492052180339,639,1200,74.94010612305183,78.3538686960649,NaN,NaN,NaN,NaN,0.4479748360049923,49.60499383041074,537042,-0.051624444156143756,1.3721773528452275,1.4238017970013712
2025-08-22T11:35:00-04:00,159.2,159.35,158.8,158.8,157.9505699176383,NaN,NaN,NaN,NaN,NaN,154.99320000000057,160.53382442683457,149.45257557316657,158.48759611193293,156.60747885461203,158.89762879075153,154.31732891847253,955,1213.0666666666666,67.24698500805553,77.6988777908481,NaN,NaN,NaN,NaN,0.4552623477189202,49.206972718096864,536087,-0.11263626325305465,1.2830064679350528,1.3956427311881074
2025-08-22T11:40:00-04:00,158.92,158.95,158.76,158.85,157.9505699176383,NaN,NaN,NaN,NaN,NaN,155.11760000000058,160.71937052004245,149.5158294799587,158.48759611193293,156.66823393282863,158.9563904230894,154.38007744256785,904,1198.1333333333334,67.61987458392728,76.85029573066859,NaN,NaN,NaN,NaN,0.4363150371675686,48.72789550732281,536991,-0.1545056356099419,1.20251068667568,1.357016322285622
2025-08-22T11:45:00-04:00,158.96,159.02,158.46,158.59,157.9505699176383,NaN,NaN,NaN,NaN,NaN,155.23780000000056,160.87442067547948,149.60117932452164,158.48759611193293,156.8252610563698,159.08840707923616,154.56211503350346,2814,1278.2666666666667,63.56712688022705,75.68911583630081,NaN,NaN,NaN,NaN,0.4451496773698853,47.47738743511636,534177,-0.2016133577028243,1.1049996251570917,1.306612982859916
2025-08-22T11:50:00-04:00,158.62,158.7,158.47,158.48,157.9505699176383,NaN,NaN,NaN,NaN,NaN,155.35540000000054,161.01229697265993,149.69850302734116,158.48759611193293,156.9105568090391,159.14849580766526,154.67261781041293,1885,1309.5,61.87741979965812,74.29897624307796,NaN,NaN,NaN,NaN,0.4297818432720356,46.316201368067524,532292,-0.23950274409557903,1.0072345527404423,1.2467372968360213
2025-08-22T11:55:00-04:00,158.4,158.4,158.23,158.23,157.9505699176383,NaN,NaN,NaN,NaN,NaN,155.46680000000057,161.12636668299322,149.80723331700793,158.48759611193293,156.92392820646057,159.15505511729828,154.69280129562287,374,1312.3333333333333,58.09761679445375,72.6239718751657,NaN,NaN,NaN,NaN,0.4169402830383188,44.59672200094139,531918,-0.27801662975062214,0.8992165096477436,1.1772331393983657
2025-08-22T12:00:00-04:00,158.27,158.56,158.27,158.56,157.9505699176383,NaN,NaN,NaN,NaN,NaN,155.58840000000058,161.24731347868533,149.92948652131582,158.48759611193293,156.93354650762507,159.16099770490618,154.70609531034395,242,1291.0666666666666,61.44550256147739,71.06590976696005,NaN,NaN,NaN,NaN,0.41073026282129693,43.26009097498228,532160,-0.27725507676707206,0.8306642934395256,1.1079193702065977
2025-08-22T12:05:00-04:00,158.49,158.51,158.4,158.46,157.9505699176383,NaN,NaN,NaN,NaN,NaN,155.70620000000056,161.3540865285386,150.05831347146253,158.48759611193293,156.9669320707071,159.18109591799345,154.75276822342073,868,1225.2,59.88410248875879,69.6737945121172,NaN,NaN,NaN,NaN,0.3928209583340612,42.01893359373454,531292,-0.2787260366410542,0.7595118244052799,1.038237861046334
2025-08-22T12:10:00-04:00,158.4,158.48,158.26,158.26,157.9505699176383,NaN,NaN,NaN,NaN,NaN,155.81860000000057,161.44156293418692,150.19563706581422,158.46646151163708,156.982790715088,159.188927602557,154.776653827619,465,1223.6666666666667,56.776622588913796,67.88948074570774,NaN,NaN,NaN,NaN,0.3804766041673425,40.45860592555863,530827,-0.2872656755397036,0.6791557666217045,0.9664214421614081
2025-08-22T12:15:00-04:00,158.18,158.22,157.88,158.05,NaN,NaN,NaN,159.22224354809643,159.22224354809643,159.22224354809643,155.92560000000057,161.51059727477457,150.34060272522657,158.46646151163708,157.00976693265864,159.19427503979026,154.82525882552702,1039,1222.9666666666667,53.62976794149865,66.29576771610918,NaN,NaN,NaN,NaN,0.380442561012532,38.00491328610124,529788,-0.29977160358156696,0.5917069376844495,0.8914785412660164
2025-08-22T12:20:00-04:00,158.1,158.21,158.1,158.21,NaN,NaN,NaN,159.22224354809643,NaN,NaN,156.03740000000056,161.5768509618948,150.49794903810633,158.42416920930967,157.01624151223368,159.1963822162827,154.83610080818465,230,1179.3333333333333,55.64682069300571,64.78886877417055,NaN,NaN,NaN,NaN,0.3646966637973509,35.7264844066051,530018,-0.2898121676709182,0.5292133316773686,0.8190254993482868
2025-08-22T12:25:00-04:00,158,158.08,158,158.08,NaN,NaN,NaN,159.15756075353414,NaN,NaN,156.14340000000055,161.63206994446182,150.6547300555393,158.11433536744772,157.0343608516168,159.19964034549452,154.8690813577391,735,1179.1333333333334,53.60647710561422,63.11015312851463,NaN,NaN,NaN,NaN,0.3536469020975407,33.349367944959354,529283,-0.2841405489028729,0.46384981321969576,0.7479903621225686
2025-08-22T12:30:00-04:00,158.15,158.42,158.15,158.34,NaN,NaN,NaN,159.15756075353414,NaN,NaN,156.25540000000055,161.6899814336743,150.8208185663268,158.07146829395822,157.0440296125055,159.2038648624357,154.88419436257533,323,1046.7666666666667,57.002139291515185,61.776782433133484,NaN,NaN,NaN,NaN,0.352672123376286,31.92343262362035,529606,-0.25591726380320423,0.4280937823685633,0.6840110461717676
2025-08-22T12:35:00-04:00,158.29,158.4,158.17,158.4,NaN,NaN,NaN,159.15756075353414,NaN,NaN,156.37300000000053,161.7331346997313,151.01286530026977,157.82617463516655,157.074461869123,159.21733966904245,154.93158406920358,1033,966.7666666666667,57.7702923899528,60.650775303579266,NaN,NaN,NaN,NaN,0.34390982884940974,30.59934982523413,530639,-0.22721878793951678,0.39998756124737156,0.6272063491868883
2025-08-22T12:40:00-04:00,158.45,158.45,158.24,158.24,NaN,NaN,NaN,159.15756075353414,NaN,NaN,156.48120000000054,161.76881214909537,151.19358785090571,157.81151383749062,157.086046096055,159.22217591364495,154.94991627846503,411,955.7666666666667,54.95106276726752,59.22298649245181,NaN,NaN,NaN,NaN,0.3343448410744504,29.485947641635935,530228,-0.213248901698202,0.36064522206413585,0.5738941237623378
2025-08-22T12:45:00-04:00,158.2,158.29,158.2,158.29,NaN,NaN,NaN,159.15756075353414,NaN,NaN,156.58820000000054,161.80083647679885,151.37556352320223,157.81151383749062,157.1056383280993,159.2291999400107,154.98207671618792,744,922.4,55.678960764777045,58.39669904650334,NaN,NaN,NaN,NaN,0.3168916381405613,28.321364153631457,530972,-0.19535518782841554,0.3297001389768184,0.5250553268052339
2025-08-22T12:50:00-04:00,158.17,158.24,158.09,158.09,NaN,NaN,NaN,159.15756075353414,NaN,NaN,156.68760000000054,161.8208462398817,151.5543537601194,157.81151383749062,157.10846129181397,159.22980959442359,154.98711298920435,122,886.3666666666667,52.055705076371325,57.284972653106486,NaN,NaN,NaN,NaN,0.30854223541623466,26.876164149416148,530850,-0.19144927483233998,0.28574373326480895,0.47719300809714893
2025-08-22T12:55:00-04:00,158.04,158.12,157.85,157.94,NaN,NaN,NaN,158.99209773411397,NaN,NaN,156.78280000000055,161.8281131358963,151.7374868641048,157.81151383749062,157.11699100016983,159.22953469978526,155.0044473005544,447,844.6666666666666,49.45629165106482,56.27705585102347,NaN,NaN,NaN,NaN,0.30578921860079006,25.116960614954326,530403,-0.19288816403420944,0.2360828030543871,0.42897096708859656
2025-08-22T13:00:00-04:00,158.12,158.27,158.12,158.25,NaN,NaN,NaN,158.99209773411397,NaN,NaN,156.88420000000053,161.83877944121065,151.92962055879042,157.81151383749062,157.12475467880628,159.2318116152045,155.01769774240807,322,826.0333333333333,54.511758748760975,55.75093720453082,NaN,NaN,NaN,NaN,0.30751856012930595,23.604007796418333,530725,-0.1678058862589134,0.2192136092649548,0.3870194955238682
2025-08-22T13:05:00-04:00,158.5,158.63,158.5,158.5,NaN,NaN,NaN,158.99209773411397,NaN,NaN,156.99360000000055,161.84338970257957,152.14381029742154,157.94274885426893,157.14553520994502,159.24403458561804,155.047035834272,676,809.9,58.1473892490493,55.75449237985907,NaN,NaN,NaN,NaN,0.31269580583435513,23.126604640022013,531401,-0.13086210554081001,0.22344186359785567,0.3543039691386657
2025-08-22T13:10:00-04:00,158.58,158.66,158.39,158.59,NaN,NaN,NaN,158.99209773411397,NaN,NaN,157.10740000000055,161.8330674617708,152.3817325382303,157.97519908341513,157.16257133682973,159.25391908266116,155.0712235909983,568,758.0333333333333,59.405264276250385,55.608761073771426,NaN,NaN,NaN,NaN,0.3096461054176162,22.32766332444091,531969,-0.09833298360722126,0.2313877396296391,0.32972072323686036
2025-08-22T13:15:00-04:00,158.64,158.64,158.64,158.64,NaN,NaN,NaN,158.99209773411397,NaN,NaN,157.22380000000055,161.8058412742837,152.6417587257174,158.0671592667321,157.1626029625824,159.25393949548902,155.0712664296758,1,752.2,60.12232664382174,55.62577708484735,NaN,NaN,NaN,NaN,0.29109995503064245,21.585789245687025,531970,-0.07260470038953576,0.23896484774994065,0.3115695481394764
2025-08-22T13:20:00-04:00,158.64,158.64,158.64,158.64,NaN,NaN,NaN,158.99209773411397,NaN,NaN,157.3430000000006,161.75287845628424,152.93312154371694,158.1817274133857,157.16269783171728,159.2540007254931,155.07139493794145,3,722.8333333333334,60.122326643821744,55.8647559459122,NaN,NaN,NaN,NaN,0.27030710109988226,20.89690617255842,531970,-0.055513172637383645,0.24217808234274685,0.2976912549801305
2025-08-22T13:25:00-04:00,158.78,158.78,158.77,158.77,NaN,NaN,NaN,158.99209773411397,NaN,NaN,157.46620000000055,161.68011958148614,153.25228041851497,158.34338193070855,157.17525152557732,159.26319814930926,155.08730490184539,367,720.3666666666667,62.13894024930465,56.47255396789835,NaN,NaN,NaN,NaN,0.26099945102132033,20.656009265531974,532337,-0.0363081399705214,0.25230608001697874,0.28861421998750014
2025-08-22T13:30:00-04:00,158.8,158.88,158.71,158.8,NaN,NaN,NaN,158.99209773411397,NaN,NaN,157.59060000000056,161.58153254255322,153.5996674574479,158.44570554456683,157.22180893051143,159.2972999231209,155.14631793790196,1392,752.7333333333333,62.60886050715603,56.96984252605194,NaN,NaN,NaN,NaN,0.2544994902340823,20.706264924904424,533729,-0.02308417570212029,0.2597590003598498,0.28284317606197007
2025-08-22T13:35:00-04:00,158.8,158.81,158.8,158.81,NaN,NaN,NaN,158.99209773411397,NaN,NaN,157.71540000000059,161.45273639898585,153.97806360101532,158.4575644356535,157.22773667625702,159.30160038198494,155.1538729705291,182,710,62.77471713711563,57.62471681401633,NaN,NaN,NaN,NaN,0.2370352409316472,20.7529308943217,533911,-0.015525991062313005,0.26343568723407884,0.27896167829639185
2025-08-22T13:40:00-04:00,158.68,158.68,158.57,158.68,NaN,NaN,NaN,158.99209773411397,NaN,NaN,157.83780000000058,161.2810456547843,154.39455434521687,158.4575644356535,157.24315987749682,159.31092354088761,155.17539621410603,536,697.8333333333334,59.10433321251509,57.774873522659185,NaN,NaN,NaN,NaN,0.2372470094365302,19.839668932391458,533375,-0.020814305917731424,0.25294379589922755,0.273758101816959
2025-08-22T13:45:00-04:00,158.79,158.79,158.68,158.71,NaN,NaN,NaN,158.99209773411397,NaN,NaN,157.9640000000006,161.04418181268312,154.88381818731807,158.4575644356535,157.24769935355746,159.31392223203608,155.18147647507885,151,676.1333333333333,59.690068482456375,57.91200038640944,NaN,NaN,NaN,NaN,0.22815793733391984,19.345179266025767,533526,-0.02361906935109892,0.24423426512808533,0.26785333447918425
2025-08-22T13:50:00-04:00,158.67,158.68,158.67,158.68,NaN,NaN,NaN,158.99209773411397,NaN,NaN,158.0830000000006,160.78120458808453,155.38479541191666,158.4575644356535,157.25064692915933,159.31575562200814,155.18553823631052,102,657.0333333333333,58.78336926621053,58.18573656490537,NaN,NaN,NaN,NaN,0.21471808466721273,18.843766262195246,533424,-0.028495387726070298,0.23223409982159637,0.26072948754766667
2025-08-22T13:55:00-04:00,158.73,158.73,158.73,158.73,NaN,NaN,NaN,158.99209773411397,NaN,NaN,158.1932000000006,160.51124207019248,155.8751579298087,158.4575644356535,157.253632565743,159.31772433383037,155.18954079765564,100,621,59.877287550658,58.48561704961115,NaN,NaN,NaN,NaN,0.20295250719098204,18.549942103884145,533524,-0.029244132080761875,0.2241743224467143,0.2534184545274762
2025-08-22T14:00:00-04:00,158.52,158.61,158.51,158.61,NaN,NaN,NaN,158.99209773411397,NaN,NaN,158.2934000000006,160.20631864938574,156.38048135061544,158.4575644356535,157.26067082881653,159.32151345314534,155.19982820448772,265,608.5333333333333,56.03352738309991,58.76974721437748,NaN,NaN,NaN,NaN,0.20417018524876895,17.334498905345054,533259,-0.038148892144101276,0.20573233934734958,0.24388123149145086
2025-08-22T14:05:00-04:00,158.59,158.6,158.48,158.6,NaN,NaN,NaN,158.99209773411397,NaN,NaN,158.39780000000056,159.69851543359263,157.09708456640848,158.4575644356535,157.28289845635774,159.33297274338534,155.23282416933014,867,605.6,55.71256748468435,59.216624059636025,NaN,NaN,NaN,NaN,0.19887231487385856,16.107235731876624,532392,-0.04459199054653662,0.18814124330828008,0.2327332338548167
2025-08-22T14:10:00-04:00,158.65,158.65,158.65,158.65,NaN,NaN,NaN,158.99209773411397,NaN,NaN,158.45400000000058,159.53146368810454,157.37653631189661,158.4575644356535,157.28292543046183,159.33298848630884,155.23286237461483,1,575.5,57.037657708223364,59.39704541388334,NaN,NaN,NaN,NaN,0.1882385780971552,15.152912589537717,532393,-0.04522371524969965,0.17620358979269213,0.22142730504239178
2025-08-22T14:20:00-04:00,158.49,158.52,158.36,158.36,NaN,NaN,NaN,158.99209773411397,NaN,NaN,158.4780000000006,159.49060851227568,157.46539148772553,158.4575644356535,157.29802159580544,159.33847968898306,155.25756350262782,686,504.56666666666666,48.05654463801149,58.676270798809206,NaN,NaN,NaN,NaN,0.19550725109021497,14.99826922281771,531707,-0.06377479915351655,0.14170880610049608,0.20548360525401263
2025-08-22T14:25:00-04:00,158.46,158.57,158.45,158.57,NaN,NaN,NaN,158.99209773411397,NaN,NaN,158.4930000000006,159.48824670265614,157.49775329734504,158.4575644356535,157.308296010296,159.3433142299505,155.27327779064152,432,456.1333333333333,53.73729243049174,58.271415666969304,NaN,NaN,NaN,NaN,0.19654244744091245,14.63153447542404,532139,-0.060530724199744645,0.1298202000043318,0.19035092420407645
2025-08-22T14:30:00-04:00,158.47,158.47,158.47,158.47,NaN,NaN,NaN,158.99209773411397,NaN,NaN,158.5182000000006,159.44358156407716,157.59281843592404,158.44800239284365,157.31053436095056,159.34422928969337,155.27683943220774,100,447,50.88353325371731,57.611501853390415,NaN,NaN,NaN,NaN,0.18964655833798974,14.29099506712992,532039,-0.0634414397050087,0.11104912457281557,0.17449056427782428
2025-08-22T14:35:00-04:00,158.57,158.57,158.43,158.43,NaN,NaN,NaN,158.99209773411397,NaN,NaN,158.54780000000062,159.3581756160581,157.73742438394314,158.44800239284365,157.32969475871914,159.3520536347194,155.3073358827189,867,467.8333333333333,49.745538264969014,56.87030268347236,NaN,NaN,NaN,NaN,0.18610037559956094,13.501846584452416,531172,-0.06608361841234062,0.09188604126239852,0.15796965967473914
2025-08-22T14:40:00-04:00,158.4,158.44,158.36,158.44,NaN,NaN,NaN,158.99209773411397,NaN,NaN,158.5742000000006,159.27545704213648,157.8729429578647,158.44800239284365,157.33192860024712,159.35279970150856,155.3110574989857,109,442.53333333333336,50.04632262201271,56.00654428152294,NaN,NaN,NaN,NaN,0.1785217773424483,13.069406806986958,531281,-0.06507747495873403,0.07662281597632159,0.14170029093505562
2025-08-22T14:45:00-04:00,158.46,158.54,158.44,158.44,NaN,NaN,NaN,158.99209773411397,NaN,NaN,158.5848000000006,159.2611577745166,157.9084422254846,158.44800239284365,157.334126178162,159.35367083499142,155.31458152133257,102,430.43333333333334,50.04632262201271,55.109220146869845,NaN,NaN,NaN,NaN,0.17291307896084446,12.186895174434346,531281,-0.0623272294657396,0.06379125410288111,0.1261184835686207
2025-08-22T14:55:00-04:00,158.3,158.3,158.19,158.3,NaN,NaN,NaN,158.89223591768595,NaN,NaN,158.5908000000006,159.2514401737204,157.9301598262808,158.35821722513595,157.34747218604653,159.35550709571953,155.33943727637353,772,421.53333333333336,45.61358310246274,53.88342485868035,NaN,NaN,NaN,NaN,0.17841928760649844,12.391216587579112,530509,-0.06742040358766635,0.04184297908403778,0.10926338267170413
2025-08-22T15:00:00-04:00,158.34,158.46,158.34,158.46,NaN,NaN,NaN,158.89223591768595,NaN,NaN,158.5914000000006,159.25150920243752,157.93129079756366,158.35821722513595,157.35378023969818,159.35758028740102,155.34998019199534,318,424.46666666666664,50.959603857093605,53.30165847615024,NaN,NaN,NaN,NaN,0.177103624206034,11.837285637245717,530827,-0.05786372468555048,0.03693372681476603,0.09479745150031652
2025-08-22T15:05:00-04:00,158.48,158.52,158.48,158.52,NaN,NaN,NaN,158.89223591768595,NaN,NaN,158.59200000000058,159.25179390657163,157.93220609342953,158.35821722513595,157.35603604435096,159.35852295480652,155.3535491338954,106,403.5,52.83202433386295,52.811798179822134,NaN,NaN,NaN,NaN,0.16873907961988888,11.059405970887429,530933,-0.04587566187108545,0.037452874161459704,0.08332853603254516
2025-08-22T15:15:00-04:00,158.48,158.48,158.26,158.26,NaN,NaN,NaN,158.89223591768595,NaN,NaN,158.5772000000006,159.2329077391085,157.9214922608927,158.22058929626604,157.36266555441483,159.35996055003298,155.36537055879668,370,405.06666666666666,44.84210828334761,51.815993823903355,NaN,NaN,NaN,NaN,0.17525771678989818,11.201737067394262,530563,-0.05330918129470122,0.016692059414168625,0.07000124070886984
2025-08-22T15:20:00-04:00,158.23,158.3,158.23,158.3,NaN,NaN,NaN,158.87215938335615,NaN,NaN,158.5682000000006,159.2265213798532,157.90987862014796,158.22058929626604,157.37401816645547,159.36145014686963,155.3865861860413,686,393.5,46.190376342149854,50.83835730900991,NaN,NaN,NaN,NaN,0.16773930844776413,11.443395369741006,531249,-0.05325929328229837,0.0034271241059968816,0.05668641738829525
2025-08-22T15:25:00-04:00,158.33,158.35,158.33,158.35,NaN,NaN,NaN,158.87215938335615,NaN,NaN,158.5472000000006,159.16370680380516,157.93069319619605,158.22058929626604,157.37673088381334,159.36204040080978,155.3914213668169,155,384.96666666666664,47.90458156931264,50.25771832231082,NaN,NaN,NaN,NaN,0.15932935784435118,11.41674193812522,531404,-0.04776200033790284,-0.0030160830340832945,0.04474591730381954
2025-08-22T15:30:00-04:00,158.31,158.31,158.17,158.17,NaN,NaN,NaN,158.82427125632245,NaN,NaN,158.5306000000006,159.1421215115922,157.91907848840899,158.22058929626604,157.39348144346928,159.36239982397575,155.42456306296282,1127,397.73333333333335,42.63845271967786,49.323852981953216,NaN,NaN,NaN,NaN,0.16080583228404086,11.999253885850937,530277,-0.05370776011392747,-0.022388782838589805,0.03131897727533767
2025-08-22T15:35:00-04:00,158.09,158.09,158,158,NaN,NaN,NaN,158.62589529012598,NaN,NaN,158.5070000000006,159.10742984531316,157.90657015468804,158.22058929626604,157.40408104079307,159.35823520753965,155.4499268740465,957,425.56666666666666,38.35053044164019,47.98905817719727,NaN,NaN,NaN,NaN,0.16146255854946562,13.106614329548966,529320,-0.06575352960653968,-0.05087293473283694,0.014880594873702746
2025-08-22T15:40:00-04:00,157.96,158.05,157.92,158.05,NaN,NaN,NaN,158.5572182314839,NaN,NaN,158.4828000000006,159.05683888297202,157.90876111702917,158.22058929626604,157.42479666190602,159.3482032307569,155.50139009305514,2046,478.8666666666667,40.253635309695944,47.43170751088902,NaN,NaN,NaN,NaN,0.15921523293879122,14.381329249698702,531366,-0.06680145623680626,-0.06862122542230509,-0.00181976918549882
2025-08-22T15:45:00-04:00,158.09,158.17,158.09,158.17,NaN,NaN,NaN,158.5572182314839,NaN,NaN,158.4628000000006,159.00866503745866,157.91693496254257,158.18246171968823,157.42548417601117,159.34809869587232,155.50286965615,57,470.03333333333336,44.668352640739464,46.78392609733529,NaN,NaN,NaN,NaN,0.15641414487173302,14.897217617372746,531423,-0.056281723480392856,-0.07217192353598989,-0.015890200055597034
2025-08-22T15:50:00-04:00,158.25,158.33,158.21,158.33,NaN,NaN,NaN,158.5572182314839,NaN,NaN,158.4486000000006,158.97005964288155,157.92714035711964,158.18246171968823,157.44522379327697,159.35014390734275,155.54030367921118,1392,493.9,49.97590267100825,46.7190953414275,NaN,NaN,NaN,NaN,0.15667027738089676,14.568642441106322,532815,-0.036382083712235155,-0.06136780469589098,-0.024985720983655826
2025-08-22T15:55:00-04:00,158.365,158.48,158.26,158.45,NaN,NaN,NaN,158.5572182314839,NaN,NaN,158.4320000000006,158.8962413156322,157.96775868436902,158.18246171968823,157.54469752161614,159.37064522390517,155.71874981932712,7118,712.2333333333333,53.57288373921181,46.992477161016275,NaN,NaN,NaN,NaN,0.1611938289965469,13.587437763121205,539933,-0.014116256371933467,-0.04263104144857266,-0.028514785076639192
2025-08-25T09:30:00-04:00,157.5,157.54,156.67,156.67,NaN,NaN,NaN,157.88553520028182,NaN,NaN,158.38940000000062,159.0570814802847,157.72171851971655,158.0890051661035,156.96,156.96,156.96,5163,884.3,24.93344142331074,45.198699932537565,NaN,NaN,NaN,NaN,0.27682284121107936,16.18160817109409,534770,-0.11275594741365359,-0.16945971934370618,-0.05670377193005259
2025-08-25T09:35:00-04:00,156.55,157.05,156.38,157.05,NaN,NaN,NaN,157.55141996390537,NaN,NaN,158.3534000000006,159.10650142688309,157.6002985731181,158.0890051661035,156.9380402308149,156.98749463157858,156.8885858300512,1018,918.1333333333333,33.14965067160793,43.99179479322294,NaN,NaN,NaN,NaN,0.3049069239817177,18.907465483211947,535788,-0.14390287199082108,-0.23658236191857895,-0.09267948992775786
2025-08-25T09:40:00-04:00,156.64,156.79,156.5,156.52,NaN,NaN,NaN,157.51840087463694,NaN,NaN,158.3120000000006,159.22014976690937,157.40385023309184,158.0890051661035,156.9025124126296,157.01571714866347,156.7893076765957,734,930.3666666666667,28.46929688186229,42.7672029203229,NaN,NaN,NaN,NaN,0.3224135722687387,21.4386187016071,535054,-0.18885995516624485,-0.3287544338855639,-0.13989447871931907
2025-08-25T09:45:00-04:00,156.34,156.34,155.91,156.15,NaN,NaN,NaN,157.04188265306254,NaN,NaN,158.26540000000062,159.35523088555595,157.1755691144453,158.0890051661035,156.86394780219783,157.06481753279974,156.66307807159592,365,896.1333333333333,25.737339524764963,40.96561261087085,NaN,NaN,NaN,NaN,0.3429554599638297,24.352794760210607,534689,-0.229474977364641,-0.42673820042512034,-0.19726322306047933
2025-08-25T09:50:00-04:00,156.04,156.04,155.75,155.96,NaN,NaN,NaN,156.82475162337786,NaN,NaN,158.22000000000062,159.48671859508195,156.9532814049193,158.0890051661035,156.80903295376126,157.10401389547155,156.51405201205097,448,905,24.44033670620695,38.937634923181136,NaN,NaN,NaN,NaN,0.3470300699664137,27.1884628784706,534241,-0.25322917390692123,-0.5137996904441309,-0.26057051653720964
2025-08-25T09:55:00-04:00,156.14,156.68,156.02,156.5,NaN,NaN,NaN,156.82475162337786,NaN,NaN,158.17880000000062,159.52980341936234,156.8277965806389,158.0890051661035,156.786809430576,157.08827651781033,156.48534234334167,444,901.9333333333333,34.53740568064167,38.20158473727357,NaN,NaN,NaN,NaN,0.3736707792545269,27.811562230866443,534685,-0.21800604224453457,-0.5330780693428778,-0.31507202709834325
2025-08-25T10:00:00-04:00,156.68,156.88,156.68,156.74,155.78731308696354,155.78731308696354,155.78731308696354,NaN,NaN,NaN,158.14440000000062,159.55144035448427,156.73735964551696,158.0890051661035,156.78551116199202,157.07714311256782,156.4938792114162,563,915.6666666666666,38.47268392929361,37.650320993498134,NaN,NaN,NaN,NaN,0.3741228664506318,27.860323932133728,535248,-0.16631193788631055,-0.5229619494562314,-0.3566500115699209
2025-08-25T10:05:00-04:00,156.93,157.17,156.79,157.17,155.97379885573793,NaN,NaN,NaN,NaN,NaN,158.12260000000063,159.55534176289203,156.68985823710923,158.0890051661035,156.79371277617682,157.08421402444242,156.50321152791122,287,921.8333333333334,44.867549585701354,37.4333901375259,NaN,NaN,NaN,NaN,0.3781140902755852,27.184832670766962,535535,-0.0944996226357413,-0.4747745398645975,-0.3802749172288562
2025-08-25T10:10:00-04:00,157.11,157.43,157.1,157.43,156.2595352713862,NaN,NaN,NaN,NaN,NaN,158.11020000000062,159.55591360896847,156.66448639103277,158.0890051661035,156.83190755208338,157.14320960021325,156.5206055039535,706,942.0333333333333,48.362328302671315,37.842238393454,NaN,NaN,NaN,NaN,0.3746773695416157,25.961521672019256,536241,-0.02447574187577023,-0.410869594573569,-0.38639385269779875
2025-08-25T10:15:00-04:00,157.43,157.48,157.2,157.2,156.3420563954141,NaN,NaN,NaN,NaN,NaN,158.09000000000063,159.55762938071766,156.6223706192836,156.40486219786771,156.85000000000005,157.16800968830023,156.53199031169987,397,946.4333333333333,45.60813826711676,38.3606389524166,NaN,NaN,NaN,NaN,0.3679147002886432,24.71249491122159,535844,0.009541545150834607,-0.3744669212592555,-0.3840084664100901
2025-08-25T10:20:00-04:00,157.1,157.19,157.1,157.19,156.3420563954141,NaN,NaN,NaN,NaN,NaN,158.0722000000006,159.5613140450501,156.58308595495112,156.40486219786771,156.85021417291753,157.1682183250037,156.53221002083137,7,917.7666666666667,45.48684704176173,38.7344397904213,NaN,NaN,NaN,NaN,0.34877793598231116,23.749165719324846,535837,0.033225493320613975,-0.34247659975932265,-0.3757020930799366
2025-08-25T10:25:00-04:00,157.08,157.11,157.08,157.1,156.3420563954141,NaN,NaN,NaN,NaN,NaN,158.0474000000006,159.55898094694507,156.53581905305614,156.40486219786771,156.85762237539095,157.17362510935587,156.54161964142602,314,928.2,44.34384352950245,38.711260568190085,NaN,NaN,NaN,NaN,0.33172236912643077,22.89542893785533,535523,0.044010012460523384,-0.3206895775042824,-0.3646995899648058
2025-08-25T10:30:00-04:00,157.25,157.39,157.25,157.28,156.38575922970793,NaN,NaN,NaN,NaN,NaN,158.02500000000063,159.54816643842622,156.50183356157504,156.61852944530827,156.85963372407005,157.1763506112047,156.5429168369354,47,906.9,47.20142493636042,38.51308358714381,NaN,NaN,NaN,NaN,0.3287421999031137,21.39677451098867,535570,0.063274538584146,-0.2856064167346233,-0.3488809553187693
2025-08-25T10:35:00-04:00,157.51,157.61,157.51,157.52,156.62322471926666,NaN,NaN,NaN,NaN,NaN,158.0106000000006,159.53896859401868,156.48223140598253,156.82782355624664,156.89837200239813,157.244446359323,156.55229764547326,627,913.4,50.82667831688975,38.31692605697795,NaN,NaN,NaN,NaN,0.3288320427671779,20.238306143658154,536197,0.09052913486413561,-0.2357195367385998,-0.3262486716027354
2025-08-25T10:40:00-04:00,157.5,157.5,157.37,157.45,156.62322471926666,NaN,NaN,NaN,NaN,NaN,157.99380000000062,159.52797021192634,156.4596297880749,156.82782355624664,156.9034384558278,157.2518141228554,156.5550627888002,105,913.5666666666667,49.75364659053887,40.0897978546371,NaN,NaN,NaN,NaN,0.3160583254266656,18.820592513796267,536092,0.10137321135764071,-0.19953215740568453,-0.30090536876332524
2025-08-25T10:45:00-04:00,157.41,157.52,157.41,157.52,156.62322471926666,NaN,NaN,NaN,NaN,NaN,157.98240000000064,159.52200285760776,156.44279714239352,156.90440707599785,156.90606125103469,157.25581938131683,156.55630312075255,51,886.3666666666667,50.87062997659712,41.355582090707756,NaN,NaN,NaN,NaN,0.30133987361047615,17.553626309729328,536143,0.11006645044492508,-0.16332230570716888,-0.27338875615209396
2025-08-25T10:50:00-04:00,157.55,157.59,157.41,157.48,156.62774738214955,NaN,NaN,NaN,NaN,NaN,157.97320000000062,159.5191906335965,156.42720936640472,157.00752566079828,156.91894873796517,157.27538753607723,156.5625099398531,253,891.1666666666666,50.18410711971837,42.90663996484034,NaN,NaN,NaN,NaN,0.29267273978115693,16.55763920320584,535890,0.10968506563211194,-0.13628242411195401,-0.24596748974406596
2025-08-25T10:55:00-04:00,157.47,157.63,157.47,157.63,156.69557704659732,NaN,NaN,NaN,NaN,NaN,157.96080000000063,159.5076566317363,156.41394336826497,157.0840205286386,156.93568357283743,157.30248428861125,156.5688828570636,301,897.8,52.75879620522568,44.83674401344467,NaN,NaN,NaN,NaN,0.28319611551107404,15.739347551897845,536191,0.11551123685926962,-0.10157844366997892,-0.21708968052924854
2025-08-25T11:00:00-04:00,157.68,157.82,157.65,157.73,156.89350536266107,NaN,NaN,NaN,NaN,NaN,157.94540000000063,159.48579584495016,156.4050041550511,157.2882164229109,156.95502611899266,157.3375632073024,156.57248903068293,294,881.8666666666667,54.44903430160414,46.9802224131159,NaN,NaN,NaN,NaN,0.2765392501174257,15.476765719116662,536485,0.12146860976369561,-0.06525391832462901,-0.18672252808832462
2025-08-25T11:05:00-04:00,157.85,157.96,157.85,157.96,157.07039148254012,NaN,NaN,NaN,NaN,NaN,157.9328000000006,159.46216609062688,156.40343390937434,157.4195731383287,156.96129476358277,157.35041936842728,156.57217015873826,79,873.9,58.15720828304212,48.667351170430216,NaN,NaN,NaN,NaN,0.2732150179661823,15.578466670303184,536564,0.13521536676998944,-0.01770331962583782,-0.15291868639582726
2025-08-25T11:10:00-04:00,157.6,157.82,157.6,157.77,157.07039148254012,NaN,NaN,NaN,NaN,NaN,157.91540000000063,159.4319287201813,156.39887127981996,157.4195731383287,156.96772875020318,157.36149904850427,156.5739584519021,103,873.8,54.22975857054179,49.792856501947945,NaN,NaN,NaN,NaN,0.2794139452543131,14.87407623499308,536461,0.1260121291326231,0.00459647501995164,-0.12141565411267147
2025-08-25T11:15:00-04:00,157.85,157.96,157.85,157.85,157.0717719913227,NaN,NaN,NaN,NaN,NaN,157.89960000000062,159.40199786978775,156.3972021302135,157.4195731383287,156.98068605458528,157.3864049116828,156.57496719748775,176,867.3333333333334,55.58967464223462,50.5587225774146,NaN,NaN,NaN,NaN,0.2730272348790049,14.587350898699478,536637,0.1198502904912893,0.02839720900144016,-0.09145308148984914
2025-08-25T11:20:00-04:00,158,158.1,157.96,158.1,157.2005550826262,NaN,NaN,NaN,NaN,NaN,157.88620000000063,159.36913163671016,156.4032683632911,157.5071014468243,156.98641299439532,157.3985284234949,156.57429756529575,67,846.7,59.62666940623828,51.36331837052653,NaN,NaN,NaN,NaN,0.27138243238764737,14.674382882014699,536704,0.1264935953762944,0.06666391273051886,-0.05982968264577553
2025-08-25T11:25:00-04:00,158.13,158.175,158.13,158.175,157.35052985159774,NaN,NaN,NaN,NaN,NaN,157.87370000000064,159.33600340187758,156.4113965981237,157.66318115745943,157.00491424836602,157.43911719386162,156.57071130287042,201,848.2333333333333,60.77854060315842,52.446918537386644,NaN,NaN,NaN,NaN,0.25735511578853093,14.941732458649563,536905,0.12935826746815338,0.10186815168941621,-0.02749011577873718
2025-08-25T11:30:00-04:00,158.14,158.14,157.96,157.96,157.35052985159774,NaN,NaN,NaN,NaN,NaN,157.85670000000061,159.2946285236658,156.41877147633542,157.66318115745943,157.0946876861848,157.59959066332536,156.58978470904427,1237,851.9,55.8585853451437,53.18775698762822,NaN,NaN,NaN,NaN,0.25432975037506467,14.59464330296473,535668,0.11090243871968052,0.11113793262086347,0.00023549390118294752
2025-08-25T11:35:00-04:00,157.78,157.87,157.77,157.77,157.35052985159774,NaN,NaN,NaN,NaN,NaN,157.83850000000064,159.25719270779595,156.41980729220532,157.66318115745943,157.1174886982194,157.62970210066345,156.60527529577536,465,835.5,51.86310307405506,53.72484695509626,NaN,NaN,NaN,NaN,0.249734768205417,13.658240783549077,535203,0.08139349063538084,0.10197735719540901,0.020583866560028162
2025-08-25T11:45:00-04:00,157.61,157.68,157.58,157.6,157.35052985159774,NaN,NaN,NaN,NaN,NaN,157.81630000000064,159.21433692338064,156.41826307662063,157.66318115745943,157.12360264297106,157.6356626080552,156.61154267788692,178,773.2333333333333,48.51906148051565,53.81896385110735,NaN,NaN,NaN,NaN,0.24546799904788705,13.138971644410969,535025,0.04759441035266952,0.08007687950086506,0.03248246914819554
2025-08-25T11:50:00-04:00,157.74,157.8,157.71,157.8,157.35052985159774,NaN,NaN,NaN,NaN,NaN,157.79870000000065,159.17478547667326,156.42261452332804,157.66318115745943,157.13029267852713,157.64387939801824,156.616705959036,153,776.4333333333333,52.4070217066748,53.93184552180628,NaN,NaN,NaN,NaN,0.24222028483018204,12.275893354970204,535178,0.03638222028441492,0.0779602445037142,0.04157802421929927
2025-08-25T11:55:00-04:00,157.5,157.5,157.5,157.5,157.35052985159774,NaN,NaN,NaN,NaN,NaN,157.77410000000063,159.12648410191937,156.42171589808189,157.66318115745943,157.13376108467912,157.64617401905673,156.62134815030151,140,734.7,46.708675254560234,53.71434756923638,NaN,NaN,NaN,NaN,0.2463474073423127,12.084460068564514,535038,0.007923062604202322,0.05148185247455217,0.04355878987034985
2025-08-25T12:00:00-04:00,157.53,157.54,157.45,157.48,157.35052985159774,NaN,NaN,NaN,NaN,NaN,157.75150000000065,159.08488704024217,156.41811295975913,157.66318115745943,157.13756342261118,157.64854734909125,156.62657949613111,161,502.8,46.34687137637444,53.39122195493476,NaN,NaN,NaN,NaN,0.2351797353892906,12.046515884136461,534877,-0.012003396567129933,0.028554544161437434,0.04055794072856737
2025-08-25T12:05:00-04:00,157.44,157.71,157.44,157.71,157.35052985159774,NaN,NaN,NaN,NaN,NaN,157.73370000000065,159.0448808567423,156.422519143259,157.66318115745943,157.15575289739502,157.6653649725768,156.64614082221323,591,350.4,51.043325664751265,53.45259470815139,NaN,NaN,NaN,NaN,0.23766689714719913,11.42598229915198,535468,-0.009555373579080609,0.028613723754716602,0.03816909733379721
2025-08-25T12:10:00-04:00,157.65,157.83,157.65,157.83,157.35052985159774,NaN,NaN,NaN,NaN,NaN,157.71730000000065,159.0024820256655,156.4321179743358,157.66318115745943,157.16249647716995,157.67332915175166,156.65166380258825,174,322.26666666666665,53.3382791753039,53.49398634887127,NaN,NaN,NaN,NaN,0.2335478330652568,10.760357336066605,535642,-0.00020995244015390574,0.03790665678360483,0.038116609223758736
2025-08-25T12:20:00-04:00,157.75,157.77,157.75,157.77,157.35052985159774,NaN,NaN,NaN,NaN,NaN,157.70550000000065,158.97762931697153,156.43337068302978,157.66318115745943,157.17365822445146,157.6861854500502,156.6611309988527,300,307.8,52.02508345874369,53.320847002952675,NaN,NaN,NaN,NaN,0.22258013070345364,10.14227701320161,535342,0.001482020853124294,0.039969135290164104,0.03848711443703981
2025-08-25T12:25:00-04:00,157.795,157.795,157.795,157.795,157.35052985159774,NaN,NaN,NaN,NaN,NaN,157.69000000000065,158.93828041685944,156.44171958314186,157.62304492596752,157.17373516603718,157.68627729069945,156.6611930413749,2,295.7,52.54929498804019,52.92028176759539,NaN,NaN,NaN,NaN,0.2084672642246339,9.656567832929289,535344,0.0037093888719876636,0.04312385052702439,0.039414461655036724
2025-08-25T12:30:00-04:00,157.55,157.55,157.55,157.55,157.35052985159774,NaN,NaN,NaN,NaN,NaN,157.67160000000067,158.90031711923078,156.44288288077055,157.42473576528528,157.17605049945644,157.68785977538772,156.66424122352515,100,284.1,47.11590770485262,52.4121495629033,NaN,NaN,NaN,NaN,0.21107674535144408,9.595490046715785,535244,-0.011083654057888755,0.025559894082675783,0.03664354814056454
2025-08-25T12:35:00-04:00,157.55,157.55,157.54,157.54,157.35052985159774,NaN,NaN,NaN,NaN,NaN,157.65380000000067,158.86369678860436,156.443903211397,157.42473576528528,157.17726689154654,157.68866348495308,156.66587029814,54,271.1,46.90274040442239,51.79165426020243,NaN,NaN,NaN,NaN,0.19671412068348518,9.572249769958892,535190,-0.020746872188821056,0.010709957904538214,0.03145683009335927
2025-08-25T12:45:00-04:00,157.7,157.78,157.7,157.78,157.35052985159774,NaN,NaN,NaN,NaN,NaN,157.64060000000066,158.83012871300878,156.45107128699254,157.42473576528528,157.182275251297,157.6942447929485,156.6703057096455,143,257.1,52.4616894290608,51.27986997611833,NaN,NaN,NaN,NaN,0.19980596920609403,9.107640432889811,535333,-0.010686551382080335,0.018098640865758853,0.028785192247839188
2025-08-25T12:50:00-04:00,157.71,157.72,157.68,157.71,157.35052985159774,NaN,NaN,NaN,NaN,NaN,157.62600000000066,158.7936420680449,156.4583579319564,157.42473576528528,157.18952258193443,157.70156835547456,156.6774768083943,232,255.26666666666668,50.7914353091594,50.56650531226125,NaN,NaN,NaN,NaN,0.19267697140565834,8.599188988241501,535101,-0.008550396089402428,0.01809719713608615,0.02664759322548858
2025-08-25T12:55:00-04:00,157.68,157.71,157.68,157.71,157.35052985159774,NaN,NaN,NaN,NaN,NaN,157.61420000000066,158.76617805494607,156.46222194505526,157.42473576528528,157.19144338927708,157.70347966770373,156.67940711085043,63,233.83333333333334,50.7914353091594,50.20456602397665,NaN,NaN,NaN,NaN,0.18105718773382568,8.127055503925211,535101,-0.007006210465156735,0.017889830144042662,0.024896040609199397
2025-08-25T13:00:00-04:00,157.52,157.52,157.22,157.22,NaN,NaN,NaN,158.03188650685428,158.03188650685428,158.03188650685428,157.58940000000067,158.72068005332846,156.45811994667287,157.42473576528528,157.19245654578492,157.70259781883396,156.68231527273588,133,225.03333333333333,40.35971800229823,49.382895661708304,NaN,NaN,NaN,NaN,0.20312453146712448,8.99401896708311,534968,-0.03716869542258208,-0.021564828669028202,0.015603866753553878
2025-08-25T13:05:00-04:00,157.25,157.46,157.25,157.44,NaN,NaN,NaN,158.01952802927002,NaN,NaN,157.5678000000007,158.6679966365277,156.46760336347367,157.42473576528528,157.1949789498304,157.7022068501775,156.68775104948332,226,232.33333333333334,45.7473459457637,49.1849159806546,NaN,NaN,NaN,NaN,0.20575849350518766,9.799056468586873,535194,-0.04022788365185976,-0.034680987811270825,0.005546895840588937
2025-08-25T13:20:00-04:00,157.47,157.53,157.47,157.47,NaN,NaN,NaN,158.01952802927002,NaN,NaN,157.55200000000067,158.63452852111683,156.46947147888451,157.42473576528528,157.19582181796977,157.70256934193594,156.6890742940036,49,223.5,46.45764080103183,48.7599602016801,NaN,NaN,NaN,NaN,0.19749002968338877,10.228054433656625,535243,-0.03817255150923474,-0.042168793545954486,-0.003996242036719748
2025-08-25T13:25:00-04:00,157.45,157.45,157.27,157.27,NaN,NaN,NaN,158.00447698534725,NaN,NaN,157.53140000000067,158.59524780820973,156.4675521917916,157.42473576528528,157.19710804411847,157.70159032849165,156.69262575974528,166,227.46666666666667,42.46599154172737,48.45691136504918,NaN,NaN,NaN,NaN,0.19766931327743162,11.242298958104302,535077,-0.04761034070106736,-0.06350916791305394,-0.015898827211986585
2025-08-25T13:30:00-04:00,157.37,157.38,157.37,157.38,NaN,NaN,NaN,158.00447698534725,NaN,NaN,157.51200000000065,158.5505046938055,156.47349530619582,157.40413581556868,157.19792346899666,157.70140371877503,156.6944432192183,79,209.2,45.25217350683809,48.3787186600823,NaN,NaN,NaN,NaN,0.19140721947189973,12.184097445091428,535156,-0.04386506180143025,-0.0707301544637744,-0.02686509266234415
2025-08-25T13:35:00-04:00,157.26,157.3,157.26,157.3,NaN,NaN,NaN,157.89790155069863,NaN,NaN,157.49460000000067,158.51745842570892,156.47174157429242,157.40413581556868,157.19846093779756,157.7004614415323,156.69646043406283,106,209.23333333333332,43.59854179176873,47.84694838344068,NaN,NaN,NaN,NaN,0.1863067037953358,13.389626529865204,535050,-0.044078603705728095,-0.08196334729450427,-0.03788474358877618
2025-08-25T13:40:00-04:00,157.09,157.09,157.09,157.09,NaN,NaN,NaN,157.89790155069863,NaN,NaN,157.47640000000067,158.4950148236975,156.45778517630384,157.40413581556868,157.1972355289421,157.69652374860692,156.69794730927725,200,214.2,39.51637761357061,46.85966970045973,NaN,NaN,NaN,NaN,0.18799908209566954,14.97827674985559,534850,-0.054958095817630837,-0.10658236336081472,-0.05162426754318389
2025-08-25T13:45:00-04:00,157.26,157.27,157.26,157.27,NaN,NaN,NaN,157.87988550383903,NaN,NaN,157.46080000000066,158.46762145341722,156.4539785465841,157.40413581556868,157.19724337249582,157.69650393469678,156.69798281029486,2,205.83333333333334,44.328017171155885,46.30987925134632,NaN,NaN,NaN,NaN,0.1874277190888365,15.528168693028332,534852,-0.04693832842572658,-0.11029717807534212,-0.06335884964961554
2025-08-25T13:50:00-04:00,157.41,157.425,157.32,157.32,NaN,NaN,NaN,157.87988550383903,NaN,NaN,157.44380000000064,158.43065472035903,156.45694527964224,157.40413581556868,157.20098415499427,157.69487349352946,156.7070948164591,430,210.13333333333333,45.62209369317695,45.81507915885608,NaN,NaN,NaN,NaN,0.18511145343963395,15.325820807114681,535282,-0.03568259512618542,-0.10796209355734732,-0.0722794984311619
2025-08-25T13:55:00-04:00,157.31,157.38,157.25,157.25,NaN,NaN,NaN,157.87988550383903,NaN,NaN,157.42220000000066,158.37728776511196,156.46711223488936,157.07559753757116,157.20250677947712,157.69244880295707,156.71256475599716,304,210.46666666666667,44.07736706909888,45.59804054201653,NaN,NaN,NaN,NaN,0.18117492105108832,15.375303126719706,534978,-0.030565457031590332,-0.11048631972064982,-0.07992086268905949
2025-08-25T14:00:00-04:00,157.17,157.32,157.17,157.32,NaN,NaN,NaN,157.83642558706362,NaN,NaN,157.39960000000065,158.30870690189803,156.49049309810326,157.07559753757116,157.20328114947455,157.69045746647683,156.71610483247227,214,214.96666666666667,46.04477584508847,45.53675735920696,NaN,NaN,NaN,NaN,0.17894814097601097,15.689708917696258,535192,-0.020559982527895065,-0.10562084084892831,-0.08506085832103324
2025-08-25T14:10:00-04:00,157.51,157.52,157.51,157.52,NaN,NaN,NaN,157.83642558706362,NaN,NaN,157.41660000000064,158.30197774937426,156.53122225062702,157.10242054189519,157.20333154650223,157.69048489720637,156.71617819579808,3,211.63333333333333,51.31488743686171,45.45484293119274,NaN,NaN,NaN,NaN,0.1804518451920114,15.061666047793446,535195,0.00032805968279843445,-0.0846507837175352,-0.08497884340033364
2025-08-25T14:15:00-04:00,157.42,157.42,157.23,157.23,NaN,NaN,NaN,157.83642558706362,NaN,NaN,157.42020000000065,158.3010381457857,156.5393618542156,157.10242054189519,157.20381620103782,157.68970078186962,156.71793162020603,101,209.13333333333333,44.523909940099976,45.007162547688495,NaN,NaN,NaN,NaN,0.18827671339258348,15.406238065133032,535094,-0.004329304171712373,-0.0903904736149741,-0.08606116944326173
2025-08-25T14:20:00-04:00,157.32,157.32,157.1,157.1,NaN,NaN,NaN,157.81698463202443,NaN,NaN,157.43180000000066,158.27956826965746,156.58403173034387,157.10242054189519,157.2033331584286,157.68536764568728,156.7212986711699,302,216.96666666666667,41.8501872939717,44.368501975175086,NaN,NaN,NaN,NaN,0.1905426624359703,16.09933308530628,534792,-0.014533193371181835,-0.10422766115723903,-0.08969446778605719
2025-08-25T14:25:00-04:00,157.33,157.37,157.28,157.37,NaN,NaN,NaN,157.81698463202443,NaN,NaN,157.45620000000065,158.2211798945362,156.6912201054651,157.10242054189519,157.21086138793854,157.680467756034,156.74125501984307,1111,247.3,48.73579646579795,44.96679329399649,NaN,NaN,NaN,NaN,0.19621818654768744,16.507912533707387,535903,-0.0021184428553308043,-0.0923425213552207,-0.09022407849988989
2025-08-25T14:30:00-04:00,157.33,157.37,157.33,157.37,NaN,NaN,NaN,157.81698463202443,NaN,NaN,157.48440000000065,158.11963110680145,156.84916889319985,157.10242054189519,157.2122930269854,157.67980931676323,156.7447767372076,200,212.73333333333332,48.735796465797954,45.1802540454275,NaN,NaN,NaN,NaN,0.1850597446514235,16.887307735794128,535903,0.006596490230779489,-0.08197846571141554,-0.08857495594219503
2025-08-25T14:35:00-04:00,157.29,157.29,157.29,157.29,NaN,NaN,NaN,157.81698463202443,NaN,NaN,157.50020000000066,158.07293016250486,156.92746983749646,157.10242054189519,157.21243772561698,157.67953054408258,156.74534490715138,38,198.5,46.83026445822271,45.206870020941146,NaN,NaN,NaN,NaN,0.17755547717632272,17.372612674050938,535865,0.0074151503951973285,-0.07930601794819836,-0.08672116834339569
2025-08-25T14:45:00-04:00,157.16,157.21,157.14,157.21,NaN,NaN,NaN,157.74678295634155,NaN,NaN,157.50960000000066,158.04641594521118,156.97278405479014,157.10242054189519,157.21217399036436,157.67687783898108,156.74747014174764,211,199.6,44.938063671199046,45.383446601617685,NaN,NaN,NaN,NaN,0.1755872288065858,18.301600219670302,535654,0.0032247635222636822,-0.08269021394056608,-0.08591497746282976
2025-08-25T14:50:00-04:00,157.15,157.27,157.15,157.25,NaN,NaN,NaN,157.74678295634155,NaN,NaN,157.51120000000066,158.04442250423634,156.97797749576497,157.10242054189519,157.21225938938886,157.6751827266104,156.74933605216734,159,199.8,46.110526906342045,45.44475755872512,NaN,NaN,NaN,NaN,0.17161671246325857,18.825035403040058,535813,0.0037652397816104466,-0.08120842773581671,-0.08497366751742716
2025-08-25T14:55:00-04:00,157.32,157.33,157.27,157.27,NaN,NaN,NaN,157.74678295634155,NaN,NaN,157.50800000000064,158.0450400348799,156.97095996512138,157.10242054189519,157.21300792856343,157.67375975059318,156.75225610653368,202,201.86666666666667,46.7214059087328,45.667819281365404,NaN,NaN,NaN,NaN,0.16507266157302672,18.972384324353005,536015,0.005957661722137672,-0.07752659036475507,-0.08348425208689274
2025-08-25T15:00:00-04:00,157.25,157.25,157.24,157.24,NaN,NaN,NaN,157.74678295634155,NaN,NaN,157.50880000000066,158.04411881999445,156.97348118000687,157.10242054189519,157.21304546536535,157.673513274187,156.7525776565437,26,197.36666666666667,45.881245140535455,46.12245267614861,NaN,NaN,NaN,NaN,0.1554246143178106,19.221767234818017,535989,0.0058660989241635375,-0.07615162843168832,-0.08201772735585186
2025-08-25T15:05:00-04:00,157.31,157.42,157.31,157.42,NaN,NaN,NaN,157.74678295634155,NaN,NaN,157.51340000000067,158.04158723859052,156.98521276141082,157.10154460693894,157.21400476551153,157.6733505895906,156.75465894143247,119,181.63333333333333,51.514905669598306,46.63580185460878,NaN,NaN,NaN,NaN,0.15717999900939403,18.505276928574258,536108,0.0177361179890492,-0.05984757986954037,-0.07758369785858957
2025-08-25T15:10:00-04:00,157.4,157.4,157.4,157.4,NaN,NaN,NaN,157.74678295634155,NaN,NaN,157.51940000000067,158.0353404607348,157.00345953926654,157.13523568555118,157.21504668204423,157.67331441009895,156.7567789539895,119,179.8,50.881121010278186,47.011446662973164,NaN,NaN,NaN,NaN,0.14738142765157886,17.839964501347907,535989,0.02367722185352099,-0.04798717054168833,-0.07166439239520932
2025-08-25T15:15:00-04:00,157.34,157.34,156.94,156.97,NaN,NaN,NaN,157.6858025512116,NaN,NaN,157.5132000000007,158.04761841191757,156.97878158808382,157.13523568555118,157.2096019675978,157.6590633399044,156.76014059529118,916,200.33333333333334,39.600507721745856,46.69167099530508,NaN,NaN,NaN,NaN,0.16971132567646663,18.868408773141613,535073,-0.0006284532925267955,-0.07244995901086781,-0.07182150571834102
2025-08-25T15:20:00-04:00,157.04,157.06,157.04,157.06,NaN,NaN,NaN,157.5832660716111,NaN,NaN,157.5040000000007,158.05326496247702,156.9547350375244,157.13523568555118,157.20817645217542,157.65582969772504,156.7605232066258,204,207.06666666666666,42.475190748774466,46.436700631282655,NaN,NaN,NaN,NaN,0.16401765955671926,19.823392739807197,535277,-0.009431462333116411,-0.08361083363473654,-0.07417937130162013
2025-08-25T15:30:00-04:00,157.1,157.1,156.9,156.9,NaN,NaN,NaN,157.53629943199238,NaN,NaN,157.49300000000068,158.06759550905267,156.9184044909487,157.13523568555118,157.20551698213336,157.6514115220267,156.75962244224002,249,212.03333333333333,38.92802708348845,45.551924891756,NaN,NaN,NaN,NaN,0.16658782673123848,21.108111489142047,535028,-0.023989152059156624,-0.10416581137556591,-0.08017665931640929
2025-08-25T15:35:00-04:00,156.88,156.88,156.82,156.855,NaN,NaN,NaN,157.37283127599272,NaN,NaN,157.4797000000007,158.08132915406426,156.87807084593712,157.13523568555118,157.20178539651974,157.64679295810652,156.75677783493296,241,218.26666666666668,37.96766071315507,45.08362137554565,NaN,NaN,NaN,NaN,0.16040298196472233,22.514996970290387,534787,-0.03399691853216921,-0.1226728074816208,-0.08867588894945158
2025-08-25T15:40:00-04:00,156.93,156.93,156.82,156.88,NaN,NaN,NaN,157.37283127599272,NaN,NaN,157.4677000000007,158.09232215699836,156.84307784300302,157.13523568555118,157.1939548903218,157.63638754045962,156.751522240184,564,232.3,38.869941152051446,44.87074665112277,NaN,NaN,NaN,NaN,0.15680276896724313,23.505614640646673,535351,-0.03608353527983013,-0.13378030804923924,-0.09769677276940911
2025-08-25T15:45:00-04:00,156.88,156.88,156.81,156.81,NaN,NaN,NaN,157.3452450262661,NaN,NaN,157.45130000000069,158.10058825573157,156.8020117442698,157.13523568555118,157.18827091739516,157.62949515179793,156.7470466829924,375,237.06666666666666,37.236746943679044,44.04938597097142,NaN,NaN,NaN,NaN,0.15060257118386813,24.455996328120637,534976,-0.03907638132675492,-0.14654224942785277,-0.10746586810109784
2025-08-25T15:50:00-04:00,156.81,156.9,156.65,156.75,NaN,NaN,NaN,157.2865975250722,NaN,NaN,157.43170000000066,158.10487935133904,156.75852064866228,157.13523568555118,157.1388535366653,157.57503296165632,156.70267411167427,3159,340.26666666666665,35.846448686687296,43.12871827246352,NaN,NaN,NaN,NaN,0.15770238752787755,25.806696078262654,531817,-0.041753104791124124,-0.159657249090003,-0.11790414429887888
2025-08-25T15:55:00-04:00,156.71,156.72,156.3,156.31,NaN,NaN,NaN,157.059706728478,NaN,NaN,157.39870000000067,158.1247463064052,156.67265369359615,157.13523568555118,157.09390651210677,157.5490976995882,156.63871532462534,1862,397.9,27.68355393098348,41.76109609194644,NaN,NaN,NaN,NaN,0.17858078841874264,27.85534249144275,529955,-0.06824691895708168,-0.20321279299523098,-0.1349658740381493
2025-08-26T09:30:00-04:00,156.17,156.82,156.17,156.82,NaN,NaN,NaN,157.059706728478,NaN,NaN,157.37970000000067,158.11554077018306,156.64385922981828,157.13523568555118,156.60333333333332,156.60333333333332,156.60333333333332,3437,504.93333333333334,43.68973756248203,41.671929941323796,NaN,NaN,NaN,NaN,0.21225358924597573,29.994423969348954,533392,-0.04749764548351604,-0.19433793089254436,-0.14684028540902833
2025-08-26T09:35:00-04:00,156.41,156.7,156.41,156.7,NaN,NaN,NaN,157.059706728478,NaN,NaN,157.35670000000067,158.10410246124073,156.60929753876061,156.89818854844094,156.6033333333333,156.6033360307316,156.60333063593498,208,510.23333333333335,41.36952887538909,41.33328722482715,NaN,NaN,NaN,NaN,0.22637833287126294,31.980713913119,533184,-0.03832190259350815,-0.19474266365091353,-0.15642076105740538
2025-08-26T09:40:00-04:00,156.54,156.73,156.54,156.73,NaN,NaN,NaN,157.059706728478,NaN,NaN,157.32930000000067,158.06606864690582,156.59253135309552,156.6812406710022,156.60517226069967,156.61580634513535,156.594538176264,109,508.3333333333333,42.19600471341162,41.010044282304214,NaN,NaN,NaN,NaN,0.2237798805233154,33.60961482924203,533293,-0.027221239120830576,-0.1904473099584436,-0.16322607083761304
2025-08-26T09:45:00-04:00,156,156.12,155.82,155.82,NaN,NaN,NaN,156.70322537847966,NaN,NaN,157.28220000000067,158.09397376101293,156.4704262389884,156.6812406710022,156.42792588204316,156.72811224660884,156.12773951747747,1310,549.3666666666667,28.891857061849677,39.79651656239809,NaN,NaN,NaN,NaN,0.27279560334307834,36.1903103996394,531983,-0.07542254911942048,-0.25750425723688863,-0.18208170811746816
2025-08-26T09:50:00-04:00,156.14,156.5,156.12,156.38,NaN,NaN,NaN,156.70322537847966,NaN,NaN,157.25060000000067,158.07724778415434,156.423952215847,156.5749940294414,156.4191324855215,156.70634225522275,156.13192271582022,519,563.1333333333333,41.18200845314939,39.05845247550888,NaN,NaN,NaN,NaN,0.3018816316757161,36.66818100215604,532502,-0.06428252584284788,-0.262434865421028,-0.19815233957818013
2025-08-26T09:55:00-04:00,156.56,156.69,156.44,156.69,NaN,NaN,NaN,156.70322537847966,NaN,NaN,157.22900000000067,158.05667143182936,156.40132856817198,156.5749940294414,156.4358667754214,156.7151280553099,156.15660549553292,547,574.7,46.67635530007565,38.75811206763727,NaN,NaN,NaN,NaN,0.30246151512745084,36.31062159611946,533049,-0.03234038600521033,-0.23857782208469303,-0.2062374360794827
2025-08-26T10:00:00-04:00,156.72,156.91,156.66,156.73,155.9883527206893,155.9883527206893,155.9883527206893,NaN,NaN,NaN,157.21160000000066,158.04390869217949,156.37929130782183,156.5609952235531,156.44484420462356,156.7254855246306,156.16420288461651,171,580.3333333333334,47.359649345272615,39.31233646931775,NaN,NaN,NaN,NaN,0.29871426404691864,35.13997081462424,533220,-0.006191401212544745,-0.21397668759516364,-0.2077852863826189
2025-08-26T10:05:00-04:00,156.69,156.69,156.54,156.63,155.9883527206893,NaN,NaN,NaN,NaN,NaN,157.18820000000068,158.01880883636792,156.35759116363343,156.5197961788425,156.45330967124804,156.72965027400187,156.1769690684942,320,576.6666666666666,45.78025454092988,39.5484124544717,NaN,NaN,NaN,NaN,0.29094895947213856,34.337643053721855,532900,0.006035411759298309,-0.200241021683496,-0.2062764334427943
2025-08-26T10:10:00-04:00,156.73,156.92,156.55,156.55,155.9883527206893,NaN,NaN,NaN,NaN,NaN,157.16920000000067,158.01375517230238,156.32464482769896,156.190836943074,156.46029199571024,156.734934091413,156.18564990000746,217,573.7666666666667,44.50165924826773,39.94652903767023,NaN,NaN,NaN,NaN,0.29659546236698414,32.7680406263834,532683,0.010157724763450088,-0.1935792774884817,-0.20373700225193178
2025-08-26T10:15:00-04:00,156.61,156.84,156.61,156.7,155.9883527206893,NaN,NaN,NaN,NaN,NaN,157.15360000000067,158.00341419089818,156.30378580910315,156.0716695544592,156.4833878908849,156.7554558852293,156.2113198965405,677,589.2,47.46440580590677,40.624867972866774,NaN,NaN,NaN,NaN,0.296124357912199,31.31055265814055,533360,0.02363910690724358,-0.1741881186178773,-0.1978272255251209
2025-08-26T10:20:00-04:00,156.77,157.07,156.77,157.07,156.10190906731262,NaN,NaN,NaN,NaN,NaN,157.14080000000067,157.97585774594404,156.3057422540573,156.19161586480504,156.49147474483118,156.7683512980791,156.21459819158326,127,593.3333333333334,53.989234451953656,41.704817494288356,NaN,NaN,NaN,NaN,0.3014011894898994,29.174515266293337,533487,0.056265863677097905,-0.12749489592874852,-0.18376075960584642
2025-08-26T10:25:00-04:00,157.11,157.15,156.87,156.87,156.19091320061656,NaN,NaN,NaN,NaN,NaN,157.12160000000068,157.93628629486773,156.30691370513364,156.30729269184403,156.49930768240895,156.78041749990535,156.21819786491255,129,594.2666666666667,50.34907886424695,42.64141263147177,NaN,NaN,NaN,NaN,0.29987253309776385,27.245446893506447,533358,0.06267791219119112,-0.10541336936685752,-0.16809128155804864
2025-08-26T10:30:00-04:00,157.03,157.03,156.89,156.9,156.19091320061656,NaN,NaN,NaN,NaN,NaN,157.10420000000065,157.8996856624031,156.3087143375982,156.30729269184403,156.5213422982885,156.81168098787185,156.23100360870512,409,597.8333333333334,50.88402674814659,43.71552535014744,NaN,NaN,NaN,NaN,0.28988163787649474,25.454169118775766,533767,0.06685816629310484,-0.0845185736916676,-0.15137673998477244
2025-08-26T10:35:00-04:00,156.91,157.04,156.83,156.88,156.19091320061656,NaN,NaN,NaN,NaN,NaN,157.08590000000066,157.8587536466028,156.31304635339853,156.3316673227802,156.53986017245396,156.83536917651853,156.2443511683894,402,574.2,50.49344442394026,45.34480324250149,NaN,NaN,NaN,NaN,0.2841758065996008,23.698230614098236,533365,0.06607717259106735,-0.06878027424593824,-0.1348574468370056
2025-08-26T10:40:00-04:00,156.84,156.84,156.84,156.84,156.19091320061656,NaN,NaN,NaN,NaN,NaN,157.07170000000067,157.83596594786724,156.3074340521341,156.3316673227802,156.54331720801656,156.83885974511642,156.2477746709167,100,570.8666666666667,49.67222464048045,45.77212374807281,NaN,NaN,NaN,NaN,0.2667346775567716,22.067716288326245,533265,0.06080054934248176,-0.0588567601589034,-0.11965730950138516
2025-08-26T10:45:00-04:00,157.04,157.05,156.97,157.05,156.25107694218764,NaN,NaN,NaN,NaN,NaN,157.0619000000007,157.8143703044334,156.30942969556799,156.47566708657934,156.62414750957853,156.9480356708874,156.30025934826966,1758,628.2,53.910332164449244,46.6678954115771,NaN,NaN,NaN,NaN,0.26268220058843134,21.205366597845156,535023,0.06879860110264571,-0.03365905812307801,-0.10245765922572372
2025-08-26T10:50:00-04:00,157.03,157.03,157.03,157.03,156.25107694218764,NaN,NaN,NaN,NaN,NaN,157.04690000000068,157.77087483315577,156.32292516684558,156.56053366926346,156.64620471014493,156.97433229403936,156.3180771262505,600,641.1666666666666,53.44869925470265,47.471659307383604,NaN,NaN,NaN,NaN,0.2453477576892584,20.404613313826996,534423,0.06986282228916967,-0.015129131364261639,-0.0849919536534313
2025-08-26T10:55:00-04:00,157.2,157.2,157,157,156.37862589153875,NaN,NaN,NaN,NaN,NaN,157.03270000000066,157.73150815612902,156.3338918438723,156.72442693541075,156.6472684013974,156.975660609157,156.31887619363783,28,636.8,52.71945733115273,49.17363075519097,NaN,NaN,NaN,NaN,0.24210863214002484,20.251523715703154,534395,0.065727856427636,-0.002832133118886304,-0.0685599895465223
2025-08-26T11:00:00-04:00,156.93,157.01,156.93,156.96,156.37862589153875,NaN,NaN,NaN,NaN,NaN,157.01770000000067,157.68938209672424,156.3460179032771,156.72442693541075,156.65840890594117,156.98630235770395,156.3305154541784,400,643.4,51.70647278415058,49.92537820740534,NaN,NaN,NaN,NaN,0.2305294441300219,19.778795848281135,533995,0.0577629188742156,0.003643659046247194,-0.054119259827968405
2025-08-26T11:05:00-04:00,157.09,157.11,156.97,156.97,156.37862589153875,NaN,NaN,NaN,NaN,NaN,157.01270000000065,157.68200175489068,156.34339824511062,156.72442693541075,156.6681933842239,156.99680774297778,156.33957902547004,322,653.2666666666667,51.955017549165014,50.302425510911725,NaN,NaN,NaN,NaN,0.2247773409778779,19.690156237912895,534317,0.050874194265689274,0.00947348300414319,-0.04140071126154608
2025-08-26T11:10:00-04:00,156.97,156.97,156.93,156.93,156.37862589153875,NaN,NaN,NaN,NaN,NaN,157.00250000000068,157.66089881459322,156.34410118540814,156.72442693541075,156.67722176647524,157.00409556300076,156.35034796994972,400,662.6333333333333,50.82817081706237,50.55017704461098,NaN,NaN,NaN,NaN,0.21157895947945748,19.405673230087476,533917,0.04171430163797901,0.010742165785927682,-0.03097213585205133
2025-08-26T11:15:00-04:00,156.96,156.96,156.73,156.82,156.37862589153875,NaN,NaN,NaN,NaN,NaN,156.98950000000067,157.63602378074208,156.34297621925927,156.72442693541075,156.68111377884486,157.00490969495908,156.35731786273064,305,668.8333333333334,47.76040149655697,50.691616112870065,NaN,NaN,NaN,NaN,0.21289474808806896,18.199933499275645,533612,0.027048749804621998,0.0028388014037261655,-0.024209948400895832
2025-08-26T11:25:00-04:00,156.87,156.87,156.52,156.52,156.37862589153875,NaN,NaN,NaN,NaN,NaN,156.97450000000066,157.629047934908,156.31995206509333,156.72442693541075,156.67904489380643,156.9953537528568,156.36273603475607,610,658.6333333333333,40.5688278545083,50.4106995847444,NaN,NaN,NaN,NaN,0.2226879803674922,17.555303057112013,533002,-0.0024858557932579475,-0.027317268142468265,-0.024831412349210318
2025-08-26T11:30:00-04:00,156.61,156.61,156.25,156.25,NaN,NaN,NaN,157.12927940115873,157.12927940115873,157.12927940115873,156.95190000000065,157.62660553511375,156.27719446488754,156.72442693541075,156.666857973564,156.9826484765888,156.3510674705392,538,669.7666666666667,35.40213536402996,49.54910883889605,NaN,NaN,NaN,NaN,0.23249598176981517,17.84195990002598,532464,-0.037871647717546836,-0.07217097199614386,-0.034299324278597026
2025-08-26T11:40:00-04:00,156.46,156.48,156.46,156.48,NaN,NaN,NaN,157.12927940115873,NaN,NaN,156.93550000000067,157.61540661054806,156.25559338945328,156.72442693541075,156.66345767024313,156.97749260300495,156.34942273748132,244,669.6,42.15982870444911,48.70415128550287,NaN,NaN,NaN,NaN,0.2323176973576848,18.10814125416038,532708,-0.04307471913533238,-0.08814272319776251,-0.045068004062430125
2025-08-26T11:45:00-04:00,156.45,156.45,156.45,156.45,NaN,NaN,NaN,157.12927940115873,NaN,NaN,156.92270000000065,157.6144838095084,156.23091619049288,156.72442693541075,156.661931555492,156.97535826510605,156.34850484587795,100,664.9,41.54927777181959,48.0755940646152,NaN,NaN,NaN,NaN,0.2178664332607074,18.387954550489553,532608,-0.04558150906931283,-0.10204489039907116,-0.05646338132975833
2025-08-26T11:50:00-04:00,156.48,156.48,156.48,156.48,NaN,NaN,NaN,157.12927940115873,NaN,NaN,156.9069000000007,157.60231035297528,156.2114896470261,156.72442693541075,156.66064007004093,156.97332560218766,156.3479545378942,100,649.4333333333333,42.44686513341826,47.47293966356318,NaN,NaN,NaN,NaN,0.2044474023135141,18.486723531186037,532708,-0.04233396262584786,-0.10938083461206816,-0.0670468719862203
2025-08-26T11:55:00-04:00,156.52,156.52,156.52,156.52,NaN,NaN,NaN,157.12927940115873,NaN,NaN,156.89090000000067,157.58436575911537,156.19743424088597,156.69863323866292,156.6605403040836,156.97313733921595,156.34794326895127,10,637.2666666666667,43.688537662103364,46.98687489486054,NaN,NaN,NaN,NaN,0.1927011592911217,18.35731558945957,532718,-0.03491528706964661,-0.11069098082327855,-0.07577569375363194
2025-08-26T12:00:00-04:00,156.51,156.51,156.51,156.51,NaN,NaN,NaN,157.12927940115873,NaN,NaN,156.87610000000066,157.56986448387926,156.18233551612207,156.69863323866292,156.6594799370759,156.97122842115857,156.34773145299323,100,535.3,43.43623897281434,46.541447347170106,NaN,NaN,NaN,NaN,0.1796510764846144,18.278282097279597,532618,-0.028382432014196435,-0.11125373377137748,-0.08287130175718105
2025-08-26T12:10:00-04:00,156.56,156.69,156.56,156.69,NaN,NaN,NaN,157.12927940115873,NaN,NaN,156.86350000000067,157.54737206337458,156.17962793662676,156.62090659093033,156.65906933933317,156.9657905079437,156.35234817072265,470,488.9,49.13079210725098,46.2000516287988,NaN,NaN,NaN,NaN,0.1796759995928567,17.215500016027192,533088,-0.010557209715385957,-0.0960678139014135,-0.08551060418602754
2025-08-26T12:15:00-04:00,156.75,156.78,156.75,156.78,NaN,NaN,NaN,157.12927940115873,NaN,NaN,156.84870000000066,157.50663862866543,156.1907613713359,156.56572527274426,156.65908446383528,156.96578745705096,156.3523814706196,2,374.4,51.746589329749455,46.07847234844501,NaN,NaN,NaN,NaN,0.17327057105051005,16.18472740282035,533090,0.007691894267214325,-0.07589573635200964,-0.08358763061922396
2025-08-26T12:20:00-04:00,156.58,156.68,156.5,156.5,NaN,NaN,NaN,157.12927940115873,NaN,NaN,156.83410000000066,157.4899404982109,156.17825950179042,156.4883267178999,156.65709218436874,156.96101449746686,156.3531698712706,301,377.5,44.141618426809785,45.46576956956337,NaN,NaN,NaN,NaN,0.18089410168975942,15.94394785547173,532789,0.0016199638958283302,-0.08156267574943854,-0.08318263964526687
2025-08-26T12:25:00-04:00,156.46,156.6,156.46,156.6,NaN,NaN,NaN,157.1112542109295,NaN,NaN,156.8241000000007,157.47866455682492,156.16953544317647,156.4883267178999,156.65293384631826,156.95139839452267,156.35446929811386,625,394.7,47.13010250836332,45.13888597843572,NaN,NaN,NaN,NaN,0.17797309442620418,15.879063636615973,533414,0.004869401016828714,-0.07709588837423098,-0.0819652893910597
2025-08-26T12:30:00-04:00,156.66,156.72,156.66,156.72,NaN,NaN,NaN,157.1112542109295,NaN,NaN,156.8111000000007,157.4473430031455,156.17485699685588,156.4883267178999,156.6541424049315,156.94884411089242,156.35944069897056,411,364.73333333333335,50.549129054817726,45.038465371696624,NaN,NaN,NaN,NaN,0.17383215911004707,15.193786505182425,533825,0.015056204760317965,-0.06314503344066225,-0.07820123820098021
2025-08-26T12:35:00-04:00,156.69,156.69,156.69,156.69,NaN,NaN,NaN,157.1112542109295,NaN,NaN,156.7975000000007,157.41414333212106,156.18085666788033,156.4883267178999,156.65417597736305,156.94874173214862,156.3596102225775,15,347.93333333333334,49.68408937184346,44.9567452684667,NaN,NaN,NaN,NaN,0.1635584334593295,14.557457740279842,533810,0.01945024070966317,-0.05388843731390125,-0.07333867802356442
2025-08-26T12:45:00-04:00,156.55,156.55,156.45,156.46,NaN,NaN,NaN,157.05708257394986,NaN,NaN,156.78090000000068,157.3882341411806,156.17356585882078,156.4883267178999,156.651328997423,156.94418229328178,156.35847570156423,277,338.93333333333334,43.53324598575887,44.654805589123974,NaN,NaN,NaN,NaN,0.1690185453550923,14.970515161490491,533533,0.00717527560846376,-0.06436958351298472,-0.07154485912144848
2025-08-26T12:50:00-04:00,156.53,156.56,156.44,156.56,NaN,NaN,NaN,157.04812427513397,NaN,NaN,156.7679000000007,157.3656895608256,156.17011043917583,156.4883267178999,156.6461433286186,156.93429388417223,156.35799277306495,670,355.56666666666666,46.62706744663535,45.087536988561624,NaN,NaN,NaN,NaN,0.16551722068687175,15.354068481186095,534203,0.006139452690311131,-0.06387054325855956,-0.0700099959488707
2025-08-26T12:55:00-04:00,156.59,156.66,156.59,156.66,NaN,NaN,NaN,157.04812427513397,NaN,NaN,156.75610000000069,157.33845140512798,156.1737485948734,156.4883267178999,156.64607677902623,156.93321487794177,156.3589386801107,120,348.9,49.6008571820536,46.10173140413474,NaN,NaN,NaN,NaN,0.16083741920923764,15.12935478960662,534323,0.012188412848529145,-0.05477447988820927,-0.06696289273673842
2025-08-26T13:00:00-04:00,156.65,156.65,156.65,156.65,NaN,NaN,NaN,157.04812427513397,NaN,NaN,156.7437000000007,157.3078730576864,156.179526942315,156.4883267178999,156.64609960437517,156.9324013537558,156.35979785499453,100,345,49.30501169957167,46.61210161807207,NaN,NaN,NaN,NaN,0.1500633178371486,14.920692075997104,534223,0.015313158418779269,-0.04782144471326433,-0.0631346031320436
2025-08-26T13:05:00-04:00,156.65,156.65,156.65,156.65,NaN,NaN,NaN,157.04812427513397,NaN,NaN,156.7319000000007,157.27846340805962,156.1853365919418,156.4883267178999,156.64611992128718,156.93167517136965,156.3605646712047,90,325.43333333333334,49.30501169957167,47.1660826129115,NaN,NaN,NaN,NaN,0.13934450942020943,14.726933841931128,534223,0.017044533463139486,-0.041828936303119235,-0.05887346976625872
2025-08-26T13:10:00-04:00,156.38,156.38,156.38,156.38,NaN,NaN,NaN,157.04812427513397,NaN,NaN,156.7111000000007,157.22978020882508,156.19241979117632,156.43616826835822,156.64591984269273,156.93146090740103,156.36037877798444,13,321.6333333333333,41.54552274998405,47.101701014094765,NaN,NaN,NaN,NaN,0.14867704446162375,15.710828580658884,534210,0.000542192144886211,-0.05819572958515096,-0.05873792173003717
2025-08-26T13:15:00-04:00,156.33,156.33,156.33,156.33,NaN,NaN,NaN,157.04812427513397,NaN,NaN,156.6897000000007,157.18046434165737,156.19893565834403,156.43616826835822,156.64428398826306,156.92998599288438,156.35858198364173,90,320.3333333333333,40.28126372275351,46.858324304141206,NaN,NaN,NaN,NaN,0.1416286841429351,16.806722517660518,534120,-0.012484959068630855,-0.07434412056582573,-0.06185916149719488
2025-08-26T13:20:00-04:00,156.49,156.55,156.48,156.55,NaN,NaN,NaN,157.01162201393444,NaN,NaN,156.6813000000007,157.16693694160062,156.19566305840078,156.43616826835822,156.64196228827103,156.92530320130456,156.3586213752375,350,318.3666666666667,47.80718871207846,47.17053499980293,NaN,NaN,NaN,NaN,0.14722663527558252,16.470205893180527,534470,-0.005391798679228149,-0.06859890984623007,-0.06320711116700192
2025-08-26T13:30:00-04:00,156.58,156.6,156.53,156.53,NaN,NaN,NaN,157.01162201393444,NaN,NaN,156.6707000000007,157.14583370650425,156.19556629349714,156.43616826835822,156.64085171159132,156.92258435769264,156.35911906549,225,312.46666666666664,47.224537057728405,47.034373924837034,NaN,NaN,NaN,NaN,0.14171044704161187,15.883932988559943,534245,-0.0013634022772529564,-0.06491136401356812,-0.06354796173631516
2025-08-26T13:40:00-04:00,156.29,156.29,156.23,156.23,NaN,NaN,NaN,156.76252129782046,NaN,NaN,156.65730000000067,157.14347367172167,156.17112632827968,156.43616826835822,156.6365249398763,156.91966274734642,156.35338713240617,201,315.8333333333333,39.45651509183661,46.156511479271835,NaN,NaN,NaN,NaN,0.15301684368149754,16.52535784455827,534044,-0.017332954163603725,-0.08521415444081981,-0.06788120027721609
2025-08-26T13:45:00-04:00,156.27,156.33,156.27,156.33,NaN,NaN,NaN,156.76252129782046,NaN,NaN,156.6468000000007,157.1380911957674,156.155508804234,156.43616826835822,156.6168533374739,156.90211396655633,156.3315927083915,1164,296.03333333333336,42.83216874733862,46.062979359309615,NaN,NaN,NaN,NaN,0.14922992627567794,16.895079781372985,535208,-0.019433111478404125,-0.09217258962522124,-0.07273947814681711
2025-08-26T13:50:00-04:00,156.31,156.31,155.99,155.99,NaN,NaN,NaN,156.66725597590667,NaN,NaN,156.6290000000007,157.1488653662541,156.1091346337473,156.43616826835822,156.5900409078265,156.89071993554438,156.28936188010863,1050,311.03333333333336,35.57039443712178,45.237285925649495,NaN,NaN,NaN,NaN,0.1628563601131298,18.135007486188393,534158,-0.040765587341591594,-0.1236964623238066,-0.082930874982215
2025-08-26T13:55:00-04:00,156.06,156.23,156.06,156.23,NaN,NaN,NaN,156.66725597590667,NaN,NaN,156.61740000000069,157.14639618057296,156.0884038194284,156.43616826835822,156.5831011456523,156.88599705961101,156.2802052316936,345,321.6,42.92614356490189,44.692786962084085,NaN,NaN,NaN,NaN,0.16836662010504772,19.286368926374127,534503,-0.035927066210191205,-0.127839707744954,-0.0919126415347628
2025-08-26T14:00:00-04:00,156.26,156.45,156.26,156.45,NaN,NaN,NaN,156.66725597590667,NaN,NaN,156.61140000000069,157.14104909048928,156.0817509095121,156.43616826835822,156.57712518331306,156.8772801392178,156.27697022740833,650,329.93333333333334,48.70704157555126,44.6229978337775,NaN,NaN,NaN,NaN,0.1720547186689728,19.133140021149238,535153,-0.016133182677173646,-0.11207911988122987,-0.09594593720405623
2025-08-26T14:05:00-04:00,156.47,156.47,156.47,156.47,NaN,NaN,NaN,156.66725597590667,NaN,NaN,156.61460000000068,157.13883216143438,156.09036783856698,156.30429452271952,156.5766261374577,156.87616997059288,156.27708230432253,100,322.53333333333336,49.210684166870195,45.02852913242831,NaN,NaN,NaN,NaN,0.16119366733547547,18.887726370590418,535253,-0.0007299577837961008,-0.09685838443380135,-0.09612842665000525
2025-08-26T14:10:00-04:00,156.5,156.65,156.5,156.57,NaN,NaN,NaN,156.66725597590667,NaN,NaN,156.60960000000068,157.13065984212955,156.08854015787182,156.30429452271952,156.57660525544293,156.8751978820191,156.27801262886675,137,313.76666666666665,51.76113228919891,45.39524804975427,NaN,NaN,NaN,NaN,0.16253697681151344,17.777950323826076,535390,0.016220901660762566,-0.07585229957405204,-0.0920732012348146
2025-08-26T14:20:00-04:00,156.6,156.71,156.6,156.71,156.14682165733674,156.14682165733674,156.14682165733674,NaN,NaN,NaN,156.6098000000007,157.13100613876162,156.08859386123976,156.30624677335283,156.57692211866754,156.8750765119086,156.2787677254265,71,305.96666666666664,55.156278612972855,45.792063866248505,NaN,NaN,NaN,NaN,0.16092719275354925,16.541109586241003,535461,0.03576893223397799,-0.04736203594234212,-0.08313096817632011
2025-08-26T14:25:00-04:00,156.75,156.8,156.75,156.8,156.27764794563961,NaN,NaN,NaN,NaN,NaN,156.61120000000068,157.13406349948093,156.08833650052043,156.43199741868227,156.5793223585207,156.87656299408923,156.28208172295217,255,294.1333333333333,57.239810581742844,46.358835214975024,NaN,NaN,NaN,NaN,0.15586096469972452,15.792515403612706,535716,0.052647671468082496,-0.017321378841216983,-0.06996905030929948
2025-08-26T14:35:00-04:00,156.83,156.91,156.83,156.91,156.38025485720146,NaN,NaN,NaN,NaN,NaN,156.6330000000007,157.11106693996032,156.15493306004106,156.5605979349458,156.58342525529716,156.88072997954373,156.28612053105059,300,286.2,59.70411352761008,47.10162820269205,NaN,NaN,NaN,NaN,0.152585181506886,15.559909714899266,536016,0.06812489778568757,0.015187071922809992,-0.05293782586287758
2025-08-26T14:40:00-04:00,156.97,157,156.86,156.86,156.44342509096504,NaN,NaN,NaN,NaN,NaN,156.64260000000067,157.1192350376536,156.16596496234774,156.65047834795666,156.58826664303334,156.8859371379144,156.29059614815228,338,289.3333333333333,58.06602057454487,48.28166376158925,NaN,NaN,NaN,NaN,0.15168623997067887,15.701634207969533,535678,0.07154624454745497,0.03649497982144112,-0.035051264726013845
2025-08-26T14:45:00-04:00,156.91,156.94,156.89,156.94,156.44342509096504,NaN,NaN,NaN,NaN,NaN,156.64760000000066,157.13131164871854,156.1638883512828,156.65047834795666,156.620390625,156.9201310562543,156.3206501937457,2393,365.76666666666665,59.95899157248075,49.687215750855486,NaN,NaN,NaN,NaN,0.14656579425848637,15.833235522963356,538071,0.07536507484670035,0.059155078832361596,-0.016209996014338757
2025-08-26T14:50:00-04:00,156.97,157.05,156.94,157.05,156.5262406304041,NaN,NaN,NaN,NaN,NaN,156.65400000000068,157.15020963221275,156.1577903677886,156.73930614269227,156.6263290323429,156.92763407556177,156.32502398912405,383,375.2,62.46780967094583,50.734402962203156,NaN,NaN,NaN,NaN,0.1439539518114526,16.39757601103968,538454,0.08097560839626064,0.08500951448098704,0.004033906084726403
2025-08-26T14:55:00-04:00,157.06,157.23,157.06,157.12,156.67300241993115,NaN,NaN,NaN,NaN,NaN,156.66380000000063,157.1767973091071,156.15080269089418,156.8914449141538,156.65095663712384,156.96458948308506,156.33732379116262,1285,417.7,64.01306095754026,51.933583240761145,NaN,NaN,NaN,NaN,0.14652866953920446,17.55807154553171,539739,0.08467776704852856,0.1098811148953871,0.025203347846858546
2025-08-26T15:05:00-04:00,157.07,157.07,156.88,156.93,156.67300241993115,NaN,NaN,NaN,NaN,NaN,156.67140000000066,157.18866990933842,156.1541300906629,156.8914449141538,156.66005807454926,156.97342457530428,156.34669157379423,808,441.3,57.13681396552385,53.1964617317388,NaN,NaN,NaN,NaN,0.15320519314354764,17.57679173609915,538931,0.07020412966021163,0.11295850992212308,0.04275438026191146
2025-08-26T15:10:00-04:00,157,157.04,157,157.04,156.67300241993115,NaN,NaN,NaN,NaN,NaN,156.67820000000066,157.20563439317627,156.15076560682505,156.8914449141538,156.66410184317402,156.97807881935756,156.35012486699048,306,435.8333333333333,59.82734018143567,54.41040254846002,NaN,NaN,NaN,NaN,0.15011910791900746,17.594174770197487,539237,0.06408227715872937,0.12285722671032318,0.058774949551593805
2025-08-26T15:15:00-04:00,156.99,157.08,156.94,157.08,156.67300241993115,NaN,NaN,NaN,NaN,NaN,156.67840000000066,157.206435755514,156.15036424448732,156.8914449141538,156.6696601102985,156.98449169437092,156.3548285262261,424,449.9,60.79114464302024,56.2118847060242,NaN,NaN,NaN,NaN,0.14939631449622226,17.26177295977934,539661,0.058902786307985344,0.13240343243657549,0.07350064612859014
2025-08-26T15:20:00-04:00,157.17,157.43,157.17,157.34,156.80006223375554,NaN,NaN,NaN,NaN,NaN,156.68780000000064,157.2450689109792,156.13053108902207,156.9636878368374,156.69234686304736,157.02357725239838,156.36111647369634,1029,474.1666666666667,66.42907484547547,57.89066551177945,NaN,NaN,NaN,NaN,0.16372514917506312,18.236990975669805,540690,0.0684911016275263,0.159114523162998,0.09062342153547172
2025-08-26T15:30:00-04:00,157.42,157.42,157.29,157.29,156.86005940494846,NaN,NaN,NaN,NaN,NaN,156.69560000000064,157.27500880139132,156.11619119860995,156.9819502694699,156.6950360415672,157.02815730574017,156.36191477739422,123,457.43333333333334,64.50805943741845,59.01930964476997,NaN,NaN,NaN,NaN,0.16131620994827256,19.142550561853813,540567,0.06689337556326545,0.17424014098955354,0.10734676542628808
2025-08-26T15:35:00-04:00,157.24,157.24,157.09,157.12,156.86005940494846,NaN,NaN,NaN,NaN,NaN,156.70040000000066,157.28973128129934,156.11106871870197,156.9819502694699,156.7151485514334,157.05398495699143,156.37631214587537,1356,488.93333333333334,58.33159305573795,59.67080313683196,NaN,NaN,NaN,NaN,0.1640793378091094,18.8579576035571,539211,0.05055762771746489,0.1705438000731192,0.11998617235565431
2025-08-26T15:40:00-04:00,157.13,157.13,157.05,157.07,156.86005940494846,NaN,NaN,NaN,NaN,NaN,156.70500000000064,157.3021565951574,156.10784340484386,156.9819502694699,156.71758101776888,157.0566109283033,156.37855110723447,204,495.23333333333335,56.614631558940864,60.017481656099235,NaN,NaN,NaN,NaN,0.15807367082274332,18.38584756690114,539007,0.03338360883537758,0.1617156833998763,0.12833207456449872
2025-08-26T15:45:00-04:00,157.01,157.17,157.01,157.17,156.86005940494846,NaN,NaN,NaN,NaN,NaN,156.70740000000063,157.31101325296035,156.1037867470409,156.9819502694699,156.73011229963302,157.07095852291712,156.38926607634892,1001,519.3666666666667,59.2011709490649,60.30640253724867,NaN,NaN,NaN,NaN,0.15821126576397568,17.94745967572061,540008,0.02608102993158229,0.16093336197897656,0.13485233204739427
2025-08-26T15:50:00-04:00,157.33,157.68,157.33,157.51,156.970064792935,NaN,NaN,NaN,NaN,NaN,156.71700000000064,157.35511284201124,156.07888715799004,157.10477483037488,156.75471427414294,157.1166467148355,156.39278183345039,1043,531.8,66.51147480666512,60.96866426760026,NaN,NaN,NaN,NaN,0.18333903249512165,19.245315676941686,541051,0.04060528699102989,0.18560894078618162,0.14500365379515173
2025-08-26T15:55:00-04:00,157.57,157.69,157.46,157.47,157.03301639325613,NaN,NaN,NaN,NaN,NaN,156.72640000000064,157.39407369211153,156.05872630788974,157.1148198642999,156.84668087997355,157.27025633173318,156.42310542821392,4367,673.3666666666667,65.03508446122474,61.34944790571559,NaN,NaN,NaN,NaN,0.18667195874546935,20.47652688366177,536684,0.043705536507541304,0.19963557442957836,0.15593003792203705
2025-08-27T09:30:00-04:00,157.54,157.91,157.5,157.5,157.1276520117445,NaN,NaN,NaN,NaN,NaN,156.73720000000063,157.43636567360878,156.03803432639248,157.22985589143994,157.63666666666666,157.63666666666666,157.63666666666666,2363,748.8,65.65092129173387,61.89122652837195,NaN,NaN,NaN,NaN,0.2047668188350785,22.160509657713416,539047,0.04385054192219659,0.2107432153247828,0.1668926734025862
2025-08-27T09:35:00-04:00,157.61,157.61,157.54,157.54,157.1276520117445,NaN,NaN,NaN,NaN,NaN,156.74860000000064,157.48040336096653,156.01679663903474,157.22985589143994,157.62830771153605,157.65161260184811,157.605002821224,304,755.9333333333333,66.49819703885385,62.358312633112895,NaN,NaN,NaN,NaN,0.1979977603468596,23.724207947904226,539351,0.04267388854603932,0.22023503408513534,0.17756114553909602
2025-08-27T09:40:00-04:00,157.35,157.54,157.33,157.33,157.1276520117445,NaN,NaN,NaN,NaN,NaN,156.75660000000065,157.50472416022856,156.00847583977273,157.22985589143994,157.57347483380818,157.67309812988438,157.47385153773197,843,783.6,58.359329796645675,62.0648497849486,NaN,NaN,NaN,NaN,0.19885506317922533,23.976887080296223,538508,0.02467884878044954,0.20840970651465796,0.1837308577342084
2025-08-27T09:45:00-04:00,157.48,157.56,157.12,157.16,NaN,NaN,NaN,157.94314516521735,157.94314516521735,157.94314516521735,156.76340000000064,157.51984018871573,156.00695981128555,157.22985589143994,157.4880583047196,157.64556317142703,157.33055343801217,1441,828.6333333333333,52.73269917119624,61.2591096573526,NaN,NaN,NaN,NaN,0.21607970152356623,23.19773567228132,537067,-0.00041784156354982005,0.18320855577977113,0.18362639734332095
2025-08-27T09:50:00-04:00,157.26,157.44,157.23,157.44,NaN,NaN,NaN,157.94314516521735,NaN,NaN,156.78180000000063,157.55815754593024,156.00544245407102,157.22985589143994,157.47265308511885,157.62481107069308,157.32049509954462,743,841.7333333333333,59.63558331082984,61.43759318201732,NaN,NaN,NaN,NaN,0.22064543712902587,22.47423793626748,537810,0.00006880213329357732,0.18371240000993794,0.18364359787664436
2025-08-27T09:55:00-04:00,157.36,157.41,157.24,157.39,NaN,NaN,NaN,157.9382789625224,NaN,NaN,156.80460000000065,157.58409942854422,156.02510057145707,157.22985589143994,157.46541632180103,157.61602024874338,157.31481239485868,347,845.8,58.00650071225117,61.3075332199327,NaN,NaN,NaN,NaN,0.21917076304838035,21.802418609968907,537463,-0.004494912565148612,0.1780249571702086,0.18251986973535722
2025-08-27T10:00:00-04:00,157.35,157.49,157.33,157.49,NaN,NaN,NaN,157.9382789625224,NaN,NaN,156.82480000000064,157.62175661056804,156.02784338943323,157.22985589143994,157.46483349551303,157.6139581026954,157.31570888833068,125,843.2666666666667,60.339986549415116,61.27530764181805,NaN,NaN,NaN,NaN,0.21494427997349577,21.491477073765193,537588,-0.0024019622107506466,0.17951741697191892,0.18191937918266957
2025-08-27T10:05:00-04:00,157.32,157.32,157.32,157.32,NaN,NaN,NaN,157.9382789625224,NaN,NaN,156.84220000000062,157.64364160058307,156.04075839941817,157.22985589143994,157.46476306262497,157.6138855963896,157.31564052886034,3,804.5666666666667,54.76830823064213,60.44239574075852,NaN,NaN,NaN,NaN,0.21173397426110435,21.146222580931656,537585,-0.013471753751340743,0.16507968699349362,0.17855144074483437
2025-08-27T10:10:00-04:00,157.48,157.53,157.33,157.53,NaN,NaN,NaN,157.9382789625224,NaN,NaN,156.86320000000063,157.6804484561852,156.04595154381607,157.22985589143994,157.4647416041301,157.61274093540783,157.31674227285237,94,772.7,59.71666800422483,60.100153495530414,NaN,NaN,NaN,NaN,0.2116101189567403,21.61276706750926,537679,-0.007929983039918875,0.16863896194493577,0.17656894498485465
2025-08-27T10:15:00-04:00,157.53,157.7,157.52,157.7,NaN,NaN,NaN,157.9382789625224,NaN,NaN,156.88680000000062,157.73075677562605,156.0428432243752,157.22985589143994,157.47219028690824,157.6212635127931,157.3231170610234,278,770.4666666666667,63.224150110872316,60.44962185661143,NaN,NaN,NaN,NaN,0.2093522533169716,22.579924951183354,537957,0.005198451776331409,0.1830670097052689,0.1778685579289375
2025-08-27T10:20:00-04:00,157.78,157.78,157.77,157.77,NaN,NaN,NaN,157.9382789625224,NaN,NaN,156.91200000000063,157.784220155199,156.03977984480227,157.3108785265892,157.4775710710711,157.63059781722632,157.3245443249159,119,752.7666666666667,64.59129312366264,61.0193833969487,NaN,NaN,NaN,NaN,0.20011280665147455,23.708548625066804,538076,0.016000231723667047,0.1978688475835213,0.18186861585985425
2025-08-27T10:25:00-04:00,157.85,157.885,157.85,157.885,NaN,NaN,NaN,157.9382789625224,NaN,NaN,156.93590000000063,157.84709633403236,156.0247036659689,157.45220282127136,157.48423137486472,157.6442770972733,157.32418565245615,114,753.2333333333333,66.776445880697,61.56047446349385,NaN,NaN,NaN,NaN,0.19403332046208213,25.04585481881326,538190,0.027612789427235718,0.21638460264389892,0.1887718132166632
2025-08-27T10:30:00-04:00,157.85,158.17,157.85,157.97,157.41862991129221,157.41862991129221,157.41862991129221,NaN,NaN,NaN,156.95970000000062,157.914486698235,156.00491330176624,157.66376225701708,157.5515221851757,157.78000667494393,157.3230376954075,1024,782.8,68.33204443710993,61.69051515138276,NaN,NaN,NaN,NaN,0.20303094042907577,26.950367124165858,539214,0.03714731241021646,0.23520595372943376,0.1980586413192173
2025-08-27T10:35:00-04:00,157.925,157.925,157.82,157.835,157.41862991129221,NaN,NaN,NaN,NaN,NaN,156.98640000000063,157.9626951188769,156.01010488112436,157.66376225701708,157.55242935685976,157.78118830528103,157.3236704084385,23,781.2,63.265434581321095,61.5641115885325,NaN,NaN,NaN,NaN,0.19924301611271364,28.52441653887504,539191,0.030754995759756237,0.2365023860189126,0.20574739025915637
2025-08-27T10:40:00-04:00,157.74,157.81,157.74,157.81,157.41862991129221,NaN,NaN,NaN,NaN,NaN,157.01060000000064,158.0071593605662,156.01404063943508,157.66376225701708,157.5584406793738,157.78726291312637,157.32961844562124,206,779.5666666666667,62.34355219722748,61.327870938924896,NaN,NaN,NaN,NaN,0.19179708639037688,29.46456833199743,538985,0.021664986546323095,0.23282862344206023,0.21116363689573714
2025-08-27T10:45:00-04:00,157.74,157.8,157.74,157.8,157.41862991129221,NaN,NaN,NaN,NaN,NaN,157.03220000000064,158.04923522018532,156.01516477981596,157.66376225701708,157.56250499368147,157.79115995391106,157.33385003345188,150,774.5666666666667,61.954661384808,61.00333267792162,NaN,NaN,NaN,NaN,0.18309729450534948,30.33756642561108,538835,0.012268515271475072,0.226499280985081,0.21423076571360591
2025-08-27T10:50:00-04:00,157.77,157.8,157.77,157.8,157.41862991129221,NaN,NaN,NaN,NaN,NaN,157.05440000000064,158.08889628279923,156.01990371720206,157.66376225701708,157.56724504051414,157.79582675080712,157.33866333022115,174,769.1,61.954661384808,61.26014207707607,NaN,NaN,NaN,NaN,0.17216177346925315,31.148207512538033,538835,0.003782752275062584,0.21895920605743413,0.21517645378237155
2025-08-27T10:55:00-04:00,157.77,157.77,157.77,157.77,157.41862991129221,NaN,NaN,NaN,NaN,NaN,157.08060000000063,158.1198971467049,156.04130285329637,157.66376225701708,157.5696442235633,157.79792480353746,157.34136364358915,100,692.6666666666666,60.63860065204868,61.824849325708385,NaN,NaN,NaN,NaN,0.16200736107859232,31.900945664684492,538735,-0.005610510269601077,0.2081633159453702,0.21377382621497126
2025-08-27T11:00:00-04:00,157.79,157.82,157.78,157.78,157.41862991129221,NaN,NaN,NaN,NaN,NaN,157.10500000000064,158.15152185793085,156.05847814207044,157.66376225701708,157.5828683292511,157.81049623557053,157.3552404229317,531,697.6,60.93647751721711,61.917770340450325,NaN,NaN,NaN,NaN,0.15400683528726306,32.76470775098183,539266,-0.012514671565187596,0.19813048675848677,0.21064515832367436
2025-08-27T11:05:00-04:00,157.56,157.67,157.56,157.63,157.41862991129221,NaN,NaN,NaN,NaN,NaN,157.12440000000063,158.17316620802967,156.0756337919716,157.66376225701708,157.58373636330688,157.80875784081135,157.3587148858024,215,661.9333333333333,54.29857841261396,61.6529187476191,NaN,NaN,NaN,NaN,0.15872063276674417,31.943009011963415,539051,-0.02767908761895993,0.17604629879997447,0.2037253864189344
2025-08-27T11:10:00-04:00,157.76,157.78,157.54,157.67,157.41862991129221,NaN,NaN,NaN,NaN,NaN,157.14480000000063,158.19554061457924,156.094059385422,157.66376225701708,157.58854243291108,157.80748715565164,157.36959771017052,591,654.7,55.68488286558323,61.32041134163111,NaN,NaN,NaN,NaN,0.1645263018548345,31.620650640009725,539642,-0.035037485214908626,0.1599285299002986,0.19496601511520723
2025-08-27T11:15:00-04:00,157.64,157.64,157.64,157.64,157.41862991129221,NaN,NaN,NaN,NaN,NaN,157.16460000000063,158.2146092185954,156.11459078140587,157.66376225701708,157.58957282071822,157.806434213021,157.37271142841544,200,651.1666666666666,54.35320250915857,61.29076093295371,NaN,NaN,NaN,NaN,0.15491728029377497,31.321317866052727,539442,-0.041504861259120285,0.14308493854130688,0.18458979980042717
2025-08-27T11:20:00-04:00,157.5,157.67,157.5,157.67,157.41862991129221,NaN,NaN,NaN,NaN,NaN,157.19040000000064,158.22531224706108,156.1554877529402,157.57874081310348,157.59013489736074,157.80444633433407,157.3758234603874,242,645.1,55.49928108352674,60.989519010046706,NaN,NaN,NaN,NaN,0.1559946174156473,30.0998468382332,539684,-0.04315107391417397,0.1306509574077097,0.17380203132188368
2025-08-27T11:25:00-04:00,157.53,157.53,157.53,157.53,157.41862991129221,NaN,NaN,NaN,NaN,NaN,157.21440000000064,158.22372777584917,156.2050722241521,157.57874081310348,157.58955275895454,157.8029056088395,157.37619990906958,100,614.1333333333333,49.28094015795246,59.993575441981,NaN,NaN,NaN,NaN,0.1548521447431001,28.965623740972212,539584,-0.05243983039372299,0.10825224332972994,0.16069207372345293
2025-08-27T11:30:00-04:00,157.49,157.49,157.37,157.44,NaN,NaN,NaN,157.92166566028015,157.92166566028015,157.92166566028015,157.23220000000063,158.2252924625215,156.23910753747975,157.57874081310348,157.57963856149897,157.78959361504573,157.3696835079522,700,633.3666666666667,45.733456868815,58.6465871380633,NaN,NaN,NaN,NaN,0.15521984869002128,26.926876523846648,538884,-0.06272144914635172,0.08229026229051328,0.145011711436865
2025-08-27T11:35:00-04:00,157.43,157.46,157.43,157.46,NaN,NaN,NaN,157.9184081302674,NaN,NaN,157.25080000000062,158.22525032665516,156.2763496733461,157.57874081310348,157.57886745974528,157.7884343845382,157.36930053495237,66,590.3666666666667,46.65248277911557,57.20916120223607,NaN,NaN,NaN,NaN,0.14627557378359127,25.03375410794434,538950,-0.06592349740242281,0.06260733968383647,0.1285308370862593
2025-08-27T11:40:00-04:00,157.36,157.36,157.04,157.35,NaN,NaN,NaN,157.70916230616433,NaN,NaN,157.27320000000063,158.20323819229856,156.3431618077027,157.57874081310348,157.5394743243958,157.7632172079968,157.3157314407948,1510,633.9,42.39941026500167,55.35683018994262,NaN,NaN,NaN,NaN,0.16582731851333588,25.04136390711526,537440,-0.07266639467536593,0.03769784374205187,0.1103642384174178
2025-08-27T11:45:00-04:00,157.27,157.47,157.27,157.47,NaN,NaN,NaN,157.70916230616433,NaN,NaN,157.29600000000065,158.18752677979657,156.40447322020472,157.57874081310348,157.53787341904464,157.7607805508661,157.3149662872232,150,605.5333333333333,47.97178363487506,54.264426550910756,NaN,NaN,NaN,NaN,0.16826822433381108,24.406892227681105,537590,-0.06643146960686852,0.027324901408832147,0.09375637101570067
2025-08-27T11:55:00-04:00,157.49,157.57,157.49,157.57,NaN,NaN,NaN,157.70916230616433,NaN,NaN,157.32760000000064,158.1402382707514,156.51496172924988,157.41759412038624,157.53800662842576,157.7581793692565,157.31783388759501,319,581.4,52.12800122651763,53.5347443387172,NaN,NaN,NaN,NaN,0.1633919225956813,23.27301482441307,537909,-0.05351408451119814,0.026863765376702986,0.08037784988790113
2025-08-27T12:00:00-04:00,157.46,157.46,157.46,157.46,NaN,NaN,NaN,157.70916230616433,NaN,NaN,157.35220000000064,158.10252302316786,156.6018769768334,157.41759412038624,157.5374145477546,157.75685458949476,157.31797450601442,100,439.1666666666667,47.62149730432535,52.51094690439702,NaN,NaN,NaN,NaN,0.15957821383884588,22.355829407182508,537809,-0.05036515358124681,0.017421407911342612,0.06778656149258942
2025-08-27T12:10:00-04:00,157.39,157.39,157.28,157.28,NaN,NaN,NaN,157.70916230616433,NaN,NaN,157.36880000000065,158.07391150827036,156.66368849173094,157.34106023704717,157.53390249975104,157.75333530633964,157.31446969316244,213,367.5,41.32566647130741,51.037447267718406,NaN,NaN,NaN,NaN,0.1610369128503574,22.261181546648267,537596,-0.05785641673307412,-0.004533959423753231,0.05332245730932089
2025-08-27T12:15:00-04:00,157.24,157.24,157.24,157.24,NaN,NaN,NaN,157.70916230616433,NaN,NaN,157.38420000000065,158.04217677701726,156.72622322298403,157.34106023704717,157.53172350731515,157.75179038426725,157.31165663036305,100,360.7,40.05826471213623,49.56742327201037,NaN,NaN,NaN,NaN,0.1523914190753313,22.328626546286266,537496,-0.0625577035960306,-0.024874672185717372,0.037683031410313234
2025-08-27T12:20:00-04:00,157,157.1,156.72,156.72,NaN,NaN,NaN,157.4396157583546,NaN,NaN,157.38720000000066,158.03152650038209,156.74287349961924,157.19684818963776,157.514010785305,157.75690526333528,157.27111630727472,358,344.53333333333336,28.025298020230963,47.216624736511356,NaN,NaN,NaN,NaN,0.1786491748556655,23.91757565742022,537138,-0.09575373511796907,-0.08200913748714811,0.013744597630820962
2025-08-27T12:25:00-04:00,156.84,156.86,156.5,156.69,NaN,NaN,NaN,157.23463322388392,NaN,NaN,157.38680000000065,158.032830215326,156.7407697846753,157.16778284136817,157.50311665478736,157.76225911225657,157.24397419731815,184,302.6333333333333,27.511842469740515,45.30328645487754,NaN,NaN,NaN,NaN,0.19160280522311893,25.838474239607972,536954,-0.11358063232899174,-0.12823119278041872,-0.014650560451426979
2025-08-27T12:30:00-04:00,156.69,156.74,156.69,156.74,NaN,NaN,NaN,157.23463322388392,NaN,NaN,157.38560000000064,158.03619246776597,156.7350075322353,157.16778284136817,157.5019512252983,157.76264620207812,157.2412562485185,21,278.56666666666666,29.819660238429933,43.45577055293801,NaN,NaN,NaN,NaN,0.1814883191357541,27.62216578021089,536975,-0.11547565215271485,-0.15899512564232055,-0.04351947348960569
2025-08-27T12:35:00-04:00,156.49,156.55,156.4,156.55,NaN,NaN,NaN,157.0332298589521,NaN,NaN,157.37840000000065,158.05724148304554,156.69955851695576,157.1559848147805,157.4850557421401,157.77394819809865,157.19616328618156,241,275.03333333333336,26.38236766326206,41.45785377823112,NaN,NaN,NaN,NaN,0.19281058205462906,29.794118029804235,536734,-0.12233858675796576,-0.1964427069370629,-0.07410412017909714
2025-08-27T12:40:00-04:00,156.69,156.81,156.69,156.81,NaN,NaN,NaN,157.0332298589521,NaN,NaN,157.37740000000065,158.05943296044057,156.69536703956072,157.1559848147805,157.47465260061136,157.77394381811715,157.17536138310558,211,277.9,37.07198738418573,40.141618513992476,NaN,NaN,NaN,NaN,0.19760982619358347,30.409928807711545,536945,-0.10295876462758138,-0.20280257596357387,-0.09984381133599249
2025-08-27T12:45:00-04:00,156.83,156.98,156.83,156.98,NaN,NaN,NaN,157.0332298589521,NaN,NaN,157.37820000000065,158.05826987811267,156.69813012188862,157.1559848147805,157.461103117506,157.768581598289,157.15362463672304,370,290.1333333333333,42.90921564453384,39.68649533446257,NaN,NaN,NaN,NaN,0.19563769575118378,30.187135881537603,537315,-0.07365533917430407,-0.19191298530387257,-0.1182576461295685
2025-08-27T12:50:00-04:00,157.04,157.08,157.04,157.08,156.5064155969426,156.5064155969426,156.5064155969426,NaN,NaN,NaN,157.37880000000064,158.0577626198288,156.69983738017248,157.07378785182442,157.45899284424533,157.76699465800667,157.150991030484,80,289.6666666666667,46.077805178977194,39.711091642331304,NaN,NaN,NaN,NaN,0.18880643176895798,29.539763703686727,537395,-0.04396748644455417,-0.1732170041852612,-0.12924951774070703
2025-08-27T12:55:00-04:00,157.09,157.12,157.09,157.12,156.57112397889978,NaN,NaN,NaN,NaN,NaN,157.37880000000064,158.05776261981808,156.6998373801832,156.9910302814595,157.45829406660883,157.76638261214003,157.15020552107762,30,281.4,47.33687913506886,39.759977096327965,NaN,NaN,NaN,NaN,0.17817740092831755,28.761765618694064,537425,-0.019323817476171623,-0.15340428958592156,-0.13408047210974994
2025-08-27T13:00:00-04:00,157.05,157.07,157.05,157.07,156.57112397889978,NaN,NaN,NaN,NaN,NaN,157.38160000000065,158.05426169737368,156.70893830262762,156.90082422516764,157.45028793129754,157.76027582803786,157.1403000345572,310,287.76666666666665,45.894308116696905,40.00961265716334,NaN,NaN,NaN,NaN,0.1704504437191515,28.16451246154451,537115,-0.0048331538711703925,-0.14012191444871291,-0.13528876057754252
2025-08-27T13:15:00-04:00,157.06,157.06,157.06,157.06,156.57112397889978,NaN,NaN,NaN,NaN,NaN,157.38200000000063,158.05387201098998,156.71012798901128,156.7598639204075,157.447752441586,157.7583186623004,157.1371862208716,100,287.3,45.595033557666426,39.839844794505574,NaN,NaN,NaN,NaN,0.15898969773921143,27.60992024419136,537015,0.005097900425634239,-0.12891638504549974,-0.13401428547113398
2025-08-27T13:20:00-04:00,156.96,156.96,156.96,156.96,156.57112397889978,NaN,NaN,NaN,NaN,NaN,157.37960000000064,158.0566076507189,156.70259234928238,156.7598639204075,157.44149639795634,157.75490751563967,157.128085280273,200,259.8333333333333,42.603197117762065,39.159501643880176,NaN,NaN,NaN,NaN,0.1547761479006959,27.429177890754325,536815,0.005895268775983148,-0.12664519950115505,-0.1325404682771382
2025-08-27T13:25:00-04:00,157.21,157.31,157.21,157.31,156.74648396429717,NaN,NaN,NaN,NaN,NaN,157.37900000000064,158.05620011747735,156.70179988252394,156.9029129090608,157.43903889485546,157.75074559331912,157.1273321963918,236,266.93333333333334,53.98418905362129,39.61397962597275,NaN,NaN,NaN,NaN,0.16872070876493153,25.640804484819142,537051,0.02963053256539444,-0.09550230257039516,-0.1251328351357896
2025-08-27T13:30:00-04:00,157.3,157.42,157.3,157.42,156.85346196592008,NaN,NaN,NaN,NaN,NaN,157.38160000000065,158.0584114649721,156.7047885350292,157.03433032724863,157.4389197822752,157.75032315228682,157.1275164122636,32,261.1333333333333,56.878190316542565,40.72487418634669,NaN,NaN,NaN,NaN,0.1652406581388633,24.06149685679626,537083,0.05111480979303659,-0.06123932289449385,-0.11235413268753044
2025-08-27T13:35:00-04:00,157.38,157.38,157.38,157.38,156.85346196592008,NaN,NaN,NaN,NaN,NaN,157.38680000000065,158.0594745417403,156.714125458261,157.0514642617989,157.43855063383666,157.74901176900357,157.12808949866974,100,259.46666666666664,55.51101934676655,41.82864237453457,NaN,NaN,NaN,NaN,0.15629489684322964,22.5949969164893,536983,0.06037282037562075,-0.03688810721800451,-0.09726092759362526
2025-08-27T13:40:00-04:00,157.48,157.48,157.48,157.48,156.85346196592008,NaN,NaN,NaN,NaN,NaN,157.39500000000064,158.06199924973006,156.7280007502712,157.16717140943913,157.43880870846567,157.748319001702,157.12929841522936,100,257,58.21510863313781,43.98505741831364,NaN,NaN,NaN,NaN,0.15227383278299852,21.62931109224505,537083,0.07027919473903373,-0.009411934169833103,-0.07969112890886683
2025-08-27T13:50:00-04:00,157.46,157.48,157.46,157.48,157.00872945777476,NaN,NaN,NaN,NaN,NaN,157.40120000000064,158.06547572522672,156.73692427477457,157.21973712755133,157.4394210343914,157.74620816898286,157.1326338997999,290,263.3333333333333,58.21510863313781,46.1781478585563,NaN,NaN,NaN,NaN,0.1428257018699259,20.637329043547055,537083,0.07353069556315056,0.012222240545071372,-0.06130845501807919
2025-08-27T13:55:00-04:00,157.5,157.5,157.48,157.48,157.04696902787592,NaN,NaN,NaN,NaN,NaN,157.40060000000062,158.06453565889944,156.7366643411018,157.28178970204107,157.43999194409201,157.74496354915993,157.1350203390241,200,252.3,58.21510863313781,48.206394172464,NaN,NaN,NaN,NaN,0.1340524374506462,19.801858387360447,537083,0.07227301020417412,0.029032807737138455,-0.04324020246703566
2025-08-27T14:00:00-04:00,157.57,157.57,157.57,157.57,157.04696902787592,NaN,NaN,NaN,NaN,NaN,157.40260000000063,158.06796077368762,156.73723922631365,157.35043176163285,157.4407727263628,157.7449930529696,157.13655239975603,100,248.46666666666667,60.88738853694346,50.671038520584105,NaN,NaN,NaN,NaN,0.1309058347756003,19.329840417118785,537183,0.07383384918183797,0.0490521090102618,-0.024781740171576163
2025-08-27T14:05:00-04:00,157.67,157.67,157.65,157.65,157.23097797787867,NaN,NaN,NaN,NaN,NaN,157.40560000000062,158.07403590505402,156.73716409494722,157.44434540930627,157.44116100153872,157.74524525918267,157.13707674389477,30,229.76666666666668,63.143736784556474,52.5333063348963,NaN,NaN,NaN,NaN,0.1286982751487713,19.307192824791716,537213,0.07627300393593239,0.07055951474833932,-0.005713489187593065
2025-08-27T14:10:00-04:00,157.77,157.78,157.77,157.78,157.3477517061569,NaN,NaN,NaN,NaN,NaN,157.41040000000064,158.0860355224112,156.73476447759006,157.53447632744502,157.44513595166168,157.7495855129037,157.14068639041966,200,229.76666666666668,66.52336665988447,54.22003140742135,NaN,NaN,NaN,NaN,0.1287912554952873,19.711749296827932,537413,0.0821518470666386,0.09697631964570519,0.014824472579066588
2025-08-27T14:20:00-04:00,157.76,157.76,157.76,157.76,157.3477517061569,NaN,NaN,NaN,NaN,NaN,157.41900000000064,158.101237494689,156.73676250531227,157.553581061956,157.44699016547912,157.75149645421118,157.14248387674706,100,225.03333333333333,65.52783520371177,55.609319266330964,NaN,NaN,NaN,NaN,0.12102045153133893,20.0235743677668,537313,0.08011855131302205,0.11497266172034415,0.0348541104073221
2025-08-27T14:25:00-04:00,157.63,157.63,157.61,157.61,157.3477517061569,NaN,NaN,NaN,NaN,NaN,157.42800000000062,158.10820291028998,156.74779708971127,157.553581061956,157.44801315070634,157.75188413221912,157.14414216919357,103,225.13333333333333,58.461464683453926,56.40393251978704,NaN,NaN,NaN,NaN,0.1230904192790988,19.395347527865905,537210,0.06475376623251458,0.11579631819796532,0.051042551965450746
2025-08-27T14:30:00-04:00,157.69,157.74,157.68,157.68,157.3477517061569,NaN,NaN,NaN,NaN,NaN,157.43280000000064,158.11665132825544,156.74894867174584,157.553581061956,157.45094339986505,157.7542478944981,157.14763890523201,201,208.5,60.596928074940045,57.45411965966156,NaN,NaN,NaN,NaN,0.12358396075916286,19.291358560219322,537411,0.055730808447106886,0.12070606252433436,0.06497525407722747
2025-08-27T14:35:00-04:00,157.75,157.75,157.75,157.75,157.3477517061569,NaN,NaN,NaN,NaN,NaN,157.44000000000062,158.1294548565408,156.75054514346044,157.553581061956,157.45140981207646,157.75470736933048,157.14811225482245,27,207.2,62.66399023419224,58.67333085084197,NaN,NaN,NaN,NaN,0.11975653499065074,19.237861483332793,537438,0.0510287617198726,0.12876120622706821,0.07773244450719562
2025-08-27T14:45:00-04:00,157.66,157.66,157.53,157.53,157.3477517061569,NaN,NaN,NaN,NaN,NaN,157.44080000000065,158.13057781868778,156.75102218131352,157.553581061956,157.45350024601646,157.7546027391464,157.15239775288651,302,166.93333333333334,53.215342810704875,59.431341257480746,NaN,NaN,NaN,NaN,0.12691678249131846,17.932822234665785,537136,0.030658040015972443,0.11605499452716117,0.08539695451118873
2025-08-27T14:50:00-04:00,157.49,157.49,157.41,157.41,157.3477517061569,NaN,NaN,NaN,NaN,NaN,157.44260000000065,158.1315767479014,156.7536232520999,157.553581061956,157.45346210490544,157.7542243542241,157.15269985558677,40,163.26666666666668,48.88547456014443,59.067147365089546,NaN,NaN,NaN,NaN,0.12642272659908177,17.160581849891955,537096,0.007846253789245458,0.09520477174774555,0.0873585179585001
2025-08-27T14:55:00-04:00,157.38,157.38,157.38,157.38,157.3477517061569,NaN,NaN,NaN,NaN,NaN,157.43960000000064,158.12833460721072,156.75086539279056,157.553581061956,157.45341220423418,157.75407837872248,157.15274602974588,12,153.03333333333333,47.83754664751646,58.421387103016244,NaN,NaN,NaN,NaN,0.11953538898486173,16.583571790975117,537084,-0.009574006316388023,0.07539101006301507,0.0849650163794031
2025-08-27T15:00:00-04:00,157.22,157.3,157.21,157.21,NaN,NaN,NaN,157.6569822434663,157.6569822434663,157.6569822434663,157.42980000000065,158.11737824221257,156.74222175778874,157.553581061956,157.45213932027914,157.75235755940858,157.1519210811497,106,153.23333333333332,42.3035292104232,57.477994950420296,NaN,NaN,NaN,NaN,0.1231400040573707,16.789011988680404,536978,-0.031614415317599745,0.04544699723240342,0.07706141255000316
2025-08-27T15:05:00-04:00,157.2,157.2,157.11,157.19,NaN,NaN,NaN,157.5523466869451,NaN,NaN,157.41820000000064,158.10198873869038,156.7344112613109,157.553581061956,157.44868000741158,157.74870395688924,157.14865605793392,218,153.4,41.69245375810997,56.297805316489736,NaN,NaN,NaN,NaN,0.12148714662470096,17.36769463642524,536760,-0.04575054425943789,0.019873232225705806,0.0656237764851437
2025-08-27T15:10:00-04:00,157.01,157.01,156.56,156.57,NaN,NaN,NaN,157.25019456481124,NaN,NaN,157.39190000000065,158.1024797345539,156.6813202654474,157.553581061956,157.41823484485184,157.7464853510859,157.08998433861777,777,175.96666666666667,28.127975581384973,54.14872438422167,NaN,NaN,NaN,NaN,0.15780949329436483,19.4362272201641,535983,-0.09237770789929163,-0.04984835838897084,0.042529349510320794
2025-08-27T15:15:00-04:00,156.75,156.85,156.75,156.85,NaN,NaN,NaN,157.25019456481124,NaN,NaN,157.36950000000064,158.07637551885415,156.66262448114713,157.5093135037215,157.4166363749093,157.74591000335485,157.08736274646375,50,165.7,37.946826333510934,52.70098993424832,NaN,NaN,NaN,NaN,0.16653738663048173,21.35700747649303,536033,-0.09927890474787346,-0.08156928142452102,0.01770962332335243
2025-08-27T15:20:00-04:00,156.9,156.99,156.9,156.99,NaN,NaN,NaN,157.25019456481124,NaN,NaN,157.35260000000065,158.05453800234787,156.65066199765343,157.5093135037215,157.36481139483033,157.7070035028152,157.02261928684544,2409,239.86666666666667,42.19881602607678,51.36609189775784,NaN,NaN,NaN,NaN,0.1646418590140198,22.32839245213823,538442,-0.08962705931755612,-0.09432420082359272,-0.004697141506036603
2025-08-27T15:25:00-04:00,157.01,157.04,156.85,156.89,NaN,NaN,NaN,157.25019456481124,NaN,NaN,157.33420000000064,158.03544563396517,156.6329543660361,157.5093135037215,157.35459010107525,157.69917347232297,157.01000672982752,507,256.06666666666666,40.085926554341015,49.719105452742454,NaN,NaN,NaN,NaN,0.1664531547987325,23.23039278666592,537935,-0.08521801447729357,-0.11121965960265356,-0.026001645125359997
2025-08-27T15:30:00-04:00,156.94,156.98,156.92,156.93,NaN,NaN,NaN,157.25019456481124,NaN,NaN,157.31680000000063,158.01411416103693,156.61948583896432,157.35745080297718,157.35087714498508,157.6961001027119,157.00565418725824,198,254.63333333333333,41.35090322418622,47.921072350192574,NaN,NaN,NaN,NaN,0.16099221517025183,24.067964525870202,538133,-0.07519748286578234,-0.11999849870758794,-0.04480101584180559
2025-08-27T15:35:00-04:00,157.05,157.26,157.05,157.26,156.65772197406798,156.65772197406798,156.65772197406798,NaN,NaN,NaN,157.3060000000006,157.98963733016532,156.6223626698359,157.18796064238177,157.34652352010414,157.68804239238287,157.00500464782542,610,267.93333333333334,50.614717556059176,46.85584966107454,NaN,NaN,NaN,NaN,0.173064199800947,23.278708224447826,538743,-0.04350656010238379,-0.09918421596978533,-0.05567765586740154
2025-08-27T15:40:00-04:00,157.21,157.21,157.21,157.21,156.65772197406798,NaN,NaN,NaN,NaN,NaN,157.29480000000063,157.96589748857014,156.62370251143113,157.1233685139054,157.34473038249936,157.68435489883578,157.00510586616295,300,265.6,49.342988165367004,46.20452990978261,NaN,NaN,NaN,NaN,0.16427389981516385,22.545827373127043,538443,-0.02404589852800209,-0.08573502902740415,-0.06168913049940206
2025-08-27T15:45:00-04:00,157.23,157.24,157.14,157.24,156.71675700529747,NaN,NaN,NaN,NaN,NaN,157.28400000000065,157.94074348047232,156.62725651952897,157.00969481112435,157.334437556555,157.6631636323596,157.0057114807504,1840,324.26666666666665,50.15226893287445,45.4584828282065,NaN,NaN,NaN,NaN,0.1596829069712252,22.14494301453881,540283,-0.008110869192171855,-0.07182771698961687,-0.06371684779744502
2025-08-27T15:50:00-04:00,157.3,157.3,157.07,157.21,156.71675700529747,NaN,NaN,NaN,NaN,NaN,157.27560000000062,157.92513103019414,156.6260689698071,156.91775584889945,157.32655165378833,157.64760020994532,157.00550309763133,1461,371.96666666666664,49.30401357929015,44.504198781427775,NaN,NaN,NaN,NaN,0.16470555647328183,22.0470008039134,538822,0.0009684480727123884,-0.06250628770655453,-0.06347473577926692
2025-08-27T15:55:00-04:00,157.23,157.27,157.09,157.09,156.71675700529747,NaN,NaN,NaN,NaN,NaN,157.26400000000064,157.90561047307233,156.62238952692894,156.856517792898,157.30084528984327,157.60406516365458,156.99762541603195,4455,510.1333333333333,45.955743405489926,43.98565596676956,NaN,NaN,NaN,NaN,0.16579801672519076,21.956054465475518,534367,-0.00047101201780549995,-0.06406350080152379,-0.06359248878371829
2025-08-28T09:30:00-04:00,158.07,159.5,158.07,159.5,157.9927579476014,NaN,NaN,NaN,NaN,NaN,157.30120000000062,158.1927123325917,156.40968766740954,157.9391713874547,159.02333333333334,159.02333333333334,159.02333333333334,2839,601.4333333333333,78.10898003898393,46.0730492152581,NaN,NaN,NaN,NaN,0.32609815838767686,24.34511732672557,537206,0.15303178389479444,0.12769724108477476,-0.025334542810019678
2025-08-28T09:35:00-04:00,159.44,159.72,159.44,159.59,158.78558713180132,NaN,NaN,NaN,NaN,NaN,157.33960000000062,158.4337221865817,156.24547781341954,158.33133710996375,159.1338450664405,159.3567211023494,158.9109690305316,698,618.0333333333333,78.62052330329334,48.271833262099314,NaN,NaN,NaN,NaN,0.32280543278855717,26.76359317929638,537904,0.24719674347912077,0.2836613865388813,0.03646464305976052
2025-08-28T09:40:00-04:00,159.65,159.65,159.5,159.56,158.796242262174,NaN,NaN,NaN,NaN,NaN,157.38020000000063,158.63798529136028,156.12241470864097,158.464069687971,159.15707708779445,159.3950284780965,158.9191256974924,199,616.8,77.96650803738041,50.81918889259625,NaN,NaN,NaN,NaN,0.31046218758937494,29.009320756683554,537705,0.291012082996916,0.4002297468059055,0.10921766380898952
2025-08-28T09:45:00-04:00,159.54,159.54,159.36,159.36,158.796242262174,NaN,NaN,NaN,NaN,NaN,157.41860000000062,158.79315744120547,156.04404255879578,158.4912557503768,159.19366820276497,159.43246234548815,158.9548740600418,604,635.8666666666667,73.57249955628515,53.09633502103734,NaN,NaN,NaN,NaN,0.30257203133299015,30.59406443474511,537101,0.28946010534044836,0.47104279548454997,0.1815826901441016
2025-08-28T09:50:00-04:00,159.14,159.14,158.62,158.79,NaN,NaN,NaN,159.71651273219268,159.71651273219268,159.71651273219268,157.44520000000063,158.8723999997078,156.01800000029345,158.4912557503768,159.12437821927887,159.37842047162317,158.87033596693456,1096,669.0666666666667,62.72301136160003,55.567409005338405,NaN,NaN,NaN,NaN,0.33381688623777717,29.89080005612122,536005,0.23528185567906443,0.47568500974293215,0.24040315406386772
2025-08-28T09:55:00-04:00,158.96,159.05,158.75,158.75,NaN,NaN,NaN,159.71651273219268,NaN,NaN,157.47320000000065,158.9460336766729,156.0003663233284,158.4912557503768,159.08814785246685,159.3423992595956,158.8338964453381,827,693.3,62.03169441388289,57.28775672536498,NaN,NaN,NaN,NaN,0.33140139436365107,29.237768847399032,535178,0.18424569851950023,0.470710277213243,0.28646457869374276
2025-08-28T10:00:00-04:00,159,159.43,159,159.43,NaN,NaN,NaN,159.71651273219268,NaN,NaN,157.5124000000006,159.083837863609,155.94096213639222,158.4912557503768,159.10067963101469,159.35146598876244,158.84989327326693,422,697.7,68.4066795954122,59.15974698031751,NaN,NaN,NaN,NaN,0.35630129476624794,29.237588988378466,535600,0.18338312849191107,0.5156934893086316,0.3323103608167205
2025-08-28T10:05:00-04:00,159.57,159.98,159.57,159.77,158.8466637478553,158.8466637478553,158.8466637478553,NaN,NaN,NaN,157.55640000000062,159.25025600307964,155.8625439969216,158.71799435535434,159.1655903950984,159.47587032360985,158.85531046658696,714,714.8333333333334,71.02617966201026,61.369765059436745,NaN,NaN,NaN,NaN,0.37013691656865755,29.96044557150942,536314,0.19189763525849884,0.5721824048898441,0.3802847696313452
2025-08-28T10:10:00-04:00,159.54,159.7,159.54,159.67,158.8466637478553,NaN,NaN,NaN,NaN,NaN,157.60060000000064,159.3944713886895,155.80672861131177,158.71799435535434,159.1981295084717,159.52045425339557,158.87580476354785,549,729.8,69.20861827816466,63.35960184900663,NaN,NaN,NaN,NaN,0.36012713681375474,30.548727361239347,535765,0.1773260219737947,0.6019422970985886,0.4246162751247939
2025-08-28T10:15:00-04:00,159.72,159.72,159.27,159.27,158.8466637478553,NaN,NaN,NaN,NaN,NaN,157.64040000000062,159.4914449371005,155.78935506290074,158.71799435535434,159.20104958198823,159.5222430388163,158.87985612516016,106,732.3333333333334,62.336968963720224,64.19690552098241,NaN,NaN,NaN,NaN,0.3665466270413429,30.357357960578263,535659,0.12949888292151612,0.586489878776689,0.4569909958551729
2025-08-28T10:25:00-04:00,159.05,159.05,158.81,158.98,NaN,NaN,NaN,159.8872907617498,159.8872907617498,159.8872907617498,157.67520000000061,159.55994397177886,155.79045602822237,158.71799435535434,159.19479552702757,159.5144527031066,158.87513835094853,203,732.4333333333333,57.85216834660698,64.8047041053567,NaN,NaN,NaN,NaN,0.37322186796696183,29.078401725181152,535456,0.07005979111526617,0.5445657347492556,0.47450594363398946
2025-08-28T10:30:00-04:00,158.95,159.06,158.81,159.03,NaN,NaN,NaN,159.88286845439754,NaN,NaN,157.72140000000064,159.62339057808248,155.8194094219188,158.71799435535434,159.18564597380453,159.50200987221493,158.86928207539412,345,740.6,58.40777356641279,65.3943830077523,NaN,NaN,NaN,NaN,0.36442030596932173,27.90840183828606,535801,0.02799677295707559,0.5095019098303339,0.48150513687325835
2025-08-28T10:35:00-04:00,158.98,159.2,158.91,159.2,NaN,NaN,NaN,159.88286845439754,NaN,NaN,157.77160000000063,159.6944327434112,155.84876725659007,158.71799435535434,159.17983828561137,159.4855648161497,158.87411175507305,653,758.9333333333333,60.32288802045622,66.18144546783559,NaN,NaN,NaN,NaN,0.3591045698286553,27.07584145469657,536454,0.0066240633980736985,0.48978521612085046,0.48316115272277677
2025-08-28T10:40:00-04:00,159.24,159.485,159.24,159.485,NaN,NaN,NaN,159.88286845439754,NaN,NaN,157.82650000000064,159.7848036023846,155.86819639761666,158.71799435535434,159.19243950516582,159.49386317227317,158.89101583805848,553,770.6666666666666,63.368133033119015,67.4251875840948,NaN,NaN,NaN,NaN,0.3538113862694674,26.79290171779285,537007,0.006663964941613754,0.49149110889979397,0.4848271439581802
2025-08-28T10:45:00-04:00,159.48,159.48,159.41,159.41,NaN,NaN,NaN,159.88286845439754,NaN,NaN,157.88370000000063,159.85654242632972,155.91085757367154,158.71799435535434,159.1972535305089,159.49754846759288,158.89695859342493,200,776.4333333333333,62.01914210632876,66.27591344604801,NaN,NaN,NaN,NaN,0.33389628725022097,26.53017196209654,536807,-0.002866762910283094,0.4812436903203263,0.4841104532306094
2025-08-28T10:50:00-04:00,159.5,159.5,159.5,159.5,NaN,NaN,NaN,159.88286845439754,NaN,NaN,157.93750000000063,159.93682413558642,155.93817586441483,158.8381645390656,159.2002486479356,159.5005530007268,158.89994429514442,100,769.7,63.03605182678049,65.16273691201138,NaN,NaN,NaN,NaN,0.31647512387520543,26.32258927913857,536907,-0.007360110888063542,0.47491031462053,0.48227042550859356
2025-08-28T10:55:00-04:00,159.56,159.56,159.55,159.56,NaN,NaN,NaN,159.88286845439754,NaN,NaN,157.9891000000006,160.0198394611701,155.9583605388311,159.00053163125247,159.207231813773,159.50865502059233,158.90580860695368,202,775.1,63.733192434640884,64.14607151181569,NaN,NaN,NaN,NaN,0.2981554721698338,26.244146270635653,537109,-0.010358332758134803,0.469322509560925,0.47968084231905983
2025-08-28T11:00:00-04:00,159.64,159.69,159.64,159.69,NaN,NaN,NaN,159.88286845439754,NaN,NaN,158.04130000000063,160.10971273422732,155.97288726577395,159.17742530500198,159.21347623604464,159.51763126659867,158.9093212054906,140,779.3666666666667,65.26190154956144,63.552457368478294,NaN,NaN,NaN,NaN,0.28614436701484536,26.42027352921259,537249,-0.007771421601709183,0.4699665653169234,0.47773798691863256
2025-08-28T11:05:00-04:00,159.4,159.45,159.4,159.45,NaN,NaN,NaN,159.88286845439754,NaN,NaN,158.08790000000062,160.17608015485678,155.99971984514445,159.17742530500198,159.21963166217094,159.5216840756395,158.91757924870237,301,785.8666666666667,60.215557982418446,63.37335355567961,NaN,NaN,NaN,NaN,0.2864197693709273,25.804069620273722,536948,-0.02541429039444487,0.44597012392557644,0.4713844143200213
2025-08-28T11:10:00-04:00,159.405,159.405,159.405,159.405,NaN,NaN,NaN,159.88286845439754,NaN,NaN,158.1346000000006,160.23404358322955,156.03515641677166,159.17742530500198,159.21964890252974,159.52169255921015,158.91760524584933,1,778.6333333333333,59.28983029337013,63.17750611850012,NaN,NaN,NaN,NaN,0.26917550013014585,25.231880276259062,536947,-0.04230955625475363,0.41849746900157925,0.4608070252563329
2025-08-28T11:15:00-04:00,159.6,159.6,159.4,159.4,NaN,NaN,NaN,159.88286845439754,NaN,NaN,158.18140000000062,160.28725378389439,156.07554621610686,159.17742530500198,159.22022192323155,159.52214899450814,158.91829485195495,25,753.5666666666667,59.18096267100851,62.51852633818557,NaN,NaN,NaN,NaN,0.26423439297799173,25.135122623514793,536922,-0.055201422736254724,0.3918052468360145,0.4470066695722692
2025-08-28T11:20:00-04:00,159,159,159,159,NaN,NaN,NaN,159.88286845439754,NaN,NaN,158.22220000000064,160.31079393830385,156.13360606169744,159.17742530500198,159.21620949864868,159.51681980131943,158.91559919597793,200,758.5666666666667,51.097573659326336,61.095054480851005,NaN,NaN,NaN,NaN,0.27393193633670704,23.801951760320136,536722,-0.08999038510151641,0.33451868819537367,0.4245090732968901
2025-08-28T11:25:00-04:00,158.83,158.83,158.63,158.72,NaN,NaN,NaN,159.55030304456378,NaN,NaN,158.25040000000064,160.32700765652226,156.17379234347902,159.17742530500198,159.2114836701552,159.51444465379262,158.90852268651776,107,681.8333333333334,46.32742076280833,59.460683229754125,NaN,NaN,NaN,NaN,0.28079394088408544,22.57341879059059,536615,-0.12881710210733754,0.2634876956627181,0.39230479777005567
2025-08-28T11:30:00-04:00,158.72,159.21,158.72,159.21,NaN,NaN,NaN,159.55030304456378,NaN,NaN,158.28620000000063,160.36602553093442,156.20637446906684,159.17742530500198,159.2089651445155,159.5102815270488,158.90764876198222,172,670.6666666666666,54.357568347313475,58.89072604286793,NaN,NaN,NaN,NaN,0.2957372308209371,21.399871049207373,536787,-0.11870604346167124,0.24392224344296665,0.3626282869046379
2025-08-28T11:35:00-04:00,159.12,159.2,159.12,159.19,NaN,NaN,NaN,159.55030304456378,NaN,NaN,158.32240000000064,160.40088140697137,156.24391859302992,159.17742530500198,159.20792405245712,159.50525421600187,158.91059388891236,309,674.3666666666667,54.002425618184404,58.615744419409175,NaN,NaN,NaN,NaN,0.28104171433372754,20.310148146494384,536478,-0.11072822698405399,0.2242180031745704,0.3349462301586244
2025-08-28T11:40:00-04:00,158.97,158.97,158.97,158.97,NaN,NaN,NaN,159.55030304456378,NaN,NaN,158.35220000000064,160.42423104202544,156.28016895797583,159.17742530500198,159.20588441205885,159.50274882249334,158.90902000162436,100,657.3666666666667,50.12308371234364,58.02398085840424,NaN,NaN,NaN,NaN,0.27668159188131836,18.90479094757384,536378,-0.1170168564282813,0.18867515962327275,0.30569201605155405
2025-08-28T11:45:00-04:00,158.95,158.95,158.95,158.95,NaN,NaN,NaN,159.55030304456378,NaN,NaN,158.38160000000062,160.44499180941497,156.31820819058626,159.17742530500198,159.20370944893043,159.50024142619475,158.9071774716661,100,650.7,49.77303305693048,57.27041978958097,NaN,NaN,NaN,NaN,0.2583471924612249,17.562251204811787,536278,-0.11888751959297866,0.15708261656033073,0.2759701361533094
2025-08-28T11:50:00-04:00,158.97,158.98,158.97,158.98,NaN,NaN,NaN,159.55030304456378,NaN,NaN,158.41160000000062,160.4652800527731,156.35791994722814,159.12676175616102,159.1999143334726,159.49539471699472,158.9044339499505,200,596.0333333333333,50.33335021476569,56.33936387398431,NaN,NaN,NaN,NaN,0.24203667871399465,16.384434724168155,536478,-0.11442917193318558,0.13293367123682742,0.247362843170013
2025-08-28T12:00:00-04:00,158.92,158.98,158.92,158.98,NaN,NaN,NaN,159.55030304456378,NaN,NaN,158.43980000000062,160.48518598781524,156.394414012186,159.12676175616102,159.19596999588984,159.49059517291073,158.90134481886895,200,554,50.33335021476569,55.50466445315838,NaN,NaN,NaN,NaN,0.22903405880585234,15.287316762228365,536478,-0.10789135953837406,0.11249864374704543,0.2203900032854195
2025-08-28T12:05:00-04:00,159.09,159.17,159.09,159.16,NaN,NaN,NaN,159.55030304456378,NaN,NaN,158.47000000000062,160.5124367797174,156.42756322028384,159.12676175616102,159.1959010673235,159.49035131207575,158.90145082257123,15,406,53.91113030397451,54.85288434438651,NaN,NaN,NaN,NaN,0.2262459117482913,14.687046257661219,536493,-0.08865981614278795,0.10956523310693456,0.1982250492497225
2025-08-28T12:10:00-04:00,159.36,159.36,159.36,159.36,NaN,NaN,NaN,159.55030304456378,NaN,NaN,158.50160000000062,160.5492410230202,156.45395897698106,158.9451075312874,159.1961700819672,159.49045376582023,158.9018863981142,20,312.03333333333336,57.56858120232291,54.412554970649516,NaN,NaN,NaN,NaN,0.22437120376627173,14.646768963840762,536513,-0.061001810426370984,0.12197278621675878,0.18297459664312976
2025-08-28T12:15:00-04:00,159.45,159.53,159.35,159.52,NaN,NaN,NaN,159.55030304456378,NaN,NaN,158.53680000000062,160.59273069901363,156.48086930098762,159.10808602502988,159.21388548448869,159.50613400520646,158.9216369637709,855,317.26666666666665,60.283916893344156,54.05698463806256,NaN,NaN,NaN,NaN,0.2212018320686814,15.036876296111243,537368,-0.03192581082466467,0.1430673331122989,0.17499314393696358
2025-08-28T12:25:00-04:00,159.56,159.71,159.56,159.71,158.93694012913116,158.93694012913116,158.93694012913116,NaN,NaN,NaN,158.5788000000006,160.6430650602982,156.514534939703,159.27746882002393,159.2565624134109,159.56389956073588,158.94922526608593,1381,356.6666666666667,63.28832212843037,54.276467791349134,NaN,NaN,NaN,NaN,0.21897312977806113,15.819232977483185,538749,-0.0014979567763853674,0.17312069796648188,0.17461865474286725
2025-08-28T12:30:00-04:00,159.51,159.51,159.51,159.51,158.93694012913116,NaN,NaN,NaN,NaN,NaN,158.61540000000062,160.67951612055543,156.5512838794458,159.27746882002393,159.2566501627311,159.56397027150692,158.94933005395526,5,336.7,58.2897562889346,54.20503393388945,NaN,NaN,NaN,NaN,0.21761790622248656,16.351787013888043,538744,0.00329666031799819,0.178739480140365,0.1754428198223668
2025-08-28T12:35:00-04:00,159.23,159.26,159.23,159.26,158.93694012913116,NaN,NaN,NaN,NaN,NaN,158.64560000000063,160.70235826463392,156.58884173536734,159.27746882002393,159.25647048915238,159.55961251302872,158.95332846527603,401,313.53333333333336,52.687952965200424,53.74124752633173,NaN,NaN,NaN,NaN,0.2220737700637376,15.833616965957612,538343,-0.011424877609398754,0.16116172281061836,0.1725866004200171
2025-08-28T12:45:00-04:00,159.31,159.31,159.31,159.31,158.93694012913116,NaN,NaN,NaN,NaN,NaN,158.68120000000062,160.721036816794,156.64136318320723,159.27746882002393,159.25699899933286,159.55868724098502,158.9553107576807,148,290.9,53.64740733941544,53.92337850348095,NaN,NaN,NaN,NaN,0.20978278648775714,15.492957524020664,538491,-0.018435697316987243,0.14954197877378306,0.1679776760907703
2025-08-28T12:50:00-04:00,159.37,159.37,159.37,159.37,158.93694012913116,NaN,NaN,NaN,NaN,NaN,158.72040000000064,160.73620439505294,156.70459560494834,159.27746882002393,159.25848683344302,159.55845907148822,158.95851459539782,200,283.5,54.83115066905309,54.53078778249844,NaN,NaN,NaN,NaN,0.19908401602434608,15.34943709088343,538691,-0.019565874150406698,0.14352033340276193,0.16308620755316863
2025-08-28T12:55:00-04:00,159.18,159.18,158.92,159.065,NaN,NaN,NaN,159.55030304456378,159.55030304456378,159.55030304456378,158.75410000000062,160.73518322873147,156.77301677126977,159.27746882002393,159.25059355818513,159.5473034404078,158.95388367596246,613,280.1333333333333,48.10580959526121,54.08423358592328,NaN,NaN,NaN,NaN,0.2170065863083226,14.750104410796824,538078,-0.04019978492861284,0.11283647639240257,0.15303626132101542
2025-08-28T13:00:00-04:00,158.97,159.07,158.97,159.07,NaN,NaN,NaN,159.55030304456378,NaN,NaN,158.79130000000063,160.72427678184448,156.85832321815678,159.27746882002393,159.2479199733383,159.5437261678625,158.9521137788141,200,268.5,48.217939416880355,53.67105600011585,NaN,NaN,NaN,NaN,0.20864897300058485,14.193581207859262,538278,-0.05210149536947789,0.08790939210916804,0.14001088747864593
2025-08-28T13:05:00-04:00,159.18,159.18,159.18,159.18,NaN,NaN,NaN,159.55030304456378,NaN,NaN,158.83110000000062,160.7117959241638,156.95040407583744,159.27746882002393,159.24749818874326,159.5424327396284,158.95256363785813,100,268.3,50.73971632164621,53.71510118649461,NaN,NaN,NaN,NaN,0.20160261778625835,13.305610743921456,538378,-0.051086519933943864,0.0761527375612161,0.12723925749515996
2025-08-28T13:10:00-04:00,159.19,159.21,159.19,159.21,NaN,NaN,NaN,159.55030304456378,NaN,NaN,158.88390000000064,160.65261285378566,157.11518714621562,159.27746882002393,159.24669044280515,159.53897538496253,158.95440550064777,300,271.53333333333336,51.43437200987294,53.833768254561924,NaN,NaN,NaN,NaN,0.18934528794438285,12.378799759460938,538678,-0.04701779931109318,0.06846700835629349,0.11548480766738667
2025-08-28T13:15:00-04:00,159.21,159.35,159.21,159.35,NaN,NaN,NaN,159.55030304456378,NaN,NaN,158.93390000000062,160.60864928247682,157.25915071752442,159.27746882002393,159.24824211878644,159.53664407333068,158.9598401642422,462,275.43333333333334,54.64844914354245,54.14198960661741,NaN,NaN,NaN,NaN,0.1858206245197831,11.944272521814003,539140,-0.03412123332869968,0.07283326600651208,0.10695449933521176
2025-08-28T13:20:00-04:00,159.36,159.39,159.36,159.39,NaN,NaN,NaN,159.55030304456378,NaN,NaN,158.98190000000065,160.56617003982976,157.39762996017154,159.08557224298755,159.24902648434121,159.53674729826284,158.9613056704196,101,257.03333333333336,55.55351737881507,54.5148586897638,NaN,NaN,NaN,NaN,0.1754048656255123,11.674077200273734,539241,-0.02267160138710153,0.07861499760133484,0.10128659898843637
2025-08-28T13:25:00-04:00,159.43,159.5,159.43,159.5,NaN,NaN,NaN,159.55030304456378,NaN,NaN,159.03410000000065,160.50732868527615,157.56087131472515,159.20145779439005,159.25214955625313,159.53911422041736,158.9651848920889,236,246.46666666666667,58.03382713980956,54.80933703518059,NaN,NaN,NaN,NaN,0.17073308950940524,11.788528353404558,539477,-0.008210178663704479,0.09102387565880576,0.09923405432251024
2025-08-28T13:30:00-04:00,159.57,159.57,159.57,159.57,158.88284603515046,158.88284603515046,158.88284603515046,NaN,NaN,NaN,159.08690000000064,160.43895309035284,157.73484690964844,159.29616623551203,159.25216803270743,159.53913458827688,158.96520147713798,1,239.83333333333334,59.579646253338005,54.95298453882452,NaN,NaN,NaN,NaN,0.16353786883016155,12.122545029064437,539478,0.004846890603322024,0.10529266757666278,0.10044577697334076
2025-08-28T13:35:00-04:00,159.52,159.52,159.52,159.52,158.88284603515046,NaN,NaN,NaN,NaN,NaN,159.13210000000063,160.38424869689237,157.8799513031089,159.29616623551203,159.2537159259473,159.54057138682657,158.966860465068,100,239.83333333333334,57.938000459452596,54.78541907926085,NaN,NaN,NaN,NaN,0.15542802105657735,12.203910383357274,539378,0.008670098481755886,0.11128340007553561,0.10261330159377972
2025-08-28T13:40:00-04:00,159.56,159.56,159.56,159.56,158.88284603515046,NaN,NaN,NaN,NaN,NaN,159.17910000000066,160.3096444525067,158.04855554749463,159.34474639072772,159.2537336261365,159.54059024727007,158.9668770050029,1,233.13333333333333,58.91334266658247,54.47292054627171,NaN,NaN,NaN,NaN,0.1471831624096784,12.42286866320368,539379,0.012229110892256284,0.11789969020910007,0.10567057931684379
2025-08-28T13:55:00-04:00,159.42,159.43,159.42,159.43,158.90287960505643,NaN,NaN,NaN,NaN,NaN,159.22290000000064,160.21016103900067,158.2356389610006,159.34474639072772,159.255219815897,159.5412868535449,158.96915277824908,150,233.46666666666667,54.4909290275732,54.201575741888746,NaN,NaN,NaN,NaN,0.1466700793804167,11.965505717519063,539229,0.004559085923818512,0.11136943672161692,0.10681035079779841
2025-08-28T14:00:00-04:00,159.53,159.57,159.53,159.57,159.03252144119023,NaN,NaN,NaN,NaN,NaN,159.27010000000067,160.07711298570578,158.46308701429555,159.34474639072772,159.26034692498305,159.546636546903,158.97405730306312,302,233.5,58.13561239949377,54.59069427290971,NaN,NaN,NaN,NaN,0.1461936451389574,12.074765124845447,539531,0.007473371403593471,0.11615206505229025,0.10867869364869678
2025-08-28T14:05:00-04:00,159.59,159.72,159.59,159.72,159.14058864840885,NaN,NaN,NaN,NaN,NaN,159.32270000000065,159.84821768676653,158.79718231323477,159.4339901520526,159.26615001573458,159.5545967980961,158.97770323337306,251,241.83333333333334,61.67696849308263,55.1642343553145,NaN,NaN,NaN,NaN,0.14646552762903228,12.695642825643864,539782,0.017490069272663944,0.1305412802395267,0.11305121096686277
2025-08-28T14:10:00-04:00,159.68,159.75,159.68,159.75,159.21442552802662,NaN,NaN,NaN,NaN,NaN,159.32770000000065,159.8645061466714,158.7908938533299,159.48619212164206,159.2696020503775,159.55969801730714,158.97950608344786,136,245.53333333333333,62.36270603447668,55.7022025957019,NaN,NaN,NaN,NaN,0.14100370422695804,13.372820722427386,539918,0.023735346712779923,0.14272039435783768,0.11898504764505775
2025-08-28T14:15:00-04:00,159.73,159.73,159.73,159.73,159.21442552802662,NaN,NaN,NaN,NaN,NaN,159.33050000000065,159.87416625708636,158.78683374291495,159.50895369731364,159.27212574686178,159.56341581151653,158.98083568220702,100,242.2,61.571712871660885,56.664052829730444,NaN,NaN,NaN,NaN,0.13236058249646176,14.001628769440657,539818,0.02404440228214945,0.14904055049774456,0.12499614821559511
2025-08-28T14:20:00-04:00,159.75,159.75,159.75,159.75,159.21442552802662,NaN,NaN,NaN,NaN,NaN,159.33430000000067,159.88691201495976,158.78168798504157,159.56316295785092,159.27267520805952,159.5642478620638,158.98110255405524,21,239.33333333333334,62.089547900411674,57.65488200712554,NaN,NaN,NaN,NaN,0.12433482660385808,14.660920318505463,539839,0.02311445227923531,0.15388921356463925,0.13077476128540394
2025-08-28T14:25:00-04:00,159.75,159.77,159.75,159.77,159.31681440787514,NaN,NaN,NaN,NaN,NaN,159.34250000000065,159.90840193415406,158.77659806584725,159.61053036628073,159.27775327372885,159.57203300690918,158.98347354054852,191,239.96666666666667,62.63183202134013,58.504318842817966,NaN,NaN,NaN,NaN,0.11688233898929752,15.352063371168681,540030,0.021403984590669223,0.15752974202374048,0.13612575743307126
2025-08-28T14:30:00-04:00,159.79,159.82,159.79,159.82,159.375141025699,NaN,NaN,NaN,NaN,NaN,159.36310000000066,159.92199852305822,158.8042014769431,159.6674242930246,159.28348770726126,159.58129095685243,158.9856844576701,201,236.36666666666667,64.01757610050653,59.40311913500612,NaN,NaN,NaN,NaN,0.11210502906148934,16.195503453261132,540231,0.0211597149845541,0.1625754011637639,0.1414156861792098
2025-08-28T14:35:00-04:00,159.59,159.59,159.59,159.59,159.375141025699,NaN,NaN,NaN,NaN,NaN,159.37990000000067,159.91402167065627,158.84577832934508,159.6674242930246,159.28378315661703,159.58159477697868,158.9859715362554,18,233.63333333333333,54.082320245055534,59.36268135654277,NaN,NaN,NaN,NaN,0.12052609841423936,15.720910922044002,540213,0.00393006180841407,0.14632826343972738,0.1423982016313133
2025-08-28T14:40:00-04:00,159.64,159.66,159.64,159.66,159.375141025699,NaN,NaN,NaN,NaN,NaN,159.38450000000068,159.92420084219503,158.84479915780634,159.6674242930246,159.28769912754757,159.5863356023999,158.98906265269522,200,236.96666666666667,56.30494918763221,59.41635505717257,NaN,NaN,NaN,NaN,0.11691709138465035,15.600707991315396,540413,-0.003906152098276189,0.13751551150846808,0.14142166360674427
2025-08-28T14:50:00-04:00,159.55,159.55,159.55,159.55,159.375141025699,NaN,NaN,NaN,NaN,NaN,159.38010000000068,159.91066758199514,158.84953241800622,159.6674242930246,159.28883379053244,159.5873204536601,158.99034712740476,82,233.03333333333333,52.041907627789655,58.988360806314006,NaN,NaN,NaN,NaN,0.11642301342860284,14.965562001143512,540331,-0.016922229546715267,0.12026887667335018,0.13719110622006545
2025-08-28T14:55:00-04:00,159.65,159.65,159.57,159.57,159.375141025699,NaN,NaN,NaN,NaN,NaN,159.3781000000007,159.90502272588262,158.85117727411878,159.6674242930246,159.29145823526332,159.59001428171226,158.99290218881438,163,231.8,52.742500521362985,58.49999325403008,NaN,NaN,NaN,NaN,0.11524994104084509,14.851662536898075,540494,-0.02416775534416632,0.10698141203985756,0.13114916738402388
2025-08-28T15:00:00-04:00,159.6,159.6,159.43,159.43,159.375141025699,NaN,NaN,NaN,NaN,NaN,159.3813000000007,159.90750075925928,158.8550992407421,159.6674242930246,159.29717692255616,159.59316355916067,159.00119028595165,577,250.53333333333333,47.510409127827984,57.75516530177117,NaN,NaN,NaN,NaN,0.11916065953792668,13.95874556897208,539917,-0.037572331733713465,0.08418375271688205,0.12175608445059552
2025-08-28T15:05:00-04:00,159.43,159.43,159.43,159.43,159.375141025699,NaN,NaN,NaN,NaN,NaN,159.3903000000007,159.90398243014113,158.8766175698603,159.6674242930246,159.29916966726677,159.59337098659014,159.0049683479434,300,259.8666666666667,47.510409127827984,56.940670049002996,NaN,NaN,NaN,NaN,0.11064918385664621,13.129608384469371,539917,-0.045114483790826054,0.06536297971206295,0.110477463502889
2025-08-28T15:10:00-04:00,159.5,159.55,159.49,159.49,159.375141025699,NaN,NaN,NaN,NaN,NaN,159.3995000000007,159.90342558879556,158.89557441120584,159.6674242930246,159.3025619577162,159.59558999962692,159.00953391580546,327,242.26666666666668,49.97689067250603,56.61823873792677,NaN,NaN,NaN,NaN,0.11131709929545752,12.97428993647786,540244,-0.044654924913379634,0.05465880736116446,0.0993137322745441
2025-08-28T15:15:00-04:00,159.43,159.43,159.33,159.34,NaN,NaN,NaN,159.78695314895478,159.78695314895478,159.78695314895478,159.4023000000007,159.9033078233337,158.9012921766677,159.6674242930246,159.30335941169798,159.5946458059796,159.01207301741636,256,204.76666666666668,44.36430415509574,55.634573863326914,NaN,NaN,NaN,NaN,0.11479444934578174,12.155168763023006,539988,-0.05250407127189653,0.03368364318467343,0.08618771445656996
2025-08-28T15:20:00-04:00,159.37,159.4,159.28,159.28,NaN,NaN,NaN,159.74481891491138,NaN,NaN,159.3982000000007,159.89978851566894,158.89661148433248,159.6674242930246,159.3095122299808,159.54089942143247,159.07812503852915,12073,607.0333333333333,42.31713042243739,54.25172828685225,NaN,NaN,NaN,NaN,0.11516627439251194,11.650787701657448,527915,-0.059286230741212476,0.012079926030054366,0.07136615677126684
2025-08-28T15:25:00-04:00,159.28,159.33,159.23,159.33,NaN,NaN,NaN,159.68005441877906,NaN,NaN,159.39660000000072,159.8985380031818,158.89466199681962,159.43535154753573,159.3087757183825,159.5334514542421,159.08409998252287,1986,659.8666666666667,44.61089484644412,52.98374177342134,NaN,NaN,NaN,NaN,0.11408296907876271,11.438289947625266,529901,-0.05788902316080953,-0.0009951221797450671,0.05689390098106446
2025-08-28T15:35:00-04:00,159.32,159.33,159.32,159.33,NaN,NaN,NaN,159.68005441877906,NaN,NaN,159.3932000000007,159.8945930983634,158.89180690163798,159.43535154753573,159.3088436391525,159.53309519178725,159.08459208651777,132,659.3333333333334,44.610894846444126,51.772254771620155,NaN,NaN,NaN,NaN,0.1066484712874239,11.240970604595384,529901,-0.05449733310181128,-0.01122776539619963,0.04326956770561165
2025-08-28T15:40:00-04:00,159.33,159.37,159.33,159.37,NaN,NaN,NaN,159.68005441877906,NaN,NaN,159.3894000000007,159.8885538430647,158.8902461569367,159.41222499042289,159.30900812076047,159.53289120546683,159.0851250360541,120,656.6666666666666,46.58173362284183,50.66455375179373,NaN,NaN,NaN,NaN,0.10188786619546449,10.795114620315237,530021,-0.04735642106364023,-0.01592595862393864,0.03143046243970159
2025-08-28T15:45:00-04:00,159.52,159.52,159.45,159.45,NaN,NaN,NaN,159.68005441877906,NaN,NaN,159.3846000000007,159.87666438509018,158.8925356149112,159.41222499042289,159.31077856535296,159.53409761140946,159.08745951929646,380,648.9,50.38416783151134,49.78972059537739,NaN,NaN,NaN,NaN,0.10532444718150315,10.568522192495788,530401,-0.03557926631675671,-0.013043620456244298,0.02253564586051241
2025-08-28T15:50:00-04:00,159.51,159.51,159.37,159.49,NaN,NaN,NaN,159.68005441877906,NaN,NaN,159.38540000000071,159.878016848123,158.89278315187843,159.3247799923383,159.31407748157176,159.53591990719045,159.09223505595307,816,669.4333333333333,52.215688969476815,48.94672865744669,NaN,NaN,NaN,NaN,0.10780127238282337,9.8616358037731,531217,-0.023985196579460882,-0.007445849863813692,0.01653934671564719
2025-08-28T15:55:00-04:00,159.42,159.48,159.33,159.44,NaN,NaN,NaN,159.68005441877906,NaN,NaN,159.3861000000007,159.87892568830173,158.89327431169968,159.31385919509654,159.31957433974137,159.5366245941411,159.10252408534163,2043,734.2,49.74381978640967,48.63683576754342,NaN,NaN,NaN,NaN,0.11152975292690717,9.350890419084426,529174,-0.018802583902027714,-0.006963883161887452,0.011838700740140262
2025-08-29T09:30:00-04:00,158.61,159,158.5,158.83,NaN,NaN,NaN,159.24242306324047,NaN,NaN,159.3747000000007,159.89149941858156,158.85790058141984,159.31385919509654,158.77666666666667,158.77666666666667,158.77666666666667,1001,757.5666666666667,30.66877912963143,46.80568076340051,NaN,NaN,NaN,NaN,0.17070619914641363,11.857107024360056,528173,-0.05360526626537707,-0.05516788209158108,-0.001562615826204006
2025-08-29T09:35:00-04:00,159,159,158.42,158.42,NaN,NaN,NaN,159.24242306324047,NaN,NaN,159.3631000000007,159.9360114757383,158.79018852426313,159.2875067048394,158.702383805374,158.7837159875378,158.62105162321023,835,770,24.00564656511399,44.8030906874951,NaN,NaN,NaN,NaN,0.1999414706359564,14.353462047329662,527338,-0.09875983278964079,-0.12501240681325498,-0.0262525740236142
2025-08-29T09:40:00-04:00,158.25,158.75,158.2,158.385,NaN,NaN,NaN,159.07417060101042,NaN,NaN,159.3564000000007,159.96590484745803,158.74689515254335,159.2875067048394,158.6389887794198,158.77045571813503,158.50752184070458,600,786.6333333333333,23.53556261718056,42.716880837196356,NaN,NaN,NaN,NaN,0.2249456513048175,17.0973566809024,526738,-0.12387896519743555,-0.18110128052040864,-0.05722231532297309
2025-08-29T09:45:00-04:00,158.33,158.33,157.73,157.83,NaN,NaN,NaN,158.69125375550996,NaN,NaN,159.3288000000007,160.07252457203205,158.58507542796937,159.2875067048394,158.5736027685082,158.80921693984862,158.3379885971678,261,787.4666666666667,17.63750728968462,40.58310213447182,NaN,NaN,NaN,NaN,0.2556638190687592,20.33686602348059,526477,-0.1680263291890024,-0.2672552268092261,-0.09922889762022369
2025-08-29T09:50:00-04:00,158.17,158.23,158.17,158.17,NaN,NaN,NaN,158.69125375550996,NaN,NaN,159.3084000000007,160.11916862239343,158.49763137760795,159.2875067048394,158.54699677938808,158.79430617598106,158.2996873827951,201,794.1333333333333,29.32267566749111,39.28397831587633,NaN,NaN,NaN,NaN,0.2659735462781319,23.344981841588904,526678,-0.1642861672194484,-0.3045866066445342,-0.1403004394250858
2025-08-29T09:55:00-04:00,157.88,157.88,157.5,157.5,NaN,NaN,NaN,158.43593575657002,NaN,NaN,159.27900000000068,160.23102520926466,158.3269747907367,159.2875067048394,158.37522593320233,158.79751410898427,157.9529377574204,665,812.9666666666667,22.53713127535441,37.32399550179407,NaN,NaN,NaN,NaN,0.2948325786868359,26.817152829808403,526013,-0.19480849623282998,-0.3838110597161233,-0.1890025634832933
2025-08-29T10:00:00-04:00,157.77,157.81,157.1,157.1,NaN,NaN,NaN,158.26384776763499,NaN,NaN,159.24200000000067,160.36985637343045,158.1141436265709,159.2875067048394,158.2696940662296,158.77829108426306,157.76109704819612,403,826.3666666666667,19.618280391420114,35.55642237581724,NaN,NaN,NaN,NaN,0.32448739449491953,30.32169287705801,525610,-0.22753108269754913,-0.4734164168552297,-0.2458853341576806
2025-08-29T10:05:00-04:00,157.01,157.08,156.48,156.48,NaN,NaN,NaN,157.6366274145607,NaN,NaN,159.1920000000007,160.55833085270393,157.82566914729745,159.2540053638715,158.05059275362316,158.77399996707516,157.32718554017117,634,842.5,16.13097306751854,33.685982564751605,NaN,NaN,NaN,NaN,0.34559543774528273,33.90219010939614,524976,-0.2734386725303096,-0.5876836748205676,-0.314245002290258
2025-08-29T10:10:00-04:00,156.65,156.65,156.16,156.16,NaN,NaN,NaN,157.28950798662612,NaN,NaN,159.1356000000007,160.7436990513839,157.52750094861747,159.19520429109718,157.88985410094634,158.74215598075165,157.03755222114103,472,848.1666666666666,14.680489559474879,31.54809647282523,NaN,NaN,NaN,NaN,0.35591004933490605,37.35994614687252,524504,-0.30543529412949966,-0.6960391199521325,-0.39060382582263287
2025-08-29T10:15:00-04:00,156.16,156.44,156.08,156.44,NaN,NaN,NaN,157.153393987234,NaN,NaN,159.0812000000007,160.85754406549938,157.30485593450203,158.30216343287776,157.7433643189131,158.67456870843293,156.8121599293933,522,857.2,21.345043124021487,29.886249921223612,NaN,NaN,NaN,NaN,0.35620218866812603,40.60230896100212,525026,-0.28804872745488774,-0.7506647351412425,-0.4626160076863548
2025-08-29T10:20:00-04:00,156.89,157.1,156.81,157.1,NaN,NaN,NaN,157.153393987234,NaN,NaN,159.03600000000068,160.8947684092107,157.17723159079065,158.1517307463022,157.73693838974538,158.66662975637735,156.8072470231134,49,854.3,34.36047854722682,29.013303130108255,NaN,NaN,NaN,NaN,0.37790203233468816,41.24050318728709,525075,-0.21571393406976147,-0.7322584252735567,-0.5165444912037952
2025-08-29T10:25:00-04:00,156.89,156.89,156.5,156.6,NaN,NaN,NaN,157.153393987234,NaN,NaN,158.9776000000007,160.95177450065495,157.00342549934646,157.79638459704177,157.71953161320315,158.65157098482786,156.78749224157843,93,854.0666666666667,30.273469883182102,27.57682470522759,NaN,NaN,NaN,NaN,0.39376617288221005,42.13659401875748,524982,-0.18626740044165357,-0.7493787417558622,-0.5631113413142086
2025-08-29T10:30:00-04:00,156.81,156.96,156.76,156.76,NaN,NaN,NaN,157.153393987234,NaN,NaN,158.91860000000068,160.9762559865726,156.86094401342876,157.23960767763342,157.66998518030624,158.5985730737992,156.74139728681328,337,864.6,33.01903905750898,26.20563542580132,NaN,NaN,NaN,NaN,0.39135430339062455,42.74828672853953,525319,-0.14270183389316138,-0.7414886336806603,-0.5987867997874989
2025-08-29T10:35:00-04:00,156.78,157.08,156.72,157.08,NaN,NaN,NaN,157.153393987234,NaN,NaN,158.8700000000007,160.98351744707145,156.75648255292992,157.1576861421067,157.6428856509344,158.56368369366717,156.72208760820163,241,866.2666666666667,38.25560476112979,25.385048638281326,NaN,NaN,NaN,NaN,0.3891147102912952,42.931814607434816,525560,-0.0820344374725821,-0.7013298466282265,-0.6192954091556444
2025-08-29T10:40:00-04:00,156.98,157.03,156.73,156.73,NaN,NaN,NaN,157.153393987234,NaN,NaN,158.81940000000068,161.01277971155474,156.62602028844663,156.68714891368538,157.61287980475896,158.52942921823188,156.69633039128604,242,867.6333333333333,35.02981692340778,25.69655133783678,NaN,NaN,NaN,NaN,0.38632080241334715,43.10223335212329,525318,-0.056399092255159156,-0.6897942744745933,-0.6333951822194341
2025-08-29T10:45:00-04:00,156.65,156.72,156.46,156.46,NaN,NaN,NaN,157.153393987234,NaN,NaN,158.7624000000007,161.04800822518877,156.47679177481263,156.5007191309483,157.56711824817515,158.48945497022947,156.64478152612082,294,876.8333333333334,32.7365527983556,26.320187497354034,NaN,NaN,NaN,NaN,0.3780121736695353,43.593483063967135,525024,-0.048831047159930696,-0.6944339911693476,-0.6456029440094169
2025-08-29T10:50:00-04:00,156.41,156.41,156.2,156.2,NaN,NaN,NaN,157.153393987234,NaN,NaN,158.6990000000007,161.08723449414907,156.31076550585232,155.8991517285525,157.52232699083856,158.45903523125844,156.5856187504187,245,878.3333333333334,30.655339433934316,26.828742984265013,NaN,NaN,NaN,NaN,0.3695827326931413,44.33987735658614,524779,-0.05223449271682745,-0.7108960599054512,-0.6586615671886238
2025-08-29T10:55:00-04:00,156.33,156.33,156.12,156.29,NaN,NaN,NaN,157.153393987234,NaN,NaN,158.6435000000007,161.12238866209447,156.16461133790693,155.8991517285525,157.44624387011262,158.40351005739078,156.48897768283447,450,890.6,32.26072028912327,27.87325819851063,NaN,NaN,NaN,NaN,0.35818396607220315,45.11900155793887,525229,-0.039881006510341654,-0.7085128253265509,-0.6686318188162093
2025-08-29T11:05:00-04:00,156.505,156.505,156.505,156.505,NaN,NaN,NaN,157.153393987234,NaN,NaN,158.59220000000067,161.1388968094126,156.04550319058873,155.8991517285525,157.44499801455987,158.40224236077617,156.48775366834357,10,885.5,36.06840703666893,28.355096153451907,NaN,NaN,NaN,NaN,0.3479565399241889,45.19755710766971,525239,-0.010230866039023345,-0.6814204013649885,-0.6711895353259651
2025-08-29T11:10:00-04:00,156.93,156.93,156.81,156.81,NaN,NaN,NaN,157.153393987234,NaN,NaN,158.5448000000007,161.13384149040553,155.95575850959585,156.07188763841208,157.42366130678914,158.37007429390164,156.47724831967665,281,875.6333333333333,41.12435267789304,29.682754825061807,NaN,NaN,NaN,NaN,0.3534596442153191,43.89162422282789,525520,0.034473080832344905,-0.628098184285534,-0.6625712651178789
2025-08-29T11:15:00-04:00,157.02,157.02,156.85,156.85,NaN,NaN,NaN,157.153393987234,NaN,NaN,158.4976000000007,161.12221672612264,155.87298327387873,156.22851011072967,157.41445934653626,158.35489953977591,156.4740191532966,142,870.3666666666667,41.77469716276444,31.26535602301497,NaN,NaN,NaN,NaN,0.3432125267713683,42.41400695374048,525662,0.06927875511372816,-0.5759728212257187,-0.6452515763394469
2025-08-29T11:20:00-04:00,156.98,157.05,156.98,157.05,NaN,NaN,NaN,157.153393987234,NaN,NaN,158.4516000000007,161.09539760175255,155.80780239824884,156.3168080885837,157.40927982521225,158.34447858634306,156.47408106408145,108,863.0666666666667,45.043448808788966,33.33053286167715,NaN,NaN,NaN,NaN,0.33298306057341465,40.95055686184324,525770,0.10610873885187821,-0.5126156527745991,-0.6187243916264773
2025-08-29T11:25:00-04:00,156.97,156.97,156.97,156.97,NaN,NaN,NaN,157.153393987234,NaN,NaN,158.40320000000068,161.06505255772552,155.74134744227584,156.34344647086695,157.408195986512,158.34249452389366,156.47389744913033,20,855.2,43.979872130046175,35.42334590243224,NaN,NaN,NaN,NaN,0.3149128419610288,39.61234814944129,525750,0.1241660427855592,-0.46351683814452826,-0.5876828809300875
2025-08-29T11:30:00-04:00,156.82,156.91,156.71,156.78,NaN,NaN,NaN,157.153393987234,NaN,NaN,158.3488000000007,161.02987557503067,155.66772442497071,156.34344647086695,157.38385086057156,158.3069902427747,156.4607114783684,338,464.03333333333336,41.47507450588079,36.86120528685076,NaN,NaN,NaN,NaN,0.31099049610666896,38.89301978271953,525412,0.1222074584469044,-0.434923557871457,-0.5571310163183614
2025-08-29T11:35:00-04:00,156.84,156.84,156.75,156.75,NaN,NaN,NaN,157.153393987234,NaN,NaN,158.2924000000007,160.98695542883263,155.59784457116876,156.34344647086695,157.37671347766718,158.2966986073019,156.45672834803247,101,401.2,41.07726737630495,37.3409759174992,NaN,NaN,NaN,NaN,0.29520546067047854,38.225072013620746,525311,0.11773826603178716,-0.40995818377862747,-0.5276964498104146
2025-08-29T11:40:00-04:00,156.76,156.83,156.65,156.65,NaN,NaN,NaN,157.153393987234,NaN,NaN,158.2350000000007,160.94473947069596,155.52526052930543,156.34344647086695,157.3562189957652,158.26923566374134,156.44320232778907,271,405.8333333333333,39.710014450932874,38.015014815195684,NaN,NaN,NaN,NaN,0.2869764991940163,37.80774712512184,525040,0.10719416977277185,-0.3937037375944499,-0.5008979073672217
2025-08-29T11:45:00-04:00,156.69,156.82,156.63,156.8,NaN,NaN,NaN,157.153393987234,NaN,NaN,158.17980000000068,160.89177120911273,155.46782879088863,156.34344647086695,157.3402182956009,158.24633148056878,156.434105110633,239,409.8,42.78627746699554,38.71267470158758,NaN,NaN,NaN,NaN,0.28004960639444354,37.46181217280473,525279,0.10910527918237295,-0.36451630838925553,-0.4736215875716285
2025-08-29T11:50:00-04:00,156.69,156.79,156.66,156.66,NaN,NaN,NaN,157.153393987234,NaN,NaN,158.1244000000007,160.84510846638247,155.4036915336189,156.34344647086695,157.32377371346595,158.22379839736615,156.42374902956576,240,405.1333333333333,40.69898492160164,38.887201855907,NaN,NaN,NaN,NaN,0.2700460630805558,37.14058685993883,525039,0.09996709118632918,-0.34866272358871697,-0.44862981477504615
2025-08-29T11:55:00-04:00,156.72,156.72,156.54,156.54,NaN,NaN,NaN,157.153393987234,NaN,NaN,158.0638000000007,160.78798983168363,155.33961016831776,156.34344647086695,157.30114399861034,158.1958976187257,156.406390378495,300,387.93333333333334,38.94522195176595,39.16687364364687,NaN,NaN,NaN,NaN,0.26361420143194514,37.11294647957587,524739,0.08543096460603017,-0.3418411090175084,-0.4272720736235386
2025-08-29T12:00:00-04:00,156.68,156.68,156.68,156.68,NaN,NaN,NaN,157.153393987234,NaN,NaN,158.0030000000007,160.7122759178472,155.2937240821542,156.34344647086695,157.2947371497335,158.18707389584588,156.4024004036211,100,323.1666666666667,42.08096253780246,39.83433148217879,NaN,NaN,NaN,NaN,0.2547846156153787,37.087280412095964,524839,0.08467140061510242,-0.32143282285466057,-0.406104223469763
2025-08-29T12:10:00-04:00,156.96,157.25,156.96,157.25,156.2750017979699,156.2750017979699,156.2750017979699,NaN,NaN,NaN,157.95300000000069,160.6234636299804,155.28253637002098,156.6029791050617,157.2938242126118,158.18334782100465,156.40430060421897,63,291.9,52.72654278618271,41.41084600733939,NaN,NaN,NaN,NaN,0.2773000002142797,34.74410730499638,524902,0.1198351489506495,-0.2563102872814511,-0.3761454362321006
2025-08-29T12:25:00-04:00,157.33,157.33,157.14,157.14,156.41681989806216,NaN,NaN,NaN,NaN,NaN,157.9012000000007,160.53196077191484,155.27043922808656,156.71738328404936,157.2899623924915,158.16049041647685,156.41943436850616,435,278.56666666666666,50.786553822078425,42.7341198311219,NaN,NaN,NaN,NaN,0.2710642859132616,32.31024089081511,524467,0.13200245176852282,-0.2111423715214471,-0.3431448232899699
2025-08-29T12:30:00-04:00,157.16,157.18,157.07,157.18,156.41681989806216,NaN,NaN,NaN,NaN,NaN,157.8498000000007,160.43407936551748,155.26552063448392,156.71738328404936,157.28656189107167,158.14721941239216,156.42590436975118,242,266.6333333333333,51.48557897893165,43.83534639842638,NaN,NaN,NaN,NaN,0.2595596940623153,30.27452462612823,524709,0.13838998721559637,-0.1701573392704745,-0.30854732648607086
2025-08-29T12:35:00-04:00,157.23,157.26,157.17,157.26,156.44291854348222,NaN,NaN,NaN,NaN,NaN,157.79960000000068,160.3296741805466,155.26952581945477,156.7789253017916,157.28477202425137,158.1317604584369,156.43778359006583,341,269.3,52.92572763288529,44.67830175235439,NaN,NaN,NaN,NaN,0.24744828734357877,28.117611168591345,525050,0.14305731906272845,-0.1297256776576603,-0.27278299672038875
2025-08-29T12:40:00-04:00,157.3,157.31,157.27,157.28,156.546194973324,NaN,NaN,NaN,NaN,NaN,157.74880000000067,160.21577998351904,155.2818200164823,156.90014024143326,157.2847755341484,158.13097906945256,156.43857199884422,20,263.26666666666665,53.29896717456275,45.50146389605427,NaN,NaN,NaN,NaN,0.23334483824760968,26.290258988252468,525070,0.1422466749747354,-0.0949746530019695,-0.2372213279767049
2025-08-29T12:45:00-04:00,157.44,157.44,157.3,157.3,156.63818611090016,NaN,NaN,NaN,NaN,NaN,157.70300000000069,160.1159881887519,155.29001181124946,157.03211219314662,157.28550073233242,158.12675840493205,156.4442430597328,128,245.36666666666667,53.6943544225899,46.11938572561149,NaN,NaN,NaN,NaN,0.22810592122992304,25.04186462819742,525198,0.13772082805347138,-0.06507029290986566,-0.20279112096333704
2025-08-29T12:50:00-04:00,157.35,157.35,157.32,157.32,156.63818611090016,NaN,NaN,NaN,NaN,NaN,157.6562000000007,160.00547610957872,155.30692389042267,157.03211219314662,157.28591638704992,158.12324681179913,156.4485859623007,103,235.36666666666667,54.11273644611457,46.843161748187796,NaN,NaN,NaN,NaN,0.21538406971349874,23.88264129386059,525301,0.1307897227207693,-0.03930396756237542,-0.17009369028314472
2025-08-29T12:55:00-04:00,157.33,157.33,157.33,157.33,156.63818611090016,NaN,NaN,NaN,NaN,NaN,157.6118000000007,159.89933295911536,155.32426704088604,157.04395180361385,157.28592438117684,158.12317909210873,156.44866967024495,2,214.3,54.33490272833239,47.761720906934336,NaN,NaN,NaN,NaN,0.20071377901967877,22.806219626262102,525303,0.12177811513571923,-0.01787104636349568,-0.1396491614992149
2025-08-29T13:00:00-04:00,157.1,157.1,156.77,156.77,156.63818611090016,NaN,NaN,NaN,NaN,NaN,157.5558000000007,159.78519216806927,155.3264078319321,157.04395180361385,157.2678489127609,158.09052215826173,156.4451756672601,514,215.7,42.05540686609063,47.8315880133476,NaN,NaN,NaN,NaN,0.2263770805182733,22.548049913780275,524789,0.07528126707188151,-0.045547577659363014,-0.12082884473124453
2025-08-29T13:05:00-04:00,156.67,156.84,156.58,156.84,NaN,NaN,NaN,157.4330767492232,157.4330767492232,157.4330767492232,157.5040000000007,159.67642629311732,155.3315737068841,157.04395180361385,157.25861267086376,158.07672564825222,156.4404996934753,211,205.33333333333334,43.76618575170617,48.12131453483141,NaN,NaN,NaN,NaN,0.22877871762411026,22.80444998031009,525000,0.04776038506324347,-0.06112836340219019,-0.10888874846543366
2025-08-29T13:10:00-04:00,156.74,156.74,156.5,156.55,NaN,NaN,NaN,157.35657326062216,NaN,NaN,157.4464000000007,159.5635245024903,155.32927549751108,157.04395180361385,157.24515085847636,158.0602748170723,156.43002689988043,244,211.83333333333334,38.67212995557489,47.82744685544422,NaN,NaN,NaN,NaN,0.23672309493667407,23.240450653441084,524756,0.010492746510614145,-0.09577281532716597,-0.10626556183778012
2025-08-29T13:15:00-04:00,156.48,156.49,156.28,156.46,NaN,NaN,NaN,157.12491083968476,NaN,NaN,157.3858000000007,159.43793582372697,155.33366417627443,157.04395180361385,157.2139910133996,158.02927577210627,156.39870625469294,465,224.23333333333332,37.224097261777786,47.579240594028235,NaN,NaN,NaN,NaN,0.23910001672691236,24.15304546703901,524291,-0.01819072135119218,-0.12900396352677035,-0.11081324217557817
2025-08-29T13:20:00-04:00,156.56,156.56,156.56,156.56,NaN,NaN,NaN,157.12491083968476,NaN,NaN,157.33020000000067,159.31714233410818,155.34325766589316,157.04395180361385,157.2087853219772,158.022895735826,156.39467490812837,100,216.33333333333334,39.91613005715811,47.648591172984816,NaN,NaN,NaN,NaN,0.2291643012464182,24.678612723723102,524391,-0.02782334608558827,-0.1455924247825635,-0.11776907869697524
2025-08-29T13:25:00-04:00,156.79,156.79,156.63,156.63,NaN,NaN,NaN,157.12491083968476,NaN,NaN,157.2772000000007,159.19339118018738,155.36100881981403,157.04395180361385,157.20753355038508,158.02107705270535,156.3939900480648,30,209.3,41.79765754280173,47.62835510191333,NaN,NaN,NaN,NaN,0.22922399401453045,24.181065438206637,524421,-0.02686142819886038,-0.15134586394555072,-0.12448443574669034
2025-08-29T13:30:00-04:00,156.66,156.76,156.58,156.58,NaN,NaN,NaN,157.12491083968476,NaN,NaN,157.2222000000007,159.05562756579965,155.38877243420174,157.04395180361385,157.19861732061898,158.00882455065667,156.3884100905813,201,207.93333333333334,40.81449849173133,46.77749479516681,NaN,NaN,NaN,NaN,0.22570799444206244,23.859968883841585,524220,-0.02690637860248779,-0.1581174089998001,-0.1312110303973123
2025-08-29T13:35:00-04:00,156.56,156.7,156.53,156.7,NaN,NaN,NaN,157.12491083968476,NaN,NaN,157.1696000000007,158.9064878372034,155.43271216279803,157.04395180361385,157.1877661123457,157.99369143179825,156.38184079289317,255,206.63333333333333,44.206465637242545,46.30748849624996,NaN,NaN,NaN,NaN,0.22172885198191422,23.706192909040798,524475,-0.01666973024134491,-0.15204819319899343,-0.13537846295764852
2025-08-29T13:40:00-04:00,156.66,156.7,156.66,156.7,NaN,NaN,NaN,157.12491083968476,NaN,NaN,157.1162000000007,158.739675974267,155.49272402573442,157.04395180361385,157.18768932138016,157.99357675741103,156.3818018853493,2,198.53333333333333,44.20646563724255,45.78755182898645,NaN,NaN,NaN,NaN,0.20874821969749122,23.56340093244007,524475,-0.008145522955440687,-0.14556036665194938,-0.1374148436965087
2025-08-29T13:45:00-04:00,156.76,156.76,156.73,156.73,NaN,NaN,NaN,157.12491083968476,NaN,NaN,157.0618000000007,158.5450528574211,155.57854714258028,156.59116144289106,157.18093225668497,157.9825753315263,156.37928918184363,200,190.2,45.1184183084748,45.22988687724285,NaN,NaN,NaN,NaN,0.1981233468619563,23.13660728110714,524675,0.0007916016175307239,-0.1364253416745953,-0.13721694329212603
2025-08-29T13:50:00-04:00,156.81,156.81,156.81,156.81,NaN,NaN,NaN,157.12491083968476,NaN,NaN,157.0082000000007,158.32042217594832,155.69597782405307,156.47310835211684,157.18087627958445,157.98247181411102,156.37928074505788,2,189.93333333333334,47.579050626887266,44.821321409551736,NaN,NaN,NaN,NaN,0.18968596494324602,22.492726492030943,524677,0.012708114879144944,-0.12133179969319485,-0.1340399145723398
2025-08-29T13:55:00-04:00,156.7,156.7,156.6,156.65,NaN,NaN,NaN,157.12491083968476,NaN,NaN,156.9524000000007,158.06893256067363,155.83586743932776,156.47310835211684,157.1713563048042,157.96884989830394,156.37386271130444,242,188.63333333333333,43.38904263576678,44.08522771049294,NaN,NaN,NaN,NaN,0.19113696744730044,22.61644217266861,524435,0.010522164253540217,-0.12088720925541452,-0.13140937350895474
2025-08-29T14:00:00-04:00,156.61,156.61,156.51,156.57,NaN,NaN,NaN,157.12491083968476,NaN,NaN,156.90720000000067,157.8911413798977,155.92325862010364,156.47310835211684,157.16265186375475,157.95770397640368,156.36759975110581,196,190.43333333333334,41.4247177231748,43.17894065885439,NaN,NaN,NaN,NaN,0.18748432691535147,23.010056595962062,524239,0.004693084582103574,-0.12554301778132526,-0.13023610236342884
2025-08-29T14:05:00-04:00,156.68,156.78,156.68,156.78,NaN,NaN,NaN,157.12491083968476,NaN,NaN,156.8744000000007,157.7587339635283,155.99006603647308,156.47310835211684,157.13124721453167,157.90355850465087,156.35893592441246,1118,224.1,48.07070729451951,42.73149812786774,NaN,NaN,NaN,NaN,0.1890925892785412,22.507734930781968,525357,0.015382558210401215,-0.11100790460042731,-0.12639046281082852
2025-08-29T14:10:00-04:00,156.8,156.8,156.64,156.64,NaN,NaN,NaN,157.12491083968476,NaN,NaN,156.83950000000067,157.61346188476577,156.06553811523557,156.47310835211684,157.12705903335114,157.89684906901516,156.35726899768713,143,228.2,44.449868651499834,42.902531112539826,NaN,NaN,NaN,NaN,0.1870145471872186,22.182114761908682,525214,0.013493938860412391,-0.10952303923531304,-0.12301697809572543
2025-08-29T14:15:00-04:00,156.58,156.58,156.58,156.58,NaN,NaN,NaN,157.12491083968476,NaN,NaN,156.8145000000007,157.53797563818318,156.0910243618182,156.47310835211684,157.1266934010604,157.8963560111096,156.35703079101123,10,217.26666666666668,42.956505264510064,42.84469679202583,NaN,NaN,NaN,NaN,0.1779420795309868,22.09378379461518,525204,0.008895276746095512,-0.11189788216310603,-0.12079315890920155
2025-08-29T14:20:00-04:00,156.55,156.55,156.39,156.51,NaN,NaN,NaN,157.066381390562,NaN,NaN,156.78130000000067,157.39728314835307,156.16531685164827,156.47310835211684,157.11533079465121,157.8828589261416,156.34780266316082,269,222.86666666666667,41.21670358609199,43.02645205134848,NaN,NaN,NaN,NaN,0.17880335956448962,22.637123905062,524935,0.0021806310231058668,-0.1180673701303192,-0.12024800115342507
2025-08-29T14:25:00-04:00,156.45,156.47,156.45,156.47,NaN,NaN,NaN,157.03745496371823,NaN,NaN,156.7607000000007,157.3473583665346,156.1740416334668,156.47310835211684,157.11426236671906,157.8816146628808,156.34691007055733,25,214.66666666666666,40.21440056889971,43.24004514471432,NaN,NaN,NaN,NaN,0.1703174053098834,23.141654007619756,524910,-0.0035987195928235682,-0.12474640064445452,-0.12114768105163096
2025-08-29T14:30:00-04:00,156.53,156.53,156.53,156.53,NaN,NaN,NaN,157.03745496371823,NaN,NaN,156.7493000000007,157.33127597804432,156.16732402195706,156.47310835211684,157.11045758444035,157.87674965466212,156.3441655142186,100,210.03333333333333,42.47417244923794,43.422762458434306,NaN,NaN,NaN,NaN,0.16243759064489188,23.24903067006236,525010,-0.002098913654442064,-0.12377132311968353,-0.12167240946524147
2025-08-29T14:35:00-04:00,156.56,156.56,156.44,156.44,NaN,NaN,NaN,157.03745496371823,NaN,NaN,156.7485000000007,157.33206233517893,156.16493766482245,156.47310835211684,157.09456907678958,157.8575695248266,156.33156862875256,397,215.26666666666668,40.03001219776925,43.29650207664627,NaN,NaN,NaN,NaN,0.1594063341702571,23.667577970850523,524613,-0.005683161437996659,-0.12877636126273728,-0.12309319982474062
2025-08-29T14:40:00-04:00,156.45,156.45,156.37,156.37,NaN,NaN,NaN,156.9462199867576,NaN,NaN,156.7527000000007,157.32211095794935,156.18328904205202,156.39944918102705,157.0893802112868,157.8518995107058,156.32686091186778,118,209.2,38.189296875639236,43.10898767549684,NaN,NaN,NaN,NaN,0.15373445315809472,24.295595475514446,524495,-0.010976797057614396,-0.1368141961467586,-0.1258373990891442
2025-08-29T14:45:00-04:00,156.43,156.44,156.43,156.44,NaN,NaN,NaN,156.9462199867576,NaN,NaN,156.7527000000007,157.3221109579749,156.18328904202647,156.39944918102705,157.08125733723267,157.84246412505027,156.32005054941507,200,212.53333333333333,41.105772288688556,42.88750957917155,NaN,NaN,NaN,NaN,0.14775342078965892,24.87875458698809,524695,-0.008104851454679679,-0.1359684634074938,-0.12786361195281412
2025-08-29T14:50:00-04:00,156.43,156.5,156.41,156.5,NaN,NaN,NaN,156.9462199867576,NaN,NaN,156.7407000000007,157.30560002573029,156.1757999742711,156.39944918102705,157.07519447182517,157.83503507940014,156.3153538642502,161,215.8,43.56381908289701,42.84160625386115,NaN,NaN,NaN,NaN,0.14362817644754067,24.9956068670714,524856,-0.0008851339114963053,-0.1289700293421845,-0.12808489543068818
2025-08-29T14:55:00-04:00,156.47,156.47,156.47,156.47,NaN,NaN,NaN,156.9462199867576,NaN,NaN,156.73810000000068,157.30675064763827,156.1694493523631,156.39944918102705,157.0714888970528,157.83046944954168,156.31250834456392,100,204.63333333333333,42.60630326492089,42.66216946503588,NaN,NaN,NaN,NaN,0.13551187812985926,25.10411255572019,524756,0.0029396409855160233,-0.12441034419879315,-0.12734998518430918
2025-08-29T15:00:00-04:00,156.52,156.52,156.52,156.52,NaN,NaN,NaN,156.9462199867576,NaN,NaN,156.73330000000067,157.3051727472903,156.16142725271104,156.32310572026313,157.06813270853615,157.82601492040996,156.31025049666235,100,199.9,44.784583721856734,42.46256468610512,NaN,NaN,NaN,NaN,0.1294038868348701,24.829171319139828,524856,0.009534743651601646,-0.11543155561980711,-0.12496629927140876
2025-08-29T15:05:00-04:00,156.43,156.5,156.43,156.5,NaN,NaN,NaN,156.9310457351508,NaN,NaN,156.72170000000068,157.28847900373938,156.15492099626198,156.32310572026313,157.06626688506023,157.82367931928954,156.30885445083092,52,190.26666666666668,44.06417344547533,42.510788315370014,NaN,NaN,NaN,NaN,0.12658932348952248,24.993353122383066,524804,0.013031539836847086,-0.1086768744753499,-0.12170841431219699
2025-08-29T15:15:00-04:00,156.67,156.69,156.67,156.67,NaN,NaN,NaN,156.9310457351508,NaN,NaN,156.7205000000007,157.2874576695506,156.1535423304508,156.4329876609684,157.06394098373835,157.81968534769223,156.30819661978447,99,192.9,51.24355447931806,43.21213379795167,NaN,NaN,NaN,NaN,0.131118657525985,23.829349676787885,524903,0.026498724319914457,-0.08858500891230392,-0.11508373323221838
2025-08-29T15:20:00-04:00,156.74,156.77,156.64,156.73,NaN,NaN,NaN,156.9310457351508,NaN,NaN,156.72590000000068,157.2879522743384,156.16384772566295,156.4993901287747,157.05134430168786,157.79625169020295,156.30643691317277,618,209.23333333333332,53.51148442155482,43.600760735597056,NaN,NaN,NaN,NaN,0.13103875341698779,22.269576818592178,525521,0.03842884399264794,-0.06704767824140845,-0.10547652223405639
2025-08-29T15:25:00-04:00,156.7,156.7,156.51,156.52,NaN,NaN,NaN,156.9310457351508,NaN,NaN,156.7323000000007,157.27728150342142,156.18731849657996,156.4993901287747,157.02388855416186,157.75537382678172,156.292403281542,1056,241,45.52899440775218,43.677841146757935,NaN,NaN,NaN,NaN,0.13739312817291713,21.503266512052342,524465,0.0314518082937639,-0.06616176186685152,-0.09761357016061542
2025-08-29T15:30:00-04:00,156.6,156.63,156.6,156.6,NaN,NaN,NaN,156.9310457351508,NaN,NaN,156.7385000000007,157.27010229406375,156.20689770593765,156.4993901287747,157.01082555343376,157.73430256113255,156.28734854573497,595,260.76666666666665,48.67033612159438,44.08597192226396,NaN,NaN,NaN,NaN,0.13543647616056484,20.791692655979634,525060,0.031425319114700895,-0.058331921267239295,-0.08975724038194019
2025-08-29T15:35:00-04:00,156.63,156.63,156.48,156.57,NaN,NaN,NaN,156.9310457351508,NaN,NaN,156.7398000000007,157.26942613139025,156.21017386861118,156.4993901287747,156.9819313574608,157.69049576009107,156.27336695483055,1291,286.6666666666667,47.56261244014828,44.53925112612512,NaN,NaN,NaN,NaN,0.13647672786338202,20.72772990934881,523769,0.028665118767456102,-0.053925841922620066,-0.08259096069007617
2025-08-29T15:40:00-04:00,156.56,156.75,156.56,156.68,NaN,NaN,NaN,156.9310457351508,NaN,NaN,156.7372000000007,157.2666984788034,156.20770152119803,156.4993901287747,156.95655822595873,157.64177296029033,156.27134349162714,1743,337.73333333333335,51.88664404025736,45.37298280265067,NaN,NaN,NaN,NaN,0.14029981873028313,19.87766262485397,525512,0.03320531481446634,-0.041084317171993234,-0.07428963198645958
2025-08-29T15:45:00-04:00,156.68,156.79,156.65,156.72,NaN,NaN,NaN,156.9310457351508,NaN,NaN,156.73460000000068,157.2631332147435,156.20606678525786,156.4993901287747,156.93586529908828,157.59382801078883,156.27790258738773,2098,399.53333333333336,53.39173497014229,46.15280869700098,NaN,NaN,NaN,NaN,0.1402784031066905,18.838952192992547,527610,0.037540335213634285,-0.027364212969416712,-0.064904548183051
2025-08-29T15:50:00-04:00,156.76,156.77,156.52,156.52,NaN,NaN,NaN,156.9310457351508,NaN,NaN,156.7240000000007,157.24804579863527,156.19995420136613,156.4993901287747,156.89131797501264,157.51401279921507,156.2686231508102,3710,507.7,45.69478878620557,46.557435596175004,NaN,NaN,NaN,NaN,0.1481156600276412,18.55698792571169,523900,0.02611770522523764,-0.032257416651503945,-0.058375121876741584
2025-08-29T15:55:00-04:00,156.53,156.84,156.53,156.75,NaN,NaN,NaN,156.9310457351508,NaN,NaN,156.7196000000007,157.238983633826,156.2002163661754,156.4993901287747,156.8425726207245,157.38295523906163,156.30219000238736,9933,835.4666666666667,53.921484262875715,47.6811632666919,NaN,NaN,NaN,NaN,0.1603931128828092,17.841356407742555,533833,0.03279934629763813,-0.01737593900469392,-0.05017528530233205
2025-09-02T09:30:00-04:00,152.995,153.56,152,153.2,NaN,NaN,NaN,153.90972018170464,NaN,NaN,156.6480000000007,157.76153850362917,155.53446149637224,156.4993901287747,152.92,152.92,152.92,9050,1136.1333333333334,15.32697397321752,45.83982052987254,NaN,NaN,NaN,NaN,0.48822217624832287,22.36389633680138,524783,-0.1908273945085613,-0.28870952843803366,-0.09788213392947237
2025-09-02T09:35:00-04:00,153.25,154,153.25,154,152.43753982655466,152.43753982655466,152.43753982655466,NaN,NaN,NaN,156.5930000000007,157.93015668457218,155.25584331542922,156.4993901287747,152.96394935119298,153.14981601311152,152.77808268927444,506,1146.3,27.85828418671936,44.717996608716994,NaN,NaN,NaN,NaN,0.5104920208020148,25.571137042510152,525289,-0.2690423121434277,-0.43418502410875703,-0.16514271196532931
2025-09-02T09:40:00-04:00,154,154.68,154,154.31,153.11378801625673,NaN,NaN,NaN,NaN,NaN,156.5462000000007,158.02806849587895,155.06433150412246,156.4341105573969,153.13578355136767,153.62097226082318,152.65059484191215,1375,1183.6333333333334,32.054597130265535,43.96430331338446,NaN,NaN,NaN,NaN,0.5225997336018714,27.19705346320298,526664,-0.2826732143028049,-0.5184842298438355,-0.23581101554103057
2025-09-02T09:45:00-04:00,155,155.25,154.63,155.03,153.6413431064269,NaN,NaN,NaN,NaN,NaN,156.5108000000007,158.0501756653596,154.9714243346418,156.4341105573969,153.24007592752372,153.87445816445802,152.60569369058942,659,1205.5333333333333,40.68448569123647,43.67143916834016,NaN,NaN,NaN,NaN,0.5524140383445947,27.724657497231874,527323,-0.22830004074769555,-0.52118606647565,-0.29288602572795447
2025-09-02T09:50:00-04:00,155.32,155.6,155.32,155.5,154.14264569249838,NaN,NaN,NaN,NaN,NaN,156.48760000000073,158.05204269920392,154.92315730079753,156.4341105573969,153.31853368853368,154.065101310519,152.57196606654836,422,1212.9333333333334,45.54654852171182,43.77732310235705,NaN,NaN,NaN,NaN,0.5536701784628374,27.659335977419946,527745,-0.14958763557900573,-0.47987057020171164,-0.3302829346227059
2025-09-02T09:55:00-04:00,155.45,155.45,155.1,155.1,154.14264569249838,NaN,NaN,NaN,NaN,NaN,156.4588000000007,158.07062450629573,154.84697549370568,156.4341105573969,153.3497729195666,154.12856077669437,152.5709850624388,201,1219.5666666666666,42.363856800361866,43.143058982431604,NaN,NaN,NaN,NaN,0.5426937371440637,27.79538832638061,527544,-0.11492653295063843,-0.47394110081100393,-0.3590145678603655
2025-09-02T10:00:00-04:00,155.24,155.81,155.12,155.12,154.14264569249838,NaN,NaN,NaN,NaN,NaN,156.42760000000072,158.0809484082562,154.77425159174524,156.4341105573969,153.62101894448767,154.61763437613627,152.62440351283908,1916,1275.3666666666666,42.57990849163674,42.3622321302946,NaN,NaN,NaN,NaN,0.5546441844909168,27.34623256264863,529460,-0.08262756599425924,-0.46229902535318956,-0.3796714593589303
2025-09-02T10:05:00-04:00,155.15,155.15,154.91,154.97,154.14264569249838,NaN,NaN,NaN,NaN,NaN,156.3820000000007,158.06755747428159,154.6964425257198,156.36028844591755,153.66849249208192,154.67991758650254,152.6570673976613,500,1285.5,41.32861396181859,42.06220495558505,NaN,NaN,NaN,NaN,0.5321695998844234,27.139945468556785,528960,-0.06416298304656126,-0.4598751881671319,-0.39571220512057065
2025-09-02T10:10:00-04:00,154.77,155.19,154.77,154.85,154.14264569249838,NaN,NaN,NaN,NaN,NaN,156.3362000000007,158.06087685063173,154.61152314936967,156.35223075673403,153.77932917446452,154.80978977951375,152.7488685694153,1401,1294.9333333333334,40.30809342439616,41.464901905785176,NaN,NaN,NaN,NaN,0.5241574856069636,27.090209376394036,527559,-0.05327669759657583,-0.4623080771162904,-0.4090313795197146
2025-09-02T10:15:00-04:00,154.81,155.23,154.81,155.13,154.14264569249838,NaN,NaN,NaN,NaN,NaN,156.2952000000007,158.03509075492585,154.55530924507556,153.8767393755946,153.83598465879734,154.8770945260579,152.79487479153678,744,1314.9666666666667,43.79550668169993,41.19582292303887,NaN,NaN,NaN,NaN,0.5167176652064653,26.97157321323413,528303,-0.02206252537655712,-0.436609536240411,-0.41454701086385387
2025-09-02T10:20:00-04:00,155.07,155.4,155.07,155.34,154.14264569249838,NaN,NaN,NaN,NaN,NaN,156.25680000000068,157.9945707095977,154.51902929040367,154.07929644824355,153.86356993899707,154.9132632327005,152.81387664529365,329,1325.6,46.32818588975553,40.79879019800302,NaN,NaN,NaN,NaN,0.5033806891202902,26.54411113363257,528632,0.01583952245848458,-0.39474760779074813,-0.4105871302492327
2025-09-02T10:25:00-04:00,155.01,155.61,155.01,155.61,154.14264569249838,NaN,NaN,NaN,NaN,NaN,156.22340000000068,157.94534592224178,154.50145407775958,154.25343715859483,153.96645708256014,155.05138532546925,152.88152883965103,1219,1357.2666666666667,49.48028041131472,40.5194005866582,NaN,NaN,NaN,NaN,0.5102820684688425,25.758342042961612,529851,0.059739471539040356,-0.33591279082543224,-0.3956522623644726
2025-09-02T10:30:00-04:00,155.45,155.58,155.37,155.52,154.1792736730047,NaN,NaN,NaN,NaN,NaN,156.1878000000007,157.8927588379544,154.48284116204698,154.37474972687588,154.06514402872068,155.17934317405275,152.95094488338862,1269,1398.7333333333333,48.45866408807793,40.71682025107766,NaN,NaN,NaN,NaN,0.4909762064353544,25.028699315910007,528582,0.08198696373551195,-0.29316855769508265,-0.3751555214305946
2025-09-02T10:35:00-04:00,155.6,155.63,155.4,155.4,154.2468066878681,NaN,NaN,NaN,NaN,NaN,156.1494000000007,157.83702749418057,154.46177250582082,154.5507997815007,154.09704483469702,155.2183806001899,152.97570906920413,453,1410.5,47.063381360979776,40.22695575808508,NaN,NaN,NaN,NaN,0.47233504883282834,24.24989147132593,528129,0.08739547034255857,-0.2659111835023964,-0.35330665384495497
2025-09-02T10:40:00-04:00,155.23,155.26,154.91,154.91,154.2468066878681,NaN,NaN,NaN,NaN,NaN,156.10100000000068,157.78922391853843,154.41277608146294,154.5507997815007,154.11975826600477,155.236571151442,153.00294538056752,502,1414,41.77409210571546,42.11603562469208,NaN,NaN,NaN,NaN,0.47359683105905553,24.23006342970199,527627,0.058154376586300294,-0.28061368311207957,-0.33876805969837986
2025-09-02T10:45:00-04:00,155.03,155.17,154.89,154.89,154.2468066878681,NaN,NaN,NaN,NaN,NaN,156.0634000000007,157.77394428737605,154.35285571262537,154.5507997815007,154.14457880306327,155.2546422169241,153.03451538920243,608,1430.3333333333333,41.568739769263544,43.09535388058809,NaN,NaN,NaN,NaN,0.45976848598340875,24.238885845282685,527019,0.03859020745656949,-0.290530300377668,-0.3291205078342375
2025-09-02T10:50:00-04:00,154.52,154.71,154.5,154.7,154.2468066878681,NaN,NaN,NaN,NaN,NaN,156.0206000000007,157.75815418881697,154.28304581118445,154.5507997815007,154.15451628840512,155.255492044769,153.05354053204124,436,1438.2,39.57826066979335,43.6327584191258,NaN,NaN,NaN,NaN,0.45478502269887855,24.761908210526833,526583,0.015179975545837832,-0.31014553840194026,-0.3253255139477781
2025-09-02T10:55:00-04:00,154.56,154.89,154.56,154.89,154.2468066878681,NaN,NaN,NaN,NaN,NaN,155.98740000000072,157.74652619191338,154.22827380808806,154.5507997815007,154.1693097574579,155.26133221235628,153.07728730255954,523,1450.2666666666667,42.54125994633845,43.76538515163308,NaN,NaN,NaN,NaN,0.44587180679181465,24.822658191846088,527106,0.01480242305074464,-0.3068224851343473,-0.32162490818509193
2025-09-02T11:00:00-04:00,154.92,155.14,154.77,154.77,154.2468066878681,NaN,NaN,NaN,NaN,NaN,155.9536000000007,157.73983967011804,154.16736032988337,154.5507997815007,154.1907559534258,155.2734643170004,153.1080475898512,675,1469.4333333333334,41.16812953324097,43.45264093817087,NaN,NaN,NaN,NaN,0.44045239202096903,24.31069260863831,526431,0.009063886222081763,-0.3102950504074897,-0.3193589366295715
2025-09-02T11:05:00-04:00,154.55,154.71,154.42,154.71,154.2468066878681,NaN,NaN,NaN,NaN,NaN,155.9166000000007,157.72753394664417,154.10566605335723,154.5507997815007,154.20163203648283,155.27240938470908,153.1308546882566,602,1486.1666666666667,40.46484031957603,43.31699690382902,NaN,NaN,NaN,NaN,0.4339915068766157,24.34808261139474,525829,0.004074413254615217,-0.3142659200613025,-0.3183403333159177
2025-09-02T11:10:00-04:00,154.58,154.73,154.49,154.49,154.2468066878681,NaN,NaN,NaN,NaN,NaN,155.87380000000073,157.71615019447307,154.03144980552838,154.5507997815007,154.20614329954955,155.27111468212937,153.14117191696974,290,1494.1,37.907690015367535,42.98326701266694,NaN,NaN,NaN,NaN,0.42013497067114175,24.335218392500217,525539,-0.010404117201527452,-0.331345479817827,-0.3209413626162996
2025-09-02T11:15:00-04:00,154.53,154.53,154.37,154.37,154.2468066878681,NaN,NaN,NaN,NaN,NaN,155.8296000000007,157.70775211287287,153.95144788712855,154.5507997815007,154.20796231155776,155.26864932799708,153.14727529511845,200,1497.4666666666667,36.55087858355626,42.64200019993392,NaN,NaN,NaN,NaN,0.40155390133748853,24.503819437785715,525339,-0.023665737097470774,-0.35052353398813807,-0.3268577968906673
2025-09-02T11:20:00-04:00,154.26,154.45,154.24,154.45,NaN,NaN,NaN,155.49155775395693,155.49155775395693,155.49155775395693,155.78460000000075,157.68486612848244,153.88433387151906,154.5507997815007,154.2133498296284,155.25772647961094,153.1689731796459,772,1502.6,38.14049392603335,42.48717166433658,NaN,NaN,NaN,NaN,0.3878714798133807,24.85637223289438,526111,-0.02265195323554703,-0.3551727384351011,-0.3325207851995541
2025-09-02T11:25:00-04:00,154.42,154.56,154.42,154.44,NaN,NaN,NaN,155.49155775395693,NaN,NaN,155.73940000000073,157.6578469132863,153.82095308671515,154.17253567240215,154.22085693651104,155.25096517864822,153.19074869437387,733,1491.8333333333333,38.01229475480033,42.07408509812946,NaN,NaN,NaN,NaN,0.37016637411242603,24.878778448293755,525378,-0.01843572844409913,-0.35556544575467797,-0.33712971731057884
2025-09-02T11:30:00-04:00,154.29,154.29,154.29,154.29,NaN,NaN,NaN,155.49155775395693,NaN,NaN,155.69060000000073,157.629793275329,153.75140672467245,154.17253567240215,154.2211444562133,155.24911833129912,153.19317058112748,106,1475.5333333333333,36.05464039714841,41.3402604200861,NaN,NaN,NaN,NaN,0.35444020453296743,25.114928402429292,525272,-0.021325751370360357,-0.3637869065235293,-0.34246115515316894
2025-09-02T11:35:00-04:00,154,154,153.81,153.81,NaN,NaN,NaN,155.00458220880873,NaN,NaN,155.63060000000075,157.61270962337292,153.6484903766286,154.17253567240215,154.21640702188859,155.2381516868977,153.19466235687946,352,1444.2333333333333,30.620202316601635,39.993111984749454,NaN,NaN,NaN,NaN,0.3634087613520404,26.042519157090492,524920,-0.04952955627654043,-0.40437310049884445,-0.354843544222304
2025-09-02T11:40:00-04:00,153.73,153.74,153.73,153.74,NaN,NaN,NaN,154.7955102902265,NaN,NaN,155.57240000000075,157.60169173828504,153.54310826171647,154.17253567240215,154.21636989746565,155.23808374331023,153.19465605162108,2,1386.2,29.91212253511158,38.66835901668043,NaN,NaN,NaN,NaN,0.34316527839832417,27.01078108801035,524918,-0.06584292921774121,-0.4371472057444805,-0.3713042765267393
2025-09-02T11:45:00-04:00,153.62,153.74,153.6,153.63,NaN,NaN,NaN,154.70139618612532,NaN,NaN,155.51360000000076,157.59360292284663,153.4335970771549,154.17253567240215,154.20447890630916,155.2184983321905,153.19045948042782,561,1334.9666666666667,28.785627785811613,37.3628051898827,NaN,NaN,NaN,NaN,0.3286534727984449,28.08506512706863,524357,-0.07625107299146827,-0.46661811776607465,-0.3903670447746064
2025-09-02T11:50:00-04:00,153.19,153.27,153.15,153.27,NaN,NaN,NaN,154.25996908675597,NaN,NaN,155.44340000000074,157.58374991510192,153.30305008489955,153.90466128913275,154.17105068753656,155.18318742720555,153.15891394786757,938,1242.5666666666666,25.41256145629231,36.19412442920962,NaN,NaN,NaN,NaN,0.3394639390271267,29.626781623641996,523419,-0.09819294576610693,-0.51310822698224,-0.4149152812161331
2025-09-02T11:55:00-04:00,153.25,153.49,153.19,153.38,NaN,NaN,NaN,154.25996908675597,NaN,NaN,155.37820000000073,157.56684228212364,153.18955771787782,153.90466128913275,154.13019607161885,155.13268164320283,153.12771050003488,1438,959.4,28.18178890035277,35.23791365285885,NaN,NaN,NaN,NaN,0.3366450862394756,30.36631201103142,524857,-0.0959956036248788,-0.5349097857472316,-0.4389141821223528
2025-09-02T12:00:00-04:00,153.47,153.65,153.47,153.6,NaN,NaN,NaN,154.25996908675597,NaN,NaN,155.31860000000074,157.5352100602283,153.10198993977318,153.90466128913275,154.10767650163916,155.0957904338508,153.11956256942753,1213,698.1666666666666,33.49958825852761,34.803722766339874,NaN,NaN,NaN,NaN,0.33188472293665666,30.570534784761662,526070,-0.07154472111616916,-0.5283450835175643,-0.4568003624013951
2025-09-02T12:05:00-04:00,153.52,153.52,153.23,153.23,NaN,NaN,NaN,154.25996908675597,NaN,NaN,155.25300000000072,157.51829733128537,152.98770266871608,153.90466128913275,154.09565268294818,155.08083483520812,153.11047053068825,469,696.9333333333333,29.538218438840943,33.8749340872329,NaN,NaN,NaN,NaN,0.33460724272689585,31.10507913028699,525601,-0.0719168630530933,-0.5466964412177617,-0.4747795781646684
2025-09-02T12:10:00-04:00,153.31,153.42,153.31,153.42,NaN,NaN,NaN,154.25996908675597,NaN,NaN,155.19200000000075,157.48699281024824,152.89700718975325,153.90466128913275,154.08703656862428,155.06933337463693,153.10473976261164,373,663.5333333333333,33.8632130608061,33.35315433920184,NaN,NaN,NaN,NaN,0.3242781539606888,31.60144173684622,525974,-0.05192628269930105,-0.5396874315387947,-0.4877611488394937
2025-09-02T12:15:00-04:00,153.49,153.5,153.46,153.5,NaN,NaN,NaN,154.25996908675597,NaN,NaN,155.13140000000075,157.44183549121863,152.82096450878288,153.69072903130618,154.06445852318834,155.03485291362574,153.09406413275093,1205,681.7333333333333,35.65412299679751,33.009531673289096,NaN,NaN,NaN,NaN,0.3068297143920691,31.79417594916716,527179,-0.02712227427826036,-0.5216639916873191,-0.4945417174090588
2025-09-02T12:20:00-04:00,153.52,153.59,153.48,153.52,NaN,NaN,NaN,154.25996908675597,NaN,NaN,155.07300000000075,157.3957578433992,152.7502421566023,153.28058322504495,154.05421697073592,155.0180579449894,153.09037599648244,626,688.5333333333333,36.119839198203195,32.88182804349164,NaN,NaN,NaN,NaN,0.29277044907835087,31.66715795591482,527805,-0.00436881218405849,-0.5000027326391319,-0.4956339204550734
2025-09-02T12:25:00-04:00,153.34,153.34,153.28,153.31,NaN,NaN,NaN,154.24967616340723,NaN,NaN,155.01180000000073,157.35579211583317,152.6678078841683,153.17757326402878,154.05180997131876,155.01501833725203,153.0886016053855,106,685.3666666666667,33.387361047030325,32.65586250516835,NaN,NaN,NaN,NaN,0.28900113128704075,31.903739816204418,527699,0.0012385278454726811,-0.4940857606482325,-0.4953242884937052
2025-09-02T12:30:00-04:00,153.39,153.5,153.39,153.44,NaN,NaN,NaN,154.24967616340723,NaN,NaN,154.95180000000073,157.30006809352554,152.60353190647592,153.17757326402878,154.0461084915166,155.00658429884274,153.08563268419047,310,631.8333333333334,36.58557623396321,32.544796955734775,NaN,NaN,NaN,NaN,0.2819296219093948,31.56824130357571,528009,0.017500247552936554,-0.47344897905253447,-0.490949226605471
2025-09-02T12:35:00-04:00,153.43,153.5,153.43,153.43,NaN,NaN,NaN,154.24967616340723,NaN,NaN,154.89040000000074,157.23407219531362,152.54672780468786,153.06216800458043,154.04251116585556,155.00117422335398,153.08384810835713,202,621.9,36.440639535786666,32.43253586866236,NaN,NaN,NaN,NaN,0.266791791773009,31.256706970420485,527807,0.030613100276018268,-0.45268285126044816,-0.48329595153646643
2025-09-02T12:40:00-04:00,153.49,153.64,153.47,153.48,NaN,NaN,NaN,154.24967616340723,NaN,NaN,154.83060000000071,157.16255680901352,152.4986431909879,153.16856001467613,154.0344188842894,154.98762698368327,153.08121078489555,534,593,37.768143744749025,32.554928964919554,NaN,NaN,NaN,NaN,0.26273523521779263,30.46578604144382,528341,0.044824193150433345,-0.42726571009842473,-0.4720899032488581
2025-09-02T12:45:00-04:00,153.55,153.69,153.41,153.41,NaN,NaN,NaN,154.24967616340723,NaN,NaN,154.76840000000072,157.08263200200116,152.4541679980003,153.1728480117409,154.02522179606387,154.97267666666278,153.07776692546497,596,588.0666666666667,36.615142346532195,32.98313896705746,NaN,NaN,NaN,NaN,0.2639684327022361,29.87302114132686,527745,0.05121838964272507,-0.40806691619545177,-0.45928530583817684
2025-09-02T12:50:00-04:00,153.46,153.74,153.46,153.64,NaN,NaN,NaN,154.24967616340723,NaN,NaN,154.71120000000073,156.99255272132413,152.42984727867733,153.1728480117409,154.0219567034678,154.9663554402839,153.07755796665168,275,586.2666666666667,42.79466856419993,33.90332082627805,NaN,NaN,NaN,NaN,0.2686849732235058,29.132251829718747,528020,0.07140647465003935,-0.37002721252562765,-0.441433687175667
2025-09-02T12:55:00-04:00,153.75,153.91,153.75,153.86,NaN,NaN,NaN,154.24967616340723,NaN,NaN,154.65500000000074,156.87827416192488,152.4317258380766,153.31202272751418,154.01782015888222,154.9518162086189,153.08382410914552,807,572.5333333333333,48.01531852556425,35.276870164831806,NaN,NaN,NaN,NaN,0.2687789037075418,27.813066182868422,528827,0.09838108253324512,-0.3184573340091106,-0.4168384165423557
2025-09-02T13:00:00-04:00,153.99,154.12,153.99,154.08,NaN,NaN,NaN,154.24967616340723,NaN,NaN,154.60200000000071,156.74995530659302,152.4540446934084,153.51161818201135,154.0184273722831,154.94618674900852,153.09066799555768,480,546.2333333333333,52.667261519771024,37.22363445508029,NaN,NaN,NaN,NaN,0.26815183915700247,25.88002905976569,529307,0.12797106757208865,-0.2568745820772449,-0.38484564964933354
2025-09-02T13:05:00-04:00,154.03,154.15,154.01,154.01,NaN,NaN,NaN,154.24967616340723,NaN,NaN,154.55180000000072,156.63443559921208,152.46916440078937,153.59329454560907,154.01970139896468,154.93190049087974,153.10750230704963,1240,572.4666666666667,51.1003554583176,38.860674923506345,NaN,NaN,NaN,NaN,0.2589981363600748,24.075673840421537,528067,0.1388503699769087,-0.21128268717819765,-0.35013305715510634
2025-09-02T13:10:00-04:00,153.96,153.97,153.77,153.77,NaN,NaN,NaN,154.24967616340723,NaN,NaN,154.49520000000072,156.50463868757492,152.48576131242652,153.59329454560907,154.01703116312322,154.92281781041575,153.1112445158307,551,574.1,46.04257774578913,39.75660274402503,NaN,NaN,NaN,NaN,0.25764112662006805,23.065250471181667,527516,0.1262663970549407,-0.19230006083643048,-0.31856645789137117
2025-09-02T13:15:00-04:00,153.85,153.97,153.85,153.97,NaN,NaN,NaN,154.24967616340723,NaN,NaN,154.4432000000007,156.36796259293462,152.51843740706678,153.59329454560907,154.0167486540695,154.92107753405512,153.11241977408386,123,557.9333333333333,50.44439526716867,41.24990108890558,NaN,NaN,NaN,NaN,0.25352390329006236,22.127000199744646,527639,0.12742775579170562,-0.15928176315173914,-0.28670951894344476
2025-09-02T13:20:00-04:00,154.01,154.12,154.01,154.12,NaN,NaN,NaN,154.24967616340723,NaN,NaN,154.3920000000007,156.2092286590193,152.57477134098212,153.60316680735187,154.0171694682646,154.9186515890585,153.1156873474707,241,551.4333333333333,53.50781658601806,42.65308705499215,NaN,NaN,NaN,NaN,0.246129338769344,20.701205751370765,527880,0.13366222495449592,-0.11963173775032487,-0.2532939627048208
2025-09-02T13:25:00-04:00,154.16,154.365,154.16,154.3,153.44758203176664,153.44758203176664,153.44758203176664,NaN,NaN,NaN,154.34360000000072,156.03477123885176,152.65242876114968,153.8290334458815,154.02039435294526,154.91667912873527,153.12410957715525,483,550.1,56.94720504987648,44.174021487354935,NaN,NaN,NaN,NaN,0.2460486717143912,19.87423345320717,528363,0.14435948694113337,-0.07284460402840409,-0.21720409096953747
2025-09-02T13:30:00-04:00,154.4,154.63,154.4,154.63,153.69212375759545,NaN,NaN,NaN,NaN,NaN,154.30580000000072,155.88122674826087,152.73037325174056,154.0362267567052,154.0291898006656,154.92063730028988,153.1377423010413,648,549.2,62.43404001471348,46.05360725996281,NaN,NaN,NaN,NaN,0.2520451951633621,19.84656741555494,529011,0.1665367979623334,-0.009033093516620738,-0.17556989147895413
2025-09-02T13:35:00-04:00,154.59,154.75,154.59,154.75,153.86270904134113,NaN,NaN,NaN,NaN,NaN,154.2658000000007,155.6847522328682,152.8468477671332,154.19498140536416,154.0437077592579,154.93076672770704,153.15664879080876,873,558.2333333333333,64.21976950294126,48.25592214967073,NaN,NaN,NaN,NaN,0.24547053836597885,20.12384905136986,529884,0.1809657295717074,0.05063727048568012,-0.13032845908602728
2025-09-02T13:40:00-04:00,154.69,154.85,154.69,154.85,153.97758590309832,NaN,NaN,NaN,NaN,NaN,154.2988000000007,155.69361118404413,152.9039888159573,154.32598512429132,154.0530088092719,154.93848632190736,153.1675312966364,502,565.3,65.683714915696,50.33436062693736,NaN,NaN,NaN,NaN,0.23936549991126582,20.627270228184763,530386,0.18809292785951814,0.1047877007383704,-0.08330522712114774
2025-09-02T13:45:00-04:00,154.76,154.76,154.73,154.73,153.97758590309832,NaN,NaN,NaN,NaN,NaN,154.31340000000074,155.71067511933458,152.9161248806669,154.32598512429132,154.05519941622313,154.94011206222345,153.17028677022282,130,562.9666666666667,62.38512210527417,52.18753795332932,NaN,NaN,NaN,NaN,0.23083939277474716,21.094732749512893,530256,0.17580133377828408,0.13644644010170737,-0.03935489367657671
2025-09-02T14:00:00-04:00,154.59,154.75,154.59,154.75,153.97758590309832,NaN,NaN,NaN,NaN,NaN,154.32220000000072,155.72481065130205,152.9195893486994,154.32598512429132,154.06223328724033,154.9448126456256,153.17965392885506,452,552.3,62.72114356571178,53.96989508339809,NaN,NaN,NaN,NaN,0.22577943614797927,20.908445535834925,530708,0.16051654865116455,0.16129079213737896,0.0007742434862144237
2025-09-02T14:10:00-04:00,154.41,154.41,154.35,154.35,153.97758590309832,NaN,NaN,NaN,NaN,NaN,154.30860000000072,155.6966058210016,152.92059417899983,154.32598512429132,154.07045212347313,154.9425797999465,153.19832444699978,1131,565.5666666666667,52.60042612137953,55.111701067315764,NaN,NaN,NaN,NaN,0.23822376213740973,19.787873726417924,529577,0.11698767457052502,0.1470088366993707,0.030021162128845685
2025-09-02T14:15:00-04:00,154.32,154.32,154.31,154.31,153.97758590309832,NaN,NaN,NaN,NaN,NaN,154.28480000000073,155.63043733566343,152.93916266433803,154.32598512429132,154.07110413821255,154.9421510784066,153.2000571980185,114,565.8333333333334,51.70198578980467,55.74793801200182,NaN,NaN,NaN,NaN,0.22406492198473704,18.599280749846905,529463,0.0807455286199352,0.13095307290376468,0.05020754428382948
2025-09-02T14:20:00-04:00,154.31,154.51,154.31,154.43,153.97758590309832,NaN,NaN,NaN,NaN,NaN,154.2714000000007,155.59750111196425,152.94529888803717,154.32598512429132,154.0741689228088,154.94194963379604,153.20638821182158,380,566.7666666666667,54.22783472296658,56.191689168959115,NaN,NaN,NaN,NaN,0.22234599898582644,18.128923083918565,529843,0.060997226689920206,0.12645407764622973,0.06545685095630953
2025-09-02T14:25:00-04:00,154.22,154.22,154.22,154.22,153.97758590309832,NaN,NaN,NaN,NaN,NaN,154.25340000000074,155.5571828650178,152.94961713498367,154.32598512429132,154.07450849128364,154.9413067959813,153.20771018658598,100,570.0333333333333,49.362650389865294,55.955645516823,NaN,NaN,NaN,NaN,0.22146414191541083,17.335179095474903,529743,0.03142333119485527,0.10473601494987861,0.07331268375502334
2025-09-02T14:30:00-04:00,154.27,154.33,154.26,154.26,153.97758590309832,NaN,NaN,NaN,NaN,NaN,154.23920000000072,155.52682006785417,152.95157993214727,154.32598512429132,154.0769307633295,154.93897720880298,153.21488431785602,504,568.1333333333333,50.277718589353086,55.89688574046839,NaN,NaN,NaN,NaN,0.21350241749288248,16.96654099558313,530247,0.013124052303360029,0.08971774913422337,0.07659369683086334
2025-09-02T14:35:00-04:00,154.27,154.32,154.27,154.32,153.97758590309832,NaN,NaN,NaN,NaN,NaN,154.2286000000007,155.5046063319378,152.95259366806363,154.32598512429132,154.07796811760215,154.9381732887187,153.2177629464856,200,543.5333333333333,51.68802421396939,56.30013191676698,NaN,NaN,NaN,NaN,0.2025379591005339,16.624234188540772,530447,0.004097204017391776,0.08171520185260306,0.07761799783521128
2025-09-02T14:40:00-04:00,154.24,154.26,154.14,154.14,153.97758590309832,NaN,NaN,NaN,NaN,NaN,154.2088000000007,155.45870009166757,152.95889990833385,154.32598512429132,154.07900238867347,154.9348976403464,153.22310713700054,447,510.5,47.34912020074785,56.07904084059406,NaN,NaN,NaN,NaN,0.20092810487906768,15.740249329029846,530000,-0.013970239771497986,0.060155198120838804,0.07412543789233679
2025-09-02T14:45:00-04:00,154.12,154.48,154.11,154.48,153.97758590309832,NaN,NaN,NaN,NaN,NaN,154.1916000000007,155.40179905766283,152.98140094233858,154.28663047954646,154.0858560222355,154.93221936048113,153.23949268398988,1116,507.26666666666665,55.02838571176983,56.1876529210049,NaN,NaN,NaN,NaN,0.21300466881627542,15.699642920791188,531116,-0.003540002230228864,0.0697004351045507,0.07324043733477957
2025-09-02T14:50:00-04:00,154.54,154.7,154.54,154.7,153.97758590309832,NaN,NaN,NaN,NaN,NaN,154.1734000000007,155.32361118025395,153.02318881974745,154.28663047954646,154.092620306639,154.93608845481316,153.24915215846482,552,510.03333333333336,59.177384643657035,56.346951463417795,NaN,NaN,NaN,NaN,0.21350433532939853,16.324888763647714,531668,0.01655520831289624,0.09393444772589987,0.07737923941300363
2025-09-02T14:55:00-04:00,154.61,154.61,154.52,154.52,153.97758590309832,NaN,NaN,NaN,NaN,NaN,154.15340000000072,155.24240402163866,153.06439597836277,154.18595005974026,154.09795418061404,154.9379262118899,153.25798214933818,540,515.6,54.728483385591105,55.796554561337636,NaN,NaN,NaN,NaN,0.21111116852015424,16.811260973138364,531128,0.01609001435397353,0.09749175735547055,0.08140174300149702
2025-09-02T15:00:00-04:00,154.63,154.77,154.59,154.75,153.98047172148512,NaN,NaN,NaN,NaN,NaN,154.1404000000007,155.18414678882314,153.09665321117828,154.2440080382338,154.1080080489307,154.94456099046695,153.27145510739447,782,501.5,58.97280990605975,55.42177173298895,NaN,NaN,NaN,NaN,0.21388894219728607,17.72226715544992,531910,0.028890913178221414,0.11751538447427379,0.08862447129605237
2025-09-02T15:05:00-04:00,154.79,154.79,154.79,154.79,153.98047172148512,NaN,NaN,NaN,NaN,NaN,154.13800000000072,155.17518850705378,153.10081149294766,154.34920643058703,154.10802253228,154.94457249452526,153.27147257003472,1,480.6666666666667,59.680776461682285,54.99299041484512,NaN,NaN,NaN,NaN,0.20146830346890793,18.624235312359193,531911,0.03714449332268674,0.1350550879494108,0.09791059462672405
2025-09-02T15:10:00-04:00,154.75,154.81,154.7,154.81,154.09741328341926,NaN,NaN,NaN,NaN,NaN,154.1364000000007,155.1691807895205,153.10361921048087,154.40236514446963,154.1150266868394,154.94992746510823,153.28012590857057,501,493.8333333333333,60.05196205338648,54.82633612542457,NaN,NaN,NaN,NaN,0.19493485322112974,18.9849713533615,532412,0.04075422281511114,0.14885337314561298,0.10809915033050184
2025-09-02T15:15:00-04:00,154.83,154.88,154.83,154.88,154.21775813417295,NaN,NaN,NaN,NaN,NaN,154.1400000000007,155.18182916027538,153.098170839726,154.51889211557568,154.11837663605493,154.95290305668075,153.2838502154291,214,490.6333333333333,61.39167763488716,54.731374273222805,NaN,NaN,NaN,NaN,0.1860109351339057,19.544174019561307,532626,0.044362044773743864,0.16355170629768168,0.11918966152393781
2025-09-02T15:20:00-04:00,154.77,154.77,154.75,154.75,154.21775813417295,NaN,NaN,NaN,NaN,NaN,154.1372000000007,155.17167795492264,153.10272204507874,154.51889211557568,154.11984204008655,154.95396952358448,153.28571455658863,110,487.56666666666666,57.53278622895199,55.08368570947799,NaN,NaN,NaN,NaN,0.18201015405291213,19.626990273347303,532516,0.034914900301346946,0.1628332869006215,0.12791838659927454
2025-09-02T15:25:00-04:00,154.72,154.75,154.72,154.75,154.21775813417295,NaN,NaN,NaN,NaN,NaN,154.1368000000007,155.1703139279196,153.1032860720818,154.51889211557568,154.12308671580334,154.95623140326936,153.28994202833732,252,478.1666666666667,57.53278622895199,55.500171455131365,NaN,NaN,NaN,NaN,0.17115228590627565,19.539329649668307,532516,0.025997108886555542,0.16041477270746896,0.1344176638209134
2025-09-02T15:30:00-04:00,154.77,154.86,154.77,154.86,154.2257074643666,NaN,NaN,NaN,NaN,NaN,154.13980000000072,155.1807955999889,153.09880440001254,154.56651276317476,154.12550013794058,154.95824292292014,153.29275735296102,165,463.8,60.00013359576271,55.91247851747395,NaN,NaN,NaN,NaN,0.1667842654843998,19.86643610027512,532681,0.02483928142504399,0.1654667656022184,0.1406274841771744
2025-09-02T15:35:00-04:00,154.85,154.93,154.85,154.89,154.31658439780446,NaN,NaN,NaN,NaN,NaN,154.1478000000007,155.2054524189002,153.0901475811012,154.6552102105398,154.13981161509517,154.97120516354713,153.3084180666432,922,485.3666666666667,60.67125314446934,56.72023585708852,NaN,NaN,NaN,NaN,0.16058538937837216,20.41858051612774,533603,0.023443917410440024,0.16993238094022445,0.14648846352978442
2025-09-02T15:40:00-04:00,154.92,155,154.92,154.93,154.39764874335881,NaN,NaN,NaN,NaN,NaN,154.1590000000007,155.23748226652086,153.08051773348055,154.72516816843182,154.18384984863906,155.01293594129675,153.35476375598137,2831,552.8333333333334,61.59645414500837,57.52871696820676,NaN,NaN,NaN,NaN,0.15697214727991798,21.174531165599085,536434,0.022557560581771413,0.17468541425699868,0.15212785367522727
2025-09-02T15:45:00-04:00,154.87,154.89,154.78,154.84,154.39764874335881,NaN,NaN,NaN,NaN,NaN,154.1668000000007,155.2591401664288,153.0744598335726,154.72516816843182,154.21949401898678,155.03915907957446,153.3998289583991,3008,637.1,58.27465840995055,57.999190839348266,NaN,NaN,NaN,NaN,0.15647413675992425,21.015750652028366,533426,0.013688994345975869,0.1692390966076971,0.15555010226172122
2025-09-02T15:50:00-04:00,154.78,154.96,154.76,154.96,154.39764874335881,NaN,NaN,NaN,NaN,NaN,154.1772000000007,155.28946644252895,153.06493355747247,154.72516816843182,154.2458218357724,155.0598539311709,153.43178974037392,2240,670.4333333333333,61.2734702238013,58.99378726956637,NaN,NaN,NaN,NaN,0.15958312699135946,21.141521049803337,535666,0.013652748206134963,0.17261603751938992,0.15896328931325496
2025-09-02T15:55:00-04:00,155,155.05,154.88,155,154.408047991383,NaN,NaN,NaN,NaN,NaN,154.1914000000007,155.32694927643126,153.05585072357013,154.72516816843182,154.28266973084888,155.0918736814059,153.47346578029186,3044,753.5333333333333,62.24746988023748,59.50943613874263,NaN,NaN,NaN,NaN,0.16032718934912063,21.59663720463269,538710,0.01401779879428855,0.17648553780611564,0.1624677390118271
2025-09-03T09:30:00-04:00,155.78,155.78,155.28,155.46,154.89200035541103,NaN,NaN,NaN,NaN,NaN,154.22440000000068,155.40855647581844,153.04024352418293,155.10702888178966,155.50666666666666,155.50666666666666,155.50666666666666,2579,835.4,71.21383713659807,60.369182745381316,NaN,NaN,NaN,NaN,0.20458953296704066,23.825531955975908,541289,0.04138670724654797,0.21420112307001204,0.17281441582346407
2025-09-03T09:40:00-04:00,155.95,156,155.95,156,155.29236397561962,NaN,NaN,NaN,NaN,NaN,154.2696000000007,155.54533639878417,152.99386360121724,155.19162310543174,155.5382488534878,155.65680998201714,155.41968772495846,183,833.4666666666667,77.8611501179389,62.021516083406155,NaN,NaN,NaN,NaN,0.22854742346939433,26.23811447553786,541472,0.08925747167825429,0.28438625542128193,0.19512878374302764
2025-09-03T09:45:00-04:00,155.97,156.28,155.97,156.28,155.431120158546,NaN,NaN,NaN,NaN,NaN,154.3226000000007,155.7034971573528,152.9417028426486,155.4782984843454,155.57444330601092,155.76167832757534,155.3872082844465,166,822.9,80.38982385981798,63.551302794388896,NaN,NaN,NaN,NaN,0.23436546465015204,28.848896693071342,541638,0.13067290925123604,0.3584699203070727,0.22779701105583666
2025-09-03T09:50:00-04:00,156.375,156.375,155.9,155.9,155.431120158546,NaN,NaN,NaN,NaN,NaN,154.3752000000007,155.79161372459842,152.95878627540296,155.49613878747633,155.64646414728682,155.89039516106263,155.402533133511,512,818.3666666666667,68.88970527261361,64.20908342374113,NaN,NaN,NaN,NaN,0.25155364574656935,31.38693067560005,541126,0.12345371922403198,0.3821141600858766,0.25866044086184464
2025-09-03T09:55:00-04:00,155.86,155.86,155.44,155.56,155.431120158546,NaN,NaN,NaN,NaN,NaN,154.41880000000072,155.84417371912798,152.99342628087345,155.49613878747633,155.64419257684472,155.8775375265065,155.41084762718293,323,800.0333333333333,60.54418050044152,64.24424188424506,NaN,NaN,NaN,NaN,0.2664426710503864,31.601654468527773,540803,0.08840105925120345,0.36916176492584896,0.2807607056746455
2025-09-03T10:00:00-04:00,155.64,155.65,155.56,155.56,155.431120158546,NaN,NaN,NaN,NaN,NaN,154.4580000000007,155.89886640573542,153.017133594266,155.49613878747633,155.6425855251848,155.87262832939064,155.412542720979,115,787.1333333333333,60.54418050044152,64.1837063746418,NaN,NaN,NaN,NaN,0.2538396231182162,31.80104084767495,540803,0.05923695970018861,0.35480690529988124,0.29556994559969263
2025-09-03T10:05:00-04:00,155.99,156.3,155.99,156.3,155.431120158546,NaN,NaN,NaN,NaN,NaN,154.5194000000007,156.00661705180627,153.03218294819513,155.49613878747633,155.65664991203818,155.89990167856624,155.41339814551012,101,786.1666666666666,69.78391817250699,65.05878722775286,NaN,NaN,NaN,NaN,0.28856536432405855,33.06475359644358,540904,0.08238258424256817,0.3985481759029028,0.31616559166033464
2025-09-03T10:10:00-04:00,156.18,156.18,155.67,155.67,155.431120158546,NaN,NaN,NaN,NaN,NaN,154.5644000000007,156.05199220190977,153.0768077980916,155.49613878747633,155.68608649789027,155.91890021210955,155.453272783671,761,796.4666666666667,57.44927387376032,65.05282205952489,NaN,NaN,NaN,NaN,0.3129535525866275,33.076919040426375,540143,0.04948363255011978,0.3780201323479844,0.3285364997978646
2025-09-03T10:15:00-04:00,155.65,155.99,155.58,155.99,155.431120158546,NaN,NaN,NaN,NaN,NaN,154.6142000000007,156.12249753005887,153.10590246994252,155.49613878747633,155.7001153201907,155.92772278932281,155.47250785105857,434,773.2333333333333,61.200643949163876,65.13857279905355,NaN,NaN,NaN,NaN,0.31988544168758243,32.78473030588124,540577,0.04369564106688023,0.3831560511314649,0.33946041006458466
2025-09-03T10:20:00-04:00,156.25,156.25,156.25,156.25,155.431120158546,NaN,NaN,NaN,NaN,NaN,154.6688000000007,156.2119533427299,153.12564665727146,155.49613878747633,155.72057995285942,155.9669771002543,155.47418280546455,200,776.1,63.97934955902677,65.37486540009336,NaN,NaN,NaN,NaN,0.31560791013846873,32.97123295628554,540777,0.05127503926019383,0.403554209139827,0.35227916987963315
2025-09-03T10:25:00-04:00,156.44,156.44,156.24,156.24,155.487249943914,NaN,NaN,NaN,NaN,NaN,154.72740000000067,156.28219032644353,153.17260967355782,155.53261872504336,155.76306466459556,156.04485434149942,155.4812749876917,420,777.4333333333333,63.79012269457776,65.53155601077688,NaN,NaN,NaN,NaN,0.3073502022714344,33.450453277113354,540357,0.0494878983386145,0.41413904280290126,0.36465114446428676
2025-09-03T10:30:00-04:00,156.48,156.7,156.48,156.7,155.71328403737243,NaN,NaN,NaN,NaN,NaN,154.79260000000068,156.39854799392697,153.18665200607438,155.74409498003467,155.77074637929067,156.06276358518588,155.47872917339546,52,775.8333333333334,68.4174728640995,66.25604275750182,NaN,NaN,NaN,NaN,0.31825375925204474,34.279046849595254,540409,0.07180518610366798,0.4544076270938717,0.38260244099020374
2025-09-03T10:35:00-04:00,156.73,156.73,156.5,156.59,155.74677112658281,NaN,NaN,NaN,NaN,NaN,154.85580000000067,156.49073407794126,153.22086592206009,155.85027598402775,155.82062999302985,156.16616676720372,155.475093218856,371,771.4,66.2376083964376,66.61062405554726,NaN,NaN,NaN,NaN,0.3119499193054694,35.09140279414208,540038,0.0715210267670337,0.47200372444899585,0.40048269768196215
2025-09-03T10:40:00-04:00,156.68,157.02,156.68,157.02,155.96259971173814,NaN,NaN,NaN,NaN,NaN,154.9266000000007,156.6225462724917,153.2306537275097,156.10122078722222,155.85085900443056,156.2355516037616,155.46616640509953,178,770.6666666666666,70.23055624044909,67.18084450984809,NaN,NaN,NaN,NaN,0.3203820679265078,36.242716065501526,540216,0.09138414192613314,0.5147128750896286,0.42332873316349545
2025-09-03T10:45:00-04:00,156.82,156.82,156.69,156.69,155.96259971173814,NaN,NaN,NaN,NaN,NaN,154.99220000000068,156.70210661709712,153.28229338290424,156.10122078722222,155.885335837716,156.29939259579578,155.47127907963625,260,764.4333333333333,63.97716509535299,66.66393936404486,NaN,NaN,NaN,NaN,0.3210690630746153,37.311792674621024,539956,0.07412421365669847,0.5159840002343685,0.44185978657767006
2025-09-03T10:50:00-04:00,156.7,156.7,156.64,156.69,155.96259971173814,NaN,NaN,NaN,NaN,NaN,155.05320000000066,156.78329336141647,153.32310663858485,156.10122078722222,155.89029864118262,156.30775569302912,155.47284158933613,42,728.6333333333333,63.97716509535299,65.67222614814587,NaN,NaN,NaN,NaN,0.3024212728550001,38.08807611354599,539956,0.05539195990284862,0.5110997364562309,0.45570777655338224
2025-09-03T11:00:00-04:00,156.86,156.86,156.75,156.83,155.96259971173814,NaN,NaN,NaN,NaN,NaN,155.11260000000067,156.8783216539433,153.34687834605805,156.17498504305777,155.93176411865375,156.38231526080781,155.48121297649968,315,720.7333333333333,65.48908712843382,64.60788781018987,NaN,NaN,NaN,NaN,0.29296261050821554,39.04800672434056,540271,0.045527080207591275,0.5126166268128713,0.46708954660528007
2025-09-03T11:05:00-04:00,156.9,156.9,156.9,156.9,155.96259971173814,NaN,NaN,NaN,NaN,NaN,155.16900000000066,156.9787878326537,153.35921216734764,156.3169880344462,155.93451791808874,156.38737300031994,155.48166283585755,20,703.4,66.25179267462184,64.41946548176188,NaN,NaN,NaN,NaN,0.27703670975762823,39.99855544992003,540291,0.037166230185061766,0.5135473343366073,0.4763811041515455
2025-09-03T11:10:00-04:00,156.66,156.66,156.66,156.66,155.96259971173814,NaN,NaN,NaN,NaN,NaN,155.22200000000066,157.0480558587393,153.39594414126202,156.3169880344462,155.93554813973304,156.38890544984523,155.48219082962086,10,677.6666666666666,61.253419461763635,64.47012540757059,NaN,NaN,NaN,NaN,0.27439123048922687,39.798766239986776,540281,0.01031818125728462,0.48927883072315126,0.47896064946586664
2025-09-03T11:15:00-04:00,156.64,156.67,156.5,156.5,155.96259971173814,NaN,NaN,NaN,NaN,NaN,155.27660000000066,157.08893378802702,153.4642662119743,156.3169880344462,155.94612553508284,156.40273329332132,155.48951777684437,122,681.7,58.10606307960666,64.29597416322524,NaN,NaN,NaN,NaN,0.2669347140257098,38.9600541807071,540159,-0.021627970815477182,0.45192568594652016,0.47355365676199734
2025-09-03T11:20:00-04:00,156.39,156.39,156.33,156.33,155.96259971173814,NaN,NaN,NaN,NaN,NaN,155.32380000000066,157.12041855695998,153.52718144304134,156.3169880344462,155.9473059614939,156.4037669437535,155.49084497923428,21,665.7,54.87950567185803,63.23137327032175,NaN,NaN,NaN,NaN,0.26001080588101533,37.53309335004324,540138,-0.055683727210456446,0.4039489977489268,0.45963272495938323
2025-09-03T11:25:00-04:00,156.27,156.28,156.22,156.28,155.96259971173814,NaN,NaN,NaN,NaN,NaN,155.36700000000064,157.14957903029614,153.58442096970515,156.3169880344462,155.9495527612731,156.405137041842,155.4939684807042,52,660.3,53.93095223874961,62.9800645821067,NaN,NaN,NaN,NaN,0.24929574831808665,35.80815280349181,540086,-0.08149144956400323,0.3577684130043792,0.43925986256838245
2025-09-03T11:30:00-04:00,156.05,156.13,156.01,156.13,155.96259971173814,NaN,NaN,NaN,NaN,NaN,155.40360000000067,157.17213729370354,153.6350627062978,156.3169880344462,155.95514307195617,156.40241189962885,155.5078742442835,300,666.6333333333333,51.07864119746233,62.25706438555659,NaN,NaN,NaN,NaN,0.25077462343822404,33.49203722474394,539786,-0.10697261140451647,0.3055440983127369,0.41251670971725335
2025-09-03T11:50:00-04:00,156.4,156.54,156.4,156.54,155.96259971173814,NaN,NaN,NaN,NaN,NaN,155.44180000000065,157.22430470945537,153.65929529054594,156.3169880344462,155.97161757770635,156.4216405933681,155.5215945620446,238,666.1666666666666,57.668810184967775,61.80631157312381,NaN,NaN,NaN,NaN,0.2621478646212078,32.42104485730755,540024,-0.09493162287504997,0.2938521811234409,0.3887838039984909
2025-09-03T11:55:00-04:00,156.31,156.38,156.31,156.35,155.96259971173814,NaN,NaN,NaN,NaN,NaN,155.47380000000064,157.2629132550108,153.68468674499047,156.3169880344462,155.9924814769829,156.43817668160483,155.54678627236098,458,675.9333333333333,54.03605522526801,61.10959246817311,NaN,NaN,NaN,NaN,0.2598515885768351,31.124678554277352,539566,-0.09807791585345588,0.266186409181671,0.3642643250351269
2025-09-03T12:00:00-04:00,156.26,156.26,156.25,156.25,155.96259971173814,NaN,NaN,NaN,NaN,NaN,155.50180000000066,157.29480279956113,153.7087972004402,156.3169880344462,156.01613504160227,156.44769281285073,155.5845772703538,821,672.5666666666667,52.173222505245334,59.949288871112095,NaN,NaN,NaN,NaN,0.24843361796420363,29.717127834268155,538745,-0.10461123962454955,0.23350027550443997,0.3381115151289895
2025-09-03T12:05:00-04:00,156.65,156.65,156.65,156.65,155.96259971173814,NaN,NaN,NaN,NaN,NaN,155.54020000000065,157.34762242965965,153.73277757034165,156.3169880344462,156.01961628588168,156.45252940757968,155.5867031641837,50,579.8666666666667,58.35728577178305,59.38640868363677,NaN,NaN,NaN,NaN,0.2592597881096181,29.351386869831487,538795,-0.08077773896632418,0.23713934142108428,0.31791708038740846
2025-09-03T12:15:00-04:00,156.62,156.62,156.62,156.62,155.96259971173814,NaN,NaN,NaN,NaN,NaN,155.57760000000064,157.39542973879162,153.75977026120967,156.11587234204558,156.01968222588326,156.45261729292707,155.58674715883944,1,479.6333333333333,57.754126826184255,58.49523515404643,NaN,NaN,NaN,NaN,0.24288408895893115,28.90342689765516,538794,-0.06641777918127201,0.23489485641081842,0.3013126355920904
2025-09-03T12:20:00-04:00,156.8,156.85,156.67,156.67,156.01380406552178,NaN,NaN,NaN,NaN,NaN,155.62400000000065,157.43253531876752,153.81546468123378,156.3195634351274,156.02108370784467,156.4547385178285,155.58742889786083,18,405.56666666666666,58.52356119688755,58.10569201844175,NaN,NaN,NaN,NaN,0.24196379689043535,28.989265517277214,538812,-0.0534916314440978,0.23444809628696817,0.28793972773106596
2025-09-03T12:25:00-04:00,156.64,156.64,156.5,156.5,156.01380406552178,NaN,NaN,NaN,NaN,NaN,155.66780000000065,157.45284583672975,153.88275416327156,156.3195634351274,156.02337807850415,156.45747043465684,155.58928572235146,40,305.43333333333334,54.86471606186247,57.454802801763854,NaN,NaN,NaN,NaN,0.2368235256839748,28.439155001715505,538772,-0.05605974713639178,0.21786504381057625,0.27392479094696803
2025-09-03T12:30:00-04:00,156.5,156.51,156.49,156.51,156.01380406552178,NaN,NaN,NaN,NaN,NaN,155.70940000000067,157.473950526111,153.94484947389034,156.3195634351274,156.0311084863453,156.46590914612676,155.59630782656382,150,224.46666666666667,55.04276877714731,56.70863720524339,NaN,NaN,NaN,NaN,0.22133613099226102,27.891303086597325,538922,-0.056589791113643595,0.20318755205491357,0.25977734316855716
2025-09-03T12:35:00-04:00,156.59,156.59,156.57,156.57,156.01380406552178,NaN,NaN,NaN,NaN,NaN,155.75640000000064,157.4845748057542,154.02822519424709,156.3195634351274,156.04274660221384,156.4800479801787,155.60544522424897,203,225.13333333333333,56.160240441217525,55.98781204571451,NaN,NaN,NaN,NaN,0.21124069306424326,27.583611536978996,539125,-0.052494762671056266,0.19415888982973684,0.2466536525007931
2025-09-03T12:40:00-04:00,156.31,156.31,156.28,156.28,156.01380406552178,NaN,NaN,NaN,NaN,NaN,155.79680000000064,157.47693542288275,154.11666457711854,156.3195634351274,156.04991190476193,156.48282177916056,155.6170020303633,284,229.06666666666666,49.7265950946036,55.16446744806022,NaN,NaN,NaN,NaN,0.21686635784536817,26.222873227400108,538841,-0.06793203274936269,0.16173861156408975,0.22967064431345244
2025-09-03T12:45:00-04:00,156.35,156.35,156.35,156.35,156.01380406552178,NaN,NaN,NaN,NaN,NaN,155.83740000000066,157.47027138477193,154.20452861522938,156.3195634351274,156.04994252287185,156.48284092310757,155.61704412263612,1,212.03333333333333,51.180403155308994,54.66977745346753,NaN,NaN,NaN,NaN,0.2063759037135557,25.07541689509089,538842,-0.07167333211244337,0.14007897917289824,0.2117523112853416
2025-09-03T12:50:00-04:00,156.29,156.3,156.05,156.05,156.01380406552178,NaN,NaN,NaN,NaN,NaN,155.87560000000065,157.4355854355796,154.31561456442168,156.3195634351274,156.05264290650612,156.4787302797961,155.62655553321613,328,212.2,45.153819821619734,53.97508560702194,NaN,NaN,NaN,NaN,0.2130633391625862,23.546218130860485,538514,-0.09133687611564797,0.09758121614078163,0.1889180922564296
2025-09-03T12:55:00-04:00,156.12,156.34,156.12,156.34,156.01380406552178,NaN,NaN,NaN,NaN,NaN,155.91280000000063,157.42589505294183,154.39970494705943,156.3195634351274,156.05781824020556,156.4800044754358,155.63563200497532,251,216.73333333333332,51.14285636667392,53.77593590187367,NaN,NaN,NaN,NaN,0.21855881493668664,21.99517020044091,538765,-0.08208878225635796,0.08630711443598216,0.16839589669234012
2025-09-03T13:00:00-04:00,156.355,156.49,156.35,156.49,156.01380406552178,NaN,NaN,NaN,NaN,NaN,155.94860000000065,157.42958351078025,154.46761648922106,156.3195634351274,156.07294767370115,156.49348294572124,155.65241240168106,424,227.5,53.944239318488194,53.980621481946955,NaN,NaN,NaN,NaN,0.2136617567269237,20.778550986787177,539189,-0.06395161025311175,0.08845638387595045,0.1524079941290622
2025-09-03T13:05:00-04:00,156.51,156.51,156.5,156.5,156.01380406552178,NaN,NaN,NaN,NaN,NaN,155.98820000000066,157.41931531303192,154.5570846869694,156.3195634351274,156.0791896986835,156.49982317049296,155.65855622687405,159,207.43333333333334,54.13305482112694,53.728067527386884,NaN,NaN,NaN,NaN,0.1998287741035707,19.71324946289924,539348,-0.04998243108455988,0.08992995527336234,0.13991238635792222
2025-09-03T13:10:00-04:00,156.47,156.47,156.42,156.47,156.01380406552178,NaN,NaN,NaN,NaN,NaN,156.02260000000066,157.4151792470075,154.63002075299383,156.21601647878524,156.0923602921764,156.5112378081511,155.67348277620172,400,206.3,53.425422609935254,53.68445091200597,NaN,NaN,NaN,NaN,0.19126957595331653,18.427082226594973,538948,-0.04179674301420977,0.08766645759016001,0.12946320060436978
2025-09-03T13:15:00-04:00,156.59,156.59,156.59,156.59,156.01380406552178,NaN,NaN,NaN,NaN,NaN,156.05860000000067,157.41444075731783,154.7027592426835,156.2423282328414,156.09253540951883,156.51144320963155,155.6736276094061,4,199.76666666666668,55.9082529283992,53.95123879937411,NaN,NaN,NaN,NaN,0.18617889195665138,17.651609546074614,538952,-0.027997229609655866,0.09446666359229994,0.1224638932019558
2025-09-03T13:20:00-04:00,156.46,156.5,156.36,156.36,156.01380406552178,NaN,NaN,NaN,NaN,NaN,156.08960000000067,157.39994627453433,154.77925372546702,156.2423282328414,156.10452332599993,156.519744931185,155.68930172081488,451,200.8,50.36622406042762,53.38044867713444,NaN,NaN,NaN,NaN,0.18930897110260414,16.692404520637254,538501,-0.03367484352540025,0.0803703387952055,0.11404518232060575
2025-09-03T13:25:00-04:00,156.27,156.27,156.17,156.2,156.01380406552178,NaN,NaN,NaN,NaN,NaN,156.11600000000067,157.38017720245406,154.85182279754727,156.2423282328414,156.107566211548,156.51733368194738,155.69779874114863,340,210.4,46.88446542811133,52.6040442915578,NaN,NaN,NaN,NaN,0.18935833030956287,16.409661827160413,538161,-0.04671872536020777,0.055646775620346034,0.1023655009805538
2025-09-03T13:30:00-04:00,156.25,156.26,156.08,156.08,156.01380406552178,NaN,NaN,NaN,NaN,NaN,156.14260000000067,157.34515601083928,154.94004398916206,156.2423282328414,156.10784129832007,156.51587818994577,155.69980440669437,104,201.5,44.40511337772293,51.59558373304605,NaN,NaN,NaN,NaN,0.18868987814459254,16.41742880260317,538057,-0.06103667140058637,0.026069661729820837,0.0871063331304072
2025-09-03T13:35:00-04:00,156.11,156.11,156.07,156.07,156.01380406552178,NaN,NaN,NaN,NaN,NaN,156.16900000000066,157.3041775188095,155.03382248119183,156.2423282328414,156.10783730158738,156.51584104075474,155.69983356242003,2,195.63333333333333,44.19536943131478,50.83348754514979,NaN,NaN,NaN,NaN,0.17806917256283739,16.455423805718326,538055,-0.06824354787102041,0.0018018982916316872,0.0700454461626521
2025-09-03T13:40:00-04:00,155.9,155.9,155.74,155.75,NaN,NaN,NaN,156.4318940057856,156.4318940057856,156.4318940057856,156.18680000000066,157.26583986914764,155.10776013085368,156.2423282328414,156.0993472398478,156.50492694466845,155.69376753502712,344,198.43333333333334,38.00848905380415,49.6167532791967,NaN,NaN,NaN,NaN,0.1889213745226336,17.410317907441254,537711,-0.0902434822596206,-0.04275890666187365,0.04748457559774695
2025-09-03T13:45:00-04:00,155.49,155.7,155.49,155.7,NaN,NaN,NaN,156.21453518734083,NaN,NaN,156.20300000000066,157.22657217587508,155.17942782412624,156.2423282328414,156.08684629043472,156.4940619922599,155.67963058860954,345,208.53333333333333,37.1337697711476,48.25771965990599,NaN,NaN,NaN,NaN,0.19399841919958768,18.85978795979474,537366,-0.10292569346710026,-0.08117254123612838,0.021753152230971885
2025-09-03T13:50:00-04:00,155.81,155.81,155.81,155.81,NaN,NaN,NaN,156.21453518734083,NaN,NaN,156.22060000000064,157.18453701000135,155.25666298999994,156.2423282328414,156.0847253504942,156.49109575914255,155.67835494184587,100,201.36666666666667,40.38431346882054,47.59041382949291,NaN,NaN,NaN,NaN,0.1879985321139038,19.708879284394136,537466,-0.09865749914512255,-0.1015687217004313,-0.002911222555308752
2025-09-03T14:00:00-04:00,155.59,155.71,155.59,155.71,NaN,NaN,NaN,156.21453518734083,NaN,NaN,156.23800000000065,157.13037660168192,155.3456233983194,156.2423282328414,156.0842176142016,156.49059803939605,155.67783718900716,16,201.23333333333332,38.43851784818702,46.68027916469849,NaN,NaN,NaN,NaN,0.1902843512486249,20.982697360443076,537450,-0.09716571382522526,-0.12436836483684033,-0.027202651011615068
2025-09-03T14:05:00-04:00,155.73,155.81,155.71,155.81,NaN,NaN,NaN,156.21453518734083,NaN,NaN,156.25500000000065,157.0791189230097,155.4308810769916,156.2423282328414,156.0792399377698,156.48418228963007,155.67429758590956,215,208.06666666666666,41.47526515773584,46.41752526013535,NaN,NaN,NaN,NaN,0.18383546901657985,21.71526766761058,537665,-0.08450733665146556,-0.13283682182594703,-0.04832948517448146
2025-09-03T14:10:00-04:00,155.85,155.91,155.77,155.91,NaN,NaN,NaN,156.21453518734083,NaN,NaN,156.27320000000066,157.0224443121139,155.52395568788742,156.1068625862731,156.07857560975617,156.48307128484333,155.674079934669,41,205.36666666666667,44.42745678154005,45.93785386119722,NaN,NaN,NaN,NaN,0.18070436408682317,21.954600062665474,537706,-0.06532091977060997,-0.12998063488774392,-0.06465971511713395
2025-09-03T14:15:00-04:00,155.93,155.93,155.68,155.68,NaN,NaN,NaN,156.21453518734083,NaN,NaN,156.27760000000066,157.0100868321231,155.5451131678782,155.86049006901848,156.06640716690723,156.4676415547344,155.66517277908005,535,222.5,39.493016321369694,44.90562364711733,NaN,NaN,NaN,NaN,0.18565405236633578,22.41020230572503,537171,-0.06395958721807082,-0.14460919913972248,-0.08064961192165165
2025-09-03T14:20:00-04:00,155.69,155.69,155.5,155.5,NaN,NaN,NaN,156.18814540689002,NaN,NaN,156.26760000000067,157.02808994681962,155.50711005318172,155.8423920552148,156.03869489137358,156.44525873434378,155.63213104840338,808,247.7,36.11256882534176,43.618446075989816,NaN,NaN,NaN,NaN,0.18596447719731163,23.27271166313052,536363,-0.07050537546730781,-0.16878133125578643,-0.09827595578847861
2025-09-03T14:25:00-04:00,155.57,155.68,155.57,155.58,NaN,NaN,NaN,156.18814540689002,NaN,NaN,156.25360000000063,157.03805660126733,155.46914339873393,155.75591364417184,156.0316803022175,156.43855549220018,155.6248051122348,244,245.83333333333334,38.62696471459375,42.56141336917971,NaN,NaN,NaN,NaN,0.18553844311178985,24.07361320929276,536607,-0.0649107642072196,-0.1794144110475031,-0.11450364684028351
2025-09-03T14:30:00-04:00,155.42,155.42,155.23,155.34,NaN,NaN,NaN,155.93660562900516,NaN,NaN,156.24240000000066,157.06193703958348,155.42286296041783,155.5013031863378,156.02524629014403,156.43573705362132,155.61475552666673,138,242.5,34.26951727807996,41.01578939415691,NaN,NaN,NaN,NaN,0.19728569717523506,25.558049263422213,536469,-0.07227377216013911,-0.2048458620404574,-0.1325720898803183
2025-09-03T14:35:00-04:00,155.34,155.34,155.02,155.02,NaN,NaN,NaN,155.80744173677766,NaN,NaN,156.23160000000064,157.0996217504545,155.36357824954678,155.5013031863378,155.98242970743956,156.42640549722555,155.53845391765358,753,252.33333333333334,29.492312849332237,39.52479573622153,NaN,NaN,NaN,NaN,0.20605100451986064,27.311667404310242,535716,-0.09231307032047883,-0.24796342778091685,-0.155650357460438
2025-09-03T14:40:00-04:00,155.05,155.38,155.03,155.38,NaN,NaN,NaN,155.80744173677766,NaN,NaN,156.22800000000063,157.1085361998622,155.34746380013908,155.5013031863378,155.9618752561266,156.41556940597187,155.50818110628134,465,240.46666666666667,39.67977479300483,39.010174976571065,NaN,NaN,NaN,NaN,0.21704736133986954,28.734530563937827,536181,-0.07564071692304972,-0.25020125361425016,-0.17456053669120045
2025-09-03T14:45:00-04:00,155.44,155.46,155.44,155.46,NaN,NaN,NaN,155.80744173677766,NaN,NaN,156.21120000000064,157.11728290969467,155.30511709030662,155.5013031863378,155.96062791268093,156.41446298746615,155.50679283789572,40,240.13333333333333,41.695825050382595,38.81665438176104,NaN,NaN,NaN,NaN,0.20725826410130832,29.638845937924597,536221,-0.05452874924148074,-0.24272147324305138,-0.18819272400157064
2025-09-03T14:50:00-04:00,155.4,155.49,155.4,155.49,NaN,NaN,NaN,155.80744173677766,NaN,NaN,156.20760000000064,157.12363109077415,155.29156890922712,155.5013031863378,155.95751614868988,156.411646304933,155.50338599244677,102,243.5,42.47230690255205,38.69357848684941,NaN,NaN,NaN,NaN,0.19888267380835797,30.566058148967368,536323,-0.034807442709299585,-0.23170202738819512,-0.19689458467889553
2025-09-03T15:00:00-04:00,155.53,155.53,155.5,155.5,NaN,NaN,NaN,155.80744173677766,NaN,NaN,156.19780000000065,157.13321255029584,155.26238744970547,155.5013031863378,155.95456323021978,156.40864045843549,155.50048600200407,109,246.53333333333333,42.746023253603596,39.03197378683509,NaN,NaN,NaN,NaN,0.1875339113934747,31.20279473668773,536432,-0.018188619193908823,-0.21963035867128156,-0.20144173947737273
2025-09-03T15:05:00-04:00,155.66,155.66,155.66,155.66,NaN,NaN,NaN,155.80744173677766,NaN,NaN,156.18600000000066,157.13329087360648,155.23870912639484,155.47804254907024,155.95450974458302,156.40856309250134,155.5004563966647,3,245.3,47.08426068450832,39.742723137789426,NaN,NaN,NaN,NaN,0.1855672034367977,31.081373218924664,536435,0.005228546996623673,-0.19490605573159314,-0.20013460272821681
2025-09-03T15:10:00-04:00,155.44,155.46,155.35,155.35,NaN,NaN,NaN,155.80744173677766,NaN,NaN,156.16820000000064,157.14378753541394,155.19261246458734,155.24721457458352,155.94788598432737,156.4033823769228,155.49238959173195,195,246.8,40.65644448013428,39.762161067168975,NaN,NaN,NaN,NaN,0.19445526033416943,31.750094177199628,536240,0.0016729972129076454,-0.19804335621208224,-0.1997163534249899
2025-09-03T15:15:00-04:00,155.32,155.32,155.32,155.32,NaN,NaN,NaN,155.80744173677766,NaN,NaN,156.14060000000066,157.1323936071721,155.14880639282921,155.24721457458352,155.93681671269908,156.39577964685273,155.47785377854544,300,250.03333333333333,40.086114888355304,39.87984657003814,NaN,NaN,NaN,NaN,0.182708456024586,32.43875835163383,535940,-0.0007370078303319816,-0.20063761321290485,-0.19990060538257287
2025-09-03T15:20:00-04:00,155.4,155.5,155.4,155.5,NaN,NaN,NaN,155.80744173677766,NaN,NaN,156.11880000000065,157.11801280979324,155.11958719020805,155.24721457458352,155.93140923613132,156.39047054224062,155.472347930022,198,247.16666666666666,45.06552000936331,40.13629334515439,NaN,NaN,NaN,NaN,0.1825149948799732,32.136425871417984,536138,0.011100718015205013,-0.18602470786356662,-0.19712542587877163
2025-09-03T15:30:00-04:00,155.59,155.72,155.59,155.72,NaN,NaN,NaN,155.80744173677766,NaN,NaN,156.09280000000064,157.06412519748326,155.121474802518,155.2799630897494,155.93039227030783,156.38881786089047,155.4719666797252,69,249.43333333333334,50.482346165531865,40.56878544401095,NaN,NaN,NaN,NaN,0.18519249524568931,30.85453355976729,536207,0.03377549817860595,-0.1549060531555142,-0.18868155133412015
2025-09-03T15:35:00-04:00,155.73,155.75,155.73,155.75,NaN,NaN,NaN,155.80744173677766,NaN,NaN,156.07400000000064,157.03469141729227,155.113308582709,155.38297047179952,155.92929483492466,156.38659689424657,155.47199277560276,102,241.9,51.18915098013981,41.4042236339231,NaN,NaN,NaN,NaN,0.17410731701385446,29.53532467114735,536309,0.04985174727755154,-0.1263668672371807,-0.17621861451473225
2025-09-03T15:40:00-04:00,155.73,155.73,155.73,155.73,NaN,NaN,NaN,155.80744173677766,NaN,NaN,156.05480000000065,157.00378042089505,155.10581957910625,155.4263763774396,155.92928337263473,156.38657477866855,155.4719919666009,1,233.56666666666666,50.66989338870544,42.44403253130622,NaN,NaN,NaN,NaN,0.16309965151286557,28.310344988857405,536308,0.057644915990699486,-0.10416246952635788,-0.16180738551705737
2025-09-03T15:45:00-04:00,155.66,155.73,155.62,155.73,NaN,NaN,NaN,155.80744173677766,NaN,NaN,156.03280000000063,156.95961855791194,155.10598144208933,155.4321011019517,155.92373113931635,156.37702340138176,155.47043887725093,419,233.4,50.66989338870544,43.304241722314195,NaN,NaN,NaN,NaN,0.15930681926194554,27.56689614702756,536308,0.0609828484588259,-0.08557882494352498,-0.14656167340235088
2025-09-03T15:50:00-04:00,155.83,156.06,155.83,156.06,155.39798654782237,155.39798654782237,155.39798654782237,NaN,NaN,NaN,156.01600000000064,156.90917411475047,155.12282588525082,155.65668088156136,155.9263030433303,156.3698727836505,155.48273330301012,803,254.86666666666667,58.68896845028507,45.04848823461457,NaN,NaN,NaN,NaN,0.17149918931466462,25.7426448377544,537111,0.08227418203783113,-0.043718945855061975,-0.1259931278928931
2025-09-03T15:55:00-04:00,156.04,156.07,155.86,155.98,155.41421443201227,NaN,NaN,NaN,NaN,NaN,156.00240000000065,156.87643944949247,155.12836055050883,155.65668088156136,155.92890034537953,156.35920953775567,155.4985911530034,1176,280.73333333333335,56.29962565243232,46.96329629197886,NaN,NaN,NaN,NaN,0.17424924722075855,24.087088422859253,535935,0.0873494710610282,-0.01680628906660786,-0.10415576012763605
2025-09-04T09:30:00-04:00,155.51,155.53,155,155.4,NaN,NaN,NaN,155.92438622398828,155.92438622398828,155.92438622398828,155.98040000000063,156.85859779052296,155.1022022094783,155.65668088156136,155.30999999999997,155.30999999999997,155.30999999999997,5584,466.73333333333335,42.720281817440465,47.18047536515282,NaN,NaN,NaN,NaN,0.23180287241927508,24.651590239683525,530351,0.04988688345415264,-0.04179715580994525,-0.09168403926409789
2025-09-04T09:35:00-04:00,155.7,155.81,155.44,155.48,NaN,NaN,NaN,155.92438622398828,NaN,NaN,155.96340000000063,156.8467627563337,155.08003724366756,155.65668088156136,155.33263738664917,155.40696224896806,155.25831252433028,518,468.96666666666664,44.70150440674566,47.39516674775019,NaN,NaN,NaN,NaN,0.2445312386750409,24.179728409812125,530869,0.029732185438708786,-0.054518807465711916,-0.0842509929044207
2025-09-04T09:40:00-04:00,155.15,155.25,155,155.25,NaN,NaN,NaN,155.8446267040885,NaN,NaN,155.94280000000063,156.8435378304909,155.04206216951036,155.65668088156136,155.32873313063422,155.40636678633857,155.25109947492987,147,462.53333333333336,40.37742599551073,47.24553239724724,NaN,NaN,NaN,NaN,0.26135043591253726,24.629445903199194,530722,0.0016310384353501461,-0.08221219486023301,-0.08384323329558316
2025-09-04T09:45:00-04:00,154.97,155.05,154.62,154.75,NaN,NaN,NaN,155.60782549026632,NaN,NaN,155.91520000000062,156.8740012512054,154.95639874879583,155.65668088156136,155.28891254003446,155.44629929960564,155.13152578046328,516,476.26666666666665,32.92183175471051,46.54380443304059,NaN,NaN,NaN,NaN,0.28768254763307005,25.66097242645603,530206,-0.04721216698172734,-0.14285844202274234,-0.095646275041015
2025-09-04T09:50:00-04:00,154.92,154.98,154.91,154.98,NaN,NaN,NaN,155.60782549026632,NaN,NaN,155.8840000000006,156.860802948058,154.90719705194323,155.65668088156136,155.2701455137145,155.441184930704,155.09910609672502,405,489.7,38.543366698360195,45.93374057688715,NaN,NaN,NaN,NaN,0.2835623656592786,26.61881848376595,530611,-0.0598011505690957,-0.17039771325238462,-0.11059656268328892
2025-09-04T09:55:00-04:00,154.81,154.81,154.81,154.81,NaN,NaN,NaN,155.60782549026632,NaN,NaN,155.85320000000064,156.86574878366028,154.840651216341,155.65668088156136,155.269632673911,155.44126482558062,155.09800052224136,8,478.5,36.132997963495356,45.61063725427008,NaN,NaN,NaN,NaN,0.2754507681121864,27.66648477134882,530603,-0.074397521561021,-0.20359346463456518,-0.12919594307354418
2025-09-04T10:00:00-04:00,154.775,154.775,154.29,154.37,NaN,NaN,NaN,155.326272245056,NaN,NaN,155.81560000000064,156.90325553338005,154.72794446662124,155.65668088156136,155.2281612761276,155.47108134147302,154.98524121078216,397,480.23333333333335,30.769556831500353,44.94516882163759,NaN,NaN,NaN,NaN,0.29291857038988806,29.348776927189697,530206,-0.10654812043187267,-0.262381093613385,-0.15583297318151235
2025-09-04T10:05:00-04:00,154.17,154.17,154.17,154.17,NaN,NaN,NaN,155.326272245056,NaN,NaN,155.76600000000064,156.92103073521633,154.61096926478496,155.65668088156136,155.21437415852333,155.48389262819353,154.94485568885312,100,480.23333333333335,28.685256659857274,43.775150010958576,NaN,NaN,NaN,NaN,0.2862815296477544,31.051483858765554,530106,-0.13245689770096059,-0.3214040953077131,-0.1889471976067525
2025-09-04T10:10:00-04:00,154.22,154.59,154.22,154.35,NaN,NaN,NaN,155.21155694229276,NaN,NaN,155.72060000000064,156.9155521158977,154.5256478841036,155.6423447052491,155.16194797005937,155.4916209734596,154.83227496665916,519,497,33.0789425997762,42.53204975626175,NaN,NaN,NaN,NaN,0.29583284895863027,31.188263399126736,530625,-0.1285426328837719,-0.34962548871146737,-0.22108285582769546
2025-09-04T10:15:00-04:00,154.15,154.18,154,154.08,NaN,NaN,NaN,154.9076225358249,NaN,NaN,155.66880000000066,156.91795741172956,154.41964258827176,154.93930061135944,155.1187452657061,155.50462886618354,154.73286166522868,343,501.26666666666665,30.084798258982786,41.02459599046482,NaN,NaN,NaN,NaN,0.2997019311758705,31.6470897724919,530282,-0.134566029341062,-0.389290392504023,-0.254724363162961
2025-09-04T10:20:00-04:00,154.09,154.34,154,154.34,NaN,NaN,NaN,154.9076225358249,NaN,NaN,155.62560000000065,156.90580098394747,154.34539901605382,154.93930061135944,155.030941141268,155.48356511985222,154.57831716268376,932,530.9666666666667,36.084397843587304,39.982774880099235,NaN,NaN,NaN,NaN,0.30258036466330857,31.567098177901293,531214,-0.1123723379410787,-0.3951897855893094,-0.2828174476482307
2025-09-04T10:25:00-04:00,154.41,154.48,154.22,154.38,NaN,NaN,NaN,154.9076225358249,NaN,NaN,155.58300000000065,156.8842317239002,154.2817682761011,154.31344048908755,155.0139517927603,155.47307167877102,154.5548319067496,246,521.3333333333334,36.98037673995697,39.004952262331486,NaN,NaN,NaN,NaN,0.2995389100445002,31.061447002835685,531460,-0.08743991925566402,-0.39211734671781073,-0.3046774274621467
2025-09-04T10:30:00-04:00,154.41,154.56,154.41,154.56,NaN,NaN,NaN,154.9076225358249,NaN,NaN,155.54280000000065,156.8437721900548,154.2418278099465,154.01360191301603,155.0055857542936,155.46540946393785,154.54576204464936,164,499.8666666666667,40.98922321294177,37.7406847453784,NaN,NaN,NaN,NaN,0.2910004164698935,30.345744677794993,531624,-0.05296415175429747,-0.3708826171550186,-0.3179184654007211
2025-09-04T10:35:00-04:00,154.64,154.71,154.64,154.65,NaN,NaN,NaN,154.9076225358249,NaN,NaN,155.51020000000065,156.81732196803006,154.20307803197124,154.02755845882146,154.99360560492136,155.44954495724434,154.53766625259837,362,503.8,42.943575546976604,36.786681166417274,NaN,NaN,NaN,NaN,0.2809289581506158,29.223440109188026,531986,-0.019936948529620302,-0.3428396510627465,-0.3229027025331262
2025-09-04T10:40:00-04:00,154.52,154.52,154.52,154.52,NaN,NaN,NaN,154.9076225358249,NaN,NaN,155.47360000000063,156.7870794095555,154.16012059044576,154.02755845882146,154.99277463690416,155.44874482789794,154.53680444591038,18,499.8,40.83960991333053,36.65234745898085,NaN,NaN,NaN,NaN,0.27014831828271435,28.447287415127636,531968,-0.0035434635994773256,-0.32733203203247285,-0.3237885684329955
2025-09-04T10:45:00-04:00,154.44,154.45,154.39,154.45,NaN,NaN,NaN,154.9076225358249,NaN,NaN,155.44160000000065,156.77515680768178,154.1080431923195,154.02755845882146,154.9766816589338,155.4357690546084,154.51759426325924,302,484.76666666666665,39.71138712259176,36.29591051011272,NaN,NaN,NaN,NaN,0.260137724119665,28.008983753081385,531666,0.005402091482705096,-0.31703595407961416,-0.32243804556231925
2025-09-04T10:50:00-04:00,154.42,154.45,154.42,154.45,NaN,NaN,NaN,154.9076225358249,NaN,NaN,155.40380000000064,156.74049377170758,154.0671062282937,154.02755845882146,154.976529250284,155.43564051771529,154.5174179828527,3,469.3666666666667,39.71138712259175,36.24833630490422,NaN,NaN,NaN,NaN,0.24369931525397476,27.601987495467007,531666,0.013665411655356507,-0.3053562809931236,-0.3190216926484801
2025-09-04T10:55:00-04:00,154.4,154.4,154.26,154.39,NaN,NaN,NaN,154.9076225358249,NaN,NaN,155.36180000000067,156.69128525350862,154.03231474649272,154.02755845882146,154.964317338036,155.42710961674115,154.50152505933087,210,475.03333333333336,38.64997253986855,36.6574892181298,NaN,NaN,NaN,NaN,0.23986364987869066,27.582851151553132,531456,0.017207737239394283,-0.29751202109923724,-0.31471975833863153
2025-09-04T11:00:00-04:00,154.42,154.42,154.33,154.33,NaN,NaN,NaN,154.9076225358249,NaN,NaN,155.31840000000065,156.638068806675,153.9987311933263,154.02755845882146,154.9637009735744,155.42665922950144,154.50074271764734,11,472,37.56858947052501,36.58786227328442,NaN,NaN,NaN,NaN,0.22915910345878238,27.486602368108237,531445,0.017566120401709184,-0.29276210783649503,-0.3103282282382042
2025-09-04T11:05:00-04:00,154.34,154.34,154.34,154.34,NaN,NaN,NaN,154.9076225358249,NaN,NaN,155.27580000000066,156.5814620693323,153.970137930669,154.02755845882146,154.95234547109695,155.4185874690061,154.4861034731878,200,475.03333333333336,37.880544112249225,36.712686998195416,NaN,NaN,NaN,NaN,0.2135048817831544,27.397228497766545,531645,0.020337282825288627,-0.28490662470659345,-0.3052439075318821
2025-09-04T11:10:00-04:00,154,154,153.72,153.88,NaN,NaN,NaN,154.58468315637745,NaN,NaN,155.22160000000065,156.52953492166353,153.91366507833777,154.02755845882146,154.92105457813926,155.41512853599306,154.42698062028546,326,485.8,30.364394099586335,36.683746803058696,NaN,NaN,NaN,NaN,0.24254024737007226,28.561753052122974,531319,-0.005565195142508694,-0.31220040146001793,-0.30663520631750923
2025-09-04T11:15:00-04:00,153.9,154.15,153.88,154.15,NaN,NaN,NaN,154.58468315637745,NaN,NaN,155.17740000000066,156.4778110731969,153.87698892680442,154.02755845882146,154.86871778903372,155.3898677504013,154.34756782766615,732,503.7,38.124832157078316,37.35800219571734,NaN,NaN,NaN,NaN,0.24450165827221068,29.04669023459423,532051,-0.0014823259176633963,-0.3084881137145885,-0.3070057877969251
2025-09-04T11:20:00-04:00,154.22,154.22,154.22,154.22,NaN,NaN,NaN,154.58468315637745,NaN,NaN,155.13780000000065,156.43181261172694,153.84378738827436,154.02755845882146,154.86817956801903,155.3894480307698,154.34691110526825,10,494.03333333333336,39.991998459547396,37.851791899986715,NaN,NaN,NaN,NaN,0.2320372541099094,29.222682340906864,532061,0.008420593020514677,-0.2964800465212818,-0.30490063954179647
2025-09-04T11:25:00-04:00,154.22,154.4,154.22,154.36,NaN,NaN,NaN,154.58468315637745,NaN,NaN,155.10340000000065,156.38679929846683,153.82000070153447,154.00587355578662,154.85345076674736,155.3750723518035,154.3318291816912,337,498.6666666666667,43.65420473748969,38.82103521988006,NaN,NaN,NaN,NaN,0.2283203073877735,28.701803733690408,532398,0.02590032322380942,-0.27252523551203467,-0.2984255587358441
2025-09-04T11:30:00-04:00,154.28,154.28,154.22,154.22,NaN,NaN,NaN,154.58468315637745,NaN,NaN,155.06640000000064,156.34284982639176,153.78995017360953,154.00587355578662,154.83772373387856,155.3616645254587,154.31378294229842,326,507.23333333333335,40.96205007205417,39.16943895048484,NaN,NaN,NaN,NaN,0.2220117140029336,28.218130741275125,532072,0.029284757655034965,-0.26181961166705037,-0.29110436932208533
2025-09-04T11:35:00-04:00,154.32,154.32,154.11,154.11,NaN,NaN,NaN,154.58468315637745,NaN,NaN,155.03360000000066,156.32232501305526,153.74487498694606,154.00587355578662,154.83602125656913,155.36034963836372,154.31169287477454,33,504.93333333333334,38.930563533315016,39.30873800715327,NaN,NaN,NaN,NaN,0.22115373443129402,28.042781160184294,532039,0.025504900150327137,-0.2592232441341764,-0.28472814428450355
2025-09-04T11:40:00-04:00,154.23,154.35,154.22,154.35,NaN,NaN,NaN,154.58468315637745,NaN,NaN,155.00660000000067,156.2949143091895,153.71828569081185,154.00587355578662,154.82740290637858,155.35174268165787,154.3030631310993,211,511.93333333333334,45.30422884614725,39.61695269523937,NaN,NaN,NaN,NaN,0.22249989625762878,27.75226516511019,532250,0.03971080114153247,-0.23508964285758793,-0.2748004439991204
2025-09-04T11:45:00-04:00,154.43,154.43,154.43,154.43,NaN,NaN,NaN,154.58468315637745,NaN,NaN,154.97900000000064,156.25636760539203,153.70163239460925,154.00587355578662,154.8243600051046,155.34783593721139,154.30088407299783,100,501.3,47.279419203439645,39.92665581355816,NaN,NaN,NaN,NaN,0.21232133223922764,27.1351872611927,532350,0.054143795152533425,-0.20712070005845362,-0.26126449521098705
2025-09-04T11:50:00-04:00,154.3,154.55,154.3,154.55,NaN,NaN,NaN,154.58468315637745,NaN,NaN,154.95580000000066,156.22129967968138,153.69030032031995,154.06964326140238,154.82048587442247,155.34243399586714,154.2985377529778,143,479.3,50.185368746352744,40.594210015916886,NaN,NaN,NaN,NaN,0.2150126656507114,26.933269409748924,532493,0.07039182716474066,-0.17327471125506122,-0.24366653841980188
2025-09-04T11:55:00-04:00,154.55,154.63,154.44,154.44,153.87162619277646,153.87162619277646,153.87162619277646,NaN,NaN,NaN,154.92840000000066,156.17795902592658,153.67884097407475,154.1507146091219,154.81713466726617,155.3373296423469,154.29693969218545,141,444.8,47.595544427821224,41.157364109147565,NaN,NaN,NaN,NaN,0.21322604667566042,26.383262777612437,532352,0.07208724125532598,-0.1535574868506444,-0.2256447281059704
2025-09-04T12:00:00-04:00,154.33,154.37,154.3,154.37,153.87162619277646,NaN,NaN,NaN,NaN,NaN,154.89760000000064,156.12457390327143,153.67062609672985,154.1507146091219,154.8084485717788,155.32769595345715,154.28920119010044,251,267.03333333333336,45.969787116361225,41.60439268013109,NaN,NaN,NaN,NaN,0.20799561477025513,26.284719854159512,532101,0.06696088510368076,-0.14194362172636943,-0.20890450683005019
2025-09-04T12:05:00-04:00,154.31,154.31,154.3,154.3,153.87162619277646,NaN,NaN,NaN,NaN,NaN,154.87000000000066,156.08738079468526,153.65261920531606,154.1507146091219,154.8052733718295,155.3244234091861,154.28612333447288,86,252.63333333333333,44.33877281525712,42.01073555694457,NaN,NaN,NaN,NaN,0.19813878514380787,26.193215710953222,532015,0.057674890182270955,-0.13681089410221148,-0.19448578428448243
2025-09-04T12:10:00-04:00,154.33,154.34,154.33,154.34,153.87162619277646,NaN,NaN,NaN,NaN,NaN,154.84680000000066,156.05947598280798,153.63412401719333,154.1507146091219,154.7985216002689,155.31693442152263,154.2801087790152,200,254.4,45.52810827936764,42.579272614719045,NaN,NaN,NaN,NaN,0.1868431576335353,25.952474283118832,532215,0.05315699174251551,-0.12803954460633804,-0.18119653634885355
2025-09-04T12:15:00-04:00,154.34,154.34,154.31,154.31,153.87162619277646,NaN,NaN,NaN,NaN,NaN,154.82140000000064,156.02474872721604,153.61805127278524,154.1507146091219,154.79786750599519,155.31622748225178,154.2795075297386,19,237.83333333333334,44.75570179653113,43.070355306453465,NaN,NaN,NaN,NaN,0.1756400749454257,25.797122737309845,532196,0.04727608750178286,-0.12210142697162496,-0.16937751447340782
2025-09-04T12:20:00-04:00,154.34,154.35,154.34,154.35,153.87162619277646,NaN,NaN,NaN,NaN,NaN,154.80160000000066,156.00274185643016,153.60045814357116,154.1507146091219,154.79689578846612,155.31511956998435,154.2786720069479,30,225.33333333333334,46.069486733569526,44.19214763745226,NaN,NaN,NaN,NaN,0.165951498163609,25.59436567904235,532226,0.045208649049707395,-0.11286670316127356,-0.15807535221098096
2025-09-04T12:25:00-04:00,154.12,154.12,154.1,154.1,153.87162619277646,NaN,NaN,NaN,NaN,NaN,154.78320000000068,155.99849874485156,153.5679012551498,154.1507146091219,154.79590621266425,155.31441649813826,154.27739592719024,20,225.73333333333332,39.71278464021653,44.30557281481928,NaN,NaN,NaN,NaN,0.17195496258049406,26.20977374040578,532206,0.02702963345171444,-0.12428831039633792,-0.15131794384805236
2025-09-04T12:30:00-04:00,154.31,154.36,154.24,154.36,153.87162619277646,NaN,NaN,NaN,NaN,NaN,154.76280000000065,155.97156823224074,153.55403176776056,154.1507146091219,154.7923508834341,155.31054367838075,154.27415808848744,105,216,47.78240933905494,44.862030734784106,NaN,NaN,NaN,NaN,0.17824389382474587,25.478383172095764,532311,0.03219057001367359,-0.11107973133096039,-0.14327030134463398
2025-09-04T12:35:00-04:00,154.41,154.49,154.41,154.48,153.87667281562727,NaN,NaN,NaN,NaN,NaN,154.74320000000066,155.93781083172263,153.54858916827868,154.1507146091219,154.78743527734937,155.30334393077578,154.27152662392297,211,219.7,51.03975801866732,45.38957025486822,NaN,NaN,NaN,NaN,0.17479790140869225,24.19076832405202,532522,0.0427021498418228,-0.08989261404235549,-0.1325947638841783
2025-09-04T12:45:00-04:00,154.69,154.69,154.69,154.69,153.87667281562727,NaN,NaN,NaN,NaN,NaN,154.72720000000064,155.90264912237305,153.55175087762822,154.28403724057273,154.7867570420901,155.30093078979544,154.27258329438476,100,205.73333333333332,56.19016735335808,46.477292917818495,NaN,NaN,NaN,NaN,0.17731233702235766,22.763305101474497,532622,0.06166263773222344,-0.05551646671889898,-0.11717910445112242
2025-09-04T12:50:00-04:00,154.75,154.76,154.64,154.74,154.13391056134634,NaN,NaN,NaN,NaN,NaN,154.71200000000064,155.86655272693994,153.55744727306134,154.37522979245819,154.7855011631089,155.29534748255375,154.27565484366406,250,202.63333333333333,57.34082476308942,47.79231157708811,NaN,NaN,NaN,NaN,0.17321859866361813,21.70662727814949,532872,0.07457342957228323,-0.02396231748576838,-0.09853574705805161
2025-09-04T12:55:00-04:00,154.53,154.53,154.53,154.53,154.13391056134634,NaN,NaN,NaN,NaN,NaN,154.68940000000063,155.81265534020238,153.56614465979888,154.37522979245819,154.7853264734035,155.29504222313662,154.27561072367038,10,171.9,51.25217843909312,48.21716511944138,NaN,NaN,NaN,NaN,0.1758458416162174,20.244635096841773,532862,0.06625302356450267,-0.015719467602423265,-0.08197249116692594
2025-09-04T13:00:00-04:00,154.59,154.8,154.59,154.8,154.13391056134634,NaN,NaN,NaN,NaN,NaN,154.67840000000064,155.78622930060436,153.5705706993969,154.37522979245819,154.78487623762373,155.29253810318872,154.27721437205875,120,167.7,57.50058045144301,48.94724806572733,NaN,NaN,NaN,NaN,0.1825711386436312,19.88511110607824,532982,0.07554295808426142,0.01245620643840084,-0.06308675164586058
2025-09-04T13:05:00-04:00,155,155,154.88,154.88,154.3591393415316,NaN,NaN,NaN,NaN,NaN,154.66960000000066,155.76380992467165,153.57539007532966,154.5277976537386,154.78511406715404,155.29236059407432,154.27786754023376,26,163.1,59.17051170977933,49.58904399168637,NaN,NaN,NaN,NaN,0.18381605731194245,20.165467272233375,533008,0.08308618535167382,0.0407709800437317,-0.042315205307942125
2025-09-04T13:10:00-04:00,154.88,154.88,154.71,154.71,154.3591393415316,NaN,NaN,NaN,NaN,NaN,154.65380000000064,155.72209875936866,153.58550124063262,154.5277976537386,154.78496787553166,155.29020314332885,154.27973260773447,118,154.96666666666667,54.28882756848396,50.067135644590856,NaN,NaN,NaN,NaN,0.18282919607537423,19.674560029459457,532890,0.07299539573727895,0.04892903936365656,-0.024066356373622387
2025-09-04T13:15:00-04:00,154.79,154.86,154.79,154.86,154.3591393415316,NaN,NaN,NaN,NaN,NaN,154.63660000000064,155.6625326290125,153.61066737098878,154.5277976537386,154.78532988774035,155.28881159130563,154.28184818417506,105,157.86666666666667,57.611868174393045,50.89871286302169,NaN,NaN,NaN,NaN,0.1804842534985622,19.218717589740812,532995,0.07263620298417581,0.06672889735659737,-0.005907305627578432
2025-09-04T13:20:00-04:00,154.99,154.99,154.99,154.99,154.3591393415316,NaN,NaN,NaN,NaN,NaN,154.62140000000062,155.6024362680792,153.64036373192204,154.56883239871416,154.78668576791432,155.28877158969289,154.28459994613576,100,151.13333333333333,60.30516410628313,52.03916938380927,NaN,NaN,NaN,NaN,0.17687823539152173,19.22934132576581,533095,0.07695351021330159,0.09028458213904855,0.013331071925746969
2025-09-04T13:30:00-04:00,155.2,155.2,155.15,155.19,154.60840801635993,NaN,NaN,NaN,NaN,NaN,154.61060000000063,155.5537386744711,153.66746132553016,154.75806591897134,154.7898647435055,155.29115595182884,154.28857353518214,123,155.13333333333333,64.08589820943891,53.36472580738582,NaN,NaN,NaN,NaN,0.17924407572069728,19.864905013489516,533218,0.08826748050479492,0.12366542255674062,0.0353979420519457
2025-09-04T13:40:00-04:00,155.06,155.19,155.06,155.16,154.60840801635993,NaN,NaN,NaN,NaN,NaN,154.59920000000065,155.50080603328732,153.69759396671398,154.77145273517706,154.79458527784982,155.29407219514252,154.29509836055712,210,155.13333333333333,63.11483055802037,54.67609214749219,NaN,NaN,NaN,NaN,0.17572664174064714,20.01809613237822,533008,0.0884944845169782,0.14601604769816845,0.057521563181190255
2025-09-04T13:45:00-04:00,155.07,155.17,155.07,155.155,154.60840801635993,NaN,NaN,NaN,NaN,NaN,154.58110000000065,155.3969315753056,153.7652684246957,154.78516218814164,154.7994517908096,155.29694753058084,154.30195605103836,226,162.3,62.94364295181644,55.881389020224105,NaN,NaN,NaN,NaN,0.17031759590202908,20.160345028489154,532782,0.08315423769471961,0.16146436029958977,0.07831012260487016
2025-09-04T13:50:00-04:00,155.19,155.38,155.19,155.32,154.73236116073528,NaN,NaN,NaN,NaN,NaN,154.56790000000063,155.3108726504101,153.82492734959118,154.95962975051333,154.81609111303206,155.31329911239305,154.31888311367106,542,173.7,66.20153369112384,57.773442523860346,NaN,NaN,NaN,NaN,0.17422348190902662,20.929857795591527,533324,0.08526396798868505,0.18489008259072648,0.09962611460204143
2025-09-04T13:55:00-04:00,155.23,155.23,155.23,155.23,154.73236116073528,NaN,NaN,NaN,NaN,NaN,154.56450000000063,155.29363716080547,153.8353628391958,154.95962975051333,154.81938696965986,155.3159759310443,154.3227980082754,130,167.16666666666666,62.95053733287582,58.856880237704694,NaN,NaN,NaN,NaN,0.16820751891552496,21.64440536504373,533194,0.0754647659572164,0.19395707204856194,0.11849230609134553
2025-09-04T14:00:00-04:00,155.33,155.33,155.32,155.32,154.79610799976086,NaN,NaN,NaN,NaN,NaN,154.56130000000064,155.27559072462043,153.84700927538086,154.97496304032853,154.82512403617136,155.32176423409672,154.328483838246,188,149.03333333333333,64.81148457155024,59.84057499148205,NaN,NaN,NaN,NaN,0.16333555327870336,22.601133399658664,533382,0.07003014624202306,0.20602998889387436,0.1359998426518513
2025-09-04T14:05:00-04:00,155.24,155.24,155.24,155.24,154.79610799976086,NaN,NaN,NaN,NaN,NaN,154.56110000000066,155.27462446296624,153.84757553703508,154.97496304032853,154.8276211829381,155.323803262799,154.33143910307717,100,152.03333333333333,61.83816949665892,60.24400371600354,NaN,NaN,NaN,NaN,0.15738301375879485,23.01966200488463,533282,0.05660743819452499,0.20675914039500753,0.15015170220048255
2025-09-04T14:10:00-04:00,155.29,155.3,155.29,155.3,154.79610799976086,NaN,NaN,NaN,NaN,NaN,154.57210000000066,155.3133532355761,153.83084676442522,155.01077634581026,154.83596778007688,155.33160967718635,154.34032588296742,301,150.83333333333334,63.2016933631466,60.6626371874362,NaN,NaN,NaN,NaN,0.15042708420459538,23.601734771818787,533583,0.047687044803449846,0.20976050820479486,0.162073463401345
2025-09-04T14:15:00-04:00,155.35,155.35,155.3,155.3,154.84043305651628,NaN,NaN,NaN,NaN,NaN,154.57850000000064,155.33900575229165,153.81799424770963,155.09362107664822,154.84010930723247,155.33560707750485,154.3446115369601,147,144.86666666666667,63.2016933631466,61.51617396772573,NaN,NaN,NaN,NaN,0.14325372104712306,24.30377049096341,533583,0.038118488526206,0.20972157405910252,0.17160308553289652
2025-09-04T14:20:00-04:00,155.25,155.25,155.22,155.22,154.84043305651628,NaN,NaN,NaN,NaN,NaN,154.58670000000066,155.36563160112868,153.80776839887264,155.09362107664822,154.84278725261936,155.33762929421655,154.34794521102216,118,147.7,59.89255815526806,61.687029517998944,NaN,NaN,NaN,NaN,0.1387355981151866,24.444996716010753,533465,0.02345298298896309,0.20091931426910037,0.17746633128013728
2025-09-04T14:25:00-04:00,155.3,155.3,155.22,155.22,154.84043305651628,NaN,NaN,NaN,NaN,NaN,154.60370000000066,155.39988291819805,153.80751708180327,155.09362107664822,154.84283426454041,155.3376666888519,154.34800184022893,2,140.73333333333332,59.89255815526806,61.738604264105284,NaN,NaN,NaN,NaN,0.13454019824981703,24.759425445135363,533465,0.011413557446820155,0.19173327808866247,0.18031972064184232
2025-09-04T14:30:00-04:00,155.2,155.26,155.17,155.26,154.84043305651628,NaN,NaN,NaN,NaN,NaN,154.62550000000067,155.4326040820308,153.81839591797055,155.09362107664822,154.8503685632217,155.3432726028895,154.35746452355392,341,148.76666666666668,61.07440296264988,62.22328822083143,NaN,NaN,NaN,NaN,0.13135875551768747,24.718861152641498,533806,0.004177927297682349,0.18554212976394524,0.1813642024662629
2025-09-04T14:35:00-04:00,155.4,155.48,155.36,155.48,154.95656621928296,NaN,NaN,NaN,NaN,NaN,154.64810000000065,155.48578464189288,153.81041535810843,155.1829071929951,154.8567591494967,155.35077173774826,154.36274656124513,192,150.4,66.85872058095217,62.8837776784428,NaN,NaN,NaN,NaN,0.1376902729807097,25.472751305833658,533998,0.011810183870392038,0.19612693230425293,0.1843167484338609
2025-09-04T14:40:00-04:00,155.43,155.43,155.3,155.3,154.95656621928296,NaN,NaN,NaN,NaN,NaN,154.67250000000067,155.51363791928563,153.8313620807157,155.1829071929951,154.86430356415104,155.35814404897155,154.37046307933053,279,155,59.11816233318556,62.798991837507245,NaN,NaN,NaN,NaN,0.1407123963392289,25.775021415915283,533719,0.0028072649752038104,0.18782582965286565,0.18501856467766184
2025-09-04T14:45:00-04:00,155.33,155.33,155.33,155.33,154.95656621928296,NaN,NaN,NaN,NaN,NaN,154.69230000000067,155.54768578388163,153.8369142161197,155.1829071929951,154.86680052696553,155.3604880732363,154.37311298069477,97,149.86666666666667,59.950397126590836,62.5035989030181,NaN,NaN,NaN,NaN,0.13280436802928405,26.055700803848225,533816,-0.0027550006642623748,0.18157481384733387,0.18432981451159625
2025-09-04T14:50:00-04:00,155.31,155.31,155.31,155.31,154.95656621928296,NaN,NaN,NaN,NaN,NaN,154.71090000000066,155.57866883977292,153.8431311602284,155.1829071929951,154.86682502395166,155.3605099216712,154.37314012623213,1,147.03333333333333,59.0868231946586,62.215884091349395,NaN,NaN,NaN,NaN,0.1247469131700502,26.17119847856893,533815,-0.009053752330632658,0.17301262409830542,0.18206637642893808
2025-09-04T15:00:00-04:00,155.37,155.37,155.37,155.37,154.95656621928296,NaN,NaN,NaN,NaN,NaN,154.7271000000007,155.61304828248035,153.84115171752103,155.1829071929951,154.8723266090823,155.3660856059933,154.3785676121713,200,147.03333333333333,60.90619451994165,62.0703520605012,NaN,NaN,NaN,NaN,0.12012213365790392,26.52731943324594,534015,-0.010357879761661692,0.16911902672686097,0.17947690648852266
2025-09-04T15:10:00-04:00,155.45,155.61,155.45,155.61,155.09578442402167,NaN,NaN,NaN,NaN,NaN,154.74630000000067,155.66571026710739,153.82688973289396,155.31770462900064,154.8806055123497,155.3770383989014,154.384172625798,224,153.86666666666667,67.19104822379104,62.14103166997743,NaN,NaN,NaN,NaN,0.12868483839662573,27.70306476653649,534239,0.003047678221317074,0.18328650426516901,0.18023882604385194
2025-09-04T15:15:00-04:00,155.5,155.5,155.5,155.5,155.09578442402167,NaN,NaN,NaN,NaN,NaN,154.76590000000067,155.70671175549114,153.8250882445102,155.31770462900064,154.88083958682,155.3773246385502,154.3843545350898,7,153.1,62.25133199883021,62.09108843183132,NaN,NaN,NaN,NaN,0.12735020708258202,28.794828290306285,534232,0.0026271119354043804,0.18352271596310743,0.18089560402770305
2025-09-04T15:25:00-04:00,155.41,155.46,155.295,155.295,155.09578442402167,NaN,NaN,NaN,NaN,NaN,154.7828000000007,155.73063787604028,153.8349621239611,155.31770462900064,154.90114620456933,155.3960633585736,154.40622905056506,838,180.36666666666667,54.247207581790946,61.33649721827708,NaN,NaN,NaN,NaN,0.13289662086239848,28.32280010552096,533394,-0.012506020188237044,0.16526307879240676,0.1777690989806438
2025-09-04T15:30:00-04:00,155.35,155.36,155.27,155.28,155.09578442402167,NaN,NaN,NaN,NaN,NaN,154.79940000000067,155.75240081809184,153.8463991819095,155.31770462900064,154.90956620311843,155.402648851365,154.41648355487186,414,190.66666666666666,53.70309771537095,60.7554206624708,NaN,NaN,NaN,NaN,0.12983257651508454,27.720867381306007,532980,-0.02391353988190023,0.1478771741282685,0.17179071401016874
2025-09-04T15:35:00-04:00,155.24,155.35,155.22,155.35,155.09578442402167,NaN,NaN,NaN,NaN,NaN,154.81860000000069,155.77650404491573,153.86069595508565,155.31770462900064,154.92578381917835,155.41504657063734,154.43652106771935,842,211.7,55.92484435809605,60.23564573353862,NaN,NaN,NaN,NaN,0.12984453533543533,26.829544115975413,533822,-0.026908911630082494,0.13815457447256563,0.16506348610264812
2025-09-04T15:40:00-04:00,155.46,155.46,155.46,155.46,155.09578442402167,NaN,NaN,NaN,NaN,NaN,154.84120000000067,155.8052281320059,153.87717186799543,155.31770462900064,154.92643082065692,155.41575008634845,154.43711155496538,25,209.2,59.23542976071291,59.95234119050764,NaN,NaN,NaN,NaN,0.12842706852576236,26.51171082954705,533847,-0.02186065227434303,0.13773767075971932,0.15959832303406235
2025-09-04T15:45:00-04:00,155.4,155.4,155.27,155.29,155.09578442402167,NaN,NaN,NaN,NaN,NaN,154.86020000000067,155.8214095709458,153.89899042905554,155.31770462900064,154.9747069449167,155.45087214236938,154.49854174746403,2886,297.06666666666666,52.65315158727338,59.43524072136516,NaN,NaN,NaN,NaN,0.1328251350596363,25.032728789082565,530961,-0.029854559891442867,0.12228012316975878,0.15213468306120165
2025-09-04T15:50:00-04:00,155.25,155.48,155.25,155.48,155.09578442402167,NaN,NaN,NaN,NaN,NaN,154.89220000000068,155.82691741143913,153.95748258856224,155.31770462900064,155.0132992342203,155.48380023226386,154.54279823617676,2328,374.3333333333333,58.23861197613641,59.317101708570036,NaN,NaN,NaN,NaN,0.13976619684109012,24.04865618892342,533289,-0.02256158769643765,0.12393269844065458,0.14649428613709223
2025-09-04T15:55:00-04:00,155.48,155.65,155.44,155.53,155.09578442402167,NaN,NaN,NaN,NaN,NaN,154.9198000000007,155.84668933495638,153.992910665045,155.31770462900064,155.04272493244724,155.51562692875618,154.5698229361383,1530,421.3333333333333,59.58963201953975,59.21104664120503,NaN,NaN,NaN,NaN,0.14478289706672712,23.87602817853921,534819,-0.014952455557187855,0.12780371669060742,0.14275617224779527
2025-09-05T09:30:00-04:00,157.28,157.86,157.28,157.34,156.82184106148037,NaN,NaN,NaN,NaN,NaN,154.9822000000007,156.11045557355357,153.8539444264478,156.36318182259956,157.49333333333334,157.49333524068197,157.4933314259847,2929,518.1,82.12870718337766,60.301759969949714,NaN,NaN,NaN,NaN,0.3008698329905332,27.19061743845423,537748,0.10480912421972285,0.27376757752244885,0.168958453302726
2025-09-05T09:35:00-04:00,157.3,157.42,157.2,157.2,156.82184106148037,NaN,NaN,NaN,NaN,NaN,155.0390000000007,156.31280375225305,153.76519624774835,156.36318182259956,157.43507530120482,157.5321462482606,157.33800435414904,1055,549.3333333333334,78.48242845671436,61.68492183591606,NaN,NaN,NaN,NaN,0.29509341634835223,29.981065918010597,536693,0.16390425987416035,0.37383877814542643,0.20993451827126608
2025-09-05T09:40:00-04:00,157.3,157.3,157.3,157.3,156.82184106148037,NaN,NaN,NaN,NaN,NaN,155.1006000000007,156.50156629483612,153.69963370516527,156.36318182259956,157.4317678746327,157.52988952018322,157.33364622908218,100,549.1666666666666,79.19302085423337,63.05939495931909,NaN,NaN,NaN,NaN,0.28115817232347157,32.57219664902723,536793,0.1968196473494362,0.4559590774580613,0.2591394301086251
2025-09-05T09:45:00-04:00,157.74,157.74,157.1,157.44,156.82184106148037,NaN,NaN,NaN,NaN,NaN,155.1672000000007,156.6851870352759,153.64921296472548,156.54322909317096,157.43141662866697,157.52610873650784,157.3367245208261,302,555.9,80.17986079938667,64.56604050251396,NaN,NaN,NaN,NaN,0.3067897314432247,35.29392717102235,537095,0.21370471161436078,0.5262703196265761,0.31256560801221533
2025-09-05T09:50:00-04:00,157.3,157.3,156.98,157.14,156.82184106148037,NaN,NaN,NaN,NaN,NaN,155.2230000000007,156.81979679335507,153.62620320664632,156.54322909317096,157.36186310247064,157.51105380140953,157.21267240353174,1375,597.6333333333333,72.26992111854511,65.37773525955706,NaN,NaN,NaN,NaN,0.3177333220544235,37.36964589913233,535720,0.19109028853441046,0.5514284686802284,0.360338180145818
2025-09-05T09:55:00-04:00,157.05,157.05,156.67,156.67,NaN,NaN,NaN,157.693146256653,157.693146256653,157.693146256653,155.2678000000007,156.89842216324254,153.63717783675887,156.54322909317096,157.3243115648463,157.52578844651896,157.12283468317366,410,604.3,61.95745101455619,65.00390688746886,NaN,NaN,NaN,NaN,0.32860951333625027,38.20029166887191,535310,0.13361930117518944,0.5273623066148048,0.3937430054396153
2025-09-05T10:00:00-04:00,156.505,156.52,156.12,156.44,NaN,NaN,NaN,157.19027597225966,NaN,NaN,155.3056000000007,156.9554237964227,153.6557762035787,156.54322909317096,157.23050419348544,157.57445738724834,156.88655099972254,665,618.9333333333333,57.62409935871527,64.6733902703178,NaN,NaN,NaN,NaN,0.3444231195265169,37.359532418773675,534645,0.07232531263370157,0.4841496462317423,0.4118243335980407
2025-09-05T10:05:00-04:00,156.4,156.4,155.57,155.57,NaN,NaN,NaN,156.93435433715695,NaN,NaN,155.32820000000072,156.96084418635505,153.6955558136464,156.54322909317096,157.04960579857578,157.61568760836767,156.4835239887839,1028,635.1333333333333,44.84682560980785,64.00193441517614,NaN,NaN,NaN,NaN,0.38196432527462315,35.312312356689176,533617,-0.029159875682802094,0.37537448899453807,0.40453436467734016
2025-09-05T10:10:00-04:00,155.5,155.75,155,155,NaN,NaN,NaN,156.3834745945589,NaN,NaN,155.34080000000068,156.95326936072726,153.7283306392741,156.54322909317096,156.9351750416766,157.6372492850149,156.23310079833828,534,648.6,38.779750808878696,62.93598106471241,NaN,NaN,NaN,NaN,0.4082525877550072,33.21950123960946,533083,-0.13130434771712302,0.2404039300309364,0.3717082777480594
2025-09-05T10:15:00-04:00,155.02,155.02,154.44,154.44,NaN,NaN,NaN,155.7717257493517,NaN,NaN,155.3436000000007,156.94930238813873,153.73789761186265,156.54322909317096,156.75364337684178,157.66957956817296,155.8377071855106,719,666.3,33.92403756182145,61.36449486497851,NaN,NaN,NaN,NaN,0.4205202600582219,32.117084214496494,532364,-0.22757001819672118,0.08724575500215792,0.3148157731988791
2025-09-05T10:20:00-04:00,154.22,154.74,154,154,NaN,NaN,NaN,155.4652836698357,NaN,NaN,155.3368000000007,156.96220426948855,153.71139573051283,156.54322909317096,156.38695196179415,157.6121266792874,155.1617772443009,1562,715.0333333333333,30.674139500461806,59.32440270353201,NaN,NaN,NaN,NaN,0.4433402414826353,31.656175728989655,530802,-0.3069277664728749,-0.06884393489221452,0.23808383158066038
2025-09-05T10:25:00-04:00,153.8,154.2,153.52,153.79,NaN,NaN,NaN,154.9982253212068,NaN,NaN,155.32640000000072,156.98428062273476,153.66851937726668,156.54322909317096,156.05518219832734,157.4841033338734,154.62626106278128,1597,758.2333333333333,29.23464083162311,57.65165193527127,NaN,NaN,NaN,NaN,0.46024450994815985,31.765488510309066,529205,-0.35615027923274206,-0.2071040174602672,0.14904626177247488
2025-09-05T10:30:00-04:00,153.8,153.94,153.62,153.74,NaN,NaN,NaN,154.91012417024285,NaN,NaN,155.3142000000007,157.00920366939118,153.61919633061024,156.54322909317096,155.80896214984975,157.33375458038412,154.28416971931537,1480,802.6666666666666,28.887042761508553,55.55511127708356,NaN,NaN,NaN,NaN,0.4502270449518622,31.866993235819947,527725,-0.3728817199933295,-0.31705588821918695,0.055825831774142506
2025-09-05T10:35:00-04:00,153.75,154.08,153.61,153.61,NaN,NaN,NaN,154.91012417024285,NaN,NaN,155.30440000000073,157.03270974053135,153.5760902594701,156.11258327453677,155.50708400446038,157.09034693602666,153.9238210728941,2386,878.2666666666667,27.95632561388942,53.29558939096568,NaN,NaN,NaN,NaN,0.45163939888387195,31.646386745969746,525339,-0.37262683674866753,-0.4099577141616919,-0.03733087741302439
2025-09-05T10:40:00-04:00,153.74,153.97,153.4,153.45,NaN,NaN,NaN,154.85362553528327,NaN,NaN,155.28620000000072,157.07211215888063,153.5002878411208,155.8650666196294,155.2537290380313,156.86302337735023,153.6444346987124,2483,960.9666666666667,26.811354070983782,49.34434988293754,NaN,NaN,NaN,NaN,0.4600937275350235,31.69971965961083,522856,-0.36280385407709614,-0.4908356950093946,-0.12803184093229844
2025-09-05T10:45:00-04:00,153.32,153.32,152.87,153.04,NaN,NaN,NaN,154.2895971018613,NaN,NaN,155.2574000000007,157.1383042929548,153.3764957070466,155.29705329570353,154.9995474304864,156.66574530361768,153.3333495573551,2462,1031.6666666666667,24.088789792891674,45.45908997837879,NaN,NaN,NaN,NaN,0.46865846128252064,32.33461050183378,520394,-0.36262622161627545,-0.5813146179526427,-0.2186883963363673
2025-09-05T10:50:00-04:00,153,153.89,152.99,153.89,NaN,NaN,NaN,154.2895971018613,NaN,NaN,155.2414000000007,157.15467054000055,153.32812946000087,154.98664263656283,154.94759233884471,156.60422130064063,153.2909633770488,807,1052.1666666666667,38.11827032217072,42.525179226088596,NaN,NaN,NaN,NaN,0.4994685711909104,31.687877995844943,521201,-0.2872666646721265,-0.5777717271765255,-0.29050506250439895
2025-09-05T10:55:00-04:00,153.87,153.88,152.98,152.98,NaN,NaN,NaN,154.2895971018613,NaN,NaN,155.2062000000007,157.21733158178353,153.1950684182179,154.24431410925027,154.80367359430207,156.45499191905577,153.15235526954837,2068,1111.8,31.422715900474742,39.04252601902346,NaN,NaN,NaN,NaN,0.5287922446772737,31.100057336477043,519133,-0.2803993559607495,-0.6410042574553358,-0.36060490149458635
2025-09-05T11:00:00-04:00,152.93,153.14,152.68,152.72,NaN,NaN,NaN,154.241991337372,NaN,NaN,155.1700000000007,157.29068951033787,153.04931048966353,153.52545128740022,154.71777830979173,156.3814751563876,153.05408146319584,1100,1145.2333333333333,29.81149969285528,36.00978163147418,NaN,NaN,NaN,NaN,0.5238785129146099,30.935529315790927,518033,-0.2747010888640003,-0.7039812625745867,-0.4292801737105864
2025-09-05T11:05:00-04:00,152.85,153.17,152.85,153.15,NaN,NaN,NaN,154.241991337372,NaN,NaN,155.1370000000007,157.32981736568004,152.94418263432138,153.17436102992016,154.62900416713876,156.29019259515113,152.9678157391264,1415,1192.3666666666666,35.685064096536266,34.13318256590133,NaN,NaN,NaN,NaN,0.5186014762778511,30.714170531972897,519448,-0.2253739795983004,-0.7109976482084619,-0.4856236686101615
2025-09-05T11:10:00-04:00,152.86,153.32,152.86,153.32,NaN,NaN,NaN,154.241991337372,NaN,NaN,155.1058000000007,157.35599764448065,152.85560235552074,152.69779284731914,154.60397864231444,156.26177577319837,152.94618151143052,461,1201.0666666666666,37.89769336298072,32.724153566206006,NaN,NaN,NaN,NaN,0.5144156565437175,30.15622986836231,519909,-0.16736588557374565,-0.6948310255773436,-0.5274651400035979
2025-09-05T11:15:00-04:00,153.52,153.73,153.49,153.49,NaN,NaN,NaN,154.241991337372,NaN,NaN,155.0814000000007,157.37428904206294,152.78851095793848,152.69779284731914,154.58628476909792,156.2352976359588,152.93727190223703,469,1209.2333333333333,40.116348338982085,32.38626233257559,NaN,NaN,NaN,NaN,0.5069573953620231,28.742605722162693,520378,-0.1065761379157163,-0.6606853123982432,-0.554109174482527
2025-09-05T11:20:00-04:00,153.73,153.73,153.73,153.73,NaN,NaN,NaN,154.241991337372,NaN,NaN,155.0588000000007,157.382047347841,152.7355526521604,152.69779284731914,154.5861285811567,156.23503159739104,152.93722556492233,5,1209.1666666666667,43.2014285190485,32.70209645473057,NaN,NaN,NaN,NaN,0.4878890099790201,27.429954729263052,520383,-0.04251945762865117,-0.607258496518341,-0.5647390388896898
2025-09-05T11:25:00-04:00,153.89,153.92,153.88,153.88,NaN,NaN,NaN,154.241991337372,NaN,NaN,155.0366000000007,157.38314933023653,152.69005066976487,152.86354689819348,154.5782825987641,156.21946011159793,152.93710508593028,314,1191.7,45.10494272998575,33.50073253817088,NaN,NaN,NaN,NaN,0.4666112235519471,25.801320838394687,520697,0.014580236411148029,-0.5465137433757548,-0.5610939797869028
2025-09-05T11:30:00-04:00,153.79,154.04,153.79,154.04,NaN,NaN,NaN,154.241991337372,NaN,NaN,155.0136000000007,157.3761732071681,152.6510267928333,153.06983751855478,154.5748268235238,156.2120885518676,152.93756509518002,155,1183.0666666666666,47.13992167279131,34.676859836194424,NaN,NaN,NaN,NaN,0.45113899329823665,24.03383273497749,520852,0.06493111126617279,-0.4799300907041868,-0.5448612019703596
2025-09-05T11:35:00-04:00,153.89,154.29,153.89,154.29,152.84651329759697,152.84651329759697,152.84651329759697,NaN,NaN,NaN,154.9962000000007,157.36700455526295,152.62539544473844,153.31387001484381,154.57044872704904,156.19967297489828,152.9412244791998,295,1164.8333333333333,50.24362444222413,36.17750152266592,NaN,NaN,NaN,NaN,0.44748620806264877,22.755300219144566,521147,0.11400807954852044,-0.40235110253470907,-0.5163591820832295
2025-09-05T11:40:00-04:00,154.33,154.44,154.33,154.41,153.17758087497896,NaN,NaN,NaN,NaN,NaN,154.98130000000072,157.35728384658196,152.60531615341947,153.58409601187506,154.5686936303793,156.18992043520134,152.94746682555726,282,1173.4,51.7093127660697,37.80766366584886,NaN,NaN,NaN,NaN,0.42623719320103143,21.862810852177894,521429,0.15115774832655238,-0.32741199667503906,-0.47856974500159144
2025-09-05T11:45:00-04:00,154.22,154.22,154.22,154.22,153.17758087497896,NaN,NaN,NaN,NaN,NaN,154.95930000000072,157.3426908700056,152.57590912999584,153.58409601187506,154.56863237653562,156.1897233640117,152.94754138905952,5,1077.3666666666666,49.236251309158035,39.327658358368055,NaN,NaN,NaN,NaN,0.4093631079723862,20.76983757273832,521424,0.158756174953247,-0.2801245263100327,-0.4388807012632797
2025-09-05T11:50:00-04:00,154.02,154.25,154.02,154.07,153.17758087497896,NaN,NaN,NaN,NaN,NaN,154.93610000000072,157.33105410377846,152.541145896223,153.58409601187506,154.56512445962906,156.18044904773186,152.94979987152627,221,1007.1333333333333,47.312434222846846,40.79202122635827,NaN,NaN,NaN,NaN,0.3965514574029293,19.2868201252867,521203,0.14962500253950006,-0.25184944808890464,-0.4014744506284047
2025-09-05T11:55:00-04:00,154.24,154.33,153.99,154.04,153.17758087497896,NaN,NaN,NaN,NaN,NaN,154.91050000000072,157.31583428014164,152.5051657198598,153.58409601187506,154.56172115550942,156.17132577148013,152.9521165395387,221,963.5,46.917586948490964,42.42264959461537,NaN,NaN,NaN,NaN,0.39251206758843454,18.093427058665494,520982,0.1378038067111721,-0.2292196922394396,-0.3670234989506117
2025-09-05T12:00:00-04:00,154.17,154.17,154.17,154.17,153.17758087497896,NaN,NaN,NaN,NaN,NaN,154.88910000000072,157.30135677721458,152.47684322278687,153.58409601187506,154.56113928423378,156.16961873410756,152.95265983436,43,867.3,48.907428051036476,43.193303718105774,NaN,NaN,NaN,NaN,0.3737612056178317,16.9852763539458,521025,0.1348129864004105,-0.1985072659500986,-0.3333202523505091
2025-09-05T12:05:00-04:00,154.03,154.03,154.03,154.03,153.17758087497896,NaN,NaN,NaN,NaN,NaN,154.86370000000073,157.28484420041494,152.44255579958653,153.58409601187506,154.55931079592398,156.16532054708813,152.95330104475983,100,835.4666666666667,46.86977618370207,44.29666516690772,NaN,NaN,NaN,NaN,0.35706397664512846,15.95328712262023,520925,0.11997562283742563,-0.18335072380372708,-0.3033263466411527
2025-09-05T12:10:00-04:00,154.2,154.3,154.2,154.28,153.17856044608868,NaN,NaN,NaN,NaN,NaN,154.84330000000074,157.26658340051227,152.4200165994892,153.677756304937,154.55820208533405,156.16133769660698,152.9550664740611,108,835.7333333333333,50.81090517427723,45.79662270129501,NaN,NaN,NaN,NaN,0.35084512117047717,15.320061109999978,521033,0.12310631476101103,-0.14944345318988894,-0.27254976795089997
2025-09-05T12:15:00-04:00,154.37,154.37,154.37,154.37,153.17856044608868,NaN,NaN,NaN,NaN,NaN,154.82630000000074,157.25069997508726,152.40190002491423,153.8272050439496,154.55819563055184,156.16130412902888,152.9550871320748,1,825.7,52.18596496725854,46.97525847777517,NaN,NaN,NaN,NaN,0.3322133268011576,14.901565323720817,521034,0.12684350931666094,-0.1139953813050738,-0.24083889062173475
2025-09-05T12:20:00-04:00,154.37,154.37,154,154.23,153.17856044608868,NaN,NaN,NaN,NaN,NaN,154.8065000000007,157.23388398265274,152.37911601734868,153.8272050439496,154.55609499130554,156.1547298358022,152.9574601468089,172,785.6,49.851428974994526,47.829096735776155,NaN,NaN,NaN,NaN,0.33491237488678954,14.153793211752344,520862,0.1157977733645254,-0.09609167391607798,-0.21188944728060338
2025-09-05T12:25:00-04:00,154.25,154.28,154.19,154.19,153.23150904312806,NaN,NaN,NaN,NaN,NaN,154.78510000000074,157.2149794124841,152.35522058751738,153.8272050439496,154.55179608872731,156.1406231061615,152.96296907129312,380,784.6,49.17456096999489,48.47611192370564,NaN,NaN,NaN,NaN,0.31741863382344765,13.459433393495903,520482,0.102183258526718,-0.0841603741222059,-0.1863436326489239
2025-09-05T12:30:00-04:00,154.15,154.21,154.15,154.21,153.23150904312806,NaN,NaN,NaN,NaN,NaN,154.75970000000075,157.18654190651145,152.33285809349005,153.8272050439496,154.5491366233419,156.13241500404968,152.9658582426341,220,769.7666666666667,49.54345242297992,48.92911363112931,NaN,NaN,NaN,NaN,0.2990315885503444,12.921604519183536,520702,0.09126854172689858,-0.07225795549030067,-0.16352649721719925
2025-09-05T12:35:00-04:00,153.9,154.05,153.9,154.05,153.23150904312806,NaN,NaN,NaN,NaN,NaN,154.73470000000074,157.16451514506744,152.30488485493404,153.8272050439496,154.54547328244274,156.12409476633087,152.96685179855461,201,742.2,46.627791789850136,49.037888563976765,NaN,NaN,NaN,NaN,0.29981504651103424,13.063088771222715,520501,0.0709229745683908,-0.07487277900671074,-0.14579575357510155
2025-09-05T12:40:00-04:00,154.14,154.31,154.14,154.31,153.26896226976038,NaN,NaN,NaN,NaN,NaN,154.71430000000072,157.1409058681258,152.28769413187564,153.8272050439496,154.54164570367942,156.11024344534894,152.9730479620099,400,737.7333333333333,51.61127431695544,49.357270895702776,NaN,NaN,NaN,NaN,0.2969711146173883,12.402324424125059,520901,0.0723746523590087,-0.05532743812634067,-0.12770209048534936
2025-09-05T12:45:00-04:00,154.46,154.47,154.46,154.47,153.53060034840766,NaN,NaN,NaN,NaN,NaN,154.69750000000073,157.11900221953294,152.27599778046851,153.95009675904112,154.5413765230635,156.10716246051877,152.97559058560822,110,717.4333333333333,54.43107168833471,49.65637427042496,NaN,NaN,NaN,NaN,0.2871874635732889,11.689918303841806,521011,0.08086559879798698,-0.026620091987865635,-0.10748569078585261
2025-09-05T12:50:00-04:00,154.19,154.33,154.19,154.27,153.53060034840766,NaN,NaN,NaN,NaN,NaN,154.6755000000007,157.09214581584126,152.25885418416016,153.95009675904112,154.53430163273958,156.08065825893343,152.98794500654574,800,692.0333333333333,50.47178392431277,49.56797935315661,NaN,NaN,NaN,NaN,0.286674073318054,11.402055957986148,520211,0.07016484497807095,-0.019779634563263926,-0.08994447954133487
2025-09-05T12:55:00-04:00,154.36,154.64,154.36,154.64,153.56171436704085,NaN,NaN,NaN,NaN,NaN,154.65610000000072,157.05795535768118,152.25424464232026,154.01026192578632,154.53439956664874,156.074620659355,152.9941784739425,251,647.1666666666666,56.74087179606854,50.10402367365021,NaN,NaN,NaN,NaN,0.2926259252239056,10.875332902730639,520462,0.08421220493977816,0.015320776633387823,-0.06889142830639033
2025-09-05T13:00:00-04:00,154.48,154.48,154.48,154.48,153.56171436704085,NaN,NaN,NaN,NaN,NaN,154.6357000000007,157.02583640599372,152.24556359400768,154.01026192578632,154.53439785014092,156.07459467312515,152.9942010271567,1,597.8666666666667,53.582401562700504,50.55187848363977,NaN,NaN,NaN,NaN,0.28315264485076924,10.386232922850523,520461,0.07901951887500061,0.029882970287360422,-0.04913654858764018
2025-09-05T13:05:00-04:00,154.38,154.48,154.33,154.48,153.56171436704085,NaN,NaN,NaN,NaN,NaN,154.61940000000072,157.00243473731112,152.23636526269033,154.01026192578632,154.53277636265736,156.06101988034013,153.0045328449746,500,535,53.582401562700504,51.027936670369016,NaN,NaN,NaN,NaN,0.2736417416471412,9.783342576492004,520461,0.0720704786297689,0.04095154969957093,-0.031118928930197957
2025-09-05T13:10:00-04:00,154.7,154.78,154.7,154.71,153.843621032416,NaN,NaN,NaN,NaN,NaN,154.60800000000071,156.9837272569111,152.23227274309033,154.1963741060026,154.53444687426204,156.05631174158853,153.01258200693556,275,461.4,57.524242843625146,51.64342344126821,NaN,NaN,NaN,NaN,0.27552447438663197,9.747053086321152,520736,0.07889866926179828,0.0675044076470499,-0.011394261614748383
2025-09-05T13:15:00-04:00,154.78,154.9,154.78,154.9,153.95845644003344,NaN,NaN,NaN,NaN,NaN,154.5990000000007,156.9668116477566,152.2311883522448,154.3380992848021,154.5361723856209,156.05418282359227,153.0181619476495,173,385.1,60.507824784274874,52.617569769880554,NaN,NaN,NaN,NaN,0.2694155833590152,10.006707213998874,520909,0.09127168368285772,0.10269534298882377,0.011423659305966047
2025-09-05T13:20:00-04:00,154.81,154.92,154.81,154.92,154.00852660185012,NaN,NaN,NaN,NaN,NaN,154.5882000000007,156.94510539462703,152.2312946053744,154.41547942784166,154.53994919037947,156.0501091912509,153.02978918950805,359,370.1666666666667,60.81980318818707,53.3324910565884,NaN,NaN,NaN,NaN,0.2580287559762274,10.297678820589818,521268,0.09541444289395354,0.13069171292340798,0.03527727002945444
2025-09-05T13:25:00-04:00,154.81,154.85,154.79,154.85,154.00852660185012,NaN,NaN,NaN,NaN,NaN,154.5794000000007,156.92903285627068,152.22976714373073,154.41547942784166,154.54256233920935,156.04615401707915,153.03897066133956,300,311.23333333333335,59.0611975819412,53.82357910049431,NaN,NaN,NaN,NaN,0.24888384483506795,10.497749638064912,520968,0.0882204087432336,0.14555278095849644,0.05733237221526284
2025-09-05T13:35:00-04:00,154.72,154.72,154.72,154.72,154.00852660185012,NaN,NaN,NaN,NaN,NaN,154.5642000000007,156.90012496439013,152.2282750356113,154.41547942784166,154.54309360559694,156.04446394277952,153.04172326841436,100,277.9,55.83240761875301,54.250791860762774,NaN,NaN,NaN,NaN,0.24039214163256276,10.429747339036313,520868,0.07026768331551872,0.14516697635966125,0.07489929304414253
2025-09-05T13:40:00-04:00,154.58,154.58,154.49,154.49,154.00852660185012,NaN,NaN,NaN,NaN,NaN,154.5434000000007,156.86301931343428,152.22378068656712,154.41547942784166,154.54296639272667,156.04019678913252,153.04573599632081,185,236.9,50.5654415921062,54.350140476627864,NaN,NaN,NaN,NaN,0.23964984580166468,9.78570424467021,520683,0.039970809512565736,0.12486280493484969,0.08489199542228396
2025-09-05T13:45:00-04:00,154.6,154.62,154.6,154.62,154.00852660185012,NaN,NaN,NaN,NaN,NaN,154.48900000000071,156.66697796114744,152.311022038854,154.41547942784166,154.54317737865514,156.03816641722844,153.04818834008185,101,224.9,53.2499013172676,54.614886826219845,NaN,NaN,NaN,NaN,0.2318177139586883,9.119013203976168,520784,0.02640833225604952,0.11790241074234586,0.09149407848629634
2025-09-05T13:50:00-04:00,154.5,154.6,154.5,154.6,154.00852660185012,NaN,NaN,NaN,NaN,NaN,154.4370000000007,156.47312278590272,152.40087721409867,154.41547942784166,154.54324066398226,156.03621492550064,153.05026640246388,91,212.3,52.775084061032125,55.053979131304274,NaN,NaN,NaN,NaN,0.2238307343902109,8.773892595536772,520693,0.014412778520712682,0.10951005163718719,0.0950972731164745
2025-09-05T13:55:00-04:00,154.67,154.68,154.67,154.68,154.00852660185012,NaN,NaN,NaN,NaN,NaN,154.3846000000007,156.25109279647208,152.5181072035293,154.41547942784166,154.54364630990676,156.03436744868162,153.0529251711319,103,215.56666666666666,54.52192915842977,55.261883048552434,NaN,NaN,NaN,NaN,0.21355711050519674,8.162462358349245,520796,0.010377085584756987,0.10806863009742074,0.09769154451266375
2025-09-05T14:00:00-04:00,154.88,154.92,154.79,154.79,154.10960562848905,NaN,NaN,NaN,NaN,NaN,154.33160000000072,155.9865530987999,152.67664690120154,154.5050718073057,154.54536330115502,156.0318264046375,153.05890019767253,202,211.83333333333334,56.88356756174734,55.43706132522477,NaN,NaN,NaN,NaN,0.21544588832625272,8.366244823299995,520998,0.01343291531947545,0.11448268866200806,0.10104977334253261
2025-09-05T14:05:00-04:00,154.94,155.06,154.94,155.06,154.2516690090123,NaN,NaN,NaN,NaN,NaN,154.2900000000007,155.75404371493468,152.82595628506672,154.59305744584458,154.54792583513293,156.03077880136408,153.06507286890178,185,212.83333333333334,62.087688651626756,56.2667688057472,NaN,NaN,NaN,NaN,0.21934261058866397,8.973464881677911,521183,0.030953592313976416,0.13974176373500313,0.10878817142102672
2025-09-05T14:10:00-04:00,155.11,155.11,155.11,155.11,154.2516690090123,NaN,NaN,NaN,NaN,NaN,154.2588000000007,155.5779551232774,152.93964487672397,154.71144595667565,154.5495613881937,156.03056483461503,153.06855794177235,100,206.33333333333334,62.97882808138916,56.71233711184153,NaN,NaN,NaN,NaN,0.20724670983233165,9.683801049871196,521283,0.04251165696259605,0.1619277426242718,0.11941608566167573
2025-09-05T14:15:00-04:00,155.26,155.3,155.26,155.3,154.56573560531905,NaN,NaN,NaN,NaN,NaN,154.2360000000007,155.43775205398026,153.03424794602114,154.88615676534053,154.55174267919998,156.03109507849948,153.07239027990047,102,200.33333333333334,66.22743881529897,57.61555405845569,NaN,NaN,NaN,NaN,0.20601480198716496,10.874473203974963,521385,0.0585641591291452,0.19262128457310723,0.13405712544396203
2025-09-05T14:20:00-04:00,155.39,155.39,155.31,155.31,154.65592944144092,NaN,NaN,NaN,NaN,NaN,154.2308000000007,155.41148346276577,153.05011653723562,155.0139254122724,154.55887342839614,156.03337273063093,153.08437412616135,316,210.7,66.39458170277828,58.53070978274696,NaN,NaN,NaN,NaN,0.19772803041665138,12.215171525641047,521701,0.06497152991902139,0.21527153784273878,0.1503000079237174
2025-09-05T14:25:00-04:00,155.29,155.35,155.29,155.35,154.65592944144092,NaN,NaN,NaN,NaN,NaN,154.2378000000007,155.4405853670753,153.0350146329261,155.01914032981793,154.55896209420868,156.03339980693113,153.08452438148623,4,203.46666666666667,67.09606354822142,59.214411261646696,NaN,NaN,NaN,NaN,0.1878903139583193,13.36212132718852,521705,0.06676408091021879,0.23375510906149088,0.1669910281512721
2025-09-05T14:30:00-04:00,155.4,155.41,155.4,155.41,154.75660099932944,NaN,NaN,NaN,NaN,NaN,154.2572000000007,155.50292895897877,153.01147104102262,155.11531226385435,154.561440336295,156.03443243060784,153.08844824198215,102,199.5,68.16938091892573,59.76166527126462,NaN,NaN,NaN,NaN,0.17875529153272524,14.596500744579549,521807,0.06669436820145674,0.250358988403093,0.18366462020163626
2025-09-05T14:35:00-04:00,155.41,155.41,155.36,155.36,154.7592554993599,NaN,NaN,NaN,NaN,NaN,154.2844000000007,155.565369382637,153.0034306173644,155.14924981108348,154.5729580860883,156.0386689729927,153.10724719918392,500,214.73333333333332,66.23054062098767,60.14814651646465,NaN,NaN,NaN,NaN,0.16955848499467222,15.52638561352003,521307,0.05828912616306342,0.2565260279054655,0.1982369017424021
2025-09-05T14:40:00-04:00,155.3,155.37,155.24,155.37,154.7592554993599,NaN,NaN,NaN,NaN,NaN,154.31600000000068,155.62428742990986,153.0077125700915,155.14924981108348,154.5734476039872,156.0388082548151,153.1080869531593,23,212.16666666666666,66.43614821988612,60.67492870488929,NaN,NaN,NaN,NaN,0.1667328789236239,15.754724583316747,521330,0.048796159623409385,0.25923210127166385,0.21043594164825447
2025-09-05T14:45:00-04:00,155.35,155.35,155.35,155.35,154.7592554993599,NaN,NaN,NaN,NaN,NaN,154.3482000000007,155.67728202878516,153.01911797121625,155.14924981108348,154.57349145842156,156.03882235155086,153.10816056529225,2,208.63333333333333,65.57619281293293,61.37091336161643,NaN,NaN,NaN,NaN,0.15625195900050864,15.966753626699415,521328,0.03709331919869957,0.2568025906466289,0.21970927144792934
2025-09-05T14:50:00-04:00,155.41,155.44,155.17,155.17,154.7592554993599,NaN,NaN,NaN,NaN,NaN,154.37940000000071,155.71093992025487,153.04786007974656,155.14924981108348,154.57598300697725,156.0392348871185,153.112731126836,129,212.9,58.2662235670809,61.92096921697176,NaN,NaN,NaN,NaN,0.16437681907190163,15.246855205604898,521199,0.0143234854798234,0.2376136282977086,0.2232901428178852
2025-09-05T14:55:00-04:00,155.15,155.27,155.07,155.27,154.7592554993599,NaN,NaN,NaN,NaN,NaN,154.4158000000007,155.74322210288742,153.088377897114,155.14924981108348,154.5799118392604,156.0394139916733,153.1204096868475,224,214.63333333333333,60.87555766422243,62.465658956039974,NaN,NaN,NaN,NaN,0.16692133199533846,14.196695272008371,521423,0.0036470068245555154,0.2278489013485796,0.2242018945240241
2025-09-05T15:00:00-04:00,155.28,155.41,155.25,155.41,154.7592554993599,NaN,NaN,NaN,NaN,NaN,154.46320000000068,155.75962240001337,153.166777599988,155.14924981108348,154.5906837418323,156.04287419765654,153.13849328600804,503,218.73333333333332,64.24594650955208,63.285006273791396,NaN,NaN,NaN,NaN,0.16642695113852832,13.746352034591286,521926,0.00365448177553096,0.2287699967434378,0.22511551496790683
2025-09-05T15:05:00-04:00,155.47,155.48,155.47,155.48,154.89809971168273,NaN,NaN,NaN,NaN,NaN,154.4950000000007,155.81146952081696,153.17853047918442,155.15413070247666,154.59360528702152,156.04428892864985,153.1429216453932,120,215.4,65.83091239306641,64.09279079055116,NaN,NaN,NaN,NaN,0.15953931177149008,13.612580829895329,522046,0.005882494244613928,0.23246863277367424,0.22658613852906032
2025-09-05T15:10:00-04:00,155.51,155.51,155.5,155.5,154.95023154296987,NaN,NaN,NaN,NaN,NaN,154.5454000000007,155.8182375227024,153.27256247729903,155.23430456198133,154.62264611210128,156.05891853725376,153.1863736869488,1200,248.7,66.290703911397,64.76472910124042,NaN,NaN,NaN,NaN,0.1502865037878123,13.611497432486633,523246,0.00618120993067145,0.23431265094239961,0.22813144101172816
2025-09-05T15:15:00-04:00,155.58,155.66,155.58,155.66,155.06863010919852,NaN,NaN,NaN,NaN,NaN,154.6042000000007,155.803827208442,153.40457279155942,155.35944364958507,154.6385245214841,156.06900192171432,153.20804712125388,600,255.36666666666667,69.7926891307875,65.31508627832334,NaN,NaN,NaN,NaN,0.15098032494582547,14.198599174525919,523846,0.014175405306649014,0.24585069764503942,0.2316752923383904
2025-09-05T15:20:00-04:00,155.61,155.65,155.57,155.65,155.07141964968952,NaN,NaN,NaN,NaN,NaN,154.65420000000069,155.81498656058577,153.4934134394156,155.36455491966805,154.65343201471623,156.07812466533312,153.22873936409934,587,271.26666666666665,69.30805606314827,65.76717399130612,NaN,NaN,NaN,NaN,0.14662458744969534,14.684633426796598,523259,0.015692597869568614,0.25129103967535116,0.23559844180578254
2025-09-05T15:25:00-04:00,155.74,155.74,155.73,155.73,155.2086278474309,NaN,NaN,NaN,NaN,NaN,154.7024000000007,155.8374387478892,153.5673612521122,155.46664393573445,154.65623738607815,156.0801397400072,153.23233503214908,101,247.96666666666667,71.04053632914828,66.11096667086679,NaN,NaN,NaN,NaN,0.14257997406043163,15.484609174625561,523360,0.018778419947268837,0.2590714667398686,0.24029304679259975
2025-09-05T15:30:00-04:00,155.64,155.64,155.52,155.64,155.2086278474309,NaN,NaN,NaN,NaN,NaN,154.7454000000007,155.85609859061913,153.63470140938227,155.46664393573445,154.67675448087294,156.09180327110084,153.26170569064504,864,268.4,66.49318761811014,66.11800995053335,NaN,NaN,NaN,NaN,0.14739569019897075,15.018961234381287,522496,0.011793862056471233,0.2550353743631888,0.24324151230671756
2025-09-05T15:35:00-04:00,155.69,155.74,155.51,155.57,155.2086278474309,NaN,NaN,NaN,NaN,NaN,154.7822000000007,155.87771295711093,153.68668704289047,155.46664393573445,155.1247401341383,156.2443917997799,154.00508846849672,36944,1499.8333333333333,63.109524263967515,65.83325714451522,NaN,NaN,NaN,NaN,0.15329599804190272,15.005843833772147,485552,0.00011299984224116821,0.24338276210951904,0.24326976226727787
2025-09-05T15:40:00-04:00,155.46,155.57,155.46,155.465,155.2086278474309,NaN,NaN,NaN,NaN,NaN,154.8139000000007,155.89478350862368,153.73301649137773,155.46664393573445,155.1252655337804,156.24421720581836,154.00631386174246,108,1486.7666666666667,58.31580892106861,65.1294305732397,NaN,NaN,NaN,NaN,0.15020342675319434,14.718433527163546,485444,-0.016132960623545106,0.2231035614878465,0.2392365221113916
2025-09-05T15:45:00-04:00,155.54,155.54,155.53,155.53,155.2086278474309,NaN,NaN,NaN,NaN,NaN,154.8437000000007,155.91974239657958,153.7676576034218,155.46664393573445,155.1258227134807,156.24411173515796,154.00753369180342,105,1481.1,60.324919730031915,64.7076005096,NaN,NaN,NaN,NaN,0.14483175341367963,14.451552528169845,485549,-0.023502823010319085,0.20985799334849276,0.23336081635881184
2025-09-05T15:50:00-04:00,155.66,155.75,155.62,155.64,155.2086278474309,NaN,NaN,NaN,NaN,NaN,154.87070000000068,155.95750818881126,153.7838918111901,155.46664393573445,155.13312532608043,156.2456489602225,154.02060169193837,1046,1510.2,63.528598589358644,64.49991839313375,NaN,NaN,NaN,NaN,0.15020091388413098,15.096980105346484,486595,-0.021997616155750382,0.20586379616412387,0.22786141231987425
2025-09-05T15:55:00-04:00,155.73,155.79,155.64,155.76,155.2086278474309,NaN,NaN,NaN,NaN,NaN,154.89770000000067,156.00428250449698,153.79111749550435,155.46664393573445,155.14078289576446,156.24818602580737,154.03337976572155,1013,1532,66.68866655457035,64.57938080325073,NaN,NaN,NaN,NaN,0.15018656289240775,15.849383802244185,487608,-0.0143202796148722,0.20996106280128402,0.22428134241615622
2025-09-08T09:30:00-04:00,157.28,158.13,157.28,157.77,156.8870188787505,NaN,NaN,NaN,NaN,NaN,154.9687000000007,156.32059764377388,153.6168023562275,156.65033675831134,157.72666666666666,157.72666666666666,157.72666666666666,3274,1631.1333333333334,87.00270815541536,66.63198684527462,NaN,NaN,NaN,NaN,0.3087446655429504,19.9386804175365,490882,0.11747119300101122,0.37112033366742025,0.25364914066640903
2025-09-08T09:35:00-04:00,157.73,157.78,157.39,157.39,156.8870188787505,NaN,NaN,NaN,NaN,NaN,155.03510000000068,156.52318398931368,153.54701601068768,156.65033675831134,157.71167894239846,157.76527774034065,157.65808014445628,256,1636.3333333333333,77.39362934114618,67.81184910791202,NaN,NaN,NaN,NaN,0.3145486180041693,23.73588441745079,490626,0.1673543177136611,0.46284203780848543,0.2954877200948243
2025-09-08T09:40:00-04:00,157.59,157.59,157.59,157.59,156.8870188787505,NaN,NaN,NaN,NaN,NaN,155.10610000000068,156.73004986353257,153.4821501364688,156.65033675831134,157.7115068363979,157.7652625783436,157.65775109445218,5,1630.3333333333333,78.72543471045798,68.8460982651196,NaN,NaN,NaN,NaN,0.30636657386101557,27.261859560228345,490631,0.1999167316354501,0.545383634639137,0.3454669030036869
2025-09-08T09:45:00-04:00,157.7,157.92,157.49,157.92,156.8870188787505,NaN,NaN,NaN,NaN,NaN,155.18110000000067,156.96380949940917,153.39839050059217,156.7426124202554,157.71816018965367,157.7727851293631,157.66353524994426,402,1640.3666666666666,80.74148491558189,69.91113915958498,NaN,NaN,NaN,NaN,0.3151975328709415,30.73016975466088,491033,0.22775652967274818,0.6301625650946221,0.4024060354218739
2025-09-08T09:50:00-04:00,157.72,157.72,157.72,157.72,156.8870188787505,NaN,NaN,NaN,NaN,NaN,155.25490000000067,157.14327124508773,153.36652875491362,156.7426124202554,157.71820576335557,157.77215066498314,157.664260861728,100,1640.6666666666667,76.0384863073118,70.60740933072175,NaN,NaN,NaN,NaN,0.3069691376658734,33.95074350663395,490933,0.21683441032480638,0.6734490483278819,0.4566146380030755
2025-09-08T09:55:00-04:00,157.955,158.06,157.76,157.76,157.06807838718865,NaN,NaN,NaN,NaN,NaN,155.32450000000065,157.31763245904827,153.33136754095304,157.05647194896346,157.72295826350646,157.78181238324584,157.66410414376708,140,1641.9,76.33537416720854,71.0747439761804,NaN,NaN,NaN,NaN,0.3093284849754542,37.12738963733519,491073,0.19701165748114047,0.7028792098545011,0.5058675523733607
2025-09-08T10:00:00-04:00,157.87,158.06,157.87,157.91,157.12043846049826,NaN,NaN,NaN,NaN,NaN,155.39530000000067,157.4963534594017,153.29424654059966,157.10717755917076,157.73559144642718,157.81262879033616,157.6585541025182,250,1643.5,77.46306238520825,71.65724442775611,NaN,NaN,NaN,NaN,0.3086621646200654,40.077132472986335,491323,0.17922021505705676,0.7298928211946816,0.5506726061376248
2025-09-08T10:05:00-04:00,157.99,158.16,157.68,157.68,157.12043846049826,NaN,NaN,NaN,NaN,NaN,155.46430000000066,157.63324814122026,153.29535185878106,157.15774204733663,157.74827214394386,157.82812910378817,157.66841518409956,612,1657.7333333333333,71.81227042194485,71.7123682915273,NaN,NaN,NaN,NaN,0.32090058143291716,41.98428199698005,490711,0.13897542408842534,0.7243918862481564,0.5854164621597311
2025-09-08T10:10:00-04:00,157.5,157.5,157.45,157.45,157.12043846049826,NaN,NaN,NaN,NaN,NaN,155.52950000000067,157.73695668118359,153.32204331881775,157.15774204733663,157.73244864831113,157.83356442849072,157.63133286813155,300,1664.4,66.58164231277544,71.71868648400338,NaN,NaN,NaN,NaN,0.31440768275913866,42.820995690290125,490411,0.08645025458632483,0.6934792803926371,0.6070290258063122
2025-09-08T10:15:00-04:00,157.4,157.45,157.31,157.31,157.12043846049826,NaN,NaN,NaN,NaN,NaN,155.59150000000068,157.82125716150284,153.36174283849851,157.15774204733663,157.62474523427753,157.81492133081747,157.43456913773758,2145,1732.5,63.54748271937062,71.7499692308179,NaN,NaN,NaN,NaN,0.301949991133485,43.06117041310601,488266,0.03452799003524676,0.6501890133503707,0.615661023315124
2025-09-08T10:20:00-04:00,157.2,157.41,157.2,157.41,157.12043846049826,NaN,NaN,NaN,NaN,NaN,155.6587000000007,157.90106732924443,153.41633267075696,157.15774204733663,157.62032535297726,157.8122747232717,157.4283759826828,118,1725.9,64.7820221915822,72.21184160728316,NaN,NaN,NaN,NaN,0.29538213462395085,42.869365547118804,488384,0.0009430085751456208,0.616839784034056,0.6158967754589104
2025-09-08T10:25:00-04:00,157.61,158.05,157.61,158.05,157.12043846049826,NaN,NaN,NaN,NaN,NaN,155.7335000000007,158.03953057205143,153.42746942794997,157.15774204733663,157.6349082969432,157.83203883070445,157.43777776318194,413,1739.5333333333333,71.4469396639171,73.00627160256067,NaN,NaN,NaN,NaN,0.31999769643652687,43.540097237789595,488797,0.01507145028319612,0.6347360883129056,0.6196646380297095
2025-09-08T10:30:00-04:00,158.1,158.19,158.07,158.1,157.26813005619715,NaN,NaN,NaN,NaN,NaN,155.80610000000067,158.1761221854016,153.43607781459974,157.38543611407127,157.68042849067268,157.9154247209457,157.44543226039966,830,1763.8,71.8944440079628,73.60383198960382,NaN,NaN,NaN,NaN,0.3071407181196311,44.315849852843265,489627,0.020678332473683114,0.6455125536218134,0.6248342211481303
2025-09-08T10:35:00-04:00,158.13,158.22,158.06,158.22,157.29548778091547,NaN,NaN,NaN,NaN,NaN,155.8851000000007,158.30778981903043,153.46241018097098,157.496348891257,157.69643086230775,157.94327228683338,157.44958943778212,301,1757.1666666666667,72.98862026335188,74.05382868308821,NaN,NaN,NaN,NaN,0.2966306668253715,45.06955515831204,489928,0.02507025058400003,0.6561720343781303,0.6311017837941303
2025-09-08T10:40:00-04:00,158.27,158.29,158.14,158.14,157.3884201545102,NaN,NaN,NaN,NaN,NaN,155.9551000000007,158.4315026246241,153.4786973753773,157.6360791130056,157.72298330919375,157.987659050103,157.4583075682845,520,1773.7333333333333,71.00402701388597,72.91106574440754,NaN,NaN,NaN,NaN,0.2861570477664168,45.8503200872113,489408,0.01564974820616305,0.6506639690518341,0.635014220845671
2025-09-08T10:50:00-04:00,158.15,158.26,158.13,158.13,157.3884201545102,NaN,NaN,NaN,NaN,NaN,156.02810000000068,158.54118486909414,153.51501513090722,157.67186329040447,157.74938676795222,158.02712723883144,157.471646297073,602,1793.7333333333333,70.74508214642218,72.43616951621297,NaN,NaN,NaN,NaN,0.27500297292595816,46.53246352313099,488806,0.0024972940841546665,0.6381358384508644,0.6356385443667097
2025-09-08T10:55:00-04:00,158.09,158.13,158.09,158.13,157.3884201545102,NaN,NaN,NaN,NaN,NaN,156.10110000000068,158.6419638608265,153.56023613917486,157.67186329040447,157.7529993571199,158.03173722307554,157.47426149116427,102,1792.8333333333333,70.74508214642219,71.86614433306757,NaN,NaN,NaN,NaN,0.25821704628838915,46.984993305066496,488806,-0.011672316912878733,0.6210481482256114,0.6327204651384901
2025-09-08T11:05:00-04:00,158,158.13,158,158.13,157.3884201545102,NaN,NaN,NaN,NaN,NaN,156.1695000000007,158.7408375895107,153.59816241049072,157.67259250585886,157.7601160815402,158.04004755777257,157.4801846053078,226,1792.9,70.74508214642219,71.15211556384187,NaN,NaN,NaN,NaN,0.24905868583921817,46.99041281159516,488806,-0.02571006413962762,0.6005828849639556,0.6262929491035832
2025-09-08T11:10:00-04:00,158.11,158.18,158.07,158.14,157.3884201545102,NaN,NaN,NaN,NaN,NaN,156.2343000000007,158.83750572357346,153.63109427642794,157.7590740046871,157.8592934106921,158.14946303117463,157.56912379020955,3882,1905.5333333333333,70.87773102585348,70.78349018659485,NaN,NaN,NaN,NaN,0.23912592256498927,47.07947586306304,492688,-0.03823250472895312,0.5785023181923918,0.616734822921345
2025-09-08T11:15:00-04:00,158.07,158.07,158.07,158.07,157.3884201545102,NaN,NaN,NaN,NaN,NaN,156.29730000000072,158.92259938087324,153.6720006191282,157.7590740046871,157.86495832773224,158.1532225301019,157.57669412536256,400,1914.8666666666666,68.53511780679969,70.22632901799422,NaN,NaN,NaN,NaN,0.2270454995246324,47.16217726799749,492288,-0.05416700693973586,0.5490260642466751,0.603193071186411
2025-09-08T11:20:00-04:00,158.09,158.19,158.09,158.13,157.4415970223926,NaN,NaN,NaN,NaN,NaN,156.3629000000007,159.00413311338127,153.72166688662014,157.83260736299974,157.86943081906523,158.1573954757226,157.58146616240785,249,1883.1666666666667,69.46666095811905,69.65515748748784,NaN,NaN,NaN,NaN,0.21939939241573042,47.45434557366036,492537,-0.06298505647384922,0.5244617505940994,0.5874468070679486
2025-09-08T11:25:00-04:00,158.21,158.22,158.21,158.22,157.53606988501116,NaN,NaN,NaN,NaN,NaN,156.4329000000007,159.0817654853051,153.7840345146963,157.8890858903998,157.8702323791936,158.15834678396817,157.58211797441902,35,1864.3333333333333,70.86026196914548,69.58715688371646,NaN,NaN,NaN,NaN,0.21015657867174992,47.779409158750084,492572,-0.06482230901233399,0.5064189208025311,0.5712412298148651
2025-09-08T11:30:00-04:00,158.22,158.22,158.22,158.22,157.53606988501116,NaN,NaN,NaN,NaN,NaN,156.5075000000007,159.1433560277882,153.8716439722132,157.95526871231982,157.8704629141401,158.1586222072019,157.5823036210783,10,1845.1,70.86026196914548,69.89277257345718,NaN,NaN,NaN,NaN,0.19514539448091064,48.0812539163334,492572,-0.06778366800961533,0.4865116448028459,0.5542953128124612
2025-09-08T11:35:00-04:00,158,158,157.95,157.95,157.53606988501116,NaN,NaN,NaN,NaN,NaN,156.5741000000007,159.18397485509215,153.96422514490925,157.95526871231982,157.87447342934144,158.15721703793375,157.59172982074912,660,1863.7333333333333,61.14960852675069,69.7214958454129,NaN,NaN,NaN,NaN,0.2004921520179892,46.8545222354258,491912,-0.08837063236581266,0.4438320223551955,0.5322026547210081
2025-09-08T11:40:00-04:00,157.97,158.03,157.9,158.03,157.53606988501116,NaN,NaN,NaN,NaN,NaN,156.64270000000067,159.22154253866915,154.0638574613322,157.95526871231982,157.88052723832288,158.15670257934283,157.60435189730293,903,1865.0333333333333,62.777272678786474,69.57829945164177,NaN,NaN,NaN,NaN,0.1954569983024182,45.46355671660488,492815,-0.09638818512346758,0.4117174233166736,0.5081056084401412
2025-09-08T11:45:00-04:00,158,158.01,157.8,157.84,157.53606988501116,NaN,NaN,NaN,NaN,NaN,156.70590000000067,159.24380440310213,154.1679955968992,157.95526871231982,157.88101271661066,158.13216625454712,157.6298591786742,3501,750.2666666666667,56.701364439512446,68.52504407847002,NaN,NaN,NaN,NaN,0.19792435556653046,43.6730385721883,489314,-0.11311826189676832,0.3667077810691808,0.4798260429659491
2025-09-08T11:50:00-04:00,157.93,158.03,157.93,158.03,157.53606988501116,NaN,NaN,NaN,NaN,NaN,156.77070000000066,159.2748501630826,154.26654983691873,157.95526871231982,157.8815927492051,158.1322488767502,157.63093662166003,102,750.0666666666667,60.78839653054366,67.73175497294007,NaN,NaN,NaN,NaN,0.197358330168921,42.07678339392412,489416,-0.10992363001275507,0.34242150545000527,0.45234513546276034
2025-09-08T11:55:00-04:00,158.09,158.12,158.09,158.12,157.53606988501116,NaN,NaN,NaN,NaN,NaN,156.83190000000067,159.31530805331036,154.34849194669098,157.95526871231982,157.88382800201242,158.13426599808085,157.633390005944,201,753.2666666666667,62.58974643367724,66.98897827082045,NaN,NaN,NaN,NaN,0.1896898780139983,40.8954071863931,489617,-0.10053927282403663,0.32667104443271455,0.4272103172567512
2025-09-08T12:00:00-04:00,158.05,158.13,158.05,158.09,157.53606988501116,NaN,NaN,NaN,NaN,NaN,156.8915000000007,159.3496572364718,154.43334276352957,157.95526871231982,157.88872775955764,158.13815676582175,157.63929875329353,500,735.0666666666667,61.57432444715491,66.31542808748253,NaN,NaN,NaN,NaN,0.18185488672728303,39.57437863586409,489117,-0.0951962295583712,0.30821503030878716,0.40341125986715837
2025-09-08T12:05:00-04:00,158.04,158.13,158.04,158.13,157.53606988501116,NaN,NaN,NaN,NaN,NaN,156.9481000000007,159.38732191676553,154.50887808323586,157.95526871231982,157.89072708725675,158.13981437746895,157.64163979704455,201,708,62.449081307630344,65.7228565989974,NaN,NaN,NaN,NaN,0.1752938233896202,38.28929174997006,489318,-0.08798208679269465,0.29343365137629007,0.3814157381689847
2025-09-08T12:10:00-04:00,158.01,158.18,158.01,158.18,157.53606988501116,NaN,NaN,NaN,NaN,NaN,157.0055000000007,159.42280449037662,154.58819550962477,157.95526871231982,157.89085842901062,158.13993668622408,157.64178017179717,12,599.2666666666667,63.565615380390085,65.21003754428082,NaN,NaN,NaN,NaN,0.1749156931475056,37.29052000571233,489330,-0.0791346467833155,0.2824974296898404,0.3616320764731559
2025-09-08T12:15:00-04:00,158.12,158.16,158.11,158.15,157.56365845755516,NaN,NaN,NaN,NaN,NaN,157.06150000000068,159.45238958323637,154.670610416765,157.95526871231982,157.89397255393956,158.1430321346291,157.64491297325003,269,599.7,62.36737266623826,64.61162972426767,NaN,NaN,NaN,NaN,0.16742171506554043,36.36308910033015,489061,-0.07465233436690744,0.2683166585145216,0.342968992881429
2025-09-08T12:20:00-04:00,158.19,158.33,158.19,158.33,157.69008307312086,NaN,NaN,NaN,NaN,NaN,157.1199000000007,159.48912813574518,154.75067186425625,157.99695958274964,157.8969350425774,158.14734153004653,157.6465285551083,165,605.0333333333333,66.45344795418939,64.29560950486311,NaN,NaN,NaN,NaN,0.1683201639894309,36.15312748319464,489226,-0.05956911241037621,0.2685076023684587,0.32807671477883493
2025-09-08T12:25:00-04:00,158.37,158.46,158.37,158.46,157.85326111525174,NaN,NaN,NaN,NaN,NaN,157.1819000000007,159.52577618257064,154.83802381743075,158.12856766619973,157.93617084597093,158.21449432725672,157.65784736468515,1723,649.0666666666667,69.0658251899343,64.333517175087,NaN,NaN,NaN,NaN,0.16558300941875692,36.387301508699096,490949,-0.041687246280756374,0.2759676569278895,0.31765490320864587
2025-09-08T12:30:00-04:00,158.49,158.53,158.35,158.37,157.87924924637665,NaN,NaN,NaN,NaN,NaN,157.2419000000007,159.55050207900675,154.93329792099465,158.17485413295978,157.97203186148556,158.26805149019583,157.6760122327753,1888,708.6666666666666,65.27594888693193,64.03418059857363,NaN,NaN,NaN,NaN,0.1666127944602748,36.81988393662162,489061,-0.03693351354624863,0.2714880112758351,0.30842152482208374
2025-09-08T12:35:00-04:00,158.27,158.27,158.04,158.21,157.87924924637665,NaN,NaN,NaN,NaN,NaN,157.2991000000007,159.55856691925177,155.0396330807496,158.17485413295978,157.98496596878007,158.27554073945578,157.69439119810437,1737,761.9,59.070222886149864,63.19203494978824,NaN,NaN,NaN,NaN,0.17828330914168464,35.2711395419938,487324,-0.04504049653367315,0.25212090415499233,0.2971614006886655
2025-09-08T12:40:00-04:00,158.13,158.31,158.13,158.23,157.87924924637665,NaN,NaN,NaN,NaN,NaN,157.3603000000007,159.55048027549597,155.17011972450544,158.17485413295978,157.98519499876818,158.27572401957642,157.69466597795994,26,754.4333333333333,59.58741363140383,62.386831497092395,NaN,NaN,NaN,NaN,0.17840592991727908,33.99029818281391,487350,-0.04919350964825081,0.23566951362835198,0.2848630232766028
2025-09-08T12:45:00-04:00,158.09,158.09,158.09,158.09,157.87924924637665,NaN,NaN,NaN,NaN,NaN,157.4167000000007,159.53264291964433,155.30075708035707,158.17485413295978,157.9855154797431,158.27565766993473,157.69537328955147,83,736.8,54.404990954300466,61.90507309906024,NaN,NaN,NaN,NaN,0.17566264920890104,32.573114538267944,487267,-0.06074924748917521,0.2089264639151338,0.269675711404309
2025-09-08T12:50:00-04:00,158.1,158.12,158.06,158.12,157.87924924637665,NaN,NaN,NaN,NaN,NaN,157.4709000000007,159.51611068821072,155.4256893117907,158.17485413295978,157.9868906441476,158.27555455218527,157.69822673610992,330,737.8,55.302096115605956,61.37113191597592,NaN,NaN,NaN,NaN,0.16740103140826543,31.257158296903835,487597,-0.06535163622906304,0.18798616611798025,0.2533378023470433
2025-09-08T12:55:00-04:00,158.14,158.16,158.11,158.11,157.87924924637665,NaN,NaN,NaN,NaN,NaN,157.52350000000072,159.49514930937497,155.55185069062648,158.17485413295978,157.98750860663162,158.2756829474285,157.69933426583475,122,670.3666666666667,54.91423661988902,61.24347992885996,NaN,NaN,NaN,NaN,0.15901524345053097,30.2226120340715,487475,-0.06775829259280153,0.16863993660604137,0.2363982291988429
2025-09-08T13:00:00-04:00,158.04,158.04,157.97,157.99,157.87924924637665,NaN,NaN,NaN,NaN,NaN,157.5733000000007,159.46203673103713,155.68456326896427,158.17485413295978,157.9878613938092,158.27194475619976,157.70377803141864,802,693.1666666666666,50.35067361964842,60.49792829236744,NaN,NaN,NaN,NaN,0.1576570117754941,28.4003653526585,486673,-0.07552805370319399,0.14198816206985043,0.21751621577304442
2025-09-08T13:05:00-04:00,157.91,157.96,157.91,157.96,157.87924924637665,NaN,NaN,NaN,NaN,NaN,157.61930000000072,159.4298159593724,155.80878404062904,158.17485413295978,157.9869370208168,158.26812790742184,157.70574613421178,602,699.4666666666667,49.2487809929591,59.545002189459005,NaN,NaN,NaN,NaN,0.1521100823629597,26.375612725358327,486071,-0.08033626779612094,0.11709588102789326,0.1974321488240142
2025-09-08T13:10:00-04:00,157.88,158.02,157.87,158,NaN,NaN,NaN,158.4517003856578,158.4517003856578,158.4517003856578,157.66630000000072,159.3898066693105,155.94279333069093,158.17485413295978,157.98608800682604,158.26221041107289,157.7099656025792,1082,707.8666666666667,50.794984951402036,58.7750493683338,NaN,NaN,NaN,NaN,0.15195936219417727,24.821668223470457,487153,-0.07838584799337173,0.09944983883229952,0.17783568682567125
2025-09-08T13:15:00-04:00,158.09,158.12,158.09,158.12,NaN,NaN,NaN,158.4517003856578,NaN,NaN,157.7141000000007,159.35051766037054,156.07768233963088,158.17485413295978,157.98635108088683,158.2622391747893,157.71046298698437,64,699.9666666666667,55.20422085849028,58.25755933625236,NaN,NaN,NaN,NaN,0.14967655060887924,23.905787696518825,487217,-0.06701742132146174,0.09406391017384408,0.16108133149530582
2025-09-08T13:20:00-04:00,158.11,158.22,158.11,158.22,NaN,NaN,NaN,158.4517003856578,NaN,NaN,157.76570000000072,159.29656120832743,156.234838791674,157.9137326993738,157.98718395930368,158.26278472753538,157.71158319107198,128,686.9,58.53850325643402,57.89847989882693,NaN,NaN,NaN,NaN,0.14684251127967254,23.5387497109854,487345,-0.05146552912957153,0.09674942008334142,0.14821494921291295
2025-09-08T13:25:00-04:00,158.21,158.21,158.21,158.21,NaN,NaN,NaN,158.4517003856578,NaN,NaN,157.8185000000007,159.21938864624218,156.41761135375924,157.95998615949907,157.98787367866436,158.26332579749072,157.712421559838,94,669.9666666666667,58.07299839776915,57.59173887965056,NaN,NaN,NaN,NaN,0.1370680461882667,23.197928724418645,487251,-0.041009420352622034,0.09695317377213541,0.13796259412475745
2025-09-08T13:35:00-04:00,158.22,158.22,158.22,158.22,NaN,NaN,NaN,158.4517003856578,NaN,NaN,157.87360000000072,159.1065331527534,156.64066684724804,158.01498892759926,157.98796537081537,158.26340170575926,157.71252903587148,12,666.9666666666667,58.429004719558776,57.01856436289124,NaN,NaN,NaN,NaN,0.12799175717481842,22.932748263140283,487263,-0.03292555435768857,0.09680565117764672,0.1297312055353353
2025-09-08T13:40:00-04:00,158.09,158.13,158.07,158.13,NaN,NaN,NaN,158.4517003856578,NaN,NaN,157.9256000000007,158.96250431533957,156.88869568466185,158.01498892759926,157.9881498767461,158.26341875442847,157.7128809990637,46,660.9666666666667,53.98604278572944,55.94143704830518,NaN,NaN,NaN,NaN,0.12956377451947465,21.61998516543873,487217,-0.033059056177193694,0.08840738531384318,0.12146644149103687
2025-09-08T13:45:00-04:00,158.11,158.11,158.02,158.02,NaN,NaN,NaN,158.4517003856578,NaN,NaN,157.9732000000007,158.77874518135104,157.16765481865036,158.01498892759926,157.98822500164138,158.26333508852102,157.71311491476175,37,532.8,49.07432610896346,54.78417827845028,NaN,NaN,NaN,NaN,0.12816636205379683,20.0803620200095,487180,-0.03953705156011399,0.07204512704089439,0.11158217860100837
2025-09-08T13:50:00-04:00,158.03,158.03,157.73,157.92,NaN,NaN,NaN,158.35135008419448,NaN,NaN,158.01640000000071,158.51620412080732,157.5165958791941,158.01498892759926,157.9875415267955,158.26177647998196,157.71330657360903,221,526.8333333333334,45.06065899669572,53.78349514348927,NaN,NaN,NaN,NaN,0.14044019333566932,20.152797401896297,486959,-0.048923775796729074,0.05042745885509703,0.0993512346518261
2025-09-08T14:00:00-04:00,158.11,158.15,158.11,158.15,NaN,NaN,NaN,158.35135008419448,NaN,NaN,158.0240000000007,158.52012901464792,157.5278709853535,158.01498892759926,157.98790031537536,158.26190258858668,157.71389804216403,74,521,54.3154900546361,53.406929173720144,NaN,NaN,NaN,NaN,0.1468373223831228,19.475186842828876,487033,-0.038470231090984935,0.05126344578809494,0.08973367687907988
2025-09-08T14:05:00-04:00,158.21,158.21,158.08,158.08,NaN,NaN,NaN,158.35135008419448,NaN,NaN,158.0378000000007,158.49983532247276,157.5757646775286,158.01498892759926,157.98885348399244,158.2621244832182,157.71558248476668,218,527.1,51.47349328527161,53.197536483075226,NaN,NaN,NaN,NaN,0.1456346564986137,18.49567566275356,486815,-0.03518679997608995,0.04575017690896743,0.08093697688505738
2025-09-08T14:10:00-04:00,158.26,158.4,158.26,158.4,157.830912553557,157.830912553557,157.830912553557,NaN,NaN,NaN,158.0540000000007,158.508840630517,157.59915936948443,158.01498892759926,157.98944088100993,158.26288271865033,157.71599904336952,50,528.4333333333333,61.41323081618689,53.63404610454529,NaN,NaN,NaN,NaN,0.15808932389156935,17.754773617495,486865,-0.011600493312859131,0.06643636024398347,0.0780368535568426
2025-09-08T14:15:00-04:00,158.37,158.51,158.37,158.46,157.94450743748624,NaN,NaN,NaN,NaN,NaN,158.0648000000007,158.53188012074244,157.59771987925896,158.06940286194927,158.0234357689133,158.3125705449951,157.73430099283146,2492,589.5,62.94579727460559,54.20772900845362,NaN,NaN,NaN,NaN,0.15679722932788484,17.5633305906533,489357,0.006908676520455556,0.08667269920741205,0.0797640226869565
2025-09-08T14:20:00-04:00,158.54,158.58,158.53,158.53,158.06566619032776,NaN,NaN,NaN,NaN,NaN,158.0810000000007,158.55525309611818,157.60674690388322,158.16752228955943,158.02689399328196,158.3181737101103,157.73561427645362,223,566.8333333333334,64.70696755265641,55.23317857509705,NaN,NaN,NaN,NaN,0.1541688558044648,17.684594756800458,489580,0.02188774444853346,0.10712370324762333,0.08523595879908986
2025-09-08T14:25:00-04:00,158.47,158.54,158.44,158.54,158.06566619032776,NaN,NaN,NaN,NaN,NaN,158.09660000000073,158.5788382804583,157.61436171954315,158.16752228955943,158.0290175076227,158.32139165512436,157.73664336012106,150,455.1333333333333,64.96316534397731,56.35563460016977,NaN,NaN,NaN,NaN,0.1502996518184312,17.252903306978926,489730,0.02999003897322082,0.12272350751561589,0.09273346854239507
2025-09-08T14:30:00-04:00,158.53,158.59,158.53,158.59,158.0929417147408,NaN,NaN,NaN,NaN,NaN,158.11020000000073,158.60870159391138,157.61169840609008,158.25601426531802,158.03174926115125,158.32589438862013,157.73760413368237,172,457.46666666666664,66.28116020406839,57.461789975360226,NaN,NaN,NaN,NaN,0.1438496766885434,17.084430733613466,489902,0.03584172267404426,0.1375356218849504,0.10169389921090613
2025-09-08T14:35:00-04:00,158.59,158.59,158.49,158.49,158.0929417147408,NaN,NaN,NaN,NaN,NaN,158.12640000000073,158.62055398322528,157.63224601677618,158.2728114122544,158.03993783500292,158.33833093836427,157.74154473164157,577,470,61.31341790866731,57.89816119323001,NaN,NaN,NaN,NaN,0.14071755692507562,16.67566411566621,489325,0.030321672074326206,0.1395959893038139,0.10927431722948769
2025-09-08T14:40:00-04:00,158.53,158.6,158.53,158.6,158.1114200334725,NaN,NaN,NaN,NaN,NaN,158.14940000000072,158.62206749322414,157.6767325067773,158.29124912980353,158.04226741400785,158.3420955537563,157.7424392742594,151,458.3666666666667,64.4681610854521,58.321708181017016,NaN,NaN,NaN,NaN,0.1385234457161406,16.34807466661741,489476,0.031296009073654193,0.14839432857155543,0.11709831949790124
2025-09-08T14:45:00-04:00,158.71,158.71,158.71,158.71,158.1114200334725,NaN,NaN,NaN,NaN,NaN,158.17740000000072,158.61220220692633,157.7425977930751,158.40799930384284,158.04498177411352,158.34720119393296,157.7427623542941,142,456.4,67.33662498279662,58.983395794233275,NaN,NaN,NaN,NaN,0.13648605673641723,16.600456901293224,489618,0.036218496112130905,0.16237143963806489,0.12615294352593398
2025-09-08T14:50:00-04:00,158.63,158.63,158.58,158.6,158.1596719726475,NaN,NaN,NaN,NaN,NaN,158.2012000000007,158.59358022270817,157.80881977729325,158.40799930384284,158.04825516534808,158.35258737857077,157.7439229521254,206,462.8666666666667,61.950673702032425,59.23494357869568,NaN,NaN,NaN,NaN,0.13602276696952995,15.966757087298472,489412,0.029235126883398355,0.16269685213018192,0.13346172524678357
2025-09-08T14:55:00-04:00,158.62,158.64,158.61,158.64,158.1944596102544,NaN,NaN,NaN,NaN,NaN,158.21300000000073,158.62163186260562,157.80436813739584,158.40799930384284,158.04868530315096,158.3533156698288,157.74405493647313,26,454.76666666666665,63.10629448062932,59.88639012833138,NaN,NaN,NaN,NaN,0.12916399790027724,15.433208798674139,489438,0.024661494160425346,0.16428859294731524,0.1396270987868899
2025-09-08T15:00:00-04:00,158.58,158.66,158.58,158.64,158.19812053706102,NaN,NaN,NaN,NaN,NaN,158.22380000000075,158.6481562644019,157.7994437355996,158.40799930384284,158.0807444913016,158.40501924482425,157.75646973777896,2065,518.1,63.106294480629316,60.88867358345037,NaN,NaN,NaN,NaN,0.12565228376454202,14.734723324031213,489438,0.01922907989339734,0.16366344865363658,0.14443436876023924
2025-09-08T15:05:00-04:00,158.65,158.67,158.51,158.53,158.19812053706102,NaN,NaN,NaN,NaN,NaN,158.23000000000073,158.66292493478662,157.79707506521484,158.40799930384284,158.09132625529978,158.4198761355468,157.76277637505277,823,488.1,57.53328709379539,61.77957559038606,NaN,NaN,NaN,NaN,0.12810569206707448,13.744520279610898,488615,0.006479404141809253,0.1525336239375008,0.14605421979569155
2025-09-08T15:10:00-04:00,158.49,158.49,158.3,158.39,158.19812053706102,NaN,NaN,NaN,NaN,NaN,158.23500000000072,158.66942375532724,157.8005762446742,158.40799930384284,158.11304130081302,158.43903220184782,157.78705039977822,2948,523.4333333333333,51.321247981593345,61.56570115659729,NaN,NaN,NaN,NaN,0.1353838569194256,14.00300407080382,485667,-0.012117528065906852,0.130907309713308,0.14302483777921485
2025-09-08T15:15:00-04:00,158.32,158.32,158.21,158.21,158.19812053706102,NaN,NaN,NaN,NaN,NaN,158.23660000000075,158.6700532952352,157.8031467047663,158.40799930384284,158.11377383204777,158.43901965538242,157.78852800871312,226,473.06666666666666,44.646544220717615,61.078061937700575,NaN,NaN,NaN,NaN,0.13857072428232223,14.663931001933111,485441,-0.03592961367893921,0.09811282068054084,0.13404243435948004
2025-09-08T15:20:00-04:00,158.28,158.3,158.25,158.25,158.19812053706102,NaN,NaN,NaN,NaN,NaN,158.23900000000071,158.67139333851648,157.80660666148495,158.40799930384284,158.11464409177884,158.43916685173062,157.79012133182707,236,480.06666666666666,46.31740572007973,59.99978871655007,NaN,NaN,NaN,NaN,0.13510138683358516,15.277648866553164,485677,-0.04764041063944627,0.07449192106017222,0.12213233169961848
2025-09-08T15:25:00-04:00,158.19,158.31,158.19,158.31,NaN,NaN,NaN,158.6801621218722,158.6801621218722,158.6801621218722,158.24260000000072,158.67430008012957,157.81089991987187,158.40799930384284,158.115389883667,158.43931079989414,157.79146896743987,200,483.96666666666664,48.8133142510223,58.990325643436975,NaN,NaN,NaN,NaN,0.13402271634547228,16.133965655676132,485877,-0.04976751957669941,0.05992293222874423,0.10969045180544364
2025-09-08T15:30:00-04:00,158.315,158.315,158.315,158.315,NaN,NaN,NaN,158.6801621218722,NaN,NaN,158.24610000000072,158.67725328962746,157.814946710374,158.40799930384284,158.1168169613778,158.44001572575567,157.79361819699992,300,482.96666666666664,49.02600435559184,57.870256843646644,NaN,NaN,NaN,NaN,0.12480680803508107,16.886687525317736,486177,-0.04917279322846349,0.04822446026986427,0.09739725349832776
2025-09-08T15:35:00-04:00,158.35,158.36,158.32,158.32,NaN,NaN,NaN,158.6801621218722,NaN,NaN,158.25110000000072,158.6797597242253,157.82244027577613,158.40777564356753,158.11997949151484,158.44185901785178,157.7980999651779,622,499.6333333333333,49.253087334822574,56.74810841442131,NaN,NaN,NaN,NaN,0.11910632174686213,17.19403950775733,486799,-0.04679117504946266,0.03890828468649943,0.08569945973596209
2025-09-08T15:40:00-04:00,158.41,158.44,158.35,158.37,NaN,NaN,NaN,158.6801621218722,NaN,NaN,158.2559000000007,158.68440292787477,157.82739707212664,158.40777564356753,158.12389174263814,158.44500633895242,157.80277714632385,634,494.03333333333336,51.57624687767041,55.69775746253574,NaN,NaN,NaN,NaN,0.11917015590780088,16.817037269094097,487433,-0.04043597462459653,0.03515449145521643,0.07559046607981296
2025-09-08T15:45:00-04:00,158.39,158.39,158.3,158.3,NaN,NaN,NaN,158.6801621218722,NaN,NaN,158.2575000000007,158.68605221290656,157.82894778709485,158.40777564356753,158.1260156941773,158.4461488508248,157.8058825375298,450,488.96666666666664,48.24623661739346,54.7643873703019,NaN,NaN,NaN,NaN,0.11708657334295616,16.77514462369088,486983,-0.03948931782941538,0.02622881879304373,0.06571813662245911
2025-09-08T15:50:00-04:00,158.3,158.33,158.11,158.19,NaN,NaN,NaN,158.62341857880045,NaN,NaN,158.2569000000007,158.68574444637395,157.82805555362748,158.38822051485403,158.13745095711926,158.43638324767886,157.83851866655965,6883,682.3333333333334,43.493936294934194,53.26622845669347,NaN,NaN,NaN,NaN,0.12443753238988778,17.73536689095617,480100,-0.04444495912340013,0.010161937718208947,0.054606896841609076
2025-09-08T15:55:00-04:00,158.2,158.22,158.09,158.18,NaN,NaN,NaN,158.55780864340042,NaN,NaN,158.26150000000072,158.68192954126263,157.8410704587388,158.1925167989167,158.13815765505743,158.43301081739972,157.84330449271513,1419,727.5,43.0785108288592,51.53350601712651,NaN,NaN,NaN,NaN,0.12483485150489547,18.71959783373713,478681,-0.04635719817380592,-0.0033396008756483297,0.043017597298157594
2025-09-09T09:30:00-04:00,158.55,159.7,158.55,159.7,158.5332281131178,158.5332281131178,158.5332281131178,NaN,NaN,NaN,158.29490000000072,158.87244130518462,157.71735869481682,158.69319088083628,159.31666666666666,159.31666666666666,159.31666666666666,7139,961.2,77.79523859864867,52.6652606525991,NaN,NaN,NaN,NaN,0.22448950496883022,20.73817039327058,485820,0.05148503414514128,0.10737388997958419,0.05588885583444291
2025-09-09T09:35:00-04:00,159.74,160.05,159.74,159.9,159.28239956252153,NaN,NaN,NaN,NaN,NaN,158.33610000000073,159.05465212697888,157.61754787302257,159.06955270466904,159.48367843606624,159.74630725232524,159.22104961980725,2887,1054.3,79.56160355680186,53.84063987232571,NaN,NaN,NaN,NaN,0.23345454032820112,23.11226638581308,488707,0.12236572401186258,0.20884601084927112,0.08648028683740855
2025-09-09T09:40:00-04:00,159.82,159.87,159.48,159.87,159.28239956252153,NaN,NaN,NaN,NaN,NaN,158.3729000000007,159.2045443706399,157.5412556293615,159.06955270466904,159.49585407562228,159.7579040128401,159.23380413840445,500,1070.5666666666666,78.55219129358944,54.94391821610858,NaN,NaN,NaN,NaN,0.246779216019045,24.266678752759823,488207,0.15767479959871927,0.28357378633580765,0.12589898673708838
2025-09-09T09:45:00-04:00,159.85,160,159.76,159.76,159.28239956252153,NaN,NaN,NaN,NaN,NaN,158.4057000000007,159.32010474581725,157.49129525418417,159.08451373098816,159.50848357280134,159.7736947933321,159.24327235227057,401,1082.4,74.80462262766596,56.177585039956476,NaN,NaN,NaN,NaN,0.2462949863033996,25.550731488746443,487806,0.16337253053585205,0.3301146499069034,0.16674211937105138
2025-09-09T09:50:00-04:00,159.79,159.79,159.38,159.41,159.28239956252153,NaN,NaN,NaN,NaN,NaN,158.43210000000073,159.3839741298969,157.48022587010456,159.08451373098816,159.50913033245072,159.76960393338933,159.2486567315121,403,1094.6,64.29413854706468,57.1042200803473,NaN,NaN,NaN,NaN,0.25798820156744223,25.38774692479017,487403,0.13452316148264995,0.3348960712243638,0.20037290974171387
2025-09-09T09:55:00-04:00,159.47,159.69,159.47,159.49,159.28239956252153,NaN,NaN,NaN,NaN,NaN,158.45930000000072,159.45194094172447,157.46665905827697,159.08451373098816,159.51045321262848,159.7667786681388,159.25412775711814,379,1099.8666666666666,65.48777976617855,58.59287976216593,NaN,NaN,NaN,NaN,0.2595604728840536,25.236404115402205,487782,0.11266766098646233,0.3412074859747918,0.22853982498832945
2025-09-09T10:00:00-04:00,159.67,159.78,158.87,158.88,NaN,NaN,NaN,160.09795935746018,160.09795935746018,160.09795935746018,158.4733000000007,159.46952810601022,157.4770718939912,159.08451373098816,159.48542845104546,159.74716026123292,159.223696640858,949,1129.0333333333333,51.382694946606485,58.954686135489276,NaN,NaN,NaN,NaN,0.30602043910662097,23.50029690971563,486833,0.052050502834687706,0.2936029535316891,0.24155245069700138
2025-09-09T10:05:00-04:00,159.1,159.1,158.94,159,NaN,NaN,NaN,159.78782484121197,NaN,NaN,158.49030000000073,159.4928695183717,157.48773048162977,159.08451373098816,159.47051182005967,159.74099032173922,159.20003331838012,413,1135.5333333333333,53.504298967591005,59.28975647238703,NaN,NaN,NaN,NaN,0.29987612202757646,21.888197361578094,487246,0.016784201160100043,0.26253270214712643,0.24574850098702639
2025-09-09T10:10:00-04:00,159.3,159.45,159.23,159.29,NaN,NaN,NaN,159.78782484121197,NaN,NaN,158.5095000000007,159.5355492187052,157.48345078129623,159.08451373098816,159.46499533627883,159.73182485971512,159.19816581284255,509,1150.8333333333333,58.246380461731626,59.94835476568274,NaN,NaN,NaN,NaN,0.31059925616846307,21.103506438272117,487755,0.010066791265757408,0.25833199006922314,0.24826519880346573
2025-09-09T10:15:00-04:00,159.3,159.3,159.3,159.3,NaN,NaN,NaN,159.78782484121197,NaN,NaN,158.52630000000073,159.57579665991327,157.4768033400882,159.08451373098816,159.4637892300195,159.73001298668203,159.19756547335697,100,1071.1,58.40392207255576,60.60198581837796,NaN,NaN,NaN,NaN,0.28912788072785994,20.374864866630855,487855,0.0037035212594221933,0.2528946003777435,0.24919107911832128
2025-09-09T10:20:00-04:00,159.17,159.17,159.17,159.17,NaN,NaN,NaN,159.78782484121197,NaN,NaN,158.54230000000072,159.60607292650462,157.47852707349682,159.08451373098816,159.4616572327044,159.7280827721071,159.1952316933017,100,1067,55.47359883326595,60.880368100920506,NaN,NaN,NaN,NaN,0.2777616035330145,19.317425657584415,487755,-0.011047121605942956,0.2353821771108926,0.24642929871683555
2025-09-09T10:25:00-04:00,159.09,159.16,159.09,159.16,NaN,NaN,NaN,159.78782484121197,NaN,NaN,158.56130000000073,159.6345470541154,157.48805294588607,159.08451373098816,159.45513985682456,159.7227864331435,159.1874932805056,282,1071.4,55.243984053678,61.380207203512256,NaN,NaN,NaN,NaN,0.2636357747092266,18.10267732981238,487473,-0.02259825593278203,0.21818147880085803,0.24077973473364006
2025-09-09T10:30:00-04:00,159,159,158.6,158.6,NaN,NaN,NaN,159.56353821379153,NaN,NaN,158.56870000000072,159.6378020714475,157.49959792855392,159.08451373098816,159.43396447389614,159.724428414733,159.14350053305927,425,1079.8333333333333,44.20848780726663,61.431246597250286,NaN,NaN,NaN,NaN,0.284804647944282,17.881132975098854,487048,-0.06658667984701555,0.1575463849248706,0.22413306477188616
2025-09-09T10:35:00-04:00,158.45,158.45,158.44,158.44,NaN,NaN,NaN,159.19565011316462,NaN,NaN,158.57570000000072,159.6367259370892,157.51467406291223,158.85261098479052,159.42147355507086,159.73054208178377,159.11240502835795,185,1066.7666666666667,41.64858339237263,61.329108923215536,NaN,NaN,NaN,NaN,0.2758900302339759,18.016384211155316,486863,-0.10292139255132784,0.09548132408272636,0.1984027166340542
2025-09-09T10:45:00-04:00,158.6,158.62,158.6,158.62,NaN,NaN,NaN,159.19565011316462,NaN,NaN,158.5857000000007,159.6387527238408,157.53264727616062,158.80008878783244,159.4151343431611,159.73113566691174,159.09913301941046,116,1065.6,45.47383699636571,59.020437380195325,NaN,NaN,NaN,NaN,0.269040742360121,17.625398426110063,486979,-0.11062159729557747,0.060125720014582384,0.17074731731015985
2025-09-09T10:50:00-04:00,158.45,158.65,158.37,158.65,NaN,NaN,NaN,159.19565011316462,NaN,NaN,158.5965000000007,159.6408567394277,157.5521432605737,158.61307103026596,159.39912602030657,159.73301389389,159.06523814672315,281,1070.2333333333333,46.10795044274821,56.630890729191485,NaN,NaN,NaN,NaN,0.26982354647725526,17.767478934955278,487260,-0.109291110312359,0.03413342941971109,0.1434245397320701
2025-09-09T10:55:00-04:00,158.71,158.88,158.71,158.75,NaN,NaN,NaN,159.19565011316462,NaN,NaN,158.61170000000072,159.64233787973964,157.5810621202618,158.52216471519753,159.33759084389195,159.70462273881043,158.97055894897346,1663,1118.8,48.26762289342609,54.46770727203697,NaN,NaN,NaN,NaN,0.2669790074431649,17.214994350571892,488923,-0.09765377401915028,0.021357322208132246,0.11901109622728252
2025-09-09T11:00:00-04:00,158.83,158.91,158.64,158.64,NaN,NaN,NaN,159.19565011316462,NaN,NaN,158.62530000000072,159.6389871505354,157.61161284946604,158.52216471519753,159.3299179747433,159.70088200086244,158.95895394862416,214,1125.0666666666666,46.08009344820227,52.41595518778956,NaN,NaN,NaN,NaN,0.2671947926257967,16.866380086515672,488709,-0.0933454893509747,0.002329234538564151,0.09567472388953885
2025-09-09T11:05:00-04:00,158.45,158.61,158.43,158.61,NaN,NaN,NaN,159.19565011316462,NaN,NaN,158.63750000000073,159.63535018873142,157.63964981127003,158.52216471519753,159.32244243132672,159.69936377222376,158.94552109042968,164,1061.7,45.47477789075647,51.0717151409104,NaN,NaN,NaN,NaN,0.2631094502953812,17.02072526852134,488545,-0.08853859329794429,-0.014998517732891514,0.07354007556505278
2025-09-09T11:10:00-04:00,158.54,158.57,158.54,158.54,NaN,NaN,NaN,159.19565011316462,NaN,NaN,158.64590000000072,159.63319871830743,157.65860128169402,158.52216471519753,159.31782025213502,159.6983049119376,158.93733559233243,103,1037.7,44.0216745141733,49.53842190862432,NaN,NaN,NaN,NaN,0.24931591813142692,17.16404579466946,488442,-0.08602207191180786,-0.033987514324707035,0.052034557587100815
2025-09-09T11:15:00-04:00,158.72,158.75,158.66,158.66,NaN,NaN,NaN,159.19565011316462,NaN,NaN,158.65470000000073,159.63447223840464,157.67492776159682,158.52216471519753,159.3125040322581,159.69571687351396,158.92929119100222,147,944.3333333333334,47.139996809343316,49.235372041676946,NaN,NaN,NaN,NaN,0.246507638264897,16.697405102760353,488589,-0.07275161537662168,-0.038904961633676294,0.03384665374294539
2025-09-09T11:20:00-04:00,158.78,158.82,158.77,158.78,NaN,NaN,NaN,159.19565011316462,NaN,NaN,158.6661000000007,159.6381438051774,157.69405619482401,158.31179649314845,159.29347857460039,159.68217357396088,158.9047835752399,656,958.6666666666666,50.13164696409815,48.99446832714174,NaN,NaN,NaN,NaN,0.24032852124597553,16.037345323999773,489245,-0.05327064424072089,-0.03274165155795572,0.020528992682765167
2025-09-09T11:25:00-04:00,158.73,158.73,158.73,158.73,NaN,NaN,NaN,159.19565011316462,NaN,NaN,158.6763000000007,159.64007343768313,157.7125265623183,158.31179649314845,159.29036818282185,159.68023070627842,158.90050565936528,100,954.1333333333333,48.890058638567986,48.32615962548719,NaN,NaN,NaN,NaN,0.2267336268712638,15.539132178597079,489145,-0.04164585584374707,-0.031528327121918664,0.0101175287218284
2025-09-09T11:30:00-04:00,158.8,158.82,158.72,158.82,NaN,NaN,NaN,159.19565011316462,NaN,NaN,158.6901000000007,159.6418741114216,157.73832588857982,158.424749755615,159.28402627132505,159.67547654305704,158.89257599959305,231,955.1666666666666,51.231391704231385,47.81383602774974,NaN,NaN,NaN,NaN,0.2176812249518874,14.76218591516005,489376,-0.02652516894075359,-0.023038932454113592,0.00348623648664
2025-09-09T11:35:00-04:00,158.66,158.66,158.66,158.66,NaN,NaN,NaN,159.19565011316462,NaN,NaN,158.7029000000007,159.6352992488124,157.77050075118902,158.424749755615,159.2836863321894,159.67530075553202,158.8920719088468,10,945.5,47.100485306576346,47.215756490129046,NaN,NaN,NaN,NaN,0.21356113745532376,14.232450299273895,489366,-0.025899931703124913,-0.028888678142266144,-0.00298874643914123
2025-09-09T11:40:00-04:00,158.41,158.45,158.41,158.45,NaN,NaN,NaN,159.08621464949258,NaN,NaN,158.71350000000072,159.62179565624967,157.80520434375177,158.424749755615,159.27905154043418,159.67456001953522,158.88354306133314,101,928.1333333333333,42.281619725874066,46.28987332385734,NaN,NaN,NaN,NaN,0.21616391335137206,14.482824337805758,489265,-0.03752478946887739,-0.04989473327523797,-0.012369943806360577
2025-09-09T11:45:00-04:00,158.51,158.55,158.49,158.49,NaN,NaN,NaN,159.08621464949258,NaN,NaN,158.7203000000007,159.616631210655,157.8239687893464,158.424749755615,159.27346761325953,159.67291012501605,158.874025101503,135,911.5,43.468040785490274,46.23698425087332,NaN,NaN,NaN,NaN,0.20786649096913282,14.327729556685723,489400,-0.04017843266560855,-0.06259298463837126,-0.022414551972762715
2025-09-09T11:50:00-04:00,158.42,158.7,158.42,158.7,NaN,NaN,NaN,159.08621464949258,NaN,NaN,158.7327000000007,159.610212871225,157.8551871287764,158.424749755615,159.24089165131988,159.65612643552004,158.82565686711973,955,928.3333333333334,49.35395872863551,46.78736820346353,NaN,NaN,NaN,NaN,0.21301888447133768,13.627852221135948,490355,-0.02612940638618632,-0.05507630995549562,-0.028946903569309297
2025-09-09T11:55:00-04:00,158.81,158.81,158.62,158.62,NaN,NaN,NaN,159.08621464949258,NaN,NaN,158.73710000000068,159.6100904691415,157.86410953085985,158.424749755615,159.23768713019012,159.65386665269097,158.82150760768928,113,702.6666666666666,47.332187025769194,46.92010749127805,NaN,NaN,NaN,NaN,0.21137467843767052,12.718274855341127,490242,-0.020795511940602467,-0.05494129349506238,-0.034145781554459916
2025-09-09T12:00:00-04:00,158.63,158.73,158.6,158.73,NaN,NaN,NaN,159.08621464949258,NaN,NaN,158.7425000000007,159.61190036761658,157.8730996323848,158.424749755615,159.2302771505512,159.6484927845684,158.812061516534,268,664.3,50.34426961686356,47.222701718000586,NaN,NaN,NaN,NaN,0.20556220140640802,11.818460784017681,490510,-0.009030951545421564,-0.045434470986236875,-0.03640351944081531
2025-09-09T12:10:00-04:00,158.85,158.98,158.85,158.98,NaN,NaN,NaN,159.08621464949258,NaN,NaN,158.75150000000068,159.6212315673426,157.88176843265876,158.50521849594875,159.22694166087913,159.64393754613212,158.80994577562615,229,433.96666666666664,56.44142498536148,47.8065447245674,NaN,NaN,NaN,NaN,0.20873632987737886,11.818361709212574,490739,0.015102564288160356,-0.017525314080614862,-0.03262787836877522
2025-09-09T12:15:00-04:00,159.045,159.12,159,159.01,158.4307830635458,158.4307830635458,158.4307830635458,NaN,NaN,NaN,158.7609000000007,159.63144394444592,157.8903560555555,158.670174796759,159.22296722319297,159.63628977995663,158.8096446664293,446,352.6,57.121818515364225,48.595239372221826,NaN,NaN,NaN,NaN,0.2038265920289957,12.240818429701026,491185,0.03164927514647252,0.006933715564315435,-0.024715559582157084
2025-09-09T12:20:00-04:00,158.95,159.03,158.86,159.03,158.4307830635458,NaN,NaN,NaN,NaN,NaN,158.76970000000068,159.64204949374732,157.89735050625404,158.670174796759,159.22030618777816,159.63221840531227,158.80839397024405,222,343.3333333333333,57.597343133248984,49.46113688954272,NaN,NaN,NaN,NaN,0.20141040688406653,12.066494628965101,491407,0.041863005963553225,0.027613197872284445,-0.014249808091268778
2025-09-09T12:25:00-04:00,159.08,159.18,159.05,159.18,158.49910192360267,NaN,NaN,NaN,NaN,NaN,158.78350000000069,159.65953709922525,157.90746290077612,158.74911186992577,159.22003398104727,159.6313029535664,158.80876500852813,68,332.23333333333335,61.083274888837465,50.67982263059016,NaN,NaN,NaN,NaN,0.19773823496377646,12.369374397797275,491475,0.05577280897188415,0.05546620312358641,-0.0003066058482977408
2025-09-09T12:30:00-04:00,159.2,159.24,159.2,159.24,158.6239154725298,NaN,NaN,NaN,NaN,NaN,158.7963000000007,159.67990808008616,157.91269191991526,158.8652894959406,159.2201346468075,159.6282715314622,158.81199776215283,322,329.53333333333336,62.41432036446602,51.770845741670364,NaN,NaN,NaN,NaN,0.18789978960922116,12.830781065843869,491797,0.06539935630937907,0.08144258953842609,0.01604323322904703
2025-09-09T12:35:00-04:00,159.16,159.16,159.16,159.16,158.6239154725298,NaN,NaN,NaN,NaN,NaN,158.8053000000007,159.69435885025004,157.91624114975136,158.8652894959406,159.21985253643592,159.62705168062672,158.81265339224512,100,320.23333333333335,59.49257224326094,52.43948326161056,NaN,NaN,NaN,NaN,0.180192661779992,13.079471102852114,491697,0.06275307115786963,0.09448457217638406,0.031731501018514435
2025-09-09T12:40:00-04:00,159.18,159.21,159.18,159.21,158.6346419904662,NaN,NaN,NaN,NaN,NaN,158.8175000000007,159.71168174841216,157.92331825158925,158.913185277402,159.21984881175743,159.6270098461451,158.81268777736975,4,288.73333333333335,60.72990132595839,53.28518631070988,NaN,NaN,NaN,NaN,0.17089318593856478,13.476094791766572,491701,0.060706404360449516,0.10761450646907633,0.046908102108626816
2025-09-09T12:45:00-04:00,159.1,159.1,159.02,159.02,158.6346419904662,NaN,NaN,NaN,NaN,NaN,158.8251000000007,159.71957747830896,157.93062252169244,158.913185277402,159.21895986934211,159.62526310442556,158.81265663425867,110,278.6333333333333,53.98201267453352,53.48165923716004,NaN,NaN,NaN,NaN,0.17225795837152427,13.105516054864678,491591,0.04368825489489493,0.10151842072724548,0.05783016583235055
2025-09-09T12:50:00-04:00,158.95,158.95,158.95,158.95,158.6346419904662,NaN,NaN,NaN,NaN,NaN,158.8313000000007,159.72485651147426,157.93774348852716,158.913185277402,159.21783503717478,159.62365912255552,158.81201095179404,90,264.6666666666667,51.70268103765576,53.8103875036657,NaN,NaN,NaN,NaN,0.1649538184878455,12.456179079154419,491501,0.02573693494288634,0.09000133451095849,0.06426439956807214
2025-09-09T12:55:00-04:00,158.83,158.83,158.79,158.79,158.6346419904662,NaN,NaN,NaN,NaN,NaN,158.8365000000007,159.72599929690196,157.94700070309946,158.913185277402,159.21398044992796,159.61986778337192,158.808093116484,202,268.06666666666666,46.83486309919692,54.135619173188765,NaN,NaN,NaN,NaN,0.164599974310142,11.937468291733559,491299,0.0023395102391663147,0.06718878736703005,0.06484927712786373
2025-09-09T13:00:00-04:00,158.96,159,158.96,159,158.6346419904662,NaN,NaN,NaN,NaN,NaN,158.8487000000007,159.73006441908032,157.96733558092106,158.913185277402,159.21353135768442,159.61914315888677,158.80791955648206,43,266.1666666666667,53.07900128666161,54.82211635184386,NaN,NaN,NaN,NaN,0.16784283328798957,11.404951223302175,491342,0.000362307646479626,0.06530216168596326,0.06493985403948363
2025-09-09T13:05:00-04:00,159,159.01,159,159,158.6346419904662,NaN,NaN,NaN,NaN,NaN,158.8645000000007,159.72763440391307,158.00136559608833,158.913185277402,159.21349273431645,159.61907727547177,158.80790819316113,4,256.9,53.07900128666161,55.08819082027429,NaN,NaN,NaN,NaN,0.15656834519598967,10.949998010981941,491342,-0.0014880016526747503,0.06307985197364019,0.06456785362631494
2025-09-09T13:10:00-04:00,159.03,159.1,158.98,159.02,158.6346419904662,NaN,NaN,NaN,NaN,NaN,158.8799000000007,159.725936618126,158.0338633818754,158.913185277402,159.2085506857884,159.60961464314371,158.80748672843308,614,263.2,53.67989160130947,55.54159828995574,NaN,NaN,NaN,NaN,0.1539563205391336,10.888178601233916,491956,-0.0018820356897437107,0.0622153090141353,0.06409734470387901
2025-09-09T13:15:00-04:00,159.11,159.11,159.11,159.11,158.6346419904662,NaN,NaN,NaN,NaN,NaN,158.89590000000072,159.72837027525068,158.06342972475076,158.913185277402,159.20811235155458,159.60833711870484,158.8078875844043,100,260.3666666666667,56.386621288141825,55.973194837904195,NaN,NaN,NaN,NaN,0.14938801192919574,10.871375432979216,492056,0.003128877317330886,0.06800844135054263,0.06487956403321174
2025-09-09T13:20:00-04:00,159.19,159.24,159.19,159.24,158.71624560155928,NaN,NaN,NaN,NaN,NaN,158.9144000000007,159.73544479731387,158.09335520268755,158.94992236886995,159.20812723098578,159.60815661113296,158.8080978508386,22,257.23333333333335,60.0207130517211,56.22885827121559,NaN,NaN,NaN,NaN,0.14800315393425287,11.374664199797914,492078,0.013810401288862434,0.08214256564428979,0.06833216435542736
2025-09-09T13:25:00-04:00,159.08,159.1,159.07,159.1,158.71624560155928,NaN,NaN,NaN,NaN,NaN,158.93000000000072,159.7347558630999,158.12524413690153,158.94992236886995,159.2075006998159,159.60656006805488,158.80844133157694,120,251.86666666666667,54.731590916756346,56.05812772845788,NaN,NaN,NaN,NaN,0.14957435722466453,11.212147445132294,491958,0.01022396528911533,0.08111212096682152,0.07088815567770619
2025-09-09T13:30:00-04:00,159.06,159.06,158.98,159.01,158.71624560155928,NaN,NaN,NaN,NaN,NaN,158.94280000000072,159.7317237220241,158.15387627797733,158.94992236886995,159.2043484749693,159.60084501505304,158.80785193488555,380,209.1,51.58455779191333,55.62864306121962,NaN,NaN,NaN,NaN,0.14746190313718882,10.617362474342166,491578,0.0010502360029826519,0.0722009506814345,0.07115071467845185
2025-09-09T13:35:00-04:00,159.02,159.02,159.02,159.02,158.71624560155928,NaN,NaN,NaN,NaN,NaN,158.9572000000007,159.7246585586196,158.1897414413818,158.94992236886995,159.20355060232282,159.59937321782277,158.80772798682287,100,205.3,51.91539282222485,54.97379434217587,NaN,NaN,NaN,NaN,0.13764319577024814,10.065062144322761,491678,-0.00476522574167508,0.065194182501358,0.06995940824303308
2025-09-09T13:40:00-04:00,158.96,159,158.96,159,158.71624560155928,NaN,NaN,NaN,NaN,NaN,158.9734000000007,159.70892821781942,158.237871782182,158.94992236886995,159.20167088571395,159.59628689515202,158.80705487627588,202,206.56666666666666,51.16239600689002,54.170085459491865,NaN,NaN,NaN,NaN,0.13209725321523058,9.450040571454366,491476,-0.010074603338725327,0.05736615406962642,0.06744075740835175
2025-09-09T13:45:00-04:00,159,159.04,159,159.04,158.71624560155928,NaN,NaN,NaN,NaN,NaN,158.9906000000007,159.69046752974253,158.2907324702589,158.94992236886995,159.2013186891611,159.59561542530685,158.80702195301535,47,204.7,52.641866313380625,53.68074932164326,NaN,NaN,NaN,NaN,0.12551887798557068,8.884140845921621,491523,-0.01093642896157919,0.053770221206377755,0.06470665016795694
2025-09-09T13:50:00-04:00,159.12,159.16,159.09,159.16,158.71624560155928,NaN,NaN,NaN,NaN,NaN,158.9798000000007,159.65165105433925,158.30794894566213,158.94992236886995,159.20073707884248,159.59330372418333,158.80817043350163,212,206.86666666666667,56.863696566823506,53.40459183884792,NaN,NaN,NaN,NaN,0.12512467241517308,8.968701014173309,491735,-0.0038350974079385397,0.05991277840803377,0.06374787581597231
2025-09-09T14:00:00-04:00,159.11,159.11,159.11,159.11,158.71624560155928,NaN,NaN,NaN,NaN,NaN,158.9640000000007,159.5836773347408,158.34432266526062,158.94992236886995,159.2007293788188,159.59328025689234,158.80817850074527,2,185.06666666666666,54.67653621658309,53.45420066328003,NaN,NaN,NaN,NaN,0.11975862438551664,9.047221170407017,491733,-0.0029551386287454268,0.06005395253004053,0.06300909115878596
2025-09-09T14:05:00-04:00,159.12,159.13,159.12,159.13,158.71624560155928,NaN,NaN,NaN,NaN,NaN,158.9492000000007,159.5145860974662,158.3838139025352,158.95521221725764,159.20071681090567,159.5932355665108,158.80819805530055,4,181.86666666666667,55.41525057485855,53.71938420165166,NaN,NaN,NaN,NaN,0.11263300835797843,9.226046931685163,491737,-0.001546772843900271,0.061075625103910625,0.0626223979478109
2025-09-09T14:10:00-04:00,159.11,159.14,158.9,159.08,158.71624560155928,NaN,NaN,NaN,NaN,NaN,158.93560000000068,159.45299594048157,158.41820405951978,158.95521221725764,159.19396938291683,159.5795098571405,158.80842890869317,1033,208.6,53.08578455455408,54.165878591320016,NaN,NaN,NaN,NaN,0.12173065061812145,9.043972352366312,490704,-0.004344751705541237,0.05719145831588435,0.061536210021425584
2025-09-09T14:15:00-04:00,159.2,159.2,159.2,159.2,158.71624560155928,NaN,NaN,NaN,NaN,NaN,158.9314000000007,159.43658923108444,158.42621076891697,158.95521221725764,159.1939718328933,159.57943400418097,158.80850966160565,10,208.6,57.68341075900367,54.494764982201595,NaN,NaN,NaN,NaN,0.12160703271682537,8.52595642401089,490714,0.001226394191181715,0.06306920276040273,0.06184280856922102
2025-09-09T14:20:00-04:00,159.25,159.25,159.1,159.1,158.7528226078315,NaN,NaN,NaN,NaN,NaN,158.9236000000007,159.40555866960878,158.44164133039263,158.96070865523592,159.19328600946486,159.5757691732806,158.8108028456491,390,218.23333333333332,53.020308995551936,54.49057267569377,NaN,NaN,NaN,NaN,0.12363510180848111,8.577741143406467,490324,-0.002291584564542981,0.05897832786354229,0.06126991242808527
2025-09-09T14:25:00-04:00,159.16,159.22,159.16,159.22,158.77064885293004,NaN,NaN,NaN,NaN,NaN,158.9304000000007,159.4192510603598,158.4415489396416,158.96070865523592,159.19331541575428,159.5749603079744,158.81167052353416,110,217.4,57.46402488167034,54.76086791000525,NaN,NaN,NaN,NaN,0.12337545167930421,8.625826954273787,490434,0.0027230767173954465,0.06467375832482958,0.06195068160743413
2025-09-09T14:30:00-04:00,159.16,159.16,159.16,159.16,158.77064885293004,NaN,NaN,NaN,NaN,NaN,158.9336000000007,159.42631103014122,158.44088896986017,158.96070865523592,159.1933127629362,159.57494257596605,158.81168294990633,2,185.63333333333333,54.67910800537917,54.63890267552221,NaN,NaN,NaN,NaN,0.11884863370221121,8.67047806436487,490432,0.0013295687096450959,0.0636126424944905,0.062283073784845405
2025-09-09T14:35:00-04:00,159.12,159.14,159.12,159.14,158.77064885293004,NaN,NaN,NaN,NaN,NaN,158.93060000000068,159.41637212685208,158.44482787314928,158.96070865523592,159.1932960515842,159.5748740094722,158.81171809369621,7,182.1,53.7441103912164,54.19057391405759,NaN,NaN,NaN,NaN,0.11321658843776698,8.948912086830365,490425,-0.0014577294728992177,0.060460911943721385,0.0619186414166206
2025-09-09T14:40:00-04:00,159.08,159.08,159.08,159.08,158.77064885293004,NaN,NaN,NaN,NaN,NaN,158.9262000000007,159.4023997891616,158.45000021083982,158.96070865523592,159.1928468918491,159.57373426274268,158.8119595209555,100,176.5,50.93044474399434,53.91906347314601,NaN,NaN,NaN,NaN,0.10941540354935318,9.44401587841656,490325,-0.007521897650652656,0.05251626935330478,0.060038167003957435
2025-09-09T14:45:00-04:00,159.23,159.35,159.23,159.35,158.8851375826732,NaN,NaN,NaN,NaN,NaN,158.92980000000068,159.41593561814597,158.4436643818554,159.0434690121477,159.19604103196951,159.5721843077767,158.81989775616233,707,192.43333333333334,60.86054404378185,54.58163391970805,NaN,NaN,NaN,NaN,0.12088573186725524,9.422188828568672,491032,0.00575492224464428,0.06723181980976278,0.0614768975651185
2025-09-09T14:50:00-04:00,159.49,159.59,159.46,159.57,159.10581314709714,NaN,NaN,NaN,NaN,NaN,158.93800000000067,159.4524006213465,158.42359937865484,159.2247752097182,159.21673516726474,159.59044781575204,158.84302251877745,1660,232.9,66.76270145187507,55.642155964683056,NaN,NaN,NaN,NaN,0.12939389387673766,10.513525935857794,492692,0.027254306106348408,0.09554478019805401,0.0682904740917056
2025-09-09T15:00:00-04:00,159.5,159.58,159.5,159.54,159.1289580040473,NaN,NaN,NaN,NaN,NaN,158.9568000000007,159.48882165296405,158.42477834703735,159.24782016777453,159.2203497831775,159.59351854161858,158.84718102473644,312,235.9,65.31626094390204,56.65314631732677,NaN,NaN,NaN,NaN,0.1258657585998287,11.526910392626268,492380,0.036763866505559434,0.11424530722365489,0.07748144071809546
2025-09-09T15:05:00-04:00,159.51,159.53,159.47,159.47,159.1289580040473,NaN,NaN,NaN,NaN,NaN,158.9774000000007,159.5075442815032,158.4472557184982,159.24782016777453,159.22699489653252,159.59790040794726,158.85608938511777,705,257.1333333333333,61.94395422069283,57.31758116784908,NaN,NaN,NaN,NaN,0.12187534727126903,12.252102283475606,491675,0.03562343212899466,0.12201073087933878,0.08638729875034412
2025-09-09T15:10:00-04:00,159.44,159.45,159.42,159.42,159.1289580040473,NaN,NaN,NaN,NaN,NaN,158.99340000000072,159.52770493093067,158.45909506907077,159.24782016777453,159.22773726186753,159.59816670312537,158.8573078206097,105,249.9,59.57778000725862,57.51144427073729,NaN,NaN,NaN,NaN,0.11674139389475062,12.56328344593788,491570,0.029062731074823225,0.12271571259387315,0.09365298151904992
2025-09-09T15:20:00-04:00,159.47,159.61,159.47,159.58,159.141385243753,NaN,NaN,NaN,NaN,NaN,159.0120000000007,159.5617199279663,158.46228007203513,159.30252392590057,159.22966486636207,159.59983984314053,158.8594898895836,171,252.26666666666668,64.2799135086801,58.19739979160134,NaN,NaN,NaN,NaN,0.12197415147369886,13.600267748922063,491741,0.03278410422424806,0.13463311179936,0.10184900757511194
2025-09-09T15:25:00-04:00,159.6,159.6,159.53,159.6,159.1749586417642,NaN,NaN,NaN,NaN,NaN,159.0290000000007,159.59751033342874,158.46048966657267,159.31901914072043,159.31443386271079,159.66909400172364,158.95977372369794,9337,563.3666666666667,64.83063748789502,58.8699274282468,NaN,NaN,NaN,NaN,0.11826171208271988,14.56318174455023,501078,0.03374580721829244,0.1440312665979775,0.11028545937968505
2025-09-09T15:30:00-04:00,159.59,159.68,159.59,159.64,159.25041506713853,NaN,NaN,NaN,NaN,NaN,159.0490000000007,159.63154956805715,158.46645043194422,159.41021531257636,159.32898054695053,159.6819413351968,158.97601975870427,1807,619.9333333333333,65.96098793557249,59.789584812605256,NaN,NaN,NaN,NaN,0.11624301836252585,15.810865474079986,502885,0.03412682811816453,0.15294399452739071,0.11881716640922618
2025-09-09T15:35:00-04:00,159.66,159.66,159.52,159.52,159.25041506713853,NaN,NaN,NaN,NaN,NaN,159.0672000000007,159.65061120937762,158.48378879062378,159.41021531257636,159.33681307176917,159.68649334785832,158.98713279568003,1364,662.4,59.75606303920813,59.93763140404843,NaN,NaN,NaN,NaN,0.11793994562234446,16.402470946572542,501521,0.02383530683066773,0.14861129994756084,0.12477599311689311
2025-09-09T15:40:00-04:00,159.51,159.58,159.44,159.58,159.25041506713853,NaN,NaN,NaN,NaN,NaN,159.08800000000068,159.6688958592223,158.50710414077906,159.41021531257636,159.3557076827893,159.6931630169616,159.018252348617,4403,802.4333333333333,61.69625755967541,60.55734201577154,NaN,NaN,NaN,NaN,0.11951566379217805,16.341157947667302,505924,0.018826795414968095,0.14830948738560323,0.12948269197063514
2025-09-09T15:45:00-04:00,159.68,159.87,159.68,159.86,159.3653473832429,NaN,NaN,NaN,NaN,NaN,159.1120000000007,159.71876189663922,158.5052381033622,159.4860702400391,159.3723376505054,159.71411664044558,159.0305586605652,1767,859.9,69.16683794903781,61.39325723486922,NaN,NaN,NaN,NaN,0.13169311637845046,17.562809775820455,507691,0.03138910264746195,0.16871907027996258,0.13732996763250063
2025-09-09T15:50:00-04:00,159.93,159.93,159.77,159.77,159.43714977491368,NaN,NaN,NaN,NaN,NaN,159.13180000000068,159.75822720186852,158.50537279813284,159.54285619203128,159.39972497054202,159.74803626304768,159.05141367803637,3075,962.2666666666667,64.79254999275025,62.115645948252855,NaN,NaN,NaN,NaN,0.13371503663713233,18.91158025626429,504616,0.03062184397512835,0.17560727260141107,0.14498542862628272
2025-09-09T15:55:00-04:00,159.89,159.97,159.74,159.74,159.43714977491368,NaN,NaN,NaN,NaN,NaN,159.1520000000007,159.79032280174724,158.51367719825416,159.545284953625,159.45402428760377,159.80787750140632,159.10017107380122,7582,1194.5333333333333,63.35425274753056,62.802084687989584,NaN,NaN,NaN,NaN,0.1405925340201936,20.30637365873627,497034,0.025299359050156317,0.17660962743897812,0.1513102683888218
2025-09-10T09:30:00-04:00,161.73,161.97,161.2,161.44,160.8747996916052,NaN,NaN,NaN,NaN,NaN,159.2044000000007,160.10242592345986,158.30637407654154,160.5152279629,161.53666666666666,161.53666666666666,161.53666666666666,4408,1338.1333333333334,84.43704208477993,65.1954130694743,NaN,NaN,NaN,NaN,0.28983592444732187,24.36328630147661,501442,0.12774765606197114,0.31099483846628573,0.1832471824043146
2025-09-10T09:35:00-04:00,161.605,161.62,160.95,160.95,160.8747996916052,NaN,NaN,NaN,NaN,NaN,159.2502000000007,160.25921924621147,158.2411807537899,160.5152279629,161.32929529003147,161.50913423371762,161.14945634634532,5861,1532.7666666666667,71.64294206722226,65.9655843568629,NaN,NaN,NaN,NaN,0.3169905012725143,27.144256625020187,495581,0.15232223579804502,0.37364997715187087,0.22132774135382585
2025-09-10T09:40:00-04:00,160.95,161.55,160.95,161.55,160.8747996916052,NaN,NaN,NaN,NaN,NaN,159.3122000000007,160.48465240382458,158.13974759617682,160.5152279629,161.331263952532,161.5024473549377,161.1600805501263,1079,1564.7333333333333,76.36537047905608,66.65148928737584,NaN,NaN,NaN,NaN,0.3372054654673363,29.72658621116779,496660,0.1960129185072042,0.4663438894878311,0.2703309709806269
2025-09-10T09:45:00-04:00,161.76,162.25,161.71,162.23,161.10550948008603,NaN,NaN,NaN,NaN,NaN,159.3870000000007,160.79386459874848,157.98013540125294,160.7007567170048,161.40037560184075,161.6693652163375,161.131385987344,1183,1591.5,80.35779563692799,67.72588462259198,NaN,NaN,NaN,NaN,0.3631193607910972,32.65406592044342,497843,0.25405352645121587,0.5878978790446467,0.33384435259343087
2025-09-10T09:50:00-04:00,162.16,162.16,161.49,161.59,161.10550948008603,NaN,NaN,NaN,NaN,NaN,159.4448000000007,160.9667736657431,157.9228263342583,160.7007567170048,161.43823157296183,161.71413327227322,161.16232987365044,1538,1639.4333333333334,68.61058279543693,68.20207237793083,NaN,NaN,NaN,NaN,0.39003940644887464,34.5920791291327,496305,0.23322744933633432,0.6253786642638488,0.3921512149275145
2025-09-10T09:55:00-04:00,161.51,161.92,161.41,161.9,161.10550948008603,NaN,NaN,NaN,NaN,NaN,159.5104000000007,161.16176530157304,157.85903469842833,160.7007567170048,161.44754524990813,161.7242271878465,161.17086331196975,443,1647.4666666666667,70.83461437262623,69.00613197545711,NaN,NaN,NaN,NaN,0.39860802027395437,36.112617660353166,496748,0.22415620739665887,0.672346474173338,0.44819026677667917
2025-09-10T10:00:00-04:00,161.87,162,161.86,162,161.10550948008603,NaN,NaN,NaN,NaN,NaN,159.5758000000007,161.35260202589672,157.79899797410468,160.7007567170048,161.45306093238824,161.73319914752813,161.17292271724835,160,1651.2333333333333,71.53524345425953,69.52436982871278,NaN,NaN,NaN,NaN,0.38013601882581377,37.60539481899375,496908,0.20901559116729096,0.7094597557357929,0.5004441645685019
2025-09-10T10:05:00-04:00,161.82,161.82,161.76,161.76,161.10550948008603,NaN,NaN,NaN,NaN,NaN,159.63140000000067,161.5016727499588,157.76112725004253,160.7007567170048,161.45745763851534,161.7382425599931,161.17667271703758,200,1650.8333333333333,67.35332643061304,69.70456189604978,NaN,NaN,NaN,NaN,0.37012630319539913,38.61716393045761,496708,0.16869011032806958,0.7113068024785889,0.5426166921505193
2025-09-10T10:10:00-04:00,161.35,161.35,161.17,161.17,161.10550948008603,NaN,NaN,NaN,NaN,NaN,159.67460000000065,161.58482180892258,157.76437819107872,160.7007567170048,161.45246152834406,161.73213971657464,161.17278334011348,334,1661.9,58.326290667801125,69.15922637692326,NaN,NaN,NaN,NaN,0.3858315672528709,37.659669774525156,496374,0.09197251138350393,0.6575823313798992,0.5656098199963953
2025-09-10T10:15:00-04:00,161.17,161.345,161.17,161.345,161.10550948008603,NaN,NaN,NaN,NaN,NaN,159.72090000000068,161.6780281918255,157.76377180817587,160.7007567170048,161.4443818162861,161.71948593741143,161.16927769516076,779,1687.7333333333333,60.037146161311945,69.17930374278781,NaN,NaN,NaN,NaN,0.3707721695919523,36.77056805830216,497153,0.04507759001240941,0.6219568075119071,0.5768792174994977
2025-09-10T10:20:00-04:00,161.45,161.45,161.45,161.45,161.10550948008603,NaN,NaN,NaN,NaN,NaN,159.76630000000065,161.77574849131855,157.75685150868276,160.7007567170048,161.44441674437883,161.71866473041126,161.1701687583464,100,1656.6333333333334,61.069843953790816,69.13455991379605,NaN,NaN,NaN,NaN,0.3517884431925264,36.131185676541996,497253,0.014763277038455924,0.5953333137975676,0.5805700367591117
2025-09-10T10:25:00-04:00,161.4,161.48,161.4,161.48,161.10550948008603,NaN,NaN,NaN,NaN,NaN,159.81110000000066,161.87086628753408,157.75133371246724,160.7145091640464,161.4447399640503,161.7139765853618,161.17550334273884,605,1676.4666666666667,61.37694410177319,68.57813892470573,NaN,NaN,NaN,NaN,0.33237498296448764,35.37713268736922,497858,-0.008389478714854182,0.570083188365544,0.5784726670803981
2025-09-10T10:30:00-04:00,161.5,161.67,161.39,161.49,161.10550948008603,NaN,NaN,NaN,NaN,NaN,159.85770000000065,161.96139504426813,157.75400495573317,160.91760733123712,161.44660791751775,161.71257160853273,161.18064422650278,445,1678.3,61.48600670515089,68.34195726130577,NaN,NaN,NaN,NaN,0.3286339127527386,35.033388744846135,498303,-0.027097035387300017,0.5446013728462731,0.5716984082335731
2025-09-10T10:35:00-04:00,161.48,161.56,161.48,161.55,161.10550948008603,NaN,NaN,NaN,NaN,NaN,159.90450000000067,162.0521314859024,157.75686851409893,160.9180858649897,161.4472885312958,161.71227089705417,161.18230616553745,141,1679.3333333333333,62.17613692361034,68.25780613102576,NaN,NaN,NaN,NaN,0.31087434755611537,34.714197941074694,498444,-0.038785103544455746,0.5232170288030034,0.5620021323474591
2025-09-10T10:40:00-04:00,161.53,161.57,161.53,161.53,161.10550948008603,NaN,NaN,NaN,NaN,NaN,159.95470000000066,162.13438659198098,157.77501340802033,161.03646869199176,161.44842027990694,161.71204061730856,161.18479994250532,206,1686.1333333333334,61.778748666324574,66.63935660113609,NaN,NaN,NaN,NaN,0.2915261798735352,34.43802253346041,498238,-0.05047779845292566,0.498904884281302,0.5493826827342276
2025-09-10T10:45:00-04:00,161.47,161.51,161.42,161.51,161.10550948008603,NaN,NaN,NaN,NaN,NaN,160.00590000000068,162.20892309548174,157.80287690451962,161.03646869199176,161.4487066848052,161.7111459539449,161.18626741566547,160,1691.2333333333333,61.35643407299816,65.90460603012008,NaN,NaN,NaN,NaN,0.2785600241682836,33.75106719392871,498078,-0.061445393817798566,0.47257594046197937,0.5340213342797779
2025-09-10T10:55:00-04:00,161.16,161.16,161.11,161.13,161.10550948008603,NaN,NaN,NaN,NaN,NaN,160.05270000000067,162.24982649596072,157.85557350404062,161.03646869199176,161.44362370568658,161.7069514443103,161.18029596706285,289,1697.5333333333333,53.827409031741475,64.29475164102618,NaN,NaN,NaN,NaN,0.2872343081562617,32.01966032835335,497789,-0.09421788385689622,0.4162489794586577,0.5104668633155539
2025-09-10T11:00:00-04:00,161.26,161.34,161.13,161.13,161.10550948008603,NaN,NaN,NaN,NaN,NaN,160.09530000000066,162.29172838245816,157.89887161754316,161.03646869199176,161.44182997490404,161.7050119165759,161.17864803323218,133,1678.4,53.82740903174146,62.39972402637,NaN,NaN,NaN,NaN,0.28171757185938645,30.872327430346978,497789,-0.11447381749861496,0.36737459144228524,0.4818484089409002
2025-09-10T11:05:00-04:00,161.18,161.29,161.18,161.21,161.10550948008603,NaN,NaN,NaN,NaN,NaN,160.13950000000065,162.33493002604834,157.94406997395296,161.03646869199176,161.43911323676775,161.70172955735944,161.17649691617606,231,1630.7666666666667,55.17053859578506,61.439720869252014,NaN,NaN,NaN,NaN,0.2730234595837157,29.806946882198197,498020,-0.12045644447244552,0.3312778533503433,0.45173429782278884
2025-09-10T11:10:00-04:00,161.27,161.27,161.17,161.22,161.10550948008603,NaN,NaN,NaN,NaN,NaN,160.18350000000066,162.3756005905894,157.9913994094119,161.03646869199176,161.43659156400832,161.6987361649611,161.17444696305554,213,1627.4666666666667,55.345400241115776,60.33334843128698,NaN,NaN,NaN,NaN,0.26066464104202336,28.779825180210555,498233,-0.12137191201941855,0.30001940779851566,0.4213913198179342
2025-09-10T11:15:00-04:00,161.28,161.37,160.81,160.81,NaN,NaN,NaN,161.90309678521783,161.90309678521783,161.90309678521783,160.21750000000065,162.39462861339868,158.04037138660263,161.03646869199176,161.40645729528407,161.68279281354702,161.13012177702112,1361,1649.3333333333333,47.21391954916652,58.59611100949462,NaN,NaN,NaN,NaN,0.2820457381104504,26.862761981566173,496872,-0.1455901795481669,0.2394035953827256,0.3849937749308925
2025-09-10T11:20:00-04:00,160.83,160.85,160.75,160.79,NaN,NaN,NaN,161.58977420407157,NaN,NaN,160.24850000000063,162.41317665005596,158.0838233499453,161.03646869199176,161.3663187424577,161.67323886137478,161.05939862354063,1400,1692.5,46.85230170214585,57.13175210031839,NaN,NaN,NaN,NaN,0.2690424711025607,25.266821724963297,495472,-0.1579239106946616,0.18758888656256545,0.34551279725722706
2025-09-10T11:25:00-04:00,160.79,161.02,160.77,161.02,NaN,NaN,NaN,161.58977420407157,NaN,NaN,160.28690000000066,162.4367882666896,158.1370117333117,161.03646869199176,161.3500695167006,161.6620868887635,161.03805214463767,836,1714.6666666666667,51.456881434827174,56.64108001224882,NaN,NaN,NaN,NaN,0.2676822945952349,23.693766836503496,496308,-0.14584773361963127,0.16320313023268795,0.3090508638523192
2025-09-10T11:30:00-04:00,160.94,160.94,160.91,160.91,NaN,NaN,NaN,161.58977420407157,NaN,NaN,160.32490000000064,162.45019197036015,158.19960802964113,161.03646869199176,161.3479592449206,161.66065757966257,161.0352609101786,109,1407.0666666666666,49.25882365032936,55.87119983289291,NaN,NaN,NaN,NaN,0.2564192735527191,22.233073011505113,496199,-0.14047054133823073,0.1334626871795308,0.27393322851776153
2025-09-10T11:35:00-04:00,160.81,160.86,160.81,160.81,NaN,NaN,NaN,161.58091556197473,NaN,NaN,160.36070000000066,162.4569690760575,158.26443092394382,161.0281749535934,161.3321666375647,161.65279282076074,161.01154045436869,694,1369.9666666666667,47.28149507638724,54.88631777022123,NaN,NaN,NaN,NaN,0.24524646829895305,20.76895677144362,495505,-0.13861568683316744,0.10066361997630224,0.23927930680946968
2025-09-10T11:40:00-04:00,160.98,161.01,160.9,160.9,NaN,NaN,NaN,161.58091556197473,NaN,NaN,160.39870000000064,162.46357656756012,158.33382343244116,160.78904446099187,161.31713587816174,161.64057519124734,160.99369656507614,905,1354.6666666666667,49.255774534896794,54.02051994401577,NaN,NaN,NaN,NaN,0.24201457770616988,19.68673977191237,496410,-0.12662451063072636,0.08099866852106175,0.2076231791517881
2025-09-10T11:45:00-04:00,160.9,160.97,160.81,160.88,NaN,NaN,NaN,161.58091556197473,NaN,NaN,160.43550000000067,162.46752977321458,158.40347022678677,160.78904446099187,161.30561236444876,161.63217057022783,160.9790541586697,655,1229.7333333333333,48.81825248977129,53.11568035720294,NaN,NaN,NaN,NaN,0.23615639358430035,18.34520732268779,495755,-0.11564002177928476,0.06307315192768215,0.1787131737069669
2025-09-10T11:50:00-04:00,160.9,161.03,160.9,160.95,NaN,NaN,NaN,161.58091556197473,NaN,NaN,160.47130000000067,162.47505728051786,158.46754271948348,160.78904446099187,161.3023384071465,161.6290659216224,160.97561089267057,234,1178.6333333333334,50.476342958670614,52.27998078827867,NaN,NaN,NaN,NaN,0.23000236547113645,17.319207524357534,495989,-0.09985517336847333,0.05389420699637526,0.1537493803648486
2025-09-10T11:55:00-04:00,160.78,160.83,160.71,160.71,NaN,NaN,NaN,161.4851164726129,NaN,NaN,160.50330000000065,162.46983360999735,158.53676639000395,160.78904446099187,161.284090007568,161.62020051672744,160.94797949840859,844,1104.2666666666667,45.08360149301211,51.08747027589921,NaN,NaN,NaN,NaN,0.23071648222319677,16.508701971708067,495145,-0.1014449060659261,0.02694324778244095,0.12838815384836705
2025-09-10T12:00:00-04:00,160.61,160.63,160.43,160.49,NaN,NaN,NaN,161.25079299658503,NaN,NaN,160.53050000000064,162.4575269845729,158.6034730154284,160.70523556879348,161.23737090410015,161.61122052599103,160.86352128220926,1656,906.7333333333333,40.78239254364214,49.617895880945206,NaN,NaN,NaN,NaN,0.2342367334929685,16.6418391262426,493489,-0.11233378644811079,-0.012029079211771432,0.10030470723633936
2025-09-10T12:05:00-04:00,160.53,160.61,160.47,160.54,NaN,NaN,NaN,161.24712058764936,NaN,NaN,160.55970000000065,162.44164411162149,158.6777558883798,160.58539359435665,161.2067328600215,161.59922567414287,160.81424004590014,1250,801.4666666666667,42.133625468615854,48.78262562643624,NaN,NaN,NaN,NaN,0.2275055382434718,16.765466484024664,494739,-0.11099357868910656,-0.038437266125043834,0.07255631256406272
2025-09-10T12:10:00-04:00,160.61,160.7,160.55,160.55,NaN,NaN,NaN,161.24712058764936,NaN,NaN,160.58670000000063,162.42814031650923,158.74525968349204,160.58539359435665,161.17977374755102,161.58330296046034,160.7762445346417,1323,650.2,42.41662852782589,47.96756987615656,NaN,NaN,NaN,NaN,0.22268371408322357,16.484061425647393,496062,-0.10435840104052156,-0.05789168873658923,0.04646671230393233
2025-09-10T12:15:00-04:00,160.6,160.72,160.6,160.61,NaN,NaN,NaN,161.24712058764936,NaN,NaN,160.61690000000064,162.40867999744984,158.82512000255144,160.58539359435665,161.1653279518938,161.57274843471615,160.75790746907145,824,641.7,44.180577939893624,47.18257268645004,NaN,NaN,NaN,NaN,0.2189205916487067,16.13338447239733,496886,-0.09132352872580357,-0.06768769860332213,0.023635830122481438
2025-09-10T12:20:00-04:00,160.45,160.45,160.43,160.43,NaN,NaN,NaN,161.12156496639938,NaN,NaN,160.64110000000065,162.38890466850324,158.89329533149805,160.58539359435665,161.1600794912559,161.57067982841318,160.74947915409865,222,609.6666666666666,40.20187692470671,46.10089244956367,NaN,NaN,NaN,NaN,0.21614054938808527,16.38983900462243,496664,-0.09006885584432918,-0.08895023968293003,0.0011186161613991434
2025-09-10T12:25:00-04:00,160.39,160.45,160.39,160.45,NaN,NaN,NaN,161.07876655883575,NaN,NaN,160.66690000000065,162.36383475397122,158.96996524603009,160.58539359435665,161.15823651250847,161.56995143070068,160.74652159431625,78,561,40.83938365758634,45.645568457307945,NaN,NaN,NaN,NaN,0.2049876530032222,16.75882288561727,496742,-0.08329473786785112,-0.10299980617341475,-0.01970506830556364
2025-09-10T12:30:00-04:00,160.53,160.53,160.53,160.53,NaN,NaN,NaN,161.07876655883575,NaN,NaN,160.69470000000067,162.33527357019162,159.0541264298097,160.58539359435665,161.1581958512669,161.56992846594082,160.74646323659297,2,546.3,43.43699614290454,45.40161806021928,NaN,NaN,NaN,NaN,0.19605996350299293,16.69469786976275,496744,-0.06939734370783296,-0.10645174794035484,-0.037054404232521876
2025-09-10T12:35:00-04:00,160.56,160.7,160.56,160.685,NaN,NaN,NaN,161.07876655883575,NaN,NaN,160.72680000000065,162.30121641227282,159.15238358772848,160.58539359435665,161.15485195306215,161.5672906550274,160.7424132510969,204,547.7666666666667,48.184123834542966,45.167849660198975,NaN,NaN,NaN,NaN,0.19419853753849253,15.833830260148979,496948,-0.0468192470326803,-0.09557846302337225,-0.048759215990691954
2025-09-10T12:40:00-04:00,160.61,160.61,160.61,160.61,NaN,NaN,NaN,161.07876655883575,NaN,NaN,160.75200000000066,162.2770219668022,159.22697803319912,160.35431487548533,161.15481692223608,161.56726550261496,160.7423683418572,2,541.1666666666666,46.165166668792466,44.946874161517776,NaN,NaN,NaN,NaN,0.18568435628574226,15.03445319407905,496946,-0.03455518747397871,-0.09195320033316534,-0.05739801285918663
2025-09-10T12:45:00-04:00,160.41,160.41,160.41,160.41,NaN,NaN,NaN,161.07876655883575,NaN,NaN,160.76880000000065,162.25948784097707,159.27811215902423,160.3291726711803,161.14303445439293,161.562629149215,160.72343975957085,500,546.7,41.20673065440618,44.512962417090556,NaN,NaN,NaN,NaN,0.18670690226533332,15.08702412346051,496446,-0.037297118546389674,-0.10401941104217372,-0.06672229249578404
2025-09-10T12:50:00-04:00,160.39,160.61,160.39,160.56,NaN,NaN,NaN,161.07876655883575,NaN,NaN,160.78920000000068,162.23943358091208,159.33896641908927,160.3291726711803,161.1343269380751,161.55734982518646,160.71130405096375,448,535.6666666666666,45.89998049354528,44.27326284270831,NaN,NaN,NaN,NaN,0.18908498067495433,14.21263025263409,496894,-0.026879587260610863,-0.10032177657154762,-0.07344218931093675
2025-09-10T12:55:00-04:00,160.61,160.81,160.61,160.81,NaN,NaN,NaN,161.07876655883575,NaN,NaN,160.81600000000068,162.21639851442112,159.41560148558025,160.36190912611545,161.12660295811537,161.5489460061013,160.70425991012945,646,553.8666666666667,52.679908356479935,44.54909540461607,NaN,NaN,NaN,NaN,0.19343605348388615,13.78262543386842,497540,-0.0023170337157025905,-0.07633848145556499,-0.0740214477398624
2025-09-10T13:00:00-04:00,160.72,161,160.71,160.87,NaN,NaN,NaN,161.07876655883575,NaN,NaN,160.84500000000068,162.18741573262906,159.5025842673723,160.49652730089235,161.11064495107755,161.5250077913873,160.69628211076778,2082,603.1,54.16456138354012,44.812539577821035,NaN,NaN,NaN,NaN,0.20033347823503656,14.03214883844328,499622,0.0177036609652612,-0.051891871533285894,-0.0695955324985471
2025-09-10T13:05:00-04:00,160.95,160.95,160.73,160.73,NaN,NaN,NaN,161.07876655883575,NaN,NaN,160.86800000000068,162.16144655831332,159.57455344168804,160.49652730089235,161.10009124560423,161.51110468834946,160.689077802859,1237,629.5,50.20634555978551,45.178449868304845,NaN,NaN,NaN,NaN,0.20173822978967673,14.263849142691368,498385,0.021024205614941838,-0.0433152754798698,-0.06433948109481163
2025-09-10T13:10:00-04:00,160.63,160.75,160.63,160.75,NaN,NaN,NaN,161.07876655883575,NaN,NaN,160.89100000000067,162.1333268487871,159.64867315121424,160.49652730089235,161.09310348901667,161.50369206857897,160.68251490945437,657,646.7,50.759937147425276,45.89113162571793,NaN,NaN,NaN,NaN,0.19589978480470016,14.001909767457008,499042,0.023866259116726372,-0.03450665719890367,-0.05837291631563004
2025-09-10T13:15:00-04:00,160.71,160.77,160.61,160.61,NaN,NaN,NaN,161.07876655883575,NaN,NaN,160.9104000000007,162.1032903382957,159.7175096617057,160.49652730089235,161.07958663427337,161.4905699106673,160.66860335787945,1191,679.5333333333333,46.83469961000283,46.226922635817004,NaN,NaN,NaN,NaN,0.19333551446150704,13.758680347596531,497851,0.015994196253049715,-0.0383801709993179,-0.05437436725236761
2025-09-10T13:20:00-04:00,160.57,160.65,160.5,160.57,NaN,NaN,NaN,161.07876655883575,NaN,NaN,160.93140000000068,162.0609291759024,159.80187082409896,160.49652730089235,161.061860931315,161.47617085570124,160.64755100692878,1374,720,45.746228756789165,46.464751223600096,NaN,NaN,NaN,NaN,0.1902401205713998,12.997725476296578,496477,0.008164711734959924,-0.04416847758366771,-0.05233318931862763
2025-09-10T13:25:00-04:00,160.3,160.31,160.27,160.28,NaN,NaN,NaN,160.91182105126353,NaN,NaN,160.9454000000007,162.02377626050318,159.8670237394982,160.49652730089235,161.05634946739866,161.47429010754095,160.63840882725637,281,719.7333333333333,38.7202078890357,46.07472479139596,NaN,NaN,NaN,NaN,0.19808011195915573,12.822144940388528,496196,-0.015200675969006552,-0.07133403427988583,-0.056133358310879275
2025-09-10T13:30:00-04:00,160.33,160.41,160.31,160.41,NaN,NaN,NaN,160.91182105126353,NaN,NaN,160.95640000000068,162.0009554840372,159.91184451596416,160.49652730089235,161.0482946220966,161.47021190228153,160.62637734191165,474,731.1,42.95018861655599,46.2710327693852,NaN,NaN,NaN,NaN,0.1932172468192157,12.198397477436632,496670,-0.020240750357749984,-0.08143429625806675,-0.06119354590031677
2025-09-10T13:35:00-04:00,160.49,160.55,160.46,160.46,NaN,NaN,NaN,160.91182105126353,NaN,NaN,160.9702000000007,161.96892110181497,159.9714788981864,160.49652730089235,161.0439183389973,161.46705295306887,160.6207837249257,316,733.9333333333333,44.53597194459831,46.53507478988605,NaN,NaN,NaN,NaN,0.18941601490355847,11.636151685499408,496986,-0.018589944694081956,-0.08443097676791922,-0.06584103207383726
2025-09-10T13:40:00-04:00,160.455,160.47,160.44,160.46,NaN,NaN,NaN,160.91182105126353,NaN,NaN,160.9846000000007,161.93136679239407,160.03783320760735,160.49652730089235,161.0413223188119,161.46531429719968,160.6173303404241,179,732.8,44.535971944598316,46.61357306143561,NaN,NaN,NaN,NaN,0.17802915669616154,11.022503985084697,496986,-0.01598047594476129,-0.08581662700478887,-0.06983615106002758
2025-09-10T13:45:00-04:00,160.39,160.6,160.36,160.6,NaN,NaN,NaN,160.91182105126353,NaN,NaN,160.9678000000007,161.9114528170946,160.02414718290677,160.49652730089235,161.02972842666145,161.45596894119245,160.60348791213045,921,718.1333333333333,49.12791574371687,46.68098676923375,NaN,NaN,NaN,NaN,0.1824556455035772,11.001160335550622,497907,-0.003936032737854256,-0.0747561919823454,-0.07082015924449114
2025-09-10T13:50:00-04:00,160.49,160.49,160.385,160.385,NaN,NaN,NaN,160.91182105126353,NaN,NaN,160.95650000000072,161.91416225736998,159.99883774263145,160.43722184071387,161.02679795576697,161.45409877090177,160.59949714063217,200,678.1333333333333,43.21124928689189,46.46999267052656,NaN,NaN,NaN,NaN,0.18478024225332196,10.981341232411841,497707,-0.009255619582642982,-0.08238968372279487,-0.07313406414015189
2025-09-10T13:55:00-04:00,160.305,160.38,160.305,160.38,NaN,NaN,NaN,160.91182105126353,NaN,NaN,160.9331000000007,161.888785910332,159.97741408966942,160.3138219780569,161.0192319085069,161.44999314509613,160.58847067191766,474,666.0666666666667,43.08130600360569,46.603890909755094,NaN,NaN,NaN,NaN,0.1772959392352264,10.539819193058717,497233,-0.011756977703098317,-0.08783028626902478,-0.07607330856592646
2025-09-10T14:00:00-04:00,160.31,160.42,160.31,160.42,NaN,NaN,NaN,160.91182105126353,NaN,NaN,160.8969000000007,161.7883031406819,160.0054968593195,160.3138219780569,161.01461210048348,161.44718991936776,160.5820342815992,308,672.7,44.518708019736536,46.505228590197326,NaN,NaN,NaN,NaN,0.17248908643270916,10.320239702796034,497541,-0.009462207929184674,-0.08790106847740731,-0.07843886054822263
2025-09-10T14:05:00-04:00,160.4,160.4,160.27,160.27,NaN,NaN,NaN,160.8914520706005,NaN,NaN,160.8705000000007,161.756401235584,159.9845987644174,160.2100575824455,160.9861718001523,161.43189651019233,160.54044709011228,1792,709.3,40.39862594010272,45.62799413188467,NaN,NaN,NaN,NaN,0.17088272311608546,9.891649010581038,495749,-0.016385403570446447,-0.09892061501128069,-0.08253521144083424
2025-09-10T14:10:00-04:00,160.265,160.29,160.18,160.18,NaN,NaN,NaN,160.78115879466412,NaN,NaN,160.8361000000007,161.69251179300795,159.97968820699344,160.18431966861576,160.9670169553863,161.4231945200898,160.5108393906828,1128,716.7333333333333,38.119113127905855,44.48189068505365,NaN,NaN,NaN,NaN,0.16653395717922118,9.37004641283406,494621,-0.024856910518503,-0.11360634958896298,-0.08874943907045998
2025-09-10T14:15:00-04:00,160.15,160.15,160,160.02,NaN,NaN,NaN,160.62087884945208,NaN,NaN,160.79650000000072,161.61630302462353,159.9766969753779,160.18431966861576,160.93516497011507,161.41349415104062,160.4568357891895,1643,749.6666666666666,34.402652556932026,43.353055470564115,NaN,NaN,NaN,NaN,0.16749581738070587,9.754340351750928,492978,-0.038265361145336366,-0.13658114050213044,-0.09831577935679407
2025-09-10T14:20:00-04:00,159.865,159.93,159.86,159.92,NaN,NaN,NaN,160.4378843562952,NaN,NaN,160.75970000000072,161.568312168589,159.95108783141245,160.18431966861576,160.9260179126739,161.41194495178203,160.44009087356577,420,755.8666666666667,32.28409595375891,42.03335252815938,NaN,NaN,NaN,NaN,0.16696040185351238,10.687650492391034,492558,-0.050149024959820265,-0.1610020605565694,-0.11085303559674914
2025-09-10T14:25:00-04:00,159.7,159.85,159.7,159.85,NaN,NaN,NaN,160.32320779464538,NaN,NaN,160.73330000000072,161.57222934099462,159.89437065900682,160.18431966861576,160.92100182111082,161.41160987707815,160.4303937651435,212,734.8,30.851867418370844,40.89172165732852,NaN,NaN,NaN,NaN,0.17074894457826142,12.129593367376758,492346,-0.058425190959870615,-0.18388452429658741,-0.1254593333367168
2025-09-10T14:30:00-04:00,159.8,160,159.8,160,NaN,NaN,NaN,160.32320779464538,NaN,NaN,160.7064000000007,161.55138056735268,159.86141943264874,160.18431966861576,160.90856298109836,161.40835856583428,160.40876739636244,607,699.8333333333334,37.27359653947743,40.28653364180625,NaN,NaN,NaN,NaN,0.17283830567981337,12.577494263265484,492953,-0.049833348052951615,-0.1877510184029063,-0.1379176703499547
2025-09-10T14:35:00-04:00,159.73,159.88,159.69,159.88,NaN,NaN,NaN,160.32320779464538,NaN,NaN,160.67500000000072,161.52379208241155,159.8262079175899,160.05137167033126,160.8855430080227,161.40432504224617,160.36676097379922,1038,692.7666666666667,34.51225848985902,39.98596582757934,NaN,NaN,NaN,NaN,0.18263556955982688,13.401438785956676,491915,-0.048236551503608116,-0.19821335972946486,-0.14997680822585674
2025-09-10T14:40:00-04:00,159.8,159.93,159.64,159.66,NaN,NaN,NaN,160.32320779464538,NaN,NaN,160.63860000000074,161.50215321732284,159.77504678267863,160.05137167033126,160.83764532658748,161.39465865329973,160.28063199987523,2155,720.5,30.108411346801688,39.068696022596896,NaN,NaN,NaN,NaN,0.19030445744841212,14.16653012845564,489760,-0.05737964673196658,-0.22170136664081497,-0.1643217199088484
2025-09-10T14:45:00-04:00,159.71,159.71,159.45,159.52,NaN,NaN,NaN,160.1705657917425,NaN,NaN,160.59920000000074,161.48329583143843,159.71510416856304,160.05137167033126,160.82878187662237,161.39389887996643,160.26366487327832,359,705,27.687224447804084,37.86521405854017,NaN,NaN,NaN,NaN,0.19528271048781262,15.543645990286567,489401,-0.06753880897318243,-0.24874523112532643,-0.181206422152144
2025-09-10T14:50:00-04:00,159.47,159.47,159.35,159.47,NaN,NaN,NaN,159.99690371029968,NaN,NaN,160.55760000000072,161.45447733786753,159.6607226621339,160.03009733626504,160.8055760581759,161.3937770894038,160.21737502694796,873,726.7,26.856575051208452,36.60239999472661,NaN,NaN,NaN,NaN,0.19347680259582714,17.13219692009717,488528,-0.07190473791069954,-0.2710873445405184,-0.19918260662981888
2025-09-10T14:55:00-04:00,159.48,159.59,159.47,159.47,NaN,NaN,NaN,159.99690371029968,NaN,NaN,160.51640000000074,161.42005046293121,159.61274953707027,159.93907786901204,160.80030420601722,161.39307305707487,160.20753535495956,215,731.2666666666667,26.856575051208438,35.011589945261726,NaN,NaN,NaN,NaN,0.1882284595532684,17.8428192175165,488528,-0.06905594260438186,-0.2855025348852962,-0.21644659228091434
2025-09-10T15:00:00-04:00,159.45,159.45,159.31,159.31,NaN,NaN,NaN,159.9521994550458,NaN,NaN,160.47240000000073,161.3923418237931,159.55245817620838,159.77926229520963,160.77348923602722,161.3922301526279,160.15474831942655,1000,764.5333333333333,24.1659033459121,33.6512080923346,NaN,NaN,NaN,NaN,0.18621214101374897,19.0253196634494,487528,-0.07188787022088486,-0.3063064300570204,-0.23441855983613555
2025-09-10T15:05:00-04:00,159.195,159.25,158.97,158.98,NaN,NaN,NaN,159.70255402527098,NaN,NaN,160.42940000000075,161.42060258228904,159.43819741771247,159.57098229514733,160.7242874237094,161.39760926369033,160.05096558372847,1598,811,19.767123715164416,31.985909357445934,NaN,NaN,NaN,NaN,0.19719698808419572,20.998431986906265,485930,-0.08881706643765663,-0.3454398928832063,-0.2566228264455497
2025-09-10T15:10:00-04:00,158.97,158.97,158.745,158.78,NaN,NaN,NaN,159.4551652059405,NaN,NaN,160.38240000000076,161.4557223929123,159.30907760708922,159.57098229514733,160.71261526141853,161.40001693693074,160.02521358590633,344,822.4,17.668089573145323,30.06800803983227,NaN,NaN,NaN,NaN,0.19989720322103782,23.278212919319255,485586,-0.10519597270722497,-0.3881177923295809,-0.2829218196223559
2025-09-10T15:15:00-04:00,158.74,159.02,158.74,159.02,NaN,NaN,NaN,159.4551652059405,NaN,NaN,160.33860000000075,161.4512743275343,159.2259256724672,159.57098229514733,160.644847847209,161.40051182988014,159.88918386453787,2200,879.0666666666667,27.602971155928415,29.15403269810554,NaN,NaN,NaN,NaN,0.20561883156239236,25.096520838631147,487786,-0.09205182358670344,-0.3979865991057352,-0.30593477551903175
2025-09-10T15:20:00-04:00,158.88,159,158.75,159,NaN,NaN,NaN,159.4551652059405,NaN,NaN,160.29420000000076,161.43934516073207,159.14905483926944,159.3864286688943,160.60612199590832,161.39584207311808,159.81640191869857,1329,908.4333333333333,27.30725437138358,28.38175707263966,NaN,NaN,NaN,NaN,0.21021748645079366,26.784949620849336,486457,-0.07747502118734462,-0.40277855200321255,-0.32530353081586794
2025-09-10T15:25:00-04:00,158.97,159.01,158.915,158.99,NaN,NaN,NaN,159.4551652059405,NaN,NaN,160.25780000000074,161.44979355667715,159.06580644332433,159.3864286688943,160.5967509360156,161.3938148322036,159.79968703982763,342,898.3,27.15063164878103,27.8637555792003,NaN,NaN,NaN,NaN,0.2019876659900226,28.28582641254413,486115,-0.06194964165369299,-0.4027405828829842,-0.3407909412292912
2025-09-10T15:30:00-04:00,158.98,159.18,158.98,159.13,NaN,NaN,NaN,159.4551652059405,NaN,NaN,160.22460000000075,161.44752083111163,159.00167916888986,159.14514293511542,160.56158311777605,161.3812992937027,159.7418669418494,1432,876.6333333333333,32.94886372656988,27.91123899154394,NaN,NaN,NaN,NaN,0.20184568984787934,28.587507977403753,487547,-0.036929733061750514,-0.3869531075564794,-0.35002337449472887
2025-09-10T15:35:00-04:00,159.15,159.15,158.88,158.88,NaN,NaN,NaN,159.4551652059405,NaN,NaN,160.18180000000072,161.43966765567674,158.9239323443247,159.10049147847386,160.5302664184374,161.37144161915646,159.68909121771836,1226,876.2666666666667,28.575109602790562,27.748613433288206,NaN,NaN,NaN,NaN,0.20671385485874585,29.164101698634752,486321,-0.03207514110465287,-0.39011730087554497,-0.3580421597708921
2025-09-10T15:40:00-04:00,158.825,159.35,158.825,159.35,NaN,NaN,NaN,159.4551652059405,NaN,NaN,160.15060000000074,161.4120541447042,158.88914585529727,159.10049147847386,160.4998602089805,161.35542131875735,159.64429909920364,1430,902.0333333333333,43.70473906639555,28.2079807566395,NaN,NaN,NaN,NaN,0.22944857951169298,28.557792748575235,487751,0.005907559004051655,-0.35065771101582754,-0.3565652700198792
2025-09-10T15:45:00-04:00,159.35,159.39,159.28,159.39,NaN,NaN,NaN,159.4551652059405,NaN,NaN,160.12220000000073,161.386927891362,158.85747210863946,158.9783931827791,160.49171589245097,161.3496532619899,159.63377852291202,456,877.5333333333333,44.776866895135015,28.94116707130207,NaN,NaN,NaN,NaN,0.22091653811799958,27.78298112113663,488207,0.035208139637399716,-0.31255509547312954,-0.34776323511052926
2025-09-10T15:50:00-04:00,159.43,159.58,159.42,159.42,158.8622538739191,158.8622538739191,158.8622538739191,NaN,NaN,NaN,160.09260000000074,161.35239401458108,158.8328059854204,158.98943699302663,160.48395447823103,161.34319289726582,159.62471605919623,493,848.1666666666666,45.61345588103264,30.04867025231857,NaN,NaN,NaN,NaN,0.21870821396671578,26.1246591881209,488700,0.056812528020187214,-0.27674757508529524,-0.33356010310548245
2025-09-10T15:55:00-04:00,159.44,159.54,159.41,159.485,158.8622538739191,NaN,NaN,NaN,NaN,NaN,160.06470000000076,161.31526052998345,158.81413947001806,159.00254959442128,160.47235269398854,161.33334366296802,159.61136172500906,755,863.9666666666667,47.470289094086525,31.461746298481597,NaN,NaN,NaN,NaN,0.21237191296909289,24.62766095865614,489455,0.07456468545204781,-0.24035424629042268,-0.3149189317424705
2025-09-11T09:30:00-04:00,160.36,160.6,159.91,160.56,159.50494619503786,NaN,NaN,NaN,NaN,NaN,160.05690000000075,161.2900194423695,158.823780557632,159.61253967553705,160.35666666666665,160.35666666666665,160.35666666666665,3038,949.4333333333333,67.33390884654705,34.35298442672007,NaN,NaN,NaN,NaN,0.27684534775701347,25.638794606014713,492493,0.15325763418214977,-0.1233468890147833,-0.27660452319693307
2025-09-11T09:35:00-04:00,160.81,160.81,160.5,160.66,159.89676682253614,NaN,NaN,NaN,NaN,NaN,160.05590000000075,161.28697869739818,158.8248213026033,159.86503174042963,160.45706088480068,160.5986210006818,160.31550076891958,1528,989.8333333333334,68.52619063770773,37.32938554004145,NaN,NaN,NaN,NaN,0.27921353720294123,26.93565956271764,494021,0.20345034850094762,-0.02229158757074856,-0.22574193607169618
2025-09-11T09:40:00-04:00,160.63,161.03,160.63,160.85,160.05168651242084,NaN,NaN,NaN,NaN,NaN,160.06310000000073,161.3083789081888,158.81782109181265,160.0740253923437,160.50147424740538,160.68197832443803,160.32097017037273,605,1004.0333333333333,70.71339355850293,40.65420626951222,NaN,NaN,NaN,NaN,0.2878411416884458,28.479328123041963,494626,0.23842836825351435,0.07229352424519675,-0.1661348440083176
2025-09-11T09:45:00-04:00,160.855,161.5,160.855,161.38,160.34592803458355,NaN,NaN,NaN,NaN,NaN,160.07990000000075,161.3722366276457,158.7875633723558,160.41022031387496,160.62256651017213,160.9429526360086,160.30218038433566,1006,1006.8666666666667,75.77135819550286,44.65450873239354,NaN,NaN,NaN,NaN,0.313709631567843,30.51122767899403,495632,0.28319108583336194,0.1878540132833848,-0.09533707254997713
2025-09-11T09:50:00-04:00,161.56,161.83,161.52,161.7,160.81986312392067,NaN,NaN,NaN,NaN,NaN,160.10290000000074,161.46683414766386,158.73896585233763,160.73317625109996,160.7429836394948,161.19490074549532,160.2910665334943,791,1026.5666666666666,78.21745757852601,48.979463589920734,NaN,NaN,NaN,NaN,0.32344465788442683,32.73530512268253,496423,0.31769296765783944,0.3017791370223222,-0.015913830635517254
2025-09-11T09:55:00-04:00,161.73,161.86,161.53,161.84,160.83373298192424,NaN,NaN,NaN,NaN,NaN,160.12750000000074,161.56927841542037,158.6857215845811,160.81754100087997,160.79225724291624,161.28320778252194,160.30130670331053,361,1022.8,79.20654445093193,52.66543311099241,NaN,NaN,NaN,NaN,0.32391289660696865,34.82961082698043,496784,0.33174364473622275,0.3987657252847612,0.06702208054853843
2025-09-11T10:00:00-04:00,161.745,161.745,161.57,161.59,160.83373298192424,NaN,NaN,NaN,NaN,NaN,160.15070000000074,161.64748456672078,158.6539154332807,160.81754100087997,160.84859031491382,161.36745591614635,160.3297247136813,525,1030.0333333333333,72.8455427855131,55.91816799771595,NaN,NaN,NaN,NaN,0.3200619754207573,36.77432326668562,496259,0.30659434341527125,0.4502650098176275,0.14367066640235626
2025-09-11T10:05:00-04:00,161.58,161.84,161.54,161.54,160.83373298192424,NaN,NaN,NaN,NaN,NaN,160.17250000000075,161.71707405104223,158.62792594895927,160.91482624056317,160.8747985145061,161.40428937168704,160.34530765732515,269,979.2666666666667,71.60693387565466,59.09361815677835,NaN,NaN,NaN,NaN,0.3186289771764183,38.681864203823395,495990,0.2702583652330996,0.48149362294373077,0.21123525771063117
2025-09-11T10:10:00-04:00,161.63,161.63,161.33,161.33,160.83373298192424,NaN,NaN,NaN,NaN,NaN,160.18850000000074,161.7638237759746,158.6131762240269,160.91482624056317,160.89182557677006,161.42185003572524,160.36180111781488,257,950.2333333333333,66.49315297600691,61.48963881745242,NaN,NaN,NaN,NaN,0.31729833594953005,39.49529048342782,495733,0.21798878704209607,0.48372124151325124,0.2657324544711552
2025-09-11T10:15:00-04:00,161.5,161.74,161.5,161.61,160.83373298192424,NaN,NaN,NaN,NaN,NaN,160.20700000000073,161.8263233152072,158.58767668479427,160.91482624056317,160.90113264224286,161.43402880395757,160.36823648052814,109,899.1,69.60951621159249,64.42066786093828,NaN,NaN,NaN,NaN,0.32391988338170624,40.408345025580175,495842,0.18924620944124554,0.5022902162727121,0.31304400683146655
2025-09-11T10:20:00-04:00,161.65,161.65,161.46,161.55,160.83373298192424,NaN,NaN,NaN,NaN,NaN,160.22580000000073,161.88474347076584,158.56685652923562,160.91482624056317,160.92977981754697,161.46770912573862,160.39185050935532,390,898.1,68.14687318323374,66.16653458356959,NaN,NaN,NaN,NaN,0.3143541774258699,41.07100582783044,495452,0.15462729733935282,0.5063281285056576,0.35170083116630474
2025-09-11T10:25:00-04:00,161.62,161.73,161.58,161.65,160.83373298192424,NaN,NaN,NaN,NaN,NaN,160.25060000000073,161.95623377053187,158.5449662294696,160.97704882813468,160.97104449872555,161.51969698304293,160.42239201440816,537,908.9333333333333,69.30452387915591,67.91851008242821,NaN,NaN,NaN,NaN,0.30475745046687763,41.813453631254674,495989,0.1279983925154341,0.5116988218105973,0.38370042929516324
2025-09-11T10:30:00-04:00,161.98,162,161.98,162,161.13048519141475,NaN,NaN,NaN,NaN,NaN,160.27940000000072,162.0522628145418,158.50653718545965,161.22263906250777,161.0038317228618,161.57287315349137,160.43479029223224,312,899.1,73.0027819109217,69.87489051313457,NaN,NaN,NaN,NaN,0.3079890611478145,42.89778790351947,496301,0.12343608238069015,0.5379955322710259,0.4145594498903358
2025-09-11T10:35:00-04:00,162.15,162.4,162.15,162.32,161.40000859180498,NaN,NaN,NaN,NaN,NaN,160.30960000000076,162.16701631282064,158.45218368718088,161.5781112500062,161.04578311455842,161.6503019465619,160.44126428255493,328,875.4333333333333,75.86578979128717,71.90314056293462,NaN,NaN,NaN,NaN,0.31456127106582815,44.37710192923714,496629,0.1307479844174605,0.5779944304121614,0.44724644599470087
2025-09-11T10:40:00-04:00,162.32,162.32,162.17,162.2,161.40000859180498,NaN,NaN,NaN,NaN,NaN,160.33620000000076,162.26179867031635,158.41060132968516,161.58748900000495,161.07540575916227,161.70030876194178,160.45050275638275,258,812.2,72.75010782231851,72.29001191834688,NaN,NaN,NaN,NaN,0.3028068945611265,45.75075066740356,496371,0.1167413374306247,0.5931731177829818,0.47643178035235706
2025-09-11T10:45:00-04:00,162.12,162.12,162.02,162.1,161.40000859180498,NaN,NaN,NaN,NaN,NaN,160.36360000000076,162.34889598778727,158.37830401221424,161.58748900000495,161.0989011457248,161.73484295313617,160.46295933831342,247,808.4666666666667,70.16412469662149,72.40700720826928,NaN,NaN,NaN,NaN,0.2940349735210445,46.29362733694154,496124,0.09111716465868064,0.5903282361757078,0.4992110715170272
2025-09-11T10:50:00-04:00,162,162,161.76,161.92,161.40000859180498,NaN,NaN,NaN,NaN,NaN,160.38700000000074,162.41703842307186,158.35696157692962,161.58748900000495,161.11250519621527,161.75134710715142,160.47366328527912,184,785.5,65.64113775529431,72.04470322232581,NaN,NaN,NaN,NaN,0.29731818969811297,45.650145528427025,495940,0.05424152571737051,0.5670129786637403,0.5127714529463698
2025-09-11T10:55:00-04:00,161.84,161.92,161.84,161.92,161.40000859180498,NaN,NaN,NaN,NaN,NaN,160.41320000000076,162.48740805107272,158.3389919489288,161.58748900000495,161.11373861735734,161.75282849988068,160.474648734834,17,778.9,65.64113775529432,71.32111604802519,NaN,NaN,NaN,NaN,0.28179546186253235,45.05262670623498,495940,0.023610319763745613,0.5422843526510519,0.5186740328873063
2025-09-11T11:00:00-04:00,161.99,161.99,161.94,161.94,161.40000859180498,NaN,NaN,NaN,NaN,NaN,160.44060000000076,162.5581123515905,158.32308764841102,161.58748900000495,161.12949500015193,161.77279465647905,160.48619534382482,205,752.4,65.92420077161427,70.44302627610293,NaN,NaN,NaN,NaN,0.2666672145866387,44.63968818961218,496145,-0.0002787175544443077,0.518325635944251,0.5186043534986953
2025-09-11T11:05:00-04:00,162,162.07,162,162,161.40000859180498,NaN,NaN,NaN,NaN,NaN,160.47500000000076,162.63638844244764,158.31361155755388,161.58748900000495,161.1350835145584,161.7802277170182,160.4899393120986,69,701.4333333333333,66.80766327523753,69.55739190641047,NaN,NaN,NaN,NaN,0.2569052706875928,44.41901388874009,496214,-0.016136249572110906,0.49843404153355664,0.5145702911056675
2025-09-11T11:10:00-04:00,162.1,162.1,162,162,161.40000859180498,NaN,NaN,NaN,NaN,NaN,160.50680000000077,162.7098131727096,158.30378682729193,161.6639734364173,161.1479202393712,161.79724977811594,160.49859070062644,160,695.3,66.80766327523753,69.12611479853365,NaN,NaN,NaN,NaN,0.2456977513527643,44.276424525120326,496214,-0.029920793684059532,0.47716929900059313,0.5070900926846527
2025-09-11T11:15:00-04:00,162.1,162.21,162.1,162.19,161.4066747306316,NaN,NaN,NaN,NaN,NaN,160.54140000000075,162.79416633478806,158.28863366521344,161.75617874913385,161.17510924686312,161.83642278095533,160.5137957127709,307,632.2,69.69336541108501,68.98943133677868,NaN,NaN,NaN,NaN,0.24314791197042457,44.372946408885056,496521,-0.029489868890416937,0.4702277565716315,0.49971762546204845
2025-09-11T11:20:00-04:00,162.28,162.34,162.09,162.09,161.46659860651198,NaN,NaN,NaN,NaN,NaN,160.57400000000075,162.86791107044883,158.28008892955268,161.85194299930708,161.20393091318417,161.87672227627397,160.53113955009437,342,599.3,66.420365332557,68.9842322193894,NaN,NaN,NaN,NaN,0.24363734682967997,44.719513513118116,496179,-0.03861146250665798,0.45145329732872597,0.49006475983538395
2025-09-11T11:25:00-04:00,162.22,162.26,162.06,162.06,161.46659860651198,NaN,NaN,NaN,NaN,NaN,160.60320000000078,162.93455562261454,158.27184437738703,161.85194299930708,161.20996742989738,161.88466786265857,160.53526699713618,78,590.5,65.42765650865715,68.68552795489401,NaN,NaN,NaN,NaN,0.24052039348470203,44.86891081815134,496101,-0.04868698078847139,0.4292060338497947,0.4778930146382661
2025-09-11T11:30:00-04:00,162.28,162.34,162.2,162.275,161.52387393692516,NaN,NaN,NaN,NaN,NaN,160.64100000000076,163.0178230895707,158.26417691043082,161.85194299930708,161.2968002823771,162.00577145012758,160.5878291146266,1062,578.1666666666666,69.00318012090617,68.74669273615633,NaN,NaN,NaN,NaN,0.24334036537865195,45.17628777614057,497163,-0.04308593013985029,0.42403560196345325,0.46712153210330354
2025-09-11T11:35:00-04:00,162.27,162.27,162.1,162.1,161.52387393692516,NaN,NaN,NaN,NaN,NaN,160.67540000000076,163.08566956150273,158.2651304384988,161.85194299930708,161.3068139493581,162.0176562025719,160.59597169614426,153,542.4,63.26761074490058,68.31548465513809,NaN,NaN,NaN,NaN,0.23845891070874906,44.860890298314864,497010,-0.052743413460232536,0.4011922652780129,0.4539356787382454
2025-09-11T11:40:00-04:00,162.07,162.12,162.07,162.08,161.52387393692516,NaN,NaN,NaN,NaN,NaN,160.70860000000076,163.14942038649397,158.26777961350754,161.85194299930708,161.31460449635767,162.02615994161263,160.60304905110272,132,499.1333333333333,62.62692487100531,67.57435200942977,NaN,NaN,NaN,NaN,0.22499755994383921,44.38813304053787,496878,-0.06144643823169943,0.3771276309486211,0.43857406918032055
2025-09-11T11:45:00-04:00,162.04,162.1,161.97,162.08,161.52387393692516,NaN,NaN,NaN,NaN,NaN,160.74480000000077,163.21207214532933,158.2775278546722,161.85194299930708,161.32514682215452,162.0369716059008,160.61332203840826,193,490.3666666666667,62.62692487100531,66.62871880083821,NaN,NaN,NaN,NaN,0.21821201994785036,43.353219311526686,496878,-0.06767859779762475,0.3539758219332896,0.42165441973091433
2025-09-11T11:50:00-04:00,162.06,162.17,162.06,162.11,161.52387393692516,NaN,NaN,NaN,NaN,NaN,160.78340000000077,163.27439453213307,158.29240546786846,161.85194299930708,161.3530442310907,162.0671663894733,160.6389220727081,494,490.4,63.27391693344919,65.95184802306184,NaN,NaN,NaN,NaN,0.2104825899515743,42.6101161082157,497372,-0.06996658368982561,0.33419619011863233,0.40416277380845794
2025-09-11T11:55:00-04:00,162.2,162.25,162.2,162.25,161.55841392141892,NaN,NaN,NaN,NaN,NaN,160.82800000000077,163.34246773673834,158.3135322632632,161.87131742848828,161.35335947571977,162.0675479915319,160.63917095990763,5,465.4,66.2134318218935,65.66965567486697,NaN,NaN,NaN,NaN,0.2054481192407466,42.16355320103726,497377,-0.062483086916545916,0.3260589151627755,0.38854200207932144
2025-09-11T12:00:00-04:00,162.31,162.5,162.31,162.5,161.73462237953623,NaN,NaN,NaN,NaN,NaN,160.87960000000078,163.42313835416357,158.336061645838,162.07205394279063,161.39549264587777,162.12631080540484,160.6646744863507,565,382.96666666666664,70.72020535215464,66.03244621749987,NaN,NaN,NaN,NaN,0.20863039643783615,42.412969080883435,497942,-0.042104956766310875,0.33591080612143287,0.37801576288774374
2025-09-11T12:05:00-04:00,162.35,162.47,162.35,162.47,161.74963954410276,NaN,NaN,NaN,NaN,NaN,160.93200000000078,163.49640012460898,158.36759987539259,162.07205394279063,161.4101650153818,162.1460206608649,160.6743093698987,209,339,69.52178684031536,66.30963543785852,NaN,NaN,NaN,NaN,0.2044425109779911,42.6445695407406,497733,-0.032485955637209074,0.3374083183412324,0.3698942739784415
2025-09-11T12:15:00-04:00,162.47,162.54,162.47,162.54,161.86511047391627,NaN,NaN,NaN,NaN,NaN,160.98280000000076,163.57185168722518,158.39374831277635,162.171114523386,161.41517316309756,162.1531089051264,160.67723742106872,67,321.06666666666666,70.76660446112464,66.65552141568068,NaN,NaN,NaN,NaN,0.19483947447956268,43.035433405445154,497800,-0.023659003627536868,0.3403205194440204,0.3639795230715573
2025-09-11T12:20:00-04:00,162.49,162.49,162.41,162.41,161.86511047391627,NaN,NaN,NaN,NaN,NaN,161.03340000000077,163.63313186292638,158.43366813707516,162.171114523386,161.42481118397572,162.16586684981746,160.68375551813398,141,292.23333333333335,65.42251799689717,66.5565824672278,NaN,NaN,NaN,NaN,0.19020808344530787,42.97382476871028,497659,-0.028500825180123757,0.3283534915964026,0.35685431677652635
2025-09-11T12:25:00-04:00,162.49,162.5,162.26,162.26,161.86511047391627,NaN,NaN,NaN,NaN,NaN,161.08540000000076,163.67716684119668,158.49363315880484,162.171114523386,161.45011896241348,162.1961071369091,160.70413078791788,425,280.03333333333336,59.81007367093456,66.056754638349,NaN,NaN,NaN,NaN,0.19376464891350081,41.92643461397243,497234,-0.04286754703749074,0.30326988297966295,0.3461374300171537
2025-09-11T12:30:00-04:00,162.24,162.26,162.24,162.26,161.86511047391627,NaN,NaN,NaN,NaN,NaN,161.1402000000008,163.71305441467015,158.56734558533142,162.171114523386,161.4538642790838,162.20012007924015,160.70760847892745,72,270.4,59.810073670934564,65.35080522833826,NaN,NaN,NaN,NaN,0.1813528882768209,40.82731300255304,497234,-0.05278081119473843,0.2801614160237307,0.3329422272184691
2025-09-11T12:35:00-04:00,162.23,162.23,162.125,162.125,161.86511047391627,NaN,NaN,NaN,NaN,NaN,161.1933000000008,163.7354885136807,158.65111148632087,162.171114523386,161.46351698073033,162.20917642523872,160.71785753622194,214,260.03333333333336,54.89459046952451,64.52753559526451,NaN,NaN,NaN,NaN,0.17804196768561872,39.09478245912762,497020,-0.06787815112552531,0.24809453831156247,0.3159726894370878
2025-09-11T12:40:00-04:00,162.12,162.12,161.98,162.03,161.86511047391627,NaN,NaN,NaN,NaN,NaN,161.24450000000078,163.74862879043872,158.74037120956285,162.171114523386,161.48419664490163,162.22429140079498,160.74410188900828,579,270.3666666666667,51.676072781068534,63.54527961472247,NaN,NaN,NaN,NaN,0.17568182713664668,36.68150397096188,496441,-0.08272592722313343,0.21256528040817102,0.29529120763130445
2025-09-11T12:45:00-04:00,161.91,162,161.91,161.98,161.86511047391627,NaN,NaN,NaN,NaN,NaN,161.29790000000077,163.74803231461473,158.8477676853868,162.171114523386,161.49588711939103,162.2306255628962,160.76114867588586,406,275.3333333333333,50.01400375700812,62.188909874444036,NaN,NaN,NaN,NaN,0.17170455376974367,34.08083078458351,496035,-0.09357859259347068,0.1783179668894661,0.2718965594829368
2025-09-11T12:50:00-04:00,161.9,161.92,161.88,161.91,161.86511047391627,NaN,NaN,NaN,NaN,NaN,161.35650000000075,163.72072778072146,158.99227221928004,162.171114523386,161.50404564193167,162.2336267884157,160.77446449544763,340,283.03333333333336,47.70088103881212,61.07700060972343,NaN,NaN,NaN,NaN,0.1665827999290473,31.781743270407908,495695,-0.10242135404105035,0.14386986693162385,0.2462912209726742
2025-09-11T12:55:00-04:00,161.98,162.145,161.98,162.14,161.86511047391627,NaN,NaN,NaN,NaN,NaN,161.42370000000076,163.6797033774583,159.16769662254322,162.171114523386,161.50521325575016,162.23453198377837,160.77589452772196,34,271.1666666666667,55.05605168864414,60.536223953840484,NaN,NaN,NaN,NaN,0.17146974279125918,30.45741428658932,495729,-0.09016205635223998,0.13358865053237423,0.2237507068846142
2025-09-11T13:00:00-04:00,161.97,162.07,161.97,162,161.86511047391627,NaN,NaN,NaN,NaN,NaN,161.48330000000075,163.63729406663612,159.3293059333654,162.171114523386,161.51216492753622,162.23887854181422,160.78545131325822,236,261.1333333333333,50.408864380486776,59.66350534737488,NaN,NaN,NaN,NaN,0.1713647611633112,29.17058105369587,495493,-0.08872608750212863,0.11284309750695343,0.20156918500908205
2025-09-11T13:05:00-04:00,161.965,162.02,161.96,162.02,161.86511047391627,NaN,NaN,NaN,NaN,NaN,161.54370000000074,163.58203246530857,159.5053675346929,162.12989161870883,161.51667595198435,162.24152730998927,160.79182459397944,161,256.1,51.04459395388156,58.78998227740577,NaN,NaN,NaN,NaN,0.163410135365932,27.91506780490619,495654,-0.08373619643364599,0.09689893946702455,0.18063513590067054
2025-09-11T13:10:00-04:00,162.12,162.15,162.12,162.15,161.86511047391627,NaN,NaN,NaN,NaN,NaN,161.60690000000076,163.51648622719787,159.69731377280365,162.09191329496704,161.51706950981517,162.24186114496158,160.79227787466877,11,245.53333333333333,55.07590014137501,57.99444430022587,NaN,NaN,NaN,NaN,0.16102369712550796,27.352522637222254,495665,-0.06956955935511194,0.0936731867067806,0.16324274606189254
2025-09-11T13:15:00-04:00,162.18,162.2,162.07,162.07,161.86511047391627,NaN,NaN,NaN,NaN,NaN,161.66570000000075,163.44306997811066,159.88833002189085,161.92353063597363,161.5355099751548,162.25643420697347,160.81458574333615,556,255.46666666666667,52.22579111529435,56.673414711878706,NaN,NaN,NaN,NaN,0.15880771875939992,26.83015926723003,495109,-0.06363690048898074,0.08369662045066661,0.14733352093964736
2025-09-11T13:20:00-04:00,162.115,162.24,162.115,162.24,161.86511047391627,NaN,NaN,NaN,NaN,NaN,161.73290000000077,163.3286933321977,160.13710666780383,161.8933245087789,161.5439185750636,162.26408600356876,160.82375114655844,231,254.93333333333334,57.284388502306676,55.79931483059238,NaN,NaN,NaN,NaN,0.15960716741944392,26.53340439153172,495340,-0.04707668210570032,0.08848766830752197,0.1355643504132223
2025-09-11T13:25:00-04:00,162.21,162.25,162.19,162.19,161.86511047391627,NaN,NaN,NaN,NaN,NaN,161.78970000000075,163.2374947503404,160.3419052496611,161.939744149516,161.55104766561627,162.270622417525,160.83147291370753,197,255.36666666666667,55.42550556597076,54.7035220523671,NaN,NaN,NaN,NaN,0.15249236974662667,26.306438948191254,495143,-0.03865601807791835,0.08724432781582436,0.12590034589374272
2025-09-11T13:30:00-04:00,162.22,162.28,162.22,162.28,161.86511047391627,NaN,NaN,NaN,NaN,NaN,161.84750000000074,163.1286295793643,160.56637042063718,161.9867953196128,161.55704376088633,162.27650434357724,160.83758317819542,157,260.03333333333336,58.063450022805846,54.17787433993201,NaN,NaN,NaN,NaN,0.1480286290504393,26.246994920204774,495300,-0.026755916334652644,0.09245545047542691,0.11921136681007956
2025-09-11T13:35:00-04:00,162.3,162.45,162.3,162.45,161.86571096783797,NaN,NaN,NaN,NaN,NaN,161.90810000000076,162.99632036329507,160.81987963670645,162.13043625569023,161.5635772575012,162.28404679409334,160.84310772090907,145,258.03333333333336,62.56949944917878,54.37497618123516,NaN,NaN,NaN,NaN,0.14959801268969272,26.96007076372168,495445,-0.00813239818569575,0.10904586907795988,0.11717826726365563
2025-09-11T13:40:00-04:00,162.36,162.37,162.32,162.32,161.86571096783797,NaN,NaN,NaN,NaN,NaN,161.96480000000074,162.8105090747502,161.11909092525127,162.13043625569023,161.57565868631062,162.2968788805578,160.85443849206342,297,265.6333333333333,57.482969979156266,54.20875448896528,NaN,NaN,NaN,NaN,0.1481981546404286,27.622212618415958,495148,-0.005397812247976197,0.11043100195368538,0.11582881420166158
2025-09-11T13:45:00-04:00,162.27,162.27,162.15,162.15,161.86571096783797,NaN,NaN,NaN,NaN,NaN,161.99660000000074,162.74228475853175,161.25091524146973,162.13043625569023,161.57983241877884,162.30036789621127,160.8592969413464,130,264.6333333333333,51.5780495240432,53.971858707145195,NaN,NaN,NaN,NaN,0.1497554293089685,26.841850114262776,495018,-0.015305856560745484,0.09669649350072973,0.11200235006147521
2025-09-11T13:50:00-04:00,162.1,162.17,162.1,162.17,161.86571096783797,NaN,NaN,NaN,NaN,NaN,162.02680000000078,162.668581145759,161.38501885424256,162.13043625569023,161.5926018253644,162.30992377282465,160.87527987790415,441,269.1,52.200159347767254,54.00929346190939,NaN,NaN,NaN,NaN,0.144058612929756,25.755115391777757,495459,-0.02045841926241246,0.08642932598345965,0.1068877452458721
2025-09-11T13:55:00-04:00,162.195,162.2,162.125,162.125,161.86571096783797,NaN,NaN,NaN,NaN,NaN,162.05230000000077,162.5993510388121,161.50524896118944,162.13043625569023,161.59342633681885,162.31053758809557,160.87631508554213,29,258.6666666666667,50.62418189598516,54.05287761469346,NaN,NaN,NaN,NaN,0.13912585486334403,24.91835531092752,495430,-0.026461751640568937,0.07381055569516093,0.10027230733572987
2025-09-11T14:00:00-04:00,162.25,162.25,162.18,162.18,161.86571096783797,NaN,NaN,NaN,NaN,NaN,162.06830000000076,162.58151188515774,161.55508811484378,162.13043625569023,161.61776885406465,162.3304946419404,160.9050430661889,815,283.23333333333335,52.51131767723143,54.39648023172341,NaN,NaN,NaN,NaN,0.13811686523024802,24.428207550543316,496245,-0.02624154730006098,0.06747037321065363,0.09371192051071461
2025-09-11T14:05:00-04:00,162.21,162.22,162.11,162.16,161.86571096783797,NaN,NaN,NaN,NaN,NaN,162.07750000000075,162.58036081479713,161.57463918520438,162.13043625569023,161.62618643522984,162.33658200868823,160.91579086177146,320,258.5,51.736959767528894,54.15940223735804,NaN,NaN,NaN,NaN,0.13610851771380067,23.418198522755965,495925,-0.02685860918154573,0.06013865903378246,0.08699726821532819
2025-09-11T14:10:00-04:00,162.19,162.2,162.11,162.11,161.86571096783797,NaN,NaN,NaN,NaN,NaN,162.08290000000076,162.58122154183303,161.5845784581685,162.13043625569023,161.63021750223243,162.33927149861742,160.92116350584743,164,258.8666666666667,49.76133029371129,54.11314980258836,NaN,NaN,NaN,NaN,0.1328150521628131,22.480332996953422,495761,-0.029821419618224904,0.04972049369254705,0.07954191331077196
2025-09-11T14:15:00-04:00,162.08,162.09,162.075,162.09,161.86571096783797,NaN,NaN,NaN,NaN,NaN,162.09290000000075,162.57090874369555,161.61489125630595,162.13043625569023,161.63274875917733,162.34063579414666,160.924861724208,117,258.3666666666667,48.956034375428345,53.96396697555599,NaN,NaN,NaN,NaN,0.12582826272261396,21.319917854733074,495644,-0.0321166854236212,0.03939605653124545,0.07151274195486665
2025-09-11T14:20:00-04:00,162.06,162.06,161.97,162.05,161.86571096783797,NaN,NaN,NaN,NaN,NaN,162.10310000000078,162.55450620180292,161.65169379819864,162.13043625569023,161.64181128772387,162.34399598537996,160.93962659006777,495,268.43333333333334,47.30709578479068,53.40905237865711,NaN,NaN,NaN,NaN,0.1254119582424276,20.15716037643405,495149,-0.0350763784140703,0.027667268937278777,0.06274364735134907
2025-09-11T14:25:00-04:00,161.93,161.93,161.85,161.85,NaN,NaN,NaN,162.3359845860036,162.3359845860036,162.3359845860036,162.11350000000076,162.51430543790102,161.7126945621005,162.0493490045522,161.64478577765541,162.3430037464382,160.94656780887263,276,261.1666666666667,40.04444421542925,52.538956171523886,NaN,NaN,NaN,NaN,0.13073967551082685,19.861146226270414,494873,-0.04842824954399303,0.0022083354213577877,0.05063658496535082
2025-09-11T14:30:00-04:00,161.93,161.93,161.865,161.865,NaN,NaN,NaN,162.3341216502762,NaN,NaN,162.11860000000078,162.4996513863095,161.73754861369207,161.9602413522646,161.6519065752164,162.34098430672887,160.96282884370393,661,283.03333333333336,40.77877586874473,51.359983840555174,NaN,NaN,NaN,NaN,0.12711541297434012,19.58627594397561,495534,-0.05376263395670911,-0.01656670748053557,0.03719592647617354
2025-09-11T14:35:00-04:00,161.83,161.92,161.83,161.92,NaN,NaN,NaN,162.30404793889997,NaN,NaN,162.12600000000077,162.47567413261322,161.77632586738832,161.9602413522646,161.65348663156811,162.34054611133033,160.9664271518059,150,269.2,43.51079893611396,50.50893336699398,NaN,NaN,NaN,NaN,0.12446431204759975,19.55668500273264,495684,-0.05111693330346788,-0.026700240153161303,0.024416693150306576
2025-09-11T14:40:00-04:00,161.94,162.02,161.94,162.02,NaN,NaN,NaN,162.30404793889997,NaN,NaN,162.13340000000076,162.4571680636584,161.80963193634312,161.9602413522646,161.65668879831713,162.34129151272631,160.97208608390795,215,269.4,48.190700278705584,49.803736956701094,NaN,NaN,NaN,NaN,0.12271686118705853,18.646239124637304,495899,-0.04061986122820195,-0.02635813338494586,0.014261727843256088
2025-09-11T14:45:00-04:00,162.07,162.07,162.07,162.07,NaN,NaN,NaN,162.30404793889997,NaN,NaN,162.13480000000075,162.45684943573013,161.81275056427137,161.9602413522646,161.65913762307227,162.34244584222034,160.9758294039242,136,271.7,50.40318236965265,48.93471430816352,NaN,NaN,NaN,NaN,0.11752279967369599,17.397239578976166,496035,-0.02885027782633137,-0.021801119439658123,0.007049158386673245
2025-09-11T14:50:00-04:00,161.89,161.89,161.89,161.89,NaN,NaN,NaN,162.30404793889997,NaN,NaN,162.12620000000075,162.45096181893777,161.80143818106373,161.93319308181168,161.65920800487785,162.3424239454644,160.97599206429132,7,267.23333333333335,43.24369366733474,47.91762314303342,NaN,NaN,NaN,NaN,0.12198545683986105,17.43895069534634,496028,-0.03151239704690902,-0.03234133792196303,-0.0008289408750540104
2025-09-11T14:55:00-04:00,161.83,161.98,161.83,161.98,NaN,NaN,NaN,162.30404793889997,NaN,NaN,162.12180000000077,162.4483992024313,161.79520079757026,161.92555446544935,161.6631478540773,162.3421500423465,160.9841456658081,339,264.3666666666667,47.27628956575832,47.6103545745845,NaN,NaN,NaN,NaN,0.12398649563701221,16.770258386954865,496367,-0.02577788283625654,-0.03305129442037469,-0.007273411584118147
2025-09-11T15:00:00-04:00,161.92,161.92,161.88,161.88,NaN,NaN,NaN,162.30404793889997,NaN,NaN,162.11740000000077,162.45091005835542,161.78388994164612,161.85294357235946,161.6641413472359,162.3418446608373,160.9864380336345,101,265.3333333333333,43.571879561248146,46.99404887554742,NaN,NaN,NaN,NaN,0.12227317452008236,16.149329814877063,496266,-0.027147737287536215,-0.041208083193538414,-0.014060345906002199
2025-09-11T15:05:00-04:00,161.88,161.96,161.88,161.96,NaN,NaN,NaN,162.30404793889997,NaN,NaN,162.11820000000077,162.44999969714235,161.7864003028592,161.8329562798326,161.6644974820758,162.34182303437572,160.98717192977588,31,259.23333333333335,47.14029238441865,46.74519962472124,NaN,NaN,NaN,NaN,0.11925366205436308,15.252575134548271,496297,-0.021349607675836817,-0.04074735550079822,-0.019397747824961405
2025-09-11T15:10:00-04:00,162.05,162.05,162.05,162.05,NaN,NaN,NaN,162.30404793889997,NaN,NaN,162.12080000000077,162.44835677226177,161.79324322773977,161.8329562798326,161.66451393334188,162.34182971463127,160.98719815205249,1,239.96666666666667,50.90196361772116,46.63024576332764,NaN,NaN,NaN,NaN,0.11716411476476596,14.582067163991391,496298,-0.010675835342936497,-0.032742542003632025,-0.022066706660695528
2025-09-11T15:15:00-04:00,162.03,162.16,162.03,162.16,NaN,NaN,NaN,162.30404793889997,NaN,NaN,162.12520000000077,162.44881062873702,161.80158937126453,161.88544921102044,161.66455252115782,162.3418522792224,160.98725276309324,2,226.5,55.10699830979089,46.870962802060646,NaN,NaN,NaN,NaN,0.1180809637101395,14.6809332189168,496300,0.003795044272056177,-0.017322901320625306,-0.021117945592681483
2025-09-11T15:20:00-04:00,162.17,162.3,162.16,162.3,NaN,NaN,NaN,162.30404793889997,NaN,NaN,162.13120000000077,162.45642336789493,161.80597663210662,162.01035936881635,161.66822272637324,162.34499660492963,160.99144884781686,147,220.06666666666666,59.82328228992436,47.589673658933,NaN,NaN,NaN,NaN,0.1196466091594163,15.54232821927261,496447,0.021793169988850766,0.006123516893381975,-0.01566965309546879
2025-09-11T15:25:00-04:00,162.24,162.36,162.24,162.36,161.90241025890376,161.90241025890376,161.90241025890376,NaN,NaN,NaN,162.1384000000008,162.46760169960663,161.80919830039494,162.06828749505308,161.6744640207196,162.35097412659374,160.99795391484545,228,226.53333333333333,61.681259678678096,48.498618323450835,NaN,NaN,NaN,NaN,0.11967185136231547,16.63454963542238,496675,0.03590352958942485,0.029209758891312276,-0.006693770698112578
2025-09-11T15:30:00-04:00,162.43,162.51,162.37,162.37,162.04002797440813,NaN,NaN,NaN,NaN,NaN,162.1420000000008,162.4772610908288,161.8067389091728,162.20162999604247,161.6933593238376,162.37135754341313,161.01536110426207,622,239.4,61.996702526533504,49.54787594786103,NaN,NaN,NaN,NaN,0.12183814769357702,18.294723601410944,497297,0.04356470974302541,0.04776211648066919,0.004197406737643777
2025-09-11T15:35:00-04:00,162.33,162.35,162.32,162.35,162.04002797440813,NaN,NaN,NaN,NaN,NaN,162.1472000000008,162.48710680929008,161.8072931907115,162.20162999604247,161.69631009615387,162.37416209602995,161.01845809627778,112,237.76666666666668,60.91661267328343,51.03874512342205,NaN,NaN,NaN,NaN,0.1167068514297509,19.388389499924273,497185,0.04476823473720676,0.06015770015915223,0.015389465421945466
2025-09-11T15:40:00-04:00,162.33,162.37,162.32,162.33,162.04002797440813,NaN,NaN,NaN,NaN,NaN,162.15260000000077,162.49536078981134,161.8098392101902,162.20162999604247,161.70515611187014,162.38249254711562,161.02781967662466,342,248.8,59.79475168689108,52.397029110432506,NaN,NaN,NaN,NaN,0.11194207632762665,20.493787687039024,496843,0.04175909995146996,0.06758834036128292,0.025829240409812958
2025-09-11T15:45:00-04:00,162.37,162.4,162.31,162.31,162.04002797440813,NaN,NaN,NaN,NaN,NaN,162.1533000000008,162.4971988790228,161.8094011209788,162.20162999604247,161.7243773136422,162.4001931225135,161.0485615047709,777,256.1666666666667,58.631906239471434,53.47710820352946,NaN,NaN,NaN,NaN,0.11037478516136785,21.65839465777757,496066,0.036172118010500645,0.07104438792293877,0.03487226991243812
2025-09-11T15:50:00-04:00,162.29,162.32,162.15,162.32,162.04002797440813,NaN,NaN,NaN,NaN,NaN,162.15770000000077,162.50437685100067,161.81102314900087,162.20162999604247,161.7509137892709,162.42012006162696,161.08170751691483,1329,292.76666666666665,59.060607745515746,54.253530165444474,NaN,NaN,NaN,NaN,0.11463372907841211,21.31601982665,497395,0.031094356579924265,0.07374021563734345,0.04264585905741919
2025-09-11T15:55:00-04:00,162.17,162.27,161.99,161.99,NaN,NaN,NaN,162.53686704050497,162.53686704050497,162.53686704050497,162.1559000000008,162.505097306664,161.8067026933376,162.20162999604247,161.7628923371784,162.42284529133204,161.1029393830248,1009,319.8333333333333,43.16385690088587,53.73643548910399,NaN,NaN,NaN,NaN,0.13001703414423868,19.86587423863136,496386,0.004833073318442918,0.04868720070547283,0.043854127387029915
2025-09-12T09:30:00-04:00,162.61,162.8,162.37,162.71,162.08617237042708,162.08617237042708,162.08617237042708,NaN,NaN,NaN,162.1685000000008,162.54982007421518,161.7871799257864,162.20162999604247,162.62666666666667,162.62666666666667,162.62666666666667,4545,466.1,65.18314378141719,55.30353906868131,NaN,NaN,NaN,NaN,0.17858724599107895,20.82483962505445,500931,0.03366856028646229,0.08593982774510778,0.052271267458645486
2025-09-12T09:35:00-04:00,162.325,162.365,162.215,162.25,162.08617237042708,NaN,NaN,NaN,NaN,NaN,162.1713000000008,162.55291661255617,161.78968338744542,162.20162999604247,162.3778272390037,162.53648643013216,162.21916804787523,11180,833.9333333333333,51.4648679196065,55.602723236813326,NaN,NaN,NaN,NaN,0.2011881569917165,20.82859571490967,489751,0.020144450793103744,0.07745183095002517,0.057307380156921425
2025-09-12T09:40:00-04:00,162.38,162.67,162.38,162.67,162.08617237042708,NaN,NaN,NaN,NaN,NaN,162.17970000000076,162.5855936301817,161.77380636981982,162.20162999604247,162.38502429662296,162.54502848347516,162.22502010977075,601,844.0666666666667,59.786559287468094,56.76091464582903,NaN,NaN,NaN,NaN,0.21681757434945012,21.763638559202665,490352,0.03689275392804868,0.10342332256698228,0.0665305686389336
2025-09-12T09:45:00-04:00,162.615,162.715,162.42,162.68,162.08617237042708,NaN,NaN,NaN,NaN,NaN,162.18330000000077,162.6034362148441,161.76316378515745,162.20162999604247,162.4304096580781,162.5984665536154,162.26235276254081,4244,981.2,59.96257721210296,57.67679213352078,NaN,NaN,NaN,NaN,0.22240203332449052,22.752355458842548,494596,0.04548791688464879,0.12339046474474458,0.07790254786009579
2025-09-12T09:50:00-04:00,162.72,162.72,162.72,162.72,162.08617237042708,NaN,NaN,NaN,NaN,NaN,162.18830000000077,162.6274838328479,161.74911616715363,162.16111455797375,162.4304378119126,162.59851079203457,162.26236483179065,2,966.5666666666667,60.70351884824753,58.37690322141551,NaN,NaN,NaN,NaN,0.2093733166584549,23.684453437620608,494598,0.05033313063571192,0.1408189611547357,0.09048583051902377
2025-09-12T09:55:00-04:00,162.5,162.79,162.4,162.4,162.08617237042708,NaN,NaN,NaN,NaN,NaN,162.1855000000008,162.61740392334332,161.75359607665825,162.16111455797375,162.434867936213,162.60043673039698,162.26929914202904,958,997.5333333333333,52.35597336051996,58.18040143932473,NaN,NaN,NaN,NaN,0.22227522261142144,22.867540439881733,493640,0.02948487640173146,0.1273419260211881,0.09785704961945664
2025-09-12T10:00:00-04:00,162.31,162.34,162.21,162.21,162.08617237042708,NaN,NaN,NaN,NaN,NaN,162.18150000000077,162.60869199316693,161.7543080068346,162.16111455797375,162.4329739087803,162.5987063982651,162.2672414192955,227,977.9333333333333,48.124429672092226,57.34476910947958,NaN,NaN,NaN,NaN,0.21996984956774832,21.308552098773756,493413,0.0018544484357731067,0.10017511016417302,0.09832066172839991
2025-09-12T10:05:00-04:00,162.5,162.54,162.48,162.51,162.08617237042708,NaN,NaN,NaN,NaN,NaN,162.18650000000076,162.62300085799063,161.7499991420109,162.08629065368257,162.43444629788257,162.5989256377931,162.26996695797206,424,981.4,54.39233928908748,56.824131938794544,NaN,NaN,NaN,NaN,0.22782914602719373,20.579533956156855,493837,0.002687946665805463,0.10168059506065674,0.09899264839485128
2025-09-12T10:10:00-04:00,162.54,162.54,162.41,162.41,162.08617237042708,NaN,NaN,NaN,NaN,NaN,162.18950000000078,162.63002355103117,161.74897644897038,162.08629065368257,162.4346317872714,162.5983120564017,162.2709515181411,220,983.2666666666667,52.13123156036982,56.119455441211414,NaN,NaN,NaN,NaN,0.22084134988239384,19.609709697504314,493617,-0.004214802858140618,0.0937241448221755,0.09793894768031612
2025-09-12T10:15:00-04:00,162.36,162.36,162.36,162.36,162.08617237042708,NaN,NaN,NaN,NaN,NaN,162.1942000000008,162.63687983802583,161.75152016197575,162.08629065368257,162.4343001051805,162.59769168291865,162.27090852744237,100,982.7,50.9898729106047,55.410402601020074,NaN,NaN,NaN,NaN,0.2086383963193645,18.49817142176338,493517,-0.012404139482803028,0.08243377332681234,0.09483791280961537
2025-09-12T10:20:00-04:00,162.46,162.76,162.46,162.76,162.08617237042708,NaN,NaN,NaN,NaN,NaN,162.20880000000076,162.6763106833286,161.74128931667292,162.12984952918794,162.43968533541567,162.604749757391,162.27462091344034,550,984.5333333333333,58.76736999340682,55.33701819434263,NaN,NaN,NaN,NaN,0.22230708229655113,18.7828628018696,494067,0.007775634842170948,0.10455745636232905,0.0967818215201581
2025-09-12T10:25:00-04:00,162.8,162.88,162.76,162.76,162.22105373897585,NaN,NaN,NaN,NaN,NaN,162.22440000000077,162.7119556983708,161.73684430163075,162.31587962335036,162.44601230305872,162.61632818505217,162.27569642106528,412,989.0666666666667,58.76736999340682,55.34669417676658,NaN,NaN,NaN,NaN,0.2149994335610835,19.370828417091836,494067,0.019133973422045286,0.1206992882977147,0.10156531487566942
2025-09-12T10:30:00-04:00,162.66,162.66,162.6,162.6,162.22105373897585,NaN,NaN,NaN,NaN,NaN,162.23820000000077,162.72843161772906,161.7479683822725,162.31587962335036,162.44604195963126,162.61635847166355,162.27572544759897,4,967.1666666666666,54.73769611189381,55.037914774365014,NaN,NaN,NaN,NaN,0.21107090259243444,19.21436044416593,494063,0.014113347692706696,0.11920699949155278,0.10509365179884608
2025-09-12T10:35:00-04:00,162.52,162.52,162.45,162.45,162.22105373897585,NaN,NaN,NaN,NaN,NaN,162.24440000000078,162.7373407256424,161.75145927435915,162.31587962335036,162.44627258771,162.615886334457,162.27665884096302,200,968.8333333333334,51.19360164253194,55.61146797019688,NaN,NaN,NaN,NaN,0.2067086952644038,18.4622244393569,493863,-0.0003040965914976601,0.10471353105947401,0.10501762765097167
2025-09-12T10:40:00-04:00,162.35,162.35,162.33,162.33,162.22105373897585,NaN,NaN,NaN,NaN,NaN,162.25100000000077,162.73949155470314,161.7625084452984,162.31587962335036,162.44578387246034,162.61517653684865,162.27639120807203,106,965.2,48.48880318125749,54.419015070185466,NaN,NaN,NaN,NaN,0.20051521703123037,17.307406895560778,493757,-0.017940275434016245,0.08259228335845137,0.10053255879246761
2025-09-12T10:45:00-04:00,162.5,162.61,162.5,162.6,162.22105373897585,NaN,NaN,NaN,NaN,NaN,162.2626000000008,162.7561189550602,161.76908104494137,162.31587962335036,162.45180002401634,162.61917760663738,162.2844224413953,1210,1001,54.3349577215551,54.62402148461037,NaN,NaN,NaN,NaN,0.2061927015289997,17.076954233308868,494967,-0.011739598697557987,0.08585806042052013,0.09759765911807812
2025-09-12T10:50:00-04:00,162.73,162.8,162.73,162.8,162.22105373897585,NaN,NaN,NaN,NaN,NaN,162.2756000000008,162.79035679597578,161.7608432040258,162.31587962335036,162.45955549477742,162.63219905674197,162.28691193281287,611,1021.1333333333333,58.1260431195383,54.505413186901094,NaN,NaN,NaN,NaN,0.20575036570550095,17.395067035430216,495578,0.0046360280513807195,0.10339269418230401,0.09875666613092329
2025-09-12T10:55:00-04:00,162.84,162.89,162.84,162.89,162.29032835558326,NaN,NaN,NaN,NaN,NaN,162.2920000000008,162.83118085925355,161.75281914074804,162.43986482798354,162.46640806916426,162.6455746712779,162.28724146705062,431,1024.2,59.74557867994305,54.48991329174682,NaN,NaN,NaN,NaN,0.19748248244082053,17.92786068412772,496009,0.01950016946732472,0.12313187796507918,0.10363170849775447
2025-09-12T11:00:00-04:00,162.95,162.95,162.95,162.95,162.29032835558326,NaN,NaN,NaN,NaN,NaN,162.3062000000008,162.87569999032095,161.73670000968067,162.55989186238685,162.46659381601688,162.64597645921856,162.2872111728152,10,1021.1666666666666,60.83315197227878,54.49917280060619,NaN,NaN,NaN,NaN,0.18766230512361923,18.581004624453993,496019,0.030678763558822403,0.14198016294628246,0.11130139938746006
2025-09-12T11:05:00-04:00,162.55,162.55,162.535,162.535,162.29032835558326,NaN,NaN,NaN,NaN,NaN,162.3131000000008,162.8851555558869,161.74104444411466,162.55989186238685,162.46688308210267,162.64597099639187,162.28779516781347,103,1023.5666666666667,50.64172559300997,54.376726531498335,NaN,NaN,NaN,NaN,0.203900711900503,17.551799525615177,495916,0.008578014193037858,0.12202391712875738,0.11344590293571952
2025-09-12T11:10:00-04:00,162.53,162.53,162.47,162.47,162.29032835558326,NaN,NaN,NaN,NaN,NaN,162.3169000000008,162.8905475912948,161.7432524087068,162.55989186238685,162.4670760300478,162.64542739005347,162.28872467004211,220,1030.8666666666666,49.2500086742542,54.45712503165276,NaN,NaN,NaN,NaN,0.19397923247903834,16.376601240625646,495696,-0.010906393815545784,0.09981291066628728,0.11071930448183306
2025-09-12T11:15:00-04:00,162.59,162.59,162.59,162.59,162.29032835558326,NaN,NaN,NaN,NaN,NaN,162.3197000000008,162.89727219373614,161.74212780626547,162.55989186238685,162.46845937429663,162.6462777372868,162.29064101130646,300,1040.8,51.8792323297487,54.27761739169999,NaN,NaN,NaN,NaN,0.18869500158767877,15.486610937544953,495996,-0.015898399200239027,0.09084630548153427,0.1067447046817733
2025-09-12T11:20:00-04:00,162.41,162.41,162.41,162.41,162.29032835558326,NaN,NaN,NaN,NaN,NaN,162.3215000000008,162.89962541803865,161.74337458196297,162.55989186238685,162.46824089991776,162.64576252240192,162.2907192774336,100,1039.2333333333333,47.87281260939082,53.9734446094872,NaN,NaN,NaN,NaN,0.1880739300457022,14.726289506676995,495896,-0.03065422169120209,0.06842692756777069,0.09908114925897278
2025-09-12T11:25:00-04:00,162.51,162.51,162.51,162.51,162.29032835558326,NaN,NaN,NaN,NaN,NaN,162.32870000000082,162.9070694657843,161.75033053421734,162.55989186238685,162.46824246048055,162.64576094944084,162.29072397152026,1,1031.6666666666667,50.174907372016634,53.915232785302344,NaN,NaN,NaN,NaN,0.18178293504243734,13.688059952686865,495897,-0.032817477949101864,0.058059301822595444,0.09087677977169731
2025-09-12T11:30:00-04:00,162.49,162.49,162.49,162.49,162.29032835558326,NaN,NaN,NaN,NaN,NaN,162.3351000000008,162.91338536119832,161.7568146388033,162.55989186238685,162.46840387254719,162.64527251458048,162.2915352305139,200,1017.6,49.702138732339066,53.26771626665465,NaN,NaN,NaN,NaN,0.17022701111083335,12.769934308277012,495697,-0.03455787817061354,0.04767943205843039,0.08223731022904393
2025-09-12T11:35:00-04:00,162.51,162.51,162.41,162.49,162.29032835558326,NaN,NaN,NaN,NaN,NaN,162.34240000000082,162.91910526176534,161.7656947382363,162.55989186238685,162.46841053486997,162.64490969123204,162.2919113785079,113,1017.6333333333333,49.70213873233907,52.620199748006954,NaN,NaN,NaN,NaN,0.1652107960314877,12.216475222480806,495697,-0.034586888094040466,0.039003700111493345,0.07359058820553381
2025-09-12T11:50:00-04:00,162.1,162.1,162.1,162.1,NaN,NaN,NaN,162.9754269498468,162.9754269498468,162.9754269498468,162.34080000000083,162.91973819958875,161.7618618004129,162.55989186238685,162.46705468865005,162.64463558473997,162.28947379256013,100,1009.5666666666667,40.971468420008875,51.636897770015175,NaN,NaN,NaN,NaN,0.18126716774352536,12.718875595465667,495597,-0.05835176936037699,0.0006508765050625698,0.05900264586543956
2025-09-12T11:55:00-04:00,162.16,162.16,162.14,162.16,NaN,NaN,NaN,162.67858116711247,NaN,NaN,162.34080000000083,162.9197381996013,161.76186180040034,162.55989186238685,162.46250338507662,162.64273825596504,162.2822685141882,400,997,42.640816114486945,51.02598451801197,NaN,NaN,NaN,NaN,0.17260522719041657,12.927468875875906,495997,-0.06689709639493255,-0.02461872462822612,0.04227837176670642
2025-09-12T12:00:00-04:00,162,162,161.67,161.74,NaN,NaN,NaN,162.40637293224373,NaN,NaN,162.3334000000008,162.93303802329137,161.73376197671024,162.20248791389884,162.42718383505527,162.65691877427224,162.1974488958383,1561,1004.7333333333333,35.14767164599455,50.07304655120747,NaN,NaN,NaN,NaN,0.19527628239110176,14.34720344324924,494436,-0.09593514814304782,-0.07764056341210335,0.018294584730944467
2025-09-12T12:05:00-04:00,161.76,161.84,161.71,161.84,NaN,NaN,NaN,162.33812870805085,NaN,NaN,162.3284000000008,162.94012032742418,161.71667967257744,162.20248791389884,162.4249409994185,162.65731896588562,162.1925630329514,104,974.5666666666667,37.943812724155585,48.90225047996465,NaN,NaN,NaN,NaN,0.19061369079173704,15.665528398667334,494540,-0.10289157928232759,-0.11031988937196502,-0.007428310089637433
2025-09-12T12:10:00-04:00,161.96,162.03,161.96,162.03,NaN,NaN,NaN,162.33812870805085,NaN,NaN,162.32800000000083,162.94047367204772,161.71552632795394,162.20248791389884,162.42320287929877,162.65665333807056,162.189752420527,122,827.1333333333333,42.974644470356196,47.82000771930878,NaN,NaN,NaN,NaN,0.19056985573518423,16.063593093593813,494662,-0.08966491033520405,-0.1195094480086425,-0.029844537673438448
2025-09-12T12:15:00-04:00,162.12,162.27,162.12,162.27,NaN,NaN,NaN,162.33812870805085,NaN,NaN,162.33640000000082,162.9337542993538,161.73904570064784,162.20248791389884,162.42139873517428,162.65459092343457,162.188206546914,263,463.23333333333335,48.63876499369786,47.026663884576976,NaN,NaN,NaN,NaN,0.19410058032552888,15.515991923559437,494925,-0.06108598144893625,-0.10620201448460875,-0.045116033035672506
2025-09-12T12:20:00-04:00,162.2,162.29,162.2,162.29,NaN,NaN,NaN,162.33812870805085,NaN,NaN,162.34490000000085,162.92708378448881,161.76271621551288,162.20248791389884,162.41830447115436,162.65030858851517,162.18630035379354,579,462.5,49.09254909161665,46.18804939310111,NaN,NaN,NaN,NaN,0.18666482458799136,14.934601022163854,495504,-0.03828336686385368,-0.09297024161548961,-0.05468687475163593
2025-09-12T12:25:00-04:00,162.3,162.31,162.17,162.17,NaN,NaN,NaN,162.33812870805085,NaN,NaN,162.34990000000084,162.92160093485654,161.77819906514515,162.20248791389884,162.41683309776593,162.6486253677034,162.18504082782846,222,328.43333333333334,46.441279302858646,45.888017515233166,NaN,NaN,NaN,NaN,0.1833316228317073,14.493861172392878,495282,-0.02914380231054768,-0.09111662763982054,-0.061972825329272854
2025-09-12T12:30:00-04:00,162.31,162.31,162.31,162.31,NaN,NaN,NaN,162.33812870805085,NaN,NaN,162.35570000000084,162.91972840258828,161.7916715974134,162.20248791389884,162.41648308925508,162.64797585994071,162.18499031856945,100,331.7,49.844487256674974,45.930480271120366,NaN,NaN,NaN,NaN,0.18023650691515786,14.084602740462685,495382,-0.012388066682926163,-0.07745790868293057,-0.0650698420000044
2025-09-12T12:35:00-04:00,162.2,162.24,162.15,162.205,NaN,NaN,NaN,162.33812870805085,NaN,NaN,162.35840000000084,162.91820868064747,161.79859131935422,161.88904291927093,162.41325118886232,162.64452931904322,162.18197305868142,459,315.06666666666666,47.41124367143374,45.61133822409787,NaN,NaN,NaN,NaN,0.17879104213550348,14.257286824754054,494923,-0.007344118650310899,-0.07424999031289303,-0.06690587166258213
2025-09-12T12:40:00-04:00,162.11,162.11,162.11,162.11,NaN,NaN,NaN,162.33812870805085,NaN,NaN,162.36280000000085,162.9111544829047,161.814445517097,161.88904291927093,162.41227553996953,162.6438190488307,162.18073203110836,100,310.8333333333333,45.258522339887634,45.42460320484765,NaN,NaN,NaN,NaN,0.17280596769725315,14.550781887141223,494823,-0.009250388907709503,-0.07846885779721902,-0.06921846888950951
2025-09-12T12:45:00-04:00,162.2,162.2,162.2,162.2,NaN,NaN,NaN,162.33812870805085,NaN,NaN,162.36720000000085,162.90665587300427,161.82774412699743,161.88904291927093,162.4102395670692,162.64159693655546,162.17888219758294,301,306.73333333333335,47.68211822397906,45.24654683713068,NaN,NaN,NaN,NaN,0.16689125571887614,14.389435359268063,495124,-0.0035856401905506458,-0.07370051912769782,-0.07011487893714717
2025-09-12T12:50:00-04:00,162.2,162.33,162.2,162.33,NaN,NaN,NaN,162.33812870805085,NaN,NaN,162.37620000000084,162.8975542355721,161.85484576442957,161.9852159797334,162.41011369303408,162.64138679613234,162.17884058993582,32,300.46666666666664,51.053085497717035,45.343043034657676,NaN,NaN,NaN,NaN,0.1642561660246724,13.646662090933855,495156,0.009088400008545147,-0.05875437892646573,-0.06784277893501088
2025-09-12T12:55:00-04:00,162.28,162.39,162.28,162.39,161.8308302768836,161.8308302768836,161.8308302768836,NaN,NaN,NaN,162.38480000000084,162.89241386796192,161.87718613203975,162.0591727837867,162.4096885399553,162.64014615533821,162.1792309245724,237,305.03333333333336,52.57199474081798,45.54803274954902,NaN,NaN,NaN,NaN,0.1603807255943376,12.693683603816499,495393,0.02100338341662783,-0.04158854966422609,-0.06259193308085392
2025-09-12T13:00:00-04:00,162.34,162.34,162.34,162.34,161.8308302768836,NaN,NaN,NaN,NaN,NaN,162.39060000000086,162.88932894333237,161.89187105666934,162.0591727837867,162.4096863383144,162.64014064616632,162.1792320304625,1,286.73333333333335,51.14758455330497,46.27489818764161,NaN,NaN,NaN,NaN,0.1524963880518837,11.808775008636097,495392,0.0247501876353462,-0.031654198536671174,-0.05640438617201737
2025-09-12T13:10:00-04:00,162.27,162.31,162.27,162.31,161.8308302768836,NaN,NaN,NaN,NaN,NaN,162.39360000000084,162.8885344996687,161.89866550033298,162.0591727837867,162.40897317971576,162.63887350438497,162.17907285504654,201,279.7,50.26754095213497,46.81966424747361,NaN,NaN,NaN,NaN,0.14660378890532008,11.312939740332494,495191,0.024400864305935778,-0.025903305789597653,-0.05030417009553343
2025-09-12T13:20:00-04:00,162.42,162.54,162.42,162.54,161.99481538262765,NaN,NaN,NaN,NaN,NaN,162.39840000000083,162.8942646579116,161.90253534209006,162.2116164652988,162.40970452375018,162.63882358877677,162.18058545872358,258,288.1666666666667,56.453706283287886,48.34152386442314,NaN,NaN,NaN,NaN,0.15256066112636793,11.201081902189479,495449,0.03803945777774843,-0.0027548478733478987,-0.040794305651096326
2025-09-12T13:35:00-04:00,162.37,162.48,162.37,162.48,161.99481538262765,NaN,NaN,NaN,NaN,NaN,162.40080000000086,162.89705944719196,161.90454055280975,162.2116164652988,162.4098130845956,162.6385699824686,162.18105618672263,104,284.96666666666664,54.5475227272656,49.527503150359564,NaN,NaN,NaN,NaN,0.15380632818876933,10.849540940729783,495345,0.04113662677711352,0.010626477820295577,-0.030510148956817945
2025-09-12T13:40:00-04:00,162.54,162.6,162.52,162.6,162.0794288920223,NaN,NaN,NaN,NaN,NaN,162.40540000000087,162.90468685034014,161.9061131496616,162.26183453779123,162.41040479798758,162.638958435705,162.18185116027016,117,285.3333333333333,57.6289780625893,50.5742412640905,NaN,NaN,NaN,NaN,0.15139159046100042,11.028499159998436,495462,0.04885769721534807,0.030561972562367146,-0.018295724652980926
2025-09-12T13:45:00-04:00,162.76,162.86,162.76,162.86,162.31581848783946,NaN,NaN,NaN,NaN,NaN,162.41560000000084,162.9305354900851,161.90066450991657,162.459467630233,162.41676884422105,162.6492484108128,162.18428927762932,502,261.73333333333335,63.416128442710566,51.62976722473427,NaN,NaN,NaN,NaN,0.1591493339995018,12.121604996759563,495964,0.06789530458439225,0.06657340607750939,-0.0013218985068828605
2025-09-12T14:00:00-04:00,162.73,162.73,162.68,162.68,162.31581848783946,NaN,NaN,NaN,NaN,NaN,162.42260000000087,162.9421853721206,161.90301462788113,162.459467630233,162.41931137333006,162.65225124589483,162.1863715007653,301,251.4,57.55522672731753,52.23424419871291,NaN,NaN,NaN,NaN,0.16063866728525217,12.709971467385314,495663,0.06479339601475745,0.07966984651156395,0.014876450496806502
2025-09-12T14:05:00-04:00,162.73,162.73,162.73,162.73,162.31581848783946,NaN,NaN,NaN,NaN,NaN,162.43100000000086,162.95657777627417,161.90542222372756,162.459467630233,162.42383874581174,162.6580531691316,162.18962432249188,490,253.36666666666667,58.69712439433923,53.10966170524723,NaN,NaN,NaN,NaN,0.15273590533630438,13.2563117615378,496153,0.06250786036353634,0.09301127595122693,0.03050341558769059
2025-09-12T14:15:00-04:00,162.8,162.8,162.8,162.8,162.31581848783946,NaN,NaN,NaN,NaN,NaN,162.44060000000084,162.97517512001795,161.90602487998373,162.4823274266793,162.4238611177193,162.65808654012736,162.18963569531124,2,253.1,60.30713285118924,53.85699353342682,NaN,NaN,NaN,NaN,0.14682619781228418,14.024081687028431,496155,0.061987708215870414,0.1079880508575286,0.04600034264165819
2025-09-12T14:20:00-04:00,162.85,162.9,162.85,162.9,162.41441843681062,NaN,NaN,NaN,NaN,NaN,162.45880000000088,162.9927346765983,161.92486532340345,162.59586194134343,162.42412057538556,162.6585341313204,162.1897070194507,19,250.3,62.55284134680432,54.938536224524725,NaN,NaN,NaN,NaN,0.14348146939712064,15.094203442693352,496174,0.06437457887080048,0.12646856623015879,0.06209398735935831
2025-09-12T14:25:00-04:00,162.87,162.9,162.87,162.9,162.4412630533192,NaN,NaN,NaN,NaN,NaN,162.46260000000086,163.0062478261663,161.91895217383544,162.64168955307474,162.42578994906415,162.66143322893163,162.19014666919668,121,247,62.55284134680432,56.173844725018775,NaN,NaN,NaN,NaN,0.13537565015446926,16.087887930096496,496174,0.06192990232753133,0.13950636526877247,0.07757646294124114
2025-09-12T14:30:00-04:00,162.94,163.08,162.94,163.06,162.5618874599865,NaN,NaN,NaN,NaN,NaN,162.47880000000086,163.04398867549313,161.9136113245086,162.7833516424598,162.4413383816529,162.69271825949247,162.18995850381336,897,266.9,66.11073090664983,57.4901742023524,NaN,NaN,NaN,NaN,0.1385631037148648,17.623060174132068,497071,0.06665473502339149,0.1608948817204805,0.09424014669708901
2025-09-12T14:40:00-04:00,163.1,163.1,162.99,162.99,162.60225621180533,NaN,NaN,NaN,NaN,NaN,162.48520000000087,163.0659373234786,161.90446267652314,162.80768131396783,162.44464598512224,162.69912554983745,162.19016642040702,197,270.1333333333333,63.27810140976504,58.363389624641535,NaN,NaN,NaN,NaN,0.1365228820209448,19.112094381115195,496874,0.06079561137445372,0.17023466091515616,0.10943904954070244
2025-09-12T14:45:00-04:00,163.06,163.16,163.06,163.16,162.66419911126874,NaN,NaN,NaN,NaN,NaN,162.49480000000085,163.10330623572332,161.88629376427838,162.84114505117427,162.44950202210066,162.7094771950792,162.18952684912213,250,278.43333333333334,66.97851279296702,59.39242662836647,NaN,NaN,NaN,NaN,0.13891410473373358,20.688153995711193,497124,0.06378748769756853,0.18917340916266312,0.12538592146509459
2025-09-12T14:50:00-04:00,163.13,163.25,163.13,163.25,162.7480991516656,NaN,NaN,NaN,NaN,NaN,162.50540000000086,163.14680420866966,161.86399579133206,162.9349160409394,162.4539592004303,162.7195919924934,162.18832640836717,207,278.6666666666667,68.77258214546578,60.65135502780653,NaN,NaN,NaN,NaN,0.13756309725275292,22.4304650664025,497331,0.06691936253732922,0.2090351246367561,0.1421157620994269
2025-09-12T14:55:00-04:00,163.33,163.33,163.33,163.33,162.7480991516656,NaN,NaN,NaN,NaN,NaN,162.52400000000085,163.20482596814557,161.84317403185614,163.03793283275155,162.45948020707306,162.73319947170702,162.1857609424391,224,282.3666666666667,70.31638401952141,62.08341524690555,NaN,NaN,NaN,NaN,0.13345144744898577,24.282639295491894,497555,0.0691841082790651,0.22859589744825826,0.15941178916919316
2025-09-12T15:00:00-04:00,163.27,163.27,163.21,163.21,162.81058207827382,NaN,NaN,NaN,NaN,NaN,162.54400000000086,163.24520182464718,161.84279817535455,163.03793283275155,162.46381308751114,162.74277674159572,162.18484943342656,201,285.73333333333335,65.11618039915834,62.70216339803916,NaN,NaN,NaN,NaN,0.13249062977405854,25.069985031697644,497354,0.0578654152462984,0.23174355822706616,0.17387814298076776
2025-09-12T15:05:00-04:00,163.27,163.27,163.27,163.27,162.81058207827382,NaN,NaN,NaN,NaN,NaN,162.55920000000089,163.28915440876622,161.82924559123555,163.03793283275155,162.46394839160834,162.74308406034731,162.18481272286937,6,272.6,66.45211042962949,63.55249109106516,NaN,NaN,NaN,NaN,0.12731272764734022,25.801091786745843,497360,0.0499815230375483,0.23635504677770314,0.18637352374015484
2025-09-12T15:10:00-04:00,163.24,163.24,163.09,163.09,162.81058207827382,NaN,NaN,NaN,NaN,NaN,162.57280000000088,163.3163406101095,161.82925938989226,163.03793283275155,162.47594776898558,162.7666400034028,162.18525553456834,646,242.1,59.13544062937922,63.660095560121576,NaN,NaN,NaN,NaN,0.13107610424395927,25.196883299007407,496714,0.02923362678174335,0.22291555721733403,0.19368193043559068
2025-09-12T15:15:00-04:00,163.23,163.25,163.23,163.25,162.8138148597759,NaN,NaN,NaN,NaN,NaN,162.59060000000088,163.3552244561133,161.82597554388846,163.03793283275155,162.48116209578384,162.77764481119524,162.18467938037244,249,246.93333333333334,63.03184981522614,63.63264708672983,NaN,NaN,NaN,NaN,0.13314209679796193,24.682359347543677,496963,0.023141837361638468,0.22260922713763875,0.1994673897760003
2025-09-12T15:20:00-04:00,163.27,163.38,163.27,163.38,162.90045963887698,NaN,NaN,NaN,NaN,NaN,162.60300000000086,163.3977276256147,161.80827237438703,163.05775943063603,162.4850967049683,162.78655594969882,162.18363746023778,168,248.46666666666667,65.87861981766568,64.22717516461185,NaN,NaN,NaN,NaN,0.13291766131239288,24.78661647515196,497131,0.024588278594799756,0.23020273801949998,0.20561445942470022
2025-09-12T15:25:00-04:00,163.28,163.28,163.25,163.25,162.90045963887698,NaN,NaN,NaN,NaN,NaN,162.61280000000087,163.42687901266922,161.79872098733253,163.05775943063603,162.49913061453105,162.81521573831017,162.18304549075194,679,262.3333333333333,60.833707422941664,64.37978823808345,NaN,NaN,NaN,NaN,0.13270925693293592,24.73749941229561,496452,0.014035077668865997,0.22315830651078272,0.20912322884191673
2025-09-12T15:30:00-04:00,163.25,163.25,163.1,163.1,162.90045963887698,NaN,NaN,NaN,NaN,NaN,162.6228000000009,163.44820937653432,161.79739062346746,163.05775943063603,162.5176825507877,162.8475200223524,162.187845079223,1100,279.7,55.547921829702155,64.03984459369151,NaN,NaN,NaN,NaN,0.1339443100091552,23.666474444167164,495352,-0.004794392317193391,0.203130238445425,0.20792463076261838
2025-09-12T15:35:00-04:00,163.18,163.2,163.05,163.05,162.90045963887698,NaN,NaN,NaN,NaN,NaN,162.6348000000009,163.467227677847,161.80237232215478,163.05775943063603,162.5295376199421,162.86619884260887,162.1928763972753,802,299.03333333333336,53.86773565403162,63.419479901350606,NaN,NaN,NaN,NaN,0.13509114500849964,22.359413424751835,494550,-0.02143150170961622,0.18113525362559812,0.20256675533521434
2025-09-12T15:40:00-04:00,163.05,163.24,163.01,163.24,162.90045963887698,NaN,NaN,NaN,NaN,NaN,162.65300000000087,163.49767745257392,161.80832254742782,163.05775943063603,162.5473172386568,162.8953313280359,162.1993031492777,1137,333.6,58.94910227440518,63.16206996760781,NaN,NaN,NaN,NaN,0.14187034893646525,21.14571390672332,495687,-0.020457251145366534,0.17699519140350617,0.1974524425488727
2025-09-12T15:45:00-04:00,163.38,163.38,163.27,163.27,162.90045963887698,NaN,NaN,NaN,NaN,NaN,162.6664000000009,163.52836992921115,161.80443007079063,163.05775943063603,162.55877612266715,162.91634589492583,162.20120635040848,621,339,59.70383266307938,62.70443437878135,NaN,NaN,NaN,NaN,0.14173675258385962,20.793554867600015,496308,-0.0186598131708538,0.17412767608530544,0.19278748925615924
2025-09-12T15:50:00-04:00,163.4,163.42,163.23,163.31,162.90045963887698,NaN,NaN,NaN,NaN,NaN,162.6766000000009,163.55653508787648,161.7966649121253,163.05775943063603,162.5675527238662,162.9322251007652,162.20288034696722,480,351.6666666666667,60.74026269145859,62.5231601846166,NaN,NaN,NaN,NaN,0.14518412739929806,20.46655004555695,496788,-0.01575993581724125,0.17308756948460768,0.18884750530184893
2025-09-12T15:55:00-04:00,163.34,163.34,163.15,163.22,162.90045963887698,NaN,NaN,NaN,NaN,NaN,162.68320000000088,163.57431785914528,161.79208214085648,163.05775943063603,162.60923859182844,162.9976401731295,162.2208370105274,2766,433.8333333333333,57.17686891997889,61.82304276511746,NaN,NaN,NaN,NaN,0.1483852611564909,19.57680211404917,494022,-0.0205814633959773,0.1631206760568773,0.1837021394528546
2025-09-15T09:30:00-04:00,164.8,165.05,164.4,164.97,164.0473789053053,NaN,NaN,NaN,NaN,NaN,162.72360000000089,163.8191474242886,161.62805257571318,163.80332471563818,164.8066666666667,164.8066666666667,164.8066666666667,11149,804.4,80.78368661169416,62.680978798419474,NaN,NaN,NaN,NaN,0.26850059964531386,22.81845186241585,505171,0.08748154518783074,0.293054070937643,0.20557252574981227
2025-09-15T09:35:00-04:00,164.74,165.06,164.74,165,164.2095435005187,NaN,NaN,NaN,NaN,NaN,162.77290000000087,164.0386868536588,161.50711314634296,163.90265977251053,164.80835929203545,164.82290350836303,164.79381507570787,151,801.5333333333333,80.9772839767002,63.44247165250368,NaN,NaN,NaN,NaN,0.2721791282420767,25.83827568722442,505322,0.15066778272224854,0.39390725415262295,0.24323947143037442
2025-09-15T09:40:00-04:00,165.09,165.3,165,165.3,164.45001879594966,NaN,NaN,NaN,NaN,NaN,162.82950000000088,164.27620694990335,161.3827930500984,164.22412781800844,164.83015711181685,164.92105006724674,164.73926415638695,666,823.7,82.83916709869413,64.70839927389909,NaN,NaN,NaN,NaN,0.27416633336764346,28.869829689845744,505988,0.19930116946556803,0.49236593326233447,0.29306476379676644
2025-09-15T09:45:00-04:00,165.2,165.3,165.02,165.15,164.4536543052247,NaN,NaN,NaN,NaN,NaN,162.88070000000087,164.4645762700663,161.29682372993545,164.29930225440674,164.84115238633615,164.94816867864063,164.73413609403167,417,830.9,78.69187638619036,65.58266827079629,NaN,NaN,NaN,NaN,0.2745830238413833,31.684844120851256,505571,0.20709147237502995,0.5519291042655539,0.3448376318905239
2025-09-15T09:50:00-04:00,165.4,165.53,165.4,165.455,164.73894274589628,NaN,NaN,NaN,NaN,NaN,162.94160000000088,164.67545863290206,161.2077413670997,164.5394418035254,164.91242947343343,165.13443170887962,164.69042723798725,1607,875.8666666666667,80.79705896552004,67.12992672337778,NaN,NaN,NaN,NaN,0.2821128078527127,34.5073571345986,507178,0.21743877472922868,0.6166361003020597,0.39919732557283105
2025-09-15T09:55:00-04:00,165.43,165.57,165.425,165.57,164.7846726210828,NaN,NaN,NaN,NaN,NaN,163.00280000000086,164.88137942044136,161.12422057956036,164.70505344282032,164.9175679826116,165.14554489625272,164.68959106897046,119,876.3666666666667,81.53770865387895,68.45177378328155,NaN,NaN,NaN,NaN,0.2723190358632319,37.16312840925971,507297,0.21622538903427319,0.6694790618656725,0.45325367283139933
2025-09-15T10:00:00-04:00,165.6,165.69,165.41,165.47,164.83139204739723,NaN,NaN,NaN,NaN,NaN,163.06240000000088,165.05758945438043,161.06721054562132,164.85804275425625,164.9539300466356,165.2176692331304,164.6901908601408,901,902.5,78.69533652499518,69.3672535480908,NaN,NaN,NaN,NaN,0.27286767615871543,39.7341887146697,506396,0.19361597660070684,0.6952736435822828,0.501657666981576
2025-09-15T10:05:00-04:00,165.38,165.44,165.09,165.09,164.83139204739723,NaN,NaN,NaN,NaN,NaN,163.11440000000087,165.18143811258577,161.04736188741597,164.85804275425625,164.98046806988253,165.24172925689325,164.71920688287182,1761,944.4666666666667,68.87052739731543,69.94131211768892,NaN,NaN,NaN,NaN,0.28051998500452113,40.51684550444229,504635,0.14047093603325855,0.6772463370231492,0.5367754009898906
2025-09-15T10:10:00-04:00,165.11,165.15,165,165.11,164.83139204739723,NaN,NaN,NaN,NaN,NaN,163.17460000000085,165.2946055091728,161.0545944908289,164.85804275425625,164.98421877097115,165.24157253061668,164.72686501132563,614,954.9,69.08926104468186,70.90855063304463,NaN,NaN,NaN,NaN,0.27119712893277004,40.836600400855346,505249,0.09617961001896869,0.6569999135136015,0.5608203034946329
2025-09-15T10:15:00-04:00,165.11,165.12,164.82,164.82,NaN,NaN,NaN,165.70265103766476,165.70265103766476,165.70265103766476,163.22780000000085,165.3765988828416,161.07900111716012,164.85804275425625,164.98144770396462,165.23352574666006,164.72936966126917,784,964.7,62.25813038506922,71.50786454240446,NaN,NaN,NaN,NaN,0.2732544768661444,40.35357141983017,504465,0.039756756689420136,0.610516249356408,0.5707594926669879
2025-09-15T10:20:00-04:00,164.79,164.79,164.61,164.76,NaN,NaN,NaN,165.42798508140726,NaN,NaN,163.28820000000087,165.43609921525106,161.14030078475068,164.85804275425625,164.972565043244,165.22481077723455,164.72031930925345,639,985.9333333333333,60.91613107395853,71.64836659951541,NaN,NaN,NaN,NaN,0.2687362999471326,39.077237162641296,503826,-0.0067246747411509045,0.5623536492405492,0.5690783239817001
2025-09-15T10:25:00-04:00,164.62,164.65,164.54,164.65,NaN,NaN,NaN,165.3198948504342,NaN,NaN,163.34440000000086,165.48482392037508,161.20397607962664,164.85804275425625,164.96874785200774,165.22233903123922,164.71515667277626,202,992.0333333333333,58.429482701130645,71.55734160223335,NaN,NaN,NaN,NaN,0.2652551356651945,37.628764753322336,503624,-0.04771393837713789,0.5094359010102778,0.5571498393874157
2025-09-15T10:30:00-04:00,164.67,165,164.67,165,NaN,NaN,NaN,165.3198948504342,NaN,NaN,163.40380000000087,165.55980794035383,161.2477920596479,164.85804275425625,164.9675123837139,165.2192966563858,164.715728111042,303,998.1,63.53065580886153,71.75665539633357,NaN,NaN,NaN,NaN,0.27130834026053735,37.09260514667868,503927,-0.0536472176358489,0.4900908173426046,0.5437380349784535
2025-09-15T10:35:00-04:00,164.88,164.89,164.88,164.89,NaN,NaN,NaN,165.3198948504342,NaN,NaN,163.45620000000088,165.6267414621428,161.28565853785895,164.85804275425625,164.96708764700833,165.2182776540236,164.71589763999305,102,971.6,60.997253077326484,72.02953997900126,NaN,NaN,NaN,NaN,0.26050060167049927,36.594742654795276,503825,-0.06653090522659699,0.4605744034452073,0.5271053086718043
2025-09-15T10:40:00-04:00,164.96,165.02,164.96,165.02,NaN,NaN,NaN,165.3198948504342,NaN,NaN,163.51080000000087,165.69852974538833,161.3230702546134,164.85804275425625,164.96726803947683,165.21778050026666,164.716755578687,107,968.6,62.88112367173743,70.75078548329006,NaN,NaN,NaN,NaN,0.2511791301226082,36.415288414359416,503932,-0.06762771320821703,0.44257066716153304,0.5101983803697501
2025-09-15T10:45:00-04:00,164.95,164.95,164.85,164.85,NaN,NaN,NaN,165.3198948504342,NaN,NaN,163.56440000000086,165.7494232398955,161.37937676010623,164.85804275425625,164.96675525235042,165.2165869333764,164.71692357132446,120,964.2666666666667,58.87627206938514,69.1721417756247,NaN,NaN,NaN,NaN,0.2453806208281373,35.77837612550233,503812,-0.08027039882105613,0.4098603818434299,0.490130780664486
2025-09-15T10:55:00-04:00,164.98,164.98,164.98,164.98,NaN,NaN,NaN,165.3198948504342,NaN,NaN,163.61780000000087,165.8080859719385,161.42751402806323,164.584434203405,164.96675727496395,165.2165699328986,164.7169446170293,3,957.4666666666667,60.92571705864574,67.60689534419267,NaN,NaN,NaN,NaN,0.23713914791184146,35.26058214916207,503815,-0.08015881476021558,0.3899322622142165,0.4700910769744321
2025-09-15T11:00:00-04:00,164.99,165.02,164.89,164.89,NaN,NaN,NaN,165.3198948504342,NaN,NaN,163.67150000000086,165.85223771895792,161.4907622810438,164.5554462325012,164.96635885055161,165.21470461310972,164.7180130879935,237,957.9,58.74306634648838,66.1819803413568,NaN,NaN,NaN,NaN,0.22948635163242592,34.37661046580556,503578,-0.08591613886660943,0.3626959033911703,0.44861204225777973
2025-09-15T11:05:00-04:00,164.75,164.75,164.63,164.63,NaN,NaN,NaN,165.3198948504342,NaN,NaN,163.72190000000086,165.87222359399573,161.571576406006,164.5554462325012,164.96163564970635,165.2107744066027,164.71249689281,322,961.9333333333333,52.85240728865502,64.1859337930093,NaN,NaN,NaN,NaN,0.23166589794439485,32.50072067285096,503256,-0.10570335505887096,0.31648284843419106,0.422186203493062
2025-09-15T11:10:00-04:00,164.62,164.62,164.62,164.62,NaN,NaN,NaN,165.3198948504342,NaN,NaN,163.77030000000087,165.8901475508512,161.65045244915055,164.5554462325012,164.96144974853658,165.21064810451304,164.71225139256012,11,962.1,52.63379062686104,62.12136821965088,NaN,NaN,NaN,NaN,0.21583261951979457,30.720565652278815,503245,-0.1170516219545843,0.27587167604983165,0.39292329800441594
2025-09-15T11:15:00-04:00,164.57,164.59,164.57,164.59,NaN,NaN,NaN,165.20397086356695,NaN,NaN,163.81550000000087,165.90676205886896,161.72423794113277,164.5554462325012,164.96113203506,165.2104664947515,164.71179757536848,17,941.1333333333333,51.93968788644637,60.21025045975454,NaN,NaN,NaN,NaN,0.20398743241123865,28.867909875706815,503228,-0.12352519297083725,0.2385168067908694,0.36204199976170665
2025-09-15T11:20:00-04:00,164.53,164.53,164.47,164.47,NaN,NaN,NaN,165.1119721879503,NaN,NaN,163.85710000000086,165.91577927537932,161.7984207246224,164.5554462325012,164.9586995787645,165.20967127462563,164.70772788290338,105,936.3333333333334,49.147739819360126,58.80147991847202,NaN,NaN,NaN,NaN,0.1979883300961505,26.860900536870762,503123,-0.1320660946009119,0.1969593815105668,0.3290254761114787
2025-09-15T11:25:00-04:00,164.49,164.69,164.49,164.69,NaN,NaN,NaN,165.1119721879503,NaN,NaN,163.90410000000088,165.92911722433422,161.87908277566754,164.5554462325012,164.95656943697986,165.20815751265062,164.7049813613091,130,935.0666666666667,54.026827195094015,57.725591786358606,NaN,NaN,NaN,NaN,0.19956059223213968,25.489568260436542,503253,-0.11945601979039955,0.17970545137347926,0.2991614711638788
2025-09-15T11:30:00-04:00,164.76,164.76,164.76,164.76,NaN,NaN,NaN,165.1119721879503,NaN,NaN,163.9531000000009,165.93965570242446,161.96654429757731,164.5554462325012,164.95520556364227,165.2064497077272,164.70396141955734,143,917.2,55.49016424824452,57.24216563372827,NaN,NaN,NaN,NaN,0.19030626421555777,24.466351152454717,503396,-0.10355034880827352,0.1697235351535369,0.2732738839618104
2025-09-15T11:35:00-04:00,164.79,164.87,164.79,164.87,NaN,NaN,NaN,165.1119721879503,NaN,NaN,163.99970000000087,165.96062468974688,162.03877531025486,164.5554462325012,164.95495642912473,165.20597606099676,164.7039367972527,46,882.0666666666667,57.76520714177173,57.01709963857207,NaN,NaN,NaN,NaN,0.18457010248587605,23.898949744935607,503442,-0.08362414480410818,0.16874370295667518,0.25236784776078336
2025-09-15T11:40:00-04:00,164.94,165.09,164.94,165.09,NaN,NaN,NaN,165.1119721879503,NaN,NaN,164.05190000000087,165.987014352916,162.11678564708575,164.7179991149906,164.95600153014874,165.2056498861177,164.70635317417978,257,863.9,61.95372541555077,57.26883126103065,NaN,NaN,NaN,NaN,0.18710080945117055,24.057633417622878,503699,-0.05501197377141373,0.1836028805465162,0.23861485431792992
2025-09-15T11:45:00-04:00,165.1,165.19,165.1,165.19,164.5708817655626,164.5708817655626,164.5708817655626,NaN,NaN,NaN,164.10370000000086,166.01914126479764,162.18825873520407,164.84239929199248,164.9563909702668,165.2059598303661,164.70682211016748,40,827.3333333333334,63.715201550622204,57.28201309972784,NaN,NaN,NaN,NaN,0.18087932306180082,24.486160422189137,503739,-0.029988240407385264,0.20112955380869835,0.2311177942160836
2025-09-15T11:50:00-04:00,165.27,165.37,165.21,165.34,164.7174325944007,NaN,NaN,NaN,NaN,NaN,164.15330000000085,166.06578697744126,162.24081302256045,165.00191943359397,164.96110771065807,165.2122567023172,164.70995871899893,286,816.1666666666666,66.24008812151015,57.65650131716948,NaN,NaN,NaN,NaN,0.18081651427167267,25.35178171776283,504025,-0.005266223250414204,0.22453501515306584,0.22980123840348005
2025-09-15T11:55:00-04:00,165.39,165.41,165.39,165.39,164.8439129310188,NaN,NaN,NaN,NaN,NaN,164.20750000000086,166.10343275167492,162.3115672483268,165.08053554687518,164.96521119972638,165.21869105843328,164.7117313410195,202,806.9,67.06283603175085,57.955195057170435,NaN,NaN,NaN,NaN,0.1729010489665527,26.254800384695447,504227,0.011600951448862556,0.24430242771455823,0.23270147626569568
2025-09-15T12:00:00-04:00,165.39,165.39,165.17,165.17,164.8439129310188,NaN,NaN,NaN,NaN,NaN,164.2563000000009,166.1229834865157,162.3896165134861,165.08053554687518,164.97217942888324,165.22621032151267,164.7181485362538,551,733.0666666666667,60.120216306914244,58.044048216993936,NaN,NaN,NaN,NaN,0.17626525975465598,25.960957137135388,503676,0.005403447754093904,0.23945578595831307,0.23405233820421917
2025-09-15T12:05:00-04:00,165.24,165.365,165.24,165.365,164.8439129310188,NaN,NaN,NaN,NaN,NaN,164.30760000000086,166.1522281356662,162.46297186433551,165.08053554687518,164.9778505495161,165.23368015069732,164.72202094833486,361,373.46666666666664,63.706667491015736,58.24268753359179,NaN,NaN,NaN,NaN,0.1776034554864678,25.688102692972475,504037,0.0115463487974376,0.24848527420101618,0.23693892540357858
2025-09-15T12:10:00-04:00,165.38,165.5,165.38,165.5,164.88522235670223,NaN,NaN,NaN,NaN,NaN,164.35960000000085,166.1891013962499,162.5300986037518,165.1154142000001,164.99116901571833,165.25552671965673,164.72681131177993,635,389.6,65.98721027682248,58.76012638575852,NaN,NaN,NaN,NaN,0.17456035152314803,25.85506108209561,504672,0.02124657914040387,0.2634971493290834,0.24225057018867954
2025-09-15T12:15:00-04:00,165.49,165.49,165.38,165.43,164.88907588594304,NaN,NaN,NaN,NaN,NaN,164.41020000000088,166.21520965062464,162.60519034937712,165.1223313600001,164.99997271370708,165.26887553771382,164.73106988970034,467,382.96666666666664,63.750329856653075,59.5385494263298,NaN,NaN,NaN,NaN,0.17066318355720922,26.01009387199566,504205,0.019536926133737004,0.2666717278558508,0.2471348017221138
2025-09-15T12:20:00-04:00,165.38,165.39,165.31,165.39,164.88907588594304,NaN,NaN,NaN,NaN,NaN,164.45680000000087,166.24014826628652,162.6734517337152,165.1223313600001,165.0131413074742,165.2857210506316,164.7405615643168,882,398.46666666666664,62.447626386011926,60.239537694840585,NaN,NaN,NaN,NaN,0.1670443847316946,25.75649409933894,503323,0.012635403433351455,0.2629290560138031,0.25029365258045166
2025-09-15T12:25:00-04:00,165.26,165.26,165.25,165.26,164.88907588594304,NaN,NaN,NaN,NaN,NaN,164.50220000000084,166.2490762517469,162.75532374825477,165.1223313600001,165.0161066688314,165.28833512138573,164.7438782162771,300,354.9,58.27944521696562,60.69237750416339,NaN,NaN,NaN,NaN,0.16511264296514402,25.18352846915668,503023,-0.0029308817675759435,0.24663005037098173,0.24956093213855768
2025-09-15T12:30:00-04:00,165.33,165.45,165.33,165.45,164.88907588594304,NaN,NaN,NaN,NaN,NaN,164.54800000000085,166.27163917305612,162.8243608269456,165.1223313600001,165.0208609351191,165.29483888769727,164.7468829825409,301,360.96666666666664,62.24579419241311,61.62795281652432,NaN,NaN,NaN,NaN,0.1668903113247764,25.334730597422382,503324,-0.00268372935310629,0.2462062704471748,0.2488899998002811
2025-09-15T12:35:00-04:00,165.4,165.4,165.38,165.38,164.88907588594304,NaN,NaN,NaN,NaN,NaN,164.59060000000085,166.28891285659972,162.89228714340197,165.1223313600001,165.02159289792434,165.29578432555104,164.74740147029763,50,332.6,59.983235479420436,62.053410551119065,NaN,NaN,NaN,NaN,0.1599695748015776,25.475132573669107,503274,-0.00912445256700295,0.23748443409152742,0.24660888665853037
2025-09-15T12:40:00-04:00,165.62,165.67,165.62,165.67,165.1099176541623,NaN,NaN,NaN,NaN,NaN,164.63740000000087,166.3231001390761,162.95169986092563,165.25530634004483,165.0266339804412,165.30545338932774,164.74781457155467,201,280.6,65.56724620643118,62.77320211956097,NaN,NaN,NaN,NaN,0.1692574623157501,26.440587522829777,503475,0.0035757821420399905,0.25107861433608036,0.24750283219404037
2025-09-15T12:45:00-04:00,165.59,165.59,165.475,165.49,165.1099176541623,NaN,NaN,NaN,NaN,NaN,164.68300000000087,166.33479417570206,163.0312058242997,165.25530634004483,165.03171479647966,165.31351149306434,164.74991809989498,263,268.9,59.97326320080904,62.9309204094922,NaN,NaN,NaN,NaN,0.17109621500748173,26.492286892727833,503212,-0.0023950207595331563,0.24450905624462393,0.2469040770041571
2025-09-15T12:50:00-04:00,165.53,165.53,165.53,165.53,165.1099176541623,NaN,NaN,NaN,NaN,NaN,164.72820000000084,166.3461984669153,163.11020153308638,165.25530634004483,165.0336648794615,165.31662511923403,164.75070463968896,100,246.1,60.77416372818,62.84666600325143,NaN,NaN,NaN,NaN,0.16173219964980387,26.54029345049032,503312,-0.005710124186268595,0.23976642177132135,0.24547654595758994
2025-09-15T12:55:00-04:00,165.39,165.39,165.19,165.29,165.1099176541623,NaN,NaN,NaN,NaN,NaN,164.77220000000085,166.32806909440703,163.21633090559467,165.25530634004483,165.03938301128755,165.321718795122,164.7570472274531,583,244.23333333333332,53.81626815208357,62.13959933192724,NaN,NaN,NaN,NaN,0.17446561396053242,24.87797136891634,502729,-0.025042834772923767,0.21417300249143523,0.239215837264359
2025-09-15T13:00:00-04:00,165.15,165.3,165.11,165.3,165.1099176541623,NaN,NaN,NaN,NaN,NaN,164.81320000000085,166.31350764809858,163.31289235190312,165.25530634004483,165.0453278039609,165.32541518328665,164.76524042463515,812,264.56666666666666,54.052313803002455,61.269044023462406,NaN,NaN,NaN,NaN,0.17557521296335138,23.202834641502328,503541,-0.03739012493955876,0.19247818108991055,0.2298683060294693
2025-09-15T13:05:00-04:00,165.5,165.6,165.5,165.6,165.1099176541623,NaN,NaN,NaN,NaN,NaN,164.85760000000082,166.316447818987,163.39875218101463,165.25530634004483,165.04563716945447,165.32592911824523,164.7653452206637,16,255,60.5641584526858,60.80485276781491,NaN,NaN,NaN,NaN,0.1844626977516822,22.567224933341063,503557,-0.026119481398435535,0.19721895428142489,0.22333843567986042
2025-09-15T13:10:00-04:00,165.46,165.57,165.46,165.57,165.1099176541623,NaN,NaN,NaN,NaN,NaN,164.90400000000085,166.30166805748743,163.50633194251427,165.25530634004483,165.05102143241393,165.3343818268015,164.76766103802638,301,261.6333333333333,59.65369520573376,60.7715298320163,NaN,NaN,NaN,NaN,0.1812867907694182,21.799154600117635,503256,-0.021636697801270255,0.19629256342827262,0.21792926122954287
2025-09-15T13:15:00-04:00,165.56,165.56,165.345,165.345,165.1099176541623,NaN,NaN,NaN,NaN,NaN,164.94890000000083,166.25297712921733,163.64482287078434,165.25530634004483,165.05398788518212,165.33809626323435,164.7698795071299,223,265.5,53.19475197840189,60.02067872397246,NaN,NaN,NaN,NaN,0.1844091628573165,20.58129462009743,503033,-0.03403853827138631,0.17538108839030997,0.20941962666169628
2025-09-15T13:20:00-04:00,165.2,165.2,165.2,165.2,165.1099176541623,NaN,NaN,NaN,NaN,NaN,164.9919000000008,166.1792498047991,163.80455019520252,165.25530634004483,165.05404098628944,165.3381113402903,164.76997063228856,10,261.8333333333333,49.47686281738699,58.84136819115564,NaN,NaN,NaN,NaN,0.1815942226532232,19.36320202324451,503023,-0.05119021520746184,0.145431857652369,0.19662207285983083
2025-09-15T13:25:00-04:00,165.23,165.23,165.2,165.2,165.1099176541623,NaN,NaN,NaN,NaN,NaN,165.03110000000083,166.10886860176328,163.9533313982384,165.25530634004483,165.0553012156849,165.338565856762,164.7720365746078,224,269.2,49.47686281738699,57.82183483120806,NaN,NaN,NaN,NaN,0.17076606389227877,18.104173052705583,503023,-0.061049644265215725,0.12031001752831116,0.1813596617935269
2025-09-15T13:30:00-04:00,165.37,165.4,165.37,165.4,165.1099176541623,NaN,NaN,NaN,NaN,NaN,165.07370000000083,166.03135089618826,164.1160491038134,165.1665960576287,165.0565402170788,165.34000976147075,164.77307067268686,103,264.73333333333335,54.55753202705028,57.2582566627108,NaN,NaN,NaN,NaN,0.17285420218568864,17.38095738876511,503126,-0.05291890881210698,0.11521102577839315,0.16812993459050013
2025-09-15T13:35:00-04:00,165.34,165.34,165.34,165.34,165.1099176541623,NaN,NaN,NaN,NaN,NaN,165.11430000000084,165.93119903840767,164.297400961594,165.1665960576287,165.05856319583216,165.3420254519819,164.77510093968243,200,260.6666666666667,52.84078689473242,56.869781068265574,NaN,NaN,NaN,NaN,0.1647931877438539,16.571912055195813,502926,-0.05041049305389475,0.10511681827313168,0.15552731132702644
2025-09-15T13:40:00-04:00,165.35,165.36,165.35,165.36,165.1099176541623,NaN,NaN,NaN,NaN,NaN,165.15710000000084,165.77171887292437,164.5424811270773,165.08330974520473,165.05963371851854,165.3431478845479,164.77611955248918,101,263.6666666666667,53.3675349134879,56.23561969119949,NaN,NaN,NaN,NaN,0.1544508171907222,15.905451016446689,503027,-0.046337224840902164,0.09760578027589872,0.1439430051168009
2025-09-15T13:45:00-04:00,165.35,165.35,165.315,165.315,165.1099176541623,NaN,NaN,NaN,NaN,NaN,165.16400000000084,165.7778077866384,164.5501922133633,165.08764165587755,165.0610221538389,165.3444497037398,164.777594603938,147,268,51.96121899300586,55.662618513598446,NaN,NaN,NaN,NaN,0.14663290167710033,15.108414214028537,502880,-0.04553920111568849,0.08701900372219029,0.13255820483787878
2025-09-15T13:50:00-04:00,165.35,165.36,165.35,165.36,165.1099176541623,NaN,NaN,NaN,NaN,NaN,165.17120000000082,165.7855893219943,164.55681067800734,165.12761332470203,165.06207456619558,165.3455445852949,164.77860454709625,101,267.8666666666667,53.28687058113247,54.785448826077115,NaN,NaN,NaN,NaN,0.13937340870016574,14.416658435439064,502981,-0.04098848811112332,0.08132259469897463,0.12231108281009795
2025-09-15T13:55:00-04:00,165.47,165.5,165.47,165.5,165.1099176541623,NaN,NaN,NaN,NaN,NaN,165.17520000000084,165.7954675543234,164.55493244567828,165.24409065976164,165.06329274150093,165.34727567880708,164.77930980419478,81,266.23333333333335,57.240285692974155,54.59023614694605,NaN,NaN,NaN,NaN,0.13941816522158149,14.428057210159201,503062,-0.02816811894516444,0.0871009341286424,0.11526905307380683
2025-09-15T14:00:00-04:00,165.47,165.47,165.33,165.37,165.1099176541623,NaN,NaN,NaN,NaN,NaN,165.17960000000087,165.80220690560157,164.55699309440018,165.24409065976164,165.06954330265324,165.3543351884318,164.78475141687468,555,279.96666666666664,52.77393393046952,54.0187911613953,NaN,NaN,NaN,NaN,0.14160258199146764,13.666227187730303,502507,-0.02800312283327784,0.08026514953220953,0.10826827236548738
2025-09-15T14:05:00-04:00,165.4,165.4,165.4,165.4,165.1099176541623,NaN,NaN,NaN,NaN,NaN,165.17850000000087,165.79934861190551,164.55765138809622,165.24409065976164,165.0695546937838,165.35434827963272,164.78476110793488,1,278.46666666666664,53.672302265488966,54.0085078837814,NaN,NaN,NaN,NaN,0.1336309689920772,12.958813595474899,502508,-0.02550426775301992,0.07638793767421248,0.1018922054272324
2025-09-15T14:10:00-04:00,165.12,165.17,165.12,165.17,165.1099176541623,NaN,NaN,NaN,NaN,NaN,165.17050000000083,165.78118895434747,164.5598110456542,165.24409065976164,165.07069696145436,165.35370920949111,164.7876847134176,401,283.26666666666665,46.38681672718675,53.46097237836599,NaN,NaN,NaN,NaN,0.14408589977835748,13.095568981893777,502107,-0.038208052405603946,0.05413213992022747,0.09234019232583142
2025-09-15T14:15:00-04:00,165.11,165.11,165.04,165.04,NaN,NaN,NaN,165.5376910184423,165.5376910184423,165.5376910184423,165.16190000000086,165.7675662108226,164.55623378917912,165.24409065976164,165.07066406029634,165.3530437692231,164.78828435136958,132,286.3333333333333,42.846637716679076,52.19543518293694,NaN,NaN,NaN,NaN,0.14307976407990305,13.540977496711612,501975,-0.05330575347325889,0.02570800048425781,0.0790137539575167
2025-09-15T14:20:00-04:00,165.03,165.04,164.97,164.97,NaN,NaN,NaN,165.45620506305855,NaN,NaN,165.15950000000083,165.7672343160881,164.55176568391357,165.24409065976164,165.06926080405913,165.34925705625707,164.78926455186118,546,295,41.03078808510363,50.86522753146336,NaN,NaN,NaN,NaN,0.13785978093133805,14.225537705609254,501429,-0.06516191411041494,-0.002438638680501981,0.06272327542991296
2025-09-15T14:25:00-04:00,165.06,165.06,164.81,164.81,NaN,NaN,NaN,165.39978665110135,NaN,NaN,165.15350000000086,165.7689453663228,164.5380546336789,165.24409065976164,165.06758712445418,165.34677113307302,164.78840311583534,289,297.9,37.15478177259147,49.71951537390547,NaN,NaN,NaN,NaN,0.14586979657909963,15.430884695555141,501140,-0.07995989303325021,-0.03722659086164981,0.0427333021716004
2025-09-15T14:30:00-04:00,164.89,164.98,164.89,164.98,NaN,NaN,NaN,165.39978665110135,NaN,NaN,165.15670000000085,165.7668167420487,164.54658325795302,165.24409065976164,165.06699786009855,165.34560520749753,164.78839051269958,153,284.6333333333333,43.2851304494428,49.27724877619517,NaN,NaN,NaN,NaN,0.14759338253773446,16.55013547193347,501293,-0.07458393832714776,-0.0504966207373343,0.024087317589813462
2025-09-15T14:35:00-04:00,165.03,165.03,164.92,164.92,NaN,NaN,NaN,165.39978665110135,NaN,NaN,165.15990000000085,165.7633019878486,164.5564980121531,165.24409065976164,165.06657666623167,165.34473493425136,164.78841839821197,117,276.5,41.73764047477274,48.724447180294156,NaN,NaN,NaN,NaN,0.14490814092789725,17.25009512644458,501176,-0.07135324008135888,-0.06510423251188513,0.006249007569473743
2025-09-15T14:40:00-04:00,164.65,164.73,164.625,164.73,NaN,NaN,NaN,165.15741164311137,NaN,NaN,165.16150000000084,165.7598886687874,164.5631113312143,165.24409065976164,165.06474291125545,165.34343306899262,164.78605275351828,152,260.4,37.20196449947023,47.48476378546701,NaN,NaN,NaN,NaN,0.15562898800447514,18.884647171592025,501024,-0.0777701733937486,-0.09096370917271202,-0.01319353577896341
2025-09-15T14:45:00-04:00,164.77,164.85,164.77,164.8,NaN,NaN,NaN,165.15741164311137,NaN,NaN,165.15750000000082,165.7627875341232,164.55221246587845,165.1802725278093,165.06364989816043,165.34225382330388,164.785045973017,131,249.2,39.79767648978502,46.55311304225648,NaN,NaN,NaN,NaN,0.15308406028987012,19.643965307880233,501155,-0.07312782246437186,-0.10460331385942823,-0.03147549139505637
2025-09-15T14:50:00-04:00,164.97,164.97,164.97,164.97,NaN,NaN,NaN,165.15741164311137,NaN,NaN,165.15910000000088,165.76196877417334,164.5562312258284,165.15321802224744,165.06364687055478,165.3422468010136,164.78504694009595,1,219.83333333333334,45.6709243121846,46.00335514216338,NaN,NaN,NaN,NaN,0.15429234169773562,19.65107461838574,501156,-0.0552486466516372,-0.10053629970960287,-0.04528765305796567
2025-09-15T14:55:00-04:00,165.03,165.07,165.03,165.07,NaN,NaN,NaN,165.15741164311137,NaN,NaN,165.16010000000085,165.76220792962795,164.55799207037376,164.83257441779796,165.06364641925822,165.3422373489539,164.78505548956255,2,209.9,48.83312705541013,45.779920003763685,NaN,NaN,NaN,NaN,0.1504143172907541,19.115275994967025,501158,-0.03435145500783632,-0.08822697181776107,-0.05387551680992475
2025-09-15T15:00:00-04:00,165.13,165.13,165.105,165.105,NaN,NaN,NaN,165.15741164311137,NaN,NaN,165.16520000000085,165.76100184534374,164.56939815465796,164.79711798607022,165.0639877894782,165.34165038608478,164.78632519287163,214,207,49.9315615658022,45.54025507409724,NaN,NaN,NaN,NaN,0.1439561517699861,18.30242120403264,501372,-0.01672794906033879,-0.07478545313534823,-0.058057504075009446
2025-09-15T15:10:00-04:00,165.27,165.31,165.25,165.31,164.81774749894004,164.81774749894004,164.81774749894004,NaN,NaN,NaN,165.17180000000084,165.766559648043,164.5770403519587,164.94119438885616,165.06560869749998,165.3429303817868,164.78828701321316,225,212.83333333333334,55.90282899500908,45.44472245281402,NaN,NaN,NaN,NaN,0.14831642664355943,17.31081610096657,501597,0.008806950039957254,-0.047048816525062875,-0.05585576656502013
2025-09-15T15:15:00-04:00,165.19,165.19,165.16,165.16,164.81774749894004,NaN,NaN,NaN,NaN,NaN,165.17720000000085,165.76650521712753,164.58789478287417,164.94119438885616,165.0662699669549,165.34283594218326,164.78970399172655,200,212.8,51.10052226561851,45.32519304818181,NaN,NaN,NaN,NaN,0.1484366818833056,16.185790170119223,501397,0.015286632018128556,-0.036747476542359436,-0.05203410856048799
2025-09-15T15:20:00-04:00,165.2,165.25,165.2,165.25,164.81774749894004,NaN,NaN,NaN,NaN,NaN,165.18960000000087,165.75804996165726,164.62115003834447,164.94119438885616,165.06784242671435,165.3435760432245,164.7921088102042,300,214.03333333333333,53.67207195516672,45.325176597444504,NaN,NaN,NaN,NaN,0.14426263317735546,15.20470932560595,501697,0.024764595418284623,-0.021078364287632212,-0.045842959705916835
2025-09-15T15:25:00-04:00,165.25,165.27,165.23,165.23,164.81774749894004,NaN,NaN,NaN,NaN,NaN,165.20180000000084,165.74651555782017,164.6570844421815,164.97717152709436,165.07174019081512,165.3456182732596,164.79786210837065,724,234.83333333333334,53.004989342645636,45.79790321283442,NaN,NaN,NaN,NaN,0.13681530223611724,14.391111706004045,500973,0.028548586482095524,-0.010157226603297431,-0.038705813085392955
2025-09-15T15:30:00-04:00,165.18,165.2,165.1,165.13,164.81774749894004,NaN,NaN,NaN,NaN,NaN,165.21260000000086,165.72904647244184,164.6961535275599,164.97717152709436,165.0728174950899,165.34476687141915,164.80086811876066,498,232,49.680163051579164,46.28601216532729,NaN,NaN,NaN,NaN,0.1363284949335371,13.751676473991312,500475,0.02339486182295896,-0.009462235806694252,-0.03285709762965321
2025-09-15T15:35:00-04:00,165.25,165.37,165.25,165.37,164.86140425008392,NaN,NaN,NaN,NaN,NaN,165.23060000000086,165.70313207181027,164.75806792819145,165.01058977734039,165.0782711759139,165.3498609934057,164.80668135842208,717,228.83333333333334,56.700125253094924,47.40525053446952,NaN,NaN,NaN,NaN,0.1437336024382851,13.22085655581714,501192,0.03455400093936984,0.010335403544559085,-0.024218597394810755
2025-09-15T15:40:00-04:00,165.39,165.55,165.39,165.5,165.01724951144374,NaN,NaN,NaN,NaN,NaN,165.24680000000083,165.69919699262758,164.7944030073741,165.1724718218723,165.08615689060284,165.36078186240618,164.8115319187995,677,250.86666666666667,59.95865020981358,49.03409827998539,NaN,NaN,NaN,NaN,0.14632405940697948,13.482894582265065,501869,0.04825404794789026,0.03609896254005207,-0.01215508540783819
2025-09-15T15:45:00-04:00,165.57,165.605,165.56,165.56,165.13601089728718,NaN,NaN,NaN,NaN,NaN,165.26280000000085,165.70158085521382,164.82401914478788,165.25047745749782,165.09060909038675,165.36789701547113,164.81332116530237,317,251.4,61.40238513084272,50.328187900085375,NaN,NaN,NaN,NaN,0.1433723408779088,13.938719967877047,502186,0.05825129049187379,0.06065902770700404,0.0024077372151302574
2025-09-15T15:50:00-04:00,165.66,165.66,165.49,165.54,165.13601089728718,NaN,NaN,NaN,NaN,NaN,165.27620000000087,165.70702970984695,164.8453702901548,165.29138196599828,165.1064273879278,165.3919851257872,164.8208696500684,1205,284.1333333333333,60.61779593707366,51.676770433106874,NaN,NaN,NaN,NaN,0.14527431652948586,13.96156250519882,500981,0.06016543537945674,0.07761453143945118,0.017449096059994444
2025-09-15T15:55:00-04:00,165.57,165.59,165.49,165.59,165.13601089728718,NaN,NaN,NaN,NaN,NaN,165.28620000000083,165.72245478672073,164.84994521328093,165.29138196599828,165.12725921217583,165.4217344959044,164.83278392844727,1747,342.03333333333336,61.927558290722644,53.44288427533919,NaN,NaN,NaN,NaN,0.14204043677737932,13.982773432711898,502728,0.06124301588341457,0.09400286591426266,0.03275985003084809
2025-09-16T09:30:00-04:00,166.46,166.81,165.9,165.9,165.76616777045237,NaN,NaN,NaN,NaN,NaN,165.30040000000085,165.76827964148146,164.83252035852024,165.9240844582389,166.20333333333335,166.20333524068198,166.20333142598471,5853,529.6666666666666,68.84566613449104,55.51774067853248,NaN,NaN,NaN,NaN,0.21903754843613785,16.97862646901071,508581,0.07819277285924059,0.13050081610489883,0.05230804324565824
2025-09-16T09:35:00-04:00,166.1,166.1,165.65,165.65,NaN,NaN,NaN,166.49843076456818,166.49843076456818,166.49843076456818,165.30660000000083,165.78452233568268,164.82867766431897,165.9240844582389,166.18045286059632,166.27375313552304,166.0871525856696,352,537.9666666666667,59.4618775652228,56.50280876803521,NaN,NaN,NaN,NaN,0.23553486640498433,18.681784663666036,508229,0.06828625939965707,0.13766586749522958,0.0693796080955725
2025-09-16T09:40:00-04:00,165.63,165.63,165.445,165.445,NaN,NaN,NaN,166.1605475479969,NaN,NaN,165.30770000000084,165.7866371972791,164.82876280272257,165.9240844582389,166.16829719892388,166.2971011346375,166.03949326321026,114,535.1,53.07366679314561,56.805704463587745,NaN,NaN,NaN,NaN,0.23335380451891494,19.47075453794893,508115,0.044782228402596866,0.1253573935988186,0.08057516519622172
2025-09-16T09:45:00-04:00,165.2,165.47,165.11,165.47,NaN,NaN,NaN,165.93381811399706,NaN,NaN,165.31370000000084,165.7931030026461,164.83429699735558,165.9240844582389,166.07746482836242,166.36176438925926,165.79316526746558,789,558.0333333333333,53.72656160983303,57.07677589530423,NaN,NaN,NaN,NaN,0.2423999613389914,19.074981661972824,508904,0.028563651905188378,0.1162797300777072,0.08771607817251882
2025-09-16T09:50:00-04:00,165.3,165.41,165.29,165.41,NaN,NaN,NaN,165.93381811399706,NaN,NaN,165.31460000000084,165.79455349666387,164.8346465033378,165.9240844582389,166.0219719953326,166.35463711824363,165.68930687242155,605,573.3,51.86160604900781,56.788117113446994,NaN,NaN,NaN,NaN,0.23794282124334964,18.707478277137866,508299,0.01227205796037703,0.10305615062299012,0.09078409266261309
2025-09-16T09:55:00-04:00,165.25,165.25,165.25,165.25,NaN,NaN,NaN,165.93381811399706,NaN,NaN,165.30960000000087,165.78692521294028,164.83227478706146,165.9240844582389,166.01209138615133,166.35382165394267,165.67036111835998,100,573.2666666666667,47.16038966892604,56.5066790708261,NaN,NaN,NaN,NaN,0.23237547686882443,18.231270856695,508199,-0.009621006514984903,0.07875783451888196,0.08837884103386687
2025-09-16T10:00:00-04:00,165.11,165.31,165.11,165.27,NaN,NaN,NaN,165.84041881609005,NaN,NaN,165.30640000000088,165.78259760488643,164.83020239511532,165.9240844582389,166.00622967479677,166.3532950242656,165.65916432532794,59,572.5333333333333,47.79740671417967,56.08706012504131,NaN,NaN,NaN,NaN,0.23006294280676473,17.318268979258665,508258,-0.0223681858768556,0.06041860868779736,0.08278679456465296
2025-09-16T10:05:00-04:00,165.31,165.31,165.25,165.27,NaN,NaN,NaN,165.84041881609005,NaN,NaN,165.30400000000085,165.77969738167167,164.82830261833004,165.9240844582389,165.95528181495928,166.33818729922857,165.57237633069,591,573.7333333333333,47.79740671417967,55.71508993729373,NaN,NaN,NaN,NaN,0.21791558974913885,16.470481521639208,508258,-0.029940045085059958,0.045361738208328006,0.07530178329338796
2025-09-16T10:10:00-04:00,165.16,165.18,164.9,165.05,NaN,NaN,NaN,165.6726749956523,NaN,NaN,165.29980000000083,165.78065739981577,164.8189426001859,165.9240844582389,165.91579772401843,166.33378947164817,165.4978059763887,383,586.4666666666667,41.426112260982215,55.125514880822514,NaN,NaN,NaN,NaN,0.228778761909915,16.00233725145424,507875,-0.04784283113286063,0.015498244377312176,0.0633410755101728
2025-09-16T10:15:00-04:00,165.15,165.15,165.09,165.09,NaN,NaN,NaN,165.6726749956523,NaN,NaN,165.29260000000085,165.77502404472872,164.81017595527297,165.9240844582389,165.91534252250221,166.3336546011569,165.49703044384754,5,573.2666666666667,42.91602068751622,54.14093598328118,NaN,NaN,NaN,NaN,0.21958027891634924,15.567631857711058,507880,-0.054580712270483764,-0.004884814827931905,0.04969589744255186
2025-09-16T10:20:00-04:00,164.86,165.16,164.86,165.16,NaN,NaN,NaN,165.64039188653442,NaN,NaN,165.28820000000084,165.77136771306564,164.80503228693604,165.16626756659113,165.89029575199243,166.3269388357996,165.45365266818524,267,577.7666666666667,45.52732198637246,53.11012682446397,NaN,NaN,NaN,NaN,0.22532454470803737,15.807138359068931,508147,-0.05192850604915246,-0.015214735118888711,0.03671377093026375
2025-09-16T10:25:00-04:00,164.98,165.1,164.98,165.1,NaN,NaN,NaN,165.64039188653442,NaN,NaN,165.27680000000083,165.7501952249139,164.80340477508776,164.7805140532729,165.85456724041427,166.31374226761838,165.39539221321016,410,573.2333333333333,43.682770372546535,51.84444005601424,NaN,NaN,NaN,NaN,0.22208707722889232,16.029537253186955,507737,-0.05170774874710658,-0.027920915003619484,0.0237868337434871
2025-09-16T10:30:00-04:00,165.15,165.41,165.15,165.41,NaN,NaN,NaN,165.64039188653442,NaN,NaN,165.27520000000084,165.74623698257219,164.8041630174295,164.8023304395699,165.83584818415017,166.29737400555612,165.3743223627442,348,575.2,54.04292453655651,51.374806384548734,NaN,NaN,NaN,NaN,0.22836657171254302,15.088199444778832,508085,-0.029292160953901535,-0.012828367448889821,0.016463793505011714
2025-09-16T10:35:00-04:00,165.47,165.5,165.42,165.5,NaN,NaN,NaN,165.64039188653442,NaN,NaN,165.27460000000082,165.74441204643264,164.804787953569,164.96886435165592,165.8338768042968,166.29491748657256,165.37283612202106,54,571.9,56.54243969944757,50.99015505660051,NaN,NaN,NaN,NaN,0.21848324516164733,14.104645080660047,508139,-0.008113468826150614,0.006321957472323447,0.014435426298474061
2025-09-16T10:45:00-04:00,165.44,165.64,165.44,165.64,NaN,NaN,NaN,165.64039188653442,NaN,NaN,165.28160000000082,165.76242196182034,164.8007780381813,165.11509148132473,165.8285816232571,166.28639178334146,165.37077146317273,206,574.8666666666667,60.17129604116086,50.37055719279122,NaN,NaN,NaN,NaN,0.217163013364386,13.639567711823682,508345,0.014389114451218526,0.03242181936249722,0.01803270491127869
2025-09-16T10:50:00-04:00,165.7,165.79,165.7,165.79,165.13061895490654,165.13061895490654,165.13061895490654,NaN,NaN,NaN,165.29140000000086,165.79285404467456,164.78994595532717,165.29507318505978,165.8277924062155,166.28301954096335,165.37256527146766,118,573.7333333333333,63.67154745749678,50.67124789938221,NaN,NaN,NaN,NaN,0.21236565526693027,13.658898473403058,508463,0.03714724538968908,0.06446676164839005,0.027319516258700965
2025-09-16T10:55:00-04:00,165.72,165.805,165.66,165.7,165.13061895490654,NaN,NaN,NaN,NaN,NaN,165.29340000000084,165.80052696531365,164.78627303468804,165.33655854804783,165.82426055120837,166.27225322664543,165.3762678757713,353,581.1333333333333,60.250197684644185,51.18385724877497,NaN,NaN,NaN,NaN,0.20755382274786455,13.520199074619796,508110,0.04347162441892964,0.08165904678236302,0.03818742236343338
2025-09-16T11:00:00-04:00,165.67,165.67,165.34,165.34,165.13061895490654,NaN,NaN,NaN,NaN,NaN,165.28880000000083,165.78994492809255,164.78765507190911,165.33655854804783,165.81062696826555,166.25593928358995,165.36531465294115,401,594.4666666666667,48.92538564347114,50.84091610832055,NaN,NaN,NaN,NaN,0.2184428354087303,12.85283319362886,507709,0.021834261870675976,0.06548024970177835,0.04364598783110237
2025-09-16T11:10:00-04:00,165.5,165.515,165.48,165.48,165.13061895490654,NaN,NaN,NaN,NaN,NaN,165.29150000000084,165.79527475020885,164.78772524979283,165.33655854804783,165.80950092031023,166.25442886006832,165.36457298055214,39,595.7,52.652556322282535,50.8974125564116,NaN,NaN,NaN,NaN,0.2153397757366769,12.233136304137275,507748,0.015664354918814308,0.06322643147962026,0.04756207656080595
2025-09-16T11:15:00-04:00,165.41,165.515,165.41,165.515,165.13061895490654,NaN,NaN,NaN,NaN,NaN,165.29780000000085,165.80470890594785,164.79089109405385,165.33655854804783,165.80860852818154,166.25326342689115,165.36395362947192,30,589.5666666666667,53.564872794781024,51.35487563682981,NaN,NaN,NaN,NaN,0.2074583631840564,11.896142956073483,507778,0.012776029263820612,0.06353211314058171,0.0507560838767611
2025-09-16T11:35:00-04:00,165.39,165.39,165.39,165.39,165.13061895490654,NaN,NaN,NaN,NaN,NaN,165.30160000000086,165.80836795371482,164.7948320462869,165.33655854804783,165.80781642337962,166.25242277161067,165.36321007514857,21,582.7666666666667,49.86908495804154,51.502852654248514,NaN,NaN,NaN,NaN,0.20156848009948095,11.65327976375746,507757,0.001856000628596824,0.05307608466250713,0.051220084033910304
2025-09-16T11:40:00-04:00,165.35,165.35,165.35,165.35,165.13061895490654,NaN,NaN,NaN,NaN,NaN,165.30060000000086,165.80678431320644,164.79441568679528,165.33655854804783,165.8074042731965,166.25202249931286,165.36278604708016,10,576.4333333333333,48.71087434364773,51.56810034206766,NaN,NaN,NaN,NaN,0.1900278743780889,11.573726281361052,507747,-0.008105426665482432,0.04108830070205727,0.0491937273675397
2025-09-16T11:45:00-04:00,165.53,165.53,165.53,165.53,165.13061895490654,NaN,NaN,NaN,NaN,NaN,165.30440000000087,165.81454758542748,164.79425241457426,165.33655854804783,165.80616119973715,166.25016886832822,165.36215353114608,50,568.1,53.899571254331136,52.45906169873543,NaN,NaN,NaN,NaN,0.18931159763679734,10.765267621604028,507797,-0.0028854667840749887,0.04558689388744597,0.048472360671520956
2025-09-16T11:50:00-04:00,165.5,165.5,165.5,165.5,165.13061895490654,NaN,NaN,NaN,NaN,NaN,165.30720000000088,165.8200670772147,164.79433292278705,165.33655854804783,165.8060240676043,166.24997955367263,165.362068581536,5,544.1333333333333,52.93832070528077,53.1749402714329,NaN,NaN,NaN,NaN,0.1779321978055976,10.101441153459154,507792,-0.0018188792952255409,0.04619876155248903,0.04801764084771457
2025-09-16T11:55:00-04:00,165.66,165.71,165.63,165.71,165.13061895490654,NaN,NaN,NaN,NaN,NaN,165.31510000000085,165.8402266122796,164.7899733877221,165.34307902977247,165.80449368954945,166.24588174969065,165.36310562940824,141,532.2333333333333,58.51555962669924,54.10267153145624,NaN,NaN,NaN,NaN,0.18022275510519833,10.10781970042506,507933,0.011908927473612316,0.06290380018972996,0.05099487271611765
2025-09-16T12:00:00-04:00,165.655,165.66,165.57,165.57,165.13061895490654,NaN,NaN,NaN,NaN,NaN,165.31930000000088,165.84913397296634,164.78946602703542,165.34307902977247,165.80034639163347,166.23818556166185,165.36250722160509,234,516.1333333333333,53.92724210501785,54.83441951234705,NaN,NaN,NaN,NaN,0.1773497011691138,9.844908090597263,507699,0.010489581692820361,0.0641068498321431,0.05361726813932274
2025-09-16T12:10:00-04:00,165.65,165.65,165.65,165.65,165.13061895490654,NaN,NaN,NaN,NaN,NaN,165.32230000000087,165.85786030371386,164.78673969628787,165.34307902977247,165.79982697069156,166.23699817363712,165.362655767746,40,494.9,56.048075868178735,54.97764460746292,NaN,NaN,NaN,NaN,0.17039615108560655,9.600775881471453,507739,0.013666676755596921,0.07070061408381889,0.05703393732822197
2025-09-16T12:15:00-04:00,165.8,165.8,165.8,165.8,165.13061895490654,NaN,NaN,NaN,NaN,NaN,165.33090000000087,165.88280828848795,164.77899171151378,165.4603364632435,165.7998284523606,166.23512385871658,165.36453304600462,100,487.6666666666667,59.78596193009592,55.20932476679495,NaN,NaN,NaN,NaN,0.16893928315092074,9.976348779609587,507839,0.02399427066458687,0.08702677565895556,0.06303250499436869
2025-09-16T12:20:00-04:00,165.73,165.73,165.68,165.68,165.18056966834527,NaN,NaN,NaN,NaN,NaN,165.33650000000088,165.89671870630315,164.77628129369862,165.4603364632435,165.79961687460835,166.23449071607078,165.3647430331459,24,448.3,55.704523051287815,54.890269553232585,NaN,NaN,NaN,NaN,0.16544362006871244,9.734068149474176,507815,0.020976812156799737,0.08925352019036836,0.06827670803356863
2025-09-16T12:25:00-04:00,165.67,165.84,165.67,165.84,165.23122559251138,NaN,NaN,NaN,NaN,NaN,165.3499000000009,165.92539105890054,164.77440894110126,165.48961533647582,165.79956831671925,166.23379417998794,165.36534245345055,35,391.23333333333335,59.658959425761175,54.60365612239433,NaN,NaN,NaN,NaN,0.16576907577809125,9.952111841428902,507850,0.027574248962773176,0.10274451923703509,0.07517027027426192
2025-09-16T12:30:00-04:00,165.83,165.83,165.83,165.83,165.23122559251138,NaN,NaN,NaN,NaN,NaN,165.36570000000086,165.94960756026893,164.78179243973278,165.54469226918067,165.79965106069622,166.2332890859357,165.36601303545675,32,197.2,59.3026200685838,54.535972006961444,NaN,NaN,NaN,NaN,0.15464271322251263,10.154580983958288,507818,0.02894041720072213,0.11134579177516457,0.08240537457444244
2025-09-16T12:35:00-04:00,165.71,165.71,165.71,165.71,165.23122559251138,NaN,NaN,NaN,NaN,NaN,165.38050000000086,165.96104198720823,164.7999580127935,165.54469226918067,165.79889572275118,166.23078085992373,165.36701058557864,100,188.8,55.053136863703095,54.9736685226923,NaN,NaN,NaN,NaN,0.1521682337066192,9.718295214781078,507718,0.019870206765454923,0.1072431330312611,0.08737292626580617
2025-09-16T12:55:00-04:00,165.76,165.76,165.76,165.76,165.23122559251138,NaN,NaN,NaN,NaN,NaN,165.39950000000087,165.9661295076215,164.83287049238024,165.54469226918067,165.7988924459422,166.23075953798616,165.3670253538982,1,185.03333333333333,56.453338381098376,55.24515295546486,NaN,NaN,NaN,NaN,0.14487050272757376,9.543486369518964,507719,0.01553786641133667,0.10679525927997702,0.09125739286864035
2025-09-16T13:00:00-04:00,165.84,166.07,165.84,166.07,165.4552819114866,NaN,NaN,NaN,NaN,NaN,165.42130000000088,166.00529934835788,164.8373006516439,165.7105224418205,165.80664617541592,166.23152176937205,165.3817705814598,493,175.16666666666666,63.95149900423755,55.9870548275689,NaN,NaN,NaN,NaN,0.1566654668184615,10.594940701921272,508212,0.03095941832855338,0.12995666577933207,0.09899724745077869
2025-09-16T13:05:00-04:00,166.01,166.12,165.96,166.12,165.54117818823724,NaN,NaN,NaN,NaN,NaN,165.44530000000088,166.04338163228326,164.8472183677185,165.75241795345642,165.8108467292695,166.23354948597483,165.3881439725642,203,161.76666666666668,64.99834184111415,57.06771603350266,NaN,NaN,NaN,NaN,0.1569036477599997,11.738173725848416,508415,0.04129074862113674,0.15061068322719962,0.10931993460606287
2025-09-16T13:10:00-04:00,166.18,166.32,166.18,166.32,165.746579179681,NaN,NaN,NaN,NaN,NaN,165.4771000000009,166.08860008902914,164.86559991097263,165.92593436276513,165.81880442150273,166.24214853391118,165.3954603090943,220,165.76666666666668,68.89003405853218,58.509084584565834,NaN,NaN,NaN,NaN,0.15998195863428463,13.414727151353647,508635,0.05736858081203314,0.1810306606211043,0.12366207980907115
2025-09-16T13:15:00-04:00,166.27,166.27,166.19,166.19,165.746579179681,NaN,NaN,NaN,NaN,NaN,165.5049000000009,166.11712704844382,164.89267295155798,165.92593436276513,165.8199214891073,166.24319473022962,165.39664824798496,36,165,63.915482051316985,59.22450678435053,NaN,NaN,NaN,NaN,0.15784039016040682,14.971526760751361,508599,0.05501479887377175,0.19243057840128586,0.1374157795275141
2025-09-16T13:20:00-04:00,166.25,166.3,166.25,166.25,165.7843830955358,NaN,NaN,NaN,NaN,NaN,165.5305000000009,166.15797509818216,164.90302490181963,165.94079799216968,165.82089494163426,166.24421962340466,165.39757025986387,28,146.23333333333332,65.16573200280175,60.097893305602035,NaN,NaN,NaN,NaN,0.15442321943466444,16.50967337892125,508627,0.053231793688042706,0.20395552163756747,0.15072372794952477
2025-09-16T13:25:00-04:00,166.17,166.2,166.16,166.2,165.7843830955358,NaN,NaN,NaN,NaN,NaN,165.55310000000088,166.19386170210436,164.9123382978974,165.94079799216968,165.83239164845108,166.2538701906184,165.41091310628377,417,147.36666666666667,63.20056116763514,60.43253627281174,NaN,NaN,NaN,NaN,0.14982156090361723,17.346226889507104,508210,0.04475873934570776,0.20667215213165946,0.1619134127859517
2025-09-16T13:30:00-04:00,166.33,166.46,166.33,166.42,165.90080153952744,NaN,NaN,NaN,NaN,NaN,165.5794000000009,166.25161020435684,164.90718979564497,166.0641107149886,165.84224567901236,166.26663598258543,165.4178553754393,233,154.96666666666667,67.80157019490167,61.423559707803456,NaN,NaN,NaN,NaN,0.1576914494105031,18.937298822742875,508443,0.04966541831953297,0.22399518568536791,0.17432976736583494
2025-09-16T13:35:00-04:00,166.41,166.41,166.27,166.29,165.90080153952744,NaN,NaN,NaN,NaN,NaN,165.5990000000009,166.29536197401512,164.90263802598668,166.0641107149886,165.8457479716646,166.27056393546866,165.42093200786053,99,149.36666666666667,62.804579332998166,61.9061670981477,NaN,NaN,NaN,NaN,0.15714206016689408,20.03603876768016,508344,0.040251658836904014,0.22464434091196495,0.18439268207506093
2025-09-16T13:50:00-04:00,166.17,166.32,166.17,166.32,165.90080153952744,NaN,NaN,NaN,NaN,NaN,165.62220000000087,166.33559795267922,164.90880204732252,166.0641107149886,165.85156343680492,166.27633186786855,165.4267950057413,189,142,63.473598072976436,62.16956967978202,NaN,NaN,NaN,NaN,0.15663191301211635,20.444137361181184,508533,0.03247469532858199,0.2249860512357884,0.19251135590720642
2025-09-16T13:55:00-04:00,166.35,166.44,166.35,166.38,165.91064970488011,NaN,NaN,NaN,NaN,NaN,165.6448000000009,166.38083793300956,164.90876206699227,166.06930468607416,165.86134064421182,166.28833095321986,165.4343503352038,255,138.9,64.83586866289954,62.82180865204001,NaN,NaN,NaN,NaN,0.1540153477969655,21.227085789032568,508788,0.027971838619812006,0.22747615418197142,0.19950431556215942
2025-09-16T14:00:00-04:00,166.47,166.47,166.42,166.46,165.97039290011284,NaN,NaN,NaN,NaN,NaN,165.6694000000009,166.43014342510924,164.90865657489258,166.12844374885933,165.86727454297665,166.296157626295,165.43839145965828,143,141.86666666666667,66.62327630538766,63.31925985772761,NaN,NaN,NaN,NaN,0.14944282295432534,22.052573701895213,508931,0.026969775610319324,0.23321653507505857,0.20624675946473925
2025-09-16T14:05:00-04:00,166.38,166.52,166.32,166.47,165.97039290011284,NaN,NaN,NaN,NaN,NaN,165.69620000000089,166.47328316085722,164.91911683914455,166.14675499908745,165.88021883898227,166.31260975256518,165.44782792539937,330,146,66.85010633688029,63.85836601974878,NaN,NaN,NaN,NaN,0.15305404988616048,22.18091350268098,509261,0.0236857660273877,0.23585396699897387,0.21216820097158617
2025-09-16T14:10:00-04:00,166.46,166.46,166.32,166.32,165.97039290011284,NaN,NaN,NaN,NaN,NaN,165.7152000000009,166.50578955145153,164.92461044855025,166.14675499908745,165.89641648907835,166.3304135248056,165.4624194533511,500,158.73333333333332,60.23712869582602,64.22865115061471,NaN,NaN,NaN,NaN,0.15283590346572082,22.300086174839187,508761,0.008878818887060907,0.2232667245804123,0.2143879056933514
2025-09-16T14:15:00-04:00,166.4,166.49,166.4,166.49,165.97039290011284,NaN,NaN,NaN,NaN,NaN,165.73500000000092,166.55218051788634,164.9178194821155,166.14675499908745,165.91587539381473,166.35455317775478,165.47719760987468,537,164.86666666666667,64.52075579475888,64.80489525159047,NaN,NaN,NaN,NaN,0.15406191036102762,22.535173670886863,509298,0.008027138155960067,0.2244218283883015,0.21639469023234142
2025-09-16T14:20:00-04:00,166.55,166.55,166.55,166.55,165.97039290011284,NaN,NaN,NaN,NaN,NaN,165.7548000000009,166.6015017413705,164.9080982586313,166.2128985595328,165.92000702650913,166.36021978017106,165.4797942728472,102,154.9,65.91637430032512,64.94524348702528,NaN,NaN,NaN,NaN,0.14734320247809723,23.003039247371646,509400,0.008928756071481081,0.22755563532169276,0.21862687925021168
2025-09-16T14:25:00-04:00,166.56,166.56,166.56,166.56,165.97039290011284,NaN,NaN,NaN,NaN,NaN,165.77520000000092,166.64893671023464,164.9014632897672,166.28531884762623,165.9202930660197,166.36061526434895,165.47997086769044,7,153.83333333333334,66.15532928025927,65.02788544696422,NaN,NaN,NaN,NaN,0.13753297372966106,23.479820274092702,509407,0.007670809678584384,0.22821539134844215,0.22054458166985777
2025-09-16T14:30:00-04:00,166.46,166.52,166.46,166.49,166.04983445870283,NaN,NaN,NaN,NaN,NaN,165.7932000000009,166.68776751497498,164.8986324850268,166.28531884762623,165.9388387176478,166.38357886154785,165.49409857374775,527,170.4,62.83446633113678,64.5953448950074,NaN,NaN,NaN,NaN,0.13485204703468487,23.1576899614264,508880,0.000002337411158959135,0.22054750343380647,0.2205451660226475
2025-09-16T14:35:00-04:00,166.56,166.66,166.54,166.66,166.15666016512543,NaN,NaN,NaN,NaN,NaN,165.80840000000092,166.7349644925199,164.88183550748192,166.35920406248079,165.9521632751938,166.40252232639418,165.50180422399345,323,180.46666666666667,67.14756371273077,64.82620787082267,NaN,NaN,NaN,NaN,0.13736261510363507,23.49935645762929,509203,0.004034099694716631,0.22558779064104328,0.22155369094632665
2025-09-16T14:40:00-04:00,166.63,166.66,166.51,166.51,166.15666016512543,NaN,NaN,NaN,NaN,NaN,165.8256000000009,166.7714914096407,164.87970859036108,166.35920406248079,165.9705825698849,166.42614131307243,165.51502382669736,516,197.33333333333334,60.478333249175606,64.49139367413508,NaN,NaN,NaN,NaN,0.13826528545337582,23.588951529203786,508687,-0.005242856268310947,0.21500012061093798,0.22024297687924893
2025-09-16T14:45:00-04:00,166.61,166.62,166.58,166.62,166.1615230016949,NaN,NaN,NaN,NaN,NaN,165.8491000000009,166.81419002628073,164.88400997372108,166.35920406248079,165.98532430778644,166.4456325524266,165.5250160631463,404,209.13333333333333,63.352892574219744,64.50227448889113,NaN,NaN,NaN,NaN,0.13624633649242138,23.672146952808674,509091,-0.005770603512030847,0.21302972248921037,0.21880032600124122
2025-09-16T14:50:00-04:00,166.62,166.62,166.62,166.62,166.1615230016949,NaN,NaN,NaN,NaN,NaN,165.8721000000009,166.85461125124783,164.88958874875397,166.37399247999016,165.98894440641874,166.45041987664064,165.52746893619684,100,212.3,63.352892574219744,64.18451180169957,NaN,NaN,NaN,NaN,0.1265144553143913,23.74939984615607,509091,-0.0077936414955141475,0.20905827413184852,0.21685191562736267
2025-09-16T14:55:00-04:00,166.6,166.6,166.54,166.54,166.1615230016949,NaN,NaN,NaN,NaN,NaN,165.8947000000009,166.8856034457525,164.9037965542493,166.37399247999016,165.99244066515496,166.45465285620168,165.53022847410824,108,211.2,59.69095274776923,63.96210990275465,NaN,NaN,NaN,NaN,0.12319199422050708,23.138406359637766,508983,-0.01573549757202114,0.19718254366233623,0.21291804123435737
2025-09-16T15:00:00-04:00,166.59,166.7,166.59,166.7,166.23140726133508,NaN,NaN,NaN,NaN,NaN,165.9237000000009,166.92227660639153,164.92512339361028,166.43055518719368,166.0003335200747,166.4654782909142,165.53518874923518,210,210.4,64.15371350415101,64.01068957640997,NaN,NaN,NaN,NaN,0.1258211374904706,23.137396853836943,509193,-0.011618725245691713,0.19839463467724272,0.21001335992293443
2025-09-16T15:05:00-04:00,166.68,166.68,166.57,166.57,166.23140726133508,NaN,NaN,NaN,NaN,NaN,165.94970000000092,166.94653581336598,164.95286418663585,166.43055518719368,166.01707976975177,166.4863956689059,165.54776387059763,507,225.96666666666667,58.48774682493529,63.55725230226967,NaN,NaN,NaN,NaN,0.12611962766972237,22.962855657075394,508686,-0.01864028734094797,0.18671300074674946,0.20535328808769743
2025-09-16T15:10:00-04:00,166.555,166.6,166.555,166.6,166.23140726133508,NaN,NaN,NaN,NaN,NaN,165.97630000000092,166.9701426630064,164.98245733699542,166.43055518719368,166.02413752600242,166.49475267973173,165.5535223722731,231,230.33333333333334,59.37933003943994,63.03982756898768,NaN,NaN,NaN,NaN,0.1203253685504556,22.66548820625233,508917,-0.02202174858245276,0.17782610235963148,0.19984785094208424
2025-09-16T15:15:00-04:00,166.81,166.81,166.81,166.81,166.23140726133508,NaN,NaN,NaN,NaN,NaN,166.0115000000009,166.99624819056805,165.02675180943373,166.50744425584318,166.02834269763127,166.50118568197954,165.555499713283,100,232.86666666666667,65.03968467519876,62.91051173601045,NaN,NaN,NaN,NaN,0.12673069936828077,23.499122331120397,509017,-0.011407031836659531,0.18558906114625984,0.19699609298291937
2025-09-16T15:20:00-04:00,166.87,166.87,166.81,166.81,166.4401065099366,NaN,NaN,NaN,NaN,NaN,166.0459000000009,167.01958925168844,165.07221074831335,166.59795540467454,166.04017652537604,166.519370321078,165.5609827296741,280,241.03333333333333,65.03968467519876,63.25355144882279,NaN,NaN,NaN,NaN,0.12196422084197515,24.53398832567395,509017,-0.005951933340024473,0.1895561763078888,0.19550810964791326
2025-09-16T15:25:00-04:00,166.78,166.78,166.62,166.625,166.4401065099366,NaN,NaN,NaN,NaN,NaN,166.0752000000009,167.0284469978093,165.1219530021925,166.59795540467454,166.06124131369248,166.54594317079568,165.57653945658927,651,261.6666666666667,56.93399424572528,62.7116399096061,NaN,NaN,NaN,NaN,0.12682391935326248,23.923971213496156,508366,-0.015809451027060856,0.1757462958640872,0.19155574689114804
2025-09-16T15:30:00-04:00,166.615,166.66,166.56,166.64,166.4401065099366,NaN,NaN,NaN,NaN,NaN,166.1060000000009,167.03029648859953,165.18170351140228,166.59795540467454,166.07547950195374,166.5620000889569,165.58895891495058,513,275.43333333333334,57.39760110684782,62.10315611007201,NaN,NaN,NaN,NaN,0.12490792511374334,22.931517289440457,508879,-0.021948306817109298,0.16412036336976144,0.18606867018687073
2025-09-16T15:35:00-04:00,166.68,166.75,166.68,166.75,166.4401065099366,NaN,NaN,NaN,NaN,NaN,166.13280000000088,167.05251552061054,165.21308447939123,166.59795540467454,166.0911064785637,166.58197699287416,165.60023596425322,495,291.9,60.73570021657733,61.71603974838043,NaN,NaN,NaN,NaN,0.1238430733199055,22.502795159367103,509374,-0.019321865714460318,0.16191633804379535,0.18123820375825567
2025-09-16T15:40:00-04:00,166.77,166.83,166.77,166.79,166.4401065099366,NaN,NaN,NaN,NaN,NaN,166.15860000000092,167.07823697119775,165.23896302880408,166.59795540467454,166.09818375247966,166.59162095918416,165.60474654577516,209,282.43333333333334,61.904632438549775,61.64962304176708,NaN,NaN,NaN,NaN,0.12071142522562743,22.51050465244742,509583,-0.015762386740971523,0.16153522033204126,0.1772976070730128
2025-09-16T15:45:00-04:00,166.78,166.78,166.7,166.7,166.4401065099366,NaN,NaN,NaN,NaN,NaN,166.1798000000009,167.09951073648952,165.2600892635123,166.59795540467454,166.11784849752817,166.6156780076891,165.62001898736725,673,298.1,57.73947425196284,60.97761665171223,NaN,NaN,NaN,NaN,0.11851775199522571,21.987424548110905,508910,-0.02006506210401343,0.15221627944299598,0.17228134154700941
2025-09-16T15:50:00-04:00,166.78,166.9,166.64,166.74,166.4401065099366,NaN,NaN,NaN,NaN,NaN,166.19880000000092,167.12474505171627,165.27285494828556,166.59795540467454,166.1443806085458,166.64829330584135,165.64046791125023,927,321.6666666666667,59.0579733955663,60.876162376454424,NaN,NaN,NaN,NaN,0.12862362685271098,22.110760388951388,509837,-0.020728001506020777,0.14637133966448346,0.16709934117050423
2025-09-16T15:55:00-04:00,166.94,166.94,166.71,166.8,166.4401065099366,NaN,NaN,NaN,NaN,NaN,166.22080000000088,167.15055773125573,165.29104226874603,166.59795540467454,166.2709176978556,166.79550457048245,165.74633082522874,5202,493.8666666666667,61.02240080120423,60.70969867838188,NaN,NaN,NaN,NaN,0.13586479636323087,22.41509027211804,515039,-0.017751275957532592,0.1449102462235885,0.1626615221811211
2025-09-17T09:30:00-04:00,166.69,166.78,166.29,166.6,NaN,NaN,NaN,166.9774057804777,166.9774057804777,166.9774057804777,166.2460000000009,167.1467485769294,165.34525142307237,166.59795540467454,166.55666666666664,166.55666666666664,166.55666666666664,4204,633.0666666666667,52.05630429234807,59.902799515391045,NaN,NaN,NaN,NaN,0.16258873948014432,21.481036295065397,510835,-0.02920145764611254,0.12615970012348043,0.15536115776959297
2025-09-17T09:35:00-04:00,166.3,166.3,166.3,166.3,NaN,NaN,NaN,166.9774057804777,NaN,NaN,166.2624000000009,167.1362220407127,165.38857795928908,166.59795540467454,166.55070322180916,166.58936916072247,166.51203728289585,100,622.5,42.07078458971901,58.644216075530316,NaN,NaN,NaN,NaN,0.17240382951727565,20.613700459230806,510735,-0.05540911820353567,0.08609976001517339,0.14150887821870906
2025-09-17T09:40:00-04:00,166.13,166.35,166.13,166.35,NaN,NaN,NaN,166.7355198036319,NaN,NaN,166.2791000000009,167.12666991382977,165.43153008617205,166.557315541603,166.53588717948716,166.60837749184637,166.46339686712795,246,622.9333333333333,43.998875560197675,57.204584793819365,NaN,NaN,NaN,NaN,0.1758035559803273,20.566731700612255,510981,-0.06703016081890549,0.05772117719507719,0.12475133801398268
2025-09-17T09:45:00-04:00,166.36,166.98,166.36,166.98,166.11109473289685,166.11109473289685,166.11109473289685,NaN,NaN,NaN,166.3109000000009,167.14179756217544,165.48000243782639,166.557315541603,166.5549865265427,166.64986774301985,166.46010531006556,398,632.9,61.421966091942515,57.41417188431988,NaN,NaN,NaN,NaN,0.2082461591245893,20.401430365873054,511379,-0.031732379331597685,0.08508586384948558,0.11681824318108326
2025-09-17T09:50:00-04:00,167,167.34,167,167.26,166.58740860867425,NaN,NaN,NaN,NaN,NaN,166.3491000000009,167.17538733430501,165.5228126656968,166.557315541603,166.66692389065196,166.92598232298099,166.40786545832293,1039,661.2333333333333,66.42212512640833,57.91722867624618,NaN,NaN,NaN,NaN,0.2190857191871196,21.20490153818854,512418,0.008858986277302958,0.12789197602771196,0.119032989750409
2025-09-17T09:55:00-04:00,167.24,167.28,167.12,167.12,166.6220718537345,NaN,NaN,NaN,NaN,NaN,166.38090000000088,167.20100655336995,165.5607934466318,166.557315541603,166.68652001712695,166.95864861683398,166.41439141741992,241,660.7666666666667,62.088889480690185,57.70645759092414,NaN,NaN,NaN,NaN,0.21486531067375367,21.95098191248149,512177,0.02381679117546545,0.14880397871974083,0.12498718754427537
2025-09-17T10:00:00-04:00,167.1,167.18,166.78,166.78,166.6220718537345,NaN,NaN,NaN,NaN,NaN,166.40650000000088,167.19429248465195,165.6187075153498,166.557315541603,166.6972413441436,166.9671863042128,166.42729638407442,309,666.3,53.03922861197254,56.849282157836555,NaN,NaN,NaN,NaN,0.22808921705420024,21.212618649001286,511868,0.00910604792710698,0.1363697474531591,0.12726369952605213
2025-09-17T10:05:00-04:00,166.9,166.9,166.62,166.62,NaN,NaN,NaN,167.3768312241799,167.3768312241799,167.3768312241799,166.42470000000088,167.18898374237244,165.66041625762932,166.557315541603,166.6975076475603,166.96521752562577,166.4297977694948,110,658.9666666666667,49.39092227773696,56.31049130298025,NaN,NaN,NaN,NaN,0.23179713012175743,19.956120524209137,511758,-0.011962780092765815,0.11231022441009486,0.12427300450286068
2025-09-17T10:15:00-04:00,166.5,166.5,166.29,166.29,NaN,NaN,NaN,167.02879344126262,NaN,NaN,166.4391000000009,167.1645727829675,165.71362721703431,166.55106890027037,166.6959912136189,166.96405105357417,166.42793137366363,30,643.3,42.84497330951306,55.271017888884906,NaN,NaN,NaN,NaN,0.23881162082734705,19.28765910503704,511728,-0.04673400694484245,0.06585549582180761,0.11258950276665006
2025-09-17T10:20:00-04:00,166.34,166.34,166.34,166.34,NaN,NaN,NaN,167.02879344126262,NaN,NaN,166.45290000000088,167.14320454066487,165.7625954593369,166.55106890027037,166.69073828144212,166.9602530099684,166.42122355291585,100,628.7333333333333,44.0548160786974,54.07952616475063,NaN,NaN,NaN,NaN,0.22532507648253736,18.666944930091525,511828,-0.06391363825117413,0.03269745495268239,0.09661109320385652
2025-09-17T10:25:00-04:00,166,166,165.8,165.8,NaN,NaN,NaN,166.5576299743736,NaN,NaN,166.45290000000088,167.14320454066487,165.7625954593369,166.55106890027037,166.66277975766215,166.96680593770327,166.35875357762103,238,633.2666666666667,35.351403028487084,52.18286692117472,NaN,NaN,NaN,NaN,0.2478018567337841,19.40998450570731,511590,-0.10667336315664935,-0.03673061074195516,0.06994275241469419
2025-09-17T10:30:00-04:00,165.5,165.78,165.5,165.78,NaN,NaN,NaN,166.30864679372027,NaN,NaN,166.4549000000009,167.13676359254507,165.77303640745671,166.55106890027037,166.6572454523978,166.96914180169594,166.34534910309966,40,634.3666666666667,35.075017677829564,50.5639771658795,NaN,NaN,NaN,NaN,0.25153029553851464,20.657341697641566,511550,-0.12979634436705176,-0.09230267804412051,0.03749366632293125
2025-09-17T10:35:00-04:00,165.52,165.52,165.45,165.45,NaN,NaN,NaN,166.1682537576421,NaN,NaN,166.4471000000009,167.16489687854028,165.7293031214615,166.55106890027037,166.65306497175138,166.9722321340977,166.33389780940504,25,617.6333333333333,30.79662953629476,48.54530974736009,NaN,NaN,NaN,NaN,0.2571352744286216,21.90291598790882,511525,-0.15888689383192564,-0.1611149509669758,-0.002228057135050164
2025-09-17T10:40:00-04:00,165.56,165.56,165.56,165.56,NaN,NaN,NaN,166.1682537576421,NaN,NaN,166.44170000000088,167.18170435058173,165.70169564942003,166.55106890027037,166.63784122562672,166.9796857645906,166.29599668666282,100,610.2,33.69972323583306,46.59368992126215,NaN,NaN,NaN,NaN,0.2466256119694353,22.897661578921383,511625,-0.16175091734456187,-0.2044167038157525,-0.04266578647119063
2025-09-17T10:45:00-04:00,165.2,165.2,165.19,165.19,NaN,NaN,NaN,165.8823241882648,NaN,NaN,166.43130000000087,167.22482582747983,165.63777417252192,166.55106890027037,166.62983841181898,166.9871986788927,166.27247814474526,40,594.3333333333334,29.254263352413005,44.96497271126679,NaN,NaN,NaN,NaN,0.2554380682573331,24.465329230737925,511585,-0.17829034121043547,-0.26552871298423497,-0.0872383717737995
2025-09-17T10:50:00-04:00,165.15,165.15,165.08,165.08,NaN,NaN,NaN,165.7860821797073,NaN,NaN,166.41770000000088,167.27733529410307,165.5580647058987,166.39685512021632,166.61621825669178,166.9998491144978,166.23258739888576,65,583.0333333333333,28.068795497655728,43.964830633262274,NaN,NaN,NaN,NaN,0.2450496348103797,26.090604500744135,511520,-0.18553526480745358,-0.31915745278311647,-0.1336221879756629
2025-09-17T10:55:00-04:00,165.26,165.26,165.21,165.21,NaN,NaN,NaN,165.7860821797073,NaN,NaN,166.4005000000009,167.3196305668058,165.481369433196,166.13348409617305,166.6156462678375,167.00023245378424,166.23106008189075,3,579.8,31.596670640682618,43.07895885329691,NaN,NaN,NaN,NaN,0.24040323232392247,27.133914035988028,511523,-0.17083567311902753,-0.3471667793744473,-0.17633110625541976
2025-09-17T11:00:00-04:00,165.25,165.25,165.25,165.25,NaN,NaN,NaN,165.7860821797073,NaN,NaN,166.3831000000009,167.35427843821338,165.4119215617884,165.72178727693841,166.59716161342712,167.01044888382228,166.18387434303196,100,579.5333333333333,32.69055944380486,41.02671552128707,NaN,NaN,NaN,NaN,0.22608871572935602,28.102701461571645,511623,-0.14850648195986058,-0.3619642087052455,-0.2134577267453849
2025-09-17T11:05:00-04:00,165.21,165.21,165.21,165.21,NaN,NaN,NaN,165.7860821797073,NaN,NaN,166.36090000000087,167.38607840343667,165.33572159656507,165.69242982155075,166.5786364850427,167.0189539461032,166.13831902398218,100,575.8666666666667,32.13709811854288,38.57778502072525,NaN,NaN,NaN,NaN,0.21279666460583,29.079982265450568,511523,-0.12733267555343336,-0.3726235711871766,-0.24529089563374323
2025-09-17T11:10:00-04:00,165.43,165.62,165.43,165.62,NaN,NaN,NaN,165.7860821797073,NaN,NaN,166.3495000000009,167.3945114826478,165.30448851735397,165.21194385724058,166.40751278630194,166.96160236516903,165.85342320743484,1506,609.1666666666666,42.82266120519529,37.20162585818991,NaN,NaN,NaN,NaN,0.22688261713398475,28.282281846147626,513029,-0.07898484220407959,-0.3440219483888427,-0.2650371061847631
2025-09-17T11:20:00-04:00,165.83,165.83,165.7,165.7,165.12109128062988,165.12109128062988,165.12109128062988,NaN,NaN,NaN,166.33850000000086,167.39893434444878,165.27806565555295,165.29061067438593,166.39144334743767,166.9482215514347,165.83466514344065,223,608.9,44.653891195889955,36.60267318561257,NaN,NaN,NaN,NaN,0.22567671591012925,26.825830212789832,513252,-0.03701913515790278,-0.3113110251321416,-0.2742918899742388
2025-09-17T11:25:00-04:00,165.69,165.69,165.43,165.43,165.12109128062988,NaN,NaN,NaN,NaN,NaN,166.32310000000086,167.4130851186499,165.23311488135184,165.29061067438593,166.36484851672625,166.9332977997419,165.79639923371062,289,615.2,39.997876428709354,35.93174133925346,NaN,NaN,NaN,NaN,0.22884266477369014,26.166047484108734,512963,-0.023505341183600037,-0.3036735664537389,-0.28016822527013885
2025-09-17T11:30:00-04:00,165.62,165.62,165.62,165.62,165.12109128062988,NaN,NaN,NaN,NaN,NaN,166.30710000000087,167.4142767514114,165.19992324859035,165.29061067438593,166.3647701693489,166.93324088013406,165.79629945856374,1,605.9,44.39194907380987,36.04223960813181,NaN,NaN,NaN,NaN,0.2260681887184264,25.553392093190574,512964,0.0008766282551339044,-0.27907243995122144,-0.27994906820635534
2025-09-17T11:40:00-04:00,165.71,165.71,165.71,165.71,165.12109128062988,NaN,NaN,NaN,NaN,NaN,166.29550000000086,167.4152325568547,165.175767443147,165.29061067438593,166.36387605042015,166.93247283505673,165.79527926578356,13,584.6333333333333,46.39449993495086,36.209359883578486,NaN,NaN,NaN,NaN,0.2163490323813962,24.656026746532028,512977,0.024408652001243702,-0.24943825320480073,-0.27384690520604443
2025-09-17T11:45:00-04:00,165.98,165.99,165.895,165.895,165.30239617490346,NaN,NaN,NaN,NaN,NaN,166.2870000000009,167.41229818218972,165.16170181781206,165.46314613222847,166.35439591682936,166.92038794811828,165.78840388554045,211,574.5666666666667,50.35234276712778,37.28085557919568,NaN,NaN,NaN,NaN,0.2208955300684394,22.901978706254607,513188,0.05218140449120645,-0.20862014959203634,-0.2608015540832428
2025-09-17T11:50:00-04:00,165.91,165.91,165.62,165.62,165.30239617490346,NaN,NaN,NaN,NaN,NaN,166.27180000000087,167.4120942773055,165.13150572269623,165.46314613222847,166.34155271372467,166.9089335939819,165.77417183346742,200,564.7333333333333,45.03006632974609,37.991930482904,NaN,NaN,NaN,NaN,0.22583156363497886,22.039486299239417,512988,0.05168121269126588,-0.19620003821916043,-0.24788125091042632
2025-09-17T12:00:00-04:00,165.6,165.6,165.6,165.6,165.30239617490346,NaN,NaN,NaN,NaN,NaN,166.25460000000086,167.40887871802008,165.10032128198165,165.46314613222847,166.33416010367856,166.90349230962036,165.76482789773675,100,561.1,44.660338837687334,38.982195433003476,NaN,NaN,NaN,NaN,0.21112930908962396,21.292593456647438,512888,0.04964202036477594,-0.1858287254544564,-0.23547074581923233
2025-09-17T12:10:00-04:00,165.54,165.54,165.54,165.54,165.30239617490346,NaN,NaN,NaN,NaN,NaN,166.23600000000087,167.4056649087819,165.06633509121986,165.46314613222847,166.33408094098883,166.90343997689683,165.76472190508082,1,538.7,43.50625645409592,39.68266209145082,NaN,NaN,NaN,NaN,0.20033435844036526,20.767399701658483,512887,0.04407925939634999,-0.18037167157379486,-0.22445093097014485
2025-09-17T12:15:00-04:00,165.57,165.57,165.48,165.48,165.30239617490346,NaN,NaN,NaN,NaN,NaN,166.21920000000082,167.40753725806147,165.03086274194018,165.46314613222847,166.31373128524206,166.89037710215726,165.73708546832685,254,516.2666666666667,42.32829717111092,40.61652164992925,NaN,NaN,NaN,NaN,0.19245333283748225,20.45126205259722,512633,0.03649913743953043,-0.1788270091707318,-0.21532614661026223
2025-09-17T12:30:00-04:00,165.72,165.72,165.68,165.68,165.30239617490346,NaN,NaN,NaN,NaN,NaN,166.20300000000083,167.3981937076897,165.00780629231195,165.46314613222847,166.31294818267145,166.88965078666044,165.73624557868246,13,343.3,47.437123249997505,41.99997363223937,NaN,NaN,NaN,NaN,0.1958495233490913,19.576985545614445,512646,0.04456133889186406,-0.15962447299543214,-0.2041858118872962
2025-09-17T12:35:00-04:00,165.41,165.41,165.41,165.41,165.30239617490346,NaN,NaN,NaN,NaN,NaN,166.18020000000084,167.39143236371115,164.96896763629053,165.46314613222847,166.3118973264798,166.88908585071076,165.73470880224883,12,203.56666666666666,42.02481409064952,42.744841021522724,NaN,NaN,NaN,NaN,0.2011459859670141,19.54733551329543,512634,0.0319093453931347,-0.16429913014587783,-0.19620847553901252
2025-09-17T12:40:00-04:00,165.31,165.31,165.27,165.27,NaN,NaN,NaN,165.8857938933187,165.8857938933187,165.8857938933187,166.15440000000086,167.38694150391132,164.9218584960904,165.46314613222847,166.308913386842,166.8879128503724,165.72991392331159,30,201.23333333333332,39.50774329769883,43.23178272537229,NaN,NaN,NaN,NaN,0.19677841554079784,19.88044257566699,512604,0.015160902648883812,-0.17725734722790776,-0.19241824987679157
2025-09-17T12:50:00-04:00,165.73,165.73,165.73,165.73,NaN,NaN,NaN,165.8857938933187,NaN,NaN,166.1392000000008,167.3735554751107,164.90484452489093,165.46314613222847,166.29792935521613,166.87682298856433,165.71903572186793,200,199.7,50.08624884859271,44.51386492037585,NaN,NaN,NaN,NaN,0.21557995728788223,18.700068971789445,512804,0.034978909449839335,-0.1486946130644924,-0.18367352251433172
2025-09-17T13:10:00-04:00,165.66,165.66,165.59,165.59,NaN,NaN,NaN,165.8857938933187,NaN,NaN,166.1178000000008,167.35239816901841,164.8832018309832,165.46314613222847,166.29611568423374,166.8753119962958,165.71691937217167,28,187.36666666666667,47.37110446130667,44.83875372438381,NaN,NaN,NaN,NaN,0.21018138891017538,17.996435379703442,512776,0.03830684345090751,-0.13578996820069733,-0.17409681165160484
2025-09-17T13:15:00-04:00,165.62,165.62,165.62,165.62,NaN,NaN,NaN,165.8857938933187,NaN,NaN,166.10000000000085,167.33712731716838,164.8628726828333,165.3435169057828,166.2897784859562,166.86992377710285,165.70963319480953,100,156.06666666666666,48.02134991079607,45.07928648973425,NaN,NaN,NaN,NaN,0.19731128970230577,17.343061329909297,512876,0.0418863572914317,-0.12173886503731524,-0.16362522232874693
2025-09-17T13:20:00-04:00,165.62,165.62,165.62,165.62,NaN,NaN,NaN,165.8857938933187,NaN,NaN,166.08000000000084,167.3151858155428,164.84481418445887,165.30764852460862,166.28343576888557,166.86446010811667,165.70241142965446,102,151.43333333333334,48.02134991079607,45.65239173845472,NaN,NaN,NaN,NaN,0.18321762615214107,16.73635685510045,512876,0.04342591507548818,-0.1093428284843867,-0.15276874355987488
2025-09-17T13:30:00-04:00,165.78,165.78,165.78,165.78,NaN,NaN,NaN,165.8857938933187,NaN,NaN,166.06320000000085,167.29138037718704,164.83501962281466,165.41554858786802,166.27880477110352,166.8591441847904,165.69846535741664,100,144.46666666666667,51.71166454411583,46.175228557762296,NaN,NaN,NaN,NaN,0.18155922428413077,15.589450732991029,512976,0.05371801152705291,-0.08562122915105874,-0.13933924067811165
2025-09-17T13:35:00-04:00,165.89,165.94,165.89,165.94,165.35255069711974,165.35255069711974,165.35255069711974,NaN,NaN,NaN,166.05120000000082,167.2722152492665,164.83018475073513,165.56843887029441,166.27431698455948,166.85234552265797,165.69628844646098,139,145.43333333333334,55.141459972301895,46.80001141757308,NaN,NaN,NaN,NaN,0.1800192796924069,14.965162132448965,513115,0.06883406673334766,-0.05329665726142707,-0.12213072399477473
2025-09-17T13:40:00-04:00,166.19,166.19,165.96,165.96,165.5040256654325,NaN,NaN,NaN,NaN,NaN,166.03640000000084,167.2434593021597,164.82934069784199,165.76775109623551,166.27211434056207,166.84790845324986,165.69632022787428,103,147.86666666666667,55.56630748861279,47.17243746910772,NaN,NaN,NaN,NaN,0.1850179025715207,15.129147724400632,513218,0.07708991754326681,-0.02576832706569121,-0.10285824460895802
2025-09-17T13:45:00-04:00,166.01,166.01,166.01,166.01,165.5040256654325,NaN,NaN,NaN,NaN,NaN,166.02520000000084,167.22260045053,164.82779954947168,165.76775109623551,166.2697767472279,166.84352702053798,165.6960264739178,100,147.86666666666667,56.671123771363284,48.003941572080386,NaN,NaN,NaN,NaN,0.17537376667355373,15.281420059784326,513318,0.08235196619890933,0.0000817131396786408,-0.08227025305923069
2025-09-17T13:50:00-04:00,165.91,165.91,165.89,165.89,165.5040256654325,NaN,NaN,NaN,NaN,NaN,166.01100000000082,167.1975883864815,164.82441161352014,165.76775109623551,166.2691124365708,166.84256747803929,165.6956573951023,20,140.6,53.24907900456643,48.61742301257175,NaN,NaN,NaN,NaN,0.1714184976254431,14.932189620996361,513298,0.07442501274013788,0.010761012865941666,-0.06366399987419621
2025-09-17T13:55:00-04:00,165.96,165.96,165.93,165.93,165.5040256654325,NaN,NaN,NaN,NaN,NaN,165.9934000000008,167.15796247534223,164.82883752465938,165.76775109623551,166.26335519986003,166.83340753007946,165.6933028696406,200,145.93333333333334,54.24097034126614,49.38418829022676,NaN,NaN,NaN,NaN,0.16417431922362727,14.771830579708212,513498,0.06868818882062608,0.02219623615158639,-0.04649195266903969
2025-09-17T14:00:00-04:00,166.25,167.5,166.25,167.36,166.15693066747053,NaN,NaN,NaN,NaN,NaN,166.00440000000083,167.20929939784625,164.7995006021554,166.46284684901806,166.3159305453656,166.89967662499876,165.73218446573244,834,172.9,74.81388534351493,51.704587445398474,NaN,NaN,NaN,NaN,0.264590439279082,17.487504361592894,514332,0.15317482788600179,0.14497658218846254,-0.008198245697539241
2025-09-17T14:05:00-04:00,167.13,167.13,166.13,166.13,NaN,NaN,NaN,167.48315709014176,167.48315709014176,167.48315709014176,165.99450000000084,167.18690974455666,164.80209025544502,166.46284684901806,166.32606847339252,166.89061664374722,165.76152030303783,906,199.76666666666668,52.817524873077275,52.08890184704703,NaN,NaN,NaN,NaN,0.3335482650448632,19.604158093495723,513426,0.11967875423219736,0.14140019709270746,0.0217214428605101
2025-09-17T14:10:00-04:00,165.83,165.83,163.85,163.85,NaN,NaN,NaN,165.96528631331714,NaN,NaN,165.93870000000084,167.25929200320022,164.61810799680146,166.46284684901806,166.11816550147887,166.90338564138432,165.33294536157342,1703,255.2,33.28292489483238,51.464481190202946,NaN,NaN,NaN,NaN,0.47258053182737303,19.373868522075824,511723,-0.05329199761641782,-0.04489355416001217,0.008398443456405646
2025-09-17T14:15:00-04:00,163.74,165.1,163.57,165.1,NaN,NaN,NaN,165.61777329907542,NaN,NaN,165.90570000000082,167.22601209906364,164.585387900938,166.46284684901806,166.00330369909852,166.85920197378857,165.14740542440848,1209,293.3333333333333,45.24056062946128,51.873968142471696,NaN,NaN,NaN,NaN,0.5481104938397036,19.48256947933577,512932,-0.07921754653269074,-0.09062348970945777,-0.011405943176767038
2025-09-17T14:20:00-04:00,165.05,165.05,164.44,164.71,NaN,NaN,NaN,165.61777329907542,NaN,NaN,165.86410000000083,167.20130557840784,164.52689442159382,166.46284684901806,166.00283015350192,166.85892002269944,165.1467402843044,6,293.43333333333334,42.670879738101796,51.344298920293774,NaN,NaN,NaN,NaN,0.5561026014225816,19.58350608250572,512926,-0.11609936672420085,-0.1565301515820181,-0.04043078485781725
2025-09-17T14:25:00-04:00,165.45,165.84,165.19,165.72,164.10619209733,164.10619209733,164.10619209733,NaN,NaN,NaN,165.84450000000083,167.16068577674562,164.52831422325605,166.46284684901806,165.98270165266436,166.8227984751239,165.14260483020482,811,317.1333333333333,50.51066683849864,51.56855337580748,NaN,NaN,NaN,NaN,0.5970952727495398,18.38047683475963,513737,-0.06830561624801801,-0.12581280516783977,-0.057507188919821754
2025-09-17T14:30:00-04:00,165.44,165.44,164.82,164.82,164.10619209733,NaN,NaN,NaN,NaN,NaN,165.80610000000084,167.12756175083376,164.48463824916792,166.46284684901806,165.9701971661022,166.81182059305422,165.12857373915017,224,321.26666666666665,44.65108258025221,51.32781999505435,NaN,NaN,NaN,NaN,0.6187313246960017,17.752512642018647,513513,-0.09168034146662728,-0.17210761575310585,-0.08042727428647857
2025-09-17T14:35:00-04:00,164.65,165.18,164.65,164.99,164.10619209733,NaN,NaN,NaN,NaN,NaN,165.76990000000086,167.07958467918618,164.46021532081554,166.46284684901806,165.9434212970862,166.79005418991304,165.09678840425934,457,286.3,45.92709384458164,51.17823027603903,NaN,NaN,NaN,NaN,0.6123933729320017,17.38681304542444,513970,-0.08994288843925888,-0.19285588483555216,-0.10291299639629328
2025-09-17T14:40:00-04:00,164.5,165.11,164.31,164.4,164.10619209733,NaN,NaN,NaN,NaN,NaN,165.72590000000085,167.06848510303328,164.38331489696841,166.46284684901806,165.88845521804728,166.75895423345747,165.0179562026371,754,304,42.28369989454985,50.504804229641465,NaN,NaN,NaN,NaN,0.6257938462940024,17.46914513288778,513216,-0.12085311521482686,-0.25397939041482687,-0.1331262752
2025-09-17T14:45:00-04:00,164,164.7,163.98,164.7,NaN,NaN,NaN,165.88450912556843,165.88450912556843,165.88450912556843,165.69390000000084,167.05634969041796,164.33145030958372,166.46284684901806,165.83991693885434,166.73378420436896,164.94604967333973,645,315.8666666666667,44.686524345119906,49.75802311341418,NaN,NaN,NaN,NaN,0.6325228572730021,17.929642752183604,513861,-0.11353274054256307,-0.27504220087820386,-0.1615094603356408
2025-09-17T14:50:00-04:00,164.3,164.54,163.58,163.83,NaN,NaN,NaN,165.68703143804262,NaN,NaN,165.64350000000087,167.08904522547593,164.1979547745258,165.68527747921445,165.74983308270677,166.70866744796444,164.7909987174491,968,348.1,39.54493793325425,48.61363957374571,NaN,NaN,NaN,NaN,0.6673426531820716,18.78833662547908,512893,-0.15704181425492975,-0.35781172815430295,-0.2007699138993732
2025-09-17T14:55:00-04:00,163.94,164.67,163.94,164.67,NaN,NaN,NaN,165.68703143804262,NaN,NaN,165.59730000000084,167.01644792707583,164.17815207292585,163.53422198337157,165.73592021294183,166.69920203305904,164.77263839282463,212,354.73333333333335,46.00476264369957,47.85175663605544,NaN,NaN,NaN,NaN,0.6796753208119218,19.3349515608366,513105,-0.12064284875622638,-0.3515734748446562,-0.2309306260884298
2025-09-17T15:00:00-04:00,165.81,165.81,165.5,165.5,163.90772548723803,163.90772548723803,163.90772548723803,NaN,NaN,NaN,165.56210000000084,166.89949162511604,164.22470837488564,163.46960224977263,165.73461791572535,166.69324645902515,164.77598937242556,200,354.3666666666667,51.51737754576332,47.72806367471236,NaN,NaN,NaN,NaN,0.7125556550396428,18.006820873654235,513305,-0.03643037345618158,-0.2764685929086568,-0.2400382194524752
2025-09-17T15:05:00-04:00,166.33,166.95,166.22,166.59,164.71941978327266,NaN,NaN,NaN,NaN,NaN,165.55150000000086,166.84708056441633,164.25591943558538,164.3526817998181,165.76034657395059,166.71558445191684,164.80510869598433,634,368.8333333333333,57.63450555124837,47.97045904685394,NaN,NaN,NaN,NaN,0.765230251108239,17.95991596070206,513939,0.09001175115878593,-0.1275235305039928,-0.21753528166277872
2025-09-17T15:10:00-04:00,166.74,167,165.83,165.83,164.71941978327266,NaN,NaN,NaN,NaN,NaN,165.53250000000082,166.7825211994004,164.28247880060124,164.3526817998181,165.77286863726215,166.71797195447854,164.82776532004576,588,385.1,52.6467536829574,46.38709249967127,NaN,NaN,NaN,NaN,0.7941423760290781,17.396198535887304,513351,0.11802646368096428,-0.07000220206157337,-0.18802866574253765
2025-09-17T15:15:00-04:00,166.7,166.7,166.25,166.25,164.71941978327266,NaN,NaN,NaN,NaN,NaN,165.52510000000086,166.75347533307036,164.29672466693137,164.3526817998181,165.79259576695833,166.72913480154983,164.85605673236682,701,408.43333333333334,54.96618435216215,46.54056817674876,NaN,NaN,NaN,NaN,0.7995607777412851,16.872746641416462,514052,0.1579160407565283,0.009366385203122718,-0.14854965555340557
2025-09-17T15:20:00-04:00,166.62,166.79,166.62,166.79,164.75017764959506,NaN,NaN,NaN,NaN,NaN,165.53510000000085,166.7959322485125,164.2742677514892,164.4677730815069,165.80117074255222,166.73770887687914,164.8646326082253,205,406.8,57.826416572316504,48.29367472514048,NaN,NaN,NaN,NaN,0.7810207221883356,16.491629730204412,514257,0.2104556723932285,0.11451993493813006,-0.09593573745509844
2025-09-17T15:25:00-04:00,167.4,167.6,167.33,167.33,165.48857866552257,NaN,NaN,NaN,NaN,NaN,165.55490000000086,166.89431552884048,164.21548447116123,165.3372184652055,165.87410088743576,166.84895050677997,164.89925126809155,1061,441.73333333333335,60.52635851008282,49.385517430899164,NaN,NaN,NaN,NaN,0.7830906706034547,17.001508377857842,515318,0.26769022780032814,0.2386770472953117,-0.029013180505016417
2025-09-17T15:30:00-04:00,167.34,167.35,166.8,166.8,165.48857866552257,NaN,NaN,NaN,NaN,NaN,165.57490000000087,166.95752430142386,164.19227569857787,165.3372184652055,165.91793637846655,166.8974658804506,164.9384068764825,969,473.6333333333333,56.6902648683022,50.386902083056334,NaN,NaN,NaN,NaN,0.766441336988921,16.699080900568134,514349,0.25597212003865355,0.2909519695433005,0.03497984950464697
2025-09-17T15:35:00-04:00,167.05,167.2,167.05,167.2,165.48857866552257,NaN,NaN,NaN,NaN,NaN,165.60330000000084,167.05806267443288,164.1485373255688,165.3372184652055,165.94347418027877,166.92856418793048,164.95838417262706,519,489.93333333333334,58.81196745780602,50.979852127292574,NaN,NaN,NaN,NaN,0.740266955775425,16.418255385941976,514868,0.2604171165210154,0.3605012451559162,0.10008412863490082
2025-09-17T15:40:00-04:00,167.1,167.15,167.1,167.15,165.48857866552257,NaN,NaN,NaN,NaN,NaN,165.63730000000083,167.15427489726304,164.12032510273863,165.60545585418524,165.95765426252584,166.9453327688065,164.96997575624516,302,493.3333333333333,58.426662361865326,51.96382211169351,NaN,NaN,NaN,NaN,0.6945336017914656,16.15748883664626,514566,0.24544832754807255,0.40689453806999154,0.161446210521919
2025-09-17T15:45:00-04:00,167.32,167.32,167.15,167.15,165.48857866552257,NaN,NaN,NaN,NaN,NaN,165.66910000000084,167.24382243869428,164.0943775613074,165.9993646833482,165.9674832302352,166.95743881749775,164.97752764297263,201,499.1,58.426662361865326,52.856648434356636,NaN,NaN,NaN,NaN,0.6570669159492172,16.127211850620274,514566,0.2217274994153035,0.4386055847910484,0.21687808537574488
2025-09-17T15:50:00-04:00,167.33,167.33,166.88,167.01,165.48857866552257,NaN,NaN,NaN,NaN,NaN,165.70550000000082,167.31792953301655,164.0930704669851,166.04849174667856,165.9990693340433,166.99202051800373,165.00611815008287,751,520.8,57.2095381974972,53.922779741710016,NaN,NaN,NaN,NaN,0.6422764219528457,15.644751788629968,513815,0.18432471294336933,0.44728397655495655,0.2629592636115872
2025-09-17T15:55:00-04:00,167.27,167.27,166.69,166.9,165.48857866552257,NaN,NaN,NaN,NaN,NaN,165.7419000000008,167.3781993488191,164.10560065118253,166.04849174667856,166.08611145674917,167.0717606710235,165.10046224247483,2639,605.3666666666667,56.21858520873012,54.74649837482502,NaN,NaN,NaN,NaN,0.6378281060990719,14.88436952527107,511176,0.1418014725287015,0.4402111042724641,0.2984096317437626
2025-09-18T09:30:00-04:00,168.2,169.27,168.2,169.27,166.72186320646975,NaN,NaN,NaN,NaN,NaN,165.82310000000086,167.72685091828254,163.9193490817192,167.03283471787427,168.91333333333333,168.91333333333333,168.91333333333333,6331,813.0666666666667,68.77008774127434,56.83400907539791,NaN,NaN,NaN,NaN,0.7615546699491385,16.29479253514785,517507,0.25624258133971406,0.6187128584184052,0.3624702770786911
2025-09-18T09:35:00-04:00,169.33,169.65,169.13,169.13,167.39746033344838,NaN,NaN,NaN,NaN,NaN,165.90070000000082,168.00990649508574,163.7914935049159,167.60026777429943,168.99169758929696,169.14797011797245,168.83542506062147,1592,861.5,67.53834304453893,58.37212196117215,NaN,NaN,NaN,NaN,0.7443007649527722,17.884586469631962,515915,0.302300346454042,0.7403457101462436,0.4380453636922016
2025-09-18T09:40:00-04:00,169.27,169.28,168.78,169,167.39746033344838,NaN,NaN,NaN,NaN,NaN,165.9765000000008,168.24719526774103,163.7058047322606,167.60026777429943,168.9934029178033,169.14504392511662,168.84176191049,508,875,66.3499456415843,59.43159111087366,NaN,NaN,NaN,NaN,0.7268507103132885,18.804997675385366,515407,0.30303150539015955,0.816834745429901,0.5138032400397414
2025-09-18T09:45:00-04:00,168.76,169.3,168.61,169.3,167.39746033344838,NaN,NaN,NaN,NaN,NaN,166.0501000000008,168.50119648095318,163.59900351904844,167.60026777429943,168.99550582535466,169.14557361502216,168.84543803568715,238,879.6,67.75979177085824,60.15482584084579,NaN,NaN,NaN,NaN,0.724218516719482,19.39308595612173,515645,0.30206542248029733,0.8913850181401131,0.5893195956598157
2025-09-18T09:50:00-04:00,169.36,169.8,169.36,169.54,167.62688675319924,NaN,NaN,NaN,NaN,NaN,166.12690000000083,168.76296288978745,163.49083711021422,168.0645371004413,169.07028638262318,169.30838595807415,168.8321868071722,1306,922.4666666666667,68.8829951568544,61.314557374695575,NaN,NaN,NaN,NaN,0.7082029083823762,20.371217744612785,516951,0.2955686568964897,0.9587804167804279,0.6632117598839382
2025-09-18T09:55:00-04:00,169.58,169.7,169.37,169.69,167.62688675319924,NaN,NaN,NaN,NaN,NaN,166.21210000000082,169.02218760698784,163.4020123930138,168.14662968035304,169.16153516011883,169.45388133385472,168.86918898638294,2141,987.1666666666666,69.59594146844256,62.35954002585846,NaN,NaN,NaN,NaN,0.6811884149264911,21.279482976783047,519092,0.27952868724702085,1.0126226189427143,0.7330939316956935
2025-09-18T10:00:00-04:00,169.695,169.99,169.57,169.95,167.9001798722332,NaN,NaN,NaN,NaN,NaN,166.29870000000082,169.2914076768231,163.30599232317854,168.53730374428244,169.24107227804473,169.59145689409186,168.8906876619976,1618,1013.3,70.84294991243661,63.28929240729561,NaN,NaN,NaN,NaN,0.6625320995746,22.375324470487808,520710,0.26473090448448444,1.064007562301299,0.7992766578168146
2025-09-18T10:05:00-04:00,169.98,170.38,169.98,170.38,168.3269898780408,NaN,NaN,NaN,NaN,NaN,166.39210000000082,169.5899493333695,163.19425066663214,169.00284299542594,169.6358651393864,170.1977464705803,169.07398380819248,8877,1279,72.82786268333922,64.16797127681393,NaN,NaN,NaN,NaN,0.6459226638907005,23.714590985483248,529587,0.2617330521902237,1.1264429730545942,0.8647099208643705
2025-09-18T10:10:00-04:00,170.43,170.51,170.34,170.37,168.6330357926753,NaN,NaN,NaN,NaN,NaN,166.48160000000084,169.86395506103236,163.09924493896932,169.32327439634074,169.6501187944032,170.2163838246923,169.0838537641141,426,1236.4333333333334,72.703905467952,65.31180274821749,NaN,NaN,NaN,NaN,0.6119281878985067,25.062802676933487,529161,0.2376120054329366,1.1617249276555413,0.9241129222226047
2025-09-18T10:15:00-04:00,170.385,170.41,170.3,170.41,168.6330357926753,NaN,NaN,NaN,NaN,NaN,166.57740000000086,170.1240622279078,163.03073777209391,169.4056195170726,169.65080879483062,170.21724387234272,169.08437371731853,22,1196.8666666666666,72.90258211882406,66.3182752240045,NaN,NaN,NaN,NaN,0.5760761744771836,26.231450053461742,529183,0.20416513210620935,1.1793193373553663,0.975154205249157
2025-09-18T10:20:00-04:00,170.44,170.48,170.16,170.16,168.6330357926753,NaN,NaN,NaN,NaN,NaN,166.66860000000085,170.34227937616646,162.99492062383524,169.5164956136581,169.66769299984534,170.23528932099322,169.10009667869747,650,1218.3333333333333,69.49785419081465,67.10907464035802,NaN,NaN,NaN,NaN,0.5577850191573843,27.014653879987215,528533,0.14765389558361708,1.1597215747286782,1.0120676791450611
2025-09-18T10:25:00-04:00,170.37,170.45,170.3,170.39,168.7215899207331,NaN,NaN,NaN,NaN,NaN,166.76560000000086,170.56879478318905,162.96240521681267,169.53419649092646,169.6843012701682,170.25544772178182,169.11315481855456,566,1210.1666666666667,70.84681110859205,67.99622812226707,NaN,NaN,NaN,NaN,0.5386575177889992,27.741914576046582,529099,0.10994472097685337,1.149498580366128,1.0395538593892746
2025-09-18T10:30:00-04:00,170.46,170.58,170.46,170.54,168.91583583342705,NaN,NaN,NaN,NaN,NaN,166.86680000000084,170.79500455664936,162.9385954433523,169.7523571927412,169.69573408102727,170.27130403981914,169.1201641222354,334,1213.8333333333333,71.72505975484185,69.03305109064884,NaN,NaN,NaN,NaN,0.5137534093755011,28.557138013684437,529433,0.08064109240275275,1.1403552248927156,1.0597141324899628
2025-09-18T10:35:00-04:00,170.38,170.42,170.23,170.23,168.91583583342705,NaN,NaN,NaN,NaN,NaN,166.95780000000082,170.98146457833423,162.9341354216674,169.7523571927412,169.70552726594457,170.2813817546544,169.12967277723473,410,1212.2666666666667,67.21820607493444,69.8187382953777,NaN,NaN,NaN,NaN,0.4991995944201083,28.756609563923803,529023,0.028602119153523287,1.0954667814318668,1.0668646622783435
2025-09-18T10:45:00-04:00,170.26,170.63,170.26,170.47,168.91583583342705,NaN,NaN,NaN,NaN,NaN,167.05900000000085,171.17532117295042,162.94267882705128,169.77630860335435,169.71940268842513,170.29874632482824,169.14005905202202,473,1202.9,68.8501053630621,69.82445383979112,NaN,NaN,NaN,NaN,0.4921139091043867,29.19814328624127,529496,0.00007556637134875643,1.0669591202425295,1.0668835538711807
2025-09-18T10:50:00-04:00,170.48,170.48,170.35,170.43,168.91583583342705,NaN,NaN,NaN,NaN,NaN,167.16220000000084,171.35201486928477,162.9723851307169,169.77630860335435,169.72249456486364,170.30242077329413,169.14256835643315,113,1185.1666666666667,68.24037826663071,69.87459921279768,NaN,NaN,NaN,NaN,0.4662486298826444,29.608138885536057,529383,-0.030087565838631702,1.029274096572891,1.0593616624115227
2025-09-18T10:55:00-04:00,170.51,170.69,170.49,170.52,169.11936965849637,NaN,NaN,NaN,NaN,NaN,167.25800000000083,171.53067223162225,162.98532776837942,169.9616375061468,169.73313949303306,170.31704560888036,169.14923337718577,327,1163.8,68.90757315307843,70.0572868921901,NaN,NaN,NaN,NaN,0.45151658489102636,30.254468446365244,529710,-0.05133040115055443,0.9951986609733297,1.046529062123884
2025-09-18T11:00:00-04:00,170.6,170.75,170.6,170.7,169.23985285583746,NaN,NaN,NaN,NaN,NaN,167.36020000000084,171.71211450270664,163.00828549729505,170.05231000491744,169.77284940078087,170.37522218237575,169.170476619186,1131,1194.4333333333334,70.25351922646055,70.23541028187599,NaN,NaN,NaN,NaN,0.43569397168452373,30.9303576002182,530841,-0.06000800054155464,0.9715190614469407,1.0315270619884953
2025-09-18T11:05:00-04:00,170.63,170.99,170.63,170.99,169.39099590784483,NaN,NaN,NaN,NaN,NaN,167.46760000000086,171.90660810529243,163.02859189470928,170.25184800393396,169.91178569507642,170.5826316392141,169.24093975093874,3924,1318.5666666666666,72.33162152410895,70.48174073667988,NaN,NaN,NaN,NaN,0.43028725942134444,31.85632379016163,534765,-0.0531983459957448,0.9650291294938143,1.018227475489559
2025-09-18T11:10:00-04:00,171,171,170.68,170.75,169.44185973021553,NaN,NaN,NaN,NaN,NaN,167.57020000000085,172.07036975667066,163.07003024333105,170.25184800393396,169.92164767589074,170.59533456495535,169.24796078682613,344,1308.9,68.09201600004288,70.37431748893705,NaN,NaN,NaN,NaN,0.42240959803410505,32.72857101040958,534421,-0.07074066609592844,0.9298016428696485,1.000542308965577
2025-09-18T11:15:00-04:00,170.75,171,170.75,170.99,169.50632065156935,NaN,NaN,NaN,NaN,NaN,167.67440000000082,172.24466416729877,163.10413583270287,170.27458272251772,169.9412257263834,170.62234680385282,169.260104648914,631,1310.3333333333333,69.98653132033775,70.31314473235855,NaN,NaN,NaN,NaN,0.4100946267459547,33.53851485778268,535052,-0.07183302380126333,0.9107510292139978,0.9825840530152611
2025-09-18T11:20:00-04:00,171,171.01,170.72,170.72,169.51898789467984,NaN,NaN,NaN,NaN,NaN,167.77000000000083,172.390839750399,163.14916024960266,170.28466617801416,169.9794432642151,170.6691314302818,169.2897550981484,1459,1335.6,65.28994544614588,69.77472207255903,NaN,NaN,NaN,NaN,0.4015164391212431,34.180815771487275,533593,-0.09494088712568949,0.8639079441081492,0.9588488312338387
2025-09-18T11:25:00-04:00,170.71,170.71,170.5,170.5,169.51898789467984,NaN,NaN,NaN,NaN,NaN,167.8608000000008,172.51411338283808,163.20748661716354,170.28466617801416,169.9844714410031,170.67335743503426,169.29558544697196,287,1338.3333333333333,61.65909355212078,68.98580693571394,NaN,NaN,NaN,NaN,0.3885509791840113,33.98609094093582,533306,-0.1272290178043718,0.799812558978374,0.9270415767827458
2025-09-18T11:30:00-04:00,170.66,170.7,170.59,170.59,169.51898789467984,NaN,NaN,NaN,NaN,NaN,167.9524000000008,172.6365871182644,163.2682128817372,170.28466617801416,169.99295032055971,170.68118826469356,169.30471237642587,451,1318,62.575983344875645,68.24819273757477,NaN,NaN,NaN,NaN,0.37508305209943826,33.805275026852314,533757,-0.14350510859471,0.7476601910393583,0.8911652996340683
2025-09-18T11:35:00-04:00,170.56,170.78,170.56,170.78,169.51898789467984,NaN,NaN,NaN,NaN,NaN,168.05020000000084,172.76217366703887,163.33822633296282,170.28466617801416,169.9998203396055,170.68827374854553,169.31136693066546,332,1296.7666666666667,64.50576577316357,67.89161499345683,NaN,NaN,NaN,NaN,0.3640056912351926,33.792741438702464,534089,-0.14218309986125677,0.7134364248074974,0.8556195246687541
2025-09-18T11:40:00-04:00,170.75,170.75,170.48,170.48,169.51898789467984,NaN,NaN,NaN,NaN,NaN,168.14120000000082,172.86160954143517,163.42079045856647,170.28466617801416,170.0095695002517,170.6961026214828,169.3230363790206,600,1299.4666666666667,59.305723266129945,67.0672515761381,NaN,NaN,NaN,NaN,0.3594338561469654,33.46569335933333,533489,-0.1608468363858495,0.6545609791864422,0.8154078155722917
2025-09-18T11:45:00-04:00,170.58,170.635,170.57,170.635,169.51898789467984,NaN,NaN,NaN,NaN,NaN,168.2067000000008,172.97260038071587,163.44079961928574,170.28466617801416,170.01600392831295,170.70167744304322,169.3303304135827,378,1302,61.05267582288035,66.30493843814085,NaN,NaN,NaN,NaN,0.34483143785075365,33.162005857061985,533867,-0.16165522742785954,0.6133387812874673,0.7749940087153269
2025-09-18T11:50:00-04:00,170.56,170.56,170.35,170.35,169.51898789467984,NaN,NaN,NaN,NaN,NaN,168.2911000000008,173.05636989360775,163.52583010639384,170.28466617801416,170.02171947671724,170.7041952073626,169.33924374607187,509,1312.2666666666667,56.26947632122541,65.52288631287593,NaN,NaN,NaN,NaN,0.3405577637185567,32.00004030962713,533358,-0.17894118375965196,0.5513175290157619,0.7302587127754139
2025-09-18T12:00:00-04:00,170.5,170.6,170.44,170.6,169.51898789467984,NaN,NaN,NaN,NaN,NaN,168.42610000000082,173.0611306535014,163.79106934650022,170.28466617801416,170.039658801106,170.71711829566414,169.36219930654784,1273,1329.6666666666667,59.28296632625337,64.83951923881816,NaN,NaN,NaN,NaN,0.3340893520243741,31.02985931130145,534631,-0.17109850710068386,0.516385578899559,0.6874840860002429
2025-09-18T12:05:00-04:00,170.21,170.24,170.04,170.04,169.51898789467984,NaN,NaN,NaN,NaN,NaN,168.52490000000083,173.08207038949297,163.96772961050868,170.28466617801416,170.04036892430275,170.71426406372956,169.36647378487595,399,1255,50.83285749171761,63.59612489775294,NaN,NaN,NaN,NaN,0.35022582687977616,28.89209772572125,534232,-0.19921915576042293,0.4384601412997142,0.6376792970601372
2025-09-18T12:10:00-04:00,170.03,170.29,169.9,170.29,169.51898789467984,NaN,NaN,NaN,NaN,NaN,168.63650000000086,173.08655089845604,164.1864491015457,170.28466617801416,170.04426071538694,170.7074434669892,169.3810779637847,1266,1086.1666666666667,53.98610484577149,62.530305732945294,NaN,NaN,NaN,NaN,0.35306683924550547,27.320246323012693,535498,-0.19626042068847938,0.39235377119953796,0.5886141918880173
2025-09-18T12:15:00-04:00,170.31,170.31,170.26,170.26,169.51898789467984,NaN,NaN,NaN,NaN,NaN,168.72730000000084,173.1205171399624,164.33408286003927,170.14822908314326,170.04721465357582,170.70668340634123,169.38774590081042,501,1049.8,53.542346634763696,61.33665054782409,NaN,NaN,NaN,NaN,0.3314192078708273,25.792577361886433,534997,-0.19139846045357356,0.3493661163210504,0.540764576774624
2025-09-18T12:20:00-04:00,170.39,170.39,170.3,170.3,169.51898789467984,NaN,NaN,NaN,NaN,NaN,168.8369000000008,173.1064221698585,164.56737783014313,170.14822908314326,170.0479445330094,170.7067179476767,169.3891711183421,102,1036.2666666666667,54.08428411549568,60.03326930435171,NaN,NaN,NaN,NaN,0.3170321215943393,24.09407702998905,535099,-0.18069499527307764,0.3148958326832769,0.49559082795635456
2025-09-18T12:25:00-04:00,170.26,170.26,170.26,170.26,169.51898789467984,NaN,NaN,NaN,NaN,NaN,168.94230000000084,173.0850658440799,164.79953415592178,170.14822908314326,170.0484797698074,170.7065073039288,169.39045223568598,100,1031.6666666666667,53.41327898329039,58.984788088869394,NaN,NaN,NaN,NaN,0.2972441129090308,22.653609394480895,534999,-0.17158485395322493,0.2811097605148234,0.4526946144680483
2025-09-18T12:30:00-04:00,170.24,170.43,170.19,170.42,169.51898789467984,NaN,NaN,NaN,NaN,NaN,169.06270000000083,173.01600404078428,165.10939595921738,170.0945832665146,170.05235010795545,170.70696387404288,169.397736341868,521,1005.5,55.77674899868193,57.969803637322556,NaN,NaN,NaN,NaN,0.2931552477012435,21.36414965025508,535520,-0.15079633646942425,0.264199193881268,0.41499553035069225
2025-09-18T12:35:00-04:00,170.36,170.54,170.36,170.54,169.51898789467984,NaN,NaN,NaN,NaN,NaN,169.17950000000084,172.95123501175104,165.40776498825065,170.03316661321168,170.05808910517948,170.71015494942313,169.40602326093583,546,952.3333333333334,57.51752815540332,57.41463097369808,NaN,NaN,NaN,NaN,0.28507273000829597,20.53538533223659,536066,-0.12598681869064715,0.2575120069873833,0.38349882567803045
2025-09-18T12:40:00-04:00,170.57,170.66,170.57,170.62,169.620704183919,NaN,NaN,NaN,NaN,NaN,169.31530000000083,172.78356320208002,165.84703679792165,170.19158674991257,170.06327132084965,170.71451088574307,169.41203175595624,381,911.1,58.68512491350228,57.202204642368194,NaN,NaN,NaN,NaN,0.2732818207219894,20.15095087259146,536447,-0.10222312885284607,0.25571991461197285,0.3579430434648189
2025-09-18T12:45:00-04:00,170.66,170.78,170.66,170.78,169.74908126646812,NaN,NaN,NaN,NaN,NaN,169.43750000000082,172.664641304452,166.21035869554964,170.32526939993008,170.07277593712985,170.7243110756494,169.42124079861028,585,634.7,60.99414435907967,57.089216143382764,NaN,NaN,NaN,NaN,0.26519026209898994,20.16037494377239,537032,-0.07502227530265271,0.26416519933650306,0.3391874746391558
2025-09-18T12:50:00-04:00,170.74,170.82,170.62,170.62,169.76594120890138,NaN,NaN,NaN,NaN,NaN,169.5399000000008,172.5803029270648,166.49949707293683,170.35621551994404,170.08182274788092,170.7327560660094,169.43088942975245,623,641.2666666666667,57.53147263506996,56.59105234780465,NaN,NaN,NaN,NaN,0.26053381480620413,20.169125867011825,536409,-0.06734364929760261,0.25500791301715253,0.32235156231475515
2025-09-18T12:55:00-04:00,170.64,170.66,170.56,170.66,169.76594120890138,NaN,NaN,NaN,NaN,NaN,169.62130000000084,172.5575839166014,166.68501608340028,170.35621551994404,170.0840177323344,170.73455466076746,169.43348080390132,171,646.2333333333333,58.17080599422773,56.50998682838307,NaN,NaN,NaN,NaN,0.24906711374861773,19.886248501183797,536580,-0.05938668101049782,0.2481182110516329,0.3075048920621307
2025-09-18T13:00:00-04:00,170.78,170.78,170.67,170.67,169.82632246513535,NaN,NaN,NaN,NaN,NaN,169.71810000000085,172.4607898400797,166.97541015992198,170.3831779327642,170.09296745230077,170.7430504003525,169.44288450424904,619,645.2,58.339658566486875,56.316199881497816,NaN,NaN,NaN,NaN,0.23984803419514536,20.030513084285452,537199,-0.05345154625504456,0.240690459243325,0.29414200549836955
2025-09-18T13:05:00-04:00,170.77,170.83,170.75,170.75,169.91035326217468,NaN,NaN,NaN,NaN,NaN,169.80810000000082,172.37965897442268,167.23654102557896,170.43254234621136,170.10494657754052,170.7555231887962,169.45436996628484,768,651.9333333333333,59.7398214209401,56.56408167433458,NaN,NaN,NaN,NaN,0.2341446031812082,20.329618994870604,537967,-0.04450572380576212,0.23850985074116693,0.28301557454692905
2025-09-18T13:10:00-04:00,170.72,170.72,170.62,170.65,169.91035326217468,NaN,NaN,NaN,NaN,NaN,169.88530000000083,172.31780192988768,167.45279807011397,170.43254234621136,170.1102711558016,170.7600086324982,169.460533679105,422,654.8666666666667,57.154008402348005,56.41201325119848,NaN,NaN,NaN,NaN,0.2267057029539787,19.928147834063108,537545,-0.045527557371809135,0.22610612783216766,0.2716336852039768
2025-09-18T13:15:00-04:00,170.63,170.67,170.63,170.67,169.91035326217468,NaN,NaN,NaN,NaN,NaN,169.95210000000083,172.28150171694338,167.62269828305827,170.43254234621136,170.1128272196358,170.76211451994644,169.46353991932514,208,648.1333333333333,57.54976483000236,56.89179234679025,NaN,NaN,NaN,NaN,0.21336958131440825,19.555353184741858,537753,-0.044981472248022736,0.21540684489394835,0.2603883171419711
2025-09-18T13:20:00-04:00,170.71,170.77,170.59,170.7,169.91035326217468,NaN,NaN,NaN,NaN,NaN,170.03010000000083,172.18687211566595,167.8733278843357,170.43254234621136,170.11560143840882,170.7645391585466,169.46666371827104,216,639.5666666666667,58.173846813225445,57.19091677303696,NaN,NaN,NaN,NaN,0.210986039791951,19.598644031034677,537969,-0.042740574237357165,0.2069625993452746,0.24970317358263178
2025-09-18T13:25:00-04:00,170.53,170.57,170.51,170.57,169.91035326217468,NaN,NaN,NaN,NaN,NaN,170.0975000000008,172.101510229258,168.0934897707436,170.43254234621136,170.11772031419366,170.76578049977508,169.46966012861225,219,643.1,54.438954363675,57.254960182244915,NaN,NaN,NaN,NaN,0.2094870369496686,19.190806671207497,537750,-0.04966828371642626,0.18761781893709895,0.2372861026535252
2025-09-18T13:30:00-04:00,170.55,170.55,170.39,170.39,169.91035326217468,NaN,NaN,NaN,NaN,NaN,170.16230000000084,171.98193865613277,168.3426613438689,170.43254234621136,170.12073092511275,170.76654056421097,169.47492128601453,419,646.1666666666666,49.68265731734017,56.940558268090946,NaN,NaN,NaN,NaN,0.20738082002469277,18.17947584916522,537331,-0.06505721589163424,0.1559645827889824,0.22102179868061664
2025-09-18T13:35:00-04:00,170.29,170.4,170.16,170.4,169.91035326217468,NaN,NaN,NaN,NaN,NaN,170.22730000000084,171.8312915332995,168.62330846670218,170.43254234621136,170.1265369096843,170.7637506967367,169.48932312263187,1360,653.8,49.94430978052767,56.6927747536079,NaN,NaN,NaN,NaN,0.20971076145150108,17.55918780279456,538691,-0.07266913059797236,0.13018538543315117,0.20285451603112353
2025-09-18T13:40:00-04:00,170.35,170.35,170.22,170.31,169.91035326217468,NaN,NaN,NaN,NaN,NaN,170.2933000000008,171.60776964169395,168.97883035830768,170.43254234621136,170.12785571071296,170.76271728219098,169.49299413923495,372,535.4,47.54787593967488,56.10499810653596,NaN,NaN,NaN,NaN,0.20758856420496577,16.983206045450373,538319,-0.08122367100734179,0.10132492727194631,0.1825485982792881
2025-09-18T13:45:00-04:00,170.28,170.52,170.28,170.52,169.91035326217468,NaN,NaN,NaN,NaN,NaN,170.36570000000083,171.2544159495122,169.47698405048945,170.43254234621136,170.13344612130447,170.7639574110145,169.50293483159444,858,552.5333333333333,53.19158749400019,55.79600234500716,NaN,NaN,NaN,NaN,0.2099036667617546,15.92090093177448,539177,-0.07059016348030558,0.09431089392890613,0.1649010574092117
2025-09-18T13:50:00-04:00,170.54,170.73,170.43,170.73,169.91035326217468,NaN,NaN,NaN,NaN,NaN,170.3949000000008,171.23214426480203,169.55765573519957,170.43254234621136,170.13821949337083,170.76756069092315,169.5088782958185,465,547,58.05224615292389,55.750796719251575,NaN,NaN,NaN,NaN,0.21633911913591378,15.798590042738475,539642,-0.04832649601515987,0.10449293739026189,0.15281943340542176
2025-09-18T13:55:00-04:00,170.64,170.64,170.56,170.56,169.91035326217468,NaN,NaN,NaN,NaN,NaN,170.42350000000081,171.17973342885864,169.667266571143,170.41890168126022,170.1423529010146,170.77025116557095,169.51445463645823,450,513.3666666666667,53.233128678829914,55.19643845637658,NaN,NaN,NaN,NaN,0.2130291820547762,15.685015645776474,539192,-0.044080934242739234,0.0977182656019977,0.14179919984473693
2025-09-18T14:00:00-04:00,170.79,170.82,170.71,170.82,169.99913441967036,NaN,NaN,NaN,NaN,NaN,170.45990000000083,171.10570024691296,169.8140997530887,170.41890168126022,170.14661749645637,170.77458921995043,169.51864577296232,327,514.7,58.858346422222084,55.29121515545887,NaN,NaN,NaN,NaN,0.21638424047943441,16.250026156695554,539519,-0.023809266606005464,0.1120376165872301,0.13584688319323557
2025-09-18T14:05:00-04:00,170.91,171.04,170.91,171.01,170.21394649150352,NaN,NaN,NaN,NaN,NaN,170.49410000000083,171.06764926458908,169.92055073541258,170.5027631781541,170.16845900794675,170.80246705793775,169.53445095795576,1312,543.4,62.41603966267378,55.59444613177645,NaN,NaN,NaN,NaN,0.21664250901661758,17.461686961713756,540831,0.001031609061853983,0.13713639452055304,0.13610478545869906
2025-09-18T14:10:00-04:00,170.96,170.96,170.81,170.87,170.21394649150352,NaN,NaN,NaN,NaN,NaN,170.52070000000083,171.03510065990466,170.006299340097,170.5027631781541,170.18091374610592,170.8162382063496,169.54558928586223,899,562.3,58.40811919036057,55.59933617633886,NaN,NaN,NaN,NaN,0.21545375837257266,18.034493071430894,539932,0.00637199574765604,0.1440697801432691,0.13769778439561306
2025-09-18T14:15:00-04:00,170.96,171.11,170.93,170.93,170.2678004189113,NaN,NaN,NaN,NaN,NaN,170.54550000000083,171.01490920201115,170.0760907979905,170.56616843401866,170.18910051074494,170.8263679036286,169.55183311786126,525,559.8,59.60528775153485,55.589726628524204,NaN,NaN,NaN,NaN,0.21720706134596096,19.022686919029848,540457,0.011958911528449467,0.15264642380617488,0.1406875122777254
2025-09-18T14:20:00-04:00,170.94,171.06,170.94,171.06,170.2678004189113,NaN,NaN,NaN,NaN,NaN,170.56770000000085,171.02724416422524,170.10815583577647,170.56616843401866,170.19179813270836,170.82978356996927,169.55381269544745,169,552.8333333333334,62.14753450273476,55.94640706426611,NaN,NaN,NaN,NaN,0.21097798553553487,19.940295491800306,540626,0.021847451301536897,0.16799682640464653,0.14614937510310963
2025-09-18T14:25:00-04:00,171.07,171.17,171.07,171.13,170.40270658004107,NaN,NaN,NaN,NaN,NaN,170.58270000000084,171.0651487940572,170.1002512059445,170.71494779777194,170.19893701387832,170.83964389508068,169.55823013267596,402,549.2666666666667,63.48031780433395,56.37001799100408,NaN,NaN,NaN,NaN,0.20376527228299562,21.12306254438269,541028,0.030034937471916934,0.1836930469430058,0.15365810947108888
2025-09-18T14:30:00-04:00,171.16,171.22,171.16,171.2,170.4930380991301,NaN,NaN,NaN,NaN,NaN,170.59930000000085,171.10774865904693,170.09085134095477,170.81095823821755,170.20412293843597,170.8471582655578,169.56108761131415,275,516,64.81449597476458,56.84435007397116,NaN,NaN,NaN,NaN,0.19563918140563905,22.367370175069627,541303,0.036658578946815595,0.19948133315460836,0.16282275420779277
2025-09-18T14:35:00-04:00,171.12,171.13,171.05,171.07,170.4930380991301,NaN,NaN,NaN,NaN,NaN,170.61250000000084,171.13468866218224,170.09031133781943,170.81095823821755,170.21578761227548,170.8624159058376,169.56915931871336,709,526.3333333333334,60.40120616050674,57.27022520231628,NaN,NaN,NaN,NaN,0.19237923987666322,22.821482595912748,540594,0.0291077255519345,0.1992074111477109,0.1700996855957764
2025-09-18T14:40:00-04:00,171.1,171.1,170.8,170.83,170.4930380991301,NaN,NaN,NaN,NaN,NaN,170.62590000000083,171.1351806288391,170.11661937116256,170.81095823821755,170.22718490024297,170.87452232204714,169.5798474784388,892,513.8666666666667,53.19928054396543,57.52141257564666,NaN,NaN,NaN,NaN,0.2000664370283289,21.884043591478,539702,0.005982116176047991,0.17757733081583638,0.17159521463978838
2025-09-18T14:45:00-04:00,170.86,171.01,170.86,171,170.4930380991301,NaN,NaN,NaN,NaN,NaN,170.6381000000008,171.1533820188463,170.12281798115532,170.81095823821755,170.23254266086897,170.8804992121475,169.58458610959045,402,510.56666666666666,57.10113598577532,58.03261444745006,NaN,NaN,NaN,NaN,0.19863312009773246,21.013564515931453,540104,0.0004584418535772128,0.1721682669567599,0.1717098251031827
2025-09-18T14:50:00-04:00,171.17,171.2,171.11,171.145,170.4930380991301,NaN,NaN,NaN,NaN,NaN,170.65020000000084,171.18378770499365,170.11661229500803,170.81095823821755,170.23942604916562,170.88979727240493,169.5890548259263,413,520.9333333333333,60.152692330333416,58.93295847535425,NaN,NaN,NaN,NaN,0.19873075437646506,20.94877427022317,540517,0.004660393074717717,0.17753531644657983,0.1728749233718621
2025-09-18T14:55:00-04:00,171.19,171.2,171.12,171.2,170.4958095715207,NaN,NaN,NaN,NaN,NaN,170.66960000000083,171.2111416501948,170.12805834980685,170.81095823821755,170.24616790883564,170.89899257334798,169.5933432443233,401,530.9666666666667,61.277852643472166,59.51054884317367,NaN,NaN,NaN,NaN,0.19024998620671643,20.888611899208335,540918,0.00898369302140245,0.18410453964861517,0.17512084662721272
2025-09-18T15:00:00-04:00,171.2,171.2,170.91,170.94,170.4958095715207,NaN,NaN,NaN,NaN,NaN,170.67900000000083,171.2226690159454,170.13533098405625,170.81095823821755,170.2607425952419,170.91582718128356,169.60565800920025,1071,549.3,53.57621947759356,59.19083265207864,NaN,NaN,NaN,NaN,0.1973749871919504,19.728315794096446,539847,-0.006966622284929447,0.16641256877105093,0.17337919105598038
2025-09-18T15:05:00-04:00,170.92,170.99,170.91,170.97,170.4958095715207,NaN,NaN,NaN,NaN,NaN,170.68980000000084,171.2347071837266,170.14489281627507,170.81095823821755,170.26360693367107,170.91885856619837,169.60835530114377,234,538.9,54.290094528893015,59.26633021279743,NaN,NaN,NaN,NaN,0.18899105953538342,18.650897982206835,540081,-0.016264904133170305,0.1530480608895175,0.1693129650226878
2025-09-18T15:10:00-04:00,171.09,171.11,171.01,171.01,170.4958095715207,NaN,NaN,NaN,NaN,NaN,170.69960000000083,171.24954123223705,170.1496587677646,170.81095823821755,170.2652765540442,170.92081784827295,169.60973525981544,122,530.2666666666667,55.27757933553635,59.01056113517702,NaN,NaN,NaN,NaN,0.18549169813999994,18.18585666112706,540203,-0.02023114133725462,0.14402403835111954,0.16425517968837416
2025-09-18T15:15:00-04:00,170.98,170.98,170.87,170.87,170.4958095715207,NaN,NaN,NaN,NaN,NaN,170.70300000000083,171.25500724533913,170.15099275466252,170.81095823821755,170.26997006127135,170.92539210595493,169.61454801658778,420,524.7666666666667,51.11536630701622,58.203370181201485,NaN,NaN,NaN,NaN,0.18224229112999898,17.034028008053063,539783,-0.0320885081728583,0.12414454447230128,0.15623305264515958
2025-09-18T15:20:00-04:00,170.89,170.89,170.85,170.85,170.4958095715207,NaN,NaN,NaN,NaN,NaN,170.7002000000008,171.24775806902556,170.15264193097602,170.78084519549915,170.27607845334992,170.93086310372698,169.62129380297287,597,523.9,50.53002197387125,57.64064895145225,NaN,NaN,NaN,NaN,0.17208212747785565,15.865034898091418,539186,-0.04053904356292998,0.10555924819149709,0.14609829175442707
2025-09-18T15:25:00-04:00,170.85,170.89,170.82,170.88,170.4958095715207,NaN,NaN,NaN,NaN,NaN,170.7028000000008,171.25250959510012,170.15309040490146,170.78084519549915,170.27835815383563,170.93289015705847,169.62382615061279,226,525.7333333333333,51.42852018834051,57.0565941255098,NaN,NaN,NaN,NaN,0.1647905469437226,14.839118564854667,539412,-0.04312797210387767,0.09218832662457999,0.13531629872845766
2025-09-18T15:30:00-04:00,170.85,170.85,170.66,170.67,170.4958095715207,NaN,NaN,NaN,NaN,NaN,170.6964000000008,171.24000294233622,170.1527970576654,170.78084519549915,170.29096126450986,170.94046847334806,169.64145405567166,1684,561.2333333333333,45.235059438756316,55.84856019236849,NaN,NaN,NaN,NaN,0.1687340793048852,14.661686198713417,537728,-0.05712518506180911,0.06390981740119628,0.12103500246300539
2025-09-18T15:35:00-04:00,170.68,170.71,170.59,170.67,170.4958095715207,NaN,NaN,NaN,NaN,NaN,170.69540000000077,171.2390095648136,170.15179043518793,170.78084519549915,170.29532258419246,170.94216456591337,169.64848060247155,723,559.7333333333333,45.235059438756316,54.54532745197008,NaN,NaN,NaN,NaN,0.16525307364025088,14.80588536921848,537728,-0.06400722339083312,0.041025973224463996,0.10503319661529711
2025-09-18T15:40:00-04:00,170.71,170.72,170.55,170.6,170.4958095715207,NaN,NaN,NaN,NaN,NaN,170.69740000000078,171.23885079089544,170.15594920910613,170.78084519549915,170.299536614887,170.94327079734808,169.6558024324259,789,571.9666666666667,43.222771675098734,53.00306143056538,NaN,NaN,NaN,NaN,0.16559213980880352,15.115201926009853,536939,-0.07039019134285954,0.0170454574367227,0.08743564877958224
2025-09-18T15:45:00-04:00,170.55,170.57,170.43,170.48,NaN,NaN,NaN,171.07743981483944,171.07743981483944,171.07743981483944,170.69520000000077,171.2392660244756,170.15113397552594,170.71967615639932,170.3076660218711,170.93895044938276,169.67638159435947,2689,654.6666666666666,39.94244248231324,51.541721167837274,NaN,NaN,NaN,NaN,0.16590698696531667,15.904629465766416,534250,-0.07915619563014505,-0.011509595758099067,0.06764659987204598
2025-09-18T15:50:00-04:00,170.55,170.67,170.52,170.67,NaN,NaN,NaN,171.07743981483944,NaN,NaN,170.69300000000075,171.2365660024381,170.1494339975634,170.70059274009557,170.31141127602845,170.93981961834908,169.68300293370783,778,673.4,46.82387059136434,51.08633474265149,NaN,NaN,NaN,NaN,0.16762791646779387,15.985370289766834,535028,-0.06899242373041035,-0.018593929790966968,0.05039849393944339
2025-09-18T15:55:00-04:00,170.74,170.76,170.53,170.53,NaN,NaN,NaN,171.07743981483944,NaN,NaN,170.69400000000078,171.23617709186868,170.15182290813289,170.70059274009557,170.32107323533506,170.9413423677518,169.70080410291834,2195,739.2666666666667,42.921364831579865,50.07349394592324,NaN,NaN,NaN,NaN,0.17208306529152215,15.512323434100656,532833,-0.06839921793560098,-0.03510052848005785,0.03329868945554314