time,open,high,low,close,Long Stop,Long Stop Start,Buy Label,Short Stop,Short Stop Start,Sell Label,Basis,Upper,Lower,ATR Trailing Stoploss,VWAP,Upper Band #1,Lower Band #1,Volume,Volume MA,RSI,RSI-based MA,Regular Bullish,Regular Bullish Label,Regular Bearish,Regular Bearish Label,ATR,ADX,OnBalanceVolume,Histogram,MACD,Signal
2025-08-28T09:45:00-04:00,104.72,104.75,104.02,104.25,103.53217655160441,NaN,NaN,NaN,NaN,NaN,104.53930000000005,105.82170712723568,103.25689287276442,103.34958530962511,104.69868993063382,104.88203545116198,104.51534441010566,60441,46462.933333333334,48.80432500889263,35.483863087255536,NaN,NaN,NaN,NaN,0.5460655986274736,32.8389902573194,40659494,0.1124494846543097,-0.16053566939299913,-0.27298515404730883
2025-08-28T09:50:00-04:00,104.28,104.32,103.39,103.74,NaN,NaN,NaN,105.36837462017199,105.36837462017199,105.36837462017199,104.50730000000004,105.78803917719077,103.22656082280932,103.34958530962511,104.51072663622942,104.90684497783153,104.11460829462732,93726,49168,43.608235512592415,36.53199887512823,NaN,NaN,NaN,NaN,0.5734894844397963,31.44437831162562,40565768,0.07161684683210606,-0.18346409550717624,-0.2550809423392823
2025-08-28T09:55:00-04:00,103.75,104.01,103,103.3,NaN,NaN,NaN,105.08731213743691,NaN,NaN,104.46730000000005,105.77122823421733,103.16337176578277,103.34958530962511,104.38151118089446,104.89153189651736,103.87149046527156,60148,50570.6,39.68280035484142,37.20439237354971,NaN,NaN,NaN,NaN,0.6046688069798112,30.65731819824773,40505620,0.016515219233501965,-0.23443691829740487,-0.25095213753090684
2025-08-28T10:00:00-04:00,103.31,103.95,103.235,103.7,NaN,NaN,NaN,105.08731213743691,NaN,NaN,104.44970000000006,105.77071235421613,103.128687645784,103.34958530962511,104.29560626412085,104.83205255219312,103.75915997604858,64365,52401.63333333333,44.56789169493082,38.260154693072856,NaN,NaN,NaN,NaN,0.6125496064812535,29.926476664396823,40569985,0.008927779730690144,-0.23979241286754416,-0.2487201925982343
2025-08-28T10:05:00-04:00,103.69,104.61,103.6,104.12,NaN,NaN,NaN,105.08731213743691,NaN,NaN,104.44310000000007,105.76733395213296,103.11886604786719,103.34958530962511,104.27185884092773,104.77663500966969,103.76708267218578,82796,54249.76666666667,49.21851238836405,39.91184385697441,NaN,NaN,NaN,NaN,0.6409389203040214,28.05496038697774,40652781,0.03277506400034405,-0.20775136259780425,-0.2405264265981483
2025-08-28T10:10:00-04:00,104.1,104.5,104.03,104.36,NaN,NaN,NaN,105.08731213743691,NaN,NaN,104.44910000000007,105.76904801412063,103.12915198587952,103.34958530962511,104.27432985858441,104.75336490085257,103.79529481631624,71588,55635.23333333333,51.71160781952793,41.756570237382455,NaN,NaN,NaN,NaN,0.6287289974251626,26.317123843660017,40724369,0.0635130296038571,-0.16113513959332693,-0.22464816919718403
2025-08-28T10:15:00-04:00,104.36,104.4,103.95,104,NaN,NaN,NaN,105.08731213743691,NaN,NaN,104.44870000000009,105.76917992789129,103.12822007210889,103.34958530962511,104.26255068834703,104.72520465867458,103.79989671801948,58031,56339.26666666667,47.911878784415116,42.928200098302916,NaN,NaN,NaN,NaN,0.6159626404662227,24.834916771292963,40666338,0.05852324849130605,-0.15149410858305146,-0.2100173570743575
2025-08-28T10:20:00-04:00,104.01,104.37,103.92,104.11,NaN,NaN,NaN,105.08731213743691,NaN,NaN,104.43850000000008,105.76140627029154,103.1155937297086,103.32366824770008,104.25718547370725,104.71086565334475,103.80350529406975,33648,56762.26666666667,49.14158750820518,44.28046965446614,NaN,NaN,NaN,NaN,0.6041081661472071,23.510272056495534,40699986,0.06126249614268972,-0.13343923689599535,-0.19470173303868507
2025-08-28T10:25:00-04:00,104.13,104.13,103.44,103.52,NaN,NaN,NaN,105.08731213743691,NaN,NaN,104.41750000000008,105.76450593910168,103.07049406089847,103.04293459816007,104.23500844027376,104.69285229536356,103.77716458518395,33384,56942.86666666667,43.24448950219659,45.23051343352818,NaN,NaN,NaN,NaN,0.6102432971366921,23.060992894128365,40666602,0.023890559105655712,-0.16483853415661542,-0.18872909326227114
2025-08-28T10:30:00-04:00,103.55,104.04,103.48,104.02,NaN,NaN,NaN,105.08731213743691,NaN,NaN,104.41210000000007,105.76326555609188,103.06093444390825,102.89134767852806,104.21891409439485,104.673803741287,103.76402444750269,36481,57515.5,48.846770601940925,47.066524766656066,NaN,NaN,NaN,NaN,0.6066544901983572,22.64380510050171,40703083,0.03284360942687098,-0.1476745814786824,-0.18051819090555338
2025-08-28T10:35:00-04:00,104.02,104.27,103.88,104.27,NaN,NaN,NaN,105.08731213743691,NaN,NaN,104.40970000000007,105.76144022651503,103.05795977348511,102.79177183829609,104.21656551344314,104.66483561022108,103.76829541666521,27001,57392.566666666666,51.428400346716366,49.10945318286821,NaN,NaN,NaN,NaN,0.5911791694699031,21.74672499403462,40730084,0.05433365748417143,-0.1126011190503391,-0.16693477653451053
2025-08-28T10:40:00-04:00,104.3,104.45,104.2,104.31,NaN,NaN,NaN,105.08731213743691,NaN,NaN,104.41070000000008,105.7620696903429,103.05933030965726,103.14241747063687,104.22069897889179,104.66038784356769,103.78101011421589,37765,57796.86666666667,51.84714340599106,48.49791453482435,NaN,NaN,NaN,NaN,0.5668092287934815,20.52998678332229,40767849,0.06902956221296652,-0.08064782376830237,-0.1496773859812689
2025-08-28T10:45:00-04:00,104.35,104.39,103.91,104.25,NaN,NaN,NaN,105.08731213743691,NaN,NaN,104.40890000000007,105.76088119808642,103.05691880191372,103.14241747063687,104.2200531123361,104.65595259804786,103.78415362662435,16622,57217.53333333333,51.13501300214991,48.17599627968729,NaN,NaN,NaN,NaN,0.5606085695939474,19.93147424791797,40751227,0.0721575472008838,-0.05948045198016416,-0.13163799918104796
2025-08-28T10:50:00-04:00,104.26,104.53,104.22,104.48,NaN,NaN,NaN,105.08731213743691,NaN,NaN,104.41210000000007,105.76398178476947,103.06021821523066,103.3461471812076,104.22650530159575,104.65631691932546,103.79669368386604,33814,57864.6,53.75706531081826,48.2075515172559,NaN,NaN,NaN,NaN,0.5427079574800943,19.063280159448624,40785041,0.08621367092232171,-0.023870910528145828,-0.11008458145046754
2025-08-28T10:55:00-04:00,104.51,104.77,104.34,104.52,NaN,NaN,NaN,105.08731213743691,NaN,NaN,104.41890000000006,105.76946327507879,103.06833672492134,103.60791774496607,104.23959604009406,104.66513234211475,103.81405973807337,42903,57833.46666666667,54.217176689416384,48.59418378015045,NaN,NaN,NaN,NaN,0.5346573890886585,17.7400282247855,40827944,0.09406064053595362,0.0074912192194744875,-0.08656942131647913
2025-08-28T11:00:00-04:00,104.53,104.65,104.13,104.17,NaN,NaN,NaN,105.08731213743691,NaN,NaN,104.41510000000008,105.76737288665522,103.06282711334494,103.60791774496607,104.24167556730436,104.66161739799372,103.82173373661499,28794,57286.03333333333,49.56960810233608,49.01999610798929,NaN,NaN,NaN,NaN,0.5336104327251836,16.93418121598034,40799150,0.07250120941730225,0.004057090455148682,-0.06844411896215356
2025-08-28T11:05:00-04:00,104.15,104.15,103.85,104.02,NaN,NaN,NaN,105.08731213743691,NaN,NaN,104.40290000000006,105.75820083745134,103.04759916254878,103.60791774496607,104.23378913404218,104.6487883296035,103.81878993848086,37055,57067.5,47.68308907378497,49.59144530219954,NaN,NaN,NaN,NaN,0.5183525446733853,16.712005436873614,40762095,0.04623888486258222,-0.01064551288392579,-0.05688439774650801
2025-08-28T11:10:00-04:00,104.02,104.23,103.94,104.1,NaN,NaN,NaN,105.08731213743691,NaN,NaN,104.38990000000007,105.74410307191741,103.03569692808273,103.60791774496607,104.23209499462426,104.64493381909904,103.81925617014949,13165,55169.96666666667,48.80221835733833,49.89389720665722,NaN,NaN,NaN,NaN,0.5020416486252868,16.31337950881864,40775260,0.032978267168215426,-0.01566156378623873,-0.04863983095445416
2025-08-28T11:15:00-04:00,104.09,104.36,103.95,103.95,NaN,NaN,NaN,105.08731213743691,NaN,NaN,104.37130000000006,105.72361181315719,103.01898818684293,103.60791774496607,104.22895449843581,104.63785817865435,103.82005081821727,24662,54884.166666666664,46.78153354815513,49.71982728949944,NaN,NaN,NaN,NaN,0.49546724515205176,15.6276903052863,40750598,0.01380878412091769,-0.031378850803307046,-0.045187634924224736
2025-08-28T11:20:00-04:00,103.95,103.95,103.66,103.8,NaN,NaN,NaN,105.08731213743691,NaN,NaN,104.34870000000006,105.70067752940055,102.99672247059958,103.60791774496607,104.21589629408949,104.62511473122903,103.80667785694995,36147,54491.2,44.784561339739675,49.22503825522885,NaN,NaN,NaN,NaN,0.4807910133554771,15.571823754181091,40714451,-0.008090838290679067,-0.055301182787573566,-0.0472103444968945
2025-08-28T11:25:00-04:00,103.79,103.82,103.44,103.61,NaN,NaN,NaN,105.06471610148489,NaN,NaN,104.32830000000006,105.69340162259586,102.96319837740425,103.60791774496607,104.19941782148204,104.61450319275687,103.78433245020722,33701,51924.433333333334,42.32026479439856,48.825637255941956,NaN,NaN,NaN,NaN,0.473591655258657,15.924320428989658,40680750,-0.03308791066563849,-0.08857023282894261,-0.05548232216330412
2025-08-28T11:30:00-04:00,103.57,103.89,103.57,103.7,NaN,NaN,NaN,105.06471610148489,NaN,NaN,104.30430000000005,105.67054743000705,102.93805256999306,103.60791774496607,104.19277645998417,104.60876796840853,103.77678495155982,17024,51406.9,43.895113802180525,48.45088913408305,NaN,NaN,NaN,NaN,0.462620822740182,16.059920423709777,40697774,-0.040771656920113794,-0.10644689331344637,-0.06567523639333257
2025-08-28T11:35:00-04:00,103.69,103.81,103.52,103.69,NaN,NaN,NaN,105.05345000155958,NaN,NaN,104.28310000000005,105.65391419601745,102.91228580398264,103.60791774496607,104.1874421210259,104.6045922941907,103.7702919478611,12751,50655.63333333333,43.752172590019995,48.487152211784725,NaN,NaN,NaN,NaN,0.4502907639730266,16.284708864517203,40685023,-0.04348979063007587,-0.1200374746809274,-0.07654768405085154
2025-08-28T11:40:00-04:00,103.7,103.91,103.67,103.84,NaN,NaN,NaN,105.05345000155958,NaN,NaN,104.26350000000004,105.63106754861546,102.89593245138461,103.60791774496607,104.18224130443818,104.59888358527202,103.76559902360434,17194,50223.9,46.5631544131121,48.324036769725524,NaN,NaN,NaN,NaN,0.43526999511781,16.195335487481348,40702217,-0.03264313729570151,-0.11735160567047842,-0.08470846837477691
2025-08-28T11:45:00-04:00,103.82,103.86,103.56,103.79,NaN,NaN,NaN,105.04724473282599,NaN,NaN,104.23830000000005,105.59334628703837,102.88325371296173,103.46033419597286,104.17823827690275,104.59513020496237,103.76134634884312,11412,49578.13333333333,45.7425458479248,47.91790430552613,NaN,NaN,NaN,NaN,0.4256078526093948,16.354028435067253,40690805,-0.026552070177178644,-0.11789855609625022,-0.09134648591907157
2025-08-28T11:50:00-04:00,103.75,103.86,103.61,103.77,NaN,NaN,NaN,105.04555179042481,NaN,NaN,104.20830000000005,105.53681136239327,102.87978863760684,103.3274911083381,104.17079650628872,104.58787955502883,103.75371345754861,22288,46690.3,45.39789918119152,47.45724400375474,NaN,NaN,NaN,NaN,0.4130644345658666,16.501386172111303,40668517,-0.021785968717702706,-0.11857894681619996,-0.09679297809849725
2025-08-28T11:55:00-04:00,103.76,103.94,103.68,103.8,NaN,NaN,NaN,105.04555179042481,NaN,NaN,104.17610000000006,105.46396845601944,102.88823154398068,103.3274911083381,104.1649911850751,104.58124236185967,103.74874000829053,20941,43783.066666666666,46.054475348030735,47.094348457031934,NaN,NaN,NaN,NaN,0.40213126066830407,16.363346330378175,40689458,-0.014859639158141952,-0.1153675270461747,-0.10050788788803275
2025-08-28T12:00:00-04:00,103.79,103.96,103.62,103.89,NaN,NaN,NaN,105.04555179042481,NaN,NaN,104.14670000000005,105.39151582574097,102.90188417425914,103.3274911083381,104.1610730208545,104.57652619753276,103.74561984417625,15238,38958.566666666666,48.0718410153783,46.68826100735765,NaN,NaN,NaN,NaN,0.39769331347771014,16.391239014452143,40704696,-0.0030794821642494974,-0.10435724059334461,-0.10127775842909512
2025-08-28T12:05:00-04:00,103.91,104.03,103.86,103.98,NaN,NaN,NaN,105.04555179042481,NaN,NaN,104.12030000000006,105.32138019715907,102.91921980284104,103.32727000897708,104.15812363133689,104.57128830028734,103.74495896238645,19453,37103.13333333333,50.08218090646415,46.392904165718214,NaN,NaN,NaN,NaN,0.3814295053721595,16.157496402919662,40724149,0.01113244329857535,-0.08736220430587593,-0.09849464760445129
2025-08-28T12:10:00-04:00,103.97,104.06,103.89,104.04,NaN,NaN,NaN,105.04555179042481,NaN,NaN,104.09410000000007,105.24274736103264,102.9454526389675,103.41281600718166,104.15649497902841,104.56788701672028,103.74510294133654,13738,35875.86666666667,51.43210476168114,46.52593964138571,NaN,NaN,NaN,NaN,0.36632739784557683,15.825990141051664,40737887,0.024183638505016897,-0.06826509947318016,-0.09244873797819705
2025-08-28T12:15:00-04:00,104.08,104.17,103.81,104.085,NaN,NaN,NaN,105.04555179042481,NaN,NaN,104.06600000000006,105.1431982176033,102.98880178239682,103.47225280574533,104.15263550169811,104.55871956461121,103.74655143878502,40134,35198.96666666667,52.47026644483114,46.86788088217473,NaN,NaN,NaN,NaN,0.36587544085660706,15.096200396832579,40778021,0.03481076089377255,-0.048935286860981364,-0.08374604775475392
2025-08-28T12:20:00-04:00,104.11,104.16,103.83,103.935,NaN,NaN,NaN,105.04555179042481,NaN,NaN,104.03350000000006,105.02291447331305,103.04408552668707,103.47225280574533,104.14993398805606,104.55350425214587,103.74636372396625,21652,32796.5,48.73101557253839,46.86279496897473,NaN,NaN,NaN,NaN,0.3633129093668493,14.418538491486288,40756369,0.03083764487639326,-0.04519899165926233,-0.0760366365356556
2025-08-28T12:25:00-04:00,103.94,104.175,103.84,104.135,NaN,NaN,NaN,105.04555179042481,NaN,NaN,104.01060000000007,104.93437841499559,103.08682158500454,103.47225280574533,104.14861235214968,104.54966762413066,103.7475570801687,19081,31427.6,53.49026651858921,47.34199018114858,NaN,NaN,NaN,NaN,0.3612905586977882,13.726608020549822,40775450,0.040187556692246384,-0.025802190670347613,-0.065989747362594
2025-08-28T12:30:00-04:00,104.12,104.18,103.77,103.8,NaN,NaN,NaN,105.04555179042481,NaN,NaN,103.98620000000007,104.8654168333273,103.10698316667283,103.47225280574533,104.143698275981,104.5418857452653,103.74551080669669,31229,30323.066666666666,45.81806307180744,47.41581173343915,NaN,NaN,NaN,NaN,0.36476980450508983,13.356845184678026,40744221,0.023163900703389737,-0.037034871483356824,-0.06019877218674656
2025-08-28T12:35:00-04:00,103.79,103.81,103.54,103.54,NaN,NaN,NaN,104.84275553482135,NaN,NaN,103.95780000000006,104.80033227832399,103.11526772167613,103.47225280574533,104.13778986114689,104.53745204136246,103.73812768093131,17151,28134.9,40.91324906955542,47.31531061023606,NaN,NaN,NaN,NaN,0.35800053275472604,13.824838852561363,40727070,-0.004764258896311234,-0.0661540958071356,-0.06138983691082437
2025-08-28T12:40:00-04:00,103.58,103.76,103.5,103.73,NaN,NaN,NaN,104.78013028323855,NaN,NaN,103.93960000000007,104.76146091281394,103.1177390871862,103.47225280574533,104.12944425851103,104.53045574983234,103.72843276718972,26699,26638.6,45.50430856482753,47.430253093282275,NaN,NaN,NaN,NaN,0.35100049470081746,14.389462091385868,40753769,-0.009334302400937813,-0.07305771491199664,-0.06372341251105883
2025-08-28T12:45:00-04:00,103.72,103.95,103.72,103.84,NaN,NaN,NaN,104.78013028323855,NaN,NaN,103.92700000000008,104.73515097598869,103.11884902401147,103.47225280574533,104.12612963616736,104.52606600139865,103.72619327093608,17381,25283.6,48.02235191835776,47.735265902449264,NaN,NaN,NaN,NaN,0.3423576022221879,14.007924957642754,40771150,-0.004108500369051721,-0.06885903797237347,-0.06475053760332175
2025-08-28T12:50:00-04:00,103.82,103.9,103.69,103.735,NaN,NaN,NaN,104.78013028323855,NaN,NaN,103.92450000000008,104.73423637684988,103.11476362315028,103.47225280574533,104.12313839722887,104.52267296481541,103.72360382964233,13191,24601.7,45.84478134563695,47.68395354048675,NaN,NaN,NaN,NaN,0.33290348777774653,13.766721457159795,40757959,-0.00672823092707675,-0.07316082626216769,-0.06643259533509094
2025-08-28T12:55:00-04:00,103.72,103.73,102.77,103.14,NaN,NaN,NaN,104.43781804593091,NaN,NaN,103.90910000000007,104.74811296772046,103.07008703227967,103.47225280574533,104.07179132826668,104.51303750008546,103.63054515644791,92617,26576.133333333335,35.90823931583334,46.98150307390879,NaN,NaN,NaN,NaN,0.3780532386507649,15.872848996570815,40665342,-0.04538337898585168,-0.12316181906740553,-0.07777844008155385
2025-08-28T13:00:00-04:00,103.14,103.54,103.05,103.42,NaN,NaN,NaN,104.43781804593091,NaN,NaN,103.90010000000008,104.75017879634898,103.05002120365118,103.47225280574533,104.06317928217594,104.50890794288196,103.61745062146991,19453,26008.533333333333,42.251490334208725,46.75675958483858,NaN,NaN,NaN,NaN,0.3860494358899966,17.828538854595337,40684795,-0.0486545681349454,-0.1385966502502356,-0.0899420821152902
2025-08-28T13:05:00-04:00,103.415,103.54,103.245,103.47,NaN,NaN,NaN,104.43781804593091,NaN,NaN,103.89870000000008,104.75137299710924,103.04602700289091,103.43680224459627,104.0516967947918,104.50159559002279,103.6017979995608,30104,26111.966666666667,43.33008657181481,46.56216038653746,NaN,NaN,NaN,NaN,0.37954590475499694,19.644536579903818,40714899,-0.04414346527554125,-0.14512141370971676,-0.10097794843417551
2025-08-28T13:10:00-04:00,103.46,103.78,103.39,103.73,NaN,NaN,NaN,104.43781804593091,NaN,NaN,103.90290000000006,104.75012155309113,103.05567844690898,103.42894179567702,104.04684118451222,104.49636043917499,103.59732192984944,19852,25514.866666666665,48.69615338500011,46.606754127224725,NaN,NaN,NaN,NaN,0.38029262584392576,20.243230814363137,40734751,-0.021488730731018174,-0.12783886184794824,-0.10635013111693006
2025-08-28T13:15:00-04:00,103.72,104.03,103.65,103.92,NaN,NaN,NaN,104.43781804593091,NaN,NaN,103.90710000000007,104.75253501229668,103.06166498770347,103.37815343654161,104.04412228676456,104.49077738013378,103.59746719339535,26207,25834.366666666665,52.25413903380298,46.76189399346322,NaN,NaN,NaN,NaN,0.3802717239979307,19.824948251766017,40760958,0.006932222730009416,-0.09768485270441829,-0.1046170754344277
2025-08-28T13:20:00-04:00,103.98,103.98,103.78,103.85,NaN,NaN,NaN,104.43781804593091,NaN,NaN,103.91190000000007,104.75324865543728,103.07055134456287,103.2340545595093,104.04290732613823,104.48823732260279,103.59757732967368,12203,25114,50.854823869821395,46.72065964404466,NaN,NaN,NaN,NaN,0.367395172283793,19.43654301506869,40748755,0.020869064623407443,-0.0785307446551684,-0.09939980927857585
2025-08-28T13:25:00-04:00,103.85,104.18,103.82,104.15,NaN,NaN,NaN,104.43781804593091,NaN,NaN,103.92310000000009,104.76191556971209,103.0842844302881,103.28924211100671,104.04304408779427,104.48406081508352,103.60202736050502,34385,24830.066666666666,56.260793948437694,46.99141160858799,NaN,NaN,NaN,NaN,0.36686694569209444,18.34093303910261,40783140,0.04856192450137878,-0.03869740365185237,-0.08725932815323115
2025-08-28T13:30:00-04:00,104.17,104.19,103.91,103.945,NaN,NaN,NaN,104.43781804593091,NaN,NaN,103.94260000000007,104.73598323653005,103.1492167634701,103.33739368880536,104.04263677217772,104.48045195181912,103.60482159253631,26282,24746.333333333332,52.04760638997054,47.22831095269028,NaN,NaN,NaN,NaN,0.36066216385694494,17.28774013219489,40756858,0.0510864818017189,-0.023401225901082512,-0.07448770770280141
2025-08-28T13:35:00-04:00,103.94,103.95,103.82,103.82,NaN,NaN,NaN,104.43781804593091,NaN,NaN,103.96030000000007,104.70069559696661,103.21990440303354,103.33739368880536,104.04174478492207,104.47865175932975,103.6048378105144,9047,23812.733333333334,49.60811924435586,46.951014718816474,NaN,NaN,NaN,NaN,0.344186295010021,16.617120440414322,40747811,0.0426926698517837,-0.021121870388071784,-0.06381454023985549
2025-08-28T13:40:00-04:00,103.84,103.89,103.675,103.74,NaN,NaN,NaN,104.43781804593091,NaN,NaN,103.93110000000007,104.58356391471752,103.27863608528263,103.33739368880536,104.03845872955682,104.47375302729398,103.60316443181966,22123,24111.333333333332,48.05570581817151,47.110846343556766,NaN,NaN,NaN,NaN,0.33495870250930543,16.467240953588394,40725688,0.03066994271362814,-0.02547711184782031,-0.05614705456144845
2025-08-28T13:45:00-04:00,103.73,103.76,103.52,103.56,NaN,NaN,NaN,104.43781804593091,NaN,NaN,103.90570000000008,104.51356843971814,103.29783156028202,103.33739368880536,104.0359515524683,104.47117935419215,103.60072375074446,10920,23653.266666666666,44.66863330691326,47.379088074796606,NaN,NaN,NaN,NaN,0.3281759380443557,16.794665357704844,40714768,0.010551263677369985,-0.04295797496473597,-0.05350923864210595
2025-08-28T13:50:00-04:00,103.56,103.69,103.47,103.63,NaN,NaN,NaN,104.43781804593091,NaN,NaN,103.88550000000008,104.46066693230443,103.31033306769572,103.33739368880536,104.03147300249887,104.46671931653535,103.5962266884624,19072,23084.1,46.25508599356768,47.43271503399234,NaN,NaN,NaN,NaN,0.32044908532690164,17.244537406953462,40733840,0.002343220725832984,-0.05058021273481472,-0.052923433460647706
2025-08-28T13:55:00-04:00,103.64,103.64,103.4,103.54,NaN,NaN,NaN,104.43781804593091,NaN,NaN,103.8713000000001,104.44482527406095,103.29777472593926,103.33739368880536,104.02710451339685,104.46297851166916,103.59123051512454,16330,22505.066666666666,44.48889956461913,47.18032558015386,NaN,NaN,NaN,NaN,0.3147027220892654,17.8684261599443,40717510,-0.008185353985323426,-0.06315512594230199,-0.054969771956978566
2025-08-28T14:00:00-04:00,103.58,103.68,103.42,103.51,NaN,NaN,NaN,104.43781804593091,NaN,NaN,103.8667000000001,104.44800064510014,103.28539935490005,103.33739368880536,104.02329817968366,104.45960532401396,103.58699103535336,14760,22429.6,43.88733849395185,47.04050823360493,NaN,NaN,NaN,NaN,0.31079538479717544,18.24463409811454,40702750,-0.015768751856726868,-0.07468071177788715,-0.05891195992116029
2025-08-28T14:05:00-04:00,103.5,103.75,103.44,103.46,NaN,NaN,NaN,104.43781804593091,NaN,NaN,103.86990000000009,104.44034715793998,103.29945284206019,103.33739368880536,104.01820716771226,104.4548991998641,103.58151513556042,20679,22693.866666666665,42.84745069945309,47.53616618957777,NaN,NaN,NaN,NaN,0.31073857159737733,18.235079908552574,40682071,-0.022349048796321283,-0.08684827091656189,-0.0644992221202406
2025-08-28T14:10:00-04:00,103.49,103.61,103.44,103.6,NaN,NaN,NaN,104.43781804593091,NaN,NaN,103.8679000000001,104.44140881422162,103.2943911857786,103.33739368880536,104.01605202560746,104.45288901329434,103.57921503792059,8890,22417.066666666666,46.658586885573555,47.85095880038954,NaN,NaN,NaN,NaN,0.300685816483279,18.22620816110218,40690961,-0.01577937733783827,-0.08422344379253843,-0.06844406645470016
2025-08-28T14:15:00-04:00,103.59,103.59,103.46,103.57,NaN,NaN,NaN,104.43781804593091,NaN,NaN,103.8569000000001,104.43174220444193,103.28205779555826,103.33739368880536,104.01372236771891,104.45075362074289,103.57669111469494,9498,22353.266666666666,45.951462039231636,48.038199905205026,NaN,NaN,NaN,NaN,0.2892082581630448,18.21797010989824,40681463,-0.012124991934606102,-0.08360030637295779,-0.07147531443835169
2025-08-28T14:20:00-04:00,103.55,103.63,103.42,103.47,NaN,NaN,NaN,104.43781804593091,NaN,NaN,103.8391000000001,104.40558279762273,103.27261720237748,103.20291495104429,104.00987324873645,104.44746134593413,103.57228515153878,14846,22105.2,43.58052302770175,47.672797736826574,NaN,NaN,NaN,NaN,0.28355052543711257,18.210320490923152,40666617,-0.014929021431720868,-0.09013659122800277,-0.0752075697962819
2025-08-28T14:25:00-04:00,103.46,103.525,103.42,103.51,NaN,NaN,NaN,104.39721780621075,NaN,NaN,103.82930000000009,104.4012370944515,103.25736290554867,103.18483196083544,104.00656948047052,104.44474891007896,103.56839005086208,12388,21820.1,44.80724956508301,47.14087706048944,NaN,NaN,NaN,NaN,0.27079691647731907,18.20321727330343,40679005,-0.012665569214262054,-0.09103953131410947,-0.07837396209984741
2025-08-28T14:30:00-04:00,103.49,103.52,103.37,103.45,NaN,NaN,NaN,104.34813972411025,NaN,NaN,103.81610000000012,104.39196557456941,103.24023442543083,103.07765853692655,104.0018436516717,104.4411662077502,103.56252109559321,16753,21870.6,43.286874034518924,46.60030921511069,NaN,NaN,NaN,NaN,0.2621685653003671,18.433563219779156,40662252,-0.013697470524515476,-0.09549580025549176,-0.08179832973097628
2025-08-28T14:35:00-04:00,103.45,103.45,103.23,103.3,NaN,NaN,NaN,104.23208791846888,NaN,NaN,103.81170000000012,104.3997803006333,103.22361969936694,103.07765853692655,103.99620225586021,104.43798137380323,103.5544231379172,16724,21779.633333333335,39.66346067411098,45.41478540980164,NaN,NaN,NaN,NaN,0.2591565249217694,19.25836345387517,40645528,-0.022453112050058316,-0.10986471979354917,-0.08741160774349085
2025-08-28T14:40:00-04:00,103.29,103.37,103.23,103.25,NaN,NaN,NaN,104.17062937672031,NaN,NaN,103.79630000000012,104.40182393841175,103.19077606158848,103.07765853692655,103.99201546358383,104.43585060939911,103.54818031776854,11825,21715.866666666665,38.50639516208578,44.4475560363813,NaN,NaN,NaN,NaN,0.2506453445702145,20.024249385535757,40633703,-0.029157917546126316,-0.12385900467614874,-0.09470108713002243
2025-08-28T14:45:00-04:00,103.26,103.26,103.08,103.1,NaN,NaN,NaN,104.02560076868755,NaN,NaN,103.77290000000012,104.39362889411443,103.15217110588581,103.07765853692655,103.98155385620835,104.43242640465672,103.53068130775998,25229,21219.033333333333,35.18981661947747,43.417677277461415,NaN,NaN,NaN,NaN,0.24559924852948536,21.33131455278294,40608474,-0.04054113135658535,-0.1453775013257541,-0.10483636996916876
2025-08-28T14:50:00-04:00,103.09,103.27,103.09,103.21,NaN,NaN,NaN,104.02125527920177,NaN,NaN,103.75090000000013,104.37189819642765,103.12990180357261,103.07765853692655,103.977334529205,104.43068260025197,103.52398645815802,10925,20861.466666666667,39.317505522453565,42.79352011348156,NaN,NaN,NaN,NaN,0.2409135879202359,22.461219745695026,40619399,-0.037574959953276754,-0.1518050699107647,-0.11423010995748795
2025-08-28T14:55:00-04:00,103.23,103.46,103.05,103.06,NaN,NaN,NaN,104.02125527920177,NaN,NaN,103.72710000000012,104.36084471199302,103.09335528800722,103.0703611709064,103.96726353779772,104.42630969383761,103.50821738175783,26556,21110.633333333335,35.954693752874704,42.171095859621666,NaN,NaN,NaN,NaN,0.25299118878307597,22.06172938080699,40592843,-0.04227731515632174,-0.16707675390289012,-0.12479943874656838
2025-08-28T15:00:00-04:00,103.07,103.2,103.05,103.065,NaN,NaN,NaN,103.9653379713388,NaN,NaN,103.69880000000013,104.32181704629541,103.07578295370486,103.0703611709064,103.96296402063857,104.42487469533297,103.50105334594416,10404,20416.466666666667,36.15072981428905,41.44935613253033,NaN,NaN,NaN,NaN,0.24563467529857094,21.69077404198239,40603247,-0.0415515525973624,-0.17673887949327138,-0.13518732689590898
2025-08-28T15:05:00-04:00,103.065,103.16,103.02,103.15,NaN,NaN,NaN,103.91123169991431,NaN,NaN,103.67140000000013,104.26746388917365,103.07533611082661,103.0703611709064,103.95879714628734,104.42340019769058,103.4941940948841,10243,20186.2,39.53884898370407,41.09578109103639,NaN,NaN,NaN,NaN,0.23808934134867307,21.502874624339128,40613490,-0.03226147915908706,-0.1755141758447678,-0.14325269668568075
2025-08-28T15:10:00-04:00,103.19,103.44,103.19,103.24,NaN,NaN,NaN,103.91123169991431,NaN,NaN,103.65280000000013,104.2434848905963,103.06211510940395,103.04483114938009,103.95281029037132,104.4195991848097,103.48602139593294,18939,19927.533333333333,42.98848736115952,41.03157743869409,NaN,NaN,NaN,NaN,0.241797245538053,20.387096922814912,40632429,-0.017697843824781068,-0.16537500146665707,-0.147677157641876
2025-08-28T15:15:00-04:00,103.25,103.26,103.02,103.08,NaN,NaN,NaN,103.91123169991431,NaN,NaN,103.63400000000014,104.23645829728561,103.03154170271468,103.04483114938009,103.94511602000287,104.41652608716953,103.47370595283621,19729,20005.8,38.75509850963166,40.73926656799256,NaN,NaN,NaN,NaN,0.24166887085676417,19.42187596524731,40612700,-0.01650637087784923,-0.16831012123918754,-0.1518037503613383
2025-08-28T15:20:00-04:00,103.09,103.1,102.95,103.02,NaN,NaN,NaN,103.82698504629099,NaN,NaN,103.61240000000012,104.22385478982105,103.0009452101792,102.95986491950408,103.92748121100263,104.41113444289861,103.44382797910664,41650,20954.433333333334,37.272772767375216,40.068851273835534,NaN,NaN,NaN,NaN,0.23512109436699472,18.862938027031394,40571050,-0.017339381494275774,-0.173477977229183,-0.15613859573490724
2025-08-28T15:25:00-04:00,103.01,103.09,102.91,102.93,NaN,NaN,NaN,103.79007663509593,NaN,NaN,103.59200000000014,104.22473059035157,102.95926940964871,102.90789193560326,103.91113773662072,104.40628631333657,103.41598915990487,38076,19136.4,35.103843365616655,39.29402136857732,NaN,NaN,NaN,NaN,0.2311838733407813,18.53502554799437,40532974,-0.021272641351158805,-0.18272939742385574,-0.16145675607269694
2025-08-28T15:30:00-04:00,102.92,103.07,102.87,103.06,NaN,NaN,NaN,103.75143678804612,NaN,NaN,103.57720000000013,104.22423372398343,102.93016627601683,102.89854594356679,103.89819326439024,104.40149795059247,103.39488857818802,31924,19552.1,40.49057107565098,39.073310514859415,NaN,NaN,NaN,NaN,0.22895645381643898,18.423809335043934,40564898,-0.012854518696518547,-0.17752490444334512,-0.16467038574682658
2025-08-28T15:35:00-04:00,103.1,103.4,103.1,103.26,NaN,NaN,NaN,103.75143678804612,NaN,NaN,103.57020000000016,104.2232083000599,102.91719169994042,102.89854594356679,103.89091872478227,104.39598915866864,103.3858482908959,25638,19403.233333333334,47.68510596135347,39.27887168602159,NaN,NaN,NaN,NaN,0.2368881356866936,17.72506127812784,40590536,0.007360453846009557,-0.15546981843931462,-0.16283027228532418
2025-08-28T15:40:00-04:00,103.27,103.34,103.22,103.29,NaN,NaN,NaN,103.75143678804612,NaN,NaN,103.56200000000014,104.21856987439266,102.90543012560762,102.89854594356679,103.88235684068236,104.38894364077302,103.3757700405917,32484,19824.3,48.68722289848334,39.664610890590474,NaN,NaN,NaN,NaN,0.22853898313764437,17.07622379670575,40623020,0.023043982278776964,-0.13402529443685296,-0.15706927671562992
2025-08-28T15:45:00-04:00,103.31,103.48,103.31,103.37,NaN,NaN,NaN,103.75143678804612,NaN,NaN,103.55560000000014,104.21329184270319,102.8979081572971,102.9705515742643,103.87449468823134,104.3808494526338,103.36813992382888,37152,20189.133333333335,51.36278576663537,40.50027696862792,NaN,NaN,NaN,NaN,0.22578619862781246,17.108513215836528,40660172,0.03820349414992141,-0.10931490902822816,-0.14751840317814957
2025-08-28T15:50:00-04:00,103.4,103.45,103.09,103.42,NaN,NaN,NaN,103.75143678804612,NaN,NaN,103.54720000000012,104.2008640115388,102.89353598846144,102.9705515742643,103.8609241621583,104.36833015330342,103.35351817101318,58764,21741.166666666668,53.011868764523655,41.53638222594491,NaN,NaN,NaN,NaN,0.2353728987258258,15.951875344926231,40718936,0.05023827252445817,-0.08472056252257687,-0.13495883504703504
2025-08-28T15:55:00-04:00,103.45,103.75,103.42,103.66,NaN,NaN,NaN,103.75143678804612,NaN,NaN,103.54460000000012,104.19540823595379,102.89379176404644,103.11495300752915,103.85056136166901,104.34988187350334,103.35124084983468,103434,24042.8,60.01918044538662,43.30990821350985,NaN,NaN,NaN,NaN,0.2421319773882667,16.094441326468374,40822370,0.07169449845066951,-0.045340711983698156,-0.11703521043436767
2025-08-29T09:30:00-04:00,102.745,103.67,102.42,103.21,NaN,NaN,NaN,103.75143678804612,NaN,NaN,103.53340000000013,104.18757257660572,102.87922742339454,103.11495300752915,103.10000000000001,103.10000000000001,103.10000000000001,106513,26717.166666666668,46.12862218543949,43.79641654658028,NaN,NaN,NaN,NaN,0.31412255043196197,16.877728527292252,40715857,0.05373354006224065,-0.049868285356566844,-0.1036018254188075
2025-08-29T09:35:00-04:00,103.21,104.05,103.12,103.29,102.57797927710777,102.57797927710777,102.57797927710777,NaN,NaN,NaN,103.52320000000013,104.17633018608896,102.8700698139113,103.11495300752915,103.25539535379968,103.44496984440013,103.06582086319924,71568,28801.2,48.41433079885275,44.686390621293,NaN,NaN,NaN,NaN,0.3581137968296785,16.379223191618344,40787425,0.04570908951734591,-0.046465463522125106,-0.09217455303947102
2025-08-29T09:40:00-04:00,103.26,103.9,102.72,103.53,102.57797927710777,NaN,NaN,NaN,NaN,NaN,103.51600000000012,104.16067976545719,102.87132023454305,103.11495300752915,103.29579640707826,103.4635050584375,103.12808775571901,82190,30803.433333333334,54.63314262648048,46.00656296502096,NaN,NaN,NaN,NaN,0.41681995419898765,16.770889892024506,40869615,0.05443995049379348,-0.02412461492222917,-0.07856456541602265
2025-08-29T09:45:00-04:00,103.5,103.7,102.49,103.12,NaN,NaN,NaN,104.3311490470981,104.3311490470981,104.3311490470981,103.49880000000012,104.13891736423037,102.85868263576987,103.11495300752915,103.25141874687131,103.41938483892062,103.083452654822,77997,33039.333333333336,44.71577508885429,46.37634340110312,NaN,NaN,NaN,NaN,0.47347567175620336,17.558622010168254,40791618,0.031609468827303394,-0.039052729381893414,-0.07066219820919681
2025-08-29T09:50:00-04:00,103.15,104.11,102.99,103.65,NaN,NaN,NaN,104.3311490470981,NaN,NaN,103.49100000000011,104.11381939596946,102.86818060403077,103.11495300752915,103.3231513216184,103.52508916676976,103.12121347646703,93261,35512.3,55.86818473579078,47.296321785005354,NaN,NaN,NaN,NaN,0.5196559809164748,17.128134257675956,40884879,0.0501103202267968,-0.008024297925700807,-0.05813461815249761
2025-08-29T09:55:00-04:00,103.7,103.97,103.27,103.94,NaN,NaN,NaN,104.3311490470981,NaN,NaN,103.4881000000001,104.10110208808231,102.87509791191789,103.11495300752915,103.36155754330197,103.58721227391673,103.1359028126872,45393,36481.066666666666,60.556817798200655,48.85358744847456,NaN,NaN,NaN,NaN,0.5325376965652983,16.728395630361675,40930272,0.0781165543971643,0.03951107484395777,-0.038605479553206534
2025-08-29T10:00:00-04:00,103.95,104.38,103.18,103.21,102.31096014977692,102.31096014977692,102.31096014977692,NaN,NaN,NaN,103.47360000000012,104.07786828477556,102.86933171522467,103.11495300752915,103.39425198698956,103.61793100895875,103.17057296502037,79657,38644.3,47.01588421510627,49.549523980455355,NaN,NaN,NaN,NaN,0.5802135753820618,15.734586869553342,40850615,0.04534038474231043,0.01807000137468151,-0.027270383367628923
2025-08-29T10:05:00-04:00,103.16,103.47,102.33,102.86,102.31096014977692,NaN,NaN,NaN,NaN,NaN,103.44810000000011,104.04614979724889,102.85005020275133,103.11495300752915,103.32266247201507,103.5950381468313,103.05028679719884,91389,41001.3,42.149485307595256,50.052784119168116,NaN,NaN,NaN,NaN,0.6201983199976289,16.04817080168943,40759226,0.00033253523646980046,-0.026854714322041673,-0.027187249558511473
2025-08-29T10:10:00-04:00,102.84,102.99,101.93,102.57,NaN,NaN,NaN,104.09145986352972,104.09145986352972,104.09145986352972,103.42350000000009,104.06148197467776,102.78551802532242,103.11495300752915,103.22708160470913,103.59507265048406,102.8590905589342,84792,43531.36666666667,38.58575570150719,49.91672587815784,NaN,NaN,NaN,NaN,0.6516127257120832,16.91894429735042,40674434,-0.046154206475919154,-0.08488000765341042,-0.03872580117749126
2025-08-29T10:15:00-04:00,102.54,102.95,102.13,102.9,NaN,NaN,NaN,104.09145986352972,NaN,NaN,103.4107000000001,104.0643084760795,102.7570915239207,102.67856992481866,103.18513846658055,103.56910131334413,102.80117561981697,58526,45165.63333333333,44.351634479721156,49.67862077232696,NaN,NaN,NaN,NaN,0.6636403881612206,17.72751968617849,40732960,-0.051458831016669114,-0.10304933994832766,-0.05159050893165854
2025-08-29T10:20:00-04:00,102.88,103.49,102.88,103.27,NaN,NaN,NaN,104.09145986352972,NaN,NaN,103.40150000000011,104.04980008483396,102.75319991516626,102.67856992481866,103.18760872899011,103.55445245307551,102.82076500490471,75985,47203.6,50.01774110190024,49.773657786856745,NaN,NaN,NaN,NaN,0.6598089318639905,17.22136096590925,40808945,-0.028003233522868307,-0.08659455083524392,-0.058591317312375615
2025-08-29T10:25:00-04:00,103.21,103.25,102.54,103.23,NaN,NaN,NaN,104.09145986352972,NaN,NaN,103.3893000000001,104.0270052924348,102.75159470756542,102.21285593985493,103.17428071502142,103.53050489817264,102.81805653187021,68962,49089.4,49.431763008499125,49.63572758984701,NaN,NaN,NaN,NaN,0.6648225795879904,17.294701072383916,40739983,-0.01385228434663878,-0.07590667274567409,-0.06205438839903531
2025-08-29T10:30:00-04:00,103.21,103.23,102.75,103.05,NaN,NaN,NaN,104.09145986352972,NaN,NaN,103.3756000000001,104.0124410790792,102.73875892092101,102.14078579296458,103.1687302681573,103.52014078341703,102.81731975289757,32738,49622.23333333333,46.77606789509107,49.1903132420304,NaN,NaN,NaN,NaN,0.6516209667602771,17.362802599824683,40707245,-0.015178025390433544,-0.08102692013707724,-0.0658488947466437
2025-08-29T10:35:00-04:00,103.07,103.5,102.85,103.24,NaN,NaN,NaN,104.09145986352972,NaN,NaN,103.37760000000011,104.01209267923203,102.7431073207682,102.14078579296458,103.16951298455947,103.51599632334732,102.82302964577163,27931,49995.8,49.83944343447651,48.46318916982252,NaN,NaN,NaN,NaN,0.6515051834202578,16.811985437760786,40735176,-0.0024876290920418237,-0.06895843111169597,-0.06647080201965415
2025-08-29T10:40:00-04:00,103.22,103.33,102.49,102.5,NaN,NaN,NaN,104.09145986352972,NaN,NaN,103.35920000000011,104.03941867072956,102.67898132927067,102.14078579296458,103.15930822988118,103.50701101892645,102.8116054408359,26357,50480.2,40.1474330908031,48.0359613773485,NaN,NaN,NaN,NaN,0.6649690988902396,16.91051905477463,40708819,-0.04102219852963805,-0.11774855018170172,-0.07672635165206367
2025-08-29T10:45:00-04:00,102.47,102.63,102.35,102.57,NaN,NaN,NaN,104.09145986352972,NaN,NaN,103.34120000000011,104.0555152245302,102.62688477547003,102.14078579296458,103.1446635871117,103.50150947841979,102.7878176958036,23862,50434.63333333333,41.31009933367851,47.5285162726932,NaN,NaN,NaN,NaN,0.6374713061123654,17.22453047526608,40732681,-0.05785773271209614,-0.14904851754218384,-0.0911907848300877
2025-08-29T10:50:00-04:00,102.56,102.66,102.33,102.47,NaN,NaN,NaN,104.09145986352972,NaN,NaN,103.31600000000012,104.06187666540808,102.57012333459215,101.63261426472873,103.12163573238374,103.49245171800823,102.75081974675925,37975,51336.3,40.111355826632305,46.49124578698976,NaN,NaN,NaN,NaN,0.615509069961482,17.440633650649012,40694706,-0.07092731882827542,-0.17984993336543198,-0.10892261453715656
2025-08-29T10:55:00-04:00,102.46,102.67,102.29,102.67,NaN,NaN,NaN,104.09145986352972,NaN,NaN,103.29100000000011,104.03801539475988,102.54398460524034,101.63261426472873,103.09274433374745,103.47550818123922,102.70998048625567,57061,52353.13333333333,43.63425305668769,46.41399421326357,NaN,NaN,NaN,NaN,0.5986869935356616,17.711672309102198,40751767,-0.06164439550235015,-0.18597810891509425,-0.1243337134127441
2025-08-29T11:00:00-04:00,102.62,103.01,102.48,103,NaN,NaN,NaN,104.09145986352972,NaN,NaN,103.2740000000001,104.00792915190115,102.54007084809905,101.63261426472873,103.08784371898801,103.46868376026032,102.7070036777157,21708,52729.933333333334,48.96838143276781,45.92115112019051,NaN,NaN,NaN,NaN,0.5937807797116859,17.083578870090236,40773475,-0.030401182135206206,-0.16233519108175187,-0.13193400894654567
2025-08-29T11:05:00-04:00,103,103.28,102.83,103.14,NaN,NaN,NaN,104.09145986352972,NaN,NaN,103.2538000000001,103.94449981903783,102.56310018096237,101.95242643381305,103.08775573565173,103.46486350807328,102.71064796323017,23155,53160.333333333336,51.08334890877078,45.24447477094551,NaN,NaN,NaN,NaN,0.5835107240179942,15.878437035572087,40796630,0.0009124290348393738,-0.13079347265299646,-0.13170590168783583
2025-08-29T11:10:00-04:00,103.14,103.34,102.91,102.91,NaN,NaN,NaN,104.09145986352972,NaN,NaN,103.2331000000001,103.90137207035353,102.56482792964668,102.06294114705044,103.08726221733596,103.46167927086027,102.71284516381165,17266,53104.566666666666,47.59357596841944,45.285738467610734,NaN,NaN,NaN,NaN,0.5725456723024236,14.863514818730614,40779364,0.007014037720226546,-0.12293835453755264,-0.1299523922577792
2025-08-29T11:15:00-04:00,102.94,103.2,102.94,103.2,NaN,NaN,NaN,104.09145986352972,NaN,NaN,103.22070000000011,103.86761888209554,102.57378111790467,102.06294114705044,103.08755227103835,103.45989075616373,102.71521378591297,13549,52898.566666666666,52.0422581535,45.992365099461075,NaN,NaN,NaN,NaN,0.5523638385665366,13.921087045949246,40792913,0.03016259405059267,-0.09224914969453835,-0.12241174374513102
2025-08-29T11:20:00-04:00,103.2,103.68,103.19,103.64,NaN,NaN,NaN,104.09145986352972,NaN,NaN,103.2187000000001,103.85977662570058,102.57762337429962,102.50168233411227,103.09374833570337,103.46671988686914,102.72077678453759,18423,52124.333333333336,57.8838933583181,47.37080350351899,NaN,NaN,NaN,NaN,0.5479092786689275,14.08778702278404,40811336,0.07228626425610271,-0.032053913425002634,-0.10434017768110534
2025-08-29T11:25:00-04:00,103.63,103.66,103.28,103.37,NaN,NaN,NaN,104.09145986352972,NaN,NaN,103.21490000000009,103.85006451413673,102.57973548586344,102.52734586728981,103.09690095632409,103.46959391657998,102.7242079960682,11471,51237.5,53.57162023299126,48.02937391446686,NaN,NaN,NaN,NaN,0.5359157587640038,14.242579858416349,40799865,0.07861967950248878,-0.006065578302994368,-0.08468525780548315
2025-08-29T11:30:00-04:00,103.38,103.53,103.17,103.47,NaN,NaN,NaN,104.09145986352972,NaN,NaN,103.21170000000009,103.84004261356384,102.58335738643635,102.52734586728981,103.09921469314234,103.4713388125043,102.72709057378039,9928,50504.3,54.911408329025015,48.3789215735472,NaN,NaN,NaN,NaN,0.5233503474237178,14.071366718738352,40809793,0.08562179368008818,0.022341984294627082,-0.0632798093854611
2025-08-29T11:35:00-04:00,103.46,103.55,103.25,103.43,NaN,NaN,NaN,104.09145986352972,NaN,NaN,103.2095000000001,103.83398779012005,102.58501220988016,102.53110135506549,103.10231319565695,103.47386283064931,102.73076356066458,12665,50071.86666666667,54.23719937303996,48.722167028157266,NaN,NaN,NaN,NaN,0.5073967511791663,13.95880063356917,40797128,0.0835463506754974,0.041153128958910656,-0.04239322171658674
2025-08-29T11:40:00-04:00,103.46,103.64,103.27,103.48,NaN,NaN,NaN,104.09145986352972,NaN,NaN,103.2089000000001,103.83228845033878,102.58551154966142,102.63988108405239,103.10600261433223,103.47742783018938,102.73457739847507,13116,49426.26666666667,54.98127962366677,49.30825358019838,NaN,NaN,NaN,NaN,0.49758269752351186,14.069861635929854,40810244,0.0814432395531467,0.05941082772484663,-0.02203241182830007
2025-08-29T11:45:00-04:00,103.43,103.63,103.35,103.49,NaN,NaN,NaN,104.09145986352972,NaN,NaN,103.2095000000001,103.83391092239457,102.58508907760564,102.6899048672419,103.11334185998759,103.48493888094534,102.74174483902983,25008,49021.46666666667,55.13838706141138,49.686749553550875,NaN,NaN,NaN,NaN,0.4820410762718325,14.172989709550487,40835252,0.07669470298093968,0.07383596689787453,-0.002858736083065149
2025-08-29T11:50:00-04:00,103.505,103.57,103.27,103.39,NaN,NaN,NaN,104.09145986352972,NaN,NaN,103.2053000000001,103.82192439135666,102.58867560864353,102.6899048672419,103.11650593952702,103.48737008224998,102.74564179680405,14106,47532.86666666667,53.1411960283218,50.614875477659346,NaN,NaN,NaN,NaN,0.46903814225241575,13.985438183689311,40821146,0.06334224535908867,0.07631907061579568,0.012976825256707018
2025-08-29T11:55:00-04:00,103.42,103.55,103.24,103.29,NaN,NaN,NaN,104.09145986352972,NaN,NaN,103.19970000000008,103.80800390433478,102.59139609566537,102.6899048672419,103.12016274712641,103.48942100951635,102.75090448473648,20165,44757.23333333333,51.146104631400874,51.31744728463952,NaN,NaN,NaN,NaN,0.4576782749486719,13.70230800888191,40800981,0.04515260481140938,0.06941758127096875,0.024264976459559367
2025-08-29T12:00:00-04:00,103.31,103.6,103.31,103.54,NaN,NaN,NaN,104.09145986352972,NaN,NaN,103.2011000000001,103.81220159549595,102.58999840450424,102.74367129202786,103.12406575584147,103.49323849600489,102.75489301567805,14587,41693.03333333333,55.63084514223152,52.42598223575375,NaN,NaN,NaN,NaN,0.44712982673805163,13.593396786236376,40815568,0.047117913148477186,0.08316236789515585,0.03604445474667867
2025-08-29T12:05:00-04:00,103.51,103.55,103.33,103.47,NaN,NaN,NaN,104.09145986352972,NaN,NaN,103.2003000000001,103.80988480953734,102.59071519046286,102.75493703362228,103.12581315433354,103.4947634569363,102.75686285173079,7316,39551.3,54.132409163726216,53.175850529113646,NaN,NaN,NaN,NaN,0.4309062676853336,13.49226493663695,40808252,0.04108388459301957,0.08739931048795313,0.04631542589493356
2025-08-29T12:10:00-04:00,103.46,103.85,103.42,103.84,NaN,NaN,NaN,104.09145986352972,NaN,NaN,103.20810000000009,103.8398432706609,102.57635672933928,102.99894962689783,103.13322619319753,103.50552078451378,102.76093160188128,17744,37403.1,60.23009999676478,53.980258997970566,NaN,NaN,NaN,NaN,0.43084153427923777,14.294803835638906,40825996,0.058338473990237,0.11923851838272981,0.06090004439249281
2025-08-29T12:15:00-04:00,103.84,104.09,103.77,104.065,NaN,NaN,NaN,104.09145986352972,NaN,NaN,103.2234000000001,103.89884782183425,102.54795217816594,103.24915970151827,103.1732873514119,103.57841015075972,102.76816455206408,69076,37105.73333333333,63.41521727970387,54.86110673875151,NaN,NaN,NaN,NaN,0.42292428183072134,15.62940872117789,40895072,0.07989887742018359,0.1607736411677223,0.08087476374753871
2025-08-29T12:20:00-04:00,104.05,104.12,103.7,103.73,102.59845104405707,102.59845104405707,102.59845104405707,NaN,NaN,NaN,103.2330000000001,103.92317099331572,102.54282900668449,103.24915970151827,103.18299165555784,103.59316689853507,102.77281641258061,21117,34700.933333333334,56.19845679319155,55.47574108337809,NaN,NaN,NaN,NaN,0.42271540455709855,16.552513964499838,40873955,0.06710785225227975,0.1647595790628884,0.09765172681060866
2025-08-29T12:25:00-04:00,103.72,103.72,103.27,103.34,102.59845104405707,NaN,NaN,NaN,NaN,NaN,103.23780000000009,103.9275424446929,102.54805755530728,103.24915970151827,103.1861979960011,103.59484958535013,102.77754640665206,18362,33799.9,49.18141150737289,55.27139489436901,NaN,NaN,NaN,NaN,0.4253785899458778,15.75260508640941,40855593,0.029793619932685783,0.1348937517264659,0.10510013179378011
2025-08-29T12:30:00-04:00,103.34,103.52,103.26,103.32,102.59845104405707,NaN,NaN,NaN,NaN,NaN,103.24000000000011,103.93007535820288,102.54992464179733,103.24915970151827,103.18703487741996,103.59492217358299,102.77914758125694,6946,31376.2,48.844592607511075,54.62573055502565,NaN,NaN,NaN,NaN,0.41356583352117154,14.975973949267024,40848647,0.0026094201070204354,0.10836190692755565,0.10575248682053522
2025-08-29T12:35:00-04:00,103.3,103.36,103.04,103.34,102.59845104405707,NaN,NaN,NaN,NaN,NaN,103.24560000000011,103.93428465933142,102.5569153406688,103.24915970151827,103.18764715171889,103.59347956028392,102.78181474315386,15539,28847.866666666665,49.21911724621386,54.31483748454155,NaN,NaN,NaN,NaN,0.40688255969823023,14.279358266550785,40864186,-0.014253671771735144,0.08793539710586629,0.10218906887760143
2025-08-29T12:40:00-04:00,103.35,103.54,103.25,103.48,102.59845104405707,NaN,NaN,NaN,NaN,NaN,103.2539000000001,103.94368051581998,102.56411948418022,103.24915970151827,103.19082731679208,103.5948285780194,102.78682605556476,20700,26711.466666666667,51.87519365448682,54.09796500778883,NaN,NaN,NaN,NaN,0.3985338054340714,13.474339950024294,40884886,-0.016073095341921778,0.0820976997001992,0.09817079504212098
2025-08-29T12:45:00-04:00,103.5,103.74,103.46,103.56,102.59845104405707,NaN,NaN,NaN,NaN,NaN,103.2621000000001,103.95647767821232,102.56772232178788,103.24915970151827,103.19244930590177,103.59641420313217,102.78848440867138,6312,24971,53.37590567625972,54.036444029447374,NaN,NaN,NaN,NaN,0.39006710504592357,13.319880368045142,40891198,-0.012160487864092559,0.08297018521200528,0.09513067307609784
2025-08-29T12:50:00-04:00,103.58,103.8,103.49,103.79,102.59845104405707,NaN,NaN,NaN,NaN,NaN,103.2731000000001,103.98298137037169,102.56321862962851,103.24915970151827,103.19500111304582,103.59951058027053,102.7904916458211,7888,22701.1,57.48109310152969,54.215002135009016,NaN,NaN,NaN,NaN,0.38434802611407204,13.34693971749646,40899086,0.004740106061764018,0.10105580565330285,0.09631569959153884
2025-08-29T12:55:00-04:00,103.78,103.81,103.61,103.68,102.59845104405707,NaN,NaN,NaN,NaN,NaN,103.28510000000011,104.00177144494124,102.56842855505899,103.24915970151827,103.19912122900969,103.60453040830161,102.79371204971777,12736,20826.9,54.987442321666975,54.20422036788442,NaN,NaN,NaN,NaN,0.3711803099630671,13.401699664421296,40886350,0.0071865518550938146,0.1052988894104061,0.09811233755531229
2025-08-29T13:00:00-04:00,103.66,103.66,103.02,103.03,102.59845104405707,NaN,NaN,NaN,NaN,NaN,103.28530000000012,104.00168093217256,102.56891906782768,103.24915970151827,103.19947101642421,103.60300342567369,102.79593860717473,14680,20224.966666666667,43.091312565232805,53.48637154909234,NaN,NaN,NaN,NaN,0.39181028782284877,13.343454351145867,40871670,-0.034032747175608474,0.055571403585801704,0.08960415076141018
2025-08-29T13:05:00-04:00,103.07,103.18,102.9,103.1,102.59845104405707,NaN,NaN,NaN,NaN,NaN,103.28870000000012,103.99989845330477,102.57750154669547,103.23732776121462,103.19823588390733,103.60018995423647,102.79628181357819,14079,19763.233333333334,44.48423792639403,53.01052392730613,NaN,NaN,NaN,NaN,0.3838238386926454,13.593760108994054,40885749,-0.05443381988546332,0.02156187590458103,0.07599569579004435
2025-08-29T13:10:00-04:00,103.09,103.1,102.85,102.9,102.59845104405707,NaN,NaN,NaN,NaN,NaN,103.2855000000001,104.00220426258902,102.56879573741118,103.06862269490867,103.19638943431188,103.59741342131761,102.79536544730615,11914,19281.8,41.36866833185891,51.99179701227952,NaN,NaN,NaN,NaN,0.3742649930717422,13.953332483505418,40873835,-0.07782367725527829,-0.02128390077905351,0.05653977647622478
2025-08-29T13:15:00-04:00,102.94,102.96,102.69,102.88,102.59845104405707,NaN,NaN,NaN,NaN,NaN,103.27790000000012,104.00352825191901,102.55227174808122,103.06862269490867,103.19174270854191,103.59214572486279,102.79133969222103,21362,19198.466666666667,41.058980496257306,51.05798067888889,NaN,NaN,NaN,NaN,0.36681749356661747,14.68654579219289,40852473,-0.09019615658457686,-0.05620541925449629,0.03399073733008057
2025-08-29T13:20:00-04:00,102.89,103.22,102.89,103.11,102.59845104405707,NaN,NaN,NaN,NaN,NaN,103.27430000000011,104.00143687844923,102.547163121551,103.06862269490867,103.1909409414126,103.59010419357922,102.79177768924599,11065,18301.466666666667,46.05986851921587,50.045821287635384,NaN,NaN,NaN,NaN,0.36490195831185934,14.415103566784468,40863538,-0.0788545797490953,-0.06457748735628854,0.014277092392806744
2025-08-29T13:25:00-04:00,103.14,103.4,103.14,103.3,102.59845104405707,NaN,NaN,NaN,NaN,NaN,103.2729000000001,103.9995638562669,102.54623614373331,103.06862269490867,103.19159816411334,103.58935889102851,102.79383743719818,12149,16804.4,49.845593253862475,49.07656242864671,NaN,NaN,NaN,NaN,0.3595518184324413,13.576221751756357,40875687,-0.05561701714074491,-0.055244179033124396,0.00037283810762051353
2025-08-29T13:30:00-04:00,103.31,103.45,103.1,103.1,102.59845104405707,NaN,NaN,NaN,NaN,NaN,103.26650000000011,103.99350550204642,102.5394944979538,103.06862269490867,103.19172183602495,103.5885040892249,102.79493958282501,8162,16352.866666666667,46.172111823760545,48.36039493083022,NaN,NaN,NaN,NaN,0.35886954568726753,12.638243842518717,40867525,-0.05090355900034447,-0.06325661064281007,-0.012353051642465604
2025-08-29T13:35:00-04:00,103.11,103.3,103.07,103.29,102.59845104405707,NaN,NaN,NaN,NaN,NaN,103.25910000000009,103.9774138311384,102.54078616886177,103.06862269490867,103.19188478842656,103.58752795458518,102.79624162226794,9589,15900.666666666666,49.946073775045946,48.41501366423544,NaN,NaN,NaN,NaN,0.34966457813817725,11.865519025548446,40877114,-0.03304282953666718,-0.05365658856329958,-0.0206137590266324
2025-08-29T13:40:00-04:00,103.3,103.35,103.17,103.35,102.59845104405707,NaN,NaN,NaN,NaN,NaN,103.2619000000001,103.98051781220126,102.54328218779894,103.06862269490867,103.19232940200546,103.58713011350585,102.79752869050506,7575,15577.633333333333,51.11174753957615,48.576953302240085,NaN,NaN,NaN,NaN,0.3375456796997355,11.063976396908817,40884689,-0.016098919068382345,-0.04073740786211033,-0.024638488793727986
2025-08-29T13:45:00-04:00,103.39,103.5,103.33,103.48,102.59845104405707,NaN,NaN,NaN,NaN,NaN,103.2657000000001,103.98687684377936,102.54452315622083,102.8557138253759,103.19332700414903,103.58762887799627,102.79902513030179,6853,15354.433333333332,53.63139449554424,48.89211596290654,NaN,NaN,NaN,NaN,0.3255781311497545,10.834310827054386,40891542,0.003886048390371412,-0.019780928305763723,-0.023666976696135135
2025-08-29T13:50:00-04:00,103.46,103.63,103.44,103.52,102.59845104405707,NaN,NaN,NaN,NaN,NaN,103.26550000000009,103.98638903446552,102.54461096553466,103.01957106030072,103.19660205338663,103.59037033607365,102.8028337706996,16488,15289.933333333332,54.40997994900944,49.07317212680101,NaN,NaN,NaN,NaN,0.31589397892477183,11.038296665129705,40908030,0.018976999603968,0.000054272808824862295,-0.018922726795143136
2025-08-29T13:55:00-04:00,103.52,103.63,103.37,103.42,102.59845104405707,NaN,NaN,NaN,NaN,NaN,103.27150000000009,103.99243897107534,102.55056102892483,103.01957106030072,103.19746662094838,103.59092252161396,102.80401072028279,5312,15084.633333333333,52.05664825208897,48.97893945364596,NaN,NaN,NaN,NaN,0.3119015518587161,10.939789519886718,40902718,0.021231658293484716,0.007616846071712757,-0.013614812221771957
2025-08-29T14:00:00-04:00,103.41,103.43,103.3,103.3,102.59845104405707,NaN,NaN,NaN,NaN,NaN,103.26450000000008,103.97735412253832,102.55164587746185,103.01957106030072,103.1979630250505,103.59084071240362,102.80508533769738,5806,14947.233333333334,49.30098524396683,48.394646035248606,NaN,NaN,NaN,NaN,0.2989085838688085,10.560241326352376,40896912,0.013997840054751168,0.0038824878466670043,-0.010115352208084164
2025-08-29T14:05:00-04:00,103.34,103.78,103.34,103.76,102.59845104405707,NaN,NaN,NaN,NaN,NaN,103.26090000000009,103.96178997710629,102.56001002289389,103.09226038287397,103.20211848959013,103.59533715041876,102.80889982876151,16699,15081.7,58.39329971132431,48.637921563081264,NaN,NaN,NaN,NaN,0.31184368502103677,11.322098701454692,40913611,0.03817837811040639,0.03760762042992383,-0.000570757680482566
2025-08-29T14:10:00-04:00,103.73,103.73,103.56,103.72,102.62873091008673,NaN,NaN,NaN,NaN,NaN,103.2711000000001,103.98347992672475,102.55872007327545,103.09226038287397,103.20484069161394,103.59852529389941,102.81115608932846,10082,14980.566666666668,57.428823128262735,49.66202946044054,NaN,NaN,NaN,NaN,0.3038548503766772,12.02953769262113,40903529,0.04878539417762016,0.06041098504154263,0.011625590863922473
2025-08-29T14:15:00-04:00,103.7,103.7,103.5,103.58,102.62873091008673,NaN,NaN,NaN,NaN,NaN,103.2855000000001,103.99315033738833,102.57784966261187,103.09226038287397,103.20655777950392,103.60021583979865,102.8128997192092,7693,14403.4,54.06307113979805,50.34623183282655,NaN,NaN,NaN,NaN,0.2978652182069145,12.410924677974473,40895836,0.0438357941524197,0.0664203335544471,0.022584539402027398
2025-08-29T14:20:00-04:00,103.56,103.56,103.33,103.45,102.62873091008673,NaN,NaN,NaN,NaN,NaN,103.3031000000001,103.98187799021728,102.62432200978292,103.09226038287397,103.20759877095122,103.6007192085897,102.81447833331275,7579,14185.833333333334,51.06999340478795,51.039183623750056,NaN,NaN,NaN,NaN,0.29444627404927776,12.023159395319892,40888257,0.029933340750601035,0.06000121534027869,0.030067874589677655
2025-08-29T14:25:00-04:00,103.48,103.53,103.25,103.43,102.62873091008673,NaN,NaN,NaN,NaN,NaN,103.3137000000001,103.98346058409582,102.64393941590437,103.09226038287397,103.20836331464747,103.6009051473641,102.81582148193084,6855,13742.166666666666,50.60581065557012,51.72110006370097,NaN,NaN,NaN,NaN,0.2934143973314723,11.335085469528016,40881402,0.018099920759446934,0.052692775538986325,0.03459285477953939
2025-08-29T14:30:00-04:00,103.46,103.68,103.45,103.61,102.62873091008673,NaN,NaN,NaN,NaN,NaN,103.3205000000001,103.99523328064079,102.6457667193594,103.09226038287397,103.21215581659594,103.60447161025343,102.81984002293845,18094,13859.066666666668,54.60488525521058,52.3314584019863,NaN,NaN,NaN,NaN,0.29031336895065285,11.252257544816187,40899496,0.020905937638866716,0.06072527682812279,0.03981933918925607
2025-08-29T14:35:00-04:00,103.62,103.62,103.47,103.51,102.62873091008673,NaN,NaN,NaN,NaN,NaN,103.3261000000001,104.00238186431771,102.64981813568248,103.09226038287397,103.2137710419194,103.60575804924214,102.82178403459666,8962,13913.933333333332,52.08207770055305,52.49120729103562,NaN,NaN,NaN,NaN,0.2802909854541781,11.175345900440917,40890534,0.0148239791645393,0.05834931314493019,0.04352533398039089
2025-08-29T14:40:00-04:00,103.48,103.57,103.36,103.55,102.62873091008673,NaN,NaN,NaN,NaN,NaN,103.3361000000001,104.01053988613276,102.66166011386744,103.09226038287397,103.21474280499301,103.60639371427291,102.8230918957131,6216,13529.666666666666,53.017131981732135,52.980137302319314,NaN,NaN,NaN,NaN,0.2752702007788792,10.603998219149265,40896750,0.01239072232773978,0.059013736890065616,0.046623014562325836
2025-08-29T14:45:00-04:00,103.59,103.64,103.44,103.57,102.62873091008673,NaN,NaN,NaN,NaN,NaN,103.3427000000001,104.01970283604385,102.66569716395634,103.09226038287397,103.2165758181621,103.60793619682579,102.82521543949841,9831,11554.833333333334,53.505664611130896,53.234393790611094,NaN,NaN,NaN,NaN,0.2698937578661023,10.361988910307177,40906581,0.011067362095470684,0.06045721718166419,0.04938985508619351
2025-08-29T14:50:00-04:00,103.55,103.84,103.5,103.76,102.74725322656518,NaN,NaN,NaN,NaN,NaN,103.36790000000008,104.01048257058649,102.72531742941366,103.22240406313375,103.22496644797783,103.61801908985596,102.8319138060997,31760,11909.6,57.97618254553215,53.72471057675081,NaN,NaN,NaN,NaN,0.2749013465899524,10.891223736441951,40938341,0.021332814374872576,0.07605587305478423,0.05472305867991165
2025-08-29T14:55:00-04:00,103.77,103.85,103.65,103.69,102.84192353444858,NaN,NaN,NaN,NaN,NaN,103.39030000000008,103.9971555347158,102.78344446528436,103.255923250507,103.23029409188288,103.62465801221694,102.83593017154882,19509,11947.833333333334,55.84570624539222,53.882875701739955,NaN,NaN,NaN,NaN,0.269551250404955,11.418416221976422,40918832,0.021682563460899487,0.08182626300603602,0.06014369954513653
2025-08-29T15:00:00-04:00,103.69,103.76,103.6,103.71,102.84192353444858,NaN,NaN,NaN,NaN,NaN,103.41510000000008,103.96848409809283,102.86171590190733,103.255923250507,103.23585962314463,103.63104003981235,102.84067920647692,22664,12471.766666666666,56.33937279510625,54.02068947646116,NaN,NaN,NaN,NaN,0.2617261610903161,11.639786736782847,40941496,0.021493178254911538,0.08701017236377595,0.06551699410886441
2025-08-29T15:05:00-04:00,103.68,103.75,103.5,103.75,102.84192353444858,NaN,NaN,NaN,NaN,NaN,103.43670000000007,103.95528117978304,102.9181188202171,103.255923250507,103.23859904663733,103.63400665802266,102.84319143525201,11980,12353.133333333333,57.36604328081686,54.39993197851315,NaN,NaN,NaN,NaN,0.26088857815529354,11.321881571256538,40953476,0.02220316798039676,0.09327095408436037,0.07106778610396361
2025-08-29T15:10:00-04:00,103.74,103.76,103.65,103.68,102.84778773971905,NaN,NaN,NaN,NaN,NaN,103.45030000000008,103.95790776196314,102.94269223803703,103.255923250507,103.24265336084422,103.6386383066347,102.84666841505373,16824,12223.933333333332,54.93167285107765,54.80212395044964,NaN,NaN,NaN,NaN,0.2501108225727725,11.07205874537749,40936652,0.01636910112351006,0.09152916250835119,0.07516006138484113
2025-08-29T15:15:00-04:00,103.71,103.81,103.61,103.78,102.86447920609545,NaN,NaN,NaN,NaN,NaN,103.46310000000008,103.97104050833869,102.95515949166148,103.30170616340767,103.24726036278203,103.64421272828454,102.85030799727951,18016,12614.066666666668,57.69367321108107,54.75215062900369,NaN,NaN,NaN,NaN,0.24653147810328896,11.074108935864805,40954668,0.017550872161639197,0.09709865158689013,0.07954777942525093
2025-08-29T15:20:00-04:00,103.76,103.82,103.66,103.77,102.91109378763656,NaN,NaN,NaN,NaN,NaN,103.48030000000008,103.97007713299206,102.99052286700811,103.33336493072613,103.25100844639415,103.64883592076642,102.85318097202189,14413,12831.566666666668,57.31539764845663,54.74404880901754,NaN,NaN,NaN,NaN,0.24035065823876806,11.12425777465256,40940255,0.01600813907461171,0.09955795326851558,0.08354981419390387
2025-08-29T15:25:00-04:00,103.75,103.82,103.6,103.69,102.91109378763656,NaN,NaN,NaN,NaN,NaN,103.4901000000001,103.97664903143854,103.00355096856165,103.33336493072613,103.2577373854214,103.65637338231748,102.8591013885253,29194,13380.166666666666,54.2508838308809,54.75746400123774,NaN,NaN,NaN,NaN,0.23889703979314167,10.797207780312332,40911061,0.008334889947716626,0.09396842662854965,0.08563353668083303
2025-08-29T15:30:00-04:00,103.72,103.85,103.66,103.78,102.94519082716471,NaN,NaN,NaN,NaN,NaN,103.4929000000001,103.98445300831897,103.00134699168125,103.35555355566473,103.26472470777263,103.66497270115848,102.86447671438678,27501,13807.533333333333,57.034126809841744,55.183473530170154,NaN,NaN,NaN,NaN,0.2354043940936314,10.657586579274227,40938562,0.008051402482372558,0.09569778978379873,0.08764638730142617
2025-08-29T15:35:00-04:00,103.79,103.91,103.69,103.86,102.99700033502086,NaN,NaN,NaN,NaN,NaN,103.50270000000009,104.00351218036359,103.0018878196366,103.40444284453179,103.27396691157332,103.67717728341457,102.87075653973208,33682,14460.966666666667,59.39863698977364,55.81153255404184,NaN,NaN,NaN,NaN,0.23430408022980048,10.855300431735603,40972244,0.011758007931331166,0.10234389721559012,0.09058588928425895
2025-08-29T15:40:00-04:00,103.88,104.1,103.86,103.97,103.18077304706536,NaN,NaN,NaN,NaN,NaN,103.5127000000001,104.03019090813484,102.99520909186535,103.57555427562542,103.28593038312145,103.69589904680002,102.87596171944288,35049,15232.133333333333,62.45794347009052,56.372465283676114,NaN,NaN,NaN,NaN,0.23471093164195725,11.94397178120587,41007293,0.01965895097157258,0.11515957799872467,0.09550062702715209
2025-08-29T15:45:00-04:00,103.97,104.13,103.885,104.04,103.21119245401694,NaN,NaN,NaN,NaN,NaN,103.52490000000009,104.0623922883196,102.98740771168058,103.58794342050034,103.29678026237143,103.71320937028459,102.88035115445827,30956,15551.933333333332,64.30136244310926,57.24527133671585,NaN,NaN,NaN,NaN,0.23544586509610246,13.083065948745704,41038249,0.027177129787785706,0.12947203926188422,0.10229490947409851
2025-08-29T15:50:00-04:00,104.06,104.12,103.77,103.87,103.21119245401694,NaN,NaN,NaN,NaN,NaN,103.53270000000009,104.07861285019143,102.98678714980875,103.58794342050034,103.31591238854557,103.73976035338936,102.89206442370178,66181,17389.133333333335,56.98340387192289,57.52857647172948,NaN,NaN,NaN,NaN,0.2436283033035243,13.30848380555065,40972068,0.018683102554608283,0.12564878766735887,0.10696568511275059
2025-08-29T15:55:00-04:00,103.89,104.08,103.86,104.05,103.21119245401694,NaN,NaN,NaN,NaN,NaN,103.54390000000008,104.10850708463029,102.97929291536987,103.58794342050034,103.3368217281859,103.77032624491989,102.9033172114519,68314,19261.3,61.92450353073305,58.12992210884392,NaN,NaN,NaN,NaN,0.2419405673532725,13.51780038686953,41040382,0.022891805487191635,0.13558044197174013,0.1126886364845485
2025-09-02T09:30:00-04:00,100.35,100.55,97.91,98.48,NaN,NaN,NaN,100.83197728994637,100.83197728994637,100.83197728994637,103.44570000000009,104.97205514871582,101.91934485128435,103.58794342050034,98.98,98.98,98.98,279981,28321.933333333334,12.826516917267782,54.90494599253931,NaN,NaN,NaN,NaN,0.6632305268280387,18.41126369960195,40760401,-0.33216203557419666,-0.3025139079831973,0.029648127590999315
2025-09-02T09:35:00-04:00,98.47,100.01,98.47,99.39,NaN,NaN,NaN,100.83197728994637,NaN,NaN,103.3677000000001,105.27016704044816,101.46523295955204,103.58794342050034,99.10420266555924,99.25611225771985,98.95229307339864,187163,34241.066666666666,23.49843213129695,52.594426412961084,NaN,NaN,NaN,NaN,0.7258569177688935,22.955193918567772,40947564,-0.47948664408482694,-0.5697101775150344,-0.09022353343020743
2025-09-02T09:40:00-04:00,99.36,100.36,99.36,100.165,NaN,NaN,NaN,100.83197728994637,NaN,NaN,103.30020000000009,105.40242830349037,101.19797169650981,103.58794342050034,99.24872116230628,99.5983223330854,98.89911999152716,94693,37145,31.220953387754435,50.800253598150235,NaN,NaN,NaN,NaN,0.7454385664996869,26.465594780120206,41042257,-0.49641013215948326,-0.7107361986295615,-0.21432606647007826
2025-09-02T09:45:00-04:00,100.14,101.2,99.99,101,98.71518673157462,98.71518673157462,98.71518673157462,NaN,NaN,NaN,103.25080000000008,105.44865564585555,101.05294435414461,103.58794342050034,99.48403884983064,100.1133253566714,98.85475234298988,106111,40453.6,38.43222259411107,49.44783783481411,NaN,NaN,NaN,NaN,0.7786215260354241,28.20677644350873,41148368,-0.42575308809106277,-0.7465174265839067,-0.32076433849284397
2025-09-02T09:50:00-04:00,101,101.88,100.94,101.76,99.4874509710485,NaN,NaN,NaN,NaN,NaN,103.2092000000001,105.43937341029792,100.97902658970227,103.58794342050034,99.68574812281163,100.53911014641123,98.83238609921203,73187,42343.566666666666,44.169895640985054,48.67913946266464,NaN,NaN,NaN,NaN,0.7901485598900365,28.77611065758844,41221555,-0.30772216957508863,-0.7054170504617048,-0.39769488088661614
2025-09-02T09:55:00-04:00,101.79,101.84,100.81,101.1,99.4874509710485,NaN,NaN,NaN,NaN,NaN,103.1499000000001,105.442696100833,100.8571038991672,103.58794342050034,99.8046652217331,100.72376299755997,98.88556744590623,60978,44199.1,40.62884735213897,47.46022332988306,NaN,NaN,NaN,NaN,0.8072808056121769,29.39423391403212,41160577,-0.2561053216761383,-0.717826532981789,-0.4617212113056507
2025-09-02T10:00:00-04:00,101.12,101.69,100.56,100.7,99.4874509710485,NaN,NaN,NaN,NaN,NaN,103.0893000000001,105.47581713591326,100.70278286408693,103.58794342050034,99.891704252245,100.82838721698937,98.95502128750064,63955,46137.4,38.60866311122506,46.12402800579509,NaN,NaN,NaN,NaN,0.8303321766398781,30.142740602356533,41096622,-0.23164505861976203,-0.7512775345803533,-0.5196324759605913
2025-09-02T10:05:00-04:00,100.73,100.95,100.3,100.51,99.4874509710485,NaN,NaN,NaN,NaN,NaN,103.03270000000009,105.52465602690222,100.54074397309796,103.51135473640028,99.92903878890255,100.85358903940147,99.00448853840362,49168,47219.7,37.651003167608735,44.93832224413279,NaN,NaN,NaN,NaN,0.8174513068798872,31.01775623250191,41047454,-0.21155858889303558,-0.7840807120768858,-0.5725221231838502
2025-09-02T10:10:00-04:00,100.47,100.93,100.32,100.62,99.4874509710485,NaN,NaN,NaN,NaN,NaN,102.9787000000001,105.55886806429355,100.39853193570666,103.48308378912022,99.9528583228436,100.87015746819452,99.03555917749267,32515,47967.46666666667,38.60054659331839,43.621637942952546,NaN,NaN,NaN,NaN,0.8026333563884677,31.830270746208328,41079969,-0.17563901006197524,-0.7920708857613192,-0.616431875699344
2025-09-02T10:15:00-04:00,100.58,100.63,99.75,99.88,99.4874509710485,NaN,NaN,NaN,NaN,NaN,102.9095000000001,105.62902661321918,100.189973386781,98.82795239681514,99.96418373358702,100.84259502929277,99.08577243788127,87634,50632.166666666664,34.76480870089898,41.862078779461505,NaN,NaN,NaN,NaN,0.8081595452178625,32.98095218781519,40992335,-0.18552320627220853,-0.8483358835396047,-0.6628126772673961
2025-09-02T10:20:00-04:00,99.86,100.35,99.67,99.78,99.4874509710485,NaN,NaN,NaN,NaN,NaN,102.83550000000008,105.6870583458914,99.98394165410876,98.82795239681514,99.9621761299727,100.81155924550902,99.11279301443639,72068,52781.8,34.269229836347336,39.84859923419413,NaN,NaN,NaN,NaN,0.7990052919880146,34.10278461352002,40920267,-0.18233202565563755,-0.890727709336943,-0.7083956836813055
2025-09-02T10:25:00-04:00,99.76,100.32,99.66,100.27,99.4874509710485,NaN,NaN,NaN,NaN,NaN,102.76970000000009,105.70203995983051,99.83736004016966,98.82795239681514,99.96776875383455,100.79770593999876,99.13783156767033,53594,54339.76666666667,38.86780890069667,38.03191683830752,NaN,NaN,NaN,NaN,0.789076342560299,35.15155022760037,40973861,-0.1330447458964139,-0.8747016160518228,-0.7416568701554089
2025-09-02T10:30:00-04:00,100.24,100.64,100,100.03,99.4874509710485,NaN,NaN,NaN,NaN,NaN,102.69450000000008,105.70999216547318,99.67900783452697,98.82795239681514,99.98028472702313,100.7915212930081,99.16904816103816,59789,55729.6,37.48453891082266,36.6391407696575,NaN,NaN,NaN,NaN,0.7784280323774205,35.46350407945737,40914072,-0.10373270357156417,-0.8713227496198641,-0.7675900460483
2025-09-02T10:35:00-04:00,100.04,100.17,99.7,99.77,99.4874509710485,NaN,NaN,NaN,NaN,NaN,102.61630000000008,105.72680658896913,99.50579341103104,98.82795239681514,99.97669122687584,100.7734787607258,99.17990369302589,45372,56943.26666666667,35.990203829661155,34.78669079100951,NaN,NaN,NaN,NaN,0.7563974586361761,36.008753183415,40868700,-0.08951726424239559,-0.8794866263512944,-0.7899693621088988
2025-09-02T10:40:00-04:00,99.8,99.82,99.16,99.38,NaN,NaN,NaN,101.50396899326186,101.50396899326186,101.50396899326186,102.54330000000007,105.7802946617234,99.30630533827674,98.82795239681514,99.9505492687846,100.73550564748707,99.16559289008212,66573,58955.166666666664,33.812734455988604,36.285706329489564,NaN,NaN,NaN,NaN,0.7495119258764491,36.93321870934409,40802127,-0.09360154836426182,-0.9069712975642261,-0.8133697491999643
2025-09-02T10:45:00-04:00,99.37,99.57,98.62,98.67,NaN,NaN,NaN,101.14697040265905,NaN,NaN,102.45470000000006,105.86382564157377,99.04557435842635,98.7153619174521,99.85520208524889,100.65722101043886,99.05318316005892,140904,63324.26666666667,30.22727237744158,36.76633777564275,NaN,NaN,NaN,NaN,0.763832502599559,38.15535289800501,40661223,-0.12914995525733253,-0.97480719327163,-0.8456572380142975
2025-09-02T10:50:00-04:00,98.66,99.21,98.62,99.15,NaN,NaN,NaN,100.95415356617454,NaN,NaN,102.37970000000008,105.90921237992262,98.85018762007755,98.60191247448857,99.82121839730029,100.62496342018498,99.01747337441559,60493,64282.03333333333,35.22785589620237,37.052545097674745,NaN,NaN,NaN,NaN,0.7514158952710183,39.29019178747586,40721716,-0.10631857969635783,-0.9785554626347448,-0.872236882938387
2025-09-02T10:55:00-04:00,99.15,99.59,99,99.55,NaN,NaN,NaN,100.95415356617454,NaN,NaN,102.31310000000009,105.92699921829833,98.69920078170185,98.60191247448857,99.80480040962964,100.5978591568136,99.01174166244567,59294,65608.2,39.142163321857026,37.1032551496566,NaN,NaN,NaN,NaN,0.7398861884659457,39.51569688225744,40781010,-0.0529558374877136,-0.938431679798029,-0.8854758423103154
2025-09-02T11:00:00-04:00,99.58,100.07,99.58,99.75,NaN,NaN,NaN,100.95415356617454,NaN,NaN,102.24590000000009,105.92244168479269,98.5693583152075,98.60191247448857,99.80467145069919,100.58700563833357,99.02233726306481,43989,66319.03333333334,41.0600849281715,36.881125813027055,NaN,NaN,NaN,NaN,0.7241800321469493,38.779970556197306,40824999,0.004103175022443506,-0.880346873532261,-0.8844500485547045
2025-09-02T11:05:00-04:00,99.76,100.25,99.74,100.22,NaN,NaN,NaN,100.95415356617454,NaN,NaN,102.18430000000008,105.89121678353129,98.47738321646887,98.65544382696987,99.81081696531282,100.58506719938333,99.03656673124232,38826,67213.9,45.41370479773269,37.22290134485518,NaN,NaN,NaN,NaN,0.7088814584221675,37.763084076005455,40863825,0.07770922769253175,-0.7873135139390399,-0.8650227416315717
2025-09-02T11:10:00-04:00,100.24,100.61,100.16,100.42,NaN,NaN,NaN,100.95415356617454,NaN,NaN,102.13070000000009,105.860536462906,98.40086353709418,99.1093550615759,99.82465749034908,100.59486407761898,99.05445090307919,40560,68005.1,47.20094916584791,37.836636063042526,NaN,NaN,NaN,NaN,0.6903899256777272,36.17610824425094,40904385,0.14042020937656174,-0.6894974799108695,-0.8299176892874313
2025-09-02T11:15:00-04:00,100.41,100.62,99.98,99.98,NaN,NaN,NaN,100.95415356617454,NaN,NaN,102.06450000000008,105.82703544834163,98.30196455165853,99.1093550615759,99.83288246509301,100.59639309603965,99.06937183414637,39176,68710.43333333333,43.80303877167795,38.27606717761889,NaN,NaN,NaN,NaN,0.6867906452721753,34.928382549645974,40865209,0.1518516074497176,-0.6401031799752843,-0.7919547874250019
2025-09-02T11:20:00-04:00,99.99,100.28,99.92,100.27,NaN,NaN,NaN,100.95415356617454,NaN,NaN,102.00290000000008,105.78005665018394,98.22574334981623,99.1093550615759,99.8468898056001,100.596602081912,99.0971775292882,79403,70876.76666666666,46.534917616987016,38.84280796502379,NaN,NaN,NaN,NaN,0.6634484563241626,33.84679867314958,40944612,0.17678349724681353,-0.570975415866485,-0.7477589131132986
2025-09-02T11:25:00-04:00,100.26,100.46,100.09,100.24,NaN,NaN,NaN,100.95415356617454,NaN,NaN,101.93810000000009,105.72283190068,98.15336809932018,99.15786979152685,99.85415324014669,100.59929563289583,99.10901084739754,32581,70989.66666666667,46.28425485584654,39.665625547520044,NaN,NaN,NaN,NaN,0.6424878523010075,32.49088044430227,40912031,0.1880456850758241,-0.5127018067685185,-0.7007474918443426
2025-09-02T11:30:00-04:00,100.23,100.23,99.78,99.88,NaN,NaN,NaN,100.95415356617454,NaN,NaN,101.86530000000008,105.66551915684292,98.06508084315723,99.15786979152685,99.85559188303972,100.59591339732066,99.11527036875879,24943,70904.4,43.27205152222816,40.308684239368674,NaN,NaN,NaN,NaN,0.6294530057080779,31.66245818964977,40887088,0.16866116282763222,-0.48992103830980227,-0.6585822011374345
2025-09-02T11:35:00-04:00,99.91,99.95,99.35,99.35,NaN,NaN,NaN,100.95415356617454,NaN,NaN,101.78390000000009,105.62159894077558,97.94620105922459,99.15786979152685,99.85200789750937,100.58871034404252,99.11530545097621,22464,70530.46666666666,39.224718873199315,40.33417780883315,NaN,NaN,NaN,NaN,0.6273492195860729,31.433765703747817,40864624,0.11985062936042801,-0.5087689144368994,-0.6286195437973274
2025-09-02T11:40:00-04:00,99.38,99.44,99.135,99.21,NaN,NaN,NaN,100.95415356617454,NaN,NaN,101.70210000000009,105.58118241212219,97.82301758787798,99.15786979152685,99.84181345361623,100.57616520972311,99.10746169750934,33658,70484.1,38.20811017389405,40.38586147048111,NaN,NaN,NaN,NaN,0.6043242753299243,31.47173726597548,40830966,0.07977089601893095,-0.5289059237736637,-0.6086768197925947
2025-09-02T11:45:00-04:00,99.2,99.41,99.11,99.21,NaN,NaN,NaN,100.95415356617454,NaN,NaN,101.61110000000008,105.50625149384855,97.7159485061516,99.15786979152685,99.8336002937299,100.5662119414454,99.1009886460144,27120,70356.23333333334,38.20811017389405,40.54428335221203,NaN,NaN,NaN,NaN,0.5825868270920723,31.536626246968442,40830966,0.056017163829360284,-0.5386553650058943,-0.5946725288352546
2025-09-02T11:50:00-04:00,99.21,99.22,98.46,98.8,NaN,NaN,NaN,100.63159935164812,NaN,NaN,101.51270000000008,105.43823956037113,97.58716043962903,99.15786979152685,99.78948592152751,100.53492537084709,99.04404647220794,90545,71168.36666666667,35.116855471199884,40.637434853298544,NaN,NaN,NaN,NaN,0.5952591965854961,32.30121003759292,40740421,0.017448546154441247,-0.572861846142203,-0.5903103922966443
2025-09-02T11:55:00-04:00,98.81,99.09,98.63,99.07,NaN,NaN,NaN,100.63159935164812,NaN,NaN,101.42250000000007,105.36112425220308,97.48387574779706,99.15786979152685,99.76904861086838,100.51712254941951,99.02097467231725,50341,70569.26666666666,38.637689303318574,41.23817891943262,NaN,NaN,NaN,NaN,0.5855978254008184,33.01118070031564,40790762,0.014972318569323795,-0.5715949940849896,-0.5865673126543134
2025-09-02T12:00:00-04:00,99.04,99.33,98.98,99.1,NaN,NaN,NaN,100.63159935164812,NaN,NaN,101.33550000000008,105.28330255332436,97.3876974466758,99.15786979152685,99.75484476231637,100.50038194749993,99.0093075771328,48644,62858.03333333333,39.03355392662402,41.510014493034156,NaN,NaN,NaN,NaN,0.5687694093007595,33.07328422779675,40839406,0.01989754554965928,-0.5616953807172393,-0.5815929262668986
2025-09-02T12:05:00-04:00,99.11,99.25,98.67,98.67,NaN,NaN,NaN,100.63159935164812,NaN,NaN,101.24030000000008,105.21098377487341,97.26961622512674,99.15786979152685,99.74361866744235,100.4910869209186,98.99615041396609,27619,57539.9,35.4985678786818,41.249757675664505,NaN,NaN,NaN,NaN,0.5695715943507051,33.48789316662081,40811787,-0.00019780356255538756,-0.5818401807200928,-0.5816423771575374
2025-09-02T12:10:00-04:00,98.66,98.96,98.64,98.95,NaN,NaN,NaN,100.50457428415015,NaN,NaN,101.14710000000008,105.10967294696718,97.18452705303298,99.15786979152685,99.73437868968566,100.48344704773986,98.98531033163145,22916,55147.333333333336,39.35027039618105,41.12762806623662,NaN,NaN,NaN,NaN,0.5517450518970829,33.90700678422618,40834703,0.010388858510863352,-0.5686563040189583,-0.5790451625298216
2025-09-02T12:15:00-04:00,98.97,99.07,98.87,99,NaN,NaN,NaN,100.50457428415015,NaN,NaN,101.05690000000008,105.00551742386256,97.10828257613761,98.9582958332215,99.72417566639055,100.47324661418133,98.97510471859977,30386,52623.166666666664,40.038843472284256,40.74370940013316,NaN,NaN,NaN,NaN,0.5266204053330047,33.998204653324585,40865089,0.024949699478519216,-0.5478580381816727,-0.5728077376601919
2025-09-02T12:20:00-04:00,98.99,99.14,98.82,98.99,NaN,NaN,NaN,100.50457428415015,NaN,NaN,100.96570000000007,104.89034419279506,97.04105580720508,98.6326366665772,99.71470409818706,100.46361052277152,98.9657976736026,29095,51153.433333333334,39.94117448632061,40.225154065881206,NaN,NaN,NaN,NaN,0.5118618049520763,33.888774441682685,40835994,0.037352250199291115,-0.526117424911078,-0.5634696751103692
2025-09-02T12:25:00-04:00,98.96,99.2,98.9,99.19,NaN,NaN,NaN,100.50457428415015,NaN,NaN,100.87810000000009,104.76162875102392,96.99457124897626,98.2948874666094,99.70866409610196,100.45637799603762,98.9609501961663,22460,49869.5,42.93914992684963,40.16344771982204,NaN,NaN,NaN,NaN,0.4967288188840707,33.61477946766352,40858454,0.061068440271242475,-0.4871341247713161,-0.5482025650425586
2025-09-02T12:30:00-04:00,99.17,99.55,99.12,99.14,NaN,NaN,NaN,100.50457428415015,NaN,NaN,100.78570000000009,104.60995104301739,96.96144895698279,98.593305812504,99.70329364091856,100.44798044166001,98.95860684017711,28485,48687.166666666664,42.369731341576085,39.86593441443555,NaN,NaN,NaN,NaN,0.49196247467806514,32.406361252771454,40829969,0.07453895515151332,-0.4550288711031669,-0.5295678262546802
2025-09-02T12:35:00-04:00,99.15,99.26,98.84,99.03,NaN,NaN,NaN,100.50457428415015,NaN,NaN,100.6925000000001,104.45573703744863,96.92926296255156,98.593305812504,99.69207778319506,100.4353207293634,98.94883483702672,40225,48389.066666666666,41.07908768937929,39.49413675968788,NaN,NaN,NaN,NaN,0.4868222979153463,31.767921240359225,40789744,0.07688258347882548,-0.43346459690614836,-0.5103471803849738
2025-09-02T12:40:00-04:00,99.05,99.48,99.04,99.43,NaN,NaN,NaN,100.50457428415015,NaN,NaN,100.6069000000001,104.28545019811156,96.92834980188863,98.593305812504,99.6846014373481,100.42227317240409,98.94692970229212,48095,48908.4,47.35865352913173,39.78603690303813,NaN,NaN,NaN,NaN,0.48419213377853604,30.607542312273967,40837839,0.10450101559628555,-0.3797209108896169,-0.48422192648590245
2025-09-02T12:45:00-04:00,99.43,99.7,99.35,99.43,NaN,NaN,NaN,100.50457428415015,NaN,NaN,100.52050000000008,104.10133132806135,96.93966867193882,98.72077257600205,99.68246662247267,100.41628525434399,98.94864799060136,27259,46895.9,47.35865352913173,40.36703223560473,NaN,NaN,NaN,NaN,0.4746069813657841,28.995245120931045,40837839,0.12074815674622064,-0.33328673055312663,-0.45403488729934727
2025-09-02T12:50:00-04:00,99.44,99.78,99.3,99.78,NaN,NaN,NaN,100.50457428415015,NaN,NaN,100.4425000000001,103.91284421924055,96.97215578075964,98.75661806080163,99.68167907378344,100.41089052690339,98.9524676206635,31184,45533.1,52.49630850190681,41.38761783046279,NaN,NaN,NaN,NaN,0.4749921969825141,27.307100661223227,40869023,0.1510772638921284,-0.26518830743418675,-0.41626557132631514
2025-09-02T12:55:00-04:00,99.8,100.02,99.78,99.99,NaN,NaN,NaN,100.50457428415015,NaN,NaN,100.3667000000001,103.70519883031523,97.02820116968496,99.0812944486413,99.68613964182691,100.40952427676844,98.96275500688539,45243,45254.73333333333,55.31431688759688,42.60948973858443,NaN,NaN,NaN,NaN,0.4582070400551913,25.530922268602552,40914266,0.1793639640195649,-0.192060616301859,-0.3714245803214239
2025-09-02T13:00:00-04:00,99.97,100.19,99.95,100.125,NaN,NaN,NaN,100.50457428415015,NaN,NaN,100.29380000000009,103.48791869535555,97.09968130464463,99.31903555891304,99.68978509165882,100.41089202091409,98.96867816240355,23038,44029.7,57.07711658443145,44.17807981810096,NaN,NaN,NaN,NaN,0.44262082290839155,24.254190123793613,40937304,0.1996925558916529,-0.12180888545685775,-0.32150144134851066
2025-09-02T13:05:00-04:00,100.17,100.28,99.92,99.94,NaN,NaN,NaN,100.50457428415015,NaN,NaN,100.21880000000009,103.263003383486,97.17459661651418,99.40322844713045,99.69336422683863,100.41172676248718,98.97500169119007,25749,43375.6,53.937012137740254,45.27088859198823,NaN,NaN,NaN,NaN,0.43671933555779213,23.263767525040254,40911555,0.19309070915594012,-0.0801380549035855,-0.2732287640595256
2025-09-02T13:10:00-04:00,99.93,99.975,99.54,99.59,NaN,NaN,NaN,100.50457428415015,NaN,NaN,100.13500000000009,103.00835065733868,97.2616493426615,99.40322844713045,99.69350505294545,100.40574990103151,98.9812602048594,44301,42633.2,48.500624699245016,45.94710793288972,NaN,NaN,NaN,NaN,0.43659652587509185,21.794866391008924,40867254,0.1589854576307752,-0.07449694202105661,-0.23348239965183182
2025-09-02T13:15:00-04:00,99.57,100,99.55,99.87,NaN,NaN,NaN,100.50457428415015,NaN,NaN,100.0552000000001,102.72470179621864,97.38569820378156,99.40322844713045,99.69474762323472,100.40316943739931,98.98632580907012,28997,38902.96666666667,52.615306551484274,47.16973212380419,NaN,NaN,NaN,NaN,0.437553916884014,20.369781532292976,40896251,0.14927222664201575,-0.04689211634931212,-0.19616434299132787
2025-09-02T13:20:00-04:00,99.89,100.44,99.89,100.44,NaN,NaN,NaN,100.50457428415015,NaN,NaN,99.9846000000001,102.41196387054305,97.55723612945715,99.40322844713045,99.70108965366104,100.40799895135102,98.99418035597107,30145,37891.36666666667,59.67810402138825,48.621720239890415,NaN,NaN,NaN,NaN,0.4470143513922982,19.77502912734176,40926396,0.17352352610022634,0.020740064633955058,-0.15278346146627128
2025-09-02T13:25:00-04:00,100.44,100.78,100.32,100.72,99.11268602612971,99.11268602612971,99.11268602612971,NaN,NaN,NaN,99.91820000000008,102.06343263074943,97.77296736925074,99.70751437194463,99.72899525891856,100.44230702399854,99.01568349383858,84922,38745.63333333333,62.6251442336072,50.23502743712777,NaN,NaN,NaN,NaN,0.44794189772142035,19.863002876445453,41011318,0.19888922432602418,0.09582806894125895,-0.10306115538476524
2025-09-02T13:30:00-04:00,100.71,100.98,100.53,100.97,99.32165484312381,NaN,NaN,NaN,NaN,NaN,99.86020000000008,101.7116134708473,98.00878652915286,99.89701149755571,99.7448447079911,100.46499269004056,99.02469672594165,40375,38625.166666666664,65.07926089885859,52.030605038023374,NaN,NaN,NaN,NaN,0.4480889050270334,20.286856330184005,41051693,0.2212558556061029,0.17350866412286337,-0.04774719148323951
2025-09-02T13:35:00-04:00,100.93,101.11,100.86,101.03,99.58271598661818,NaN,NaN,NaN,NaN,NaN,99.79980000000009,101.25522428179094,98.34437571820924,100.11860919804457,99.76202624386956,100.49194694458548,99.03210554315363,38808,38624.566666666666,65.66201641496008,53.65366693003126,NaN,NaN,NaN,NaN,0.4339396975251025,20.89626272444786,41090501,0.2279405910796415,0.2371785473663124,0.009237956286670873
2025-09-02T13:40:00-04:00,101,101.26,100.97,101.21,99.73691071449919,NaN,NaN,NaN,NaN,NaN,99.8544000000001,101.3125078698153,98.39629213018489,100.32188735843565,99.77358089289714,100.51128255115445,99.03587923463984,23857,38067.8,67.4186377095617,55.442874527744515,NaN,NaN,NaN,NaN,0.42365829055902415,21.70701744832715,41114358,0.23158439013431933,0.29871844395457003,0.0671340538202507
2025-09-02T13:45:00-04:00,101.24,101.3,101.04,101.07,99.81909659111285,NaN,NaN,NaN,NaN,NaN,99.88800000000009,101.37881320091634,98.39718679908384,100.41950988674851,99.78507580305877,100.53016028075814,99.03999132535941,24314,37572.4,64.6484959523125,57.1264036893826,NaN,NaN,NaN,NaN,0.41196841266195033,22.525884708058033,41090044,0.21218169509538998,0.33236117268948817,0.1201794775940982
2025-09-02T13:50:00-04:00,101.09,101.22,100.97,100.98,99.81909659111285,NaN,NaN,NaN,NaN,NaN,99.90430000000009,101.42440527267904,98.38419472732114,100.41950988674851,99.79963208989155,100.55268829897499,99.0465758808081,33387,36038.53333333333,62.860369980625414,58.23366915020358,NaN,NaN,NaN,NaN,0.40039924032895385,23.047822412523573,41056657,0.18205830356655045,0.34775235705228624,0.1656940534857358
2025-09-02T13:55:00-04:00,100.97,101.07,100.935,100.97,99.81909659111285,NaN,NaN,NaN,NaN,NaN,99.90370000000009,101.42209758957907,98.3853024104211,100.41950988674851,99.80662471754418,100.562966946343,99.05028248874537,17210,35526.166666666664,62.653010544238455,59.3261232227112,NaN,NaN,NaN,NaN,0.3814421517340279,23.408973902182822,41039447,0.1514849705377069,0.35505026665786943,0.20356529612016253
2025-09-02T14:00:00-04:00,100.96,101.36,100.96,101.03,99.88188425340873,NaN,NaN,NaN,NaN,NaN,99.88910000000007,101.34872144408885,98.42947855591129,100.57518906201524,99.82454308254631,100.59095154423663,99.058134620856,40684,36050.86666666667,63.432443466965005,60.107275720215355,NaN,NaN,NaN,NaN,0.3827677123244549,24.28977661010622,41080131,0.12635429910801424,0.3615081700051803,0.23515387089716608
2025-09-02T14:05:00-04:00,101.06,101.07,100.58,100.64,99.88188425340873,NaN,NaN,NaN,NaN,NaN,99.87990000000008,101.31445984888478,98.44534015111537,100.57518906201524,99.83468230398535,100.60309223646301,99.06627237150768,32476,36384.6,55.34681436092291,60.10959696831007,NaN,NaN,NaN,NaN,0.3904271614441363,23.843877454640545,41047655,0.07694643812512703,0.33133691855357483,0.2543904804284478
2025-09-02T14:10:00-04:00,100.63,100.73,100.5,100.53,99.88188425340873,NaN,NaN,NaN,NaN,NaN,99.87650000000006,101.30405770462937,98.44894229537076,100.57518906201524,99.84076373009161,100.60901816509113,99.07250929509209,24516,36079.86666666667,53.28376307195047,59.83864314599,NaN,NaN,NaN,NaN,0.3789680784838411,23.18780114086655,41023139,0.03260571614476382,0.29514762560940255,0.26254190946463873
2025-09-02T14:15:00-04:00,100.53,100.76,100.53,100.61,99.88188425340873,NaN,NaN,NaN,NaN,NaN,99.87850000000006,101.30987730876498,98.44712269123514,100.57518906201524,99.84511865242315,100.61349645290669,99.07674085193962,16749,35734.166666666664,54.60892766672436,59.88663711234601,NaN,NaN,NaN,NaN,0.36832750144928134,22.64843923333368,41039888,0.005816433742966365,0.26981245164334666,0.2639960179003803
2025-09-02T14:20:00-04:00,100.61,100.96,100.61,100.69,99.88188425340873,NaN,NaN,NaN,NaN,NaN,99.87990000000008,101.31430927215314,98.44549072784702,100.57518906201524,99.85603325992058,100.62616496784209,99.08590155199907,37078,33951.933333333334,55.95444333140424,60.419052728928804,NaN,NaN,NaN,NaN,0.36701839420290366,22.605671485302008,41076966,-0.00858086473722175,0.25326993697885314,0.2618508017160749
2025-09-02T14:25:00-04:00,100.68,100.87,100.66,100.79,99.88188425340873,NaN,NaN,NaN,NaN,NaN,99.89810000000007,101.35496909502751,98.44123090497263,100.57518906201524,99.86096843074196,100.63195128951664,99.08998557196729,16689,32830.2,57.644580674740304,60.77828659487567,NaN,NaN,NaN,NaN,0.35580279461698255,22.56595857641545,41093655,-0.013160466788414094,0.24540021823055724,0.25856068501897134
2025-09-02T14:30:00-04:00,100.8,101.15,100.75,101,99.88188425340873,NaN,NaN,NaN,NaN,NaN,99.92250000000007,101.41115879235082,98.43384120764932,100.57518906201524,99.87563031849186,100.65185780246333,99.09940283452039,41686,32598.266666666666,61.026715241713745,60.874615967756064,NaN,NaN,NaN,NaN,0.35895973785862706,23.14079587636522,41135341,-0.004296518225493817,0.2531900372371041,0.2574865554625979
2025-09-02T14:35:00-04:00,100.99,101.21,100.86,101.04,99.88188425340873,NaN,NaN,NaN,NaN,NaN,99.93790000000008,101.45625449089925,98.41954550910091,100.57518906201524,99.89890689708344,100.68435752874667,99.1134562654202,64314,33821.433333333334,61.65480004296132,60.80530566842422,NaN,NaN,NaN,NaN,0.3583197565830104,23.797121996329878,41199655,0.0016897143719751817,0.2595986984275669,0.2579089840555917
2025-09-02T14:40:00-04:00,101.01,101.08,100.12,100.76,99.88188425340873,NaN,NaN,NaN,NaN,NaN,99.95250000000007,101.4880575534784,98.41694244652174,100.57518906201524,99.93364761035315,100.71692651975074,99.15036870095555,154856,38219.433333333334,54.97588078891235,60.083635660570906,NaN,NaN,NaN,NaN,0.4012969168270807,22.124884594274647,41044799,-0.014867061474128085,0.23932515721293157,0.25419221868705966
2025-09-02T14:45:00-04:00,100.75,101.14,100.68,101.11,99.88188425340873,NaN,NaN,NaN,NaN,NaN,99.97930000000008,101.54760610533671,98.41099389466345,100.57518906201524,99.94032636019608,100.7255134243877,99.15513929600446,21672,37928.96666666667,60.70596061174725,59.729631674627136,NaN,NaN,NaN,NaN,0.4054899941965745,20.668497226210775,41066471,-0.004446411487851076,0.2486342043272458,0.2530806158150969
2025-09-02T14:50:00-04:00,101.09,101.71,101.06,101.57,100.08072463314852,NaN,NaN,NaN,NaN,NaN,100.02310000000008,101.64347142656588,98.40272857343429,100.4814355774353,99.95824236043819,100.75564604154637,99.16083867933001,40739,38317.1,66.70368012794117,59.67856327593996,NaN,NaN,NaN,NaN,0.4229549946111043,20.563803262438025,41107210,0.02936697597012633,0.2897893357777548,0.26042235980762846
2025-09-02T14:55:00-04:00,101.56,101.57,101.28,101.39,100.14046442255086,NaN,NaN,NaN,NaN,NaN,100.07750000000009,101.69514303850683,98.45985696149334,100.4814355774353,99.96948374995665,100.77395325834165,99.16501424157165,26668,38457.36666666667,62.67246819131104,59.537418435868425,NaN,NaN,NaN,NaN,0.4134582092817391,20.466587438934763,41080542,0.03515968631634708,0.3043719677030623,0.2692122813867152
2025-09-02T15:00:00-04:00,101.4,101.67,101.33,101.55,100.22748876698037,NaN,NaN,NaN,NaN,NaN,100.1255000000001,101.77237370493741,98.4786262950628,100.59771876955861,99.97992245902853,100.79161600198861,99.16822891606844,23448,38289.46666666667,64.71384125853317,59.66980924143326,NaN,NaN,NaN,NaN,0.40821119433304365,20.577763246243876,41103990,0.04470378531209396,0.32509201302683266,0.2803882277147387
2025-09-02T15:05:00-04:00,101.52,101.75,101.46,101.57,100.35078473211762,NaN,NaN,NaN,NaN,NaN,100.1659000000001,101.85293727286195,98.47886272713824,100.74717501564687,99.99227578977904,100.81299513358582,99.17155644597227,26815,37842.46666666667,64.9717147382496,59.83543096957692,NaN,NaN,NaN,NaN,0.3997675375949696,20.843604813665454,41130805,0.04706250269282408,0.33921635608076883,0.29215385338794475
2025-09-02T15:10:00-04:00,101.57,101.71,101.35,101.64,100.35078473211762,NaN,NaN,NaN,NaN,NaN,100.2037000000001,101.9358602812722,98.471539718728,100.74717501564687,100.0072934388413,100.8383008265515,99.1762860511311,33728,37363.566666666666,65.91073015803494,60.012451447510486,NaN,NaN,NaN,NaN,0.39692699919532887,20.722541062307627,41164533,0.04787753244602255,0.35200076894547294,0.3041232364994504
2025-09-02T15:15:00-04:00,101.62,101.72,101.54,101.59,100.41580798938817,NaN,NaN,NaN,NaN,NaN,100.2311000000001,102.00623412451668,98.45596587548351,100.84419201001401,100.01871349103388,100.85771391115111,99.17971307091665,25270,37297.26666666667,64.57904333941124,60.67189637454536,NaN,NaN,NaN,NaN,0.38143221353851914,20.633459328019452,41139263,0.039915041254846184,0.3540170380680081,0.3141019968131619
2025-09-02T15:20:00-04:00,101.55,101.65,101.39,101.45,100.41580798938817,NaN,NaN,NaN,NaN,NaN,100.25170000000011,102.05874356339444,98.44465643660578,100.84419201001401,100.03082613051221,100.8769395255229,99.18471273550152,29427,37238.7,60.87056275342628,61.213810637507926,NaN,NaN,NaN,NaN,0.37275848400005385,20.02785335853561,41109836,0.021033812733619206,0.3403942627301859,0.3193604499965667
2025-09-02T15:25:00-04:00,101.43,101.44,101.22,101.38,100.41580798938817,NaN,NaN,NaN,NaN,NaN,100.2797000000001,102.11224185218609,98.44715814781412,100.84419201001401,100.03888601510509,100.88862909746408,99.18914293274611,22129,36468.23333333333,59.044814667153084,61.530659708967114,NaN,NaN,NaN,NaN,0.36256144942862173,18.908101252733204,41087707,0.000718012537151258,0.3202579656680058,0.31953995313085454
2025-09-02T15:30:00-04:00,101.35,101.65,101.32,101.445,100.41580798938817,NaN,NaN,NaN,NaN,NaN,100.3032000000001,102.1645508642951,98.44184913570511,100.86138630912717,100.05176705316951,100.90842425795891,99.19510984838011,32774,36792.76666666667,60.237450250378686,61.83658877460815,NaN,NaN,NaN,NaN,0.3602356316122925,18.447145528165798,41120481,-0.010818213456932957,0.3060171863096883,0.3168353997666213
2025-09-02T15:35:00-04:00,101.47,101.62,101.31,101.43,100.41580798938817,NaN,NaN,NaN,NaN,NaN,100.32700000000011,102.21475422129043,98.43924577870979,100.86138630912717,100.06245869303474,100.92451097885271,99.20040640721678,28023,36868.566666666666,59.8046411916243,61.99087881152844,NaN,NaN,NaN,NaN,0.3566473722114146,17.98436796192547,41092458,-0.021327580608911823,0.29017592400548153,0.31150350461439336
2025-09-02T15:40:00-04:00,101.4,101.655,101.34,101.42,100.41580798938817,NaN,NaN,NaN,NaN,NaN,100.3578000000001,102.26552341811337,98.45007658188682,100.86878723784139,100.07551817945223,100.94412644200729,99.20690991689717,34362,36537.26666666667,59.497722366872466,61.88166503475406,NaN,NaN,NaN,NaN,0.35367255991059915,17.65552723452661,41058096,-0.03027471595078196,0.2736601096759159,0.3039348256266979
2025-09-02T15:45:00-04:00,101.41,101.5,101,101.06,100.41580798938817,NaN,NaN,NaN,NaN,NaN,100.3920000000001,102.28750098918968,98.49649901081051,100.86878723784139,100.08373418826208,100.95434504805144,99.21312332847273,27621,36491.4,49.62425260501986,61.02234021775824,NaN,NaN,NaN,NaN,0.3641245199169849,16.60257920283201,41030475,-0.06004083117505865,0.22888378665787457,0.2889246178329332
2025-09-02T15:50:00-04:00,100.92,101.02,100.56,100.76,100.41580798938817,NaN,NaN,NaN,NaN,NaN,100.4230000000001,102.29065735615974,98.55534264384046,100.86878723784139,100.09352942263261,100.96187509135075,99.22518375391448,53302,37263.3,43.19183086889245,60.18062236632825,NaN,NaN,NaN,NaN,0.37382991135148597,16.7820447880241,40977173,-0.09732958568441763,0.16726263572741118,0.2645922214118288
2025-09-02T15:55:00-04:00,100.76,100.9,100.72,100.83,100.41580798938817,NaN,NaN,NaN,NaN,NaN,100.4554000000001,102.29373820610364,98.61706179389655,100.86878723784139,100.10334897866645,100.9698301903238,99.23686776700909,52157,36171.13333333333,44.98380825815957,59.05761148392913,NaN,NaN,NaN,NaN,0.3599849176835232,16.948691402845323,41029330,-0.11354427720574237,0.12266187490465086,0.23620615211039322
2025-09-03T09:30:00-04:00,101.605,102.1,100.67,100.84,100.41580798938817,NaN,NaN,NaN,NaN,NaN,100.4962000000001,102.27536672631373,98.71703327368647,100.86878723784139,101.20333333333333,101.20333333333333,101.20333333333333,95500,38008.63333333333,45.249511208622685,57.525170846834946,NaN,NaN,NaN,NaN,0.4364145664204139,17.312038525191912,41124830,-0.11927042284921358,0.08711812354887627,0.20638854639808984
2025-09-03T09:35:00-04:00,100.79,101.54,100.56,100.755,100.41580798938817,NaN,NaN,NaN,NaN,NaN,100.52990000000008,102.26296836565494,98.79683163434522,100.86878723784139,101.06487411015128,101.19007241157176,100.9396758087308,116802,40608.433333333334,43.33377382804924,56.14383553517339,NaN,NaN,NaN,NaN,0.47524209739038464,17.361957278834666,41008028,-0.12391321375979625,0.051497029198344535,0.17541024295814078
2025-09-03T09:40:00-04:00,100.77,100.93,100.11,100.43,NaN,NaN,NaN,101.93383781869188,101.93383781869188,101.93383781869188,100.5565000000001,102.24111419916095,98.87188580083925,100.86878723784139,100.90063514066698,101.18106113716014,100.62020914417381,84913,42643.63333333333,36.900860583187175,54.15719405836297,NaN,NaN,NaN,NaN,0.49986766186250053,16.338951349836904,40923115,-0.14266741217749423,-0.002924022263727011,0.13974338991376722
2025-09-03T09:45:00-04:00,100.41,101.05,100.3,100.82,NaN,NaN,NaN,101.93383781869188,NaN,NaN,100.59950000000012,102.19680178739098,99.00219821260926,100.86878723784139,100.86004326387592,101.11730640013594,100.6027801276159,88249,44774.8,47.057529876729575,52.877609425397246,NaN,NaN,NaN,NaN,0.5177342574437505,15.632465828822564,41011364,-0.12332844384572397,-0.014417164893387735,0.10891127895233624
2025-09-03T09:50:00-04:00,100.79,100.99,100.68,100.85,NaN,NaN,NaN,101.93383781869188,NaN,NaN,100.6375000000001,102.16489942386336,99.11010057613684,100.86878723784139,100.85789807967926,101.10108352549004,100.61471263386848,46200,45201.9,47.75418955864185,51.58071366829775,NaN,NaN,NaN,NaN,0.5028960961977674,14.976443559309253,41057564,-0.10382046576281881,-0.020864303251187266,0.08295616251163154
2025-09-03T09:55:00-04:00,100.87,101.01,100.44,101.01,NaN,NaN,NaN,101.93383781869188,NaN,NaN,100.67770000000012,102.1347768133533,99.22062318664693,100.86878723784139,100.85279133568122,101.07936946958304,100.6262132017794,67225,46869.066666666666,51.42539875317362,50.64116762642363,NaN,NaN,NaN,NaN,0.5076892321836417,14.01932171667459,41124789,-0.07669627195017166,-0.012914177426083029,0.06378209452408863
2025-09-03T10:00:00-04:00,101,101.58,100.94,101.51,NaN,NaN,NaN,101.93383781869188,NaN,NaN,100.72810000000013,102.12110522611849,99.33509477388176,100.70296725261983,100.92719987416999,101.20017296994683,100.65422677839314,89206,48486.46666666667,60.71538149322877,50.630083250695236,NaN,NaN,NaN,NaN,0.5171400013133817,14.078163771394694,41213995,-0.024347464713164034,0.03334776363263359,0.05769522834579762
2025-09-03T10:05:00-04:00,101.54,101.55,100.9,100.99,NaN,NaN,NaN,101.93383781869188,NaN,NaN,100.76410000000011,102.08754503474972,99.4406549652505,100.70296725261983,100.94455875766904,101.21312702784358,100.6759904874945,50511,49087.63333333333,50.00434643073198,49.9843355195223,NaN,NaN,NaN,NaN,0.526630001219568,14.03379985270036,41163484,-0.023971093738365895,0.027731361172840252,0.05170245491120615
2025-09-03T10:10:00-04:00,101,101.26,100.2,100.57,NaN,NaN,NaN,101.93383781869188,NaN,NaN,100.79270000000011,102.03376117496639,99.55163882503383,100.70296725261983,100.91688635641347,101.18395504367777,100.64981766914917,73565,50722.6,43.35203156226468,48.778234184657016,NaN,NaN,NaN,NaN,0.5647278582753134,13.571897745855004,41089919,-0.0497533675744634,-0.010489254556873107,0.039264113017590294
2025-09-03T10:15:00-04:00,100.58,101.61,100.49,101.44,NaN,NaN,NaN,101.93383781869188,NaN,NaN,100.8409000000001,101.98802281818837,99.69377718181184,100.70296725261983,100.94739676872902,101.21225832606979,100.68253521138826,93415,53278.13333333333,56.316094858602526,48.529052303726885,NaN,NaN,NaN,NaN,0.6043901541127913,12.759055055018637,41183334,-0.008141639489652998,0.029087063655524048,0.037228703145177046
2025-09-03T10:20:00-04:00,101.45,101.88,101.32,101.8,NaN,NaN,NaN,101.93383781869188,NaN,NaN,100.88830000000013,101.99339838475659,99.78320161524367,100.04607704747077,101.00357227677753,101.3228251761477,100.68431937740736,68247,54317.1,60.35879544587183,48.59055752365542,NaN,NaN,NaN,NaN,0.6012194288190206,12.493943829652391,41251581,0.04100153571035709,0.08848062278312341,0.04747908707276632
2025-09-03T10:25:00-04:00,101.82,102.26,101.75,102.05,100.36494300608621,100.36494300608621,100.36494300608621,NaN,NaN,NaN,100.94070000000012,102.01219056925355,99.8692094307467,100.51548412691523,101.07479225618788,101.4774068332936,100.67217767908215,65842,55955.53333333333,62.92479112047036,49.540595989044746,NaN,NaN,NaN,NaN,0.594703755331948,12.87165173702855,41317423,0.08517571579098414,0.1539487318114965,0.06877301602051235
2025-09-03T10:30:00-04:00,102.07,102.48,101.95,102.47,100.57721832399139,NaN,NaN,NaN,NaN,NaN,100.99450000000013,102.09714998979567,99.89185001020459,100.81938730153217,101.13491412196682,101.60840260043368,100.66142564349995,48490,56182.333333333336,66.81156933162231,51.22772016495402,NaN,NaN,NaN,NaN,0.5900820585225232,13.554141514631645,41365913,0.13457461264545348,0.2369912818273292,0.10241666918187572
2025-09-03T10:35:00-04:00,102.48,102.49,102.01,102.28,100.6212084001736,NaN,NaN,NaN,NaN,NaN,101.04030000000012,102.16231855600073,99.9182814439995,100.92150984122574,101.16960881333037,101.67469163156944,100.6645259950913,31442,55086.6,63.5650816732394,52.554953980316874,NaN,NaN,NaN,NaN,0.5822190543423422,14.203162386133986,41334471,0.14542319126062628,0.2841956582576586,0.1387724669970323
2025-09-03T10:40:00-04:00,102.28,102.6,102.12,102.58,100.73978983652934,NaN,NaN,NaN,NaN,NaN,101.08940000000011,102.26068756503457,99.91811243496565,101.1052078729806,101.22228934045141,101.7775122207571,100.66706646014572,44353,51403.166666666664,66.3457804391376,54.06183035392508,NaN,NaN,NaN,NaN,0.5749176933178884,14.980628447366309,41378824,0.16247968323143042,0.34187207103632034,0.17939238780488992
2025-09-03T10:45:00-04:00,102.57,102.69,102.23,102.41,100.85070848032348,NaN,NaN,NaN,NaN,NaN,101.13880000000012,102.32031692328415,99.95728307671608,101.26416629838448,101.28025522253637,101.88113529729625,100.67937514777648,53026,52448.3,63.39326865880467,55.494651413264755,NaN,NaN,NaN,NaN,0.5667092866523246,15.84766700430264,41325798,0.15216841947399656,0.3696029121473856,0.21743449267338905
2025-09-03T10:50:00-04:00,102.45,102.65,102.06,102.27,100.85070848032348,NaN,NaN,NaN,NaN,NaN,101.19240000000012,102.33036175682778,100.05443824317246,101.26416629838448,101.31343731235722,101.93249198393161,100.69438264078283,36580,52309.666666666664,60.98627877900858,57.215038427252004,NaN,NaN,NaN,NaN,0.5683729090343016,16.178079994782298,41289218,0.12681181741841246,0.37594926444640464,0.24913744702799218
2025-09-03T10:55:00-04:00,102.3,102.45,102.12,102.31,100.85070848032348,NaN,NaN,NaN,NaN,NaN,101.24120000000012,102.35719921147307,100.12520078852717,101.26416629838448,101.33308730867991,101.96111006073262,100.70506455662719,23606,52207.6,61.436805711784565,58.242129558327356,NaN,NaN,NaN,NaN,0.5513462726747085,16.484892057370555,41312824,0.10455247347762114,0.3798280388750186,0.27527556539739745
2025-09-03T11:00:00-04:00,102.28,102.33,101.86,101.91,100.85070848032348,NaN,NaN,NaN,NaN,NaN,101.27060000000012,102.37804144766335,100.16315855233688,101.26416629838448,101.352219922401,101.9820354822533,100.72240436254872,33067,52528.23333333333,54.6414766398847,58.734078635558994,NaN,NaN,NaN,NaN,0.545535824626515,16.039533518127595,41279757,0.05708323419489403,0.34662960814101496,0.2895463739461209
2025-09-03T11:05:00-04:00,101.91,102.3,101.85,102.16,100.85070848032348,NaN,NaN,NaN,NaN,NaN,101.29940000000012,102.42284940251314,100.1759505974871,101.26416629838448,101.37478014343554,102.00817557136584,100.74138471550525,37476,52883.6,57.78430396442951,59.1882861506487,NaN,NaN,NaN,NaN,0.5387118371531926,15.598402824334947,41317233,0.03765271411508797,0.3366122665899809,0.2989595524748929
2025-09-03T11:10:00-04:00,102.17,102.3,101.73,101.75,100.85070848032348,NaN,NaN,NaN,NaN,NaN,101.31500000000011,102.44137826683712,100.1886217331631,101.26416629838448,101.38784860238748,102.0193003200004,100.75639688477456,30262,52768.066666666666,51.483988073064985,58.52890090635129,NaN,NaN,NaN,NaN,0.5409467059279641,14.84894921207554,41286971,-0.005390576270083991,0.29222133213728796,0.29761190840737195
2025-09-03T11:15:00-04:00,101.74,101.89,101.61,101.69,100.85070848032348,NaN,NaN,NaN,NaN,NaN,101.32820000000012,102.45637686556844,100.2000231344318,101.26416629838448,101.39954230904877,102.02321538866447,100.77586922943307,45223,53433.166666666664,50.61427197223766,58.57246701645884,NaN,NaN,NaN,NaN,0.5223076555045382,13.818504202455248,41241748,-0.038629024669714074,0.24932562757022936,0.28795465223994343
2025-09-03T11:20:00-04:00,101.685,101.74,101.31,101.55,100.85070848032348,NaN,NaN,NaN,NaN,NaN,101.33500000000012,102.4643431719386,100.20565682806165,101.26416629838448,101.40282061262951,102.01915252050277,100.78648870475625,33237,53560.166666666664,48.55323870298894,58.943981812224855,NaN,NaN,NaN,NaN,0.5157142515399278,13.569611032581296,41208511,-0.06899694341946977,0.20170847296560623,0.270705416385076
2025-09-03T11:25:00-04:00,101.53,101.61,101.22,101.27,100.85070848032348,NaN,NaN,NaN,NaN,NaN,101.33900000000013,102.4659747113399,100.21202528866036,101.26416629838448,101.40245448610074,102.0156683782826,100.78924059391888,13877,53285.1,44.63822237017623,58.10984806305155,NaN,NaN,NaN,NaN,0.5067346621442187,13.552725049927549,41194634,-0.10475094825838399,0.13976673106209603,0.24451767932048002
2025-09-03T11:30:00-04:00,101.23,101.44,101.11,101.42,100.85070848032348,NaN,NaN,NaN,NaN,NaN,101.34780000000012,102.47028681061705,100.22531318938319,101.26416629838448,101.40153409711091,102.01122993190204,100.79183826231979,16128,52730.23333333333,47.099134258581515,57.162729406816524,NaN,NaN,NaN,NaN,0.4941107577053458,13.798097049879699,41210762,-0.1143262194561992,0.10160990500023104,0.21593612445643023
2025-09-03T11:35:00-04:00,101.45,101.76,101.45,101.7,100.85070848032348,NaN,NaN,NaN,NaN,NaN,101.36240000000012,102.48384057354671,100.24095942645353,101.2143330387076,101.40688970697587,102.01062205033466,100.80315736361709,32315,52873.3,51.43853054755927,56.34228222303716,NaN,NaN,NaN,NaN,0.48310284644067847,13.050801340519055,41243077,-0.09843434715929508,0.09289319050731137,0.19132753766660646
2025-09-03T11:40:00-04:00,101.73,101.91,101.52,101.82,100.85070848032348,NaN,NaN,NaN,NaN,NaN,101.37820000000012,102.5027190260766,100.25368097392364,101.13646643096607,101.41909674086308,102.01538888404897,100.82280459767719,52338,53472.5,53.209975669937975,55.37073981863114,NaN,NaN,NaN,NaN,0.4764526431234872,12.290943483147306,41295415,-0.0773997153287701,0.09457789350564383,0.17197760883441393
2025-09-03T11:45:00-04:00,101.8,101.95,101.615,101.74,100.85070848032348,NaN,NaN,NaN,NaN,NaN,101.40020000000011,102.50902092332908,100.29137907667115,101.04633851581828,101.42609370506979,102.0184071508565,100.83378025928307,30076,53554.333333333336,51.851991374780326,54.534090511598336,NaN,NaN,NaN,NaN,0.4663488829003815,11.694972796109933,41265339,-0.06683149476895373,0.08843824037322179,0.1552697351421755
2025-09-03T11:50:00-04:00,101.72,101.83,101.55,101.69,100.85070848032348,NaN,NaN,NaN,NaN,NaN,101.42340000000013,102.50666809239314,100.34013190760712,101.04633851581828,101.42849885828925,102.01864017541827,100.83835754116022,13807,52237.833333333336,50.97633245820322,53.43627279867446,NaN,NaN,NaN,NaN,0.4530382484074972,10.942721551201696,41251532,-0.06131056920069561,0.07863152364130599,0.1399420928420016
2025-09-03T11:55:00-04:00,101.67,101.67,101.33,101.39,100.85070848032348,NaN,NaN,NaN,NaN,NaN,101.43900000000012,102.49713798722229,100.38086201277795,101.01207081265463,101.42867460234064,102.01733054440986,100.84001866027141,7682,50755.333333333336,45.96104987043362,52.19111431379081,NaN,NaN,NaN,NaN,0.44639265923553306,10.720649795157888,41243850,-0.07505728315735172,0.04612048889531195,0.12117777205266367
2025-09-03T12:00:00-04:00,101.37,101.52,101.24,101.43,100.85070848032348,NaN,NaN,NaN,NaN,NaN,101.45380000000011,102.49009447552459,100.41750552447564,100.97609831289003,101.4284585032061,102.01512980233775,100.84178720407445,10350,47917,46.71382419056581,51.17165327175918,NaN,NaN,NaN,NaN,0.4345074692901379,10.762661756758371,41254200,-0.07829087840218758,0.023314174049929193,0.10160505245211678
2025-09-03T12:05:00-04:00,101.44,101.85,101.395,101.64,100.85070848032348,NaN,NaN,NaN,NaN,NaN,101.47080000000011,102.49073795890004,100.45086204110018,100.97609831289003,101.43027537916223,102.01458215721257,100.84596860111188,14063,44492.36666666667,50.60420287789212,50.39789592648116,NaN,NaN,NaN,NaN,0.4359712214836993,10.216457433298414,41268263,-0.06373810050792074,0.021932426817215855,0.0856705273251366
2025-09-03T12:10:00-04:00,101.64,101.68,101.38,101.42,100.85070848032348,NaN,NaN,NaN,NaN,NaN,101.4792000000001,102.49037033185095,100.46802966814926,100.97609831289003,101.4307482845906,102.01288534564381,100.8486112235374,11690,42051.6,46.75317631045439,49.834445902950414,NaN,NaN,NaN,NaN,0.4262589913777216,9.662838882914086,41256573,-0.06609637259156341,0.0030500615856823288,0.06914643417724574
2025-09-03T12:15:00-04:00,101.44,101.58,101.25,101.31,100.85070848032348,NaN,NaN,NaN,NaN,NaN,101.48460000000011,102.4891931315726,100.48000686842762,100.97609831289003,101.43033389518254,102.01010732795075,100.85056046241434,12833,39537.73333333333,44.91276698113462,48.91505040414364,NaN,NaN,NaN,NaN,0.41938334913645564,9.203185365158951,41243740,-0.07175994863737614,-0.020553501619474446,0.051206447017901696
2025-09-03T12:20:00-04:00,101.28,101.51,101.24,101.24,100.85070848032348,NaN,NaN,NaN,NaN,NaN,101.4942000000001,102.47990859791862,100.50849140208159,100.97609831289003,101.42974605456867,102.00786930492082,100.85162280421652,9262,38306.46666666667,43.732983134136965,48.36140719422021,NaN,NaN,NaN,NaN,0.4087131099124238,8.808035795358679,41234478,-0.07648206916618198,-0.04439613943982579,0.0320859297263562
2025-09-03T12:25:00-04:00,101.25,101.25,100.98,101.09,100.85070848032348,NaN,NaN,NaN,NaN,NaN,101.49380000000012,102.48014793049894,100.5074520695013,100.97609831289003,101.42406943561461,101.9986612817559,100.84947758947332,28273,37008.066666666666,41.23344288152562,47.69134797345507,NaN,NaN,NaN,NaN,0.39880503063296474,9.223478842037093,41206205,-0.08529765725393718,-0.07453614184106527,0.010761515412871903
2025-09-03T12:30:00-04:00,101.1,101.12,100.9,101.06,100.85070848032348,NaN,NaN,NaN,NaN,NaN,101.48360000000011,102.47710700048424,100.49009299951598,100.97609831289003,101.42042071674663,101.99362329079364,100.84721814269963,14911,34531.566666666666,40.73202283826977,47.1326896974037,NaN,NaN,NaN,NaN,0.38603324273061007,9.830672919466863,41191294,-0.08836429353643065,-0.09969385150766641,-0.011329557971235762
2025-09-03T12:35:00-04:00,101.05,101.19,100.9,100.9,100.85070848032348,NaN,NaN,NaN,NaN,NaN,101.47380000000013,102.48038742292846,100.46721257707179,100.92470986895975,101.41550949889992,101.98718271508241,100.84383628271743,19043,33482.63333333333,38.072825250955155,46.663732760316485,NaN,NaN,NaN,NaN,0.37917372539270877,10.116306426510258,41172251,-0.09576173625885186,-0.1310317282948006,-0.03526999203594873
2025-09-03T12:40:00-04:00,100.92,101,100.62,100.91,NaN,NaN,NaN,102.04388059831763,102.04388059831763,102.04388059831763,101.46100000000013,102.47959118393678,100.44240881606348,100.92470986895975,101.40882003065222,101.98045998996474,100.8371800713397,19437,31678.366666666665,38.343754818122655,46.03834851456942,NaN,NaN,NaN,NaN,0.37923274500751497,11.149284065884538,41191688,-0.09441859516841847,-0.15329323599647182,-0.058874640828053354
2025-09-03T12:45:00-04:00,100.9,100.95,100.7,100.72,NaN,NaN,NaN,102.03688602566683,NaN,NaN,101.44400000000013,102.48291674353256,100.4050832564677,100.92470986895975,101.40329363643463,101.97534546484901,100.83124180802024,14981,29063.9,35.19329895813702,44.877974829610686,NaN,NaN,NaN,NaN,0.3700018346498353,12.108477588160655,41176707,-0.10021576883893728,-0.18414435187672495,-0.08392858303778768
2025-09-03T12:50:00-04:00,100.73,100.79,100.59,100.7,NaN,NaN,NaN,101.87407302450015,NaN,NaN,101.42520000000013,102.48309594951077,100.3673040504895,100.92470986895975,101.39825268417836,101.97137852017606,100.82512684818066,11996,27188.866666666665,34.86853076693605,43.567871622253406,NaN,NaN,NaN,NaN,0.35785884646056154,13.288862082592196,41164711,-0.09910704118981459,-0.2078123845250559,-0.10870534333524132
2025-09-03T12:55:00-04:00,100.72,100.82,100.6,100.73,NaN,NaN,NaN,101.8702515233865,NaN,NaN,101.40800000000014,102.4824542800828,100.33354571991748,100.7897678951678,101.39063656057338,101.96503699829252,100.81623612285425,19092,25630.533333333333,35.825182998943106,42.42309959540789,NaN,NaN,NaN,NaN,0.3480117859990928,14.242070187136763,41183803,-0.09031118153348269,-0.2215943202520947,-0.131283138718612
2025-09-03T13:00:00-04:00,100.71,100.96,100.68,100.91,NaN,NaN,NaN,101.8702515233865,NaN,NaN,101.39720000000014,102.48056726920294,100.31383273079734,100.70281431613424,101.38567264296174,101.95975064561242,100.81159464031106,15833,24541.966666666667,41.38789372481152,41.73821111445134,NaN,NaN,NaN,NaN,0.343153801284871,14.471605267973434,41199636,-0.06737978293373564,-0.21550786738578154,-0.1481280844520459
2025-09-03T13:05:00-04:00,100.91,100.98,100.62,100.64,NaN,NaN,NaN,101.8702515233865,NaN,NaN,101.38240000000015,102.48632615694113,100.27847384305916,100.6732514529074,101.38185471643332,101.95632975458068,100.80737967828597,10365,23839.4,36.304453888621666,41.04845425860763,NaN,NaN,NaN,NaN,0.34435710119309443,14.875592358584576,41189271,-0.06535498074521881,-0.2298218103835694,-0.1644668296383506
2025-09-03T13:10:00-04:00,100.68,100.91,100.64,100.81,NaN,NaN,NaN,101.8702515233865,NaN,NaN,101.36970000000014,102.48500517796545,100.25439482203483,100.44560116232591,101.37640433369772,101.9510465890798,100.80176207831565,16033,22895.4,41.201356950164836,40.65470659857898,NaN,NaN,NaN,NaN,0.3390458796793017,15.250723228437781,41205304,-0.04831144233488044,-0.22485613255695114,-0.1765446902220707
2025-09-03T13:15:00-04:00,100.8,100.99,100.76,100.79,NaN,NaN,NaN,101.8702515233865,NaN,NaN,101.35690000000014,102.48377335578981,100.23002664421047,100.44218474388859,101.37279408956172,101.94713084837973,100.79845733074372,12014,21528.333333333332,40.803909264738536,39.95468562621087,NaN,NaN,NaN,NaN,0.3312568882736366,15.1900459464366,41193290,-0.034763146044442333,-0.2199986227776236,-0.18523547673318128
2025-09-03T13:20:00-04:00,100.75,100.85,100.61,100.61,NaN,NaN,NaN,101.82007264913643,NaN,NaN,101.34070000000013,102.48660751808205,100.1947924819182,100.44218474388859,101.36791289337805,101.9430768678555,100.7927489189006,12693,20732.1,37.31507775311047,39.280535729257736,NaN,NaN,NaN,NaN,0.32473853911123357,15.67053442587937,41180597,-0.03424741784881616,-0.22804474904420147,-0.1937973311953853
2025-09-03T13:25:00-04:00,100.605,100.65,100.44,100.47,NaN,NaN,NaN,101.61416025599388,NaN,NaN,101.32890000000015,102.49804206150606,100.15975793849424,100.30421953120124,101.35885875281545,101.93754369782013,100.78017380781077,19164,20584.033333333333,34.821269609254585,38.559714488409156,NaN,NaN,NaN,NaN,0.31654292917471744,16.656534698430384,41161433,-0.03929652283091978,-0.24291798473403503,-0.20362146190311525
2025-09-03T13:30:00-04:00,100.51,100.66,100.38,100.38,NaN,NaN,NaN,101.57874388072142,NaN,NaN,101.32130000000012,102.50991399958282,100.13268600041742,100.30421953120124,101.34884450892388,101.931816887342,100.76587213050576,20528,20166.066666666666,33.28141530392112,37.813173929108025,NaN,NaN,NaN,NaN,0.31393271994795197,17.750855710274173,41140905,-0.04428842709839645,-0.2589819957761108,-0.21469356867771436
2025-09-03T13:35:00-04:00,100.37,100.55,100.25,100.31,NaN,NaN,NaN,101.45152824977956,NaN,NaN,101.31090000000013,102.52534586540398,100.09645413459629,100.30421953120124,101.33795197572373,101.92669498711663,100.74920896433082,20427,19597.766666666666,32.09269037635886,37.16026303588183,NaN,NaN,NaN,NaN,0.3129375256659552,19.138533064928378,41120478,-0.047605499635337556,-0.2742004432218863,-0.22659494358654875
2025-09-03T13:40:00-04:00,100.32,100.39,100.04,100.08,NaN,NaN,NaN,101.26645878388048,NaN,NaN,101.29570000000012,102.5516554291451,100.03974457085515,100.30421953120124,101.31915505513466,101.92135142141072,100.7169586888586,30026,19589.9,28.49177018926045,36.28595927523831,NaN,NaN,NaN,NaN,0.31558484526124364,20.95390964775493,41090452,-0.05980125731442679,-0.3013465152295822,-0.24154525791515544
2025-09-03T13:45:00-04:00,100.1,100.18,99.88,100.089,NaN,NaN,NaN,101.07457429370409,NaN,NaN,101.28238000000012,102.57459353591537,99.99016646408487,100.30421953120124,101.26907414125301,101.90892057058012,100.6292277119259,76623,20636.566666666666,28.828292692068544,35.62563552103212,NaN,NaN,NaN,NaN,0.3144716420282985,22.987607082071488,41167075,-0.06153396024743141,-0.31846270822444467,-0.25692874797701326
2025-09-03T13:50:00-04:00,100.05,100.45,100.01,100.41,NaN,NaN,NaN,101.07457429370409,NaN,NaN,101.28198000000012,102.57526063404747,99.98869936595277,100.30421953120124,101.24258867271116,101.89340217469656,100.59177517072577,54003,21328.766666666666,39.72387857786706,35.7242157895853,NaN,NaN,NaN,NaN,0.3234379533119913,23.40640010651809,41221078,-0.03656643256418929,-0.30263678868224986,-0.26607035611806057
2025-09-03T13:55:00-04:00,100.43,100.49,100.08,100.3,NaN,NaN,NaN,101.07457429370409,NaN,NaN,101.2715800000001,102.58771483139878,99.95544516860141,100.30421953120124,101.2359575402072,101.88932001469045,100.58259506572394,13994,21332.666666666668,37.59965881701412,35.89609863664795,NaN,NaN,NaN,NaN,0.3296209566468488,23.59743840306187,41207084,-0.023594627467119156,-0.2955636404519595,-0.27196901298484033
2025-09-03T14:00:00-04:00,100.28,100.42,100.1,100.25,NaN,NaN,NaN,101.07457429370409,NaN,NaN,101.25958000000011,102.60155860430488,99.91760139569534,100.30421953120124,101.22238991198097,101.88123043475136,100.56354938921058,28243,21736.5,36.64054160230604,36.02267083917438,NaN,NaN,NaN,NaN,0.3289337454577887,23.77483110699537,41178841,-0.01493867559162243,-0.2906423574743684,-0.27570368188274597
2025-09-03T14:05:00-04:00,100.26,100.42,100.07,100.34,NaN,NaN,NaN,101.07457429370409,NaN,NaN,101.24618000000011,102.61104457584868,99.88131542415154,100.18137562496099,101.2177558761578,101.87828969979803,100.55722205251756,10038,20993.933333333334,39.62589452193355,36.2941502336737,NaN,NaN,NaN,NaN,0.3304384779250901,24.03646346700396,41188879,-0.00047305500607980333,-0.27629500064034573,-0.27582194563426593
2025-09-03T14:10:00-04:00,100.36,100.43,100.31,100.42,NaN,NaN,NaN,101.07457429370409,NaN,NaN,101.22438000000011,102.60640465332791,99.8423553466723,100.0101004999688,101.21517035983041,101.87629795606976,100.55404276359106,6393,19462.433333333334,42.231493206052555,36.35440733947662,NaN,NaN,NaN,NaN,0.31540715807329833,24.219824595225198,41195272,0.01623854319037954,-0.2555237666462915,-0.27176230983667105
2025-09-03T14:15:00-04:00,100.42,100.42,100.12,100.12,NaN,NaN,NaN,101.07457429370409,NaN,NaN,101.20698000000012,102.62188593270336,99.79207406729687,100.00808039997503,101.20894257145744,101.87265433934749,100.54523080356739,12941,18891.266666666666,35.96342377204404,36.33004804543536,NaN,NaN,NaN,NaN,0.31430664678234826,25.009317898055023,41182331,0.009194103874128445,-0.2602696799940105,-0.26946378386813896
2025-09-03T14:20:00-04:00,100.16,100.29,100.08,100.12,NaN,NaN,NaN,101.07457429370409,NaN,NaN,101.19798000000013,102.63453746783412,99.76142253216614,99.87846431998003,101.2022695741685,101.86907899797433,100.53546015036267,13282,18873.766666666666,35.96342377204404,35.95590996128387,NaN,NaN,NaN,NaN,0.3068561720121811,25.86299948917591,41182331,0.006753465547972293,-0.26102195193317357,-0.26777541748114586
2025-09-03T14:25:00-04:00,100.13,100.27,99.97,100.04,NaN,NaN,NaN,101.07457429370409,NaN,NaN,101.16998000000012,102.64074472571151,99.69921527428873,99.69666956055748,101.19317412837643,101.86473311689608,100.52161513985678,17211,19191.4,34.385066453372374,35.497421189043436,NaN,NaN,NaN,NaN,0.3063664454398823,26.978557729655208,41165120,0.002205537166491134,-0.26501849602303196,-0.2672240331895231
2025-09-03T14:30:00-04:00,100.03,100.03,99.68,99.78,NaN,NaN,NaN,100.85819468165488,NaN,NaN,101.12958000000013,102.63935805467884,99.61980194532143,99.69666956055748,101.176847532856,101.8606453331682,100.49304973254381,25437,19694.3,29.806556635245727,34.9610982520531,NaN,NaN,NaN,NaN,0.3101974136227478,28.72142226825457,41139683,-0.014916996228326485,-0.2858702784749312,-0.2709532822466047
2025-09-03T14:35:00-04:00,99.78,99.79,99.43,99.43,NaN,NaN,NaN,100.61668583248877,NaN,NaN,101.07718000000014,102.63658971857669,99.5177702814236,99.69666956055748,101.15852905753158,101.8597995030066,100.45725861205656,24187,20031.766666666666,24.983829702032892,34.258423972965836,NaN,NaN,NaN,NaN,0.3137547412211229,30.811126634554896,41115496,-0.04473304783250892,-0.32686959203724086,-0.28213654420473194
2025-09-03T14:40:00-04:00,99.45,100.01,99.41,100,NaN,NaN,NaN,100.61668583248877,NaN,NaN,101.02778000000013,102.56388766757713,99.49167233242314,99.69666956055748,101.12432495184422,101.84848432520457,100.40016557848386,55759,21500.733333333334,41.56589902057168,34.85017280986944,NaN,NaN,NaN,NaN,0.3342008311339004,31.465645509981073,41171255,-0.022127937665402775,-0.3097964662864854,-0.2876685286210826
2025-09-03T14:45:00-04:00,99.99,100.17,99.98,100.07,NaN,NaN,NaN,100.61668583248877,NaN,NaN,100.98358000000013,102.50007438323846,99.4670856167618,99.69666956055748,101.11491295539551,101.84259001012329,100.38723590066773,19914,21736.766666666666,43.22565349878239,35.645384461471124,NaN,NaN,NaN,NaN,0.32390077176719306,31.254154718006927,41191169,0.0002903460422655213,-0.2873055960682507,-0.2875959421105162
2025-09-03T14:50:00-04:00,100.1,100.16,99.99,100.11,NaN,NaN,NaN,100.61668583248877,NaN,NaN,100.93418000000013,102.39949927933603,99.46886072066422,99.69666956055748,101.10972016409352,101.83920784604919,100.38023248213784,11287,21804.266666666666,44.20098146485479,36.76747098115643,NaN,NaN,NaN,NaN,0.31290785949810795,31.057770411173795,41202456,0.019501135396298885,-0.2632195228651426,-0.2827206582614415
2025-09-03T14:55:00-04:00,100.13,100.2,100.04,100.09,NaN,NaN,NaN,100.61668583248877,NaN,NaN,100.88778000000013,102.30951006101263,99.46604993898764,99.69666956055748,101.10511721723311,101.83606358701522,100.37417084745101,10338,21206.433333333334,43.795859052316544,37.83658286403129,NaN,NaN,NaN,NaN,0.3019858695339571,30.662401781061106,41192118,0.03182096124538869,-0.24294445670470566,-0.27476541795009435
2025-09-03T15:00:00-04:00,100.06,100.17,99.98,99.99,NaN,NaN,NaN,100.61668583248877,NaN,NaN,100.84218000000011,102.22949289563897,99.45486710436126,99.68333564844598,101.09959214912077,101.83260725636435,100.36657704187718,11782,21102.133333333335,41.73607970961514,37.98031151629901,NaN,NaN,NaN,NaN,0.29398687885296,30.487495195363685,41180336,0.033997899528368625,-0.2322680435396336,-0.2662659430680022
2025-09-03T15:05:00-04:00,99.99,100.22,99.98,100.12,NaN,NaN,NaN,100.61668583248877,NaN,NaN,100.79838000000012,102.13491551483038,99.46184448516986,99.59566851875678,101.08923927172226,101.82536511069497,100.35311343274955,23782,21260.1,45.335410610171,38.53286521581022,NaN,NaN,NaN,NaN,0.2901306732206053,30.03743759702618,41204118,0.0443039282712413,-0.21088603272895057,-0.25518996100019187
2025-09-03T15:10:00-04:00,100.16,100.16,99.92,99.95,NaN,NaN,NaN,100.61668583248877,NaN,NaN,100.75918000000013,102.07785531651982,99.44050468348044,99.58877192610866,101.08214145021665,101.82101040663132,100.34327249380199,15100,21115.533333333333,41.706962735566066,38.8947524396145,NaN,NaN,NaN,NaN,0.2865499108477046,29.83075583180183,41189018,0.03991857761153089,-0.20529173898577824,-0.24521031659730913
2025-09-03T15:15:00-04:00,99.93,100.08,99.84,100.04,NaN,NaN,NaN,100.61668583248877,NaN,NaN,100.71678000000014,101.98804213126407,99.44551786873622,99.58877192610866,101.07221637246187,101.81501874211004,100.32941400281369,20992,21315.9,44.25086117810692,39.22510720076975,NaN,NaN,NaN,NaN,0.28322491721572535,29.914850013548005,41210010,0.04305645236916056,-0.19138975113585843,-0.234446203505019
2025-09-03T15:20:00-04:00,100.03,100.07,99.9,100.035,NaN,NaN,NaN,100.61668583248877,NaN,NaN,100.68248000000013,101.9327535214357,99.43220647856455,99.58877192610866,101.06382538369353,101.80970959274278,100.31794117464428,18304,21526.166666666668,44.13562613841539,39.36111669593852,NaN,NaN,NaN,NaN,0.27513742312888695,29.992937468026604,41191706,0.044584434062315215,-0.178715660927125,-0.2233000949894402
2025-09-03T15:25:00-04:00,100.05,100.16,100.02,100.1,NaN,NaN,NaN,100.61668583248877,NaN,NaN,100.65068000000012,101.87749450529341,99.42386549470683,99.62520898093412,101.05590686070687,101.80385475310317,100.30795896831057,19211,21530.133333333335,46.10067865422105,40.085206330379734,NaN,NaN,NaN,NaN,0.26548475004825217,29.459794006953683,41210917,0.04938888616976542,-0.16156398727723342,-0.21095287344699884
2025-09-03T15:30:00-04:00,100.13,100.31,100.05,100.25,NaN,NaN,NaN,100.61668583248877,NaN,NaN,100.62468000000011,101.82905173265014,99.42030826735008,99.7521671847473,101.0462936202187,101.79544099556783,100.29714624486958,26851,21897.4,50.43367691796127,41.1187958408024,NaN,NaN,NaN,NaN,0.2650929821876631,28.053837076661175,41237768,0.06130704330123524,-0.1343190693204548,-0.19562611262169002
2025-09-03T15:35:00-04:00,100.3,100.33,100.06,100.135,NaN,NaN,NaN,100.61668583248877,NaN,NaN,100.60198000000011,101.79961015927557,99.40434984072465,99.7521671847473,101.03670980327662,101.78724766725153,100.28617193930171,26485,22434.733333333334,47.29455877573469,42.04090243525685,NaN,NaN,NaN,NaN,0.26544348345997254,26.632848752555898,41211283,0.06000775137124029,-0.12061642340763967,-0.18062417477887996
2025-09-03T15:40:00-04:00,100.14,100.31,100.1,100.25,NaN,NaN,NaN,100.61668583248877,NaN,NaN,100.57858000000012,101.75692902062086,99.40023097937937,99.7521671847473,101.02335574573559,101.7749038050421,100.27180768642907,40025,23234.466666666667,50.60549167375559,43.526540652293264,NaN,NaN,NaN,NaN,0.26148323464140366,25.31335959445814,41251308,0.06503342233836149,-0.0993323968559281,-0.16436581919428958
2025-09-03T15:45:00-04:00,100.27,100.46,100.23,100.44,NaN,NaN,NaN,100.61668583248877,NaN,NaN,100.5533800000001,101.68779437861659,99.41896562138362,99.88898959859061,101.01701104549016,101.76757467112687,100.26644741985346,24254,23642.466666666667,55.5713928008847,45.711366587925546,NaN,NaN,NaN,NaN,0.25923443216701697,23.799546732749594,41275562,0.0783981039998041,-0.06636818919453447,-0.14476629319433856
2025-09-03T15:50:00-04:00,100.46,100.75,100.4,100.7,99.7089692155087,99.7089692155087,99.7089692155087,NaN,NaN,NaN,100.53098000000011,101.60720610933043,99.45475389066979,100.11819167887249,101.00947929385741,101.75493619876734,100.26402238894748,47400,24799.366666666665,61.30443368554037,47.121261921137595,NaN,NaN,NaN,NaN,0.26571768701222964,23.70325113801904,41322962,0.10057746864407717,-0.019044457389242098,-0.11962192603331927
2025-09-03T15:55:00-04:00,100.69,100.84,100.64,100.81,99.88606152389468,NaN,NaN,NaN,NaN,NaN,100.51238000000012,101.53520384719643,99.48955615280381,100.234553343098,101.00575091755074,101.74615117048478,100.2653506646167,38750,25452.233333333334,63.45313705738921,48.56608217532379,NaN,NaN,NaN,NaN,0.26102356651135633,23.946526041602258,41361712,0.11731714090046907,0.02702450009226709,-0.09029264080820198
2025-09-04T09:30:00-04:00,100.6,102.5,100.54,102.25,100.43760418189947,NaN,NaN,NaN,NaN,NaN,100.52358000000011,101.60813964077923,99.43902035922099,101.0356426744784,101.76333333333334,101.76333333333334,101.76333333333334,176361,30646.666666666668,79.50069361892638,51.08749018632891,NaN,NaN,NaN,NaN,0.382379026046259,27.00479494648237,41538073,0.21437990145439095,0.17768223600978672,-0.03669766544460424
2025-09-04T09:35:00-04:00,102.27,102.31,101.215,101.77,100.57998580999494,NaN,NaN,NaN,NaN,NaN,100.53118000000012,101.64485361035058,99.41750638964966,101.0356426744784,101.76383256281326,101.76459599086802,101.76306913475851,75417,32479.666666666668,68.67574984597472,52.86462524301878,NaN,NaN,NaN,NaN,0.43328052418581187,29.84461607244247,41462656,0.23368089764961558,0.25540345661741526,0.021722558967799663
2025-09-04T09:40:00-04:00,101.76,102.19,101.33,102.18,100.57998580999494,NaN,NaN,NaN,NaN,NaN,100.5461800000001,101.72610682417643,99.36625317582379,101.0356426744784,101.79526784868747,101.85265019259481,101.73788550478014,75571,33997.833333333336,72.16243889354719,55.037936613299635,NaN,NaN,NaN,NaN,0.4637604867439681,32.48159283226257,41538227,0.25949565108978373,0.3460921228300293,0.0865964717402456
2025-09-04T09:45:00-04:00,102.2,102.38,101.38,101.67,100.57998580999494,NaN,NaN,NaN,NaN,NaN,100.54678000000011,101.72895943071492,99.3646005692853,101.0356426744784,101.79870394964911,101.84933552515257,101.74807237414565,99575,34762.9,62.79860814982489,56.285307866132065,NaN,NaN,NaN,NaN,0.5020633091193989,35.10152378972174,41438652,0.22873615555479715,0.372516666183742,0.14378051062894487
2025-09-04T09:50:00-04:00,101.72,102.11,101.52,102.01,100.57998580999494,NaN,NaN,NaN,NaN,NaN,100.5585800000001,101.78628974354817,99.33087025645204,101.0356426744784,101.80831527475137,101.86262422463605,101.75400632486668,57241,34870.833333333336,65.96898360323696,58.01830935667996,NaN,NaN,NaN,NaN,0.5083445013251564,37.53431682164811,41495893,0.21785315864905078,0.41609695894025833,0.19824380029120756
2025-09-04T09:55:00-04:00,102,102.58,101.68,102.48,100.72249794162636,NaN,NaN,NaN,NaN,NaN,100.58198000000012,101.90684180351126,99.25711819648897,101.0356426744784,101.87088955796983,102.032266173688,101.70951294225166,80623,37091.8,69.80037627390121,59.84327472066526,NaN,NaN,NaN,NaN,0.5363198940876447,40.17113629085575,41576516,0.2277986355740052,0.4829920947587141,0.25519345918470887
2025-09-04T10:00:00-04:00,102.48,103.15,102.33,102.79,101.2846571260979,NaN,NaN,NaN,NaN,NaN,100.61298000000012,102.06446329594165,99.16149670405859,101.19579471325846,102.08401905275396,102.48792165871394,101.68011644679397,178954,42115.5,72.03662377816656,61.83620312350463,NaN,NaN,NaN,NaN,0.5565827587956707,42.95359809975043,41755470,0.2395476126667072,0.5546279750180929,0.3150803623513857
2025-09-04T10:05:00-04:00,102.79,103.05,102.44,102.76,101.2846571260979,NaN,NaN,NaN,NaN,NaN,100.64638000000012,102.21255791530895,99.0802020846913,101.19579471325846,102.1663177603977,102.6033691165617,101.72926640423371,104867,45276.46666666667,71.48495648271115,63.64936582553964,NaN,NaN,NaN,NaN,0.5603982760245513,45.5373126365812,41650603,0.2295671047687013,0.6020392433122623,0.37247213854356104
2025-09-04T10:10:00-04:00,102.79,103.38,102.5,102.53,101.41455329051482,NaN,NaN,NaN,NaN,NaN,100.67578000000012,102.3249043877892,99.02665561221103,101.44530861648542,102.22878058264054,102.6850394230429,101.77252174223818,92257,48138.6,67.23383940803208,64.84937743197327,NaN,NaN,NaN,NaN,0.5832269705942259,48.09964027928708,41558346,0.1932034087326739,0.6139763994594034,0.4207729907267295
2025-09-04T10:15:00-04:00,102.55,102.71,101.85,102.13,101.41455329051482,NaN,NaN,NaN,NaN,NaN,100.70038000000014,102.39812824469942,99.00263175530085,101.44530861648542,102.22886067604891,102.66988122069321,101.78784013140461,66142,49911.96666666667,60.495842932349014,65.79232630030286,NaN,NaN,NaN,NaN,0.6029964726946383,48.0377584156498,41492204,0.1309201340348657,0.5844231582703117,0.453503024235446
2025-09-04T10:20:00-04:00,102.14,102.28,101.76,102.15,101.41455329051482,NaN,NaN,NaN,NaN,NaN,100.72518000000015,102.47002542306025,98.98033457694005,101.44530861648542,102.22421899386234,102.65986999906829,101.78856798865638,29053,50437.666666666664,60.70787573971022,66.51392516215677,NaN,NaN,NaN,NaN,0.5970681532164496,47.6929356922353,41521257,0.0821609870909577,0.5562042580991431,0.4740432710081854
2025-09-04T10:25:00-04:00,102.13,102.36,101.46,101.79,101.41455329051482,NaN,NaN,NaN,NaN,NaN,100.74658000000014,102.51670962643684,98.97645037356344,101.44530861648542,102.21007267233097,102.64253414604796,101.77761119861397,43098,51300.566666666666,54.98682145718892,66.47217006617849,NaN,NaN,NaN,NaN,0.6187061422724179,46.45900370878472,41478159,0.019996562711014076,0.499038974396953,0.4790424116859389
2025-09-04T10:30:00-04:00,101.75,102.23,101.7,101.92,101.41455329051482,NaN,NaN,NaN,NaN,NaN,100.77098000000015,102.57124582436275,98.97071417563755,101.44530861648542,102.20170511840895,102.6296207925794,101.7737894442385,35875,51648.5,56.5781678041942,66.13457964608234,NaN,NaN,NaN,NaN,0.6123699892529596,45.31320972415203,41514034,-0.016086188955273806,0.45893467549184663,0.47502086444712044
2025-09-04T10:35:00-04:00,101.91,102.29,101.86,102.28,101.41455329051482,NaN,NaN,NaN,NaN,NaN,100.80198000000013,102.65107437249536,98.9528856275049,101.44530861648542,102.20034555889973,102.62334013141513,101.77735098638432,26590,51728.6,60.71955003969684,65.93932343053288,NaN,NaN,NaN,NaN,0.5993435614491772,44.350146032704984,41540624,-0.019215209627739427,0.45100185241244617,0.4702170620401856
2025-09-04T10:40:00-04:00,102.29,102.37,101.69,101.84,101.41455329051482,NaN,NaN,NaN,NaN,NaN,100.82058000000013,102.69221872966537,98.9489412703349,101.44530861648542,102.19264415617492,102.61069666956826,101.77459164278159,38907,51166.86666666667,53.947178635523564,64.11407236028982,NaN,NaN,NaN,NaN,0.6051047356313793,42.906660452288826,41501717,-0.05253577740358628,0.4045473402857027,0.457083117689289
2025-09-04T10:45:00-04:00,101.84,101.84,101.52,101.7,101.41455329051482,NaN,NaN,NaN,NaN,NaN,100.84178000000013,102.72870750427506,98.95485249572519,101.44530861648542,102.1766508772304,102.59745983141198,101.75584192304882,38533,51787.5,51.96130189546734,62.92018322096787,NaN,NaN,NaN,NaN,0.5847401116577099,41.042234480127036,41463184,-0.08376806396502917,0.35237303773300255,0.4361411016980317
2025-09-04T10:50:00-04:00,101.7,102.08,101.58,101.65,101.41455329051482,NaN,NaN,NaN,NaN,NaN,100.85858000000013,102.75898606565693,98.95817393434334,101.44530861648542,102.16667434169466,102.58702327982886,101.74632540356046,30660,52433.26666666667,51.2358903028264,61.42542975020209,NaN,NaN,NaN,NaN,0.5786872465393021,39.800909051143094,41432524,-0.10611969414165212,0.3034914840209666,0.4096111781626187
2025-09-04T10:55:00-04:00,101.63,101.7,101.45,101.6,101.41455329051482,NaN,NaN,NaN,NaN,NaN,100.87478000000014,102.78634833159944,98.96321166840085,101.44530861648542,102.15776908087477,102.58098455562892,101.73455360612063,19374,52734.46666666667,50.47699365893932,60.54531442942454,NaN,NaN,NaN,NaN,0.5552095860722092,38.242935239307236,41413150,-0.12149152330623414,0.25774677402982604,0.3792382973360602
2025-09-04T11:00:00-04:00,101.6,101.735,101.46,101.51,101.41455329051482,NaN,NaN,NaN,NaN,NaN,100.89278000000013,102.81097424626118,98.97458575373908,100.73224689318833,102.15129180535001,102.5766376370273,101.72594597367272,14101,52811.76666666667,49.068142380709524,59.3381114849583,NaN,NaN,NaN,NaN,0.5351946156384804,36.87315657298181,41399049,-0.13395853452802947,0.21179012917602336,0.3457486637040528
2025-09-04T11:05:00-04:00,101.53,101.8,101.53,101.65,101.41455329051482,NaN,NaN,NaN,NaN,NaN,100.91638000000013,102.8422077343501,98.99055226565017,100.72536360788703,102.14351494076207,102.56991318489524,101.7171166966289,20639,52707,51.34316507890347,58.01973925674418,NaN,NaN,NaN,NaN,0.5176807145214455,35.74913803863346,41419688,-0.12896793953467156,0.1845387392857134,0.31350667882038497
2025-09-04T11:10:00-04:00,101.66,101.66,100.98,101.15,NaN,NaN,NaN,102.83623577510257,102.83623577510257,102.83623577510257,100.93178000000015,102.85251262230281,99.01104737769748,100.72536360788703,102.10925725321381,102.56060899139989,101.65790551502774,52802,53963.73333333333,43.815642687685454,56.003954893138385,NaN,NaN,NaN,NaN,0.5292749491984845,33.32185047880431,41366886,-0.15384623123338476,0.121198889778654,0.27504512101203876
2025-09-04T11:15:00-04:00,101.12,101.47,101.12,101.45,NaN,NaN,NaN,102.79004323987064,NaN,NaN,100.95458000000013,102.87231037061638,99.0368496293839,100.72536360788703,102.09823993281641,102.5554658604549,101.64101400517792,19887,53926.9,48.67761194460465,54.37485885470221,NaN,NaN,NaN,NaN,0.5164695956843066,31.067940601820094,41386773,-0.14473682355892142,0.09412409156338697,0.2388609151223084
2025-09-04T11:20:00-04:00,101.46,101.6,101.36,101.395,NaN,NaN,NaN,102.79004323987064,NaN,NaN,100.98088000000014,102.88593889210256,99.07582110789772,100.72536360788703,102.08780224566087,102.54858476657719,101.62701972474454,22586,54069.63333333333,47.859910451327686,52.991006786366185,NaN,NaN,NaN,NaN,0.49672176742114144,29.08077406598807,41364187,-0.13712750072850705,0.06745153921167457,0.20457903994018162
2025-09-04T11:25:00-04:00,101.39,101.815,101.38,101.77,NaN,NaN,NaN,102.79004323987064,NaN,NaN,101.01450000000014,102.91473919546691,99.11426080453337,100.77524893379054,102.08274523176802,102.54318286845864,101.62230759507739,16541,53980.63333333333,53.584939670324,52.49737083907868,NaN,NaN,NaN,NaN,0.49231306974820294,27.793141763289462,41380728,-0.10310315853965615,0.07570009176561143,0.17880325030526759
2025-09-04T11:30:00-04:00,101.78,102.03,101.62,101.94,NaN,NaN,NaN,102.79004323987064,NaN,NaN,101.04510000000015,102.95466905085337,99.13553094914693,100.99319914703243,102.07681425935496,102.53237794413452,101.6212505745754,39330,54396.6,55.946446560126255,52.15726875482269,NaN,NaN,NaN,NaN,0.4864335647661882,27.10538782205882,41420058,-0.06715363432968158,0.09486120739316561,0.1620148417228472
2025-09-04T11:35:00-04:00,101.94,102.05,101.75,101.84,NaN,NaN,NaN,102.79004323987064,NaN,NaN,101.07590000000013,102.98608186568438,99.16571813431588,101.07055931762594,102.07496973161058,102.52879003264997,101.6211494305712,13765,53972.6,54.199571234160466,52.10103659603494,NaN,NaN,NaN,NaN,0.47311688156860315,26.513200915165697,41406293,-0.04895968930304387,0.10081523009404236,0.14977491939708623
2025-09-04T11:40:00-04:00,101.84,102.26,101.8,102.09,NaN,NaN,NaN,102.79004323987064,NaN,NaN,101.11270000000013,103.02870648224251,99.19669351775775,101.24644745410076,102.07466165175056,102.52568203890085,101.62364126460027,18348,53250.03333333333,57.75120685294392,52.18482509951706,NaN,NaN,NaN,NaN,0.47217996145656066,26.44134358009692,41424641,-0.020400582616534935,0.12427419112641758,0.1446747737429525
2025-09-04T11:45:00-04:00,102.09,102.25,101.92,102.03,NaN,NaN,NaN,102.79004323987064,NaN,NaN,101.14650000000015,103.06641171671677,99.22658828328352,101.2741579632806,102.07457418551431,102.52312144631432,101.6260269247143,16449,52989.86666666667,56.616463820757126,51.891747512449946,NaN,NaN,NaN,NaN,0.4620242499239491,26.374618911818775,41408192,-0.006578887701439801,0.13645116411615277,0.14303005181759257
2025-09-04T11:50:00-04:00,102,102.42,101.89,102.42,NaN,NaN,NaN,102.79004323987064,NaN,NaN,101.18650000000017,103.12742271870034,99.24557728129999,101.37432637062449,102.07665343560825,102.52281745537519,101.63048941584131,18756,52035.066666666666,61.86202684229548,52.45709381293364,NaN,NaN,NaN,NaN,0.4668796606436671,26.694883860578837,41426948,0.026014070273513462,0.1755476396594844,0.14953356938597093
2025-09-04T11:55:00-04:00,102.4,102.41,102.11,102.26,NaN,NaN,NaN,102.79004323987064,NaN,NaN,101.22930000000015,103.16864319808958,99.28995680191072,101.41846109649958,102.0785371989125,102.52278817886858,101.63428621895642,15803,51270.166666666664,58.724917643669514,52.94020922351952,NaN,NaN,NaN,NaN,0.45567397059769105,26.99227274157032,41411145,0.03350490913226897,0.19141470580130715,0.15790979666903818
2025-09-04T12:00:00-04:00,102.27,102.57,102.27,102.49,NaN,NaN,NaN,102.79004323987064,NaN,NaN,101.27670000000015,103.22112033521114,99.33227966478916,101.62176887719967,102.08503916517721,102.52795101954345,101.64212731081096,27912,46321.86666666667,61.72935920989393,53.68974271688148,NaN,NaN,NaN,NaN,0.4452686869835694,27.627506442269695,41439057,0.04968206831047739,0.22001238205713491,0.17033031374665752
2025-09-04T12:05:00-04:00,102.5,102.73,102.42,102.73,NaN,NaN,NaN,102.79004323987064,NaN,NaN,101.33050000000014,103.28390855941208,99.3770914405882,101.81641510175974,102.09163069578399,102.53582687349136,101.64743451807662,19293,44451.066666666666,64.62312494634543,54.70018066598192,NaN,NaN,NaN,NaN,0.4356066379133146,28.549918586852417,41458350,0.07098055252216923,0.25905600439936904,0.18807545187719982
2025-09-04T12:10:00-04:00,102.75,103.16,102.73,103.1,101.60373927664696,101.60373927664696,101.60373927664696,NaN,NaN,NaN,101.39690000000014,103.36065547357204,99.43314452642825,102.2141320814078,102.13114378020404,102.60326169903334,101.65902586137474,72373,44344.46666666667,68.56890048008748,56.09309195879463,NaN,NaN,NaN,NaN,0.4352061637766487,30.144021025132655,41530723,0.10250699957104836,0.31620920134101027,0.2137022017699619
2025-09-04T12:15:00-04:00,103.12,103.24,102.88,103.14,101.7306147640721,NaN,NaN,NaN,NaN,NaN,101.47110000000015,103.4122051388286,99.5299948611717,102.30330566512623,102.14618528238515,102.62943764182054,101.66293292294975,26512,41909.03333333333,68.97181437012314,57.35228119388175,NaN,NaN,NaN,NaN,0.4298342949354595,31.742267550218724,41557235,0.11749800388154216,0.3605747066218896,0.24307670274034746
2025-09-04T12:20:00-04:00,103.15,103.63,103.14,103.6,102.049223183887,NaN,NaN,NaN,NaN,NaN,101.54310000000014,103.5271865807709,99.55901341922937,102.63564453210098,102.19109291972221,102.72247230902356,101.65971353042086,59762,41993.066666666666,73.22289051266755,59.452798895666184,NaN,NaN,NaN,NaN,0.43413184529721205,33.73523118497344,41616997,0.147874676896122,0.42792004886049995,0.28004537196437795
2025-09-04T12:25:00-04:00,103.61,103.69,103.29,103.5,102.1603948573467,NaN,NaN,NaN,NaN,NaN,101.61170000000014,103.62429296431064,99.59910703568964,102.6945156256808,102.21877290364048,102.77702198089118,101.66052382638979,37874,40568.1,70.9472435822612,61.04348686978451,NaN,NaN,NaN,NaN,0.4316938563474106,35.6557625204741,41579123,0.15022746555149447,0.467829703903746,0.31760223835225154
2025-09-04T12:30:00-04:00,103.49,103.94,103.44,103.94,102.3526496365582,NaN,NaN,NaN,NaN,NaN,101.68830000000014,103.75719594711617,99.61940405288411,102.89361250054463,102.28165696077126,102.90842514419205,101.65488877735046,75116,37106.833333333336,74.67647647400287,62.958955871404164,NaN,NaN,NaN,NaN,0.43657286660830985,37.71520500247017,41654239,0.16901122901391485,0.5288662746196451,0.35985504560573023
2025-09-04T12:35:00-04:00,103.95,104.23,103.95,104.03,102.77389283489647,NaN,NaN,NaN,NaN,NaN,101.76710000000014,103.88601773318024,99.64818226682004,103.24789000043572,102.34071147473486,103.03496529996679,101.64645764950293,63414,35725.066666666666,75.37281660358477,64.5152327952085,NaN,NaN,NaN,NaN,0.4261033761362882,39.9046155285291,41717653,0.17438754013054175,0.5778394707689074,0.40345193063836565
2025-09-04T12:40:00-04:00,104.01,104.6,103.85,104.49,102.86644316058299,NaN,NaN,NaN,NaN,NaN,101.85710000000016,104.0475110025236,99.66668899747671,103.43931200034856,102.41309592066663,103.18888562532179,101.63730621601148,73151,35088.2,78.61026399985144,66.13407689804602,NaN,NaN,NaN,NaN,0.4492388492694105,42.232499505042874,41790804,0.19429355588328245,0.6463188754924687,0.45202531960918624
2025-09-04T12:45:00-04:00,104.45,104.74,104.3,104.31,103.16319574419285,NaN,NaN,NaN,NaN,NaN,101.94090000000014,104.17914635819928,99.702653641801,103.59144960027885,102.47965149088967,103.32423539822247,101.63506758355686,67338,35128.066666666666,74.48406019533915,67.58296896670164,NaN,NaN,NaN,NaN,0.44857893146445244,44.49330261886617,41723466,0.18097686361718807,0.6782463991306713,0.49726953551348324
2025-09-04T12:50:00-04:00,104.29,104.37,104.16,104.18,103.16319574419285,NaN,NaN,NaN,NaN,NaN,102.02550000000014,104.27607970309627,99.774920296904,103.59144960027885,102.53262531867925,103.41698100776975,101.64826962958875,64066,36295.166666666664,71.56251540775878,68.56949100633128,NaN,NaN,NaN,NaN,0.43153757921699215,45.952098617758416,41659400,0.15031330491992656,0.6851611666633914,0.5348478617434649
2025-09-04T12:55:00-04:00,104.17,104.29,104.06,104.17,103.16319574419285,NaN,NaN,NaN,NaN,NaN,102.10810000000016,104.36428074629936,99.85191925370097,103.59144960027885,102.5558742623574,103.45510004183265,101.65664848288216,30543,35876.666666666664,71.33074004636731,69.62051073673199,NaN,NaN,NaN,NaN,0.4171420378443501,46.857225914636544,41628857,0.11770002605524632,0.6819728943125227,0.5642728682572764
2025-09-04T13:00:00-04:00,104.14,104.44,104.06,104.41,103.16319574419285,NaN,NaN,NaN,NaN,NaN,102.19560000000014,104.46271414798343,99.92848585201685,103.59144960027885,102.58719136383247,103.50798457510652,101.66639815255843,39334,35991.96666666667,73.54526703095644,70.45502789306492,NaN,NaN,NaN,NaN,0.41448903514118196,47.86928871007005,41668191,0.10126049611772048,0.690848488404427,0.5895879922867066
2025-09-04T13:05:00-04:00,104.41,104.41,103.92,103.93,103.16319574419285,NaN,NaN,NaN,NaN,NaN,102.27220000000015,104.50953427095193,100.03486572904838,103.59144960027885,102.63463205546051,103.57798824481806,101.69127586610297,71708,37495.9,63.05474817538746,70.76430150247334,NaN,NaN,NaN,NaN,0.41988267548824,48.17486786279138,41596483,0.0496406348922529,0.6516387859020227,0.6019981510097698
2025-09-04T13:10:00-04:00,103.91,104.06,103.64,103.655,103.16319574419285,NaN,NaN,NaN,NaN,NaN,102.34030000000016,104.53414175363126,100.14645824636905,103.59144960027885,102.64973782278227,103.59598521846345,101.70349042710109,30158,37204.26666666667,57.95434636316917,70.49465772770729,NaN,NaN,NaN,NaN,0.41989105581050873,47.3049861959575,41566325,-0.008354097970575736,0.5915555285465501,0.5999096265171259
2025-09-04T13:15:00-04:00,103.67,104.09,103.67,104.09,103.16319574419285,NaN,NaN,NaN,NaN,NaN,102.41940000000014,104.57433910818882,100.26446089181145,103.59144960027885,102.66545776383131,103.61664230184253,101.7142732258201,28106,36856.7,63.04631370956344,70.38202835365144,NaN,NaN,NaN,NaN,0.4209702661097583,46.552557101662494,41594431,-0.02197471515580207,0.5724412325723733,0.5944159477281754
2025-09-04T13:20:00-04:00,104.06,104.3,103.9,104.11,103.16319574419285,NaN,NaN,NaN,NaN,NaN,102.49660000000014,104.61132687597998,100.3818731240203,103.59144960027885,102.69259224316446,103.6548593409761,101.73032514535281,44715,37325.2,63.26658163869321,70.00329129355184,NaN,NaN,NaN,NaN,0.4194723899590607,46.23140371348948,41639146,-0.03350272670740728,0.5525375393439163,0.5860402660513235
2025-09-04T13:25:00-04:00,104.18,104.35,104.17,104.3,103.16319574419285,NaN,NaN,NaN,NaN,NaN,102.57380000000013,104.66426459907846,100.4833354009218,103.59144960027885,102.70885450891282,103.67935639754899,101.73835262027666,24630,37500.4,65.37790674290466,69.74658360589338,NaN,NaN,NaN,NaN,0.40665293353341314,46.02003918116319,41663776,-0.03218945383361793,0.5458034487593011,0.577992902592919
2025-09-04T13:30:00-04:00,104.3,104.32,103.84,103.84,103.16319574419285,NaN,NaN,NaN,NaN,NaN,102.63660000000013,104.68638968677318,100.58681031322708,103.59144960027885,102.72295364770919,103.69742480194738,101.748482493471,26432,37911.433333333334,56.8573274447002,68.57761481532428,NaN,NaN,NaN,NaN,0.41189200970959716,44.49553408245634,41637344,-0.06430447179807952,0.4976123128453196,0.5619167846433991
2025-09-04T13:35:00-04:00,103.85,103.96,103.56,103.6,103.16319574419285,NaN,NaN,NaN,NaN,NaN,102.69240000000012,104.69152905036454,100.6932709496357,103.50274219534276,102.73082635129317,103.70534001684506,101.75631268574129,19528,37874.4,52.977872449162824,67.29408830581725,NaN,NaN,NaN,NaN,0.4110425804446253,42.13574094794903,41617816,-0.10150172359852683,0.4350396301452406,0.5365413537437674
2025-09-04T13:40:00-04:00,103.6,103.9,103.59,103.88,103.16319574419285,NaN,NaN,NaN,NaN,NaN,102.72500000000012,104.74723638578953,100.70276361421071,103.50274219534276,102.74848255344183,103.72430795423323,101.77265715265044,41365,37493.166666666664,56.69063807398973,66.00938556295918,NaN,NaN,NaN,NaN,0.4038252532700094,39.94450446590653,41659181,-0.10651795155826782,0.40339391429593263,0.5099118658542005
2025-09-04T13:45:00-04:00,103.89,104.23,103.82,104.12,103.16319574419285,NaN,NaN,NaN,NaN,NaN,102.77200000000013,104.81242250526736,100.7315774947329,103.50274219534276,102.77076043257374,103.75293469006701,101.78858617508047,42990,38263.26666666667,59.632769743704046,64.88509650153912,NaN,NaN,NaN,NaN,0.4042663066078666,38.71029575295582,41702171,-0.09341070886083064,0.39314847977816214,0.4865591886389928
2025-09-04T13:50:00-04:00,104.12,104.62,104.12,104.48,103.16319574419285,NaN,NaN,NaN,NaN,NaN,102.81800000000013,104.90611015035414,100.72988984964611,103.59997975656691,102.79571952800627,103.79078540446504,101.8006536515475,39112,38814.13333333333,63.62453352499441,63.81468718190648,NaN,NaN,NaN,NaN,0.4111044275644476,38.330653190692736,41741283,-0.0617601076276974,0.409359054104371,0.4711191617320684
2025-09-04T13:55:00-04:00,104.45,104.58,104.33,104.51,103.21423486310479,NaN,NaN,NaN,NaN,NaN,102.87480000000014,104.9892492994651,100.76035070053517,103.63898380525353,102.83388827662185,103.84887784427713,101.81889870896657,59683,40252.2,63.944504647815876,63.06186178565482,NaN,NaN,NaN,NaN,0.3995969684527014,37.978127954305585,41800966,-0.041065130607483236,0.4197877484727144,0.4608528790801976
2025-09-04T14:00:00-04:00,104.52,104.64,104.51,104.58,103.37290600569095,NaN,NaN,NaN,NaN,NaN,102.92620000000014,105.07866701252351,100.77373298747676,103.82218704420282,102.84501139679375,103.8662312813019,101.8237915122856,16850,39502.86666666667,64.72422741734071,62.57341264348211,NaN,NaN,NaN,NaN,0.38034004213465095,37.765711678089254,41817816,-0.02567548919845819,0.4287585175821249,0.4544340067805831
2025-09-04T14:05:00-04:00,104.56,104.62,103.94,103.99,103.37290600569095,NaN,NaN,NaN,NaN,NaN,102.95640000000014,105.12528730919783,100.78751269080246,103.82218704420282,102.8656815116748,103.8923357078738,101.83902731547579,41415,40424.53333333333,54.10393943321804,61.34292688540001,NaN,NaN,NaN,NaN,0.4017443248393192,35.65746835531513,41776401,-0.05647901828809471,0.3838352339204647,0.4403142522085594
2025-09-04T14:10:00-04:00,104.01,104.13,103.95,104.06,103.37290600569095,NaN,NaN,NaN,NaN,NaN,102.98180000000013,105.17193950240767,100.7916604975926,103.82218704420282,102.87170729265489,103.89919010517582,101.84422448013396,13752,40271.333333333336,55.04640301571477,60.02157945573989,NaN,NaN,NaN,NaN,0.38590544449365305,33.699813841310586,41790153,-0.07237237461369594,0.3498487839414395,0.4222211585551354
2025-09-04T14:15:00-04:00,104.04,104.24,103.98,104.14,103.37290600569095,NaN,NaN,NaN,NaN,NaN,103.00940000000013,105.22232624369032,100.79647375630994,103.82218704420282,102.88015406415364,103.90925557588805,101.85105255241923,18362,40335.1,56.154532481977185,59.52870690621058,NaN,NaN,NaN,NaN,0.37691219845839147,32.16032004123001,41808515,-0.07728403958838309,0.32561610906965655,0.40290014865803964
2025-09-04T14:20:00-04:00,104.15,104.15,103.86,104.1,103.37290600569095,NaN,NaN,NaN,NaN,NaN,103.04080000000013,105.27011950155169,100.81148049844857,103.82218704420282,102.88773752429972,103.91769791184657,101.85777713675287,17911,40306.933333333334,55.418937198213534,59.34760625157089,NaN,NaN,NaN,NaN,0.3707041842827925,30.35010360013936,41790604,-0.08253708927987174,0.29972878705819994,0.3822658763380717
2025-09-04T14:25:00-04:00,104.08,104.095,103.8,103.86,103.37290600569095,NaN,NaN,NaN,NaN,NaN,103.07540000000012,105.30079869686844,100.85000130313179,103.82218704420282,102.89340341669669,103.92335171433936,101.86345511905401,15100,40283.5,51.09418222673257,58.49388257422583,NaN,NaN,NaN,NaN,0.36565388540544996,28.47881643918796,41775504,-0.10030415279457328,0.2568856853448551,0.3571898381394284
2025-09-04T14:30:00-04:00,103.87,104.17,103.75,104.17,103.37290600569095,NaN,NaN,NaN,NaN,NaN,103.11580000000012,105.34587027692376,100.88572972307648,103.82218704420282,102.90024747257061,103.93084825866298,101.86964668647825,16639,39907.73333333333,55.88316025004266,57.966495332179356,NaN,NaN,NaN,NaN,0.3695357507336322,26.963672759666284,41792143,-0.08965505035542548,0.24512102519514656,0.33477607555057204
2025-09-04T14:35:00-04:00,104.16,104.49,104.14,104.44,103.37290600569095,NaN,NaN,NaN,NaN,NaN,103.16880000000012,105.39627351050927,100.94132648949096,103.82218704420282,102.91434938162405,103.94981698687425,101.87888177637385,27017,40165.2,59.59433442548429,57.55338302379219,NaN,NaN,NaN,NaN,0.3681403399669438,26.417305828574637,41819160,-0.06410185371328814,0.25464875840896184,0.31875061212225
2025-09-04T14:40:00-04:00,104.42,104.47,104.15,104.18,103.37290600569095,NaN,NaN,NaN,NaN,NaN,103.21400000000013,105.42996660624854,100.99803339375171,103.82218704420282,102.92465399825227,103.96285051542318,101.88645748108135,21425,38466.933333333334,54.81263887836112,57.40733384048225,NaN,NaN,NaN,NaN,0.3647017442550187,25.909965106846684,41797735,-0.06422386108991318,0.23847078575985847,0.30269464684977165
2025-09-04T14:45:00-04:00,104.18,104.33,104.03,104.14,103.37290600569095,NaN,NaN,NaN,NaN,NaN,103.25120000000014,105.46564851825444,101.03675148174584,103.82218704420282,102.93326332763161,103.97297452609513,101.89355212916809,19626,38237.4,54.093531721621176,57.48702378851499,NaN,NaN,NaN,NaN,0.3600801910939458,24.983072479475258,41778109,-0.0662459278953853,0.21988723698054002,0.2861331648759253
2025-09-04T14:50:00-04:00,104.13,104.18,104.01,104.03,103.37290600569095,NaN,NaN,NaN,NaN,NaN,103.29500000000013,105.48253559971377,101.10746440028649,103.63338403241241,102.93837747305066,103.97854791107558,101.89820703502575,12758,36670.6,52.070413311932015,57.1570077340823,NaN,NaN,NaN,NaN,0.3465030345872355,24.045689348166448,41765351,-0.07366916365473736,0.19404671030750364,0.267715873962241
2025-09-04T14:55:00-04:00,104.01,104.06,103.81,103.84,103.37290600569095,NaN,NaN,NaN,NaN,NaN,103.33780000000013,105.48214713608054,101.19345286391972,103.63338403241241,102.94593913924506,103.9855138285366,101.90636444995351,22463,36156.9,48.68350527547476,56.37491741492307,NaN,NaN,NaN,NaN,0.33960996068814725,22.433134835693966,41742888,-0.08902611537123079,0.1564332297482025,0.2454593451194333
2025-09-04T15:00:00-04:00,103.86,104.07,103.84,104.06,103.37290600569095,NaN,NaN,NaN,NaN,NaN,103.38600000000014,105.48427643555524,101.28772356444503,103.63338403241241,102.95192775711115,103.99151098493206,101.91234452929024,16537,34204.26666666667,52.53344438998461,55.582696762422366,NaN,NaN,NaN,NaN,0.3317806777818503,20.97078645297689,41759425,-0.08218257907260909,0.14273112127867194,0.22491370035128103
2025-09-04T15:05:00-04:00,104.07,104.08,103.83,103.83,103.37290600569095,NaN,NaN,NaN,NaN,NaN,103.43060000000014,105.46907849142342,101.39212150857686,103.63338403241241,102.95935128485758,103.9983268759134,101.92037569380174,22435,32838.3,48.44172087966665,54.47535506469742,NaN,NaN,NaN,NaN,0.3259392007974324,19.612891526168177,41736990,-0.09031359445861054,0.11202170727801786,0.2023353017366284
2025-09-04T15:10:00-04:00,103.83,104.14,103.72,104.14,103.37290600569095,NaN,NaN,NaN,NaN,NaN,103.48320000000012,105.45537926163234,101.5110207383679,103.63338403241241,102.9680194652973,104.006972844436,101.9290660861586,24405,31213.433333333334,53.67857910789058,53.68638018545098,NaN,NaN,NaN,NaN,0.33265782931190163,18.506716418567123,41761395,-0.0727367460610055,0.11141436916037151,0.184151115221377
2025-09-04T15:15:00-04:00,104.11,104.13,103.9,103.96,103.37290600569095,NaN,NaN,NaN,NaN,NaN,103.52940000000014,105.43473213902533,101.62406786097495,103.63338403241241,102.97512998525461,104.01398814002735,101.93627183048187,20394,29648.633333333335,50.472857593747044,53.42701719691734,NaN,NaN,NaN,NaN,0.3260394129324797,17.47955381865186,41741001,-0.07107298763854267,0.09530988067319868,0.16638286831174134
2025-09-04T15:20:00-04:00,103.95,104.05,103.85,103.86,103.37290600569095,NaN,NaN,NaN,NaN,NaN,103.58360000000012,105.36527341564548,101.80192658435476,103.63338403241241,102.98109285328235,104.01936742400044,101.94281828256426,18737,28137.666666666668,48.731659590047165,52.97596409508394,NaN,NaN,NaN,NaN,0.31703659772301707,16.734695205749365,41722264,-0.07420305986960199,0.07362904347473886,0.14783210334434085
2025-09-04T15:25:00-04:00,103.86,103.95,103.74,103.75,103.37290600569095,NaN,NaN,NaN,NaN,NaN,103.62960000000012,105.30409435950588,101.95510564049437,103.62470722592992,102.9844062766207,104.02193639256274,101.94687616067867,11868,27515.166666666668,46.81835638653054,52.30909437398061,NaN,NaN,NaN,NaN,0.30939112645708783,16.49060172492842,41710396,-0.08064278157881868,0.047028626370817506,0.1276714079496362
2025-09-04T15:30:00-04:00,103.74,103.9,103.59,103.63,103.37290600569095,NaN,NaN,NaN,NaN,NaN,103.67430000000013,105.22235169164381,102.12624830835645,103.50376578074395,102.98888788817519,104.02474795581135,101.95302782053902,18612,26824.433333333334,44.754031699653005,51.54731540979771,NaN,NaN,NaN,NaN,0.30943461742443884,16.821679612380617,41691784,-0.08927372203585408,0.016079255404818582,0.10535297744067267
2025-09-04T15:35:00-04:00,103.62,103.69,103.44,103.69,103.37290600569095,NaN,NaN,NaN,NaN,NaN,103.71270000000013,105.1620021907118,102.26339780928845,103.43401262459517,102.99480208588197,104.02744555325764,101.96215861850631,28993,25400.6,46.03526027877962,51.185963842086785,NaN,NaN,NaN,NaN,0.3051892876084075,17.627312897822836,41720777,-0.0871349754344226,-0.003565741852355586,0.08356923358206701
2025-09-04T15:40:00-04:00,103.67,103.91,103.6,103.85,103.37290600569095,NaN,NaN,NaN,NaN,NaN,103.75090000000013,105.10911602110997,102.39268397889029,103.40747485682733,103.00908853415176,104.0377880674143,101.98038900088922,55643,26250.1,49.40493224665126,50.723233270415975,NaN,NaN,NaN,NaN,0.3055329099220928,17.254007725223605,41776420,-0.07177774964283026,-0.006152953471470823,0.06562479617135944
2025-09-04T15:45:00-04:00,103.82,103.83,103.48,103.52,103.37290600569095,NaN,NaN,NaN,NaN,NaN,103.78450000000014,105.0304442202604,102.53855577973987,103.40747485682733,103.0148081738283,104.04026151706849,101.98935483058811,29638,26301.166666666668,43.387383227543324,49.56559389913448,NaN,NaN,NaN,NaN,0.3101377020705141,17.32756909948782,41746782,-0.08004754759203633,-0.034434638318685984,0.04561290927335035
2025-09-04T15:50:00-04:00,103.54,103.6,103.36,103.42,NaN,NaN,NaN,104.46935108991335,104.46935108991335,104.46935108991335,103.81110000000014,104.96455964818531,102.65764035181496,103.40747485682733,103.02264566243896,104.04071735385,102.00457397102792,55800,26670.666666666668,41.72873131737718,48.63102907334991,NaN,NaN,NaN,NaN,0.30512786620833415,17.789540577189598,41690982,-0.08783228258578661,-0.06417744395888292,0.023654838626903693
2025-09-04T15:55:00-04:00,103.41,103.45,102.705,102.905,NaN,NaN,NaN,104.1234714949173,NaN,NaN,103.82860000000014,104.89684162060418,102.7603583793961,103.40747485682733,103.02252037144733,104.01619337452084,102.02884736837382,157565,31101.833333333332,34.42898278686921,47.226418435153334,NaN,NaN,NaN,NaN,0.33654730433631064,19.763837875209862,41533417,-0.12118904378992863,-0.1278314661105071,-0.006642422320578472
2025-09-05T09:30:00-04:00,104.98,106.03,104.1,104.25,103.64043630030622,103.64043630030622,103.64043630030622,NaN,NaN,NaN,103.86520000000014,104.8608183204364,102.8695816795639,103.71712668486049,104.79333333333332,104.79333524068196,104.79333142598469,329823,41214.86666666667,56.05184245272678,47.510806230924395,NaN,NaN,NaN,NaN,0.535722496883717,20.78242061196036,41863240,-0.049848170022837715,-0.06895263484912562,-0.0191044648262879
2025-09-05T09:35:00-04:00,104.23,104.88,103.51,103.69,NaN,NaN,NaN,105.74162898607133,105.74162898607133,105.74162898607133,103.89380000000016,104.77941065935885,103.00818934064147,103.71712668486049,104.52332431144247,104.8895237719603,104.15712485092463,179309,46540.9,48.83158829738629,47.521383589632364,NaN,NaN,NaN,NaN,0.5953137471063078,20.592950263349383,41683931,-0.03808368898401985,-0.06670907605631271,-0.02862538707229286
2025-09-05T09:40:00-04:00,103.7,104.21,103,103.37,NaN,NaN,NaN,105.24632766852262,NaN,NaN,103.91140000000016,104.71598943565411,103.1068105643462,103.71712668486049,104.26646558867165,104.80457808311591,103.72835309422739,176771,51054.433333333334,45.24501306447796,47.00078135209617,NaN,NaN,NaN,NaN,0.6392199080272853,19.57811175765428,41507160,-0.0488742105097255,-0.08971815020944973,-0.04084393969972423
2025-09-05T09:45:00-04:00,103.43,103.46,101.69,102.62,NaN,NaN,NaN,104.3830855017716,NaN,NaN,103.90920000000017,104.72718865516033,103.09121134484,103.71712668486049,103.90646058512014,104.74390677370707,103.06901439653322,187570,55873.76666666667,38.16903822451995,46.267018305299985,NaN,NaN,NaN,NaN,0.7199899145967646,19.362673172234647,41319590,-0.10056631494059241,-0.16655183337546475,-0.06598551843487234
2025-09-05T09:50:00-04:00,102.66,102.93,101.51,102.04,NaN,NaN,NaN,104.13953616078199,NaN,NaN,103.88800000000016,104.83374626616948,102.94225373383084,103.71712668486049,103.68457294747111,104.65950774928262,102.7096381456596,127126,58807.566666666666,33.77053498386819,44.84501515358409,NaN,NaN,NaN,NaN,0.7699906349827101,19.346965300570883,41192464,-0.16410673978644963,-0.2711189431679344,-0.10701220338148476
2025-09-05T09:55:00-04:00,102.1,102.1,100.51,100.725,NaN,NaN,NaN,103.35410269892827,NaN,NaN,103.83970000000016,105.12060188538044,102.55879811461989,103.71712668486049,103.29902218666946,104.5840910830322,102.01395329030672,176369,62697.1,26.355044313177117,43.12231420497195,NaN,NaN,NaN,NaN,0.8285627324839444,20.23426899683703,41016095,-0.27827451871293246,-0.45485535177265035,-0.1765808330597179
2025-09-05T10:00:00-04:00,100.68,100.68,99.22,99.78,NaN,NaN,NaN,102.11118893988608,NaN,NaN,103.76330000000014,105.47539183164392,102.05120816835637,103.71712668486049,102.78314800676338,104.48374729702806,101.0825487164987,210106,69138.96666666666,22.526856142893962,41.2505425301753,NaN,NaN,NaN,NaN,0.8768796801636624,21.926995315143134,40805989,-0.39394289920785375,-0.6690094570695351,-0.2750665578616813
2025-09-05T10:05:00-04:00,99.75,99.96,98.65,98.97,NaN,NaN,NaN,101.54658944261853,NaN,NaN,103.67270000000015,105.84777168617055,101.49762831382975,103.71712668486049,102.30903806941643,104.305853174398,100.31222296443487,211068,74794.06666666667,19.863532712418447,39.32519798202443,NaN,NaN,NaN,NaN,0.9078168458662571,23.811968725952507,40594921,-0.4949750398867847,-0.8937853577201622,-0.3988103178333775
2025-09-05T10:10:00-04:00,98.97,99.3,98.55,98.61,NaN,NaN,NaN,101.1669717406813,NaN,NaN,103.56610000000015,106.16037083396895,100.97182916603134,103.71712668486049,102.0119732541443,104.15580347598562,99.86814303230297,148733,79293.43333333333,18.79969288762497,37.471316638308146,NaN,NaN,NaN,NaN,0.8965442140186674,25.616046512024916,40446188,-0.5516911002810296,-1.0884241931846645,-0.5367330929036349
2025-09-05T10:15:00-04:00,98.59,98.82,97,97.26,NaN,NaN,NaN,100.29824575246852,NaN,NaN,103.43070000000016,106.56455450204245,100.29684549795786,103.71712668486049,101.16957103683626,103.74404034072299,98.59510173294953,423323,92792.13333333333,15.456592217707822,35.287126062517295,NaN,NaN,NaN,NaN,0.962505341588762,28.002493721695142,40022865,-0.639579622059577,-1.3362076204781062,-0.6966279984185292
2025-09-05T10:20:00-04:00,97.25,98.5,97.25,97.81,NaN,NaN,NaN,100.29824575246852,NaN,NaN,103.29710000000016,106.78812568881563,99.80607431118469,102.34470134788839,101.00516914272899,103.61620024121494,98.39413804424304,113199,95968.4,21.575371328273008,33.29930028263314,NaN,NaN,NaN,NaN,0.9830406743324218,30.21848041638892,40136064,-0.619687884596458,-1.4712378541641016,-0.8515499695676436
2025-09-05T10:25:00-04:00,97.79,98.31,97.5,97.9,NaN,NaN,NaN,100.29824575246852,NaN,NaN,103.16890000000016,106.95964361569918,99.37815638430115,101.57676107831071,100.8175494807996,103.45419145546865,98.18090750613055,147007,100365.3,22.563009788893837,31.81184503701532,NaN,NaN,NaN,NaN,0.9706806261658204,32.276182347176004,40283071,-0.5612280577557831,-1.5530850417623725,-0.9918569840065894
2025-09-05T10:30:00-04:00,97.92,98.48,97.7,98.23,NaN,NaN,NaN,100.29824575246852,NaN,NaN,103.04990000000016,107.07267590228042,99.0271240977199,100.46840886264857,100.7178219362119,103.35423741393801,98.0814064584858,93903,102940.76666666666,26.23138110762791,30.704891450604652,NaN,NaN,NaN,NaN,0.9570605814396904,33.890632606248644,40376974,-0.465063668819959,-1.5731865700315382,-1.1081229012115792
2025-09-05T10:35:00-04:00,98.21,98.63,97.71,98.3,NaN,NaN,NaN,100.29824575246852,NaN,NaN,102.93250000000016,107.15531292505054,98.70968707494978,99.82672709011887,100.6558038882147,103.28830187491903,98.02330590151038,64096,104176.73333333334,27.021133089093638,30.17575932933497,NaN,NaN,NaN,NaN,0.9544133970511413,35.1222127058642,40441070,-0.36584050541241075,-1.5654235329770927,-1.199583027564682
2025-09-05T10:40:00-04:00,98.415,98.57,97.8,98.07,NaN,NaN,NaN,100.29824575246852,NaN,NaN,102.80570000000016,107.21984862006016,98.39155137994015,98.82238167209509,100.58294161885449,103.21092908849252,97.95495414921646,77412,106042.96666666666,26.034878348570075,28.031690464752348,NaN,NaN,NaN,NaN,0.9412410115474881,36.26582279836436,40363658,-0.2882130782401786,-1.5598493753649052,-1.2716362971247266
2025-09-05T10:45:00-04:00,98.05,98.06,96.65,97.28,NaN,NaN,NaN,99.88904779663557,NaN,NaN,102.67270000000015,107.33697881241964,98.00842118758065,97.30540533767609,100.34098966388079,103.0095370112142,97.67244231654738,214215,112529.26666666666,22.937994418156578,26.182148044807366,NaN,NaN,NaN,NaN,0.9754380821512381,37.94550732821227,40149443,-0.26327179399997,-1.6007260396246892,-1.3374542456247192
2025-09-05T10:50:00-04:00,97.28,97.88,96.93,97.88,NaN,NaN,NaN,99.88904779663557,NaN,NaN,102.55720000000014,107.4010146785354,97.71338532146487,96.60532427014087,100.25100312384824,102.92163944757556,97.58036680012091,96427,115318.23333333334,29.770755206627513,25.07684391210376,NaN,NaN,NaN,NaN,0.9736210762832916,39.50521439164248,40245870,-0.18335402440326964,-1.566646776128806,-1.3832927517255365
2025-09-05T10:55:00-04:00,97.89,97.99,96.95,97.03,NaN,NaN,NaN,99.88904779663557,NaN,NaN,102.41600000000012,107.4794798311047,97.35252016889555,96.2412594161127,100.16952708093402,102.84641063609403,97.492643525774,85205,117409.63333333333,26.22345331722245,24.223587847296795,NaN,NaN,NaN,NaN,0.9783624279773416,40.73375365662661,40160665,-0.16528519202202974,-1.5898992417530735,-1.4246140497310438
2025-09-05T11:00:00-04:00,96.98,97.37,95.66,96.05,NaN,NaN,NaN,99.2055547186929,NaN,NaN,102.25480000000012,107.59777593481485,96.91182406518539,96.00402070837744,99.91547422187537,102.67067140594854,97.1602770378022,218768,124150.66666666667,22.843824891251685,23.443108554967043,NaN,NaN,NaN,NaN,1.0306222545503891,42.479476368645905,39941897,-0.194848851235091,-1.6681751137749075,-1.4733262625398165
2025-09-05T11:05:00-04:00,96.07,97,96.06,96.77,NaN,NaN,NaN,99.2055547186929,NaN,NaN,102.10420000000013,107.62947695595349,96.57892304404677,96.00402070837744,99.79356920863813,102.5683207990653,97.01881761821096,125614,127589.96666666666,29.983382497027605,23.70227556809922,NaN,NaN,NaN,NaN,1.0248635220825044,44.10050460123525,40067511,-0.14378372908130155,-1.6530559238914435,-1.509272194810142
2025-09-05T11:10:00-04:00,96.79,97.18,96.5,97.18,NaN,NaN,NaN,99.2055547186929,NaN,NaN,101.97100000000013,107.64166980170751,96.30033019829276,96.00402070837744,99.73532297191697,102.51082189113238,96.95982405270156,71312,129153.53333333334,33.7432028453605,24.503443189703972,NaN,NaN,NaN,NaN,1.000230413362326,45.24372865975709,40138823,-0.06431473047069458,-1.5896656078985103,-1.5253508774278157
2025-09-05T11:15:00-04:00,97.18,97.52,97.01,97.44,NaN,NaN,NaN,99.2055547186929,NaN,NaN,101.84780000000012,107.6379544573537,96.05764554264654,96.00402070837744,99.69390593895234,102.4632558496593,96.92455602824538,60754,130498.86666666667,36.08704853489456,25.662265748452267,NaN,NaN,NaN,NaN,0.9652139552650165,45.633417312475736,40199577,0.019365308112677226,-1.5011442422869692,-1.5205095503996464
2025-09-05T11:20:00-04:00,97.41,97.97,97.35,97.96,NaN,NaN,NaN,99.2055547186929,NaN,NaN,101.72940000000011,107.59017013369605,95.86862986630418,96.00402070837744,99.64154343667052,102.3911192320566,96.89196764128444,98464,133156.43333333332,40.6119809389204,27.220286323544798,NaN,NaN,NaN,NaN,0.94055581560323,45.1635307483427,40298041,0.11784655421053714,-1.373201357636475,-1.4910479118470121
2025-09-05T11:25:00-04:00,97.94,98.13,97.63,98.09,NaN,NaN,NaN,99.2055547186929,NaN,NaN,101.60880000000012,107.51581872690649,95.70178127309374,96.12054585578336,99.60720336365898,102.33916170257201,96.87524502474595,75356,135272.7,41.72280820338333,29.096444608235906,NaN,NaN,NaN,NaN,0.9090875430601422,44.441782404326275,40373397,0.19528487575459508,-1.2469418171537683,-1.4422266929083634
2025-09-05T11:30:00-04:00,98.12,98.26,97.83,98.15,NaN,NaN,NaN,99.2055547186929,NaN,NaN,101.48220000000012,107.4089462101909,95.55545378980933,96.4374366846267,99.57076880114306,102.27998501712034,96.86155258516578,90720,137676.3,42.259617378664856,30.573890754692467,NaN,NaN,NaN,NaN,0.8748670042701325,43.53496707846674,40464117,0.25056212488028673,-1.129024036808005,-1.3795861616882916
2025-09-05T11:35:00-04:00,98.13,98.77,98.11,98.65,NaN,NaN,NaN,99.2055547186929,NaN,NaN,101.36500000000012,107.27936218032112,95.45063781967913,96.98194934770136,99.55293065929965,102.24273134613426,96.86312997246503,65040,138877.86666666667,46.66831259710296,32.29569809813598,NaN,NaN,NaN,NaN,0.8595193611079799,41.80932197001228,40529157,0.3165602087186221,-0.983885900790014,-1.3004461095086361
2025-09-05T11:40:00-04:00,98.67,98.91,98.53,98.84,NaN,NaN,NaN,99.2055547186929,NaN,NaN,101.25020000000013,107.13323627729758,95.36716372270268,97.28955947816108,99.54125234375364,102.2128798736624,96.86962481384488,57815,138950.26666666666,48.28423914978282,33.870902244004185,NaN,NaN,NaN,NaN,0.8252679781716953,39.97664109707785,40586972,0.36531319491360414,-0.843804615866631,-1.2091178107802352
2025-09-05T11:45:00-04:00,98.82,98.83,98.32,98.8,NaN,NaN,NaN,99.2055547186929,NaN,NaN,101.14640000000013,107.0155375993415,95.27726240065876,97.28955947816108,99.5250292704737,102.17490980619326,96.87514873475413,72779,140388.3,47.954811871829556,35.36616501419961,NaN,NaN,NaN,NaN,0.8034631225880035,38.52524247020522,40514193,0.38519089055742506,-0.7276291975834539,-1.112820088140879
2025-09-05T11:50:00-04:00,98.83,98.85,98.46,98.56,NaN,NaN,NaN,99.2055547186929,NaN,NaN,101.03640000000013,106.88912655776842,95.18367344223184,97.40991806602308,99.51665016059239,102.15560839708674,96.87769192409804,37503,139778.4,45.929991667064066,36.78724453694918,NaN,NaN,NaN,NaN,0.7739300424031461,37.141025054023316,40476690,0.3722866311199142,-0.6474617992409861,-1.0197484303609003
2025-09-05T11:55:00-04:00,98.57,98.93,98.52,98.89,NaN,NaN,NaN,99.2055547186929,NaN,NaN,100.93140000000012,106.7458891572696,95.11691084273065,97.57293445281847,99.50110380013236,102.11421302718287,96.88799457308184,87008,137426.5,49.11169471312202,38.65679455801814,NaN,NaN,NaN,NaN,0.7479350393743508,35.70198974979028,40563698,0.3750392917703449,-0.5509493156479692,-0.9259886074183141
2025-09-05T12:00:00-04:00,98.93,99.08,98.33,98.49,NaN,NaN,NaN,99.2055547186929,NaN,NaN,100.81920000000012,106.60120323763422,95.03719676236602,97.61934756225477,99.48455889362526,102.07535687756435,96.89376090968618,80133,129103.5,45.60838422890063,39.78805377389479,NaN,NaN,NaN,NaN,0.7480825365618972,34.62750772519961,40483565,0.3400194225915889,-0.5009643291788279,-0.8409837517704168
2025-09-05T12:05:00-04:00,98.48,98.65,98.11,98.65,NaN,NaN,NaN,99.2055547186929,NaN,NaN,100.71500000000013,106.4617249803701,94.96827501963017,97.61934756225477,99.4724013198389,102.0499946743663,96.89480796531149,50975,124825.7,47.22991855708496,41.288515576742114,NaN,NaN,NaN,NaN,0.7332194982360478,33.925494265891714,40534540,0.31812318159629227,-0.44332977477505153,-0.7614529563713438
2025-09-05T12:10:00-04:00,98.63,99.02,98.63,98.94,NaN,NaN,NaN,99.2055547186929,NaN,NaN,100.61040000000014,106.29178815431641,94.92901184568387,97.67418243984305,99.46674776227543,102.0330149718899,96.90048055266097,39856,120261.86666666667,50.131805764221035,43.2376570676685,NaN,NaN,NaN,NaN,0.7087038197906158,32.50389092927901,40574396,0.31317164285001176,-0.36998840280882916,-0.6831600456588409
2025-09-05T12:15:00-04:00,98.93,99.01,98.72,98.82,NaN,NaN,NaN,99.2055547186929,NaN,NaN,100.49800000000013,106.09360649081088,94.90239350918938,97.78834595187445,99.46313386780061,102.0223043333291,96.90396340227211,25308,114853.13333333333,48.93269357466066,44.59117928749943,NaN,NaN,NaN,NaN,0.6787964040912866,31.18383068813864,40549088,0.29222125935565635,-0.31788347146427043,-0.6101047308199268
2025-09-05T12:20:00-04:00,98.8,99.08,98.56,99.06,NaN,NaN,NaN,99.2055547186929,NaN,NaN,100.39560000000012,105.90465859108592,94.88654140891431,97.84267676149955,99.45928278836011,102.01010981723954,96.90845575948069,29740,111606.93333333333,51.434693445656634,45.85485718752058,NaN,NaN,NaN,NaN,0.6674538037990515,30.212970198803912,40578828,0.2846496912580049,-0.25429261674742065,-0.5389423080054255
2025-09-05T12:25:00-04:00,99.01,99.01,98.385,98.41,NaN,NaN,NaN,99.2055547186929,NaN,NaN,100.28100000000013,105.71155798238121,94.85044201761906,97.84267676149955,99.44974484937181,101.98794170398429,96.91154799475933,48909,107358.26666666666,45.00368336483596,46.491759675373544,NaN,NaN,NaN,NaN,0.6679928178134047,29.585833434616017,40529919,0.22841412454857374,-0.25342465231970834,-0.4818387768682821
2025-09-05T12:30:00-04:00,98.43,98.48,98.16,98.25,NaN,NaN,NaN,99.2055547186929,NaN,NaN,100.16540000000013,105.51732520127203,94.81347479872824,97.84267676149955,99.4262043595743,101.94364521017954,96.90876350896906,91652,103409.8,43.55990262420239,46.70232551003654,NaN,NaN,NaN,NaN,0.6431361879695906,29.343730469562946,40438267,0.17537492089674822,-0.26262012574734683,-0.43799504664409505
2025-09-05T12:35:00-04:00,98.29,98.63,98.15,98.49,NaN,NaN,NaN,99.2055547186929,NaN,NaN,100.05840000000013,105.32543424708892,94.79136575291135,97.84267676149955,99.41441195434079,101.91934211698462,96.90948179169696,53417,98154.76666666666,46.34072912404664,47.032177004369636,NaN,NaN,NaN,NaN,0.631483603114619,28.742927560070342,40491684,0.152246888991787,-0.2476864354043613,-0.3999333243961483
2025-09-05T12:40:00-04:00,98.48,98.76,98.45,98.6,NaN,NaN,NaN,99.2055547186929,NaN,NaN,99.94920000000013,105.10507833836408,94.79332166163618,97.84267676149955,99.40978197799339,101.90829963557263,96.91126432041415,26081,94066.36666666667,47.61470630444438,47.41468335621103,NaN,NaN,NaN,NaN,0.6085204886064322,27.861351721749244,40517765,0.14043571195909715,-0.2243886844472769,-0.36482439640637404
2025-09-05T12:45:00-04:00,98.58,98.74,98.31,98.46,NaN,NaN,NaN,99.2055547186929,NaN,NaN,99.84180000000013,104.89249411467458,94.79110588532569,97.84267676149955,99.40429813796568,101.89623809708375,96.91235817884761,27809,80882.56666666667,46.114086995988124,47.37509581327425,NaN,NaN,NaN,NaN,0.5957690251345437,27.291447178618476,40489956,0.12006238438434386,-0.21474641592594423,-0.3348088003102881
2025-09-05T12:50:00-04:00,98.44,98.63,98.39,98.53,NaN,NaN,NaN,99.2055547186929,NaN,NaN,99.72960000000013,104.64069553562167,94.81850446437859,97.84267676149955,99.39895947638756,101.88434201792464,96.91357693485048,27814,78036.4,47.01327638679705,47.28431275877527,NaN,NaN,NaN,NaN,0.5703569519106473,26.76225010285419,40517770,0.1085185331646159,-0.1991606338545182,-0.3076791670191341
2025-09-05T12:55:00-04:00,98.5,98.95,98.45,98.94,NaN,NaN,NaN,99.2055547186929,NaN,NaN,99.62920000000014,104.39330678301798,94.8650932169823,97.88834810957324,99.39650664198663,101.8772645166346,96.91574876733867,18399,73749.46666666666,52.05931599121889,47.57749162444593,NaN,NaN,NaN,NaN,0.565331455345601,25.41943560709144,40536169,0.12456464443496545,-0.15197336147542728,-0.27653800591039274
2025-09-05T13:00:00-04:00,98.92,98.97,98.62,98.62,NaN,NaN,NaN,99.2055547186929,NaN,NaN,99.52440000000016,104.13984001802578,94.90895998197453,97.9456784876586,99.38999292200042,101.85933765436114,96.92064818963969,46290,72162.36666666667,48.2010604655053,47.7397108243346,NaN,NaN,NaN,NaN,0.5499506371066291,24.121270576406577,40489879,0.11019164341157378,-0.13879845164592552,-0.2489900950574993
2025-09-05T13:05:00-04:00,98.63,99.16,98.5,99.16,NaN,NaN,NaN,99.2055547186929,NaN,NaN,99.43260000000015,103.888017484366,94.9771825156343,98.01054279012688,99.38637852599044,101.84611421244587,96.926642839535,37969,71291.46666666666,54.349520291510466,48.11384122279092,NaN,NaN,NaN,NaN,0.5578113058847267,22.428007460443695,40527848,0.13213803042087205,-0.08381755703140925,-0.2159555874522813
2025-09-05T13:10:00-04:00,99.18,99.45,99.12,99.45,97.49413631062362,97.49413631062362,97.49413631062362,NaN,NaN,NaN,99.34900000000016,103.64007911835537,95.05792088164495,98.3654342321015,99.38580073001027,101.83017178872151,96.94142967129903,59635,70698.9,57.2820650073084,48.94767556410575,NaN,NaN,NaN,NaN,0.5415390697501032,21.47596607167305,40587483,0.15944265509935723,-0.016652268578084772,-0.176094923677442
2025-09-05T13:15:00-04:00,99.44,99.85,99.43,99.62,97.87326647832255,NaN,NaN,NaN,NaN,NaN,99.26760000000014,103.37675915486261,95.15844084513768,98.7723473856812,99.38984664872842,101.8143619580135,96.96533133944334,79540,66209.73333333334,58.946935609366335,49.78460535355442,NaN,NaN,NaN,NaN,0.532857707625095,21.39305637149898,40667023,0.1806528440771579,0.04972113141900536,-0.13093171265815254
2025-09-05T13:20:00-04:00,99.62,99.9,99.37,99.9,97.87629982021699,NaN,NaN,NaN,NaN,NaN,99.18860000000015,103.08890103453385,95.28829896546645,98.77287790854497,99.39398843163838,101.80368395936338,96.98429290391337,61198,65035.433333333334,61.6014143737928,50.603863111380974,NaN,NaN,NaN,NaN,0.532653585651874,21.148126049810266,40728221,0.2035394843181842,0.12349264273957772,-0.08004684157860649
2025-09-05T13:25:00-04:00,99.87,99.92,99.65,99.76,98.06942255566166,NaN,NaN,NaN,NaN,NaN,99.11340000000014,102.8167722146178,95.41002778538248,98.88330232683597,99.39730913423247,101.7967892926794,96.99782897578554,43133,63633.03333333333,59.52881390471406,51.36072884924193,NaN,NaN,NaN,NaN,0.5138926152481684,20.961510694801593,40685088,0.19900980977295102,0.16871542063758227,-0.030294389135368735
2025-09-05T13:30:00-04:00,99.75,99.94,99.58,99.94,98.07331243949521,NaN,NaN,NaN,NaN,NaN,99.04380000000013,102.54615724048794,95.54144275951232,98.93064186146877,99.40039254837905,101.79137549088473,97.00940960587336,36526,57558.3,61.33027601991669,52.067556175974794,NaN,NaN,NaN,NaN,0.5029002855875849,20.571597766488566,40721614,0.1975016420962034,0.21658266348488553,0.019081021388682125
2025-09-05T13:35:00-04:00,99.88,99.93,99.57,99.585,98.08952551042725,NaN,NaN,NaN,NaN,NaN,98.97740000000015,102.30600225319768,95.64879774680261,98.93751348917503,99.4045914038084,101.77873142800257,97.03045137961422,72396,55784.36666666667,56.03287736648384,52.85535574752107,NaN,NaN,NaN,NaN,0.4934074080456149,20.177188511865683,40649218,0.16337376069477946,0.22329822225715645,0.059924461562377
2025-09-05T13:40:00-04:00,99.6,99.65,99.01,99.22,98.08952551042725,NaN,NaN,NaN,NaN,NaN,98.87680000000015,101.84661397396964,95.90698602603065,98.93751348917503,99.40358737859533,101.76701407874066,97.04016067845001,46257,54949.2,51.14171355931264,53.39691367145752,NaN,NaN,NaN,NaN,0.5038783074709282,19.232512709160382,40602961,0.10957897613039715,0.19689818172537343,0.08731920559497629
2025-09-05T13:45:00-04:00,99.22,99.46,99.1,99.2,98.08952551042725,NaN,NaN,NaN,NaN,NaN,98.78700000000013,101.4218707748196,96.15212922518067,98.93751348917503,99.40266120084237,101.75882181682316,97.04650058486159,31792,53983.8,50.87963284342045,53.72112107998421,NaN,NaN,NaN,NaN,0.493601285508719,18.355313749505463,40571169,0.06804471053818892,0.17237509376771243,0.10433038322952351
2025-09-05T13:50:00-04:00,99.19,99.4,99.11,99.14,98.08952551042725,NaN,NaN,NaN,NaN,NaN,98.70240000000014,100.99228492286896,96.41251507713132,98.93751348917503,99.40170280307086,101.7518228640213,97.05158274212042,26714,51592.13333333333,50.050969320907356,53.89513986687443,NaN,NaN,NaN,NaN,0.4790583365438109,17.54077185839732,40544455,0.03366460133441948,0.14641113489754787,0.11274653356312839
2025-09-05T13:55:00-04:00,99.16,99.59,99.15,99.425,98.08952551042725,NaN,NaN,NaN,NaN,NaN,98.63850000000015,100.64877485682615,96.62822514317415,98.93751348917503,99.401623668693,101.74477840836275,97.05846892902326,30869,50109.23333333333,53.892335190401226,54.45072902361822,NaN,NaN,NaN,NaN,0.4769827410763961,16.363980438276606,40575324,0.027511206471783803,0.14713554165285814,0.11962433518107433
2025-09-05T14:00:00-04:00,99.43,99.67,99.43,99.52,98.08952551042725,NaN,NaN,NaN,NaN,NaN,98.58810000000015,100.36787289561835,96.80832710438196,98.93751348917503,99.40241062755975,101.73891617019825,97.06590508492124,29829,48079.53333333333,55.13104060179551,55.030569324689544,NaN,NaN,NaN,NaN,0.4604125452852253,15.503556593213105,40605153,0.027184280712695547,0.15360468607194377,0.12642040535924823
2025-09-05T14:05:00-04:00,99.54,99.85,99.54,99.8,98.16182226693267,NaN,NaN,NaN,NaN,NaN,98.56960000000015,100.27793584519688,96.86126415480342,98.93751348917503,99.40386395937246,101.73528250676927,97.07244541197565,23373,46690.63333333333,58.65654143361208,55.501799713431915,NaN,NaN,NaN,NaN,0.45109736347913765,15.208828690786067,40628526,0.04227072023047046,0.17925880564733632,0.13698808541686586
2025-09-05T14:10:00-04:00,99.8,100.05,99.77,100.03,98.40833034570846,NaN,NaN,NaN,NaN,NaN,98.57460000000016,100.29846987907507,96.85073012092525,99.17400001288503,99.40777420714328,101.73128776853437,97.08426064575218,37993,46029.9,61.343447199178904,56.440541622980035,NaN,NaN,NaN,NaN,0.4388761232306279,15.448663974597853,40666519,0.06293987569581055,0.21566293003662906,0.1527230543408185
2025-09-05T14:15:00-04:00,100.03,100.07,99.81,99.91,98.47113351181264,NaN,NaN,NaN,NaN,NaN,98.59340000000014,100.35421508398414,96.83258491601615,99.23920001030802,99.41238130830313,101.7261384833019,97.09862413330436,47230,45178.26666666667,59.18234217613646,56.78574318616761,NaN,NaN,NaN,NaN,0.4260992572855824,15.72174320131275,40619289,0.06354502303392412,0.23215433313322364,0.16860931009929953
2025-09-05T14:20:00-04:00,99.93,100.02,99.82,99.94,98.49062744309387,NaN,NaN,NaN,NaN,NaN,98.62000000000015,100.42074540121317,96.81925459878713,99.25536000824643,99.41509139117551,101.72304459030657,97.10713819204445,28361,44873.53333333333,59.56585566572198,56.948871090340006,NaN,NaN,NaN,NaN,0.4099493103366124,15.975316768976583,40647650,0.06097053357022983,0.24482247706208682,0.183851943491857
2025-09-05T14:25:00-04:00,99.93,100.37,99.88,100.36,98.69378074113507,NaN,NaN,NaN,NaN,NaN,98.68200000000016,100.50451145400478,96.85948854599553,99.51328800659714,99.41979712765199,101.72165191344342,97.11794234186056,32323,43050.7,64.58300464531584,57.351447450050685,NaN,NaN,NaN,NaN,0.4156672167411407,17.072807921760912,40679973,0.0812879930606093,0.2854619348176186,0.20417394175700931
2025-09-05T14:30:00-04:00,100.37,100.5,100.26,100.39,98.98110888926529,NaN,NaN,NaN,NaN,NaN,98.73360000000015,100.5999997856792,96.8672002143211,99.6946304052777,99.42646371962195,101.72173158632862,97.13119585291528,37722,41637,64.91785558334195,57.58833610787563,NaN,NaN,NaN,NaN,0.4031195584024875,18.368624286688657,40717695,0.08981444719721302,0.3164420007535256,0.22662755355631256
2025-09-05T14:35:00-04:00,100.42,100.59,100.33,100.35,99.0892403033896,NaN,NaN,NaN,NaN,NaN,98.78260000000014,100.68714009146258,96.87805990853771,99.81570432422217,99.43386399848971,101.72219700522041,97.14553099175902,40776,41297.03333333333,64.04835237765553,57.9111602845143,NaN,NaN,NaN,NaN,0.3928967328023102,19.758692954997866,40676919,0.08583161503265721,0.3339170723471341,0.24808545731447687
2025-09-05T14:40:00-04:00,100.415,100.45,100.26,100.355,99.0892403033896,NaN,NaN,NaN,NaN,NaN,98.82510000000013,100.77276885275444,96.87743114724583,99.81570432422217,99.43821408050954,101.7220106401159,97.15441752090318,26063,40837.26666666667,64.11305742780618,58.109930385077845,NaN,NaN,NaN,NaN,0.3784041090307165,20.72746613779273,40702982,0.07689315846225547,0.3442019053922962,0.26730874693004075
2025-09-05T14:45:00-04:00,100.35,100.44,100.19,100.24,99.0892403033896,NaN,NaN,NaN,NaN,NaN,98.86390000000011,100.8451847246168,96.88261527538343,99.81570432422217,99.44447301937329,101.72102602113695,97.16792001760963,40853,41355.433333333334,61.37692552911114,58.49164811097979,NaN,NaN,NaN,NaN,0.36923238695709387,21.303022004722248,40662129,0.057483806464052045,0.33916350501010584,0.2816796985460538
2025-09-05T14:50:00-04:00,100.24,100.4,99.89,99.91,99.0892403033896,NaN,NaN,NaN,NaN,NaN,98.90070000000014,100.88997022799624,96.91142977200404,99.81570432422217,99.4484249544869,101.71827480451344,97.17857510446035,35539,41548.73333333333,54.225466992517994,58.71191621335161,NaN,NaN,NaN,NaN,0.37928721646015895,20.588943295670454,40626590,0.01867715542732895,0.305026142830215,0.28634898740288606
2025-09-05T14:55:00-04:00,99.93,100.14,99.92,100.14,99.0892403033896,NaN,NaN,NaN,NaN,NaN,98.95790000000014,100.92178501699757,96.9940149830027,99.81570432422217,99.45109998296438,101.71639736147871,97.18580260445005,24315,40728.933333333334,57.90676034317025,59.21385389190516,NaN,NaN,NaN,NaN,0.36862384385586217,19.925870208693787,40650905,0.005442284636355654,0.29315184319833065,0.287709558561975
2025-09-05T15:00:00-04:00,100.14,100.32,99.98,100.3,99.0892403033896,NaN,NaN,NaN,NaN,NaN,99.00630000000014,100.98079316027795,97.03180683972232,99.81570432422217,99.45561734257078,101.71481659229467,97.19641809284688,34103,38810.63333333333,60.29874074027229,59.945837564716946,NaN,NaN,NaN,NaN,0.3665792835804426,19.856863001620024,40685008,0.004449463557372635,0.2932713880086908,0.28882192445131816
2025-09-05T15:05:00-04:00,100.3,100.605,100.29,100.51,99.18548096114625,NaN,NaN,NaN,NaN,NaN,99.07590000000013,101.01179120561939,97.14000879438088,99.8220334343689,99.46316982045416,101.71561494457028,97.21072469633803,42480,38446.066666666666,63.25049848964939,60.61427780037752,NaN,NaN,NaN,NaN,0.36289504903898223,20.5352858680766,40727488,0.01436250935488026,0.3067750611449185,0.2924125517900382
2025-09-05T15:10:00-04:00,100.5,100.72,100.43,100.72,99.33080000836688,NaN,NaN,NaN,NaN,NaN,99.16930000000013,100.95718703222165,97.38141296777862,99.94862674749513,99.47046872101554,101.71769031044315,97.22324713158793,36063,38778.8,65.97483850004743,61.38883479310981,NaN,NaN,NaN,NaN,0.3576882598219115,21.431665818438244,40763551,0.03055874792351998,0.3306109866944382,0.30005223877091824
2025-09-05T15:15:00-04:00,100.69,100.87,100.55,100.63,99.47871818980475,NaN,NaN,NaN,NaN,NaN,99.24650000000014,100.9443989958134,97.54860100418688,100.0929013979961,99.47963114776098,101.72081032515426,97.2384519703677,43633,39306.26666666667,63.79218288212079,61.75566632514614,NaN,NaN,NaN,NaN,0.35499624126320406,22.59401680274535,40719918,0.03062918769344264,0.33833872338772153,0.3077095356942789
2025-09-05T15:20:00-04:00,100.65,100.92,100.65,100.91,99.57014009026815,NaN,NaN,NaN,NaN,NaN,99.32110000000013,100.97649879183146,97.6657012081688,100.15332111839687,99.49037058665316,101.72581002726072,97.25493114604559,46419,39926.433333333334,67.40509057381055,62.18864085190556,NaN,NaN,NaN,NaN,0.3503536526015471,23.78095765731381,40766337,0.04413132211396398,0.36287368833673384,0.31874236622276986
2025-09-05T15:25:00-04:00,100.9,101.25,100.87,101.22,99.84854281343779,NaN,NaN,NaN,NaN,NaN,99.39670000000015,101.04681103868015,97.74658896132016,100.4466568947175,99.51090609251604,101.73955281660191,97.28225936843016,74614,41800.26666666667,70.87065222417813,63.0235201410514,NaN,NaN,NaN,NaN,0.3524712488442934,25.52002776051996,40840951,0.0671583240333532,0.40269027126446133,0.33553194723110813
2025-09-05T15:30:00-04:00,101.25,101.25,100.83,100.93,99.84854281343779,NaN,NaN,NaN,NaN,NaN,99.45610000000013,101.10888708852124,97.80331291147903,100.4466568947175,99.52580987416628,101.74826042249546,97.3033593258371,59482,42240,64.01389045995222,63.34123691206785,NaN,NaN,NaN,NaN,0.35729473106970117,26.9360926771521,40781469,0.05650454918694203,0.40616263371478567,0.34965808452784364
2025-09-05T15:35:00-04:00,100.94,101.14,100.65,100.86,99.84854281343779,NaN,NaN,NaN,NaN,NaN,99.51150000000013,101.16310679339709,97.85989320660316,100.4466568947175,99.5354195995239,101.75291254843086,97.31792665061695,42465,42389.86666666667,62.44344022789136,63.18841088225181,NaN,NaN,NaN,NaN,0.36677367885043644,27.384643813285365,40739004,0.03920990519339007,0.3986704660195812,0.35946056082619116
2025-09-05T15:40:00-04:00,100.87,101.05,100.76,100.86,99.84854281343779,NaN,NaN,NaN,NaN,NaN,99.56570000000015,101.21289034722093,97.91850965277936,100.4466568947175,99.54544874852787,101.75776716496635,97.3331303320894,44746,41893.566666666666,62.44344022789136,63.011666928291056,NaN,NaN,NaN,NaN,0.3612898446468332,27.801155582551967,40739004,0.023037376051549097,0.3882572808906275,0.3652199048390784
2025-09-05T15:45:00-04:00,100.85,101.1,100.8,101.06,99.84854281343779,NaN,NaN,NaN,NaN,NaN,99.61390000000014,101.29184432564975,97.93595567435054,100.4466568947175,99.55834399503328,101.7649203702727,97.35176761979386,54563,41061,65.26697948867584,63.09871172193535,NaN,NaN,NaN,NaN,0.35691199860063066,28.312804513462662,40793567,0.02112698338477348,0.3916286340700452,0.37050165068527174
2025-09-05T15:50:00-04:00,101.06,101.19,100.83,101.14,99.84854281343779,NaN,NaN,NaN,NaN,NaN,99.65990000000015,101.37612782869232,97.94367217130798,100.4466568947175,99.58090410060797,101.77833947568944,97.3834687255265,93434,42135.53333333333,66.35654486245227,63.258960824410075,NaN,NaN,NaN,NaN,0.35713257012915706,29.012273189781425,40887001,0.020549695170642313,0.39618876964857463,0.3756390744779323
2025-09-05T15:55:00-04:00,101.145,101.34,101.05,101.25,100.01966062549307,NaN,NaN,NaN,NaN,NaN,99.70890000000014,101.46359460590178,97.95420539409851,100.50100362500883,99.61014965895976,101.79855088575306,97.42174843216645,112948,44462.7,67.84995701033185,63.72132021592584,NaN,NaN,NaN,NaN,0.35233738654850344,30.01446399919375,40999949,0.022705926405466315,0.4040214824847652,0.3813155560792989
2025-09-08T09:30:00-04:00,110.6,112.93,110.12,112.81,108.81035786978886,NaN,NaN,NaN,NaN,NaN,99.99390000000014,104.0410670536289,95.94673294637138,106.41880290000707,111.95333333333333,111.95333333333333,111.95333333333333,1198816,83205.7,94.66279521784897,66.60970080344948,NaN,NaN,NaN,NaN,1.1614561446521823,34.48078409296836,42198765,0.7571229407825072,1.327719232057433,0.5705962912749257
2025-09-08T09:35:00-04:00,112.87,113.52,112.25,112.69,110.12056887570753,NaN,NaN,NaN,NaN,NaN,100.26990000000012,105.64322727088175,94.89657272911849,107.67604232000565,112.21944401413471,112.61921189961045,111.81967612865897,531204,98499.3,93.78837869916852,69.17267354316364,NaN,NaN,NaN,NaN,1.1692092771770262,38.65230479393196,41667561,1.1648915246015223,2.0267106970268287,0.8618191724253064
2025-09-08T09:40:00-04:00,112.65,113.48,112.29,113.195,110.12056887570753,NaN,NaN,NaN,NaN,NaN,100.56400000000014,107.01674205280122,94.11125794719905,108.20983385600452,112.3719015176687,112.84318230832505,111.90062072701235,427873,111219.83333333333,94.03796920402355,71.58261843343159,NaN,NaN,NaN,NaN,1.1706943288072384,42.52585973054103,42095434,1.3837783138771729,2.5915420647717724,1.2077637508945995
2025-09-08T09:45:00-04:00,113.26,115.08,113.21,114.98,111.21422701278311,NaN,NaN,NaN,NaN,NaN,100.89060000000013,108.47636446773748,93.30483553226279,109.9213670848036,112.8305063721781,113.78073332920104,111.88027941515517,621298,130870.03333333334,94.82889852351187,73.83821843585034,NaN,NaN,NaN,NaN,1.2217161624638646,46.18635329282368,42716732,1.551335945394101,3.1469336826372256,1.5955977372431247
2025-09-08T09:50:00-04:00,114.99,115.65,114.67,115.61,112.22880760311115,NaN,NaN,NaN,NaN,NaN,101.22400000000015,109.83374285330147,92.61425714669882,111.03309366784289,113.17130902205982,114.3991918685494,111.94342617557024,442867,144741.8,95.07712564109664,75.91695323163958,NaN,NaN,NaN,NaN,1.2044507222878746,49.60575896922386,43159599,1.6006925971869692,3.5964634837268363,1.9957708865398671
2025-09-08T09:55:00-04:00,115.6,115.77,114.71,115.43,112.29749816660609,NaN,NaN,NaN,NaN,NaN,101.55620000000016,111.00970423070568,92.10269576929464,111.5464749342743,113.39054440671806,114.72171358055375,112.05937523288237,369298,156022.76666666666,93.69326870911215,78.05274507642467,NaN,NaN,NaN,NaN,1.1941328135530267,52.785284097512765,42790301,1.5180351976691941,3.89331488362636,2.3752796859571657
2025-09-08T10:00:00-04:00,115.425,115.71,114.87,115.435,112.36670279539672,NaN,NaN,NaN,NaN,NaN,101.88370000000015,112.0744273165352,91.69297268346509,111.91117994741944,113.55270659827963,114.93619660365329,112.16921659290597,326150,165900.13333333333,93.69601352112272,79.93066814408984,NaN,NaN,NaN,NaN,1.1688376125849527,55.73770028806675,43116451,1.3653133443185212,4.081921366355317,2.716608022036796
2025-09-08T10:05:00-04:00,115.4,115.68,114.9,115.04,112.39321630469689,NaN,NaN,NaN,NaN,NaN,102.21630000000016,113.00009169123562,91.4325083087647,112.25094395793558,113.65064355573722,115.04817683307786,112.25311027839658,246570,173340.03333333333,90.35059045003123,81.32209230307933,NaN,NaN,NaN,NaN,1.1410634974003133,58.47922960786688,42869881,1.1480434897797056,4.151662384261428,3.0036188944817224
2025-09-08T10:10:00-04:00,115.01,115.21,114.51,114.965,112.39321630469689,NaN,NaN,NaN,NaN,NaN,102.55060000000016,113.8460399011269,91.25516009887342,112.25094395793558,113.7149935404283,115.10352914552102,112.32645793533557,227082,179643,89.69572731758511,83.15650922148168,NaN,NaN,NaN,NaN,1.1095589618717188,60.46956934974009,42642799,0.9195108724781873,4.153007485079456,3.233496612601269
2025-09-08T10:15:00-04:00,114.94,115.25,114.32,114.46,112.39321630469689,NaN,NaN,NaN,NaN,NaN,102.87000000000016,114.58351885643086,91.15648114356947,112.31040413307876,113.75523741907676,115.12798255368433,112.3824922844692,191786,184461.53333333333,85.21694156983853,84.78318788876363,NaN,NaN,NaN,NaN,1.096733321738025,62.043793852089465,42451013,0.6663616843863016,4.066448718084146,3.4000870336978446
2025-09-08T10:20:00-04:00,114.46,115.55,114.27,115.29,112.39321630469689,NaN,NaN,NaN,NaN,NaN,103.20380000000016,115.35463183325184,91.05296816674847,112.55832330646301,113.81432348466998,115.18171609843063,112.44693087090934,221532,190900.56666666668,86.41738911683467,86.49561280940245,NaN,NaN,NaN,NaN,1.1098237987567376,63.5478199693032,42672545,0.4947316135009481,4.01850155057403,3.5237699370730815
2025-09-08T10:25:00-04:00,115.31,116.33,115.31,116.31,112.90806779827946,NaN,NaN,NaN,NaN,NaN,103.56080000000014,116.17327102831081,90.94832897168948,113.41665864517041,113.94969358442252,115.37389960961971,112.52548755922533,319812,200483.53333333333,87.73545494505285,88.10050391342936,NaN,NaN,NaN,NaN,1.1048363845598272,65.04882035625299,42992357,0.39419104061825205,4.016508737845896,3.6223176972276443
2025-09-08T10:30:00-04:00,116.32,116.57,116.02,116.05,113.44042835290311,NaN,NaN,NaN,NaN,NaN,103.91120000000015,116.91262293135546,90.90977706864484,113.96432691613633,114.03373852817676,115.49532574710307,112.57215130925044,197592,205812.53333333333,85.45894665199054,89.46496118411066,NaN,NaN,NaN,NaN,1.065205214234125,66.47332939661166,42794765,0.26089344001227266,3.9484344972429852,3.6875410572307126
2025-09-08T10:35:00-04:00,116.06,116.12,115.685,115.99,113.44042835290311,NaN,NaN,NaN,NaN,NaN,104.25220000000016,117.60385310513908,90.90054689486124,113.96432691613633,114.08539944331044,115.55966856786239,112.61113031875848,148913,209417.1,84.91139804103406,90.68363554344653,NaN,NaN,NaN,NaN,1.0201905560745448,67.26493398392807,42645852,0.1262209533664569,3.845317248938784,3.719096295572327
2025-09-08T10:40:00-04:00,115.98,116.59,115.93,116.46,113.51241509014521,NaN,NaN,NaN,NaN,NaN,104.60900000000017,118.28898947367904,90.92901052632129,114.41836922632726,114.13420568772874,115.62857691679618,112.6398344586613,121785,212607.83333333334,85.68511869178005,90.04237293444162,NaN,NaN,NaN,NaN,0.9944626592120771,68.09178697713263,42767637,0.03128214781132854,3.7581989803364877,3.726916832525159
2025-09-08T10:45:00-04:00,116.47,116.52,115.9,116.15,113.51241509014521,NaN,NaN,NaN,NaN,NaN,104.94880000000016,118.91162572547431,90.98597427452601,114.4726953810618,114.17929799497422,115.68755201638159,112.67104397356685,125420,215426.73333333334,82.67383421455324,89.24847689982623,NaN,NaN,NaN,NaN,0.9677153264112137,68.80949866834243,42642217,-0.08362458325973154,3.622386103450495,3.7060106867102265
2025-09-08T10:50:00-04:00,116.14,116.45,115.94,116.37,113.5412707742852,NaN,NaN,NaN,NaN,NaN,105.28720000000015,119.51811721007364,91.05628278992667,114.55715630484944,114.2186313110638,115.73906560900201,112.6981970131256,110536,217926.63333333333,83.12702768812595,88.46912393440498,NaN,NaN,NaN,NaN,0.9350213745246988,69.47594523875152,42752753,-0.17100926331992028,3.492249107560326,3.6632583708802464
2025-09-08T10:55:00-04:00,116.38,116.4,115.81,115.81,113.5412707742852,NaN,NaN,NaN,NaN,NaN,105.61100000000015,120.04667081918852,91.17532918081177,114.59072504387956,114.2594942534478,115.78602104909979,112.73296745779581,136318,221660.06666666668,77.56543184698666,87.23601917179603,NaN,NaN,NaN,NaN,0.9103769906300777,69.84893315982063,42616435,-0.2859508187471791,3.3058198474462728,3.591770666193452
2025-09-08T11:00:00-04:00,115.8,115.93,115.19,115.52,113.5412707742852,NaN,NaN,NaN,NaN,NaN,105.92340000000014,120.526277721873,91.32052227812729,114.59072504387956,114.28628805314459,115.8079802569355,112.76459584935368,126804,224750.1,74.77539125376396,85.78589528698657,NaN,NaN,NaN,NaN,0.8982072055850728,69.06873738160706,42489631,-0.39425655453313535,3.0989499730270325,3.493206527560168
2025-09-08T11:05:00-04:00,115.51,115.79,115.15,115.63,113.5412707742852,NaN,NaN,NaN,NaN,NaN,106.24080000000015,120.983239195736,91.4983608042643,114.59072504387956,114.30849284999077,115.82538397602272,112.79160172395882,111343,227045.53333333333,75.14065897064519,84.46070887709607,NaN,NaN,NaN,NaN,0.8797638337575676,68.27350906985853,42600974,-0.46629986552372227,2.9103316956555147,3.376631561179237
2025-09-08T11:10:00-04:00,115.63,115.63,115.01,115.27,113.5412707742852,NaN,NaN,NaN,NaN,NaN,106.54740000000014,121.39023022068147,91.7045697793188,114.59072504387956,114.3250261339255,115.83462661658493,112.81542565126608,104830,229337.76666666666,71.49195584434585,82.8747047573263,NaN,NaN,NaN,NaN,0.8612092742034549,67.27611597920763,42496144,-0.5407694720424265,2.7006697211262036,3.24143919316863
2025-09-08T11:15:00-04:00,115.28,115.685,115.17,115.21,113.5412707742852,NaN,NaN,NaN,NaN,NaN,106.85990000000017,121.76104874631991,91.95875125368042,114.59072504387956,114.34017380685125,115.84375304386367,112.83659456983884,94153,231021.76666666666,70.8742447431896,81.4835372068376,NaN,NaN,NaN,NaN,0.8364800403317796,66.3813563940804,42401991,-0.5924781916055957,2.5008414536616357,3.0933196452672314
2025-09-08T11:20:00-04:00,115.25,115.84,115.1,115.79,113.5412707742852,NaN,NaN,NaN,NaN,NaN,107.19130000000015,122.13503511676255,92.24756488323776,114.59072504387956,114.35631783586882,115.85662940968801,112.85600626204963,84692,232297.53333333333,73.27783937086961,80.31083092492936,NaN,NaN,NaN,NaN,0.8295886088795102,65.64218654945269,42486683,-0.585016489164595,2.3620490338114877,2.9470655229760827
2025-09-08T11:25:00-04:00,115.76,115.84,115.44,115.59,113.5412707742852,NaN,NaN,NaN,NaN,NaN,107.51910000000017,122.46632685851642,92.5718731414839,114.59072504387956,114.37120247634594,115.86891032888121,112.87349462381067,77110,232380.73333333334,71.09895622580859,79.3024034003558,NaN,NaN,NaN,NaN,0.7989037082452599,64.95581455086982,42409573,-0.589303474167088,2.210436180267223,2.799739654434311
2025-09-08T11:30:00-04:00,115.58,115.9,115.43,115.61,113.5412707742852,NaN,NaN,NaN,NaN,NaN,107.84850000000014,122.76848126674358,92.92851873325671,114.59072504387956,114.38677618717254,115.88188851183347,112.89166386251162,81136,233102.53333333333,71.1912072140156,78.21481897872584,NaN,NaN,NaN,NaN,0.7754105862277412,64.35795700412493,42490709,-0.5853465501501711,2.0680564667465973,2.6534030168967684
2025-09-08T11:35:00-04:00,115.61,116.03,115.56,115.95,113.5412707742852,NaN,NaN,NaN,NaN,NaN,108.17900000000016,123.07004549720949,93.28795450279083,114.61748052857777,114.40572399820486,115.90026439200582,112.9111836044039,87378,234599.63333333333,72.78177057627356,77.14669866667019,NaN,NaN,NaN,NaN,0.7535955443543311,63.891190275213425,42578087,-0.5546741565535576,1.9600603212048213,2.514734477758379
2025-09-08T11:40:00-04:00,115.97,116.2,115.69,116.18,113.6529901040893,NaN,NaN,NaN,NaN,NaN,108.51220000000016,123.35882132068944,93.66557867931088,114.81498442286221,114.42594365517834,115.92194821983874,112.92993909051795,85217,235948.66666666666,73.83420128822684,76.31635971211563,NaN,NaN,NaN,NaN,0.7361958626147364,63.574023201694665,42663304,-0.5146206501632018,1.8714586650543765,2.3860793152175783
2025-09-08T11:45:00-04:00,116.19,116.28,115.75,115.91,113.75489964481251,NaN,NaN,NaN,NaN,NaN,108.83440000000014,123.60981588450123,94.05898411549906,114.90698753828977,114.4417670565677,115.9382903999392,112.94524371319619,70130,236467.56666666668,70.39319903896622,75.27934549768223,NaN,NaN,NaN,NaN,0.7214675867136838,63.33506931792595,42593174,-0.5015228223564061,1.7591757872720706,2.2606986096284767
2025-09-08T11:50:00-04:00,115.93,116.19,115.77,115.82,113.76535875186647,NaN,NaN,NaN,NaN,NaN,109.15020000000017,123.83408531145422,94.46631468854612,114.90698753828977,114.45551601825751,115.9518689858976,112.95916305061742,64370,235498.76666666666,69.23491265106476,74.10433078048827,NaN,NaN,NaN,NaN,0.6999341876627065,63.11318356871215,42528804,-0.4933766499973098,1.6439777971318392,2.137354447129149
2025-09-08T11:55:00-04:00,115.815,116.18,115.66,116.18,113.76535875186647,NaN,NaN,NaN,NaN,NaN,109.47560000000016,124.04666346702122,94.9045365329791,114.90698753828977,114.46888706269583,115.96566124042847,112.97211288496318,60448,233748.76666666666,71.2712365503152,73.28985951875698,NaN,NaN,NaN,NaN,0.6870817456867996,62.56744747738928,42589252,-0.45891866125618375,1.563706120558919,2.022624781815103
2025-09-08T12:00:00-04:00,116.19,116.35,115.94,116.03,114.00351902804363,NaN,NaN,NaN,NaN,NaN,109.79740000000017,124.22183305506157,95.37296694493877,115.09961761960435,114.49137321787099,115.99000448385456,112.99274195188741,97619,197042.2,69.21550896181252,72.2961796097346,NaN,NaN,NaN,NaN,0.6672901924234564,62.21041229022004,42491633,-0.44127632054862076,1.471029381129327,1.9123057016779477
2025-09-08T12:05:00-04:00,116.02,116.08,115.79,115.91,114.00351902804363,NaN,NaN,NaN,NaN,NaN,110.10840000000016,124.37519129166577,95.84160870833455,115.09961761960435,114.50373794560576,116.00178397809555,113.00569191311598,61784,181394.86666666667,67.5372110157771,71.57987812179105,NaN,NaN,NaN,NaN,0.6403408929646376,61.3969899224447,42429849,-0.43217825499765183,1.3720828829308829,1.8042611379285347
2025-09-08T12:10:00-04:00,115.9,116.23,115.73,116.23,114.00351902804363,NaN,NaN,NaN,NaN,NaN,110.42520000000017,124.51711327818725,96.3332867218131,115.09961761960435,114.51643923599656,116.01494290738876,113.01793556460436,58887,169095.33333333334,69.65055328753326,71.21381826706029,NaN,NaN,NaN,NaN,0.6303165434671635,60.79649768831723,42488736,-0.3998477174711639,1.30445149108958,1.7042992085607438
2025-09-08T12:15:00-04:00,116.21,116.35,116.03,116.33,114.18271550701654,NaN,NaN,NaN,NaN,NaN,110.74480000000018,124.6315564189746,96.85804358102577,115.25700422123744,114.53531195370273,116.03630721705626,113.0343166903492,80209,151059.03333333333,70.30121814742755,70.86814392254475,NaN,NaN,NaN,NaN,0.6081510760766513,60.361744049198784,42568945,-0.3677788890099032,1.2445755972983648,1.612354486308268
2025-09-08T12:20:00-04:00,116.34,116.67,116.34,116.39,114.54259207487942,NaN,NaN,NaN,NaN,NaN,111.06550000000017,124.71629620388264,97.4147037961177,115.62560337698994,114.56826373628193,116.077271104529,113.05925636803487,126901,140526.83333333334,70.7070126621681,70.81207655238919,NaN,NaN,NaN,NaN,0.5889974277854622,60.26561249607193,42695846,-0.3392696597703817,1.188267411595291,1.5275370713656726
2025-09-08T12:25:00-04:00,116.39,116.77,116.34,116.69,114.62315607147582,NaN,NaN,NaN,NaN,NaN,111.39450000000016,124.77608275391793,98.0129172460824,115.71948270159196,114.59345926249415,116.10984337259562,113.07707515239268,93395,131330.06666666668,72.71450570702072,70.9435237640914,NaN,NaN,NaN,NaN,0.5776404686579285,60.26711084318164,42789241,-0.2983965157700834,1.1545414266530685,1.4529379424231519
2025-09-08T12:30:00-04:00,116.72,116.725,116.14,116.19,114.62315607147582,NaN,NaN,NaN,NaN,NaN,111.72010000000019,124.75585628645794,98.68434371354243,115.71948270159196,114.60935445391026,116.12801408941827,113.09069481840224,68708,122748.66666666667,64.74992221253423,70.33438682421031,NaN,NaN,NaN,NaN,0.578166149468076,59.55180988799207,42720533,-0.3022905723100311,1.075074727035613,1.377365299345644
2025-09-08T12:35:00-04:00,116.2,116.28,115.77,115.93,114.62315607147582,NaN,NaN,NaN,NaN,NaN,112.03590000000017,124.69378239635468,99.37801760364566,115.71948270159196,114.6258425084941,116.14287839703178,113.10880661995643,91634,117584.13333333333,61.00782080355232,69.61359143690628,NaN,NaN,NaN,NaN,0.5732971387917852,57.697532772318915,42628899,-0.31803448930772005,0.9798221877109938,1.2978566770187139
2025-09-08T12:40:00-04:00,115.915,116.37,115.9,116.08,114.62315607147582,NaN,NaN,NaN,NaN,NaN,112.35150000000017,124.60357921129885,100.0994207887015,115.71948270159196,114.63778816897863,116.15456878931207,113.1210075486452,62129,112085.7,62.359381779355054,68.98274676300196,NaN,NaN,NaN,NaN,0.5659187717352291,56.10959779803836,42691028,-0.3134902400276356,0.9059938769841693,1.219484117011805
2025-09-08T12:45:00-04:00,116.09,116.1,115.84,115.98,114.62315607147582,NaN,NaN,NaN,NaN,NaN,112.66090000000017,124.47471067902923,100.84708932097111,115.71948270159196,114.64538943208304,116.16118080604986,113.12959805811622,44383,107172.26666666666,60.84520045107008,68.13013461120171,NaN,NaN,NaN,NaN,0.5440674308969978,54.44288762355593,42646645,-0.31170788651285397,0.8298492588707376,1.1415571453835915
2025-09-08T12:50:00-04:00,115.98,116.11,115.92,116.105,114.62315607147582,NaN,NaN,NaN,NaN,NaN,112.9686000000002,124.3145042900912,101.6226957099092,115.71948270159196,114.6515280898159,116.16681691246896,113.13623926716284,34353,100932.96666666666,62.08453116383407,67.29087245945938,NaN,NaN,NaN,NaN,0.5187769001186406,52.91228641145867,42680998,-0.2966806499890293,0.770706332897305,1.0673869828863343
2025-09-08T12:55:00-04:00,116.12,116.15,115.69,116.04,114.62315607147582,NaN,NaN,NaN,NaN,NaN,113.27680000000018,124.08998598008627,102.46361401991409,115.71948270159196,114.6611544316182,116.17499428085691,113.1473145823795,58050,92207.56666666667,61.003238820148155,66.62016101525809,NaN,NaN,NaN,NaN,0.5145785501101668,50.72260414782128,42622948,-0.2855886908727834,0.710401119295355,0.9959898101681384
2025-09-08T13:00:00-04:00,116.03,116.16,115.65,115.82,114.62315607147582,NaN,NaN,NaN,NaN,NaN,113.57500000000019,123.81471230064197,103.3352876993584,115.71948270159196,114.66935535030782,116.18135741537479,113.15735328524086,53598,87407.76666666666,57.36177254115893,65.77207957883624,NaN,NaN,NaN,NaN,0.5142515108165828,48.5590247445104,42569350,-0.286785569718664,0.6375078480198084,0.9242934177384724
2025-09-08T13:05:00-04:00,115.815,115.89,115.41,115.505,114.62315607147582,NaN,NaN,NaN,NaN,NaN,113.86070000000018,123.48418793525119,104.23721206474917,115.71948270159196,114.67734611810201,116.18530562010018,113.16938661610384,68677,84733.23333333334,52.52697445269494,64.4332037147205,NaN,NaN,NaN,NaN,0.5118049743296843,45.79352628326346,42500673,-0.3010311474965339,0.548004483367805,0.849035630864339
2025-09-08T13:10:00-04:00,115.5,115.77,115.28,115.32,114.62315607147582,NaN,NaN,NaN,NaN,NaN,114.14850000000018,123.04087476717658,105.25612523282379,115.71948270159196,114.6853088419262,116.187590413739,113.1830272701134,82716,83430.93333333333,49.868526438396316,63.051276391619346,NaN,NaN,NaN,NaN,0.5102474761632779,42.84273625349235,42417957,-0.31372621306908555,0.45687786452798207,0.7706040775970676
2025-09-08T13:15:00-04:00,115.33,115.69,115.27,115.28,114.62315607147582,NaN,NaN,NaN,NaN,NaN,114.4369000000002,122.4816073010714,106.39219269892898,115.59208616127357,114.69025139427312,116.18861785665746,113.19188493188878,55336,81094.8,49.287685581372955,61.74773886059047,NaN,NaN,NaN,NaN,0.5038012278659011,40.0726723020432,42362621,-0.31481534456138194,0.3770848968953402,0.6919002414567221
2025-09-08T13:20:00-04:00,115.28,115.5,115.18,115.44,114.62315607147582,NaN,NaN,NaN,NaN,NaN,114.72850000000018,121.77911082459721,107.67788917540315,115.20593514321509,114.69474493374784,116.18919543264757,113.20029443484812,53974,79209.4,51.71054173226585,60.466309463785656,NaN,NaN,NaN,NaN,0.49067256873262194,37.22133224840059,42416595,-0.29509194672958794,0.32303530804473723,0.6181272547743252
2025-09-08T13:25:00-04:00,115.43,115.5,114.92,114.97,114.62315607147582,NaN,NaN,NaN,NaN,NaN,115.00670000000018,120.87696119009395,109.13643880990641,115.20593514321509,114.69986380037493,116.18624132894811,113.21348627180174,97642,77920.2,44.92119405537971,58.65345060006795,NaN,NaN,NaN,NaN,0.49705309953743454,35.30005137410239,42318953,-0.3028901457964165,0.2395145725288046,0.5424047183252211
2025-09-08T13:30:00-04:00,114.97,115.05,114.74,115.03,114.62315607147582,NaN,NaN,NaN,NaN,NaN,115.28450000000016,119.61676141869783,110.9522385813025,115.16599849165766,114.7013683442883,116.18320334766797,113.21953334090863,52346,75438.26666666666,45.897761565405716,56.88136123601349,NaN,NaN,NaN,NaN,0.4836921638561894,33.979451987737484,42371299,-0.29301584440236617,0.17613491282226335,0.4691507572246295
2025-09-08T13:35:00-04:00,115.04,115.12,114.77,114.88,114.62315607147582,NaN,NaN,NaN,NaN,NaN,115.55710000000016,117.20845107107547,113.90574892892485,115.16599849165766,114.7024235010302,116.1808110393527,113.22403596270769,39906,73057.03333333334,43.80662570874635,54.816512664708185,NaN,NaN,NaN,NaN,0.4741427235807479,32.507793143572734,42331393,-0.28531625630956003,0.11250543683767944,0.3978216931472395
2025-09-08T13:40:00-04:00,114.84,115.01,114.7,114.85,114.62315607147582,NaN,NaN,NaN,NaN,NaN,115.59790000000015,117.06642863776999,114.12937136223032,115.16479879332613,114.70336636938306,116.17717623971667,113.22955649904945,52779,71322,43.38092513847084,53.29015573084651,NaN,NaN,NaN,NaN,0.4624182433249803,31.33120619918416,42278614,-0.2710749483937689,0.058978007655028364,0.33005295604879725
2025-09-08T13:45:00-04:00,114.83,115.01,114.74,114.94,114.62315607147582,NaN,NaN,NaN,NaN,NaN,115.64290000000015,116.87034953458225,114.41545046541806,115.1168390346609,114.70427683735835,116.17467126389718,113.23388241081952,39977,69516.13333333333,45.10441135437558,52.15419791304817,NaN,NaN,NaN,NaN,0.4486740830874824,30.238661179394764,42318591,-0.2452040158223735,0.023547936270830405,0.2687519520932039
2025-09-08T13:50:00-04:00,114.95,114.98,114.54,114.83,NaN,NaN,NaN,116.2938385924157,116.2938385924157,116.2938385924157,115.67560000000016,116.71282830656604,114.63837169343428,114.81547122772872,114.70527677462063,116.16636925960213,113.24418428963912,108728,70317.33333333333,43.366859102616175,50.797589150423974,NaN,NaN,NaN,NaN,0.4480545057240906,29.7779288332962,42209863,-0.2256047200669909,-0.013253947990534698,0.2123507720764562
2025-09-08T13:55:00-04:00,114.83,115.15,114.72,115.14,NaN,NaN,NaN,116.2938385924157,NaN,NaN,115.67880000000015,116.70838352742818,114.64921647257212,114.66537698218298,114.7079503154581,116.1627465487768,113.25315408213942,77805,70340.5,49.29505885936206,49.972579036730544,NaN,NaN,NaN,NaN,0.4467648981723703,28.661005777979625,42287668,-0.18364617464027994,-0.017206946223893738,0.1664392284163862
2025-09-08T14:00:00-04:00,115.15,115.47,115.13,115.34,NaN,NaN,NaN,116.2938385924157,NaN,NaN,115.67340000000017,116.7071938672333,114.63960613276704,114.59630158574637,114.71086285838392,116.16275971723769,113.25896599953015,41933,69033.73333333334,52.732740015730386,49.30459395472314,NaN,NaN,NaN,NaN,0.4391388340172013,26.7160317647747,42329601,-0.13647419721484613,-0.004153518102171461,0.13232067911267467
2025-09-08T14:05:00-04:00,115.35,115.48,115.12,115.42,NaN,NaN,NaN,116.2938385924157,NaN,NaN,115.67320000000016,116.70718599600443,114.6392140039959,114.54172880809735,114.71414946101231,116.16295905104063,113.265339870984,45771,67646.83333333333,54.07401692115909,48.80964953336677,NaN,NaN,NaN,NaN,0.43348606015882973,24.9099844667987,42375372,-0.09585444197500206,0.012502626643922099,0.10835706861892416
2025-09-08T14:10:00-04:00,115.42,115.76,115.35,115.7,NaN,NaN,NaN,116.2938385924157,NaN,NaN,115.67850000000016,116.7102620849494,114.6467379150509,114.80438304647787,114.72418634472358,116.16785513809852,113.28051755134864,100029,68140.56666666667,58.51151634075151,48.89177409048053,NaN,NaN,NaN,NaN,0.4318084844331998,24.08916496305946,42475401,-0.048488842927914194,0.04774601495903141,0.09623485788694561
2025-09-08T14:15:00-04:00,115.685,115.72,115.3,115.59,NaN,NaN,NaN,116.2938385924157,NaN,NaN,115.68950000000015,116.70540403087111,114.6735959691292,114.80438304647787,114.72825334682038,116.16944545910545,113.28706123453532,44582,67288.96666666666,56.213567616090224,49.1551021735802,NaN,NaN,NaN,NaN,0.43096502125939995,23.141839963383944,42430819,-0.024156435648732516,0.06603931332602997,0.09019574897476249
2025-09-08T14:20:00-04:00,115.58,115.87,115.41,115.84,NaN,NaN,NaN,116.2938385924157,NaN,NaN,115.70700000000015,116.70231703489448,114.71168296510582,114.86040514974583,114.7333421921224,116.1725033696805,113.29418101456429,46565,66695.46666666666,60.05338823509385,49.88259230191574,NaN,NaN,NaN,NaN,0.4330389483123005,22.700117249631273,42477384,0.007493084637987285,0.09956210477224658,0.0920690201342593
2025-09-08T14:25:00-04:00,115.84,115.965,115.56,115.92,NaN,NaN,NaN,116.2938385924157,NaN,NaN,115.73620000000015,116.66704598078401,114.8053540192163,114.95482411979667,114.73863787398369,116.17625557869155,113.30102016927583,44048,66148.8,61.225194104882185,50.735271482166404,NaN,NaN,NaN,NaN,0.4310361662899934,22.555644612864793,42521432,0.031203628345418927,0.13107355556603295,0.09986992722061402
2025-09-08T14:30:00-04:00,115.92,116.13,115.74,115.97,NaN,NaN,NaN,116.2938385924157,NaN,NaN,115.74980000000016,116.67401850226628,114.82558149773405,115.12685929583732,114.74908317097129,116.18483507932679,113.31333126261579,78471,65510.53333333333,61.975950071871125,51.46851493499535,NaN,NaN,NaN,NaN,0.4281050115549939,22.859505779168007,42599903,0.04670958016015095,0.1582569024208027,0.11154732226065175
2025-09-08T14:35:00-04:00,115.98,116.03,115.52,115.73,NaN,NaN,NaN,116.2938385924157,NaN,NaN,115.73820000000016,116.64845657917692,114.8279434208234,115.12685929583732,114.75424272885216,116.18813666954284,113.32034878816148,46557,65002.96666666667,56.337347602097054,52.28395447404658,NaN,NaN,NaN,NaN,0.4339546535867805,22.23665601617567,42553346,0.037646622020733406,0.15860559978656852,0.12095897776583511
2025-09-08T14:40:00-04:00,115.74,116.03,115.69,116.03,NaN,NaN,NaN,116.2938385924157,NaN,NaN,115.73780000000016,116.64752558495677,114.82807441504356,115.12685929583732,114.75921275034955,116.19204687072325,113.32637862997585,39169,64345.7,61.10140412374228,53.36992894249919,NaN,NaN,NaN,NaN,0.4272436069020107,21.658295521968498,42592515,0.0480351765372484,0.18100294843739562,0.13296777190014722
2025-09-08T14:45:00-04:00,116.02,116.25,115.93,116.16,NaN,NaN,NaN,116.2938385924157,NaN,NaN,115.74120000000018,116.65592741290061,114.82647258709974,115.27719195946871,114.76899061646189,116.20123848957957,113.33674274334422,66632,63893.13333333333,62.986088185172115,54.739890547958176,NaN,NaN,NaN,NaN,0.41958334926615226,21.75810830985744,42659147,0.05911249242119038,0.2068583874266352,0.14774589500544483
2025-09-08T14:50:00-04:00,116.18,116.23,115.85,115.85,NaN,NaN,NaN,116.2938385924157,NaN,NaN,115.72900000000018,116.62104484186682,114.83695515813355,115.27719195946871,114.77442598762782,116.20573174933288,113.34312022592276,41719,61053.73333333333,56.01626435759875,55.64241477789589,NaN,NaN,NaN,NaN,0.4167559671757135,21.507317046266117,42617428,0.04182631797645908,0.20002879247601868,0.1582024744995596
2025-09-08T14:55:00-04:00,115.85,116.07,115.77,116.02,NaN,NaN,NaN,116.2938385924157,NaN,NaN,115.72640000000018,116.61426944980722,114.83853055019314,115.27719195946871,114.7802499740128,116.21040647675812,113.35009347126748,46020,59474.566666666666,58.714306091958434,56.61455011629466,NaN,NaN,NaN,NaN,0.40841625523459096,20.933352107211153,42663448,0.03820577510749762,0.2059596933839316,0.167753918276434
2025-09-08T15:00:00-04:00,116.01,116.42,116.01,116.41,114.85744177236461,114.85744177236461,114.85744177236461,NaN,NaN,NaN,115.7272000000002,116.61745650230668,114.83694349769371,115.47532228324798,114.79212296916383,116.22279444755203,113.36145149077562,74336,59662.166666666664,64.14772988043481,58.098898028996,NaN,NaN,NaN,NaN,0.4085293798606914,21.388370924901626,42737784,0.057293187552987346,0.23937040271766818,0.18207721516468084
2025-09-08T15:05:00-04:00,116.43,116.77,116.41,116.56,115.24505805543895,NaN,NaN,NaN,NaN,NaN,115.7422000000002,116.66230468963778,114.82209531036261,115.83425782659837,114.83269722358595,116.27188645203964,113.39350799513227,218042,63875.76666666667,66.0010515831472,59.292183223552065,NaN,NaN,NaN,NaN,0.4050629955849277,22.573507590403167,42955826,0.07416609068263927,0.2747848285179799,0.20061873783534065
2025-09-08T15:10:00-04:00,116.55,116.67,116.34,116.67,115.24505805543895,NaN,NaN,NaN,NaN,NaN,115.76520000000019,116.71882038563272,114.81157961436766,115.83425782659837,114.84924747734433,116.2913754430333,113.40711951165537,92949,64903.1,67.33459838794937,60.335173107282,NaN,NaN,NaN,NaN,0.399701353043147,23.371786744234928,43048775,0.08604473073644467,0.3081746512558965,0.22212992051945182
2025-09-08T15:15:00-04:00,116.67,116.92,116.44,116.49,115.34613760836483,NaN,NaN,NaN,NaN,NaN,115.78240000000018,116.7564497728112,114.80835022718917,115.94912500902296,114.86715268650889,116.31283221981775,113.42147315320003,99282,66733.06666666667,62.981295625512466,60.9714073004501,NaN,NaN,NaN,NaN,0.4054369706829225,24.61225753042307,42949493,0.07546712965561092,0.3164638325889655,0.24099670293335457
2025-09-08T15:20:00-04:00,116.49,116.95,116.49,116.93,115.38404044434823,NaN,NaN,NaN,NaN,NaN,115.81560000000017,116.82985763980781,114.80134236019254,115.94912500902296,114.88069593787424,116.33022241571976,113.43116946002871,69515,67905.13333333333,68.3653399316685,61.675251842658454,NaN,NaN,NaN,NaN,0.4093343299198572,25.821054899817042,43019008,0.0907638337216018,0.3544514950853568,0.263687661363755
2025-09-08T15:25:00-04:00,116.93,117.12,116.81,117.06,115.64749315142332,NaN,NaN,NaN,NaN,NaN,115.85260000000018,116.90985349840528,114.79534650159508,116.1596400057747,114.91739429978158,116.38060719614818,113.45418140341498,174195,71776.63333333333,69.76453855957226,62.64317833862146,NaN,NaN,NaN,NaN,0.40223902063986755,27.26026734134542,43193203,0.10148582756113944,0.3905449458151793,0.28905911825403985
2025-09-08T15:30:00-04:00,117.07,117.1,116.72,116.815,115.64749315142332,NaN,NaN,NaN,NaN,NaN,115.87310000000019,116.96391967340428,114.78228032659611,116.1596400057747,114.93511613423637,116.4034758669355,113.46675640153724,91598,73043.3,64.017764552062,62.926348075547764,NaN,NaN,NaN,NaN,0.40065051916559097,28.1644738181488,43101605,0.08461548636217164,0.39482847620675443,0.3102129898445828
2025-09-08T15:35:00-04:00,116.81,116.91,116.65,116.79,115.64749315142332,NaN,NaN,NaN,NaN,NaN,115.8971000000002,117.01443090885503,114.77976909114535,116.1596400057747,114.94707875142342,116.41816387773969,113.47599362510715,66029,72955.03333333334,63.44346969543902,63.084796332016104,NaN,NaN,NaN,NaN,0.39060405351090527,28.668727193141518,43035576,0.06518220550649712,0.3916907467277042,0.3265085412212071
2025-09-08T15:40:00-04:00,116.75,117.08,116.59,117,115.64749315142332,NaN,NaN,NaN,NaN,NaN,115.92490000000018,117.08077800390409,114.76902199609627,116.1596400057747,114.96245967312153,116.43779251845496,113.4871268277881,81403,72911.26666666666,66.18742268633713,63.38561580447794,NaN,NaN,NaN,NaN,0.39770376397441165,29.510263081557763,43116979,0.060009835986632176,0.4015208362044973,0.3415110002178651
2025-09-08T15:45:00-04:00,116.99,117.09,116.81,117.085,115.67686057382504,NaN,NaN,NaN,NaN,NaN,115.94760000000018,117.14827021279949,114.74692978720087,116.18015654636532,114.98218760870475,116.46380476030987,113.50057045709963,100784,74426.2,67.25867617101997,64.16571070225815,NaN,NaN,NaN,NaN,0.38929635226195375,30.313318766153934,43217763,0.05593309103728522,0.41142736401447166,0.35549427297718644
2025-09-08T15:50:00-04:00,117.05,117.28,116.85,117.24,115.79109418410572,NaN,NaN,NaN,NaN,NaN,115.96880000000017,117.2214429019911,114.71615709800925,116.33712523709225,115.0125126346539,116.5051980102845,113.5198272590233,149176,77599.6,69.17643626461481,64.74249871232048,NaN,NaN,NaN,NaN,0.3922037556718147,31.457838824609034,43366939,0.05709652568836776,0.42686493008764614,0.3697684043992784
2025-09-08T15:55:00-04:00,117.25,117.29,116.94,117.25,115.85127172119184,NaN,NaN,NaN,NaN,NaN,115.99560000000018,117.29839797355854,114.69280202644183,116.3607001896738,115.04979738121904,116.55581978724952,113.54377497518855,186102,80548.26666666666,69.30136721994297,65.19359007194697,NaN,NaN,NaN,NaN,0.3891892016952571,32.54097376515309,43553041,0.05209971844191352,0.4348930524516703,0.3827933340097568
2025-09-09T09:30:00-04:00,116.515,117.65,115.71,116.665,NaN,NaN,NaN,117.83380821980828,117.83380821980828,117.83380821980828,116.01250000000019,117.32761254267724,114.69738745732313,116.3607001896738,116.67500000000001,116.67500000000001,116.67500000000001,344287,90279.63333333333,55.20502661745216,65.13564451907936,NaN,NaN,NaN,NaN,0.49996140157416813,31.212655381308668,43208754,0.005413476041955356,0.389560179062201,0.3841467030202456
2025-09-09T09:35:00-04:00,116.7,117.23,115.87,116.82,NaN,NaN,NaN,117.83380821980828,NaN,NaN,116.02530000000017,117.35901122808346,114.69158877191688,116.3607001896738,116.66307129482132,116.67966076966779,116.64648181997485,178009,94883.06666666667,57.66229402361725,65.06050079991213,NaN,NaN,NaN,NaN,0.561392730033156,29.979216882024556,43386763,-0.017742793863530226,0.36196821069083285,0.3797110045543631
2025-09-09T09:40:00-04:00,116.76,117.2,116.38,116.72,NaN,NaN,NaN,117.83380821980828,NaN,NaN,116.03910000000018,117.3869244544143,114.69127554558605,116.3607001896738,116.6957536020669,116.74581346294046,116.64569374119334,240715,101147.6,55.54528212295217,64.44604024580623,NaN,NaN,NaN,NaN,0.5798646778879312,28.833881132689314,43146048,-0.04117010778573771,0.32824836982219097,0.3694184776079287
2025-09-09T09:45:00-04:00,116.72,116.98,115.46,115.605,NaN,NaN,NaN,117.83380821980828,NaN,NaN,116.03300000000017,117.38585771606819,114.68014228393216,116.3607001896738,116.54915062176046,116.83247797301432,116.2658232705066,209416,106795.56666666667,38.55035475593065,62.48527618671933,NaN,NaN,NaN,NaN,0.6470172008959368,29.48190386957531,42936632,-0.12822030211044,0.20914309996987868,0.3373634020803187
2025-09-09T09:50:00-04:00,115.61,116.32,115.23,115.8,NaN,NaN,NaN,117.60576373074538,NaN,NaN,116.02440000000017,117.37760603011243,114.67119396988791,116.3607001896738,116.46263745460749,116.82315745181337,116.1021174574016,123844,107299.43333333333,41.898497217441886,60.66841181739737,NaN,NaN,NaN,NaN,0.6786588294033692,30.392945735940195,43060476,-0.16669139065534572,0.12899916376113651,0.29569055441648223
2025-09-09T09:55:00-04:00,115.78,116.22,115.59,115.83,NaN,NaN,NaN,117.60576373074538,NaN,NaN,116.01440000000017,117.36581354142089,114.66298645857944,116.3607001896738,116.3821806141944,116.77260376294564,115.99175746544316,175639,110560.56666666667,42.418302085255924,59.1996265645219,NaN,NaN,NaN,NaN,0.6751831987316997,31.238913183279017,43236115,-0.182847309931561,0.06713141700203096,0.24997872693359197
2025-09-09T10:00:00-04:00,115.84,116.24,114.56,114.97,NaN,NaN,NaN,117.37920827532793,NaN,NaN,115.98600000000016,117.36406676178662,114.6079332382137,116.3607001896738,116.15820936919303,116.7274343480325,115.58898439035356,315982,119695.53333333334,33.23811978905515,56.69053941147809,NaN,NaN,NaN,NaN,0.7469558273937207,33.121519617391655,42920133,-0.24055056823416474,-0.05070948335911396,0.18984108487505078
2025-09-09T10:05:00-04:00,115.03,115.66,115.03,115.56,NaN,NaN,NaN,117.32833517190392,NaN,NaN,115.96340000000016,117.33157168511157,114.59522831488876,116.3607001896738,116.08685594627661,116.67051637683593,115.5031955157173,169059,123805.13333333333,42.441470255115796,54.73889167544549,NaN,NaN,NaN,NaN,0.7428875540084547,34.86965416335339,43089192,-0.2281861176434705,-0.09539156217928735,0.13279455546418314
2025-09-09T10:10:00-04:00,115.52,115.64,115.05,115.42,NaN,NaN,NaN,117.31863811863556,NaN,NaN,115.94800000000015,117.32293999867333,114.57306000132697,116.3607001896738,116.05763438784955,116.64658835267285,115.46868042302624,74663,122959.6,40.99725191713467,53.09456934437925,NaN,NaN,NaN,NaN,0.7319670144364225,36.49292195603215,43014529,-0.21861956175426617,-0.14047989672864958,0.07813966502561659
2025-09-09T10:15:00-04:00,115.4,115.44,114.91,115.04,NaN,NaN,NaN,117.13120002233394,NaN,NaN,115.93020000000017,117.32845742977804,114.5319425702223,115.93656015173904,116.02549725335635,116.628513482635,115.4224810240777,65732,123664.6,37.288268463442485,51.22634068495093,NaN,NaN,NaN,NaN,0.7175407991195353,38.13105858023232,42948797,-0.22612612784025682,-0.20451799477470445,0.021608133065552378
2025-09-09T10:20:00-04:00,115.02,115.22,114.73,114.87,NaN,NaN,NaN,116.90910002131876,NaN,NaN,115.90600000000016,117.33460351390357,114.47739648609675,115.17924812139123,115.94362838378039,116.59044319786845,115.29681356969233,154772,127271.5,35.73089059537527,49.05087410702509,NaN,NaN,NaN,NaN,0.701287884896711,39.81571396226112,42794025,-0.23002319283303652,-0.2659208579757433,-0.03589766514270675
2025-09-09T10:25:00-04:00,114.88,115.32,114.79,115.23,NaN,NaN,NaN,116.90910002131876,NaN,NaN,115.89100000000016,117.33187751038581,114.45012248961451,115.14939849711298,115.91672151660791,116.56973623299093,115.26370680022488,68729,128094.2,41.320088585665864,47.19811785092837,NaN,NaN,NaN,NaN,0.6890530359755164,41.00281141568177,42862754,-0.1971059706729923,-0.2822801284839471,-0.08517415781095483
2025-09-09T10:30:00-04:00,115.2,115.52,114.51,114.53,NaN,NaN,NaN,116.90910002131876,NaN,NaN,115.85950000000015,117.3483522424882,114.3706477575121,114.57951879769038,115.87059604473649,116.54502410878207,115.1961679806909,96165,128684,34.95459965289639,44.753700950091336,NaN,NaN,NaN,NaN,0.7119778191201217,42.38407334313358,42766589,-0.21003732098471276,-0.34772080904184577,-0.137683488057133
2025-09-09T10:35:00-04:00,114.56,115.27,114.56,115.23,NaN,NaN,NaN,116.8953935290602,NaN,NaN,115.84330000000017,117.34154111542117,114.34505888457917,113.93269203052185,115.84535563700163,116.52519996329585,115.16551131070742,67799,129392.06666666667,44.210299031315664,42.96148179376081,NaN,NaN,NaN,NaN,0.7139794034686842,43.66667370433884,42834388,-0.16120433865045414,-0.3391889113702007,-0.17798457271974655
2025-09-09T10:40:00-04:00,115.205,115.56,114.8,115.03,NaN,NaN,NaN,116.8953935290602,NaN,NaN,115.82750000000019,117.34295405734704,114.31204594265333,113.93269203052185,115.82967099238165,116.51013305236236,115.14920893240094,51219,129793.73333333334,42.35581813731307,42.04368118803659,NaN,NaN,NaN,NaN,0.717266588935207,43.744292426321834,42783169,-0.13328705495413623,-0.34459339141241685,-0.21130633645828062
2025-09-09T10:45:00-04:00,114.97,115.2,114.76,115.13,NaN,NaN,NaN,116.8953935290602,NaN,NaN,115.82000000000016,117.34544288649107,114.29455711350926,113.64032268270036,115.80966366454977,116.49306902058696,115.12625830851259,59946,129570.86666666667,43.629054169110326,41.04130691271466,NaN,NaN,NaN,NaN,0.6974618325826921,43.872539179188244,42843115,-0.10049370879740827,-0.33692347245504095,-0.23642976365763269
2025-09-09T10:50:00-04:00,115.09,115.09,114.59,114.97,NaN,NaN,NaN,116.78776713679814,NaN,NaN,115.81300000000017,117.35071909006045,114.2752809099399,113.64032268270036,115.7942752080793,116.48224484703798,115.10630556912062,40475,129529.4,42.02945253268452,40.07589051340983,NaN,NaN,NaN,NaN,0.6862145588267851,44.22956021042968,42802640,-0.0827267696519412,-0.3398382257225592,-0.25711145607061797
2025-09-09T10:55:00-04:00,115,115.14,114.72,114.87,NaN,NaN,NaN,116.78776713679814,NaN,NaN,115.80480000000017,117.35809451165527,114.25150548834507,113.64032268270036,115.78019501598224,116.47158377140305,115.08880626056144,39423,129309.5,41.017250312698174,40.25209733889322,NaN,NaN,NaN,NaN,0.6671992331963006,44.3589825789866,42763217,-0.07129185274874306,-0.34622627200654676,-0.2749344192578037
2025-09-09T11:00:00-04:00,114.86,115.03,114.34,114.37,NaN,NaN,NaN,116.60848203993383,NaN,NaN,115.78340000000019,117.38494230663017,114.1818576933702,113.64032268270036,115.74336029019688,116.45483747769957,115.03188310269418,78392,129444.7,36.308779421856556,39.8528317820657,NaN,NaN,NaN,NaN,0.6688278593965646,44.997983564135,42684825,-0.08978973892850484,-0.3871715929184347,-0.2973818539899299
2025-09-09T11:05:00-04:00,114.37,114.5,114.15,114.3,NaN,NaN,NaN,116.20877831084594,NaN,NaN,115.77000000000018,117.40930717070368,114.13069282929668,113.64032268270036,115.71061198953643,116.44561527369386,114.975608705379,60008,124176.9,35.69106803107081,39.37231506390962,NaN,NaN,NaN,NaN,0.6460544408682382,45.81676216544828,42624817,-0.09843299200682842,-0.42042309399846545,-0.321990101991637
2025-09-09T11:10:00-04:00,114.28,114.45,113.75,114.01,NaN,NaN,NaN,115.99360656944384,NaN,NaN,115.74960000000017,117.44950098533317,114.04969901466717,113.64032268270036,115.64296013232546,116.433128926137,114.85279133851391,112438,124826.53333333334,33.173129920805806,39.367672930463236,NaN,NaN,NaN,NaN,0.6499076950919357,46.99027345037666,42512379,-0.11426199570464124,-0.4648175966224386,-0.35055560091779736
2025-09-09T11:15:00-04:00,114.02,114.3,113.81,113.82,NaN,NaN,NaN,115.92935172537823,NaN,NaN,115.72840000000016,117.49623420035724,113.96056579964309,113.64032268270036,115.61043764554917,116.42610590771912,114.79476938337922,54279,123326.43333333333,31.60017843359826,38.59329494321197,NaN,NaN,NaN,NaN,0.6384857168710828,48.0799625006673,42458100,-0.127122913566805,-0.5094592428763036,-0.3823363293094986
2025-09-09T11:20:00-04:00,113.86,114.5,113.86,114.2,NaN,NaN,NaN,115.92935172537823,NaN,NaN,115.71540000000016,117.51809669105693,113.91270330894339,113.64032268270036,115.58606558281868,116.41554259736212,114.75658856827523,48434,122623.73333333334,37.93838819920123,38.37480467764531,NaN,NaN,NaN,NaN,0.6414510228088631,48.26277522898829,42506534,-0.1007834949521429,-0.5083156979996772,-0.40753220304753435
2025-09-09T11:25:00-04:00,114.24,114.24,113.92,114.04,NaN,NaN,NaN,115.91997750184255,NaN,NaN,115.69740000000016,117.5480423101032,113.84675768989712,113.64032268270036,115.5683595205277,116.4089565209633,114.72776252009209,33361,117929.26666666666,36.40858180645671,38.31196991643203,NaN,NaN,NaN,NaN,0.6184902354653724,48.432529905286344,42473173,-0.08548665320828641,-0.5143905195578924,-0.428903866349606
2025-09-09T11:30:00-04:00,114.02,114.4,114.02,114.24,NaN,NaN,NaN,115.91997750184255,NaN,NaN,115.68560000000016,117.56550706151621,113.80569293848411,113.59032521354258,115.55046727857945,116.39960330406461,114.70133125309428,38499,116159.3,39.68269879483918,38.59424193067946,NaN,NaN,NaN,NaN,0.6014552186464179,47.920442515534766,42511672,-0.05474377008863013,-0.49733357896039365,-0.4425898088717635
2025-09-09T11:35:00-04:00,114.25,114.35,113.82,113.82,NaN,NaN,NaN,115.88324396345571,NaN,NaN,115.65920000000017,117.60493519265384,113.7134648073465,113.59032521354258,115.52508154225067,116.38998143582948,114.66018164867187,48188,115564.6,35.543981729627006,38.18166286953383,NaN,NaN,NaN,NaN,0.5963512744573881,47.769282187993014,42463484,-0.055373379648889,-0.5118065334328747,-0.45643315378398575
2025-09-09T11:40:00-04:00,113.85,114.22,113.79,114.22,NaN,NaN,NaN,115.78014196511681,NaN,NaN,115.63680000000016,117.6221037651566,113.65149623484373,113.59032521354258,115.5021313269669,116.37900852671109,114.62525412722272,47487,114434.06666666667,41.772543050265384,38.66865882648875,NaN,NaN,NaN,NaN,0.5844690405675742,47.67666701920333,42510971,-0.023176963197640066,-0.48540435778103586,-0.4622273945833958
2025-09-09T11:45:00-04:00,114.23,114.59,114.14,114.57,NaN,NaN,NaN,115.78014196511681,NaN,NaN,115.61980000000015,117.62667813281249,113.61292186718782,113.44526017083408,115.48931491498575,116.36864826910009,114.60998156087142,36374,112287.06666666667,46.632104563276876,38.84164493591455,NaN,NaN,NaN,NaN,0.5748641090984619,46.117937034540866,42547345,0.02476832285585867,-0.43126699101357246,-0.45603531386943114
2025-09-09T11:50:00-04:00,114.56,114.9,114.5,114.88,NaN,NaN,NaN,115.78014196511681,NaN,NaN,115.60340000000016,117.62076307092555,113.58603692907478,113.7235895141266,115.47746771227986,116.35448915292513,114.6004462716346,50088,108984.13333333333,50.567263238540086,39.42817672885934,NaN,NaN,NaN,NaN,0.5623738155914293,43.657445905295006,42597433,0.07746216557838703,-0.3592076068964474,-0.4366697724748344
2025-09-09T11:55:00-04:00,114.89,115.02,114.77,114.9,NaN,NaN,NaN,115.78014196511681,NaN,NaN,115.58960000000016,117.61655815446262,113.5626418455377,113.95387161130127,115.46781490542494,116.34068166676059,114.5949481440893,52112,104517.8,50.81922262749283,39.94176019017238,NaN,NaN,NaN,NaN,0.5400614001920415,41.01478106736581,42649545,0.11168633886680218,-0.2970618488913317,-0.4087481877581339
2025-09-09T12:00:00-04:00,114.895,115,114.79,114.84,NaN,NaN,NaN,115.78014196511681,NaN,NaN,115.56960000000015,117.60599273224858,113.53320726775172,114.04209728904102,115.46198456396277,116.3324985501865,114.59147057773905,31233,94082.66666666667,49.995925795610994,40.51079399466712,NaN,NaN,NaN,NaN,0.5164855858926095,38.56087800357441,42618312,0.12718002459081268,-0.249773157019618,-0.3769531816104307
2025-09-09T12:05:00-04:00,114.83,114.89,114.52,114.7,NaN,NaN,NaN,115.78014196511681,NaN,NaN,115.54520000000015,117.59341576987124,113.49698423012906,114.04209728904102,115.45594516420708,116.32560449034754,114.58628583806662,25412,88996.1,48.04025738406016,41.01243735690726,NaN,NaN,NaN,NaN,0.5060223297574235,36.98109568180036,42592900,0.1247263168642111,-0.22104528553016678,-0.3457716023943779
2025-09-09T12:10:00-04:00,114.7,115.15,114.68,115.1,NaN,NaN,NaN,115.78014196511681,NaN,NaN,115.52780000000016,117.57606674042853,113.47953325957178,114.15394226498626,115.44903377911433,116.31428854169943,114.58377901652923,46706,82529.13333333333,53.62222318622961,42.24911191150534,NaN,NaN,NaN,NaN,0.5034493062033217,34.69868413811756,42639606,0.1453294199910139,-0.16410982740561053,-0.30943924739662443
2025-09-09T12:15:00-04:00,115.09,115.26,114.95,115.03,NaN,NaN,NaN,115.78014196511681,NaN,NaN,115.51380000000016,117.56591262847361,113.46168737152671,114.308153811989,115.44578250206928,116.30790728260959,114.58365772152897,28789,76508.23333333334,52.55812242328141,43.453901510948945,NaN,NaN,NaN,NaN,0.4896314986173703,32.25851370813141,42610817,0.14897849962558152,-0.12321612286464756,-0.2721946224902291
2025-09-09T12:20:00-04:00,114.98,115.26,114.78,115.25,NaN,NaN,NaN,115.78014196511681,NaN,NaN,115.49820000000017,117.54623394501623,113.45016605498411,114.308153811989,115.44234819220692,116.30091371235211,114.58378267206173,32464,73462.23333333334,55.54403639562257,45.051823402007294,NaN,NaN,NaN,NaN,0.48894353443041555,30.464665164531766,42643281,0.15997740537618207,-0.07222286577000148,-0.23220027114618355
2025-09-09T12:25:00-04:00,115.23,115.32,115.08,115.32,NaN,NaN,NaN,115.78014196511681,NaN,NaN,115.48140000000016,117.52120787329021,113.44159212671012,114.39881843967295,115.44028840315727,116.29471434692843,114.5858624593861,33939,68738.9,56.48254647096133,46.82913540467608,NaN,NaN,NaN,NaN,0.4711618533996712,28.610442384348193,42677220,0.165069188492646,-0.02586378553037605,-0.19093297402302206
2025-09-09T12:30:00-04:00,115.32,115.59,115.31,115.46,NaN,NaN,NaN,115.78014196511681,NaN,NaN,115.47360000000015,117.51069110251572,113.43650889748457,114.71305475173837,115.4404210779708,116.2904919112057,114.59035024473589,34258,59348.1,58.37521930454245,48.2889090550576,NaN,NaN,NaN,NaN,0.45750743529969473,27.041026990667422,42711478,0.17028259229387693,0.02192026634432409,-0.14836232594955284
2025-09-09T12:35:00-04:00,115.44,115.49,115.31,115.42,NaN,NaN,NaN,115.78014196511681,NaN,NaN,115.46160000000016,117.4927350915032,113.43046490849711,114.71305475173837,115.44025103909775,116.28818140759925,114.59232067059624,17054,54281.26666666667,57.60434432305606,49.80289209195755,NaN,NaN,NaN,NaN,0.4376854756354303,25.583712696535276,42694424,0.16342364238248916,0.055917227028558614,-0.10750641535393055
2025-09-09T12:40:00-04:00,115.44,115.55,115.28,115.36,NaN,NaN,NaN,115.78014196511681,NaN,NaN,115.44060000000016,117.45371066758305,113.42748933241727,114.78175504111256,115.43984371650039,116.28381298968013,114.59587444332065,31937,52857.066666666666,56.401194612269634,50.997070364631156,NaN,NaN,NaN,NaN,0.4257079416614707,24.408865594163732,42662487,0.147708703718063,0.0771294642936482,-0.0705792394244148
2025-09-09T12:45:00-04:00,115.35,115.5,115.25,115.43,NaN,NaN,NaN,115.78014196511681,NaN,NaN,115.41800000000016,117.40554521959365,113.43045478040668,114.78175504111256,115.43961877203621,116.2815508533328,114.59768669073962,16608,51219.6,57.5160556491453,52.566504216025315,NaN,NaN,NaN,NaN,0.4131573743999371,23.207254812152943,42679095,0.1352264442068843,0.09845381583419055,-0.036772628372693725
2025-09-09T12:50:00-04:00,115.465,115.55,115.29,115.36,NaN,NaN,NaN,115.78014196511681,NaN,NaN,115.39180000000016,117.34691100450615,113.43668899549417,114.82832322631204,115.4393389036936,116.27829855798424,114.60037924940295,24430,46874.86666666667,55.97463179104324,53.58093912608088,NaN,NaN,NaN,NaN,0.40221756194279806,22.255512606423917,42654665,0.11618202467674783,0.10845490247324108,-0.0077271222035067595
2025-09-09T12:55:00-04:00,115.37,115.47,115.14,115.19,NaN,NaN,NaN,115.78014196511681,NaN,NaN,115.36580000000016,117.29622208854273,113.43537791145759,114.82832322631204,115.43834912791742,116.27500238111007,114.60169587472477,19938,45248.5,52.30824171965179,53.98637749439337,NaN,NaN,NaN,NaN,0.39705916466116953,20.788430211219193,42634727,0.08737634160088549,0.1014933047976001,0.014116963196714613
2025-09-09T13:00:00-04:00,115.19,115.28,114.98,115.07,NaN,NaN,NaN,115.78014196511681,NaN,NaN,115.32860000000016,117.20802974328173,113.4491702567186,114.82832322631204,115.43564449108516,116.26937319760872,114.6019157845616,28889,43005.96666666667,49.82721715993051,53.933517060206974,NaN,NaN,NaN,NaN,0.39012636718537147,19.75242848843239,42605838,0.056954263981582376,0.08530979317369258,0.028355529192110207
2025-09-09T13:05:00-04:00,115.08,115.125,114.78,114.92,NaN,NaN,NaN,115.78014196511681,NaN,NaN,115.28580000000018,117.10196778958318,113.46963221041717,114.82832322631204,115.43207964716171,116.26384614834178,114.60031314598164,25494,41595.8,46.83672830376652,53.649053179940815,NaN,NaN,NaN,NaN,0.38690305524355917,19.43135479166601,42580344,0.025069496953314153,0.0596924003837529,0.034622903430438744
2025-09-09T13:10:00-04:00,114.95,115.04,114.75,114.92,NaN,NaN,NaN,115.78014196511681,NaN,NaN,115.24790000000017,117.01321820358926,113.48258179641108,114.82832322631204,115.42886459075689,116.25911660092677,114.598612580587,21612,40608.9,46.83672830376652,53.423396216237634,NaN,NaN,NaN,NaN,0.3799814084404482,19.225410344506116,42580344,0.003454907833253071,0.03894153822200508,0.03548663038875201
2025-09-09T13:15:00-04:00,114.92,115.43,114.92,115.41,NaN,NaN,NaN,115.78014196511681,NaN,NaN,115.22030000000017,116.93060922348158,113.50999077651875,114.82832322631204,115.42735594956177,116.2541911463427,114.60052075278084,30813,39637.8,56.685518084693584,54.040914837711455,NaN,NaN,NaN,NaN,0.3892684506947023,18.133328151819576,42611157,0.020673320574605816,0.061328281107009275,0.04065496053240346
2025-09-09T13:20:00-04:00,115.43,115.71,115.4,115.48,NaN,NaN,NaN,115.78014196511681,NaN,NaN,115.18990000000016,116.82497490957635,113.55482509042398,114.86518956383834,115.4284257472002,116.25100690654627,114.60584458785412,37759,39547.26666666667,57.88580834065075,54.34545663445582,NaN,NaN,NaN,NaN,0.38360641850222266,17.94015144021994,42648916,0.03447835143164496,0.08375289982195966,0.0492745483903147
2025-09-09T13:25:00-04:00,115.48,115.54,115.11,115.13,NaN,NaN,NaN,115.78014196511681,NaN,NaN,115.15080000000016,116.69363163045774,113.60796836954258,114.86518956383834,115.42677496975956,116.24548320737122,114.6080667321479,35860,39428.5,50.36993828604697,54.18915776751051,NaN,NaN,NaN,NaN,0.3869202457520644,16.790103562111398,42613056,0.018538256181944004,0.0724473686177447,0.053909112435800696
2025-09-09T13:30:00-04:00,115.17,115.2,114.9,114.96,NaN,NaN,NaN,115.78014196511681,NaN,NaN,115.10520000000017,116.52848628178876,113.68191371821158,114.86518956383834,115.42289722346376,116.23865194584441,114.60714250108312,35214,37989.23333333333,47.16656900373354,53.590767239518435,NaN,NaN,NaN,NaN,0.38071165676977387,16.07110981844699,42577842,-0.003764974668408562,0.049202894100289996,0.05296786876869856
2025-09-09T13:35:00-04:00,114.95,115.19,114.88,115.11,NaN,NaN,NaN,115.78014196511681,NaN,NaN,115.06240000000017,116.34708087863281,113.77771912136753,114.86518956383834,115.4205914137143,116.23426148704786,114.60692134038075,23621,36776.333333333336,50.17741711639034,53.14040085704907,NaN,NaN,NaN,NaN,0.3756608241433616,15.460443355320603,42601463,-0.008457089862822925,0.0423965064401699,0.050853596302992826
2025-09-09T13:40:00-04:00,115.12,115.44,115.11,115.32,NaN,NaN,NaN,115.78014196511681,NaN,NaN,115.03550000000016,116.23855984885961,113.8324401511407,114.86518956383834,115.41935539935227,116.22926444005688,114.60944635864766,35522,34212.46666666667,54.119459398864755,52.83641800664352,NaN,NaN,NaN,NaN,0.3723993367045499,14.611642026353364,42636985,0.0019834047312940334,0.05333285221711037,0.05134944748581634
2025-09-09T13:45:00-04:00,115.32,115.78,115.29,115.74,NaN,NaN,NaN,115.78014196511681,NaN,NaN,115.01390000000018,116.1231507200435,113.90464927995686,114.86518956383834,115.42069268948973,116.22780416877993,114.61358121019953,27480,33319.166666666664,60.79979206129575,53.06466427366064,NaN,NaN,NaN,NaN,0.38079938408279596,14.727987558198391,42664465,0.03475860681588981,0.0947977060056786,0.060039099189788794
2025-09-09T13:50:00-04:00,115.74,115.95,115.74,115.91,114.61932544048628,114.61932544048628,114.61932544048628,NaN,NaN,NaN,114.99770000000017,116.02763438622273,113.9677656137776,115.11068681302284,115.42372241976835,116.22892143258187,114.61852340695484,25859,32566.666666666668,63.139264201673704,53.54595495861808,NaN,NaN,NaN,NaN,0.3685994280768825,15.231163680113106,42690324,0.0637810027583141,0.13976535263768142,0.07598434987936732
2025-09-09T13:55:00-04:00,115.9,115.91,115.62,115.66,114.61932544048628,NaN,NaN,NaN,NaN,NaN,114.99880000000017,116.03144042140399,113.96615957859636,115.11068681302284,115.4253602160049,116.22871406691932,114.62200636509048,20464,32136.766666666666,57.68692728491023,53.558160075458424,NaN,NaN,NaN,NaN,0.36298518321424744,15.282575069293697,42669860,0.061981021951950044,0.15346062731930488,0.09147960536735483
2025-09-09T14:00:00-04:00,115.66,115.85,115.63,115.74,114.61932544048628,NaN,NaN,NaN,NaN,NaN,114.99760000000016,116.02664662670514,113.96855337329518,115.11068681302284,115.42651727686146,116.22861877182498,114.62441578189794,14125,31324.3,58.909731176277525,53.767810031546595,NaN,NaN,NaN,NaN,0.3527719558418011,15.33031421638996,42683985,0.061875092269644355,0.16882347070441028,0.10694837843476593
2025-09-09T14:05:00-04:00,115.735,115.99,115.71,115.99,114.68113053196312,NaN,NaN,NaN,NaN,NaN,115.00080000000018,116.04111410637006,113.9604858936303,115.2394716482677,115.4294004243695,116.2298806667668,114.6289201819722,23700,30508.033333333333,62.55179810514318,54.49949263051026,NaN,NaN,NaN,NaN,0.3475739589959583,15.739387281971773,42707685,0.07354449101933322,0.19887899220893246,0.12533450118959924
2025-09-09T14:10:00-04:00,115.975,115.98,115.51,115.96,114.68113053196312,NaN,NaN,NaN,NaN,NaN,115.02060000000017,116.09494378106993,113.94625621893042,115.2394716482677,115.43203185952893,116.23042199080493,114.63364172825294,26440,29806.466666666667,61.843414777676124,55.35779246034924,NaN,NaN,NaN,NaN,0.3570329619248177,15.380101801326301,42681245,0.07394613969844349,0.2177671758126536,0.1438210361142101
2025-09-09T14:15:00-04:00,115.93,116,115.8,115.98,114.745224307016,NaN,NaN,NaN,NaN,NaN,115.02900000000017,116.12640238742337,113.93159761257697,115.2394716482677,115.43673980610981,116.23277140524023,114.6407082069794,37392,29840.4,62.151148199583794,56.45167959576476,NaN,NaN,NaN,NaN,0.34581632178733096,15.104655840855827,42718637,0.070286670819207,0.23167937463821886,0.16139270381901186
2025-09-09T14:20:00-04:00,116,116.05,115.79,115.86,114.782259565788,NaN,NaN,NaN,NaN,NaN,115.03780000000017,116.15449003753496,113.9211099624654,115.30212948391306,115.43839561692792,116.23348413423186,114.64330709962398,14092,28640.533333333333,59.07272647824472,57.32567946537034,NaN,NaN,NaN,NaN,0.3396865845168067,15.000364286080256,42704545,0.05517893706215157,0.23036637514670133,0.17518743808454976
2025-09-09T14:25:00-04:00,115.87,116.12,115.84,116.02,114.85579322188855,NaN,NaN,NaN,NaN,NaN,115.05740000000016,116.20745954625681,113.9073404537435,115.38170358713046,115.44457132223799,116.23736359898231,114.65177904549367,44370,28382.466666666667,61.790269060387885,57.69030453506279,NaN,NaN,NaN,NaN,0.33542325705132064,15.118657995621604,42748915,0.05143080694714361,0.23947594676847928,0.18804513982133567
2025-09-09T14:30:00-04:00,116.02,116.09,115.85,115.9,114.86416625725724,NaN,NaN,NaN,NaN,NaN,115.07800000000017,116.25057323861574,113.9054267613846,115.38170358713046,115.44752311133588,116.23891298410365,114.65613323856812,23578,28127.3,58.64511905889856,57.74454101493764,NaN,NaN,NaN,NaN,0.3286073101190841,15.22850215448143,42725337,0.03701297241564558,0.23431135534089265,0.19729838292524707
2025-09-09T14:35:00-04:00,115.9,115.98,115.87,115.97,114.86416625725724,NaN,NaN,NaN,NaN,NaN,115.09280000000017,116.29107235632466,113.89452764367567,115.38170358713046,115.44957647506645,116.23995209659196,114.65920085354094,16792,27839.966666666667,59.92650505801671,58.42715292722119,NaN,NaN,NaN,NaN,0.3129925022534352,15.330500301994125,42742129,0.02870437664716402,0.2331788537342021,0.2044744770870381
2025-09-09T14:40:00-04:00,115.99,116.26,115.96,116.24,115.0471845443191,NaN,NaN,NaN,NaN,NaN,115.12700000000017,116.35627783674992,113.8977221632504,115.61119223661079,115.45438879541283,116.24418971061691,114.66458788020874,27729,27207.4,64.49611830582914,59.66497787737087,NaN,NaN,NaN,NaN,0.31206446637819063,16.308597090094644,42769858,0.03735859338205044,0.2511727188146011,0.21381412543255068
2025-09-09T14:45:00-04:00,116.24,116.68,116.23,116.66,115.37913070139551,NaN,NaN,NaN,NaN,NaN,115.15560000000018,116.45752571213475,113.8536742878656,115.93595378928863,115.46521032915517,116.25825576547632,114.67216489283402,41472,27630.166666666668,70.19050606769046,61.09448423103517,NaN,NaN,NaN,NaN,0.3219170044940344,18.19710244246519,42811330,0.06567860580957902,0.29591238269452447,0.23023377688494545
2025-09-09T14:50:00-04:00,116.64,116.98,116.51,116.95,115.65394294224117,NaN,NaN,NaN,NaN,NaN,115.19400000000016,116.58879030679816,113.79920969320216,116.14976303143091,115.48229370568531,116.28459666921817,114.67999074215244,52578,28300.633333333335,73.36684741297552,62.469297660614515,NaN,NaN,NaN,NaN,0.33249436131588894,20.48021171993308,42863908,0.09639418501507069,0.3507265081537838,0.2543323231387131
2025-09-09T14:55:00-04:00,116.95,118.17,116.95,118.05,116.35217280850293,NaN,NaN,NaN,NaN,NaN,115.25240000000016,116.85988529073524,113.6449147092651,116.89581042514472,115.59350366877574,116.51470162411027,114.6723057134412,216650,34391,81.44371507951428,63.94386359048726,NaN,NaN,NaN,NaN,0.3958876212218968,23.868045742817515,43080558,0.17847370349622815,0.47742445250899834,0.2989507490127702
2025-09-09T15:00:00-04:00,118.06,118.35,117.77,118.14,116.82798313538916,NaN,NaN,NaN,NaN,NaN,115.31580000000014,117.11263316976111,113.51896683023917,117.04064834011577,115.6848456693823,116.70312973878427,114.66656159998033,166033,38783.5,81.92665535778342,65.28582010163795,NaN,NaN,NaN,NaN,0.4090385054203326,27.139572859863907,43246591,0.2235817819141327,0.5784279764054361,0.3548461944913034
2025-09-09T15:05:00-04:00,118.15,118.63,118.1,118.55,117.11671117468964,NaN,NaN,NaN,NaN,NaN,115.38940000000015,117.3963495658688,113.3824504341315,117.31751867209262,115.74300826145162,116.82513350081875,114.66088302208449,98218,41488.96666666667,83.97300787469376,67.1633972866225,NaN,NaN,NaN,NaN,0.4176786121760232,30.3596770275529,43344809,0.263064302262704,0.6836765723196834,0.4206122700569794
2025-09-09T15:10:00-04:00,118.54,118.69,117.78,117.78,117.11671117468964,NaN,NaN,NaN,NaN,NaN,115.45760000000014,117.55123439023072,113.36396560976956,117.31751867209262,115.79356502011258,116.91671324468183,114.67041679554333,102229,43832.03333333333,68.32634688338726,67.8360126942732,NaN,NaN,NaN,NaN,0.4528444255920213,32.195577888975045,43242580,0.22104667277800327,0.6969206110294834,0.47587393825148017
2025-09-09T15:15:00-04:00,117.8,118.2,117.79,118.2,117.11671117468964,NaN,NaN,NaN,NaN,NaN,115.53560000000014,117.7386493775533,113.33255062244699,117.31751867209262,115.81568957459744,116.95537986485132,114.67599928434356,46582,44831.166666666664,71.45109274564749,68.47167659716635,NaN,NaN,NaN,NaN,0.4504983951925913,33.90034297458132,43289162,0.20558817172911992,0.7328591529128801,0.5272709811837601
2025-09-09T15:20:00-04:00,118.2,118.47,118.2,118.29,117.11671117468964,NaN,NaN,NaN,NaN,NaN,115.62120000000013,117.91136554859247,113.33103445140779,117.31751867209262,115.83796410719808,116.99668200388003,114.67924621051613,42887,45446.4,72.08658093517658,69.2033313227021,NaN,NaN,NaN,NaN,0.4376056526788345,35.74725506403916,43332049,0.18605837192753927,0.7598439460931843,0.573785574165645
2025-09-09T15:25:00-04:00,118.26,118.595,118.23,118.53,117.13113299537608,NaN,NaN,NaN,NaN,NaN,115.71540000000016,118.08746816089482,113.3433318391055,117.39954764808914,115.8746101868821,117.06550965220207,114.68371072156212,68566,47067.333333333336,73.7637366672171,70.03280192753304,NaN,NaN,NaN,NaN,0.432419534630346,37.57791233136465,43400615,0.17414913022626788,0.7914719869484799,0.617322856722212
2025-09-09T15:30:00-04:00,118.525,118.59,118.35,118.44,117.21414967740444,NaN,NaN,NaN,NaN,NaN,115.80020000000015,118.25134337400975,113.34905662599054,117.5136381184713,115.9055906767903,117.12230088469094,114.68888046888965,59311,48081.4,72.01627774007908,70.95734130337836,NaN,NaN,NaN,NaN,0.4186752821567505,39.27780836530975,43341304,0.14618385868224026,0.8000526800750123,0.653868821392772
2025-09-09T15:35:00-04:00,118.43,118.53,118.23,118.33,117.21414967740444,NaN,NaN,NaN,NaN,NaN,115.88600000000015,118.38455638318298,113.38744361681732,117.51891049477705,115.94142871529424,117.18464774110934,114.69820968947913,73242,49673,69.83859591518147,71.53222179300649,NaN,NaN,NaN,NaN,0.41019847628841094,40.36200766195141,43268062,0.10801142857427926,0.788883107110621,0.6808716785363418
2025-09-09T15:40:00-04:00,118.32,118.36,117.88,118.29,117.21414967740444,NaN,NaN,NaN,NaN,NaN,115.96700000000016,118.50907238290506,113.42492761709525,117.51891049477705,115.98375775660526,117.25227978548439,114.71523572772612,96955,52184.433333333334,69.02126363493174,72.27337497700886,NaN,NaN,NaN,NaN,0.41518429941066753,40.05918870913753,43171107,0.06966346766021714,0.7679510131116132,0.698287545451396
2025-09-09T15:45:00-04:00,118.31,118.53,118.26,118.46,117.21414967740444,NaN,NaN,NaN,NaN,NaN,116.05980000000014,118.62029210894025,113.49930789106003,117.55590271665731,116.02288246619433,117.31784455433983,114.72792037804884,83680,53946.666666666664,70.59625925521745,73.0355002768089,NaN,NaN,NaN,NaN,0.4048139923099053,40.04473231561011,43254787,0.0464586831830478,0.7563608994302058,0.709902216247158
2025-09-09T15:50:00-04:00,118.47,118.52,118.09,118.46,117.21414967740444,NaN,NaN,NaN,NaN,NaN,116.14460000000014,118.73640310979654,113.55279689020374,117.55590271665731,116.06277498866804,117.38177893081033,114.74377104652575,90493,55704.46666666667,70.59625925521745,73.47122463033665,NaN,NaN,NaN,NaN,0.4066129928591972,39.43963618159286,43254787,0.02300688988522137,0.7386608286036846,0.7156539387184633
2025-09-09T15:55:00-04:00,118.45,118.69,118.45,118.49,117.36163874751576,NaN,NaN,NaN,NaN,NaN,116.22300000000016,118.85635907159208,113.58964092840823,117.77457773866068,116.1162146648887,117.4697268492038,114.76270248057361,116562,58394.53333333333,70.89906512725952,73.52183599173443,NaN,NaN,NaN,NaN,0.3947120647978256,39.17081950943277,43371349,0.0024917505595547507,0.7187686269179068,0.716276876358352
2025-09-10T09:30:00-04:00,120.955,121.67,119.61,119.67,119.05292789535595,NaN,NaN,NaN,NaN,NaN,116.31880000000015,119.0944300617955,113.5431699382048,119.34766219092855,120.31666666666666,120.31666666666666,120.31666666666666,335316,68397.93333333333,79.73785150538687,73.97690771262096,NaN,NaN,NaN,NaN,0.5936612030265529,41.36061703632522,43706665,0.05827732074106806,0.789123527284687,0.730846206543619
2025-09-10T09:35:00-04:00,119.71,120.43,119.44,120.41,119.05292789535595,NaN,NaN,NaN,NaN,NaN,116.42900000000016,119.40112718434712,113.4568728156532,119.34766219092855,120.25024838989732,120.35233672251724,120.14816005727741,141931,72341.6,83.18669300264739,74.10140613570191,NaN,NaN,NaN,NaN,0.6219711170960854,43.01082250104062,43848596,0.13074972779906935,0.8942833662924556,0.7635336384933863
2025-09-10T09:40:00-04:00,120.46,121.93,120.11,121.895,119.1968826484545,NaN,NaN,NaN,NaN,NaN,116.57010000000015,119.87798179352713,113.26221820647318,119.34766219092855,120.57670026469266,121.0738398510732,120.07956067831212,211980,78223.53333333334,87.70819571347343,74.51437330396547,NaN,NaN,NaN,NaN,0.7075446087320799,45.12915627252979,44060576,0.2571281520670927,1.0849438285772521,0.8278156765101594
2025-09-10T09:45:00-04:00,121.895,122.94,121.85,122.69,120.50611525534292,NaN,NaN,NaN,NaN,NaN,116.72990000000016,120.41180303510895,113.04799696489137,120.1611630417554,121.02410301925502,121.94431677430724,120.1038892642028,209880,84303.53333333334,89.35815076401393,74.89902636748833,NaN,NaN,NaN,NaN,0.7348628509655031,47.37614052035485,44270456,0.36604862265426996,1.285376454827997,0.9193278321737269
2025-09-10T09:50:00-04:00,122.7,122.7,121.15,121.15,120.50611525534292,NaN,NaN,NaN,NaN,NaN,116.85090000000015,120.7042495507093,112.997550449291,120.1611630417554,121.14170210600635,122.0097760807343,120.2736281312784,201412,90155.3,69.80976404519058,75.00498473618858,NaN,NaN,NaN,NaN,0.7930869330393955,48.24313913944679,44069044,0.30846845117103594,1.3049133961375219,0.996444944966486
2025-09-10T09:55:00-04:00,121.1,122.1,121.06,121.81,120.50611525534292,NaN,NaN,NaN,NaN,NaN,116.98650000000015,121.04567639428849,112.9273236057118,120.1611630417554,121.19103265026772,122.0302802665066,120.35178503402884,116592,93359.56666666667,72.57846707842835,75.08551147424434,NaN,NaN,NaN,NaN,0.8107235806794381,48.89769712990359,44185636,0.28924314902929904,1.3579988812531099,1.0687557322238108
2025-09-10T10:00:00-04:00,121.82,122.35,121.35,121.99,120.50611525534292,NaN,NaN,NaN,NaN,NaN,117.12130000000016,121.38343505651201,112.85916494348831,120.1611630417554,121.24235014871611,122.07101854301514,120.41368175441708,95457,96070.63333333333,73.29770360396485,75.17202023630067,NaN,NaN,NaN,NaN,0.824243324916621,49.62115528418653,44281093,0.2637740357630911,1.3984732769276746,1.1346992411645835
2025-09-10T10:05:00-04:00,122,122.37,121.06,121.22,120.50611525534292,NaN,NaN,NaN,NaN,NaN,117.23930000000014,121.62044962538042,112.85815037461987,120.1611630417554,121.2702798023865,122.06536676630536,120.47519283846763,131058,99649.23333333334,65.39578314494187,74.57430927042387,NaN,NaN,NaN,NaN,0.8589402302797197,49.77796459076588,44150035,0.1744985806396353,1.3528224669641276,1.1783238863244923
2025-09-10T10:10:00-04:00,121.25,121.86,120.86,121.43,120.50611525534292,NaN,NaN,NaN,NaN,NaN,117.35870000000016,121.86304581709186,112.85435418290845,120.1611630417554,121.27653140530987,122.04975438285503,120.50330842776471,84502,101584.63333333333,66.4578371506378,74.17727779974949,NaN,NaN,NaN,NaN,0.8690159281168824,49.570333647754445,44234537,0.1120541064311733,1.318391519363459,1.2063374129322857
2025-09-10T10:15:00-04:00,121.47,121.91,121.27,121.84,120.50611525534292,NaN,NaN,NaN,NaN,NaN,117.48710000000015,122.12704227980906,112.84715772019125,120.1611630417554,121.29844739364466,122.05546012106095,120.54143466622838,89335,103316.06666666667,68.49112875418436,74.08103014539255,NaN,NaN,NaN,NaN,0.8526576475371052,49.41052585550299,44323872,0.08220835256913661,1.3090978536437063,1.2268895010745697
2025-09-10T10:20:00-04:00,121.83,122.24,121.57,122.13,120.50611525534292,NaN,NaN,NaN,NaN,NaN,117.62250000000016,122.39934927540666,112.84565072459365,120.1611630417554,121.33531165592173,122.0875335241416,120.58308978770185,92489,105929.3,69.88183662760304,74.14249964486908,NaN,NaN,NaN,NaN,0.8396106727130264,49.48106531482612,44416361,0.06651391969062148,1.3100319006878465,1.243517980997225
2025-09-10T10:25:00-04:00,122.1,122.5,121.74,122.45,120.50611525534292,NaN,NaN,NaN,NaN,NaN,117.76290000000016,122.68420636721055,112.84159363278977,120.19401636122747,121.40569705218303,122.16684224635263,120.64455185801343,146009,109317.26666666666,71.38278941269449,74.19868037040314,NaN,NaN,NaN,NaN,0.8339241960906677,49.71328398799208,44562370,0.062274919990420896,1.3213616309852512,1.2590867109948303
2025-09-10T10:30:00-04:00,122.46,123,121.935,122.33,120.50611525534292,NaN,NaN,NaN,NaN,NaN,117.90230000000014,122.93700801933677,112.8675919806635,120.62271308898198,121.47571998419409,122.25395542458539,120.69748454380279,137386,113110.86666666667,69.97449241248945,74.15426845306543,NaN,NaN,NaN,NaN,0.8504296106556198,50.22872486034158,44424984,0.037216470027310766,1.3056072985289688,1.268390828501658
2025-09-10T10:35:00-04:00,122.37,122.94,122.33,122.7,120.50611525534292,NaN,NaN,NaN,NaN,NaN,118.05250000000015,123.20137880998914,112.90362119001117,120.73317047118559,121.53043901784011,122.32994745750692,120.7309305781733,96849,115779.43333333333,71.820522747007,74.22008685447597,NaN,NaN,NaN,NaN,0.8332560670373612,50.70734852752325,44521833,0.03160822874071445,1.3079011144275512,1.2762928856868367
2025-09-10T10:40:00-04:00,122.72,123.32,122.6,123.13,120.73045684101207,NaN,NaN,NaN,NaN,NaN,118.21370000000013,123.48227354888114,112.94512645111912,121.19453637694846,121.62830346709382,122.48445443860172,120.77215249558591,147336,119766.33333333333,73.83395910169399,73.79838025421218,NaN,NaN,NaN,NaN,0.8251663479632639,51.37509837500326,44669169,0.04224201299691033,1.3290954019329746,1.2868533889360643
2025-09-10T10:45:00-04:00,123.12,123.44,122.8,122.84,120.90452698460244,NaN,NaN,NaN,NaN,NaN,118.37210000000013,123.71081148873739,113.03338851126287,121.41962910155877,121.67922953902196,122.55952478540937,120.79893429263456,84567,121202.83333333333,70.19142793194038,72.87014703487597,NaN,NaN,NaN,NaN,0.8119401802516022,52.06388708006616,44584602,0.016453547619768694,1.307420323460775,1.2909667758410064
2025-09-10T10:50:00-04:00,122.835,122.94,122.11,122.18,120.90452698460244,NaN,NaN,NaN,NaN,NaN,118.51730000000015,123.86745484261444,113.16714515738586,121.41962910155877,121.7027257592436,122.57829543402674,120.82715608446047,77142,122021.63333333333,62.61979762547009,71.07811860001858,NaN,NaN,NaN,NaN,0.8132301673764877,51.210454637885526,44507460,-0.054461840818595286,1.2228894748177623,1.2773513156363576
2025-09-10T10:55:00-04:00,122.18,122.39,121.745,122.21,120.90452698460244,NaN,NaN,NaN,NaN,NaN,118.65330000000013,124.02625360485979,113.28034639514047,121.41962910155877,121.712391094139,122.57988227842627,120.84489990985172,57598,116719.9,62.81614348903408,69.18226093752003,NaN,NaN,NaN,NaN,0.8012137268495955,49.7288180622051,44565058,-0.10578609094798574,1.1451187019513753,1.250904792899361
2025-09-10T11:00:00-04:00,122.25,122.4,121.31,121.325,120.90452698460244,NaN,NaN,NaN,NaN,NaN,118.77020000000013,124.11617230071093,113.42422769928933,121.41962910155877,121.71141505869485,122.5664043833746,120.8564257340151,72486,113601.66666666667,53.83287496661245,68.04105457476444,NaN,NaN,NaN,NaN,0.8218413177889102,47.59628622211835,44492572,-0.20029254762119875,1.0005391083728625,1.2008316559940613
2025-09-10T11:05:00-04:00,121.3,121.62,120.91,121.16,120.90452698460244,NaN,NaN,NaN,NaN,NaN,118.89080000000014,124.1745533477599,113.60704665224038,121.41962910155877,121.68829540473276,122.52882871133352,120.847762098132,127597,114580.96666666666,52.33028135455895,66.59475559448806,NaN,NaN,NaN,NaN,0.8138526522325601,44.97880548560973,44364975,-0.2705053649746527,0.8626999497757453,1.133205314750398
2025-09-10T11:10:00-04:00,121.19,121.44,121,121.12,120.90452698460244,NaN,NaN,NaN,NaN,NaN,119.01400000000014,124.2119599844529,113.81604001554737,121.41962910155877,121.68105208291217,122.51763782517445,120.8444663406499,38927,112470.9,51.95170412175387,65.07004134575871,NaN,NaN,NaN,NaN,0.7871488913588056,42.54828765885174,44326048,-0.31321698352002114,0.7416840853503714,1.0549010688703926
2025-09-10T11:15:00-04:00,121.13,121.21,120.61,120.66,NaN,NaN,NaN,123.10518878416781,123.10518878416781,123.10518878416781,119.12500000000014,124.22077786014732,114.02922213985296,121.41962910155877,121.66528083616237,122.50204996181104,120.8285117105137,50699,112608.13333333333,47.6798282147716,63.80461599360368,NaN,NaN,NaN,NaN,0.7737811134046048,39.67617784166578,44275349,-0.3625419037581874,0.6017236891726583,0.9642655929308457
2025-09-10T11:20:00-04:00,120.66,120.84,120.42,120.435,NaN,NaN,NaN,122.78268020306926,NaN,NaN,119.22730000000014,124.21770447658949,114.2368955234108,121.41962910155877,121.6394437803679,122.482949073904,120.7959384868318,66046,113380.1,45.70036310567891,62.32193927610662,NaN,NaN,NaN,NaN,0.7485110338757045,36.96117349409442,44209303,-0.39760276222150615,0.46726214015396295,0.8648649023754691
2025-09-10T11:25:00-04:00,120.43,121.06,120.33,120.93,NaN,NaN,NaN,122.78268020306926,NaN,NaN,119.33110000000015,124.24231911137771,114.41988088862259,121.41962910155877,121.62310158357185,122.46688076492937,120.77932240221433,54090,112897.56666666667,50.563008163756464,61.0413592339332,NaN,NaN,NaN,NaN,0.7471888171702973,34.53995793310056,44263393,-0.3750302998985914,0.39607702750222984,0.7711073274008212
2025-09-10T11:30:00-04:00,120.93,121.14,120.51,120.55,NaN,NaN,NaN,122.78268020306926,NaN,NaN,119.42390000000015,124.2476090666795,114.60019093332079,121.41962910155877,121.60622583164337,122.45073196079413,120.76171970249261,55422,112767.93333333333,47.0776045126076,59.41248551143353,NaN,NaN,NaN,NaN,0.7388181873724186,32.41558779962912,44207971,-0.37250336035018095,0.30547812696309506,0.677981487313276
2025-09-10T11:35:00-04:00,120.56,121,120.5,120.81,NaN,NaN,NaN,122.78268020306926,NaN,NaN,119.52690000000013,124.24347498191058,114.81032501808967,120.90870328124701,121.59546522901512,122.43979675593171,120.75113370209853,38092,111596.26666666666,49.63570371896129,57.859122247595444,NaN,NaN,NaN,NaN,0.7217597454172457,30.424969762626002,44246063,-0.34098071712599076,0.2517555909057876,0.5927363080317783
2025-09-10T11:40:00-04:00,120.8,120.84,120.235,120.26,NaN,NaN,NaN,122.63710849913392,NaN,NaN,119.61730000000014,124.2117680693162,115.02283193068409,120.44246262499762,121.58306081144532,122.43119181798862,120.73492980490202,32265,109439.93333333333,44.71216238954032,56.05467010309907,NaN,NaN,NaN,NaN,0.7134197636017284,28.406242355799822,44213798,-0.3438517412891231,0.16292163142037452,0.5067733727094976
2025-09-10T11:45:00-04:00,120.25,120.49,119.86,120.13,NaN,NaN,NaN,122.26508084008238,NaN,NaN,119.70010000000013,124.17784027383982,115.22235972616045,120.29697009999809,121.55399410283944,122.41721622800193,120.69077197767695,62397,108730.5,43.61101625764351,54.03970535385883,NaN,NaN,NaN,NaN,0.7074612090587475,27.154316616415446,44151401,-0.34054241954792824,0.08109534827458731,0.42163776782251555
2025-09-10T11:50:00-04:00,120.12,120.28,119.78,120.24,NaN,NaN,NaN,122.09325898371499,NaN,NaN,119.78570000000012,124.13599884490596,115.43540115509428,119.59006086399877,121.53586518039847,122.408729600998,120.66300075979895,38570,106999.73333333334,44.84869823684305,51.96932957779804,NaN,NaN,NaN,NaN,0.692642551268837,26.119496942052127,44189971,-0.3174404524661314,0.024837202239851308,0.3422776547059827
2025-09-10T11:55:00-04:00,120.24,120.24,119.6,119.66,NaN,NaN,NaN,121.97674721172794,NaN,NaN,119.85930000000013,124.07190347528248,115.64669652471778,119.59006086399877,121.5123518756616,122.40164892341937,120.62305482790381,43321,104558.36666666667,39.87850106822531,49.804120516104106,NaN,NaN,NaN,NaN,0.6888823690353486,25.4477206199757,44146650,-0.32645455905212784,-0.06579054410917706,0.2606640149429508
2025-09-10T12:00:00-04:00,119.65,119.75,119.1,119.3,NaN,NaN,NaN,121.47689506574031,NaN,NaN,119.92810000000013,123.98674109770381,115.86945890229644,119.4872649298939,121.47748879654286,122.39993534875624,120.55504224432947,52220,95121.83333333333,37.12816094635791,47.98328932473896,NaN,NaN,NaN,NaN,0.6861050569613955,25.54831596593653,44094430,-0.34034192204409563,-0.1647633876121688,0.17557853443192684
2025-09-10T12:05:00-04:00,119.33,119.84,119.32,119.69,NaN,NaN,NaN,121.47689506574031,NaN,NaN,120.00150000000012,123.90453638209712,116.09846361790312,119.4872649298939,121.45117552196302,122.39306042545617,120.50929061846988,45741,91915.5,41.810261870422714,46.48286920912386,NaN,NaN,NaN,NaN,0.6756689814641533,25.43277770818185,44140171,-0.3079167932771546,-0.20931745716451644,0.09859933611263817
2025-09-10T12:10:00-04:00,119.71,119.9,119.53,119.74,NaN,NaN,NaN,121.47689506574031,NaN,NaN,120.07830000000013,123.8025162182084,116.35408378179186,119.4872649298939,121.42871155587142,122.38470464204984,120.47271846969299,42609,86269.8,42.402475644885584,45.666412114714795,NaN,NaN,NaN,NaN,0.6538354827881427,25.181324180096183,44182780,-0.2691598717687014,-0.23785050359823856,0.03130936817046283
2025-09-10T12:15:00-04:00,119.76,120.17,119.7,119.89,NaN,NaN,NaN,121.47689506574031,NaN,NaN,120.15670000000013,123.69192084741016,116.6214791525901,119.4872649298939,121.39959434780371,122.3688034521475,120.43038524345992,64495,81423.63333333333,44.236021562438246,45.088250700991885,NaN,NaN,NaN,NaN,0.6407043768747039,24.310825510965557,44247275,-0.22147077093035927,-0.24552909549248625,-0.02405832456212699
2025-09-10T12:20:00-04:00,119.88,119.95,119.36,119.39,NaN,NaN,NaN,121.47689506574031,NaN,NaN,120.21970000000012,123.58149916710988,116.85790083289035,119.42781194391512,121.36157741987506,122.35561956932062,120.3675352704295,70781,77069.26666666666,39.69937382119979,44.21308425095231,NaN,NaN,NaN,NaN,0.6370826356693682,24.063379122152714,44176494,-0.21165979939716495,-0.28863307380858316,-0.07697327441141823
2025-09-10T12:25:00-04:00,119.4,119.47,118.945,119.425,NaN,NaN,NaN,121.14536730016522,NaN,NaN,120.27500000000013,123.48845110433652,117.06154889566375,119.2797495551321,121.31489162461199,122.34492011640985,120.28486313281412,78294,75792.66666666667,40.16198793458301,43.676095659510274,NaN,NaN,NaN,NaN,0.6290767331215567,24.43319727723218,44254788,-0.19147954719109953,-0.31632270840029264,-0.12484316120919312
2025-09-10T12:30:00-04:00,119.44,119.48,119.235,119.4,NaN,NaN,NaN,121.14536730016522,NaN,NaN,120.32400000000013,123.40514653984047,117.24285346015978,118.92679964410567,121.30319310310398,122.34105993385921,120.26532627234874,21143,73315.53333333334,39.926367202841305,43.26366738073616,NaN,NaN,NaN,NaN,0.6016426807557316,24.75126447526477,44233645,-0.1692505521212459,-0.3364063513607505,-0.16715579923950458
2025-09-10T12:35:00-04:00,119.38,119.4,118.95,119.05,NaN,NaN,NaN,121.03395553589436,NaN,NaN,120.34400000000012,123.37847260656135,117.3095273934389,118.82502440590443,121.28092913427102,122.33635759026902,120.22550067827302,36409,70160.56666666667,36.68176648492956,42.272150117962816,NaN,NaN,NaN,NaN,0.5908110607017509,25.441241173595238,44197236,-0.16725770986493377,-0.3762279365706718,-0.208970226705738
2025-09-10T12:40:00-04:00,119.07,119.21,119,119.115,NaN,NaN,NaN,120.90809392062641,NaN,NaN,120.36350000000013,123.35327072698868,117.37372927301158,118.82502440590443,121.26214511737102,122.33207761848128,120.19221261626076,30947,68375.4,37.694414327276874,41.60192224758204,NaN,NaN,NaN,NaN,0.5636102706516254,26.081933822044963,44228183,-0.1511874195989375,-0.3979545012044099,-0.2467670816054724
2025-09-10T12:45:00-04:00,119.1,119.15,118.46,118.53,NaN,NaN,NaN,120.62022601514342,NaN,NaN,120.36310000000012,123.35384632156884,117.3723536784314,118.82502440590443,121.19866801741306,122.32738752770938,120.06994850711673,91420,68444.9,32.635602965196455,40.38762933659884,NaN,NaN,NaN,NaN,0.5726381084622244,27.36003694874121,44136763,-0.16827298358676646,-0.45710831108893046,-0.288835327502164
2025-09-10T12:50:00-04:00,118.52,119.03,118.5,118.9,NaN,NaN,NaN,120.56998846900052,NaN,NaN,120.38550000000012,123.31466660502002,117.45633339498022,118.82502440590443,121.14701171897904,122.31627557675739,119.9777478612007,81138,68066.53333333334,38.27774257635811,39.928027921371545,NaN,NaN,NaN,NaN,0.5695925292863513,28.546846994959157,44217901,-0.14391494407484995,-0.46872900759572644,-0.3248140635208765
2025-09-10T12:55:00-04:00,118.9,119.22,118.81,118.86,NaN,NaN,NaN,120.56998846900052,NaN,NaN,120.39870000000013,123.29410657593131,117.50329342406896,118.82502440590443,121.11770904702803,122.30596863169258,119.92944946236348,51032,64900.63333333333,37.9080946212226,39.520676375912906,NaN,NaN,NaN,NaN,0.5581930629087546,29.071302069886723,44166869,-0.12069497636297155,-0.47568278397459096,-0.3549878076116194
2025-09-10T13:00:00-04:00,118.89,119.1,118.75,118.93,NaN,NaN,NaN,120.56998846900052,NaN,NaN,120.41150000000012,123.27498755889833,117.5480124411019,118.82502440590443,121.09773036056852,122.29875537752363,119.8967053436134,34996,61487.63333333333,39.01795088165347,39.104194421970796,NaN,NaN,NaN,NaN,0.5433221298438432,29.64412280324585,44201865,-0.09211052779874251,-0.4701259673600475,-0.378015439561305
2025-09-10T13:05:00-04:00,118.935,119.02,118.28,118.46,NaN,NaN,NaN,120.41728101159033,NaN,NaN,120.41010000000013,123.27733175902432,117.54286824097593,118.57901952472355,121.057291172964,122.28982561919163,119.82475672673637,62820,60353.333333333336,34.552223104429814,38.72374599598539,NaN,NaN,NaN,NaN,0.5573705491407112,30.789490768000327,44139045,-0.09591377052744654,-0.4979076527206132,-0.4019938821931667
2025-09-10T13:10:00-04:00,118.46,118.54,118.11,118.13,NaN,NaN,NaN,120.07058642015441,NaN,NaN,120.40390000000012,123.28942753581732,117.51837246418292,118.27007249582307,121.0344161565756,122.28748563118681,119.7813466819644,32162,56514.2,31.800163088198033,38.343174720402544,NaN,NaN,NaN,NaN,0.548272652773518,32.048964306851,44106883,-0.1106645386174484,-0.5403245554649772,-0.42966001684752875
2025-09-10T13:15:00-04:00,118.14,118.22,117.88,118,NaN,NaN,NaN,119.7626052192383,NaN,NaN,120.39730000000013,123.30320929658001,117.49139070342025,118.27007249582307,120.98096254466053,122.28471762563093,119.67720746369012,71322,56072.7,30.760739026001872,37.5539230886582,NaN,NaN,NaN,NaN,0.5333960347182669,33.47094245645453,44035561,-0.11848798424516016,-0.5777699971539789,-0.45928201290881876
2025-09-10T13:20:00-04:00,118.03,118.485,117.88,118.47,NaN,NaN,NaN,119.7626052192383,NaN,NaN,120.40090000000014,123.29678652401194,117.50501347598833,118.20705799665845,120.96130265924768,122.28045367273894,119.64215164575641,29342,54479.36666666667,38.57755213185284,37.280714266298716,NaN,NaN,NaN,NaN,0.5385106036669625,33.94075759571725,44064903,-0.08299874403626017,-0.563030442954144,-0.4800316989178838
2025-09-10T13:25:00-04:00,118.49,118.84,118.3,118.76,NaN,NaN,NaN,119.7626052192383,NaN,NaN,120.40690000000014,123.28788100652483,117.52591899347544,118.15064639732675,120.93624685020032,122.27008773855142,119.60240596184921,43886,54022.3,42.86376510344384,37.18269594779911,NaN,NaN,NaN,NaN,0.5386169891193228,33.36092978786776,44108789,-0.03352036462669056,-0.521932154701247,-0.48841179007455643
2025-09-10T13:30:00-04:00,118.79,119.05,118.64,119.05,NaN,NaN,NaN,119.7626052192383,NaN,NaN,120.41870000000013,123.2723915110006,117.56500848899965,118.03981095543129,120.91011658690535,122.25485696753309,119.5653762062776,53359,53384.73333333333,46.85744917234702,37.69398704430962,NaN,NaN,NaN,NaN,0.5294300613250852,32.27631059732026,44162148,0.022208797502871636,-0.4606507931959669,-0.48285959069883855
2025-09-10T13:35:00-04:00,119.02,119.31,118.98,119.12,NaN,NaN,NaN,119.7626052192383,NaN,NaN,120.43130000000012,123.25623526297022,117.60636473703002,118.18154049478437,120.8950820978708,122.24394584585318,119.54621834988842,35319,50308.8,47.80580006618861,38.239973625138596,NaN,NaN,NaN,NaN,0.5151850569447218,30.63642164998178,44197467,0.06484390999485318,-0.40180470320527206,-0.46664861320012524
2025-09-10T13:40:00-04:00,119.11,119.23,118.65,118.7,NaN,NaN,NaN,119.7626052192383,NaN,NaN,120.41190000000013,123.27060242591976,117.5531975740805,118.18154049478437,120.8756819047406,122.23258779269297,119.51877601678824,40098,50347.833333333336,42.86328454003246,38.44975343493797,NaN,NaN,NaN,NaN,0.5198146957343844,29.71564665668541,44157369,0.06561847514179014,-0.3846255192728876,-0.4502439944146777
2025-09-10T13:45:00-04:00,118.66,118.87,118.5,118.68,NaN,NaN,NaN,119.7626052192383,NaN,NaN,120.37730000000012,123.27684286741324,117.477757132587,118.18154049478437,120.85716219535564,122.22314130025336,119.49118309045792,35835,49852.36666666667,42.637225553094204,38.8751433683783,NaN,NaN,NaN,NaN,0.5091136460390716,29.116299411694307,44121534,0.06549256395045444,-0.36837828947660967,-0.4338708534270641
2025-09-10T13:50:00-04:00,118.7,118.86,118.27,118.41,NaN,NaN,NaN,119.7626052192383,NaN,NaN,120.30760000000014,123.2253499824262,117.38985001757408,118.18154049478437,120.82932737035813,122.21070536915744,119.44794937155882,50984,49350.3,39.60082530238225,39.01131558088583,NaN,NaN,NaN,NaN,0.5148912427505667,28.936487245431096,44070550,0.04870516535268993,-0.3729893967362017,-0.4216945620888916
2025-09-10T13:55:00-04:00,118.4,118.55,118.16,118.54,NaN,NaN,NaN,119.7626052192383,NaN,NaN,120.22460000000012,123.10237611359267,117.34682388640758,118.18154049478437,120.80671404510947,122.20111962350727,119.41230846671168,40619,48901.26666666667,41.75171192782745,39.66246622107376,NaN,NaN,NaN,NaN,0.5059704396969549,28.944501838366232,44111169,0.047770749012764346,-0.3619811258229362,-0.4097518748357005
2025-09-10T14:00:00-04:00,118.555,118.66,118.36,118.56,NaN,NaN,NaN,119.7626052192383,NaN,NaN,120.17280000000011,123.07521703412505,117.27038296587517,118.18154049478437,120.78422401839657,122.1899126448288,119.37853539196435,43173,48492.96666666667,42.09336565660549,39.93501072680571,NaN,NaN,NaN,NaN,0.4912582654328865,28.632130858177096,44154342,0.0496928362573682,-0.3476358295139903,-0.3973286657713585
2025-09-10T14:05:00-04:00,118.55,118.6,118.25,118.29,NaN,NaN,NaN,119.7626052192383,NaN,NaN,120.10240000000013,123.0133038046555,117.19149619534477,118.18154049478437,120.76543006279893,122.18153245516997,119.34932767042788,34484,48372.7,38.7859001335584,39.997711120543975,NaN,NaN,NaN,NaN,0.481168389330537,28.5361305869884,44119858,0.03468418308685034,-0.3539734369127956,-0.38865761999964593
2025-09-10T14:10:00-04:00,118.25,118.5,118.15,118.43,NaN,NaN,NaN,119.7626052192383,NaN,NaN,120.03120000000011,122.92805937525091,117.13434062474931,118.18154049478437,120.71684664930076,122.1588407139082,119.27485258469332,90935,50328.36666666667,41.35886012018165,40.16491892329599,NaN,NaN,NaN,NaN,0.4717992186640697,28.623893586556242,44210793,0.03593663812299419,-0.3437368223459032,-0.3796734604688974
2025-09-10T14:15:00-04:00,118.41,118.41,118.02,118.08,NaN,NaN,NaN,119.74219726621834,NaN,NaN,119.96840000000012,122.89543497758106,117.04136502241917,118.18154049478437,120.69458842001411,122.14970602583263,119.2394708141956,39695,49571.63333333333,37.154345456563746,40.350784805591275,NaN,NaN,NaN,NaN,0.467384988759494,28.933731491426478,44171098,0.015963022852307218,-0.35971968190351333,-0.37568270475582055
2025-09-10T14:20:00-04:00,118.01,118.31,118,118.17,NaN,NaN,NaN,119.65505193593569,NaN,NaN,119.90320000000011,122.84230990607388,116.96409009392634,118.18154049478437,120.67615933443139,122.14188178680166,119.21043688206112,33267,49394.86666666667,38.87512195016544,40.856139010017515,NaN,NaN,NaN,NaN,0.45614320384810175,29.257277978498347,44204365,0.011775756969646056,-0.36096300854376295,-0.372738765513409
2025-09-10T14:25:00-04:00,118.17,118.46,117.94,118.32,NaN,NaN,NaN,119.65505193593569,NaN,NaN,119.83280000000012,122.7515272294574,116.91407277054284,118.0372323958275,120.63171223989345,122.12015136186277,119.14327311792412,85026,50785.03333333333,41.73840959739898,41.64025833654588,NaN,NaN,NaN,NaN,0.4607044035732371,29.014264065388083,44289391,0.021504792944612827,-0.345857774332643,-0.3673625672772558
2025-09-10T14:30:00-04:00,118.35,118.42,118.23,118.4,NaN,NaN,NaN,119.65505193593569,NaN,NaN,119.7582000000001,122.62852594664668,116.88787405335353,117.730785916662,120.61889769349912,122.11291359176282,119.12488179523542,26321,49921.73333333333,43.26485937833878,41.97506599700916,NaN,NaN,NaN,NaN,0.44136837474657714,28.788608288928557,44315712,0.034930034937771026,-0.323700023605042,-0.35863005854281305
2025-09-10T14:35:00-04:00,118.4,118.4,117.87,118.01,NaN,NaN,NaN,119.60126981392754,NaN,NaN,119.66940000000011,122.47511961535402,116.8636803846462,117.6536287333296,120.59372160780077,122.10129680381966,119.08614641178188,47189,49970,38.033381127885555,41.630038570183565,NaN,NaN,NaN,NaN,0.4476992051218217,29.304338095674566,44268523,0.019894299276732863,-0.333762184446897,-0.35365648372362984
2025-09-10T14:40:00-04:00,118,118.19,117.56,117.73,NaN,NaN,NaN,119.36053027693083,NaN,NaN,119.57740000000011,122.32927299125274,116.82552700874749,117.58192238933094,120.56117424533424,122.0892614388179,119.03308705185059,56344,50427.833333333336,34.78163091346484,40.767480123120556,NaN,NaN,NaN,NaN,0.46072069047026265,30.298290818612188,44212179,-0.005217427800763508,-0.36017826847458423,-0.3549608406738207
2025-09-10T14:45:00-04:00,117.74,117.98,117.64,117.83,NaN,NaN,NaN,119.27436980979762,NaN,NaN,119.48000000000009,122.12557744169432,116.83442255830586,117.58192238933094,120.5366964777901,122.07968216624906,118.99371078933115,43107,49714.9,36.857966088021875,39.98549198182293,NaN,NaN,NaN,NaN,0.4520977840081013,31.22124691848284,44255286,-0.011065589041110768,-0.3687928269752092,-0.35772723793409844
2025-09-10T14:50:00-04:00,117.81,117.87,117.62,117.74,NaN,NaN,NaN,119.17689845480682,NaN,NaN,119.3722000000001,121.84788266140647,116.89651733859374,117.56253791146474,120.51919850916886,122.07305280853508,118.96534420980264,30467,48371.1,35.75468129764734,39.477734607366855,NaN,NaN,NaN,NaN,0.43766222800752264,32.11218756155911,44224819,-0.016633285545754994,-0.37851884486629217,-0.3618855593205372
2025-09-10T14:55:00-04:00,117.73,117.9,117.6,117.76,NaN,NaN,NaN,119.1577212523156,NaN,NaN,119.2706000000001,121.58005849929907,116.96114150070113,117.50120442282878,120.49455153795412,122.06315292958298,118.92595014632526,43731,47219,36.211632602221066,39.01876368230448,NaN,NaN,NaN,NaN,0.4278292117212718,32.80271069790855,44268550,-0.01467547069434283,-0.3802298976884657,-0.3655544269941229
2025-09-10T15:00:00-04:00,117.75,117.92,116.88,117.04,NaN,NaN,NaN,118.88555210448307,NaN,NaN,119.1678000000001,121.40659535465102,116.92900464534918,117.50120442282878,120.4324281359346,122.04760578721522,118.81725048465398,96709,49737.86666666667,28.384582292140337,38.2176034672872,NaN,NaN,NaN,NaN,0.47155569659832425,34.50930954732287,44171841,-0.05529506586678978,-0.43467325932761014,-0.37937819346082036
2025-09-10T15:05:00-04:00,117,117.14,116.72,116.86,NaN,NaN,NaN,118.40529973609748,NaN,NaN,119.06080000000009,121.21766936090441,116.90393063909576,117.50120442282878,120.37920448877279,122.03879433841652,118.71961463912905,76699,51080.86666666667,26.823621060012854,37.1513112624433,NaN,NaN,NaN,NaN,0.4678731468413012,36.27269963568609,44095142,-0.08588444337938439,-0.48673374768505084,-0.40084930430566645
2025-09-10T15:10:00-04:00,116.84,117.17,116.69,117.05,NaN,NaN,NaN,118.4036952026385,NaN,NaN,118.9753000000001,121.10513136421568,116.84546863578453,117.50120442282878,120.3280134558563,122.0264781388449,118.6295487728677,77455,52631.13333333333,31.12900369135413,36.36814255063963,NaN,NaN,NaN,NaN,0.4687393506383514,37.91013328916622,44172597,-0.0847752454329676,-0.506818361096876,-0.42204311566390834
2025-09-10T15:15:00-04:00,117.035,117.55,116.83,117.54,NaN,NaN,NaN,118.4036952026385,NaN,NaN,118.9029000000001,120.97610726412023,116.82969273587997,117.50120442282878,120.28315713440566,122.00811158929208,118.55820267951923,77737,52175.03333333333,40.802268299687846,36.512168848220306,NaN,NaN,NaN,NaN,0.4866865398784691,37.869601664572315,44250334,-0.044517621403612984,-0.47769014241842456,-0.4331725210148116
2025-09-10T15:20:00-04:00,117.52,117.56,117.195,117.47,NaN,NaN,NaN,118.4036952026385,NaN,NaN,118.82990000000011,120.84183587372895,116.81796412627126,117.39996353826302,120.25695674164459,121.99563016901588,118.51828331427329,48159,51075.73333333333,39.93924368591636,36.41076767434421,NaN,NaN,NaN,NaN,0.4779946441728648,37.79394704274896,44202175,-0.017469320584438508,-0.4550091717453597,-0.4375398511609212
2025-09-10T15:25:00-04:00,117.49,117.56,117.17,117.285,NaN,NaN,NaN,118.4036952026385,NaN,NaN,118.76240000000011,120.75052900989456,116.77427099010566,117.07497083061041,120.23385055563605,121.9848380619981,118.482863049274,42168,50780.26666666667,37.67142024293496,36.44770158765645,NaN,NaN,NaN,NaN,0.47170931244623165,37.77030290269662,44160007,-0.007417499494169477,-0.446811725528633,-0.43939422603446354
2025-09-10T15:30:00-04:00,117.3,117.56,117.3,117.37,NaN,NaN,NaN,118.4036952026385,NaN,NaN,118.70110000000011,120.66805733558016,116.73414266442006,116.97030506527253,120.20921547002588,121.97221545635486,118.4462154836969,46876,51176.26666666667,39.37473509703009,36.483388241003915,NaN,NaN,NaN,NaN,0.45765864727150124,37.74834762979088,44206883,0.008701999519699188,-0.42851672663483953,-0.4372187261545387
2025-09-10T15:35:00-04:00,117.38,117.45,116.93,116.95,NaN,NaN,NaN,118.4036952026385,NaN,NaN,118.62150000000011,120.54281335288908,116.70018664711114,116.97030506527253,120.17708995198181,121.95879769409329,118.39538220987033,56281,50958.3,34.37581942908348,35.95748894326709,NaN,NaN,NaN,NaN,0.4621116010378223,38.400481210555085,44150602,-0.004468163113973911,-0.44280393004700613,-0.4383357669330322
2025-09-10T15:40:00-04:00,116.94,117.48,116.9,117.48,NaN,NaN,NaN,118.4036952026385,NaN,NaN,118.56010000000013,120.42640060814587,116.6937993918544,116.97030506527253,120.14984267721661,121.94499481401402,118.3546905404192,51670,51608.566666666666,44.032072762123065,36.012289899251684,NaN,NaN,NaN,NaN,0.47053220096369197,39.006033821264694,44202272,0.025330847928975053,-0.4066722070218134,-0.43200305495078845
2025-09-10T15:45:00-04:00,117.48,117.58,117.17,117.21,NaN,NaN,NaN,118.4036952026385,NaN,NaN,118.48810000000012,120.27784846276877,116.69835153723146,116.65624405221801,120.10347358333966,121.91974286322898,118.28720430345035,91310,52274.833333333336,40.7430220172197,36.205835677061266,NaN,NaN,NaN,NaN,0.466208472323428,39.09554407159364,44110962,0.029388126001326287,-0.3952678974491306,-0.4246560234504569
2025-09-10T15:50:00-04:00,117.26,117.47,116.94,117.39,NaN,NaN,NaN,118.4036952026385,NaN,NaN,118.43070000000013,120.17291584195777,116.68848415804248,116.46697716082464,120.05297082820937,121.89167201611784,118.2142696403009,101004,54663.566666666666,43.75913008301266,36.847085617743254,NaN,NaN,NaN,NaN,0.4707650100146118,39.60714625558236,44211966,0.04574926256126771,-0.36746944524887226,-0.41321870781014
2025-09-10T15:55:00-04:00,117.45,117.67,117.42,117.42,NaN,NaN,NaN,118.4036952026385,NaN,NaN,118.37650000000012,120.07186928130163,116.68113071869861,116.57366227605903,120.01364277424932,121.86496624726769,118.16231930123095,88885,56163.53333333333,44.26827721288606,37.376393555233555,NaN,NaN,NaN,NaN,0.457138937870711,39.18427855222758,44300851,0.059287620045741174,-0.33910918275296353,-0.3983968027987047
2025-09-11T09:30:00-04:00,117.88,119.07,117.4,118.33,116.6433302343061,116.6433302343061,116.6433302343061,NaN,NaN,NaN,118.33830000000013,119.94789698060387,116.72870301939639,117.35792982084722,118.26666666666665,118.26666857401528,118.26666475931802,85936,57249.433333333334,56.988182684740664,38.89307222574022,NaN,NaN,NaN,NaN,0.543771870879945,37.73369456606115,44386787,0.12637142690242975,-0.24043251917066755,-0.3668039460730973
2025-09-11T09:35:00-04:00,118.39,118.88,118.24,118.66,116.95340613274674,NaN,NaN,NaN,NaN,NaN,118.31830000000012,119.88601503787037,116.75058496212988,117.35792982084722,118.41022442545604,118.57235617568155,118.24809267523052,67374,58317.933333333334,60.50820577238401,40.628541737894714,NaN,NaN,NaN,NaN,0.5506453086742348,36.38672372176376,44454161,0.1861975690132618,-0.13405698480652006,-0.32025455381978185
2025-09-11T09:40:00-04:00,118.72,118.92,117.96,118.69,116.95340613274674,NaN,NaN,NaN,NaN,NaN,118.30610000000011,119.85241470276303,116.7597852972372,117.35792982084722,118.44882839375683,118.59092435510831,118.30673243240534,79436,59629.2,60.8221054076707,42.945507674718314,NaN,NaN,NaN,NaN,0.5798849294832186,34.426299663026114,44533597,0.2187688811692755,-0.04679345235818744,-0.26556233352746295
2025-09-11T09:45:00-04:00,118.7,119.61,118.45,119.29,117.28300021599445,NaN,NaN,NaN,NaN,NaN,118.29810000000012,119.81963329243291,116.77656670756733,117.56462006827377,118.68314715545563,119.0218043272489,118.34448998366236,125800,62628.03333333333,66.54887097562046,45.78302552583314,NaN,NaN,NaN,NaN,0.621321720234417,33.786656994442204,44659397,0.26842740176213653,0.06997191867520769,-0.1984554830869288
2025-09-11T09:50:00-04:00,119.35,119.7,119.19,119.47,117.70786384254015,NaN,NaN,NaN,NaN,NaN,118.29270000000014,119.7955269494408,116.78987305055948,117.80869605461902,118.83125974850982,119.26110869432323,118.40141080269642,85368,63774.166666666664,68.05736962549982,48.420765949700694,NaN,NaN,NaN,NaN,0.6133701687891018,33.32507639691037,44744765,0.29877745271338446,0.17501633280480178,-0.12376111990858268
2025-09-11T09:55:00-04:00,119.44,120.04,118.91,119.98,117.70786384254015,NaN,NaN,NaN,NaN,NaN,118.29450000000011,119.80517038098685,116.78382961901337,117.96195684369522,118.99510260168009,119.49878814193778,118.4914170614224,112201,66160.23333333334,71.92102005852792,50.64353393247499,NaN,NaN,NaN,NaN,0.6502722995898809,33.373372992375046,44856966,0.3358131839471554,0.2960053600253616,-0.03980782392179383
2025-09-11T10:00:00-04:00,119.98,120.06,119.33,119.86,117.8655639557029,NaN,NaN,NaN,NaN,NaN,118.30390000000013,119.84721628643675,116.7605837135635,118.03256547495617,119.0855221970204,119.61786938984437,118.55317500419642,75674,67243.6,69.7822319554024,52.775175951723995,NaN,NaN,NaN,NaN,0.6559671353334611,33.44549688092086,44781292,0.3341273814495844,0.3778514028901867,0.04372402144060228
2025-09-11T10:05:00-04:00,119.98,120.31,119.66,120.22,118.15008377589822,NaN,NaN,NaN,NaN,NaN,118.31980000000013,119.92416275199488,116.71543724800537,118.36305237996493,119.20464994252465,119.79723784472696,118.61206204032234,87650,69015.8,72.43097186908915,55.258001067877856,NaN,NaN,NaN,NaN,0.6555409113810714,33.85115508660997,44868942,0.33813097906567646,0.4663877452726979,0.12825676620702142
2025-09-11T10:10:00-04:00,120.29,120.5,119.95,120.1,118.39848905881193,NaN,NaN,NaN,NaN,NaN,118.33380000000012,119.98709315004342,116.68050684995683,118.66744190397195,119.36282000485554,120.01411734258961,118.71152266712146,138686,70607.5,70.22139155038168,57.461333671688685,NaN,NaN,NaN,NaN,0.6480022748538518,34.47064742489832,44730256,0.31408755971773017,0.5208662158541841,0.20677865613645396
2025-09-11T10:15:00-04:00,120.1,121.15,120.05,120.48,118.7065122834114,NaN,NaN,NaN,NaN,NaN,118.36240000000012,120.11098942007342,116.61381057992682,119.13395352317755,119.5185383231738,120.24736500040724,118.78971164594036,128306,73561.2,73.02743717205131,60.22216351047211,NaN,NaN,NaN,NaN,0.6802878266500059,35.74638621752308,44858562,0.30491817209667393,0.5879263712572964,0.2830081991606225
2025-09-11T10:20:00-04:00,120.5,120.68,119.69,119.87,118.7065122834114,NaN,NaN,NaN,NaN,NaN,118.37750000000013,120.16444403941239,116.59055596058786,119.13395352317755,119.56543269028276,120.28024228424826,118.85062309631726,89897,75448.86666666667,62.797689627500795,61.562564715141946,NaN,NaN,NaN,NaN,0.7024101247464347,35.92594440000526,44768665,0.24167775648264495,0.5851053947639286,0.3434276382812837
2025-09-11T10:25:00-04:00,119.87,119.88,119.02,119.045,118.7065122834114,NaN,NaN,NaN,NaN,NaN,118.38780000000014,120.18405405774661,116.59154594225367,119.13395352317755,119.55022221000505,120.24556166880923,118.85488275120086,69600,74934.66666666667,52.15637971222105,62.377804550499185,NaN,NaN,NaN,NaN,0.7136665444074036,34.54995125941156,44699065,0.13359020492461038,0.5104153944370466,0.37682518951243626
2025-09-11T10:30:00-04:00,119.05,119.56,119.03,119.32,118.7065122834114,NaN,NaN,NaN,NaN,NaN,118.39620000000014,120.20583483608577,116.5865651639145,119.13395352317755,119.53699714895943,120.21573698772762,118.85825731019123,64858,76219.23333333334,54.89980581271084,63.17356710262048,NaN,NaN,NaN,NaN,0.7005475055211605,33.27224334314597,44763923,0.07295441654905083,0.4680182101987498,0.39506379364969896
2025-09-11T10:35:00-04:00,119.28,119.41,118.82,118.83,118.7065122834114,NaN,NaN,NaN,NaN,NaN,118.39560000000012,120.20463912616374,116.58656087383649,119.13395352317755,119.51883128971001,120.19230153060712,118.84536104881289,44093,76116.03333333334,49.457877964567295,63.54425287059771,NaN,NaN,NaN,NaN,0.6926512551267922,31.638037138507407,44719830,-0.0037476884275873257,0.3903791831152148,0.3941268715428021
2025-09-11T10:40:00-04:00,118.87,118.97,118.54,118.74,NaN,NaN,NaN,120.67089356143535,120.67089356143535,120.67089356143535,118.39180000000013,120.1971274052031,116.58647259479716,119.13395352317755,119.47818974184024,120.15581866931946,118.80056081436102,70037,76572.46666666666,48.50680088209411,62.93843988469439,NaN,NaN,NaN,NaN,0.6738904511891636,29.55574460399722,44649793,-0.06096339103935955,0.31792263274360266,0.3788860237829622
2025-09-11T10:45:00-04:00,118.77,119.28,118.58,119.05,NaN,NaN,NaN,120.67089356143535,NaN,NaN,118.40360000000014,120.21824491291684,116.58895508708343,119.13395352317755,119.46673047427446,120.14091069610684,118.79255025244207,30565,76154.4,51.93534642305511,62.32609278831375,NaN,NaN,NaN,NaN,0.6757554189613664,28.17024657728101,44680358,-0.07730003906091937,0.282260974956813,0.3595610140177324
2025-09-11T10:50:00-04:00,119.06,119.08,118.41,118.665,NaN,NaN,NaN,120.67089356143535,NaN,NaN,118.41430000000013,120.22867483447882,116.59992516552143,119.13395352317755,119.43957203774038,120.11604283356395,118.7631012419168,51041,76840.2,47.68858194505818,61.38798396955572,NaN,NaN,NaN,NaN,0.6753443176069832,26.534310920496367,44629317,-0.11133518746799231,0.22039202968274196,0.3317272171507343
2025-09-11T10:55:00-04:00,118.67,119.02,118.43,118.96,NaN,NaN,NaN,120.6459701608239,NaN,NaN,118.43350000000014,120.25024791866451,116.61675208133576,119.13395352317755,119.42389779096581,120.09922435205458,118.74857122987704,35526,76566.7,50.995169340144,60.2770052813074,NaN,NaN,NaN,NaN,0.6692482949207693,25.015227810624914,44664843,-0.11102946751080267,0.1929403827622309,0.3039698502730336
2025-09-11T11:00:00-04:00,118.95,119.25,118.95,119.145,NaN,NaN,NaN,120.6459701608239,NaN,NaN,118.44700000000013,120.27463125383166,116.6193687461686,119.13395352317755,119.41905852950526,120.09017145000125,118.74794560900928,22951,74108.1,53.00149732385919,59.20158583119021,NaN,NaN,NaN,NaN,0.6428734167121427,24.045411192355264,44687794,-0.09598246730594073,0.18399176614060764,0.27997423344654837
2025-09-11T11:05:00-04:00,119.17,119.96,119.17,119.72,NaN,NaN,NaN,120.6459701608239,NaN,NaN,118.46620000000013,120.32645972379603,116.60594027620422,118.57216281854204,119.42457108636799,120.0870566758597,118.76208549687628,42041,72952.83333333333,58.66587939861666,58.254790069767985,NaN,NaN,NaN,NaN,0.6551681726612752,24.27086629871283,44729835,-0.04737705449548163,0.22075291532719632,0.26812996982267795
2025-09-11T11:10:00-04:00,119.76,120,119.71,119.81,NaN,NaN,NaN,120.6459701608239,NaN,NaN,118.48140000000014,120.37265359483366,116.5901464051666,118.58332851656863,119.4350807066562,120.09237792388045,118.77778348943194,39115,71674.83333333333,59.48888364684456,57.51955090487099,NaN,NaN,NaN,NaN,0.6290847317568989,24.535773559191252,44768950,-0.011129439915473438,0.2542181699283361,0.26534760984380956
2025-09-11T11:15:00-04:00,119.84,120.38,119.77,120.36,NaN,NaN,NaN,120.6459701608239,NaN,NaN,118.50620000000013,120.46172710029207,116.5506728997082,118.94166281325491,119.45822488928422,120.11769985587225,118.7987499226962,50275,70759.43333333333,64.18236545670005,56.930364732557486,NaN,NaN,NaN,NaN,0.6277215366314062,25.288660002191772,44819225,0.04485387789235762,0.3214149572092566,0.276561079316899
2025-09-11T11:20:00-04:00,120.35,120.4,120.03,120.21,NaN,NaN,NaN,120.6459701608239,NaN,NaN,118.53640000000014,120.54877873174067,116.52402126825962,119.06433025060393,119.47574843863259,120.13736735466503,118.81412952260015,37928,70418.4,62.070249902605035,56.34814032914487,NaN,NaN,NaN,NaN,0.6093128554434488,26.01352516455152,44781297,0.0654978183786567,0.3584333522902199,0.2929355339115632
2025-09-11T11:25:00-04:00,120.28,120.7,120.25,120.7,118.67203316329662,118.67203316329662,118.67203316329662,NaN,NaN,NaN,118.57680000000013,120.67822405048727,116.475375949513,119.38646420048313,119.50799506133568,120.18490034966483,118.83108977300652,50578,70698.73333333334,66.00572560740385,55.84658950309863,NaN,NaN,NaN,NaN,0.6007905086260603,27.066301935439856,44831875,0.10360355439090418,0.4224399769001934,0.31883642250928923
2025-09-11T11:30:00-04:00,120.71,121.08,120.655,120.69,119.08853165587406,NaN,NaN,NaN,NaN,NaN,118.62240000000014,120.80475857731123,116.44004142268905,119.81667136038651,119.60306799915946,120.33743030251358,118.86870569580535,132910,73566.53333333334,65.85555039963157,56.06500812967939,NaN,NaN,NaN,NaN,0.5882340437241986,28.47118090531157,44698965,0.11851147453299105,0.466975765675528,0.34846429114253696
2025-09-11T11:35:00-04:00,120.68,120.76,120.43,120.5,119.08853165587406,NaN,NaN,NaN,NaN,NaN,118.66160000000015,120.90615558183862,116.41704441816168,119.81667136038651,119.62206987629666,120.3613277825539,118.88281197003943,36698,72913.76666666666,62.92610268662325,56.834274056422416,NaN,NaN,NaN,NaN,0.5697887548867557,29.141723840509957,44662267,0.10634066418597043,0.48139012137500004,0.3750494571890296
2025-09-11T11:40:00-04:00,120.5,120.78,120.185,120.78,119.08853165587406,NaN,NaN,NaN,NaN,NaN,118.70600000000013,121.02727723462158,116.38472276537868,119.81667136038651,119.64353930568458,120.38813060651356,118.89894800485561,42442,72606.16666666667,65.37079918054948,57.58220215412517,NaN,NaN,NaN,NaN,0.5715895581091301,29.11215881736529,44704709,0.10758737427038828,0.509533675027015,0.4019463007566267
2025-09-11T11:45:00-04:00,120.79,120.93,120.53,120.8,119.08853165587406,NaN,NaN,NaN,NaN,NaN,118.75620000000013,121.14684640630345,116.36555359369682,119.81667136038651,119.66152407505177,120.41323382624212,118.90981432386143,31248,70604.1,65.5455657965852,58.73132271355502,NaN,NaN,NaN,NaN,0.5593331611013356,29.297725753874353,44735957,0.10034076563669647,0.5273722578024973,0.42703149216580083
2025-09-11T11:50:00-04:00,120.81,121,120.71,120.86,119.17340993385885,NaN,NaN,NaN,NaN,NaN,118.80480000000014,121.26474061716291,116.34485938283737,119.9026605892143,119.69091757960761,120.45605524731114,118.92577991190409,48619,68857.93333333333,66.0983339171332,59.98786078748639,NaN,NaN,NaN,NaN,0.5400950781655264,29.57050191885623,44784576,0.09047459822342752,0.5401247399450853,0.44965014172165774
2025-09-11T11:55:00-04:00,120.89,121.02,120.8,120.92,119.27484584595618,NaN,NaN,NaN,NaN,NaN,118.86160000000014,121.38237403984844,116.34082596015183,120.03212847137145,119.70909519127575,120.48280072771493,118.93538965483657,29840,66889.76666666666,66.67412392530048,61.04063060907534,NaN,NaN,NaN,NaN,0.5172311440108458,29.85387875940928,44814416,0.07927753300479373,0.5487470579776499,0.46946952497285616
2025-09-11T12:00:00-04:00,120.96,121.37,120.74,121.18,119.40826194386727,NaN,NaN,NaN,NaN,NaN,118.92180000000013,121.51632096541586,116.32727903458441,120.26470277709716,119.76443475886613,120.56971174912229,118.95915776860997,83356,66803.76666666666,69.1215279262075,62.57155532201458,NaN,NaN,NaN,NaN,0.5252860622957861,30.620652744215764,44897772,0.08041609871618954,0.5699896483680931,0.48957354965190353
2025-09-11T12:05:00-04:00,121.19,121.54,121.04,121.515,119.64993185550968,NaN,NaN,NaN,NaN,NaN,118.98570000000012,121.67348868960879,116.29791131039146,120.40576222167773,119.80575890147219,120.64012261348753,118.97139518945684,55392,66404.36666666667,71.97710109793208,64.07026473328516,NaN,NaN,NaN,NaN,0.5234799149889443,31.555769256054727,44953164,0.093829753648496,0.6068607417125236,0.5130309880640276
2025-09-11T12:10:00-04:00,121.51,121.68,120.94,120.99,119.64993185550968,NaN,NaN,NaN,NaN,NaN,119.03750000000012,121.77746514576083,116.29753485423942,120.40576222167773,119.86016272013525,120.72163626376968,118.99868917650082,86899,66653.13333333333,62.25982454651612,64.7315738206178,NaN,NaN,NaN,NaN,0.5389456353468776,32.60320975162853,44866265,0.05913698286836111,0.5869522166494789,0.5278152337811178
2025-09-11T12:15:00-04:00,121,121.05,120.47,120.8,119.64993185550968,NaN,NaN,NaN,NaN,NaN,119.09330000000013,121.8607910008837,116.32580899911656,120.40576222167773,119.87882669173123,120.74118592300107,119.0164674604614,46578,64012.4,59.1476313443349,64.76598467388338,NaN,NaN,NaN,NaN,0.5418780899649576,32.126963663413704,44819687,0.017354821032161016,0.5495087600713191,0.5321539390391581
2025-09-11T12:20:00-04:00,120.835,120.86,120.49,120.84,119.64993185550968,NaN,NaN,NaN,NaN,NaN,119.15550000000012,121.93739162261758,116.37360837738265,120.40576222167773,119.888081844237,120.75027055358757,119.02589313488645,25052,62001.86666666667,59.60542813161448,64.77430927993838,NaN,NaN,NaN,NaN,0.5296010835388895,31.684735152928507,44844739,-0.012042036278043233,0.517101393691604,0.5291434299696472
2025-09-11T12:25:00-04:00,120.86,121,120.79,120.84,119.64993185550968,NaN,NaN,NaN,NaN,NaN,119.21570000000011,122.01049373836136,116.42090626163886,120.40576222167773,119.9040948732314,120.76832987882548,119.03985986763732,37934,59526.3,59.60542813161448,64.4473851852894,NaN,NaN,NaN,NaN,0.5067724347146826,31.516030720191957,44844739,-0.0346602531345499,0.4858181135514599,0.5204783666860098
2025-09-11T12:30:00-04:00,120.86,121.39,120.86,121.09,119.64993185550968,NaN,NaN,NaN,NaN,NaN,119.28270000000012,122.0933477616346,116.47205223836563,120.40576222167773,119.9224170225078,120.79270741843352,119.05212662658208,36030,58204.833333333336,62.640092559085595,64.48808823218089,NaN,NaN,NaN,NaN,0.5098601179493479,31.968432723358404,44880769,-0.03581065149394613,0.47571505231857714,0.5115257038125233
2025-09-11T12:35:00-04:00,121.1,121.47,121.06,121.29,119.6812680974875,NaN,NaN,NaN,NaN,NaN,119.3533000000001,122.18466971093346,116.52193028906674,120.40576222167773,119.94308511119948,120.82246630338274,119.06370391901622,36946,56514.7,64.91116645744523,64.40990543575526,NaN,NaN,NaN,NaN,0.5027272523815371,32.503761848104915,44917715,-0.02655439480955668,0.47833271030057745,0.5048871051101341
2025-09-11T12:40:00-04:00,121.27,121.36,120.98,121.25,119.6812680974875,NaN,NaN,NaN,NaN,NaN,119.43750000000011,122.23892552997205,116.63607447002818,120.40576222167773,119.9661261527493,120.85351029944135,119.07874200605724,45217,53399.066666666666,64.07226637023574,64.28252800508413,NaN,NaN,NaN,NaN,0.4939610200685699,32.72993710453406,44872498,-0.026516393103843072,0.4717416137303303,0.4982580068341734
2025-09-11T12:45:00-04:00,121.23,121.41,121.11,121.24,119.72659965080989,NaN,NaN,NaN,NaN,NaN,119.52510000000011,122.27204920957561,116.7781507904246,120.40576222167773,119.98320203334097,120.87689831431501,119.08950575236693,33074,50224.666666666664,63.85010062177895,64.34852785759526,NaN,NaN,NaN,NaN,0.4801066614922433,33.022555947474565,44839424,-0.03028324100555102,0.46040395557723457,0.4906871965827856
2025-09-11T12:50:00-04:00,121.25,121.5,121.11,121.44,119.78811784850036,NaN,NaN,NaN,NaN,NaN,119.6129000000001,122.31810837644586,116.90769162355433,120.48776903518181,119.99510182097133,120.89391345965186,119.0962901822908,21897,47958,66.3622670920075,64.41934699412796,NaN,NaN,NaN,NaN,0.4736704713856545,33.446215632620365,44861321,-0.02276669950394039,0.4622288222028601,0.4849955217068005
2025-09-11T12:55:00-04:00,121.44,121.65,121.37,121.57,120.02388521902307,NaN,NaN,NaN,NaN,NaN,119.6935000000001,122.38697971961778,117.00002028038242,120.70021522814547,120.01185827223341,120.91986797109085,119.10384857337597,27760,46563.333333333336,67.9226728200309,64.58914035294552,NaN,NaN,NaN,NaN,0.45983686628667925,34.08812812549463,44889081,-0.012987324199781713,0.46876136645707334,0.48174869065685505
2025-09-11T13:00:00-04:00,121.58,121.66,121.19,121.25,120.02388521902307,NaN,NaN,NaN,NaN,NaN,119.7691000000001,122.42056577575481,117.11763422424538,120.70021522814547,120.03188916285808,120.94787410008747,119.11590422562868,38160,45673.4,60.48480566935127,64.18817404953252,NaN,NaN,NaN,NaN,0.4605628044090592,33.98627013656953,44850921,-0.030990647498661317,0.44301038128352843,0.47400102878218975
2025-09-11T13:05:00-04:00,121.33,121.37,121.11,121.28,120.02388521902307,NaN,NaN,NaN,NaN,NaN,119.84900000000009,122.43621858373116,117.26178141626902,120.70021522814547,120.05194604680683,120.97354634781462,119.13034574579905,43089,45639.933333333334,60.91690004438347,63.77694377232416,NaN,NaN,NaN,NaN,0.44623688980841253,33.590447247560526,44894010,-0.04305704779462144,0.42017971903891294,0.4632367668335344
2025-09-11T13:10:00-04:00,121.3,121.31,121.03,121.16,120.02388521902307,NaN,NaN,NaN,NaN,NaN,119.9248000000001,122.43808069263935,117.41151930736086,120.70021522814547,120.0611747795306,120.98449362432113,119.13785593474007,21906,44035.566666666666,58.17654345266025,62.99515916707078,NaN,NaN,NaN,NaN,0.43436282625066885,32.91919523806887,44872104,-0.060244272978549895,0.387931425610347,0.4481756985888969
2025-09-11T13:15:00-04:00,121.15,121.15,120.83,120.88,120.02388521902307,NaN,NaN,NaN,NaN,NaN,120.0034000000001,122.38182505872946,117.62497494127074,120.70021522814547,120.06854903257181,120.99158517279933,119.14551289234429,22053,43751.833333333336,52.26816865193632,61.587378278071085,NaN,NaN,NaN,NaN,0.4269083386613352,31.569990117391512,44850051,-0.08981366657724188,0.3359086153673445,0.4257222819445864
2025-09-11T13:20:00-04:00,120.85,121.01,120.74,121.01,120.02388521902307,NaN,NaN,NaN,NaN,NaN,120.07400000000011,122.35624100392245,117.79175899607777,120.70021522814547,120.07461242029419,120.99713849679551,119.15208634379286,19136,42688.333333333336,54.57484440727273,61.03845112526799,NaN,NaN,NaN,NaN,0.4157006001855263,30.00648071585471,44869187,-0.09922394130350021,0.3016923553152111,0.4009162966187113
2025-09-11T13:25:00-04:00,120.99,121.14,120.64,120.65,120.02388521902307,NaN,NaN,NaN,NaN,NaN,120.1428000000001,122.2782232929333,118.00737670706688,120.70021522814547,120.07905601413674,121.00055472134196,119.15755730693152,16336,42048.666666666664,47.70030727673437,60.22078512043938,NaN,NaN,NaN,NaN,0.4217219858865601,28.915993864723927,44852851,-0.12655007255412504,0.242728705926055,0.36927877848018004
2025-09-11T13:30:00-04:00,120.64,120.7,120.48,120.52,120.02388521902307,NaN,NaN,NaN,NaN,NaN,120.20540000000008,122.19273675053128,118.21806324946888,120.70021522814547,120.0840128638429,121.0021196654463,119.1659060622395,27765,42209.13333333333,45.47275571975522,59.21130851959229,NaN,NaN,NaN,NaN,0.4073132726089486,27.337010510944843,44825086,-0.1487065387401122,0.18339560505503982,0.332102143795152
2025-09-11T13:35:00-04:00,120.52,120.85,120.51,120.82,120.02388521902307,NaN,NaN,NaN,NaN,NaN,120.2734000000001,122.10111818396938,118.44568181603081,120.70021522814547,120.08920748517968,121.00540509957351,119.17300987078586,22257,41549.666666666664,51.14293215739944,58.60684452143407,NaN,NaN,NaN,NaN,0.4025051817083086,26.30495542017374,44847343,-0.13868075272371055,0.1587512028905138,0.29743195561422436
2025-09-11T13:40:00-04:00,120.85,120.85,120.03,120.44,120.02388521902307,NaN,NaN,NaN,NaN,NaN,120.31560000000009,122.05729646035581,118.57390353964436,120.70021522814547,120.09519600231275,121.00467546713158,119.18571653749392,47823,41839.933333333334,44.7895273408344,57.331804148701835,NaN,NaN,NaN,NaN,0.4323262401577147,24.98521761729329,44799520,-0.15208925267881646,0.1073203897657038,0.25940964244452025
2025-09-11T13:45:00-04:00,120.46,120.46,119.71,119.76,NaN,NaN,NaN,121.50963456906437,121.50963456906437,121.50963456906437,120.3376000000001,122.02193516854756,118.65326483145263,120.66517218251636,120.09363600912249,120.99721168908441,119.19006032916057,37361,41409.46666666667,36.13796411354007,55.276575409851475,NaN,NaN,NaN,NaN,0.4550172230035922,24.52619741933804,44762159,-0.1982816703330938,0.011557554528152991,0.2098392248612468
2025-09-11T13:50:00-04:00,119.8,119.86,119.36,119.365,NaN,NaN,NaN,121.03806027047054,NaN,NaN,120.3511000000001,121.9926739885872,118.709526011413,120.4441377460131,120.08802238733963,120.98884607340119,119.18719870127808,28472,41094.26666666667,32.24201601763018,53.00298609895107,NaN,NaN,NaN,NaN,0.4582302785033356,24.801461401596807,44733687,-0.24396097138542686,-0.09511198937053678,0.14884898201489008
2025-09-11T13:55:00-04:00,119.4,119.84,119.34,119.74,NaN,NaN,NaN,121.02133025817643,NaN,NaN,120.36010000000009,121.98313479938632,118.73706520061386,120.42931019681048,120.0836942121119,120.9812265321863,119.18616189203749,27969,40340.63333333333,38.96897806670863,51.22576305930319,NaN,NaN,NaN,NaN,0.4612138300388116,25.09474732647739,44761656,-0.23722843890813589,-0.1476865666202798,0.08954187228785611
2025-09-11T14:00:00-04:00,119.76,120.05,119.54,119.61,NaN,NaN,NaN,121.02133025817643,NaN,NaN,120.3629000000001,121.98025597813181,118.74554402186838,120.28044815744839,120.0803574452625,120.97425350822371,119.1864613823013,27838,36838.23333333333,37.576242644910735,49.16961845593914,NaN,NaN,NaN,NaN,0.46469855646461017,24.659100517012206,44733818,-0.22968534366713367,-0.19756480729606096,0.03212053637107269
2025-09-11T14:05:00-04:00,119.57,119.74,119.5,119.64,NaN,NaN,NaN,121.02133025817643,NaN,NaN,120.3561000000001,121.98267098216402,118.72952901783617,120.22548682076696,120.07747553126411,120.9692567115313,119.18569435099693,18686,36237.833333333336,38.1258109902716,47.041271182384904,NaN,NaN,NaN,NaN,0.4486486595742805,24.344413932803445,44752504,-0.21129529933634064,-0.23199858779935312,-0.020703288463012476
2025-09-11T14:10:00-04:00,119.64,119.66,119.43,119.43,NaN,NaN,NaN,120.91585645388541,NaN,NaN,120.34750000000011,121.98895088260196,118.70604911739827,120.22548682076696,120.07512608064252,120.96582013165003,119.184432029635,12158,35228.36666666667,35.75298016622591,45.27471221787595,NaN,NaN,NaN,NaN,0.4330308981761169,24.214155378032213,44740346,-0.2019052885567236,-0.273084899158917,-0.07117961060219338
2025-09-11T14:15:00-04:00,119.47,119.48,119.09,119.2,NaN,NaN,NaN,120.64672661507244,NaN,NaN,120.3271000000001,121.99944456975949,118.65475543024071,120.00671156529086,120.06736446960338,120.95736719642711,119.17736174277964,28280,35129.433333333334,33.30792591616667,43.302642637289026,NaN,NaN,NaN,NaN,0.4299572625921086,24.80968684644322,44712066,-0.19946473461117778,-0.3205105288661656,-0.12104579425498782
2025-09-11T14:20:00-04:00,119.28,119.3,118.99,118.99,NaN,NaN,NaN,120.48710267802369,NaN,NaN,120.3049000000001,122.01769478046893,118.59210521953128,120.00671156529086,120.05817200786535,120.94895737590674,119.16738663982396,28412,34455.86666666667,31.209293707073115,41.37641051260424,NaN,NaN,NaN,NaN,0.42138888669267244,25.552458549246627,44683654,-0.1997769296924231,-0.3707669563705167,-0.1709900266780936
2025-09-11T14:25:00-04:00,119,119.05,118.8,118.93,NaN,NaN,NaN,120.24018891993171,NaN,NaN,120.2739000000001,122.02849316082472,118.51930683917547,119.76536925223269,120.04728346219686,120.94062806165677,119.15393886273695,29252,34436.26666666667,30.61575324306142,39.82980941197031,NaN,NaN,NaN,NaN,0.40914682335748154,26.58737101845285,44654402,-0.19177014714588597,-0.41070271061045105,-0.21893256346456508
2025-09-11T14:30:00-04:00,118.94,119.14,118.9,119.05,NaN,NaN,NaN,120.24018891993171,NaN,NaN,120.2575000000001,122.04196210383337,118.47303789616684,119.21729540178615,120.03848874046493,120.93293518535498,119.14404229557488,26509,32541.366666666665,33.34603253866857,38.313465707070016,NaN,NaN,NaN,NaN,0.39706490740337536,27.181705026476543,44680911,-0.16704465691565057,-0.4277383846091283,-0.2606937276934777
2025-09-11T14:35:00-04:00,119.03,119.11,118.78,119.03,NaN,NaN,NaN,120.21958329274769,NaN,NaN,120.25720000000013,122.0424822297882,118.47191777021204,118.79873524571451,120.03133873575275,120.92701102138179,119.13566645012372,20722,31385.7,33.11216646333099,37.27145564896978,NaN,NaN,NaN,NaN,0.39227455687456275,27.96606198198005,44660189,-0.1416901000309857,-0.4378063527322098,-0.2961162527012241
2025-09-11T14:40:00-04:00,119.04,119.13,118.79,118.83,NaN,NaN,NaN,120.21958329274769,NaN,NaN,120.24740000000013,122.05834808318482,118.43645191681543,118.79873524571451,120.02551470201233,120.92245129837814,119.12857810564653,16214,29029.533333333333,30.786895149364753,36.2224656082276,NaN,NaN,NaN,NaN,0.3885406599549504,28.60661381734859,44643975,-0.12843462321092208,-0.4566595317148767,-0.32822490850395464
2025-09-11T14:45:00-04:00,118.82,119.16,118.77,119.05,NaN,NaN,NaN,120.21958329274769,NaN,NaN,120.25180000000012,122.04997547530978,118.45362452469045,118.79873524571451,120.01773110038316,120.91573005591849,119.11973214484783,23579,28262.9,36.10243879390803,35.148144653692505,NaN,NaN,NaN,NaN,0.3886448985295968,29.062866021688077,44667554,-0.09636134208640262,-0.44867658611195793,-0.3523152440255553
2025-09-11T14:50:00-04:00,119.07,119.08,118.85,119.02,NaN,NaN,NaN,120.19792974024571,NaN,NaN,120.2574000000001,122.03836966847243,118.47643033152778,118.6481905572573,120.01404509536428,120.91255929924998,119.11553089147858,11182,27800.566666666666,35.69980661862725,34.49887888782057,NaN,NaN,NaN,NaN,0.37731312006319734,29.486528782860454,44656372,-0.06990954914434078,-0.4397021804559813,-0.36979263131164053
2025-09-11T14:55:00-04:00,119.02,119.38,118.98,119.17,NaN,NaN,NaN,120.19792974024571,NaN,NaN,120.2598000000001,122.03456754534666,118.48503245465353,118.6481905572573,120.00865096196355,120.90676846679904,119.11053345712807,20345,27214.266666666666,39.34240912663082,34.72776781732705,NaN,NaN,NaN,NaN,0.3789336114872541,28.51939218091398,44676717,-0.0367213252933305,-0.41569428792830365,-0.37897296263497315
2025-09-11T15:00:00-04:00,119.19,119.19,118.74,118.77,NaN,NaN,NaN,120.19792974024571,NaN,NaN,120.2619000000001,122.02934775312303,118.49445224687716,118.53546220822614,120.00189445630146,120.9014188946303,119.10237001797262,19366,26658.8,33.837488733104436,34.841730154146646,NaN,NaN,NaN,NaN,0.38400978209530756,28.272068801502847,44657351,-0.03606663836154844,-0.4240562605869087,-0.38798962222536026
2025-09-11T15:05:00-04:00,118.78,118.98,118.63,118.72,NaN,NaN,NaN,120.03333042115098,NaN,NaN,120.2571000000001,122.03990126767795,118.47429873232224,118.53546220822614,119.9954852698842,120.89699689171054,119.09397364805785,16710,25984.266666666666,33.21191471477103,34.43051134329396,NaN,NaN,NaN,NaN,0.38158051194564335,28.314249945205216,44640641,-0.03341927636165709,-0.4297637176774316,-0.3963444413157745
2025-09-11T15:10:00-04:00,118.7,118.91,118.66,118.8,NaN,NaN,NaN,119.99158812928047,NaN,NaN,120.25020000000009,122.05272596098698,118.44767403901321,118.53546220822614,119.98869030691216,120.89217643345552,119.0852041803688,18108,25080.633333333335,35.27380394088296,34.266051435863396,NaN,NaN,NaN,NaN,0.37218190394952594,28.3534181500717,44658749,-0.021289257737033718,-0.4229560134870667,-0.40166675575003297
2025-09-11T15:15:00-04:00,118.83,119.07,118.78,119.02,NaN,NaN,NaN,119.99158812928047,NaN,NaN,120.2362000000001,122.06565298929026,118.40674701070994,118.53546220822614,119.98478268541272,120.88878152683213,119.08078384399332,12210,24385.166666666668,40.69591401881149,34.44963022361624,NaN,NaN,NaN,NaN,0.36631176795313064,27.66350390239807,44670959,0.005131426189397215,-0.3952524730132865,-0.4003838992026837
2025-09-11T15:20:00-04:00,119.04,119.11,118.6,118.6,NaN,NaN,NaN,119.99158812928047,NaN,NaN,120.2120000000001,122.09460351641484,118.32939648358537,118.53546220822614,119.97234250977036,120.87997814596311,119.0647068735776,33365,24767.433333333334,34.716771918148154,34.37561534875355,NaN,NaN,NaN,NaN,0.37657521309933595,27.529609702727726,44637594,-0.001730794040290029,-0.4025473917530462,-0.4008165977127562
2025-09-11T15:25:00-04:00,118.6,118.6,118.31,118.52,NaN,NaN,NaN,119.64638079125342,NaN,NaN,120.17520000000009,122.11583284524374,118.23456715475643,118.53546220822614,119.95507403239809,120.87149151225412,119.03865655254205,38056,25110.633333333335,33.70109073884207,34.40369855037322,NaN,NaN,NaN,NaN,0.37039126930652566,28.102261149005,44599538,-0.007392414346581888,-0.41005711564598357,-0.4026647012994017
2025-09-11T15:30:00-04:00,118.51,118.67,118.08,118.09,NaN,NaN,NaN,119.59268166437826,NaN,NaN,120.1328000000001,122.15927789033732,118.10632210966288,118.53546220822614,119.93255991050333,120.86301096964495,119.00210885136171,44906,25335.5,28.820400624187386,34.23306333016709,NaN,NaN,NaN,NaN,0.3860776072132026,29.098833399311886,44554632,-0.03432406391709619,-0.44556978119577195,-0.41124571727867576
2025-09-11T15:35:00-04:00,118.1,118.35,117.88,118.34,NaN,NaN,NaN,119.34142340690653,NaN,NaN,120.0856000000001,122.16624762995184,118.00495237004836,118.53546220822614,119.90405099025322,120.8529667428588,118.95513523764765,55570,25751.533333333333,34.73810410075791,34.5275169628597,NaN,NaN,NaN,NaN,0.39207206384083093,30.381755563124425,44610202,-0.029701311307825662,-0.44837235641345785,-0.4186710451056322
2025-09-11T15:40:00-04:00,118.35,118.36,118.02,118.15,NaN,NaN,NaN,119.34142340690653,NaN,NaN,120.0348000000001,122.17705858383995,117.89254141616026,118.53546220822614,119.88714224340667,120.84659469578511,118.92768979102823,33577,26140.566666666666,32.52494561482062,34.468867896870556,NaN,NaN,NaN,NaN,0.3883526307093432,31.524407702514118,44576625,-0.033555279836474994,-0.4606151449012259,-0.4270598650647509
2025-09-11T15:45:00-04:00,118.15,118.45,118.01,118.28,NaN,NaN,NaN,119.34142340690653,NaN,NaN,119.9904000000001,122.18366682372161,117.79713317627858,118.2893697665809,119.85618084378646,120.83240208074574,118.87995960682719,65985,27604.966666666667,35.550469564831815,34.64303240412062,NaN,NaN,NaN,NaN,0.3920417285158186,32.13641041507391,44642610,-0.022022129862419138,-0.45458752739277486,-0.4325653975303557
2025-09-11T15:50:00-04:00,118.27,118.29,117.79,117.86,NaN,NaN,NaN,119.274369569061,NaN,NaN,119.9320000000001,122.19252825685194,117.67147174314826,118.25187732048941,119.82147953473475,120.82112101541807,118.82183805405143,65883,29163.2,30.752777981064753,34.64059546352776,NaN,NaN,NaN,NaN,0.39975303362183157,33.13933692348088,44576727,-0.036498741099283805,-0.4781888239044605,-0.4416900828051767
2025-09-11T15:55:00-04:00,117.85,117.9,117.65,117.72,NaN,NaN,NaN,118.98735277046731,NaN,NaN,119.8704000000001,122.19977145170517,117.54102854829503,118.25187732048941,119.76814475998158,120.80773747835302,118.72855204161014,94449,31766.966666666667,29.331794444484757,34.15697800999752,NaN,NaN,NaN,NaN,0.3890563883631293,34.32081945621519,44482278,-0.048566745004999246,-0.5023985140614258,-0.4538317690564265
2025-09-12T09:30:00-04:00,117.93,118.57,117.12,117.84,NaN,NaN,NaN,118.98735277046731,NaN,NaN,119.81000000000012,122.18967140589011,117.43032859411012,118.25187732048941,117.84333333333332,117.84333333333332,117.84333333333332,123404,34954.933333333334,32.22265497573052,33.9086100355049,NaN,NaN,NaN,NaN,0.4648380749086192,32.732605648015955,44605682,-0.04178916976336078,-0.5060682312606275,-0.4642790614972667
2025-09-12T09:35:00-04:00,117.7,118,116.67,117.01,NaN,NaN,NaN,118.80974704912414,NaN,NaN,119.7318000000001,122.21514593643776,117.24845406356245,118.20050185639154,117.60037761113648,117.90170005039958,117.29905517187338,80227,36887.26666666667,24.697205806381774,32.862524084058535,NaN,NaN,NaN,NaN,0.5266353552722892,32.22325307512523,44525455,-0.08408637696110083,-0.5693870326986428,-0.48530065573754194
2025-09-12T09:40:00-04:00,117.03,117.48,116.48,116.92,NaN,NaN,NaN,118.5240767287094,NaN,NaN,119.6466000000001,122.21616917789903,117.07703082210118,117.72740148511323,117.41965277141331,117.80467487425328,117.03463066857334,80063,37961.933333333334,24.04154006775471,32.16281346510498,NaN,NaN,NaN,NaN,0.5604471156099828,32.097498921204334,44445392,-0.1075086964740799,-0.6196865263301419,-0.512177829856062
2025-09-12T09:45:00-04:00,116.87,117.53,116.57,116.82,NaN,NaN,NaN,118.5240767287094,NaN,NaN,119.5527000000001,122.18467964278189,116.92072035721831,117.67692118809059,117.3258396298379,117.71333457758391,116.9383446820919,75500,39233.23333333333,23.301325760495175,31.45491425408528,NaN,NaN,NaN,NaN,0.5889866073521274,31.811310633320172,44369892,-0.11826590793333092,-0.6600102147727256,-0.5417443068393947
2025-09-12T09:50:00-04:00,116.85,116.93,115.99,116.12,NaN,NaN,NaN,118.12003685405135,NaN,NaN,119.4553000000001,122.22419466033314,116.68640533966705,117.43514364830239,117.09484108531252,117.63108432791745,116.5585978427076,110901,41980.86666666667,18.911855959940482,30.28620368401796,NaN,NaN,NaN,NaN,0.614058992541262,32.49619556399893,44258991,-0.1585420105919494,-0.7399218200793314,-0.581379809487382
2025-09-12T09:55:00-04:00,116.1,116.49,115.61,115.74,NaN,NaN,NaN,117.75458063341263,NaN,NaN,119.35410000000009,122.28419057198313,116.42400942801704,117.43514364830239,116.87973813545109,117.53882186041041,116.22065441049178,108372,44660.96666666667,17.035728329077173,28.59619042046551,NaN,NaN,NaN,NaN,0.6330547787883144,33.61562459403852,44150619,-0.19442564079036384,-0.8244118604753368,-0.6299862196849729
2025-09-12T10:00:00-04:00,115.7,115.7,114.83,115.12,NaN,NaN,NaN,117.01619060462116,NaN,NaN,119.23970000000008,122.36870265899748,116.11069734100269,117.43514364830239,116.49085418498856,117.40097869576823,115.5807296742089,176549,49618,14.507017644038157,27.15263654374337,NaN,NaN,NaN,NaN,0.6528365803034345,35.408105700817075,43974070,-0.2405481791097771,-0.9306714435721943,-0.6901232644624172
2025-09-12T10:05:00-04:00,115.12,115.3,114.55,114.75,NaN,NaN,NaN,116.69886375895655,NaN,NaN,119.11790000000008,122.4554188928347,115.78038110716545,117.22811491864191,116.2933339266691,117.29801699845883,115.28865085487938,104531,52479.5,13.243620519924406,25.691388670963537,NaN,NaN,NaN,NaN,0.6597768245674749,37.28754450784258,43869539,-0.2741677730937432,-1.0328329808295962,-0.758665207735853
2025-09-12T10:10:00-04:00,114.78,114.85,114.05,114.65,NaN,NaN,NaN,116.2523244971858,NaN,NaN,118.98910000000006,122.5045673601166,115.47363263988353,117.06539354793082,116.11840799453473,117.2093674369017,115.02744855216777,93871,55203.26666666667,12.916219431706509,24.555375728643472,NaN,NaN,NaN,NaN,0.669792765669798,39.36891718198975,43775668,-0.2803327160760596,-1.1090811028309275,-0.828748386754868
2025-09-12T10:15:00-04:00,114.65,115.51,114.48,115.365,NaN,NaN,NaN,116.2523244971858,NaN,NaN,118.87060000000007,122.46636675551055,115.27483324448959,117.06539354793082,116.0052125650866,117.08032599473475,114.93009913543844,121688,58316.86666666667,26.842172193360952,23.991380592400837,NaN,NaN,NaN,NaN,0.695521853836241,39.533027822162964,43897356,-0.21631610822048464,-1.0991435220304737,-0.8828274138099891
2025-09-12T10:20:00-04:00,115.37,116.12,115.33,116.1,NaN,NaN,NaN,116.2523244971858,NaN,NaN,118.76760000000007,122.37983988129638,115.15536011870377,116.13131483834466,115.99054574244082,117.01460937886075,114.96648210602088,112194,61109.6,37.84554626201201,24.371423495771644,NaN,NaN,NaN,NaN,0.7022702928479385,38.380239793507656,44009550,-0.10989753886529074,-1.0201993373916025,-0.9103017985263118
2025-09-12T10:25:00-04:00,116.1,116.49,115.94,116.39,114.3416381321903,114.3416381321903,114.3416381321903,NaN,NaN,NaN,118.67060000000009,122.27252428571168,115.0686757142885,115.48505187067573,116.00862559530658,117.00182437000076,115.0154268206124,81094,62837.666666666664,41.57915053676227,24.80204356519525,NaN,NaN,NaN,NaN,0.6913938433587999,36.62490185856992,44090644,-0.010629260436377685,-0.9235883740717838,-0.9129591136354062
2025-09-12T10:30:00-04:00,116.4,116.84,116.32,116.39,114.72088185345437,NaN,NaN,NaN,NaN,NaN,118.56960000000008,122.13829434947962,115.00090565052054,115.45404149654058,116.03239124531552,117.00799776321269,115.05678472741836,62246,64028.9,41.57915053676228,25.575355890602218,NaN,NaN,NaN,NaN,0.6791514259760293,34.39865679948306,44090644,0.06047065070328894,-0.837370800256295,-0.8978414509595839
2025-09-12T10:35:00-04:00,116.38,117.12,116.35,116.89,114.8553872237519,NaN,NaN,NaN,NaN,NaN,118.47600000000007,121.96971263844497,114.98228736155517,115.25321315443472,116.07068075807292,117.03551541035267,115.10584610579318,71160,65710.16666666667,47.84388462547436,26.897648046387186,NaN,NaN,NaN,NaN,0.6856406098348851,31.99953620201991,44161804,0.14195900717297283,-0.7203926919933679,-0.8623516991663407
2025-09-12T10:40:00-04:00,116.93,117.09,116.56,116.9,114.9585514408541,NaN,NaN,NaN,NaN,NaN,118.38900000000008,121.81811767077374,114.95988232922642,115.33157052354777,116.09967051750503,117.05780890642986,115.14153212858021,54160,66975.03333333334,47.96407031832307,28.02203485657237,NaN,NaN,NaN,NaN,0.6745234234181076,29.771781361518418,44215964,0.1940926770552448,-0.6197358528472847,-0.8138285299025295
2025-09-12T10:45:00-04:00,116.94,117.25,116.87,117.08,115.22657182990618,NaN,NaN,NaN,NaN,NaN,118.30500000000008,121.65150145674825,114.9584985432519,115.65325641883821,116.1370637986186,117.09481654452328,115.17931105271391,58566,68141.26666666666,50.18906715418457,29.842882095701135,NaN,NaN,NaN,NaN,0.6534860360310996,27.971667417888224,44274530,0.2355010913343617,-0.5194521657345774,-0.7549532570689391
2025-09-12T10:50:00-04:00,117.05,117.05,116.415,116.63,115.22657182990618,NaN,NaN,NaN,NaN,NaN,118.21440000000008,121.4913813182269,114.93741868177327,115.65325641883821,116.1532329721592,117.10174688751216,115.20471905680624,44925,69266.03333333334,45.00777249555743,31.340470126258477,NaN,NaN,NaN,NaN,0.6543084620288776,26.424031716799018,44229605,0.22727454285423376,-0.470860078501147,-0.6981346213553807
2025-09-12T10:55:00-04:00,116.65,116.88,116.46,116.85,115.22657182990618,NaN,NaN,NaN,NaN,NaN,118.13380000000011,121.34208836609152,114.9255116339087,115.65325641883821,116.17047527112892,117.10985298172035,115.23109756053749,48056,70189.73333333334,47.842682428651415,33.09342417398392,NaN,NaN,NaN,NaN,0.6375721433125293,24.98694142293047,44277661,0.23060884067243825,-0.40987357051483286,-0.6404824111872711
2025-09-12T11:00:00-04:00,116.85,116.88,116.09,116.16,115.22657182990618,NaN,NaN,NaN,NaN,NaN,118.0368000000001,121.18407613024401,114.88952386975619,115.65325641883821,116.17487057793306,117.1046592582213,115.24508189764482,35013,70711.3,40.747688545000806,34.65312650148823,NaN,NaN,NaN,NaN,0.6484598473616339,24.250271400952865,44242648,0.18241478530899813,-0.4124639295510235,-0.5948787148600216
2025-09-12T11:05:00-04:00,116.16,116.44,116.13,116.44,115.22657182990618,NaN,NaN,NaN,NaN,NaN,117.95260000000009,121.04042528003303,114.86477471996714,115.65325641883821,116.17684773540046,117.10110887397148,115.25258659682943,20320,70831.63333333333,44.3540066121887,36.60443209313905,NaN,NaN,NaN,NaN,0.6242841439786602,23.566220666259376,44262968,0.16593754216914236,-0.38745678714859366,-0.553394329317736
2025-09-12T11:10:00-04:00,116.425,116.75,116.38,116.64,115.22657182990618,NaN,NaN,NaN,NaN,NaN,117.87500000000011,120.89511390513557,114.85488609486465,115.65325641883821,116.18334529905623,117.10174943712539,115.26494116098706,26569,71113.66666666667,46.842737762370255,38.914126387305636,NaN,NaN,NaN,NaN,0.6061209908373276,22.276900910678616,44289537,0.16471992845727879,-0.3474944187461375,-0.5122143472034163
2025-09-12T11:15:00-04:00,116.64,116.74,116.34,116.4,115.22657182990618,NaN,NaN,NaN,NaN,NaN,117.78660000000009,120.71406268294037,114.85913731705982,115.65325641883821,116.18720924792665,117.10051935099592,115.27389914485737,21324,71417.46666666666,44.28326981949519,41.13124419441783,NaN,NaN,NaN,NaN,0.5913980629203751,21.15374675744636,44268213,0.14467538204938102,-0.33137011964169005,-0.47604550169107107
2025-09-12T11:20:00-04:00,116.42,116.47,116.14,116.17,115.22657182990618,NaN,NaN,NaN,NaN,NaN,117.7012000000001,120.56243998294475,114.83996001705545,115.65325641883821,116.18808617859227,117.09591289370438,115.28025946348016,20861,71000.66666666667,41.9193989475008,43.20289987411742,NaN,NaN,NaN,NaN,0.5727267727117767,20.483274592659125,44247352,0.11418967938831992,-0.33330840245567117,-0.4474980818439911
2025-09-12T11:25:00-04:00,116.19,116.22,115.78,115.87,115.22657182990618,NaN,NaN,NaN,NaN,NaN,117.62340000000009,120.46798323134006,114.77881676866012,115.65325641883821,116.18330895207434,117.08231898086463,115.28429892328406,36499,70948.76666666666,38.99541041092484,44.070988318229126,NaN,NaN,NaN,NaN,0.5632462889466497,20.475858278190735,44210853,0.0740302753305418,-0.35496023768081386,-0.42899051301135566
2025-09-12T11:30:00-04:00,115.89,116.12,115.8,115.945,115.22657182990618,NaN,NaN,NaN,NaN,NaN,117.55500000000009,120.393247346518,114.71675265348219,115.65325641883821,116.17937672831486,117.07110604108922,115.2876474155405,30986,70484.76666666666,40.11993148643716,44.23344440568807,NaN,NaN,NaN,NaN,0.5458715540218896,20.468971700470085,44241839,0.05367569892838364,-0.36189588935087613,-0.4155715882792598
2025-09-12T11:35:00-04:00,115.96,116.04,115.27,115.28,115.22657182990618,NaN,NaN,NaN,NaN,NaN,117.46580000000009,120.30409763062603,114.62750236937414,115.47701365065993,116.16860015829988,117.05678192756507,115.2804183890347,30360,69644.43333333333,34.11514727332536,43.70030131544257,NaN,NaN,NaN,NaN,0.5618807287346125,21.275004797593237,44211479,-0.0005459836535607887,-0.4162540678462108,-0.41570808419265
2025-09-12T11:40:00-04:00,115.28,115.35,115.1,115.18,NaN,NaN,NaN,116.86849038718236,116.86849038718236,116.86849038718236,117.37720000000009,120.21880458896221,114.53559541103796,115.47701365065993,116.15049899739843,117.03987792495668,115.26112006984017,35210,69698.86666666667,33.30782572524666,43.10949240033431,NaN,NaN,NaN,NaN,0.5396035338249973,22.25269845479522,44176269,-0.03709429761192501,-0.46207595620755626,-0.42498165859563125
2025-09-12T11:45:00-04:00,115.22,115.38,115,115.19,NaN,NaN,NaN,116.81060446049226,NaN,NaN,117.28820000000009,120.11947516147951,114.45692483852066,115.47701365065993,116.11651028968164,117.00785490082998,115.2251656785333,68404,69779.5,33.47735841940768,42.08331195704384,NaN,NaN,NaN,NaN,0.5282032814089257,23.294941176953948,44244673,-0.0535448750685496,-0.49191275243131827,-0.43836787736276867
2025-09-12T11:50:00-04:00,115.16,115.25,114.99,115.18,NaN,NaN,NaN,116.70239516683353,NaN,NaN,117.20320000000007,120.02734501044674,114.3790549895534,115.47701365065993,116.09702669124576,116.98993741203647,115.20411597045505,39354,68895.2,33.3859624231972,41.042018535963415,NaN,NaN,NaN,NaN,0.5090459041654314,24.276747857157115,44205319,-0.057690527865221886,-0.510481037194296,-0.45279050932907416
2025-09-12T11:55:00-04:00,115.15,115.46,115.12,115.24,NaN,NaN,NaN,116.70239516683353,NaN,NaN,117.12400000000007,119.94181120731054,114.3061887926896,115.47701365065993,116.08638744357259,116.9783749080573,115.19439997908788,25810,66607.23333333334,34.54069995012624,39.92427802138782,NaN,NaN,NaN,NaN,0.49697119672504264,24.546043914779922,44231129,-0.04930764545125832,-0.5144250661431471,-0.46511742069188877
2025-09-12T12:00:00-04:00,115.23,115.3,114.93,115.12,NaN,NaN,NaN,116.65152121606113,NaN,NaN,117.04660000000007,119.86773838016626,114.22546161983388,115.47701365065993,116.06870283843526,116.96199341944723,115.17541225742329,37118,63731.03333333333,33.297492149781164,39.08782942526095,NaN,NaN,NaN,NaN,0.487901825530396,25.104988405218194,44194011,-0.04488636182280237,-0.5212253729703917,-0.47633901114758936
2025-09-12T12:05:00-04:00,115.11,115.25,114.93,115.25,NaN,NaN,NaN,116.60031570624015,NaN,NaN,116.97300000000008,119.7857566549587,114.16024334504147,115.29461092052794,116.05805427299305,116.95165710282757,115.16445144315853,23694,61846.6,35.98554280889847,38.24089088099288,NaN,NaN,NaN,NaN,0.4759088379925101,25.62400828919659,44217705,-0.027123181505201543,-0.5102429880290913,-0.48311980652388975
2025-09-12T12:10:00-04:00,115.26,115.35,115.07,115.1,NaN,NaN,NaN,116.60031570624015,NaN,NaN,116.89400000000006,119.69081461667321,114.09718538332692,115.05968873642236,116.04817284705365,116.9416223209062,115.1547233732011,23257,59953.066666666666,34.26947167630374,37.77816110465737,NaN,NaN,NaN,NaN,0.4619153495644737,25.771368902645836,44194448,-0.019735860734714117,-0.5077896324422824,-0.48805377170756825
2025-09-12T12:15:00-04:00,115.09,115.23,115.01,115.17,NaN,NaN,NaN,116.56258104638825,NaN,NaN,116.81680000000007,119.58647634210834,114.0471236578918,115.03175098913789,116.03574976070449,116.92936143563907,115.14213808576991,28772,58395.46666666667,35.80791040824003,37.16772566151818,NaN,NaN,NaN,NaN,0.4446356817384398,26.023668150754148,44223220,-0.0051543152176475315,-0.4944966657296277,-0.48934235051198016
2025-09-12T12:20:00-04:00,115.145,115.7,115.13,115.63,NaN,NaN,NaN,116.56258104638825,NaN,NaN,116.75280000000008,119.48101638438365,114.0245836156165,114.7844007913103,116.02452860269437,116.91236761914475,115.136689586244,44042,56166.833333333336,44.92960899031336,37.03107360637126,NaN,NaN,NaN,NaN,0.45359027589998036,24.792580179387777,44267262,0.03807267890029287,-0.44175150188661405,-0.4798241807869069
2025-09-12T12:25:00-04:00,115.63,115.78,115.44,115.645,NaN,NaN,NaN,116.56258104638825,NaN,NaN,116.68470000000006,119.34939916501699,114.02000083498314,114.85846287914485,116.01989714764576,116.9036620420542,115.13613225323734,25064,53389.9,45.20305316518675,37.0967724167778,NaN,NaN,NaN,NaN,0.4454766847642677,23.42982081260788,44292326,0.06850241905043564,-0.39419615697386234,-0.462698576024298
2025-09-12T12:30:00-04:00,115.66,115.66,115.49,115.52,NaN,NaN,NaN,116.56258104638825,NaN,NaN,116.61470000000007,119.21340229923179,114.01599770076835,114.85846287914485,116.01405725467994,116.89375323343855,115.13436127592134,27836,48432.8,43.27469386107079,37.19357919631852,NaN,NaN,NaN,NaN,0.4257997787096773,22.164401400597974,44264490,0.08022530727203325,-0.36241694193425644,-0.4426422492062897
2025-09-12T12:35:00-04:00,115.53,115.6,115.32,115.4,NaN,NaN,NaN,116.56258104638825,NaN,NaN,116.53930000000008,119.05449145196091,114.02410854803925,114.85846287914485,116.0105738599192,116.8887291511106,115.13241856872781,13480,45397.76666666667,41.44673495441369,37.36867380656771,NaN,NaN,NaN,NaN,0.4153855088018433,21.427895947464457,44251010,0.07974480856093119,-0.3429612385051257,-0.4227060470660569
2025-09-12T12:40:00-04:00,115.385,115.52,114.98,115.01,NaN,NaN,NaN,116.56258104638825,NaN,NaN,116.46410000000007,118.93241658423939,113.99578341576076,114.85846287914485,115.99067936386132,116.86773818156942,115.11362054615321,53852,44063.8,36.10836901773934,37.08213363023215,NaN,NaN,NaN,NaN,0.4242865438874253,21.51840755237297,44197158,0.05422812809554167,-0.3549208869466298,-0.4091490150421715
2025-09-12T12:45:00-04:00,115.035,115.13,114.97,115.07,NaN,NaN,NaN,116.38838629610093,NaN,NaN,116.39110000000008,118.8034899270276,113.97871007297256,114.85846287914485,115.97718352160018,116.85498785243207,115.09937919076829,33359,41119.5,37.443313126529546,37.31985976260388,NaN,NaN,NaN,NaN,0.40540893360975183,21.62388241230963,44230517,0.042951232337108736,-0.3554599746207856,-0.39841120695789434
2025-09-12T12:50:00-04:00,115.08,115.24,114.99,115.17,NaN,NaN,NaN,116.38838629610093,NaN,NaN,116.31850000000007,118.65379548452265,113.9832045154775,114.85846287914485,115.97105813179151,116.84859934990524,115.09351691367777,16881,37942.4,39.70450495162722,37.77676542163107,NaN,NaN,NaN,NaN,0.3943082954947696,21.335699079201177,44247398,0.0436455232784444,-0.34385430285983887,-0.38749982613828327
2025-09-12T12:55:00-04:00,115.18,115.19,114.7,115.125,NaN,NaN,NaN,116.2638395797118,NaN,NaN,116.24060000000009,118.46757969456714,114.01362030543304,114.85846287914485,115.95593201355248,116.83479772786747,115.0770662992375,36992,36472.333333333336,39.02097278607549,38.17273787639306,NaN,NaN,NaN,NaN,0.4011434172451428,21.721146603987222,44210406,0.042453688014667645,-0.33443271611994874,-0.3768864041346164
2025-09-12T13:00:00-04:00,115.13,115.17,114.77,114.95,NaN,NaN,NaN,116.2638395797118,NaN,NaN,116.16760000000009,118.31842146167911,114.01677853832108,114.85846287914485,115.94212898651196,116.82256879853084,115.06168917449308,33317,35508.03333333333,36.396799075359375,38.387797637261784,NaN,NaN,NaN,NaN,0.4010617445847759,22.07906216271712,44177089,0.03174908652101188,-0.3372000459833515,-0.3689491325043634
2025-09-12T13:05:00-04:00,114.955,115.05,114.82,114.83,NaN,NaN,NaN,116.22009969969609,NaN,NaN,116.0938000000001,118.16857185251736,114.01902814748284,114.85846287914485,115.93380420554928,116.8156138078745,115.05199460322406,19293,33779.13333333333,34.67478708146224,38.397375289500076,NaN,NaN,NaN,NaN,0.3888430485430065,22.411412324394878,44157796,0.01908082926581306,-0.34509809592209706,-0.3641789251879101
2025-09-12T13:10:00-04:00,114.83,115.11,114.8,114.96,NaN,NaN,NaN,116.22009969969609,NaN,NaN,116.0312000000001,118.04938191449803,114.01301808550217,114.85846287914485,115.90896462283403,116.79297591980577,115.0249533258623,62997,34073.7,38.09195902384536,38.739837209076086,NaN,NaN,NaN,NaN,0.3832114022185062,22.467745548988834,44220793,0.0217568084850846,-0.3369829145815544,-0.358739723066639
2025-09-12T13:15:00-04:00,114.99,115.05,114.58,114.67,NaN,NaN,NaN,116.09036976769829,NaN,NaN,115.95780000000009,117.90029649677905,114.01530350322113,114.83777030331588,115.89315263312739,116.78111128141082,115.00519398484396,34785,33281,33.839420609567426,38.586542766266724,NaN,NaN,NaN,NaN,0.38941058777432713,23.063891364053326,44186008,0.0070569716358858114,-0.34991850852178175,-0.35697548015766756
2025-09-12T13:20:00-04:00,114.68,115.36,114.65,115.25,NaN,NaN,NaN,116.09036976769829,NaN,NaN,115.89980000000008,117.74789519235664,114.05170480764353,114.8022162426527,115.88095832013865,116.767656965398,114.99425967487929,38580,33069.5,46.6641649184576,39.47187799784915,NaN,NaN,NaN,NaN,0.4123098315047319,22.395595855055223,44224588,0.037742182893949594,-0.3097977515402306,-0.3475399344341802
2025-09-12T13:25:00-04:00,115.28,115.36,115.04,115.07,NaN,NaN,NaN,116.09036976769829,NaN,NaN,115.83560000000008,117.5678893984586,114.10331060154157,114.61177299412216,115.87626849456062,116.761998919669,114.99053806945224,16629,32021.933333333334,43.82493912491821,40.0445229061833,NaN,NaN,NaN,NaN,0.40571627211153627,21.775035739556984,44207959,0.04667784700139854,-0.289192625682432,-0.3358704726838305
2025-09-12T13:30:00-04:00,115.05,115.06,114.5,114.54,NaN,NaN,NaN,116.09036976769829,NaN,NaN,115.7692000000001,117.43941598603162,114.09898401396858,114.46973471623818,115.8561714028264,116.7474346686046,114.96490813704821,44641,32342.866666666665,36.737161561619075,39.45934808984799,NaN,NaN,NaN,NaN,0.41745082410356893,22.48685099261053,44163318,0.01907032344412929,-0.3120325683786689,-0.3311028918227982
2025-09-12T13:35:00-04:00,114.58,114.68,114.42,114.6,NaN,NaN,NaN,115.84243612881521,NaN,NaN,115.70680000000007,117.31271377104021,114.10088622895994,114.46973471623818,115.84063977159002,116.73761770909674,114.9436618340833,31854,32727.333333333332,37.96041848333612,38.942017041144375,NaN,NaN,NaN,NaN,0.4062043366676001,23.305134276719,44195172,0.007614426349724035,-0.32158485888564314,-0.3291992852353672
2025-09-12T13:40:00-04:00,114.61,115.27,114.59,115.25,NaN,NaN,NaN,115.84243612881521,NaN,NaN,115.65500000000009,117.14526037993842,114.16473962006175,114.34783838196284,115.83083703793066,116.72668549417206,114.93498858168927,32644,32929.833333333336,49.37973717668835,39.378091563688486,NaN,NaN,NaN,NaN,0.425761169762771,22.1133879251829,44227816,0.044517659703426415,-0.27355221060608415,-0.31806987030951056
2025-09-12T13:45:00-04:00,115.245,115.56,115.22,115.45,NaN,NaN,NaN,115.84243612881521,NaN,NaN,115.62380000000009,117.06375216587402,114.18384783412615,114.47429860125199,115.8257869723546,116.71742234304698,114.93415160166224,32518,33302.96666666667,52.289683346952565,40.15258787744126,NaN,NaN,NaN,NaN,0.4196353719225733,20.8031337642449,44260334,0.08097751720844959,-0.2168479737989486,-0.2978254910073982
2025-09-12T13:50:00-04:00,115.47,115.78,115.375,115.75,NaN,NaN,NaN,115.84243612881521,NaN,NaN,115.60040000000008,116.99256930005083,114.20823069994933,114.70893888100159,115.82370502230336,116.71068358782088,114.93672645678583,29897,33604.166666666664,56.34368205266697,41.5979673799361,NaN,NaN,NaN,NaN,0.41858998821381815,20.093364804843805,44290231,0.12144539158364037,-0.1460187515278477,-0.2674641431114881
2025-09-12T13:55:00-04:00,115.75,115.92,115.71,115.88,114.53776376797987,114.53776376797987,114.53776376797987,NaN,NaN,NaN,115.5816000000001,116.9321486884983,114.23105131150189,114.95815110480126,115.82392053771841,116.70349578520317,114.94434529023364,46324,33931.666666666664,58.008768180406676,43.06692845521304,NaN,NaN,NaN,NaN,0.4036907033414031,19.740579387791637,44336555,0.15117821897783207,-0.07849136938919798,-0.22966958836703005
2025-09-12T14:00:00-04:00,115.88,115.97,115.41,115.44,114.53776376797987,NaN,NaN,NaN,NaN,NaN,115.56800000000008,116.91025779938263,114.22574220061753,114.95815110480126,115.82036383112207,116.69314504787378,114.94758261437035,46370,34444.46666666667,50.92857466167519,43.868647720216465,NaN,NaN,NaN,NaN,0.41485565310273165,18.591085973113472,44290185,0.13590324883624513,-0.05979052732172363,-0.19569377615796876
2025-09-12T14:05:00-04:00,115.42,115.65,115.38,115.585,114.53776376797987,NaN,NaN,NaN,NaN,NaN,115.5649000000001,116.90627018007766,114.22352981992253,114.95815110480126,115.81711188888225,116.68536895209284,114.94885482567166,33040,34533.8,52.96591774095735,44.86471521699374,NaN,NaN,NaN,NaN,0.40450882073825156,17.44487895175613,44323225,0.13024258465952865,-0.03289054533355795,-0.1631331299930866
2025-09-12T14:10:00-04:00,115.57,115.61,115.42,115.43,114.53776376797987,NaN,NaN,NaN,NaN,NaN,115.5711000000001,116.90704204963657,114.23515795036363,114.95815110480126,115.81400059483293,116.67874953144069,114.94925165822518,27236,34268,50.54987846163411,45.875649458870505,NaN,NaN,NaN,NaN,0.3891867621140906,16.380543860495745,44295989,0.1114625742303601,-0.023804912205136475,-0.13526748643549658
2025-09-12T14:15:00-04:00,115.42,115.67,115.26,115.62,114.53776376797987,NaN,NaN,NaN,NaN,NaN,115.5885000000001,116.90371291051912,114.27328708948107,114.95815110480126,115.81229002595126,116.67484109711987,114.94973895478265,16738,32545.8,53.35845951048373,47.2101974895149,NaN,NaN,NaN,NaN,0.3906734219630839,15.481320803169835,44312727,0.1072071391771953,-0.0012585624640024662,-0.10846570164119776
2025-09-12T14:20:00-04:00,115.61,115.89,115.6,115.82,114.53776376797987,NaN,NaN,NaN,NaN,NaN,115.61190000000009,116.90086065106658,114.3229393489336,115.02121335402127,115.8117029167134,116.66825998844746,114.95514584497934,40960,32599.333333333332,56.17979712942888,48.502185925628005,NaN,NaN,NaN,NaN,0.3834824632514355,14.72610760721382,44353687,0.11267233340139768,0.032374715110549346,-0.08029761829084833
2025-09-12T14:25:00-04:00,115.86,115.98,115.86,115.95,114.729710950884,NaN,NaN,NaN,NaN,NaN,115.62360000000008,116.9140030998115,114.33319690018867,115.20497068321701,115.81256382984927,116.66605762154933,114.9590700381492,21629,32459.966666666667,57.9598954918723,50.22507698864979,NaN,NaN,NaN,NaN,0.36751943016204797,14.2667272509539,44375316,0.11921969571839577,0.06872700135714638,-0.05049269436124939
2025-09-12T14:30:00-04:00,115.95,116.23,115.91,116.23,114.89017863493473,NaN,NaN,NaN,NaN,NaN,115.62620000000008,116.92094871693317,114.331451283067,115.44997654657361,115.8178922678265,116.66499862570097,114.97078590995201,51847,32950.933333333334,61.58003985262914,51.290496626804895,NaN,NaN,NaN,NaN,0.36412518515047365,14.470805739808382,44427163,0.13540304024967026,0.11876110595083844,-0.016641934298831818
2025-09-12T14:35:00-04:00,116.22,116.32,116.18,116.27,115.10471596971043,NaN,NaN,NaN,NaN,NaN,115.62380000000009,116.91331085299873,114.33428914700144,115.62598123725888,115.82362192132481,116.666652094956,114.98059174769362,40009,33494.76666666667,62.08237078413839,52.594598888177764,NaN,NaN,NaN,NaN,0.3481162433540103,14.873313938987625,44467172,0.14115282385663463,0.15979909552196148,0.01864627166532684
2025-09-12T14:40:00-04:00,116.3,116.47,116.22,116.43,115.21768342563267,NaN,NaN,NaN,NaN,NaN,115.62460000000009,116.91605939154269,114.33314060845748,115.78978498980712,115.83023649324065,116.67032012692417,114.99015285955713,37316,33963.4,64.10409799616428,54.54938006207385,NaN,NaN,NaN,NaN,0.3411079402572953,15.593275286091263,44504488,0.14739804427043043,0.2028938270033649,0.05549578273293445
2025-09-12T14:45:00-04:00,116.44,116.62,116.4,116.5,115.40392508810393,NaN,NaN,NaN,NaN,NaN,115.61680000000007,116.8820395188348,114.35156048116534,115.9658279918457,115.8500673020432,116.68557392209381,115.01456068199259,93663,36126.433333333334,64.98375565066229,56.47961843116858,NaN,NaN,NaN,NaN,0.3324573730960599,16.590549854392968,44598151,0.14754687040067338,0.23992937073377618,0.0923825003331028
2025-09-12T14:50:00-04:00,116.49,116.6,116.24,116.59,115.40392508810393,NaN,NaN,NaN,NaN,NaN,115.61060000000006,116.85346707254959,114.36773292745053,115.9658279918457,115.85946942210931,116.69217568394404,115.02676316027458,48669,36280.666666666664,66.13290356311684,57.67627317305632,NaN,NaN,NaN,NaN,0.3344247035891984,16.907587108551294,44646820,0.14480685710212732,0.27339107171076193,0.12858421460863462
2025-09-12T14:55:00-04:00,116.58,116.98,116.56,116.77,115.65805984267321,NaN,NaN,NaN,NaN,NaN,115.60440000000006,116.8206937803174,114.38810621968271,116.20732991478124,115.88006363265723,116.71435618931636,115.04577107599809,75059,37947.166666666664,68.36872802623097,58.824776364433355,NaN,NaN,NaN,NaN,0.34053722476139864,18.014655999200166,44721879,0.1458133568653596,0.3108509106903341,0.1650375538249745
2025-09-12T15:00:00-04:00,116.71,116.71,115.85,116.09,115.65805984267321,NaN,NaN,NaN,NaN,NaN,115.59360000000007,116.78255759387243,114.4046424061277,116.20732991478124,115.88521659230845,116.71412942198556,115.05630376263134,51593,38739.066666666666,53.89371530538057,58.64977873962719,NaN,NaN,NaN,NaN,0.38192742299272747,16.91712505672072,44670286,0.09389980703444867,0.28241231261803534,0.18851250558358668
2025-09-12T15:05:00-04:00,116.08,116.15,115.91,116.09,115.65805984267321,NaN,NaN,NaN,NaN,NaN,115.57840000000006,116.72125859144293,114.43554140855719,116.20732991478124,115.8868685886863,116.71177928166519,115.06195789570741,34129,39427.36666666667,53.89371530538057,58.355846391411035,NaN,NaN,NaN,NaN,0.371789749921819,15.897989181561242,44670286,0.05472038415666852,0.25691298577942234,0.20219260162275382
2025-09-12T15:10:00-04:00,116.08,116.11,115.7,115.8,115.65805984267321,NaN,NaN,NaN,NaN,NaN,115.57120000000006,116.70380153629722,114.4385984637029,116.20732991478124,115.88657171637827,116.70419434545317,115.06894908730337,60986,39665.166666666664,48.785058416613325,58.20273808819233,NaN,NaN,NaN,NaN,0.3745190534988317,15.097982758412204,44609300,0.006944474108844412,0.21087319425880935,0.20392872014996494
2025-09-12T15:15:00-04:00,115.85,116.29,115.845,116.26,115.65805984267321,NaN,NaN,NaN,NaN,NaN,115.56760000000006,116.6902330478107,114.44496695218942,116.20732991478124,115.88878036182435,116.70304017303562,115.07452055061307,31511,39603.566666666666,55.92232342406955,58.41390992270034,NaN,NaN,NaN,NaN,0.38276769253463006,14.147463708942015,44640811,0.004132364597145222,0.20909417589639645,0.20496181129925123
2025-09-12T15:20:00-04:00,116.26,116.3,116.12,116.2,115.65805984267321,NaN,NaN,NaN,NaN,NaN,115.55880000000006,116.65423883445236,114.46336116554777,116.20732991478124,115.89081262110018,116.70286079174353,115.07876445045683,22499,39790.833333333336,54.848633070013165,58.72096382329885,NaN,NaN,NaN,NaN,0.3682842859250131,13.29075341174835,44618312,-0.0035444940846747763,0.20053119369340777,0.20407568777808255
2025-09-12T15:25:00-04:00,116.2,116.2,115.59,115.815,NaN,NaN,NaN,117.07355726868929,117.07355726868929,117.07355726868929,115.54710000000006,116.61858511890523,114.47561488109488,116.20732991478124,115.89061751953719,116.6991367471315,115.08209829194287,30812,39584.833333333336,48.42399557104431,58.36850211333889,NaN,NaN,NaN,NaN,0.3855496940732264,13.45820433472432,44587500,-0.03460071180471372,0.1608247980221904,0.19542550982690413
2025-09-12T15:30:00-04:00,115.81,115.93,115.24,115.44,NaN,NaN,NaN,116.80911556661073,NaN,NaN,115.53250000000006,116.58943188050793,114.47556811949218,116.20732991478124,115.88336873891865,116.68513485791766,115.08160261991964,74225,40948.433333333334,43.12528693942533,57.43603709976721,NaN,NaN,NaN,NaN,0.40729614449656826,14.277734041186344,44513275,-0.07796560192621177,0.09796850741913943,0.1759341093453512
2025-09-12T15:35:00-04:00,115.42,115.56,115.3,115.43,NaN,NaN,NaN,116.63392849540115,NaN,NaN,115.52370000000006,116.57656430276488,114.47083569723524,116.20732991478124,115.87759012221318,116.67585191772073,115.07932832670562,46792,41865.066666666666,42.99019412808371,56.36677271663946,NaN,NaN,NaN,NaN,0.39677499131824234,15.03872591147251,44466483,-0.103300923582028,0.04680795486781619,0.1501088784498442
2025-09-12T15:40:00-04:00,115.41,115.71,115.36,115.53,NaN,NaN,NaN,116.63392849540115,NaN,NaN,115.51540000000008,116.5613691008925,114.46943089910766,116.20732991478124,115.87343621063067,116.66775713444112,115.07911528682023,44838,41259.76666666667,44.85067465712877,55.171818059818,NaN,NaN,NaN,NaN,0.39343392050979603,15.281979753988242,44511321,-0.10875215486810415,0.01416868486471401,0.12292083973281816
2025-09-12T15:45:00-04:00,115.52,115.58,115.24,115.475,NaN,NaN,NaN,116.598889393537,NaN,NaN,115.51930000000007,116.56318123847136,114.47541876152879,115.63186393182498,115.86756929851067,116.6582170516441,115.07692154537725,50014,41767.4,44.000168850411,53.880232207408895,NaN,NaN,NaN,NaN,0.3896172119019537,15.757311084310377,44461307,-0.1110985307100045,-0.01595232365468746,0.09514620705531704
2025-09-12T15:50:00-04:00,115.41,115.52,114.95,115.3,NaN,NaN,NaN,116.44757623928531,NaN,NaN,115.52170000000007,116.56299843946798,114.48040156053216,115.37975546647552,115.8486662301681,116.63414147725051,115.0631909830857,120251,44489.76666666667,41.31555436134707,52.25247909063624,NaN,NaN,NaN,NaN,0.40250169676609937,16.75779653480796,44341056,-0.11878074604541841,-0.05332972550145598,0.06545102054396243
2025-09-12T15:55:00-04:00,115.26,115.29,115,115.01,NaN,NaN,NaN,116.34336822840872,NaN,NaN,115.51810000000006,116.56518908887718,114.47101091112295,115.37975546647552,115.82937405318246,116.61368522191702,115.0450628844479,102792,47361.86666666667,37.25861154716743,50.27211165467232,NaN,NaN,NaN,NaN,0.3951801469970921,17.68681873884143,44238264,-0.13647295377276264,-0.10514017167199086,0.03133278210077177
2025-09-15T09:30:00-04:00,115.37,115.79,114.5,114.66,NaN,NaN,NaN,116.34336822840872,NaN,NaN,115.50770000000007,116.57808536987062,114.43731463012952,115.37975546647552,114.98333333333335,114.98333333333335,114.98333333333335,136574,50426.3,33.041631769447065,47.908449383695924,NaN,NaN,NaN,NaN,0.45909585078301457,18.54948221401537,44101690,-0.1630297864032934,-0.172454450903345,-0.00942466450005159
2025-09-15T09:35:00-04:00,114.64,115.84,114.5,115.49,NaN,NaN,NaN,116.34336822840872,NaN,NaN,115.51270000000008,116.58036888126615,114.44503111873401,115.37975546647552,115.11821791641783,115.26441057566198,114.97202525717368,116263,53239.933333333334,48.05594394884978,46.45753623531156,NaN,NaN,NaN,NaN,0.5220175757270852,19.154619825328474,44217953,-0.11807421997166964,-0.15701743946463864,-0.038943219492969
2025-09-15T09:40:00-04:00,115.5,116.44,115.35,115.75,114.36939160750441,114.36939160750441,114.36939160750441,NaN,NaN,NaN,115.52530000000007,116.58899621604924,114.4616037839509,115.15880437318042,115.3331732361617,115.6873536491647,114.97899282315869,105841,55679.833333333336,51.70892478834747,46.30147976980919,NaN,NaN,NaN,NaN,0.5625877488894365,17.80286284194227,44323794,-0.06675966565596407,-0.12239280156292409,-0.05563313590696002
2025-09-15T09:45:00-04:00,115.78,116.52,115.25,115.32,114.36939160750441,NaN,NaN,NaN,NaN,NaN,115.52670000000008,116.58912667512502,114.46427332487514,114.75204349854432,115.39799352913913,115.74789919214467,115.04808786613359,77843,57190.666666666664,45.95311677435264,45.73429416045004,NaN,NaN,NaN,NaN,0.6131171953973337,16.780263829324536,44245951,-0.05803144391114662,-0.1281724407958933,-0.07014099688474668
2025-09-15T09:50:00-04:00,115.35,115.62,114.9,114.99,114.36939160750441,NaN,NaN,NaN,NaN,NaN,115.52450000000007,116.59090001876862,114.45809998123153,114.67710783906836,115.36321214697932,115.69559195296479,115.03083234099385,78581,58813.46666666667,42.08174646220751,45.25548616370678,NaN,NaN,NaN,NaN,0.6207516814403812,16.676054334427363,44167370,-0.0699390264129867,-0.15756477990098006,-0.08762575348799335
2025-09-15T09:55:00-04:00,114.96,114.97,114.53,114.73,114.36939160750441,NaN,NaN,NaN,NaN,NaN,115.5157000000001,116.60075485575928,114.43064514424091,114.67710783906836,115.26136681749576,115.64226641026364,114.88046722472787,101269,60644.96666666667,39.27435547917537,44.06634559621433,NaN,NaN,NaN,NaN,0.6092694184803535,17.32023293116673,44066101,-0.08952987442792558,-0.19953809652290033,-0.11000822209497475
2025-09-15T10:00:00-04:00,114.73,115.04,114.63,114.97,114.36939160750441,NaN,NaN,NaN,NaN,NaN,115.5025000000001,116.5976826331742,114.40731736682599,114.58368627125469,115.22177027992399,115.60065494876271,114.84288561108526,71411,61479.666666666664,43.05109555012229,43.22366434479356,NaN,NaN,NaN,NaN,0.5950358885889006,17.69977226452243,44137512,-0.08079657118892189,-0.2110039360811271,-0.13020736489220522
2025-09-15T10:05:00-04:00,114.93,114.93,114.42,114.62,114.36939160750441,NaN,NaN,NaN,NaN,NaN,115.48200000000008,116.60379499018956,114.36020500981061,114.43794901700376,115.11706751402225,115.52346772471363,114.71066730333088,156413,65592.1,39.22023260914197,42.56625270465768,NaN,NaN,NaN,NaN,0.591819039403979,18.455247290002827,43981099,-0.09223632278403399,-0.24550276837224771,-0.15326644558821373
2025-09-15T10:10:00-04:00,114.67,114.85,114.44,114.52,114.36939160750441,NaN,NaN,NaN,NaN,NaN,115.46200000000007,116.61557877929002,114.30842122071013,114.42619191736473,115.08267158282236,115.49569751413327,114.66964565151144,60577,66703.46666666666,38.17501138281721,42.21266159347139,NaN,NaN,NaN,NaN,0.5788319651608373,19.15675981366319,43920522,-0.09955582245872993,-0.27771122366162615,-0.17815540120289622
2025-09-15T10:15:00-04:00,114.52,114.58,113.93,114.09,NaN,NaN,NaN,115.87644179729962,115.87644179729962,115.87644179729962,115.43580000000009,116.65164597709459,114.21995402290558,114.42619191736473,114.99950318236259,115.46962039688627,114.5293859678389,94119,69282.83333333333,33.98136321458573,41.569173671078666,NaN,NaN,NaN,NaN,0.5839153962207769,20.681226599736657,43826403,-0.12474204898676705,-0.33408296243635505,-0.209340913449588
2025-09-15T10:20:00-04:00,114.065,114.2,113.89,113.98,NaN,NaN,NaN,115.63501262469511,NaN,NaN,115.4152000000001,116.69255188574049,114.13784811425971,114.42619191736473,114.94806525778587,115.45494853703738,114.44118197853436,55563,69769.6,32.9831710942221,40.72149484515676,NaN,NaN,NaN,NaN,0.5643500107764359,22.157110657298546,43770840,-0.1391005253735948,-0.3832165701665815,-0.2441160447929867
2025-09-15T10:25:00-04:00,113.97,114.075,113.71,113.78,NaN,NaN,NaN,115.46001205084532,NaN,NaN,115.38940000000008,116.74340980794878,114.03539019205138,114.42619191736473,114.8771250377633,115.43637951218409,114.31787056334252,73184,71488.1,31.189261996309185,39.80643006986377,NaN,NaN,NaN,NaN,0.5501107242924054,23.797150187653397,43697656,-0.1513462341909434,-0.433298837531666,-0.2819526033407226
2025-09-15T10:30:00-04:00,113.77,114.6,113.54,114.38,NaN,NaN,NaN,115.46001205084532,NaN,NaN,115.37360000000008,116.75562900114937,113.99157099885079,114.27395353389178,114.8411817201831,115.4075711765021,114.2747922638641,60689,71782.83333333333,41.47338715695731,39.81770384097879,NaN,NaN,NaN,NaN,0.586531386842947,23.57736723324133,43758345,-0.11022668119953005,-0.41973595484013515,-0.3095092736406051
2025-09-15T10:35:00-04:00,114.37,114.77,114.29,114.66,NaN,NaN,NaN,115.46001205084532,NaN,NaN,115.36430000000007,116.75909462288367,113.96950537711648,113.46316282711344,114.83226434991903,115.3912150024558,114.27331369738226,40925,71813.36666666667,45.56225197986989,40.410821014743256,NaN,NaN,NaN,NaN,0.5789220020684501,22.895745272589128,43799270,-0.05798479439658488,-0.3819902666363362,-0.3240054722397513
2025-09-15T10:40:00-04:00,114.69,114.84,114.34,114.39,NaN,NaN,NaN,115.46001205084532,NaN,NaN,115.35310000000008,116.76984258777807,113.9363574122221,113.38711280175139,114.8231684514462,115.37629981464727,114.27003708824512,37291,71812.53333333334,42.48029016684979,41.08501090027202,NaN,NaN,NaN,NaN,0.573284716206418,22.06757363247019,43761979,-0.03647780629199504,-0.3696027301047451,-0.33312492381275005
2025-09-15T10:45:00-04:00,114.4,114.45,113.51,113.85,NaN,NaN,NaN,115.46001205084532,NaN,NaN,115.33350000000007,116.80471616359655,113.86228383640359,113.38711280175139,114.7845110075253,115.35493903389298,114.21408298115762,57748,70615.36666666667,37.07826986742005,40.30089132302704,NaN,NaN,NaN,NaN,0.5994786650488165,22.783265494495062,43704231,-0.05250991804418598,-0.3987623213679825,-0.34625240332379653
2025-09-15T10:50:00-04:00,113.88,113.95,113.22,113.42,NaN,NaN,NaN,115.28816328258779,NaN,NaN,115.30270000000007,116.86553103374068,113.73986896625946,113.38711280175139,114.70368210958922,115.33557657213103,114.07178764704742,91201,72033.1,33.43244157606429,38.99542823643538,NaN,NaN,NaN,NaN,0.6088016175453299,23.840915923309755,43613030,-0.08409075679868949,-0.4513658493221584,-0.3672750925234689
2025-09-15T10:55:00-04:00,113.42,113.63,113.17,113.32,NaN,NaN,NaN,115.08847404247015,NaN,NaN,115.27570000000009,116.92554485331668,113.62585514668349,113.38711280175139,114.65643767774067,115.32406797465356,113.98880738082778,52119,71268.43333333333,32.62892337004067,38.04370013612738,NaN,NaN,NaN,NaN,0.598172930577806,24.889097105825556,43560911,-0.1025102277525905,-0.495412877214207,-0.3929026494616165
2025-09-15T11:00:00-04:00,113.32,113.46,112.71,112.77,NaN,NaN,NaN,114.79899794963059,NaN,NaN,115.22610000000007,117.01896841682228,113.43323158317787,113.38711280175139,114.54304730557612,115.31299312639332,113.77310148475893,106467,73097.56666666667,28.56283911512884,37.07806389705034,NaN,NaN,NaN,NaN,0.6090177212508198,26.424786525529615,43454444,-0.14019913641622128,-0.5681515699818931,-0.4279524335656718
2025-09-15T11:05:00-04:00,112.76,112.83,112.43,112.81,NaN,NaN,NaN,114.32063440646557,NaN,NaN,115.1809000000001,117.09695291158813,113.26484708841205,113.38711280175139,114.42798596943234,115.29745809285603,113.55851384600865,104210,75433.6,29.25333577495853,36.36227677532056,NaN,NaN,NaN,NaN,0.5940878840186178,28.147333663841668,43558654,-0.15001807661146238,-0.6154750293299998,-0.4654569527185374
2025-09-15T11:10:00-04:00,112.85,113.37,112.83,113.31,NaN,NaN,NaN,114.32063440646557,NaN,NaN,115.1563000000001,117.13518838492966,113.17741161507054,113.38711280175139,114.38019229784489,115.26625092213627,113.4941336735535,66280,75610.06666666667,37.39878191029281,35.95854008676131,NaN,NaN,NaN,NaN,0.5916530351601452,28.256988412426992,43624934,-0.11215588853340475,-0.6056518133852933,-0.49349592485188853
2025-09-15T11:15:00-04:00,113.31,113.53,112.93,113.2,NaN,NaN,NaN,114.32063440646557,NaN,NaN,115.12830000000011,117.17629278319059,113.08030721680963,113.38711280175139,114.34591220518548,115.24061829544543,113.45120611492554,53116,76330.23333333334,36.4056986910847,35.75750194975722,NaN,NaN,NaN,NaN,0.5922492469344202,27.966622614117075,43571818,-0.08506604042596289,-0.5998284753843421,-0.5147624349583793
2025-09-15T11:20:00-04:00,113.21,113.43,113.16,113.35,NaN,NaN,NaN,114.32063440646557,NaN,NaN,115.09030000000011,117.19750232535846,112.98309767464177,113.38711280175139,114.32855829436055,115.22558874134612,113.43152784737498,30729,76604.56666666667,38.79249903327844,35.80160821050445,NaN,NaN,NaN,NaN,0.5692314435819623,27.696997229972155,43602547,-0.049361705613027995,-0.5764645669746642,-0.5271028613616362
2025-09-15T11:25:00-04:00,113.34,113.85,113.33,113.79,NaN,NaN,NaN,114.32063440646557,NaN,NaN,115.05710000000012,117.19270398014261,112.92149601985763,113.38711280175139,114.31185407265701,115.20381981651408,113.41988832879994,46616,77131.36666666667,45.28016887434576,36.60866575763016,NaN,NaN,NaN,NaN,0.5657149118975362,26.43376743297886,43649163,0.008489970166131955,-0.5164903986539713,-0.5249803688201032
2025-09-15T11:30:00-04:00,113.79,114.09,113.77,113.98,NaN,NaN,NaN,114.32063440646557,NaN,NaN,115.02170000000011,117.16883633475089,112.87456366524933,112.87491575840863,114.30202436735439,115.18388648970338,113.4201622450054,51866,76386.06666666667,47.850673581173254,37.670630220983824,NaN,NaN,NaN,NaN,0.5481638467619984,24.744883633980816,43701029,0.061216723444141974,-0.4484594645149258,-0.5096761879590678
2025-09-15T11:35:00-04:00,114,114.48,113.97,114.4,112.60984930458496,112.60984930458496,112.60984930458496,NaN,NaN,NaN,114.99210000000012,117.13188418537722,112.85231581462303,113.2529326067269,114.30143885165745,115.16938456417441,113.4334931391405,62314,76903.46666666666,53.095906463051826,39.23539054003687,NaN,NaN,NaN,NaN,0.5454378577075703,23.53475251829502,43763343,0.12250578843348459,-0.35654395241721204,-0.4790497408506966
2025-09-15T11:40:00-04:00,114.4,114.52,114.245,114.255,112.80326524528564,NaN,NaN,NaN,NaN,NaN,114.96840000000012,117.11405741906961,112.82274258093062,113.40084608538152,114.3021907192188,115.16164968801016,113.44273175042744,39557,76727.43333333333,51.18193198496759,39.92885802775189,NaN,NaN,NaN,NaN,0.5261208678713146,22.485173478792145,43723786,0.14961247493263163,-0.29203414718490706,-0.4416466221175387
2025-09-15T11:45:00-04:00,114.24,114.25,113.96,114.17,112.80326524528564,NaN,NaN,NaN,NaN,NaN,114.94010000000011,117.08980276085,112.79039723915022,113.40084608538152,114.29952193165765,115.15269236841868,113.44635149489662,31323,76104.4,50.043112156839406,40.248919468964004,NaN,NaN,NaN,NaN,0.5096122344519352,20.89258521014855,43692463,0.15736139425408197,-0.24494487929993625,-0.4023062735540182
2025-09-15T11:50:00-04:00,114.19,114.57,114.09,114.57,112.80326524528564,NaN,NaN,NaN,NaN,NaN,114.92290000000011,117.07040933874516,112.77539066125506,113.49574149464418,114.30178263140168,115.14632363875364,113.45724162404971,43036,73530.56666666667,55.105519046878506,41.150721531823194,NaN,NaN,NaN,NaN,0.5074970748482247,20.0389176690029,43735499,0.18316393747862797,-0.17335135170573324,-0.3565152891843612
2025-09-15T11:55:00-04:00,114.57,114.83,114.52,114.625,113.1600696784927,NaN,NaN,NaN,NaN,NaN,114.90300000000012,117.04272802009727,112.76327197990297,113.81559319571534,114.3126575404814,115.14647668776537,113.47883839319742,66164,72309.63333333333,55.76922182414211,42.485789528731914,NaN,NaN,NaN,NaN,0.49339014093049455,19.709715469443793,43801663,0.1964949687754508,-0.11089657821504773,-0.30739154699049853
2025-09-15T12:00:00-04:00,114.65,114.74,114.21,114.21,113.1600696784927,NaN,NaN,NaN,NaN,NaN,114.8708000000001,117.00280315196937,112.73879684803083,113.81559319571534,114.3145538320937,115.13770450487321,113.49140315931417,57044,69658.63333333333,49.78817775809574,43.65405639887702,NaN,NaN,NaN,NaN,0.4960051308640307,18.712855482198336,43744619,0.1708681095452536,-0.09380641005893153,-0.26467451960418514
2025-09-15T12:05:00-04:00,114.22,114.44,114.18,114.2,113.1600696784927,NaN,NaN,NaN,NaN,NaN,114.8358000000001,116.95319496551905,112.71840503448117,113.81559319571534,114.31419761711804,115.13379274434331,113.49460248989277,19407,66430.1,49.64999996352724,44.869847584126056,NaN,NaN,NaN,NaN,0.4791476215165993,17.721776965753648,43725212,0.1476233124411467,-0.08014537905275176,-0.22776869149389847
2025-09-15T12:10:00-04:00,114.18,114.28,114.07,114.12,113.1600696784927,NaN,NaN,NaN,NaN,NaN,114.79360000000011,116.88207412241591,112.70512587758431,113.81559319571534,114.31259455395767,115.12816210312008,113.49702700479526,23088,63671.666666666664,48.49057139477863,46.29325703267248,NaN,NaN,NaN,NaN,0.45992279140827136,16.553859737108308,43702124,0.12228637654644009,-0.07491072081084837,-0.19719709735728846
2025-09-15T12:15:00-04:00,114.1,114.27,114.02,114.02,113.1600696784927,NaN,NaN,NaN,NaN,NaN,114.74860000000011,116.80459614785678,112.69260385214344,113.81559319571534,114.3113610550147,115.12467911853207,113.49804299149733,13453,61525.333333333336,47.012706624604036,47.56178352193287,NaN,NaN,NaN,NaN,0.44492830630768054,15.388859147906237,43688671,0.09541126397167471,-0.07793301739269509,-0.1733442813643698
2025-09-15T12:20:00-04:00,114.01,114.51,113.96,114.44,113.1600696784927,NaN,NaN,NaN,NaN,NaN,114.70880000000012,116.7093584820202,112.70824151798004,113.81559319571534,114.31120591322747,115.11662740025925,113.50578442619569,44976,60405.166666666664,53.43215238307042,48.707024269988416,NaN,NaN,NaN,NaN,0.4524334272857042,14.816981003702198,43733647,0.10194861347833178,-0.04590851451645506,-0.14785712799478684
2025-09-15T12:25:00-04:00,114.44,114.76,114.43,114.625,113.18976448303428,NaN,NaN,NaN,NaN,NaN,114.67130000000012,116.6053370317046,112.73726296829564,113.83523614269761,114.31498528366954,115.1158940875849,113.51407647975418,30328,58040.46666666667,55.962915395361456,50.103968320293895,NaN,NaN,NaN,NaN,0.44368818247958236,14.80615481147625,43763975,0.11385603573773184,-0.005537083322622038,-0.11939311906035388
2025-09-15T12:30:00-04:00,114.64,114.85,114.63,114.76,113.36795700653272,NaN,NaN,NaN,NaN,NaN,114.63470000000011,116.48976270514343,112.77963729485678,113.99768891415808,114.32340250591713,115.11870753485594,113.52809747697832,46884,57222.9,57.76662980993064,51.45926337576905,NaN,NaN,NaN,NaN,0.42806759801675465,14.97642480222254,43810859,0.12505472468497397,0.0369252867958636,-0.08812943788911037
2025-09-15T12:35:00-04:00,114.78,114.99,114.57,114.94,113.41304986987215,NaN,NaN,NaN,NaN,NaN,114.5981000000001,116.35269270488128,112.84350729511893,114.09815113132646,114.33152195829757,115.12304787891453,113.53999603768061,38905,53305.96666666667,60.11252794163755,52.518717594861315,NaN,NaN,NaN,NaN,0.42749134101555797,15.413833444303165,43849764,0.1378089094013164,0.08413169886253513,-0.05367721053878127
2025-09-15T12:40:00-04:00,114.94,115.33,114.93,115.19,113.77063851215068,NaN,NaN,NaN,NaN,NaN,114.58010000000012,116.29102546886276,112.86917453113747,114.41652090506118,114.36615595344765,115.15808394905996,113.57422795783533,107960,54885.4,63.17224223346204,53.61311535573908,NaN,NaN,NaN,NaN,0.4255276738001604,16.439481486065922,43957724,0.15502259537947918,0.1401010336855677,-0.014921561693911477
2025-09-15T12:45:00-04:00,115.2,115.25,115.03,115.15,113.81242767068929,NaN,NaN,NaN,NaN,NaN,114.5613000000001,116.22546683058513,112.89713316941507,114.41652090506118,114.37737719789246,115.16901464764439,113.58573974814053,37377,52994,62.34815603315979,54.273990325032514,NaN,NaN,NaN,NaN,0.41084712567157744,17.391868953417053,43920347,0.15526859013057318,0.179164175969305,0.023895585838731824
2025-09-15T12:50:00-04:00,115.14,115.45,115.11,115.26,113.96640823111251,NaN,NaN,NaN,NaN,NaN,114.5505000000001,116.18918514365117,112.91181485634903,114.60737337923915,114.39517370375464,115.18881719675602,113.60153021075325,52462,52890.63333333333,63.748670706113856,55.1716145194001,NaN,NaN,NaN,NaN,0.4057866166950364,18.626152918301976,43972809,0.1540854303361342,0.21650237375889958,0.062416943422765374
2025-09-15T12:55:00-04:00,115.3,115.42,114.83,115.03,113.96640823111251,NaN,NaN,NaN,NaN,NaN,114.52590000000009,116.09671850002968,112.9550814999705,114.60737337923915,114.4038391975871,115.19632068764096,113.61135770753324,33194,51557.63333333333,58.82192150895756,55.79867233026568,NaN,NaN,NaN,NaN,0.41894471550253404,18.85683779404048,43939615,0.13001932978938494,0.22494110565949654,0.09492177587011161
2025-09-15T13:00:00-04:00,115.01,115.29,114.95,115.22,113.96640823111251,NaN,NaN,NaN,NaN,NaN,114.5063000000001,116.01635537648237,112.99624462351782,114.60737337923915,114.4106347623069,115.20270782137662,113.61856170323718,24470,50350.333333333336,61.470958224884164,56.253346557266084,NaN,NaN,NaN,NaN,0.4133058072523533,19.07104517865481,43964085,0.119379308503921,0.24414591150001286,0.12476660299609185
2025-09-15T13:05:00-04:00,115.24,115.59,115.24,115.48,114.10449818072247,NaN,NaN,NaN,NaN,NaN,114.4996000000001,115.98920375940567,113.00999624059453,114.64877517017044,114.42349111851587,115.2188176556924,113.62816458133933,34246,50127.7,64.80735883771455,56.89892777252127,NaN,NaN,NaN,NaN,0.41021253530575696,19.860208551933216,43998331,0.12190740796586222,0.2771508629534196,0.1552434549875574
2025-09-15T13:10:00-04:00,115.45,115.45,115.19,115.39,114.10449818072247,NaN,NaN,NaN,NaN,NaN,114.4986000000001,115.98574227968767,113.01145772031252,114.64877517017044,114.4325021744208,115.22909193937711,113.6359124094645,27039,49785.96666666667,62.780748208104306,57.826968518950444,NaN,NaN,NaN,NaN,0.4016259256410605,20.41988075989068,43971292,0.10994246927382251,0.29267154157983555,0.18272907230601304
2025-09-15T13:15:00-04:00,115.4,115.43,115.11,115.21,114.10449818072247,NaN,NaN,NaN,NaN,NaN,114.49420000000009,115.97156300212103,113.01683699787915,114.64877517017044,114.43924145381682,115.23597732129345,113.64250558634019,22943,48625.8,58.81907316535486,58.481902319080994,NaN,NaN,NaN,NaN,0.39579550238098526,20.655933359242447,43948349,0.08352662603089472,0.28713735484463143,0.2036107288137367
2025-09-15T13:20:00-04:00,115.2,115.22,114.85,114.89,114.10449818072247,NaN,NaN,NaN,NaN,NaN,114.48140000000008,115.93351850757806,113.0292814924221,114.64877517017044,114.44578743612168,115.2399775782533,113.65159729399005,33682,46708.5,52.47892445396744,58.76678468045163,NaN,NaN,NaN,NaN,0.3939529664966295,20.00766192775699,43914667,0.040313150918023455,0.254002167461266,0.21368901654324257
2025-09-15T13:25:00-04:00,114.92,115.14,114.87,115.02,114.10449818072247,NaN,NaN,NaN,NaN,NaN,114.4723000000001,115.90497052738225,113.03962947261796,114.64877517017044,114.45153398663942,115.24369755418697,113.65937041909187,28984,45937.333333333336,54.619020151227325,59.310092789496146,NaN,NaN,NaN,NaN,0.38509918317544134,19.40569559852049,43943651,0.01746263423808561,0.23551730934084958,0.21805467510276397
2025-09-15T13:30:00-04:00,115.02,115.15,115,115.13,114.10449818072247,NaN,NaN,NaN,NaN,NaN,114.4689000000001,115.89448660208102,113.04331339791919,114.64877517017044,114.456015564788,115.24721555058231,113.6648155789937,20011,43055.46666666667,56.407929943835214,59.52264832955077,NaN,NaN,NaN,NaN,0.36830638437719593,18.874259221825437,43963662,0.007256933098778562,0.22712584147623716,0.2198689083774586
2025-09-15T13:35:00-04:00,115.125,115.17,114.89,114.95,114.10449818072247,NaN,NaN,NaN,NaN,NaN,114.4677000000001,115.89156264788667,113.04383735211351,114.64877517017044,114.46078215266496,115.25016908366284,113.67139522166708,25177,40421.03333333333,52.743960734194815,59.292722996610294,NaN,NaN,NaN,NaN,0.36199878549311054,17.98805830632612,43938485,-0.013011905438186533,0.20360402657972543,0.21661593201791196
2025-09-15T13:40:00-04:00,114.94,114.97,114.54,114.54,114.10449818072247,NaN,NaN,NaN,NaN,NaN,114.4653000000001,115.8882622763951,113.0423377236051,114.64877517017044,114.46300727197391,115.24875007996174,113.67726446398608,29196,39184.9,45.49506320180589,58.41618252460139,NaN,NaN,NaN,NaN,0.36685601510074495,17.33655163038649,43909289,-0.0531740034453799,0.15014842771118708,0.20332243115656698
2025-09-15T13:45:00-04:00,114.58,114.61,114.47,114.61,114.10449818072247,NaN,NaN,NaN,NaN,NaN,114.44770000000011,115.8409899339414,113.05441006605882,114.64877517017044,114.46359953760444,115.24705733098696,113.68014174422191,17341,37992.4,46.838433849626476,57.468032946600594,NaN,NaN,NaN,NaN,0.3506520140221204,16.927440789165452,43926630,-0.07294577460745771,0.11214021289724485,0.18508598750470256
2025-09-15T13:50:00-04:00,114.64,114.83,114.64,114.73,114.10449818072247,NaN,NaN,NaN,NaN,NaN,114.42730000000012,115.77276974697222,113.08183025302802,114.64877517017044,114.46539473033097,115.24654898885888,113.68424047180307,19681,37624.13333333333,49.152101184984886,56.466594300280796,NaN,NaN,NaN,NaN,0.3413197273062546,15.810734142598696,43946311,-0.07554367364703843,0.09065639544590454,0.16620006909294296
2025-09-15T13:55:00-04:00,114.76,114.96,114.75,114.96,114.10449818072247,NaN,NaN,NaN,NaN,NaN,114.4201000000001,115.75014885626199,113.09005114373822,114.55202013613635,114.46834772796142,115.24758026627416,113.68911518964867,20710,36760.6,53.34339012122605,55.82339673514267,NaN,NaN,NaN,NaN,0.33336831821294993,14.990908709241193,43967021,-0.06004901385986597,0.09113880176811051,0.15118781562797648
2025-09-15T14:00:00-04:00,114.97,115.22,114.94,115,114.10449818072247,NaN,NaN,NaN,NaN,NaN,114.42030000000011,115.75069454299515,113.08990545700507,114.55161610890909,114.47488272966189,115.25218596745717,113.6975794918666,33642,36153.13333333333,54.05272479567809,55.13082917011155,NaN,NaN,NaN,NaN,0.32955629548345355,14.959842938204806,44000663,-0.04601503665704637,0.09366901980666853,0.1396840564637149
2025-09-15T14:05:00-04:00,115.02,115.06,114.88,114.92,114.10449818072247,NaN,NaN,NaN,NaN,NaN,114.42410000000012,115.75908867412114,113.0891113258791,114.55091590822597,114.47737372312608,115.25341511509525,113.7013323311569,15761,34601.36666666667,52.33885850717743,54.66775324141297,NaN,NaN,NaN,NaN,0.31887370294892164,14.719316843543004,43984902,-0.04118551335668061,0.08820216476786413,0.12938767812454474
2025-09-15T14:10:00-04:00,114.89,115.21,114.77,115.09,114.10449818072247,NaN,NaN,NaN,NaN,NaN,114.42650000000012,115.76583005642021,113.08716994358002,114.55091590822597,114.48228298760587,115.25654461123037,113.70802136398137,27468,34198.4,55.56323258393273,54.245772838487866,NaN,NaN,NaN,NaN,0.3275255813097128,14.907152463681639,44012370,-0.026330048963962113,0.0964751169195921,0.12280516588355421
2025-09-15T14:15:00-04:00,115.1,115.22,115.03,115.195,114.10449818072247,NaN,NaN,NaN,NaN,NaN,114.43800000000012,115.79355449910372,113.08244550089651,114.55091590822597,114.4855330699849,115.2592965795165,113.71176956045329,14979,33653.6,57.47675030663455,53.72215794341072,NaN,NaN,NaN,NaN,0.317702325501876,15.109041341656024,44027349,-0.0100574035608067,0.11023341143254584,0.12029081499335254
2025-09-15T14:20:00-04:00,115.21,115.21,114.98,115.15,114.10449818072247,NaN,NaN,NaN,NaN,NaN,114.45060000000012,115.82060385402006,113.08059614598018,114.55806315600935,114.48982110449222,115.26266925917552,113.71697294980892,21111,32922.76666666667,56.356684943209245,53.263296281632506,NaN,NaN,NaN,NaN,0.31143787368031267,15.09095842151831,44006238,-0.003299262232507469,0.1161667372027182,0.11946599943522566
2025-09-15T14:25:00-04:00,115.17,115.23,114.73,114.77,114.10449818072247,NaN,NaN,NaN,NaN,NaN,114.46420000000013,115.83311542471756,113.0952845752827,114.55806315600935,114.49518769460582,115.26453265145113,113.7258427377605,39987,32050.2,47.87278361317977,52.48141845647714,NaN,NaN,NaN,NaN,0.32490659698886176,14.11998974988548,43966251,-0.024230298360400263,0.08917812648472534,0.1134084248451256
2025-09-15T14:30:00-04:00,114.765,114.99,114.6,114.86,114.10449818072247,NaN,NaN,NaN,NaN,NaN,114.48180000000013,115.84798704430442,113.11561295569585,114.55806315600935,114.4985368625784,115.26455958114528,113.73251414401153,32960,31247.4,49.800286361982906,52.29008716419253,NaN,NaN,NaN,NaN,0.3295561257753717,13.447780297106485,43999211,-0.03136960724304433,0.07419641579132019,0.10556602303436452
2025-09-15T14:35:00-04:00,114.85,114.86,114.61,114.62,114.10449818072247,NaN,NaN,NaN,NaN,NaN,114.49860000000011,115.85043732750803,113.14676267249219,114.55806315600935,114.49995560486666,115.26341357484189,113.73649763489142,22818,31361.1,45.019647099034096,51.60441766046444,NaN,NaN,NaN,NaN,0.3238735453628451,12.823585805240272,43976393,-0.05047860568924514,0.0424677659228081,0.09294637161205324
2025-09-15T14:40:00-04:00,114.64,114.66,114.36,114.42,114.10449818072247,NaN,NaN,NaN,NaN,NaN,114.49940000000014,115.85100295945756,113.14779704054271,114.55806315600935,114.49972730209541,115.25880849265467,113.74064611153615,36878,31820.766666666666,41.44881303203228,50.535909309621374,NaN,NaN,NaN,NaN,0.3221682921226417,13.060849019138207,43939515,-0.07342049088195683,0.0011707580096071979,0.07459124889156403
2025-09-15T14:45:00-04:00,114.39,114.62,114.34,114.51,114.10449818072247,NaN,NaN,NaN,NaN,NaN,114.49640000000012,115.84722943410017,113.14557056590007,114.55806315600935,114.49961699216107,115.25438253226983,113.7448514520523,36974,32604.8,43.61611668938992,49.883920449278165,NaN,NaN,NaN,NaN,0.3191562712567388,13.342461608216475,43976489,-0.07888764104327416,-0.02401830241252867,0.05486933863074549
2025-09-15T14:50:00-04:00,114.53,114.62,114.41,114.55,114.10449818072247,NaN,NaN,NaN,NaN,NaN,114.49960000000014,115.8501640895652,113.14903591043509,114.55806315600935,114.49984099843121,115.25147882160807,113.74820317525435,27226,32013.133333333335,44.59767080632232,49.819820992457906,NaN,NaN,NaN,NaN,0.3113593947384009,13.603959012360578,44003715,-0.07612645108289992,-0.04028872522287941,0.03583772586002051
2025-09-15T14:55:00-04:00,114.54,114.54,114.19,114.2,114.10449818072247,NaN,NaN,NaN,NaN,NaN,114.50660000000015,115.84721544076348,113.16598455923682,114.55806315600935,114.49835752545714,115.24723941383387,113.74947563708041,25893,31865.3,38.3128057231678,49.21084755485372,NaN,NaN,NaN,NaN,0.31483372368565793,14.531382377244448,43977822,-0.09306802439215331,-0.08049730463017113,0.012570719761982176
2025-09-15T15:00:00-04:00,114.175,114.38,114.14,114.37,114.10449818072247,NaN,NaN,NaN,NaN,NaN,114.52560000000013,115.83053009775603,113.22066990224423,114.55806315600935,114.49704388834039,115.2436593115455,113.75042846513527,21723,31026.6,42.54782886208485,48.739113817503714,NaN,NaN,NaN,NaN,0.30948845770811056,15.536697866694754,43999545,-0.08807349670684095,-0.097521151121569,-0.00944765441472806
2025-09-15T15:05:00-04:00,114.37,114.52,114.23,114.42,114.10449818072247,NaN,NaN,NaN,NaN,NaN,114.54760000000013,115.80677471386106,113.2884252861392,114.55806315600935,114.49585981336308,115.23841878509857,113.75330084162759,37306,30973.3,43.77055813309583,48.05534010406584,NaN,NaN,NaN,NaN,0.30809642501467355,15.76708824917262,44036851,-0.07704904962906793,-0.10575896645106297,-0.028709916821995047
2025-09-15T15:10:00-04:00,114.41,114.41,114.11,114.25,114.10449818072247,NaN,NaN,NaN,NaN,NaN,114.57720000000013,115.73318989615917,113.42121010384109,114.4584505248075,114.49475365937064,115.23577137471223,113.75373594402906,15669,27896.933333333334,40.606239316841254,47.0948768555775,NaN,NaN,NaN,NaN,0.3082323946564828,16.363947697971824,44021182,-0.0766873612982524,-0.12456911844481056,-0.04788175714655815
2025-09-15T15:15:00-04:00,114.26,114.32,113.95,114.08,NaN,NaN,NaN,115.14359119662787,115.14359119662787,115.14359119662787,114.60260000000015,115.65315650014686,113.55204349985344,114.177760419846,114.4880437020094,115.22415110116044,113.75193630285837,61218,28691.633333333335,37.67321592032694,46.04733095651675,NaN,NaN,NaN,NaN,0.31264436646673327,17.387280828257794,43959964,-0.08285305786937232,-0.15144807948327355,-0.06859502161390123
2025-09-15T15:20:00-04:00,114.03,114.51,114,114.5,NaN,NaN,NaN,115.14359119662787,NaN,NaN,114.62640000000015,115.61056470167031,113.64223529832998,114.0852083358768,114.4866588616501,115.21953319072396,113.75378453257623,31848,28004.5,47.72031668735513,45.48712267818978,NaN,NaN,NaN,NaN,0.3267411974333955,17.407199876854545,43991812,-0.054945516307225856,-0.13727691699793354,-0.08233140069070768
2025-09-15T15:25:00-04:00,114.52,114.57,114.38,114.5,NaN,NaN,NaN,115.14359119662787,NaN,NaN,114.65240000000014,115.54927510836649,113.7555248916338,113.91030666796892,114.486627390621,115.21602578124123,113.75722900000076,33260,28006.7,47.72031668735513,44.790234562526955,NaN,NaN,NaN,NaN,0.3169739690452957,17.15018059157047,43991812,-0.03382267549259088,-0.12460974505644629,-0.0907870695638554
2025-09-15T15:30:00-04:00,114.49,114.49,114.065,114.17,NaN,NaN,NaN,115.14359119662787,NaN,NaN,114.66880000000013,115.49718773530891,113.84041226469135,113.91030666796892,114.48399414276813,115.20990120121931,113.75808708431694,38191,28464.066666666666,41.60835526597034,43.73678244272418,NaN,NaN,NaN,NaN,0.3254043998277747,17.874147389642506,43953621,-0.0390423882250988,-0.1395900548452289,-0.10054766662013011
2025-09-15T15:35:00-04:00,114.2,114.365,114.11,114.365,NaN,NaN,NaN,115.14359119662787,NaN,NaN,114.68030000000016,115.47484240918493,113.88575759081539,113.91030666796892,114.48300476311324,115.20728800973434,113.75872151649214,17315,27899.7,46.0088847997957,43.60364681319675,NaN,NaN,NaN,NaN,0.3203755141257905,18.546402273566535,43970936,-0.026906218209797078,-0.13418043938237645,-0.10727422117257937
2025-09-15T15:40:00-04:00,114.37,114.65,114.35,114.6,NaN,NaN,NaN,115.14359119662787,NaN,NaN,114.69270000000014,115.46209251361157,113.92330748638872,113.85355558447843,114.4834639015938,115.20445170503379,113.7624760981538,32869,28094.033333333333,50.81914168506972,43.67642219341723,NaN,NaN,NaN,NaN,0.31892012025966343,17.889192480653286,44003805,-0.0019138839471749547,-0.10966657610654806,-0.10775269215937311
2025-09-15T15:45:00-04:00,114.59,114.71,114.56,114.71,NaN,NaN,NaN,115.14359119662787,NaN,NaN,114.69890000000015,115.46374061084074,113.93405938915956,113.99784446758274,114.48737872467233,115.20080125899746,113.77395619034719,81710,30052.933333333334,52.932981932402114,44.24166039580066,NaN,NaN,NaN,NaN,0.30685439738397263,17.037073033671454,44085515,0.021853459691891522,-0.08043586754450871,-0.10228932723640023
2025-09-15T15:50:00-04:00,114.7,114.94,114.66,114.85,NaN,NaN,NaN,115.14359119662787,NaN,NaN,114.71080000000016,115.46609956969306,113.95550043030727,114.2302755740662,114.49278416033397,115.20156296840895,113.78400535225899,61495,30980.033333333333,55.55148648946525,45.24899421418872,NaN,NaN,NaN,NaN,0.3049362261422604,16.25230226439373,44147010,0.04547180097228655,-0.04544957602104205,-0.0909213769933286
2025-09-15T15:55:00-04:00,114.85,114.97,114.78,114.79,NaN,NaN,NaN,115.14359119662787,NaN,NaN,114.72320000000016,115.46277220064651,113.98362779935381,114.30722045925296,114.49951507662219,115.2031832642856,113.79584688895878,72634,32435.033333333333,54.16079880486327,46.002185793865394,NaN,NaN,NaN,NaN,0.2967264957035273,15.628754021731888,44074376,0.054891465787608076,-0.022307044758818506,-0.07719851054642658
2025-09-16T09:30:00-04:00,115.09,116.1,115.02,115.15,114.46745318597974,114.46745318597974,114.46745318597974,NaN,NaN,NaN,114.73480000000016,115.48254583915896,113.98705416084137,114.91477636740237,115.42333333333332,115.42333524068195,115.42333142598468,168095,37371.166666666664,60.54329636755507,47.14115904823916,NaN,NaN,NaN,NaN,0.36910317458184594,17.6169362751219,44242471,0.08159619092330318,0.024796728107702393,-0.05679946281560079
2025-09-16T09:35:00-04:00,115.16,115.93,115.06,115.75,114.46745318597974,NaN,NaN,NaN,NaN,NaN,114.75730000000016,115.5564150355116,113.95818496448871,114.91477636740237,115.47730346469916,115.55175173870855,115.40285519068978,88339,39476.566666666666,68.43241385837138,49.292559629325126,NaN,NaN,NaN,NaN,0.40488151925457155,19.46310551041263,44330810,0.13286521627337322,0.10928205752611575,-0.023583158747257485
2025-09-16T09:40:00-04:00,115.8,116.02,114.02,114.3,NaN,NaN,NaN,116.40145277889036,116.40145277889036,116.40145277889036,114.75910000000016,115.5536682852803,113.96453171472002,114.91477636740237,115.24615114631044,115.58000311935905,114.91229917326183,127159,42742,45.0104816481026,49.46846339975497,NaN,NaN,NaN,NaN,0.5188185535935307,18.172836708447665,44203651,0.06571402455136878,0.058559371941953486,-0.00715465260941529
2025-09-16T09:45:00-04:00,114.33,114.8,113.8,114.74,NaN,NaN,NaN,115.75502310712262,NaN,NaN,114.76990000000016,115.54829190641699,113.99150809358333,114.91477636740237,115.09915907105125,115.53145064148895,114.66686750061355,86415,45044.46666666667,50.54225673070095,49.95215615672676,NaN,NaN,NaN,NaN,0.5531886569082786,17.228315837585292,44290066,0.04832512044243914,0.05325174794363363,0.004926627501194495
2025-09-16T09:50:00-04:00,114.75,115.25,114.43,114.72,NaN,NaN,NaN,115.75502310712262,NaN,NaN,114.78190000000016,115.53802668249095,114.02577331750938,114.91477636740237,115.0594204051008,115.47458474572089,114.6442560644807,71997,46788.333333333336,50.294589885736436,50.64418119736213,NaN,NaN,NaN,NaN,0.5722466099862581,16.552790997274972,44218069,0.03357154116007224,0.04689105395128479,0.013319512791212554
2025-09-16T09:55:00-04:00,114.7,114.74,114.12,114.59,NaN,NaN,NaN,115.75502310712262,NaN,NaN,114.79330000000016,115.51973956388736,114.06686043611296,114.91477636740237,115.00730767402067,115.43634774236016,114.57826760568118,53906,47894.86666666667,48.626630545717575,51.4265679563186,NaN,NaN,NaN,NaN,0.5756575664158105,15.450472027203494,44164163,0.014146680076317357,0.03100286288660925,0.016856182810291893
2025-09-16T10:00:00-04:00,114.51,115.24,114.33,115.23,NaN,NaN,NaN,115.75502310712262,NaN,NaN,114.80910000000016,115.53847422492869,114.07972577507162,114.91477636740237,114.99949936083614,115.40590072506399,114.5930979966083,70324,49117.6,56.308733564334936,52.0400263046743,NaN,NaN,NaN,NaN,0.5995391688146808,15.172169915849008,44234487,0.0419195913674188,0.0692556720195654,0.027336080652146592
2025-09-16T10:05:00-04:00,115.16,115.47,115.01,115.18,NaN,NaN,NaN,115.75502310712262,NaN,NaN,114.82020000000017,115.55490255204042,114.08549744795992,114.91477636740237,115.01845071433799,115.4118799042273,114.62502152444867,62645,50680.4,55.60911269612243,52.60351173387197,NaN,NaN,NaN,NaN,0.5895720853279175,15.283084497937358,44171842,0.05368951884546625,0.0944479792089794,0.04075846036351315
2025-09-16T10:10:00-04:00,115.19,115.21,114.75,115.06,NaN,NaN,NaN,115.75502310712262,NaN,NaN,114.82620000000017,115.56373253486461,114.08866746513573,114.91477636740237,115.01767866010583,115.39801258760913,114.63734473260253,51102,51468.2,53.87889171478227,53.47997862307282,NaN,NaN,NaN,NaN,0.580316936375923,14.832112042072673,44120740,0.05022248131056682,0.10353656200172168,0.053314080691154855
2025-09-16T10:15:00-04:00,115.055,115.3,114.52,114.6,NaN,NaN,NaN,115.75502310712262,NaN,NaN,114.81940000000017,115.55887722072453,114.07992277927582,114.91477636740237,114.98576569194584,115.34422399578132,114.62730738811037,138982,55601.63333333333,47.746142975651985,53.60406849277683,NaN,NaN,NaN,NaN,0.5945800123490714,13.950003696573713,43981758,0.015574484239320875,0.07278218599030595,0.05720770175098507
2025-09-16T10:20:00-04:00,114.58,115.11,114.17,115.11,NaN,NaN,NaN,115.75502310712262,NaN,NaN,114.81780000000018,115.55440344824534,114.08119655175501,114.5468210939219,114.97247135262805,115.32146431752865,114.62347838772745,69492,57214.333333333336,53.99801548784615,53.831130907260864,NaN,NaN,NaN,NaN,0.619252868609852,13.426901712771652,44051250,0.02506680756900813,0.08854121121224523,0.0634744036432371
2025-09-16T10:25:00-04:00,115.11,115.5,114.77,115.32,NaN,NaN,NaN,115.75502310712262,NaN,NaN,114.82120000000018,115.56543533910813,114.07696466089222,113.91345687513751,114.98954416148798,115.33021599463629,114.64887232833968,81477,58597.333333333336,56.31568289641048,54.072752404690036,NaN,NaN,NaN,NaN,0.6271633779948628,12.728571867302804,44132727,0.0425253938413819,0.11663114594496449,0.07410575210358258
2025-09-16T10:30:00-04:00,115.35,116.1,114.89,116.1,113.73462393416683,113.73462393416683,113.73462393416683,NaN,NaN,NaN,114.83800000000015,115.65542277922354,114.02057722077676,113.98657457267755,115.05121297925136,115.43297232462785,114.66945363387487,102225,60906.166666666664,63.6426853412862,54.6506951798201,NaN,NaN,NaN,NaN,0.6687945652809436,13.027773583265509,44234952,0.10034101585424209,0.1995320219213852,0.09919100606714311
2025-09-16T10:35:00-04:00,116.11,116.2,115.8,116.04,114.26509557352288,NaN,NaN,NaN,NaN,NaN,114.85820000000017,115.7409134529282,113.97548654707214,114.30925965814204,115.11289254128573,115.55099742186873,114.67478766070273,80292,62821.96666666667,62.770521943911,55.26567540403779,NaN,NaN,NaN,NaN,0.6495949534751624,13.448736292039701,44154660,0.126585320502944,0.2574226566958231,0.1308373361928791
2025-09-16T10:40:00-04:00,116,116.99,115.77,116.97,114.55759122927184,NaN,NaN,NaN,NaN,NaN,114.89320000000016,115.95177783841653,113.8346221615838,114.86740772651363,115.25701861285486,115.85970691735697,114.65433030835275,136787,66152.26666666666,69.70140059455214,55.91982570596616,NaN,NaN,NaN,NaN,0.6903381710840792,14.825658931128944,44291447,0.19455653887799,0.3740330097903666,0.1794764709123766
2025-09-16T10:45:00-04:00,116.96,117.3,116.58,117.29,115.10224617339586,NaN,NaN,NaN,NaN,NaN,114.92940000000016,116.17333350304082,113.68546649695949,115.2419261812109,115.41086801882425,116.17597326447157,114.64576277317693,129866,69248.66666666667,71.65665875098374,56.15012891258134,NaN,NaN,NaN,NaN,0.6924568731495021,16.426764937846034,44421313,0.24574600617211237,0.48665897862751706,0.2409129724554047
2025-09-16T10:50:00-04:00,117.28,117.36,116.85,117.05,115.28123498369604,NaN,NaN,NaN,NaN,NaN,114.96260000000015,116.33582429340203,113.58937570659828,115.45854094496872,115.48654173881978,116.31118667878988,114.66189679884968,71842,70735.86666666667,68.1067463745188,57.79986210732535,NaN,NaN,NaN,NaN,0.6794242393531095,17.9753566661726,44349471,0.24743556394785188,0.5502074273902196,0.3027718634423677
2025-09-16T10:55:00-04:00,117.03,117.03,116.64,116.75,115.28123498369604,NaN,NaN,NaN,NaN,NaN,114.99340000000016,116.45375535400693,113.5330446459934,115.45854094496872,115.52355956951303,116.36526499898207,114.68185414004398,45899,71402.73333333334,63.84872345562404,58.75032401624843,NaN,NaN,NaN,NaN,0.6601796508278871,18.92567334096308,44303572,0.21361795246923987,0.5697943040289175,0.35617635155967764
2025-09-16T11:00:00-04:00,116.73,116.92,116.14,116.215,115.28123498369604,NaN,NaN,NaN,NaN,NaN,115.01990000000016,116.51935255342494,113.52044744657539,115.45854094496872,115.55710987459707,116.40044720698343,114.71377254221072,63276,72787.83333333333,57.004218138056,59.2295831771284,NaN,NaN,NaN,NaN,0.6687382471973239,18.753222675983203,44240296,0.1438338807435381,0.5359687024891002,0.39213482174556213
2025-09-16T11:05:00-04:00,116.2,116.99,116.2,116.79,115.28123498369604,NaN,NaN,NaN,NaN,NaN,115.05530000000016,116.63454210936352,113.4760578906368,115.45854094496872,115.58570434268452,116.43629068728039,114.73511799808865,45252,73052.7,61.750119184613936,60.166975222763845,NaN,NaN,NaN,NaN,0.677399800968943,18.69254892533117,44285548,0.1256747052024555,0.5492282032486315,0.42355349804617604
2025-09-16T11:10:00-04:00,116.74,117.16,116.73,117.01,115.28123498369604,NaN,NaN,NaN,NaN,NaN,115.09290000000016,116.76429832475547,113.42150167524484,115.49560237105919,115.61955630125102,116.48636893609832,114.75274366640373,43860,73992.4,63.41409184813143,60.6745008144636,NaN,NaN,NaN,NaN,0.6597283866140179,18.88130334438225,44329408,0.11788323970812292,0.5709075476813297,0.45302430797320675
2025-09-16T11:15:00-04:00,116.99,117.08,116.49,116.76,115.28123498369604,NaN,NaN,NaN,NaN,NaN,115.12910000000016,116.86375695743475,113.39444304256558,115.49560237105919,115.65533523404909,116.53183469501997,114.77883577307821,57090,73854.8,60.208726388456945,61.00304464963035,NaN,NaN,NaN,NaN,0.6547477875701597,18.538744890988752,44272318,0.08673551376824828,0.5614437001835171,0.4747081864152688
2025-09-16T11:20:00-04:00,116.78,117.15,116.78,117.14,115.28123498369604,NaN,NaN,NaN,NaN,NaN,115.18110000000016,116.99602511139643,113.36617488860388,115.65378551747789,115.69356831368948,116.58666465707735,114.80047197030161,53085,74562.7,63.24949489910993,61.67237344851089,NaN,NaN,NaN,NaN,0.6358372313151482,18.333703218774417,44325403,0.08258879195445978,0.5779441763583435,0.4953553844038837
2025-09-16T11:25:00-04:00,117.13,117.47,117.06,117.2,115.50112602325504,NaN,NaN,NaN,NaN,NaN,115.23290000000017,117.1258353818782,113.33996461812214,116.0680284139823,115.74929751634768,116.67244443219425,114.82615060050111,70850,75815.7,63.72091080486682,62.813428293454805,NaN,NaN,NaN,NaN,0.6197060005069231,18.64417642832049,44396253,0.0749732654556362,0.5890719662234289,0.5140987007677927
2025-09-16T11:30:00-04:00,117.22,117.57,117.18,117.31,115.63812029492526,NaN,NaN,NaN,NaN,NaN,115.28450000000016,117.25870085097102,113.3102991490293,116.25342273118585,115.79146947433829,116.73786355453343,114.84507539414314,53199,76315.96666666666,64.61702102764147,63.571928689154504,NaN,NaN,NaN,NaN,0.6032984290421419,19.08281188094326,44449452,0.06860278181864898,0.5998521780411039,0.5312493962224549
2025-09-16T11:35:00-04:00,117.31,117.33,116.72,117.13,115.63812029492526,NaN,NaN,NaN,NaN,NaN,115.32790000000016,117.36603158554138,113.28976841445893,116.25342273118585,115.81734922962545,116.7710517669877,114.8636466922632,42141,77143.5,61.92168851433923,63.972357661863704,NaN,NaN,NaN,NaN,0.6037771126819889,18.430989464521588,44407311,0.04468313608214891,0.5871033163251411,0.5424201802429922
2025-09-16T11:40:00-04:00,117.09,117.53,117.08,117.24,115.63812029492526,NaN,NaN,NaN,NaN,NaN,115.37270000000015,117.47741870804103,113.26798129195927,116.25342273118585,115.85683960027258,116.82708702723325,114.88659217331191,57183,77953.96666666666,62.93907630295655,63.922099873411575,NaN,NaN,NaN,NaN,0.5927930332047041,18.164707081284163,44464494,0.029423203481809268,0.5791991845952538,0.5497759811134445
2025-09-16T11:45:00-04:00,117.24,117.77,117.21,117.55,115.76863514756788,NaN,NaN,NaN,NaN,NaN,115.42530000000016,117.61199376913567,113.23860623086466,116.44071243836716,115.91415392803182,116.91425776794243,114.91405008812121,76239,77771.6,65.71890015805559,64.13269831727905,NaN,NaN,NaN,NaN,0.5904506736900826,18.305961910081127,44540733,0.03308743352253929,0.5911352730166186,0.5580478394940793
2025-09-16T11:50:00-04:00,117.55,118.13,117.46,117.86,116.06051536813297,NaN,NaN,NaN,NaN,NaN,115.48070000000016,117.76862046190116,113.19277953809915,116.73156995069372,115.98617031001652,117.03219720044083,114.9401434195922,86515,78605.6,68.28104999396342,64.03124470295128,NaN,NaN,NaN,NaN,0.5961327684265054,18.969835853604586,44627248,0.0483454641372536,0.6184796696656463,0.5701342055283927
2025-09-16T11:55:00-04:00,117.86,117.95,117.59,117.605,116.0652646695815,NaN,NaN,NaN,NaN,NaN,115.52890000000016,117.89105350051194,113.16674649948838,116.73156995069372,116.01629466000875,117.0775575959691,114.95503172404841,40531,77535.5,64.04099931871713,63.487269029217956,NaN,NaN,NaN,NaN,0.5792661421103265,19.586290229733514,44586717,0.033903244015946576,0.6125132605483259,0.5786100165323793
2025-09-16T12:00:00-04:00,117.6,117.61,117.05,117.08,116.0652646695815,NaN,NaN,NaN,NaN,NaN,115.56750000000017,117.96641579676593,113.1685842032344,116.73156995069372,116.04050078895925,117.10507460262428,114.97592697529421,46681,73488.36666666667,56.2908123655994,62.64327374286658,NaN,NaN,NaN,NaN,0.5778899891024462,18.884901917285056,44540036,-0.01570547441564185,0.558978173512827,0.5746836479284688
2025-09-16T12:05:00-04:00,117.07,117.72,117.05,117.68,116.0652646695815,NaN,NaN,NaN,NaN,NaN,115.62570000000017,118.0848421349702,113.16655786503013,116.73156995069372,116.07364246765565,117.14788860838557,114.99939632692572,55783,72403.16666666667,61.95716482022151,62.5081624117664,NaN,NaN,NaN,NaN,0.5844692755951287,18.425341805432005,44595819,-0.012924633957154041,0.5585278554820263,0.5714524894391804
2025-09-16T12:10:00-04:00,117.67,117.82,117.5,117.51,116.0652646695815,NaN,NaN,NaN,NaN,NaN,115.67870000000015,118.18335311769805,113.17404688230225,116.73156995069372,116.09768478537401,117.18041532398159,115.01495424676644,38608,69451.46666666666,59.59963703954342,62.69354947615835,NaN,NaN,NaN,NaN,0.565578613052619,18.175576429340747,44557211,-0.02656295247716023,0.53824879884273,0.5648117513198903
2025-09-16T12:15:00-04:00,117.5,117.9,117.46,117.9,116.0652646695815,NaN,NaN,NaN,NaN,NaN,115.74430000000015,118.30577224072161,113.1828277592787,116.73156995069372,116.1368235108427,117.2358507280344,115.037796293651,59734,68562.1,63.07124238973102,62.78791541938101,NaN,NaN,NaN,NaN,0.55660871212029,18.088276312840986,44616945,-0.01397910448015105,0.5473378707197014,0.5613169751998525
2025-09-16T12:20:00-04:00,117.89,117.93,117.37,117.39,116.0652646695815,NaN,NaN,NaN,NaN,NaN,115.80370000000018,118.37729500309786,113.2301049969025,116.73156995069372,116.16496062662732,117.27102690557749,115.05889434767715,50844,67857,56.26267540579218,62.27709995921392,NaN,NaN,NaN,NaN,0.5568509469688409,17.77307836777497,44566101,-0.043023412852978504,0.5075377091336293,0.5505611219866078
2025-09-16T12:25:00-04:00,117.43,117.74,117.36,117.72,116.0652646695815,NaN,NaN,NaN,NaN,NaN,115.86790000000018,118.46920512627267,113.26659487372768,116.73156995069372,116.1775447214218,117.28690867679273,115.06818076605086,22698,66816.73333333334,59.322568792769204,62.21380298809337,NaN,NaN,NaN,NaN,0.5442187364710661,17.453254807175785,44588799,-0.04293199586119578,0.4968961271601131,0.5398281230213089
2025-09-16T12:30:00-04:00,117.69,117.81,117.36,117.43,116.0652646695815,NaN,NaN,NaN,NaN,NaN,115.92550000000017,118.53505570930673,113.31594429069361,116.73156995069372,116.19055418486721,117.30246612244592,115.0786422472885,25194,65312.4,55.63873466189409,61.67017725686367,NaN,NaN,NaN,NaN,0.537488826723133,17.308490204227198,44563605,-0.0640527637575703,0.459762168324346,0.5238149320819163
2025-09-16T12:35:00-04:00,117.44,117.48,116.97,117.08,116.0652646695815,NaN,NaN,NaN,NaN,NaN,115.98310000000016,118.56475674712561,113.40144325287471,116.73156995069372,116.20989761492517,117.31931042000429,115.10048480984605,52534,64975.36666666667,51.48343486364129,60.796071832490405,NaN,NaN,NaN,NaN,0.5355253391000525,16.114491895219892,44511071,-0.10104480326391252,0.39750892800202564,0.49855373126593816
2025-09-16T12:40:00-04:00,117.05,117.32,117.02,117.23,116.0652646695815,NaN,NaN,NaN,NaN,NaN,116.04030000000017,118.6031261041233,113.47747389587704,116.66227444144332,116.21810350236889,117.32646590889583,115.10974109584195,22612,64025.7,53.100045520859815,59.97343072486315,NaN,NaN,NaN,NaN,0.5187021005929057,15.005779179713109,44533683,-0.11390633104565095,0.35617081745887447,0.4700771485045254
2025-09-16T12:45:00-04:00,117.22,117.28,116.92,117.01,116.0652646695815,NaN,NaN,NaN,NaN,NaN,116.09210000000016,118.6263731423414,113.55782685765892,116.66227444144332,116.22793853242648,117.33363579469513,115.12224127015783,31544,60444.433333333334,50.445129793539714,59.15367653052033,NaN,NaN,NaN,NaN,0.5073662362648409,14.15610450896924,44502139,-0.1343220190683237,0.3021746246691208,0.4364966437374445
2025-09-16T12:50:00-04:00,117,117.04,116.7,116.73,116.0652646695815,NaN,NaN,NaN,NaN,NaN,116.14170000000014,118.62641053445137,113.65698946554892,116.66227444144332,116.23457470683223,117.33586804307122,115.13328137059325,30797,59154.6,47.20987331366654,58.03016203128533,NaN,NaN,NaN,NaN,0.4954115051030668,13.922273809110633,44471342,-0.1619251970571915,0.23409014741595513,0.3960153444731466
2025-09-16T12:55:00-04:00,116.72,116.74,116.21,116.38,116.0652646695815,NaN,NaN,NaN,NaN,NaN,116.18770000000015,118.60220136467147,113.77319863532882,116.66227444144332,116.23824508997308,117.33015880120892,115.14633137873723,49450,58087.03333333333,43.457954365490856,56.440094474673565,NaN,NaN,NaN,NaN,0.4978821118814193,14.73229037404261,44421892,-0.19668452649881762,0.15015968634962462,0.34684421284844225
2025-09-16T13:00:00-04:00,116.36,116.82,116.33,116.81,116.0652646695815,NaN,NaN,NaN,NaN,NaN,116.23390000000016,118.60548030857007,113.86231969143026,116.66227444144332,116.24427864316256,117.32936535651152,115.1591919298136,41485,56062.36666666667,48.83763303459676,55.05127897757594,NaN,NaN,NaN,NaN,0.4973191038898889,15.237606920686368,44463377,-0.18388098994809382,0.11699297541332498,0.3008739653614188
2025-09-16T13:05:00-04:00,116.82,116.89,116.14,116.5,116.0652646695815,NaN,NaN,NaN,NaN,NaN,116.27390000000015,118.59406058927094,113.95373941072937,116.65981955315466,116.24977021987648,117.32425103998195,115.17528939977102,60228,55393.566666666666,45.478199860115225,53.725364730532945,NaN,NaN,NaN,NaN,0.5153677393263254,16.074961050034574,44403149,-0.1887431222357011,0.06494506256679244,0.25368818480249355
2025-09-16T13:10:00-04:00,116.5,116.55,116.335,116.49,116.0652646695815,NaN,NaN,NaN,NaN,NaN,116.32030000000015,118.56176328098756,114.07883671901273,116.62008451401898,116.25147624992113,117.32171834547196,115.18123415437029,24035,51635.166666666664,45.36978193769975,52.94529112854012,NaN,NaN,NaN,NaN,0.4939129008030167,16.85250417014362,44379114,-0.18484738960181196,0.022628947800228616,0.20747633740204058
2025-09-16T13:15:00-04:00,116.48,116.49,116.02,116.22,NaN,NaN,NaN,117.78207324059223,117.78207324059223,117.78207324059223,116.35740000000015,118.52848290030587,114.18631709969443,116.62008451401898,116.25137546233488,117.31497394504036,115.18777697962939,36824,48533.76666666667,42.4287071961098,51.55040129824642,NaN,NaN,NaN,NaN,0.492204836459944,18.161317275013516,44342290,-0.1918379056461378,-0.03232104465563168,0.15951686099050613
2025-09-16T13:20:00-04:00,116.22,116.51,116.22,116.49,NaN,NaN,NaN,117.78207324059223,NaN,NaN,116.39520000000017,118.50759575837021,114.28280424163013,116.27306761121518,116.25248053216944,117.31236829712408,115.1925927672148,21323,46849.8,46.18554947789096,50.59225218669982,NaN,NaN,NaN,NaN,0.4777616338556627,19.30295259228301,44363613,-0.1703864812046381,-0.053466240515291474,0.11692024068934662
2025-09-16T13:25:00-04:00,116.51,116.85,116.51,116.84,NaN,NaN,NaN,117.78207324059223,NaN,NaN,116.43780000000015,118.49779821359147,114.37780178640884,116.20756327117772,116.25779511519582,117.31300765385522,115.20258257653641,33488,46436.1,50.6786003630704,49.70706347050977,NaN,NaN,NaN,NaN,0.4693500885802582,19.18835850837653,44397101,-0.12673896023287096,-0.041503459601742065,0.08523550063112888
2025-09-16T13:30:00-04:00,116.85,117.19,116.81,116.86,NaN,NaN,NaN,117.78207324059223,NaN,NaN,116.47800000000015,118.49038664277117,114.46561335722913,116.20756327117772,116.27047185377798,117.32015562323582,115.22078808432013,56248,46201.833333333336,50.930715422378576,49.32620918598023,NaN,NaN,NaN,NaN,0.4629679393959537,18.101447553908105,44453349,-0.09223839647203279,-0.03006249495891211,0.06217590151312068
2025-09-16T13:35:00-04:00,116.89,117.01,116.55,116.77,NaN,NaN,NaN,117.78207324059223,NaN,NaN,116.51760000000017,118.47267057672686,114.56252942327349,116.18370690363372,116.27510478116223,117.32108528119505,115.2291242811294,28507,45643.666666666664,49.69955929726419,48.63885136487273,NaN,NaN,NaN,NaN,0.4627559437248147,17.693245366298587,44424842,-0.07208925790329682,-0.02793567086600035,0.044153587037296466
2025-09-16T13:40:00-04:00,116.79,117.2,116.79,117.16,NaN,NaN,NaN,117.78207324059223,NaN,NaN,116.55780000000017,118.48113685036785,114.6344631496325,116.18370690363372,116.28159067002186,117.32557419099702,115.2376071490467,26290,45058,54.798637368818724,48.57884441536735,NaN,NaN,NaN,NaN,0.46041623345875704,16.79630319061946,44451132,-0.031194781116911784,0.005160110641156734,0.03635489175806852
2025-09-16T13:45:00-04:00,117.16,117.34,116.94,116.98,NaN,NaN,NaN,117.78207324059223,NaN,NaN,116.58240000000016,118.49521493092938,114.66958506907095,116.30557793466046,116.29097940739462,117.33245035665094,115.2495084581383,37062,44390.4,52.16998494891082,48.62788370717231,NaN,NaN,NaN,NaN,0.45610078821170336,15.597701249521153,44414070,-0.01574625344758475,0.01667207494858758,0.03241832839617233
2025-09-16T13:50:00-04:00,116.975,117.29,116.92,117.28,NaN,NaN,NaN,117.78207324059223,NaN,NaN,116.64200000000017,118.4494390722736,114.83456092772673,116.30557793466046,116.30062303715806,117.34033009365007,115.26091598066606,35525,43805.066666666666,55.96163320771711,48.83228282766212,NaN,NaN,NaN,NaN,0.4499507319108677,14.53782434888197,44449595,0.01361177646643056,0.049433048979210525,0.035821272512779966
2025-09-16T13:55:00-04:00,117.29,117.455,117.24,117.3,NaN,NaN,NaN,117.78207324059223,NaN,NaN,116.69320000000016,118.42570657718596,114.96069342281436,116.53746987818269,116.31110916427491,117.35067558809016,115.27154274045967,33019,42544.03333333333,56.21085579858789,49.244120399451276,NaN,NaN,NaN,NaN,0.43316853677437744,13.89121838427971,44482614,0.032249046614751926,0.07613258078121987,0.043883534166467945
2025-09-16T14:00:00-04:00,117.295,117.44,116.94,116.94,NaN,NaN,NaN,117.78207324059223,NaN,NaN,116.73760000000017,118.37683304016643,115.09836695983391,116.53746987818269,116.31911932170162,117.35648405920364,115.2817545841996,33021,41871.433333333334,50.65402294745158,49.490131087578774,NaN,NaN,NaN,NaN,0.43794221271906475,13.32258455632141,44449593,0.018865541388504874,0.06746546090209904,0.048599919513594166
2025-09-16T14:05:00-04:00,116.94,117.23,116.9,117.01,NaN,NaN,NaN,117.78207324059223,NaN,NaN,116.78600000000017,118.30740592873187,115.26459407126848,116.53746987818269,116.32513036598091,117.36029787146087,115.28996286050095,27322,41377.46666666667,51.65480763381574,50.07562060674484,NaN,NaN,NaN,NaN,0.43023205466770287,12.89738280530812,44476915,0.0135122170188064,0.06549019078710216,0.051977973768295764
2025-09-16T14:10:00-04:00,117.01,117.36,117,117.36,NaN,NaN,NaN,117.78207324059223,NaN,NaN,116.82860000000015,118.29150264884493,115.36569735115538,116.53746987818269,116.33360605079204,117.36768856371444,115.29952353786965,30923,40502.13333333333,56.41456654841608,50.616830143446215,NaN,NaN,NaN,NaN,0.4252154793342955,12.112699416719673,44507838,0.03131083334204124,0.09111651544584731,0.059805682103806074
2025-09-16T14:15:00-04:00,117.33,117.53,117.33,117.43,NaN,NaN,NaN,117.78207324059223,NaN,NaN,116.87360000000015,118.2676904418279,115.47950955817241,116.67657966210363,116.34490097070854,117.37958289014594,115.31021905127113,34744,39118.96666666667,57.31962079754064,51.46264592469089,NaN,NaN,NaN,NaN,0.409128659381846,11.59725057709213,44542582,0.04474729509385693,0.11573980097112724,0.07099250587727031
2025-09-16T14:20:00-04:00,117.44,117.59,117.3,117.49,NaN,NaN,NaN,117.78207324059223,NaN,NaN,116.92220000000015,118.22654069169174,115.61785930830855,116.7622637296829,116.35405165515705,117.38937847024806,115.31872484006604,27905,37165.3,58.122321665907926,52.3735416195629,NaN,NaN,NaN,NaN,0.4006194694260003,11.286838759866988,44570487,0.0540051165664074,0.13849890158527955,0.08449378501887216
2025-09-16T14:25:00-04:00,117.5,117.57,117.23,117.25,NaN,NaN,NaN,117.78207324059223,NaN,NaN,116.97520000000013,118.10092458444461,115.84947541555564,116.7622637296829,116.35978040978127,117.39486914835396,115.32469167120857,19673,36470.03333333333,53.76639038996812,53.18337613340992,NaN,NaN,NaN,NaN,0.3962895073241423,10.767442009800076,44550814,0.04089014923615021,0.13560647156405992,0.0947163223279097
2025-09-16T14:30:00-04:00,117.24,117.43,117.08,117.39,NaN,NaN,NaN,117.78207324059223,NaN,NaN,117.02080000000012,118.01798876850197,116.02361123149828,116.7622637296829,116.36591285852053,117.40039283763113,115.33143287940993,22454,35662.46666666667,55.845212567058574,53.87335206835047,NaN,NaN,NaN,NaN,0.392983113943847,10.195198054967204,44573268,0.038597374905522855,0.14296304095981327,0.10436566605429042
2025-09-16T14:35:00-04:00,117.39,117.675,117.39,117.64,NaN,NaN,NaN,117.78207324059223,NaN,NaN,117.06720000000014,117.95321841967673,116.18118158032355,116.85989902959764,116.37433558173645,117.41005241267611,115.33861875079678,24285,34612.53333333333,59.35933584442904,54.49340460273323,NaN,NaN,NaN,NaN,0.3852700343764291,10.024214594010648,44597553,0.05013990430046676,0.16704054642987387,0.11690064212940711
2025-09-16T14:40:00-04:00,117.62,117.68,117.48,117.5,NaN,NaN,NaN,117.78207324059223,NaN,NaN,117.09520000000015,117.94492927453543,116.24547072546487,116.92791922367812,116.38176864863749,117.41842418819185,115.34511310908313,21996,34058.8,56.64076284874388,54.9012651331879,NaN,NaN,NaN,NaN,0.37203646049239864,9.880281615825401,44575557,0.044745887699174314,0.17283300175337502,0.1280871140542007
2025-09-16T14:45:00-04:00,117.51,117.77,117.51,117.65,NaN,NaN,NaN,117.78207324059223,NaN,NaN,117.12740000000014,117.93575695086624,116.31904304913404,117.0333353789425,116.3952291668557,117.43445416268084,115.35600417103056,37627,33321.9,58.817055363432566,55.55251485219992,NaN,NaN,NaN,NaN,0.3647481418857984,10.021589949767428,44613184,0.04742427302417901,0.18736745533442445,0.13994318231024544
2025-09-16T14:50:00-04:00,117.66,117.73,117.555,117.69,NaN,NaN,NaN,117.78207324059223,NaN,NaN,117.14180000000013,117.96396241705361,116.31963758294665,117.053168303154,116.40375164531558,117.44461368482654,115.36288960580463,23956,32425.633333333335,59.40223761891235,55.88134344149233,NaN,NaN,NaN,NaN,0.3511947031796697,10.152804831285025,44637140,0.047893845572504506,0.19981048927587608,0.15191664370337157
2025-09-16T14:55:00-04:00,117.7,117.81,117.66,117.72,116.5854455973713,116.5854455973713,116.5854455973713,NaN,NaN,NaN,117.15040000000012,117.98744441938622,116.31335558061402,117.1935346425232,116.4137232144596,117.4569746196836,115.37047180923558,26897,32565.6,59.862882111632764,56.43083609597246,NaN,NaN,NaN,NaN,0.3368236529525509,10.535010727016223,44664037,0.046207024895148996,0.20967542482230783,0.16346839992715884
2025-09-16T15:00:00-04:00,117.7,117.81,117.56,117.57,116.5854455973713,NaN,NaN,NaN,NaN,NaN,117.16080000000012,118.00548304115958,116.31611695884067,117.1935346425232,116.42872608599286,117.47438492376595,115.38306724821977,44067,33194.7,56.416042378994256,56.46329389392083,NaN,NaN,NaN,NaN,0.33062196345594014,10.454842898295448,44619970,0.031664550003821346,0.2030490874319355,0.17138453742811416
2025-09-16T15:05:00-04:00,117.57,117.59,117.21,117.38,116.5854455973713,NaN,NaN,NaN,NaN,NaN,117.17340000000013,118.01196887612939,116.33483112387087,117.1935346425232,116.43864298703551,117.48345347742442,115.3938324966466,37618,32697.5,52.307616777164014,56.18449110667626,NaN,NaN,NaN,NaN,0.33414896606623085,10.331576141891759,44582352,0.007201864203452202,0.1803868676824294,0.1731850034789772
2025-09-16T15:10:00-04:00,117.4,117.44,117.12,117.28,116.5854455973713,NaN,NaN,NaN,NaN,NaN,117.19470000000013,117.98767518246765,116.4017248175326,117.1935346425232,116.44833414016897,117.49098214247337,115.40568613786456,42638,33365.03333333333,50.234123088231655,56.15449825958912,NaN,NaN,NaN,NaN,0.33313832563292817,10.503319898861296,44539714,-0.016469067957689237,0.15259866853186566,0.1690677364895549
2025-09-16T15:15:00-04:00,117.27,117.27,117.02,117.2,116.5854455973713,NaN,NaN,NaN,NaN,NaN,117.20290000000011,117.98740007012779,116.41839992987244,117.1935346425232,116.45663950662643,117.49604144009835,115.41723757315451,43504,33763.7,48.57519704212028,55.93452607446801,NaN,NaN,NaN,NaN,0.32791415951629077,10.973887980546573,44496210,-0.037088985284744885,0.12270650488362378,0.15979549016836866
2025-09-16T15:20:00-04:00,117.23,117.66,117.22,117.64,116.5854455973713,NaN,NaN,NaN,NaN,NaN,117.21550000000012,118.00740466599478,116.42359533400546,117.1935346425232,116.46895421119912,117.50840844125102,115.42949998114722,44445,34218.63333333333,56.988396853199134,55.97551395338109,NaN,NaN,NaN,NaN,0.33734886240798384,10.418601137075338,44540655,-0.021445936997706194,0.13298806892123594,0.15443400591894213
2025-09-16T15:25:00-04:00,117.65,117.75,117.39,117.45,116.5854455973713,NaN,NaN,NaN,NaN,NaN,117.22930000000011,118.0129785310583,116.44562146894192,117.1935346425232,116.48253300354106,117.52217771265856,115.44288829442357,49127,34207.86666666667,52.95922496048717,55.66405710787727,NaN,NaN,NaN,NaN,0.3389668008074135,10.188460675503817,44491528,-0.02405024741091083,0.1243711966553036,0.14842144406621444
2025-09-16T15:30:00-04:00,117.49,117.79,117.46,117.67,116.5854455973713,NaN,NaN,NaN,NaN,NaN,117.23990000000012,118.03274422178832,116.44705577821192,117.1935346425232,116.4957797734287,117.53676406652895,115.45479548032844,44442,34306.433333333334,56.77044387572342,55.567494408578376,NaN,NaN,NaN,NaN,0.33904060074974135,10.10321983962025,44535970,-0.011735068948108968,0.13375260788107823,0.1454876768291872
2025-09-16T15:35:00-04:00,117.67,117.86,117.65,117.72,116.66266930838941,NaN,NaN,NaN,NaN,NaN,117.25030000000011,118.05434081987993,116.4462591801203,117.1935346425232,116.50835748845225,117.55155269299438,115.46516228391012,39549,33617.13333333333,57.61101497024877,55.84211045002699,NaN,NaN,NaN,NaN,0.32982341498190226,10.253110383174658,44575519,-0.0015364821543440432,0.14356707413625713,0.14510355629060118
2025-09-16T15:40:00-04:00,117.73,117.93,117.73,117.86,116.75868433982627,NaN,NaN,NaN,NaN,NaN,117.26130000000012,118.08315840631434,116.4394415936859,117.21773257232876,116.52302832829527,117.56973167049216,115.47632498609838,43699,34272.6,59.95872414445186,56.13593270555508,NaN,NaN,NaN,NaN,0.32126459962605264,10.621564795028531,44619218,0.012547930911562366,0.16078846993005413,0.14824053901849177
2025-09-16T15:45:00-04:00,117.86,118.06,117.44,117.49,116.75868433982627,NaN,NaN,NaN,NaN,NaN,117.26850000000012,118.09193730788928,116.44506269211095,117.21773257232876,116.53814284433705,117.58603253162802,115.49025315704607,53281,34821.166666666664,51.79420157959093,55.595565972352354,NaN,NaN,NaN,NaN,0.3426028425099063,9.918108917857456,44565937,-0.004246031422136032,0.14293299974082174,0.14717903116295777
2025-09-16T15:50:00-04:00,117.48,117.65,116.84,117.45,116.75868433982627,NaN,NaN,NaN,NaN,NaN,117.2727000000001,118.09765384115869,116.44774615884151,117.21773257232876,116.55627016854466,117.59844031285496,115.51410002423435,96250,37318.73333333333,50.985903620892856,55.191647456077284,NaN,NaN,NaN,NaN,0.37598835375919887,10.952260191518715,44469687,-0.018444087362224915,0.12412392196017663,0.14256800932240155
2025-09-16T15:55:00-04:00,117.52,117.66,117.16,117.33,116.75868433982627,NaN,NaN,NaN,NaN,NaN,117.26830000000011,118.0896296780436,116.44697032195663,117.21773257232876,116.58115087653813,117.61720278255791,115.54509897051835,127663,40457.9,48.538623226319515,54.45747373199777,NaN,NaN,NaN,NaN,0.3848463284906846,11.874736920111435,44342024,-0.03533416921174978,0.09840029780771431,0.1337344670194641
2025-09-17T09:30:00-04:00,117.05,118.28,117.02,117.81,116.75868433982627,NaN,NaN,NaN,NaN,NaN,117.2673000000001,118.08586266714111,116.4487373328591,117.21773257232876,117.70333333333333,117.70333333333333,117.70333333333333,128289,42859.26666666667,57.35594651262539,54.311310081548704,NaN,NaN,NaN,NaN,0.44735730502706467,11.279228628101691,44470313,-0.014655022738428586,0.11541568859642837,0.13007071133485695
2025-09-17T09:35:00-04:00,117.84,118.65,117.73,117.85,116.82316979578067,NaN,NaN,NaN,NaN,NaN,117.2722000000001,118.10165080628659,116.44274919371361,117.21773257232876,117.8835130658988,118.07006698339372,117.69695914840388,119672,45898.1,58.00173478308573,54.17837098665249,NaN,NaN,NaN,NaN,0.4811174975251316,11.583994411716942,44589985,0.00044138286341047217,0.13062243991412004,0.13018105705070956
2025-09-17T09:40:00-04:00,117.85,117.95,116.76,117.71,NaN,NaN,NaN,118.82197428584573,118.82197428584573,118.82197428584573,117.28480000000009,118.12129975496333,116.44830024503685,117.21773257232876,117.76777040862605,118.0107949347602,117.5247458824919,97473,48270.86666666667,54.86976542490885,54.06792263278925,NaN,NaN,NaN,NaN,0.5317519619876221,11.79249800969532,44492512,-0.00024092937260619673,0.1298798953349518,0.130120824707558
2025-09-17T09:45:00-04:00,117.7,118.58,117.41,118.44,NaN,NaN,NaN,118.82197428584573,NaN,NaN,117.30000000000011,118.19054590001285,116.40945409998737,117.21773257232876,117.82786588301664,118.08972173824903,117.56601002778426,65804,49228.933333333334,65.37017660801115,55.0009626207069,NaN,NaN,NaN,NaN,0.5773411075599348,11.172989479490274,44558316,0.04474464831818284,0.18605163510528655,0.1413069867871037
2025-09-17T09:50:00-04:00,118.45,118.97,118.21,118.51,116.9974263221943,116.9974263221943,116.9974263221943,NaN,NaN,NaN,117.3200000000001,118.27135272114536,116.36864727885485,117.21773257232876,117.9906818817242,118.37359934189605,117.60776442155235,116923,51942.2,66.18270298823728,56.14014689927874,NaN,NaN,NaN,NaN,0.5903881713056541,11.241674371127424,44675239,0.07377411613926771,0.23352463196118833,0.15975051582192062
2025-09-17T09:55:00-04:00,118.51,118.76,117.91,118.07,116.9974263221943,NaN,NaN,NaN,NaN,NaN,117.3234000000001,118.2841880931933,116.36261190680692,117.21773257232876,118.01107980435309,118.38490799666494,117.63725161204124,45730,52365.9,57.11176685310891,56.74990188577792,NaN,NaN,NaN,NaN,0.6089318733552508,10.732207791980283,44629509,0.05856567606246474,0.23295761090000155,0.17439193483753682
2025-09-17T10:00:00-04:00,118.09,118.28,117.32,118.08,116.9974263221943,NaN,NaN,NaN,NaN,NaN,117.33720000000011,118.32096452468714,116.35343547531308,117.180186057863,117.99581499394121,118.34680619742673,117.64482379045569,85482,54114.6,57.25515832693509,56.76895627675906,NaN,NaN,NaN,NaN,0.6340081681155906,10.650949499667451,44714991,0.04501148960113735,0.2306562968389585,0.18564480723782115
2025-09-17T10:05:00-04:00,118.07,118.2,117.74,117.95,116.9974263221943,NaN,NaN,NaN,NaN,NaN,117.3418000000001,118.3347889425525,116.3488110574477,116.95826820930068,117.99416691500495,118.33621207193379,117.65212175807612,35244,54378.666666666664,54.69503372183129,56.89294261685507,NaN,NaN,NaN,NaN,0.6215790132501918,10.57549537109125,44679747,0.02416762688513946,0.21585434084424548,0.19168671395910603
2025-09-17T10:10:00-04:00,117.95,118.19,117.9,118.15,116.9974263221943,NaN,NaN,NaN,NaN,NaN,117.3562000000001,118.37444861406529,116.33795138593491,116.95826820930068,117.99775489709208,118.3330150648007,117.66249472938345,30303,54358,57.8198596589212,56.96790088708349,NaN,NaN,NaN,NaN,0.5978947980180347,10.505430823127636,44710050,0.02085215219319267,0.21775190420059687,0.1968997520074042
2025-09-17T10:15:00-04:00,118.13,118.18,117.56,117.86,116.9974263221943,NaN,NaN,NaN,NaN,NaN,117.37180000000009,118.39652388478818,116.347076115212,116.95826820930068,117.99222421292406,118.3213922670209,117.66305615882722,31932,54264.26666666667,52.19792324464691,56.58125147811192,NaN,NaN,NaN,NaN,0.5994737410167469,10.999209749451957,44678118,-0.0026212473481394827,0.19362319282222984,0.19624444017036932
2025-09-17T10:20:00-04:00,117.9,118.02,117.47,117.53,116.9974263221943,NaN,NaN,NaN,NaN,NaN,117.3778000000001,118.40264566645406,116.35295433354612,116.95826820930068,117.97702387633262,118.30535768521516,117.64869006745009,37882,54596.833333333336,46.6405086240862,55.62995036951438,NaN,NaN,NaN,NaN,0.5959399023726933,11.599735672521293,44640236,-0.04004546146902166,0.14618761333409225,0.1862330748031139
2025-09-17T10:25:00-04:00,117.54,117.6,117.02,117.17,116.9974263221943,NaN,NaN,NaN,NaN,NaN,117.3810000000001,118.40222475491515,116.35977524508505,116.87503332316194,117.9417505905712,118.29728548255534,117.58621569858707,41321,55318.433333333334,41.45522946361306,54.89145236123024,NaN,NaN,NaN,NaN,0.5948013379175008,12.818015749008236,44598915,-0.0860751949588699,0.07863908110452655,0.16471427606339645
2025-09-17T10:30:00-04:00,117.15,117.8,116.93,117.5,NaN,NaN,NaN,118.96554955396364,118.96554955396364,118.96554955396364,117.39640000000009,118.400979593686,116.39182040631417,116.87503332316194,117.916781138287,118.28164206389533,117.55192021267868,41193,55943.066666666666,47.24508724730166,54.62425119168802,NaN,NaN,NaN,NaN,0.6144583852091071,13.47077916235049,44640108,-0.09085537576777675,0.0511450563536755,0.14200043212145225
2025-09-17T10:35:00-04:00,117.48,117.54,116.83,117.03,NaN,NaN,NaN,118.9035275894586,NaN,NaN,117.40940000000008,118.3771802230155,116.44161977698465,116.87503332316194,117.87874528611916,118.27246196056403,117.48502861167428,44763,56625.666666666664,41.022505988331176,54.087385674688846,NaN,NaN,NaN,NaN,0.6212827862656,14.22894740226083,44595345,-0.12037760439062839,-0.00847157336683324,0.11190603102379515
2025-09-17T10:40:00-04:00,117.04,117.22,116.625,116.72,NaN,NaN,NaN,118.64404906266503,NaN,NaN,117.40760000000007,118.38015589045393,116.43504410954621,116.65902665852956,117.77457700532416,118.25937664252017,117.28977736812816,104444,59373.933333333334,37.51301293291138,52.67003327613785,NaN,NaN,NaN,NaN,0.6194054443894856,15.240903354986452,44490901,-0.15337487412145007,-0.07981256162801742,0.07356231249343263
2025-09-17T10:45:00-04:00,116.72,116.74,116.38,116.47,NaN,NaN,NaN,118.2523877416348,NaN,NaN,117.40700000000008,118.38182921583858,116.43217078416158,116.5004813193337,117.72490786832562,118.25876273697641,117.19105299967482,42667,59541.933333333334,34.91858375706565,51.02123677427927,NaN,NaN,NaN,NaN,0.600876484075951,16.528944766931193,44448234,-0.1826418286995788,-0.15473997338104084,0.027901855318537935
2025-09-17T10:50:00-04:00,116.45,116.85,116.21,116.75,NaN,NaN,NaN,118.23273375337868,NaN,NaN,117.41220000000008,118.37003330493901,116.45436669506115,116.5004813193337,117.67922154898832,118.24715212204947,117.11129097592718,45399,60256.7,39.92957116246178,49.95408004124734,NaN,NaN,NaN,NaN,0.6036710209276688,17.955821870799628,44493633,-0.17379683239226312,-0.18934418517179097,-0.015547352779527852
2025-09-17T10:55:00-04:00,116.73,116.82,116.495,116.54,NaN,NaN,NaN,118.23273375337868,NaN,NaN,117.4186000000001,118.3483484391112,116.48885156088899,116.5004813193337,117.64780949325284,118.2354597238836,117.06015926262208,34007,60493.7,37.59178283440405,47.969909057418256,NaN,NaN,NaN,NaN,0.5837659480042631,19.28077918153461,44459626,-0.1724022100773881,-0.23105011537626297,-0.058647905298874876
2025-09-17T11:00:00-04:00,116.58,116.8,116.32,116.46,NaN,NaN,NaN,118.21921608520661,NaN,NaN,117.41800000000008,118.35018024011354,116.48581975988661,116.5004813193337,117.61736840329456,118.22495257252002,117.0097842340691,32055,60093.3,36.71002248422235,45.86471759284576,NaN,NaN,NaN,NaN,0.5763540945753874,20.759006528603017,44427571,-0.167061210443053,-0.26747441835269115,-0.10041320790963813
2025-09-17T11:05:00-04:00,116.46,116.82,116.34,116.82,NaN,NaN,NaN,118.21921608520661,NaN,NaN,117.41760000000008,118.3507885983291,116.48441140167105,116.40138505546696,117.5904284624913,118.20997365547137,116.97088326951123,34183,59978.8,43.17001989843302,44.868878524654626,NaN,NaN,NaN,NaN,0.5694716592485733,22.064831220307855,44461754,-0.1310661436139422,-0.2642458874270659,-0.1331797438131237
2025-09-17T11:10:00-04:00,116.805,116.97,116.46,116.93,NaN,NaN,NaN,118.21921608520661,NaN,NaN,117.41900000000007,118.3490430097926,116.48895699020754,116.09708643549885,117.56983019522225,118.19443515869781,116.94522523174669,31950,59622.53333333333,45.01674691138641,43.994706280686856,NaN,NaN,NaN,NaN,0.5652236835879613,22.768781423603322,44493704,-0.09340031191849754,-0.24993013371124562,-0.15652982179274808
2025-09-17T11:15:00-04:00,116.91,117.17,116.87,117.12,NaN,NaN,NaN,118.21921608520661,NaN,NaN,117.42600000000007,118.34155447683666,116.51044552316348,116.09708643549885,117.55011153739929,118.17062168648695,116.92960138831162,49486,59821.933333333334,48.15084428854796,43.52726417830947,NaN,NaN,NaN,NaN,0.5462791347602496,22.77701117215467,44543190,-0.05134349100100935,-0.22070918554400976,-0.1693656945430004
2025-09-17T11:20:00-04:00,117.11,117.2,116.64,116.71,NaN,NaN,NaN,118.21921608520661,NaN,NaN,117.41700000000009,118.35148809517953,116.48251190482064,115.97040590159229,117.53590555671452,118.15796993854164,116.91384117488741,26846,59235.3,42.518663366147166,42.43432158596847,NaN,NaN,NaN,NaN,0.5472591965630891,23.215386551517312,44516344,-0.046912747243734676,-0.22800662859766874,-0.18109388135393406
2025-09-17T11:25:00-04:00,116.74,116.74,116.51,116.7,NaN,NaN,NaN,118.19623784795041,NaN,NaN,117.41140000000009,118.3595519709609,116.46324802903928,115.97040590159229,117.51977229333279,118.14742613200931,116.89211845465627,24541,58415.76666666667,42.38843042372403,41.733643527331125,NaN,NaN,NaN,NaN,0.5245978253800105,23.853151709977283,44491803,-0.040663577453947,-0.2319233531713678,-0.1912597757174208
2025-09-17T11:30:00-04:00,116.68,116.94,116.61,116.8,NaN,NaN,NaN,118.19623784795041,NaN,NaN,117.40180000000008,118.36468474909611,116.43891525090405,115.97040590159229,117.50887454946889,118.13818090086967,116.8795681980681,20241,57609.066666666666,44.2281063424341,41.561329078641684,NaN,NaN,NaN,NaN,0.5106979807100097,23.784565656206592,44512044,-0.026489621724026857,-0.2243718028724544,-0.19788218114842754
2025-09-17T11:35:00-04:00,116.82,117,116.79,116.92,NaN,NaN,NaN,118.19623784795041,NaN,NaN,117.39420000000007,118.36613489497219,116.42226510502795,116.0546862572922,117.49743919627477,118.12620109520867,116.86867729734087,26328,57168.36666666667,46.43840542493376,41.91727021873602,NaN,NaN,NaN,NaN,0.48921955351643714,23.52672767961492,44538372,-0.006754857393595298,-0.20632575289042165,-0.19957089549682636
2025-09-17T11:40:00-04:00,116.94,116.98,116.58,116.89,NaN,NaN,NaN,118.19623784795041,NaN,NaN,117.39320000000006,118.36710299315193,116.4192970068482,116.0546862572922,117.48798498529726,118.11742760802707,116.85854236256745,19634,56366.2,45.948143335242754,41.82463136787468,NaN,NaN,NaN,NaN,0.4828467282652635,23.726069233276075,44518738,0.005873531194225623,-0.19222898150404433,-0.19810251269826995
2025-09-17T11:45:00-04:00,116.9,117.07,116.78,116.785,NaN,NaN,NaN,118.19623784795041,NaN,NaN,117.38870000000006,118.37168079333644,116.40571920666368,116.159999204667,117.47813933760568,118.10719024425356,116.8490884309578,23207,55363.73333333333,44.1897139554873,42.050860508385824,NaN,NaN,NaN,NaN,0.46907196196060125,23.60171227097534,44495531,0.008586068390752544,-0.18736992720982926,-0.1959559956005818
2025-09-17T11:50:00-04:00,116.76,116.79,116.35,116.42,NaN,NaN,NaN,118.02487248527875,NaN,NaN,117.36990000000007,118.38962641431584,116.3501735856843,116.159999204667,117.44979010178871,118.09038032965121,116.8091998739262,43814,53615.86666666667,38.65214872789772,42.132227350884854,NaN,NaN,NaN,NaN,0.4669953932491306,24.32212373858021,44451717,-0.011670815624156672,-0.21054451513077765,-0.19887369950662098
2025-09-17T11:55:00-04:00,116.42,116.69,116.415,116.47,NaN,NaN,NaN,117.97874191776609,NaN,NaN,117.35070000000007,118.40087333809934,116.3005266619008,116.159999204667,117.43849001855077,118.08321025469088,116.79376978241065,18318,49971.03333333333,39.76568272258101,42.47844870556452,NaN,NaN,NaN,NaN,0.4532814365884778,24.9910772442133,44470035,-0.018751657895870327,-0.22231327187645888,-0.20356161398058856
2025-09-17T12:00:00-04:00,116.5,116.66,116.36,116.43,NaN,NaN,NaN,117.91232183059489,NaN,NaN,117.32950000000008,118.40993000700988,116.24906999299029,116.159999204667,117.42170471626254,118.07294232131937,116.7704671112057,26816,46588.6,39.15340517640447,42.42300827798899,NaN,NaN,NaN,NaN,0.44233276254644344,25.715351194169163,44443219,-0.02290367393506554,-0.23219120639942048,-0.20928753246435494
2025-09-17T12:05:00-04:00,116.38,116.63,116.38,116.54,NaN,NaN,NaN,117.87767083829513,NaN,NaN,117.31530000000006,118.41797023179059,116.21262976820954,116.159999204667,117.41080012801945,118.06559060587918,116.75600965015971,18610,43219.86666666667,41.806961447107064,42.72409246461064,NaN,NaN,NaN,NaN,0.4285947080788403,26.387891290556748,44461829,-0.015377451212353399,-0.2285093464797967,-0.2131318952674433
2025-09-17T12:10:00-04:00,116.56,116.59,116.28,116.44,NaN,NaN,NaN,117.78754943655444,NaN,NaN,117.29630000000006,118.42558439291129,116.16701560708883,116.159999204667,117.3947804610598,118.05587683232292,116.73368408979667,25825,40831.6,40.09507463084009,42.96588190365476,NaN,NaN,NaN,NaN,0.42012365750178043,27.21573592275346,44436004,-0.014292732790245344,-0.23099781125524999,-0.21670507846500464
2025-09-17T12:15:00-04:00,116.44,116.5,116.21,116.37,NaN,NaN,NaN,117.6856153712565,NaN,NaN,117.27090000000007,118.42497744976838,116.11682255023176,116.159999204667,117.37637241497501,118.04568777117152,116.7070570587785,28442,39586.2,38.89447801687191,42.660486054971834,NaN,NaN,NaN,NaN,0.410829110537368,28.126317637139802,44407562,-0.015355181259502443,-0.2358990550393827,-0.22054387377988025
2025-09-17T12:20:00-04:00,116.37,116.67,116.37,116.66,NaN,NaN,NaN,117.6856153712565,NaN,NaN,117.2541000000001,118.41875564011164,116.08944435988855,116.159999204667,117.36007182611866,118.03230500589112,116.6878386463462,32848,36783.7,46.095816161437355,42.73756242997547,NaN,NaN,NaN,NaN,0.40291274549898437,28.19924784399649,44440410,0.00530161950412561,-0.21391684939972322,-0.21921846890384883
2025-09-17T12:25:00-04:00,116.64,116.81,116.61,116.79,NaN,NaN,NaN,117.6856153712565,NaN,NaN,117.23690000000008,118.40306103522029,116.07073896477986,116.159999204667,117.35211726317357,118.0237026561382,116.68053187020894,21089,35962.333333333336,48.997526280439224,42.79803971511056,NaN,NaN,NaN,NaN,0.38841897796334285,27.67526636846574,44461499,0.02826585161128753,-0.18388615438973943,-0.21215200600102696
2025-09-17T12:30:00-04:00,116.78,116.82,116.46,116.49,NaN,NaN,NaN,117.6856153712565,NaN,NaN,117.21290000000008,118.39011381237995,116.0356861876202,116.159999204667,117.3428116574856,118.01551157458752,116.67011174038367,20430,33793.933333333334,43.21604464203135,42.847852663388,NaN,NaN,NaN,NaN,0.38638905096596116,27.578235940498715,44441069,0.02396649495354386,-0.18219388730909714,-0.206160382262641
2025-09-17T12:35:00-04:00,116.5,116.54,116.09,116.145,NaN,NaN,NaN,117.588339543138,NaN,NaN,117.18140000000008,118.38660710256133,115.97619289743884,116.08263305696526,117.32496655564596,118.00622498717922,116.64370812411269,27993,33552.23333333333,37.70596827861929,42.51339108159481,NaN,NaN,NaN,NaN,0.3909326901826784,28.302495143690326,44413076,-0.00012219093992821284,-0.20631312093755128,-0.20619092999762306
2025-09-17T12:40:00-04:00,116.145,116.34,115.75,116.28,NaN,NaN,NaN,117.34091501844992,NaN,NaN,117.15560000000009,118.38148032043964,115.92971967956055,116.08263305696526,117.29821380874955,117.99478503836227,116.60164257913684,38737,33833.36666666667,40.88232524061337,42.27440671717904,NaN,NaN,NaN,NaN,0.40515178374105876,29.56576337309005,44451813,-0.004718919165778018,-0.2120895789548456,-0.20737065978906757
2025-09-17T12:45:00-04:00,116.28,116.615,116.13,116.6,NaN,NaN,NaN,117.34091501844992,NaN,NaN,117.14000000000009,118.37388654261918,115.906113457381,116.08263305696526,117.28724145306175,117.98592018350323,116.58856272262028,22757,33527.53333333333,47.69096649947303,42.363875365360414,NaN,NaN,NaN,NaN,0.4108552277595545,29.6577204509132,44474570,0.014959525319367117,-0.18867125313985866,-0.20363077845922578
2025-09-17T12:50:00-04:00,116.61,116.95,116.6,116.93,NaN,NaN,NaN,117.34091501844992,NaN,NaN,117.13300000000008,118.3676011501898,115.89839884981036,116.08263305696526,117.28252966342241,117.97916872932824,116.58589059751658,18219,32872.1,53.62288871165375,42.91207146367549,NaN,NaN,NaN,NaN,0.40650842577672985,28.624086942838318,44492789,0.04942568204850012,-0.14184867589860062,-0.19127435794710074
2025-09-17T12:55:00-04:00,116.92,116.97,116.7,116.91,NaN,NaN,NaN,117.34091501844992,NaN,NaN,117.12720000000009,118.363211585724,115.89118841427617,116.08263305696526,117.27759305752102,117.9716373142441,116.58354880079793,21053,32196.5,53.22891512565825,43.55772869011627,NaN,NaN,NaN,NaN,0.39675782393553455,27.601435588690943,44471736,0.06890488397484051,-0.1051432529785501,-0.1740481369533906
2025-09-17T13:00:00-04:00,116.92,117.21,116.92,117.1,NaN,NaN,NaN,117.34091501844992,NaN,NaN,117.11640000000008,118.3437060580193,115.88909394198087,116.32155417606808,117.2738644710491,117.96197336582924,116.58575557626895,34071,31959.1,56.49875772444955,44.83248647558427,NaN,NaN,NaN,NaN,0.38984655079728187,25.918251080435972,44505807,0.0912140822566263,-0.06003053413260773,-0.15124461638923403
2025-09-17T13:05:00-04:00,117.11,117.12,116.9,116.98,NaN,NaN,NaN,117.34091501844992,NaN,NaN,117.10700000000008,118.33113724723036,115.88286275276981,116.32155417606808,117.2717806948605,117.9576797164173,116.58588167330369,14077,30936.233333333334,53.93412392858954,45.84451799029916,NaN,NaN,NaN,NaN,0.37771465431176166,24.410121071902413,44491730,0.09413621126209293,-0.03357435231161787,-0.1277105635737108
2025-09-17T13:10:00-04:00,116.99,117.04,116.74,116.97,NaN,NaN,NaN,117.34091501844992,NaN,NaN,117.09300000000009,118.30703130110119,115.87896869889899,116.32155417606808,117.26875366826653,117.95250290532172,116.58500443121133,15906,27984.966666666667,53.71530346534706,46.88465358236648,NaN,NaN,NaN,NaN,0.37216360757520806,23.448083648485422,44475824,0.0915591055567205,-0.013261681627810162,-0.10482078718453067
2025-09-17T13:15:00-04:00,116.99,117.13,116.94,117.07,NaN,NaN,NaN,117.34091501844992,NaN,NaN,117.0800000000001,118.28074476889985,115.87925523110034,116.38971573814685,117.2670221221159,117.9483807025713,116.58566354166051,14663,27051.5,55.652946440361816,47.87365251045611,NaN,NaN,NaN,NaN,0.35915192131983587,22.25692053338455,44490487,0.09248154350990034,0.010781142202844762,-0.08170040130705558
2025-09-17T13:20:00-04:00,117.08,117.08,116.77,116.98,NaN,NaN,NaN,117.34091501844992,NaN,NaN,117.06240000000007,118.24251735012184,115.88228264987829,116.38971573814685,117.26493110993128,117.94458024963762,116.58528197022494,12228,25945.8,53.48285462107035,48.829922509758276,NaN,NaN,NaN,NaN,0.3556410697969906,21.623811574664714,44478259,0.08321293163896462,0.02231576324165019,-0.060897168397314426
2025-09-17T13:25:00-04:00,116.97,117.11,116.82,117.07,NaN,NaN,NaN,117.34091501844992,NaN,NaN,117.05400000000007,118.22778532963153,115.88021467036862,116.38971573814685,117.25805551882021,117.93014869713589,116.58596234050454,50434,26493.366666666665,55.35751662265077,50.00585383874248,NaN,NaN,NaN,NaN,0.35095242195434884,20.928052586510493,44528693,0.07934016350536402,0.03827803598439061,-0.041062127520973414
2025-09-17T13:30:00-04:00,117.08,117.28,117.06,117.13,NaN,NaN,NaN,117.34091501844992,NaN,NaN,117.04760000000006,118.21615678512889,115.87904321487123,116.57577445793119,117.25704298977246,117.92584777341739,116.58823820612753,19603,26078.3,56.612865148784906,50.75707162355302,NaN,NaN,NaN,NaN,0.3415986775290381,19.681284600087533,44548296,0.07695706040045701,0.05513419797959784,-0.021822862420859162
2025-09-17T13:35:00-04:00,117.11,117.17,116.97,117.16,NaN,NaN,NaN,117.34091501844992,NaN,NaN,117.04420000000007,118.2104373000631,115.87796269993704,116.57577445793119,117.25590239281685,117.92240741123702,116.58939737439668,14361,25417.566666666666,57.26001524791302,51.34724940694401,NaN,NaN,NaN,NaN,0.33148448627696414,18.806905613205398,44562657,0.07354264605657812,0.0701054451498635,-0.0034372009067146284
2025-09-17T13:40:00-04:00,117.15,117.22,117,117.05,NaN,NaN,NaN,117.34091501844992,NaN,NaN,117.02900000000007,118.17454441208906,115.88345558791107,116.57929565307596,117.25455180329088,117.91850569644785,116.59059791013391,16229,24893.533333333333,54.075102663627334,52.122896408486575,NaN,NaN,NaN,NaN,0.32352130868575235,17.810828317314822,44546428,0.06055872354890922,0.07226120352942189,0.011702479980512675
2025-09-17T13:45:00-04:00,117.07,117.13,116.94,117.07,NaN,NaN,NaN,117.34091501844992,NaN,NaN,117.01340000000006,118.13478742639252,115.8920125736076,116.57929565307596,117.25339667903951,117.91568366399049,116.59110969408853,11139,23615.3,54.56988240850258,53.32746170347824,NaN,NaN,NaN,NaN,0.3139840723510556,17.090295582864705,44557567,0.05041572810467948,0.07472214011136202,0.024306412006682543
2025-09-17T13:50:00-04:00,117.1,117.305,117.04,117.26,NaN,NaN,NaN,117.34091501844992,NaN,NaN,117.00440000000006,118.11039754072274,115.89840245927738,116.68644921796862,117.25301497238101,117.91286883555065,116.59316110921137,14902,23217.166666666668,59.08018489914135,54.62730882194452,NaN,NaN,NaN,NaN,0.3104852100402659,15.982082644627488,44572469,0.05331917849419887,0.09095538512443113,0.03763620663023226
2025-09-17T13:55:00-04:00,117.27,117.65,117.27,117.64,116.40106645874013,116.40106645874013,116.40106645874013,NaN,NaN,NaN,116.98840000000006,118.03226290291609,115.94453709708402,116.9601593743749,117.25598370670836,117.91275567228422,116.5992117411325,22709,23156.1,66.28878444492436,55.95572438947676,NaN,NaN,NaN,NaN,0.31616483789453265,16.041886749701057,44595178,0.0762515156457253,0.13295060118738888,0.056699085541663585
2025-09-17T14:00:00-04:00,117.63,119.03,117.59,118.76,117.10283616516104,NaN,NaN,NaN,NaN,NaN,116.99340000000004,118.06830174439584,115.91849825560423,117.75812749949992,117.34731069215746,118.05459371904242,116.64002766527251,167625,28068.9,78.37860862505104,57.72399009757657,NaN,NaN,NaN,NaN,0.396438778044923,18.47509816624303,44762803,0.15758669858510288,0.2536824587730422,0.0960957601879393
2025-09-17T14:05:00-04:00,118.85,118.85,117.2,117.25,117.10283616516104,NaN,NaN,NaN,NaN,NaN,116.97700000000006,118.00989883342268,115.94410116657744,117.75812749949992,117.3714928787855,118.06500462534206,116.67798113222895,135232,31699.033333333333,51.54107291214867,57.60342993946875,NaN,NaN,NaN,NaN,0.48597886532742784,19.570414606946475,44627571,0.1030643013204184,0.2249261368384623,0.1218618355180439
2025-09-17T14:10:00-04:00,117.28,117.31,114.88,115.29,NaN,NaN,NaN,117.74105217182641,117.74105217182641,117.74105217182641,116.92120000000004,118.0096733529551,115.83272664704498,117.75812749949992,117.25529652831563,118.03682331760824,116.47376973902301,190739,37402.53333333333,34.85708260669277,56.057596002486115,NaN,NaN,NaN,NaN,0.6248375178040406,19.67835546029084,44436832,-0.06270569416728676,0.04347971780893545,0.10618541197622221
2025-09-17T14:15:00-04:00,115.22,116.81,115.1,116.61,NaN,NaN,NaN,117.74105217182641,NaN,NaN,116.89440000000005,117.94557770148079,115.84322229851931,117.75812749949992,117.21913131460207,118.01171559107135,116.42654703813278,87694,39552.1,47.243021471529275,55.579660112696104,NaN,NaN,NaN,NaN,0.7023491236751811,19.778586252682036,44524526,-0.08004873562866396,0.00612449244039226,0.08617322806905622
2025-09-17T14:20:00-04:00,116.6,117.25,116.01,116.9,NaN,NaN,NaN,117.74105217182641,NaN,NaN,116.86940000000004,117.85750655301395,115.88129344698613,117.75812749949992,117.20453180311057,117.98995481668665,116.41910878953449,79051,40726.666666666664,49.514142182029396,55.2795771638877,NaN,NaN,NaN,NaN,0.740752757698382,19.155875055871064,44603577,-0.06900123339435041,-0.00007831367388178023,0.06892291972046863
2025-09-17T14:25:00-04:00,116.88,117.19,116.59,117.03,NaN,NaN,NaN,117.74105217182641,NaN,NaN,116.85280000000004,117.8008572978964,115.90474270210369,117.75812749949992,117.19971326347206,117.97885367935159,116.42057284759254,49507,41766.3,50.541985734729806,54.91450854205684,NaN,NaN,NaN,NaN,0.7306989892913542,18.577643230260875,44653084,-0.050791775152473864,0.005433200779876302,0.056224975932350166
2025-09-17T14:30:00-04:00,117.05,117.15,115.92,116.29,NaN,NaN,NaN,117.74105217182641,NaN,NaN,116.82800000000003,117.76874651214092,115.88725348785914,117.75812749949992,117.18083241899846,117.9589320659452,116.40273277205172,71426,43253.3,44.93401713144358,54.303877292797786,NaN,NaN,NaN,NaN,0.7663633471991149,18.850823908243257,44581658,-0.08445351431761156,-0.04934191696466428,0.03511159735294728
2025-09-17T14:35:00-04:00,116.22,116.86,115.91,116.2,NaN,NaN,NaN,117.74105217182641,NaN,NaN,116.80860000000004,117.7602786012661,115.85692139873399,117.75812749949992,117.16451258590355,117.9440280203722,116.3849971514349,54780,44458.96666666667,44.29035507593055,53.51336575374635,NaN,NaN,NaN,NaN,0.7794802509706068,19.115829257657484,44526878,-0.10718854299115824,-0.09887408138600051,0.008314461605157718
2025-09-17T14:40:00-04:00,116.16,116.85,115.86,116.06,NaN,NaN,NaN,117.74105217182641,NaN,NaN,116.77980000000004,117.73319595137887,115.8264040486212,117.75812749949992,117.14505090296024,117.92729611172281,116.36280569419766,63055,45699.96666666667,43.25243611872691,52.55904939445649,NaN,NaN,NaN,NaN,0.7945173759012774,19.4221655553172,44463823,-0.12482969226261222,-0.14772265372310756,-0.02289296146049534
2025-09-17T14:45:00-04:00,116.07,116.67,115.41,116.4,NaN,NaN,NaN,117.74105217182641,NaN,NaN,116.76720000000003,117.7236834761323,115.81071652386777,117.75812749949992,117.12761018742336,117.9137077102291,116.34151266461761,53017,46519.13333333333,46.5296364057663,51.792593762874574,NaN,NaN,NaN,NaN,0.8277661347654722,20.229142227525394,44516840,-0.10743632766265457,-0.15718837103881356,-0.04975204337615898
2025-09-17T14:50:00-04:00,116.34,116.65,115.36,115.9,NaN,NaN,NaN,117.74105217182641,NaN,NaN,116.75080000000004,117.73759756794261,115.76400243205747,117.00750199959992,117.1093948496994,117.90247754564712,116.31631215375168,47871,47019.9,42.63063547392022,50.97513182075263,NaN,NaN,NaN,NaN,0.8607828394250818,21.034391279999827,44468969,-0.12235776589687959,-0.20269925074725847,-0.08034148485037888
2025-09-17T14:55:00-04:00,115.88,117.81,115.88,117.81,115.00267288098381,115.00267288098381,115.00267288098381,NaN,NaN,NaN,116.77760000000004,117.8044110634916,115.75078893650847,114.62100159967994,117.11103972209776,117.89270913307467,116.32937031112084,89959,49315.566666666666,57.3374480180911,51.17281507858038,NaN,NaN,NaN,NaN,0.9371554937518621,19.71423838073325,44558928,-0.002671842157576751,-0.08368128754734983,-0.08100944538977307
2025-09-17T15:00:00-04:00,117.74,118.6,117.55,118.6,115.66649218041616,NaN,NaN,NaN,NaN,NaN,116.81460000000004,117.96111443955168,115.6680855604484,115.47760297865072,117.14932577847166,117.94469273205314,116.35395882489019,108952,52266.3,61.70970461465011,51.360637915402435,NaN,NaN,NaN,NaN,0.945215815626729,19.142097268792117,44667880,0.12363954058769631,0.07353998034484732,-0.05009956024284899
2025-09-17T15:05:00-04:00,118.61,118.85,118.21,118.65,116.14369708130634,NaN,NaN,NaN,NaN,NaN,116.85680000000006,118.11012958158449,115.60347041841564,116.03208238292058,117.20374489965573,118.03001775638053,116.37747204293093,129099,55636.5,61.97531923975644,51.05253325789044,NaN,NaN,NaN,NaN,0.9234146859391055,18.896105454510415,44796979,0.1999753105305047,0.19986957792028193,-0.00010573261022280012
2025-09-17T15:10:00-04:00,118.63,118.8,117.7,117.9,116.14369708130634,NaN,NaN,NaN,NaN,NaN,116.88560000000005,118.16699867336041,115.6042013266397,116.03208238292058,117.21908722922434,118.04702773424009,116.3911467242086,56558,56230.53333333333,55.730341246607125,49.434799873715875,NaN,NaN,NaN,NaN,0.9360279226577404,17.92066772578875,44740421,0.18947577212027233,0.2367389825401176,0.047263210419845283
2025-09-17T15:15:00-04:00,117.94,118.44,117.87,118.29,116.14369708130634,NaN,NaN,NaN,NaN,NaN,116.91500000000005,118.25513730643563,115.57486269356447,116.03208238292058,117.23330539641752,118.06354277663876,116.40306801619629,50402,57152.03333333333,58.09498729902045,49.902936615635284,NaN,NaN,NaN,NaN,0.9098830710393299,17.014904120547204,44790823,0.19742023100742248,0.2940384991791234,0.09661826817170091
2025-09-17T15:20:00-04:00,118.28,118.93,118.18,118.91,116.16639450319103,NaN,NaN,NaN,NaN,NaN,116.95460000000007,118.40652264259175,115.50267735740839,116.53222618005535,117.25838532493258,118.102645926782,116.41412472308315,61634,58599.2,61.606019961885764,51.81357499814908,NaN,NaN,NaN,NaN,0.8984628516793778,16.793202308672623,44852457,0.23073667045611776,0.3850391062418481,0.15430243578573036
2025-09-17T15:25:00-04:00,118.93,119.13,118.71,118.83,116.58269475304597,NaN,NaN,NaN,NaN,NaN,116.98880000000007,118.53236154398954,115.4452384560106,117.00178094404427,117.30094120891253,118.17375796781849,116.42812445000658,94773,61056.53333333333,60.897017251754505,52.788860411022306,NaN,NaN,NaN,NaN,0.8642869337022795,16.825108362851303,44757684,0.2330110127575439,0.44556620173266026,0.21255518897511635
2025-09-17T15:30:00-04:00,118.8,118.98,118.29,118.54,116.58269475304597,NaN,NaN,NaN,NaN,NaN,117.02540000000008,118.62649442571961,115.42430557428054,117.00178094404427,117.33091562335433,118.21545850878404,116.44637273792462,85598,62774.1,58.278671003622534,53.41489818399324,NaN,NaN,NaN,NaN,0.8518378670092595,16.181317431403276,44672086,0.20177675653776544,0.46477613464732315,0.2629993781095577
2025-09-17T15:35:00-04:00,118.6,118.86,118.47,118.56,116.58269475304597,NaN,NaN,NaN,NaN,NaN,117.06260000000007,118.71725916734198,115.40794083265817,117.02693980418833,117.34829555335028,118.23948824722702,116.45710285947355,50433,63985.96666666667,58.411478081811985,53.9770047802134,NaN,NaN,NaN,NaN,0.8188494479371695,15.583511566487248,44722519,0.17050089699759846,0.4761254993565558,0.30562460235895733
2025-09-17T15:40:00-04:00,118.58,118.95,118.51,118.81,116.58269475304597,NaN,NaN,NaN,NaN,NaN,117.10280000000007,118.82622352312644,115.3793764768737,117.26355184335067,117.36974863551005,118.27079248662729,116.46870478439281,58310,65399.433333333334,60.120348526573515,55.061742737008394,NaN,NaN,NaN,NaN,0.7917887730845143,15.157424750936975,44780829,0.15512795018524056,0.499534540090508,0.34440658990526746
2025-09-17T15:45:00-04:00,118.81,118.91,118.67,118.87,116.62926084397895,NaN,NaN,NaN,NaN,NaN,117.14180000000007,118.93380196430391,115.34979803569624,117.44084147468054,117.38728291713394,118.29673581858584,116.47783001568204,46958,66475.93333333333,60.53942662972975,56.2223907051369,NaN,NaN,NaN,NaN,0.752375289292763,14.76177270792601,44827787,0.13804959215155577,0.5169685800947121,0.37891898794315637
2025-09-17T15:50:00-04:00,118.89,119.02,118.39,118.855,116.62926084397895,NaN,NaN,NaN,NaN,NaN,117.18110000000007,119.03442813070647,115.32777186929367,117.52967317974444,117.41531471700344,118.33602454985561,116.49460488415127,81080,68771,60.3686298702392,57.44497597310207,NaN,NaN,NaN,NaN,0.7436341972004225,13.877393835492871,44746707,0.11569662342100945,0.5235397672194182,0.40784314379840875
2025-09-17T15:55:00-04:00,118.84,118.97,118.4,118.6,116.62926084397895,NaN,NaN,NaN,NaN,NaN,117.21740000000007,119.10897737353353,115.3258226264666,117.52967317974444,117.44861561259869,118.37877416687324,116.51845705832413,109051,70724.9,57.40369747730715,58.22169462106927,NaN,NaN,NaN,NaN,0.7312317545432488,13.056184882519242,44637656,0.07562947512522605,0.5023799877049413,0.42675051257971525
2025-09-18T09:30:00-04:00,120.02,121.4,119.86,121.31,118.21642793727358,NaN,NaN,NaN,NaN,NaN,117.31520000000006,119.51267305787314,115.11772694212698,118.81819083503643,120.85666666666667,120.85666801536583,120.85666531796751,200918,76768.73333333334,72.7314688605323,60.37175414868442,NaN,NaN,NaN,NaN,0.8790009149330176,15.0775014258589,44838574,0.21560680672740812,0.6962590209889754,0.4806522142615673
2025-09-18T09:35:00-04:00,121.35,122.91,121.35,122.45,119.60795394012479,NaN,NaN,NaN,NaN,NaN,117.43480000000005,120.04704344961921,114.8225565503809,120.04455266802914,121.70372357711074,122.3756113109528,121.03183584326867,319338,86934.63333333333,76.55358442104819,61.744335320324204,NaN,NaN,NaN,NaN,0.9305008495806587,17.837649446773884,45157912,0.36040954354524535,0.931164143693124,0.5707546001478786
2025-09-18T09:40:00-04:00,122.48,123.07,121.66,122.01,119.76531967011911,NaN,NaN,NaN,NaN,NaN,117.54640000000006,120.4391191637048,114.65368083629532,120.07264213442332,121.84457900063629,122.46984239356334,121.21931560770923,182251,92468.7,72.33907041770176,62.5035757348279,NaN,NaN,NaN,NaN,0.9647507888963257,20.47830998294598,44975661,0.39899259704444634,1.0694953464534365,0.6705027494089901
2025-09-18T09:45:00-04:00,121.92,122.41,121.43,122.28,119.76531967011911,NaN,NaN,NaN,NaN,NaN,117.66120000000006,120.82768673454652,114.49471326545361,120.07264213442332,121.87174955941143,122.4558463288636,121.28765278995925,113447,95878.96666666666,73.31008323244501,63.31320173430566,NaN,NaN,NaN,NaN,0.9658400182608731,22.54229008498181,45089108,0.4133777799108136,1.1872249742975072,0.7738471943866936
2025-09-18T09:50:00-04:00,122.32,122.85,122.01,122.09,119.81917556719532,NaN,NaN,NaN,NaN,NaN,117.77420000000005,121.1543475470881,114.394052452912,120.11969096603093,121.9230000292784,122.49049013127988,121.35550992727691,106227,98923.13333333333,71.4103446643186,64.4332019784279,NaN,NaN,NaN,NaN,0.9568514455279528,24.70266707117763,44982881,0.3815438142646682,1.2507769622175289,0.8692331479528607
2025-09-18T09:55:00-04:00,122.08,122.87,121.85,122.74,119.81917556719532,NaN,NaN,NaN,NaN,NaN,117.90160000000006,121.53140244091352,114.2717975590866,120.17575277282475,121.98125263538975,122.5453489794593,121.4171562913202,106288,101709.1,73.90196766422532,65.56227200451396,NaN,NaN,NaN,NaN,0.9613620565616712,26.42797835939032,45089169,0.37514659290264474,1.3381663890811666,0.9630197961785218
2025-09-18T10:00:00-04:00,122.75,123.33,122.63,122.63,120.37290583705192,NaN,NaN,NaN,NaN,NaN,118.02100000000006,121.86596241855116,114.17603758144895,120.8246022182598,122.10883085545349,122.71582326299935,121.50183844790763,173903,101918.36666666667,72.74652165779598,66.35802212565041,NaN,NaN,NaN,NaN,0.9426933382358378,28.299555076694,44915266,0.3356715235099781,1.3826092005659945,1.0469376770560164
2025-09-18T10:05:00-04:00,122.69,123.02,122.54,122.91,120.37290583705192,NaN,NaN,NaN,NaN,NaN,118.14340000000006,122.20723633529559,114.07956366470452,120.8246022182598,122.13825066759382,122.74933510454157,121.52716623064607,51634,99131.76666666666,73.86657823632828,67.28441933883424,NaN,NaN,NaN,NaN,0.9096438140761344,29.870574604519216,44966900,0.30165707375057726,1.424009019244238,1.1223519454936608
2025-09-18T10:10:00-04:00,122.92,123.13,122.37,122.87,120.37290583705192,NaN,NaN,NaN,NaN,NaN,118.27100000000006,122.51578503579147,114.02621496420865,120.95454541968627,122.17714984966769,122.7895026965917,121.56479700274367,79595,95426.96666666666,73.40247417957383,68.36469099425933,NaN,NaN,NaN,NaN,0.8989549702135528,31.00521608695601,44887305,0.25173913833845174,1.4370258684167254,1.1852867300782737
2025-09-18T10:15:00-04:00,122.89,123.36,122.72,123.28,120.5266661304412,NaN,NaN,NaN,NaN,NaN,118.41370000000005,122.83889640694956,113.98850359305054,121.29963633574901,122.24893916060678,122.8884373346921,121.60944098652146,109910,96167.5,75.12749915114793,69.5586924992119,NaN,NaN,NaN,NaN,0.8804581866268705,32.22209494051306,44997215,0.2226141711807723,1.463554444054239,1.2409402728734666
2025-09-18T10:20:00-04:00,123.26,123.34,122.69,122.76,120.52727221542115,NaN,NaN,NaN,NaN,NaN,118.54330000000006,123.08886821971332,113.9977317802868,121.36670906859922,122.28555462909975,122.92631045069459,121.64479880750491,82016,96266.33333333333,69.01392679876594,70.19394809008278,NaN,NaN,NaN,NaN,0.8639968875820944,33.289826056917846,44915199,0.1481908025266132,1.4261787760317333,1.27798797350512
2025-09-18T10:25:00-04:00,122.75,122.89,122.26,122.32,120.52727221542115,NaN,NaN,NaN,NaN,NaN,118.65770000000003,123.28898544143948,114.02641455856059,121.36670906859922,122.29294655367367,122.92316884319862,121.66272426414872,57226,96523.63333333333,64.24960995583085,70.4589611848043,NaN,NaN,NaN,NaN,0.847282824183373,33.405916983548785,44857973,0.054044325644496904,1.3455433805607413,1.2914990549162444
2025-09-18T10:30:00-04:00,122.34,122.71,122.34,122.67,120.52727221542115,NaN,NaN,NaN,NaN,NaN,118.77250000000004,123.51013411420607,114.034865885794,121.36670906859922,122.30185892455805,122.92393195222732,121.67978589688877,51961,95874.8,66.24575609195841,70.8787559149271,NaN,NaN,NaN,NaN,0.8146197653131322,33.51371570113466,44909934,0.002763876978815194,1.2949539011397633,1.292190024160948
2025-09-18T10:35:00-04:00,122.65,122.68,122.17,122.35,120.52727221542115,NaN,NaN,NaN,NaN,NaN,118.88130000000005,123.692141427451,114.0704585725491,121.36670906859922,122.30504587530629,122.9171824368463,121.69290931376628,54866,95877.66666666667,62.79357646851535,71.26374727144197,NaN,NaN,NaN,NaN,0.7928612106479088,33.25940089875715,44855068,-0.06172490399035513,1.2150338941730041,1.2767587981633592
2025-09-18T10:40:00-04:00,122.355,122.55,122.3,122.46,120.52727221542115,NaN,NaN,NaN,NaN,NaN,118.98850000000006,123.8740862493731,114.10291375062702,121.36670906859922,122.30696607476756,122.91482593199254,121.69910621754258,25014,94609.63333333333,63.49775421896374,70.60419622561564,NaN,NaN,NaN,NaN,0.7540854098873438,33.0232514394066,44880082,-0.10352952431490126,1.1473468927697326,1.2508764170846338
2025-09-18T10:45:00-04:00,122.48,122.92,122.22,122.59,120.52727221542115,NaN,NaN,NaN,NaN,NaN,119.10070000000005,124.05383396145098,114.14756603854912,121.4313280275986,122.31203841692424,122.9152686473672,121.70880818648128,32865,93937.9,64.35633676508036,69.73296425018938,NaN,NaN,NaN,NaN,0.7502221663239623,33.2289865344598,44912947,-0.12741236693221403,1.0916109584193663,1.2190233253515803
2025-09-18T10:50:00-04:00,122.5,122.9,122.46,122.77,120.52727221542115,NaN,NaN,NaN,NaN,NaN,119.21670000000006,124.2360248988349,114.19737510116522,121.48906242207887,122.31878317561006,122.91908153917687,121.71848481204326,30127,93346.43333333333,65.56411595787864,69.24903893163058,NaN,NaN,NaN,NaN,0.7280634401579659,33.42002626558062,44943074,-0.13532892666265317,1.0498621670232637,1.185191093685917
2025-09-18T10:55:00-04:00,122.81,123.02,122.62,122.65,120.63038830786968,NaN,NaN,NaN,NaN,NaN,119.32830000000006,124.39960579240399,114.25699420759612,121.69124993766309,122.33308488604945,122.92883505347241,121.73733471862649,59088,92317.4,64.00698196372662,68.5845316981507,NaN,NaN,NaN,NaN,0.7046303372895392,33.739176450362116,44883986,-0.15165998760252353,0.9956161091827624,1.147276096785286
2025-09-18T11:00:00-04:00,122.67,123,122.67,122.91,120.69718883933015,NaN,NaN,NaN,NaN,NaN,119.44690000000006,124.57008295203912,114.323717047961,121.76199995013047,122.34532987621598,122.9394447139978,121.75121503843417,43698,90142.26666666666,65.89684825611405,68.19071052613609,NaN,NaN,NaN,NaN,0.6792995989117145,34.0355301933735,44927684,-0.1478126176441228,0.9625103247301325,1.1103229423742553
2025-09-18T11:05:00-04:00,122.92,123.33,122.67,123.19,120.86936207390605,NaN,NaN,NaN,NaN,NaN,119.56930000000006,124.75157440802518,114.38702559197493,122.00959996010438,122.37791819877904,122.97732495758576,121.77851143997232,89403,88819.06666666667,67.8543594995613,67.75873851437437,NaN,NaN,NaN,NaN,0.6779210561323061,34.70945193958518,45017087,-0.12990623547915603,0.9479401480253102,1.0778463835044663
2025-09-18T11:10:00-04:00,123.2,123.25,122.81,122.88,120.93620925236488,NaN,NaN,NaN,NaN,NaN,119.68430000000006,124.90003696039847,114.46856303960166,122.00959996010438,122.39367836015033,122.99294809132735,121.79440862897331,52947,88698.7,63.50799171460472,67.09884351843215,NaN,NaN,NaN,NaN,0.6609266949799985,35.3352364182103,44964140,-0.14148295803786493,0.9009926859571351,1.042475643995
2025-09-18T11:15:00-04:00,122.9,123.25,122.88,123.15,121.01592701362101,NaN,NaN,NaN,NaN,NaN,119.80410000000003,125.05744395981185,114.55075604018822,122.0439439744668,122.41210798782862,123.01395451405237,121.81026146160487,54722,88842.7,65.57620003422304,66.5066736468532,NaN,NaN,NaN,NaN,0.6401462167671418,35.91632200550506,45018862,-0.13359553523387935,0.8754812249526509,1.0090767601865303
2025-09-18T11:20:00-04:00,123.17,123.19,122.46,122.47,121.01592701362101,NaN,NaN,NaN,NaN,NaN,119.91250000000004,125.15772420875284,114.66727579124723,122.0439439744668,122.41842138864263,123.0153095279301,121.82153324935516,45502,88304.96666666666,56.83899132200771,65.32356772845563,NaN,NaN,NaN,NaN,0.6465643441409176,35.17484718866718,44973360,-0.1742441243148386,0.791271604792982,0.9655157291078206
2025-09-18T11:25:00-04:00,122.48,122.87,122.45,122.51,121.01592701362101,NaN,NaN,NaN,NaN,NaN,120.02130000000005,125.25182609591774,114.79077390408237,122.0439439744668,122.42474761737533,123.01269542196376,121.83679981278691,72497,87562.43333333333,57.20023776678655,64.04304905814409,NaN,NaN,NaN,NaN,0.6303811767022808,34.457685305271404,45045857,-0.19683742358424705,0.7194689496275117,0.9163063732117588
2025-09-18T11:30:00-04:00,122.53,122.72,122.49,122.55,121.01592701362101,NaN,NaN,NaN,NaN,NaN,120.12710000000004,125.34391822187537,114.91028177812471,122.0439439744668,122.42674344975185,123.01132952388595,121.84215737561776,27399,85622.46666666666,57.58257010264985,63.22652357985009,NaN,NaN,NaN,NaN,0.6017825212235468,33.79174927068961,45073256,-0.20648100660304602,0.6582051149579513,0.8646861215609973
2025-09-18T11:35:00-04:00,122.55,122.9,122.53,122.72,121.01592701362101,NaN,NaN,NaN,NaN,NaN,120.22870000000005,125.44568181327905,115.01171818672104,122.0439439744668,122.43014674405558,123.01212992963815,121.848163558473,26403,84821.46666666666,59.24872173601264,62.86931727843451,NaN,NaN,NaN,NaN,0.5852266268504367,33.50775360352906,45099659,-0.1987355175193818,0.6162667246617701,0.8150022421811519
2025-09-18T11:40:00-04:00,122.72,122.81,122.43,122.49,121.01592701362101,NaN,NaN,NaN,NaN,NaN,120.30330000000005,125.54077557894935,115.06582442105075,122.0439439744668,122.43195324510398,123.0105635066525,121.85334298355546,28078,83813.73333333334,56.04139846983648,62.140434591140085,NaN,NaN,NaN,NaN,0.5705675820754051,32.90966370245346,45071581,-0.2055710333433699,0.5580384505019396,0.7636094838453095
2025-09-18T11:45:00-04:00,122.51,122.71,122.43,122.6,121.01592701362101,NaN,NaN,NaN,NaN,NaN,120.41030000000006,125.61236974579157,115.20823025420856,122.0439439744668,122.43355096587216,123.00923383612546,121.85786809561885,24845,83076.63333333333,57.233777082141295,61.74330606354194,NaN,NaN,NaN,NaN,0.5498127547843038,32.35429450859753,45096426,-0.19902076786206213,0.5148335240177317,0.7138542918797939
2025-09-18T11:50:00-04:00,122.61,122.69,122.16,122.31,121.01592701362101,NaN,NaN,NaN,NaN,NaN,120.55070000000005,125.56806903566873,115.53333096433137,122.0439439744668,122.43306249496717,123.00575838174913,121.86036660818522,24238,81181.9,53.14124554007174,61.003555443621075,NaN,NaN,NaN,NaN,0.5483975580139965,30.931697034148947,45072188,-0.20949738666397144,0.4519825585498296,0.661479945213801
2025-09-18T11:55:00-04:00,122.29,122.5,122.25,122.29,121.01592701362101,NaN,NaN,NaN,NaN,NaN,120.66430000000005,125.5757209797251,115.752879020275,122.0439439744668,122.43208135210605,123.0015896614729,121.8625730427392,26723,78437.63333333333,52.86051626180339,60.182425407672724,NaN,NaN,NaN,NaN,0.5270834467272825,29.610713665018118,45045465,-0.2123886688476906,0.39599410915418787,0.6083827780018785
2025-09-18T12:00:00-04:00,122.285,122.8,122.25,122.78,121.01592701362101,NaN,NaN,NaN,NaN,NaN,120.78190000000006,125.60799941465012,115.95580058535,122.0439439744668,122.43396681625322,123.00074232819286,121.86719130431358,25204,72580.5,58.627147875086294,59.686927687473265,NaN,NaN,NaN,NaN,0.5287203433896192,29.107285717743842,45070669,-0.1773429579167184,0.3867040806059805,0.5640470385226989
2025-09-18T12:05:00-04:00,122.78,122.89,122.33,122.33,121.01592701362101,NaN,NaN,NaN,NaN,NaN,120.88790000000006,125.61144531682234,116.16435468317778,121.86015517957344,122.43565101104234,122.99674720507772,121.87455481700695,49442,63583.96666666667,52.299581398176834,58.850684789934,NaN,NaN,NaN,NaN,0.5309546045760751,28.83900790559667,45021227,-0.17994063225514523,0.3391212482037673,0.5190618804589126
2025-09-18T12:10:00-04:00,122.36,122.75,122.08,122.67,121.01592701362101,NaN,NaN,NaN,NaN,NaN,121.01550000000006,125.5772506507996,116.45374934920052,121.80771945194161,122.43681317851656,122.99288551282125,121.88074084421187,44653,58997.36666666667,56.15041313325136,58.15451085258667,NaN,NaN,NaN,NaN,0.540886418534927,27.71913427795901,45065880,-0.1551702013105049,0.3250991288207814,0.4802693301312863
2025-09-18T12:15:00-04:00,122.66,122.84,122.6,122.62,121.01592701362101,NaN,NaN,NaN,NaN,NaN,121.14390000000007,125.51362003222887,116.77417996777127,121.80771945194161,122.43888925790087,122.99311079238407,121.88466772341766,20716,55906.333333333336,55.441580465123735,57.26788377869827,NaN,NaN,NaN,NaN,0.5193945314967185,26.904622767596507,45045164,-0.13907970371643097,0.3064197004857476,0.4454994042021786
2025-09-18T12:20:00-04:00,122.61,122.73,122.32,122.61,121.01592701362101,NaN,NaN,NaN,NaN,NaN,121.27490000000007,125.41375031863426,117.13604968136589,121.80771945194161,122.43997670033953,122.99167058584482,121.88828281483424,23917,53162.666666666664,55.29124487180603,56.68097328992694,NaN,NaN,NaN,NaN,0.5115806363898109,25.24665266809492,45021247,-0.12640341333003374,0.2874951375396364,0.41389855086967015
2025-09-18T12:25:00-04:00,122.62,122.89,122.6,122.67,121.07561614397943,NaN,NaN,NaN,NaN,NaN,121.40030000000007,125.31459605932716,117.48600394067299,121.8732652704808,122.44353864882572,122.99260994693284,121.8944673507186,32430,50700.73333333333,56.061104043029665,56.00132357627027,NaN,NaN,NaN,NaN,0.49575344807625343,24.137755539438903,45053677,-0.11177625855084067,0.2741782276811193,0.38595448623196
2025-09-18T12:30:00-04:00,122.68,123.04,122.57,123.025,121.1474063192531,NaN,NaN,NaN,NaN,NaN,121.54280000000008,125.15270258040997,117.9328974195902,121.99161221638464,122.45480654448063,123.00110186528818,121.90851122367309,67829,47164.933333333334,60.40537342810974,56.25606515527756,NaN,NaN,NaN,NaN,0.4939139160708077,23.49140519806154,45121506,-0.07761214785904869,0.28893930140814916,0.36655144926719785
2025-09-18T12:35:00-04:00,123.01,123.6,122.98,123.4,121.6232060320143,NaN,NaN,NaN,NaN,NaN,121.65460000000006,125.13922786536251,118.1699721346376,122.4512897731077,122.4886915616782,123.05014904329484,121.92723408006155,105836,48971.666666666664,64.408518022772,56.77094231641938,NaN,NaN,NaN,NaN,0.5029200649228922,24.061192493479886,45227342,-0.031540343770307455,0.32712601955431353,0.358666363324621
2025-09-18T12:40:00-04:00,123.41,123.64,123.27,123.46,121.81351484874092,NaN,NaN,NaN,NaN,NaN,121.75180000000006,125.16048758323025,118.34311241676987,122.53603181848617,122.50540458979911,123.07609727798533,121.9347119016129,47844,47913.3,65.01793580766213,57.3020398667774,NaN,NaN,NaN,NaN,0.4934257745712574,24.66185551561719,45275186,-0.00045086553026685294,0.3581027814117874,0.35855364694205427
2025-09-18T12:45:00-04:00,123.46,124.27,123.42,124.27,122.1622187192527,NaN,NaN,NaN,NaN,NaN,121.86420000000005,125.22667370845836,118.50172629154174,122.96182545478894,122.55129905756051,123.16893536127492,121.93366275384611,88600,47202.96666666667,71.99050436265736,58.212167197252015,NaN,NaN,NaN,NaN,0.5188953621018815,26.178157249825297,45363786,0.0674824947784387,0.44290676541510265,0.37542427063666395
2025-09-18T12:50:00-04:00,124.27,124.36,123.97,124.12,122.50552695928667,NaN,NaN,NaN,NaN,NaN,121.98860000000008,125.21260808932944,118.76459191067072,123.11846036383115,122.60697237489435,123.28083850517766,121.93310624461105,103176,47908.3,69.23827561192556,59.1548012788298,NaN,NaN,NaN,NaN,0.5096885505231757,27.700809341023774,45260610,0.09352894406035261,0.4923354507121047,0.3988065066517521
2025-09-18T12:55:00-04:00,124.11,124.18,123.765,123.93,122.50552695928667,NaN,NaN,NaN,NaN,NaN,122.10140000000007,125.19178576233718,119.01101423766296,123.11846036383115,122.62278336270438,123.30827514680533,121.93729157860344,35075,47169.933333333334,65.80645309249023,59.76713527956902,NaN,NaN,NaN,NaN,0.5029250826286636,28.400049983562635,45225535,0.0891902131487427,0.5102942730876805,0.4211040599389378
2025-09-18T13:00:00-04:00,123.95,124.01,123.46,123.52,122.50552695928667,NaN,NaN,NaN,NaN,NaN,122.19360000000007,125.17062404425046,119.21657595574969,123.11846036383115,122.63544640698639,123.32624065694377,121.94465215702901,36932,46668.96666666667,59.009483471799,60.18629513183526,NaN,NaN,NaN,NaN,0.5062875767266171,28.086604201148674,45188603,0.05179091481742487,0.4858427034607189,0.434051788643294
2025-09-18T13:05:00-04:00,123.54,123.83,123.47,123.73,122.50552695928667,NaN,NaN,NaN,NaN,NaN,122.29160000000007,125.13905390832666,119.44414609167349,123.11846036383115,122.64482746501028,123.33950512492937,121.95014980509119,27591,45759.8,61.2189456854701,60.7833258049543,NaN,NaN,NaN,NaN,0.49583846410328725,27.79554740319285,45216194,0.03507933593084045,0.47790095855684456,0.4428216226260041
2025-09-18T13:10:00-04:00,123.73,123.84,123.35,123.36,122.50552695928667,NaN,NaN,NaN,NaN,NaN,122.38800000000006,125.04057987628296,119.73542012371716,123.11846036383115,122.65248981909963,123.34887867864273,121.95610095955652,27153,45831.1,55.538713172743556,60.56272332621553,NaN,NaN,NaN,NaN,0.4954214309530531,27.146011993758407,45189041,-0.004883730532348529,0.43671695946056843,0.44160068999291696
2025-09-18T13:15:00-04:00,123.41,123.64,123.41,123.44,122.50552695928667,NaN,NaN,NaN,NaN,NaN,122.48560000000009,124.91753884792287,120.05366115207731,123.11846036383115,122.65899725648849,123.35661475407628,121.9613797589007,24001,45535.63333333333,56.47898246826198,60.861251974078755,NaN,NaN,NaN,NaN,0.4800341858849779,26.542871970712138,45213042,-0.028596369244831776,0.40585522843687727,0.43445159768170905
2025-09-18T13:20:00-04:00,123.4,123.469,123.15,123.22,122.50552695928667,NaN,NaN,NaN,NaN,NaN,122.57380000000008,124.77506196533739,120.37253803466277,123.11846036383115,122.66351539465565,123.36058880071883,121.96644198859246,22831,45292.433333333334,53.15014885132064,60.64694738251228,NaN,NaN,NaN,NaN,0.46853174403605014,25.1591985646196,45190211,-0.05996062119704204,0.3595008211854065,0.41946144238244853
2025-09-18T13:25:00-04:00,123.2,123.4,123.06,123.26,122.50552695928667,NaN,NaN,NaN,NaN,NaN,122.66160000000009,124.59936617785279,120.7238338221474,123.11846036383115,122.66913727562266,123.36511288280556,121.97316166843976,30887,44352.4,53.6846542902302,60.521452655734166,NaN,NaN,NaN,NaN,0.45935090517633254,23.60684258086618,45221098,-0.07774733520012056,0.32227727338229784,0.4000246085824184
2025-09-18T13:30:00-04:00,123.245,123.37,123.05,123.05,122.50552695928667,NaN,NaN,NaN,NaN,NaN,122.74550000000008,124.35162359426201,121.13937640573815,123.11846036383115,122.67235622956919,123.36715321103347,121.97755924810491,21051,43597.5,50.43160467406671,60.17433549875279,NaN,NaN,NaN,NaN,0.4493972690923093,22.13460594217711,45200047,-0.10186871656896274,0.272688712871215,0.3745574294401777
2025-09-18T13:35:00-04:00,123.04,123.13,122.78,123.05,122.50552695928667,NaN,NaN,NaN,NaN,NaN,122.83450000000008,123.92103255820622,121.74796744179393,123.11846036383115,122.67609896210396,123.3675878141167,121.98461011009123,38423,41898.166666666664,50.43160467406671,59.77222840096972,NaN,NaN,NaN,NaN,0.44229746415714394,21.13416390758587,45200047,-0.11506217323700751,0.2307297128939183,0.3457918861309258
2025-09-18T13:40:00-04:00,123.05,123.06,122.58,123,122.50552695928667,NaN,NaN,NaN,NaN,NaN,122.86830000000008,123.86441567603588,121.87218432396428,122.97926829106493,122.67838564350326,123.3663213182429,121.99044996876363,36597,41353.166666666664,49.601645580475925,59.00053355471017,NaN,NaN,NaN,NaN,0.4449905024316339,20.72571942061241,45163450,-0.12364322883537443,0.1912378500867078,0.3148810789220822
2025-09-18T13:45:00-04:00,122.99,123.1,122.91,123,122.50552695928667,NaN,NaN,NaN,NaN,NaN,122.87930000000007,123.86882111652767,121.88977888347247,122.77441463285193,122.68007409537934,123.36661777951103,121.99353041124765,17045,40097.26666666667,49.601645580475925,57.94289980883188,NaN,NaN,NaN,NaN,0.4267768951150885,20.207967326758265,45163450,-0.12541079656648246,0.15811758321397917,0.28352837978046164
2025-09-18T13:50:00-04:00,122.99,123.3,122.88,123.14,122.50552695928667,NaN,NaN,NaN,NaN,NaN,122.90190000000008,123.86215598672347,121.9416440132767,122.66153170628154,122.68403033370798,123.36860540748309,121.99945525993287,30707,39604.1,52.158388705670276,57.024360730118175,NaN,NaN,NaN,NaN,0.4262928311782966,19.054862854296648,45194157,-0.11359483377251384,0.14153483756481933,0.25512967133733316
2025-09-18T13:55:00-04:00,123.14,123.26,122.945,123.21,122.50552695928667,NaN,NaN,NaN,NaN,NaN,122.92050000000006,123.86779140187622,121.9732085981239,122.66022536502523,122.69237276085128,123.37337031601494,122.01137520568763,61939,39252.166666666664,53.43050540271366,55.69864651869362,NaN,NaN,NaN,NaN,0.4183433432369905,17.98412298701086,45256096,-0.0980927203599696,0.13251377088737115,0.23060649124734076
2025-09-18T14:00:00-04:00,123.2,123.26,123.05,123.19,122.50552695928667,NaN,NaN,NaN,NaN,NaN,122.94250000000005,123.86231356810391,122.02268643189619,122.55618029202019,122.6953696050266,123.37525180322301,122.01548740683019,21448,39053.8,52.996906362040626,54.53854871513041,NaN,NaN,NaN,NaN,0.40346167586292037,16.989864538816917,45234648,-0.08661286214516889,0.12234041356587966,0.20895327571104855
2025-09-18T14:05:00-04:00,123.18,123.33,123,123.04,122.50552695928667,NaN,NaN,NaN,NaN,NaN,122.94850000000005,123.86686430683494,122.03013569316516,122.50939191817065,122.69797292716076,123.37660046018783,122.0193453941337,20775,38866.2,49.73686306672974,53.39072085614753,NaN,NaN,NaN,NaN,0.3982144133012831,15.806528989501405,45213873,-0.08635475676497512,0.10100982975482964,0.18736458651980475
2025-09-18T14:10:00-04:00,123.02,123.05,122.67,122.82,122.50552695928667,NaN,NaN,NaN,NaN,NaN,122.95230000000006,123.86692606569552,122.0376739343046,122.50939191817065,122.69969141002422,123.37457318148633,122.0248096385621,39932,39261.333333333336,45.332356613565445,52.41378322341656,NaN,NaN,NaN,NaN,0.3969133837797626,15.780653669614333,45173941,-0.09741417547934286,0.06559686717062618,0.16301104264996905
2025-09-18T14:15:00-04:00,122.84,122.99,122.75,122.81,122.50552695928667,NaN,NaN,NaN,NaN,NaN,122.95030000000006,123.86572429510572,122.03487570489439,122.50939191817065,122.70253854093971,123.37131194459914,122.03376513728028,66711,40656.86666666667,45.136692762518564,51.265050871777156,NaN,NaN,NaN,NaN,0.3857052849383506,15.756626586862051,45107230,-0.10136371002299652,0.036306405121223406,0.13767011514421992
2025-09-18T14:20:00-04:00,122.83,122.98,122.7,122.78,122.50552695928667,NaN,NaN,NaN,NaN,NaN,122.94850000000004,123.86490220432219,122.03209779567788,122.50939191817065,122.70315021603574,123.37023361784821,122.03606681422326,18436,40463.46666666667,44.515932773937905,50.47770941471962,NaN,NaN,NaN,NaN,0.3781549074427542,15.890278849672859,45088794,-0.10169519066015661,0.010551126819024148,0.11224631747918076
2025-09-18T14:25:00-04:00,122.76,122.78,122.51,122.55,122.50552695928667,NaN,NaN,NaN,NaN,NaN,122.93390000000005,123.85197034592443,122.01582965407567,122.50939191817065,122.7025715292816,123.36754129263619,122.03760176592701,22958,40337.96666666667,39.97660863743798,49.298968426803604,NaN,NaN,NaN,NaN,0.3704295569111286,16.57672623710522,45065836,-0.11227331729251462,-0.02809532913646251,0.08417798815605211
2025-09-18T14:30:00-04:00,122.57,122.81,122.57,122.63,122.50552695928667,NaN,NaN,NaN,NaN,NaN,122.93130000000005,123.85205797040906,122.01054202959104,122.50939191817065,122.70168580728848,123.35757334368834,122.04579827088862,99605,42818,42.184936532648045,48.51573897546986,NaN,NaN,NaN,NaN,0.3625417314174769,17.07078560901838,45165441,-0.10867995086242287,-0.051671950421976476,0.05700800044044639
2025-09-18T14:35:00-04:00,122.62,122.71,122.15,122.18,NaN,NaN,NaN,123.69741091278694,123.69741091278694,123.69741091278694,122.92850000000004,123.85749138859241,121.99950861140768,122.50939191817065,122.69826473450281,123.35190521342939,122.04462425557624,35640,42357.933333333334,34.496684733594904,47.14516972142449,NaN,NaN,NaN,NaN,0.37664589345908484,18.591181364111588,45129801,-0.12996819556589034,-0.10545224401691655,0.024515951548973798
2025-09-18T14:40:00-04:00,122.19,122.25,121.56,121.775,NaN,NaN,NaN,123.20889223493297,NaN,NaN,122.91060000000004,123.89184541277007,121.92935458723002,122.50939191817065,122.67893173814225,123.337090386985,122.02077308929951,87491,43785.86666666667,29.31787576456682,45.637046227888774,NaN,NaN,NaN,NaN,0.3990283296405786,21.003095459440964,45042310,-0.16256776844711274,-0.17869375900991713,-0.016125990562804386
2025-09-18T14:45:00-04:00,121.775,121.98,121.67,121.81,NaN,NaN,NaN,123.11189713334511,NaN,NaN,122.89980000000007,123.91672666404298,121.88287333595716,122.50939191817065,122.66425956600382,123.32619651252874,122.0023226194789,65796,45288.53333333333,30.291819754098256,44.19849016217673,NaN,NaN,NaN,NaN,0.3926691632376803,23.24272997653253,45108106,-0.17209784230648886,-0.23124829344591546,-0.0591504511394266
2025-09-18T14:50:00-04:00,121.82,121.96,121.82,121.94,NaN,NaN,NaN,123.11189713334511,NaN,NaN,122.88940000000007,123.93435481244981,121.84444518755032,122.50939191817065,122.66113790648129,123.32348999128432,121.99878582167825,15937,45022.53333333333,33.93321287433719,43.07931639745254,NaN,NaN,NaN,NaN,0.3753356515778454,25.322390599546125,45124043,-0.16021389503291944,-0.2594178199305759,-0.09920392489765646
2025-09-18T14:55:00-04:00,121.95,121.96,121.77,121.86,NaN,NaN,NaN,123.08299924753139,NaN,NaN,122.87480000000006,123.95585496625068,121.79374503374945,122.20351353453653,122.6557931514436,123.31912317750091,121.9924631253863,26086,44811.066666666666,32.79778474040019,41.879040623161416,NaN,NaN,NaN,NaN,0.3620973907508563,27.33339678717377,45097957,-0.14856757985211994,-0.2849133997128064,-0.13634581986068645
2025-09-18T15:00:00-04:00,121.87,121.91,121.28,121.34,NaN,NaN,NaN,122.84354473627997,NaN,NaN,122.84620000000007,124.00937592824923,121.6830240717509,122.20224866210339,122.64251127908558,123.31329298570805,121.97172957246312,45666,44072.3,26.57359270186504,40.05155519431819,NaN,NaN,NaN,NaN,0.3812332914115091,29.86063907261843,45052291,-0.16542188346291478,-0.3431231741893299,-0.17770129072641513
2025-09-18T15:05:00-04:00,121.34,121.54,121.18,121.54,NaN,NaN,NaN,122.60088361190361,NaN,NaN,122.82400000000005,124.04236776059871,121.6056322394014,122.20224866210339,122.63188560135018,123.30931781092573,121.95445339177462,34541,41695.8,31.924651022345273,38.51542273857759,NaN,NaN,NaN,NaN,0.3797166277392584,32.318733347663496,45086832,-0.15293054445532103,-0.36886447129556643,-0.2159339268402454
2025-09-18T15:10:00-04:00,121.55,121.55,121.29,121.41,NaN,NaN,NaN,122.60088361190361,NaN,NaN,122.79400000000005,124.0746951237833,121.51330487621681,122.07423914374617,122.60814290322034,123.2996897807744,121.91659602566628,79191,42740.7,30.37510923108509,36.899580086366484,NaN,NaN,NaN,NaN,0.3711654400435965,34.548643996078766,45007641,-0.14341201122016806,-0.3951989408654555,-0.2517869296452874
2025-09-18T15:15:00-04:00,121.4,121.45,121.29,121.37,NaN,NaN,NaN,122.55630097696175,NaN,NaN,122.75760000000005,124.09347310778028,121.42172689221982,122.07423914374617,122.60056560693722,123.29672269159144,121.904408522283,24958,40619.3,29.89430648414873,35.482254616182125,NaN,NaN,NaN,NaN,0.35608219432619653,36.619275312464374,44982683,-0.13018529756475672,-0.4145185516012333,-0.2843332540364766
2025-09-18T15:20:00-04:00,121.36,121.37,121.21,121.32,NaN,NaN,NaN,122.44419638709985,NaN,NaN,122.72640000000007,124.1209609201712,121.33183907982894,121.84139131499693,122.59148695978536,123.29360990504578,121.88936401452493,28668,38135.7,29.270606814233858,34.33498677337273,NaN,NaN,NaN,NaN,0.34207632330289756,38.64601291196956,44954015,-0.11566919245848828,-0.42891974460958693,-0.31325055215109865
2025-09-18T15:25:00-04:00,121.32,121.37,121.11,121.2,NaN,NaN,NaN,122.37718746041351,NaN,NaN,122.68740000000005,124.14024306106514,121.23455693893497,121.21011305199755,122.58271802925633,123.29102614724226,121.87440991127039,26557,37851.76666666667,27.772974009944818,33.09472114818888,NaN,NaN,NaN,NaN,0.3362137287812624,40.65554615400285,44927458,-0.10530948296704246,-0.4448874058599017,-0.33957792289285926
2025-09-18T15:30:00-04:00,121.2,121.42,120.81,121.27,NaN,NaN,NaN,122.28367893948563,NaN,NaN,122.66340000000005,124.16852117787104,121.15827882212906,121.17337788262275,122.5540368781823,123.28296085682676,121.82511289953784,85450,39469.03333333333,30.022211477075274,32.05945534127012,NaN,NaN,NaN,NaN,0.3557698910111721,42.857301759812565,45012908,-0.08573261707539215,-0.4467436942370995,-0.3610110771617073
2025-09-18T15:35:00-04:00,121.28,121.43,121.17,121.21,NaN,NaN,NaN,122.28367893948563,NaN,NaN,122.63740000000006,124.19617931731443,121.07862068268568,121.17337788262275,122.54476392630146,123.27914385162153,121.81038400098139,30689,39572.3,29.183315521074576,31.288505832958446,NaN,NaN,NaN,NaN,0.34892918451037447,44.839887785290585,44982219,-0.06950576209742276,-0.4478932797834858,-0.37838751768606305
2025-09-18T15:40:00-04:00,121.22,121.37,121.14,121.18,NaN,NaN,NaN,122.28367893948563,NaN,NaN,122.61000000000006,124.22124175718294,120.99875824281717,121.17337788262275,122.53507157610244,123.2753332192239,121.79480993298098,31560,39719.2,28.75073293829938,30.328919861933546,NaN,NaN,NaN,NaN,0.34043424275963374,46.714581967490126,44950659,-0.054156320005280534,-0.4460829176926637,-0.3919265976873832
2025-09-18T15:45:00-04:00,121.2,121.2,120.6,120.99,NaN,NaN,NaN,122.06050860805563,NaN,NaN,122.57540000000006,124.24880830644338,120.90199169355674,120.9657023060982,122.51517936813771,123.2719677279311,121.75839100834432,53723,40709.933333333334,26.11091751954139,29.72993648950115,NaN,NaN,NaN,NaN,0.3589746539910891,48.94581243717906,44896936,-0.050248859432728,-0.4547376719782932,-0.4044888125455652
2025-09-18T15:50:00-04:00,120.98,121.25,120.76,121,NaN,NaN,NaN,122.06050860805563,NaN,NaN,122.54560000000006,124.27612320413975,120.81507679586038,120.67508453166226,122.49299946257437,123.26589461770078,121.72010430744797,64542,42100.3,26.49346178250002,29.528192633639236,NaN,NaN,NaN,NaN,0.3683336072774395,50.72365124566801,44961478,-0.040839786670131106,-0.45553854588322906,-0.41469875921309796
2025-09-18T15:55:00-04:00,120.97,121.17,120.8,120.88,NaN,NaN,NaN,122.06050860805563,NaN,NaN,122.51120000000006,124.30331557665365,120.71908442334647,120.67508453166226,122.46897208693098,123.25926425956273,121.67867991429922,69590,43390.4,24.832040545205444,29.138208404432607,NaN,NaN,NaN,NaN,0.3684526353290513,52.374501567836326,44891888,-0.03667886327417397,-0.4605473383058154,-0.42386847503164143
2025-09-19T09:30:00-04:00,121.67,122.96,121.01,122.92,120.58297894259925,120.58297894259925,120.58297894259925,NaN,NaN,NaN,122.52340000000005,124.31817401365596,120.72862598634414,121.14620934357444,122.29666666666668,122.29666666666668,122.29666666666668,191051,49057.066666666666,65.00701647777204,31.35776580467795,NaN,NaN,NaN,NaN,0.4907060185198332,49.442499592724836,45082939,0.10190425168724615,-0.29648816042258375,-0.3983924121098299
2025-09-19T09:35:00-04:00,122.86,122.86,121.73,122.18,120.79443444520838,NaN,NaN,NaN,NaN,NaN,122.52120000000006,124.31738212887139,120.72501787112874,121.14620934357444,122.28149646226544,122.3009045294416,122.26208839508928,116726,51667.166666666664,53.778598300908165,32.85639534471424,NaN,NaN,NaN,NaN,0.5406555886255593,46.71992633012131,44966213,0.1398304704314695,-0.22360432407049302,-0.36343479450196253
2025-09-19T09:40:00-04:00,122.14,122.69,121.95,122.11,120.79443444520838,NaN,NaN,NaN,NaN,NaN,122.50780000000006,124.30605488740335,120.70954511259677,121.14620934357444,122.2748380324755,122.29634211935753,122.25333394559347,82507,53197.5,52.848682740712206,34.733187490346175,NaN,NaN,NaN,NaN,0.5548944751523047,44.19182258627519,44883706,0.15511787444910952,-0.16953745144057564,-0.32465532588968515
2025-09-19T09:45:00-04:00,122.12,122.78,121.66,122.66,120.79443444520838,NaN,NaN,NaN,NaN,NaN,122.51440000000004,124.31241850938837,120.71638149061171,121.14620934357444,122.29637240787741,122.33958961564566,122.25315520010916,119562,56614.73333333333,58.86698400171974,36.65763984601578,NaN,NaN,NaN,NaN,0.595259155498569,41.127118541846464,45003268,0.19462772355698676,-0.08137067144345167,-0.27599839500043843
2025-09-19T09:50:00-04:00,122.65,123.2,122.31,123.12,121.09080413195669,NaN,NaN,NaN,NaN,NaN,122.52340000000005,124.32893309581678,120.71786690418332,121.14620934357444,122.40449075152812,122.63377358277094,122.17520792028529,116744,59482.63333333333,63.108194514727835,38.995717366275976,NaN,NaN,NaN,NaN,0.616312072962957,39.150852934737365,45120012,0.24106137470880312,0.025328323385565454,-0.21573305132323767
2025-09-19T09:55:00-04:00,123.08,123.3,122.79,123.08,121.38690394414047,NaN,NaN,NaN,NaN,NaN,122.53260000000006,124.34468414817898,120.72051585182113,121.30310507770248,122.48231701323738,122.7839735752287,122.18066045124606,84905,60248.166666666664,62.50466495019564,41.32502868527933,NaN,NaN,NaN,NaN,0.6087183534656022,37.505219602467804,45035107,0.2569423425805754,0.10544487690248161,-0.1514974656780938
2025-09-19T10:00:00-04:00,123.1,123.33,122.63,122.73,121.38690394414047,NaN,NaN,NaN,NaN,NaN,122.53500000000005,124.34780556047315,120.72219443952696,121.38248406216198,122.5222896088954,122.83403147613909,122.21054774165172,75967,62065.46666666667,57.33758777454192,43.32981303958705,NaN,NaN,NaN,NaN,0.6152384710752022,35.56107589798287,44959140,0.23247187454204793,0.13909237749946612,-0.0933794970425818
2025-09-19T10:05:00-04:00,122.75,123.25,122.67,123.14,121.38690394414047,NaN,NaN,NaN,NaN,NaN,122.54440000000004,124.36476660046792,120.72403339953216,121.40198724972959,122.57615598999355,122.90868163746573,122.24363034252137,95569,64558.6,61.36657780392607,45.72935616772857,NaN,NaN,NaN,NaN,0.6127214374269734,33.75579960096115,45054709,0.23196426465738534,0.1965758337791499,-0.03538843087823546
2025-09-19T10:10:00-04:00,123.18,123.42,122.94,123.02,121.509961723017,NaN,NaN,NaN,NaN,NaN,122.54430000000004,124.364561530688,120.72403846931208,121.70158979978368,122.62703359884885,122.98168043041682,122.27238676728089,89919,66224.83333333333,59.59269119160052,47.84153329019466,NaN,NaN,NaN,NaN,0.6032413347536184,32.45253081192509,44964790,0.21215066447074943,0.22979989971020132,0.017649235239451895
2025-09-19T10:15:00-04:00,123.04,123.38,122.77,123.13,121.509961723017,NaN,NaN,NaN,NaN,NaN,122.53890000000006,124.35055702054304,120.72724297945707,121.70158979978368,122.65188698944368,123.01250055445693,122.29127342443043,54777,65827.03333333334,60.7137556575622,50.09370758565806,NaN,NaN,NaN,NaN,0.6037240965569313,30.75558807964739,45019567,0.19546963364428616,0.2619862772948096,0.06651664365052344
2025-09-19T10:20:00-04:00,123.11,123.37,122.98,123.19,121.520750247625,NaN,NaN,NaN,NaN,NaN,122.53350000000005,124.33572778806905,120.73127221193104,121.83121747186155,122.68396549045411,123.0555232938535,122.31240768705473,66463,67427.93333333333,61.34374569074509,52.421779925118464,NaN,NaN,NaN,NaN,0.5884580896600077,29.179855542532383,45086030,0.17799008577945274,0.2890042508748394,0.11101416509538663
2025-09-19T10:25:00-04:00,123.2,123.37,122.2,122.26,121.520750247625,NaN,NaN,NaN,NaN,NaN,122.49330000000003,124.2271715177617,120.75942848223836,121.83121747186155,122.67820607036157,123.03555489022008,122.32085725050305,92395,69742.5,48.39071049718615,54.01319370923595,NaN,NaN,NaN,NaN,0.6299967975414358,28.329513880528946,44993635,0.09734118709879774,0.2326906489688838,0.13534946187008606
2025-09-19T10:30:00-04:00,122.26,122.54,121.91,122.17,121.520750247625,NaN,NaN,NaN,NaN,NaN,122.45430000000005,124.12669231046142,120.78190768953867,121.83121747186155,122.63945722139326,123.00548275379067,122.27343168899584,106238,69963.6,47.348743514010756,55.502856690058145,NaN,NaN,NaN,NaN,0.6299970262884768,28.05583549868105,44887397,0.034711689006637986,0.17873907312838355,0.14402738412174557
2025-09-19T10:35:00-04:00,122.18,122.5,122.09,122.21,121.520750247625,NaN,NaN,NaN,NaN,NaN,122.41990000000004,124.03938200363763,120.80041799636246,121.83121747186155,122.61763578948695,122.98341042163338,122.25186115734053,80381,71454.96666666666,47.88583700745113,57.14955643736141,NaN,NaN,NaN,NaN,0.6142829529821567,27.80170557267943,44967778,-0.0051232747745218465,0.13762329065359324,0.1427465654281151
2025-09-19T10:40:00-04:00,122.19,122.45,121.92,122.29,121.520750247625,NaN,NaN,NaN,NaN,NaN,122.39530000000002,123.98427251081094,120.8063274891891,121.83121747186155,122.60404356199805,122.97070111498971,122.2373860090064,48601,70158.63333333333,49.00623648092451,56.00664358044373,NaN,NaN,NaN,NaN,0.6082627420548599,27.867920974043418,45016379,-0.026018467895235153,0.11022348055907116,0.13624194845430632
2025-09-19T10:45:00-04:00,122.27,122.46,121.91,121.97,121.520750247625,NaN,NaN,NaN,NaN,NaN,122.36010000000002,123.90665551472608,120.81354448527395,121.83121747186155,122.58482387382301,122.95662237759554,122.21302537005049,57958,69897.36666666667,44.852416682842936,55.36905917915335,NaN,NaN,NaN,NaN,0.6041011176223697,27.92940670388141,44958421,-0.059414983315009134,0.06197321931054489,0.12138820262555403
2025-09-19T10:50:00-04:00,121.96,122.57,121.94,122.31,121.520750247625,NaN,NaN,NaN,NaN,NaN,122.33910000000002,123.85906274958518,120.81913725041485,121.83121747186155,122.57039940749905,122.93934089027643,122.20145792472168,71852,71761.2,49.72809726059182,55.14616021628761,NaN,NaN,NaN,NaN,0.6059510377922,27.615455855380787,45030273,-0.05664130795248698,0.050586567684945294,0.10722787563743227
2025-09-19T10:55:00-04:00,122.3,122.48,122.04,122.4,121.520750247625,NaN,NaN,NaN,NaN,NaN,122.31830000000002,123.80554390740573,120.83105609259431,121.83121747186155,122.56385699695488,122.93049549962733,122.19721849428244,39470,72207.33333333333,50.96396607329984,54.581658935686185,NaN,NaN,NaN,NaN,0.5940973922356142,27.32393006748735,45069743,-0.04716757734268914,0.04826840395907084,0.09543598130175998
2025-09-19T11:00:00-04:00,122.42,122.64,122.265,122.28,121.520750247625,NaN,NaN,NaN,NaN,NaN,122.29950000000001,123.76427063055384,120.83472936944618,121.83121747186155,122.55935950980744,122.92210271626914,122.19661630334573,43538,72136.4,49.22629481382189,53.59009467133576,NaN,NaN,NaN,NaN,0.5784475785044989,26.49084304103374,45026205,-0.04728521547061601,0.03632946196348996,0.08361467743410597
2025-09-19T11:05:00-04:00,122.26,122.34,121.91,122.32,121.520750247625,NaN,NaN,NaN,NaN,NaN,122.28070000000001,123.71957735409251,120.84182264590751,121.83121747186155,122.54260527841903,122.90526441046352,122.17994614637455,77670,73574.03333333334,49.840231173986915,52.68549225874943,NaN,NaN,NaN,NaN,0.5678441800398923,26.513436623214737,45103875,-0.043089772140916666,0.029752462257960133,0.0728422343988768
2025-09-19T11:10:00-04:00,122.33,122.49,122.1,122.39,121.520750247625,NaN,NaN,NaN,NaN,NaN,122.26750000000001,123.68992082384857,120.84507917615146,121.55397397748924,122.53545359869071,122.89414420706662,122.1767629903148,58652,72889.4,50.957807284727735,52.22979365233412,NaN,NaN,NaN,NaN,0.5551410243227572,26.02060119352171,45162527,-0.03439816476243321,0.029844528445835294,0.0642426932082685
2025-09-19T11:15:00-04:00,122.41,122.64,122.26,122.62,121.520750247625,NaN,NaN,NaN,NaN,NaN,122.25890000000001,123.66742446202423,120.8503755379758,121.46773848549579,122.5346038925739,122.88799468848465,122.18121309666314,53863,73852.9,54.54165603895998,51.74229924055083,NaN,NaN,NaN,NaN,0.5426309511568457,25.071068792293165,45216390,-0.01305485069795849,0.047924129835820395,0.060978980533778884
2025-09-19T11:20:00-04:00,122.61,123.2,122.6,123,121.520750247625,NaN,NaN,NaN,NaN,NaN,122.25890000000001,123.66742446202423,120.8503755379758,121.96219078839663,122.55126507749137,122.90627543830321,122.19625471667952,79576,75549.83333333333,59.77219641218352,51.75512104202104,NaN,NaN,NaN,NaN,0.5467287403599287,23.88468616711223,45295966,0.02470186043970854,0.09185630608341455,0.06715444564370601
2025-09-19T11:25:00-04:00,122.97,123.01,122.67,122.97,121.520750247625,NaN,NaN,NaN,NaN,NaN,122.25830000000002,123.66558619694513,120.85101380305491,121.96219078839663,122.5577088845064,122.91222961869556,122.20318815031723,37686,75920.8,59.19313235075425,51.646505091534756,NaN,NaN,NaN,NaN,0.5319624017627912,22.78304515801565,45258280,0.044545358992788914,0.12283614438469215,0.07829078539190323
2025-09-19T11:30:00-04:00,122.94,123.2,122.88,123.18,121.520750247625,NaN,NaN,NaN,NaN,NaN,122.25910000000002,123.66843415488269,120.84976584511735,122.11180210457384,122.56858030288817,122.92737570616893,122.2097848996074,40752,74430.86666666667,61.97048428693083,51.69127213411945,NaN,NaN,NaN,NaN,0.5168222302083066,22.210390226477813,45299032,0.06733568538298604,0.1624603921206358,0.09512470673764975
2025-09-19T11:35:00-04:00,123.19,123.19,122.63,122.85,121.520750247625,NaN,NaN,NaN,NaN,NaN,122.2519,123.64531722399802,120.85848277600199,122.11180210457384,122.57491545330663,122.93295583123226,122.216875075381,39867,74736.8,55.56993992706149,52.204074236253405,NaN,NaN,NaN,NaN,0.5199063566219991,20.949784016854107,45259165,0.05616330969420476,0.1653288438554057,0.10916553416120094
2025-09-19T11:40:00-04:00,122.86,123.18,122.85,123.11,121.520750247625,NaN,NaN,NaN,NaN,NaN,122.25030000000001,123.63958241913718,120.86101758086284,122.11180210457384,122.58553184816185,122.94636923475191,122.22469446157179,46567,75237.03333333334,59.14983220095208,53.047009142463494,NaN,NaN,NaN,NaN,0.5063416168632858,19.779221107917806,45305732,0.061813858813222974,0.18643285767772966,0.12461899886450668
2025-09-19T11:45:00-04:00,123.13,123.22,122.97,123.15,121.58602440423948,NaN,NaN,NaN,NaN,NaN,122.25250000000001,123.64711571772374,120.85788428227629,122.22664267754179,122.59261366544007,122.95613016294529,122.22909716793485,28142,74384.33333333333,59.68797679227327,53.890019127093645,NaN,NaN,NaN,NaN,0.4880315013730511,18.802915100891894,45333874,0.06353170783788675,0.2040336336618651,0.14050192582397836
2025-09-19T11:50:00-04:00,123.16,123.17,122.92,123.15,121.58602440423948,NaN,NaN,NaN,NaN,NaN,122.2591,123.66745178848197,120.85074821151804,122.25031414203345,122.5996210122245,122.96514876201867,122.23409326243033,30595,73252.76666666666,59.68797679227326,54.653000577904265,NaN,NaN,NaN,NaN,0.471029251274976,17.734284003901394,45333874,0.05999705598195923,0.2154982458014274,0.15550118981946817
2025-09-19T11:55:00-04:00,123.15,123.43,123.11,123.37,121.8189085997306,NaN,NaN,NaN,NaN,NaN,122.2703,123.70466454227288,120.83593545772713,122.53425131362675,122.61664752040997,122.99356880498138,122.23972623583856,52764,72691.9,62.81283464245077,55.935887575019116,NaN,NaN,NaN,NaN,0.46024144761247826,17.47645585411605,45386638,0.0672586712361121,0.23957452886460828,0.1723158576284962
2025-09-19T12:00:00-04:00,123.36,123.54,123.27,123.43,121.98304911792466,NaN,NaN,NaN,NaN,NaN,122.2833,123.74738143220672,120.81921856779327,122.6884010509014,122.63564679707949,123.02738277289029,122.24391082126868,53277,68099.43333333333,63.64063426169342,56.92964021795494,NaN,NaN,NaN,NaN,0.44665277278301624,17.522016113961588,45439915,0.07054238935792886,0.2604938443259073,0.1899514549679784
2025-09-19T12:05:00-04:00,123.44,123.46,122.98,123.22,121.98304911792466,NaN,NaN,NaN,NaN,NaN,122.2967,123.78240469479323,120.81099530520677,122.6884010509014,122.64515450424427,123.04066141581629,122.24964759267226,36950,65440.23333333333,58.71424886276794,57.48323184577409,NaN,NaN,NaN,NaN,0.44903471758422864,16.581176987760806,45402965,0.05376915108646771,0.25716289382606305,0.20339374273959535
2025-09-19T12:10:00-04:00,123.23,123.32,123.02,123.06,121.98304911792466,NaN,NaN,NaN,NaN,NaN,122.3053,123.80354752298162,120.80705247701839,122.6884010509014,122.65248834189718,123.0494797725546,122.25549691123976,34637,63844.566666666666,55.20770747231009,57.91047560709468,NaN,NaN,NaN,NaN,0.4383893806139264,15.707540656288653,45368328,0.028372214401336027,0.23885901074126537,0.21048679633992934
2025-09-19T12:15:00-04:00,123.06,123.12,122.81,122.98,121.98304911792466,NaN,NaN,NaN,NaN,NaN,122.32130000000001,123.8308970456095,120.81170295439051,122.6884010509014,122.65869348723851,123.05423598938523,122.26315098509178,45957,61391.066666666666,53.48764728636476,58.171005329407386,NaN,NaN,NaN,NaN,0.4292187105700747,14.93927096122723,45322371,0.003942207096491179,0.2154145552105433,0.21147234811405213
2025-09-19T12:20:00-04:00,122.96,123.17,122.82,122.925,121.98304911792466,NaN,NaN,NaN,NaN,NaN,122.3443,123.85494490867993,120.83365509132008,122.6884010509014,122.66228971873569,123.05696518330852,122.26761425416286,27335,58410.76666666667,52.281638407584026,58.26556469532569,NaN,NaN,NaN,NaN,0.4235602312436414,14.058357740375232,45295036,-0.017014629745695398,0.19020406093193287,0.20721869067762827
2025-09-19T12:25:00-04:00,122.91,123.02,122.7,122.86,121.98304911792466,NaN,NaN,NaN,NaN,NaN,122.3653,123.87484352044562,120.85575647955439,122.6884010509014,122.66494677048814,123.05762169285656,122.27227184811973,32406,56660.8,50.82317951947569,57.99995922964825,NaN,NaN,NaN,NaN,0.4161630718690951,13.620221160652127,45262630,-0.03529535546685464,0.16309949634405996,0.1983948518109146
2025-09-19T12:30:00-04:00,122.88,122.99,122.82,122.86,121.98304911792466,NaN,NaN,NaN,NaN,NaN,122.3837,123.8944862986301,120.87291370136991,122.6884010509014,122.66756462958395,123.05869413737355,122.27643512179435,28379,55074.53333333333,50.82317951947569,57.360743737311964,NaN,NaN,NaN,NaN,0.39857999530701704,13.213380050909244,45262630,-0.04671184732970696,0.1400050426487809,0.18671688997848784
2025-09-19T12:35:00-04:00,122.88,122.89,122.56,122.56,121.98304911792466,NaN,NaN,NaN,NaN,NaN,122.39770000000003,123.90177341579425,120.8936265842058,122.6884010509014,122.66759505978652,123.05627337877864,122.2789167407944,30870,52917.9,44.22016005637939,56.29124571628519,NaN,NaN,NaN,NaN,0.39368142421365854,13.629110539948547,45231760,-0.07226633242056829,0.09638397445277747,0.16865030687334576
2025-09-19T12:40:00-04:00,122.55,122.75,122.45,122.73,121.98304911792466,NaN,NaN,NaN,NaN,NaN,122.42550000000001,123.90146781811522,120.9495321818848,122.6884010509014,122.6672483142082,123.05314991108155,122.28134671733484,35821,51114.63333333333,48.31780256978374,55.31605416506039,NaN,NaN,NaN,NaN,0.38698989391268274,14.316499885673748,45267581,-0.07518361784918848,0.07467078456186016,0.14985440241104864
2025-09-19T12:45:00-04:00,122.75,123.04,122.75,123,121.98304911792466,NaN,NaN,NaN,NaN,NaN,122.45470000000002,123.91714508960379,120.99225491039624,122.6884010509014,122.6705650673329,123.05514364775358,122.28598648691222,32043,50356.833333333336,54.08672384511291,55.21011015920693,NaN,NaN,NaN,NaN,0.38149061577606275,13.820201952923325,45299624,-0.057206291107272544,0.07834653852695794,0.1355528296342305
2025-09-19T12:50:00-04:00,123.01,123.01,122.66,122.83,121.98304911792466,NaN,NaN,NaN,NaN,NaN,122.48310000000001,123.91818730052204,121.04801269947798,122.53872084072111,122.67268216282953,123.05519632290857,122.29016800275049,33452,49256.46666666667,50.281080507142136,54.57662789536336,NaN,NaN,NaN,NaN,0.37924128607777313,13.632576378938952,45266172,-0.05502441479739714,0.06677231113748405,0.1217967259348812
2025-09-19T12:55:00-04:00,122.84,122.9,122.7,122.89,121.98304911792466,NaN,NaN,NaN,NaN,NaN,122.51350000000001,123.91703304204846,121.10996695795156,122.43297667257688,122.67449665192613,123.05516925975834,122.29382404409392,30010,47176.96666666667,51.5761228824137,53.99720975894481,NaN,NaN,NaN,NaN,0.3664383370722181,13.458352631667747,45296182,-0.04805372392146079,0.06172957103305521,0.109783294954516
2025-09-19T13:00:00-04:00,122.87,122.88,122.56,122.57,121.98304911792466,NaN,NaN,NaN,NaN,NaN,122.5385,123.90000835477875,121.17699164522125,122.30330507044921,122.67445673664363,123.05343626102822,122.29547721225904,23303,44412.46666666667,44.864217762184644,52.938369828224204,NaN,NaN,NaN,NaN,0.3638355987099167,13.73636977546981,45272879,-0.06258810007813471,0.03154816985684761,0.09413626993498232
2025-09-19T13:05:00-04:00,122.56,122.73,122.51,122.73,121.98304911792466,NaN,NaN,NaN,NaN,NaN,122.56909999999999,123.87660401917014,121.26159598082984,122.30330507044921,122.67428825335425,123.05147285551395,122.29710365119455,25100,42569.76666666667,48.474755321848754,51.91422130532406,NaN,NaN,NaN,NaN,0.353561627373494,14.147864402917264,45297979,-0.05906439004059273,0.02030578238424141,0.07937017242483414
2025-09-19T13:10:00-04:00,122.72,122.83,122.63,122.8,121.98304911792466,NaN,NaN,NaN,NaN,NaN,122.5997,123.85471937838881,121.34468062161119,122.2663454054848,122.67531950995983,123.05014291244213,122.30049610747754,35034,42117.53333333333,50.01689702370907,50.9410972168966,NaN,NaN,NaN,NaN,0.34259293970395893,14.077760691164286,45333013,-0.05001591017379764,0.016850284707587093,0.06686619488138473
2025-09-19T13:15:00-04:00,122.81,123.01,122.81,122.97,121.98304911792466,NaN,NaN,NaN,NaN,NaN,122.6349,123.82929773950575,121.44050226049426,122.36900708997541,122.6772935767104,123.0513289537406,122.3032581996802,20977,40884.833333333336,53.64543980725787,50.57903942721732,NaN,NaN,NaN,NaN,0.333122015439391,13.259835731038242,45353990,-0.03148318511889543,0.027512213482765446,0.05899539860166088
2025-09-19T13:20:00-04:00,122.98,123.08,122.88,122.985,121.98304911792466,NaN,NaN,NaN,NaN,NaN,122.67099999999999,123.79431651823404,121.54768348176594,122.46720567198032,122.68200000036379,123.05502755236525,122.30897244836233,42504,39906.566666666666,53.963012355492594,50.490132633158915,NaN,NaN,NaN,NaN,0.3236133000508633,12.400264909489863,45396494,-0.017797416336152207,0.03674862818147062,0.05454604451762283
2025-09-19T13:25:00-04:00,123,123.06,122.82,122.82,121.98304911792466,NaN,NaN,NaN,NaN,NaN,122.7076,123.72357094452951,121.69162905547049,122.46720567198032,122.68396496124109,123.05587868648789,122.31205123599429,25002,39424.3,49.91226518285924,50.234748197194236,NaN,NaN,NaN,NaN,0.3176409214758023,11.669133404837687,45371492,-0.01931367203321853,0.03040395447609967,0.0497176265093182
2025-09-19T13:30:00-04:00,122.81,122.91,122.51,122.82,121.98304911792466,NaN,NaN,NaN,NaN,NaN,122.744,123.63542358064485,121.85257641935515,122.46720567198032,122.68471298926669,123.05446427594441,122.31496170258896,33491,39089.4,49.91226518285923,50.06550725257104,NaN,NaN,NaN,NaN,0.3235237127989587,12.087947614820381,45371492,-0.019704843237694357,0.02508657246220025,0.04479141569989461
2025-09-19T13:35:00-04:00,122.83,122.93,122.66,122.93,121.98304911792466,NaN,NaN,NaN,NaN,NaN,122.785,123.50104469143328,122.06895530856671,122.46720567198032,122.68566987501849,123.05448044954574,122.31685930049125,17406,37080.6,52.659823582333125,50.19669611420371,NaN,NaN,NaN,NaN,0.31970059045617666,12.386212237118247,45388898,-0.012305473094253179,0.029409574332078137,0.041715047426331316
2025-09-19T13:40:00-04:00,122.9,123.01,122.88,122.92,121.98304911792466,NaN,NaN,NaN,NaN,NaN,122.785,123.50104469143328,122.06895530856671,122.46720567198032,122.68741043508567,123.05552975497281,122.31929111519852,19725,35783.03333333333,52.37852934236951,50.3077925301247,NaN,NaN,NaN,NaN,0.3061505482807361,12.29412545965336,45369173,-0.008041102767397543,0.03166366896708439,0.03970477173448193
2025-09-19T13:45:00-04:00,122.91,123,122.82,122.85,121.98304911792466,NaN,NaN,NaN,NaN,NaN,122.7984,123.49342356803508,122.10337643196492,122.46720567198032,122.68891200133349,123.0560759774796,122.32174802518739,21240,34695.6,50.350977044148905,50.7457080292511,NaN,NaN,NaN,NaN,0.2971397948321126,12.42864782075314,45347933,-0.009775967458907686,0.027484812410847326,0.03726077986975501
2025-09-19T13:50:00-04:00,122.83,123.16,122.79,123.16,121.98304911792466,NaN,NaN,NaN,NaN,NaN,122.81939999999999,123.49307838034348,122.1457216196565,122.51039804367561,122.69446851381039,123.06128835383996,122.32764867378083,46532,33594.13333333333,58.08847527210737,51.443613222274216,NaN,NaN,NaN,NaN,0.3023440952012467,11.815479630142997,45394465,0.009092901696441877,0.04862690699030736,0.039534005293865485
2025-09-19T13:55:00-04:00,123.14,123.42,123.14,123.38,122.25620860022894,NaN,NaN,NaN,NaN,NaN,122.8338,123.52381611584691,122.14378388415308,122.76031843494049,122.70411098633981,123.0760447014796,122.33217727120002,46093,33874.36666666667,62.54911925316249,52.0480700371349,NaN,NaN,NaN,NaN,0.3007480884011577,11.711058129199847,45440558,0.0341223404600392,0.08218693086891449,0.048064590408875285
2025-09-19T14:00:00-04:00,123.38,123.39,123.11,123.21,122.25620860022894,NaN,NaN,NaN,NaN,NaN,122.8356,123.52905407932117,122.14214592067883,122.76031843494049,122.7098845223877,123.08388501950307,122.33588402527232,32423,33596.73333333333,57.46002132170922,52.56085152388969,NaN,NaN,NaN,NaN,0.29926608208678934,11.482416693360479,45408135,0.03673435975980115,0.09398254010862672,0.057248180348825575
2025-09-19T14:05:00-04:00,123.26,123.6,123.24,123.52,122.39753717500199,NaN,NaN,NaN,NaN,NaN,122.8444,123.56082345030016,122.12797654969982,122.8708037983619,122.72361623044023,123.1074300892876,122.33980237159285,56279,34143.8,63.32058589110162,53.399741738795974,NaN,NaN,NaN,NaN,0.3057470762234473,12.00103083974211,45464414,0.05570740206537404,0.12688243293054313,0.07117503086516909
2025-09-19T14:10:00-04:00,123.53,123.72,123.48,123.7,122.59128548522918,NaN,NaN,NaN,NaN,NaN,122.8638,123.61830264422136,122.10929735577864,123.01664303868952,122.7402276284638,123.13955065766865,122.34090459925895,56673,34480.666666666664,66.22977304562826,54.92585283047051,NaN,NaN,NaN,NaN,0.30105085649320074,12.856365545143571,45521087,0.07551735366209388,0.16557172294278644,0.09005436928069256
2025-09-19T14:15:00-04:00,123.705,123.83,123.645,123.66,122.74940887226421,NaN,NaN,NaN,NaN,NaN,122.87419999999999,123.6574326858237,122.09096731417628,123.17481443095163,122.761900411162,123.18200210756696,122.34179871475705,70823,35903.36666666667,64.99607584932139,56.105947153861415,NaN,NaN,NaN,NaN,0.2927615096008295,13.975182919982812,45450264,0.08060138802733333,0.19080610431485923,0.1102047162875259
2025-09-19T14:20:00-04:00,123.64,123.675,123.36,123.36,122.74940887226421,NaN,NaN,NaN,NaN,NaN,122.881,123.67500755671921,122.08699244328079,123.17481443095163,122.77462681257369,123.20133155854751,122.34792206659986,58519,36834.166666666664,56.49606538203661,56.56874489374196,NaN,NaN,NaN,NaN,0.29434997320077005,13.701925757898051,45391745,0.059412689818021225,0.18447057856005245,0.12505788874203122
2025-09-19T14:25:00-04:00,123.34,123.69,123.33,123.64,122.74940887226421,NaN,NaN,NaN,NaN,NaN,122.89119999999998,123.71044247945746,122.07195752054251,123.17481443095163,122.78578972611497,123.21941958423211,122.35215986799783,47020,36642.7,61.5502109392674,57.13337140317121,NaN,NaN,NaN,NaN,0.2990392608292864,13.32273435575594,45438765,0.059746329867371495,0.1997408010762456,0.1399944712088741
2025-09-19T14:30:00-04:00,123.66,123.86,123.66,123.85,122.78461899568359,NaN,NaN,NaN,NaN,NaN,122.90440000000001,123.76280698979154,122.04599301020848,123.17481443095163,122.79869378438747,123.24412670564801,122.35326086312692,42697,36290.03333333333,64.84864096364882,57.91091630375379,NaN,NaN,NaN,NaN,0.2933935993414801,13.550870029533638,45481462,0.06894885417914781,0.22618053893280887,0.15723168475366106
2025-09-19T14:35:00-04:00,123.85,123.88,123.69,123.71,122.8280454049707,NaN,NaN,NaN,NaN,NaN,122.93340000000002,123.80069335297445,122.06610664702559,123.23279599091778,122.8104118310245,123.26551537852207,122.35530828352692,41003,36425.13333333333,61.0863619591859,58.70906607349141,NaN,NaN,NaN,NaN,0.28600834224565996,13.828961725547057,45440459,0.06073448107510457,0.23314978609754178,0.1724153050224372
2025-09-19T14:40:00-04:00,123.74,123.76,123.6,123.66,122.8280454049707,NaN,NaN,NaN,NaN,NaN,122.96320000000001,123.82590449176922,122.10049550823081,123.23279599091778,122.82001745598569,123.28154786669428,122.3584870452771,37865,36532.73333333333,59.75303475779492,59.41197818598681,NaN,NaN,NaN,NaN,0.27700774637097075,13.658593427531471,45402594,0.04763930867982491,0.23196444087221835,0.18432513219239344
2025-09-19T14:45:00-04:00,123.66,123.68,123.01,123.13,122.8280454049707,NaN,NaN,NaN,NaN,NaN,122.98160000000001,123.81810807534065,122.14509192465938,123.23279599091778,122.82894454681585,123.29022822790435,122.36766086572734,68333,37278.6,47.83446928278211,59.06731002173317,NaN,NaN,NaN,NaN,0.3050786216301873,13.97568214599084,45334261,0.0014303581679015187,0.18611307990227033,0.1846827217343688
2025-09-19T14:50:00-04:00,123.12,123.27,123.06,123.27,122.8280454049707,NaN,NaN,NaN,NaN,NaN,123.00120000000003,123.81765467730642,122.18474532269363,123.23279599091778,122.83435690209778,123.29441982904243,122.37429397515314,51363,38079.53333333333,50.63548620549739,58.94280694052802,NaN,NaN,NaN,NaN,0.2982872915137449,14.270121670274541,45385624,-0.020356742722316384,0.15923679333147334,0.17959353605378972
2025-09-19T14:55:00-04:00,123.26,123.39,123.14,123.39,122.8280454049707,NaN,NaN,NaN,NaN,NaN,123.02960000000003,123.79797188918761,122.26122811081245,123.23279599091778,122.83936303615619,123.299530249529,122.37919582278337,37723,38256.76666666667,52.96666595543666,59.12964186276286,NaN,NaN,NaN,NaN,0.2948381992627631,14.047108233001214,45423347,-0.026924541711277977,0.14593785891469224,0.17286240062597022
2025-09-19T15:00:00-04:00,123.43,123.64,123.32,123.5,122.8280454049707,NaN,NaN,NaN,NaN,NaN,123.05340000000002,123.80466943242895,122.3021305675711,123.23279599091778,122.8472966368079,123.31014762197262,122.38444565164318,44162,38782.86666666667,55.061619687553154,58.91343789243756,NaN,NaN,NaN,NaN,0.2966354707439948,13.173427716442143,45467509,-0.024185692400985365,0.14263028512473852,0.16681597752572389
2025-09-19T15:05:00-04:00,123.49,123.61,123.235,123.6,122.8280454049707,NaN,NaN,NaN,NaN,NaN,123.07740000000001,123.82026537145641,122.33453462854361,123.23279599091778,122.85805788214097,123.32422061822534,122.3918951460566,62178,39826.46666666667,56.93938327853724,58.512742465678606,NaN,NaN,NaN,NaN,0.3022329371194238,12.400642370044404,45529687,-0.0163402437959759,0.14639067278075402,0.16273091657672992
2025-09-19T15:10:00-04:00,123.59,123.76,123.59,123.73,122.8280454049707,NaN,NaN,NaN,NaN,NaN,123.10640000000001,123.83556950026055,122.37723049973947,123.23279599091778,122.87053578326454,123.34416875915882,122.39690280737027,55586,40485.3,59.319187096709165,58.64554002103574,NaN,NaN,NaN,NaN,0.2927877273251793,11.874674751696498,45585273,-0.003753576428729144,0.15803894604081847,0.16179252246954762
2025-09-19T15:15:00-04:00,123.73,123.79,123.48,123.69,122.8280454049707,NaN,NaN,NaN,NaN,NaN,123.13380000000001,123.84545879472546,122.42214120527456,123.23279599091778,122.88107750284726,123.36008494963083,122.40207005606369,50793,41110.3,58.252404094090224,58.283527035534924,NaN,NaN,NaN,NaN,0.29401717537338096,11.071491154314181,45534480,0.0003045334150948431,0.16217318923841617,0.16186865582332133
2025-09-19T15:20:00-04:00,123.69,123.85,123.56,123.81,122.8280454049707,NaN,NaN,NaN,NaN,NaN,123.16220000000001,123.86615499863981,122.45824500136021,123.23279599091778,122.89081809897148,123.37570738458273,122.40592881336023,43264,41437.36666666667,60.54480728116226,57.87745805235878,NaN,NaN,NaN,NaN,0.2937302342752818,10.456472687973555,45577744,0.009014507922692705,0.1731367907266872,0.1641222828039945
2025-09-19T15:25:00-04:00,123.82,123.94,123.72,123.78,122.90177034675824,NaN,NaN,NaN,NaN,NaN,123.18540000000002,123.89280042415642,122.47799957584361,123.2508290108388,122.90279470926575,123.39571494290261,122.40987447562888,50180,42109.7,59.66276860824421,57.49650753513898,NaN,NaN,NaN,NaN,0.2884637889699044,10.214773592268202,45527564,0.01059039436407247,0.17736027575908508,0.16676988139501261
2025-09-19T15:30:00-04:00,123.79,123.79,123.34,123.42,122.90177034675824,NaN,NaN,NaN,NaN,NaN,123.19380000000001,123.90216871761821,122.48543128238181,123.2508290108388,122.91464913647249,123.41004286937338,122.4192554035716,76110,43869.933333333334,50.20985621260419,57.04749259446523,NaN,NaN,NaN,NaN,0.30000208975776854,10.333179697308505,45451454,-0.013471804666312537,0.14993012556212193,0.16340193022843447
2025-09-19T15:35:00-04:00,123.44,123.71,123.37,123.67,122.90177034675824,NaN,NaN,NaN,NaN,NaN,123.2078,123.92553020008826,122.49006979991175,123.2508290108388,122.92243908951853,123.42013807636323,122.42474010267384,46456,44581.8,55.48452760039729,56.614229498831655,NaN,NaN,NaN,NaN,0.30285908334649864,10.443128223417363,45497910,-0.013382598847365534,0.14667368166922756,0.1600562805165931
2025-09-19T15:40:00-04:00,123.72,123.86,123.63,123.78,122.90177034675824,NaN,NaN,NaN,NaN,NaN,123.21980000000002,123.9551175097185,122.48448249028154,123.2508290108388,122.93824940273622,123.44416363824791,122.43233516722452,77036,45981.86666666667,57.61231898019115,56.09734935715611,NaN,NaN,NaN,NaN,0.2976548631074633,9.946446617993198,45574946,-0.007064407960462704,0.15122577056601472,0.15829017852647742
2025-09-19T15:45:00-04:00,123.75,123.75,122.67,122.77,NaN,NaN,NaN,124.13302934866324,124.13302934866324,124.13302934866324,123.21820000000001,123.95706875702272,122.4793312429773,123.2508290108388,122.9412016881073,123.44147037233715,122.44093300387745,98258,48557.9,39.121766510987264,54.52844968228478,NaN,NaN,NaN,NaN,0.35567951574264445,11.83298416077015,45476688,-0.06863290217610771,0.07249905080634278,0.1411319529824505
2025-09-19T15:50:00-04:00,122.77,124.99,122.75,124.59,122.56462135343884,122.56462135343884,122.56462135343884,NaN,NaN,NaN,123.24780000000003,124.07968499210777,122.41591500789228,123.2508290108388,123.08425044104908,123.68953604283472,122.47896483926344,580569,66493.4,62.48636681194656,54.72368768615275,NaN,NaN,NaN,NaN,0.4902738360467409,11.521687417454718,46057257,0.011236483644550377,0.15517755753813844,0.14394107389358807
2025-09-19T15:55:00-04:00,124.6,125.22,124.58,124.74,123.56668401919163,NaN,NaN,NaN,NaN,NaN,123.27960000000002,124.20984478504111,122.34935521495892,123.26589796021733,123.22892494664914,123.98413468039621,122.47371521290208,424221,79800.7,63.722150348155324,55.85852204796512,NaN,NaN,NaN,NaN,0.5009685620434023,11.631388041441237,46481478,0.06896839858764986,0.2301515721281504,0.16118317354050055