time,open,high,low,close,Long Stop,Long Stop Start,Buy Label,Short Stop,Short Stop Start,Sell Label,Basis,Upper,Lower,ATR Trailing Stoploss,VWAP,Upper Band #1,Lower Band #1,Volume,Volume MA,RSI,RSI-based MA,Regular Bullish,Regular Bullish Label,Regular Bearish,Regular Bearish Label,ATR,ADX,OnBalanceVolume,Histogram,MACD,Signal
2025-09-22T10:30:00-04:00,124.285,124.33,123.67,123.75,122.63046489402986,NaN,NaN,NaN,NaN,NaN,123.45229999999967,124.46632013810371,122.43827986189562,122.96628038181899,123.48102129455664,123.97129194975328,122.99075063936,61136,104083.33333333333,50.50687429367647,51.9436572050711,NaN,NaN,NaN,NaN,0.6742980254553856,12.043763015715399,45192046,0.037534108238852976,0.15871778497893274,0.12118367674007977
2025-09-22T10:35:00-04:00,123.78,124.04,123.65,123.89,122.63046489402986,NaN,NaN,NaN,NaN,NaN,123.47229999999969,124.4805999754321,122.46400002456728,122.96628038181899,123.49237077484719,123.97954565707211,123.00519589262227,39436,104031.1,51.71568772957441,51.086052732315316,NaN,NaN,NaN,NaN,0.6539910236371439,11.440882527370823,45231482,0.022429943853110174,0.14922110655646748,0.1267911627033573
2025-09-22T10:40:00-04:00,123.89,124.23,123.76,124.2,122.63046489402986,NaN,NaN,NaN,NaN,NaN,123.5048999999997,124.49971152006685,122.51008847993253,122.96628038181899,123.50884700686719,123.99836342488746,123.01933058884691,39129,104073.23333333334,54.37306972804017,51.84474699651785,NaN,NaN,NaN,NaN,0.6408488076630621,10.66078178595481,45270611,0.03041467646731777,0.1648095082875045,0.13439483182018674
2025-09-22T10:45:00-04:00,124.2,124.35,123.65,123.78,122.63046489402986,NaN,NaN,NaN,NaN,NaN,123.5258999999997,124.49847532379393,122.55332467620546,122.96628038181899,123.5244350701046,124.01121667311789,123.03765346709132,52549,103547.1,50.33141371535197,51.97395320175695,NaN,NaN,NaN,NaN,0.6450738928299854,10.123665998172505,45218062,0.005796293750235021,0.14164019900798053,0.1358439052577455
2025-09-22T10:50:00-04:00,123.8,124.22,123.77,123.81,122.63046489402986,NaN,NaN,NaN,NaN,NaN,123.54609999999968,124.4992910409101,122.59290895908927,122.96628038181899,123.53370016863624,124.01876701963656,123.04863331763593,32655,102923.5,50.61379622063808,52.38305062497052,NaN,NaN,NaN,NaN,0.6311400433421295,9.624915623803222,45250717,-0.009261815935202755,0.12426663533874205,0.1335284512739448
2025-09-22T10:55:00-04:00,123.825,124.14,123.74,123.89,122.63046489402986,NaN,NaN,NaN,NaN,NaN,123.56449999999968,124.50796648084167,122.62103351915769,122.96628038181899,123.54288580352515,124.0258325126785,123.0599390943718,34796,102825.93333333333,51.407176746422714,52.59581789396017,NaN,NaN,NaN,NaN,0.6146300402462634,9.10592389584549,45285513,-0.014326367962745445,0.115620491320513,0.12994685928325844
2025-09-22T11:00:00-04:00,123.89,124.2,123.69,123.89,122.63046489402986,NaN,NaN,NaN,NaN,NaN,123.58259999999969,124.51556782391688,122.64963217608249,122.96628038181899,123.5525091797689,124.03312306640996,123.07189529312785,37962,102619.26666666666,51.407176746422714,52.603917006192596,NaN,NaN,NaN,NaN,0.6071564659429592,8.73608331614999,45285513,-0.017934419886529607,0.10752883442509642,0.12546325431162603
2025-09-22T11:05:00-04:00,123.92,123.92,123.6,123.67,122.63046489402986,NaN,NaN,NaN,NaN,NaN,123.59959999999968,124.50699151442993,122.69220848556944,122.96628038181899,123.5559117683835,124.03251838748488,123.0793051492821,29590,101533,48.90163670567198,52.141370091616295,NaN,NaN,NaN,NaN,0.586645289804177,8.204825115560146,45255923,-0.03443943558772858,0.08241395982696531,0.11685339541469389
2025-09-22T11:10:00-04:00,123.67,123.79,122.91,123.05,122.63046489402986,NaN,NaN,NaN,NaN,NaN,123.60419999999968,124.49796587564455,122.7104341243548,122.96628038181899,123.54079511071559,124.010182893402,123.07140732802918,80238,102354.73333333334,42.60015770748011,51.40585086613349,NaN,NaN,NaN,NaN,0.6075991976753079,8.77639986521256,45175685,-0.08361136921955688,0.012339183890247796,0.09595055310980467
2025-09-22T11:15:00-04:00,123.03,123.29,122.93,123.03,122.63046489402986,NaN,NaN,NaN,NaN,NaN,123.60619999999967,124.49435214938775,122.7180478506116,122.84735721952924,123.5270721127586,123.99590575292416,123.05823847259305,50216,102335.5,42.410306441139745,50.79962988803312,NaN,NaN,NaN,NaN,0.5899135406985001,9.307147847032658,45125469,-0.11219945461931738,-0.04429876516434206,0.06790068945497532
2025-09-22T11:20:00-04:00,123.01,123.8,123.01,123.8,122.63046489402986,NaN,NaN,NaN,NaN,NaN,123.62379999999966,124.49150400510771,122.75609599489161,122.84735721952924,123.52744798168774,123.98701031126167,123.06788565211382,68252,103168.43333333333,51.39195152470529,51.01407588179618,NaN,NaN,NaN,NaN,0.6042054306486067,8.729036020120091,45193721,-0.07571566837774715,-0.026743896017208613,0.04897177236053853
2025-09-22T11:25:00-04:00,123.81,124.26,123.81,124.09,122.63046489402986,NaN,NaN,NaN,NaN,NaN,123.64859999999967,124.49709051878305,122.8001094812163,122.86475001369534,123.55917128039779,124.02191720326263,123.09642535753295,111844,105223.9,54.283785399952436,50.97634659329898,NaN,NaN,NaN,NaN,0.5939050427451354,8.823986905431406,45305565,-0.03081854131294827,0.010448595719353193,0.04126713703230146
2025-09-22T11:30:00-04:00,124.1,124.14,123.92,124,122.63046489402986,NaN,NaN,NaN,NaN,NaN,123.66539999999968,124.50777008521345,122.8230299147859,122.91380001095627,123.5661882199743,124.02885180176726,123.10352463818133,28668,103642.5,53.225473011165754,50.61787739100261,NaN,NaN,NaN,NaN,0.5671975396919114,8.912155584649053,45276897,-0.007182147364490285,0.0322894528266886,0.03947160019117889
2025-09-22T11:35:00-04:00,124.02,124.17,123.9,124.05,122.63046489402986,NaN,NaN,NaN,NaN,NaN,123.67879999999967,124.52389540317485,122.83370459682449,123.05404000876501,123.57481014498799,124.03759868052407,123.11202160945192,34895,103257.13333333333,53.76477117885789,50.49523408207854,NaN,NaN,NaN,NaN,0.5459691439996318,9.047690393460988,45311792,0.010840214628545931,0.0530218684768613,0.04218165384831537
2025-09-22T11:40:00-04:00,124.06,124.1,123.78,123.84,122.63046489402986,NaN,NaN,NaN,NaN,NaN,123.69139999999966,124.52689276506523,122.8559072349341,123.05404000876501,123.57901980142115,124.0403609826694,123.11767862017291,24638,101510.53333333334,51.0999154865465,50.537594167283544,NaN,NaN,NaN,NaN,0.5298284908568005,8.898633833409908,45287154,0.007781748523099388,0.05190883950218961,0.04412709097909022
2025-09-22T11:45:00-04:00,123.85,124.24,123.82,124.14,122.63046489402986,NaN,NaN,NaN,NaN,NaN,123.70379999999969,124.54711621616086,122.86048378383852,123.1877856056096,123.58987021101439,124.05168555494082,123.12805486708795,44200,99708.6,54.56454958452047,50.741084299779686,NaN,NaN,NaN,NaN,0.5219835986527435,9.038106051485542,45331354,0.024199829984194086,0.07437687845933283,0.05017704847513874
2025-09-22T11:50:00-04:00,124.16,124.26,123.85,124.22,122.63046489402986,NaN,NaN,NaN,NaN,NaN,123.71419999999968,124.56980822836509,122.85859177163427,123.21322848448769,123.59610534243191,124.05862125199239,123.13358943287143,24102,81159.7,55.47059112774772,50.819478685473086,NaN,NaN,NaN,NaN,0.5139847701775483,9.208317598736352,45355456,0.03786972882924961,0.09751420951170076,0.059644480682451144
2025-09-22T11:55:00-04:00,124.23,124.57,124.2,124.36,122.82952631978996,NaN,NaN,NaN,NaN,NaN,123.72819999999969,124.60250603363066,122.85389396636872,123.54758278759014,123.61368091653847,124.08539492939019,123.14196690368675,46314,68562.8,57.08346589285591,51.30176812672337,NaN,NaN,NaN,NaN,0.5037001437362941,9.97635132521081,45401770,0.05284326842260012,0.1256985662107013,0.07285529778810118
2025-09-22T12:00:00-04:00,124.35,124.49,124.26,124.36,122.85886603252679,NaN,NaN,NaN,NaN,NaN,123.74819999999967,124.63358073192022,122.86281926807912,123.55706623007212,123.62333080789536,124.09965036892605,123.14701124686466,26583,64213.6,57.08346589285591,51.763887389024646,NaN,NaN,NaN,NaN,0.4841501334694152,10.689525499794234,45401770,0.05879405366088779,0.14634786486421092,0.08755381120332313
2025-09-22T12:05:00-04:00,124.37,124.56,124.21,124.5,122.8900539401392,NaN,NaN,NaN,NaN,NaN,123.76539999999969,124.6747928526474,122.85600714735197,123.6386529840577,123.63159563911731,124.11230345115152,123.1508878270831,21749,58574.9,58.813589100805224,52.29291684290911,NaN,NaN,NaN,NaN,0.47456798107874326,11.492546465075018,45423519,0.06757807066719422,0.1720263995373159,0.10444832887012169
2025-09-22T12:10:00-04:00,124.48,124.48,123.96,124.08,122.8900539401392,NaN,NaN,NaN,NaN,NaN,123.76999999999967,124.68337615496557,122.85662384503377,123.6386529840577,123.64034486741745,124.12202030391583,123.15866943091908,34558,55004.36666666667,52.03617952843887,52.33784561305312,NaN,NaN,NaN,NaN,0.47924169671597633,11.484671007843719,45388961,0.04178551393992949,0.15668022129503356,0.11489470735510407
2025-09-22T12:15:00-04:00,124.07,124.35,123.86,123.91,122.8900539401392,NaN,NaN,NaN,NaN,NaN,123.77399999999969,124.68804157478466,122.85995842521471,123.6386529840577,123.64726056467502,124.12758600982745,123.16693511952259,37679,50524.5,49.547373770103,52.38396968908391,NaN,NaN,NaN,NaN,0.4800101469505491,11.19149575051642,45351282,0.011532297415625531,0.129310079124636,0.11777778170901046
2025-09-22T12:20:00-04:00,123.93,124.04,123.79,123.82,122.8900539401392,NaN,NaN,NaN,NaN,NaN,123.77719999999967,124.6907429056488,122.86365709435053,123.6386529840577,123.65081636248661,124.12837709813661,123.1732556268366,33299,49435.433333333334,48.2321475142264,52.78625467528007,NaN,NaN,NaN,NaN,0.46358085073979566,10.71698723625077,45317983,-0.01485172198398585,0.09921312922902814,0.11406485121301399
2025-09-22T12:25:00-04:00,123.83,124.065,123.68,123.9,122.8900539401392,NaN,NaN,NaN,NaN,NaN,123.79259999999968,124.68775862307014,122.89744137692922,123.6386529840577,123.65418847982015,124.12905679723887,123.17932016240142,32772,47418.7,49.51499317762006,53.29373229931438,NaN,NaN,NaN,NaN,0.4579679328298096,9.95732803838154,45350755,-0.026544656762597346,0.08088403025976731,0.10742868702236466
2025-09-22T12:30:00-04:00,123.89,123.94,123.64,123.79,122.8900539401392,NaN,NaN,NaN,NaN,NaN,123.80299999999967,124.68562562870959,122.92037437128975,123.6386529840577,123.65549217554296,124.12826128881424,123.18272306227168,21745,45480.3,47.76237404621621,53.03447676513658,NaN,NaN,NaN,NaN,0.44668450905625157,9.35788486852078,45329010,-0.040481396834776556,0.05682694097889396,0.09730833781367051
2025-09-22T12:35:00-04:00,123.82,124.09,123.68,124.03,122.8900539401392,NaN,NaN,NaN,NaN,NaN,123.81579999999965,124.69264060151437,122.93895939848494,123.6386529840577,123.65905052694151,124.12982021208092,123.18828084180211,29388,43603.86666666667,51.77327412703781,52.855154531356966,NaN,NaN,NaN,NaN,0.44406418698080474,9.029731792331244,45358398,-0.03266547602315642,0.056476492784724996,0.08914196880788142
2025-09-22T12:40:00-04:00,124.02,124.08,123.84,123.87,122.8900539401392,NaN,NaN,NaN,NaN,NaN,123.82319999999964,124.69548839295243,122.95091160704686,123.6386529840577,123.66237378672331,124.13119701095631,123.1935505624903,28494,42571.73333333333,49.06836060909458,52.55821793120902,NaN,NaN,NaN,NaN,0.4294881736250326,8.72501822158382,45329904,-0.03707774657245991,0.04279478559230654,0.07987253216476645
2025-09-22T12:45:00-04:00,123.86,123.89,123.65,123.76,122.8900539401392,NaN,NaN,NaN,NaN,NaN,123.82639999999967,124.69656099686014,122.95623900313919,123.6386529840577,123.66401800273943,124.12931235999322,123.19872364548563,37212,41561.03333333333,47.24100015015034,52.09223428630134,NaN,NaN,NaN,NaN,0.41595330408038705,8.389096596705278,45292692,-0.0456477211788375,0.02281288069121956,0.06846060187005706
2025-09-22T12:50:00-04:00,123.79,123.98,123.67,123.67,122.8900539401392,NaN,NaN,NaN,NaN,NaN,123.82519999999965,124.69605466092884,122.95434533907047,123.6386529840577,123.66531037192469,124.12799699299092,123.20262375085846,28239,40859.1,45.74009166362303,51.70938972752109,NaN,NaN,NaN,NaN,0.40838521093178815,7.807407052815584,45264453,-0.054994018243496055,-0.0002819209343130069,0.05471209730918305
2025-09-22T12:55:00-04:00,123.68,123.74,123.43,123.7,122.8900539401392,NaN,NaN,NaN,NaN,NaN,123.82539999999966,124.69613495418515,122.95466504581417,123.47292238724616,123.66454365289765,124.1230197284386,123.20606757735669,44440,40559.26666666667,46.35195225326662,51.12277563243153,NaN,NaN,NaN,NaN,0.401357695865231,7.98690145415889,45308893,-0.0565534886991527,-0.015979763564757832,0.04057372513439487
2025-09-22T13:00:00-04:00,123.69,123.8,123.6,123.66,122.8900539401392,NaN,NaN,NaN,NaN,NaN,123.82239999999967,124.6943592653511,122.95044073464825,123.29933790979692,123.66487428588475,124.11991937185448,123.20982919991502,36914,39751.86666666667,45.61338650627735,50.41868958804078,NaN,NaN,NaN,NaN,0.38697500330342904,7.936136261774974,45271979,-0.05748891670089152,-0.03128742074171953,0.02620149595917199
2025-09-22T13:05:00-04:00,123.65,124.27,123.55,124.2,122.8900539401392,NaN,NaN,NaN,NaN,NaN,123.83079999999967,124.70903313558956,122.95256686440977,123.31588226028578,123.6697447360198,124.12334847950406,123.21614099253553,35705,39627.5,55.842615964253675,50.33005745028348,NaN,NaN,NaN,NaN,0.4107625030674697,8.296416827761178,45307684,-0.020838896416433623,0.00015287543862996245,0.020991771855063585
2025-09-22T13:10:00-04:00,124.185,124.37,124.12,124.28,122.94653223379086,NaN,NaN,NaN,NaN,NaN,123.84799999999969,124.72706313790641,122.96893686209296,123.48170580822863,123.6760627283508,124.13126566998818,123.22085978671342,27266,39232.066666666666,57.12907127945595,50.33331497789777,NaN,NaN,NaN,NaN,0.39927946713407897,8.88873667071066,45334950,0.00813907078215997,0.03116561033276355,0.02302653955060358
2025-09-22T13:15:00-04:00,124.27,124.27,123.98,123.99,122.94653223379086,NaN,NaN,NaN,NaN,NaN,123.85439999999967,124.73284553640956,122.97595446358979,123.48170580822863,123.6795502043195,124.13432189336744,123.22477851527155,22059,38215.73333333333,51.29515238369295,49.79628378381832,NaN,NaN,NaN,NaN,0.3921880766245017,8.948687075756782,45312891,0.007158184613316673,0.03197427031724942,0.024816085703932747
2025-09-22T13:20:00-04:00,124,124.32,123.93,124,122.94653223379086,NaN,NaN,NaN,NaN,NaN,123.85879999999969,124.73791446377858,122.9796855362208,123.48170580822863,123.6826196409713,124.13701494493432,123.22822433700827,19571,37779.6,51.47915257981137,49.756496144630646,NaN,NaN,NaN,NaN,0.3920317854370364,9.004355309013894,45332462,0.006580073421627863,0.033041177480967576,0.026461104059339713
2025-09-22T13:25:00-04:00,123.99,124.12,123.97,124.01,122.94653223379086,NaN,NaN,NaN,NaN,NaN,123.8835999999997,124.70662622096522,123.06057377903419,123.48170580822863,123.6843635701108,124.13829855475554,123.23042858546607,12866,37048.6,51.67575815521003,49.908523600709714,NaN,NaN,NaN,NaN,0.37474380076296276,9.056047239895497,45345328,0.006269722008184743,0.03429825656957064,0.028028534561385897
2025-09-22T13:30:00-04:00,124.04,124.21,123.95,124.03,122.94653223379086,NaN,NaN,NaN,NaN,NaN,123.87239999999969,124.67156516466677,123.0732348353326,123.48170580822863,123.68746387722422,124.14082527077404,123.23410248367439,21342,36494.6,52.09385162711119,50.18435960877291,NaN,NaN,NaN,NaN,0.36654781499417904,9.394960757476337,45366670,0.006767353043790329,0.03648772586612381,0.02972037282233348
2025-09-22T13:35:00-04:00,124.05,124.1,123.91,123.97,122.94653223379086,NaN,NaN,NaN,NaN,NaN,123.85699999999969,124.61743408683219,123.09656591316718,123.48170580822863,123.68925065501979,124.141886503982,123.23661480605759,15329,36019.23333333333,50.6773147971546,50.267382581596806,NaN,NaN,NaN,NaN,0.3539372567803089,9.537843416486824,45351341,0.0026244879121511237,0.033000982712522386,0.030376494800371263
2025-09-22T13:40:00-04:00,123.98,124.16,123.95,124.13,122.94653223379086,NaN,NaN,NaN,NaN,NaN,123.88339999999967,124.5860647567909,123.18073524320843,123.49551500739229,123.69171258133484,124.1439783218285,123.23944684084118,16638,33899.23333333333,54.249932582614356,50.730779619910955,NaN,NaN,NaN,NaN,0.34365602415314356,9.879491156524404,45367979,0.009824129821248945,0.04265665707693245,0.0328325272556835
2025-09-22T13:45:00-04:00,124.1,124.14,123.97,124.11,122.94653223379086,NaN,NaN,NaN,NaN,NaN,123.89879999999967,124.58674930077524,123.2108506992241,123.52341200591384,123.69374111184443,124.14565597726254,123.24182624642633,14112,32695.766666666666,53.7260673312571,50.87026484878377,NaN,NaN,NaN,NaN,0.3312520224279191,10.196735486559302,45353867,0.01224604761063832,0.048140086768981405,0.035894039158343084
2025-09-22T13:50:00-04:00,124.09,124.12,123.65,123.75,122.94653223379086,NaN,NaN,NaN,NaN,NaN,123.91639999999967,124.54020458513148,123.29259541486786,123.52341200591384,123.69500469321412,124.14516674239447,123.24484264403377,23136,31191.9,45.25490120150679,50.59787489109892,NaN,NaN,NaN,NaN,0.34116259225449624,9.83035657798218,45330731,-0.01017949736850026,0.023169667447717757,0.03334916481621802
2025-09-22T13:55:00-04:00,123.74,123.83,123.64,123.8,122.94653223379086,NaN,NaN,NaN,NaN,NaN,123.92699999999968,124.52394220860991,123.33005779138945,123.52341200591384,123.6953170334479,124.14435885525891,123.2462752116369,13634,27918.233333333334,46.51624144810115,50.54610641238112,NaN,NaN,NaN,NaN,0.3303652642363178,9.528630261585217,45344365,-0.02081492321250606,0.007330510800585444,0.028145434013091504
2025-09-22T14:00:00-04:00,123.79,124.02,123.58,124.02,122.94653223379086,NaN,NaN,NaN,NaN,NaN,123.93519999999968,124.52572844166212,123.34467155833724,123.52341200591384,123.69690082748609,124.14425307289571,123.24954858207647,24162,27768.033333333333,51.780607762461656,50.97757184801245,NaN,NaN,NaN,NaN,0.33819631679086637,9.232384032314013,45368527,-0.012606559928776268,0.01238723410212117,0.024993794030897437
2025-09-22T14:05:00-04:00,123.98,124.11,123.95,124.1,122.94653223379086,NaN,NaN,NaN,NaN,NaN,123.93459999999968,124.52439603289231,123.34480396710704,123.52341200591384,123.69912628161904,124.14596270646811,123.25228985676998,17063,27173.633333333335,53.57027498051544,51.49316632853022,NaN,NaN,NaN,NaN,0.32546800844866136,9.29791719411719,45385590,-0.0019233106860093267,0.022589655673385778,0.024512966359395105
2025-09-22T14:10:00-04:00,124.08,124.32,124.06,124.28,123.10574644661708,NaN,NaN,NaN,NaN,NaN,123.94299999999969,124.54022357656314,123.34577642343623,123.63826044609785,123.70641981301871,124.15431804549641,123.25852158054101,38810,27646.033333333333,57.401292795818435,52.335159634926015,NaN,NaN,NaN,NaN,0.3207917221308992,10.080184622740811,45424400,0.016137265546695315,0.04468454829276425,0.028547282746068933
2025-09-22T14:15:00-04:00,124.28,124.44,124.25,124.43,123.28412160813448,NaN,NaN,NaN,NaN,NaN,123.9587999999997,124.56485795135232,123.35274204864707,123.79960835687828,123.71155331670461,124.16151540240982,123.2615912309994,21500,26889.366666666665,60.33822325199642,52.656274441193354,NaN,NaN,NaN,NaN,0.31144945626440623,11.17512661897926,45445900,0.03592373215738501,0.07345194794280019,0.03752821578541518
2025-09-22T14:20:00-04:00,124.42,124.42,124.13,124.15,123.28412160813448,NaN,NaN,NaN,NaN,NaN,123.97459999999968,124.55816435841643,123.39103564158293,123.79960835687828,123.71449602425456,124.1648856429228,123.26410640558632,15842,26614.033333333333,52.99356138979786,52.36088087764635,NaN,NaN,NaN,NaN,0.3106316379598066,11.608376246471964,45430058,0.028231241251807516,0.07281726735017457,0.04458602609836706
2025-09-22T14:25:00-04:00,124.15,124.22,124.05,124.18,123.28412160813448,NaN,NaN,NaN,NaN,NaN,123.9759999999997,124.56119056759562,123.39080943240378,123.79960835687828,123.7169255044136,124.16722689390427,123.26662411492292,15758,25595.5,53.64463072441406,52.52870075912643,NaN,NaN,NaN,NaN,0.30058652096267763,11.63655160194498,45445816,0.023437856289483056,0.07388334646022088,0.05044549017073782
2025-09-22T14:30:00-04:00,124.2,124.42,124.2,124.38,123.29518080512148,NaN,NaN,NaN,NaN,NaN,123.9721999999997,124.54423202742466,123.40016797257475,123.80811947872168,123.71965482411997,124.17081825222333,123.26849139601661,12563,25128.166666666668,57.83730987520806,52.98285485165477,NaN,NaN,NaN,NaN,0.296258912322486,12.337566562783211,45458379,0.03150843516131643,0.08983103412238336,0.05832259896106693
2025-09-22T14:35:00-04:00,124.36,124.37,124.16,124.23,123.29518080512148,NaN,NaN,NaN,NaN,NaN,123.97099999999972,124.54060688231978,123.40139311767966,123.80811947872168,123.72189198923046,124.17342724990661,123.2703567285543,11944,24801.333333333332,53.899774414046966,53.14171315585741,NaN,NaN,NaN,NaN,0.2908118471565941,12.792432264293577,45446435,0.02481082783413273,0.08933613375373284,0.06452530591960011
2025-09-22T14:40:00-04:00,124.24,124.45,124.22,124.4,123.35034036169127,NaN,NaN,NaN,NaN,NaN,123.98399999999971,124.56243927979207,123.40556072020735,123.85539646638188,123.7270681980817,124.180367736626,123.2737686595374,23425,24430.233333333334,57.43646020597341,53.523328054347566,NaN,NaN,NaN,NaN,0.28646814378826624,13.484368466964181,45469860,0.02957301067439347,0.10149156926259195,0.07191855858819848
2025-09-22T14:45:00-04:00,124.39,124.57,124.36,124.5,123.49646125434167,NaN,NaN,NaN,NaN,NaN,123.9961999999997,124.59167480250174,123.40072519749766,123.98931717310549,123.73260871706032,124.18877115280583,123.2764462813148,21391,23887.3,59.4091436638251,54.1470301162526,NaN,NaN,NaN,NaN,0.28100613351767534,14.513145150621723,45491251,0.036733687144382215,0.11783566751867625,0.08110198037429403
2025-09-22T14:50:00-04:00,124.5,124.55,124.38,124.41,123.51730392459886,NaN,NaN,NaN,NaN,NaN,124.00039999999971,124.60446569212169,123.39633430787774,124.0004537384844,123.7365703376861,124.19454723795889,123.27859343741332,16146,23315.533333333333,56.85516772305334,54.333118340569676,NaN,NaN,NaN,NaN,0.27307712398069867,15.468437785446584,45475105,0.03281323883310708,0.12211852891567787,0.08930529008257079
2025-09-22T14:55:00-04:00,124.41,124.77,124.4,124.74,123.62992647348074,NaN,NaN,NaN,NaN,NaN,124.0195999999997,124.65465539948723,123.38454460051217,124.14536299078752,123.74678002815374,124.21202106146727,123.2815389948402,33389,23336.1,63.116315098128574,55.00385032391763,NaN,NaN,NaN,NaN,0.2800001865535052,17.02081043199187,45508494,0.04888150335939942,0.15040716928182007,0.10152566592242065
2025-09-22T15:00:00-04:00,124.74,125.26,124.73,125.17,124.0110661792316,NaN,NaN,NaN,NaN,NaN,124.04679999999969,124.75580990150183,123.33779009849755,124.49529039263003,123.77544985493327,124.27378342865299,123.27711628121355,66041,24812.633333333335,69.35656266653527,56.7253975714197,NaN,NaN,NaN,NaN,0.29785731608539784,19.523290794185453,45574535,0.08290633641643355,0.2051585864429626,0.12225225002652904
2025-09-22T15:05:00-04:00,125.18,125.95,125.18,125.94,124.51942680744835,NaN,NaN,NaN,NaN,NaN,124.0877999999997,124.97139529221057,123.20420470778883,124.94823231410402,123.81825744685695,124.38650789182066,123.25000700189324,68832,26127.433333333334,76.89498839695027,58.89530806776607,NaN,NaN,NaN,NaN,0.33229607922215515,22.75112325070405,45643367,0.14791140616686518,0.3071415077351105,0.15923010156824532
2025-09-22T15:10:00-04:00,125.95,126.64,125.95,126.18,125.2014983162007,NaN,NaN,NaN,NaN,NaN,124.1335999999997,125.19161897923289,123.07558102076652,125.4885858512832,123.92654503717579,124.67547209740944,123.17761797694213,143066,29946.5,78.65735637709744,60.815075825954345,NaN,NaN,NaN,NaN,0.3585606449920014,26.306363614919103,45786433,0.19476613308026675,0.40268776791857874,0.207921634838312
2025-09-22T15:15:00-04:00,126.18,126.29,125.49,125.67,125.2014983162007,NaN,NaN,NaN,NaN,NaN,124.1735999999997,125.30702496903368,123.04017503096571,125.4885858512832,123.97182057315909,124.7661647468647,123.17747639945348,79062,31341.5,66.96775365144481,61.77203858816358,NaN,NaN,NaN,NaN,0.39009202749257355,27.91768772628998,45707371,0.1794812152477579,0.43227315389800935,0.25279193865025146
2025-09-22T15:20:00-04:00,125.66,125.74,125.56,125.71,125.2014983162007,NaN,NaN,NaN,NaN,NaN,124.2267999999997,125.39349406462448,123.06010593537492,125.4885858512832,123.99331025215254,124.80511650708465,123.18150399722043,42303,31810.3,67.37725506475712,62.484607321659205,NaN,NaN,NaN,NaN,0.3750854541002463,29.413917258277227,45749674,0.16074027368824456,0.4537172807605572,0.2929770070723126
2025-09-22T15:25:00-04:00,125.71,125.86,125.51,125.74,125.2014983162007,NaN,NaN,NaN,NaN,NaN,124.2809999999997,125.47180644961017,123.09019355038922,125.4885858512832,124.01559773984648,124.84508876451841,123.18610671517456,44145,31800.466666666667,67.70066755579924,63.01049620050226,NaN,NaN,NaN,NaN,0.3732936359502283,30.948780600354553,45793819,0.1398110582991055,0.4677408299461945,0.327929771647089
2025-09-22T15:30:00-04:00,125.76,125.88,125.74,125.77,125.2014983162007,NaN,NaN,NaN,NaN,NaN,124.32039999999972,125.5736642819456,123.06713571805385,125.4885858512832,124.03261609340541,124.87612195271895,123.18911023409187,32676,31659.2,68.04186238035899,64.0853748426852,NaN,NaN,NaN,NaN,0.3566298048109263,32.398909090463896,45826495,0.11828876163931706,0.4757907236962353,0.35750196205691825
2025-09-22T15:35:00-04:00,125.77,125.77,125.39,125.45,125.2014983162007,NaN,NaN,NaN,NaN,NaN,124.34759999999972,125.6381599406458,123.05704005935362,125.4885858512832,124.04537461702549,124.8965463426695,123.19420289138148,29257,31444.266666666666,60.67878791983358,64.58781464235803,NaN,NaN,NaN,NaN,0.3582991044672884,32.47052115066898,45797238,0.0749171811324888,0.4511484384725293,0.3762312573400405
2025-09-22T15:40:00-04:00,125.44,125.49,125.27,125.355,125.2014983162007,NaN,NaN,NaN,NaN,NaN,124.37469999999972,125.69156356180557,123.05783643819387,125.4885858512832,124.06161415421089,124.92004122101014,123.20318708741164,42754,31960.533333333333,58.64967181964431,64.64584049553204,NaN,NaN,NaN,NaN,0.34842059700533917,32.13916108528924,45754484,0.03431272566858545,0.4191221644257723,0.3848094387571869
2025-09-22T15:45:00-04:00,125.36,125.4,125.02,125.17,NaN,NaN,NaN,126.28544927090076,126.28544927090076,126.28544927090076,124.39709999999972,125.72912415909015,123.0650758409093,125.4885858512832,124.07637346718512,124.93884072379358,123.21390621057667,46002,32758.633333333335,54.80612725396585,64.71057998409768,NaN,NaN,NaN,NaN,0.35067626864781565,31.049377118502147,45708482,-0.008250592161572812,0.37449619855522087,0.3827467907167937
2025-09-22T15:50:00-04:00,125.2,125.31,125.05,125.16,NaN,NaN,NaN,126.24201975858709,NaN,NaN,124.4234999999997,125.76261649994508,123.08438350005433,125.4885858512832,124.09924458411618,124.9669464032631,123.23154276496926,75331,34617.3,54.59784379501023,64.50782166902887,NaN,NaN,NaN,NaN,0.3441993923158292,30.037434863628427,45633151,-0.038623551583668314,0.3344673512372083,0.3730909028208766
2025-09-22T15:55:00-04:00,125.18,125.28,124.8,124.86,NaN,NaN,NaN,126.1192006786513,NaN,NaN,124.43789999999971,125.77999402070827,123.09580597929116,125.4885858512832,124.12225761546996,124.98999789963058,123.25451733130934,96938,37419.7,48.62732604724542,63.73769183927318,NaN,NaN,NaN,NaN,0.3538994357218416,28.34336576441303,45536213,-0.07818272142055738,0.2753625010451799,0.3535452224657373
2025-09-23T09:30:00-04:00,125.41,127.78,124.635,126.9,124.7484902612874,124.7484902612874,124.7484902612874,NaN,NaN,NaN,124.49149999999972,125.99844425922723,122.98455574077221,125.48023582157774,126.43833333333335,126.43833333333335,126.43833333333335,219707,44031.86666666667,71.4724808025208,64.78178563066372,NaN,NaN,NaN,NaN,0.5532637617417098,30.070437889720797,45755920,0.028085654642498237,0.3886522907688601,0.36056663612636186
2025-09-23T09:35:00-04:00,126.91,127.33,126.08,126.18,125.14185434031978,NaN,NaN,NaN,NaN,NaN,124.52789999999973,126.10659577829225,122.94920422170722,125.48023582157774,126.46712813204675,126.50967672525783,126.42457953883567,100624,46875.03333333333,61.13857990582355,64.64051883121336,NaN,NaN,NaN,NaN,0.6030306359030162,31.674147720363727,45655296,0.043984382428393254,0.4155471141618534,0.37156273173346016
2025-09-23T09:40:00-04:00,126.19,126.23,124.64,125.31,NaN,NaN,NaN,127.1439117660584,127.1439117660584,127.1439117660584,124.54689999999974,126.13985811633256,122.95394188366691,125.48023582157774,126.08307860980047,126.59888790769399,125.56726931190694,178360,52265.76666666667,51.4570918659917,63.3619852026031,NaN,NaN,NaN,NaN,0.6735284476242295,30.46347809705847,45476936,-0.00726517103411034,0.36248126794082225,0.3697464389749326
2025-09-23T09:45:00-04:00,125.24,126.87,125.09,126.58,NaN,NaN,NaN,127.1439117660584,NaN,NaN,124.58849999999973,126.27997775640122,122.89702224359823,125.48023582157774,126.09753792648098,126.57456964297293,125.62050620998903,87443,54710.13333333333,61.13273602588368,62.2361100332412,NaN,NaN,NaN,NaN,0.7525621299367845,29.985158848948533,45564379,0.03867097933785674,0.4180851631472535,0.3794141838093968
2025-09-23T09:50:00-04:00,126.56,126.84,125.76,125.76,NaN,NaN,NaN,127.1439117660584,NaN,NaN,124.62209999999973,126.33840077795207,122.90579922204739,125.48023582157774,126.10227689605041,126.52610892968595,125.67844486241488,156726,59163.13333333333,53.69135900573764,60.4528245067155,NaN,NaN,NaN,NaN,0.775950549227014,29.54100526141788,45407653,0.009646140801753189,0.3914718598115883,0.3818257190098351
2025-09-23T09:55:00-04:00,125.76,125.76,125.09,125.43,NaN,NaN,NaN,127.1439117660584,NaN,NaN,124.65249999999973,126.37111601307755,122.93388398692191,125.48023582157774,126.04032008863763,126.4888513680564,125.59178880921885,75002,61208.73333333333,51.000807567719825,59.31232835787801,NaN,NaN,NaN,NaN,0.768382652853656,28.12025396020519,45332651,-0.03359259358437272,0.33983497702936916,0.3734275706137419
2025-09-23T10:00:00-04:00,125.39,125.83,125,125.72,NaN,NaN,NaN,127.1439117660584,NaN,NaN,124.69049999999972,126.41780570554918,122.96319429445025,125.48023582157774,125.9963302171579,126.44951931037532,125.54314112394049,75006,62903.53333333333,53.219370270868474,58.30105087260024,NaN,NaN,NaN,NaN,0.7727838919355376,26.673854182431388,45407657,-0.04383016073239743,0.3186398696982451,0.3624700304306425
2025-09-23T10:05:00-04:00,125.72,125.99,125.53,125.79,NaN,NaN,NaN,127.1439117660584,NaN,NaN,124.7282999999997,126.46743496901058,122.98916503098883,125.48023582157774,125.9872533771532,126.43347716659147,125.54102958771492,37304,63578.23333333333,53.76356192948966,57.305543327863845,NaN,NaN,NaN,NaN,0.7504421853687131,25.529108175929434,45444961,-0.046786553645415174,0.3039868383738735,0.3507733920192887
2025-09-23T10:10:00-04:00,125.79,126.12,125.74,125.845,NaN,NaN,NaN,127.1439117660584,NaN,NaN,124.76939999999972,126.51501237404462,123.02378762595482,125.48023582157774,125.98379915271491,126.42124994339237,125.54634836203745,39120,63588.566666666666,54.21423912749588,56.31785595265934,NaN,NaN,NaN,NaN,0.7239820292709486,24.630121316089888,45484081,-0.045874897543567106,0.29342977008982984,0.33930466763339695
2025-09-23T10:15:00-04:00,125.88,125.91,125.47,125.65,NaN,NaN,NaN,127.1439117660584,NaN,NaN,124.80179999999972,126.55144654728325,123.05215345271618,125.48023582157774,125.9742894535404,126.40818845821877,125.54039044886201,30971,63904.26666666667,52.268961066671565,55.71715403457633,NaN,NaN,NaN,NaN,0.7036975986087378,23.356906429644024,45453110,-0.058436471558420855,0.26625907818537087,0.3246955497437917
2025-09-23T10:20:00-04:00,125.67,125.8,125.14,125.14,NaN,NaN,NaN,127.1439117660584,NaN,NaN,124.82719999999972,126.5587809655965,123.09561903440294,124.8651886572622,125.89795160384227,126.35175583158251,125.44414737610204,141942,68107.6,47.47139901387479,54.918705977021375,NaN,NaN,NaN,NaN,0.7005763415652563,21.711774435952588,45311168,-0.09875368228712039,0.20125344688489122,0.3000071291720116
2025-09-23T10:25:00-04:00,125.16,125.5,124.8,125.04,NaN,NaN,NaN,127.03994002521503,NaN,NaN,124.85279999999972,126.55816231939883,123.1474376806006,124.07074791629547,125.85436937711661,126.33059965504958,125.37813909918364,67176,69821.53333333334,46.5688174672769,54.33032670654359,NaN,NaN,NaN,NaN,0.7005351743105953,20.675152336487134,45243992,-0.12796377180159973,0.14005241442001193,0.26801618622161166
2025-09-23T10:30:00-04:00,125.06,125.1,124.76,124.91,NaN,NaN,NaN,126.78039729679617,NaN,NaN,124.87759999999973,126.54916841331782,123.20603158668165,124.07074791629547,125.82914569419394,126.32260172108917,125.33568966729871,33677,70525.33333333333,45.361368990886255,53.670578506249015,NaN,NaN,NaN,NaN,0.6747826618598377,19.769991056521683,45210315,-0.1503037663541448,0.08013647827893067,0.23044024463307547
2025-09-23T10:35:00-04:00,124.87,125.13,124.7,125.065,NaN,NaN,NaN,126.73992469239633,NaN,NaN,124.90489999999973,126.54289571440772,123.26690428559174,124.07074791629547,125.8073493132835,126.31303423086396,125.30166439570303,32165,71199.36666666667,47.12181600733332,53.563042074826726,NaN,NaN,NaN,NaN,0.6572981860127058,19.02016153229437,45242480,-0.1486360121760094,0.0446452294130637,0.19328124158907312
2025-09-23T10:40:00-04:00,125.1,125.19,124.75,125.06,NaN,NaN,NaN,126.73992469239633,NaN,NaN,124.93289999999973,126.53222371970583,123.33357628029364,124.07074791629547,125.79078176669687,126.30417342808616,125.27739010530757,26717,71309.1,47.069131572621934,51.81994570126252,NaN,NaN,NaN,NaN,0.6417768870117981,18.209599884133333,45215763,-0.14188014730379744,0.015931057459326325,0.15781120476312377
2025-09-23T10:45:00-04:00,125.1,125.55,125.07,125.52,NaN,NaN,NaN,126.73992469239633,NaN,NaN,124.95929999999973,126.55292857668171,123.36567142331775,124.1654346094155,125.77801919147339,126.28837383557634,125.26766454737044,41747,71987.63333333333,52.3477057726948,51.19202612032475,NaN,NaN,NaN,NaN,0.6309356807966694,17.025677506187915,45257510,-0.10229071959144229,0.029947805273820904,0.1322385248652632
2025-09-23T10:50:00-04:00,125.52,125.61,125.14,125.26,NaN,NaN,NaN,126.73992469239633,NaN,NaN,124.97889999999973,126.56270338439535,123.3950966156041,124.26734768753239,125.77086615664447,126.28012677861155,125.2616055346774,22136,72187.3,49.351912779604504,51.0416561855828,NaN,NaN,NaN,NaN,0.6194402750254787,16.03366216897352,45235374,-0.08991277070930852,0.01984756147862754,0.10976033218793606
2025-09-23T10:55:00-04:00,125.24,125.45,125.21,125.29,NaN,NaN,NaN,126.73992469239633,NaN,NaN,125.00489999999972,126.5654248990055,123.44437510099394,124.26734768753239,125.76531091881908,126.27390376628244,125.25671807135572,16912,71638.06666666667,49.709541454521904,50.22571371619983,NaN,NaN,NaN,NaN,0.5923373982379452,15.112505070131585,45252286,-0.07652727021893829,0.014101244414263192,0.09062851463320148
2025-09-23T11:00:00-04:00,125.3,125.45,125.02,125.41,NaN,NaN,NaN,126.73992469239633,NaN,NaN,125.03309999999972,126.57076041778434,123.4954395822151,124.27970252002073,125.75829414606133,126.26631351176485,125.25027478035781,20867,70132.26666666666,51.194063364104984,50.04733545608321,NaN,NaN,NaN,NaN,0.5807418697923782,14.200320920686249,45273153,-0.057293935081945996,0.019011095780768983,0.07630503086271498
2025-09-23T11:05:00-04:00,125.45,125.7,125.4,125.66,NaN,NaN,NaN,126.73992469239633,NaN,NaN,125.06609999999974,126.58522644648511,123.54697355351436,124.61376201601658,125.75443789941106,126.25736119181464,125.25151460700748,32262,68913.26666666666,54.22562816075341,50.27767978415704,NaN,NaN,NaN,NaN,0.5606888790929224,13.530520047808267,45305415,-0.026976652925579242,0.04258421470574092,0.06956086763132016
2025-09-23T11:10:00-04:00,125.68,125.95,125.68,125.86,NaN,NaN,NaN,126.73992469239633,NaN,NaN,125.10269999999973,126.60833237226771,123.59706762773175,124.93600961281327,125.75566684228518,126.25457515341834,125.25675853115202,23739,64935.7,56.55077765949498,50.51563745477322,NaN,NaN,NaN,NaN,0.5413539591577141,13.385195452098248,45329154,0.005569152521175999,0.07652230828279016,0.07095315576161416
2025-09-23T11:15:00-04:00,125.87,126.45,125.82,126.34,NaN,NaN,NaN,126.73992469239633,NaN,NaN,125.15009999999972,126.65932959168575,123.6408704083137,125.3238076902506,125.76766617060181,126.26512511749422,125.2702072237094,40201,63640.333333333336,61.593131434125155,51.07489241939004,NaN,NaN,NaN,NaN,0.5476858192178781,14.079629813856616,45369355,0.05566190093558164,0.14053053193109122,0.08486863099550958
2025-09-23T11:20:00-04:00,126.32,126.4,126.165,126.4,NaN,NaN,NaN,126.73992469239633,NaN,NaN,125.19549999999973,126.71578319743936,123.67521680256009,125.38154615220049,125.77825395818425,126.27674117359584,125.27976674277267,29222,63204.3,62.183907179277625,51.64415442308873,NaN,NaN,NaN,NaN,0.5253511178451725,14.724461721203674,45398577,0.08719650508023075,0.193864262345798,0.10666775726556726
2025-09-23T11:25:00-04:00,126.36,126.56,126.11,126.16,NaN,NaN,NaN,126.73992469239633,NaN,NaN,125.23649999999972,126.74802009593499,123.72497990406445,125.52023692176039,125.7958377215065,126.29401208333061,125.29766335968239,55916,63596.666666666664,58.3195889267304,52.07634212737865,NaN,NaN,NaN,NaN,0.5199688951419461,15.578238447623097,45342661,0.08610209025145124,0.2142953700798813,0.12819327982843007
2025-09-23T11:30:00-04:00,126.18,126.4,125.845,126.36,NaN,NaN,NaN,126.73992469239633,NaN,NaN,125.28869999999972,126.77126508808473,123.80613491191471,125.52023692176039,125.80634906494332,126.30223714001254,125.3104609898741,42143,63912.23333333333,60.52130400374136,53.00847819808341,NaN,NaN,NaN,NaN,0.5224711169175219,15.67901211622418,45384804,0.0924973374924492,0.2438149516939916,0.15131761420154238
2025-09-23T11:35:00-04:00,126.38,126.68,126.34,126.43,NaN,NaN,NaN,126.73992469239633,NaN,NaN,125.34129999999972,126.7952048250938,123.88739517490563,125.62255162992665,125.82499795897142,126.32640424335027,125.32359167459258,46091,64473.36666666667,61.291999095439,54.06013402866641,NaN,NaN,NaN,NaN,0.5094374657091277,16.24727942695734,45430895,0.09474459395317134,0.26974835664300656,0.17500376268983522
2025-09-23T11:40:00-04:00,126.39,126.51,126.24,126.31,NaN,NaN,NaN,126.73992469239633,NaN,NaN,125.38709999999973,126.81568404037426,123.9585159596252,125.62255162992665,125.8341489782402,126.33595055029183,125.33234740618856,29491,64031.26666666667,59.15986337726243,55.045740770550424,NaN,NaN,NaN,NaN,0.4923347895870479,16.5111574248727,45401404,0.0819328670358273,0.27741984648461937,0.19548697944879206
2025-09-23T11:45:00-04:00,126.33,126.42,126.16,126.16,NaN,NaN,NaN,126.73992469239633,NaN,NaN,125.42829999999972,126.82448137805511,124.03211862194433,125.62255162992665,125.84019261281311,126.34076459056168,125.33962063506455,25316,63341.73333333333,56.51345062274582,55.71657181450846,NaN,NaN,NaN,NaN,0.47573944747368774,16.541235143244503,45376088,0.05825280148166817,0.26830298130087726,0.2100501798192091
2025-09-23T11:50:00-04:00,126.16,126.72,126.1,126.58,NaN,NaN,NaN,126.73992469239633,NaN,NaN,125.47429999999973,126.86767146533862,124.08092853466084,125.67818643452243,125.85200644164898,126.35510542854495,125.34890745475302,33212,61937.76666666667,61.68207651855247,56.76035359636064,NaN,NaN,NaN,NaN,0.48604377265413895,17.11505363396951,45409300,0.06524531844862341,0.2916068278799884,0.22636150943136496
2025-09-23T11:55:00-04:00,126.6,126.7,126.54,126.645,NaN,NaN,NaN,126.73992469239633,NaN,NaN,125.51859999999971,126.91718219652732,124.1200178034721,125.78654914761795,125.86007768546499,126.36671155051206,125.35344382041791,18503,59323.26666666667,62.42638317468527,57.48025912507425,NaN,NaN,NaN,NaN,0.4627549317502716,17.64788508964273,45427803,0.06829227868535556,0.3117268577880594,0.24343457910270386
2025-09-23T12:00:00-04:00,126.65,126.77,126.3,126.37,125.1536809688118,125.1536809688118,125.1536809688118,NaN,NaN,NaN,125.56299999999972,126.9254580729108,124.20054192708864,125.80423931809436,125.86582294094048,126.3735902727008,125.35805560918016,16648,52554.63333333333,57.350719593753354,58.051602468942015,NaN,NaN,NaN,NaN,0.46327243662525214,17.442836118065415,45411155,0.04685285609601264,0.30200064922271963,0.255147793126707
2025-09-23T12:05:00-04:00,126.37,126.38,126.17,126.21,125.1536809688118,NaN,NaN,NaN,NaN,NaN,125.60359999999972,126.9189600877496,124.28823991224984,125.80423931809436,125.87094207993799,126.377281086378,125.36460307349797,24048,50002.1,54.570649473634724,58.39882447030721,NaN,NaN,NaN,NaN,0.44518154829487655,16.892809504468115,45387107,0.018421977293089864,0.2781752647430693,0.25975328744997944
2025-09-23T12:10:00-04:00,126.21,126.41,126.21,126.36,125.1536809688118,NaN,NaN,NaN,NaN,NaN,125.64319999999971,126.92768240176679,124.35871759823263,125.80423931809436,125.87679751544755,126.3824844230406,125.3711106078545,23694,44846.566666666666,56.69027092140668,58.79141072440019,NaN,NaN,NaN,NaN,0.42766858055952844,16.45159379172386,45410801,0.006840871199997045,0.26830437644997573,0.2614635052499787
2025-09-23T12:15:00-04:00,126.35,126.41,126.24,126.3,125.1536809688118,NaN,NaN,NaN,NaN,NaN,125.6845999999997,126.91658188317,124.45261811682941,125.80423931809436,125.87993853970877,126.38517608611025,125.3747009933073,13263,42373.9,55.5733232674904,58.887674660595685,NaN,NaN,NaN,NaN,0.4092636819481337,16.04189348703277,45397538,-0.006989324205586178,0.252726849992996,0.2597161741985822
2025-09-23T12:20:00-04:00,126.32,126.59,126.29,126.53,125.1536809688118,NaN,NaN,NaN,NaN,NaN,125.7271999999997,126.9253989152309,124.5290010847685,125.85866442469145,125.8857808849856,126.39189425770104,125.37966751227017,18574,37768.833333333336,58.91503140418721,59.0565499280737,NaN,NaN,NaN,NaN,0.4014591332375525,16.106618669233256,45416112,-0.002981150932881149,0.2559897355324807,0.25897088646536187
2025-09-23T12:25:00-04:00,126.54,126.72,126.02,126.03,125.1536809688118,NaN,NaN,NaN,NaN,NaN,125.75779999999969,126.9061852317361,124.60941476826328,125.85866442469145,125.89078004013554,126.39528695190769,125.38627312836338,25631,36123.13333333333,50.093691149684055,58.235161336327906,NaN,NaN,NaN,NaN,0.4227834808634418,15.320251957925212,45390481,-0.034582448766297125,0.21574282550749047,0.2503252742737876
2025-09-23T12:30:00-04:00,126.03,126.42,125.98,126.39,125.1536809688118,NaN,NaN,NaN,NaN,NaN,125.79739999999968,126.89246390703089,124.70233609296848,125.85866442469145,125.89778607613376,126.40008256206208,125.39548959020543,36445,34837.76666666667,55.2850215039304,57.74238378808882,NaN,NaN,NaN,NaN,0.42401323223033865,14.470620812951237,45426926,-0.03188446968859732,0.21046968716304093,0.24235415685163825
2025-09-23T12:35:00-04:00,126.41,127.2,126.13,127,125.21981410199196,NaN,NaN,NaN,NaN,NaN,125.84259999999969,126.9458882490396,124.73931175095979,125.89055618544202,125.92533230736318,126.44286981228962,125.40779480243674,62707,35684.53333333333,62.41861027418459,58.03517102719269,NaN,NaN,NaN,NaN,0.4701551442138864,15.409210705128777,45489633,0.008197286258514541,0.25260076467478143,0.2444034784162669
2025-09-23T12:40:00-04:00,126.99,127.07,126.69,127.04,125.44868618826506,NaN,NaN,NaN,NaN,NaN,125.87999999999971,127.01585210324873,124.74414789675069,125.89055618544202,125.9420303472245,126.47114366079103,125.41291703365798,33701,35503.9,62.837285546826934,58.200598280270235,NaN,NaN,NaN,NaN,0.4637154910557513,16.280758462150775,45523334,0.03321456577496623,0.28592168563497466,0.25270711986000843
2025-09-23T12:45:00-04:00,127.05,127.12,126.83,126.93,125.56920045243483,NaN,NaN,NaN,NaN,NaN,125.8997999999997,127.07304500444674,124.72655499555266,125.98495595868289,125.9534308893221,126.49036754062931,125.4164942380149,23042,35239.6,60.83031088672731,58.16762055107654,NaN,NaN,NaN,NaN,0.4513072416946267,17.18456116065889,45500292,0.0378299238940803,0.2999945247276088,0.2621646008335285
2025-09-23T12:50:00-04:00,126.95,127.3,126.95,126.97,125.73264588641507,NaN,NaN,NaN,NaN,NaN,125.9155999999997,127.12425651053644,124.70694348946296,126.20696476694631,125.97274500288265,126.52463787833466,125.42085212743063,36106,31711.733333333334,61.31418040565449,58.321500338818815,NaN,NaN,NaN,NaN,0.44549958157358127,18.35970849180634,45536398,0.03890223575700741,0.31079239552978777,0.27189015977278036
2025-09-23T12:55:00-04:00,126.98,127.26,126.71,127.26,125.73264588641507,NaN,NaN,NaN,NaN,NaN,125.9473999999997,127.21095568157865,124.68384431842075,126.20696476694631,125.98530200135842,126.54639502219125,125.42420898052559,24088,30275.466666666667,64.71719587904693,58.90748214284033,NaN,NaN,NaN,NaN,0.45296389717546914,18.62263393632982,45560486,0.05356337239701392,0.33884437526904776,0.28528100287203384
2025-09-23T13:00:00-04:00,127.26,127.52,127.19,127.21,125.9697558593162,NaN,NaN,NaN,NaN,NaN,125.9773999999997,127.28736067133576,124.66743932866365,126.43545745084563,126.01538333663285,126.60402736609028,125.42673930717542,49332,30797.3,63.677150161871126,59.049987403077374,NaN,NaN,NaN,NaN,0.4441807616629355,19.378682734338362,45511154,0.05415307268050834,0.3529723437226693,0.29881927104216094
2025-09-23T13:05:00-04:00,127.22,127.4,127.1,127.395,125.9697558593162,NaN,NaN,NaN,NaN,NaN,126.0104999999997,127.37720150378948,124.64379849620991,126.43545745084563,126.0310956137132,126.63290071442515,125.42929051300126,26868,30620.733333333334,65.86311435209096,59.295468201463514,NaN,NaN,NaN,NaN,0.4338821358298695,19.774935002763158,45538022,0.06076588139193445,0.374776622782079,0.31401074139014457
2025-09-23T13:10:00-04:00,127.41,127.51,127.31,127.48,126.08150275611249,NaN,NaN,NaN,NaN,NaN,126.04469999999971,127.46994441428329,124.61945558571612,126.5958927685412,126.04719278680606,126.66389753977,125.43048803384212,25477,30579.4,66.85024653562627,59.97400584016872,NaN,NaN,NaN,NaN,0.4171762689848791,20.36697469154367,45563499,0.06428693930206814,0.39436941551772975,0.3300824762156616
2025-09-23T13:15:00-04:00,127.5,127.54,127.29,127.37,126.11279808538012,NaN,NaN,NaN,NaN,NaN,126.0830999999997,127.54516824753367,124.62103175246574,126.68371421483297,126.06811044119428,126.70238484716322,125.43383603522534,34855,30349.666666666668,64.26051893553077,60.66613937316129,NaN,NaN,NaN,NaN,0.40523510691453063,20.9790276937359,45528644,0.05309460065015226,0.39645072702835193,0.3433561263781997
2025-09-23T13:20:00-04:00,127.39,127.51,127.07,127.32,126.11279808538012,NaN,NaN,NaN,NaN,NaN,126.12239999999969,127.6094941330204,124.63530586697897,126.68371421483297,126.07981067250435,126.7222743052087,125.4373470398,21615,30332.3,63.0646081673598,61.12144917644366,NaN,NaN,NaN,NaN,0.4077183135634936,20.742545558136797,45507029,0.036974957459856295,0.38957482320302006,0.35259986574316377
2025-09-23T13:25:00-04:00,127.33,127.34,126.67,126.73,126.11279808538012,NaN,NaN,NaN,NaN,NaN,126.1535999999997,127.62483219120855,124.68236780879084,126.68371421483297,126.09309215318814,126.738906802977,125.44727750339928,36850,30996.9,51.00273619571142,60.7949786713166,NaN,NaN,NaN,NaN,0.42645271973752985,19.29492819486174,45470179,-0.015933818293710433,0.33268259287602575,0.3486164111697362
2025-09-23T13:30:00-04:00,126.71,126.99,126.3,126.31,126.11279808538012,NaN,NaN,NaN,NaN,NaN,126.1765999999997,127.6206864795688,124.73251352043059,126.68371421483297,126.0997729783271,126.74292444527514,125.45662151137905,35636,31489.2,44.4807080767623,59.76395557650053,NaN,NaN,NaN,NaN,0.44527752547056326,18.794577081508354,45434543,-0.07824242491743111,0.2508133800229473,0.3290558049403784
2025-09-23T13:35:00-04:00,126.32,126.37,124.28,124.42,NaN,NaN,NaN,126.91634242263675,126.91634242263675,126.91634242263675,126.1677999999997,127.64876341631472,124.68683658368468,126.68371421483297,126.00709117106712,126.69207686127243,125.32210548086181,221236,37788.333333333336,27.46219446345131,58.147420098912484,NaN,NaN,NaN,NaN,0.5627577022226661,21.008830550735876,45213307,-0.23680997880502208,0.033043331434100764,0.26985331023912285
2025-09-23T13:40:00-04:00,124.39,125.06,124.07,124.63,NaN,NaN,NaN,126.21900867615325,NaN,NaN,126.1223999999997,127.64926114642466,124.59553885357474,126.68371421483297,125.96136446145563,126.68036446779382,125.24236445511744,85470,39846.03333333333,30.637719014678368,56.386898492537334,NaN,NaN,NaN,NaN,0.593275009206762,23.228755793087664,45298777,-0.31284157093613923,-0.12119865343105118,0.19164291750508805
2025-09-23T13:45:00-04:00,124.68,125.5,124.38,125.23,NaN,NaN,NaN,126.21900867615325,NaN,NaN,126.1033999999997,127.65043127326676,124.55636872673263,126.68371421483297,125.93810384678793,126.66262087650793,125.21358681706792,68509,40789.63333333333,38.871702661116245,54.704976520175315,NaN,NaN,NaN,NaN,0.6308982228348506,24.27491901967447,45367286,-0.3075536014194507,-0.19279908426922532,0.11475451715022537
2025-09-23T13:50:00-04:00,125.265,125.5,124.94,125.18,NaN,NaN,NaN,126.21900867615325,NaN,NaN,126.1007999999997,127.65358248330702,124.54801751669237,126.68371421483297,125.93069026209878,126.6552398366466,125.20614068755096,27887,40745.13333333333,38.46195038544736,52.96388115150535,NaN,NaN,NaN,NaN,0.6258340640609329,25.246356301505074,45339399,-0.29235381479576933,-0.2506877513444863,0.04166606345128304
2025-09-23T13:55:00-04:00,125.19,125.7,125.1,125.63,NaN,NaN,NaN,126.21900867615325,NaN,NaN,126.08179999999967,127.6339118002554,124.52968819974394,126.68371421483297,125.92547253380528,126.64747028364411,125.20347478396644,31987,39947.5,44.166362881773665,51.773599151151515,NaN,NaN,NaN,NaN,0.6239887737708668,25.686020910584656,45371386,-0.23916312577466275,-0.2572878437670454,-0.018124717992382647
2025-09-23T14:00:00-04:00,125.62,126.25,125.54,125.96,124.14450045528415,124.14450045528415,124.14450045528415,NaN,NaN,NaN,126.0857999999997,127.63560303280092,124.53599696719847,126.68371421483297,125.92533216991721,126.64155339877229,125.20911094106214,45085,40045.566666666666,47.97496566105602,50.82079809796591,NaN,NaN,NaN,NaN,0.6301324327872331,24.94852036742097,45416471,-0.17206183746562512,-0.23320201482441405,-0.06114017735878893
2025-09-23T14:05:00-04:00,125.99,126.43,125.85,126.13,124.38997770731667,NaN,NaN,NaN,NaN,NaN,126.09979999999969,127.63825891738266,124.56134108261672,126.60497137186637,125.92811050805291,126.64001529088628,125.21620572521954,37680,39765.2,49.87197731679339,49.76042534351923,NaN,NaN,NaN,NaN,0.6265515447310029,23.923797726721794,45454151,-0.10957787790750191,-0.19811252474316632,-0.08853464683566441
2025-09-23T14:10:00-04:00,126.11,126.2,125.67,125.89,124.38997770731667,NaN,NaN,NaN,NaN,NaN,126.10319999999967,127.63903561636515,124.5673643836342,126.28097709749309,125.92804603605234,126.63711600452982,125.21897606757486,22966,39547.7,47.25241555611206,48.587230014536445,NaN,NaN,NaN,NaN,0.6196550058216456,23.24386795461601,45431185,-0.0791789749839643,-0.18750836556561978,-0.10832939058165549
2025-09-23T14:15:00-04:00,125.93,126.07,125.46,125.51,124.38997770731667,NaN,NaN,NaN,NaN,NaN,126.09759999999967,127.63999066403275,124.5552093359666,125.79778167799446,125.92602172656751,126.63254493440355,125.21949851873147,23772,39496.23333333333,43.368223255840775,46.98045207909,NaN,NaN,NaN,NaN,0.6189653625486707,22.922655329396946,45407413,-0.079237932725428,-0.20737680648844048,-0.12813887376301247
2025-09-23T14:20:00-04:00,125.52,125.87,125.46,125.52,124.38997770731667,NaN,NaN,NaN,NaN,NaN,126.09109999999966,127.64041764351987,124.54178235647944,124.60509561615694,125.92406895424013,126.62878473967717,125.21935316880308,18504,39005.96666666667,43.49984493737253,45.31256625064331,NaN,NaN,NaN,NaN,0.6040392652237665,22.624386463122097,45425917,-0.07331470863692396,-0.21978225955916741,-0.14646755092224345
2025-09-23T14:25:00-04:00,125.51,125.93,125.51,125.76,124.38997770731667,NaN,NaN,NaN,NaN,NaN,126.09329999999966,127.64041681540687,124.54618318459245,124.60509561615694,125.92309205777094,126.62613269442812,125.22005142111377,15091,38892.23333333333,46.70152516734218,44.05835241005841,NaN,NaN,NaN,NaN,0.5908936034220691,22.20720336999164,45441008,-0.04910731233679458,-0.20785169134323667,-0.1587443790064421
2025-09-23T14:30:00-04:00,125.77,126.32,125.69,126.28,124.38997770731667,NaN,NaN,NaN,NaN,NaN,126.11609999999966,127.639772261517,124.59242773848233,124.8431113315023,125.92492478948311,126.62446896871111,125.22538061025512,31443,39385.4,52.925790979098394,43.33415118232545,NaN,NaN,NaN,NaN,0.5936869174633496,20.954631447752888,45472451,0.0032721285345526097,-0.15465421833825133,-0.15792634687280394
2025-09-23T14:35:00-04:00,126.26,126.37,125.92,126.01,124.45068652274591,NaN,NaN,NaN,NaN,NaN,126.13549999999967,127.62826019524485,124.64273980475448,124.96348906520184,125.92624375565114,126.62331227783356,125.22917523346872,22605,39337.3,49.681546601781385,43.23978049704473,NaN,NaN,NaN,NaN,0.5834235662159676,19.685976126097128,45449846,0.020140032057785973,-0.13275130680057146,-0.15289133885835743
2025-09-23T14:40:00-04:00,126.01,126.07,125.81,125.97,124.45068652274591,NaN,NaN,NaN,NaN,NaN,126.15669999999967,127.60879450122398,124.70460549877536,124.96348906520184,125.92633392376024,126.62207984122246,125.23058800629802,11432,38928.566666666666,49.20037989467718,43.576899912610074,NaN,NaN,NaN,NaN,0.5603218829148264,18.73174201559774,45438414,0.02849790803954072,-0.11726895380893154,-0.14576686184847226
2025-09-23T14:45:00-04:00,125.96,126.15,125.9,126.05,124.45068652274591,NaN,NaN,NaN,NaN,NaN,126.17639999999966,127.595058577852,124.75774142214732,125.02083300172919,125.92665538019544,126.62138008388558,125.2319306765053,9076,38789,50.23840869192672,45.20377235750118,NaN,NaN,NaN,NaN,0.538156034135196,17.657902983054782,45447490,0.038676897116386444,-0.09742074045298921,-0.13609763756937565
2025-09-23T14:50:00-04:00,126.08,126.1,125.8,125.85,124.45068652274591,NaN,NaN,NaN,NaN,NaN,126.19219999999967,127.57798809364654,124.8064119063528,125.04666640138335,125.92661861654479,126.6200639317511,125.23317330133847,11160,38541.86666666667,47.61871050098321,46.416700320808665,NaN,NaN,NaN,NaN,0.5211448888398247,16.882322382639543,45436330,0.03150662683201322,-0.09671435402935913,-0.12822098086137235
2025-09-23T14:55:00-04:00,125.86,125.92,125.65,125.68,124.45068652274591,NaN,NaN,NaN,NaN,NaN,126.19539999999968,127.57569249091726,124.8151075090821,125.04666640138335,125.92560944375549,126.61719893583991,125.23401995167107,17425,38268.333333333336,45.44927875823684,46.88652718488871,NaN,NaN,NaN,NaN,0.5032059682084083,16.491380241640563,45418905,0.015680774246505533,-0.10862001305324043,-0.12430078729974596
2025-09-23T15:00:00-04:00,125.69,126.12,125.62,125.63,124.45068652274591,NaN,NaN,NaN,NaN,NaN,126.20279999999968,127.56682516123502,124.83877483876435,125.08786649688535,125.92286637884413,126.60769166023198,125.23804109745629,62960,39152.166666666664,44.80276328020495,47.33944239165711,NaN,NaN,NaN,NaN,0.5029769704792363,15.600714537762016,45355945,0.002881767706367666,-0.12069857766678638,-0.12358034537315404
2025-09-23T15:05:00-04:00,125.61,125.76,125.54,125.69,124.45068652274591,NaN,NaN,NaN,NaN,NaN,126.21079999999967,127.55790409415866,124.86369590584067,125.08786649688535,125.91810790466882,126.59751887609464,125.23869693324299,58134,38999.73333333333,45.799141050040994,47.4560694036762,NaN,NaN,NaN,NaN,0.4827643297307193,14.964042374316538,45414079,-0.0003357504116838772,-0.12400003338775889,-0.12366428297607501
2025-09-23T15:10:00-04:00,125.7,126,125.7,125.91,124.45068652274591,NaN,NaN,NaN,NaN,NaN,126.22079999999967,127.55129819259021,124.89030180740913,125.09643455800662,125.91773119747933,126.59449017420546,125.24097222075319,25024,38710.5,49.40547801691832,47.55824885766636,NaN,NaN,NaN,NaN,0.47042402046423953,14.04491501880883,45439103,0.012832481859341799,-0.10762368065189776,-0.12045616251123956
2025-09-23T15:15:00-04:00,125.94,126.35,125.89,126.18,124.64811660817608,NaN,NaN,NaN,NaN,NaN,126.23119999999967,127.5520959991186,124.91030400088074,125.39714764640529,125.91983902816007,126.59372582895537,125.24595222736477,30596,38962.3,53.49511254605586,47.81704423118511,NaN,NaN,NaN,NaN,0.46967944757393626,13.992123906587542,45469699,0.038742319903355305,-0.07202826263204543,-0.11077058253540073
2025-09-23T15:20:00-04:00,126.2,126.2,125.79,125.9,124.64811660817608,NaN,NaN,NaN,NaN,NaN,126.23199999999966,127.55204393885188,124.91195606114744,125.39714764640529,125.9200864599202,126.5920616748314,125.248111245009,18459,38374.066666666666,49.065776518811475,47.94657001423507,NaN,NaN,NaN,NaN,0.4654166298900834,13.6676843281553,45451240,0.036092096392172035,-0.06565546204518569,-0.10174755843735772
2025-09-23T15:25:00-04:00,125.9,126.2,125.88,126.02,124.64811660817608,NaN,NaN,NaN,NaN,NaN,126.22559999999967,127.54658999257406,124.90461000742529,125.39714764640529,125.92066598108605,126.59096833861004,125.25036362356205,16690,38127.46666666667,50.940576173095565,48.48745236546756,NaN,NaN,NaN,NaN,0.455029727755078,13.366419005325362,45467930,0.04112471303297234,-0.0503416671461423,-0.09146638017911464
2025-09-23T15:30:00-04:00,126.04,126.25,126.04,126.13,124.74088447673917,NaN,NaN,NaN,NaN,NaN,126.22019999999968,127.54050142031437,124.89989857968499,125.39714764640529,125.92208592709119,126.59044654867334,125.25372530550904,21252,37191.46666666667,52.660713062606604,49.14180008869857,NaN,NaN,NaN,NaN,0.4389561757725727,13.211837718192823,45489182,0.049977058781531414,-0.028995056702200372,-0.07897211548373179
2025-09-23T15:35:00-04:00,126.14,126.24,126.04,126.06,124.77243518234192,NaN,NaN,NaN,NaN,NaN,126.21819999999967,127.539162921693,124.89723707830633,125.45035167596761,125.92356105072652,126.58954929359578,125.25757280785726,25517,37146.433333333334,51.42503537809365,49.47919367518082,NaN,NaN,NaN,NaN,0.4218878775031024,13.068297951569752,45463665,0.049158394828971955,-0.017524121947516846,-0.0666825167764888
2025-09-23T15:40:00-04:00,126.09,126.16,125.93,126.1,124.77243518234192,NaN,NaN,NaN,NaN,NaN,126.21299999999968,127.5337361585412,124.89226384145816,125.45035167596761,125.92425253693132,126.58866371548918,125.25984135837346,16448,36845.46666666667,52.11647022013574,49.421385049540625,NaN,NaN,NaN,NaN,0.40818160053859437,12.561271293783745,45480113,0.049228946165925755,-0.005146334069081604,-0.05437528023500736
2025-09-23T15:45:00-04:00,126.105,126.31,126.09,126.26,124.89399569300164,NaN,NaN,NaN,NaN,NaN,126.20959999999967,127.52895869287937,124.89024130711996,125.60262507261928,125.92604376155663,126.58883718044702,125.26325034266624,20259,36358.933333333334,54.88292981543178,49.79291242194422,NaN,NaN,NaN,NaN,0.39474005764298037,12.524559048668637,45500372,0.05739905893352696,0.01737354343190134,-0.04002551550162562
2025-09-23T15:50:00-04:00,126.3,126.46,126.12,126.34,124.99699588877428,NaN,NaN,NaN,NaN,NaN,126.21019999999967,127.52976805071546,124.89063194928389,125.72410005809542,125.93145840308036,126.59106240350216,125.27185440265855,48271,37247.46666666667,56.2441518437272,50.29603898973352,NaN,NaN,NaN,NaN,0.39083005352562383,12.899289058440525,45548643,0.06498129190816847,0.04120109938358496,-0.023780192524583504
2025-09-23T15:55:00-04:00,126.33,126.46,126.12,126.19,125.00940516655727,NaN,NaN,NaN,NaN,NaN,126.21079999999967,127.53030348256017,124.89129651743916,125.72410005809542,125.93755462561296,126.592434026553,125.28267522467293,64823,38179.9,53.014408901775774,50.494324719008446,NaN,NaN,NaN,NaN,0.3871993354166499,13.24725263894299,45483820,0.05697141184944046,0.04743407228721708,-0.009537339562223386
2025-09-24T09:30:00-04:00,127.54,128.68,127.38,128.19,126.4680685680774,NaN,NaN,NaN,NaN,NaN,126.24299999999968,127.67108123034778,124.81491876965158,126.82802403718108,128.08333333333334,128.08333333333334,128.08333333333334,120750,41017.03333333333,74.24804072290253,52.396419734859826,NaN,NaN,NaN,NaN,0.5373993828868898,16.66938744851798,45604570,0.17668671639546132,0.21132105593210326,0.034634339536641946
2025-09-24T09:35:00-04:00,128.11,128.35,127.49,127.58,126.4680685680774,NaN,NaN,NaN,NaN,NaN,126.26169999999969,127.73414505515724,124.78925494484214,126.82802403718108,127.97843818984548,128.11266932846308,127.84420705122787,73738,36100.433333333334,64.65134596590772,53.76799596397917,NaN,NaN,NaN,NaN,0.5604422841092548,19.847084057409038,45530832,0.20321521078842225,0.28865335302216977,0.08543814223374752
2025-09-24T09:40:00-04:00,127.72,127.93,127.08,127.8,126.4680685680774,NaN,NaN,NaN,NaN,NaN,126.2902999999997,127.82431226867759,124.75628773132182,126.82802403718108,127.89216386493628,128.08912200272061,127.69520572715194,58094,35187.9,66.34106532155556,55.30644610978993,NaN,NaN,NaN,NaN,0.5811249781014515,21.62897949980264,45588926,0.22245084279069888,0.3635016957221211,0.14105085293142222
2025-09-24T09:45:00-04:00,127.82,128.06,126.8,126.82,126.4680685680774,NaN,NaN,NaN,NaN,NaN,126.3024999999997,127.84345068073277,124.76154931926662,126.82802403718108,127.74283760116853,128.07019979427696,127.4154754080601,73071,35339.96666666667,53.965941952069564,55.88978903136341,NaN,NaN,NaN,NaN,0.6296160510942054,22.564926680882937,45515855,0.1590188792686654,0.339824452017254,0.18080557274858858
2025-09-24T09:50:00-04:00,126.91,126.93,125.88,126.52,NaN,NaN,NaN,128.21652494199398,128.21652494199398,128.21652494199398,126.30569999999969,127.84777912911767,124.76362087088171,126.82802403718108,127.44435392992649,128.06188069383236,126.82682716602062,97103,37647.166666666664,50.83951451751318,55.99222020997731,NaN,NaN,NaN,NaN,0.6596434760160487,21.534736049827206,45418752,0.09013125195759303,0.2934696376955799,0.20333838573798685
2025-09-24T09:55:00-04:00,126.585,127.06,125.91,126.16,NaN,NaN,NaN,128.21652494199398,NaN,NaN,126.30289999999968,127.84551866981677,124.7602813301826,126.82802403718108,127.32075049065234,127.99446009446903,126.64704088683565,55349,38425.9,47.2983924255431,55.549597344226406,NaN,NaN,NaN,NaN,0.6946689420149027,20.769434294297543,45363403,0.017400836348434062,0.22508943117352942,0.20768859482509536
2025-09-24T10:00:00-04:00,126.17,126.8,125.93,126.25,NaN,NaN,NaN,128.21652494199398,NaN,NaN,126.29729999999968,127.83861270041454,124.75598729958482,126.82802403718108,127.23614392892728,127.93771517519052,126.53457268266403,44477,38405.63333333333,48.2684986273075,55.49264892340468,NaN,NaN,NaN,NaN,0.7071925890138375,20.05879694987714,45407880,-0.0252472272591677,0.17612956075113573,0.20137678801030343
2025-09-24T10:05:00-04:00,126.29,126.33,125.57,125.71,NaN,NaN,NaN,127.88532329900508,NaN,NaN,126.2908999999997,127.83924064741596,124.74255935258343,126.82802403718108,127.09707108277046,127.87985362883333,126.31428853670758,59228,39123.9,43.13766444111747,54.93529808540625,NaN,NaN,NaN,NaN,0.7109645469414209,18.721150077123735,45348652,-0.08695215812451484,0.09268659035465987,0.17963874847917471
2025-09-24T10:10:00-04:00,125.73,125.78,125.32,125.47,NaN,NaN,NaN,127.46008133086849,NaN,NaN,126.27249999999971,127.83746932890764,124.70753067109177,126.82802403718108,126.96783303673976,127.83334610626036,126.10231996721916,52054,40093.5,41.049181846931916,54.10590299857235,NaN,NaN,NaN,NaN,0.6930385078741771,17.724386695490626,45296598,-0.13802340905334373,0.007109487162495043,0.14513289621583877
2025-09-24T10:15:00-04:00,125.46,126.4,125,126.4,NaN,NaN,NaN,127.46008133086849,NaN,NaN,126.2604999999997,127.8121162542439,124.70888374575549,126.82802403718108,126.8517256582633,127.73017206817623,125.97327924835038,80136,41972.3,50.957562255884135,54.072512061271674,NaN,NaN,NaN,NaN,0.7435357573117363,17.154127984501333,45376734,-0.10477118610648198,0.014168913582736309,0.11894009968921829
2025-09-24T10:20:00-04:00,126.36,126.9,126.26,126.745,NaN,NaN,NaN,127.46008133086849,NaN,NaN,126.25459999999971,127.79652845502743,124.712671544972,126.43841922974485,126.83578803748406,127.6832082842911,125.98836779067703,56674,43244.63333333333,54.043456390297855,54.21015393056897,NaN,NaN,NaN,NaN,0.7361403460751836,17.316703075505284,45433408,-0.0575043184322164,0.047059701648947794,0.1045640200811642
2025-09-24T10:25:00-04:00,126.78,127.12,126.57,126.96,NaN,NaN,NaN,127.46008133086849,NaN,NaN,126.25519999999972,127.79820221659561,124.71219778340382,125.9757353837959,126.83821203516256,127.66381396369296,126.01261010663215,41402,44121.666666666664,55.905531248645076,54.2831968900842,NaN,NaN,NaN,NaN,0.7228446070698142,17.746238972682264,45474810,-0.012096382582564777,0.08944354185295822,0.101539924435523
2025-09-24T10:30:00-04:00,126.93,127.34,126.92,127.175,NaN,NaN,NaN,127.46008133086849,NaN,NaN,126.25929999999971,127.81094301320297,124.70765698679645,125.86658830703671,126.8558214329518,127.66054897347121,126.05109389243239,49451,44721.933333333334,57.74914510075612,54.39069640844342,NaN,NaN,NaN,NaN,0.7012128494219704,18.41642952302545,45524261,0.029793621885384577,0.13878195179225372,0.10898832990686914
2025-09-24T10:35:00-04:00,127.18,127.39,126.82,126.91,NaN,NaN,NaN,127.46008133086849,NaN,NaN,126.2522999999997,127.78890692450307,124.71569307549635,125.64178368160145,126.86439434837045,127.6511273513291,126.07766134541181,42059,45370.4,54.71269563421286,54.51200260361749,NaN,NaN,NaN,NaN,0.6918405030346874,18.82372792357956,45482202,0.03658232753939136,0.15471623933110834,0.11813391179171698
2025-09-24T10:40:00-04:00,126.9,127.11,126.64,126.98,NaN,NaN,NaN,127.46008133086849,NaN,NaN,126.24769999999971,127.77415499128453,124.72124500871489,125.64178368160145,126.86621455440813,127.63713940327231,126.09528970554395,37563,46241.433333333334,55.3800953021081,53.164292216417884,NaN,NaN,NaN,NaN,0.6759947528179239,18.812851841082438,45519765,0.04230988280839873,0.1710212653022154,0.12871138249381667
2025-09-24T10:45:00-04:00,126.94,127.21,126.7,127.14,NaN,NaN,NaN,127.46008133086849,NaN,NaN,126.24259999999971,127.75533029996146,124.72986970003797,125.64814155622493,126.86886297819896,127.63322846930451,126.10449748709341,16864,46501.03333333333,56.94205366740067,52.613628480810235,NaN,NaN,NaN,NaN,0.6641379847595,18.951381427046535,45536629,0.05271923862470834,0.19461043077470208,0.14189119214999374
2025-09-24T10:50:00-04:00,127.17,127.7,127.17,127.63,125.5388911039364,125.5388911039364,125.5388911039364,NaN,NaN,NaN,126.2455999999997,127.76869374643822,124.72250625356118,126.17051324497994,126.8931115791805,127.65240298844229,126.1338201699187,38278,47404.96666666667,61.398657273899225,52.26059933454907,NaN,NaN,NaN,NaN,0.6566995572766787,19.753345493691977,45574907,0.08645705194099179,0.24996250707623346,0.16350545513524167
2025-09-24T10:55:00-04:00,127.64,127.98,127.51,127.96,125.87098696284838,NaN,NaN,NaN,NaN,NaN,126.2573999999997,127.82368508274307,124.69111491725634,126.52141059598397,126.93626095089557,127.70279645187098,126.16972544992016,48829,48451.76666666667,64.0940361924643,52.9840346374344,NaN,NaN,NaN,NaN,0.6433638746140586,20.838194253604772,45623736,0.1226402192271355,0.31680572916916105,0.19416550994202555
2025-09-24T11:00:00-04:00,127.98,128.59,127.87,128.57,126.3429875554462,NaN,NaN,NaN,NaN,NaN,126.28239999999971,127.95221105526893,124.61258894473049,127.06312847678717,127.04139561104047,127.86635165343097,126.21643956864997,84396,49166.3,68.47591608235717,54.24377760635183,NaN,NaN,NaN,NaN,0.6488378835701972,22.486617243265684,45708132,0.17604872958997847,0.41422642192949866,0.2381776923395202
2025-09-24T11:05:00-04:00,128.59,129.14,128.31,128.9,126.81057903019862,NaN,NaN,NaN,NaN,NaN,126.3257999999997,128.1459245672499,124.50567543274953,127.50350278142973,127.24350132301115,128.19890764320263,126.28809500281966,148251,52170.2,70.56846483144673,55.90592563534494,NaN,NaN,NaN,NaN,0.6617780347437534,24.490509195558758,45856383,0.21918379238166996,0.5121574328166076,0.2929736404349377
2025-09-24T11:10:00-04:00,128.89,129.25,128.75,128.76,127.10441634700778,NaN,NaN,NaN,NaN,NaN,126.37479999999972,128.31831635966503,124.43128364033441,127.6908022251438,127.30797757725712,128.29875156507478,126.31720358943946,51107,53039.63333333333,68.49131700355356,57.35041266221966,NaN,NaN,NaN,NaN,0.6502224608334853,26.438918999387745,45805276,0.22312457980319722,0.5718793651889342,0.348754785385737
2025-09-24T11:15:00-04:00,128.74,129.47,128.73,129.43,127.18967014941651,NaN,NaN,NaN,NaN,NaN,126.47499999999971,128.51904892316682,124.43095107683261,127.85264178011504,127.38674973147694,128.42819111990627,126.3453083430476,57413,53933.53333333333,72.6416097109976,59.45783732435397,NaN,NaN,NaN,NaN,0.6566351422025228,28.422924033804307,45862689,0.2534763337950035,0.6656002026294914,0.41212386883448787
2025-09-24T11:20:00-04:00,129.43,129.79,129.26,129.78,127.62923059717029,NaN,NaN,NaN,NaN,NaN,126.57799999999972,128.75451556399042,124.40148443600901,128.23111342409203,127.49094703300825,128.61102189557556,126.37087217044095,68166,55590.433333333334,74.52904321676006,61.8492559936274,NaN,NaN,NaN,NaN,0.6475897749023428,30.50595796125991,45930855,0.2777915046101017,0.759363249597115,0.4815717449870133
2025-09-24T11:25:00-04:00,129.775,130.06,129.48,130.01,127.88131102457164,NaN,NaN,NaN,NaN,NaN,126.67359999999971,129.01829276458704,124.32890723541237,128.5228907392736,127.6712671566246,128.91687586259144,126.42565845065775,120376,59046.63333333333,75.71472623084352,63.61762484898164,NaN,NaN,NaN,NaN,0.6427619338378907,32.63014782243505,46051231,0.28875715791645706,0.8425181923825846,0.5537610344661276
2025-09-24T11:30:00-04:00,130.01,130.05,129.14,129.15,127.88131102457164,NaN,NaN,NaN,NaN,NaN,126.75299999999972,129.15809958219876,124.34790041780069,128.5228907392736,127.73291137084861,128.99913117561587,126.46669156608135,56647,60226.46666666667,63.762611951929735,64.31185024624106,NaN,NaN,NaN,NaN,0.661850367135186,33.7056880889497,45994584,0.22056136507157464,0.8294627408055959,0.6089013757340213
2025-09-24T11:35:00-04:00,129.17,129.49,129.02,129.21,127.88131102457164,NaN,NaN,NaN,NaN,NaN,126.82459999999972,129.3037239098307,124.34547609016876,128.5228907392736,127.76204335308523,129.03301794445665,126.49106876171382,32158,60447.833333333336,64.1873665807684,64.9034099128213,NaN,NaN,NaN,NaN,0.6481467694826726,34.39929418508774,46026742,0.16453319428657087,0.8145678685922348,0.650034674305664
2025-09-24T11:40:00-04:00,129.18,129.35,129.04,129.19,127.88131102457164,NaN,NaN,NaN,NaN,NaN,126.88919999999973,129.44207474042113,124.33632525957835,128.5228907392736,127.7805754433367,129.05361988864303,126.50753099803038,21823,60627,63.918417122448794,65.34407220008507,NaN,NaN,NaN,NaN,0.623993428805339,35.04335698864448,46004919,0.1135881250405486,0.7920198306063497,0.6784317055658011
2025-09-24T11:45:00-04:00,129.19,129.19,128.42,128.5,127.88131102457164,NaN,NaN,NaN,NaN,NaN,126.93659999999974,129.51916573203326,124.35403426796621,128.5228907392736,127.80665867486118,129.07086604823357,126.5424513014888,49028,61585.96666666667,55.30819458502333,65.38660783942866,NaN,NaN,NaN,NaN,0.6344224696049584,34.12828046143489,45955891,0.025482945004431157,0.7102853868213401,0.684802441816909
2025-09-24T11:50:00-04:00,128.45,128.72,127.91,128.46,127.88131102457164,NaN,NaN,NaN,NaN,NaN,126.98799999999974,129.58744378671292,124.38855621328656,128.5228907392736,127.82499132633156,129.07217063790952,126.57781201475359,59066,61945.8,54.84694457618985,65.34852564472023,NaN,NaN,NaN,NaN,0.646963721776033,32.26832795951189,45896825,-0.03987145274442927,0.6349631258863724,0.6748345786308017
2025-09-24T11:55:00-04:00,128.48,128.5,127.94,128.15,127.88131102457164,NaN,NaN,NaN,NaN,NaN,127.04079999999975,129.62521820150658,124.4563817984929,128.5228907392736,127.83043572990132,129.06925185406672,126.59161960573593,26663,60673.8,51.27781125621185,64.94393690106388,NaN,NaN,NaN,NaN,0.6407520273634594,30.541229207726257,45870162,-0.10468000951328305,0.5439845667391978,0.6486645762524809
2025-09-24T12:00:00-04:00,128.155,128.5,128.05,128.26,127.88131102457164,NaN,NaN,NaN,NaN,NaN,127.09559999999973,129.66485953540877,124.5263404645907,128.5228907392736,127.83628706851235,129.06786094659006,126.60471319043464,24557,57467.36666666667,52.45999565494857,64.30546107113884,NaN,NaN,NaN,NaN,0.627126882551783,28.93749465249673,45894719,-0.13870706637398655,0.4752807432849977,0.6139878096589843
2025-09-24T12:05:00-04:00,128.29,128.55,127.72,127.76,NaN,NaN,NaN,130.03292442713976,130.03292442713976,130.03292442713976,127.13559999999974,129.6826183666957,124.58858163330379,128.5228907392736,127.84103007964266,129.05600417333824,126.62605598594709,51783,56735.53333333333,46.890621152836516,63.076645711165426,NaN,NaN,NaN,NaN,0.6416178195123708,26.95297680699651,45842936,-0.1902697543483023,0.3761506167236064,0.5664203710719087
2025-09-24T12:10:00-04:00,127.75,127.79,126.85,127.45,NaN,NaN,NaN,129.25983695317888,NaN,NaN,127.15899999999976,129.69562295193106,124.62237704806847,128.5228907392736,127.8194676732413,129.01083915017267,126.62809619630994,89654,57787.53333333333,43.786792900984445,61.31313691249595,NaN,NaN,NaN,NaN,0.6629308324043451,26.489523406225572,45753282,-0.23756141549293552,0.2694686017057393,0.5070300171986748
2025-09-24T12:15:00-04:00,127.47,127.82,127.31,127.74,NaN,NaN,NaN,129.25983695317888,NaN,NaN,127.19359999999975,129.71373018716753,124.67346981283197,128.3653125914189,127.8152749704292,128.99418523190928,126.63636470894912,43386,56798.03333333333,47.301058457579394,59.65117931436257,NaN,NaN,NaN,NaN,0.6520072015183198,25.997199497063527,45796668,-0.240864923931089,0.20594886228481357,0.44681378621590256
2025-09-24T12:20:00-04:00,127.8,128.4,127.66,128.36,NaN,NaN,NaN,129.25983695317888,NaN,NaN,127.24139999999976,129.75754390690844,124.72525609309109,127.92880005850807,127.81967207448297,128.9911746265436,126.64816952242234,27860,54489.933333333334,53.93198326733489,58.61122690463266,NaN,NaN,NaN,NaN,0.6582924014098691,24.42605063634953,45824528,-0.1948155261303816,0.20329437855292554,0.39810990468330715
2025-09-24T12:25:00-04:00,128.36,128.4,128.12,128.2,NaN,NaN,NaN,129.25983695317888,NaN,NaN,127.28439999999975,129.7910995353016,124.7777004646979,127.92880005850807,127.82320885180886,128.9904039292813,126.6560137743364,17459,53226.933333333334,52.10974916499404,57.14466543706097,NaN,NaN,NaN,NaN,0.6312715155948786,22.967126694257956,45807069,-0.16958042213616226,0.1861343770131043,0.35571479914926657
2025-09-24T12:30:00-04:00,128.17,128.19,127.78,127.87,NaN,NaN,NaN,129.25983695317888,NaN,NaN,127.32479999999975,129.80267163514898,124.84692836485054,127.66804004680645,127.82490820179804,128.98413169446573,126.66568470913035,28959,52709.666666666664,48.472042001408845,55.28345106453589,NaN,NaN,NaN,NaN,0.6161806930523863,22.170826625591825,45778110,-0.16917667487475535,0.14424395555582237,0.3134206304305777
2025-09-24T12:35:00-04:00,127.86,127.975,127.39,127.55,NaN,NaN,NaN,129.25983695317888,NaN,NaN,127.36219999999976,129.7956914506261,124.92870854937344,127.09743203744516,127.82319479033032,128.97722038026362,126.66916920039702,19500,51385.4,45.17851360104264,53.10229301955011,NaN,NaN,NaN,NaN,0.6139535006915011,22.00712066637865,45758610,-0.1833341415476013,0.08425295349607609,0.2675870950436774
2025-09-24T12:40:00-04:00,127.56,127.94,127.5,127.79,NaN,NaN,NaN,129.25983695317888,NaN,NaN,127.40539999999976,129.79056568822352,125.02023431177601,127.01255650396492,127.82264560332695,128.97271531419184,126.67257589246205,14703,50140.36666666667,48.03060665475611,51.978578355466276,NaN,NaN,NaN,NaN,0.601528250642108,21.85510798996642,45773313,-0.169720389888605,0.055436607682921135,0.22515699757152613
2025-09-24T12:45:00-04:00,127.75,127.92,127.53,127.83,NaN,NaN,NaN,129.25983695317888,NaN,NaN,127.44819999999976,129.785014720997,125.11138527900252,127.01255650396492,127.82222867419313,128.9684762487376,126.67598109964865,14325,47946.666666666664,48.51139885134287,50.85886637479303,NaN,NaN,NaN,NaN,0.5864190898819575,21.713953361869347,45787638,-0.1517905376188041,0.035418825548021005,0.1872093631668251
2025-09-24T12:50:00-04:00,127.81,128.17,127.66,128,NaN,NaN,NaN,129.25983695317888,NaN,NaN,127.48999999999977,129.7897365067038,125.19026349329575,126.94504520317193,127.823195293121,128.96491006880618,126.68148051743583,17318,46634.8,50.60302346662392,49.9077668279484,NaN,NaN,NaN,NaN,0.580960583461817,20.99898922803923,45804956,-0.12345309195097467,0.03289299822810676,0.15634609017908144
2025-09-24T12:55:00-04:00,127.97,127.98,127.71,127.89,NaN,NaN,NaN,129.25983695317888,NaN,NaN,127.52419999999977,129.79568001097655,125.25271998902299,126.90277051521922,127.82345382773156,128.96115570207326,126.68575195338985,15349,45766.36666666667,49.21001238078675,49.47218238478864,NaN,NaN,NaN,NaN,0.5601776846431162,20.33509396091126,45789607,-0.10766543539756149,0.021764295932129585,0.12942973132969107
2025-09-24T13:00:00-04:00,127.86,128.46,127.83,128.13,NaN,NaN,NaN,129.25983695317888,NaN,NaN,127.56879999999977,129.79814569779296,125.33945430220658,127.21095957915331,127.82677902868492,128.95894961835998,126.69460843900987,23197,44891.23333333333,52.29561268592059,49.289944392626545,NaN,NaN,NaN,NaN,0.5651649928828943,19.09836707454837,45812804,-0.07798978493370685,0.03194250016255751,0.10993228509626436
2025-09-24T13:05:00-04:00,128.13,128.21,127.89,128.21,NaN,NaN,NaN,129.25983695317888,NaN,NaN,127.61259999999979,129.80424252565263,125.42095747434693,127.21095957915331,127.82858780269223,128.9572700667368,126.69990553864764,14538,43973.86666666667,53.31376749990422,49.43536983860457,NaN,NaN,NaN,NaN,0.5476532076769739,17.949977822925693,45827342,-0.05119812729121863,0.04593462598224107,0.0971327532734597
2025-09-24T13:10:00-04:00,128.2,128.31,128.05,128.1,NaN,NaN,NaN,129.25983695317888,NaN,NaN,127.65199999999979,129.80612255924336,125.49787744075621,127.25261413065812,127.83054575706281,128.95610114061793,126.70499037350768,13483,43171.2,51.680455288231116,49.37968838383904,NaN,NaN,NaN,NaN,0.5271065499857609,17.097440625321827,45813859,-0.039627228678594306,0.04759871742521682,0.08722594610381113
2025-09-24T13:15:00-04:00,128.1,128.14,127.8,128.075,NaN,NaN,NaN,129.25983695317888,NaN,NaN,127.69229999999979,129.80068915768462,125.58391084231498,127.25261413065812,127.83141597285744,128.95422785769077,126.70860408802412,11211,42982.76666666667,51.29582466507019,49.694345777570014,NaN,NaN,NaN,NaN,0.5137417964153487,16.02761973820907,45802648,-0.03268815268160999,0.046365755251798646,0.07905390793340863
2025-09-24T13:20:00-04:00,128.04,128.08,127.73,127.815,NaN,NaN,NaN,129.25983695317888,NaN,NaN,127.72659999999978,129.78547584867442,125.66772415132513,127.25261413065812,127.83173024946029,128.95049269016272,126.71296780875787,16324,42250.96666666667,47.34901234939721,49.94879002388522,NaN,NaN,NaN,NaN,0.502045953814253,15.192316085995024,45786324,-0.04393861928194423,0.024130633830978354,0.06806925311292258
2025-09-24T13:25:00-04:00,127.815,128.13,127.62,128.09,NaN,NaN,NaN,129.25983695317888,NaN,NaN,127.7631999999998,129.78114525204256,125.74525474795703,127.25261413065812,127.83261402618255,128.94711215718416,126.71811589518094,17542,41208.066666666666,51.59158556438752,50.25525624580008,NaN,NaN,NaN,NaN,0.5026140999703771,14.66854413404159,45803866,-0.031757575598873114,0.028372283614331195,0.06012985921320431
2025-09-24T13:30:00-04:00,128.11,128.37,128.1,128.33,NaN,NaN,NaN,129.25983695317888,NaN,NaN,127.8029999999998,129.78527848705167,125.82072151294793,127.39385474791757,127.8350609802164,128.94688825140653,126.72323370902626,12934,38826,54.999607318213904,50.33151510657716,NaN,NaN,NaN,NaN,0.48671309282963593,13.673443746858089,45816800,-0.007689901946979792,0.05051748177947957,0.05820738372645936
2025-09-24T13:35:00-04:00,128.32,128.39,128.04,128.1,NaN,NaN,NaN,129.25983695317888,NaN,NaN,127.84119999999979,129.77057975532094,125.91182024467864,127.43408379833404,127.83675292186891,128.94608263327325,126.72742321046456,11420,34264.96666666667,51.27413676217077,50.27182850637549,NaN,NaN,NaN,NaN,0.4769478719132329,12.795276226787589,45805380,-0.0074103612879564615,0.04894443211651378,0.05635479340447024
2025-09-24T13:40:00-04:00,128.07,128.13,127.85,127.86,NaN,NaN,NaN,129.25983695317888,NaN,NaN,127.83459999999981,129.76141793645002,125.90778206354962,127.43408379833404,127.83789371609112,128.94150776817375,126.73427966400848,24182,33367.46666666667,47.6473006033174,50.212918406511825,NaN,NaN,NaN,NaN,0.4628801667765735,12.450761714493582,45781198,-0.02267670244525872,0.028008915347896846,0.050685617793155564
2025-09-24T13:45:00-04:00,127.85,127.85,127.36,127.38,NaN,NaN,NaN,129.12447111812426,NaN,NaN,127.83059999999982,129.76034365142428,125.90085634857537,127.43408379833404,127.83498173297777,128.9337687339924,126.73619473196314,22246,32195.233333333334,41.34791903093486,49.93930450864698,NaN,NaN,NaN,NaN,0.4655315834353897,13.160216366137782,45758952,-0.062151168845701,-0.02700334326397069,0.03514782558173031
2025-09-24T13:50:00-04:00,127.36,127.65,127.27,127.62,NaN,NaN,NaN,128.9622224309368,NaN,NaN,127.82699999999981,129.7576299490613,125.89637005093832,127.43408379833404,127.83327832065429,128.92940056660484,126.73715607470373,12523,30340.466666666667,45.245826537929474,49.74039164315936,NaN,NaN,NaN,NaN,0.4594221846185768,13.985562050838778,45771475,-0.0686391293676358,-0.05065108612781444,0.01798804323982136
2025-09-24T13:55:00-04:00,127.65,127.8,127.48,127.57,NaN,NaN,NaN,128.9622224309368,NaN,NaN,127.84199999999983,129.7526522447044,125.93134775529526,127.43408379833404,127.83185577946298,128.92451293391838,126.73919862500759,15632,26849,44.58110103643416,49.4596560849516,NaN,NaN,NaN,NaN,0.44946345714582087,14.29615517482775,45755843,-0.07246235749533693,-0.0725899036293498,-0.0001275461340128764
2025-09-24T14:00:00-04:00,127.58,127.65,127.42,127.5,NaN,NaN,NaN,128.9622224309368,NaN,NaN,127.86159999999981,129.7373925685448,125.98580743145482,127.43408379833404,127.82985117281183,128.9192348569601,126.74046748866357,15567,25479.666666666668,43.61502206332557,48.96051312757315,NaN,NaN,NaN,NaN,0.4337874959211197,14.710360921000554,45740276,-0.07552615995276481,-0.09453524607496888,-0.019009086122204078
2025-09-24T14:05:00-04:00,127.5,127.55,127.34,127.45,NaN,NaN,NaN,128.84987809287244,NaN,NaN,127.88739999999981,129.70339916305144,126.0714008369482,127.43408379833404,127.8278922701003,128.91483141173592,126.7409531284647,12311,24818.1,42.89990876263328,48.50979144056219,NaN,NaN,NaN,NaN,0.41780267478389643,15.266409473541545,45727965,-0.07650486685278608,-0.11464016968818669,-0.038135302835400606
2025-09-24T14:10:00-04:00,127.455,127.455,126.93,127.18,NaN,NaN,NaN,128.60511090683278,NaN,NaN,127.90599999999982,129.67292274879154,126.13907725120812,127.43408379833404,127.81981602183322,128.90222893489653,126.73740310876991,30799,25117.3,39.16550765971734,47.57192679583339,NaN,NaN,NaN,NaN,0.4254596265850461,16.569974486493493,45697166,-0.0899908867925086,-0.15062391132603636,-0.06063302453352776
2025-09-24T14:15:00-04:00,127.16,127.24,126.92,127.19,NaN,NaN,NaN,128.47203768379492,NaN,NaN,127.93559999999981,129.6010520588176,126.27014794118202,127.43408379833404,127.81454255761294,128.89459397531786,126.73449113990802,18430,24097.366666666665,39.37599700761484,46.576371760669865,NaN,NaN,NaN,NaN,0.4179267961146852,17.798099123973635,45715596,-0.09253523548552675,-0.1763020688904362,-0.08376683340490945
2025-09-24T14:20:00-04:00,127.16,127.21,127,127.01,NaN,NaN,NaN,128.4623996072588,NaN,NaN,127.96639999999981,129.50006885611316,126.43273114388647,127.43408379833404,127.81174025998774,128.89070738646873,126.73277313350675,9326,22439.366666666665,36.90099529913502,45.52069604716299,NaN,NaN,NaN,NaN,0.40307488210649295,18.938500573062342,45706270,-0.1000026272594133,-0.20877011747917606,-0.10876749021976277
2025-09-24T14:25:00-04:00,127.02,127.07,126.75,126.81,NaN,NaN,NaN,128.24933598874702,NaN,NaN,127.97459999999981,129.47878195714708,126.47041804285253,127.22526703866724,127.79943214153221,128.87655976354017,126.72230451952424,32902,22647.333333333332,34.319744742212166,44.308118909815995,NaN,NaN,NaN,NaN,0.3971409619560287,20.4581929703744,45673368,-0.11121266110550257,-0.247783316601641,-0.13657065549613842
2025-09-24T14:30:00-04:00,126.82,127.12,126.69,127.08,NaN,NaN,NaN,128.24209344380398,NaN,NaN,127.9812999999998,129.4663775199332,126.49622248006644,126.87621363093379,127.79405030139849,128.86978569864277,126.7183149041542,16194,22368.566666666666,40.38268066933341,43.810523789811434,NaN,NaN,NaN,NaN,0.39948803610202716,21.974185231494467,45689562,-0.09393308385254334,-0.2539870103118176,-0.16005392645927424
2025-09-24T14:35:00-04:00,127.07,127.63,127.07,127.56,NaN,NaN,NaN,128.24209344380398,NaN,NaN,127.9932999999998,129.45468100446885,126.53191899553077,126.86477672379763,127.79109783632856,128.86309046692213,126.71910520573499,20016,21309.666666666668,49.33645033446284,43.64944270195967,NaN,NaN,NaN,NaN,0.4109531763804539,21.524777626784775,45709578,-0.04608679239041388,-0.2176624169472916,-0.17157562455687772
2025-09-24T14:40:00-04:00,127.57,127.59,127.42,127.49,NaN,NaN,NaN,128.24209344380398,NaN,NaN,127.99959999999982,129.44948667150285,126.54971332849676,126.86477672379763,127.79053083099126,128.8615558368291,126.71950582515342,4949,18486.166666666668,48.199561383011215,43.16372513515948,NaN,NaN,NaN,NaN,0.3937422352104217,21.10747056526863,45704629,-0.01658473227578436,-0.19230653990160818,-0.17572180762582382
2025-09-24T14:45:00-04:00,127.52,127.56,127.26,127.34,NaN,NaN,NaN,128.24209344380398,NaN,NaN,128.00819999999982,129.4370817446578,126.57931825534185,126.7868213790381,127.7885863997217,128.85739569246326,126.71977710698013,12292,17449.7,45.765847296042,42.770275887578855,NaN,NaN,NaN,NaN,0.3870463612668199,21.09692714211236,45692337,-0.005194640869816747,-0.18221510871309476,-0.17702046784327802
2025-09-24T14:50:00-04:00,127.33,127.49,127.24,127.395,NaN,NaN,NaN,128.24209344380398,NaN,NaN,128.0164999999998,129.42608610954605,126.60691389045357,126.75445710323048,127.78678945745557,128.85362121147264,126.7199577034385,11141,16892.4,46.826032285721446,42.71161386489343,NaN,NaN,NaN,NaN,0.3772573354620471,21.13430741883929,45703478,0.007340592743901503,-0.16784472691340113,-0.17518531965730263
2025-09-24T14:55:00-04:00,127.42,127.5,127.34,127.34,NaN,NaN,NaN,128.24209344380398,NaN,NaN,128.0204999999998,129.42122159983046,126.61977840016912,126.78388119669525,127.78514274999554,128.8500426711906,126.72024282880048,10777,16669.666666666668,45.86057520413715,43.03394644869359,NaN,NaN,NaN,NaN,0.36173895435761494,21.130110042408035,45692701,0.012899787933168011,-0.15906058474084261,-0.17196037267401063
2025-09-24T15:00:00-04:00,127.33,127.69,127.28,127.68,NaN,NaN,NaN,128.24209344380398,NaN,NaN,128.0214999999998,129.42117603402716,126.62182396597247,126.91210495735619,127.78333677080171,128.8443380115602,126.72233553004321,19930,16368.7,52.39489056879911,43.54459387946999,NaN,NaN,NaN,NaN,0.36518617190349933,20.400201246100146,45712631,0.0389736911702723,-0.12324325871117026,-0.16221694988144256
2025-09-24T15:05:00-04:00,127.7,127.73,127.38,127.4,NaN,NaN,NaN,128.24209344380398,NaN,NaN,128.0102999999998,129.42068634431328,126.59991365568632,126.93268396588496,127.78244841973499,128.84188226164738,126.7230145778226,8259,15994,47.32877054873703,43.74085598749162,NaN,NaN,NaN,NaN,0.36410144533896427,19.57446144279222,45704372,0.036883198390366634,-0.11611295189348425,-0.15299615028385088
2025-09-24T15:10:00-04:00,127.39,127.45,127.19,127.2,NaN,NaN,NaN,128.24209344380398,NaN,NaN,127.9828999999998,129.4019321913963,126.56386780860329,126.93268396588496,127.78037345505803,128.8381083648541,126.72263854526196,10795,15863.733333333334,44.05226135049048,43.77208736514626,NaN,NaN,NaN,NaN,0.3566656278147529,19.37556651654038,45693577,0.022270743743498966,-0.12515772060447716,-0.14742846434797613
2025-09-24T15:15:00-04:00,127.22,127.32,127.16,127.23,NaN,NaN,NaN,128.24209344380398,NaN,NaN,127.9494999999998,129.35919961346985,126.53980038652975,126.93268396588496,127.77928572055805,128.83624130061628,126.72233014049982,5240,15560.9,44.67101083036611,43.89859465569861,NaN,NaN,NaN,NaN,0.34261808297084173,19.2777292263141,45698817,0.015203078155804961,-0.12842461665321991,-0.14362769480902488
2025-09-24T15:20:00-04:00,127.24,127.24,127.13,127.16,NaN,NaN,NaN,128.24209344380398,NaN,NaN,127.91749999999982,129.32479137004572,126.51020862995394,126.93268396588496,127.77706588013062,128.8327043955273,126.72142736473396,9684,15306.433333333332,43.463155198305714,44.20556947988349,NaN,NaN,NaN,NaN,0.3260025056157816,19.277617374330195,45689133,0.006818421620276599,-0.13510466778367913,-0.14192308940395573
2025-09-24T15:25:00-04:00,127.17,127.27,127.05,127.17,NaN,NaN,NaN,128.24209344380398,NaN,NaN,127.87229999999983,129.22654696425548,126.51805303574419,126.93268396588496,127.77286371103268,128.82609873697862,126.71962868508675,18124,15398.933333333332,43.69736475636063,44.51423860479391,NaN,NaN,NaN,NaN,0.3184308980717971,19.523126791255223,45707257,0.003137710766892454,-0.13800095094534015,-0.1411386617122326
2025-09-24T15:30:00-04:00,127.2,127.35,127.18,127.19,NaN,NaN,NaN,128.24209344380398,NaN,NaN,127.82049999999983,129.07323660447872,126.56776339552093,126.93268396588496,127.76850297028913,128.81851753666777,126.7184884039105,21841,15353.733333333334,44.19528367822238,45.03525920330015,NaN,NaN,NaN,NaN,0.30854297678095394,19.366638815192566,45729098,0.0032293160421767997,-0.1371020166595116,-0.1403313327016884
2025-09-24T15:35:00-04:00,127.18,127.21,126.89,126.97,NaN,NaN,NaN,128.1312094541269,NaN,NaN,127.75969999999982,128.86826557776115,126.65113442223848,126.93268396588496,127.76176245099767,128.8093954571812,126.71412944481412,24362,15681.2,40.00431762143119,45.44130012324437,NaN,NaN,NaN,NaN,0.3093613355823139,20.084590197491803,45704736,-0.009643065695629893,-0.15238516482122577,-0.14274209912559588
2025-09-24T15:40:00-04:00,126.97,127.155,126.88,126.89,NaN,NaN,NaN,128.0870635698484,NaN,NaN,127.71449999999984,128.77592404352364,126.65307595647604,126.93268396588496,127.75646388031124,128.80254420342808,126.7103835571944,18261,15840.466666666667,38.571926763212474,45.31196055852144,NaN,NaN,NaN,NaN,0.30690695446929184,20.778482342594,45686475,-0.02100978038597745,-0.1690043246080677,-0.14799454422209024
2025-09-24T15:45:00-04:00,126.89,127.1,126.77,127.09,NaN,NaN,NaN,128.0009470439462,NaN,NaN,127.67209999999983,128.6578526871273,126.68634731287236,126.93268396588496,127.75078715203027,128.7950822013003,126.70649210276025,20144,16138.233333333334,43.97296220745506,44.92885426373517,NaN,NaN,NaN,NaN,0.3085564577214851,21.724274011044088,45706619,-0.012920078765645826,-0.16414464267914752,-0.1512245639135017
2025-09-24T15:50:00-04:00,127.15,127.3,126.98,127.17,NaN,NaN,NaN,128.0009470439462,NaN,NaN,127.63169999999984,128.5267008045663,126.73669919543337,126.93268396588496,127.74402886441787,128.78436490960803,126.70369281922771,31078,16630.033333333333,46.0175574226861,44.77299683799766,NaN,NaN,NaN,NaN,0.30937385359852143,21.594302241889444,45737697,-0.000688220046890814,-0.15208483897211522,-0.1513966189252244
2025-09-24T15:55:00-04:00,127.13,127.13,126.73,126.77,NaN,NaN,NaN,128.0009470439462,NaN,NaN,127.59709999999984,128.48890959861004,126.70529040138966,126.78132748194118,127.73318045429728,128.7714743418235,126.69488656677106,34992,17211.7,38.46011357891656,44.25115871534585,NaN,NaN,NaN,NaN,0.3187042926271983,22.184013034223533,45702705,-0.017132261791762166,-0.17281194616492712,-0.15567968437316496
2025-09-25T09:30:00-04:00,123.36,124.22,122.35,122.46,NaN,NaN,NaN,124.91185721017898,NaN,NaN,127.47709999999985,129.14723183915595,125.80696816084377,126.78132748194118,123.01,123.01,123.01,185216,22954.433333333334,13.236116466793163,41.85187901399383,NaN,NaN,NaN,NaN,0.61165398601097,26.243362104594098,45517489,-0.3001757961989174,-0.5308994296218117,-0.23072363342289431
2025-09-25T09:35:00-04:00,122.46,122.59,121.42,121.92,NaN,NaN,NaN,123.7174546097163,NaN,NaN,127.35249999999984,129.62439898547103,125.08060101452864,126.78132748194118,122.51014866185744,123.02654162189519,121.9937557018197,173540,28358.433333333334,12.160048221071364,39.44469851520341,NaN,NaN,NaN,NaN,0.6515358441530437,30.219795013620836,45343949,-0.4942043639839906,-0.8484790884028826,-0.35427472441889196
2025-09-25T09:40:00-04:00,121.94,122.05,120.62,121.1,NaN,NaN,NaN,123.16461576382011,NaN,NaN,127.20929999999984,130.06256410277223,124.35603589722747,126.78132748194118,121.9717529832752,122.7046407806532,121.2388651858972,270111,36556.066666666666,10.73309717802249,36.468856130147934,NaN,NaN,NaN,NaN,0.70714042671354,34.05874974716823,45073838,-0.6390113312126753,-1.153038888434736,-0.5140275572220607
2025-09-25T09:45:00-04:00,121.09,122.63,120.96,122.54,NaN,NaN,NaN,123.16461576382011,NaN,NaN,127.10489999999986,130.2381803832656,123.97161961673413,126.78132748194118,121.98098350293941,122.66540741050677,121.29655959537205,93100,38917.86666666667,26.94570426144817,35.01292282391302,NaN,NaN,NaN,NaN,0.7759161105197159,36.55434166721863,45166938,-0.5996917759787296,-1.2636422771954727,-0.6639505012167431
2025-09-25T09:50:00-04:00,122.53,122.97,121.96,122,NaN,NaN,NaN,123.16461576382011,NaN,NaN,126.99589999999985,130.437584872293,123.55421512770668,126.6051517366031,122.01422158524446,122.67068528514477,121.35775788534414,81131,41204.8,25.10438961275912,33.65950341407507,NaN,NaN,NaN,NaN,0.7926363883397365,38.28193110134665,45085807,-0.5720186351429244,-1.3789737951453986,-0.8069551600024742
2025-09-25T09:55:00-04:00,122.03,122.72,122.03,122.3,NaN,NaN,NaN,123.16461576382011,NaN,NaN,126.88709999999985,130.56373818728014,123.21046181271957,126.6051517366031,122.04008423771361,122.67708282372546,121.40308565170177,67019,42917.7,28.046133005022583,32.47201214083624,NaN,NaN,NaN,NaN,0.787448074886898,39.88612129017981,45152826,-0.49818532920983183,-1.429686821514764,-0.9315014923049322
2025-09-25T10:00:00-04:00,122.26,122.82,122,122.78,NaN,NaN,NaN,123.16461576382011,NaN,NaN,126.77549999999985,130.60221621630924,122.94878378369044,126.6051517366031,122.07225570969533,122.70005755342122,121.44445386596944,60712,44422.53333333333,32.60720135026557,31.696586865976236,NaN,NaN,NaN,NaN,0.7897732123949763,41.187524559652125,45213538,-0.3866675453405488,-1.4148359239806183,-1.0281683786400695
2025-09-25T10:05:00-04:00,122.77,122.97,122.53,122.97,NaN,NaN,NaN,123.16461576382011,NaN,NaN,126.67089999999986,130.62010280058587,122.72169719941387,126.6051517366031,122.1228495614826,122.75769262892192,121.48800649404328,67231,46253.2,34.38034305028506,31.031085315542263,NaN,NaN,NaN,NaN,0.7647894115096207,42.10464930510938,45280769,-0.2750016362318477,-1.371920423929879,-1.0969187876980313
2025-09-25T10:10:00-04:00,122.97,123.38,122.87,123.19,121.13208475768948,121.13208475768948,121.13208475768948,NaN,NaN,NaN,126.57729999999985,130.62890028138992,122.5256997186098,126.35412138928248,122.18031406928249,122.84056840405991,121.52005973450507,59350,47204.9,36.4648241010017,30.478909631455075,NaN,NaN,NaN,NaN,0.7465901678303614,42.17981416297358,45340119,-0.16655528229676864,-1.3051128905689922,-1.1385576082722235
2025-09-25T10:15:00-04:00,123.22,124.24,123.22,123.93,121.68448999597632,NaN,NaN,NaN,NaN,NaN,126.50489999999985,130.6133622378899,122.3964377621098,122.00043176805256,122.26456166063826,123.0009651379936,121.52815818328293,58145,48528.73333333333,43.0212970938216,30.69440816519725,NaN,NaN,NaN,NaN,0.7682622986996211,40.843603882888296,45398264,-0.03224702187952655,-1.1788663856216317,-1.1466193637421052
2025-09-25T10:20:00-04:00,123.965,124.62,123.88,124.54,122.19655863252287,NaN,NaN,NaN,NaN,NaN,126.43989999999985,130.56776990591464,122.31203009408506,122.45834541444205,122.34151056302058,123.16403295515087,121.51898817089028,42810,49644.86666666667,47.80301807652351,31.353771830433747,NaN,NaN,NaN,NaN,0.7662435630782204,39.0612211807721,45441074,0.10300752073685615,-1.017859962821035,-1.1208674835578911
2025-09-25T10:25:00-04:00,124.54,124.64,123.73,124.05,122.19655863252287,NaN,NaN,NaN,NaN,NaN,126.36429999999986,130.52588479910793,122.20271520089177,122.45834541444205,122.4276636123682,123.31741506065647,121.53791216407994,58281,50490.833333333336,44.56752053451112,31.39624028236633,NaN,NaN,NaN,NaN,0.7765118800012044,37.559001877437396,45382793,0.1613307029061759,-0.9192041049251714,-1.0805348078313473
2025-09-25T10:30:00-04:00,124.07,124.55,124.05,124.46,122.24236024161691,NaN,NaN,NaN,NaN,NaN,126.29349999999984,130.4618096094436,122.12519039055606,122.5525410652429,122.48916089663918,123.4277860482496,121.55053574502875,40136,51288.9,47.754000963307945,31.520271963839313,NaN,NaN,NaN,NaN,0.7567610314296899,36.164083952912314,45422929,0.2254455933017243,-0.7987278162041918,-1.024173409505916
2025-09-25T10:35:00-04:00,124.45,124.78,123.99,124.63,122.31316204881612,NaN,NaN,NaN,NaN,NaN,126.22829999999985,130.39666591965937,122.05993408034031,122.78703285219433,122.54335355991437,123.52371204139892,121.56299507842981,35412,51802.1,49.06150432399302,32.27751415991621,NaN,NaN,NaN,NaN,0.7591352434704267,34.50387972209383,45458341,0.2739995302837397,-0.6816739966512415,-0.9556735269349812
2025-09-25T10:40:00-04:00,124.67,125.16,124.47,125.09,122.74324559205176,NaN,NaN,NaN,NaN,NaN,126.16749999999983,130.31175252611177,122.0232474738879,123.22062628175546,122.63334730588548,123.6959332927402,121.57076131903077,51154,53342.26666666667,52.523764087329376,35.08377470424022,NaN,NaN,NaN,NaN,0.7541970117939675,32.38549135795689,45509495,0.32813750767694017,-0.5455016423388059,-0.8736391500157461
2025-09-25T10:45:00-04:00,125.1,125.36,124.99,125.36,123.14696170150395,NaN,NaN,NaN,NaN,NaN,126.11049999999985,130.21905850636006,122.00194149363963,123.62350102540437,122.68202879049858,123.79213636852033,121.57192121247682,25599,53785.833333333336,54.47950415526553,38.106592985254096,NaN,NaN,NaN,NaN,0.7267543680943988,30.1267026354959,45535094,0.37006420330456946,-0.4110588958850343,-0.7811230991896038
2025-09-25T10:50:00-04:00,125.33,125.33,124.95,125.15,123.14823616961742,NaN,NaN,NaN,NaN,NaN,126.05149999999983,130.1286908221451,121.97430917785456,123.73580082032349,122.73498977044676,123.88970631116993,121.58027322972359,30104,54417.933333333334,52.662416606252606,41.10154437298481,NaN,NaN,NaN,NaN,0.7041290560876557,28.08823064731335,45504990,0.3706633076199102,-0.3177939646647161,-0.6884572722846263
2025-09-25T10:55:00-04:00,125.15,125.45,125.06,125.1,123.30058907099844,NaN,NaN,NaN,NaN,NaN,125.99199999999985,130.03603115717203,121.94796884282766,123.9796406562588,122.8107145074238,124.02465235776386,121.59677665708374,44279,55534.666666666664,52.215855905624764,42.906555204711715,NaN,NaN,NaN,NaN,0.6816912663671089,26.15843414301107,45460711,0.35469368186628836,-0.2450901699517658,-0.5997838518180542
2025-09-25T11:00:00-04:00,125.08,125.2,124.84,124.91,123.30058907099844,NaN,NaN,NaN,NaN,NaN,125.93389999999985,129.95490449641358,121.91289550358611,123.9796406562588,122.86235434219992,124.10659941987697,121.61810926452287,35141,56041.7,50.46465760512106,44.71800291845186,NaN,NaN,NaN,NaN,0.6587133187694583,24.568237335524977,45425570,0.31943335968304143,-0.20049215221425243,-0.5199255118972939
2025-09-25T11:05:00-04:00,124.9,125.07,124.49,124.65,123.30058907099844,NaN,NaN,NaN,NaN,NaN,125.86509999999984,129.85377320799674,121.87642679200295,123.9796406562588,122.89935359486483,124.1585455401732,121.64016164955648,29773,56758.833333333336,48.087961139888264,46.14956207094226,NaN,NaN,NaN,NaN,0.653090938857354,23.624696263439933,45395797,0.26873511734568944,-0.18400661521518202,-0.45274173256087147
2025-09-25T11:10:00-04:00,124.61,125,124.57,124.8,123.30058907099844,NaN,NaN,NaN,NaN,NaN,125.79449999999984,129.73077654010544,121.85822345989423,123.9796406562588,122.92541035749417,124.19517308441334,121.655647630575,21077,57101.566666666666,49.56377490926723,47.360745896585236,NaN,NaN,NaN,NaN,0.637155871796115,22.748550982218102,45416874,0.2365711118494384,-0.15702784274907344,-0.39359895459851185
2025-09-25T11:15:00-04:00,124.86,125.14,124.8,125.13,123.30058907099844,NaN,NaN,NaN,NaN,NaN,125.73509999999986,129.61971812282232,121.8504818771774,123.9796406562588,122.9570932610153,124.24294430141626,121.67124222061435,23450,57708.566666666666,52.746539065895384,48.6726170405574,NaN,NaN,NaN,NaN,0.6159304523821071,21.658404920115366,45440324,0.22865808332382664,-0.10777635044372857,-0.3364344337675552
2025-09-25T11:20:00-04:00,125.13,125.16,124.73,124.73,123.30058907099844,NaN,NaN,NaN,NaN,NaN,125.67249999999986,129.5188209694684,121.8261790305313,123.9796406562588,122.98377368922849,124.28023277373148,121.68731460472549,21925,58116.6,48.732246241710094,49.54886147917943,NaN,NaN,NaN,NaN,0.6026497057833847,20.76757834094194,45418399,0.18925185876332007,-0.09986961031340513,-0.2891214690767252
2025-09-25T11:25:00-04:00,124.72,124.72,124.295,124.44,123.30058907099844,NaN,NaN,NaN,NaN,NaN,125.61369999999984,129.44366543589885,121.78373456410081,123.9796406562588,123.04224539191483,124.3459709249975,121.73851985883216,63819,59639.76666666667,45.99895603428927,49.76155140349855,NaN,NaN,NaN,NaN,0.5906747267988575,20.650850085368674,45354580,0.13876064821201306,-0.1156706588117089,-0.25443130702372196
2025-09-25T11:30:00-04:00,124.46,124.83,124.46,124.8,123.30058907099844,NaN,NaN,NaN,NaN,NaN,125.55729999999986,129.35030156079154,121.76429843920818,123.9796406562588,123.06462561449518,124.37353087173359,121.75572035725678,22469,59660.7,49.765641548313354,49.90173879434068,NaN,NaN,NaN,NaN,0.5763408177417962,20.29599592248507,45377049,0.12513363377920514,-0.09801426479971553,-0.22314789857892067
2025-09-25T11:35:00-04:00,124.78,125.27,124.78,125.27,123.30058907099844,NaN,NaN,NaN,NaN,NaN,125.51129999999985,129.26108975946423,121.76151024053547,124.11918094092435,123.10469082815645,124.43127615232186,121.77810550399104,33241,59956.666666666664,54.252144776768134,50.59349766878761,NaN,NaN,NaN,NaN,0.5701736164745247,19.049906163504048,45410290,0.14206147206610217,-0.04557105849629295,-0.18763253056239512
2025-09-25T11:40:00-04:00,125.27,125.79,125.27,125.79,123.7887040540528,NaN,NaN,NaN,NaN,NaN,125.47709999999985,129.18466852400326,121.76953147599644,124.60934475273949,123.1485630462111,124.50406074199476,121.79306535042743,30116,60351.833333333336,58.652122836110564,51.37193494541636,NaN,NaN,NaN,NaN,0.5665897867263451,18.39442364840501,45440406,0.18012021119687807,0.03751773343370246,-0.1426024777631756
2025-09-25T11:45:00-04:00,125.77,125.78,125.46,125.65,123.91285386977768,NaN,NaN,NaN,NaN,NaN,125.44109999999984,129.10605363683968,121.77614636315998,124.67047580219158,123.17801517298712,124.55198111691284,121.80404922906139,20712,60370.76666666667,57.060911539295404,51.943321175080825,NaN,NaN,NaN,NaN,0.5496905162458928,17.785761312955902,45419694,0.1868980990931382,0.09102014610324716,-0.09587795298989105
2025-09-25T11:50:00-04:00,125.64,125.66,125.38,125.51,123.91285386977768,NaN,NaN,NaN,NaN,NaN,125.40769999999983,129.03893957350473,121.77646042649495,124.67047580219158,123.1944260620183,124.57741030538683,121.81144181864975,12332,59745.9,55.44111394712939,52.15170330792368,NaN,NaN,NaN,NaN,0.5304269079426148,17.05108255572105,45407362,0.17328846878952775,0.12073263299701864,-0.05255583579250911
2025-09-25T11:55:00-04:00,125.49,125.53,124.95,124.97,123.91285386977768,NaN,NaN,NaN,NaN,NaN,125.36329999999984,128.96041195825,121.76618804174967,124.67047580219158,123.21297750386651,124.60237873272034,121.82357627501268,16831,59140.53333333333,49.59327696535808,51.80268708007315,NaN,NaN,NaN,NaN,0.5339678430895708,16.150661089577397,45390531,0.12169175135937156,0.09955885340670534,-0.02213289795266622
2025-09-25T12:00:00-04:00,124.97,125.15,124.37,124.39,123.91285386977768,NaN,NaN,NaN,NaN,NaN,125.31089999999983,128.88680362848257,121.7349963715171,124.67047580219158,123.24078397278012,124.63058484541527,121.85098310014497,35343,54144.76666666667,44.200533755794275,51.19826687646899,NaN,NaN,NaN,NaN,0.5515415685831729,16.263137675574722,45355188,0.04616018216791545,0.035567329757228094,-0.010592852410687355
2025-09-25T12:05:00-04:00,124.37,124.5,124.23,124.25,123.91285386977768,NaN,NaN,NaN,NaN,NaN,125.25969999999982,128.8215615414129,121.69783845858674,124.67047580219158,123.26062657659345,124.64533010047799,121.87592305270891,33682,49482.833333333336,42.985485581606305,50.53895471046768,NaN,NaN,NaN,NaN,0.5314314565415175,16.57248880228348,45321506,-0.012439235057997735,-0.026141896233184525,-0.01370266117518679
2025-09-25T12:10:00-04:00,124.25,124.31,123.92,124.1,123.91285386977768,NaN,NaN,NaN,NaN,NaN,125.20009999999984,128.73777748108674,121.66242251891295,124.67047580219158,123.27398920793456,124.65181717401904,121.89616124185008,29462,41461.2,41.66396335864513,49.91033369286225,NaN,NaN,NaN,NaN,0.5213292096456948,17.29513343003665,45292044,-0.05796385428556132,-0.08615747903213844,-0.02819362474657712
2025-09-25T12:15:00-04:00,124.12,124.34,124,124.09,123.91285386977768,NaN,NaN,NaN,NaN,NaN,125.13069999999985,128.61623468497524,121.64516531502446,124.67047580219158,123.28446693016114,124.65724818980671,121.91168567051558,22846,39119.4,41.57220426598536,49.44492248758347,NaN,NaN,NaN,NaN,0.5083771232424311,17.894339864721104,45269198,-0.08384038337962986,-0.13299410397111444,-0.04915372059148458
2025-09-25T12:20:00-04:00,124.14,124.18,123.83,124.07,NaN,NaN,NaN,125.58999686829058,125.58999686829058,125.58999686829058,125.06229999999985,128.49376336715937,121.63083663284033,124.67047580219158,123.29032796479221,124.65925538035489,121.92140054922953,15088,36917.96666666667,41.37593557053246,48.86007682053099,NaN,NaN,NaN,NaN,0.4970644715822581,18.695969610530085,45254110,-0.09649246725603514,-0.1697693046615285,-0.07327683740549337
2025-09-25T12:25:00-04:00,124.03,124.15,123.9,124.01,NaN,NaN,NaN,125.57204246518648,NaN,NaN,124.99569999999986,128.37663952033384,121.61476047966588,124.67047580219158,123.29803641860134,124.66175576105333,121.93431707614936,20400,35364,40.75431198058299,48.0034891715801,NaN,NaN,NaN,NaN,0.4794170093263825,19.440340088781287,45233710,-0.10252526262810939,-0.2014334156906301,-0.09890815306252072
2025-09-25T12:30:00-04:00,124.07,124.45,124.03,124.32,NaN,NaN,NaN,125.57204246518648,NaN,NaN,124.93419999999986,128.24956083106358,121.61883916893615,124.67047580219158,123.309819143251,124.66937141022622,121.95026687627579,23779,34132.9,45.32482517849692,47.76010195277916,NaN,NaN,NaN,NaN,0.47660150866021217,19.334884183323314,45257489,-0.08024675567568516,-0.19921659765712718,-0.11896984198144202
2025-09-25T12:35:00-04:00,124.3,124.47,124.19,124.26,NaN,NaN,NaN,125.57204246518648,NaN,NaN,124.87259999999986,128.1206414036997,121.62455859630003,124.63238064175326,123.31782571501161,124.67482740437234,121.96082402565088,15828,32419.466666666667,44.60754182602669,47.66071522361755,NaN,NaN,NaN,NaN,0.4625585437559114,19.18502763085239,45241661,-0.0648207860793695,-0.1999958245806539,-0.1351750385012844
2025-09-25T12:40:00-04:00,124.3,124.32,123.8,124.13,NaN,NaN,NaN,125.56755073911457,NaN,NaN,124.80159999999985,127.95488491579262,121.64831508420708,124.41790451340262,123.32509015808137,124.67767543974544,121.97250487641729,18880,31070.466666666667,43.01902449639669,47.1788140056235,NaN,NaN,NaN,NaN,0.4666615049162032,19.723347615182632,45222781,-0.05881800574246923,-0.20869754567937093,-0.1498795399369017
2025-09-25T12:45:00-04:00,124.15,124.36,124.15,124.23,NaN,NaN,NaN,125.56755073911457,NaN,NaN,124.73819999999984,127.80628263255257,121.6701173674471,123.8703236107221,123.33023675165872,124.68078722026533,121.9796862830521,11173,29504.733333333334,44.65180738502724,46.493075620499155,NaN,NaN,NaN,NaN,0.4497571117079032,20.110074522381446,45233954,-0.04422405272942104,-0.20515960584867798,-0.16093555311925695
2025-09-25T12:50:00-04:00,124.26,124.27,123.68,123.71,NaN,NaN,NaN,125.45900800816017,NaN,NaN,124.66839999999983,127.66729675717079,121.66950324282888,123.5471133700873,123.3354265226994,124.68072768679426,121.99012535860453,18836,28705.6,38.47743644892579,45.052026592843106,NaN,NaN,NaN,NaN,0.4597744608716236,21.199453670006477,45215118,-0.06447651425912854,-0.24153119594316763,-0.1770546816840391
2025-09-25T12:55:00-04:00,123.7,123.76,123.57,123.58,NaN,NaN,NaN,125.10746218960743,NaN,NaN,124.59539999999984,127.51805142638787,121.67274857361181,123.5471133700873,123.34014972041099,124.6753871533937,122.00491228742828,32169,27835.2,37.096384697545005,43.62598896128951,NaN,NaN,NaN,NaN,0.44050485652365134,22.364657304463613,45182949,-0.0804725219308707,-0.2776453340976275,-0.19717281216675678
2025-09-25T13:00:00-04:00,123.6,123.74,123.33,123.33,NaN,NaN,NaN,124.96780481735256,NaN,NaN,124.51879999999984,127.36842212234534,121.66917787765435,123.5471133700873,123.34146296360609,124.66981434296684,122.01311158424534,21520,27214.666666666668,34.52967003582137,42.13231439619608,NaN,NaN,NaN,NaN,0.4383259382005331,23.77030633804059,45161429,-0.10043683613406412,-0.3227188573343369,-0.2222820212002728
2025-09-25T13:05:00-04:00,123.33,123.435,123.2,123.27,NaN,NaN,NaN,124.71722278020016,NaN,NaN,124.44079999999985,127.20819253452596,121.67340746547374,123.5471133700873,123.34100630830545,124.66172120343987,122.02029141317104,24066,26836.466666666667,33.923022455505674,41.01301050263519,NaN,NaN,NaN,NaN,0.423802656900495,25.243562693253274,45137363,-0.109487573661112,-0.3591414882766628,-0.2496539146155508
2025-09-25T13:10:00-04:00,123.32,123.44,123.16,123.31,NaN,NaN,NaN,124.67428083564562,NaN,NaN,124.36319999999985,127.03378477494091,121.69261522505879,123.5471133700873,123.34053965221521,124.65305580808932,122.0280234963411,26305,26008.166666666668,34.74610596209203,40.33769423165645,NaN,NaN,NaN,NaN,0.4135310385504597,26.664290445758347,45163668,-0.10459212743266944,-0.3803940739063876,-0.27580194647371814
2025-09-25T13:15:00-04:00,123.28,123.32,123.03,123.03,NaN,NaN,NaN,124.5263589794799,NaN,NaN,124.28439999999986,126.87394562812446,121.69485437187527,123.5471133700873,123.33926382479294,124.64796294781206,122.03056470177381,12744,25579.666666666668,31.763443983244642,39.536119831773476,NaN,NaN,NaN,NaN,0.40470739293971203,28.157475398388414,45150924,-0.11139537659581888,-0.41504616721849175,-0.30365079062267286
2025-09-25T13:20:00-04:00,123.01,123.01,122.28,122.49,NaN,NaN,NaN,124.03720629859447,NaN,NaN,124.19639999999985,126.72409225977685,121.66870774022286,123.5471133700873,123.32641259788598,124.62741502231302,122.02541017345894,37451,25824.566666666666,26.9573194912591,38.48564526981733,NaN,NaN,NaN,NaN,0.42937115058687547,30.35349886072848,45113473,-0.14151320382241828,-0.4805422954006957,-0.33902909157827743
2025-09-25T13:25:00-04:00,122.51,122.93,122.48,122.81,NaN,NaN,NaN,124.03720629859447,NaN,NaN,124.11079999999987,126.52820634568025,121.6933936543195,123.44635255685587,123.32083031163238,124.61687702830275,122.024783594962,20892,25045,33.3894027914518,37.90115945020779,NaN,NaN,NaN,NaN,0.4308446398306703,32.39266350432996,45134365,-0.1294596025303164,-0.500853594741173,-0.37139399221085656
2025-09-25T13:30:00-04:00,122.81,122.95,122.56,122.66,NaN,NaN,NaN,124.03720629859447,NaN,NaN,124.02059999999987,126.30773763471524,121.73346236528451,123.44635255685587,123.31634680038752,124.608550896276,122.02414270449904,16593,24426.733333333334,31.968315754177226,37.22918660618242,NaN,NaN,NaN,NaN,0.427927165557051,34.21080358424619,45117772,-0.12130487390952449,-0.5230250845977622,-0.4017202106882377
2025-09-25T13:35:00-04:00,122.675,122.675,122.19,122.27,NaN,NaN,NaN,123.81617134966973,NaN,NaN,123.93059999999987,126.13037966172566,121.73082033827409,123.2440820454847,123.30328818415703,124.59116393305682,122.01541243525723,31219,24474.933333333334,28.564285416572588,36.35847042303881,NaN,NaN,NaN,NaN,0.43200379658869015,36.25087773619356,45086553,-0.13106112846591167,-0.5655466212706273,-0.4344854928047156
2025-09-25T13:40:00-04:00,122.285,122.33,121.94,122.11,NaN,NaN,NaN,123.50895901559382,NaN,NaN,123.92359999999988,126.1441828424361,121.70301715756366,122.84426563638776,123.28540963357358,124.57154263575434,121.99927663139282,34600,24925.7,27.280856765416658,35.069615536390224,NaN,NaN,NaN,NaN,0.4290035254037838,38.3535960547768,45051953,-0.13655542379826435,-0.6051797725525461,-0.4686243487542817
2025-09-25T13:45:00-04:00,122.12,122.13,121.64,121.69,NaN,NaN,NaN,123.26332451488501,NaN,NaN,123.91899999999988,126.15705004415011,121.68094995584966,122.8024125091102,123.27022901774124,124.55825765039673,121.98220038508576,23836,24938.566666666666,24.206248157857587,33.61238027437814,NaN,NaN,NaN,NaN,0.4333604164463703,40.531471613883255,45028117,-0.15537174077608773,-0.6628390247243914,-0.5074672839483036
2025-09-25T13:50:00-04:00,121.69,121.95,121.65,121.76,NaN,NaN,NaN,123.15658249148116,NaN,NaN,123.93219999999987,126.11057844281859,121.75382155718114,122.60594400583054,123.25043100152126,124.54111219164402,121.95974981139851,31121,25245.1,25.70904816674563,32.37595339368878,NaN,NaN,NaN,NaN,0.4238346724144865,42.55378463305354,45059238,-0.1499268815060173,-0.6948758858308253,-0.544949004324808
2025-09-25T13:55:00-04:00,121.78,121.94,121.41,121.49,NaN,NaN,NaN,123.042192378232,NaN,NaN,123.91119999999987,126.16190172171422,121.66049827828552,122.60594400583054,123.22890732498334,124.52456516004678,121.9332494899199,31069,24153.433333333334,23.75276231533418,30.883164460139273,NaN,NaN,NaN,NaN,0.43141791009916614,44.60658074479037,45028169,-0.1509173075089606,-0.7335956387110087,-0.5826783312020481
2025-09-25T14:00:00-04:00,121.5,121.54,120.7,120.79,NaN,NaN,NaN,122.53959272467601,NaN,NaN,123.88699999999986,126.24293972761359,121.53106027238613,122.50775520466442,123.17905639834717,124.50160834208923,121.85650445460512,54311,25214.833333333332,19.59064742766168,29.534108101477553,NaN,NaN,NaN,NaN,0.4606023450920831,46.92341670734182,44973858,-0.1829869502515169,-0.8114120190164442,-0.6284250687649273
2025-09-25T14:05:00-04:00,120.81,121.57,120.8,121.29,NaN,NaN,NaN,122.53959272467601,NaN,NaN,123.86679999999986,126.29309079876025,121.44050920123946,121.98520416373155,123.13435615608866,124.4740595610935,121.79465275108382,56447,25988.366666666665,29.14162406687079,28.965910913572255,NaN,NaN,NaN,NaN,0.4834164632997905,48.96055894586662,45030305,-0.15585703942156126,-0.8232463680418789,-0.6673893286203176
2025-09-25T14:10:00-04:00,121.3,121.92,121.3,121.92,NaN,NaN,NaN,122.53959272467601,NaN,NaN,123.84959999999987,126.31828697086725,121.38091302913249,121.91913066478818,123.11878294835832,124.4593138229523,121.77825207376434,27412,25898.233333333334,38.976981200330876,29.2835759967515,NaN,NaN,NaN,NaN,0.4938867159212337,49.575161328594184,45057717,-0.08439266403828394,-0.7728801586681726,-0.6884874946298887
2025-09-25T14:15:00-04:00,121.9,122.17,121.86,122.11,NaN,NaN,NaN,122.53959272467601,NaN,NaN,123.83239999999986,126.33708220741549,121.32771779258424,121.91913066478818,123.1054123731284,124.44286070242863,121.76796404382817,31588,26260.766666666666,41.6093108528154,29.832596596559338,NaN,NaN,NaN,NaN,0.48075195049828856,49.327765514952674,45089305,-0.01677400994870537,-0.7094550070657704,-0.692680997117065
2025-09-25T14:20:00-04:00,122.115,122.26,122.02,122.14,NaN,NaN,NaN,122.53959272467601,NaN,NaN,123.81139999999986,126.35458543565721,121.26821456434251,121.60780453183055,123.09682620357997,124.43139526820099,121.76225713895894,22729,26607.333333333332,42.0344867243937,30.35319522243803,NaN,NaN,NaN,NaN,0.4635553826055543,48.81198694184544,45112034,0.03471694410695769,-0.6492848169833678,-0.6840017610903255
2025-09-25T14:25:00-04:00,122.13,122.39,122.04,122.09,NaN,NaN,NaN,122.53959272467601,NaN,NaN,123.77459999999988,126.36270883853861,121.18649116146115,121.28124362546444,123.08816829347803,124.41944484463976,121.75689174231631,24186,26852.5,41.49220501328614,31.04810672458385,NaN,NaN,NaN,NaN,0.4554442838480143,47.91797050357697,45087848,0.06821558728691757,-0.5987322769816785,-0.6669478642685961
2025-09-25T14:30:00-04:00,122.09,122.22,121.87,121.98,NaN,NaN,NaN,122.53959272467601,NaN,NaN,123.72339999999987,126.34991894341806,121.09688105658168,121.27835908298432,123.07753794444838,124.40637608583235,121.74869980306441,26014,26541.533333333333,40.26160296111108,31.998412686716133,NaN,NaN,NaN,NaN,0.4479125492874414,47.335587608655594,45061834,0.08469640739852147,-0.5610773550204442,-0.6457737624189657
2025-09-25T14:35:00-04:00,121.95,122.28,121.89,122.26,NaN,NaN,NaN,122.53959272467601,NaN,NaN,123.68759999999988,126.34396310773327,121.03123689226648,121.27835908298432,123.07310318838321,124.40033777223806,121.74586860452837,12429,25833.1,44.75327164502587,32.81011760482856,NaN,NaN,NaN,NaN,0.44377593862405273,46.59237251584338,45074263,0.11434268252148472,-0.5028454092671097,-0.6171880917885945
2025-09-25T14:40:00-04:00,122.26,122.68,122.26,122.53,121.09606222104114,121.09606222104114,121.09606222104114,NaN,NaN,NaN,123.64899999999987,126.31541707167673,120.98258292832301,121.63283985048798,123.06571824974982,124.38613236057506,121.74530413892458,33585,25970.533333333333,48.754559500911085,34.00913501530955,NaN,NaN,NaN,NaN,0.44207765729376336,44.659309684647724,45107848,0.14978791631744126,-0.42995319639179286,-0.5797411127092341
2025-09-25T14:45:00-04:00,122.55,122.56,122.2,122.41,121.09606222104114,NaN,NaN,NaN,NaN,NaN,123.60459999999988,126.27812115385858,120.93107884614118,121.63283985048798,123.06211741120804,124.37992722261889,121.74430759979718,14207,25682.566666666666,47.12109111066869,35.334621136316414,NaN,NaN,NaN,NaN,0.43621496748706595,42.9799434367606,45093641,0.16177944148991363,-0.3775168108468421,-0.5392962523367557
2025-09-25T14:50:00-04:00,122.44,122.57,122.39,122.52,121.15672198239491,NaN,NaN,NaN,NaN,NaN,123.55319999999989,126.20927662542049,120.8971233745793,121.6658175043123,123.05888197841973,124.37363442920764,121.74412952763183,15252,25688.033333333333,48.81403481698696,36.872705282857154,NaN,NaN,NaN,NaN,0.41791389838084647,41.38940157858101,45108893,0.1727513555127313,-0.3233570579458416,-0.49610841345857287
2025-09-25T14:55:00-04:00,122.53,122.72,122.47,122.56,121.29778007410424,NaN,NaN,NaN,NaN,NaN,123.49719999999986,126.11635112968628,120.87804887031345,121.87165400344985,123.05247581182124,124.35949287621979,121.74545874742269,36613,26228.466666666667,49.447834165612896,38.675675711982535,NaN,NaN,NaN,NaN,0.40592004849650026,39.4389232287729,45145506,0.17764805940632955,-0.27404833920066096,-0.4516963986069905
2025-09-25T15:00:00-04:00,122.58,122.93,122.44,122.91,121.37992643437224,NaN,NaN,NaN,NaN,NaN,123.45239999999987,126.03328530549716,120.87151469450258,122.00632320275987,123.04730454543756,124.34328872228035,121.75132036859476,48920,27066.5,54.72991385381078,40.748594689630046,NaN,NaN,NaN,NaN,0.4119257593181795,37.00461324545558,45194426,0.19785882589937343,-0.20437286623277373,-0.40223169213214716
2025-09-25T15:05:00-04:00,122.93,123.04,122.66,122.67,121.5524297782644,NaN,NaN,NaN,NaN,NaN,123.40379999999988,125.95003766371664,120.85756233628311,122.1110585622079,123.04422941817442,124.33274936267924,121.75570947366961,33467,27654.466666666667,50.809449142379954,42.681215177276165,NaN,NaN,NaN,NaN,0.40964534793831026,34.432967863325544,45160959,0.1885052864314044,-0.16660008409289162,-0.355105370524296
2025-09-25T15:10:00-04:00,122.66,122.95,122.52,122.83,121.5524297782644,NaN,NaN,NaN,NaN,NaN,123.36219999999989,125.8764101423942,120.84798985760557,122.1110585622079,123.04169508646008,124.32459070635632,121.75879946656384,25804,27885.266666666666,53.21551790616357,45.08299164002631,NaN,NaN,NaN,NaN,0.4110992516570029,32.42432164056072,45186763,0.18620916458635034,-0.12234391479135809,-0.30855307937770843
2025-09-25T15:15:00-04:00,122.87,122.95,122.72,122.87,121.5653750665591,NaN,NaN,NaN,NaN,NaN,123.32659999999989,125.81716012979533,120.83603987020444,122.1110585622079,123.04028172385075,124.31862738299529,121.76193606470622,20630,28200.5,53.82361229623638,46.8459907992667,NaN,NaN,NaN,NaN,0.3981635908243601,30.559150147993385,45207393,0.18037433387326496,-0.08308516203612726,-0.2634594959093922
2025-09-25T15:20:00-04:00,122.9,123,122.45,122.505,121.5653750665591,NaN,NaN,NaN,NaN,NaN,123.28069999999987,125.74540932163359,120.81599067836615,122.1110585622079,123.03680082491975,124.30993502339088,121.76366662644863,25729,28430.266666666666,47.72746944274401,47.47102567372478,NaN,NaN,NaN,NaN,0.4090090486226199,29.54408513556888,45181664,0.1463701170264396,-0.08049684962634274,-0.22686696665278233
2025-09-25T15:25:00-04:00,122.48,122.6,122.39,122.6,121.5653750665591,NaN,NaN,NaN,NaN,NaN,123.23009999999988,125.64423047703102,120.81596952296874,122.1110585622079,123.03378315009873,124.30372003538957,121.76384626480788,17206,27931.5,49.33588469082542,48.02292380501121,NaN,NaN,NaN,NaN,0.3947941165781466,28.750878399809576,45198870,0.12551495017087597,-0.06997327893918737,-0.19548822911006333
2025-09-25T15:30:00-04:00,122.6,122.84,122.59,122.76,121.5653750665591,NaN,NaN,NaN,NaN,NaN,123.1906999999999,125.56967457744454,120.81172542255524,122.1110585622079,123.0313779851373,124.29656409488733,121.76619187538726,23061,27982.866666666665,52.01394740445996,48.73574242501594,NaN,NaN,NaN,NaN,0.38445167967970756,27.191956743528824,45221931,0.11785668960616949,-0.04816736710235148,-0.16602405670852097
2025-09-25T15:35:00-04:00,122.77,122.88,122.55,122.58,121.5653750665591,NaN,NaN,NaN,NaN,NaN,123.15349999999988,125.5112448971719,120.79575510282785,122.1110585622079,123.02842440974194,124.28884969177282,121.76799912771106,24002,27980.733333333334,48.88340944598393,49.26368559878007,NaN,NaN,NaN,NaN,0.3805622739882998,25.744386634125267,45197929,0.09690482797790187,-0.04489302173614362,-0.1417978497140455
2025-09-25T15:40:00-04:00,122.57,122.69,122.45,122.5,121.5653750665591,NaN,NaN,NaN,NaN,NaN,123.10749999999987,125.42434807446234,120.7906519255374,122.1110585622079,123.02426900544323,124.28003706662207,121.76850094426439,25551,27955.6,47.51464469912779,49.781760008638415,NaN,NaN,NaN,NaN,0.3705221115605637,24.69849416925158,45172378,0.07488002662767615,-0.04819781642945031,-0.12307784305712646
2025-09-25T15:45:00-04:00,122.47,122.53,122.13,122.23,121.5653750665591,NaN,NaN,NaN,NaN,NaN,123.04669999999987,125.2918027682824,120.80159723171735,122.1110585622079,123.01856016443337,124.271038373337,121.76608195552973,23426,28311.666666666668,43.12568319925613,49.66550369108343,NaN,NaN,NaN,NaN,0.37262767502052385,24.577632328545324,45148952,0.04104128107436067,-0.07177624171417563,-0.1128175227885363
2025-09-25T15:50:00-04:00,122.2,122.41,122.06,122.32,121.5653750665591,NaN,NaN,NaN,NaN,NaN,122.97729999999989,125.08950568130146,120.86509431869831,122.1110585622079,123.00516895080672,124.25048838706532,121.75984951454812,53896,28859.833333333332,44.95103619279798,49.39382345478964,NaN,NaN,NaN,NaN,0.37101141251905745,24.633589647829503,45202848,0.024452484719453077,-0.08225191688921996,-0.10670440160867303
2025-09-25T15:55:00-04:00,122.31,122.73,122.31,122.66,121.5653750665591,NaN,NaN,NaN,NaN,NaN,122.91749999999988,124.88820977064996,120.94679022934979,122.06847747981305,122.99157423692407,124.21979144779915,121.76335702604898,97250,31405.1,51.308772145255,49.69294352868866,NaN,NaN,NaN,NaN,0.3745105973391249,23.513821682826876,45300098,0.03544391824717004,-0.06239950379971049,-0.09784342204688053