time,open,high,low,close,Long Stop,Long Stop Start,Buy Label,Short Stop,Short Stop Start,Sell Label,Basis,Upper,Lower,ATR Trailing Stoploss,VWAP,Upper Band #1,Lower Band #1,Volume,Volume MA,RSI,RSI-based MA,Regular Bullish,Regular Bullish Label,Regular Bearish,Regular Bearish Label,ATR,ADX,OnBalanceVolume,Histogram,MACD,Signal
2021-09-24T09:30:00-04:00,44.66,46.54,44.51,45.16,40.5034587690985,NaN,NaN,NaN,NaN,NaN,43.7013,48.81795625579815,38.584643744201855,42.86929773622968,45.40333333333333,45.40333333333333,45.40333333333333,107570,86818.63333333333,57.742689919034504,53.07857863566432,NaN,NaN,NaN,NaN,1.6856478735233424,17.35892361825093,2453489,0.6669423156941341,0.6625051146421868,-0.004437201051947337
2021-09-24T13:30:00-04:00,45.155,45.16,44.77,44.85,40.5034587690985,NaN,NaN,NaN,NaN,NaN,43.70530000000001,48.82522828465354,38.585371715346476,42.86929773622968,45.261567769395725,45.47946096270855,45.0436745760829,45535,87563.83333333333,56.239328993937086,53.729641547717236,NaN,NaN,NaN,NaN,1.5931015968431033,18.163955117996704,2407954,0.542299067970377,0.6734366339110238,0.1311375659406469
2021-09-27T09:30:00-04:00,45.16,45.91,44.02,44.42,40.5034587690985,NaN,NaN,NaN,NaN,NaN,43.731100000000005,48.852173047711545,38.610026952288464,42.86929773622968,44.78333333333334,44.78333333333334,44.78333333333334,51182,85418.73333333334,54.13396342202306,54.21639819759589,NaN,NaN,NaN,NaN,1.614308625640024,18.91148436776064,2356772,0.40710973019005875,0.6400247286782204,0.2329149984881616
2021-09-27T13:30:00-04:00,44.38,44.96,44.32,44.7,40.5034587690985,NaN,NaN,NaN,NaN,NaN,43.7729,48.890805075321275,38.654994924678725,42.86929773622968,44.764282803585985,44.8088545732603,44.71971103391167,9350,85119.46666666666,55.30723584062779,54.78696002023203,NaN,NaN,NaN,NaN,1.5447151523800222,19.60561867111286,2366122,0.31677981183584686,0.6288897632829702,0.31210995144712333
2021-09-28T09:30:00-04:00,43.96,45.94,42.51,43.83,40.5034587690985,NaN,NaN,NaN,NaN,NaN,43.75070000000001,48.857780578960515,38.6436194210395,42.86929773622968,44.09333333333333,44.093333810170485,44.09333285649617,84839,84635.7,50.946424828825116,54.76333065072266,NaN,NaN,NaN,NaN,1.679378355781449,18.801962878789393,2281283,0.18518983343032286,0.5435972432350269,0.35840740980470404
2021-09-28T13:30:00-04:00,43.94,44.98,43.82,44.8,40.5034587690985,NaN,NaN,NaN,NaN,NaN,43.7411,48.83844098918228,38.643759010817725,42.86929773622968,44.22178968452679,44.42183907933427,44.02174028971931,34981,83873.63333333333,55.18879980950202,55.13768141664712,NaN,NaN,NaN,NaN,1.6422799017970597,18.05571107163189,2316264,0.15163942916904716,0.547956696266013,0.3963172670969658
2021-09-29T09:30:00-04:00,44.33,45.43,43.4,43.67,40.5034587690985,NaN,NaN,NaN,NaN,NaN,43.65410000000001,48.60266491924633,38.705535080753684,42.86929773622968,44.166666666666664,44.166666666666664,44.166666666666664,86510,80625.83333333333,49.78691862016981,55.70105371840475,NaN,NaN,NaN,NaN,1.6699741945258413,17.647342139510343,2229754,0.046934387320324955,0.454985251247372,0.40805086392704704
2021-09-29T13:30:00-04:00,43.71,44.23,43.15,43.15,40.5034587690985,NaN,NaN,NaN,NaN,NaN,43.53090000000001,48.209444085502966,38.85235591449705,42.86929773622968,44.04245572103863,44.299626537065166,43.78528490501209,20181,79575,47.483633984562005,56.06256312074861,NaN,NaN,NaN,NaN,1.6278331806311381,17.064728214367644,2209573,-0.0580583895969955,0.33547787693080267,0.39353626652779816
2021-09-30T09:30:00-04:00,42.81,42.94,41.44,41.58,40.5034587690985,NaN,NaN,NaN,NaN,NaN,43.40470000000001,47.94445876451525,38.86494123548478,42.40843818898375,41.986666666666665,41.98666714350382,41.986666189829506,45301,75804.43333333333,41.27494558540172,55.389148482227604,NaN,NaN,NaN,NaN,1.6337022391574856,16.39851056527392,2164272,-0.22460383861726002,0.11278146825622315,0.33738530687348317
2021-09-30T13:30:00-04:00,41.67,42.52,41.6,42.05,40.5034587690985,NaN,NaN,NaN,NaN,NaN,43.26610000000001,47.531386527303376,39.00081347269664,41.779750551187,42.00832055210826,42.04067609609665,41.97596500811987,20290,75040.86666666667,43.65031046955417,54.89972770747005,NaN,NaN,NaN,NaN,1.5841520792176655,15.779879891115463,2184562,-0.29029877062836024,-0.02548815641196711,0.2648106142163931
2021-10-01T09:30:00-04:00,42.335,42.66,41.18,41.88,40.5034587690985,NaN,NaN,NaN,NaN,NaN,43.1505,47.24298200973408,39.058017990265924,41.76244035275968,41.906666666666666,41.906666666666666,41.906666666666666,32669,72361.06666666667,42.973229444526694,53.639878254552926,NaN,NaN,NaN,NaN,1.5767126449878321,15.488149503044843,2151893,-0.32952037070919504,-0.1470898491701007,0.18243052153909434
2021-10-01T13:30:00-04:00,41.95,42.07,41.83,41.83,40.5034587690985,NaN,NaN,NaN,NaN,NaN,43.0493,47.01518351316542,39.08341648683459,41.76244035275968,41.90796978510261,41.9095963183073,41.906343251897916,20969,71722.3,42.76312824116925,51.89103736116715,NaN,NaN,NaN,NaN,1.4812331703458441,15.21725699983641,2130924,-0.3416837748848633,-0.2446741970669848,0.0970095778178785
2021-10-04T09:30:00-04:00,41.55,41.66,40.32,40.51,NaN,NaN,NaN,46.07904939529031,46.07904939529031,46.07904939529031,42.919500000000006,46.78318231095629,39.05581768904372,41.32195228220775,40.82999999999999,40.82999999999999,40.82999999999999,45663,70648.36666666667,37.54440375575606,49.74390089730889,NaN,NaN,NaN,NaN,1.4832879438925695,15.92275911843519,2085261,-0.416519666935528,-0.4236400058515315,-0.007120338916003513
2021-10-04T13:30:00-04:00,40.49,41.1,40.47,40.88,NaN,NaN,NaN,45.728638059140756,NaN,NaN,42.800700000000006,46.54065187669538,39.060748123304634,41.3145618257662,40.82661308240214,40.83241719216335,40.82080897264093,15549,69236,39.76345549662312,48.19989060083659,NaN,NaN,NaN,NaN,1.4223388050431005,16.57786822856263,2100810,-0.41791325467057144,-0.5295119072542178,-0.11159865258364639
2021-10-05T09:30:00-04:00,41.38,42.31,41.38,42.15,NaN,NaN,NaN,45.728638059140756,NaN,NaN,42.743300000000005,46.43300329972429,39.05359670027572,40.99071956849037,41.946666666666665,41.946666666666665,41.946666666666665,57188,69784.83333333333,46.756258821901795,47.41514552246997,NaN,NaN,NaN,NaN,1.4228860332543076,16.08191352640524,2157998,-0.3148131684241478,-0.5051151131138312,-0.19030194468968337
2021-10-05T13:30:00-04:00,42.13,42.46,41.84,41.96,NaN,NaN,NaN,45.728638059140756,NaN,NaN,42.710100000000004,46.397524298883575,39.022675701116434,40.99071956849037,41.9883367107574,42.05234775354401,41.92432566797079,24235,69335.06666666667,45.89780343854429,46.6764651256562,NaN,NaN,NaN,NaN,1.3655370308789998,15.494277355054237,2133763,-0.2440794148736496,-0.49540121328174536,-0.25132179840809576
2021-10-06T09:30:00-04:00,41.94,42.65,41.75,42.02,NaN,NaN,NaN,45.728638059140756,NaN,NaN,42.6721,46.3480097322974,38.9961902677026,40.13857565479229,42.14000000000001,42.140000476837166,42.13999952316285,40717,66942.7,46.233519343818365,46.11214769149872,NaN,NaN,NaN,NaN,1.3322843858162141,14.781737577105453,2174480,-0.1808295095468937,-0.4773586853417129,-0.2965291757948192
2021-10-06T13:30:00-04:00,42.11,42.18,41.96,42.06,NaN,NaN,NaN,45.728638059140756,NaN,NaN,42.627300000000005,46.27726614230837,38.97733385769164,39.999410819302334,42.11815592074633,42.151692994960115,42.08461884653255,17274,64696,46.471988138654275,45.48105856992919,NaN,NaN,NaN,NaN,1.252835501115056,14.120093497581584,2191754,-0.12645020609933583,-0.45459193341898896,-0.32814172731965313
2021-10-07T09:30:00-04:00,42.26,42.8,41.93,42.2,NaN,NaN,NaN,45.728638059140756,NaN,NaN,42.563300000000005,46.12777000828975,38.99882999171026,40.58062292435349,42.309999999999995,42.309999999999995,42.309999999999995,46728,63133.86666666667,47.35213159945819,45.224323339260124,NaN,NaN,NaN,NaN,1.2254901081782663,13.288374351422958,2238482,-0.07381150502208755,-0.4204061085972626,-0.346594603575175
2021-10-07T13:30:00-04:00,42.25,42.4,41.72,41.89,NaN,NaN,NaN,45.728638059140756,NaN,NaN,42.508500000000005,46.028159216457844,38.988840783542166,40.58062292435349,42.242556063793074,42.369576229801446,42.1155358977847,13174,62521.96666666667,45.56553236410659,44.53694709316044,NaN,NaN,NaN,NaN,1.1865265290226756,12.359198793197683,2225308,-0.05357290484875127,-0.4135607346361141,-0.3599878297873628
2021-10-08T09:30:00-04:00,41.85,42.05,41.07,41.07,NaN,NaN,NaN,45.728638059140756,NaN,NaN,42.43690000000001,45.9249016571091,38.948898342890914,40.58062292435349,41.39666666666667,41.39666666666667,41.39666666666667,23982,61266.86666666667,41.143465352288274,43.91955757402605,NaN,NaN,NaN,NaN,1.1717746340924842,12.082390834725796,2201326,-0.08712790615168858,-0.46889771247697354,-0.38176980632528495
2021-10-08T13:30:00-04:00,41.14,41.83,41.1,41.75,NaN,NaN,NaN,45.61816351266799,NaN,NaN,42.3821,45.82516148071705,38.93903851928295,40.58062292435349,41.45438755426137,41.53246472191748,41.37631038660527,13107,60158.46666666667,45.837709134309755,43.80199151329374,NaN,NaN,NaN,NaN,1.142362160228735,11.825354873287615,2214433,-0.0567156082406165,-0.45266431662605555,-0.39594870838543905
2021-10-11T09:30:00-04:00,41.08,42.12,41.08,41.83,NaN,NaN,NaN,45.61816351266799,NaN,NaN,42.34450000000001,45.769749917888475,38.919250082111546,40.58062292435349,41.67666666666666,41.67666666666666,41.67666666666666,52764,59602.76666666667,46.37954432712823,44.16660570913135,NaN,NaN,NaN,NaN,1.135050577355254,11.270284946400984,2267197,-0.02596544129219247,-0.4284055100006796,-0.40244006870848714
2021-10-11T13:30:00-04:00,41.83,42.45,41.83,42.07,NaN,NaN,NaN,45.61816351266799,NaN,NaN,42.316500000000005,45.72734872135897,38.90565127864104,40.58062292435349,41.86141219457668,42.07856910143918,41.64425528771418,38189,59839.5,48.058317931561575,44.48146338498902,NaN,NaN,NaN,NaN,1.0982612504013076,10.529842152846012,2305386,0.013654527563352947,-0.385371909254296,-0.39902643681764893
2021-10-12T09:30:00-04:00,41.93,42.03,41.04,41.2,NaN,NaN,NaN,45.49755139846151,NaN,NaN,42.295500000000004,45.72062729690403,38.87037270309598,40.58062292435349,41.42333333333333,41.42333333333333,41.42333333333333,65064,57765.73333333333,42.82419912941702,44.47081836248118,NaN,NaN,NaN,NaN,1.0933854468012143,10.501706928538436,2240322,-0.014111756086584326,-0.4166661319258793,-0.402554375839295
2021-10-12T13:30:00-04:00,41.19,41.21,40.51,40.53,NaN,NaN,NaN,44.73788997125872,NaN,NaN,42.26390000000001,45.72426257637771,38.8035374236223,40.58062292435349,41.11451026724798,41.45002357302157,40.77899696147439,55124,58178.6,39.276490696118145,44.22177282354897,NaN,NaN,NaN,NaN,1.0652864863154135,10.945813204467626,2185198,-0.06986318653760515,-0.4898833590113014,-0.4200201724736963
2021-10-13T09:30:00-04:00,40.82,40.82,39.89,40.18,NaN,NaN,NaN,44.1834404271106,NaN,NaN,42.255500000000005,45.73396992224984,38.77703007775017,40.58062292435349,40.296666666666674,40.296666666666674,40.296666666666674,55459,52958.2,37.527504886973446,44.22056576149306,NaN,NaN,NaN,NaN,1.0556231658643125,11.86081036133837,2129739,-0.11965169797640163,-0.5695847949441983,-0.4499330969677967
2021-10-13T13:30:00-04:00,40.14,40.6,40.12,40.52,NaN,NaN,NaN,44.07987495315102,NaN,NaN,42.26390000000001,45.72348569195738,38.804314308042635,40.58062292435349,40.34599276312594,40.40362649857591,40.28835902767597,40623,48034.23333333333,40.30826403058486,44.25948065677604,NaN,NaN,NaN,NaN,1.0145072254454333,12.710450578432633,2170362,-0.11878587280110675,-0.5984154379691802,-0.4796295651680734
2021-10-14T09:30:00-04:00,40.72,41.79,40.61,40.88,NaN,NaN,NaN,44.07987495315102,NaN,NaN,42.2583,45.7259122101525,38.790687789847496,40.36341051985215,41.093333333333334,41.093333333333334,41.093333333333334,70359,42938,43.19160061347738,44.00486221331715,NaN,NaN,NaN,NaN,1.0327567093421879,12.100030052622527,2240721,-0.08466918845169424,-0.5854660507326912,-0.500796862280997
2021-10-14T13:30:00-04:00,40.96,41.08,40.57,40.93,NaN,NaN,NaN,44.07987495315102,NaN,NaN,42.2513,45.72818412806614,38.77441587193386,40.36341051985215,41.03705913439243,41.136878275607394,40.937239993177464,22362,41897.933333333334,43.59909291518949,43.8406686045061,NaN,NaN,NaN,NaN,0.9954169443891744,11.572215067060709,2263083,-0.05109046029306452,-0.5646599376473276,-0.5135694773542631
2021-10-15T09:30:00-04:00,41.48,41.48,40.9,41,NaN,NaN,NaN,44.07987495315102,NaN,NaN,42.23629999999999,45.728144675812686,38.7444553241873,40.36341051985215,41.126666666666665,41.126666666666665,41.126666666666665,31161,39350.96666666667,44.20253286654843,43.695598141843966,NaN,NaN,NaN,NaN,0.9657443055042333,10.841565569045708,2294244,-0.018216366299262265,-0.5363399352283409,-0.5181235689290786
2021-10-15T13:30:00-04:00,40.97,41.22,40.91,40.99,NaN,NaN,NaN,44.07987495315102,NaN,NaN,42.232699999999994,45.72930247097115,38.73609752902884,40.36341051985215,41.07578496846345,41.11845580118994,41.033114135736966,44307,39310.03333333333,44.129894260533426,43.52830572197819,NaN,NaN,NaN,NaN,0.9189054265396454,10.163105320888919,2249937,0.007428868000216582,-0.5088374839288079,-0.5162663519290245
2021-10-18T09:30:00-04:00,40.915,41.21,40.33,40.66,NaN,NaN,NaN,44.07987495315102,NaN,NaN,42.23989999999999,45.722006540587564,38.75779345941242,40.36341051985215,40.73333333333333,40.73333333333333,40.73333333333333,73439,40051.933333333334,41.69487900427009,43.124216250893326,NaN,NaN,NaN,NaN,0.9161264675010994,9.982650865066178,2176498,0.006760243216324069,-0.5078160479086193,-0.5145762911249434
2021-10-18T13:30:00-04:00,40.67,40.86,40.4,40.64,NaN,NaN,NaN,43.923452898026966,NaN,NaN,42.241699999999994,45.720401832581004,38.762998167418985,39.84572841588172,40.68368644067796,40.73368519381621,40.63368768753971,72409,42153.9,41.54525853765097,42.837053834717935,NaN,NaN,NaN,NaN,0.8835460055367352,9.815086013230776,2104089,0.009401719580896417,-0.5028241416488228,-0.5122258612297192
2021-10-19T09:30:00-04:00,41,41.47,40.57,41.11,NaN,NaN,NaN,43.923452898026966,NaN,NaN,42.26869999999999,45.69042518475752,38.846974815242454,39.69637987731574,41.05,41.05,41.05,75869,41854.9,46.411898354987805,43.213370477767896,NaN,NaN,NaN,NaN,0.8847212908555397,9.318434820093955,2179958,0.045228659512096536,-0.45569003683959863,-0.5009186963516952
2021-10-19T13:30:00-04:00,41.09,41.8,40.98,41.67,NaN,NaN,NaN,43.923452898026966,NaN,NaN,42.30229999999999,45.6663696841781,38.938230315821876,39.971103901852594,41.28017084404456,41.496416263967284,41.06392542412184,85955,43554.03333333333,51.5840663724226,43.623824566204526,NaN,NaN,NaN,NaN,0.8800983415087156,9.23033890645805,2265913,0.10561800218493878,-0.36889619362052173,-0.4745141958054605
2021-10-20T09:30:00-04:00,42.01,42.4,41.11,41.4,NaN,NaN,NaN,43.923452898026966,NaN,NaN,42.309299999999986,45.664361853379916,38.95423814662006,40.29188312148208,41.63666666666666,41.63666666666666,41.63666666666666,75148,43175.3,49.122318727062726,43.81973702334271,NaN,NaN,NaN,NaN,0.9093770314009502,9.773919771698282,2190765,0.12502748815189096,-0.3182298356155968,-0.4432573237674878
2021-10-20T13:30:00-04:00,41.39,42.14,41.27,41.83,NaN,NaN,NaN,43.923452898026966,NaN,NaN,42.30869999999999,45.66409375334769,38.95330624665228,40.29188312148208,41.68045856594021,41.734304443018516,41.6266126888619,49705,44159.433333333334,52.9715826970424,44.170684506591336,NaN,NaN,NaN,NaN,0.9065643863008821,10.278673432278497,2240470,0.1621215182567065,-0.2406054259466046,-0.4027269442033111
2021-10-21T09:30:00-04:00,41.95,43.31,41.21,41.61,NaN,NaN,NaN,43.923452898026966,NaN,NaN,42.302899999999994,45.662099958323786,38.9437000416762,40.56280519774853,42.04333333333334,42.04333333333334,42.04333333333334,84623,45470.166666666664,50.85177994390871,44.74408313619789,NaN,NaN,NaN,NaN,0.9918097872793906,11.80018167171428,2155847,0.1665043584521091,-0.19459649613817476,-0.36110085459028385
2021-10-21T13:30:00-04:00,41.65,41.88,41.27,41.27,NaN,NaN,NaN,43.923452898026966,NaN,NaN,42.29029999999999,45.660159587580054,38.92044041241992,40.56280519774853,41.92307794871795,42.155638073635345,41.69051782380056,22627,45548.066666666666,47.67639191254526,45.3440760802284,NaN,NaN,NaN,NaN,0.964537659616577,13.213010751190366,2133220,0.1421170860366036,-0.18345449704452932,-0.32557158308113293
2021-10-22T09:30:00-04:00,40.98,41.1,40,40.16,NaN,NaN,NaN,43.8722653653699,NaN,NaN,42.24029999999999,45.660544675458844,38.82005532454114,40.56280519774853,40.419999999999995,40.419999999999995,40.419999999999995,80760,47151.1,39.09365718074543,45.455944101212104,NaN,NaN,NaN,NaN,0.9863563982153931,12.810405269878059,2052460,0.05151217079835335,-0.26118136958319127,-0.3126935403815446
2021-10-22T13:30:00-04:00,40.13,40.25,39.62,39.62,NaN,NaN,NaN,43.19216239421673,NaN,NaN,42.184499999999986,45.68201240169438,38.68698759830559,40.56280519774853,40.18310019786132,40.472322200841894,39.89387819488075,54183,48258.23333333333,35.72433935695105,45.128520910238265,NaN,NaN,NaN,NaN,0.9609023697714366,12.009949900212174,1998277,-0.03958835901897306,-0.3621789891552609,-0.32259063013628786
2021-10-25T09:30:00-04:00,39.85,39.85,38.16,38.36,NaN,NaN,NaN,42.344564103570505,NaN,NaN,42.13789999999999,45.773194810604004,38.50260518939597,40.56280519774853,38.79,38.79,38.79,167818,52330.066666666666,29.364817624820844,44.140893553905656,NaN,NaN,NaN,NaN,1.01298077193062,12.393244670424128,1830459,-0.17208237821392497,-0.5376936029036941,-0.3656112246897691
2021-10-25T13:30:00-04:00,38.39,39.06,38.34,39.01,NaN,NaN,NaN,41.98594755340822,NaN,NaN,42.10249999999999,45.82346022553369,38.3815397744663,40.56280519774853,38.79468490475123,38.801050206333656,38.7883196031688,90908,54842.03333333333,35.72180590998886,43.578230196391324,NaN,NaN,NaN,NaN,0.9920535739355757,12.7491612427638,1921367,-0.2012915307630545,-0.6172256381435872,-0.4159341073805327
2021-10-26T09:30:00-04:00,39.61,39.68,39,39.06,NaN,NaN,NaN,41.98594755340822,NaN,NaN,42.03689999999999,45.8532285445575,38.220571455442474,40.56280519774853,39.24666666666667,39.24666666666667,39.24666666666667,131531,57320.13333333333,36.19748000832456,43.006440706518184,NaN,NaN,NaN,NaN,0.9697640329401774,12.37329836969621,2052898,-0.20206435199140477,-0.6685145473697887,-0.4664501953783839
2021-10-26T13:30:00-04:00,39.07,40.25,39.05,39.78,NaN,NaN,NaN,41.98594755340822,NaN,NaN,41.986499999999985,45.85381858010254,38.11918141989743,40.56280519774853,39.449631110650216,39.67203364239002,39.22722857891041,109544,60163.76666666667,42.7657230323158,42.90899990450264,NaN,NaN,NaN,NaN,0.9862094591587364,11.545817756781654,2162442,-0.14175493879591972,-0.6436438688732835,-0.5018889300773638
2021-10-27T09:30:00-04:00,35.9,36.15,34.45,35.64,NaN,NaN,NaN,39.12542827687016,NaN,NaN,41.805099999999996,45.98282401673486,37.62737598326513,40.56280519774853,35.413333333333334,35.413333333333334,35.413333333333334,1418447,106088.1,26.116853220260012,41.796283777073356,NaN,NaN,NaN,NaN,1.2964802120759695,13.550850438555646,743995,-0.3561526414936451,-0.9470797319444202,-0.5909270904507751
2021-10-27T13:30:00-04:00,35.62,35.695,35.05,35.435,NaN,NaN,NaN,39.11199971883061,NaN,NaN,41.575199999999995,45.86321210819243,37.28718789180756,40.56280519774853,35.41025094500448,35.41747220866403,35.403029681344925,258441,114127,25.585694457154474,40.65631491418075,NaN,NaN,NaN,NaN,1.2499459112134004,15.41266650020292,485554,-0.47955810958644174,-1.1903747274338272,-0.7108166178473855
2021-10-28T09:30:00-04:00,35.21,35.29,34,34.76,NaN,NaN,NaN,38.410204277065574,NaN,NaN,41.32909999999999,45.73925994721336,36.91894005278662,39.37724415819883,34.68333333333333,34.68333333333333,34.68333333333333,333710,123693.06666666667,23.864646014693292,39.045796889874,NaN,NaN,NaN,NaN,1.2631640604124432,17.555314431093937,151844,-0.568363581344033,-1.4212710945274267,-0.8529075131833938
2021-10-28T13:30:00-04:00,34.76,35.5,34.76,35.46,NaN,NaN,NaN,38.410204277065574,NaN,NaN,41.120299999999986,45.63243670449007,36.608163295509904,38.46279532655906,34.83742626768723,35.08649205760226,34.5883604777722,127734,127511.73333333334,29.184539301576024,37.44583067052781,NaN,NaN,NaN,NaN,1.2257951989544118,19.334627717066446,279578,-0.5417824128191134,-1.5301355292072856,-0.9883531163881721
2021-10-29T09:30:00-04:00,35.78,35.82,35.01,35.075,NaN,NaN,NaN,38.410204277065574,NaN,NaN,40.91859999999999,45.589227812190366,36.247972187809616,37.82523626124725,35.30166666666667,35.30166666666667,35.30166666666667,138958,131344.26666666666,28.02468185946192,35.938856608556335,NaN,NaN,NaN,NaN,1.1960955418862398,20.65961763907943,140620,-0.5122798958852199,-1.6287029862446971,-1.1164230903594772
2021-10-29T13:30:00-04:00,35.07,35.075,34.8,34.94,NaN,NaN,NaN,38.410204277065574,NaN,NaN,40.720399999999984,45.54540273160617,35.8953972683938,37.72177677260687,35.106747608007964,35.28793025586497,34.92556496015096,160827,136268.26666666666,27.610318909115776,34.12733776656158,NaN,NaN,NaN,NaN,1.1303030031800803,21.988556353550862,-20207,-0.46537089959207245,-1.6981367148495679,-1.2327658152574954
2021-11-01T09:30:00-04:00,35.215,35.215,34.42,34.55,NaN,NaN,NaN,38.276010147052766,NaN,NaN,40.52299999999999,45.530567073939714,35.515432926060264,37.72177677260687,34.72833333333333,34.72833333333333,34.72833333333333,176501,140392.83333333334,26.396103954373146,32.38050376730904,NaN,NaN,NaN,NaN,1.1063527886672175,23.40263049700755,-196708,-0.42522373621369414,-1.7642954855246131,-1.339071749310919
2021-11-01T13:30:00-04:00,34.55,34.87,34.475,34.87,NaN,NaN,NaN,38.02766877673218,NaN,NaN,40.32639999999999,45.433439079545536,35.21936092045445,37.72177677260687,34.731250827625225,34.7357965036244,34.72670515162605,72706,141543.4,29.149307429852996,31.057140589973876,NaN,NaN,NaN,NaN,1.0555418751909875,24.715699344503047,-124002,-0.34513962713286817,-1.7704962832270041,-1.425356656094136
2021-11-02T09:30:00-04:00,34.69,34.7,34.38,34.54,NaN,NaN,NaN,37.80947928688072,NaN,NaN,40.14059999999999,45.3980079697134,34.88319203028659,37.72177677260687,34.54,34.54,34.54,97117,142611.83333333334,27.986687793539517,30.263785633744885,NaN,NaN,NaN,NaN,1.0151460269630594,25.984422321505114,-221119,-0.28491679398037073,-1.7815026485695995,-1.4965858545892288
2021-11-02T13:30:00-04:00,34.53,34.99,34.41,34.97,NaN,NaN,NaN,37.80947928688072,NaN,NaN,39.94399999999999,45.22488439562981,34.66311560437017,33.054322995313974,34.627656714920924,34.74694828654352,34.50836514329833,52438,142522.3,31.803582445877197,29.983731568668183,NaN,NaN,NaN,NaN,0.9840641678942699,26.779659958537888,-168681,-0.19114879672260843,-1.7355218504924892,-1.5443730537698808
2021-11-03T09:30:00-04:00,34.99,37.49,34.69,37.04,NaN,NaN,NaN,37.80947928688072,NaN,NaN,39.81139999999999,45.04412588236812,34.57867411763186,34.54145839625117,36.406666666666666,36.406666666666666,36.406666666666666,473094,156443.46666666667,46.503352120968216,31.207912604107282,NaN,NaN,NaN,NaN,1.1137738701875366,24.982851143935818,304413,0.023825821592111662,-1.514590776779741,-1.5384165983718527
2021-11-03T13:30:00-04:00,37.05,37.22,36.32,37.03,NaN,NaN,NaN,37.80947928688072,NaN,NaN,39.68899999999999,44.889835317524025,34.48816468247596,34.54145839625117,36.52743972073205,36.72684319046335,36.328036251000746,173549,160874.33333333334,46.45126134605662,31.974302278112123,NaN,NaN,NaN,NaN,1.098504308031284,23.31438581609104,130864,0.17070603249448446,-1.3250340577537472,-1.4957400902482316
2021-11-04T09:30:00-04:00,37.07,37.94,36.54,36.72,33.80091224475851,33.80091224475851,33.80091224475851,NaN,NaN,NaN,39.59179999999999,44.82916794964854,34.35443205035144,34.99293337360075,37.06666666666666,37.06666666666666,37.06666666666666,117949,162460.66666666666,44.776796794209176,32.587110619961024,NaN,NaN,NaN,NaN,1.120039714600478,22.11070788061132,12915,0.24767191195151517,-1.1861502003088376,-1.4338221122603527
2021-11-04T13:30:00-04:00,36.75,37.23,36.68,37.05,33.80091224475851,NaN,NaN,NaN,NaN,NaN,39.491799999999984,44.728541643427576,34.25505835657239,34.99293337360075,37.03723294302582,37.075812131765076,36.998653754286565,68656,164003.8,46.96834271658393,32.887297740265886,NaN,NaN,NaN,NaN,1.079322592129015,20.99300694052301,81571,0.31706097480015494,-1.037495893760159,-1.354556868560314
2021-11-05T09:30:00-04:00,37.06,37.38,36.75,36.84,33.80091224475851,NaN,NaN,NaN,NaN,NaN,39.390999999999984,44.63400524508694,34.14799475491303,34.99293337360075,36.99,36.99,36.99,79128,165602.7,45.72477177331097,34.2878633511981,NaN,NaN,NaN,NaN,1.047228121262657,20.081183665650823,2443,0.34287936189352175,-0.9259576661934119,-1.2688370280869337
2021-11-05T13:30:00-04:00,36.82,37.01,36.65,37.01,33.80091224475851,NaN,NaN,NaN,NaN,NaN,39.29459999999998,44.53192444670079,34.05727555329917,34.99293337360075,36.94518030111786,36.99491122188459,36.895449380351124,64271,166268.16666666666,46.949305395861415,35.81383556110573,NaN,NaN,NaN,NaN,0.9981403983153243,19.131186121220818,66714,0.3635042718410364,-0.8144566882856381,-1.1779609601266745
2021-11-08T09:30:00-05:00,37,37.46,36.53,37.35,33.82265992876546,NaN,NaN,NaN,NaN,NaN,39.23139999999998,44.484773407631565,33.978026592368394,35.30148150982687,37.11333333333334,37.11333333333334,37.11333333333334,193655,170275.36666666667,49.40778942205301,37.638345804488566,NaN,NaN,NaN,NaN,0.9932732270070869,18.65402276123143,260369,0.3898133221515301,-0.690694307437262,-1.080507629588792
2021-11-08T13:30:00-05:00,37.345,38.135,37.32,37.97,34.5882208410943,NaN,NaN,NaN,NaN,NaN,39.17319999999998,44.41669530752249,33.92970469247747,36.000685207861494,37.37308882198414,37.7093285440993,37.03684909986898,115574,171714.2,53.627959719725375,39.38430440578495,NaN,NaN,NaN,NaN,0.9805394250780092,18.770382755772136,375943,0.43528640008715735,-0.5363996294798454,-0.9716860295670028
2021-11-09T09:30:00-05:00,36.78,37.195,36.54,36.86,34.5882208410943,NaN,NaN,NaN,NaN,NaN,39.067399999999985,44.2797538790079,33.85504612099207,36.000685207861494,36.865,36.865,36.865,190626,175539.43333333332,46.19801461278769,40.68239960245108,NaN,NaN,NaN,NaN,1.0126437518581513,18.01775542263832,185317,0.378990681223473,-0.4979476780376615,-0.8769383592611345
2021-11-09T13:30:00-05:00,36.88,36.98,36.46,36.71,34.5882208410943,NaN,NaN,NaN,NaN,NaN,38.96239999999998,44.14889679070665,33.77590320929331,36.000685207861494,36.819391680380924,36.887839582162684,36.750943778599165,84635,175495.43333333332,45.284950668735355,41.944873299566765,NaN,NaN,NaN,NaN,0.9774549124397115,17.234281732952432,100682,0.32226052756282886,-0.4741126998075984,-0.7963732273704273
2021-11-10T09:30:00-05:00,35.88,35.9,34.54,34.61,NaN,NaN,NaN,38.49162981692577,38.49162981692577,38.49162981692577,38.81419999999998,44.06581436512716,33.5625856348728,36.000685207861494,35.016666666666666,35.016666666666666,35.016666666666666,366261,185199.2,34.88872498309415,42.55148908733254,NaN,NaN,NaN,NaN,1.0626367044083036,17.185678818187075,-265579,0.14305302561151323,-0.6175569453560357,-0.7606099709675489
2021-11-10T13:30:00-05:00,34.61,34.75,33.76,34.47,NaN,NaN,NaN,37.51291937070187,NaN,NaN,38.66239999999998,43.96845587607319,33.35634412392676,36.000685207861494,34.797610230607965,35.11880054600036,34.47641991521557,170364,189221.16666666666,34.323006271269946,42.921039004576606,NaN,NaN,NaN,NaN,1.0574483683791391,17.664927115531555,-435943,0.021230022211379818,-0.7340724432033241,-0.7553024654147039
2021-11-11T09:30:00-05:00,34.82,34.82,34.05,34.65,NaN,NaN,NaN,37.51291937070187,NaN,NaN,38.51139999999997,43.83585341420236,33.186946585797585,36.000685207861494,34.50666666666667,34.50666666666667,34.50666666666667,120064,190402.53333333333,35.76517197701534,43.47664501768203,NaN,NaN,NaN,NaN,1.0369163420663436,18.035332057520787,-315879,-0.0378660611714996,-0.8026350418790784,-0.7647689807075788
2021-11-11T13:30:00-05:00,34.63,34.83,34.11,34.15,NaN,NaN,NaN,37.51291937070187,NaN,NaN,38.35659999999998,43.72898324768521,32.98421675231475,36.000685207861494,34.456593832191686,34.52492989530772,34.38825776907565,64464,191797.1,33.560649942184725,43.602149838846856,NaN,NaN,NaN,NaN,1.0142794604901761,18.367912357422558,-380343,-0.09785791895045615,-0.887091379395649,-0.7892334604451928
2021-11-12T09:30:00-05:00,34.76,35.88,34.64,35.08,NaN,NaN,NaN,37.51291937070187,NaN,NaN,38.236799999999974,43.628921942242236,32.84467805775771,36.000685207861494,35.2,35.2,35.2,348110,200708.76666666666,40.86222770270173,43.19921238039925,NaN,NaN,NaN,NaN,1.0654023561694497,17.557050860902752,-32233,-0.06378406119904667,-0.8689635369440012,-0.8051794757449545
2021-11-12T13:30:00-05:00,35.08,35.33,34.82,35.25,NaN,NaN,NaN,37.51291937070187,NaN,NaN,38.10679999999997,43.46717788220304,32.746422117796904,36.000685207861494,35.1880112556948,35.213614373284265,35.16240813810534,76327,201446.9,42.11453672375171,42.8894463359489,NaN,NaN,NaN,NaN,1.0257307593002032,16.80410804270579,44094,-0.020893890960430594,-0.8312968394454927,-0.8104029484850621
2021-11-15T09:30:00-05:00,35.5,35.59,34.25,34.56,NaN,NaN,NaN,37.51291937070187,NaN,NaN,37.961399999999976,43.30429174137099,32.618508258628964,36.000685207861494,34.800000000000004,34.800000000000004,34.800000000000004,96841,199081,38.54659748477058,42.44443209956042,NaN,NaN,NaN,NaN,1.0481785622073319,16.599423370555925,-52747,-0.029561769931030435,-0.8473551608988501,-0.8177933909678197
2021-11-15T13:30:00-05:00,34.54,35.06,34.52,34.97,NaN,NaN,NaN,37.51291937070187,NaN,NaN,37.81939999999997,43.094934717922854,32.54386528207709,34.782038533031354,34.823064256827045,34.847989202133995,34.798139311520096,82922,198814.8,41.706854210061316,42.06861149195167,NaN,NaN,NaN,NaN,1.0118800934782366,16.409359032131054,30175,0.000175956690899981,-0.8175734451041947,-0.8177494017950947
2021-11-16T09:30:00-05:00,34.41,34.41,32.89,33.46,NaN,NaN,NaN,36.936421690592255,NaN,NaN,37.66459999999998,42.988272356560685,32.34092764343927,34.782038533031354,33.586666666666666,33.586666666666666,33.586666666666666,159583,199749.86666666667,34.6412709026995,41.276932858336565,NaN,NaN,NaN,NaN,1.0881743725155053,17.450151955591657,-129408,-0.07010364348159004,-0.9053789561470822,-0.8352753126654922
2021-11-16T13:30:00-05:00,33.49,33.93,33.49,33.86,NaN,NaN,NaN,36.91112979556533,NaN,NaN,37.53119999999998,42.8951036382105,32.167296361789454,33.06251598650371,33.62845796696198,33.70260183120136,33.5543141027226,50700,197788.4,37.65437607100395,40.61300933513246,NaN,NaN,NaN,NaN,1.044019060192969,18.416602527376504,-78708,-0.07733647538289201,-0.9319459068941072,-0.8546094315112152
2021-11-17T09:30:00-05:00,33.83,33.92,33,33.21,NaN,NaN,NaN,36.64107844122145,NaN,NaN,37.391799999999975,42.83480128973064,31.94879871026931,33.06251598650371,33.376666666666665,33.376666666666665,33.376666666666665,84168,153312.43333333332,34.84332741833755,39.572690620581355,NaN,NaN,NaN,NaN,1.0351605558934713,19.632395875680178,-162876,-0.11150593888831895,-0.9939918551216138,-0.8824859162332949
2021-11-17T13:30:00-05:00,33.21,33.35,32.81,32.82,NaN,NaN,NaN,36.19012033025684,NaN,NaN,37.23779999999997,42.753292420447025,31.722307579552915,33.06251598650371,33.234824295497916,33.41990171359534,33.049746877400494,49437,146345.63333333333,33.23990266573726,38.11640083101078,NaN,NaN,NaN,NaN,0.9997919447582234,20.882443280951104,-212313,-0.1439208043119703,-1.0623869216232578,-0.9184661173112875
2021-11-18T09:30:00-05:00,32.86,32.89,30.67,30.75,NaN,NaN,NaN,35.05147849706335,NaN,NaN,37.035199999999975,42.74155994658655,31.328840053413405,33.06251598650371,31.436666666666667,31.436666666666667,31.436666666666667,236954,143120.43333333332,26.317409676468202,36.69635762127367,NaN,NaN,NaN,NaN,1.0869496629897788,23.127966546775397,-449267,-0.2804223314301132,-1.268994031598929,-0.9885717001688158
2021-11-18T13:30:00-05:00,30.73,31.04,30.44,30.49,NaN,NaN,NaN,33.944593110833196,NaN,NaN,36.82639999999998,42.70872676413064,30.944073235869322,33.06251598650371,31.113229944797965,31.49750761784757,30.72895227174836,167862,144458.03333333333,25.596354363665654,35.29002931376869,NaN,NaN,NaN,NaN,1.0521675442047944,25.305730084339462,-617129,-0.35885861526810725,-1.43714496925395,-1.0782863539858427
2021-11-19T09:30:00-05:00,30.34,30.8,29.17,29.53,NaN,NaN,NaN,33.26620251488623,NaN,NaN,36.59699999999997,42.700830928196424,30.493169071803525,32.91281023136238,29.833333333333332,29.833333333333332,29.833333333333332,247312,148069.83333333334,23.08171305164217,34.446671318664976,NaN,NaN,NaN,NaN,1.093441291047309,27.789201944569708,-864441,-0.4406434232187415,-1.6290906330092696,-1.188447209790528
2021-11-19T13:30:00-05:00,29.53,29.73,28.81,28.99,NaN,NaN,NaN,32.527511491482315,NaN,NaN,36.356999999999964,42.69038708749198,30.023612912507947,32.91281023136238,29.596087815897217,29.911533195595297,29.280642436199138,139892,147372,21.78522873815983,33.55111578058569,NaN,NaN,NaN,NaN,1.0810526274010728,30.211547051741576,-1004333,-0.49243199213778155,-1.803987199962755,-1.3115552078249735
2021-11-22T09:30:00-05:00,29.01,29.35,27.45,27.9,NaN,NaN,NaN,31.768533696414934,NaN,NaN,36.10179999999997,42.74195715476738,29.461642845232564,32.648248185089905,28.23333333333333,28.23333333333333,28.23333333333333,311390,151868.3,19.414689737162746,32.38322419202479,NaN,NaN,NaN,NaN,1.1395488683009962,32.850041436320055,-1315723,-0.5566820201771407,-2.0074077330463993,-1.4507257128692586
2021-11-22T13:30:00-05:00,27.91,28.32,27.795,27.795,NaN,NaN,NaN,31.344509437486987,NaN,NaN,35.84489999999997,42.75144109956701,28.93835890043292,31.440598548071918,28.131192690968945,28.259506076864632,28.002879305073257,197314,156021.9,19.197975275604293,31.357318858697614,NaN,NaN,NaN,NaN,1.0956525205652106,35.300071936285775,-1513037,-0.5612453669469903,-2.1522824215529965,-1.5910370546060062
2021-11-23T09:30:00-05:00,27.7,28.28,26.6,26.78,NaN,NaN,NaN,30.806690826692122,NaN,NaN,35.55829999999997,42.7505070632045,28.366092936795432,31.37158307076603,27.22,27.22,27.22,174212,158591.73333333334,17.199351962273298,29.66711344866701,NaN,NaN,NaN,NaN,1.1373916262391242,37.87219803137095,-1687249,-0.5849539223965698,-2.3222294576017184,-1.7372755352051485
2021-11-23T13:30:00-05:00,26.78,27.75,26.69,27.65,NaN,NaN,NaN,30.5782048800243,NaN,NaN,35.27789999999996,42.58737415071777,27.96842584928215,31.37158307076603,27.278585683061593,27.349048431936883,27.208122934186303,120432,160858.2,24.458703822613444,28.405982527157132,NaN,NaN,NaN,NaN,1.1318636529363295,40.260600833950036,-1566817,-0.49778995747963495,-2.3595129820546923,-1.8617230245750573
2021-11-24T09:30:00-05:00,27.57,28.53,27.53,27.74,NaN,NaN,NaN,30.5782048800243,NaN,NaN,35.004699999999964,42.39909285134415,27.61030714865578,31.041266456612824,27.933333333333334,27.933333333333334,27.933333333333334,102600,148508.4,25.189397257567904,27.451896796642654,NaN,NaN,NaN,NaN,1.1224448205837345,41.40812375935778,-1464217,-0.3943457375993167,-2.3546551965742033,-1.9603094589748866
2021-11-24T13:30:00-05:00,27.76,27.99,27.57,27.95,NaN,NaN,NaN,30.5782048800243,NaN,NaN,34.72709999999996,42.11787292033862,27.336327079661295,29.93301316529026,27.909491931555902,27.9511603416503,27.867823521461503,33589,143843.06666666668,26.964590796302247,26.398877981374145,NaN,NaN,NaN,NaN,1.072270190542039,42.47368076152212,-1430628,-0.27756317288644583,-2.307263425082944,-2.029700252196498
2021-11-26T09:30:00-05:00,27.14,29.06,27.14,27.93,NaN,NaN,NaN,30.5782048800243,NaN,NaN,34.453499999999956,41.817615493391656,27.089384506608255,28.374410532232208,28.043333333333333,28.043333333333333,28.043333333333333,214355,147056.6,26.89912475380315,25.845867542167262,NaN,NaN,NaN,NaN,1.1328223197890361,42.09910459286139,-1644983,-0.17258776711729862,-2.245434961093121,-2.0728471939758224
2021-11-29T09:30:00-05:00,28.23,28.23,25.76,26.02,NaN,NaN,NaN,30.540526617341737,NaN,NaN,34.148499999999956,41.62050354657381,26.676496453426104,27.852528425785767,26.670000000000005,26.670000000000005,26.670000000000005,320885,155464.23333333334,21.524547207605423,24.693736909067372,NaN,NaN,NaN,NaN,1.2283350112326763,42.40165726078601,-1965868,-0.20073786624865786,-2.323769526786645,-2.123031660537987
2021-11-29T13:30:00-05:00,26.02,27.2,25.92,27.08,NaN,NaN,NaN,30.11891177109893,NaN,NaN,33.886899999999955,41.414392514776175,26.359407485223734,26.912022740628615,26.695879698740043,26.727013101701655,26.664746295778432,221725,160217.46666666667,29.89609181287021,24.340362937248276,NaN,NaN,NaN,NaN,1.2320253675731991,42.682599023858884,-1744143,-0.12085679432900553,-2.274102653449244,-2.1532458591202386
2021-11-30T09:30:00-05:00,26.67,27.54,25.82,26.2,NaN,NaN,NaN,30.11891177109893,NaN,NaN,33.618499999999955,41.26523714730741,25.971762852692496,26.14561819250289,26.519999999999996,26.520000337174785,26.519999662825207,363806,170201.96666666667,27.29302711557895,23.915586112236973,NaN,NaN,NaN,NaN,1.2668806984608276,42.527479336364706,-2107949,-0.10098218581857266,-2.2794735913934545,-2.178491405574882
2021-11-30T13:30:00-05:00,26.22,26.55,25.85,25.95,NaN,NaN,NaN,29.762066303831876,NaN,NaN,33.37029999999995,41.189002043179016,25.551597956820885,26.070550535455478,26.3302691592159,26.531582299634515,26.128956018797282,323148,174518.4,26.584842234254083,23.934688437793106,NaN,NaN,NaN,NaN,1.22638921999934,42.38343962654869,-2431097,-0.07932503884080644,-2.27764770412589,-2.1983226652850836
2021-12-01T09:30:00-05:00,26.33,26.35,24.62,24.83,NaN,NaN,NaN,29.121063290021333,NaN,NaN,33.08669999999995,41.09299917252732,25.08040082747258,26.070550535455478,25.266666666666666,25.266666666666666,25.266666666666666,787399,196912.56666666668,23.627053161465454,23.794024066207378,NaN,NaN,NaN,NaN,1.2623614185708156,42.857696171381676,-3218496,-0.11302650442857765,-2.3396057958208054,-2.2265792913922278
2021-12-01T13:30:00-05:00,24.81,24.98,23.895,23.94,NaN,NaN,NaN,28.056242231384,NaN,NaN,32.784299999999945,41.00461556815263,24.56398443184726,26.070550535455478,24.911229053350063,25.38801467424256,24.434443432457567,437598,205144.96666666667,21.573049039340376,23.686262351042963,NaN,NaN,NaN,NaN,1.2496927458157574,43.60126199900892,-3656094,-0.16472331643817517,-2.432483436939947,-2.2677601205017717
2021-12-02T09:30:00-05:00,23.96,24.26,23.36,23.49,NaN,NaN,NaN,27.38698122086655,NaN,NaN,32.45849999999995,40.83373378778232,24.083266212217577,26.070550535455478,23.703333333333333,23.703333333333333,23.703333333333333,234878,210153.06666666668,20.598005277840258,23.60146067530585,NaN,NaN,NaN,NaN,1.2247146925432035,44.49888519803185,-3890972,-0.19653402080866833,-2.513427646512607,-2.3168936257039388
2021-12-02T13:30:00-05:00,23.51,24.28,23.42,24.16,NaN,NaN,NaN,27.381663892645342,NaN,NaN,32.228899999999946,40.867946773806224,23.589853226193668,26.070550535455478,23.808236209848996,23.931610054838828,23.684862364859164,169813,203604.8,25.96344997357062,24.069229263620702,NaN,NaN,NaN,NaN,1.198663643075832,45.304590428733356,-3721159,-0.1422892042171484,-2.494755130975374,-2.3524659267582257
2021-12-03T09:30:00-05:00,23.85,24.02,21.72,22.05,NaN,NaN,NaN,26.573860988434184,NaN,NaN,31.96119999999995,41.006251146345775,22.916148853654118,26.070550535455478,22.596666666666664,22.596666666666664,22.596666666666664,252329,206336.96666666667,21.12266894141483,24.206707382607167,NaN,NaN,NaN,NaN,1.2873305257132728,46.63951592202405,-3973488,-0.21403885671471023,-2.6200144976516135,-2.4059756409369033
2021-12-03T13:30:00-05:00,22.03,22.04,21.5,21.64,NaN,NaN,NaN,25.38050367077809,NaN,NaN,31.698799999999952,41.15570468599583,22.241895314004076,24.603440428364387,22.2692935817007,22.690768903825663,21.84781825957574,152233,207409.26666666666,20.32949978860131,24.430289370202026,NaN,NaN,NaN,NaN,1.2346640595908962,47.94399421697477,-4125721,-0.25202029983412455,-2.721001015729559,-2.4689807158954347
2021-12-06T09:30:00-05:00,21.23,22.02,20.59,21.78,NaN,NaN,NaN,24.946389867560903,NaN,NaN,31.425199999999954,41.21665013979079,21.633749860209125,23.847001874153207,21.463333333333335,21.463333333333335,21.463333333333335,315617,215781.03333333333,21.414644129508233,24.212856534980226,NaN,NaN,NaN,NaN,1.2486166267629752,49.4086399135875,-3810104,-0.2311713131630646,-2.7579448573492655,-2.526773544186201
2021-12-06T13:30:00-05:00,21.76,22.02,21.54,21.86,NaN,NaN,NaN,24.946389867560903,NaN,NaN,31.160899999999952,41.25281947847435,21.068980521525553,23.847001874153207,21.56047369457382,21.715119335456695,21.405828053690943,124533,208328.46666666667,22.0678547420801,23.98988921244538,NaN,NaN,NaN,NaN,1.1937154391370484,50.76866806044217,-3685571,-0.17784366481198344,-2.74907812520118,-2.5712344603891966
2021-12-07T09:30:00-05:00,22.59,23.32,22.05,23.23,NaN,NaN,NaN,24.946389867560903,NaN,NaN,30.926699999999954,41.19883933122057,20.654560668779343,23.245601499322568,22.86666666666667,22.86666666666667,22.86666666666667,244014,213918.03333333333,32.4265067185852,24.380026064037022,NaN,NaN,NaN,NaN,1.2127357649129737,50.30594814589301,-3441557,-0.0242244159714593,-2.601514980353521,-2.5772905643820616
2021-12-07T13:30:00-05:00,23.18,23.18,22.56,22.72,NaN,NaN,NaN,24.946389867560903,NaN,NaN,30.69009999999996,41.16056598581015,20.219634014189765,22.841481199458055,22.851732371013362,22.873501629397296,22.82996311262943,114841,214518.03333333333,30.786013789902853,24.657660995187,NaN,NaN,NaN,NaN,1.1739689245620473,49.87627965381165,-3556398,0.06428069458356234,-2.4969396961526087,-2.561220390736171
2021-12-08T09:30:00-05:00,23.01,23.15,21.78,22.8,NaN,NaN,NaN,24.946389867560903,NaN,NaN,30.448699999999953,41.077911223793045,19.81948877620686,21.63068495956644,22.576666666666668,22.576666905085247,22.57666642824809,250896,220117.16666666666,31.3725255288539,25.36108801813332,NaN,NaN,NaN,NaN,1.1879711442361867,49.838386178158196,-3305502,0.14483985353547846,-2.380170573816823,-2.5250104273523015
2021-12-08T13:30:00-05:00,22.72,23.73,22.43,23.7,NaN,NaN,NaN,24.946389867560903,NaN,NaN,30.231899999999953,40.96020925915209,19.50359074084782,21.346438374122524,22.90220400657835,23.255979290707316,22.548428722449387,212442,221879.13333333333,37.76214065331255,25.922948649593486,NaN,NaN,NaN,NaN,1.1959732053621734,49.080551058091785,-3093060,0.26819596473746277,-2.189765471430473,-2.4579614361679356
2021-12-09T09:30:00-05:00,23.26,23.48,22.05,22.05,NaN,NaN,NaN,24.946389867560903,NaN,NaN,29.973499999999955,40.85417318689466,19.092826813105248,21.346438374122524,22.526666666666667,22.526666905085246,22.526666428248088,292194,229928.93333333332,31.89843482373037,26.251906343032868,NaN,NaN,NaN,NaN,1.2284036906934468,48.574860924058356,-3385254,0.24856352972038342,-2.147257024017456,-2.3958205537378396
2021-12-09T13:30:00-05:00,22.05,22.15,21.71,21.92,NaN,NaN,NaN,24.946389867560903,NaN,NaN,29.671099999999957,40.589760227335944,18.752439772663966,20.791132685533423,22.31333459784489,22.600543005983223,22.026126189706556,161209,232496.96666666667,31.483629375768587,26.601819710283905,NaN,NaN,NaN,NaN,1.1720891413582006,48.279719761086945,-3546463,0.23677413120570456,-2.099852889730709,-2.3366270209364135
2021-12-10T09:30:00-05:00,21.78,21.78,20.42,20.49,NaN,NaN,NaN,24.656180806782128,NaN,NaN,29.340299999999953,40.34895848502938,18.331641514970528,20.791132685533423,20.896666666666665,20.896666666666665,20.896666666666665,231726,238573.26666666666,27.281070098728776,26.862820920088428,NaN,NaN,NaN,NaN,1.1955113455469006,48.58815181418268,-3778189,0.1470159966746012,-2.1528570250931622,-2.2998730217677634
2021-12-10T13:30:00-05:00,20.49,20.49,19.83,20.14,NaN,NaN,NaN,23.644536224655663,NaN,NaN,29.008699999999955,40.106698524058665,17.910701475941245,20.791132685533423,20.503975911299293,20.87504746613141,20.132904356467176,259514,239325.26666666666,26.353835604866532,27.204305674768868,NaN,NaN,NaN,NaN,1.1572605351506933,49.10283960297349,-4037703,0.08168183637261084,-2.197770726302,-2.279452562674611
2021-12-13T09:30:00-05:00,19.74,20.2,18.87,19.28,NaN,NaN,NaN,23.04251185080768,NaN,NaN,28.653299999999955,39.83628450504192,17.470315494957994,20.791132685533423,19.45,19.45,19.45,399116,247033.73333333334,24.17920596624549,27.460105723940668,NaN,NaN,NaN,NaN,1.169599068354215,49.91439848782828,-4436819,0.00234789661439061,-2.276517691906623,-2.2788655885210134
2021-12-13T13:30:00-05:00,19.29,19.75,19.23,19.68,NaN,NaN,NaN,22.90898858486188,NaN,NaN,28.310099999999952,39.520266901523314,17.099933098476594,20.791132685533423,19.482509145966244,19.5304928290782,19.43452546285429,183199,244896.63333333333,27.188653367287003,27.54762025206327,NaN,NaN,NaN,NaN,1.1231991349003425,50.667988880907735,-4253620,-0.0011971123920102578,-2.280361979011026,-2.279164866619016
2021-12-14T09:30:00-05:00,19.14,19.35,18.43,18.74,NaN,NaN,NaN,22.324034558277248,NaN,NaN,27.94469999999995,39.18772706747644,16.701672932523465,20.791132685533423,18.84,18.84,18.84,436817,254794.13333333333,24.7068448921778,27.80363281997491,NaN,NaN,NaN,NaN,1.132256339550318,51.62940872664278,-4690437,-0.042566193703158284,-2.3323726087479635,-2.289806415044805
2021-12-14T13:30:00-05:00,18.7,19.55,18.7,19.14,NaN,NaN,NaN,22.324034558277248,NaN,NaN,27.580499999999947,38.76084601432388,16.400153985676013,20.791132685533423,18.95628696531003,19.09841564517073,18.814158285449334,292414,254161.6,27.72996666805973,28.332237597079086,NaN,NaN,NaN,NaN,1.1120951724395811,52.23682172051872,-4398023,-0.019861348678005264,-2.314633100892312,-2.2947717522143067
2021-12-15T09:30:00-05:00,19,19.01,17.89,18.38,NaN,NaN,NaN,21.860039752479892,NaN,NaN,27.188699999999947,38.25769757159644,16.11970242840346,20.791132685533423,18.426666666666666,18.426666666666666,18.426666666666666,428127,261855.36666666667,25.624744325936035,28.632959039681072,NaN,NaN,NaN,NaN,1.1219455172653254,53.07412725594749,-4826150,-0.03216965543500061,-2.3349838215080574,-2.302814166073057
2021-12-15T13:30:00-05:00,18.37,19.79,18.35,19.5,NaN,NaN,NaN,21.860039752479892,NaN,NaN,26.841499999999947,37.76336252431369,15.9196374756862,20.30390614842674,18.814354445995008,19.207647261631173,18.421061630358842,416011,269915.3333333333,33.62234379109616,29.458279686039358,NaN,NaN,NaN,NaN,1.1446636946035162,52.79158807863629,-4410139,0.054272223496333094,-2.2349738867026403,-2.2892461101989734
2021-12-16T09:30:00-05:00,19.47,19.87,18.04,18.19,NaN,NaN,NaN,21.860039752479892,NaN,NaN,26.471099999999947,37.28475752925479,15.657442470745105,19.38912491874139,18.7,18.7,18.7,328566,276853.13333333336,29.611550474519916,29.257211382891835,NaN,NaN,NaN,NaN,1.1936162878461225,52.66477714610199,-4738705,0.04287675912368005,-2.235650161294373,-2.278526920418053
2021-12-16T13:30:00-05:00,18.18,18.36,17.72,18.13,NaN,NaN,NaN,21.510244003354266,NaN,NaN,26.141499999999947,36.94738844103103,15.335611558968866,18.821299934993114,18.40375294457191,18.7181942380909,18.08931165105292,291643,283154.56666666665,29.438337580716336,29.16094879652137,NaN,NaN,NaN,NaN,1.1540722672856851,52.68631182640302,-5030348,0.050430467429885883,-2.215488836130696,-2.265919303560582
2021-12-17T09:30:00-05:00,17.86,19.06,17.09,19.03,NaN,NaN,NaN,21.510244003354266,NaN,NaN,25.832699999999946,36.551028080442755,15.114371919557135,17.79303994799449,18.393333333333334,18.393333333333334,18.393333333333334,430684,296391.06666666665,35.53021599890144,29.457926687239055,NaN,NaN,NaN,NaN,1.2123528196224218,51.769484247000065,-4599664,0.1306151882220452,-2.1026503182830254,-2.2332655065050706
2021-12-17T13:30:00-05:00,19.02,19.36,18.895,19.09,NaN,NaN,NaN,21.510244003354266,NaN,NaN,25.521499999999943,36.100380517333036,14.94261948266685,17.377431958395594,18.655512387620462,19.002597431479042,18.30842734376188,245744,297437.36666666664,35.92736041723826,29.32687095609089,NaN,NaN,NaN,NaN,1.1589704753636774,50.53788488064842,-4353920,0.1982156689394432,-1.9854959203307665,-2.1837115892702097
2021-12-20T09:30:00-05:00,18.23,18.92,17.6,17.71,NaN,NaN,NaN,21.510244003354266,NaN,NaN,25.19269999999994,35.70011437462183,14.685285625378048,17.231945566716476,18.076666666666668,18.076666666666668,18.076666666666668,304140,296879.2,31.171182946117952,29.274924393404287,NaN,NaN,NaN,NaN,1.1826154414091288,50.097407278496156,-4658060,0.1620356533696592,-1.981167022558136,-2.143202675927795
2021-12-20T13:30:00-05:00,17.71,18.09,17.69,18.04,NaN,NaN,NaN,21.310932672018396,NaN,NaN,24.85189999999994,35.1578871705727,14.545912829427182,17.013445162698545,18.043445632669926,18.10206790556793,17.98482335977192,97673,292744.13333333336,33.440334021873056,29.414689010983178,NaN,NaN,NaN,NaN,1.1267143384513338,49.6883923622119,-4560387,0.17146354258793428,-1.9288732476928772,-2.1003367902808114
2021-12-21T09:30:00-05:00,18.08,18.82,18,18.79,NaN,NaN,NaN,21.310932672018396,NaN,NaN,24.52269999999994,34.526198030189704,14.519201969810178,17.013445162698545,18.536666666666665,18.536666666666665,18.536666666666665,196617,287171.1666666667,38.41008594877718,30.209618714558065,NaN,NaN,NaN,NaN,1.1048061714190958,48.385659955600744,-4363770,0.2353959761301052,-1.80609182011818,-2.041487796248285
2021-12-21T13:30:00-05:00,18.8,19.01,18.64,18.92,NaN,NaN,NaN,21.310932672018396,NaN,NaN,24.209899999999944,33.9119629744404,14.507837025559486,16.946604904127067,18.681081479827718,18.840320614311903,18.521842345343533,161713,281790,39.256706266155334,31.13125233322155,NaN,NaN,NaN,NaN,1.0523200163177318,46.94620333175218,-4202057,0.2900358917041146,-1.678942931618142,-1.9689788233222565
2021-12-22T09:30:00-05:00,18.63,18.875,18.04,18.31,NaN,NaN,NaN,21.310932672018396,NaN,NaN,23.876699999999943,33.215236418519126,14.53816358148076,16.946604904127067,18.40833333333333,18.40833333333333,18.40833333333333,307556,265795.23333333334,36.70695061987214,32.02609123705202,NaN,NaN,NaN,NaN,1.0400114437236083,46.003415504455816,-4509613,0.28810100068861,-1.608852572461494,-1.896953573150104
2021-12-22T13:30:00-05:00,18.32,18.49,18.18,18.37,NaN,NaN,NaN,21.310932672018396,NaN,NaN,23.57489999999994,32.62601363093008,14.523786369069795,16.816745175031993,18.393949748409643,18.420028479620854,18.367871017198432,93559,254327.26666666666,37.13943367061483,32.7368612587183,NaN,NaN,NaN,NaN,0.987867769171922,45.12796966482348,-4416054,0.2929087414236482,-1.5308176463705436,-1.8237263877941918
2021-12-23T09:30:00-05:00,18.29,19.1,17.89,19.04,NaN,NaN,NaN,21.310932672018396,NaN,NaN,23.27849999999994,31.924528510247253,14.632471489752628,16.96645352961638,18.676666666666666,18.676666666666666,18.676666666666666,272505,255581.5,41.91256625222978,33.96584135586487,NaN,NaN,NaN,NaN,1.0037343570882133,43.52149722673064,-4143549,0.3399517800574243,-1.3987866627224115,-1.7387384427798358
2021-12-23T13:30:00-05:00,19.06,19.245,18.88,18.89,NaN,NaN,NaN,21.310932672018396,NaN,NaN,22.99209999999994,31.24289683182227,14.74130316817761,17.355662823693102,18.797620404085823,18.955997603171635,18.63924320500001,158938,255219,41.15905159062301,34.92506170747653,NaN,NaN,NaN,NaN,0.9581104744390554,41.84738245025561,-4302487,0.35789570815790506,-1.2913688075824545,-1.6492645157403596
2021-12-27T09:30:00-05:00,18.83,18.85,18.23,18.35,NaN,NaN,NaN,21.310932672018396,NaN,NaN,22.702699999999947,30.56002504355058,14.845374956449312,17.355662823693102,18.476666666666667,18.476666666666667,18.476666666666667,236638,254695.96666666667,38.47718061477268,35.84309287096486,NaN,NaN,NaN,NaN,0.93681686912198,40.8142184009317,-4539125,0.33095562155497205,-1.2355699887966445,-1.5665256103516165
2021-12-27T13:30:00-05:00,18.36,18.47,18.25,18.405,NaN,NaN,NaN,21.271721821845436,NaN,NaN,22.455799999999943,30.0578137753103,14.853786224689586,17.355662823693102,18.44361067699421,18.491234135816242,18.39598721817218,114010,253421.86666666667,38.91376629169379,36.22105162100755,NaN,NaN,NaN,NaN,0.8856156641846956,39.854851783702365,-4425115,0.31451254310445464,-1.1733849314710483,-1.487897474575503
2021-12-28T09:30:00-05:00,18.23,18.52,17.695,17.8,NaN,NaN,NaN,20.999370829943373,NaN,NaN,22.20199999999995,29.557488019160015,14.846511980839882,17.355662823693102,18.005,18.005,18.005,287298,252477.9,35.89618539131655,36.66995411506445,NaN,NaN,NaN,NaN,0.8812859738857888,39.39423593062526,-4712413,0.2626742635215651,-1.1595546451735466,-1.4222289086951116
2021-12-28T13:30:00-05:00,17.81,17.81,17.405,17.46,NaN,NaN,NaN,20.42314942858231,NaN,NaN,21.96059999999995,29.12810071921906,14.79309928078084,17.355662823693102,17.78864128656335,18.011865685890676,17.565416887236026,269897,257323.36666666667,34.287044989926585,37.01629035857947,NaN,NaN,NaN,NaN,0.8472655471796608,39.17863518601411,-4982310,0.2076813989939077,-1.1626271599527271,-1.3703085589466348
2021-12-29T09:30:00-05:00,17.35,17.67,16.69,17.21,NaN,NaN,NaN,20.00130172728311,NaN,NaN,21.724999999999945,28.725249709832283,14.724750290167604,17.355662823693102,17.19,17.19,17.19,267797,258116.13333333333,33.11168031277509,36.84353780957044,NaN,NaN,NaN,NaN,0.8567465795239707,39.45955393917524,-5250107,0.1588643603929274,-1.1717281084554756,-1.330592468848403
2021-12-29T13:30:00-05:00,17.2,17.4,17.01,17.105,NaN,NaN,NaN,19.95124255786115,NaN,NaN,21.509099999999943,28.399248529604197,14.61895147039569,17.355662823693102,17.18374027395239,17.192433804537576,17.175046743367208,138843,258916.2,32.60611690489492,36.606306130117346,NaN,NaN,NaN,NaN,0.8234075381294012,39.720407067110564,-5388950,0.12536875690822602,-1.1738815227131205,-1.2992502796213465
2021-12-30T09:30:00-05:00,17.15,18.67,17.14,18.605,NaN,NaN,NaN,19.95124255786115,NaN,NaN,21.32529999999995,28.02251715640205,14.628082843597848,17.355662823693102,18.138333333333335,18.138333333333335,18.138333333333335,310044,260887.8,45.42558831965178,37.62447794251262,NaN,NaN,NaN,NaN,0.8763784282630154,38.132443972377,-5078906,0.20537383668327847,-1.0425329837672486,-1.247906820450527
2021-12-30T13:30:00-05:00,18.62,18.71,18.135,18.22,NaN,NaN,NaN,19.95124255786115,NaN,NaN,21.15409999999995,27.721185408307548,14.587014591692354,17.355662823693102,18.20181783562656,18.300431696039,18.10320397521412,128494,258089.53333333333,43.15650691101304,38.31849029173691,NaN,NaN,NaN,NaN,0.8548513976727999,36.60725107302745,-5207400,0.23156056255501722,-0.9584561172567554,-1.1900166798117726
2021-12-31T09:30:00-05:00,18.11,18.74,17.98,18.08,NaN,NaN,NaN,19.95124255786115,NaN,NaN,20.96269999999995,27.31567920978859,14.609720790211304,17.355662823693102,18.266666666666666,18.266666666666666,18.266666666666666,197998,254949.66666666666,42.32849920845511,38.59837695314247,NaN,NaN,NaN,NaN,0.8480762978390283,35.3370544083421,-5405398,0.23774978966660543,-0.8928294427285159,-1.1305792323951214
2021-12-31T13:30:00-05:00,18.04,18.13,17.72,17.76,NaN,NaN,NaN,19.95124255786115,NaN,NaN,20.763099999999948,26.87432111856593,14.651878881433966,17.008530258954483,18.12303068573061,18.31367252466391,17.932388846797306,112396,253322.56666666668,40.41958434153621,38.68143967281254,NaN,NaN,NaN,NaN,0.8167851337076691,34.40400534313437,-5517794,0.21905146310919332,-0.8567649035086298,-1.075816366617823
2022-01-03T09:30:00-05:00,18.02,18.81,17.92,18.68,NaN,NaN,NaN,19.95124255786115,NaN,NaN,20.57769999999995,26.35909713564169,14.79630286435821,16.8935762380609,18.470000000000002,18.470000000000002,18.470000000000002,418728,259555.96666666667,47.71947215726252,39.4680483540547,NaN,NaN,NaN,NaN,0.8334433384428355,32.60391144431367,-5099066,0.2643689377796714,-0.7453551943932339,-1.0097241321729054
2022-01-03T13:30:00-05:00,18.68,18.93,18.38,18.4,NaN,NaN,NaN,19.95124255786115,NaN,NaN,20.387099999999947,25.8031986290878,14.971001370912095,17.12186099044872,18.503401830333146,18.55056644380178,18.456237216864512,210010,257905.83333333334,45.8771565255566,40.092171415121975,NaN,NaN,NaN,NaN,0.8131973856969187,30.777077174825845,-5309076,0.2702509126950897,-0.6719104913040432,-0.942161403999133
2022-01-04T09:30:00-05:00,18.3,18.3,16.84,16.92,NaN,NaN,NaN,19.95124255786115,NaN,NaN,20.20509999999995,25.461041966955726,14.94915803304417,17.12186099044872,17.353333333333335,17.353333333333335,17.353333333333335,833290,272378.3,37.61149886262402,39.784952315864416,NaN,NaN,NaN,NaN,0.8665404295757101,30.51386964262774,-6142366,0.1739099844346893,-0.7247739234557713,-0.8986839078904606
2022-01-04T13:30:00-05:00,16.93,17.525,16.85,17.38,NaN,NaN,NaN,19.910254594264106,NaN,NaN,20.01109999999995,24.943821070565996,15.078378929433903,17.12186099044872,17.3266596882646,17.371384818122603,17.281934558406594,296386,276151.2,41.15991860064332,39.78501424515158,NaN,NaN,NaN,NaN,0.852858970320302,30.269462648443785,-5845980,0.141957963279028,-0.7212364537916756,-0.8631944170707035
2022-01-05T09:30:00-05:00,17.39,17.5,16.41,16.48,NaN,NaN,NaN,19.70262938543392,NaN,NaN,19.81669999999995,24.519238297558616,15.114161702441287,17.12186099044872,16.796666666666667,16.796666666666667,16.796666666666667,557358,280169.23333333334,36.75519621960629,39.66201535978256,NaN,NaN,NaN,NaN,0.8697976152974233,30.39006255988848,-6403338,0.06492306571791051,-0.7820405849233154,-0.8469636506412259
2022-01-05T13:30:00-05:00,16.48,16.58,15.775,15.97,NaN,NaN,NaN,18.910009867914194,NaN,NaN,19.61709999999995,24.103622524183407,15.130577475816494,17.12186099044872,16.468470583247207,16.812266503692953,16.12467466280146,507925,287352.93333333335,34.501992008958396,39.34688862530145,NaN,NaN,NaN,NaN,0.86516921420475,30.958784691818813,-6911263,-0.011589692659878637,-0.8614507664660742,-0.8498610738061956
2022-01-06T09:30:00-05:00,15.735,16.04,14.81,15.48,NaN,NaN,NaN,18.201032146645368,NaN,NaN,19.430099999999953,23.810089721449657,15.050110278550248,17.12186099044872,15.443333333333333,15.443333333333333,15.443333333333333,1513745,323540.2,32.444075285881425,39.10030933205609,NaN,NaN,NaN,NaN,0.8912285560472678,32.07385067182694,-8425008,-0.0824614905572929,-0.9529379370028117,-0.8704764464455188
2022-01-06T13:30:00-05:00,15.5,15.875,15.43,15.6,NaN,NaN,NaN,18.201032146645368,NaN,NaN,19.26329999999995,23.57832704974199,14.948272950257913,17.12186099044872,15.487545407249407,15.56828742452614,15.406803389972673,453874,324802.3,33.49033199394454,39.04340126091451,NaN,NaN,NaN,NaN,0.8593550877581773,33.10926908183448,-7971134,-0.10696570560729701,-1.00418357845464,-0.897217872847343
2022-01-07T09:30:00-05:00,15.63,16.48,15.52,15.89,NaN,NaN,NaN,18.201032146645368,NaN,NaN,19.111299999999954,23.35490403902216,14.867695960977748,17.12186099044872,15.963333333333331,15.96333357175191,15.963333094914752,526370,331395.76666666666,36.067244485128626,39.2545129875112,NaN,NaN,NaN,NaN,0.8665440100611647,33.14568628090769,-7444764,-0.09003026724465946,-1.0097557069031673,-0.9197254396585078
2022-01-07T13:30:00-05:00,15.88,16.09,15.72,15.88,NaN,NaN,NaN,18.201032146645368,NaN,NaN,18.945699999999952,23.031607003347666,14.859792996652239,17.12186099044872,15.940883239418163,15.972389845247593,15.909376633588733,267254,330582.8,36.01542535426813,39.49803501960928,NaN,NaN,NaN,NaN,0.8310765807710814,33.17950225147567,-7712018,-0.06694914256093132,-1.003411867859672,-0.9364627252987406
2022-01-10T09:30:00-05:00,15.43,15.96,14.76,15.02,NaN,NaN,NaN,18.048535375451376,NaN,NaN,18.805099999999953,22.937595367209177,14.672604632790728,17.12186099044872,15.246666666666666,15.246666666666666,15.246666666666666,579431,335541.0333333333,31.785872707226474,38.52376961872176,NaN,NaN,NaN,NaN,0.8574282535731471,33.87405637620447,-8291449,-0.09531839505524298,-1.0556107191177944,-0.9602923240625514
2022-01-10T13:30:00-05:00,15.03,15.63,14.97,15.63,NaN,NaN,NaN,17.956329222021772,NaN,NaN,18.684899999999953,22.83017368939681,14.539626310603097,16.073488792358976,15.29469723200605,15.369115355685224,15.220279108326874,241368,335395.1666666667,37.40135291788216,38.11268719064098,NaN,NaN,NaN,NaN,0.8433262354607794,34.51899949202408,-8050081,-0.06041936839635764,-1.0358165345579984,-0.9753971661616407
2022-01-11T09:30:00-05:00,15.56,16.815,15.36,16.67,NaN,NaN,NaN,17.956329222021772,NaN,NaN,18.582699999999953,22.66925464174961,14.496145358250295,15.406291033887182,16.281666666666666,16.281666666666666,16.281666666666666,639708,346580.76666666666,45.62065157044667,38.34784093078324,NaN,NaN,NaN,NaN,0.8870172186421524,33.41506028950011,-7410373,0.03988482868388332,-0.9255411303067866,-0.96542595899067
2022-01-11T13:30:00-05:00,16.68,16.78,16.37,16.4,NaN,NaN,NaN,17.956329222021772,NaN,NaN,18.473499999999955,22.495204738043892,14.451795261956018,15.260032827109747,16.334709051641536,16.4329509259376,16.23646717734547,186481,349541.0333333333,44.00521801700785,38.603957621888355,NaN,NaN,NaN,NaN,0.852944560167713,32.38997388715643,-7596854,0.09223356252616255,-0.8501340058329667,-0.9423675683591293
2022-01-12T09:30:00-05:00,16.76,17.2,16.06,16.49,NaN,NaN,NaN,17.956329222021772,NaN,NaN,18.338699999999957,22.160508896321822,14.51689110367809,14.954851290288069,16.583333333333332,16.583333333333332,16.583333333333332,309620,353307.8,44.70805229233223,38.38885620296476,NaN,NaN,NaN,NaN,0.8734485201557336,30.892348421806336,-7287234,0.13454467396083325,-0.7741867259080877,-0.9087313998689209
2022-01-12T13:30:00-05:00,16.49,16.545,16.22,16.24,NaN,NaN,NaN,17.956329222021772,NaN,NaN,18.209099999999957,21.8636504183147,14.554549581685217,14.954851290288069,16.513781614861387,16.625292011438525,16.40227121828425,120452,351932.43333333335,43.090102342674854,38.1897809041875,NaN,NaN,NaN,NaN,0.8342736258588958,29.501696203981254,-7407686,0.14634171952872166,-0.7258042504580189,-0.8721459699867405
2022-01-13T09:30:00-05:00,16.28,16.3,15.32,15.45,NaN,NaN,NaN,17.956329222021772,NaN,NaN,18.06209999999996,21.553833718370292,14.570366281629624,14.954851290288069,15.69,15.69,15.69,380757,354372.4666666667,38.36524137603882,38.2436196551457,NaN,NaN,NaN,NaN,0.8446826525832604,29.08061785777054,-7788443,0.1035996383024107,-0.7426464221087272,-0.8462460604111379
2022-01-13T13:30:00-05:00,15.44,15.545,15.26,15.29,NaN,NaN,NaN,17.956329222021772,NaN,NaN,17.89389999999996,21.079952284568453,14.707847715431464,14.954851290288069,15.616781397894531,15.752557249908032,15.48100554588103,110725,354944.6666666667,37.46912858679988,37.97999179701402,NaN,NaN,NaN,NaN,0.8047053202558846,28.742974780223314,-7899168,0.0688831031991709,-0.7601421814121743,-0.8290252846113452
2022-01-14T09:30:00-05:00,15.09,15.72,14.765,14.765,NaN,NaN,NaN,17.81162793717429,NaN,NaN,17.748199999999958,20.82510803242542,14.671291967574495,14.954851290288069,15.083333333333334,15.083333333333334,15.083333333333334,280307,355204.73333333334,34.612330254407766,37.82692994235698,NaN,NaN,NaN,NaN,0.8154406545233214,28.86135731177187,-8179475,0.017566277242415662,-0.8070674380583256,-0.8246337153007413
2022-01-14T13:30:00-05:00,14.765,15.215,14.73,15.15,NaN,NaN,NaN,17.49098575821182,NaN,NaN,17.612799999999957,20.535430431649534,14.690169568350381,14.954851290288069,15.06061377612547,15.086258766071317,15.034968786179622,220003,357240.23333333334,38.325926905014875,38.10006814921816,NaN,NaN,NaN,NaN,0.7918377506287984,29.001360125368432,-7959472,0.016568860368385785,-0.803922639840259,-0.8204915002086448
2022-01-18T09:30:00-05:00,14.85,14.95,14.27,14.38,NaN,NaN,NaN,17.134009132838557,NaN,NaN,17.490599999999958,20.432683370675303,14.548516629324613,14.954851290288069,14.533333333333333,14.533333501920728,14.533333164745939,359188,361325.23333333334,34.14870292523642,38.221827266314946,NaN,NaN,NaN,NaN,0.7981350541553127,29.521107699073468,-8318660,-0.02658420499457037,-0.8537217564518578,-0.8271375514572874
2022-01-18T13:30:00-05:00,14.405,14.81,14.37,14.4,NaN,NaN,NaN,17.059281444982258,NaN,NaN,17.375799999999956,20.34324628258105,14.408353717418862,14.954851290288069,14.531478010673183,14.534465751544234,14.528490269802132,138508,362141.8333333333,34.34885557795384,38.28315037945846,NaN,NaN,NaN,NaN,0.7725539788585047,30.003730446085292,-8180152,-0.04342091394980374,-0.881413693894542,-0.8379927799447383
2022-01-19T09:30:00-05:00,14.48,14.63,13.96,14.25,NaN,NaN,NaN,16.743405015664884,NaN,NaN,17.275199999999955,20.31770354806764,14.232696451932268,14.954851290288069,14.280000000000001,14.280000000000001,14.280000000000001,408615,366185.73333333334,33.525813039107035,38.1016195618855,NaN,NaN,NaN,NaN,0.7652286946543257,30.795007236199602,-8588767,-0.05363047023940881,-0.9050308677439993,-0.8514003975045905
2022-01-19T13:30:00-05:00,14.25,14.37,13.84,13.89,NaN,NaN,NaN,16.514386605861933,NaN,NaN,17.159399999999952,20.267021366898568,14.051778633101337,14.954851290288069,14.201205347030687,14.316215855518058,14.086194838543316,191793,363582.26666666666,31.570622527399635,37.784133645680605,NaN,NaN,NaN,NaN,0.7484266450361596,31.627442669650023,-8780560,-0.07243052852799425,-0.9419385581645834,-0.8695080296365891
2022-01-20T09:30:00-05:00,14.1,14.83,14.01,14.32,NaN,NaN,NaN,16.514386605861933,NaN,NaN,17.070999999999955,20.24450972899158,13.89749027100833,14.586381032230456,14.386666666666665,14.386666666666665,14.386666666666665,583414,374102.8333333333,36.345779008849476,38.109841238653686,NaN,NaN,NaN,NaN,0.7621104561050053,31.510743939806574,-8197146,-0.045048378681089796,-0.9258185029879513,-0.8807701243068615
2022-01-20T13:30:00-05:00,14.32,14.32,13.66,13.71,NaN,NaN,NaN,16.397684903275028,NaN,NaN,16.962399999999956,20.215895498691147,13.708904501308764,14.243104825784364,14.251250409833862,14.470376864725724,14.032123954942,222807,376901.63333333336,32.844303170232905,37.78433768525016,NaN,NaN,NaN,NaN,0.7548168520975048,31.736692995695602,-8419953,-0.056423229017748766,-0.9512991605790475,-0.8948759315612987
2022-01-21T09:30:00-05:00,13.39,13.67,12.78,12.99,NaN,NaN,NaN,15.650062862217071,NaN,NaN,16.85459999999996,20.266400017586516,13.442799982413401,13.812087088501993,13.146666666666667,13.146666666666667,13.146666666666667,849783,394892.93333333335,29.261072716809167,36.61579633856177,NaN,NaN,NaN,NaN,0.7673299340905403,32.66172396507141,-9269736,-0.09838527083866588,-1.0178575201096312,-0.9194722492709653
2022-01-21T13:30:00-05:00,12.98,13.24,12.9,12.99,NaN,NaN,NaN,15.431196368479931,NaN,NaN,16.724399999999957,20.218327669543754,13.230472330456157,13.812087088501993,13.12282216056619,13.166358028834077,13.079286292298304,254912,399106.86666666664,29.261072716809167,35.56264310283329,NaN,NaN,NaN,NaN,0.7368063673697874,33.520681293777514,-9269736,-0.11114609425605426,-1.058404867091033,-0.9472587728349788
2022-01-24T09:30:00-05:00,12.26,12.61,11.155,12.49,NaN,NaN,NaN,14.386596533549026,NaN,NaN,16.610399999999956,20.273475123445262,12.947324876554648,13.446169670801593,12.085,12.085,12.085,1404372,439319.3333333333,26.897677536163627,34.29047347739267,NaN,NaN,NaN,NaN,0.815248769700517,35.348016292451426,-10674108,-0.13659072372739944,-1.1179971774942281,-0.9814064537668287
2022-01-24T13:30:00-05:00,12.47,13.155,12.47,13.13,NaN,NaN,NaN,14.386596533549026,NaN,NaN,16.510399999999958,20.27370165679063,12.747098343209286,13.10594858931302,12.260138816947226,12.599661141575572,11.92061649231888,373689,448029.1,34.22130141502642,33.656987696846365,NaN,NaN,NaN,NaN,0.8059452861504799,36.12888310133848,-10300419,-0.09558801294408958,-1.1008914699469408,-1.0053034570028512
2022-01-25T09:30:00-05:00,12.88,13.42,12.705,13.08,NaN,NaN,NaN,14.386596533549026,NaN,NaN,16.39139999999996,20.204448145513382,12.578351854486534,13.10594858931302,13.068333333333333,13.068333333333333,13.068333333333333,519085,451374.3333333333,33.935265333287546,33.34056083664984,NaN,NaN,NaN,NaN,0.7994491942825884,36.430860620642946,-10819504,-0.05890315005830904,-1.0789323945757374,-1.0200292445174284
2022-01-25T13:30:00-05:00,13.09,13.47,12.955,13.055,NaN,NaN,NaN,14.386596533549026,NaN,NaN,16.27069999999996,20.11634585473014,12.425054145269774,13.061125677728267,13.10388563664288,13.148551002040731,13.05922027124503,328876,455336.5333333333,33.783217583660246,33.077281479282725,NaN,NaN,NaN,NaN,0.7791313946909749,36.62944939605428,-11148380,-0.02511801792611501,-1.051426766925072,-1.026308748998957
2022-01-26T09:30:00-05:00,13.35,13.57,12.92,13.49,NaN,NaN,NaN,14.386596533549026,NaN,NaN,16.186299999999957,20.086730135254687,12.285869864745226,13.061125677728267,13.326666666666668,13.326666666666668,13.326666666666668,490809,443920.5,38.91204696765193,33.38440410165732,NaN,NaN,NaN,NaN,0.7699077236416195,36.64208538030994,-10657571,0.0344919210930299,-0.9831938476326698,-1.0176857687256997
2022-01-26T13:30:00-05:00,13.46,13.58,12.34,12.41,NaN,NaN,NaN,14.386596533549026,NaN,NaN,16.07369999999996,20.07727081116381,12.070129188836109,13.061125677728267,13.003068252471914,13.273739998573683,12.732396506370145,701519,457424.93333333335,32.23611303570448,32.94941739670657,NaN,NaN,NaN,NaN,0.8034857433815039,37.0934159176679,-11359090,0.01040112250619929,-1.0046843655929507,-1.01508548809915
2022-01-27T09:30:00-05:00,12.63,12.63,11.475,11.57,NaN,NaN,NaN,14.386596533549026,NaN,NaN,15.929299999999957,20.04968542371982,11.808914576280095,12.574900542182613,11.891666666666666,11.891666666666666,11.891666666666666,815886,466042.5333333333,28.18571892214416,32.523489967914266,NaN,NaN,NaN,NaN,0.8285939045685394,38.06358782552471,-12174976,-0.04959626433511022,-1.0770808185180378,-1.0274845541829276
2022-01-27T13:30:00-05:00,11.57,11.87,11.4,11.615,NaN,NaN,NaN,14.094939593479047,NaN,NaN,15.783199999999958,19.986259247738825,11.58014075226109,11.80892043374609,11.788234780149445,11.916838467114538,11.659631093184352,527754,466703.5,28.702547520166476,32.120182249500886,NaN,NaN,NaN,NaN,0.8029800542422151,39.008403652114254,-11647222,-0.07236237051156769,-1.117937517322387,-1.0455751468108194
2022-01-28T09:30:00-05:00,9.97,12.85,9.95,12.17,NaN,NaN,NaN,14.094939593479047,NaN,NaN,15.660399999999957,19.919393702742813,11.4014062972571,11.715455558183935,11.656666666666666,11.656666666666666,11.656666666666666,1619638,470233.26666666666,34.92308392802016,32.21998731299468,NaN,NaN,NaN,NaN,0.952767193224914,40.602964219766804,-10027584,-0.0378872573252802,-1.0929342184674198,-1.0550469611421396
2022-01-28T13:30:00-05:00,12.17,12.75,11.94,12.74,NaN,NaN,NaN,14.094939593479047,NaN,NaN,15.547799999999956,19.81198299794964,11.283617002050272,11.715455558183935,11.892380388628712,12.263492626755772,11.521268150501653,653397,476884.0333333333,40.65024395143322,32.868531700425656,NaN,NaN,NaN,NaN,0.9425695365659916,42.083627604015604,-9374187,0.03170191849073989,-1.0154195630287148,-1.0471214815194547
2022-01-31T09:30:00-05:00,12.65,14.525,11.86,13.9,10.223826016603168,10.223826016603168,10.223826016603168,NaN,NaN,NaN,15.444999999999958,19.614240698256996,11.27575930174292,11.715455558183935,13.428333333333333,13.428333333333333,13.428333333333333,1377894,505268.1666666667,50.24653669401321,33.86144296365163,NaN,NaN,NaN,NaN,1.0656002839541352,40.84947234144677,-7996293,0.15723209547124428,-0.8505813621803995,-1.0078134576516438
2022-01-31T13:30:00-05:00,13.9,14.215,13.62,14.165,11.002629379484842,NaN,NaN,NaN,NaN,NaN,15.350499999999956,19.41602296759012,11.284977032409792,11.715455558183935,13.615975316406326,13.884413676516214,13.347536956296437,673266,518801.9,52.14997703107049,35.24041966799717,NaN,NaN,NaN,NaN,1.0319859779574112,39.70347102620428,-7323027,0.25376933605108754,-0.6906017875877843,-0.9443711236388719
2022-02-01T09:30:00-05:00,14.29,14.69,13.41,14.565,11.093078044053714,NaN,NaN,NaN,NaN,NaN,15.274799999999955,19.254141131393837,11.29545886860607,11.715455558183935,14.221666666666666,14.221666666666666,14.221666666666666,966449,531702.5,54.95150546178695,37.07545057835273,NaN,NaN,NaN,NaN,1.0497012652461675,38.054040888970356,-6356578,0.3351107170763583,-0.5254827272934239,-0.8605934443697822
2022-02-01T13:30:00-05:00,14.56,14.74,14.22,14.66,11.586574496596727,NaN,NaN,NaN,NaN,NaN,15.199899999999957,19.080505875375973,11.31929412462394,11.91869015134442,14.299577589182332,14.436440775686988,14.162714402677677,313186,534096.4333333333,55.61614504280101,38.957955744495,NaN,NaN,NaN,NaN,1.011865460585727,36.46089298687668,-6043392,0.3824354055474066,-0.382549187435524,-0.7649845929829306
2022-02-02T09:30:00-05:00,14.5,14.85,13.55,14.045,11.586574496596727,NaN,NaN,NaN,NaN,NaN,15.124799999999954,18.94610917880285,11.303490821197059,11.942952121075535,14.148333333333332,14.148333501920726,14.148333164745937,772550,538524.5,50.429064141929565,40.63876907347829,NaN,NaN,NaN,NaN,1.0324464991153177,35.561291458764394,-6815942,0.3597760628098102,-0.31526451447066783,-0.6750405772804781
2022-02-02T13:30:00-05:00,14.045,14.07,13.815,14.02,11.586574496596727,NaN,NaN,NaN,NaN,NaN,15.055999999999957,18.830236876509293,11.281763123490618,11.942952121075535,14.10250046552644,14.180917711294475,14.024083219758404,263911,541105.5,50.22400315632123,41.781819197856485,NaN,NaN,NaN,NaN,0.9769146063213665,34.72594718266012,-7079853,0.3312723445457816,-0.2609501465982511,-0.5922224911440327
2022-02-03T09:30:00-05:00,13.39,14.625,13.24,14.42,11.586574496596727,NaN,NaN,NaN,NaN,NaN,15.000199999999955,18.72761087619845,11.27278912380146,11.969989357488343,14.095,14.095,14.095,733021,555218.8666666667,53.48324234391597,43.17810327004423,NaN,NaN,NaN,NaN,1.0060635630126975,34.42609094098302,-6346832,0.3269671673774973,-0.18351353192216102,-0.5104806992996583
2022-02-03T13:30:00-05:00,14.415,14.675,14.05,14.17,11.586574496596727,NaN,NaN,NaN,NaN,NaN,14.941499999999953,18.626677471981882,11.256322528018023,12.238491485990675,14.16171111123333,14.25717953667044,14.06624268579622,357926,563134.6666666666,51.225635450799366,44.42399026055417,NaN,NaN,NaN,NaN,0.9788447370832191,34.07188014456962,-6704758,0.2958281456709179,-0.14069551721101092,-0.43652366288192884
2022-02-04T09:30:00-05:00,14.28,15.325,13.77,15.03,11.611646298789898,NaN,NaN,NaN,NaN,NaN,14.869999999999955,18.40369664798815,11.33630335201176,12.598293188792539,14.708333333333334,14.708333333333334,14.708333333333334,923205,581216.2666666667,57.82140967754038,45.7746590255462,NaN,NaN,NaN,NaN,1.0199986844344175,32.798260658683795,-5781553,0.319665903692084,-0.03694128326682389,-0.35660718695890786
2022-02-04T13:30:00-05:00,15.03,15.275,14.94,15.15,12.25941237611763,NaN,NaN,NaN,NaN,NaN,14.808599999999956,18.21159928886306,11.405600711136852,12.926134551034032,14.830164126656737,15.018615674024282,14.641712579289191,385845,590386.9333333333,58.66144383078659,47.66218265376635,NaN,NaN,NaN,NaN,0.9710702069748163,31.61561399321839,-5395708,0.3287587730225429,0.0543412793192708,-0.2744174937032721
2022-02-07T09:30:00-05:00,15.07,15.23,14.175,14.29,12.25941237611763,NaN,NaN,NaN,NaN,NaN,14.732799999999955,18.007364496234985,11.458235503764925,12.926134551034032,14.565,14.565000168587394,14.564999831412605,654575,602862.5333333333,50.84584529274701,49.28076310880942,NaN,NaN,NaN,NaN,0.9770651921909008,31.249584378940682,-6050283,0.26484255025598064,0.05663569411670366,-0.20820685613927697
2022-02-07T13:30:00-05:00,14.3,14.32,13.775,13.9,12.25941237611763,NaN,NaN,NaN,NaN,NaN,14.655599999999954,17.82124409875824,11.489955901241668,12.926134551034032,14.375283968671273,14.642704197044422,14.107863740298123,329442,606510.5,47.73957742273385,50.6405509589928,NaN,NaN,NaN,NaN,0.9462033927486936,31.24819056127346,-6379725,0.1879069092482649,0.026676780421054147,-0.16123012882721074
2022-02-08T09:30:00-05:00,13.8,13.8,12.94,13.195,12.25941237611763,NaN,NaN,NaN,NaN,NaN,14.545899999999952,17.520487494091096,11.571312505908809,12.926134551034032,13.311666666666667,13.311666666666667,13.311666666666667,1002218,627944.8333333334,42.6653707713611,51.19357144780287,NaN,NaN,NaN,NaN,0.9471888646952156,31.868680715627224,-7381943,0.0863132005883833,-0.05333862809173162,-0.13965182868011491
2022-02-08T13:30:00-05:00,13.2,13.385,13.165,13.38,12.25941237611763,NaN,NaN,NaN,NaN,NaN,14.445499999999951,17.225476438749652,11.665523561250248,12.926134551034032,13.311131400391593,13.311909603728646,13.31035319705454,474150,639132.9,44.33731215821869,51.45693346257326,NaN,NaN,NaN,NaN,0.8952468029312717,32.44485014467,-6907793,0.031190998468087705,-0.10066308059500528,-0.131854079063093
2022-02-09T09:30:00-05:00,13.49,14.27,13.22,13.98,12.25941237611763,NaN,NaN,NaN,NaN,NaN,14.386699999999951,17.077782020303932,11.695617979695971,12.926134551034032,13.823333333333332,13.823333333333332,13.823333333333332,907941,655777.1,49.482595272720616,51.40236621819521,NaN,NaN,NaN,NaN,0.906300602721895,31.634040507315902,-5999852,0.03449907315391157,-0.08873023762070353,-0.1232293107746151
2022-02-09T13:30:00-05:00,13.985,14.055,13.805,13.91,12.25941237611763,NaN,NaN,NaN,NaN,NaN,14.317299999999953,16.871521767976116,11.76307823202379,12.926134551034032,13.854375335128786,13.900641892209563,13.808108778048009,408717,663007.9,48.9145090270586,51.1712613607658,NaN,NaN,NaN,NaN,0.8594219882417597,30.881145844058533,-6408569,0.03142023349387693,-0.08395401890726895,-0.11537425240114588
2022-02-10T09:30:00-05:00,13.37,14.695,13.35,13.93,12.25941237611763,NaN,NaN,NaN,NaN,NaN,14.266299999999951,16.746514353640258,11.786085646359645,12.926134551034032,13.991666666666667,13.991666666666667,13.991666666666667,916101,674097.4666666667,49.09433175708595,50.75289181043001,NaN,NaN,NaN,NaN,0.894106131938777,29.304377550541684,-5492468,0.030171574195270195,-0.07765978465705814,-0.10783135885232834
2022-02-10T13:30:00-05:00,13.93,14.005,13.39,13.53,12.25941237611763,NaN,NaN,NaN,NaN,NaN,14.21749999999995,16.65739774375963,11.777602256240268,12.926134551034032,13.864585532033233,14.032897095337596,13.696273968728871,522249,684078.8666666667,45.634499926332325,50.039917159253676,NaN,NaN,NaN,NaN,0.8741699796574357,27.840235563704613,-6014717,0.0032633073503717663,-0.10375222466436362,-0.10701553201473539
2022-02-11T09:30:00-05:00,13.53,14.18,13.53,13.63,12.25941237611763,NaN,NaN,NaN,NaN,NaN,14.180499999999949,16.598706980389288,11.762293019610611,12.926134551034032,13.780000000000001,13.780000000000001,13.780000000000001,537219,673660.0666666667,46.64679893163989,49.7697553585187,NaN,NaN,NaN,NaN,0.8581578382533331,26.238388944502905,-5477498,-0.006415934412241295,-0.11503545003003701,-0.10861951561779572
2022-02-11T13:30:00-05:00,13.63,13.63,13.075,13.31,12.25941237611763,NaN,NaN,NaN,NaN,NaN,14.134699999999947,16.530270420589535,11.73912957941036,12.823407640827226,13.598278801822282,13.815620933022565,13.380936670621999,375556,677681.5333333333,43.8340456491093,49.313329822289276,NaN,NaN,NaN,NaN,0.8365037069495237,25.29335079178428,-5853054,-0.0315777507786584,-0.14809170409111871,-0.11651395331246031
2022-02-14T09:30:00-05:00,13.13,13.865,13.11,13.32,12.25941237611763,NaN,NaN,NaN,NaN,NaN,14.08329999999995,16.435916084278,11.730683915721903,12.613405452597013,13.431666666666667,13.431666666666667,13.431666666666667,615904,651399.2666666667,43.94779193491208,48.632226221646135,NaN,NaN,NaN,NaN,0.8306820135959863,24.0707791104609,-5237150,-0.04399291982619297,-0.1715051030952015,-0.12751218326900854
2022-02-14T13:30:00-05:00,13.3,13.465,12.97,13.34,12.25941237611763,NaN,NaN,NaN,NaN,NaN,14.032499999999947,16.33693680755269,11.728063192447207,12.613405452597013,13.361294268819051,13.446415405528851,13.276173132109252,420962,652975.0333333333,44.19122593943134,48.12976839940556,NaN,NaN,NaN,NaN,0.8067047269105586,23.110599705340892,-4816188,-0.04702946819996731,-0.18629901851896769,-0.13926955031900037
2022-02-15T09:30:00-05:00,13.55,13.77,13.31,13.465,12.25941237611763,NaN,NaN,NaN,NaN,NaN,14.001399999999949,16.293628644791692,11.709171355208206,12.613405452597013,13.515,13.515,13.515,436282,650214.9333333333,45.77627449817097,47.26940160087917,NaN,NaN,NaN,NaN,0.7819401035598043,21.753317056256968,-4379906,-0.03722045357412848,-0.18579511728666098,-0.1485746637125325
2022-02-15T13:30:00-05:00,13.46,13.71,13.42,13.67,12.25941237611763,NaN,NaN,NaN,NaN,NaN,13.96219999999995,16.208255351055172,11.716144648944729,12.613405452597013,13.54569347629982,13.586520624107845,13.504866328491794,246582,647471.8,48.36628766151471,46.53403330307403,NaN,NaN,NaN,NaN,0.746801524734104,20.492983167821897,-4133324,-0.014684047627322255,-0.1669297232466853,-0.15224567561936306
2022-02-16T09:30:00-05:00,13.62,14.06,13.325,13.415,12.25941237611763,NaN,NaN,NaN,NaN,NaN,13.89709999999995,16.010200177465233,11.783999822534668,12.613405452597013,13.6,13.6,13.6,420668,645133.7666666667,45.45764384099116,46.14916177080577,NaN,NaN,NaN,NaN,0.745958558681668,19.27655320830091,-4553992,-0.014674412451761598,-0.17058869118406506,-0.15591427873230346
2022-02-16T13:30:00-05:00,13.41,13.78,13.285,13.48,12.25941237611763,NaN,NaN,NaN,NaN,NaN,13.838699999999951,15.829756814860733,11.84764318513917,12.613405452597013,13.569801342569887,13.610482136207494,13.52912054893228,231812,629476.8666666667,46.34342932751907,46.04943690686185,NaN,NaN,NaN,NaN,0.7280329473472632,18.081447226900217,-4322180,-0.008329527495410105,-0.16632618810156607,-0.15799666060615597
2022-02-17T09:30:00-05:00,13.46,13.46,12.375,12.4,12.25941237611763,NaN,NaN,NaN,NaN,NaN,13.756899999999952,15.638595926552263,11.875204073447641,12.558106962537977,12.745,12.745,12.745,587725,621871.5,35.908546559335505,45.56680660600288,NaN,NaN,NaN,NaN,0.7549591653938873,17.915928367265167,-4909905,-0.07139868045765446,-0.24724501117822406,-0.1758463307205696
2022-02-17T13:30:00-05:00,12.4,12.525,12.15,12.25,NaN,NaN,NaN,14.67402476045541,14.67402476045541,14.67402476045541,13.67709999999995,15.46698948262278,11.887210517377119,12.558106962537977,12.578927521699875,12.79091395399122,12.36694108940853,360706,616303.2333333333,34.738605522308134,44.88118470343784,NaN,NaN,NaN,NaN,0.7278192250086096,18.035305284962124,-5270611,-0.11515585901311698,-0.3197911544869658,-0.20463529547384884
2022-02-18T09:30:00-05:00,12.31,12.435,11.645,11.68,NaN,NaN,NaN,14.37804636225289,NaN,NaN,13.601699999999951,15.404082434447089,11.799317565552814,12.558106962537977,11.92,11.92,11.92,584671,581804.3333333334,30.65174653301807,43.53612407917337,NaN,NaN,NaN,NaN,0.7322607089365661,18.713955283135636,-5855282,-0.17105579784743039,-0.41845504278313683,-0.24739924493570645
2022-02-18T13:30:00-05:00,11.685,12.08,11.68,11.8,NaN,NaN,NaN,14.166316982150486,NaN,NaN,13.53189999999995,15.337656229396247,11.726143770603654,12.558106962537977,11.897634796748337,11.929111950902337,11.866157642594336,295166,569863.3,32.453402334421796,42.360330743985024,NaN,NaN,NaN,NaN,0.7085278011553829,19.34413028143961,-5560116,-0.18721215761769128,-0.48141444195782057,-0.2942022843401293
2022-02-22T09:30:00-05:00,11.47,11.725,10.99,11.24,NaN,NaN,NaN,13.650348028416374,NaN,NaN,13.461399999999948,15.342744242823109,11.580055757176787,12.558106962537977,11.318333333333333,11.318333333333333,11.318333333333333,897224,553840.9666666667,28.705464797867066,40.90398310404082,NaN,NaN,NaN,NaN,0.7157758153585699,20.63028937699894,-6457340,-0.22058038593508034,-0.5699277667589797,-0.3493473808238994
2022-02-22T13:30:00-05:00,11.255,11.7,11.155,11.31,NaN,NaN,NaN,13.650348028416374,NaN,NaN,13.384599999999951,15.297199111158248,11.472000888841654,12.558106962537977,11.337096516646652,11.36810241582604,11.306090617467262,328568,542351.0333333333,29.796863226662694,39.77272333977869,NaN,NaN,NaN,NaN,0.7035775428329577,21.824579965732607,-6128772,-0.22227958681822385,-0.6271968643466792,-0.40491727752845535
2022-02-23T09:30:00-05:00,11.42,11.57,10.98,11.045,NaN,NaN,NaN,13.515539215974425,NaN,NaN,13.31789999999995,15.317618070129734,11.318181929870166,12.558106962537977,11.198333333333332,11.198333333333332,11.198333333333332,508234,527077.2,28.046461718337,38.444127824542775,NaN,NaN,NaN,NaN,0.6954648612020321,23.105002383872115,-6637006,-0.22491247715653,-0.6860578739741179,-0.46114539681758787
2022-02-23T13:30:00-05:00,11.05,11.165,10.83,10.86,NaN,NaN,NaN,13.181878342521038,NaN,NaN,13.24709999999995,15.337183338052174,11.157016661947726,12.558106962537977,11.071850297556562,11.195143405578165,10.94855718953496,534873,534466.7666666667,26.860183268966324,37.231709083104,NaN,NaN,NaN,NaN,0.6697173711161726,24.440956058604616,-7171879,-0.22237453135861285,-0.7391135610158539,-0.5167390296572411
2022-02-24T09:30:00-05:00,9.99,11.31,9.94,10.85,NaN,NaN,NaN,12.896906599679173,NaN,NaN,13.179099999999949,15.353766585939901,11.004433414059996,12.330985570030382,10.700000000000001,10.700000000000001,10.700000000000001,873882,537844.5,26.794210838079067,36.00645329047307,NaN,NaN,NaN,NaN,0.7197375588935888,26.42611952063359,-8045761,-0.2050537212519361,-0.7730561812221612,-0.5680024599702251
2022-02-24T13:30:00-05:00,10.86,11.645,10.86,11.53,NaN,NaN,NaN,12.896906599679173,NaN,NaN,13.131899999999948,15.3449060008964,10.918893999103497,11.748288456024307,10.961934100751106,11.27869587535179,10.645172326150423,597546,548965.6666666666,37.9541069391571,35.56094479045348,NaN,NaN,NaN,NaN,0.7251134475440467,27.533301672403642,-7448215,-0.13487373673225156,-0.7365946308855396,-0.601720894153288
2022-02-25T09:30:00-05:00,11.69,11.69,10.93,11.39,NaN,NaN,NaN,12.896906599679173,NaN,NaN,13.07329999999995,15.312378033477907,10.834221966521993,10.968130764819445,11.336666666666666,11.336666666666666,11.336666666666666,547284,542774.4333333333,36.71319569389501,34.91358201871949,NaN,NaN,NaN,NaN,0.7276053441480433,28.463075174322817,-7995499,-0.08726467630064338,-0.7108017395290922,-0.6235370632284488
2022-02-25T13:30:00-05:00,11.4,11.675,11.395,11.62,NaN,NaN,NaN,12.896906599679173,NaN,NaN,13.031499999999948,15.299322082969338,10.763677917030558,10.794504611855556,11.402217624521072,11.504985756926335,11.299449492115809,222666,538265.7666666667,40.17384445501844,34.32840750396976,NaN,NaN,NaN,NaN,0.6959906767088974,29.326436283247766,-7772833,-0.03248694997239032,-0.6641457506939368,-0.6316588007215465
2022-02-28T09:30:00-05:00,11.54,12.09,11.315,11.83,NaN,NaN,NaN,12.896906599679173,NaN,NaN,13.008299999999949,15.300943548396326,10.715656451603571,10.567603689484445,11.745,11.745,11.745,510483,524508.3666666667,43.22642239112142,34.16903454326478,NaN,NaN,NaN,NaN,0.701634199801119,29.184573228503968,-7262350,0.022710109383782262,-0.6032711639918187,-0.6259812733756009
2022-02-28T13:30:00-05:00,11.82,12.03,11.685,12.02,NaN,NaN,NaN,12.896906599679173,NaN,NaN,12.98889999999995,15.298190185317424,10.679609814682475,10.506219685253615,11.804362104105499,11.884173285112471,11.724550923098526,282405,521060.36666666664,45.915288469581476,34.13845305341209,NaN,NaN,NaN,NaN,0.6761603283867533,29.052843249099013,-6979945,0.07394836328833654,-0.5335458192651803,-0.6074941825535168
2022-03-01T09:30:00-05:00,12,12.25,11.605,11.63,NaN,NaN,NaN,12.896906599679173,NaN,NaN,12.971699999999949,15.308247547130883,10.635152452869015,10.708475748202893,11.828333333333333,11.828333333333333,11.828333333333333,465334,514752.3333333333,41.56383620098872,34.54240231353018,NaN,NaN,NaN,NaN,0.6739345906448424,28.433645227940442,-7445279,0.08283653240134936,-0.5039485170518301,-0.5867850494531794
2022-03-01T13:30:00-05:00,11.64,11.95,11.52,11.76,NaN,NaN,NaN,12.896906599679173,NaN,NaN,12.944299999999949,15.30478809359491,10.583811906404987,10.708475748202893,11.802109191379882,11.841369176668197,11.762849206091568,207619,510691.56666666665,43.486453723374176,35.167248613606326,NaN,NaN,NaN,NaN,0.6565106913130679,27.985062865582467,-7237660,0.09771094028433625,-0.4646463740977591,-0.5623573143820954
2022-03-02T09:30:00-05:00,11.74,11.75,11.08,11.4,NaN,NaN,NaN,12.896906599679173,NaN,NaN,12.910699999999949,15.310013243410172,10.511386756589726,10.708475748202893,11.409999999999998,11.409999999999998,11.409999999999998,308113,487554.73333333334,39.60084159724509,35.80646968962254,NaN,NaN,NaN,NaN,0.6581884990764202,28.18148685675112,-7545773,0.08406430734715076,-0.45727693019815696,-0.5413412375453077
2022-03-02T13:30:00-05:00,11.43,11.54,11.36,11.48,NaN,NaN,NaN,12.896906599679173,NaN,NaN,12.879199999999948,15.311240591767223,10.447159408232672,10.708475748202893,11.425547790500042,11.448692028132234,11.40240355286785,139047,476384.63333333336,40.865344109528465,36.40732267355873,NaN,NaN,NaN,NaN,0.6240321777138187,28.36388056283629,-7406726,0.08114479013568765,-0.43991024987569816,-0.5210550400113858
2022-03-03T09:30:00-05:00,11.51,11.82,11.12,11.67,NaN,NaN,NaN,12.896906599679173,NaN,NaN,12.842799999999949,15.291605553735,10.393994446264898,10.708475748202893,11.536666666666667,11.536666666666667,11.536666666666667,514110,463256.93333333335,43.87090247526561,37.490568221944336,NaN,NaN,NaN,NaN,0.6294584507342603,27.830669765530963,-6892616,0.09193686478816049,-0.4061339590261852,-0.4980708238143457
2022-03-03T13:30:00-05:00,11.67,11.67,11.27,11.38,NaN,NaN,NaN,12.896906599679173,NaN,NaN,12.822199999999947,15.302350930891823,10.342049069108072,10.708475748202893,11.50502482068137,11.550384553498287,11.459665087864455,250172,457972.1,40.48836647341661,38.2542470252839,NaN,NaN,NaN,NaN,0.6130685613960989,27.335545453747446,-7142788,0.07991533985268462,-0.3981766489984899,-0.47809198885117454
2022-03-04T09:30:00-05:00,11.18,11.66,10.96,11.075,NaN,NaN,NaN,12.896906599679173,NaN,NaN,12.81229999999995,15.316203520506166,10.308396479493735,10.708475748202893,11.23166666666667,11.23166666666667,11.23166666666667,392207,440508.9666666667,37.23657896581483,38.910683971532315,NaN,NaN,NaN,NaN,0.619277949867806,27.37353178075018,-7534995,0.053085472688096214,-0.41173514799105426,-0.4648206206791505
2022-03-04T13:30:00-05:00,11.07,11.1,10.85,10.97,NaN,NaN,NaN,12.896906599679173,NaN,NaN,12.799399999999949,15.334298530514259,10.264501469485639,10.708475748202893,11.128367802391004,11.254917731578159,11.00181787320385,261326,431811.5333333333,36.159883055643256,39.574948242009235,NaN,NaN,NaN,NaN,0.592900953448677,27.57660492564391,-7796321,0.03102302970377352,-0.4260418335494336,-0.4570648632532071
2022-03-07T09:30:00-05:00,11.04,12.02,11.04,11.735,NaN,NaN,NaN,12.896906599679173,NaN,NaN,12.79069999999995,15.33713909018161,10.244260909818289,10.708475748202893,11.598333333333334,11.598333333333334,11.598333333333334,1088928,450201.8333333333,47.96511906253072,41.08715597232721,NaN,NaN,NaN,NaN,0.6255508853452001,25.65560050081516,-6707393,0.06855592531434423,-0.37136995661027683,-0.43992588192462107
2022-03-07T13:30:00-05:00,11.725,11.94,11.38,11.42,NaN,NaN,NaN,12.896906599679173,NaN,NaN,12.76429999999995,15.339501747437428,10.189098252562474,10.708475748202893,11.593049342391238,11.601353113038744,11.584745571743731,440933,452381.06666666665,44.33004724123436,41.54258027961845,NaN,NaN,NaN,NaN,0.6208686792491143,23.871810677759896,-7148326,0.07239515845024164,-0.34943193386181903,-0.42182709231206067
2022-03-08T09:30:00-05:00,11.24,12.07,11.02,11.84,NaN,NaN,NaN,12.896906599679173,NaN,NaN,12.723099999999953,15.290206456694909,10.155993543304996,10.502906218583616,11.643333333333333,11.643333333333333,11.643333333333333,583141,451288.9666666667,49.79354134095952,42.4768906829802,NaN,NaN,NaN,NaN,0.6515209164456062,22.8774832968147,-6565185,0.10165557745255432,-0.2947576204963678,-0.3964131979489221
2022-03-08T13:30:00-05:00,11.83,11.91,11.61,11.755,NaN,NaN,NaN,12.896906599679173,NaN,NaN,12.67489999999995,15.222328892040931,10.127471107958968,10.502906218583616,11.68179393897199,11.736050288483987,11.627537589459994,293025,447024.4,48.75077861039923,43.08952883693597,NaN,NaN,NaN,NaN,0.6264122795566343,21.954179300222734,-6858210,0.11285600989933048,-0.255343185574759,-0.36819919547408947
2022-03-09T09:30:00-05:00,12.02,12.465,11.9,12.195,NaN,NaN,NaN,12.896906599679173,NaN,NaN,12.627499999999952,15.120095635076947,10.134904364922956,10.889238387131849,12.186666666666667,12.186666666666667,12.186666666666667,541675,450537.5,54.10831273042724,43.866806718314955,NaN,NaN,NaN,NaN,0.6323828310168746,20.798288585237064,-6316535,0.14539669930576937,-0.18645332134187775,-0.3318500206476471
2022-03-09T13:30:00-05:00,12.19,12.46,12.15,12.43,NaN,NaN,NaN,12.896906599679173,NaN,NaN,12.582899999999949,15.007299381291125,10.158500618708773,11.04439070970548,12.252183490772588,12.330861553890836,12.173505427654339,375610,454838.43333333335,56.711187170642575,44.637942339819325,NaN,NaN,NaN,NaN,0.6093554859442408,19.724961492750374,-5940925,0.1761932020643533,-0.11160851806720551,-0.2878017201315588
2022-03-10T09:30:00-05:00,12.01,12.06,11.61,11.77,NaN,NaN,NaN,12.896906599679173,NaN,NaN,12.53739999999995,14.935582011442145,10.139217988557755,11.04439070970548,11.813333333333333,11.813333333333333,11.813333333333333,518835,458110.6666666667,48.40714707032614,45.12675025905771,NaN,NaN,NaN,NaN,0.6244015226625094,18.95349987851249,-6459760,0.14676368979462567,-0.10434710788827672,-0.2511107976829024
2022-03-10T13:30:00-05:00,11.79,12.09,11.72,12.07,NaN,NaN,NaN,12.896906599679173,NaN,NaN,12.498399999999952,14.862045861800064,10.13475413819984,11.04439070970548,11.858858137052794,11.926714333958603,11.791001940146984,233532,458168,51.8578545275472,45.72470745935578,NaN,NaN,NaN,NaN,0.6062299853294729,18.172999527593152,-6226228,0.14205887486876692,-0.07353720409694375,-0.21559607896571067
2022-03-11T09:30:00-05:00,12.41,12.46,11.145,11.26,NaN,NaN,NaN,12.896906599679173,NaN,NaN,12.43519999999995,14.758588008922485,10.111811991077415,11.04439070970548,11.621666666666668,11.621666666666668,11.621666666666668,594828,458404.76666666666,43.41471444135609,45.99712694822085,NaN,NaN,NaN,NaN,0.6568564149487963,18.403614679978787,-6821056,0.08193626766482442,-0.11317574438468014,-0.19511201204950457
2022-03-11T13:30:00-05:00,11.25,11.29,11.01,11.02,NaN,NaN,NaN,12.896906599679173,NaN,NaN,12.37219999999995,14.674745686844211,10.069654313155688,11.04439070970548,11.401888003340881,11.656610108309248,11.147165898372513,442822,461141.9666666667,41.27063202155525,46.02607608479419,NaN,NaN,NaN,NaN,0.6299380995953108,18.81686541915019,-7263878,0.026419907347610738,-0.16208712786499113,-0.18850703521260187
2022-03-14T09:30:00-04:00,10.81,11.13,10.41,10.495,NaN,NaN,NaN,12.749468517304326,NaN,NaN,12.281499999999951,14.514347733277983,10.04865226672192,11.04439070970548,10.678333333333333,10.678333333333333,10.678333333333333,540103,459656.36666666664,36.96951707064276,45.53311998446399,NaN,NaN,NaN,NaN,0.63637109248136,19.98640639437646,-7803981,-0.04154733781564368,-0.24044120748215647,-0.1988938696665128
2022-03-14T13:30:00-04:00,10.5,10.765,10.45,10.64,NaN,NaN,NaN,12.53994722106322,NaN,NaN,12.19129999999995,14.315061577956607,10.067538422043294,11.04439070970548,10.660588686939283,10.687971278270156,10.63320609560841,226810,457377.8333333333,38.864590902735664,45.417136015129635,NaN,NaN,NaN,NaN,0.6134160144469772,21.072408728515132,-7577171,-0.07090307153978886,-0.2875227090912489,-0.21661963755146002
2022-03-15T09:30:00-04:00,10.62,11.12,10.2,10.8,NaN,NaN,NaN,12.53994722106322,NaN,NaN,12.121499999999951,14.19354464237732,10.049455357622582,11.04439070970548,10.706666666666669,10.706666666666669,10.706666666666669,481921,443534.4,40.97350626366903,45.68405939354779,NaN,NaN,NaN,NaN,0.6353148705579075,21.206355655271075,-7095250,-0.0734001144537943,-0.3083697806187029,-0.2349696661649086
2022-03-15T13:30:00-04:00,10.81,11.06,10.785,11.05,NaN,NaN,NaN,12.53994722106322,NaN,NaN,12.064499999999947,14.094075571395393,10.034924428604501,11.04439070970548,10.797543427927843,10.920904324981244,10.674182530874443,261533,441299.9,44.21177988821222,46.25919488158843,NaN,NaN,NaN,NaN,0.6095780940894855,21.330734944401595,-6833717,-0.0530208677398441,-0.3012457508397137,-0.24822488309986962
2022-03-16T09:30:00-04:00,11.29,12.845,11.28,12.6,9.986894842762352,9.986894842762352,9.986894842762352,NaN,NaN,NaN,12.05259999999995,14.062403214248762,10.042796785751138,11.04439070970548,12.241666666666667,12.241666666666667,12.241666666666667,969286,456668.3,59.16854781900748,47.05943979276534,NaN,NaN,NaN,NaN,0.6942510873688079,21.202963518002644,-5864431,0.06371228858323863,-0.16858452237082133,-0.23229681095405996
2022-03-16T13:30:00-04:00,12.61,12.83,12.18,12.81,10.435104168091335,NaN,NaN,NaN,NaN,NaN,12.041199999999948,14.027080721494837,10.05531927850506,10.868348287776781,12.372393725870367,12.547396047572969,12.197391404167766,540873,456868.3,60.70563262829591,48.22912446326974,NaN,NaN,NaN,NaN,0.6910902954138931,21.084318622060763,-5323558,0.14905798110802432,-0.04597433456902955,-0.19503231567705387
2022-03-17T09:30:00-04:00,12.65,13.645,12.46,13.575,10.915099433178094,NaN,NaN,NaN,NaN,NaN,12.03309999999995,13.990380654378628,10.075819345621271,11.483178630221424,13.226666666666667,13.226666666666667,13.226666666666667,831944,455470.36666666664,65.76199589889632,49.36972836026523,NaN,NaN,NaN,NaN,0.7263695600271863,21.863160961539137,-4491614,0.2453357272995676,0.11163734344740561,-0.13369838385216198
2022-03-17T13:30:00-04:00,13.58,13.7,13.355,13.39,11.440208549851816,NaN,NaN,NaN,NaN,NaN,12.022699999999952,13.945195472037485,10.10020452796242,11.79804290417714,13.31622664894867,13.437950948312446,13.194502349584893,450368,450564.43333333335,63.62962708928912,50.432503251614506,NaN,NaN,NaN,NaN,0.6991288771681016,22.640379655366,-4941982,0.28223248401795514,0.21909222117028193,-0.0631402628476732
2022-03-18T09:30:00-04:00,13.33,13.945,13.21,13.635,11.484858161222188,NaN,NaN,NaN,NaN,NaN,12.016799999999954,13.91753329007637,10.116066709923537,12.055934323341713,13.596666666666666,13.596666666666666,13.596666666666666,516749,449546.6,65.23723695652521,51.22742641062149,NaN,NaN,NaN,NaN,0.7016911002275228,23.60531724185404,-4425233,0.30677452850008535,0.32032789777743353,0.013553369277348154
2022-03-18T13:30:00-04:00,13.63,13.75,13.395,13.42,11.526569153893906,NaN,NaN,NaN,NaN,NaN,12.014599999999952,13.908564983838035,10.120635016161868,12.061247458673371,13.56861971746238,13.604908694172027,13.532330740752732,308675,452413.56666666665,62.62138803394787,51.64958361514329,NaN,NaN,NaN,NaN,0.6769274502112712,24.5013307150215,-4733908,0.29223101761683523,0.3788421412983922,0.08661112368155696
2022-03-21T09:30:00-04:00,13.2,13.28,12.52,12.87,11.526569153893906,NaN,NaN,NaN,NaN,NaN,11.999399999999953,13.853032800746824,10.145767199253083,12.061247458673371,12.889999999999997,12.890000168587392,12.889999831412602,422136,449468.6666666667,56.39202421483156,52.219931982607974,NaN,NaN,NaN,NaN,0.692861203767609,23.647415349006774,-5156044,0.23190686173579425,0.37649470085129977,0.14458783911550552
2022-03-21T13:30:00-04:00,12.86,13.175,12.795,13.06,11.526569153893906,NaN,NaN,NaN,NaN,NaN,11.994399999999953,13.835169013212806,10.1536309867871,12.061247458673371,12.94403111415556,13.003733479282655,12.884328749028466,345746,451580.0333333333,57.94827787947528,52.65496222203141,NaN,NaN,NaN,NaN,0.6705139749270655,22.85449393770739,-4810298,0.19274708499808074,0.38552169536310643,0.1927746103650257
2022-03-22T09:30:00-04:00,13.11,13.56,12.89,13.41,11.526569153893906,NaN,NaN,NaN,NaN,NaN,11.996199999999954,13.842318696076832,10.150081303923075,12.061247458673371,13.286666666666667,13.286666666666667,13.286666666666667,411018,449769.5,60.72856923924334,53.891666136166215,NaN,NaN,NaN,NaN,0.6704772624322751,22.62591015315558,-4399280,0.1786770679056889,0.41612094524713683,0.23744387734144792
2022-03-22T13:30:00-04:00,13.405,13.85,13.37,13.43,11.604832931145587,NaN,NaN,NaN,NaN,NaN,11.997999999999955,13.849523696851964,10.146476303147946,12.298286959072612,13.420262424498867,13.551914958535916,13.288609890461819,423241,456956.9,60.887704516118816,55.292885600063606,NaN,NaN,NaN,NaN,0.6568717436871127,22.768619435711624,-3976039,0.15960332939490934,0.4369480390850846,0.2773447096901753
2022-03-23T09:30:00-04:00,13.17,13.335,12.73,13.015,11.604832931145587,NaN,NaN,NaN,NaN,NaN,11.988999999999953,13.816126706061898,10.161873293938008,12.298286959072612,13.026666666666666,13.026666666666666,13.026666666666666,552684,465109.26666666666,55.832063765498894,56.64021036398191,NaN,NaN,NaN,NaN,0.6599523334237475,21.7602865585655,-4528723,0.11026878009506125,0.41518068480900183,0.3049119047139406
2022-03-23T13:30:00-04:00,13.015,13.145,12.935,13.06,11.604832931145587,NaN,NaN,NaN,NaN,NaN,11.976799999999953,13.766632126207508,10.186967873792398,12.298286959072612,13.032513427230047,13.04161016302863,13.023416691431464,228316,468084.9,56.2562066118254,57.88246862891689,NaN,NaN,NaN,NaN,0.6278128810363369,20.823977458358385,-4300407,0.0736583399389355,0.39698482963760995,0.32332648969867445
2022-03-24T09:30:00-04:00,13.05,13.23,12.62,13.01,11.604832931145587,NaN,NaN,NaN,NaN,NaN,11.968699999999954,13.73594736242682,10.201452637573087,12.298286959072612,12.953333333333335,12.953333333333335,12.953333333333335,328953,461913,55.6171258340591,58.928441455373324,NaN,NaN,NaN,NaN,0.6265405323908844,19.425492103956085,-4629360,0.04071174433705649,0.3742161701199951,0.3335044257829386
2022-03-24T13:30:00-04:00,13,13.045,12.825,12.965,11.604832931145587,NaN,NaN,NaN,NaN,NaN,11.958399999999951,13.696049492850818,10.220750507149084,12.298286959072612,12.949965052507272,12.95405451349212,12.945875591522425,223161,461012.63333333336,55.0114150303237,59.699843965524146,NaN,NaN,NaN,NaN,0.5975019229343926,18.126898560582525,-4852521,0.012014988523036618,0.34852316143673434,0.3365081729136977
2022-03-25T09:30:00-04:00,12.88,12.97,12.27,12.31,11.604832931145587,NaN,NaN,NaN,NaN,NaN,11.956599999999954,13.692601658986646,10.220598341013261,12.298286959072612,12.51666666666667,12.51666666666667,12.51666666666667,438467,462554.63333333336,46.98961021943041,58.829919851268635,NaN,NaN,NaN,NaN,0.6048232141533647,17.62738284367877,-5290988,-0.05146987820412069,0.27217082515854685,0.32364070336266754
2022-03-25T13:30:00-04:00,12.32,12.52,12.32,12.38,11.604832931145587,NaN,NaN,NaN,NaN,NaN,11.959199999999953,13.697339649166485,10.22106035083342,12.298286959072612,12.481400302975366,12.532738238247926,12.430062367702806,206910,460740.76666666666,47.86458103101646,57.91270188003439,NaN,NaN,NaN,NaN,0.5766215559995528,17.163546820839574,-5084078,-0.08704616074480265,0.21483300243166426,0.3018791631764669
2022-03-28T09:30:00-04:00,12.51,13.01,12.28,12.49,11.604832931145587,NaN,NaN,NaN,NaN,NaN,11.975399999999953,13.717922126116177,10.232877873883728,12.298286959072612,12.593333333333334,12.593333333333334,12.593333333333334,383916,437240.36666666664,49.281288261198014,56.73550847734166,NaN,NaN,NaN,NaN,0.5875771591424419,16.02553778389114,-4700162,-0.10051381351805116,0.17623689627890293,0.2767507097969541
2022-03-28T13:30:00-04:00,12.495,12.81,12.42,12.8,11.604832931145587,NaN,NaN,NaN,NaN,NaN,11.995399999999952,13.752306189870298,10.238493810129606,12.298286959072612,12.625698051085976,12.666313132736628,12.585082969435325,243784,430668.73333333334,53.14542870792848,55.986637164387325,NaN,NaN,NaN,NaN,0.5734645049179817,14.968815106724737,-4456378,-0.08642558477939749,0.16871872882270722,0.2551443136021047
2022-03-29T09:30:00-04:00,13.195,16.39,13.18,16.12,12.557440894728204,NaN,NaN,NaN,NaN,NaN,12.092999999999996,14.18200741980506,10.003992580194932,13.603273529138756,15.229999999999999,15.230000168587393,15.229999831412604,2469917,493561.26666666666,75.06024797426294,56.68828080851144,NaN,NaN,NaN,NaN,0.7889313259952687,17.41112049646848,-1986461,0.1364837578955822,0.42574901097158246,0.28926525307600026
2022-03-29T13:30:00-04:00,16.15,16.49,15.84,15.91,13.950057217695104,NaN,NaN,NaN,NaN,NaN,12.184999999999997,14.518796906331056,9.851203093668937,13.935618823311003,15.428174127651012,15.787583398028305,15.068764857273719,750927,508824.6666666667,72.74263533889227,57.4112270445789,NaN,NaN,NaN,NaN,0.7790076598527494,19.731222526056733,-2737388,0.253005425796932,0.6055220353221653,0.3525166095252333
2022-03-30T09:30:00-04:00,15.52,15.52,14.615,14.91,13.950057217695104,NaN,NaN,NaN,NaN,NaN,12.262299999999996,14.693922676321389,9.830677323678604,13.935618823311003,15.015,15.015,15.015,935056,521937.36666666664,62.79892522870205,57.86886283128394,NaN,NaN,NaN,NaN,0.815864255577553,20.17759722706649,-3672444,0.24574449688853417,0.659697230635901,0.41395273374736685
2022-03-30T13:30:00-04:00,14.9,14.92,14.405,14.56,13.950057217695104,NaN,NaN,NaN,NaN,NaN,12.336299999999996,14.817413306562306,9.855186693437686,13.935618823311003,14.916072332604875,15.084789101233744,14.747355563976006,321482,520133.1,59.72180087853737,57.995543045502664,NaN,NaN,NaN,NaN,0.7943739516077278,20.334648887200665,-3993926,0.20220104432275587,0.6667040391508117,0.4645029948280558
2022-03-31T09:30:00-04:00,14.49,14.5,13.51,13.68,NaN,NaN,NaN,16.302545088929907,16.302545088929907,16.302545088929907,12.392899999999997,14.864908163417061,9.920891836582934,13.935618823311003,13.896666666666667,13.896666666666667,13.896666666666667,461518,518222.5333333333,52.72629107034813,57.423951747724445,NaN,NaN,NaN,NaN,0.8126329550643188,19.465925001393423,-4455444,0.10391480966902555,0.5943965069143378,0.4904816972453122
2022-03-31T13:30:00-04:00,13.68,14.12,13.495,13.5,NaN,NaN,NaN,16.085838493978546,NaN,NaN,12.432299999999998,14.910827958285028,9.953772041714968,13.935618823311003,13.799443341187809,13.89526659358304,13.703620088792578,475103,526274.9,51.400043868420525,56.746261701460284,NaN,NaN,NaN,NaN,0.7992306011311532,18.643100301566545,-4930547,0.020904708378667813,0.516612582718647,0.49570787433997915
2022-04-01T09:30:00-04:00,13.54,13.75,13.25,13.27,NaN,NaN,NaN,15.742959471524976,NaN,NaN,12.469899999999997,14.941068541399094,9.9987314586009,13.935618823311003,13.423333333333332,13.423333333333332,13.423333333333332,298464,516396.1,49.68046184374492,56.30686156419215,NaN,NaN,NaN,NaN,0.7778569867646422,17.605579909659408,-5229011,-0.05141761103994874,0.43143586054004324,0.482853471579992
2022-04-01T13:30:00-04:00,13.26,13.5,13.24,13.5,NaN,NaN,NaN,15.546461313728388,NaN,NaN,12.5075,14.983004191069002,10.031995808930999,13.935618823311003,13.419616666912276,13.42444916677256,13.414784167051993,176545,507520.2,51.430345226222556,55.96215717950623,NaN,NaN,NaN,NaN,0.7408672019957392,16.63059189254171,-5052466,-0.08377646385480986,0.3781328917614797,0.46190935561628954
2022-04-04T09:30:00-04:00,13.51,13.93,13.39,13.67,NaN,NaN,NaN,15.546461313728388,NaN,NaN,12.544299999999998,15.033094093532132,10.055505906467864,13.935618823311003,13.663333333333334,13.663333333333334,13.663333333333334,296777,499409.3333333333,52.73857796762421,55.75654661761802,NaN,NaN,NaN,NaN,0.7265195447103292,16.186498307288925,-4755689,-0.09302880181011863,0.34562335335364125,0.4386521551637599
2022-04-04T13:30:00-04:00,13.67,13.845,13.56,13.84,NaN,NaN,NaN,15.546461313728388,NaN,NaN,12.5807,15.090901593498048,10.070498406501953,13.935618823311003,13.689678615689749,13.728988602943222,13.650368628436276,133300,496292.3333333333,54.07085053038509,55.68936343905097,NaN,NaN,NaN,NaN,0.6949824343738771,15.774125692411342,-4622389,-0.08710136959754317,0.32977544316683094,0.4168768127643741
2022-04-05T09:30:00-04:00,13.9,13.9,12.915,13.09,NaN,NaN,NaN,15.538966775585893,NaN,NaN,12.609899999999998,15.109129073134426,10.11067092686557,13.935618823311003,13.301666666666668,13.301666666666668,13.301666666666668,334730,491385.9666666667,47.68439877484646,55.73899119300926,NaN,NaN,NaN,NaN,0.7156979747757432,14.72946274007166,-4957119,-0.13048400638809654,0.25377180477925343,0.38425581116734997
2022-04-05T13:30:00-04:00,13.08,13.08,12.93,13.04,NaN,NaN,NaN,15.061400103968353,NaN,NaN,12.6355,15.12558774945785,10.145412250542151,12.828995058648804,13.209543912145381,13.342842010924093,13.07624581336667,159875,487997.36666666664,47.28344073065814,55.69748117155509,NaN,NaN,NaN,NaN,0.6760052622917615,13.759418570041959,-5116994,-0.15752928551093548,0.1873442042786806,0.3448734897896161
2022-04-06T09:30:00-04:00,12.74,12.89,12.04,12.13,NaN,NaN,NaN,14.564291008333427,NaN,NaN,12.6501,15.119514902360502,10.180685097639499,12.509696046919043,12.353333333333332,12.353333501920726,12.353333164745937,386939,468585.8,40.593329148992204,55.07691266354039,NaN,NaN,NaN,NaN,0.6991477435566357,13.872070481501872,-5503933,-0.22744101690965363,0.060572218652549026,0.28801323556220265
2022-04-06T13:30:00-04:00,12.14,12.6,12.12,12.51,NaN,NaN,NaN,14.429323235227361,NaN,NaN,12.6707,15.117810957844009,10.223589042155991,12.343421280523547,12.37563560898139,12.4033196137672,12.34795160419558,251121,458927.4,44.147157575563234,54.43417901122859,NaN,NaN,NaN,NaN,0.6834943333025904,13.976675827857504,-5252812,-0.2377125512412183,-0.009127453489320203,0.2285850977518981
2022-04-07T09:30:00-04:00,12.4,12.66,11.565,11.94,NaN,NaN,NaN,14.237081269989757,NaN,NaN,12.676099999999998,15.115533778564265,10.236666221435732,12.343421280523547,12.055,12.055,12.055,406910,444759.6,40.25690689539072,51.948226077023435,NaN,NaN,NaN,NaN,0.7128875952095483,14.642504722619323,-5659722,-0.27014930030934337,-0.10910152763478109,0.16104777267456227
2022-04-07T13:30:00-04:00,11.94,12.2,11.835,12.08,NaN,NaN,NaN,14.095282121353858,NaN,NaN,12.6901,15.107555265356577,10.272644734643421,12.343421280523547,12.049978724573375,12.057625600856822,12.042331848289928,175452,435595.73333333334,41.617705524743265,49.72501680458423,NaN,NaN,NaN,NaN,0.688038481266009,15.260774410612443,-5484270,-0.26885212236590783,-0.17501738028282254,0.0938347420830853
2022-04-08T09:30:00-04:00,11.44,11.68,11.065,11.28,NaN,NaN,NaN,13.494246570383226,NaN,NaN,12.694199999999999,15.101357959087919,10.287042040912079,12.343421280523547,11.341666666666667,11.341666666666667,11.341666666666667,720083,442373.5333333333,36.50133960407948,47.8466178313969,NaN,NaN,NaN,NaN,0.711392875461294,16.55493115378032,-6204353,-0.3058550083362145,-0.28848401833718285,0.017370989999031666
2022-04-08T13:30:00-04:00,11.275,11.49,11.23,11.24,NaN,NaN,NaN,13.420758089911262,NaN,NaN,12.6996,15.092430825612244,10.306769174387757,12.343421280523547,11.334998960127875,11.344999393343668,11.324998526912081,320109,442754.6666666667,36.26130075750835,46.170867822751966,NaN,NaN,NaN,NaN,0.6791505272140588,17.756648129579062,-6524462,-0.31572535001165103,-0.3772856975155321,-0.06156034750388109
2022-04-11T09:30:00-04:00,11.02,11.51,10.85,11.36,NaN,NaN,NaN,13.237087267642568,NaN,NaN,12.692099999999998,15.099285152828976,10.28491484717102,12.343421280523547,11.24,11.24,11.24,495279,445192.76666666666,37.58732499627327,45.08951310317519,NaN,NaN,NaN,NaN,0.6777826324130546,19.20544238781019,-6029183,-0.29714169079902797,-0.43298746100266605,-0.13584577020363808
2022-04-11T13:30:00-04:00,11.375,11.465,11.225,11.34,NaN,NaN,NaN,13.237087267642568,NaN,NaN,12.690499999999997,15.10116899428363,10.279831005716364,12.206237024418837,11.281595924771445,11.332271605350545,11.230920244192344,333697,444791.13333333336,37.44749367686889,44.092902375207224,NaN,NaN,NaN,NaN,0.6465124443835507,20.550751341881952,-6362880,-0.269955028114894,-0.4732895553472556,-0.2033345272323616
2022-04-12T09:30:00-04:00,11.66,12.07,11.52,11.7,NaN,NaN,NaN,13.237087267642568,NaN,NaN,12.687699999999998,15.102635369735658,10.272764630264337,11.64498961953507,11.763333333333334,11.763333333333334,11.763333333333334,520918,448454.4666666667,41.654991793111854,43.519654514447716,NaN,NaN,NaN,NaN,0.6524758412132972,20.67198068291324,-5841962,-0.21393534493834998,-0.47075370840529907,-0.2568183634669491
2022-04-12T13:30:00-04:00,11.7,11.725,11.355,11.44,NaN,NaN,NaN,13.237087267642568,NaN,NaN,12.681399999999998,15.107652286964456,10.25514771303554,11.241991695628055,11.692268908107408,11.807115399602143,11.577422416612674,199452,440994.8333333333,39.58410854887244,42.67349475177985,NaN,NaN,NaN,NaN,0.6322989954123474,20.965090194556975,-6041414,-0.18185967710701256,-0.48414295985071476,-0.3022832827437022
2022-04-13T09:30:00-04:00,11.29,11.885,11.27,11.86,NaN,NaN,NaN,13.237087267642568,NaN,NaN,12.674699999999998,15.10812754977426,10.241272450225736,11.041593356502444,11.671666666666667,11.671666666666667,11.671666666666667,240415,430585.86666666664,44.39334324320333,42.07740655717835,NaN,NaN,NaN,NaN,0.631063352882894,20.944638062037164,-5800999,-0.1226626073450654,-0.45561154192503395,-0.33294893457996855
2022-04-13T13:30:00-04:00,11.86,11.93,11.73,11.88,NaN,NaN,NaN,13.237087267642568,NaN,NaN,12.663699999999997,15.106407358649495,10.220992641350499,10.865774685201956,11.740711899251453,11.82624359840251,11.655180200100396,156666,428197.5333333333,44.61941572681038,41.40230407120873,NaN,NaN,NaN,NaN,0.6002731133912587,20.84076922735229,-5644333,-0.07481706913015562,-0.4264702709926631,-0.3516532018625075
2022-04-14T09:30:00-04:00,11.83,11.88,11.565,11.565,NaN,NaN,NaN,13.237087267642568,NaN,NaN,12.659599999999998,15.108972850343582,10.210227149656413,10.746091321222178,11.67,11.67,11.67,269529,426216.73333333334,41.74102794621276,40.977777583449175,NaN,NaN,NaN,NaN,0.5798964624347402,20.959547877096064,-5913862,-0.05780298729187788,-0.42390693597735485,-0.36610394868547697
2022-04-14T13:30:00-04:00,11.57,11.66,11.305,11.39,NaN,NaN,NaN,13.237087267642568,NaN,NaN,12.645999999999997,15.115782986418104,10.17621701358189,10.746091321222178,11.542964579047478,11.650658909127515,11.435270248967441,375033,431279.13333333336,40.18987625559811,40.47109440665917,NaN,NaN,NaN,NaN,0.5638324294036874,21.400413521592114,-6288895,-0.05193915365545415,-0.43102789075479464,-0.3790887370993405
2022-04-18T09:30:00-04:00,11.29,11.37,10.905,11.03,NaN,NaN,NaN,12.939078573958039,NaN,NaN,12.641399999999997,15.122323247502884,10.160476752497111,10.746091321222178,11.101666666666667,11.101666666666667,11.101666666666667,368585,428949.73333333334,37.13285402991352,40.223917612439266,NaN,NaN,NaN,NaN,0.5582015415891384,22.2784068215375,-6657480,-0.0650593593933696,-0.4604129363410525,-0.3953535769476829
2022-04-18T13:30:00-04:00,11.03,11.11,10.925,10.99,NaN,NaN,NaN,12.762415911505402,NaN,NaN,12.640799999999995,15.123305476328406,10.158294523671584,10.746091321222178,11.071105816398463,11.1149051366664,11.027306496130526,179446,428034.26666666666,36.79792909672543,39.6989727210937,NaN,NaN,NaN,NaN,0.5315442886184856,23.093686314343934,-6836926,-0.06882067450240303,-0.4813794200756867,-0.41255874557328365
2022-04-19T09:30:00-04:00,10.9,11.46,10.84,11.35,NaN,NaN,NaN,12.762415911505402,NaN,NaN,12.657899999999994,15.09236099989312,10.223439000106868,10.746091321222178,11.216666666666667,11.216666666666667,11.216666666666667,280310,424580.73333333334,41.87893721629891,39.814832029730006,NaN,NaN,NaN,NaN,0.5378625537171653,23.051277413246247,-6556616,-0.040834922158553943,-0.4636023982714761,-0.42276747611292215
2022-04-19T13:30:00-04:00,11.35,11.635,11.235,11.57,NaN,NaN,NaN,12.762415911505402,NaN,NaN,12.676499999999997,15.06274076739969,10.290259232600304,10.746091321222178,11.35846267244483,11.489739127303578,11.227186217586082,327034,427355.73333333334,44.79949941467036,40.04210302186766,NaN,NaN,NaN,NaN,0.5280152284516535,22.634474329527222,-6229582,-0.003259184247084823,-0.4268414564217782,-0.42358227217469335
2022-04-20T09:30:00-04:00,11.51,11.56,10.735,10.9,NaN,NaN,NaN,12.762415911505402,NaN,NaN,12.678499999999996,15.058606090072544,10.298393909927448,10.746091321222178,11.065,11.065,11.065,443039,359793.13333333336,38.46095194495253,40.182075331930015,NaN,NaN,NaN,NaN,0.5499427121336783,22.940283001212606,-6672621,-0.018432703900565006,-0.4466231520503996,-0.4281904481498346
2022-04-20T13:30:00-04:00,10.91,10.95,10.685,10.7,NaN,NaN,NaN,12.534198105429452,NaN,NaN,12.671499999999996,15.072688247514208,10.270311752485785,10.746091321222178,10.951585882010567,11.091761789347123,10.811409974674012,290021,344429.6,36.78770825511791,40.219675867473555,NaN,NaN,NaN,NaN,0.5295896612669869,23.289298487326334,-6962642,-0.03583670144448364,-0.47298632495543913,-0.4371496235109555
2022-04-21T09:30:00-04:00,10.76,11.11,10.235,10.42,NaN,NaN,NaN,12.430484555182659,NaN,NaN,12.627899999999997,15.11048582127595,10.145314178724044,10.746091321222178,10.588333333333333,10.588333333333333,10.588333333333333,413827,327055.3,34.52325371910271,40.000813633389946,NaN,NaN,NaN,NaN,0.554261828319345,24.16891980756044,-7376469,-0.05875010702240008,-0.5105872572889556,-0.4518371502665555
2022-04-21T13:30:00-04:00,10.41,10.455,10.2,10.44,NaN,NaN,NaN,12.040348893583449,NaN,NaN,12.580499999999997,15.136775611118704,10.02422438888129,10.746091321222178,10.501018183566403,10.609997301149358,10.392039065983449,265651,325194.26666666666,34.83182328541588,39.813980034000444,NaN,NaN,NaN,NaN,0.5328859834393919,25.026857331253822,-7110818,-0.06463634171492633,-0.5326325774102134,-0.4679962356952871
2022-04-22T09:30:00-04:00,10.41,10.64,10.15,10.18,NaN,NaN,NaN,12.040348893583449,NaN,NaN,12.512599999999997,15.138999238501313,9.886200761498682,10.575373056977742,10.323333333333332,10.323333333333332,10.323333333333332,376796,322370.2,32.67595452797424,39.17262022934775,NaN,NaN,NaN,NaN,0.5298226989080067,25.352206436995,-7487614,-0.07726333599007201,-0.5645754056828771,-0.4873120696928051
2022-04-22T13:30:00-04:00,10.18,10.37,10.16,10.26,NaN,NaN,NaN,11.918091657170043,NaN,NaN,12.449999999999998,15.138242548580816,9.761757451419179,10.559376804138083,10.29690539196032,10.326691972783944,10.267118811136697,296614,316420.56666666665,34.02896369505146,38.77582416836054,NaN,NaN,NaN,NaN,0.5069782204145776,25.654316320897525,-7191000,-0.0715792754068747,-0.5767861639513985,-0.5052068885445238
2022-04-25T09:30:00-04:00,10.08,10.37,9.98,10.23,NaN,NaN,NaN,11.806132945480496,NaN,NaN,12.381899999999998,15.118692202561284,9.645107797438712,10.559376804138083,10.193333333333333,10.193333333333333,10.193333333333333,383153,319243.5333333333,33.755005266981144,38.015942884344675,NaN,NaN,NaN,NaN,0.4986226332421077,26.19559873244861,-7574153,-0.06157296760307873,-0.5821730980483721,-0.5206001304452934
2022-04-25T13:30:00-04:00,10.23,10.45,10.19,10.4,NaN,NaN,NaN,11.806132945480496,NaN,NaN,12.321499999999999,15.097010943952533,9.545989056047464,10.559376804138083,10.248236805261195,10.321749668983042,10.174723941539348,213720,320482.7,36.85722091840342,37.46150039802989,NaN,NaN,NaN,NaN,0.4815781594391,26.467803935817162,-7360433,-0.036478236155338295,-0.5661979256394662,-0.529719689484128
2022-04-26T09:30:00-04:00,10.33,10.5,9.86,9.87,NaN,NaN,NaN,11.787333944125823,NaN,NaN,12.261499999999998,15.115581463448489,9.407418536551507,10.559376804138083,10.076666666666666,10.076666666666666,10.076666666666666,335725,321780.9666666667,31.849569273606363,36.75496763570087,NaN,NaN,NaN,NaN,0.49289400519345,27.206078422857267,-7696158,-0.047831103761861504,-0.5895085691864548,-0.5416774654245933
2022-04-26T13:30:00-04:00,9.87,10.09,9.86,9.99,NaN,NaN,NaN,11.540636946665558,NaN,NaN,12.200099999999997,15.114284270083195,9.2859157299168,10.282001443310467,10.033815376587828,10.081836812560256,9.9857939406154,267326,326248.5,34.03489336068968,36.31532600035027,NaN,NaN,NaN,NaN,0.47411586196534644,27.891619017965937,-7428832,-0.03984298602641567,-0.5914811979576129,-0.5516382119311972
2022-04-27T09:30:00-04:00,9.57,10.035,9.38,9.55,NaN,NaN,NaN,11.291289812726214,NaN,NaN,12.122899999999998,15.108425809635595,9.137374190364401,9.795101154648373,9.655,9.655,9.655,727194,339330.63333333336,30.209728295835163,35.820817019344666,NaN,NaN,NaN,NaN,0.4870361575392502,29.16358972183202,-8156026,-0.055798145220534945,-0.6213858934568659,-0.565587748236331
2022-04-27T13:30:00-04:00,9.56,9.765,9.475,9.53,NaN,NaN,NaN,11.17134482123866,NaN,NaN,12.044899999999998,15.092882604937275,8.996917395062722,9.748580923718698,9.633386990771424,9.66400926096678,9.602764720576067,362248,346076.4,30.04443629033186,35.33842467603084,NaN,NaN,NaN,NaN,0.4729621462864467,30.344705375421952,-8518274,-0.058993496662962386,-0.6393296190650339,-0.5803361224020716
2022-04-28T09:30:00-04:00,9.55,10.06,9.265,9.96,NaN,NaN,NaN,11.17134482123866,NaN,NaN,11.983799999999999,15.073738873181831,8.893861126818166,9.473026197084144,9.761666666666668,9.761666666666668,9.761666666666668,775964,359043.9,37.9103211761488,35.05495210173441,NaN,NaN,NaN,NaN,0.4959648501231291,30.492518007714235,-7742310,-0.02517133537250371,-0.6118002916177012,-0.5866289562451975
2022-04-28T13:30:00-04:00,9.95,10.195,9.895,10.08,NaN,NaN,NaN,11.17134482123866,NaN,NaN,11.924199999999999,15.04362517781726,8.804774822182738,9.473026197084144,9.877848257171323,10.021985022872144,9.733711491470501,504158,367478.4666666667,39.93991323497606,34.70783880318481,NaN,NaN,NaN,NaN,0.4819673608286199,30.223028800542366,-7238152,0.010353566948691384,-0.5736869975593333,-0.5840405645080247
2022-04-29T09:30:00-04:00,9.06,10.78,9.06,10.125,NaN,NaN,NaN,11.17134482123866,NaN,NaN,11.866499999999998,15.01008855450268,8.722911445497317,9.473026197084144,9.988333333333333,9.988333333333333,9.988333333333333,782762,380006.86666666664,40.722433616973476,34.869373208329165,NaN,NaN,NaN,NaN,0.5703982636265755,31.13830394641777,-6455390,0.040273517618870214,-0.5336986674844368,-0.573972185103307
2022-04-29T13:30:00-04:00,10.13,10.165,9.8,9.805,NaN,NaN,NaN,11.17134482123866,NaN,NaN,11.8033,14.982862617719626,8.623737382280375,9.473026197084144,9.967390634331124,9.997766262615743,9.937015006046506,372087,386561.36666666664,37.02788986315258,34.886529037474496,NaN,NaN,NaN,NaN,0.55572695908182,31.98820229615923,-6827477,0.04172670113904842,-0.5218138086794966,-0.563540509818545
2022-05-02T09:30:00-04:00,9.73,10.375,9.53,10.145,NaN,NaN,NaN,11.17134482123866,NaN,NaN,11.76,14.96960682950421,8.55039317049579,9.473026197084144,10.016666666666667,10.016666666666667,10.016666666666667,812955,389657.1,42.95024561088868,35.48845702974493,NaN,NaN,NaN,NaN,0.5763893191474043,33.09096798622361,-6014522,0.0672858427484504,-0.47943320638298204,-0.5467190491314324
2022-05-02T13:30:00-04:00,10.145,10.485,10.01,10.48,NaN,NaN,NaN,11.17134482123866,NaN,NaN,11.722000000000001,14.946301474738366,8.497698525261637,9.398420957667316,10.137925218934576,10.288538688178916,9.987311749690237,526943,396551.56666666665,48.126789995121726,36.43809750900963,NaN,NaN,NaN,NaN,0.5691472249225897,33.77053939571541,-5487579,0.10614183307528136,-0.41404175778733077,-0.5201835908626121
2022-05-03T09:30:00-04:00,10.11,10.495,9.645,9.96,NaN,NaN,NaN,11.17134482123866,NaN,NaN,11.671399999999998,14.925176906919123,8.417623093080874,9.093736766133851,10.033333333333333,10.033333333333333,10.033333333333333,1008616,413662.8,41.788321826287984,37.08898088746061,NaN,NaN,NaN,NaN,0.589208137428119,34.83058437189604,-6496195,0.09648911408405114,-0.3995721982575482,-0.49606131234159934
2022-05-03T13:30:00-04:00,9.96,10.125,9.895,10.09,NaN,NaN,NaN,11.17134482123866,NaN,NaN,11.617199999999999,14.884229329528615,8.350170670471382,9.058450579408426,10.034585445009347,10.036199731824295,10.032971158194398,606807,422766.4666666667,43.78174486030757,37.78560811355033,NaN,NaN,NaN,NaN,0.5635504133261106,35.814911849778056,-5889388,0.09819965061475139,-0.3733117490731601,-0.4715113996879115
2022-05-04T09:30:00-04:00,10.04,10.595,9.87,10.57,NaN,NaN,NaN,11.17134482123866,NaN,NaN,11.5062,14.521147800543172,8.491252199456827,9.058450579408426,10.345,10.34500011920929,10.344999880790711,750973,430434.9666666667,50.519374055623835,38.98306302702481,NaN,NaN,NaN,NaN,0.57508252665996,35.29423117022992,-5138415,0.1290551518809741,-0.31019245983669386,-0.43924761171766796
2022-05-04T13:30:00-04:00,10.57,10.915,10.025,10.9,NaN,NaN,NaN,11.17134482123866,NaN,NaN,11.405999999999997,14.14966032883086,8.662339671169134,9.234197496760602,10.479774992538154,10.613940280090928,10.34560970498538,757814,449047.0333333333,54.552119113924626,40.2469843267049,NaN,NaN,NaN,NaN,0.5975766318985342,33.98299459337872,-4380601,0.16669386367999228,-0.23088028211767764,-0.3975741457976699
2022-05-05T09:30:00-04:00,10.85,10.965,10.365,10.74,NaN,NaN,NaN,11.17134482123866,NaN,NaN,11.322599999999998,13.882500966834494,8.762699033165502,9.320357997408482,10.689999999999998,10.690000168587392,10.689999831412603,827724,468624,52.325383137391576,41.70954245983241,NaN,NaN,NaN,NaN,0.5977497296200674,32.64058585179047,-5208325,0.17496049265613067,-0.1788735299775066,-0.3538340226336373
2022-05-05T13:30:00-04:00,10.74,10.77,10.51,10.61,NaN,NaN,NaN,11.17134482123866,NaN,NaN,11.243599999999999,13.637402865734789,8.84979713426521,9.324286397926786,10.668378686235402,10.697184894193834,10.63957247827697,466313,478945.56666666665,50.52096657732156,42.887119118163255,NaN,NaN,NaN,NaN,0.5736247489329198,31.39406344888709,-5674638,0.16589967836070452,-0.14645942468275663,-0.31235910304346115
2022-05-06T09:30:00-04:00,10.48,10.67,9.92,10.145,NaN,NaN,NaN,11.17134482123866,NaN,NaN,11.1729,13.482005532451899,8.863794467548102,9.324286397926786,10.245,10.245,10.245,592874,489723.73333333334,44.596858918662065,43.91477130550804,NaN,NaN,NaN,NaN,0.586222981151997,31.26520829542139,-6267512,0.12469630486471639,-0.1564887219625657,-0.2811850268272821
2022-05-06T13:30:00-04:00,10.16,10.16,9.965,10.12,NaN,NaN,NaN,11.17134482123866,NaN,NaN,11.1053,13.334458056307362,8.876141943692637,9.324286397926786,10.197004017834102,10.271406500653399,10.122601535014805,246716,485446.5,44.29612063023049,44.932748758357945,NaN,NaN,NaN,NaN,0.5582784824982829,31.14555708148896,-6514228,0.09330211086818962,-0.16455738824204502,-0.25785949911023465
2022-05-09T09:30:00-04:00,9.85,10.24,9.53,9.685,NaN,NaN,NaN,11.17134482123866,NaN,NaN,11.0336,13.2096257719062,8.8575742280938,9.324286397926786,9.818333333333333,9.818333333333333,9.818333333333333,838713,501117.43333333335,39.32669867132513,45.033918579441966,NaN,NaN,NaN,NaN,0.5691157337484056,31.672084838824123,-7352941,0.0433239595232954,-0.2037045497061154,-0.2470285092294108
2022-05-09T13:30:00-04:00,9.69,9.705,9.4,9.49,NaN,NaN,NaN,11.17134482123866,NaN,NaN,10.953399999999998,13.054191698384237,8.85260830161576,9.324286397926786,9.706514301983363,9.846340240975136,9.56668836299159,536376,513015.1,37.30623237484621,44.84579851800412,NaN,NaN,NaN,NaN,0.5502503241949481,32.3331752096096,-7889317,-0.00046482372904399494,-0.2476095388907158,-0.2471447151616718
2022-05-10T09:30:00-04:00,9.7,9.935,8.915,9.23,NaN,NaN,NaN,11.168805918336938,NaN,NaN,10.864600000000001,12.871836747371841,8.857363252628161,9.324286397926786,9.360000000000001,9.360000000000001,9.360000000000001,935644,534859.5666666667,34.743182059698626,44.41870912105592,NaN,NaN,NaN,NaN,0.5838038724667377,33.521227302217646,-8824961,-0.0422258393141795,-0.29992701430439617,-0.25770117499021666
2022-05-10T13:30:00-04:00,9.235,9.65,9.225,9.28,NaN,NaN,NaN,11.159996558412532,NaN,NaN,10.773399999999999,12.641116723703055,8.905683276296942,9.324286397926786,9.369666922752195,9.381841637258367,9.357492208246024,589888,543621.3666666667,35.65865854135886,44.320906883784936,NaN,NaN,NaN,NaN,0.5724607387191136,34.624418531067974,-8235073,-0.060646990953439894,-0.33350991368201655,-0.27286292272857665
2022-05-11T09:30:00-04:00,9,9.37,8.405,8.415,NaN,NaN,NaN,10.66329216939378,NaN,NaN,10.6799,12.542433210442166,8.817366789557834,9.324286397926786,8.729999999999999,8.729999999999999,8.729999999999999,1134978,566686,28.269834133069992,43.272306063940746,NaN,NaN,NaN,NaN,0.6004992573820341,36.41660910831025,-9370051,-0.1217284364644452,-0.4250234683091332,-0.303295031844688
2022-05-11T13:30:00-04:00,8.42,8.53,8.015,8.145,NaN,NaN,NaN,10.037801616239518,NaN,NaN,10.582000000000003,12.45259990377413,8.711400096225875,9.324286397926786,8.507222020306234,8.75573552418573,8.258708516426736,912078,587421.2333333333,26.42896529793505,41.72246144271313,NaN,NaN,NaN,NaN,0.5943921675690316,38.36098804517463,-10282129,-0.1680975836996944,-0.513417011469306,-0.34531942776961155
2022-05-12T09:30:00-04:00,7.89,8.82,7.72,8.46,NaN,NaN,NaN,10.037801616239518,NaN,NaN,10.508600000000001,12.418081646939791,8.599118353060211,9.324286397926786,8.333333333333334,8.333333333333334,8.333333333333334,949513,605277.4333333333,31.992938954381486,41.022791237576946,NaN,NaN,NaN,NaN,0.6305070127426722,40.35736619747921,-9332616,-0.1650981383515956,-0.551692100709106,-0.3865939623575104
2022-05-12T13:30:00-04:00,8.455,8.55,8.21,8.55,NaN,NaN,NaN,10.037801616239518,NaN,NaN,10.429400000000003,12.328734241253974,8.530065758746032,9.13842911834143,8.366459447952632,8.41468488080931,8.318234015095955,448012,611356.1333333333,33.53946999236584,40.29120017558112,NaN,NaN,NaN,NaN,0.6097565118324813,42.21114591033345,-8884604,-0.14529533378807724,-0.568213129592607,-0.4229177958045297
2022-05-13T09:30:00-04:00,10.51,10.85,9.85,10.7,8.320079050714297,8.320079050714297,8.320079050714297,NaN,NaN,NaN,10.404600000000002,12.256171051836763,8.553028948163242,8.837243294673144,10.466666666666667,10.466666785875956,10.466666547457377,1826095,659666.1,58.07011396251966,40.83053874035939,NaN,NaN,NaN,NaN,0.7304881895587325,39.20224128721049,-7058509,0.015796939979014657,-0.4031716208307614,-0.41896856080977607
2022-05-13T13:30:00-04:00,10.7,10.785,10.435,10.69,8.624620912045465,NaN,NaN,NaN,NaN,NaN,10.376800000000003,12.167660977295519,8.585939022704487,8.826794635738514,10.509975874145615,10.584049336457866,10.435902411833364,624250,670587.3,57.962951702108874,41.074169639515404,NaN,NaN,NaN,NaN,0.7033104617331087,36.40825842288203,-7682759,0.1191198343600342,-0.2700687678597333,-0.38918860221976753
2022-05-16T09:30:00-04:00,10.56,10.61,9.96,10.48,8.624620912045465,NaN,NaN,NaN,NaN,NaN,10.360800000000001,12.133298078983433,8.58830192101657,8.658099580411411,10.35,10.35,10.35,1048855,692777.3666666667,55.64082082280438,41.31098661704488,NaN,NaN,NaN,NaN,0.7052168573236008,34.42544037925747,-8731614,0.16778261310277665,-0.17946033584129673,-0.34724294894407337
2022-05-16T13:30:00-04:00,10.5,10.55,10.075,10.11,8.624620912045465,NaN,NaN,NaN,NaN,NaN,10.338200000000002,12.094018623890271,8.582381376109733,8.659283731463304,10.320059448595112,10.367465368890548,10.272653528299676,418379,699599.3333333334,51.71004539878527,41.39592081857801,NaN,NaN,NaN,NaN,0.6887727960862009,32.584252195891814,-9149993,0.16904127030771454,-0.13594136105943022,-0.30498263136714476
2022-05-17T09:30:00-04:00,10.33,10.54,9.505,10.03,8.624620912045465,NaN,NaN,NaN,NaN,NaN,10.3116,12.044846018313642,8.578353981686359,8.659283731463304,10.025,10.025,10.025,634086,709544.7,50.873197205888914,41.84423069623707,NaN,NaN,NaN,NaN,0.7135033106514721,31.58130612118231,-9784079,0.15864380487124563,-0.1066778752780877,-0.2653216801493333
2022-05-17T13:30:00-04:00,10.02,10.13,9.83,10.05,8.624620912045465,NaN,NaN,NaN,NaN,NaN,10.285800000000002,11.995286893778353,8.57631310622165,8.659283731463304,10.017933041732997,10.028090577357245,10.007775506108748,306928,710864.7666666667,51.08631848160143,42.32924482847785,NaN,NaN,NaN,NaN,0.6839673598906527,30.6499990518092,-9477151,0.14750574495906282,-0.08093949895050478,-0.2284452439095676
2022-05-18T09:30:00-04:00,9.9,10.45,9.69,9.75,8.624620912045465,NaN,NaN,NaN,NaN,NaN,10.246800000000002,11.913902588324998,8.579697411675006,8.659283731463304,9.963333333333333,9.963333333333333,9.963333333333333,576926,705855.8333333334,47.740724356685405,42.930246663146434,NaN,NaN,NaN,NaN,0.6893982627556061,29.227432284125836,-10054077,0.11572952243081053,-0.08378334087105443,-0.19951286330186496
2022-05-18T13:30:00-04:00,9.74,9.895,9.68,9.71,8.624620912045465,NaN,NaN,NaN,NaN,NaN,10.212200000000003,11.850368684842882,8.574031315157123,8.659283731463304,9.901867958860283,9.994698583797744,9.809037333922822,252929,702211.8666666667,47.29597406608824,43.6437996410923,NaN,NaN,NaN,NaN,0.6555126725587771,27.920581581161763,-10307006,0.08901228309640524,-0.0882475094313584,-0.17725979252776364
2022-05-19T09:30:00-04:00,9.73,10.44,9.625,10.23,8.624620912045465,NaN,NaN,NaN,NaN,NaN,10.179600000000002,11.748724392774486,8.610475607225519,8.794982093125896,10.098333333333333,10.098333333333333,10.098333333333333,508310,693290.0666666667,53.37673532571545,44.97476773152208,NaN,NaN,NaN,NaN,0.6669046245188645,26.055941515349186,-9798696,0.10240149299254706,-0.04925792628707981,-0.15165941927962687
2022-05-19T13:30:00-04:00,10.23,10.4,10.15,10.19,8.624620912045465,NaN,NaN,NaN,NaN,NaN,10.145800000000001,11.637872866853334,8.653727133146669,8.958985674500717,10.149674335219169,10.22024120755853,10.079107462879808,269064,685453.6,52.87140386792681,46.204249540562635,NaN,NaN,NaN,NaN,0.637125722767517,24.324490025666076,-10067760,0.1042554783138672,-0.02134007138729288,-0.12559554970116008
2022-05-20T09:30:00-04:00,10.35,10.54,9.58,9.58,8.624620912045465,NaN,NaN,NaN,NaN,NaN,10.106100000000001,11.549864925463957,8.662335074536045,8.958985674500717,9.899999999999999,9.899999999999999,9.899999999999999,412781,673120.9,45.75703003434888,47.45333496208256,NaN,NaN,NaN,NaN,0.6601881711412657,23.346996597663747,-10480541,0.06216853167215411,-0.047884885110967446,-0.11005341678312155
2022-05-20T13:30:00-04:00,9.585,10.09,9.585,10.08,8.624620912045465,NaN,NaN,NaN,NaN,NaN,10.079900000000002,11.476286035450043,8.683513964549961,8.958985674500717,9.906930720817506,9.915820508437243,9.89804093319777,250896,669081.2,51.51593269497969,49.24526120472861,NaN,NaN,NaN,NaN,0.6494604446311752,22.43932412880444,-10229645,0.06544243962019254,-0.028250367257880882,-0.09369280687807342
2022-05-23T09:30:00-04:00,9.99,10.11,9.55,9.9,8.624620912045465,NaN,NaN,NaN,NaN,NaN,10.057300000000003,11.427783432953406,8.6868165670466,8.958985674500717,9.853333333333333,9.853333333333333,9.853333333333333,588844,661610.8333333334,49.479325686202635,50.49428882843012,NaN,NaN,NaN,NaN,0.6430704128718056,21.651610467541946,-10818489,0.05343086082123763,-0.02690423085152638,-0.08033509167276401
2022-05-23T13:30:00-04:00,9.9,10.08,9.89,10.06,8.624620912045465,NaN,NaN,NaN,NaN,NaN,10.038700000000002,11.383038960232826,8.694361039767179,8.958985674500717,9.8847755493567,9.947523730434005,9.822027368279395,147851,648974.4333333333,51.3215175442525,51.76443508213631,NaN,NaN,NaN,NaN,0.6107082405238194,20.920162067798202,-10670638,0.054044527825431496,-0.012779431890974635,-0.06682395971640613
2022-05-24T09:30:00-04:00,9.92,9.92,9.06,9.095,8.624620912045465,NaN,NaN,NaN,NaN,NaN,9.993600000000004,11.309957155182321,8.677242844817687,8.958985674500717,9.358333333333334,9.358333333333334,9.358333333333334,509087,632323.4666666667,41.49401447526142,50.58042797590358,NaN,NaN,NaN,NaN,0.638514794772118,21.455486771004676,-11179725,-0.009378765336884295,-0.0785474163875115,-0.06916865105062721
2022-05-24T13:30:00-04:00,9.09,9.17,8.97,9.1,8.624620912045465,NaN,NaN,NaN,NaN,NaN,9.944200000000004,11.20440372956112,8.683996270438888,8.958985674500717,9.278818952566434,9.404552662835638,9.15308524229723,203601,618883.2666666667,41.55646090018319,49.408535775766026,NaN,NaN,NaN,NaN,0.6071923094312525,22.064666180847574,-10976124,-0.047689920693434015,-0.12878105191741973,-0.08109113122398572
2022-05-25T09:30:00-04:00,9.05,9.355,8.995,9.06,8.624620912045465,NaN,NaN,NaN,NaN,NaN,9.907400000000006,11.16125683393262,8.653543166067392,8.958985674500717,9.136666666666668,9.136666666666668,9.136666666666668,343192,605290.5666666667,41.17780464127992,48.37546319137142,NaN,NaN,NaN,NaN,0.5895357159004487,22.20062298634723,-11319316,-0.07101604040216605,-0.1698611817266933,-0.09884514132452724
2022-05-25T13:30:00-04:00,9.05,9.25,8.975,9.225,8.624620912045465,NaN,NaN,NaN,NaN,NaN,9.877900000000004,11.125165953996856,8.630634046003152,8.958985674500717,9.141909207498776,9.148421988016041,9.13539642698151,222376,587442.6333333333,43.4661612162835,47.78661432119272,NaN,NaN,NaN,NaN,0.5670688790504167,22.355975127140333,-11096940,-0.07048255533174681,-0.18694833548921075,-0.11646578015746394
2022-05-26T09:30:00-04:00,9.1,9.535,9.06,9.44,8.624620912045465,NaN,NaN,NaN,NaN,NaN,9.858300000000003,11.101668987871161,8.614931012128846,8.958985674500717,9.344999999999999,9.344999999999999,9.344999999999999,329939,570849.8,46.39264452262437,47.466574843816694,NaN,NaN,NaN,NaN,0.5604925305468155,21.825077244244067,-10767001,-0.051670771200406196,-0.18105424415797167,-0.12938347295756547
2022-05-26T13:30:00-04:00,9.44,9.46,9.275,9.285,8.624620912045465,NaN,NaN,NaN,NaN,NaN,9.835200000000004,11.07739798743988,8.593002012560127,8.907188539600574,9.34343974537008,9.345756397831083,9.341123092909077,149659,560294.6666666666,44.600173891752156,47.003278801684594,NaN,NaN,NaN,NaN,0.5336716355077573,21.332100638697533,-10916660,-0.04588341560938991,-0.18673774246930286,-0.14085432685991295
2022-05-27T09:30:00-04:00,9.37,10.255,9.28,10.25,8.624620912045465,NaN,NaN,NaN,NaN,NaN,9.836600000000002,11.080505848527034,8.59269415147297,8.957085534986263,9.928333333333333,9.928333333333333,9.928333333333333,617332,561109.9333333333,55.9987005674418,47.593134245310054,NaN,NaN,NaN,NaN,0.5651950901143462,20.362360026305755,-10299328,0.023017458815646208,-0.11208250334035519,-0.1350999621560014
2022-05-27T13:30:00-04:00,10.25,10.415,10.25,10.39,8.64168834689831,NaN,NaN,NaN,NaN,NaN,9.839200000000003,11.087171730448922,8.591228269551085,9.294168427989009,10.067556611892945,10.266440329922728,9.868672893863161,302513,562969.8333333334,57.36910934063966,48.31264390777801,NaN,NaN,NaN,NaN,0.5366097265347499,19.73214408472895,-9996815,0.07516273234897852,-0.04114654671977824,-0.11630927906875677
2022-05-31T09:30:00-04:00,10.28,10.545,10.16,10.26,8.686043422039296,NaN,NaN,NaN,NaN,NaN,9.839800000000004,11.088551312311498,8.59104868768851,9.455834742391207,10.321666666666665,10.321666666666665,10.321666666666665,428324,549290.2,55.63633061442485,48.474043571257255,NaN,NaN,NaN,NaN,0.5257804603536963,19.365862292809506,-10425139,0.09667029814707462,0.004528593615086507,-0.09214170453198811
2022-05-31T13:30:00-04:00,10.25,10.345,9.99,10.06,8.686043422039296,NaN,NaN,NaN,NaN,NaN,9.833000000000004,11.07314837821922,8.592851621780788,9.455834742391207,10.231586687981219,10.326459199228077,10.13671417673436,386143,544282.4333333333,52.98485244458564,48.4821470410186,NaN,NaN,NaN,NaN,0.513581856042718,18.64491096706669,-10811282,0.09315971251795077,0.024307936115450346,-0.06885177640250043
2022-06-01T09:30:00-04:00,10,10.005,9.25,9.32,8.686043422039296,NaN,NaN,NaN,NaN,NaN,9.822000000000001,11.07037013741914,8.573629862580862,9.455834742391207,9.525,9.525,9.525,715408,536941.2333333333,44.528974958991675,48.394428821350225,NaN,NaN,NaN,NaN,0.5347545806110954,18.048249275806917,-11526690,0.03947839666538784,-0.019503780570765628,-0.05898217723615347
2022-06-01T13:30:00-04:00,9.31,9.4,9.22,9.365,8.686043422039296,NaN,NaN,NaN,NaN,NaN,9.8095,11.06339513118125,8.55560486881875,9.455834742391207,9.447806034169208,9.543840255080488,9.351771813257928,462241,532686.3333333334,45.10272563804075,47.93634260299745,NaN,NaN,NaN,NaN,0.5094149677103028,17.543905356051646,-11064449,0.0071719892037026,-0.05001719073152522,-0.05718917993522782
2022-06-02T09:30:00-04:00,9.25,9.7,9.15,9.67,8.686043422039296,NaN,NaN,NaN,NaN,NaN,9.811900000000001,11.06425760068755,8.559542399312452,9.455834742391207,9.506666666666668,9.506666666666668,9.506666666666668,389488,507836.6666666667,48.95636133215251,47.89898800627959,NaN,NaN,NaN,NaN,0.5123138985881383,16.464455276571005,-10674961,0.006532761662033024,-0.049023227857686535,-0.05555598951971956
2022-06-02T13:30:00-04:00,9.68,9.715,9.58,9.7,8.686043422039296,NaN,NaN,NaN,NaN,NaN,9.8153,11.065499040153181,8.56510095984682,9.455834742391207,9.555059680543001,9.628000364698613,9.48211899638739,171443,483148.8333333333,49.33310870365256,47.75695880337959,NaN,NaN,NaN,NaN,0.48536290583184266,15.431864025245808,-10503518,0.008210671327886165,-0.04529265035986185,-0.05350332168774802
2022-06-03T09:30:00-04:00,9.38,9.45,9.06,9.19,8.686043422039296,NaN,NaN,NaN,NaN,NaN,9.799900000000001,11.061507688625873,8.538292311374128,9.455834742391207,9.233333333333333,9.233333333333333,9.233333333333333,377603,464085.1666666667,43.46043014392809,47.897417065427206,NaN,NaN,NaN,NaN,0.4964084125581395,15.408809605102938,-10881121,-0.023227293334634823,-0.08253743835604155,-0.059310145021406725
2022-06-03T13:30:00-04:00,9.19,9.2,9.085,9.16,8.686043422039296,NaN,NaN,NaN,NaN,NaN,9.781500000000001,11.053027034710606,8.509972965289396,9.455834742391207,9.198020784472176,9.23990861738494,9.156132951559412,268360,458096.76666666666,43.135144596781814,48.01018018661282,NaN,NaN,NaN,NaN,0.4691649545182723,15.387401929255986,-11149481,-0.04308819807631156,-0.11317039261679618,-0.07008219454048462
2022-06-06T09:30:00-04:00,9.27,9.8,9.145,9.26,8.686043422039296,NaN,NaN,NaN,NaN,NaN,9.764200000000002,11.040092409257086,8.488307590742918,9.455834742391207,9.401666666666666,9.401666666666666,9.401666666666666,662513,419310.7,44.623009587715316,48.25626625421535,NaN,NaN,NaN,NaN,0.48243888633839577,14.456840480760341,-10486968,-0.046257181483819715,-0.12790367139525927,-0.08164648991143955
2022-06-06T13:30:00-04:00,9.26,9.39,9.055,9.1,8.686043422039296,NaN,NaN,NaN,NaN,NaN,9.7501,11.039388935809198,8.460811064190802,9.455834742391207,9.29998149075647,9.409666784667552,9.19029619684539,569394,417482.1666666667,42.69800471664124,48.20139793281233,NaN,NaN,NaN,NaN,0.4719075373142247,13.430617769643256,-11056362,-0.05528503174773147,-0.1507527795961039,-0.09546774784837242
2022-06-07T09:30:00-04:00,8.75,8.78,8.255,8.535,NaN,NaN,NaN,10.087384392585715,10.087384392585715,10.087384392585715,9.7179,11.045966398942438,8.389833601057562,9.296167793912966,8.523333333333333,8.523333333333333,8.523333333333333,965345,414698.5,36.68044130374303,47.507669131463665,NaN,NaN,NaN,NaN,0.4985569989346371,13.807692664118498,-12021707,-0.09323199949926275,-0.21200774722245086,-0.11877574772318811
2022-06-07T13:30:00-04:00,8.53,8.735,8.475,8.73,NaN,NaN,NaN,10.087384392585715,NaN,NaN,9.682900000000002,11.02098533360168,8.344814666398324,8.760934235130373,8.551872711778355,8.603885792372244,8.499859631184465,290634,410440.3333333333,39.83216630556823,47.16709716102196,NaN,NaN,NaN,NaN,0.48151721329644875,14.157833637559794,-11731073,-0.09860174799452145,-0.24202793271633993,-0.14342618472181848
2022-06-08T09:30:00-04:00,8.65,8.93,8.23,8.44,NaN,NaN,NaN,10.087384392585715,NaN,NaN,9.652500000000002,11.032433694059234,8.272566305940769,8.732938328386751,8.533333333333333,8.533333333333333,8.533333333333333,938290,420580.4666666667,36.891254936079875,45.80227961592467,NaN,NaN,NaN,NaN,0.49712312663241665,14.843450712198939,-12669363,-0.11399806911916072,-0.2859237711207694,-0.17192570200160867
2022-06-08T13:30:00-04:00,8.43,8.555,8.365,8.375,NaN,NaN,NaN,9.974721953393718,NaN,NaN,9.618200000000003,11.037622079580201,8.198777920419806,8.732938328386751,8.51086770272301,8.55304946679247,8.46868593865355,266149,419221.1666666667,36.245303610327724,44.29343634947382,NaN,NaN,NaN,NaN,0.4751857604443868,15.480095138649572,-12935512,-0.1202529521083989,-0.3222418921371073,-0.2019889400287084
2022-06-09T09:30:00-04:00,8.29,8.42,8.04,8.12,NaN,NaN,NaN,9.727689137330367,NaN,NaN,9.569200000000002,11.02255798755846,8.115842012441544,8.732938328386751,8.193333333333333,8.193333333333333,8.193333333333333,527045,417558.4666666667,33.748725016183414,42.73003594959943,NaN,NaN,NaN,NaN,0.46838677755550207,16.54607689611914,-13462557,-0.1323015427942855,-0.3673658685215653,-0.23506432572727978
2022-06-09T13:30:00-04:00,8.11,8.17,8.005,8.02,NaN,NaN,NaN,9.539612358360806,NaN,NaN,9.511600000000001,10.977648348452368,8.045551651547635,8.718884424134018,8.149618728002135,8.210438743607407,8.088798712396864,272275,418203.3333333333,32.79473862941303,41.287884962801385,NaN,NaN,NaN,NaN,0.44671629344439473,17.58567980347673,-13734832,-0.13715663031893788,-0.40651011362595213,-0.26935348330701425
2022-06-10T09:30:00-04:00,7.75,8.11,7.615,7.71,NaN,NaN,NaN,9.316107251162586,NaN,NaN,9.451,10.958830229170397,7.943169770829604,8.718884424134018,7.8116666666666665,7.8116666666666665,7.8116666666666665,490945,417624.5,29.96679063911293,40.2477289399529,NaN,NaN,NaN,NaN,0.4501651296269379,19.078801787153417,-14225777,-0.1503375594100279,-0.45727543256954917,-0.30693787315952126
2022-06-10T13:30:00-04:00,7.71,7.855,7.685,7.8,NaN,NaN,NaN,9.180716012473377,NaN,NaN,9.394800000000002,10.934773973806022,7.854826026193981,8.718884424134018,7.80245578874894,7.816837635943067,7.7880739415548135,201375,415368.2,31.80537222502808,39.29791798188057,NaN,NaN,NaN,NaN,0.43015333465358524,20.46527220056748,-14024402,-0.14217628337807459,-0.4846582273821145,-0.3424819440040399
2022-06-13T09:30:00-04:00,7.32,7.475,7.025,7.405,NaN,NaN,NaN,8.702274375542771,NaN,NaN,9.340000000000002,10.962106038457403,7.7178939615426,8.357607539307214,7.301666666666667,7.301666666666667,7.301666666666667,705181,425114.86666666664,28.294462986722152,37.82206810006411,NaN,NaN,NaN,NaN,0.45478523932118625,22.516677017313842,-14729583,-0.15169347266012967,-0.532098784829202,-0.38040531216907236
2022-06-13T13:30:00-04:00,7.405,7.42,7.17,7.235,NaN,NaN,NaN,8.702274375542771,NaN,NaN,9.282300000000003,10.992189130908768,7.572410869091238,7.677015060125294,7.2910223391779985,7.304081704603893,7.277962973752104,468482,432367.73333333334,26.91729462415995,36.220938522957496,NaN,NaN,NaN,NaN,0.4401577222268158,24.42155291857832,-15198065,-0.1570875602560407,-0.5767647624891232,-0.4196772022330825
2022-06-14T09:30:00-04:00,7.24,7.48,7.1,7.33,NaN,NaN,NaN,8.697609503335459,NaN,NaN,9.235200000000003,11.025951752756336,7.444448247243669,7.677015060125294,7.303333333333334,7.303333333333334,7.303333333333334,300406,422753.13333333336,28.99709227429362,35.18784296084075,NaN,NaN,NaN,NaN,0.43586074206775766,26.266372653215964,-14897659,-0.1423448853706939,-0.5976083089464499,-0.455263423575756
2022-06-14T13:30:00-04:00,7.32,7.33,7.125,7.23,NaN,NaN,NaN,8.599081798638391,NaN,NaN,9.190000000000003,11.064857861279057,7.315142138720949,7.677015060125294,7.273651276708156,7.310327287415193,7.236975266001119,196758,424383.36666666664,28.09087403709657,34.11325220657752,NaN,NaN,NaN,NaN,0.4193706890629178,27.97941954966521,-15094417,-0.12787372491189136,-0.6151055797156202,-0.4872318548037288
2022-06-15T09:30:00-04:00,7.04,7.18,6.875,7.08,NaN,NaN,NaN,8.385146262336647,NaN,NaN,9.147000000000002,11.112638827455331,7.181361172544673,7.457612048100235,7.044999999999999,7.044999999999999,7.044999999999999,891772,437139.5333333333,26.740885519787497,32.83595763029696,NaN,NaN,NaN,NaN,0.4147727827012808,29.853732403995753,-15986189,-0.11723077968486195,-0.6337703294098063,-0.5165395497249443
2022-06-15T13:30:00-04:00,7.085,7.205,6.895,7.05,NaN,NaN,NaN,8.385146262336647,NaN,NaN,9.102400000000001,11.15329174750887,7.051508252491131,7.352089638480187,7.047168350320166,7.04964625437146,7.044690446268872,682879,453115.4666666667,26.466928117764667,31.676595016091493,NaN,NaN,NaN,NaN,0.4072890125083322,31.500290093315925,-16669068,-0.10161989405731853,-0.6435644172965924,-0.5419445232392739
2022-06-16T09:30:00-04:00,6.93,7.13,6.81,7.015,NaN,NaN,NaN,8.291016532418308,NaN,NaN,9.074400000000002,11.198970205947521,6.949829794052484,7.23317171078415,6.984999999999999,6.984999999999999,6.984999999999999,428726,455966.6,26.13058093652475,30.923033561290186,NaN,NaN,NaN,NaN,0.40105408304345136,33.1310257763258,-17097794,-0.08380102407703394,-0.6466958033355663,-0.5628947792585324
2022-06-16T13:30:00-04:00,7.01,7.03,6.85,6.88,NaN,NaN,NaN,8.225515780944749,NaN,NaN,9.0491,11.246226933065117,6.851973066934882,7.11303736862732,6.962000476264398,6.993080871222528,6.930920081306269,234771,456379.76666666666,24.820365148149378,29.850762050045976,NaN,NaN,NaN,NaN,0.38526450568320486,34.64528033912068,-17332565,-0.07172309378556041,-0.6525486464904828,-0.5808255527049224
2022-06-17T09:30:00-04:00,6.845,7.145,6.845,7.12,NaN,NaN,NaN,8.225515780944749,NaN,NaN,9.022300000000001,11.279387689922544,6.765212310077459,6.972429894901857,7.036666666666666,7.036666666666666,7.036666666666666,287352,454960.2,31.405230806475174,29.458903183645646,NaN,NaN,NaN,NaN,0.3791741838486902,35.551699824421796,-17045213,-0.03978152296381077,-0.6305524564096858,-0.5907709334458751
2022-06-17T13:30:00-04:00,7.12,7.22,7.07,7.185,NaN,NaN,NaN,8.225515780944749,NaN,NaN,8.995,11.30663838002402,6.683361619975978,6.529367018954404,7.096482979333184,7.157307810721342,7.035658147945027,277902,459234.9666666667,33.11394369589857,29.235234618329276,NaN,NaN,NaN,NaN,0.36280459928806946,36.06867765996612,-16767311,-0.008141658034050314,-0.600948005988438,-0.5928063479543877
2022-06-21T09:30:00-04:00,7.365,8.015,7.365,7.765,NaN,NaN,NaN,8.225515780944749,NaN,NaN,8.9363,11.22067283296753,6.651927167032469,7.047493615163524,7.715,7.715,7.715,563056,457425.76666666666,46.0323976238162,30.11263980458876,NaN,NaN,NaN,NaN,0.3961756993389217,33.892181205532395,-16204255,0.05453514283725425,-0.5246374194078198,-0.5791725622450741
2022-06-21T13:30:00-04:00,7.77,7.8,7.54,7.55,NaN,NaN,NaN,8.225515780944749,NaN,NaN,8.8735,11.134095717946934,6.612904282053066,7.047493615163524,7.683808505519166,7.724776391758454,7.642840619279878,326390,458221.6666666667,42.7372373363975,30.82281828365908,NaN,NaN,NaN,NaN,0.3864488636718559,31.871148783558223,-16530645,0.08252033304427953,-0.4760221459397247,-0.5585424789840042
2022-06-22T09:30:00-04:00,7.29,7.655,7.29,7.61,NaN,NaN,NaN,8.225515780944749,NaN,NaN,8.8161,11.056269895342759,6.5759301046572425,7.047493615163524,7.5183333333333335,7.5183333333333335,7.5183333333333335,432653,458365.9666666667,43.943213219286925,31.821134182242936,NaN,NaN,NaN,NaN,0.3849168019810091,30.579447639482694,-16097992,0.10465624087983416,-0.4277221778842115,-0.5323784187640457
2022-06-22T13:30:00-04:00,7.61,7.725,7.455,7.49,NaN,NaN,NaN,8.225515780944749,NaN,NaN,8.7637,11.002924696183925,6.524475303816075,7.047493615163524,7.533381618535903,7.5521005940746715,7.514662642997134,279608,454814.8,42.03640685925877,32.551922370402266,NaN,NaN,NaN,NaN,0.37670845898236555,29.172818179661096,-16377600,0.11023981874786237,-0.3945786453292177,-0.5048184640770801
2022-06-23T09:30:00-04:00,7.77,8.065,7.61,7.675,NaN,NaN,NaN,8.225515780944749,NaN,NaN,8.716600000000001,10.946351950329896,6.486848049670106,7.089849384770979,7.783333333333333,7.783333452542623,7.783333214124044,369708,443291.4666666667,45.9316373855741,33.81172054174884,NaN,NaN,NaN,NaN,0.3908721404836251,27.243316054607696,-16007892,0.12436914510413644,-0.34935703269690954,-0.473726177801046
2022-06-23T13:30:00-04:00,7.68,7.995,7.64,7.975,NaN,NaN,NaN,8.225515780944749,NaN,NaN,8.6751,10.881152120871135,6.4690478791288655,7.089849384770979,7.8108888798696805,7.851247760200708,7.770529999538653,172345,433628.26666666666,51.61052162466128,35.57552247035608,NaN,NaN,NaN,NaN,0.38830984473479474,25.451635509915256,-15835547,0.15016966731902953,-0.28601409365225905,-0.4361837609712886
2022-06-24T09:30:00-04:00,8.08,8.37,7.845,8.045,6.842475058871342,6.842475058871342,6.842475058871342,NaN,NaN,NaN,8.641000000000002,10.832196933185145,6.44980306681486,7.341403606253426,8.086666666666666,8.086666666666666,8.086666666666666,577926,439909.5333333333,52.854803337949136,37.279644689188615,NaN,NaN,NaN,NaN,0.3980734272537379,24.702123357787055,-15257621,0.16691263325553807,-0.22754296940186602,-0.3944556026574041
2022-06-24T13:30:00-04:00,8.045,8.145,7.885,8.015,6.842475058871342,NaN,NaN,NaN,NaN,NaN,8.6071,10.783490672650476,6.4307093273495255,7.341403606253426,8.04789489652149,8.08360754647732,8.01218224656566,681176,456900.63333333336,52.23488241080967,39.00421671588241,NaN,NaN,NaN,NaN,0.3882110395927566,24.00614778795373,-15938797,0.1703386104140388,-0.1815323396398556,-0.3518709500538944
2022-06-27T09:30:00-04:00,8.15,8.395,7.825,8.37,6.845793390417896,NaN,NaN,NaN,NaN,NaN,8.5699,10.697089215843306,6.442710784156695,7.347698308002194,8.196666666666665,8.196666666666665,8.196666666666665,545579,462499.8333333333,58.44583454803516,41.268855932185815,NaN,NaN,NaN,NaN,0.40119596533613106,23.917822903176496,-15393218,0.18941972603633012,-0.11509629250848175,-0.30451601854481186
2022-06-27T13:30:00-04:00,8.36,9.7,8.29,9.11,7.595984599944355,NaN,NaN,NaN,NaN,NaN,8.548300000000001,10.630708807126984,6.465891192873018,8.157158646401754,8.844583157250545,9.194289250541246,8.494877063959844,1872791,515980.86666666664,67.83486520402283,44.22370858120426,NaN,NaN,NaN,NaN,0.47325339638355024,25.714262928781796,-13520427,0.2414509902448177,-0.002702280738789753,-0.24415327098360745
2022-06-28T09:30:00-04:00,9.06,9.3,8.84,9.03,7.671848936310522,NaN,NaN,NaN,NaN,NaN,8.5373,10.603541234706167,6.471058765293833,8.157158646401754,9.056666666666667,9.056666666666667,9.056666666666667,918322,524507.8333333334,66.09616227024685,47.0783929621844,NaN,NaN,NaN,NaN,0.4723067252132967,27.382385809701,-14438749,0.2585264044115132,0.07900473453078405,-0.17952166988072915
2022-06-28T13:30:00-04:00,9.02,9.025,8.775,8.86,7.671848936310522,NaN,NaN,NaN,NaN,NaN,8.5129,10.534015622620363,6.491784377379637,8.157158646401754,8.997792145454097,9.078677616078403,8.916906674829791,486529,521745.6666666667,62.43400307115479,49.765081385256224,NaN,NaN,NaN,NaN,0.4567848162694897,28.72595276324974,-14925278,0.246464223839204,0.12855860991827583,-0.11790561392092816
2022-06-29T09:30:00-04:00,8.51,8.81,8.45,8.56,7.671848936310522,NaN,NaN,NaN,NaN,NaN,8.4861,10.46809121087863,6.504108789121371,8.157158646401754,8.606666666666667,8.606666666666667,8.606666666666667,326365,500446.3333333333,56.486153272302424,51.55657584710103,NaN,NaN,NaN,NaN,0.45344304367881183,28.990932465508116,-15251643,0.20791344469389755,0.1419861919464438,-0.06592725274745377
2022-06-29T13:30:00-04:00,8.55,8.61,8.45,8.48,7.671848936310522,NaN,NaN,NaN,NaN,NaN,8.4545,10.384817331425118,6.52418266857488,8.157158646401754,8.574840719359283,8.619084711343355,8.530596727375212,168872,496387.6,54.98193032349777,53.11857489192954,NaN,NaN,NaN,NaN,0.43248282627318246,29.23698504617661,-15420515,0.16834702992026984,0.14450653465288354,-0.02384049526738631
2022-06-30T09:30:00-04:00,8.42,8.5,8.06,8.32,7.671848936310522,NaN,NaN,NaN,NaN,NaN,8.438999999999998,10.360924035959863,6.517075964040133,8.157158646401754,8.293333333333335,8.293333333333335,8.293333333333335,308023,475378.7,51.99941069291359,53.54479011115078,NaN,NaN,NaN,NaN,0.43301976725366936,28.370073025784976,-15728538,0.12472906121407325,0.13207083125020525,0.007341770036131998
2022-06-30T13:30:00-04:00,8.32,8.345,8.105,8.22,7.671848936310522,NaN,NaN,NaN,NaN,NaN,8.4214,10.334887956586115,6.507912043413885,8.157158646401754,8.262670435886772,8.297400675468941,8.227940196304603,240101,474510.43333333335,50.167718968244266,54.075538799139835,NaN,NaN,NaN,NaN,0.41923264102126445,27.565083292564168,-15968639,0.08440296005789563,0.11284547010850154,0.02844251005060591
2022-07-01T09:30:00-04:00,8.25,8.395,8.03,8.115,7.671848936310522,NaN,NaN,NaN,NaN,NaN,8.4025,10.309039535388681,6.4959604646113185,8.157158646401754,8.18,8.18,8.18,304869,467104.56666666665,48.24600264001954,54.38288090062074,NaN,NaN,NaN,NaN,0.41535888094831697,26.607014543185127,-16273508,0.04774263882830668,0.08812080858598925,0.040378169757682575
2022-07-01T13:30:00-04:00,8.115,8.19,8.06,8.19,7.671848936310522,NaN,NaN,NaN,NaN,NaN,8.3818,10.274594505486556,6.489005494513445,8.157158646401754,8.166230620155039,8.182643526870397,8.149817713439681,214571,465181.1,49.72733821716392,54.932233140471105,NaN,NaN,NaN,NaN,0.3949761037377228,25.71737927590459,-16058937,0.026680116411852972,0.07372831527249879,0.04704819886064582
2022-07-05T09:30:00-04:00,8.01,8.285,7.78,8.275,7.671848936310522,NaN,NaN,NaN,NaN,NaN,8.3585,10.227143625735016,6.489856374264983,8.157158646401754,8.113333333333335,8.113333333333335,8.113333333333335,256284,457359.06666666665,51.42429586866438,55.32456588926327,NaN,NaN,NaN,NaN,0.4028349534707426,24.08984730956355,-15802653,0.01707549159717532,0.06839256335711497,0.051317071759939645
2022-07-05T13:30:00-04:00,8.28,8.435,8.25,8.4,7.671848936310522,NaN,NaN,NaN,NaN,NaN,8.3408,10.190676060713301,6.4909239392866995,7.835726917121404,8.226706745042158,8.350403417424678,8.103010072659638,215292,457822.9666666667,53.88929438808252,55.48733537236478,NaN,NaN,NaN,NaN,0.38727531393711817,22.950640497983684,-15587361,0.01766973337994223,0.07340423848486743,0.055734505104925204
2022-07-06T09:30:00-04:00,8.48,8.795,8.265,8.69,7.671848936310522,NaN,NaN,NaN,NaN,NaN,8.3096,10.080560010841628,6.538639989158371,7.863866325795584,8.583333333333334,8.583333333333334,8.583333333333334,422532,448401.3333333333,59.07766120356756,55.93182521990896,NaN,NaN,NaN,NaN,0.39746993437018113,22.692014427474078,-15164829,0.03511491765823746,0.09962815217772203,0.06451323451948457
2022-07-06T13:30:00-04:00,8.695,8.795,8.61,8.62,7.671848936310522,NaN,NaN,NaN,NaN,NaN,8.2742,9.945352129520288,6.603047870479712,7.957593060636467,8.611965628356607,8.654448786495744,8.569482470217471,191928,439182.86666666664,57.39879380239728,56.30067603359379,NaN,NaN,NaN,NaN,0.3822935104865968,22.451861647715155,-15356757,0.03915304787433767,0.11345454436240665,0.07430149648806898
2022-07-07T09:30:00-04:00,8.6,8.91,8.485,8.835,7.671848936310522,NaN,NaN,NaN,NaN,NaN,8.2457,9.826582044935739,6.66481795506426,8.027574448509172,8.743333333333334,8.743333333333334,8.743333333333334,414699,442992.63333333336,61.059152181893026,56.48734157886935,NaN,NaN,NaN,NaN,0.38534397402326853,21.830326221551875,-14942058,0.05267500735551321,0.1401452556824605,0.08747024832694729
2022-07-07T13:30:00-04:00,8.83,9.02,8.83,9.015,7.740236375128205,NaN,NaN,NaN,NaN,NaN,8.224799999999998,9.73524756281053,6.714352437189468,8.219059558807338,8.820307400286332,8.92212997729386,8.718484823278803,236992,444333.76666666666,63.85891731038517,56.20334530075237,NaN,NaN,NaN,NaN,0.3713908330216064,21.51459093371475,-14705066,0.06907872859731076,0.17381865907358574,0.10473993047627497
2022-07-08T09:30:00-04:00,8.88,9.24,8.76,8.97,7.803634721713286,NaN,NaN,NaN,NaN,NaN,8.2178,9.711026252113237,6.7245737478867635,8.359247647045871,8.99,8.99,8.99,254273,423083.8,62.646265618867524,55.95692411136813,NaN,NaN,NaN,NaN,0.37914863066292026,21.715398212983313,-14959339,0.07191235335366677,0.19463037216835843,0.12271801881469166
2022-07-08T13:30:00-04:00,8.96,9.085,8.935,8.99,7.847560416180865,NaN,NaN,NaN,NaN,NaN,8.2103,9.684042731958408,6.736557268041592,8.359247647045871,8.994341526895182,9.00058958015119,8.988093473639173,122771,404413.5333333333,62.9827161668987,55.99611790392127,NaN,NaN,NaN,NaN,0.36278087132985454,21.901862115161265,-14836568,0.07007620658581379,0.2103132770469589,0.1402370704611451
2022-07-11T09:30:00-04:00,8.88,8.94,8.38,8.45,7.847560416180865,NaN,NaN,NaN,NaN,NaN,8.185899999999998,9.601412189986474,6.770387810013522,8.359247647045871,8.59,8.59,8.59,313139,400560.63333333336,49.911016137029314,55.52646525140176,NaN,NaN,NaN,NaN,0.38043938052057913,20.347408159356004,-15149707,0.02951178175509611,0.17712679765501527,0.14761501589991916
2022-07-11T13:30:00-04:00,8.455,8.46,8.3,8.35,7.847560416180865,NaN,NaN,NaN,NaN,NaN,8.1589,9.50779330934667,6.810006690653329,8.359247647045871,8.519957401050497,8.622443527435033,8.417471274665962,146262,397610.3333333333,47.927277858371376,55.02256150389274,NaN,NaN,NaN,NaN,0.3646937104833949,19.115418360973848,-15295969,-0.005187814535306812,0.14113024773078564,0.14631806226609245
2022-07-12T09:30:00-04:00,8.37,8.52,8.11,8.47,7.847560416180865,NaN,NaN,NaN,NaN,NaN,8.144499999999999,9.464110927508647,6.82488907249135,8.359247647045871,8.366666666666667,8.366666666666667,8.366666666666667,318443,398646.7,50.47124391376329,54.91340673395343,NaN,NaN,NaN,NaN,0.36792987402029526,18.459195623089506,-14977526,-0.02034072962274447,0.12089215023766187,0.14123287986040634
2022-07-12T13:30:00-04:00,8.465,8.505,8.315,8.4,7.847560416180865,NaN,NaN,NaN,NaN,NaN,8.129299999999999,9.41894027542576,6.839659724574237,8.359247647045871,8.381227807745795,8.400474075270463,8.361981540221127,182276,395459.1666666667,48.96838473947269,54.82774000332689,NaN,NaN,NaN,NaN,0.35522059730456,17.849845937911184,-15159802,-0.03452681825445794,0.09807435704233392,0.13260117529679186
2022-07-13T09:30:00-04:00,8.18,8.46,8.085,8.445,7.847560416180865,NaN,NaN,NaN,NaN,NaN,8.112999999999998,9.365119802574938,6.8608801974250575,8.359247647045871,8.33,8.33,8.33,295355,386535.8,49.99912918596023,54.95296332803694,NaN,NaN,NaN,NaN,0.3566334117828057,17.863245129315473,-14864447,-0.039945535644898486,0.08266925574066875,0.12261479138556723
2022-07-13T13:30:00-04:00,8.455,8.47,8.34,8.345,7.847560416180865,NaN,NaN,NaN,NaN,NaN,8.0979,9.319891963967127,6.875908036032871,8.359247647045871,8.348817353032237,8.374910678647051,8.322724027417422,153604,380776.26666666666,47.6937350050914,54.80770595574604,NaN,NaN,NaN,NaN,0.3404453109411768,17.840295013739077,-15018051,-0.04874749377157736,0.06168042417109554,0.1104279179426729
2022-07-14T09:30:00-04:00,8.29,8.34,8.05,8.125,7.847560416180865,NaN,NaN,NaN,NaN,NaN,8.089699999999999,9.305335488129685,6.874064511870311,8.359247647045871,8.171666666666667,8.171666666666667,8.171666666666667,212568,373440.1,42.99668591842711,54.20573381644338,NaN,NaN,NaN,NaN,0.33719921730252134,18.501642362103123,-15230619,-0.06675560271713035,0.026983414546259965,0.09373901726339032
2022-07-14T13:30:00-04:00,8.12,8.27,8.1,8.235,7.847560416180865,NaN,NaN,NaN,NaN,NaN,8.079799999999999,9.282408764312086,6.877191235687912,8.359247647045871,8.182155289435816,8.196460794511012,8.16784978436062,114269,367928.8,45.86732090471763,53.632735710488745,NaN,NaN,NaN,NaN,0.3252564160666269,19.115750614155452,-15116350,-0.06837795523356809,0.008266573221430207,0.07664452845499829
2022-07-15T09:30:00-04:00,8.3,8.36,8.11,8.34,7.847560416180865,NaN,NaN,NaN,NaN,NaN,8.0778,9.27833681326322,6.877263186736779,8.305398117636697,8.27,8.27,8.27,234878,363434.4666666667,48.531717332614726,52.879454005420676,NaN,NaN,NaN,NaN,0.31988095777615355,19.322433203156812,-14881472,-0.05980822779303979,0.0018842437136985524,0.061692471506738344
2022-07-15T13:30:00-04:00,8.335,8.42,8.31,8.405,7.847560416180865,NaN,NaN,NaN,NaN,NaN,8.078399999999998,9.279560172499995,6.877239827500002,8.011318494109357,8.312342222014744,8.365202512275514,8.259481931753973,150706,362713.1666666667,50.166898875998974,52.36289008210652,NaN,NaN,NaN,NaN,0.3048894607921425,19.270790265015705,-14730766,-0.04771593286572791,0.002047555424578462,0.04976348829030637
2022-07-18T09:30:00-04:00,8.63,8.84,8.58,8.755,7.847560416180865,NaN,NaN,NaN,NaN,NaN,8.091099999999999,9.30708731901291,6.875112680987089,8.159342727554991,8.725000000000001,8.725000000000001,8.725000000000001,251653,351837.4,57.91948676136905,52.138628266354814,NaN,NaN,NaN,NaN,0.3141830707355609,18.03996129553476,-14479113,-0.015752870511855088,0.03007240015048751,0.0458252706623426
2022-07-18T13:30:00-04:00,8.75,8.75,8.56,8.61,7.847560416180865,NaN,NaN,NaN,NaN,NaN,8.102899999999998,9.327320009637338,6.878479990362657,8.159342727554991,8.697391973362597,8.737197489681034,8.657586457044161,121056,333166.73333333334,54.160295273560145,51.44586954943873,NaN,NaN,NaN,NaN,0.3056699942544494,16.832580736494553,-14600169,-0.004564592252166877,0.040119530347134,0.04468412259930088
2022-07-19T09:30:00-04:00,8.74,9.05,8.71,8.925,7.8546092358714485,NaN,NaN,NaN,NaN,NaN,8.127199999999998,9.3675872943562,6.886812705643797,8.316379345635195,8.895000000000001,8.895000000000001,8.895000000000001,416529,328865.06666666665,60.203192560015665,51.27136433094932,NaN,NaN,NaN,NaN,0.315264994664846,16.594290536755626,-14183640,0.02238247476280062,0.07266221605280165,0.05027974129000103
2022-07-19T13:30:00-04:00,8.925,9.07,8.925,9.025,7.998945179695474,NaN,NaN,NaN,NaN,NaN,8.151699999999998,9.413475907203932,6.889924092796066,8.410603476508156,8.92886603907505,8.980196333191369,8.877535744958731,181312,272482.43333333335,61.919443609109734,51.19541629110724,NaN,NaN,NaN,NaN,0.3031032093316427,16.427987460140223,-14002328,0.04402242358197313,0.10530777076746745,0.06128534718549432
2022-07-20T09:30:00-04:00,9.02,9.43,8.96,9.24,8.17774312607295,NaN,NaN,NaN,NaN,NaN,8.1884,9.467789604459984,6.909010395540015,8.667482781206525,9.21,9.21,9.21,343167,253310.6,65.37664641075204,52.300104167801706,NaN,NaN,NaN,NaN,0.31502440866509673,17.17426588656566,-13659161,0.06844026698743028,0.14683568091978216,0.07839541393235189
2022-07-20T13:30:00-04:00,9.26,9.42,9.24,9.41,8.334436620342363,NaN,NaN,NaN,NaN,NaN,8.231899999999998,9.526479298459682,6.9373207015403136,8.71998622496522,9.26319094694993,9.333703797187074,9.192678096712786,195274,243602.1,67.86118940304647,53.723954992421355,NaN,NaN,NaN,NaN,0.30537980804616127,17.86723871110356,-13463887,0.09029143311862389,0.19125970533063175,0.10096827221200785
2022-07-21T09:30:00-04:00,9.37,9.49,9.24,9.305,8.380598592144983,NaN,NaN,NaN,NaN,NaN,8.271399999999998,9.573991325013457,6.968808674986538,8.804988979972176,9.345,9.345,9.345,238730,240680.93333333332,64.7696553653447,54.74527009610574,NaN,NaN,NaN,NaN,0.3014241074714355,18.67839419704848,-13702617,0.09163273143315653,0.21550918650345352,0.12387645507029699
2022-07-21T13:30:00-04:00,9.32,9.41,9.2,9.405,8.380598592144983,NaN,NaN,NaN,NaN,NaN,8.3149,9.620739944250518,7.009060055749481,8.804988979972176,9.34289186355916,9.345991864153845,9.339791862964475,110403,238731.96666666667,66.34230618212038,55.98626448486629,NaN,NaN,NaN,NaN,0.2948938140806187,19.252790813834427,-13592214,0.09292230042062793,0.2400293305960819,0.14710703017545396
2022-07-22T09:30:00-04:00,9.46,9.46,8.95,9,8.380598592144983,NaN,NaN,NaN,NaN,NaN,8.353299999999997,9.624075526991449,7.0825244730085455,8.804988979972176,9.136666666666667,9.136666666666667,9.136666666666667,303405,238578.03333333333,55.53074063451102,56.381379588334205,NaN,NaN,NaN,NaN,0.3102585416462889,18.7420357147674,-13895619,0.06167213618399736,0.22419720040545066,0.1625250642214533
2022-07-22T13:30:00-04:00,8.99,9.1,8.98,9.08,8.380598592144983,NaN,NaN,NaN,NaN,NaN,8.393899999999999,9.62460596000846,7.163194039991538,8.804988979972176,9.11325240245044,9.150708522322667,9.075796282578214,118560,234526.66666666666,57.02070856141015,57.04759198521412,NaN,NaN,NaN,NaN,0.2966686458144111,18.267763122776586,-13777059,0.04247588648783579,0.21561992233124805,0.17314403584341226
2022-07-25T09:30:00-04:00,8.99,9.01,8.75,8.97,8.380598592144983,NaN,NaN,NaN,NaN,NaN,8.432999999999998,9.608994897948289,7.257005102051706,8.804988979972176,8.909999999999998,8.909999999999998,8.909999999999998,143794,229157.5,54.32540681748427,57.85678633514677,NaN,NaN,NaN,NaN,0.2990494568276675,16.976018915450766,-13920853,0.0196189287692293,0.1976676968049489,0.1780487680357196
2022-07-25T13:30:00-04:00,8.975,8.985,8.78,8.895,8.380598592144983,NaN,NaN,NaN,NaN,NaN,8.473299999999997,9.569018230203582,7.377581769796412,8.804988979972176,8.900303557445056,8.911802658628671,8.888804456261441,102244,225413.26666666666,52.503134506072804,58.33077302095786,NaN,NaN,NaN,NaN,0.2923316384828341,15.776542151505362,-14023097,-0.0021453875987522963,0.17536703353727923,0.17751242113603152
2022-07-26T09:30:00-04:00,8.7,8.72,8.44,8.515,8.380598592144983,NaN,NaN,NaN,NaN,NaN,8.501199999999997,9.526436675114779,7.475963324885216,8.804988979972176,8.558333333333334,8.558333333333334,8.558333333333334,224886,224366.66666666666,44.38030103924015,58.03424328571682,NaN,NaN,NaN,NaN,0.30395080716263173,15.790460129290487,-14247983,-0.04154343380038805,0.12558312888554646,0.1671265626859345
2022-07-26T13:30:00-04:00,8.52,8.53,8.37,8.435,NaN,NaN,NaN,9.39681438661377,9.39681438661377,9.39681438661377,8.526199999999998,9.48033324017163,7.572066759828365,8.804988979972176,8.514669571492615,8.569824222948274,8.459514920036955,140942,221888.33333333334,42.876358362771214,57.513490391914836,NaN,NaN,NaN,NaN,0.29366860665101513,16.006740858050613,-14388925,-0.0706886645212646,0.07876573203435377,0.14945439655561837
2022-07-27T09:30:00-04:00,8.66,8.74,8.5,8.665,NaN,NaN,NaN,9.39681438661377,NaN,NaN,8.544199999999996,9.473856624781675,7.614543375218318,8.804988979972176,8.635,8.635,8.635,138692,212427,48.30071356604125,56.82643516367715,NaN,NaN,NaN,NaN,0.2944779918902283,15.37021977680644,-14250233,-0.07193519842548093,0.05953539852376721,0.13147059694924815
2022-07-27T13:30:00-04:00,8.67,8.93,8.63,8.91,NaN,NaN,NaN,9.39681438661377,NaN,NaN,8.571399999999997,9.461867382895337,7.6809326171046575,8.804988979972176,8.729360112248386,8.823526580218214,8.635193644278559,139263,210671.5,53.37920623652311,56.77064308960307,NaN,NaN,NaN,NaN,0.2948724210409262,14.436420116204477,-14110970,-0.0545088044600566,0.0633345913741774,0.117843395834234
2022-07-28T09:30:00-04:00,8.88,9.17,8.575,8.96,NaN,NaN,NaN,9.39681438661377,NaN,NaN,8.598399999999998,9.451719260300852,7.745080739699144,8.75699118397774,8.901666666666666,8.901666666666666,8.901666666666666,216288,204057.8,54.36444662229534,56.35358980833733,NaN,NaN,NaN,NaN,0.3163101052522887,14.313166820343298,-13894682,-0.03861230928117047,0.06957800923277091,0.10819031851394138
2022-07-28T13:30:00-04:00,8.96,9.125,8.95,9.105,NaN,NaN,NaN,9.39681438661377,NaN,NaN,8.6307,9.434583100954562,7.826816899045436,8.682592947182192,8.96214983713355,9.039080247771109,8.885219426495992,133692,200614.46666666667,57.18992026323099,56.01576671220313,NaN,NaN,NaN,NaN,0.30621652630569673,14.198717331329345,-13760990,-0.01835736224161652,0.08524361571192074,0.10360097795353726
2022-07-29T09:30:00-04:00,8.97,9.15,8.92,9.01,NaN,NaN,NaN,9.39681438661377,NaN,NaN,8.657399999999999,9.420169270487719,7.89463072951228,8.418074357745754,9.026666666666666,9.026666666666666,9.026666666666666,180755,198163.86666666667,54.79617216188138,55.26001855156952,NaN,NaN,NaN,NaN,0.3007724887124327,13.969935695905283,-13941745,-0.011706818980943251,0.08896745422735819,0.10067427320830144
2022-07-29T13:30:00-04:00,9.01,9.115,9,9.055,NaN,NaN,NaN,9.39681438661377,NaN,NaN,8.679,9.424214063206188,7.933785936793813,8.464523292185355,9.04277422666062,9.057733281137763,9.027815172183479,209576,201057.36666666667,55.74117354015302,54.39430313279142,NaN,NaN,NaN,NaN,0.2875030252329732,13.757495605868655,-13732169,-0.004970729772022842,0.09446086099327289,0.09943159076529573
2022-08-01T09:30:00-04:00,8.91,8.98,8.72,8.865,NaN,NaN,NaN,9.39681438661377,NaN,NaN,8.6954,9.419885583017553,7.970914416982446,8.464523292185355,8.855000000000002,8.855000000000002,8.855000000000002,298618,200573.33333333334,50.9025428224608,53.403795094013994,NaN,NaN,NaN,NaN,0.29089566628776076,13.110619869043822,-14030787,-0.013519960645757848,0.08253163995809842,0.09605160060385627
2022-08-01T13:30:00-04:00,8.86,9.04,8.79,9.04,NaN,NaN,NaN,9.39681438661377,NaN,NaN,8.7159,9.4199332094442,8.0118667905558,8.464523292185355,8.898545125029116,8.948853273449341,8.848236976608892,223727,203155.5,54.79481954271204,52.578974619770534,NaN,NaN,NaN,NaN,0.28797454726720645,12.273594341489495,-13807060,-0.007877307193542085,0.08620496661192867,0.09408227380547075
2022-08-02T09:30:00-04:00,8.79,9.32,8.79,9.245,NaN,NaN,NaN,9.39681438661377,NaN,NaN,8.7334,9.44562311111076,8.02117688888924,8.514755925598902,9.118333333333332,9.118333333333332,9.118333333333332,311902,202937.46666666667,58.90477028482304,52.81997673764996,NaN,NaN,NaN,NaN,0.30526207960526325,12.290097344939523,-13495158,0.008297231084722675,0.1044538126613741,0.09615658157665143
2022-08-02T13:30:00-04:00,9.24,9.255,9.09,9.24,NaN,NaN,NaN,9.39681438661377,NaN,NaN,8.736,9.454623684552818,8.017376315447184,8.528304740479122,9.142289152819842,9.177824086899593,9.106754218740091,141752,201586.66666666666,58.76443599263482,52.94452869702315,NaN,NaN,NaN,NaN,0.29524335963345877,12.305421562428833,-13636910,0.016804434242028057,0.1171621243791865,0.10035769013715844
2022-08-03T09:30:00-04:00,9.53,10.75,9.46,10.45,9.01426515339431,9.01426515339431,9.01426515339431,NaN,NaN,NaN,8.7644,9.625389291455065,7.9034107085449365,9.413643792383297,10.22,10.22,10.22,1589812,244735.23333333334,74.55989589434807,54.38984934537057,NaN,NaN,NaN,NaN,0.38201169108821176,15.188785886054273,-12047098,0.09756009947312548,0.2223078144785653,0.12474771500543981
2022-08-03T13:30:00-04:00,10.445,10.485,10.225,10.29,9.27838946460366,NaN,NaN,NaN,NaN,NaN,8.793000000000001,9.753986992628011,7.832013007371991,9.413643792383297,10.243307274985685,10.289114065942801,10.19750048402857,411594,253334.9,70.70317215384848,55.6898520344974,NaN,NaN,NaN,NaN,0.3732965702961966,17.86619561513504,-12458692,0.1317137970016682,0.28938996125752503,0.15767616425585684
2022-08-04T09:30:00-04:00,10.96,11.345,10.265,10.815,9.630053579848948,NaN,NaN,NaN,NaN,NaN,8.8381,9.950797425179129,7.725402574820873,9.845732027125312,10.808333333333332,10.808333333333332,10.808333333333332,933514,277366.43333333335,75.23061049991436,57.8934455674027,NaN,NaN,NaN,NaN,0.4237753867036112,21.144989328283565,-11525178,0.17828278807240744,0.38052964934636613,0.2022468612739587
2022-08-04T13:30:00-04:00,10.815,10.935,10.63,10.87,9.630053579848948,NaN,NaN,NaN,NaN,NaN,8.885900000000001,10.13048296629844,7.641317033701563,9.845732027125312,10.809500074848996,10.81108999705314,10.807910152644853,502711,290314.5,75.65506259106712,60.234781583709555,NaN,NaN,NaN,NaN,0.4152914305104961,24.189583490492904,-11022467,0.19979157661643598,0.45198633204450367,0.2521947554280677
2022-08-05T09:30:00-04:00,10.42,10.61,9.945,10.315,9.630053579848948,NaN,NaN,NaN,NaN,NaN,8.9258,10.222096817862443,7.629503182137558,9.845732027125312,10.29,10.29,10.29,577501,301735.26666666666,63.77822586270588,61.34031817632846,NaN,NaN,NaN,NaN,0.45169918547403204,24.934114042316086,-11599968,0.1650814491308923,0.45854656684168305,0.29346511771079076
2022-08-05T13:30:00-04:00,10.315,10.415,10.14,10.38,9.630053579848948,NaN,NaN,NaN,NaN,NaN,8.969000000000001,10.311476815442338,7.626523184557663,9.845732027125312,10.296341464709124,10.306199670804972,10.286483258613277,238966,304677.26666666666,64.48149653543516,62.13333891196503,NaN,NaN,NaN,NaN,0.4390778150830297,25.62546384043761,-11361002,0.1361446540098008,0.46364593522304176,0.32750128121324096
2022-08-08T09:30:00-04:00,10.55,10.905,10.3,10.68,9.630053579848948,NaN,NaN,NaN,NaN,NaN,9.0203,10.423002263490098,7.617597736509905,9.845732027125312,10.628333333333332,10.628333333333332,10.628333333333332,459936,311620.0333333333,67.60750251323586,63.07927147560364,NaN,NaN,NaN,NaN,0.45092939971995605,26.868481206914957,-10901066,0.12703023617418124,0.4862890764309675,0.3592588402567863
2022-08-08T13:30:00-04:00,10.67,10.715,10.6,10.68,9.630053579848948,NaN,NaN,NaN,NaN,NaN,9.070100000000002,10.527107192844351,7.613092807155652,9.845732027125312,10.636094378559784,10.651072290139558,10.62111646698001,123491,311701.2,67.60750251323586,63.82338449346113,NaN,NaN,NaN,NaN,0.42693444259710206,28.02271161864392,-10901066,0.11138306649251972,0.49848767337243594,0.3871046068799162
2022-08-09T09:30:00-04:00,10.44,10.49,10.005,10.1,9.630053579848948,NaN,NaN,NaN,NaN,NaN,9.106600000000002,10.573508913327641,7.639691086672363,9.845732027125312,10.198333333333332,10.198333333333332,10.198333333333332,258137,306421.4666666667,56.46483194766839,63.94257447816019,NaN,NaN,NaN,NaN,0.4446534109830233,27.527046287733153,-11159203,0.05519343545137029,0.4560964011941291,0.4009029657427588
2022-08-09T13:30:00-04:00,10.095,10.135,10.03,10.1,9.630053579848948,NaN,NaN,NaN,NaN,NaN,9.140600000000001,10.619181265943878,7.662018734056124,9.845732027125312,10.161825245231254,10.21362340344523,10.11002708701728,128233,304652.1666666667,56.46483194766839,63.9942643644113,NaN,NaN,NaN,NaN,0.42039245305566453,27.066785623316015,-11159203,0.013426576386598443,0.41768618622600684,0.4042596098394084
2022-08-10T09:30:00-04:00,10.51,10.545,10.16,10.4,9.630053579848948,NaN,NaN,NaN,NaN,NaN,9.174800000000001,10.688790700103592,7.66080929989641,9.845732027125312,10.368333333333332,10.368333452542622,10.368333214124043,390561,306231.9666666667,60.381814251560584,64.67135518077556,NaN,NaN,NaN,NaN,0.42215013498025994,27.255070913373398,-10768642,0.00200381641152958,0.40676438035382034,0.40476056394229076
2022-08-10T13:30:00-04:00,10.39,10.65,10.365,10.585,9.630053579848948,NaN,NaN,NaN,NaN,NaN,9.214100000000002,10.769882362671622,7.658317637328382,9.845732027125312,10.418871534592645,10.494928706649528,10.342814362535762,172444,305470.9666666667,62.61557786991292,65.22998077557563,NaN,NaN,NaN,NaN,0.41235369676738426,27.576738657241695,-10596198,0.0028553513941423914,0.4083297531849688,0.4054744017908264
2022-08-11T09:30:00-04:00,11.01,11.295,10.61,10.76,9.720332915836773,NaN,NaN,NaN,NaN,NaN,9.252600000000003,10.863257306816086,7.641942693183919,10.132458499694076,10.888333333333334,10.888333333333334,10.888333333333334,571224,316554.1,64.64620273664147,65.64008309356267,NaN,NaN,NaN,NaN,0.4336141469982853,28.665529153110352,-10024974,0.010710853231155615,0.4188629683297709,0.40815211509861526
2022-08-11T13:30:00-04:00,10.76,10.82,10.51,10.51,9.720332915836773,NaN,NaN,NaN,NaN,NaN,9.282500000000002,10.929500000000033,7.635499999999972,10.132458499694076,10.821993398287805,10.93964753189845,10.704339264677161,181611,318927.7,59.660646421745824,65.70409812421344,NaN,NaN,NaN,NaN,0.4247845650698364,29.40773698309153,-10206585,-0.004602411907378368,0.4023991002143923,0.40700151212177066
2022-08-12T09:30:00-04:00,10.65,10.92,10.44,10.86,9.720332915836773,NaN,NaN,NaN,NaN,NaN,9.320300000000001,11.0226987899432,7.617901210056802,10.132458499694076,10.74,10.74,10.74,193448,315262.4666666667,63.86250446883818,64.93999873667703,NaN,NaN,NaN,NaN,0.4287285247077053,30.21705127860635,-10013137,0.0046664234482586275,0.41283454143209397,0.40816811798383534
2022-08-12T13:30:00-04:00,10.86,10.93,10.83,10.92,9.720332915836773,NaN,NaN,NaN,NaN,NaN,9.358900000000002,11.116226708384088,7.6015732916159156,10.132458499694076,10.796658931504707,10.870668851863092,10.722649011146322,113376,315089.6666666667,64.54431886088712,64.50008064432265,NaN,NaN,NaN,NaN,0.405247915800012,30.981099316020828,-9899761,0.01033919726376853,0.421092114563546,0.4107529172997775
2022-08-15T09:30:00-04:00,10.81,11.18,10.8,10.96,9.805805713855147,NaN,NaN,NaN,NaN,NaN,9.409100000000002,11.202730608570251,7.6154693914297535,10.240863001474693,10.979999999999999,10.980000119209288,10.979999880790709,145875,315159.0333333333,65.01817229678862,63.77062077267082,NaN,NaN,NaN,NaN,0.40344449324286824,32.00236680789953,-9753886,0.012160734797669548,0.4259538357968644,0.41379310099919486
2022-08-15T13:30:00-04:00,10.955,11.155,10.9,11.01,9.862359999589003,NaN,NaN,NaN,NaN,NaN,9.462300000000003,11.284684383164016,7.639915616835989,10.276190401179754,11.001363884861966,11.02219046146252,10.980537308261413,153499,316867.5333333333,65.63640432137692,63.055002324835804,NaN,NaN,NaN,NaN,0.3928413151540919,32.95068662178689,-9600387,0.012083363897337995,0.4288973058708674,0.4168139419735294
2022-08-16T09:30:00-04:00,11.03,11.26,10.62,11.26,9.862359999589003,NaN,NaN,NaN,NaN,NaN,9.518100000000002,11.385824701341186,7.650375298658818,10.276190401179754,11.046666666666667,11.046666666666667,11.046666666666667,307167,319610.23333333334,68.62236381747044,63.40101217874756,NaN,NaN,NaN,NaN,0.4104955069287996,32.922662383665056,-9293220,0.023555842221842038,0.44625874475083194,0.4227029025289899
2022-08-16T13:30:00-04:00,11.27,11.59,10.88,10.9,9.9932505368156,NaN,NaN,NaN,NaN,NaN,9.568100000000001,11.447236918907235,7.688963081092767,10.416561856755044,11.094956375218906,11.13197414172299,11.057938608714823,522713,332335.93333333335,60.473491201504345,63.114726083466785,NaN,NaN,NaN,NaN,0.4318886850053138,33.37845063178819,-9815933,0.0026836725535115957,0.4260574932208794,0.4233738206673678
2022-08-17T09:30:00-04:00,10.77,10.8,10.31,10.435,9.9932505368156,NaN,NaN,NaN,NaN,NaN,9.607900000000003,11.474456283641086,7.7413437163589185,10.416561856755044,10.515,10.515,10.515,220907,335076.43333333335,51.90039573783849,61.99278988522411,NaN,NaN,NaN,NaN,0.44318235036207704,32.24085565138673,-10036840,-0.04407431356658209,0.3682809287091402,0.4123552422757223
2022-08-17T13:30:00-04:00,10.46,10.63,10.4,10.405,9.9932505368156,NaN,NaN,NaN,NaN,NaN,9.649100000000002,11.49313870892128,7.805061291078724,10.416561856755044,10.503156651946197,10.520302823594662,10.486010480297733,105396,333947.5333333333,51.3941754965631,60.83469509831891,NaN,NaN,NaN,NaN,0.4279550396219287,31.18451745529966,-10142236,-0.07674475901409705,0.316424293508101,0.393169052522198
2022-08-18T09:30:00-04:00,10.37,10.42,9.945,10.02,NaN,NaN,NaN,11.430517635100557,11.430517635100557,11.430517635100557,9.687000000000001,11.481410209511791,7.892589790488211,10.416561856755044,10.128333333333334,10.128333333333334,10.128333333333334,202358,333483.2,45.289153926020184,60.0364323824869,NaN,NaN,NaN,NaN,0.4313153939346481,29.13980745926238,-10344594,-0.12135312197895409,0.2414776500485054,0.3628307720274595
2022-08-18T13:30:00-04:00,10.015,10.19,10.005,10.17,NaN,NaN,NaN,11.314016833505075,NaN,NaN,9.725700000000002,11.476104536100184,7.975295463899819,10.416561856755044,10.125887140421407,10.129100253079681,10.122674027763132,117287,332936.36666666664,47.886550899535244,59.42369802190596,NaN,NaN,NaN,NaN,0.41372143722503024,27.241148177227764,-10227307,-0.13668645781469024,0.1919726997590967,0.32865915757378694
2022-08-19T09:30:00-04:00,9.82,9.84,9.21,9.225,NaN,NaN,NaN,10.81712970470939,NaN,NaN,9.743400000000001,11.454863046635873,8.031936953364129,10.416561856755044,9.424999999999999,9.424999999999999,9.424999999999999,347448,338492.8,36.22007928592341,57.69785981007474,NaN,NaN,NaN,NaN,0.45274133456609944,26.610160478146994,-10574755,-0.2024357807899264,0.07561443158637893,0.27805021237630534
2022-08-19T13:30:00-04:00,9.22,9.405,9.195,9.27,NaN,NaN,NaN,10.562032899949873,NaN,NaN,9.760700000000002,11.434776473761021,8.086623526238983,10.416561856755044,9.367914008929993,9.4346058256547,9.301222192205287,254568,339992.5333333333,37.00709427130223,55.86868241017397,NaN,NaN,NaN,NaN,0.435402667811378,26.048351995909417,-10320187,-0.23269730035580097,-0.012821413068445864,0.2198758872873551
2022-08-22T09:30:00-04:00,8.97,9.26,8.89,9.065,NaN,NaN,NaN,10.33148594995215,NaN,NaN,9.766900000000001,11.428280016733122,8.10551998326688,10.416561856755044,9.071666666666665,9.071666666666665,9.071666666666665,246580,338257.93333333335,34.8946562219122,53.74357194483617,NaN,NaN,NaN,NaN,0.4314453343962795,26.008740091432742,-10566767,-0.2545534451343346,-0.09831591913056315,0.15623752600377144
2022-08-22T13:30:00-04:00,9.065,9.1,8.995,9.03,NaN,NaN,NaN,10.261191134045234,NaN,NaN,9.775300000000001,11.417332167772631,8.133267832227371,10.416561856755044,9.0618148898676,9.075903743542577,9.047726036192623,120569,334819.3333333333,34.53222762591375,51.94868488799102,NaN,NaN,NaN,NaN,0.40812781051083097,25.9719576087044,-10687336,-0.2585663469691414,-0.16697040770765526,0.0915959392614861
2022-08-23T09:30:00-04:00,9.06,9.33,8.95,9.17,NaN,NaN,NaN,10.261191134045234,NaN,NaN,9.7802,11.413492331458198,8.146907668541804,10.416561856755044,9.15,9.15,9.15,161929,329820.23333333334,37.33589846460681,50.05392731626021,NaN,NaN,NaN,NaN,0.4061186811886288,25.330755910578368,-10525407,-0.23942767068726725,-0.207688649097598,0.03173902158966927
2022-08-23T13:30:00-04:00,9.175,9.24,9.115,9.19,NaN,NaN,NaN,10.261191134045234,NaN,NaN,9.783500000000002,11.411333222415644,8.15566677758436,9.566249485404036,9.162433655149306,9.177897698368534,9.146969611930077,104683,328584.6,37.74605813920558,48.13976583614009,NaN,NaN,NaN,NaN,0.38603877538944104,24.735354333747047,-10420724,-0.21389373036370263,-0.23562814136495902,-0.021734411001256393
2022-08-24T09:30:00-04:00,9.22,9.485,9.16,9.235,NaN,NaN,NaN,10.261191134045234,NaN,NaN,9.783400000000002,11.4113673706804,8.155432629319604,9.52799958832323,9.293333333333333,9.293333333333333,9.293333333333333,163889,281053.8333333333,38.71798675404292,46.2611811545154,NaN,NaN,NaN,NaN,0.3816788628616238,23.537301612306276,-10256835,-0.18360694510706432,-0.2512430923850868,-0.06763614727802247
2022-08-24T13:30:00-04:00,9.235,9.33,9.23,9.33,NaN,NaN,NaN,10.261191134045234,NaN,NaN,9.781800000000002,11.411388610662218,8.152211389337786,9.300899670658582,9.294346758280179,9.295880072677535,9.292813443882823,71593,269720.4666666667,40.818611315983354,44.48848165413015,NaN,NaN,NaN,NaN,0.3615589440857935,22.424824085254127,-10185242,-0.14831949149532483,-0.2530355116471785,-0.10471602015185369
2022-08-25T09:30:00-04:00,9.49,9.645,9.34,9.645,NaN,NaN,NaN,10.261191134045234,NaN,NaN,9.788600000000002,11.413002708690192,8.164197291309813,9.202219736526866,9.543333333333333,9.543333333333333,9.543333333333333,145975,243469.16666666666,47.27253649815981,42.963493988465096,NaN,NaN,NaN,NaN,0.3582333052225225,21.0504120082934,-10039267,-0.09736960630278133,-0.22642802803033035,-0.12905842172754903
2022-08-25T13:30:00-04:00,9.645,9.825,9.63,9.825,NaN,NaN,NaN,10.261191134045234,NaN,NaN,9.797000000000002,11.41772082728641,8.176279172713595,9.156729667578716,9.622329296816055,9.726614625800352,9.518043967831758,83761,229504.16666666666,50.588526516632285,42.257425082402804,NaN,NaN,NaN,NaN,0.34657378342091366,20.187270154543594,-9955506,-0.047667149186375796,-0.18864235821051878,-0.14097520902414298
2022-08-26T09:30:00-04:00,9.86,9.92,9.21,9.335,NaN,NaN,NaN,10.261191134045234,NaN,NaN,9.803700000000003,11.413922108902993,8.193477891097013,9.156729667578716,9.488333333333335,9.488333333333335,9.488333333333335,237585,218173.63333333333,42.71353478640405,41.601220728728926,NaN,NaN,NaN,NaN,0.37253279889084834,19.120688180863286,-10193091,-0.0440012324356189,-0.19597674956866662,-0.15197551713304772
2022-08-26T13:30:00-04:00,9.335,9.435,9.305,9.37,NaN,NaN,NaN,10.261191134045234,NaN,NaN,9.809500000000002,11.411320526775711,8.207679473224292,9.156729667578716,9.44939830439068,9.504998441795665,9.393798166985695,116506,214091.63333333333,43.39139042341411,41.02959322350399,NaN,NaN,NaN,NaN,0.35520902754150213,18.13029063387443,-10076585,-0.03577773951024027,-0.19669769152084804,-0.16091995201060777
2022-08-29T09:30:00-04:00,9.24,9.58,9.22,9.41,NaN,NaN,NaN,10.261191134045234,NaN,NaN,9.8183,11.406351145272112,8.23024885472789,9.156729667578716,9.403333333333334,9.403333333333334,9.403333333333334,142037,203495,44.20396854932887,40.95207998231176,NaN,NaN,NaN,NaN,0.35555123985996623,16.837268921485936,-9934548,-0.024728102196832802,-0.19183007975664879,-0.16710197755981598
2022-08-29T13:30:00-04:00,9.41,9.485,9.37,9.37,NaN,NaN,NaN,10.261191134045234,NaN,NaN,9.827800000000002,11.399240307488663,8.25635969251134,9.156729667578716,9.405103516702747,9.407494618471985,9.402712414933509,77847,201973.53333333333,43.531043949149584,40.640972342998495,NaN,NaN,NaN,NaN,0.3383690084413972,15.636605902839479,-10012395,-0.017535385337681175,-0.18902120923191745,-0.17148582389423628
2022-08-30T09:30:00-04:00,9.52,9.63,9.31,9.36,NaN,NaN,NaN,10.261191134045234,NaN,NaN,9.844700000000001,11.376990324971127,8.312409675028876,9.156729667578716,9.433333333333334,9.433333333333334,9.433333333333334,202205,200109.13333333333,43.35335820720246,41.150492265946994,NaN,NaN,NaN,NaN,0.33705693640986883,14.906808679799413,-10214600,-0.011182668996688072,-0.18546416014009637,-0.1742814911434083
2022-08-30T13:30:00-04:00,9.35,9.49,9.35,9.475,NaN,NaN,NaN,10.261191134045234,NaN,NaN,9.865500000000003,11.348111547236847,8.382888452763158,9.156729667578716,9.435391716153084,9.437852401883568,9.432931030422601,141492,200551.1,46.079150427503215,41.79849627710421,NaN,NaN,NaN,NaN,0.3229814409520211,14.22913982983364,-10073108,0.0023132269469478273,-0.17138995745972352,-0.17370318440667135
2022-08-31T09:30:00-04:00,9.54,9.68,9.43,9.45,NaN,NaN,NaN,10.261191134045234,NaN,NaN,9.881200000000002,11.32884161310736,8.433558386892644,9.156729667578716,9.52,9.52,9.52,139360,192177.73333333334,45.56583447750248,42.56072329536066,NaN,NaN,NaN,NaN,0.3177684808840196,14.116252397803548,-10212468,0.010639107066257064,-0.16040430057385002,-0.1710434076401071
2022-08-31T13:30:00-04:00,9.455,9.615,9.41,9.56,NaN,NaN,NaN,10.261191134045234,NaN,NaN,9.894200000000003,11.318203314602888,8.470196685397118,9.156729667578716,9.5234544374986,9.527559780446452,9.519349094550748,98672,189718.66666666666,48.29512130533333,43.54378712960492,NaN,NaN,NaN,NaN,0.3097135893923039,13.942308134098298,-10113796,0.023879200971320486,-0.1411944064259565,-0.16507360739727697
2022-09-01T09:30:00-04:00,9.4,9.41,8.99,9.34,NaN,NaN,NaN,10.23575847842486,NaN,NaN,9.901800000000003,11.309744260260318,8.493855739739688,9.156729667578716,9.246666666666666,9.246666666666666,9.246666666666666,199233,177318.96666666667,43.58796243222747,43.99036312729212,NaN,NaN,NaN,NaN,0.3283054758642822,13.409723488865295,-10313029,0.018391106683323277,-0.1420847240431229,-0.16047583072644617
2022-09-01T13:30:00-04:00,9.34,9.63,9.29,9.61,NaN,NaN,NaN,10.23575847842486,NaN,NaN,9.911900000000003,11.303991792950438,8.519808207049568,9.038925233582203,9.350909548515823,9.479688611788655,9.22213048524299,130546,175616.8,50.02563188307534,44.867475537568524,NaN,NaN,NaN,NaN,0.32914079901683363,12.627888153990652,-10182483,0.03268098005082182,-0.11962460566291888,-0.1523055857137407
2022-09-02T09:30:00-04:00,9.82,9.82,9.28,9.385,NaN,NaN,NaN,10.23575847842486,NaN,NaN,9.919400000000003,11.295928445038443,8.542871554961563,9.038925233582203,9.495,9.495,9.495,164907,174665.43333333332,45.378252841725086,45.34320882954582,NaN,NaN,NaN,NaN,0.34420217051563134,12.407026375614514,-10347390,0.026953971453097803,-0.11861312139736846,-0.14556709285046626
2022-09-02T13:30:00-04:00,9.39,9.53,9.38,9.44,NaN,NaN,NaN,10.23575847842486,NaN,NaN,9.927100000000003,11.288424487401867,8.565775512598139,9.038925233582203,9.474588030059044,9.496990934568938,9.45218512554915,136899,175449.53333333333,46.6821783003586,45.76203504271549,NaN,NaN,NaN,NaN,0.3303305869073719,12.201940438550958,-10210491,0.02678850060091914,-0.11208146709931732,-0.13886996770023646
2022-09-06T09:30:00-04:00,9.51,9.74,9.355,9.595,NaN,NaN,NaN,10.23575847842486,NaN,NaN,9.941700000000003,11.272463104387846,8.61093689561216,9.038925233582203,9.563333333333333,9.563333333333333,9.563333333333333,307126,180824.56666666668,50.28411475094654,45.977147775057404,NaN,NaN,NaN,NaN,0.33423554498541674,12.560984134242126,-9903365,0.03643827808839606,-0.09332212008974139,-0.12976039817813745
2022-09-06T13:30:00-04:00,9.595,9.655,9.475,9.58,NaN,NaN,NaN,10.23575847842486,NaN,NaN,9.952500000000004,11.262417936360844,8.642582063639164,9.038925233582203,9.566358907148135,9.569678002690607,9.563039811605664,255207,184214.83333333334,49.93256100186691,45.9302930954313,NaN,NaN,NaN,NaN,0.3232187203436013,12.894381851669639,-10158572,0.04080215274534335,-0.07875770724645825,-0.1195598599918016
2022-09-07T09:30:00-04:00,9.6,9.785,9.455,9.725,NaN,NaN,NaN,10.23575847842486,NaN,NaN,9.962100000000003,11.258098595678218,8.666101404321788,9.038925233582203,9.655000000000001,9.655000000000001,9.655000000000001,173673,179765.03333333333,53.32933272694975,46.68856437689885,NaN,NaN,NaN,NaN,0.3237030974619155,13.544148926655033,-9984899,0.0517419942438839,-0.05488236718694672,-0.10662436143083062
2022-09-07T13:30:00-04:00,9.725,9.92,9.725,9.86,NaN,NaN,NaN,10.23575847842486,NaN,NaN,9.974500000000003,11.254389448350901,8.694610551649104,9.207572842973272,9.739383808847998,9.829208406798307,9.64955921089769,153271,167450.3,56.30185062929711,47.61074010589049,NaN,NaN,NaN,NaN,0.3145100190717787,14.484378547135766,-9831628,0.06547393268311515,-0.024781945576936693,-0.09025587826005184
2022-09-08T09:30:00-04:00,9.59,10.08,9.58,9.99,NaN,NaN,NaN,10.23575847842486,NaN,NaN,9.965300000000003,11.23797813684372,8.692621863156285,9.260058274378618,9.883333333333333,9.883333333333333,9.883333333333333,348483,171702.83333333334,59.00929840121314,48.66826366673937,NaN,NaN,NaN,NaN,0.3277593034237945,15.73248485203503,-9483145,0.07976773583324046,0.009453791531498723,-0.07031394430174173
2022-09-08T13:30:00-04:00,9.99,10.11,9.92,10.09,NaN,NaN,NaN,10.23575847842486,NaN,NaN,9.961300000000001,11.23112488556497,8.691475114435033,9.359046619502895,9.945876188062568,10.022601489603652,9.869150886521485,231558,175908.23333333334,61.01047895518495,49.91679473859904,NaN,NaN,NaN,NaN,0.3179193531792377,16.960741664981313,-9251587,0.09156806339865572,0.04414613494657793,-0.047421928452077794
2022-09-09T09:30:00-04:00,10.44,10.925,10.29,10.89,9.540636684896848,9.540636684896848,9.540636684896848,NaN,NaN,NaN,9.962800000000003,11.236825368664212,8.688774631335795,9.906737295602316,10.701666666666668,10.701666666666668,10.701666666666668,371071,181532,72.55430596784277,52.00257672150192,NaN,NaN,NaN,NaN,0.3548536850950065,19.511534759593744,-8880516,0.1456505986376953,0.13464131984504135,-0.01100927879265396
2022-09-09T13:30:00-04:00,10.885,10.91,10.59,10.6,9.687994108310628,NaN,NaN,NaN,NaN,NaN,9.957400000000003,11.218219162290907,8.6965808377091,9.935389836481852,10.700854625796195,10.701687687042824,10.700021564549566,352581,189375.13333333333,65.03711051775065,53.35671672794816,NaN,NaN,NaN,NaN,0.3523641361596489,21.880128347448142,-9233097,0.15350648590206045,0.18087382858492163,0.02736734268286116
2022-09-12T09:30:00-04:00,10.69,11.275,10.57,11.16,9.812630739751054,NaN,NaN,NaN,NaN,NaN,9.974300000000003,11.275834494356552,8.672765505643454,10.142811869185483,11.001666666666665,11.001666785875955,11.001666547457376,363613,189913.96666666667,71.23485808502176,55.190218414199535,NaN,NaN,NaN,NaN,0.3775524121482454,24.527864366958514,-8869484,0.1858717290957276,0.2597070040525207,0.07383527495679307
2022-09-12T13:30:00-04:00,11.165,11.27,10.98,10.99,10.026033887944187,NaN,NaN,NaN,NaN,NaN,9.986500000000003,11.314190099383143,8.658809900616863,10.219249495348386,11.028209398173821,11.065285860233889,10.991132936113754,186352,187640.1,67.33275678266583,56.550049519723295,NaN,NaN,NaN,NaN,0.3712986684233707,26.986476385075285,-9055836,0.18489178837602308,0.3049500104268219,0.12005822205079883
2022-09-13T09:30:00-04:00,10.52,10.91,10.325,10.5,10.026033887944187,NaN,NaN,NaN,NaN,NaN,9.982900000000003,11.304008761608989,8.661791238391016,10.219249495348386,10.578333333333333,10.578333333333333,10.578333333333333,429670,193743.1,57.54765302863122,57.54717027660927,NaN,NaN,NaN,NaN,0.39227733496455863,26.813652830536526,-9485506,0.14222004428765625,0.29783327741036913,0.15561323312271289
2022-09-13T13:30:00-04:00,10.505,10.555,10.38,10.41,10.026033887944187,NaN,NaN,NaN,NaN,NaN,9.977500000000003,11.2893418349786,8.665658165021405,10.219249495348386,10.539145777852926,10.598800766813529,10.479490788892324,185412,195904.53333333333,55.939639079869316,57.96959936209455,NaN,NaN,NaN,NaN,0.37675752532423296,26.653173815607683,-9670918,0.10085652616706825,0.2816838908315482,0.18082736466447996
2022-09-14T09:30:00-04:00,10.39,10.655,10.28,10.57,10.026033887944187,NaN,NaN,NaN,NaN,NaN,9.986900000000002,11.308815110739,8.664984889261005,10.219249495348386,10.501666666666667,10.501666666666667,10.501666666666667,353334,202284.7,58.177017045864176,58.88379680524735,NaN,NaN,NaN,NaN,0.3766319878010735,26.50415758745947,-9317584,0.07820586623849324,0.2785846974625965,0.20037883122410327
2022-09-14T13:30:00-04:00,10.575,10.9,10.425,10.78,10.026033887944187,NaN,NaN,NaN,NaN,NaN,10.000500000000004,11.340655587982194,8.660344412017814,10.219249495348386,10.624845992957876,10.722122500053414,10.527569485862339,566559,217680.56666666668,60.97784571723576,59.90491590645286,NaN,NaN,NaN,NaN,0.3836582743867111,26.860292823869614,-8751025,0.07148408452056873,0.2897339368748142,0.21824985235424546
2022-09-15T09:30:00-04:00,10.65,11.62,10.65,11.47,10.026033887944187,NaN,NaN,NaN,NaN,NaN,10.021900000000004,11.41981686448083,8.623983135519177,10.29969807463576,11.246666666666668,11.246666666666668,11.246666666666668,637941,233482.3,68.45333289546977,61.202717202490234,NaN,NaN,NaN,NaN,0.4255398262162316,28.292454201523565,-8113084,0.10556813392041037,0.3502100197547584,0.24464188583434804
2022-09-15T13:30:00-04:00,11.465,11.47,11.17,11.26,10.12635077582639,NaN,NaN,NaN,NaN,NaN,10.035400000000005,11.4674291058494,8.60337089415061,10.29969807463576,11.261531133153861,11.285443874151959,11.237618392155763,246502,239312.6,64.40915064441614,62.23675931981518,NaN,NaN,NaN,NaN,0.41657269577221506,29.62231833791652,-8359586,0.10576523696644935,0.3768484320424097,0.27108319507596035
2022-09-16T09:30:00-04:00,10.91,11.03,10.42,10.43,10.12635077582639,NaN,NaN,NaN,NaN,NaN,10.028800000000004,11.450413956037261,8.607186043962747,10.29969807463576,10.626666666666667,10.626666666666667,10.626666666666667,301191,244486.46666666667,51.46695225326839,62.10373214312366,NaN,NaN,NaN,NaN,0.4468175032170568,28.613786851022788,-8660777,0.04490431413369389,0.32721358774307774,0.28230927360938385
2022-09-16T13:30:00-04:00,10.42,10.52,10.2,10.23,10.12635077582639,NaN,NaN,NaN,NaN,NaN,10.023200000000005,11.43938326497662,8.60701673502339,10.29969807463576,10.4451093291954,10.597817245907112,10.292401412483688,425742,255885.83333333334,48.91630326758179,61.57619304585828,NaN,NaN,NaN,NaN,0.43775911013012425,27.155364194531472,-9086519,-0.010933384096551979,0.2686425434886939,0.27957592758524585
2022-09-19T09:30:00-04:00,9.97,10.16,9.76,10.14,NaN,NaN,NaN,11.2082781240676,11.2082781240676,11.2082781240676,10.008800000000004,11.405158922340476,8.612441077659533,10.29969807463576,10.020000000000001,10.020000000000001,10.020000000000001,285319,257476.96666666667,47.76903260445901,60.7733169175187,NaN,NaN,NaN,NaN,0.4400620308351154,25.557035909275527,-9371838,-0.05365065563943039,0.21251260803595784,0.26616326367538823
2022-09-19T13:30:00-04:00,10.15,10.295,10.06,10.245,NaN,NaN,NaN,11.2082781240676,NaN,NaN,9.995300000000004,11.369028371986198,8.62157162801381,10.29969807463576,10.080547749574942,10.165592237608726,9.995503261541158,144622,258414.16666666666,49.26409441804859,59.93428945058038,NaN,NaN,NaN,NaN,0.42541474291832143,23.787627906884897,-9227216,-0.07333826281729072,0.17449043515377483,0.24782869797106555
2022-09-20T09:30:00-04:00,10.2,10.25,9.94,10.02,NaN,NaN,NaN,11.2082781240676,NaN,NaN,9.976500000000003,11.322350288850837,8.63064971114917,10.29969807463576,10.069999999999999,10.069999999999999,10.069999999999999,109611,257333.3,46.211566316940086,58.05266518980163,NaN,NaN,NaN,NaN,0.41717083270986993,22.39406086375018,-9336827,-0.09845194195346743,0.12476377052923127,0.2232157124826987
2022-09-20T13:30:00-04:00,10,10.055,9.9,9.91,NaN,NaN,NaN,11.153864454074947,NaN,NaN,9.954500000000003,11.267618806506043,8.641381193493963,10.29969807463576,10.003340114740643,10.060105830644316,9.94657439883697,151151,259776.76666666666,44.75163337436585,56.60370253670271,NaN,NaN,NaN,NaN,0.3984443446591649,21.185351995453033,-9487978,-0.11808665408440674,0.07560739487719026,0.193694048961597
2022-09-21T09:30:00-04:00,10.01,10.51,9.85,10.22,NaN,NaN,NaN,11.153864454074947,NaN,NaN,9.933700000000002,11.195382701791543,8.672017298208461,10.29969807463576,10.193333333333333,10.193333333333333,10.193333333333333,157815,258297.1,49.58546660901569,55.05731743127371,NaN,NaN,NaN,NaN,0.4171268914692246,20.28014931385136,-9330163,-0.10618540961241416,0.0609622869460793,0.16714769655849346
2022-09-21T13:30:00-04:00,10.225,10.48,9.88,9.9,NaN,NaN,NaN,11.153864454074947,NaN,NaN,9.913700000000004,11.144811384075313,8.682588615924695,10.29969807463576,10.12467674632851,10.175761404900031,10.073592087756987,285057,263082.6,45.190161004273335,53.475703447102816,NaN,NaN,NaN,NaN,0.43018925636427996,19.43960396664981,-9615220,-0.11510503157332791,0.023266407091833585,0.1383714386651615
2022-09-22T09:30:00-04:00,10.63,11.1,9.61,9.68,NaN,NaN,NaN,11.153864454074947,NaN,NaN,9.898600000000004,11.122263417774606,8.674936582225401,10.263758459708608,10.13,10.13000011920929,10.129999880790711,766859,283999.23333333334,42.40705245267184,52.39423197739143,NaN,NaN,NaN,NaN,0.5058900237668313,19.79117872581246,-10382079,-0.12996307389293035,-0.024082403701001454,0.1058806701919289
2022-09-22T13:30:00-04:00,9.68,9.78,9.615,9.63,NaN,NaN,NaN,11.043398313780436,NaN,NaN,9.883100000000002,11.100329460701593,8.665870539298412,9.645006767766885,10.033190823512504,10.219406179081348,9.84697546794366,207261,287618.86666666664,41.77731604899383,51.38263747518604,NaN,NaN,NaN,NaN,0.48154073635491473,20.117641002177784,-10589340,-0.1366191049336616,-0.06489321097514811,0.0717258939585135
2022-09-23T09:30:00-04:00,9.49,9.58,9.165,9.395,NaN,NaN,NaN,10.720630208608597,NaN,NaN,9.870600000000003,11.094766067165677,8.646433932834329,9.446887534129482,9.379999999999999,9.379999999999999,9.379999999999999,296176,290850.3,38.856733147367834,50.00261719672201,NaN,NaN,NaN,NaN,0.4803592551867067,19.290275671958433,-10885516,-0.1492802392893568,-0.11487440515318248,0.034405834136174304
2022-09-23T13:30:00-04:00,9.38,9.455,9.215,9.44,NaN,NaN,NaN,10.654578835490026,NaN,NaN,9.856000000000002,11.082944171509029,8.629055828490975,9.446887534129482,9.375558994494984,9.380527648756356,9.370590340233612,236611,294385.8,39.72567495568186,48.48460499946817,NaN,NaN,NaN,NaN,0.4631907369590848,18.522007865326177,-10648905,-0.1468323527496547,-0.14913460680089408,-0.0023022540512393774
2022-09-26T09:30:00-04:00,9.44,9.73,9.28,9.32,NaN,NaN,NaN,10.654578835490026,NaN,NaN,9.857900000000003,11.081218584833852,8.634581415166153,9.446887534129482,9.443333333333333,9.443333333333333,9.443333333333333,225091,296391.93333333335,38.167937845688634,46.32136249591237,NaN,NaN,NaN,NaN,0.4622485414620074,18.34915675067754,-10873996,-0.1452380007773126,-0.18384975502288015,-0.03861175424556753
2022-09-26T13:30:00-04:00,9.33,9.435,9.24,9.24,NaN,NaN,NaN,10.625008814981614,NaN,NaN,9.857300000000002,11.081800240914577,8.632799759085428,9.446887534129482,9.384143306060583,9.452586672752888,9.315699939368278,168342,297440.0333333333,37.122838720195325,44.37234021561088,NaN,NaN,NaN,NaN,0.44315935992900685,18.082548416698295,-11042338,-0.1413784729659065,-0.21533484545295067,-0.07395637248704416
2022-09-27T09:30:00-04:00,9.46,9.78,9.38,9.45,NaN,NaN,NaN,10.625008814981614,NaN,NaN,9.865000000000002,11.074221236995076,8.655778763004928,9.446887534129482,9.536666666666667,9.536666666666667,9.536666666666667,254578,295688.43333333335,41.640216885327895,43.670430546472275,NaN,NaN,NaN,NaN,0.4500765485055063,18.48278162392717,-10787760,-0.1174721470028278,-0.22079655624057892,-0.10332440923775112
2022-09-27T13:30:00-04:00,9.44,9.62,9.43,9.61,NaN,NaN,NaN,10.625008814981614,NaN,NaN,9.876600000000003,11.064498042762818,8.688701957237189,9.446887534129482,9.542479785331864,9.550422893191097,9.53453667747263,136351,291726.56666666665,44.88897503169377,43.382764243908845,NaN,NaN,NaN,NaN,0.4314996521836844,18.85442674492542,-10651409,-0.08517722584530593,-0.20979594154438352,-0.12461871569907759
2022-09-28T09:30:00-04:00,9.59,10.05,9.55,9.9,NaN,NaN,NaN,10.625008814981614,NaN,NaN,9.891200000000003,11.061819596623845,8.720580403376161,9.434608021842868,9.833333333333334,9.833333333333334,9.833333333333334,246752,294162.5333333333,50.290381285197896,43.56286057824733,NaN,NaN,NaN,NaN,0.43639253417056406,19.925061644833818,-10404657,-0.04082701644232792,-0.17565248625198748,-0.13482546980965956
2022-09-28T13:30:00-04:00,9.905,10.145,9.86,10,NaN,NaN,NaN,10.625008814981614,NaN,NaN,9.907400000000003,11.06105200992319,8.753747990076816,9.434608021842868,9.907833662777344,9.991443409233703,9.824223916320985,195913,295583.93333333335,52.03608162087501,43.760859664163505,NaN,NaN,NaN,NaN,0.4255787817298095,21.0642757793327,-10208744,-0.0032780002754188853,-0.13892297015393318,-0.1356449698785143
2022-09-29T09:30:00-04:00,9.82,9.89,9.575,9.61,NaN,NaN,NaN,10.625008814981614,NaN,NaN,9.914900000000003,11.055774208666243,8.774025791333763,9.172213605262323,9.691666666666666,9.691666666666666,9.691666666666666,194968,290466.76666666666,45.34752855871454,43.69914268143311,NaN,NaN,NaN,NaN,0.4255374401776803,21.24646772058061,-10403712,-0.0032234057871023958,-0.1396742271123923,-0.1364508213252899
2022-09-29T13:30:00-04:00,9.6,9.77,9.565,9.76,NaN,NaN,NaN,10.625008814981614,NaN,NaN,9.923500000000002,11.053034860019771,8.793965139980234,9.172213605262323,9.693689911403258,9.696755001770043,9.690624821036472,84952,285579.9,48.11014977711921,43.93903671020121,NaN,NaN,NaN,NaN,0.40978476587927454,21.385645580026942,-10318760,0.00779643490279186,-0.12670527769680007,-0.13450171259959193
2022-09-30T09:30:00-04:00,9.82,10.47,9.7,10.33,NaN,NaN,NaN,10.625008814981614,NaN,NaN,9.937200000000004,11.069504128756805,8.804895871243204,9.36893336589431,10.166666666666666,10.166666666666666,10.166666666666666,295865,283073.0333333333,57.00430645905072,44.46895384234657,NaN,NaN,NaN,NaN,0.43551442545932645,22.633527089697083,-10022895,0.051897050372546924,-0.06963039963390827,-0.12152745000645519
2022-09-30T13:30:00-04:00,10.33,10.33,10.085,10.085,NaN,NaN,NaN,10.625008814981614,NaN,NaN,9.942400000000003,11.074983312608788,8.809816687391217,9.36893336589431,10.166666666666666,10.166666666666666,10.166666666666666,93190,274426.6666666667,52.81398618414845,45.01351278376621,NaN,NaN,NaN,NaN,0.4219062522122316,23.792274205819353,-10116085,0.062290547570586025,-0.04366426554322267,-0.1059548131138087
2022-10-03T09:30:00-04:00,10.035,10.16,9.72,9.95,NaN,NaN,NaN,10.625008814981614,NaN,NaN,9.954700000000003,11.073909381661851,8.835490618338154,9.36893336589431,9.943333333333333,9.943333333333333,9.943333333333333,239397,270286.13333333336,50.6064988921496,45.5991875294432,NaN,NaN,NaN,NaN,0.4231986627685007,23.779493841240846,-10355482,0.057890202015698014,-0.03359206059418618,-0.0914822626098842
2022-10-03T13:30:00-04:00,9.955,10.16,9.95,10.095,NaN,NaN,NaN,10.625008814981614,NaN,NaN,9.969200000000003,11.076454911933075,8.86194508806693,9.36893336589431,10.000758831087596,10.063052485876357,9.938465176298836,203442,270855.8,52.88439020375361,46.3925499690689,NaN,NaN,NaN,NaN,0.407970186856465,23.767626359846513,-10152040,0.06218503820141669,-0.013750964858113335,-0.07593600305953002
2022-10-04T09:30:00-04:00,10.45,10.84,10.41,10.745,9.349022325600297,9.349022325600297,9.349022325600297,NaN,NaN,NaN,9.995900000000002,11.11227572528242,8.879524274717586,9.72898310667031,10.664999999999997,10.665000168587392,10.664999831412603,417078,270436.06666666665,61.46387593814957,48.007345882696164,NaN,NaN,NaN,NaN,0.432043744938146,24.802619175334662,-9734962,0.10379089138586868,0.053802611172805825,-0.049988280213062855
2022-10-04T13:30:00-04:00,10.76,10.95,10.74,10.825,9.598384947163918,NaN,NaN,NaN,NaN,NaN,10.025000000000004,11.150415478834237,8.899584521165771,9.956186485336247,10.735012152879506,10.820063539003751,10.64996076675526,282619,273676.3,62.37204840347704,49.62494398611011,NaN,NaN,NaN,NaN,0.41618347744256406,25.906213336548454,-9452343,0.12998889080399212,0.11249783329192731,-0.017491057512064825
2022-10-05T09:30:00-04:00,10.65,10.965,10.52,10.93,9.598384947163918,NaN,NaN,NaN,NaN,NaN,10.056400000000004,11.193396112570214,8.919403887429793,9.956186485336247,10.805,10.805,10.805,213202,269005.23333333334,63.58505713589067,51.440452506838824,NaN,NaN,NaN,NaN,0.4182418004823809,26.279017495534312,-9239141,0.14645537418072277,0.16557816021383864,0.019122786033115867
2022-10-05T13:30:00-04:00,10.93,10.94,10.75,10.75,9.625305292767125,NaN,NaN,NaN,NaN,NaN,10.081900000000005,11.222778415958386,8.941021584041623,10.030959350615198,10.808302516328764,10.812378587392583,10.804226445264945,139958,254785.2,60.01340224878188,53.07549275888072,NaN,NaN,NaN,NaN,0.4019388147336394,26.62519278602118,-9379099,0.13743729595465298,0.1909194059764321,0.05348211002177911
2022-10-06T09:30:00-04:00,10.83,11.145,10.71,11.06,9.70392777945953,NaN,NaN,NaN,NaN,NaN,10.114100000000004,11.272567418618126,8.955632581381883,10.200267480492158,10.971666666666666,10.971666666666666,10.971666666666666,152826,238614.7,63.786191099986965,54.6573480599278,NaN,NaN,NaN,NaN,0.40430032796695076,27.269901161475378,-9226273,0.14387613866869622,0.2333272833576494,0.08945114468895318
2022-10-06T13:30:00-04:00,11.06,11.18,10.98,11.18,9.884771971302278,NaN,NaN,NaN,NaN,NaN,10.146500000000005,11.331479746662227,8.961520253337783,10.324213984393728,11.035252433451985,11.105714010855955,10.964790856048015,124455,234546.46666666667,65.15666873204304,56.1050404670956,NaN,NaN,NaN,NaN,0.38970744739788277,27.923426749608517,-9101818,0.14721226625439637,0.27346647750694864,0.12625421125255226
2022-10-07T09:30:00-04:00,10.92,11.17,10.66,10.74,9.884771971302278,NaN,NaN,NaN,NaN,NaN,10.174500000000004,11.348035257246146,9.000964742753862,10.324213984393728,10.856666666666667,10.856666666666667,10.856666666666667,165564,230025.56666666668,56.68579680335469,56.56185586124965,NaN,NaN,NaN,NaN,0.399014058298034,27.505428977307524,-9267382,0.11235536851583591,0.26669842189734716,0.15434305338151125
2022-10-07T13:30:00-04:00,10.73,10.865,10.72,10.8,9.884771971302278,NaN,NaN,NaN,NaN,NaN,10.198300000000003,11.373343165164508,9.023256834835498,10.324213984393728,10.830106387368307,10.860642193459896,10.799570581276718,125260,220009.5,57.497261103426865,56.951940110003356,NaN,NaN,NaN,NaN,0.3808701969910316,27.117288188742318,-9142122,0.08703982990046366,0.2631428407570908,0.17610301085662716
2022-10-10T09:30:00-04:00,10.815,10.825,10.4,10.47,9.884771971302278,NaN,NaN,NaN,NaN,NaN,10.220000000000004,11.374050258870769,9.06594974112924,10.324213984393728,10.565,10.565,10.565,146713,215389.3,51.75433540602238,57.409569170525344,NaN,NaN,NaN,NaN,0.3840223257773864,25.808931280926,-9288835,0.04394444243524581,0.2310335639006844,0.1870891214654386
2022-10-10T13:30:00-04:00,10.47,10.6,10.47,10.49,9.884771971302278,NaN,NaN,NaN,NaN,NaN,10.241000000000003,11.37556070793936,9.106439292060646,10.324213984393728,10.550108973745058,10.571283333677197,10.528934613812918,72560,212987.23333333334,52.066816004222524,57.692188186747,NaN,NaN,NaN,NaN,0.36587787393614446,24.59402843795371,-9216275,0.014200145649359064,0.20483930352713742,0.19063915787777835
2022-10-11T09:30:00-04:00,10.45,10.63,9.85,10.49,NaN,NaN,NaN,11.439340072638558,11.439340072638558,11.439340072638558,10.258900000000004,11.38029250933816,9.137507490661848,10.324213984393728,10.323333333333332,10.323333333333332,10.323333333333332,204237,216141.43333333332,52.066816004222524,57.33951029711642,NaN,NaN,NaN,NaN,0.3954580257978485,23.734480437353458,-9216275,-0.00692541924537618,0.18198238382105814,0.18890780306643432
2022-10-11T13:30:00-04:00,10.49,10.49,10.265,10.44,NaN,NaN,NaN,11.439340072638558,NaN,NaN,10.276100000000003,11.38158141549274,9.170618584507267,10.324213984393728,10.350570513919854,10.386638845426504,10.314502182413204,116468,214985.33333333334,51.107072581056265,57.21758789689555,NaN,NaN,NaN,NaN,0.38328245252657356,22.936328722510368,-9332743,-0.024716591702752422,0.1580120634379938,0.1827286551407462
2022-10-12T09:30:00-04:00,10.33,10.64,10.14,10.61,NaN,NaN,NaN,11.439340072638558,NaN,NaN,10.293800000000003,11.391733622765885,9.19586637723412,10.324213984393728,10.463333333333333,10.463333333333333,10.463333333333333,128823,214018.93333333332,54.19835578027666,57.474149103190335,NaN,NaN,NaN,NaN,0.39161942020324686,21.775407371184848,-9203920,-0.02538896876754687,0.15099244418131264,0.1763814129488595
2022-10-12T13:30:00-04:00,10.61,10.675,10.54,10.65,NaN,NaN,NaN,11.439340072638558,NaN,NaN,10.309600000000003,11.404842146741903,9.214357853258104,10.324213984393728,10.540613716140143,10.61975790761552,10.461469524664766,122827,208611.26666666666,54.92057145156143,57.619590620890904,NaN,NaN,NaN,NaN,0.37328946161730076,20.59872777389564,-9081093,-0.023534799110475513,0.14696291406076512,0.17049771317124063
2022-10-13T09:30:00-04:00,10.18,10.935,9.96,10.91,NaN,NaN,NaN,11.439340072638558,NaN,NaN,10.328000000000005,11.43202355047332,9.22397644952669,10.324213984393728,10.601666666666668,10.601666785875958,10.601666547457379,176957,188947.86666666667,59.40174018970883,57.47229521028799,NaN,NaN,NaN,NaN,0.4162687857874935,20.775875718147212,-8904136,-0.006100710945118409,0.1628718244898426,0.16897253543496102
2022-10-13T13:30:00-04:00,10.92,10.935,10.57,10.625,NaN,NaN,NaN,11.439340072638558,NaN,NaN,10.338700000000003,11.44365938386886,9.233740616131145,10.225371187514982,10.64004163245446,10.69185524033071,10.58822802457821,97068,185274.76666666666,53.16323563971226,56.814522870019076,NaN,NaN,NaN,NaN,0.41260672965981543,20.940370237809383,-9001204,-0.014582077428375306,0.1507449386494919,0.1653270160778672
2022-10-14T09:30:00-04:00,10.87,11,10.15,10.155,NaN,NaN,NaN,11.439340072638558,NaN,NaN,10.324000000000003,11.418740151816742,9.229259848183265,10.036796950011986,10.435,10.435,10.435,136675,179958.06666666668,44.80612104538112,55.47317029212554,NaN,NaN,NaN,NaN,0.44384910611268574,21.84136167831748,-9137879,-0.05063517387590627,0.10203304873298435,0.15266822260889062
2022-10-14T13:30:00-04:00,10.17,10.175,9.885,9.89,NaN,NaN,NaN,11.299698874296588,NaN,NaN,10.309800000000003,11.408264309843453,9.211335690156552,9.94993756000959,10.206346268940694,10.43216198983086,9.980530548050528,140132,176742.1,40.90200885015589,54.10807076365226,NaN,NaN,NaN,NaN,0.432859884247494,23.079983213618885,-9278011,-0.08888170473484885,0.04156609169032954,0.1304477964251784
2022-10-17T09:30:00-04:00,10.42,10.58,10.115,10.12,NaN,NaN,NaN,11.299698874296588,NaN,NaN,10.289000000000003,11.361356284077186,9.216643715922821,9.834950048007672,10.271666666666667,10.271666666666667,10.271666666666667,170287,174915.3,45.352632138219164,52.79138798066884,NaN,NaN,NaN,NaN,0.45122703537267295,23.0138201515139,-9107724,-0.09470576846820075,0.01206558583992745,0.1067713543081282
2022-10-17T13:30:00-04:00,10.13,10.26,10.12,10.21,NaN,NaN,NaN,11.299698874296588,NaN,NaN,10.273400000000002,11.327042140387245,9.21975785961276,9.822455539663942,10.245702669461808,10.281384186238608,10.210021152685009,90165,172309.4,47.03355693272444,51.49687999500322,NaN,NaN,NaN,NaN,0.4289965328460535,22.952383022416416,-9017559,-0.08862137022121767,-0.004005358468393894,0.08461601175282378
2022-10-18T09:30:00-04:00,10.67,10.77,10.35,10.53,NaN,NaN,NaN,11.299698874296588,NaN,NaN,10.274000000000001,11.328191633432926,9.219808366567076,9.822455539663942,10.549999999999999,10.549999999999999,10.549999999999999,167522,169407.53333333333,52.61460418621824,51.20608052235061,NaN,NaN,NaN,NaN,0.4383539233570496,21.572647229991553,-8850037,-0.06051188421324602,0.008976156486266262,0.06948804069951228
2022-10-18T13:30:00-04:00,10.515,10.6,10.31,10.44,NaN,NaN,NaN,11.299698874296588,NaN,NaN,10.274600000000003,11.32913466514845,9.220065334851556,9.822455539663942,10.507380176810491,10.556832507294438,10.457927846326545,124429,169010.13333333333,50.987353092887204,50.74108709302636,NaN,NaN,NaN,NaN,0.42775721454583165,20.37848295949817,-8974466,-0.04609836893963102,0.01186507952497351,0.05796344846460453
2022-10-19T09:30:00-04:00,10.28,10.39,9.91,9.93,NaN,NaN,NaN,11.299698874296588,NaN,NaN,10.261800000000001,11.317217945649922,9.20638205435008,9.822455539663942,10.076666666666666,10.076666666666666,10.076666666666666,118161,164723.76666666666,42.89198250425907,50.10806188575755,NaN,NaN,NaN,NaN,0.43506027064970076,20.084016726683444,-9092627,-0.06772315437097765,-0.026690494499117534,0.04103265987186012
2022-10-19T13:30:00-04:00,9.94,10.14,9.91,10.13,NaN,NaN,NaN,11.278676111742739,NaN,NaN,10.248800000000001,11.294332515037128,9.203267484962874,9.816871545384924,10.070324354645921,10.078416343187971,10.06223236610387,72587,160612.9,46.48062196437412,49.70904802576838,NaN,NaN,NaN,NaN,0.42041310846043645,19.810583796212626,-9020040,-0.06533754544237268,-0.040639271931105725,0.02469827351126695
2022-10-20T09:30:00-04:00,10.095,10.48,9.98,10.02,NaN,NaN,NaN,11.278676111742739,NaN,NaN,10.2198,11.207046595334734,9.232553404665264,9.816871545384924,10.16,10.16000011920929,10.15999988079071,332302,165190.7,44.81267963238122,49.19089542777972,NaN,NaN,NaN,NaN,0.42609788642754814,18.679358257171845,-9352342,-0.06766230235064448,-0.05987960442703866,0.007782697923605825
2022-10-20T13:30:00-04:00,10.005,10.01,9.825,9.835,NaN,NaN,NaN,11.151469349749066,NaN,NaN,10.191300000000002,11.138237822668355,9.244362177331649,9.680497236307938,10.097618582608654,10.211423421960745,9.983813743256562,99844,165687.1,42.077873112512655,48.545952608598036,NaN,NaN,NaN,NaN,0.4095908945398662,17.967164212053667,-9452186,-0.07744966642450071,-0.08902938510702008,-0.011579718682519356
2022-10-21T09:30:00-04:00,9.77,10.025,9.55,9.94,NaN,NaN,NaN,11.030152561124108,NaN,NaN,10.181500000000002,11.128495776125677,9.234504223874326,9.59849166799173,9.838333333333333,9.838333333333333,9.838333333333333,286401,165371.63333333333,44.16076813512528,47.8289820625158,NaN,NaN,NaN,NaN,0.4142629735013043,17.867317888461347,-9165785,-0.07271773233405388,-0.10247688410008671,-0.029759151766032825
2022-10-21T13:30:00-04:00,9.93,10.15,9.93,10.14,NaN,NaN,NaN,11.030152561124108,NaN,NaN,10.179700000000002,11.126662322376,9.232737677624005,9.59849166799173,9.900862296650308,10.004710431568554,9.797014161732061,103834,165726.43333333332,47.9967681161666,47.334424681416166,NaN,NaN,NaN,NaN,0.40038704682263976,17.437845135397506,-9061951,-0.052905022759992544,-0.0958904302160235,-0.04298540745603096
2022-10-24T09:30:00-04:00,10.09,10.165,9.705,10.105,NaN,NaN,NaN,11.030152561124108,NaN,NaN,10.179000000000002,11.126130402848412,9.231869597151592,9.59849166799173,9.991666666666665,9.991666666666665,9.991666666666665,144238,162554.46666666667,47.38330669254763,46.47596514590465,NaN,NaN,NaN,NaN,0.4046451149067369,17.49677999214842,-9206189,-0.039555159999487804,-0.09242935745539071,-0.05287419745590291
2022-10-24T13:30:00-04:00,10.095,10.235,10.06,10.21,NaN,NaN,NaN,11.030152561124108,NaN,NaN,10.178300000000002,11.125285976664845,9.231314023335159,9.59849166799173,10.046604780216718,10.128382143058616,9.96482741737482,65097,157942.96666666667,49.46987023460993,46.21215333125448,NaN,NaN,NaN,NaN,0.38824189241339846,17.350638356964556,-9141092,-0.021931279135782522,-0.08028829637563106,-0.05835701723984854
2022-10-25T09:30:00-04:00,10.22,10.87,10.22,10.66,NaN,NaN,NaN,11.030152561124108,NaN,NaN,10.1911,11.14644557098461,9.23575442901539,9.857887009715824,10.583333333333334,10.583333333333334,10.583333333333334,237073,151942.8,57.28743692197895,47.10367589386861,NaN,NaN,NaN,NaN,0.4076531858124413,16.56221444592991,-8904019,0.019514680355046374,-0.03396366679604057,-0.053478347151086944
2022-10-25T13:30:00-04:00,10.67,10.905,10.635,10.82,NaN,NaN,NaN,11.030152561124108,NaN,NaN,10.209300000000002,11.177122318403423,9.241477681596582,9.960309607772661,10.644967317379551,10.738420489788542,10.551514144970561,103118,145959.43333333332,59.676208867407304,48.444690180815144,NaN,NaN,NaN,NaN,0.3978208153972669,15.904157530345955,-8800901,0.055167591125226276,0.015481141755445904,-0.03968644936978037
2022-10-26T09:30:00-04:00,10.82,11.49,10.75,11.04,9.865332875936023,9.865332875936023,9.865332875936023,NaN,NaN,NaN,10.225700000000002,11.221089391142906,9.230310608857097,10.364247686218128,11.093333333333334,11.093333333333334,11.093333333333334,228513,146469.8,62.760204311985675,49.68808819322703,NaN,NaN,NaN,NaN,0.4222621857260336,16.392327348506146,-8572388,0.08902386842072064,0.07159338615612043,-0.01743048226460021
2022-10-26T13:30:00-04:00,11.045,11.19,11.01,11.08,9.877817745211656,NaN,NaN,NaN,NaN,NaN,10.2493,11.268354483332432,9.230245516667567,10.364247686218128,11.093333333333334,11.093333452542623,11.093333214124044,158827,147098.76666666666,63.30965180791245,50.8506663985976,NaN,NaN,NaN,NaN,0.40495774388845973,16.845627893940613,-8413561,0.1082891657691941,0.11793097494689242,0.009641809177698316
2022-10-27T09:30:00-04:00,11.12,11.48,11.04,11.29,10.033371484065672,NaN,NaN,NaN,NaN,NaN,10.281500000000001,11.327942067197135,9.235057932802867,10.467518519179603,11.270000000000001,11.270000000000001,11.270000000000001,207798,148931.16666666666,66.13465174008752,51.81638408101684,NaN,NaN,NaN,NaN,0.4074607621821413,17.747612736593148,-8205763,0.12800139077529815,0.169643547646821,0.041642156871522854
2022-10-27T13:30:00-04:00,11.29,11.3,11.06,11.165,10.033371484065672,NaN,NaN,NaN,NaN,NaN,10.312200000000002,11.370387431412677,9.254012568587328,10.467518519179603,11.235606686724797,11.281262625692735,11.189950747756859,117922,148713.4,63.024023328810465,52.67614624072564,NaN,NaN,NaN,NaN,0.39549927916913125,18.585170090484787,-8323685,0.12528973553053538,0.19825432628469208,0.0729645907541567
2022-10-28T09:30:00-04:00,11.11,11.47,11.02,11.34,10.034745505109425,NaN,NaN,NaN,NaN,NaN,10.3511,11.414545889549586,9.287654110450415,10.501011852274946,11.276666666666666,11.276666666666666,11.276666666666666,198294,149804.4,65.47250497998112,54.28904070327722,NaN,NaN,NaN,NaN,0.3993921877999077,19.644745448439295,-8125391,0.1275251145105278,0.23237098389231647,0.10484586938178866
2022-10-28T13:30:00-04:00,11.35,11.57,11.335,11.515,10.265211618513542,NaN,NaN,NaN,NaN,NaN,10.392600000000002,11.47241153911218,9.312788460887823,10.677309481819956,11.361657646203101,11.459081596233748,11.264233696172454,150912,150659.46666666667,67.77082782332431,55.809769693202234,NaN,NaN,NaN,NaN,0.3876498886713428,20.791421716178224,-7974479,0.13245336091104903,0.27041257052059997,0.13795920960955094
2022-10-31T09:30:00-04:00,11.45,12.35,11.36,11.775,10.586679272217472,NaN,NaN,NaN,NaN,NaN,10.441700000000003,11.544965353394067,9.338434646605938,11.140847585455964,11.828333333333333,11.828333333333333,11.828333333333333,315206,156275.9,70.87297290266649,57.67121921250833,NaN,NaN,NaN,NaN,0.4306748966233898,22.881874049091255,-7659273,0.14393371104381497,0.31787634841431966,0.1739426373705047
2022-10-31T13:30:00-04:00,11.78,11.84,11.68,11.68,10.586679272217472,NaN,NaN,NaN,NaN,NaN,10.490500000000003,11.592685556065636,9.38831444393437,11.140847585455964,11.801467528566942,11.844251637615319,11.758683419518565,124288,158000.16666666666,68.28664450921421,59.54327431227273,NaN,NaN,NaN,NaN,0.41134097543600484,24.82300835822478,-7783561,0.13593564923873375,0.3438621989189219,0.20792654968018814
2022-11-01T09:30:00-04:00,12.04,12.15,11.625,11.85,10.639443303817984,NaN,NaN,NaN,NaN,NaN,10.5385,11.664042091616272,9.41295790838373,11.140847585455964,11.875,11.875,11.875,213087,158295.16666666666,70.37036435318129,61.41538832784816,NaN,NaN,NaN,NaN,0.4194594771905759,26.958414091280474,-7570474,0.13275002387666174,0.3738640795260153,0.24111405564935356
2022-11-01T13:30:00-04:00,11.85,11.965,11.805,11.91,10.671854971826258,NaN,NaN,NaN,NaN,NaN,10.584500000000002,11.742037472395538,9.426962527604466,11.140847585455964,11.882976863646446,11.892065986076156,11.873887741216736,164126,159883.76666666666,71.09229869752254,63.065069083659296,NaN,NaN,NaN,NaN,0.40092665739124905,28.941290843403618,-7406348,0.12542522901323105,0.3978955919158924,0.27247036290266136
2022-11-02T09:30:00-04:00,11.7,11.84,11.5,11.775,10.671854971826258,NaN,NaN,NaN,NaN,NaN,10.622000000000003,11.809504947357999,9.434495052642008,11.140847585455964,11.705,11.705,11.705,224457,163071.56666666668,67.12906922534579,64.47548069314487,NaN,NaN,NaN,NaN,0.40157475329187414,29.718931107226236,-7630805,0.10315974683349627,0.40142004644453166,0.2982602996110354
2022-11-02T13:30:00-04:00,11.775,12.01,11.325,11.42,10.671854971826258,NaN,NaN,NaN,NaN,NaN,10.650400000000001,11.844943996678166,9.455856003321836,11.140847585455964,11.627216558832382,11.684520565849361,11.569912551815403,413559,172762.63333333333,57.97622877573538,65.08307773179669,NaN,NaN,NaN,NaN,0.42181941377102605,29.880408590533627,-8044364,0.05842191669095065,0.37128769547472373,0.3128657787837731
2022-11-03T09:30:00-04:00,11.84,12.75,11.52,12.45,10.758409456619363,NaN,NaN,NaN,NaN,NaN,10.707200000000002,11.966771609714876,9.447628390285129,11.188133549441769,12.24,12.24,12.24,582265,186272.9,70.53090709061055,66.02903988669895,NaN,NaN,NaN,NaN,0.48668945564452415,31.019437956584817,-7462099,0.09019839421066173,0.42561377154710023,0.3354153773364385
2022-11-03T13:30:00-04:00,12.45,12.545,12.19,12.32,11.005072663136664,NaN,NaN,NaN,NaN,NaN,10.758400000000002,12.066967827817791,9.449832172182212,11.188133549441769,12.279466236851913,12.33284675074845,12.226085722955377,318278,193646.56666666668,67.77861777161633,66.60778337985674,NaN,NaN,NaN,NaN,0.47728306595562964,32.07710808220378,-7780377,0.09403271157072929,0.4529562667998501,0.35892355522912084
2022-11-04T09:30:00-04:00,12.47,12.58,11.86,11.9,11.005072663136664,NaN,NaN,NaN,NaN,NaN,10.789800000000003,12.130689197510234,9.448910802489772,11.188133549441769,12.113333333333332,12.113333333333332,12.113333333333332,290930,198788.4,59.676335261856366,66.38750701913322,NaN,NaN,NaN,NaN,0.49461998981594185,32.067008200229054,-8071307,0.06143098094275207,0.4357122814075609,0.37428130046480884
2022-11-04T13:30:00-04:00,11.895,12.285,11.825,12.28,11.005072663136664,NaN,NaN,NaN,NaN,NaN,10.8337,12.222293259381571,9.44510674061843,11.188133549441769,12.120219334606805,12.128426019343486,12.112012649870124,204827,200944.9,63.88306447687882,66.42846506691653,NaN,NaN,NaN,NaN,0.49214713340051747,31.95619821474513,-7866480,0.05861499533309711,0.4475500446311802,0.3889350492980831
2022-11-07T09:30:00-05:00,12.41,12.54,11.965,12.02,11.005072663136664,NaN,NaN,NaN,NaN,NaN,10.875100000000002,12.279181892198535,9.471018107801468,11.188133549441769,12.174999999999999,12.174999999999999,12.174999999999999,409921,208932.7,59.32289158240443,65.94191076993916,NaN,NaN,NaN,NaN,0.4980651953004805,32.239799304938714,-8276401,0.0336388559997437,0.43098361929776274,0.39734476329801904
2022-11-07T13:30:00-05:00,12.02,12.155,11.88,12.04,11.005072663136664,NaN,NaN,NaN,NaN,NaN,10.914000000000001,12.337119109561746,9.490880890438257,11.188133549441769,12.10499405458077,12.179827599324014,12.030160509837525,358738,217885.13333333333,59.5620173517736,65.69462462872224,NaN,NaN,NaN,NaN,0.48213196706473177,32.23911377058806,-7917663,0.013874728232546762,0.41468817358870247,0.4008134453561557
2022-11-08T09:30:00-05:00,11.59,11.62,10.265,10.27,NaN,NaN,NaN,12.507535002287877,12.507535002287877,12.507535002287877,10.9045,12.338306472296685,9.470693527703316,11.188133549441769,10.718333333333334,10.718333333333334,10.718333333333334,1239323,253611.83333333334,38.17395572178827,63.74472825313704,NaN,NaN,NaN,NaN,0.5744796837029652,31.010811279038748,-9156986,-0.11585178496802861,0.25599871414611997,0.3718504991141486
2022-11-08T13:30:00-05:00,10.26,10.38,9.605,9.735,NaN,NaN,NaN,11.592078865820246,NaN,NaN,10.882700000000002,12.35335048192957,9.412049518070432,11.188133549441769,10.33090953252965,10.736325101491303,9.925493963567998,1131765,287189.7,34.17887967735993,61.34530338556816,NaN,NaN,NaN,NaN,0.5888025634384677,30.695237367322438,-10288751,-0.22862124838079234,0.08607393863815815,0.3146951870189505
2022-11-09T09:30:00-05:00,9.57,9.63,8.5,8.605,NaN,NaN,NaN,10.760279826464782,NaN,NaN,10.836200000000003,12.439015722408396,9.233384277591611,11.188133549441769,8.911666666666667,8.911666666666667,8.911666666666667,958394,315197.4666666667,27.607038605073924,58.25487950716869,NaN,NaN,NaN,NaN,0.6349595231928628,31.434443796387974,-11247145,-0.36230123578552914,-0.13818135771296092,0.22411987807256822
2022-11-09T13:30:00-05:00,8.605,8.61,8.29,8.4,NaN,NaN,NaN,10.111858016170927,NaN,NaN,10.789200000000003,12.531151044088089,9.047248955911916,11.188133549441769,8.752259048877912,8.977734521083963,8.52678357667186,479031,328745.6,26.607513689833496,55.27779873435578,NaN,NaN,NaN,NaN,0.6124624143933726,32.28395031211802,-11726176,-0.4422227118551041,-0.3286585117463119,0.1135642001087922
2022-11-10T09:30:00-05:00,9.21,9.4,8.75,9.015,NaN,NaN,NaN,10.111858016170927,NaN,NaN,10.748300000000002,12.557625410201169,8.938974589798836,11.118006839553415,9.055,9.055,9.055,629615,338656.0333333333,34.29331727623004,52.700866800287834,NaN,NaN,NaN,NaN,0.6401436705081317,31.684261055088676,-11096561,-0.4309213793124259,-0.4250875240317402,0.00583385528068571
2022-11-10T13:30:00-05:00,9.01,9.34,8.86,9.265,NaN,NaN,NaN,10.111858016170927,NaN,NaN,10.710000000000003,12.561727841773628,8.858272158226377,11.107479501851348,9.09922988855987,9.148895830753274,9.049563946366467,499332,351972.3,37.17356393700281,50.27810003167928,NaN,NaN,NaN,NaN,0.6287048369004081,31.127406744989994,-10597229,-0.3853470824410887,-0.47584999777067516,-0.09050291532958647
2022-11-11T09:30:00-05:00,8.83,10.41,8.575,10.325,7.610158988752914,7.610158988752914,7.610158988752914,NaN,NaN,NaN,10.701700000000002,12.556533264743658,8.846866735256347,11.107479501851348,9.77,9.77,9.77,1025478,376608.2,47.65148346968988,48.88684390627528,NaN,NaN,NaN,NaN,0.7148687771218076,29.05615180356361,-9571751,-0.2681096438152627,-0.42563997009866483,-0.15753032628340213
2022-11-11T13:30:00-05:00,10.32,10.54,10.19,10.47,8.520492671082327,NaN,NaN,NaN,NaN,NaN,10.695100000000002,12.550835422952218,8.839364577047785,11.107479501851348,9.984752535958483,10.283375117075904,9.686129954841062,530344,390825.2,48.906769844459525,48.23902541118416,NaN,NaN,NaN,NaN,0.688806721613107,26.99245127164308,-9041407,-0.16988300282384,-0.36988407981320215,-0.20000107698936215
2022-11-14T09:30:00-05:00,10.02,10.27,9.625,9.95,8.520492671082327,NaN,NaN,NaN,NaN,NaN,10.684700000000003,12.551162332863845,8.818237667136161,10.871483601481078,9.948333333333332,9.948333333333332,9.948333333333332,376786,398576.8,44.7614101483102,46.398347058162706,NaN,NaN,NaN,NaN,0.6999633843550279,25.733344643781724,-9418193,-0.13077271303341909,-0.363466968281136,-0.23269425524771692
2022-11-14T13:30:00-05:00,9.965,9.97,9.54,9.56,8.520492671082327,NaN,NaN,NaN,NaN,NaN,10.666100000000002,12.558310654234786,8.773889345765218,9.705686881184864,9.828033681999269,9.956895638436645,9.699171725561893,328378,407352.8333333333,41.89337458342982,44.54940111614938,NaN,NaN,NaN,NaN,0.680680285472526,24.662445860508537,-9746571,-0.12217127915735071,-0.38540835419440533,-0.2632370750370546
2022-11-15T09:30:00-05:00,9.91,10.395,9.73,10.105,8.520492671082327,NaN,NaN,NaN,NaN,NaN,10.658400000000002,12.556538498634838,8.760261501365166,8.46526588360963,10.076666666666666,10.076666666666666,10.076666666666666,467381,415029.76666666666,47.00363930926153,43.644208548106896,NaN,NaN,NaN,NaN,0.6917031222244884,23.070354045767914,-9279190,-0.07319513776319536,-0.35473099724104884,-0.2815358594778535
2022-11-15T13:30:00-05:00,10.11,10.335,10.04,10.16,8.520492671082327,NaN,NaN,NaN,NaN,NaN,10.652800000000003,12.555130318320062,8.750469681679943,8.643712706887705,10.106837918179442,10.153282575058451,10.060393261300433,197236,418167.0333333333,47.505384677794225,42.47437427674371,NaN,NaN,NaN,NaN,0.6633671849227394,21.591983074937335,-9081954,-0.03258415089172406,-0.3222660480925086,-0.2896818972007845
2022-11-16T09:30:00-05:00,9.84,10.02,9.525,9.59,8.520492671082327,NaN,NaN,NaN,NaN,NaN,10.632400000000002,12.557864349189494,8.706935650810511,8.643712706887705,9.711666666666668,9.711666666666668,9.711666666666668,333371,421662.3,42.9654127933651,41.305982934669466,NaN,NaN,NaN,NaN,0.6613409574282579,20.888621022560784,-9415325,-0.039156949868436264,-0.33862808453632987,-0.2994711346678936
2022-11-16T13:30:00-05:00,9.595,9.63,9.27,9.29,8.520492671082327,NaN,NaN,NaN,NaN,NaN,10.605200000000002,12.566982821822974,8.64341717817703,8.643712706887705,9.570456875936085,9.727112163373127,9.413801588499043,270874,425397.2,40.75765900778639,39.96281448152752,NaN,NaN,NaN,NaN,0.6398166033262396,20.54247236929191,-9686199,-0.05763905888940546,-0.37151995827965045,-0.313880899390245
2022-11-17T09:30:00-05:00,9.14,9.56,9.03,9.495,8.520492671082327,NaN,NaN,NaN,NaN,NaN,10.5769,12.560976500541198,8.592823499458802,8.643712706887705,9.361666666666666,9.361666666666666,9.361666666666666,341462,429852.6666666667,42.91620725263739,40.30154673373103,NaN,NaN,NaN,NaN,0.6319725602315083,20.503115934569298,-9344737,-0.050257538727011386,-0.37670282279900924,-0.32644528407199785
2022-11-17T13:30:00-05:00,9.49,9.57,9.41,9.475,8.520492671082327,NaN,NaN,NaN,NaN,NaN,10.5539,12.561732951218758,8.546067048781243,8.643712706887705,9.40454922685943,9.463285375198973,9.345813078519887,182009,431988.9,42.752543567972694,40.91395129734623,NaN,NaN,NaN,NaN,0.5982602345006862,20.4485196557515,-9526746,-0.04129657560070377,-0.37806600357287756,-0.3367694279721738
2022-11-18T09:30:00-05:00,9.565,9.57,9.105,9.26,8.520492671082327,NaN,NaN,NaN,NaN,NaN,10.536000000000001,12.5734778526403,8.498522147359703,8.643712706887705,9.311666666666667,9.311666666666667,9.311666666666667,226717,432936.3333333333,40.94485554156505,41.8666525070956,NaN,NaN,NaN,NaN,0.5887416463220657,20.768753043946077,-9753463,-0.04416571791309265,-0.3919765753635396,-0.34781085745044693
2022-11-18T13:30:00-05:00,9.265,9.265,9.16,9.2,8.520492671082327,NaN,NaN,NaN,NaN,NaN,10.5222,12.586167209041815,8.458232790958185,8.643712706887705,9.269696042634706,9.320444749038405,9.218947336231007,155069,433074.9,40.4310789326384,42.85405002443881,NaN,NaN,NaN,NaN,0.5541886715847754,21.06611261869818,-9908532,-0.04430693544951125,-0.403194526762336,-0.35888759131282477
2022-11-21T09:30:00-05:00,8.96,9.01,8.735,8.79,8.520492671082327,NaN,NaN,NaN,NaN,NaN,10.495600000000001,12.613200188893016,8.377999811106987,8.643712706887705,8.844999999999999,8.844999999999999,8.844999999999999,467281,438144.06666666665,37.01325595676363,43.04833135876264,NaN,NaN,NaN,NaN,0.5478180521858629,21.849819376553402,-10375813,-0.06496613759634817,-0.44009526330826,-0.3751291257119118
2022-11-21T13:30:00-05:00,8.795,8.855,8.755,8.85,8.520492671082327,NaN,NaN,NaN,NaN,NaN,10.4684,12.634360701397817,8.302439298602184,8.643712706887705,8.838304273024836,8.84937497375481,8.827233572294862,170932,439698.86666666664,37.84136547518618,43.09603146863288,NaN,NaN,NaN,NaN,0.5158310484583012,22.5775470802761,-10204881,-0.06726025252014656,-0.45920444136209504,-0.3919441888419485
2022-11-22T09:30:00-05:00,8.8,9.185,8.65,9.08,8.520492671082327,NaN,NaN,NaN,NaN,NaN,10.439400000000001,12.639838719891944,8.238961280108057,8.643712706887705,8.971666666666666,8.971666666666666,8.971666666666666,239748,440587.56666666665,41.041346779117056,42.62387884787768,NaN,NaN,NaN,NaN,0.5172002592827083,22.51246270546206,-9965133,-0.046920922698410805,-0.450595342214962,-0.4036744195165512
2022-11-22T13:30:00-05:00,9.07,9.1,8.945,9.08,8.520492671082327,NaN,NaN,NaN,NaN,NaN,10.4122,12.645316351648455,8.179083648351545,8.349470165510162,8.99593505007153,9.02924919729532,8.96262090284774,127227,439357.6,41.041346779117056,42.06206291463893,NaN,NaN,NaN,NaN,0.4913288121910862,22.452027214563298,-9965133,-0.028032729875375195,-0.43871533186077016,-0.41068260198539497
2022-11-23T09:30:00-05:00,9.04,9.34,9.04,9.195,8.520492671082327,NaN,NaN,NaN,NaN,NaN,10.397500000000003,12.652687131924866,8.14231286807514,8.493048515406846,9.191666666666666,9.191666666666666,9.191666666666666,214292,439018.76666666666,42.75040846789363,41.91841993746632,NaN,NaN,NaN,NaN,0.4776624684631515,21.855904721707162,-9750841,-0.003641308288116374,-0.41523423734554044,-0.41159292905742406
2022-11-23T13:30:00-05:00,9.195,9.5,9.17,9.46,8.520492671082327,NaN,NaN,NaN,NaN,NaN,10.384100000000004,12.653403584802932,8.114796415197075,8.657438812325477,9.281456656699929,9.373916950047853,9.188996363352004,202093,431969.9,46.59231384467685,42.25405845612681,NaN,NaN,NaN,NaN,0.46711514928721215,20.954286029586218,-9548748,0.03250174069958156,-0.3709657531829471,-0.40346749388252867
2022-11-25T09:30:00-05:00,9.27,9.425,9.24,9.39,8.520492671082327,NaN,NaN,NaN,NaN,NaN,10.371500000000003,12.655697233165201,8.087302766834805,8.657438812325477,9.351666666666667,9.351666666666667,9.351666666666667,70079,414897.0333333333,45.719517813422684,42.162335492138325,NaN,NaN,NaN,NaN,0.44946406719526844,20.117068672616764,-9618827,0.052662808303129804,-0.33763898350361643,-0.39030179180674623
2022-11-28T09:30:00-05:00,9.3,9.53,9.17,9.23,8.520492671082327,NaN,NaN,NaN,NaN,NaN,10.3594,12.661178998948369,8.057621001051633,8.722760839888304,9.31,9.31,9.31,122410,408368.1,43.70426768447623,41.890827135472755,NaN,NaN,NaN,NaN,0.44307377668132064,19.094030810560454,-9741237,0.0558861841828579,-0.32044406157817384,-0.37633024576103175
2022-11-28T13:30:00-05:00,9.235,9.24,9.075,9.2,8.520492671082327,NaN,NaN,NaN,NaN,NaN,10.3446,12.666404332841143,8.022795667158857,8.722760839888304,9.23508069036197,9.304007716096622,9.166153664627318,144619,403491.06666666665,43.31871050735666,41.91606268647215,NaN,NaN,NaN,NaN,0.42321136406122634,18.344323329038943,-9885856,0.05649328871565262,-0.30571363486646597,-0.3622069235821186
2022-11-29T09:30:00-05:00,9.32,9.42,9.07,9.085,8.520492671082327,NaN,NaN,NaN,NaN,NaN,10.323500000000001,12.671386922319675,7.975613077680327,8.722760839888304,9.191666666666668,9.191666666666668,9.191666666666668,220178,404002.76666666666,41.79652903687257,41.990267688549736,NaN,NaN,NaN,NaN,0.41798198091399585,17.20408469033896,-10106034,0.04987547857408481,-0.29986257536451255,-0.34973805393859736
2022-11-29T13:30:00-05:00,9.085,9.19,9.035,9.175,8.520492671082327,NaN,NaN,NaN,NaN,NaN,10.304900000000002,12.674054693134172,7.935745306865831,8.722760839888304,9.171467884006335,9.199221649533046,9.143714118479624,116622,394226.13333333336,43.4706777814273,42.02987272632044,NaN,NaN,NaN,NaN,0.39919755370585325,16.227891622719877,-9989412,0.05204509320569556,-0.2846816874314779,-0.3367267806371735
2022-11-30T09:30:00-05:00,9.31,9.31,9.055,9.105,8.520492671082327,NaN,NaN,NaN,NaN,NaN,10.282800000000002,12.675580942752532,7.890019057247471,8.722760839888304,9.156666666666668,9.156666666666668,9.156666666666668,112974,386034,42.447991301529854,42.008118993003094,NaN,NaN,NaN,NaN,0.3888977284411495,15.126005539435766,-10102386,0.049279313154439064,-0.27512763919412464,-0.3244069523485637
2022-11-30T13:30:00-05:00,9.1,9.62,9.085,9.595,8.520492671082327,NaN,NaN,NaN,NaN,NaN,10.261500000000002,12.659425978840822,7.863574021159181,8.8129918720146,9.350462289814034,9.477190524709341,9.223734054918728,264192,353529.63333333336,51.11729227624471,42.73472161690879,NaN,NaN,NaN,NaN,0.3993336049810673,14.842651569864774,-9838194,0.07919068430599724,-0.22541859696606714,-0.3046092812720644
2022-12-01T09:30:00-05:00,9.64,10.07,9.55,9.94,8.520492671082327,NaN,NaN,NaN,NaN,NaN,10.243900000000002,12.638085698729252,7.849714301270751,9.16439349761168,9.853333333333333,9.853333333333333,9.853333333333333,238670,323759.8,56.128203531940265,43.855944802573205,NaN,NaN,NaN,NaN,0.40795263319670527,15.46998646991526,-9599524,0.11858140442617748,-0.15638252573934253,-0.27496393016552
2022-12-01T13:30:00-05:00,9.93,9.985,9.77,9.865,8.58178344962864,NaN,NaN,NaN,NaN,NaN,10.220400000000001,12.605918677352951,7.8348813226470515,9.16439349761168,9.859912050587782,9.869308583159198,9.850515518016367,116989,295712.9666666667,54.812766597663156,45.12733841978031,NaN,NaN,NaN,NaN,0.39417030225408345,16.05251173424785,-9716513,0.13477498038494584,-0.10649520468433771,-0.24127018506928355
2022-12-02T09:30:00-05:00,9.62,10.03,9.575,9.91,8.58178344962864,NaN,NaN,NaN,NaN,NaN,10.197000000000003,12.57125862112779,7.822741378872215,9.16439349761168,9.838333333333333,9.838333333333333,9.838333333333333,152284,284821.4,55.48684926280319,46.38773011889581,NaN,NaN,NaN,NaN,0.3985152806645061,16.011726836405078,-9564229,0.14293108199197563,-0.06260633257931403,-0.20553741457128966
2022-12-02T13:30:00-05:00,9.91,10.045,9.825,9.99,8.665173556376509,NaN,NaN,NaN,NaN,NaN,10.171000000000003,12.525199651686243,7.816800348313763,9.22052947077718,9.9006069090931,9.95790841844901,9.843305399737188,179858,269829.5,56.72284857789681,47.50783739023723,NaN,NaN,NaN,NaN,0.38576418918846994,16.006621031789432,-9384371,0.14752974344930495,-0.02112523525965848,-0.16865497870896343
2022-12-05T09:30:00-05:00,10,10.15,9.715,9.74,8.665173556376509,NaN,NaN,NaN,NaN,NaN,10.142500000000004,12.482334395849325,7.8026656041506826,9.272923576621745,9.868333333333334,9.868333333333334,9.868333333333334,100962,256550.5,51.87526885657547,48.28168896719854,NaN,NaN,NaN,NaN,0.38928103281786497,15.661500543590211,-9485333,0.1282615217199994,-0.00832807655896417,-0.13658959827896358
2022-12-05T13:30:00-05:00,9.75,9.77,9.655,9.68,8.665173556376509,NaN,NaN,NaN,NaN,NaN,10.109300000000003,12.427231845417293,7.791368154582714,9.272923576621745,9.792743546443237,9.875716324707643,9.709770768178831,83794,225161.03333333333,50.75419355677058,48.85338790211832,NaN,NaN,NaN,NaN,0.36968953047373176,15.153826129767259,-9569127,0.10687709418267029,-0.002993230550625725,-0.10987032473329601
2022-12-06T09:30:00-05:00,9.63,9.72,9.215,9.335,8.665173556376509,NaN,NaN,NaN,NaN,NaN,10.065700000000003,12.358097879950087,7.77330212004992,9.272923576621745,9.423333333333334,9.423333333333334,9.423333333333334,182259,213558.2,44.76381772947278,48.7227810367466,NaN,NaN,NaN,NaN,0.3793545640113224,14.67741595192383,-9751386,0.06685564816549944,-0.026300764526421716,-0.09315641269192115
2022-12-06T13:30:00-05:00,9.32,9.455,9.295,9.39,8.665173556376509,NaN,NaN,NaN,NaN,NaN,10.018000000000004,12.26494815249473,7.771051847505278,9.272923576621745,9.409684843154501,9.42981326311845,9.389556423190552,83799,203791.96666666667,45.86085605675329,48.73287662555594,NaN,NaN,NaN,NaN,0.36368638086765653,14.235035072497789,-9667587,0.042625558338124175,-0.03987446476926593,-0.0825000231073901
2022-12-07T09:30:00-05:00,9.3,9.415,9.17,9.24,8.665173556376509,NaN,NaN,NaN,NaN,NaN,9.969200000000004,12.175258349182885,7.763141650817124,9.272923576621745,9.275,9.275,9.275,135311,197356.4,43.333122003172576,48.70636621974854,NaN,NaN,NaN,NaN,0.3552087822342524,14.145673703563178,-9802898,0.016383592635843658,-0.06202053231258553,-0.07840412494842919
2022-12-07T13:30:00-05:00,9.24,9.365,9.19,9.27,8.665173556376509,NaN,NaN,NaN,NaN,NaN,9.917600000000004,12.065194226105003,7.770005773895005,9.272923576621745,9.275,9.275,9.275,90685,184799.86666666667,43.99794777039663,48.75488316710853,NaN,NaN,NaN,NaN,0.34233672636037726,14.062695289552469,-9712213,0.0017061072820935969,-0.0762714908458122,-0.07797759812790579
2022-12-08T09:30:00-05:00,9.44,9.475,9.16,9.4,8.665173556376509,NaN,NaN,NaN,NaN,NaN,9.867400000000005,11.942476133542922,7.792323866457089,9.272923576621745,9.345,9.345,9.345,112709,181982.3,46.90491196986076,49.11976766232197,NaN,NaN,NaN,NaN,0.3403841030489217,13.600004580595506,-9599504,0.0014243100233860412,-0.07619721059867324,-0.07762152062205928
2022-12-08T13:30:00-05:00,9.41,9.56,9.39,9.525,8.665173556376509,NaN,NaN,NaN,NaN,NaN,9.822400000000007,11.826422195485693,7.818377804514322,9.272923576621745,9.423720095579059,9.496855316712635,9.350584874445483,130580,175222.6,49.61325333644431,49.5585230591089,NaN,NaN,NaN,NaN,0.32821380997399874,12.876468393707729,-9468924,0.009857888840037785,-0.06529915957201204,-0.07515704841204983
2022-12-09T09:30:00-05:00,9.47,9.48,9.28,9.315,8.665173556376509,NaN,NaN,NaN,NaN,NaN,9.780300000000008,11.736169535526152,7.824430464473864,9.272923576621745,9.358333333333333,9.358333333333333,9.358333333333333,118021,170127.5,45.42142244591525,49.770910997993575,NaN,NaN,NaN,NaN,0.32226996640442745,12.553517848755533,-9586945,0.0019106088968040696,-0.07276878729104475,-0.07467939618784881
2022-12-09T13:30:00-05:00,9.315,9.43,9.3,9.305,8.665173556376509,NaN,NaN,NaN,NaN,NaN,9.717400000000007,11.52225150635707,7.912548493642943,9.272923576621745,9.352198004433914,9.35884346337935,9.345552545488479,100597,162098.66666666666,45.225468276608886,49.35006642659102,NaN,NaN,NaN,NaN,0.30853639737553973,12.253635199871347,-9687542,-0.0031280883208918975,-0.07858950658896369,-0.07546141826807179
2022-12-12T09:30:00-05:00,9.31,9.64,9.31,9.55,8.665173556376509,NaN,NaN,NaN,NaN,NaN,9.662000000000008,11.30686230426723,8.017137695732785,9.012250790377443,9.500000000000002,9.500000000000002,9.500000000000002,119386,160011.23333333334,50.82311587100659,48.97113159366719,NaN,NaN,NaN,NaN,0.3104266547058584,11.56135803152075,-9568156,0.01020102841890655,-0.0627101327444386,-0.07291116116334515
2022-12-12T13:30:00-05:00,9.55,9.615,9.47,9.57,8.665173556376509,NaN,NaN,NaN,NaN,NaN,9.615400000000008,11.1309432557335,8.099856744266516,9.040300632301955,9.525932703085326,9.55176584530087,9.500099560869781,120308,156464.26666666666,51.26099288969206,48.71743347166925,NaN,NaN,NaN,NaN,0.29861046508401135,10.918529232338054,-9447848,0.019961776212555432,-0.04795894089765085,-0.06792071711020628
2022-12-13T09:30:00-05:00,10.09,10.23,9.24,9.395,8.665173556376509,NaN,NaN,NaN,NaN,NaN,9.557700000000008,10.868971459309341,8.246428540690674,9.275240505841564,9.621666666666666,9.621666666666666,9.621666666666666,311763,161687.4,47.29291688929982,48.132152587847585,NaN,NaN,NaN,NaN,0.34799543186372484,12.096054909289949,-9759611,0.01448432358305174,-0.049815312631391606,-0.06429963621444335
2022-12-13T13:30:00-05:00,9.4,9.465,9.33,9.355,8.665173556376509,NaN,NaN,NaN,NaN,NaN,9.50440000000001,10.611794491587888,8.39700550841213,9.275240505841564,9.555647321877197,9.66230592031981,9.448988723434585,119447,150092.93333333332,46.40861969851667,47.39542195360614,NaN,NaN,NaN,NaN,0.3327814724448873,13.189471609316708,-9879058,0.008325371171277407,-0.05389292225034659,-0.062218293421623994
2022-12-14T09:30:00-05:00,9.27,9.44,8.94,9.36,8.665173556376509,NaN,NaN,NaN,NaN,NaN,9.450800000000008,10.28874835162991,8.612851648370107,9.275240505841564,9.246666666666666,9.246666666666666,9.246666666666666,288193,154001.63333333333,46.5431747490678,47.014558088784156,NaN,NaN,NaN,NaN,0.3447256529845382,12.767853705226395,-9590865,0.004914950028277687,-0.056074605886276885,-0.06098955591455457
2022-12-14T13:30:00-05:00,9.38,9.425,9.08,9.085,8.665173556376509,NaN,NaN,NaN,NaN,NaN,9.427100000000006,10.237611172038632,8.616588827961381,9.275240505841564,9.22691838555608,9.251360550940827,9.202476220171334,188132,152281.1,40.51762816632284,46.28337484660932,NaN,NaN,NaN,NaN,0.3447452491999284,12.376351365713962,-9778997,-0.014474113085834975,-0.07908219727184829,-0.06460808418601331
2022-12-15T09:30:00-05:00,8.82,9,8.615,8.725,NaN,NaN,NaN,9.928039277818225,9.928039277818225,9.928039277818225,9.406900000000007,10.235843641027156,8.577956358972859,9.275240505841564,8.780000000000001,8.780000000000001,8.780000000000001,234772,155865.93333333332,34.26398853644881,45.5333870471076,NaN,NaN,NaN,NaN,0.3536920171142192,12.345211719201986,-10013769,-0.04825338469532256,-0.1249248150551665,-0.07667143035984395
2022-12-15T13:30:00-05:00,8.73,8.855,8.67,8.67,NaN,NaN,NaN,9.857332947008304,NaN,NaN,9.408200000000008,10.232298926100093,8.584101073899923,9.275240505841564,8.758027322455149,8.782094191581159,8.73396045332914,195692,155245.93333333332,33.41543198934953,44.6444281851502,NaN,NaN,NaN,NaN,0.3416425873203464,12.316296333155151,-10209461,-0.06970702828091146,-0.16380521571098328,-0.09409818743007181
2022-12-16T09:30:00-05:00,8.57,8.715,8.37,8.485,NaN,NaN,NaN,9.634613267598837,NaN,NaN,9.409900000000007,10.22598452993505,8.593815470064966,9.275240505841564,8.523333333333333,8.523333333333333,8.523333333333333,227837,156104.06666666668,30.664542845961094,43.7395296739208,NaN,NaN,NaN,NaN,0.3418824025117503,13.033163069055892,-10437298,-0.09044799143955684,-0.20715817672951786,-0.11671018528996102
2022-12-16T13:30:00-05:00,8.485,8.69,8.485,8.6,NaN,NaN,NaN,9.634613267598837,NaN,NaN,9.401600000000007,10.241670092313383,8.561529907686632,9.275240505841564,8.548641884385589,8.581640291905597,8.51564347686558,134021,158235.46666666667,34.28608975530683,43.04582552998581,NaN,NaN,NaN,NaN,0.3321050880466253,13.69882503810658,-10303277,-0.09030353633837898,-0.22958960571293474,-0.13928606937455576
2022-12-19T09:30:00-05:00,8.54,8.54,8.035,8.16,NaN,NaN,NaN,9.386316014485717,NaN,NaN,9.379500000000005,10.288123684480828,8.470876315519183,9.275240505841564,8.245,8.245,8.245,156720,159379.13333333333,28.213945572918718,41.710756501632815,NaN,NaN,NaN,NaN,0.3487404389004377,15.263138940370617,-10459997,-0.1122890616577979,-0.27964739644680314,-0.16735833478900525
2022-12-19T13:30:00-05:00,8.16,8.22,8.05,8.22,NaN,NaN,NaN,9.207051650190913,NaN,NaN,9.337400000000006,10.261816010246198,8.412983989753814,9.275240505841564,8.20375183031903,8.244583056383526,8.162920604254534,159937,159889.73333333334,30.03363260890255,40.31221216395126,NaN,NaN,NaN,NaN,0.33597326469326355,16.715716135330076,-10300060,-0.11482795101518684,-0.3108932735579888,-0.19606532254280196
2022-12-20T09:30:00-05:00,8.12,8.43,8.025,8.075,NaN,NaN,NaN,9.207051650190913,NaN,NaN,9.289500000000004,10.22236494199299,8.356635058007019,8.633692404673251,8.176666666666666,8.176666666666666,8.176666666666666,171131,158254.83333333334,28.174885876836456,39.080316694731344,NaN,NaN,NaN,NaN,0.3409037457866018,17.24582264660508,-10471191,-0.11786587787504194,-0.34339766988660436,-0.22553179201156243
2022-12-20T13:30:00-05:00,8.08,8.145,8.08,8.095,NaN,NaN,NaN,9.15156978870701,NaN,NaN,9.252400000000003,10.2239847672744,8.280815232725606,8.5249539237386,8.15474315290693,8.18720860389098,8.12227770192288,78038,156968.7,28.829162057757685,37.909151964813404,NaN,NaN,NaN,NaN,0.32155347823041597,17.738064407074727,-10393153,-0.11025878392014321,-0.36335527191174144,-0.25309648799159823
2022-12-21T09:30:00-05:00,8.095,8.235,7.98,8.055,NaN,NaN,NaN,9.134112071038508,NaN,NaN,9.222300000000004,10.245767068351267,8.198832931648742,8.52046313899088,8.09,8.09,8.09,112177,156942.13333333333,28.274417399186774,36.298530645397705,NaN,NaN,NaN,NaN,0.3167996583568148,18.436825421651744,-10505330,-0.09995613133957038,-0.3780416521660612,-0.27808552082649085
2022-12-21T13:30:00-05:00,8.055,8.22,8.055,8.19,NaN,NaN,NaN,9.134112071038508,NaN,NaN,9.184000000000005,10.215763538801234,8.152236461198775,8.041370511192705,8.12235185997779,8.15485152235375,8.08985219760183,111159,151841.03333333333,32.962925026108394,34.991525797998875,NaN,NaN,NaN,NaN,0.30595682561704235,19.08567493518754,-10394171,-0.07710812549621082,-0.37447067769675435,-0.29736255220054353
2022-12-22T09:30:00-05:00,8.1,8.11,7.69,7.735,NaN,NaN,NaN,8.925063891173517,NaN,NaN,9.135500000000006,10.206429035930741,8.06457096406927,7.995596408954164,7.845,7.845,7.845,214910,151049.03333333333,26.641893672618338,33.51645271109305,NaN,NaN,NaN,NaN,0.31981705235868213,20.51037950114674,-10609081,-0.08507134212951195,-0.40370172986243347,-0.3186303877329215
2022-12-22T13:30:00-05:00,7.74,8.04,7.74,7.995,NaN,NaN,NaN,8.910060987029265,NaN,NaN,9.103600000000005,10.212812405267607,7.994387594732403,7.8994817017306636,7.871524336950673,7.909186074900306,7.83386259900104,106597,150702.63333333333,34.38494811930563,32.65761902686369,NaN,NaN,NaN,NaN,0.31875869147591906,21.833319455251708,-10502484,-0.06610546669759748,-0.4012622211049184,-0.3351567544073209
2022-12-23T09:30:00-05:00,7.94,7.995,7.76,7.95,NaN,NaN,NaN,8.883240033073388,NaN,NaN,9.076800000000006,10.230560391068932,7.923039608931079,7.8994817017306636,7.901666666666666,7.901666666666666,7.901666666666666,127628,149880.76666666666,33.72151802614643,31.741786403797875,NaN,NaN,NaN,NaN,0.3127759277990677,23.06176369834918,-10630112,-0.05056890032620004,-0.39836787981507094,-0.3477989794888709
2022-12-23T13:30:00-05:00,7.95,7.97,7.885,7.95,NaN,NaN,NaN,8.883240033073388,NaN,NaN,9.045900000000003,10.235406939870332,7.856393060129674,7.625085361384531,7.91996523679269,7.936551817780972,7.903378655804407,155334,149063.3,33.72151802614643,31.256349965213843,NaN,NaN,NaN,NaN,0.29650621867056287,24.202461924082545,-10630112,-0.035009159294650205,-0.39156042860718365,-0.35655126931253345
2022-12-27T09:30:00-05:00,7.85,7.92,7.7,7.755,NaN,NaN,NaN,8.77154205492844,NaN,NaN,9.011500000000003,10.247937220403735,7.775062779596271,7.574804771218484,7.791666666666667,7.791666666666667,7.791666666666667,113743,149489.33333333334,30.740721605729675,31.004688041591045,NaN,NaN,NaN,NaN,0.2931843459083798,25.687124751715896,-10743855,-0.03261521165999942,-0.3973202838875327,-0.3647050722275333
2022-12-27T13:30:00-05:00,7.75,7.76,7.685,7.7,NaN,NaN,NaN,8.650562870613511,NaN,NaN,8.980300000000003,10.267757043943504,7.692842956056502,7.574804771218484,7.752534258171243,7.79085926206336,7.714209254279127,118586,150649.06666666668,29.936926834692187,30.756223387686955,NaN,NaN,NaN,NaN,0.2775997497720669,27.098976399026085,-10862441,-0.029590013354315547,-0.4016925889204277,-0.37210257556611215
2022-12-28T09:30:00-05:00,7.665,7.805,7.565,7.705,NaN,NaN,NaN,8.603605467403806,NaN,NaN,8.950400000000004,10.284648612515568,7.61615138748444,7.574804771218484,7.691666666666668,7.691666666666668,7.691666666666668,188326,150851.3,30.115823386438223,30.717029140578177,NaN,NaN,NaN,NaN,0.27491405335977637,28.67461761920151,-10674115,-0.022431243796533717,-0.4001416303117793,-0.3777103865152456
2022-12-28T13:30:00-05:00,7.705,7.73,7.67,7.7,NaN,NaN,NaN,8.585032491612724,NaN,NaN,8.928600000000003,10.3074909166427,7.549709083357307,7.574804771218484,7.694551887338288,7.698516607661878,7.690587167014698,99734,151382.46666666667,30.033238678420133,30.413254063657696,NaN,NaN,NaN,NaN,0.2595630495483638,30.137713037935832,-10773849,-0.013643957684233876,-0.3947653336205379,-0.381121375936304
2022-12-29T09:30:00-05:00,7.8,8.145,7.75,7.95,NaN,NaN,NaN,8.585032491612724,NaN,NaN,8.910600000000004,10.316360491691116,7.504839508308892,7.574804771218484,7.948333333333333,7.948333333333333,7.948333333333333,242772,154964.5,39.0352288002134,31.186202865607317,NaN,NaN,NaN,NaN,0.2728085460091949,29.215277180084353,-10531077,0.012008008609474818,-0.3661113651744605,-0.37811937378393534
2022-12-29T13:30:00-05:00,7.96,8.09,7.935,8.06,NaN,NaN,NaN,8.585032491612724,NaN,NaN,8.8902,10.315010106645765,7.465389893354234,7.546050434276505,7.981248680763308,8.020616277819114,7.941881083707502,169714,157598.8,42.53840359861345,32.0794007934438,NaN,NaN,NaN,NaN,0.264393649865681,28.358729597793698,-10361363,0.03792386964169847,-0.3307145367318123,-0.36863840637351075
2022-12-30T09:30:00-05:00,7.85,8.11,7.765,7.87,NaN,NaN,NaN,8.585032491612724,NaN,NaN,8.866,10.317938015205893,7.414061984794105,7.546050434276505,7.915,7.915,7.915,364460,165990.5,38.43063458415788,32.811954272538195,NaN,NaN,NaN,NaN,0.2701512463038466,28.10923650633975,-10725823,0.043414847208869456,-0.3143698473624239,-0.35778469457129336
2022-12-30T13:30:00-05:00,7.88,8.165,7.88,8.15,NaN,NaN,NaN,8.585032491612724,NaN,NaN,8.8451,10.307539728672596,7.382660271327404,7.546050434276505,7.966645449377154,8.037916516194022,7.895374382560286,191376,168017.03333333333,46.61251950323554,34.08219409007233,NaN,NaN,NaN,NaN,0.27192615728214325,27.599607864775027,-10534447,0.06571140817400539,-0.27564543435378663,-0.341356842527792
2023-01-03T09:30:00-05:00,8.32,8.37,7.915,8.015,NaN,NaN,NaN,8.585032491612724,NaN,NaN,8.8162,10.285984419566352,7.346415580433648,7.629090257879657,8.1,8.1,8.1,129705,168406.5,43.60385348090374,35.17715381019497,NaN,NaN,NaN,NaN,0.28500286033341865,26.165623739465758,-10664152,0.07073846059000766,-0.25293376679028245,-0.3236722273802901
2023-01-03T13:30:00-05:00,8.015,8.11,8.005,8.09,NaN,NaN,NaN,8.585032491612724,NaN,NaN,8.7902,10.26444958538233,7.315950414617671,7.629090257879657,8.087031379457905,8.10260340132617,8.071459357589639,89961,168051.96666666667,45.700751924074105,36.086998588621086,NaN,NaN,NaN,NaN,0.2721455131667458,24.83406705167858,-10574191,0.07791827536004037,-0.22627438318023962,-0.30419265854028
2023-01-04T09:30:00-05:00,8.19,8.32,8.09,8.255,NaN,NaN,NaN,8.585032491612724,NaN,NaN,8.7707,10.246956088895155,7.294443911104844,7.688817765042981,8.221666666666666,8.221666666666666,8.221666666666666,147731,168996.8,50.09681203088956,37.76234989992617,NaN,NaN,NaN,NaN,0.2691351193691211,23.41893151946167,-10426460,0.09163702034611376,-0.18964638310763782,-0.2812834034537516
2023-01-04T13:30:00-05:00,8.26,8.36,8.05,8.36,NaN,NaN,NaN,8.585032491612724,NaN,NaN,8.753900000000002,10.229350155037395,7.2784498449626085,7.7000542120343844,8.242667860627012,8.259814045067683,8.225521676186341,221628,172374.13333333333,52.72004521186365,39.071999692251744,NaN,NaN,NaN,NaN,0.27205403941418377,22.104877096688824,-10204832,0.10469716169545584,-0.15041195133443175,-0.2551091130298876
2023-01-05T09:30:00-05:00,8.15,8.23,7.955,8.22,NaN,NaN,NaN,8.585032491612724,NaN,NaN,8.736600000000001,10.216393823476713,7.256806176523289,7.7000542120343844,8.135,8.135,8.135,94200,165122.03333333333,49.02001344717152,40.16474936518211,NaN,NaN,NaN,NaN,0.2815501794560277,20.599966728696433,-10299032,0.10078591520928687,-0.129126719018279,-0.22991263422756586
2023-01-05T13:30:00-05:00,8.22,8.23,8.11,8.115,NaN,NaN,NaN,8.585032491612724,NaN,NaN,8.7154,10.199828293990619,7.230971706009383,7.7000542120343844,8.141548275039796,8.14968817745593,8.133408372623661,60963,163172.56666666668,46.39033220920202,41.0696646639718,NaN,NaN,NaN,NaN,0.2700108809234544,19.202549958417787,-10359995,0.0884462723680334,-0.11935479376752411,-0.20780106613555752
2023-01-06T09:30:00-05:00,8.16,8.16,7.93,8.16,NaN,NaN,NaN,8.585032491612724,NaN,NaN,8.6965,10.184664305444777,7.208335694555224,7.7000542120343844,8.083333333333334,8.083333333333334,8.083333333333334,117349,157477.76666666666,47.68559785332627,42.28001296737155,NaN,NaN,NaN,NaN,0.26715296085749335,18.70020055027391,-10242646,0.08084180107169783,-0.10674881479593523,-0.18759061586763306
2023-01-06T13:30:00-05:00,8.17,8.32,8.15,8.265,NaN,NaN,NaN,8.585032491612724,NaN,NaN,8.6699,10.140312853589068,7.199487146410934,7.730606205249284,8.149191513394676,8.228625590227274,8.069757436562078,80665,153895.53333333333,50.67993591839672,43.76165647335045,NaN,NaN,NaN,NaN,0.26021346365338666,17.454771525771033,-10161981,0.08024868752715017,-0.08727975645869535,-0.16752844398584552
2023-01-09T09:30:00-05:00,8.39,8.635,8.39,8.62,7.654115823981211,7.654115823981211,7.654115823981211,NaN,NaN,NaN,8.6435,10.068446665668588,7.2185533343314106,7.978484964199428,8.548333333333332,8.548333333333332,8.548333333333332,133315,150513.63333333333,59.185737627986086,45.838078919175295,NaN,NaN,NaN,NaN,0.26805535910671613,17.353869939057223,-10028666,0.09985276214382793,-0.042712491306060585,-0.14256525344988852
2023-01-09T13:30:00-05:00,8.615,8.685,8.53,8.55,7.766996922891156,NaN,NaN,NaN,NaN,NaN,8.6172,9.998880368247281,7.235519631752719,8.082287971359541,8.568755250095455,8.588750799256445,8.548759700934465,139061,148625.93333333332,57.09479317247552,47.77104709732212,NaN,NaN,NaN,NaN,0.2599799763133793,17.43039971473801,-10167727,0.10373827326423464,-0.012892411869595222,-0.11663068513382986
2023-01-10T09:30:00-05:00,8.49,8.72,8.38,8.545,7.766996922891156,NaN,NaN,NaN,NaN,NaN,8.589900000000002,9.921354077315435,7.258445922684569,8.082287971359541,8.548333333333334,8.548333333333334,8.548333333333334,115760,144890.03333333333,56.94005411226103,49.0499631910398,NaN,NaN,NaN,NaN,0.2656956922909951,16.790896502524724,-10283487,0.10147971603020554,0.010218959903927072,-0.09126075612627847
2023-01-10T13:30:00-05:00,8.54,8.735,8.54,8.72,7.800822609493801,NaN,NaN,NaN,NaN,NaN,8.564500000000002,9.835216726890721,7.293783273109284,8.115764301670106,8.60878422778238,8.667079113601739,8.55048934196302,124481,144572.03333333333,60.93110534509677,50.363727601502895,NaN,NaN,NaN,NaN,0.2606459999844955,16.255680841879887,-10159006,0.10674445977140888,0.04216981858798263,-0.06457464118342625
2023-01-11T09:30:00-05:00,8.76,8.835,8.645,8.775,7.9154443090622655,NaN,NaN,NaN,NaN,NaN,8.545200000000001,9.772486372449375,7.317913627550628,8.244611441336085,8.751666666666667,8.751666666666667,8.751666666666667,105657,142869.93333333332,62.1194420574584,52.055785278167214,NaN,NaN,NaN,NaN,0.25559985712846023,16.15048532763417,-10053349,0.10854726437271117,0.07110943928246272,-0.037437825090248456
2023-01-11T13:30:00-05:00,8.775,8.8,8.71,8.765,7.955651385923072,NaN,NaN,NaN,NaN,NaN,8.526900000000001,9.712537195772798,7.341262804227204,8.282689153068869,8.754493662145858,8.757788314341619,8.751199009950097,77791,140131.73333333334,61.75166969552138,53.13715314904478,NaN,NaN,NaN,NaN,0.24377129590499877,16.052803778691715,-10131140,0.10369013727333196,0.0921748465014165,-0.011515290771915463
2023-01-12T09:30:00-05:00,8.8,8.885,8.495,8.82,7.955651385923072,NaN,NaN,NaN,NaN,NaN,8.5166,9.682765408507716,7.3504345914922835,8.282689153068869,8.733333333333333,8.733333333333333,8.733333333333333,132877,138856.6,63.047484459382545,54.52598393322183,NaN,NaN,NaN,NaN,0.25421620334035605,14.92455031148204,-9998263,0.09882512998779684,0.1120161217128306,0.013190991725033751
2023-01-12T13:30:00-05:00,8.82,9.05,8.79,9.045,8.105448886760485,NaN,NaN,NaN,NaN,NaN,8.5097,9.659074455954212,7.360325544045789,8.432921057964075,8.868212851591176,8.980484867502186,8.755940835680166,191778,142647.93333333332,67.846606269515,56.10783067218189,NaN,NaN,NaN,NaN,0.25462933167318785,14.539879312714692,-9806485,0.10483397566268783,0.14423346130339354,0.03939948564070571
2023-01-13T09:30:00-05:00,8.94,9.44,8.93,9.15,8.337928482816825,NaN,NaN,NaN,NaN,NaN,8.507900000000001,9.652967840784983,7.362832159215019,8.691336846371259,9.173333333333332,9.173333333333332,9.173333333333332,271886,147971.56666666668,69.81665341669724,57.51639077116816,NaN,NaN,NaN,NaN,0.27287009369653153,15.469697783520603,-9534599,0.10944629059782197,0.17620734888798317,0.0667610582901612
2023-01-13T13:30:00-05:00,9.15,9.33,9.145,9.325,8.403704460870607,NaN,NaN,NaN,NaN,NaN,8.509,9.657095814816895,7.360904185183106,8.691336846371259,9.199200380720443,9.240975416514583,9.157425344926303,104243,147741.03333333333,72.80711681482163,58.95118159995087,NaN,NaN,NaN,NaN,0.2665936584324936,16.333100649268946,-9430356,0.1171592881824399,0.21321016851821106,0.09605088033577117
2023-01-17T09:30:00-05:00,9.3,9.675,9.29,9.46,8.63410425810376,NaN,NaN,NaN,NaN,NaN,8.510200000000001,9.662137428856262,7.35826257114374,8.929355581677605,9.475,9.475,9.475,257710,149167.7,74.87513890381908,60.7979762754257,NaN,NaN,NaN,NaN,0.27505125425874416,18.01281852095601,-9172646,0.12359166923367809,0.2505404668778688,0.1269487976441907
2023-01-17T13:30:00-05:00,9.465,9.58,9.455,9.52,8.69062224637177,NaN,NaN,NaN,NaN,NaN,8.5101,9.661685845692828,7.358514154307171,8.929355581677605,9.489028868601677,9.50930467894719,9.468753058256164,123373,149726.9,75.7575649572022,62.8956357574257,NaN,NaN,NaN,NaN,0.2643333075259767,19.572556544665428,-9049273,0.12381617340721546,0.28171901440321,0.15790284099599455
2023-01-18T09:30:00-05:00,9.64,9.68,9.18,9.41,8.69062224637177,NaN,NaN,NaN,NaN,NaN,8.512,9.669191427552068,7.354808572447932,8.929355581677605,9.423333333333334,9.423333333333334,9.423333333333334,202620,152226.63333333333,70.84498234037227,64.54987750650041,NaN,NaN,NaN,NaN,0.2811666427026927,19.666454772020455,-9251893,0.10900672678698275,0.294161249479723,0.18515452269274024
2023-01-18T13:30:00-05:00,9.41,9.485,9.275,9.305,8.69062224637177,NaN,NaN,NaN,NaN,NaN,8.511999999999999,9.669191427552166,7.354808572447832,8.929355581677605,9.396626680616686,9.429968985620832,9.36328437561254,129996,151382.03333333333,66.41758750457774,65.67399547694193,NaN,NaN,NaN,NaN,0.27608331108107176,19.75364598313584,-9381889,0.08562126666747022,0.29218110602707803,0.2065598393596078
2023-01-19T09:30:00-05:00,9.18,9.29,9.07,9.095,8.69062224637177,NaN,NaN,NaN,NaN,NaN,8.5029,9.634163170089092,7.3716368299109085,8.929355581677605,9.151666666666666,9.151666666666666,9.151666666666666,92148,150662.2,58.53818814246211,65.62774194226162,NaN,NaN,NaN,NaN,0.2731487888609952,18.928611345826248,-9474037,0.05119042900671658,0.27054787561800353,0.21935744661128695
2023-01-19T13:30:00-05:00,9.11,9.18,9.05,9.05,8.69062224637177,NaN,NaN,NaN,NaN,NaN,8.4925,9.593487284213662,7.3915127157863365,8.929355581677605,9.124201735042341,9.153318715351258,9.095084754733424,81988,149442.26666666666,56.97828619221064,65.61942001509985,NaN,NaN,NaN,NaN,0.26292387537092404,18.07823514170973,-9556025,0.022054725279521514,0.24692585321068883,0.22487112793116731
2023-01-20T09:30:00-05:00,9.16,9.435,9.06,9.41,8.69062224637177,NaN,NaN,NaN,NaN,NaN,8.492799999999999,9.594778511587306,7.390821488412692,8.929355581677605,9.301666666666668,9.301666666666668,9.301666666666668,144226,147972.26666666666,65.01102905562702,66.19591822534028,NaN,NaN,NaN,NaN,0.27164359855871517,18.153417786255943,-9411799,0.023561137317965775,0.25432254957862455,0.23076141226065877
2023-01-20T13:30:00-05:00,9.41,9.565,9.37,9.51,8.69062224637177,NaN,NaN,NaN,NaN,NaN,8.495899999999999,9.60838494821287,7.383415051787129,8.929355581677605,9.401637195876967,9.491083204995741,9.312191186758193,180163,150653.23333333334,66.86193958509904,66.6195492424833,NaN,NaN,NaN,NaN,0.26616905580452127,18.60864838091098,-9231636,0.027548172083132233,0.26519662736457406,0.23764845528144182
2023-01-23T09:30:00-05:00,9.59,9.725,9.43,9.685,8.750703222388742,NaN,NaN,NaN,NaN,NaN,8.5024,9.638550060511415,7.3662499394885845,9.056744025346108,9.613333333333335,9.613333333333335,9.613333333333335,144734,147385.3,69.86615794556576,67.17288609163383,NaN,NaN,NaN,NaN,0.2682284089613412,19.469388895831973,-9086902,0.037604543094830356,0.28465413414997975,0.2470495910551494
2023-01-23T13:30:00-05:00,9.69,9.775,9.625,9.7,8.890330348643799,NaN,NaN,NaN,NaN,NaN,8.5147,9.688504770820156,7.340895229179843,9.165395220276887,9.64965619009013,9.692418685292811,9.60689369488745,104425,145209,70.11623715376354,67.77035519579398,NaN,NaN,NaN,NaN,0.2597835226069597,20.400478249017432,-8982477,0.04064135032631877,0.29785127896304786,0.2572099286367291
2023-01-24T09:30:00-05:00,9.6,9.805,9.57,9.755,8.890330348643799,NaN,NaN,NaN,NaN,NaN,8.535300000000001,9.758267554761783,7.31233244523822,9.199816176221509,9.71,9.71,9.71,107746,136651.86666666667,71.06446077922413,68.34299636149694,NaN,NaN,NaN,NaN,0.2580132709921768,20.975759086244413,-8874731,0.04157931321317304,0.3091840701531954,0.26760475694002234
2023-01-24T13:30:00-05:00,9.755,9.835,9.675,9.705,8.964856784611396,NaN,NaN,NaN,NaN,NaN,8.556000000000001,9.821677684088653,7.290322315911349,9.270852940977209,9.722556082703687,9.736630899353298,9.708481266054076,85748,133130.93333333332,68.92337520388458,68.41990842823763,NaN,NaN,NaN,NaN,0.2510123230641642,21.600088522652033,-8960479,0.03435696919544412,0.3105509684343275,0.2761939992388834
2023-01-25T09:30:00-05:00,9.55,9.685,9.325,9.685,8.964856784611396,NaN,NaN,NaN,NaN,NaN,8.580000000000002,9.884302112242393,7.2756978877576115,9.270852940977209,9.565,9.565,9.565,203971,135606.46666666667,68.04031050856315,68.29302679194235,NaN,NaN,NaN,NaN,0.2602257285595811,20.498977342729656,-9164450,0.024234733541139142,0.3064874161653073,0.28225268262416814
2023-01-25T13:30:00-05:00,9.685,9.78,9.675,9.695,8.964856784611396,NaN,NaN,NaN,NaN,NaN,8.6019,9.943060527304624,7.260739472695377,9.270852940977209,9.623956558309683,9.697888073303227,9.550025043316138,129710,136931.43333333332,68.2592869289954,67.96818180009761,NaN,NaN,NaN,NaN,0.24913817651961093,19.813965861846118,-9034740,0.01468482036307417,0.3006087080780109,0.2859238877149367
2023-01-26T09:30:00-05:00,9.94,10,9.64,9.68,9.022807445744379,NaN,NaN,NaN,NaN,NaN,8.6323,10.000648215915824,7.263951784084178,9.36755670578033,9.773333333333333,9.773333333333333,9.773333333333333,93545,135125.23333333334,67.51206070050284,67.44224764271789,NaN,NaN,NaN,NaN,0.2570568781967815,19.887907579070557,-9128285,0.004365338783179518,0.2913805611939111,0.2870152224107316
2023-01-26T13:30:00-05:00,9.68,9.7,9.555,9.65,9.022807445744379,NaN,NaN,NaN,NaN,NaN,8.6609,10.0531509687553,7.268649031244698,9.36755670578033,9.713097659354034,9.781685305088391,9.644510013619676,72150,130142.63333333333,65.95693497610165,66.74220264406786,NaN,NaN,NaN,NaN,0.24905281546843996,19.57360650957152,-9200435,-0.006862743532779603,0.2784367929947571,0.2852995365275367
2023-01-27T09:30:00-05:00,9.61,10.1,9.59,10.05,9.0302129825894,NaN,NaN,NaN,NaN,NaN,8.7004,10.13533113423607,7.265468865763929,9.382236291699412,9.913333333333332,9.913333333333332,9.913333333333332,219397,134315.86666666667,74.41824922189156,66.9974359927478,NaN,NaN,NaN,NaN,0.2676919000778371,20.389855982262358,-8981038,0.009385512463243095,0.2970314271065906,0.2876459146433475
2023-01-27T13:30:00-05:00,10.05,10.54,10.05,10.385,9.450430574289884,NaN,NaN,NaN,NaN,NaN,8.7462,10.245648645336045,7.246751354663954,9.72078903335953,10.150585546702507,10.35400682161844,9.947164271786573,298441,142231.8,79.10278958330485,67.90352185551401,NaN,NaN,NaN,NaN,0.2835710500722772,22.028093732384743,-8682597,0.03783410495025924,0.33493854583117155,0.2971044408809123
2023-01-30T09:30:00-05:00,10.31,10.645,10.015,10.24,9.450430574289884,NaN,NaN,NaN,NaN,NaN,8.7899,10.332949564984904,7.246850435015094,9.72078903335953,10.3,10.3,10.3,206045,145188.33333333334,72.88174435766454,68.92806158517133,NaN,NaN,NaN,NaN,0.30831597506711445,23.72698070271541,-8888642,0.04171959955208204,0.34925394032101487,0.3075343407689328
2023-01-30T13:30:00-05:00,10.24,10.24,10.115,10.145,9.450430574289884,NaN,NaN,NaN,NaN,NaN,8.829,10.407923684032909,7.2500763159670925,9.72078903335953,10.252358880463635,10.316253113386432,10.188464647540838,114552,146317.9,69.0501755190921,69.7903393942343,NaN,NaN,NaN,NaN,0.2952219768480348,25.304518603736735,-9003194,0.033101532002743794,0.3489112557723626,0.3158097237696188
2023-01-31T09:30:00-05:00,10.26,10.34,10.15,10.235,9.450430574289884,NaN,NaN,NaN,NaN,NaN,8.879,10.47443097625693,7.283569023743069,9.72078903335953,10.241666666666667,10.241666666666667,10.241666666666667,156629,147095.03333333333,70.62571319343432,70.19138826122054,NaN,NaN,NaN,NaN,0.28806326421603234,26.948326784916333,-8846565,0.028829069992009237,0.35184606125963036,0.3230169912676211
2023-01-31T13:30:00-05:00,10.235,10.42,10.23,10.415,9.482291397097494,NaN,NaN,NaN,NaN,NaN,8.9274,10.559042411804755,7.2957575881952454,9.72078903335953,10.292565598265796,10.348937970429303,10.236193226102289,127690,146716,73.52819096439025,70.66754907402705,NaN,NaN,NaN,NaN,0.2810587453434586,28.616132790457083,-8718875,0.03318220132457178,0.36449474292333583,0.33131254159876405
2023-02-01T09:30:00-05:00,10.335,10.5,10.16,10.37,9.482291397097494,NaN,NaN,NaN,NaN,NaN,8.9758,10.631985207034568,7.3196147929654325,9.762136950451252,10.343333333333334,10.343333333333334,10.343333333333334,175983,148723.43333333332,71.62282796136822,70.79302550372722,NaN,NaN,NaN,NaN,0.28526883496178296,30.305464147394233,-8894858,0.028278885813674437,0.3666611488658571,0.33838226305218266
2023-02-01T13:30:00-05:00,10.38,10.88,10.24,10.79,9.660631210991728,NaN,NaN,NaN,NaN,NaN,9.032599999999999,10.738228611392337,7.326971388607659,9.969709560361002,10.50191376651944,10.648095753366075,10.355731779672805,207101,151477.43333333332,77.48669979758304,71.3194871211429,NaN,NaN,NaN,NaN,0.31060677532165565,32.448681518607806,-8687757,0.04744160902411443,0.39768427433232567,0.35024266530821124
2023-02-02T09:30:00-05:00,11.13,11.51,11.01,11.41,10.303329792310285,NaN,NaN,NaN,NaN,NaN,9.105699999999999,10.897173147998641,7.314226852001356,10.4217676482888,11.31,11.31,11.31,462724,163379.66666666666,83.0536622951089,72.17585865799182,NaN,NaN,NaN,NaN,0.339849148512966,35.0944924684035,-8225033,0.09333932119296451,0.4669168167994169,0.37357749560645237
2023-02-02T13:30:00-05:00,11.405,11.45,10.98,11.15,10.303329792310285,NaN,NaN,NaN,NaN,NaN,9.1747,11.009525779195425,7.3398742208045755,10.4217676482888,11.282954486469675,11.332187098727854,11.233721874211497,139639,165441.26666666666,74.71056175887003,72.58922912620507,NaN,NaN,NaN,NaN,0.34914563790489694,37.40940934843307,-8364672,0.09721568923073143,0.49509710714486665,0.3978814179141352
2023-02-03T09:30:00-05:00,10.75,11.23,10.555,11.06,10.303329792310285,NaN,NaN,NaN,NaN,NaN,9.241799999999998,11.101940596836757,7.381659403163239,10.4217676482888,10.948333333333332,10.948333333333332,10.948333333333332,341650,172400.36666666667,72.01382584904056,72.87305165052489,NaN,NaN,NaN,NaN,0.37242094948311866,37.74393665426347,-8706322,0.08517811586645224,0.5043540627472005,0.4191759468807483
2023-02-03T13:30:00-05:00,11.05,11.05,10.685,10.75,10.303329792310285,NaN,NaN,NaN,NaN,NaN,9.3028,11.156725737455542,7.448874262544457,10.4217676482888,10.899843385346353,10.958729026233033,10.840957744459672,231668,173730.03333333333,63.51020654372594,72.53383162300564,NaN,NaN,NaN,NaN,0.3726051673771816,38.05456915253455,-8937990,0.0495629976268438,0.48112969391430305,0.43156669628745925
2023-02-06T09:30:00-05:00,10.62,10.715,10.42,10.55,10.303329792310285,NaN,NaN,NaN,NaN,NaN,9.354800000000001,11.199863641178796,7.509736358821206,10.4217676482888,10.561666666666666,10.561666666666666,10.561666666666666,127876,168929.7,58.69472233776794,71.90402173995314,NaN,NaN,NaN,NaN,0.36956194113595436,37.33965971749226,-9065866,0.00794391330442934,0.44149658791799595,0.4335526746135666
2023-02-06T13:30:00-05:00,10.545,10.705,10.52,10.59,10.303329792310285,NaN,NaN,NaN,NaN,NaN,9.4054,11.244409342009988,7.566390657990013,10.4217676482888,10.58536582845251,10.606936952856277,10.563794704048743,154351,170599.96666666667,59.3584371603491,71.43270046739939,NaN,NaN,NaN,NaN,0.3563789453405291,36.67581524209585,-8911515,-0.01995846593914985,0.4086045921896293,0.42856305812877915
2023-02-07T09:30:00-05:00,10.57,10.73,10.22,10.375,NaN,NaN,NaN,11.50498269613821,11.50498269613821,11.50498269613821,9.455499999999999,11.260639606789491,7.650360393210507,10.4217676482888,10.441666666666668,10.441666666666668,10.441666666666668,184432,168157.36666666667,54.30721303502714,69.99619788262336,NaN,NaN,NaN,NaN,0.3673518778162056,35.00865368035891,-9095947,-0.05402880624205331,0.3610270503262125,0.4150558565682658
2023-02-07T13:30:00-05:00,10.365,10.61,10.275,10.555,NaN,NaN,NaN,11.471347119041017,NaN,NaN,9.5036,11.295146862351078,7.7120531376489225,10.4217676482888,10.457351917641319,10.476199751890801,10.438504083391836,127731,168302.63333333333,57.56315042271608,68.45765222829559,NaN,NaN,NaN,NaN,0.3650410294007623,33.460575087317466,-8968216,-0.06484796172012608,0.3339959044181082,0.3988438661382343
2023-02-08T09:30:00-05:00,10.66,10.79,10.41,10.51,NaN,NaN,NaN,11.471347119041017,NaN,NaN,9.5535,11.315156322896168,7.791843677103831,10.4217676482888,10.57,10.57000011920929,10.56999988079071,190594,167901.76666666666,56.47961083200338,67.28607126217693,NaN,NaN,NaN,NaN,0.3661095273007078,32.481308913092604,-9158810,-0.07473773972915154,0.3054216914767949,0.3801594312059464
2023-02-08T13:30:00-05:00,10.5,10.535,10.395,10.48,NaN,NaN,NaN,11.470994998960927,NaN,NaN,9.601299999999998,11.330929798540758,7.871670201459239,10.4217676482888,10.513286026076903,10.562833201114511,10.463738851039295,249719,171892.53333333333,55.72650594213174,66.33438057810834,NaN,NaN,NaN,NaN,0.34995884677922867,31.51554160161086,-9408529,-0.08239895605629782,0.2771607361355741,0.35955969219187195
2023-02-09T09:30:00-05:00,11.07,11.16,9.9,10.33,NaN,NaN,NaN,11.470994998960927,NaN,NaN,9.6428,11.34050687693727,7.945093123062729,10.34441411863104,10.463333333333333,10.463333333333333,10.463333333333333,467588,184407.2,51.993429170520145,65.00350314790019,NaN,NaN,NaN,NaN,0.414961786294998,31.941264796566273,-9876117,-0.09573205524590034,0.2398946231344965,0.33562667838039684
2023-02-09T13:30:00-05:00,10.325,10.405,10.02,10.11,NaN,NaN,NaN,11.345627674673075,NaN,NaN,9.6778,11.34006491270196,8.015535087298039,10.008031294904832,10.369089960874128,10.503170339372986,10.23500958237527,231012,189374.66666666666,47.01846808371265,63.10995151356607,NaN,NaN,NaN,NaN,0.41282165870249815,32.33657919188202,-10107129,-0.1161702813883651,0.19041382664494044,0.30658410803330555
2023-02-10T09:30:00-05:00,9.89,10.33,9.84,9.98,NaN,NaN,NaN,11.233440053097029,NaN,NaN,9.713,11.32404314032867,8.10195685967133,9.884925035923867,10.05,10.05,10.05,229214,192207.6,44.319829870323964,61.15973736420576,NaN,NaN,NaN,NaN,0.41833439736660544,32.007429263224424,-10336343,-0.13398209255503962,0.139106492339506,0.2730885848945456
2023-02-10T13:30:00-05:00,9.98,9.99,9.85,9.985,NaN,NaN,NaN,11.035329141592618,NaN,NaN,9.750399999999999,11.296846041735702,8.203953958264297,9.844293910893782,10.015214944523759,10.065795384670336,9.964634504377182,108408,189815.76666666666,44.451885478047146,58.80010776995321,NaN,NaN,NaN,NaN,0.3984533689832765,31.70179004375666,-10227935,-0.14029323621691597,0.09772203962340065,0.23801527584031662
2023-02-13T09:30:00-05:00,9.97,10.075,9.815,10,NaN,NaN,NaN,11.035329141592618,NaN,NaN,9.787199999999999,11.266629836119366,8.307770163880631,9.844293910893782,9.963333333333333,9.963333333333333,9.963333333333333,154551,190143,44.87427829195071,56.07300891258476,NaN,NaN,NaN,NaN,0.3885638426273282,31.61094065279319,-10073384,-0.13810721041039212,0.06538126282732648,0.2034884732377186
2023-02-13T13:30:00-05:00,10,10.02,9.83,9.935,NaN,NaN,NaN,11.000992048434595,NaN,NaN,9.820599999999999,11.235036481429988,8.40616351857001,9.844293910893782,9.95063809959714,9.967465583698251,9.93381061549603,87966,189594.36666666667,43.336451827722584,53.83200106035995,NaN,NaN,NaN,NaN,0.37438071101109044,31.5265805040414,-10161350,-0.13550055732028962,0.034112776587356564,0.16961333390764619
2023-02-14T09:30:00-05:00,9.86,10.25,9.82,10.03,NaN,NaN,NaN,11.000992048434595,NaN,NaN,9.848799999999997,11.221986891868786,8.475613108131208,9.844293910893782,10.033333333333333,10.033333333333333,10.033333333333333,120024,190003.63333333333,46.23641831283272,51.99075766491653,NaN,NaN,NaN,NaN,0.3783535173674411,31.96995375361629,-10041326,-0.12224724887011557,0.016804272820001742,0.1390515216901173
2023-02-14T13:30:00-05:00,10.035,10.115,9.96,10.055,NaN,NaN,NaN,11.000992048434595,NaN,NaN,9.878899999999998,11.201952969461212,8.555847030538784,9.844293910893782,10.037310027802034,10.042204192263892,10.032415863340177,79242,189786.76666666666,47.00506134309249,50.811818722014145,NaN,NaN,NaN,NaN,0.36239969469833816,32.38165748536441,-9962084,-0.10720419368823583,0.00504627957982251,0.11225047326805834
2023-02-15T09:30:00-05:00,10.07,10.545,10.05,10.405,NaN,NaN,NaN,11.000992048434595,NaN,NaN,9.916099999999998,11.190750210842243,8.641449789157754,9.844293910893782,10.333333333333334,10.333333452542623,10.333333214124044,188861,189283.1,56.402523250122215,50.64809021575373,NaN,NaN,NaN,NaN,0.37187114507702823,33.58865566115792,-9773223,-0.07084286095484724,0.02369689707449929,0.09453975802934653
2023-02-15T13:30:00-05:00,10.41,10.63,10.39,10.62,NaN,NaN,NaN,11.000992048434595,NaN,NaN,9.954099999999999,11.196735409120539,8.711464590879459,9.844293910893782,10.440997323975553,10.547659328094436,10.33433531985667,192426,191373.63333333333,60.97992827920052,50.763911009957404,NaN,NaN,NaN,NaN,0.36245177757152625,34.84701758731527,-9580797,-0.03147968540720816,0.05519015127033633,0.08666983667754449
2023-02-16T09:30:00-05:00,10.43,10.92,10.34,10.585,NaN,NaN,NaN,11.000992048434595,NaN,NaN,9.990299999999998,11.19840663436642,8.782193365633576,9.95975365856352,10.615,10.615,10.615,257113,196825.9,59.87778518605761,51.161809020745295,NaN,NaN,NaN,NaN,0.3779909363164172,36.44224731958276,-9837910,-0.00818116302941603,0.07644338289077446,0.08462454592019049
2023-02-16T13:30:00-05:00,10.57,10.735,10.335,10.335,NaN,NaN,NaN,11.000992048434595,NaN,NaN,10.0217,11.1814303307235,8.861969669276498,9.95975365856352,10.560176550817118,10.631135425994755,10.489217675639482,153477,199536.8,52.569114654377216,50.805092180149664,NaN,NaN,NaN,NaN,0.3795630122938159,37.89806530264568,-9991387,-0.009875152271835802,0.07228060558039573,0.08215575785223153
2023-02-17T09:30:00-05:00,10.19,10.2,9.81,10.01,NaN,NaN,NaN,11.000992048434595,NaN,NaN,10.045499999999999,11.153287434483786,8.937712565516211,9.95975365856352,10.006666666666666,10.006666666666666,10.006666666666666,324394,203036.7,44.89695578361208,49.97775967669315,NaN,NaN,NaN,NaN,0.38995136855854334,36.96323932394809,-10315781,-0.03190897921388018,0.0422695338348813,0.07417851304876148
2023-02-17T13:30:00-05:00,10,10.37,9.98,10.365,NaN,NaN,NaN,11.000992048434595,NaN,NaN,10.071899999999998,11.145441596772176,8.998358403227819,9.95975365856352,10.07558192475808,10.181487804324252,9.969676045191907,137361,197667.36666666667,52.9708606998507,49.78092787367307,NaN,NaN,NaN,NaN,0.38995484223293303,36.45209449579095,-10178420,-0.022067634346274845,0.046593970115917926,0.06866160446219277
2023-02-21T09:30:00-05:00,10.08,10.28,9.83,9.93,NaN,NaN,NaN,11.000992048434595,NaN,NaN,10.087499999999999,11.129199092828703,9.045800907171294,9.95975365856352,10.013333333333334,10.013333333333334,10.013333333333334,139374,195445,44.388212988340236,49.237698146374505,NaN,NaN,NaN,NaN,0.4003152106448664,35.42673933669712,-10317794,-0.04312910668654406,0.014750221104012695,0.05787932779055675
2023-02-21T13:30:00-05:00,9.925,9.97,9.87,9.89,NaN,NaN,NaN,11.000992048434595,NaN,NaN,10.098799999999997,11.119208859232522,9.078391140767472,9.95975365856352,9.972155462239273,10.022746267845553,9.921564656632993,92335,194704.43333333332,43.68725111959322,48.99975407750883,NaN,NaN,NaN,NaN,0.3788641241702332,34.47462383182427,-10410129,-0.05714951181690505,-0.013557561980574562,0.04359194983633049
2023-02-22T09:30:00-05:00,9.87,10.09,9.835,9.875,NaN,NaN,NaN,11.000992048434595,NaN,NaN,10.107099999999997,11.11324132208165,9.100958677918344,9.95975365856352,9.933333333333334,9.933333333333334,9.933333333333334,233531,197267.83333333334,43.41040621583362,48.93479524504523,NaN,NaN,NaN,NaN,0.37001668672950216,33.88115178380941,-10643660,-0.0642960427306497,-0.036778103576981636,0.027517939153668063
2023-02-22T13:30:00-05:00,9.885,9.965,9.8,9.96,NaN,NaN,NaN,10.944413275650586,NaN,NaN,10.115899999999998,11.108959293295277,9.12284070670472,9.95975365856352,9.925500892937658,9.937096749410331,9.913905036464984,106545,196563,45.51734738115348,49.01089966669569,NaN,NaN,NaN,NaN,0.3553726376773948,33.1846112921104,-10537115,-0.0602312194260107,-0.047771085128845314,0.012460134297165385
2023-02-23T09:30:00-05:00,10.065,10.09,9.715,9.82,NaN,NaN,NaN,10.944413275650586,NaN,NaN,10.124099999999997,11.100337040887226,9.147862959112768,9.95975365856352,9.875,9.875,9.875,130502,195046.96666666667,42.69758241250969,48.85542138959276,NaN,NaN,NaN,NaN,0.35677459212900947,32.85459138320625,-10667617,-0.06357411647812447,-0.06700751130049021,-0.0034333948223657356
2023-02-23T13:30:00-05:00,9.82,10.1,9.79,10.1,NaN,NaN,NaN,10.944413275650586,NaN,NaN,10.139999999999997,11.08783964888596,9.192160351114033,9.95975365856352,9.92111269198497,9.98013808620429,9.86208729776565,79649,190798.56666666668,49.443316557225124,49.291626013128656,NaN,NaN,NaN,NaN,0.35343354983408026,32.57371114118357,-10587968,-0.04443647187651754,-0.05897898466801266,-0.01454251279149512
2023-02-24T09:30:00-05:00,9.78,9.92,9.605,9.645,NaN,NaN,NaN,10.840533794684454,NaN,NaN,10.150999999999996,11.06212897001482,9.239871029985173,9.766802926850815,9.723333333333333,9.723333333333333,9.723333333333333,124875,179536.93333333332,40.99733786022176,48.917405980799295,NaN,NaN,NaN,NaN,0.3635454391316459,31.477056567634758,-10712843,-0.059016389438299635,-0.08831299958936967,-0.02929661015107003
2023-02-24T13:30:00-05:00,9.64,9.64,9.475,9.59,NaN,NaN,NaN,10.609714076744254,NaN,NaN,10.161799999999998,11.032369376902396,9.291230623097599,9.345353873184521,9.644040609289274,9.72151987193759,9.566561346640958,130789,179241.93333333332,40.10550724529324,48.42458068809935,NaN,NaN,NaN,NaN,0.3497207649079569,29.92058481823396,-10843632,-0.06830394255922242,-0.11467653835009806,-0.04637259579087563
2023-02-27T09:30:00-05:00,9.67,9.87,9.62,9.85,NaN,NaN,NaN,10.609714076744254,NaN,NaN,10.170599999999997,11.019212137551825,9.321987862448168,9.345353873184521,9.78,9.78,9.78,91326,170897.8,46.077163381573605,47.687054983203026,NaN,NaN,NaN,NaN,0.3447407102716742,29.1790912468186,-10752306,-0.05352923269307615,-0.11328413665722081,-0.059754903964144665
2023-02-27T13:30:00-05:00,9.85,9.865,9.68,9.725,NaN,NaN,NaN,10.609714076744254,NaN,NaN,10.174899999999996,11.01218248518665,9.337617514813342,9.300180765732083,9.767728095401237,9.779379052363796,9.756077138438679,101320,166552.86666666667,43.815356115259746,46.46101411435011,NaN,NaN,NaN,NaN,0.3333306595379832,28.490561501932916,-10853626,-0.04889507387601069,-0.12087374630915804,-0.07197867243314734
2023-02-28T09:30:00-05:00,9.73,10.105,9.73,10.09,NaN,NaN,NaN,10.609714076744254,NaN,NaN,10.182999999999996,11.008927357580772,9.35707264241922,9.34441923331509,9.975,9.975,9.975,180986,168323.2,51.32835642507788,45.85034063142298,NaN,NaN,NaN,NaN,0.3366641838566987,28.521518803725865,-10672640,-0.019477649229687907,-0.09632573397025723,-0.07684808474056933
2023-02-28T13:30:00-05:00,10.105,10.16,10.025,10.06,NaN,NaN,NaN,10.609714076744254,NaN,NaN,10.190199999999995,11.005366142574886,9.375033857425105,9.48403538665207,10.017109290092597,10.069248193972555,9.964970386212638,118053,167113.26666666666,50.727935204117095,45.718827813547264,NaN,NaN,NaN,NaN,0.32225959929550596,28.692310066471016,-10790693,-0.0012322474086423896,-0.07838839400137232,-0.07715614659272993
2023-03-01T09:30:00-05:00,10,10.11,9.775,9.775,NaN,NaN,NaN,10.609714076744254,NaN,NaN,10.190599999999996,11.004930743617356,9.376269256382637,9.48403538665207,9.886666666666665,9.886666666666665,9.886666666666665,108563,164584.3,45.30590676845859,45.74803859817916,NaN,NaN,NaN,NaN,0.3231696279172555,27.724478592241386,-10899256,-0.007216402901388738,-0.08617665021946586,-0.07896024731807712
2023-03-01T13:30:00-05:00,9.77,9.79,9.7,9.73,NaN,NaN,NaN,10.609714076744254,NaN,NaN,10.191099999999995,11.00426736284754,9.377932637152451,9.48403538665207,9.81620133298876,9.88947856243792,9.742924103539599,100391,163672.96666666667,44.49718436593519,45.14277600289948,NaN,NaN,NaN,NaN,0.3065146544945944,26.517685501868872,-10999647,-0.012740789236434874,-0.09488623386362072,-0.08214544462718584
2023-03-02T09:30:00-05:00,9.47,9.47,9.215,9.335,NaN,NaN,NaN,10.333737850048633,NaN,NaN,10.184099999999995,11.020273881438762,9.34792611856123,9.48403538665207,9.340000000000002,9.340000000000002,9.340000000000002,143926,162117.36666666667,38.072835276248895,44.69167759489295,NaN,NaN,NaN,NaN,0.3214064648878377,25.48795427763471,-11143573,-0.03999454721065912,-0.13213862864050974,-0.09214408142985062
2023-03-02T13:30:00-05:00,9.34,9.74,9.34,9.63,NaN,NaN,NaN,10.333737850048633,NaN,NaN,10.182799999999997,11.022207314716933,9.34339268528306,9.48403538665207,9.454322051963029,9.56932005362599,9.339324050300068,142239,158534.7,44.51566414971208,44.75084995418716,NaN,NaN,NaN,NaN,0.3273774316815635,23.68662974502441,-11001334,-0.03531382363538145,-0.13628636097407743,-0.10097253733869598
2023-03-03T09:30:00-05:00,9.68,9.88,9.58,9.86,NaN,NaN,NaN,10.333737850048633,NaN,NaN,10.186399999999997,11.018664477194763,9.354135522805231,9.48403538665207,9.773333333333332,9.773333501920726,9.773333164745937,108428,146562.7,48.97309986853254,45.14818521509422,NaN,NaN,NaN,NaN,0.32542190084716616,22.427464028780463,-10892906,-0.014930217763768516,-0.11963530954340662,-0.1047050917796381
2023-03-03T13:30:00-05:00,9.865,9.94,9.85,9.89,NaN,NaN,NaN,10.333737850048633,NaN,NaN,10.191199999999997,11.013746193231903,9.36865380676809,9.48403538665207,9.838727307573398,9.898484357717033,9.778970257429764,129849,143190.6,49.542501250920346,45.435696205791864,NaN,NaN,NaN,NaN,0.30860605078665426,21.433313710727884,-10763057,0.0014976044365247743,-0.10283308623398213,-0.1043306906705069
2023-03-06T09:30:00-05:00,9.95,10.04,9.755,9.805,NaN,NaN,NaN,10.333737850048633,NaN,NaN,10.186299999999996,11.015047995472939,9.357552004527053,9.48403538665207,9.866666666666667,9.866666666666667,9.866666666666667,130007,139883.7,47.911183417633595,45.808096277586415,NaN,NaN,NaN,NaN,0.30691990430189314,20.80252173702629,-10893064,0.007242399799995053,-0.09527769092051308,-0.10252009072050813
2023-03-06T13:30:00-05:00,9.8,9.8,9.68,9.73,NaN,NaN,NaN,10.333737850048633,NaN,NaN,10.173199999999998,11.009641892781714,9.336758107218282,9.48403538665207,9.812921578978239,9.876939755685042,9.748903402271436,91630,139324.43333333332,46.45758543973785,45.59482976919447,NaN,NaN,NaN,NaN,0.2939256254231865,19.936307208318116,-10984694,0.006611798985035097,-0.09425534198921426,-0.10086714097424936
2023-03-07T09:30:00-05:00,9.71,9.775,9.47,9.6,NaN,NaN,NaN,10.333737850048633,NaN,NaN,10.160399999999997,11.011814916477455,9.30898508352254,9.48403538665207,9.615,9.615,9.615,246202,142379.46666666667,43.96754499636925,45.80698742177644,NaN,NaN,NaN,NaN,0.29471665217867316,18.631198648200673,-11230896,-0.0015067606431648783,-0.10275059177820545,-0.10124383113504057
2023-03-07T13:30:00-05:00,9.6,9.62,9.4,9.415,NaN,NaN,NaN,10.333737850048633,NaN,NaN,10.145799999999998,11.02243301329592,9.269166986704075,9.401728309321657,9.563060479088659,9.62939815585477,9.496722802322548,150927,144478.16666666666,40.63012414137465,45.844460057210824,NaN,NaN,NaN,NaN,0.289379748451625,17.651297243011317,-11381823,-0.017399576776319828,-0.12299330210544035,-0.10559372532912052
2023-03-08T09:30:00-05:00,9.42,9.695,9.35,9.59,NaN,NaN,NaN,10.333737850048633,NaN,NaN,10.132899999999998,11.02278558815184,9.243014411848154,9.355933225918816,9.545,9.545,9.545,93460,143592.7,44.89148644111047,45.75976884717774,NaN,NaN,NaN,NaN,0.2933526235622233,16.46629322813975,-11288363,-0.014318002461666576,-0.12349122840620375,-0.10917322594453717
2023-03-08T13:30:00-05:00,9.595,9.72,9.55,9.66,NaN,NaN,NaN,10.333737850048633,NaN,NaN,10.117799999999997,11.013628465723357,9.221971534276637,9.355933225918816,9.583356218470392,9.631319697503278,9.535392739437507,59769,142943.6,46.54428946893731,45.95469265815471,NaN,NaN,NaN,NaN,0.28454172187920734,15.308216283446699,-11228594,-0.006173410104000868,-0.11688998857453825,-0.11071657847053738
2023-03-09T09:30:00-05:00,9.59,9.83,9.44,9.46,NaN,NaN,NaN,10.333737850048633,NaN,NaN,10.099599999999999,11.011033683819198,9.1881663161808,9.355933225918816,9.576666666666666,9.576666666666666,9.576666666666666,163494,142098.03333333333,42.61195457364688,45.33209252590964,NaN,NaN,NaN,NaN,0.2920744560306926,14.232859120517436,-11392088,-0.012499067894012145,-0.12634041333805257,-0.11384134544404043
2023-03-09T13:30:00-05:00,9.45,9.575,9.35,9.43,NaN,NaN,NaN,10.333737850048633,NaN,NaN,10.072399999999998,10.980964229980575,9.163835770019421,9.355933225918816,9.51149041613976,9.573933091315551,9.449047740963968,178122,141621.23333333334,42.038228690434494,44.71139920350374,NaN,NaN,NaN,NaN,0.2872834234570717,13.56697942867901,-11570210,-0.016685305954217647,-0.13469797788681248,-0.11801267193259483
2023-03-10T09:30:00-05:00,9.32,9.37,8.52,8.95,NaN,NaN,NaN,9.93445846624328,NaN,NaN,10.023199999999997,10.90266292701865,9.143737072981345,9.355933225918816,8.946666666666667,8.946666666666667,8.946666666666667,431440,147432.13333333333,34.122091722838675,43.912555271673746,NaN,NaN,NaN,NaN,0.3317631789244237,15.24729649859326,-12001650,-0.047991067189269876,-0.17800150591918218,-0.1300104387299123
2023-03-10T13:30:00-05:00,8.945,9.105,8.82,9.02,NaN,NaN,NaN,9.93445846624328,NaN,NaN,9.980599999999999,10.843811770077371,9.117388229922627,9.355933225918816,8.959375752851981,8.976207186088766,8.942544319615196,245984,150515.7,36.014403111298286,43.30664232491397,NaN,NaN,NaN,NaN,0.3284229518583935,16.80759092065649,-11755666,-0.05944462397414943,-0.20431621869759908,-0.14487159472344965
2023-03-13T09:30:00-04:00,8.79,9.265,8.715,8.96,NaN,NaN,NaN,9.93445846624328,NaN,NaN,9.938599999999997,10.791946447816072,9.085253552183923,9.190246580735055,8.98,8.98,8.98,345235,151210.4,35.08414890758485,43.093164727152256,NaN,NaN,NaN,NaN,0.3442498838685083,17.567651466961685,-12100901,-0.06601559921185446,-0.2273910937382677,-0.16137549452641325
2023-03-13T13:30:00-04:00,8.97,9.115,8.945,8.98,NaN,NaN,NaN,9.93445846624328,NaN,NaN,9.903199999999998,10.765772338995555,9.040627661004441,9.138011999575262,8.98846438272979,9.00297301174845,8.97395575371113,117504,150548.5,35.68054012223833,42.462084439475554,NaN,NaN,NaN,NaN,0.33180346359218627,18.27342197424508,-11983397,-0.06392592953753035,-0.24128290644832617,-0.17735697691079583
2023-03-14T09:30:00-04:00,9.35,9.46,9.04,9.07,NaN,NaN,NaN,9.93445846624328,NaN,NaN,9.873599999999998,10.746867519148815,9.000332480851181,9.138011999575262,9.19,9.19,9.19,149993,150902.46666666667,38.42212911485491,41.708443671355724,NaN,NaN,NaN,NaN,0.3423889304784587,17.567006364352356,-11833404,-0.05190454276272588,-0.24223765536420316,-0.19033311260147728
2023-03-14T13:30:00-04:00,9.07,9.14,9.005,9.11,NaN,NaN,NaN,9.93445846624328,NaN,NaN,9.844,10.71845983326861,8.969540166731388,9.138011999575262,9.139072687383482,9.191549126424134,9.08659624834283,141268,152533.56666666668,39.65329253681159,41.002071620347955,NaN,NaN,NaN,NaN,0.3275754354442831,17.016278397134236,-11692136,-0.03736091131652733,-0.23703425174713644,-0.1996733404306091
2023-03-15T09:30:00-04:00,8.84,9.115,8.77,9.03,NaN,NaN,NaN,9.928458047338754,NaN,NaN,9.8171,10.70717660344496,8.92702339655504,9.138011999575262,8.971666666666666,8.971666666666666,8.971666666666666,143381,149528.56666666668,38.016195701089316,40.295286783451935,NaN,NaN,NaN,NaN,0.3288200471982629,17.175561520412483,-11835517,-0.02957175355081293,-0.23663803236912528,-0.20706627881831235
2023-03-15T13:30:00-04:00,9.04,9.2,8.945,9.2,NaN,NaN,NaN,9.928458047338754,NaN,NaN,9.79,10.67102440374834,8.908975596251658,9.138011999575262,9.041161397684498,9.112795145364373,8.969527650004622,134946,150475.26666666666,43.36687880181152,40.07452202360006,NaN,NaN,NaN,NaN,0.3235471866841012,16.991354277779045,-11700571,-0.010402673590669542,-0.22006962080664927,-0.20966694721597973
2023-03-16T09:30:00-04:00,9.12,9.37,8.99,9.315,NaN,NaN,NaN,9.928458047338754,NaN,NaN,9.7661,10.632412391692583,8.899787608307417,8.908909599660209,9.225,9.225,9.225,76503,148675.3,46.71767324288465,40.27095975549401,NaN,NaN,NaN,NaN,0.3275795304923796,16.186134360420347,-11624068,0.011407984575688312,-0.19540696649636935,-0.20681495107205766
2023-03-16T13:30:00-04:00,9.32,9.34,9.22,9.3,NaN,NaN,NaN,9.928458047338754,NaN,NaN,9.7425,10.593897087145688,8.891102912854311,8.615337368819027,9.254420677179096,9.28522163247314,9.223619721885052,69800,148347,46.33260112526679,40.67827954005774,NaN,NaN,NaN,NaN,0.31275242117149527,15.438430151444415,-11693868,0.025408684643597856,-0.17505409526756033,-0.20046277991115818
2023-03-17T09:30:00-04:00,9.29,9.36,9.05,9.1,NaN,NaN,NaN,9.928458047338754,NaN,NaN,9.717899999999998,10.571052014590734,8.864747985409263,8.625269895055222,9.17,9.17,9.17,113426,147965.36666666667,41.42926649701587,40.43097811547955,NaN,NaN,NaN,NaN,0.3125558196592455,15.299350728785106,-11807294,0.02191613510859472,-0.1730676110254148,-0.1949837461340095
2023-03-17T13:30:00-04:00,9.1,9.23,9.09,9.195,NaN,NaN,NaN,9.928458047338754,NaN,NaN,9.699599999999998,10.557564661277015,8.841635338722982,8.625269895055222,9.170691723998035,9.171512937256969,9.1698705107391,80476,146288.26666666666,44.43719366366255,40.28047127224563,NaN,NaN,NaN,NaN,0.3002304039692994,15.170205550601462,-11726818,0.026418500361956754,-0.16196062068156358,-0.18837912104352034
2023-03-20T09:30:00-04:00,9.16,9.19,8.91,8.975,NaN,NaN,NaN,9.928458047338754,NaN,NaN,9.679499999999997,10.557110961645426,8.801889038354568,8.625269895055222,9.025,9.025,9.025,102430,146658.4,39.39199380297108,40.050474074340215,NaN,NaN,NaN,NaN,0.29914251797149227,15.618360152069698,-11829248,0.015533124682237748,-0.16896271519072315,-0.1844958398729609
2023-03-20T13:30:00-04:00,8.965,9.02,8.8,8.805,NaN,NaN,NaN,9.824137422533958,NaN,NaN,9.655899999999999,10.562369392754157,8.749430607245841,8.625269895055222,8.943167600590968,9.017855741003713,8.868479460178223,122963,147379.83333333334,35.991495464482455,39.61856455820078,NaN,NaN,NaN,NaN,0.2934894809735284,16.35462623863749,-11952211,-0.0012708794661887568,-0.18608443920569684,-0.18481355973950808
2023-03-21T09:30:00-04:00,8.91,9.34,8.91,9.265,NaN,NaN,NaN,9.824137422533958,NaN,NaN,9.6412,10.54870991179168,8.73369008820832,8.625269895055222,9.171666666666667,9.171666666666667,9.171666666666667,173995,147146.8,48.85670591315608,40.67103700036631,NaN,NaN,NaN,NaN,0.3107402323325621,15.674408189406149,-11778216,0.01930435318535037,-0.1606831182578201,-0.17998747144317048
2023-03-21T13:30:00-04:00,9.265,9.375,9.225,9.33,NaN,NaN,NaN,9.824137422533958,NaN,NaN,9.6291,10.536751232577874,8.721448767422125,8.673211639211695,9.21334853218328,9.276819891736444,9.149877172630116,75037,145712.93333333332,50.37453886770749,41.69676098296697,NaN,NaN,NaN,NaN,0.29925878716595056,14.90887766088552,-11703179,0.03697760387864485,-0.13376546659486444,-0.17074307047350928
2023-03-22T09:30:00-04:00,9.3,9.34,9.145,9.215,NaN,NaN,NaN,9.824137422533958,NaN,NaN,9.612799999999998,10.520339883421222,8.705260116578774,8.681069311369356,9.233333333333333,9.233333333333333,9.233333333333333,64982,144260.23333333334,47.67849481408637,42.59635711914565,NaN,NaN,NaN,NaN,0.2918117309398113,14.479115322064962,-11768161,0.0403340285700208,-0.12032553476098329,-0.1606595633310041
2023-03-22T13:30:00-04:00,9.22,9.4,8.925,8.93,NaN,NaN,NaN,9.824137422533958,NaN,NaN,9.5903,10.508590607596615,8.672009392403384,8.681069311369356,9.135674752339044,9.20602263365531,9.065326871022778,125231,145088.23333333334,41.71933561964828,43.027699654674926,NaN,NaN,NaN,NaN,0.3048966073012533,14.790872145554545,-11893392,0.023600062499004204,-0.13115948520724885,-0.15475954770625305
2023-03-23T09:30:00-04:00,8.89,9.055,8.79,8.83,NaN,NaN,NaN,9.824137422533958,NaN,NaN,9.558799999999998,10.471178342575174,8.646421657424822,8.681069311369356,8.891666666666666,8.891666666666666,8.891666666666666,208800,147250.7,39.83786132257049,43.128823383797474,NaN,NaN,NaN,NaN,0.3020468496368781,15.470621186371215,-12102192,0.006903529356710403,-0.14613013601036506,-0.15303366536707547
2023-03-23T13:30:00-04:00,8.83,8.9,8.545,8.56,NaN,NaN,NaN,9.653842433811512,NaN,NaN,9.517599999999998,10.42057339938682,8.614626600613176,8.681069311369356,8.780308629227909,8.891974869392262,8.668642389063555,207649,149431.03333333333,35.21945644938123,42.81212080612387,NaN,NaN,NaN,NaN,0.30582921751995823,16.730481776761767,-12309841,-0.019759019082870866,-0.17773243922066406,-0.1579734201377932
2023-03-24T09:30:00-04:00,8.5,8.66,8.38,8.63,NaN,NaN,NaN,9.447190505001897,NaN,NaN,9.478499999999999,10.362312762976462,8.594687237023535,8.681069311369356,8.556666666666667,8.556666666666667,8.556666666666667,139636,150471.3,37.25052709091631,42.75743019111152,NaN,NaN,NaN,NaN,0.3039842734113897,18.271952117944977,-12170205,-0.02952733749068409,-0.19488259200114832,-0.16535525451046423
2023-03-24T13:30:00-04:00,8.63,8.73,8.62,8.67,NaN,NaN,NaN,9.447190505001897,NaN,NaN,9.445199999999998,10.322864993035603,8.567535006964393,8.681069311369356,8.606560918560296,8.664280583166123,8.54884125395447,104340,149621,38.438311441643805,42.40538966538525,NaN,NaN,NaN,NaN,0.29012825388200486,19.36431924797303,-12065865,-0.03004183955751355,-0.20290755395735616,-0.1728657143998426
2023-03-27T09:30:00-04:00,8.75,8.835,8.52,8.65,NaN,NaN,NaN,9.447190505001897,NaN,NaN,9.418,10.308170770133511,8.527829229866487,8.681069311369356,8.668333333333335,8.668333333333335,8.668333333333335,135006,149787.63333333333,38.05048059250426,41.78630447607237,NaN,NaN,NaN,NaN,0.2919048071761475,19.87761144923642,-12200871,-0.028489846169378247,-0.2084780221115654,-0.17998817594218716
2023-03-27T13:30:00-04:00,8.65,8.72,8.61,8.61,NaN,NaN,NaN,9.447190505001897,NaN,NaN,9.3829,10.259233475339196,8.506566524660803,8.681069311369356,8.661227738313912,8.671399516830142,8.65105595979768,65881,148929.33333333334,37.2411685027081,41.13691643160389,NaN,NaN,NaN,NaN,0.2789116066635656,20.354239921838136,-12266752,-0.02693539067672479,-0.21365741428809315,-0.18672202361136836
2023-03-28T09:30:00-04:00,8.59,8.7,8.545,8.615,NaN,NaN,NaN,9.447190505001897,NaN,NaN,9.356599999999998,10.244531168503602,8.468668831496394,8.681069311369356,8.62,8.62,8.62,59082,142692,37.4203461108556,40.850564975449586,NaN,NaN,NaN,NaN,0.27006077761616804,20.987455379796785,-12207670,-0.02252769303458288,-0.21488163990459697,-0.1923539468700141
2023-03-28T13:30:00-04:00,8.61,8.705,8.58,8.66,NaN,NaN,NaN,9.447190505001897,NaN,NaN,9.331999999999999,10.227578025634863,8.436421974365135,8.681069311369356,8.633871466583729,8.648035057278898,8.61970787588856,56670,139550.1,39.105404026173325,40.46972285848608,NaN,NaN,NaN,NaN,0.25969929350072746,21.547741821925744,-12151000,-0.013958645561386679,-0.20980225382174744,-0.19584360826036076
2023-03-29T09:30:00-04:00,8.8,9.11,8.77,9.065,NaN,NaN,NaN,9.447190505001897,NaN,NaN,9.315799999999998,10.200743749624857,8.430856250375138,8.635355449095485,8.981666666666667,8.981666666666667,8.981666666666667,289761,146093.46666666667,51.70855339202156,41.34947711484683,NaN,NaN,NaN,NaN,0.2732922011078183,20.158816358149604,-11861239,0.019775625290082754,-0.1711240766477573,-0.19089970193784006
2023-03-29T13:30:00-04:00,9.065,9.215,9.045,9.11,NaN,NaN,NaN,9.447190505001897,NaN,NaN,9.298799999999998,10.166070569084493,8.431529430915504,8.622737861160012,9.020948713919665,9.084366987766986,8.957530440072345,111173,147806.93333333332,52.87560035907318,42.55548460731759,NaN,NaN,NaN,NaN,0.2659141867429741,18.968029008199892,-11750066,0.04449513277779346,-0.13528078596559823,-0.1797759187433917
2023-03-30T09:30:00-04:00,9.22,9.47,9.21,9.32,8.486225069207409,8.486225069207409,8.486225069207409,NaN,NaN,NaN,9.288799999999998,10.143236796960492,8.434363203039505,8.81619028892801,9.333333333333334,9.333333333333334,9.333333333333334,335885,153553.3,57.979171723353815,43.20708930804601,NaN,NaN,NaN,NaN,0.2726346019756189,18.72584348950274,-11414181,0.07269702492640834,-0.08890463758538125,-0.1616016625117896
2023-03-30T13:30:00-04:00,9.315,9.475,9.3,9.47,8.548669384243436,NaN,NaN,NaN,NaN,NaN,9.276199999999998,10.100463453029485,8.45193654697051,8.864452231142408,9.369739450989451,9.410332071900699,9.329146830078203,270175,156621.73333333334,61.21062438476555,43.9810954164073,NaN,NaN,NaN,NaN,0.2656607018345032,18.516865422384814,-11144006,0.09760846747366475,-0.03959107816970864,-0.1371995456433734
2023-03-31T09:30:00-04:00,9.53,9.73,9.48,9.69,8.768843503141461,NaN,NaN,NaN,NaN,NaN,9.277099999999997,10.103068740328704,8.45113125967129,9.111561784913928,9.633333333333333,9.633333333333333,9.633333333333333,759032,167541.46666666667,65.41185538025192,45.247764028276265,NaN,NaN,NaN,NaN,0.2652563659891815,19.083965377107905,-10384974,0.12339638800055926,0.01704593935732568,-0.10635044864323358
2023-03-31T13:30:00-04:00,9.7,9.71,9.62,9.7,8.854577889362304,NaN,NaN,NaN,NaN,NaN,9.279299999999997,10.109167483397304,8.449432516602691,9.170249427931141,9.652610330355367,9.67414481255145,9.631075848159284,608233,179616.43333333332,65.59426870864706,46.953116391776184,NaN,NaN,NaN,NaN,0.25273805413281153,19.610558192207918,-9776741,0.13469886780786733,0.0620231361166006,-0.07267573169126675
2023-04-03T09:30:00-04:00,9.65,9.765,9.53,9.71,8.854577889362304,NaN,NaN,NaN,NaN,NaN,9.276499999999999,10.099563181049984,8.453436818950014,9.215699542344913,9.668333333333335,9.668333333333335,9.668333333333335,740644,192796.73333333334,65.78857423766316,48.80673874285423,NaN,NaN,NaN,NaN,0.2514710502661822,19.65466331793559,-9036097,0.13602265336728347,0.09735258501783761,-0.03867006834944588
2023-04-03T13:30:00-04:00,9.72,9.82,9.72,9.755,8.985989357869371,NaN,NaN,NaN,NaN,NaN,9.277099999999997,10.101512736437428,8.452687263562566,9.32555963387593,9.707706388418082,9.75520190952085,9.660210867315314,508982,205846,66.69994790385392,51.055345275316554,NaN,NaN,NaN,NaN,0.24136597524716916,19.87451298926837,-8527115,0.1329461867571162,0.12751266509694936,-0.005433521660166828
2023-04-04T09:30:00-04:00,9.81,9.81,9.605,9.78,8.985989357869371,NaN,NaN,NaN,NaN,NaN,9.270899999999997,10.075182761222806,8.46661723877719,9.32555963387593,9.731666666666667,9.731666666666667,9.731666666666667,628499,221796.2,67.22236229337565,53.196190646920805,NaN,NaN,NaN,NaN,0.23876840558665707,19.499815737689772,-7898616,0.1256936362692096,0.1516835236763452,0.02598988740713558
2023-04-04T13:30:00-04:00,9.78,9.79,9.71,9.75,8.998050220703291,NaN,NaN,NaN,NaN,NaN,9.264699999999998,10.049088704661271,8.480311295338725,9.351558165680595,9.737599874662308,9.74617731733446,9.729022431990156,300724,227111.4,65.88658774772102,55.1567818116406,NaN,NaN,NaN,NaN,0.22742780518761002,19.151882575509653,-8199340,0.11240733525953585,0.16649905648155539,0.05409172122201954
2023-04-05T09:30:00-04:00,9.7,9.73,9.52,9.64,8.998050220703291,NaN,NaN,NaN,NaN,NaN,9.261999999999999,10.040249317378525,8.483750682621473,9.351558165680595,9.63,9.63000011920929,9.629999880790711,837142,250236.76666666666,61.092935754444376,56.8026714660649,NaN,NaN,NaN,NaN,0.22761153338849507,17.909238558445555,-9036482,0.09067407400935325,0.1674343137337111,0.07676023972435785
2023-04-05T13:30:00-04:00,9.64,9.78,9.62,9.75,8.998050220703291,NaN,NaN,NaN,NaN,NaN,9.262399999999998,10.04163100554343,8.483168994456566,9.351558165680595,9.662377342828488,9.7043028010827,9.620451884574276,499259,262380.5333333333,63.919909575450944,58.70829582840368,NaN,NaN,NaN,NaN,0.22278213814645972,16.97182228618643,-8537223,0.07861893667621872,0.17503391056963125,0.09641497389341253
2023-04-06T09:30:00-04:00,9.71,10.08,9.71,10.02,9.141140410775092,NaN,NaN,NaN,NaN,NaN,9.2761,10.08353121069233,8.468668789307669,9.532917780828466,9.936666666666666,9.936666666666666,9.936666666666666,586219,279371.06666666665,69.73312784035525,61.016351666225084,NaN,NaN,NaN,NaN,0.2332976997074268,17.231646321869576,-7951004,0.08329344788821005,0.20053178375367509,0.11723833586546503
2023-04-06T13:30:00-04:00,10.015,10.04,10,10,9.294952210285315,NaN,NaN,NaN,NaN,NaN,9.283499999999998,10.110318601629224,8.456681398370772,9.582334224662771,9.965092209954753,10.00212300984988,9.928061410059625,345423,288558.5,68.84823086224296,63.140839297372914,NaN,NaN,NaN,NaN,0.21949072115689625,17.47291149786107,-8296427,0.07951176797574722,0.21662804583514905,0.13711627785940184
2023-04-10T09:30:00-04:00,9.92,9.99,9.645,9.885,9.294952210285315,NaN,NaN,NaN,NaN,NaN,9.283999999999999,10.112241510671868,8.45575848932813,9.582334224662771,9.839999999999998,9.839999999999998,9.839999999999998,558826,303405.1666666667,63.83235304951543,64.0068249871939,NaN,NaN,NaN,NaN,0.2291699553599751,16.35272735210366,-8855253,0.06438425173459175,0.21759659252764152,0.15321234079304977
2023-04-10T13:30:00-04:00,9.89,10,9.86,9.98,9.294952210285315,NaN,NaN,NaN,NaN,NaN,9.285799999999998,10.11967375543313,8.451926244566867,9.582334224662771,9.875823550151926,9.926200647501716,9.825446452802137,282584,310142.1,66.0338159466717,64.9466975291652,NaN,NaN,NaN,NaN,0.22280067283426264,15.2718224661291,-8572669,0.05619335915479476,0.2234540397365432,0.16726068058174845
2023-04-11T09:30:00-04:00,9.98,10.01,9.825,9.925,9.294952210285315,NaN,NaN,NaN,NaN,NaN,9.288199999999998,10.128701659724786,8.44769834027521,9.582334224662771,9.92,9.92,9.92,633466,327843.3,63.619440913377865,65.34957389988121,NaN,NaN,NaN,NaN,0.22010062477467246,14.414038551190439,-9206135,0.043078862420136615,0.2211092586069192,0.1780303961867826
2023-04-11T13:30:00-04:00,9.93,10.02,9.93,9.95,9.294952210285315,NaN,NaN,NaN,NaN,NaN,9.292599999999998,10.144532485587938,8.440667514412059,9.582334224662771,9.940341142955354,9.963481826636023,9.917200459274685,489465,340060.0333333333,64.25912496061547,65.56732394101334,NaN,NaN,NaN,NaN,0.2111648658621958,13.570887694659941,-8716670,0.03257305724078352,0.218746717737762,0.18617366049697848
2023-04-12T09:30:00-04:00,10.11,10.19,9.66,10.04,9.294952210285315,NaN,NaN,NaN,NaN,NaN,9.301399999999997,10.174674389868521,8.428125610131474,9.582334224662771,9.963333333333333,9.963333333333333,9.963333333333333,488478,350542.8,66.54003825017216,65.64790843172193,NaN,NaN,NaN,NaN,0.23393880401489603,13.868287856212644,-8228192,0.02832696861890699,0.2215823712706122,0.1932554026517052
2023-04-12T13:30:00-04:00,10.04,10.06,9.995,10,9.31323005099341,NaN,NaN,NaN,NaN,NaN,9.313099999999999,10.207567193361559,8.418632806638438,9.582334224662771,9.98849373637346,10.015894033562617,9.961093439184303,411879,361770.86666666664,64.56778954977926,65.5745884918028,NaN,NaN,NaN,NaN,0.22187174658526068,14.144445149083012,-8640071,0.019866076858549298,0.21808799872489182,0.19822192186634252
2023-04-13T09:30:00-04:00,10.09,10.12,9.9,10.02,9.31323005099341,NaN,NaN,NaN,NaN,NaN,9.321699999999998,10.234727075173664,8.408672924826332,9.586744370391997,10.013333333333334,10.013333333333334,10.013333333333334,376400,372151.4666666667,65.12440460728419,65.5271478039186,NaN,NaN,NaN,NaN,0.2217380504005991,14.751065439367233,-8263671,0.012990743093738683,0.21446035073351588,0.2014696076397772
2023-04-13T13:30:00-04:00,10.02,10.14,9.99,10.07,9.365097009272922,NaN,NaN,NaN,NaN,NaN,9.329899999999999,10.2620963097975,8.397703690202498,9.6383954963136,10.044854817049057,10.071075836528065,10.018633797570049,543956,386108.9666666667,66.53958786436255,65.51569351538349,NaN,NaN,NaN,NaN,0.21661390394341345,15.197575706139851,-7719715,0.009354544103337636,0.21316278776894926,0.20380824366561162
2023-04-14T09:30:00-04:00,10.04,10.1,9.915,10.055,9.365097009272922,NaN,NaN,NaN,NaN,NaN,9.3418,10.295283633839633,8.388316366160366,9.6383954963136,10.023333333333333,10.023333333333333,10.023333333333333,545680,397338.3,65.67855333571109,65.40542144697888,NaN,NaN,NaN,NaN,0.2143557679474554,15.900465050758914,-8265395,0.0037697185502914565,0.20852039185347593,0.20475067330318447
2023-04-14T13:30:00-04:00,10.05,10.1,9.96,9.995,9.365097009272922,NaN,NaN,NaN,NaN,NaN,9.3531,10.32373461714489,8.38246538285511,9.6383954963136,10.020691258490556,10.023187218168847,10.018195298812266,611439,410797.9666666667,62.210779399742364,65.14286370783755,NaN,NaN,NaN,NaN,0.20904464166549422,16.55314801361947,-8876834,-0.005624089419981659,0.19772056152820738,0.20334465094818904
2023-04-17T09:30:00-04:00,9.9,9.9,9.58,9.675,9.365097009272922,NaN,NaN,NaN,NaN,NaN,9.3676,10.335371129968216,8.399828870031783,9.6383954963136,9.718333333333334,9.718333333333334,9.718333333333334,809816,433137.3,47.73485723851672,64.18871524241415,NaN,NaN,NaN,NaN,0.22375573868938742,18.395475931178108,-9686650,-0.0334926289959554,0.1614788647032448,0.1949714936992002
2023-04-17T13:30:00-04:00,9.68,9.905,9.68,9.865,9.365097009272922,NaN,NaN,NaN,NaN,NaN,9.3845,10.356901665979672,8.412098334020326,9.6383954963136,9.747893850177938,9.792982207879787,9.70280549247609,348082,441262.0333333333,54.50411457541703,63.51615845669743,NaN,NaN,NaN,NaN,0.22420175735443107,20.073052577398855,-9338568,-0.03885651250884958,0.14640085306313821,0.1852573655719878
2023-04-18T09:30:00-04:00,9.92,10.02,9.77,9.78,9.365097009272922,NaN,NaN,NaN,NaN,NaN,9.4009,10.371769074592413,8.430030925407587,9.6383954963136,9.856666666666667,9.856666666666667,9.856666666666667,286435,446309.6666666667,51.3028582248811,62.19971062702071,NaN,NaN,NaN,NaN,0.2260444889719717,20.873398828561445,-9625003,-0.04729502564988691,0.12613858350962914,0.17343360915951606
2023-04-18T13:30:00-04:00,9.785,9.845,9.75,9.84,9.365097009272922,NaN,NaN,NaN,NaN,NaN,9.418099999999999,10.389004506117901,8.447195493882097,9.6383954963136,9.837712263118368,9.859931145758992,9.815493380477744,208450,451061.9666666667,53.38419042481848,61.09513631006182,NaN,NaN,NaN,NaN,0.21668416833111664,21.684338179773732,-9416553,-0.04785694008971944,0.11361243404736676,0.1614693741370862
2023-04-19T09:30:00-04:00,9.66,9.82,9.62,9.78,9.365097009272922,NaN,NaN,NaN,NaN,NaN,9.4323,10.403192805617586,8.461407194382414,9.6383954963136,9.74,9.74,9.74,205369,455938.2,51.035142140619435,60.18104981656925,NaN,NaN,NaN,NaN,0.21692101345032264,22.863912483389086,-9621922,-0.05100154258644535,0.09771744590402953,0.14871898849047488
2023-04-19T13:30:00-04:00,9.79,9.86,9.77,9.82,9.365097009272922,NaN,NaN,NaN,NaN,NaN,9.446499999999999,10.418889325321933,8.474110674678064,9.6383954963136,9.779354486044724,9.817674215840176,9.741034756249272,216610,461269.5333333333,52.53465216975256,59.2168238325036,NaN,NaN,NaN,NaN,0.20785522677529958,23.679188196912506,-9405312,-0.049102069449290964,0.08734140167886117,0.13644347112815214
2023-04-20T09:30:00-04:00,9.69,9.82,9.62,9.785,9.365097009272922,NaN,NaN,NaN,NaN,NaN,9.461599999999999,10.431093558513965,8.492106441486033,9.6383954963136,9.741666666666664,9.741666835254058,9.741666498079269,220829,458971.8,51.061158491133725,58.31980365948616,NaN,NaN,NaN,NaN,0.20729413914849254,24.91878132375687,-9626141,-0.04881505218310504,0.07542465589927083,0.12423970808237587
2023-04-20T13:30:00-04:00,9.79,9.83,9.7,9.72,9.365097009272922,NaN,NaN,NaN,NaN,NaN,9.471999999999998,10.44120173338689,8.502798266613105,9.634973117640703,9.746561227953794,9.750663822318176,9.742458633589413,314316,465743.23333333334,48.34897136396573,57.18336411686831,NaN,NaN,NaN,NaN,0.20177312920931456,25.996032539368503,-9940457,-0.05135700747408392,0.060043448739770966,0.11140045621385489
2023-04-21T09:30:00-04:00,9.69,9.76,9.55,9.575,9.365097009272922,NaN,NaN,NaN,NaN,NaN,9.477199999999998,10.445766280643783,8.508633719356213,9.634973117640703,9.628333333333334,9.628333333333334,9.628333333333334,359522,466531.13333333336,42.877571054879496,55.49318788863313,NaN,NaN,NaN,NaN,0.2023607628372206,27.449842358747752,-10299979,-0.060527214557777875,0.03574143801663254,0.09626865257441042
2023-04-21T13:30:00-04:00,9.58,9.69,9.58,9.645,9.365097009272922,NaN,NaN,NaN,NaN,NaN,9.484099999999998,10.452434012621707,8.51576598737829,9.432106236232041,9.633435326883893,9.638434286507778,9.628436367260008,374495,470008.4666666667,46.05155623213174,54.17059979451545,NaN,NaN,NaN,NaN,0.1961207083488477,28.799808619599908,-9925484,-0.05951241256002193,0.021878136874383003,0.08139054943440494
2023-04-24T09:30:00-04:00,9.62,9.69,9.38,9.515,9.365097009272922,NaN,NaN,NaN,NaN,NaN,9.492399999999998,10.454516915972299,8.530283084027698,9.432106236232041,9.528333333333334,9.528333333333334,9.528333333333334,348785,456333.56666666665,41.44572553047909,52.47926557474365,NaN,NaN,NaN,NaN,0.20425494346678708,30.59223885622484,-10274269,-0.06479493372121717,0.0003968822828834817,0.06519181600410065
2023-04-24T13:30:00-04:00,9.52,9.54,9.39,9.395,9.365097009272922,NaN,NaN,NaN,NaN,NaN,9.496399999999998,10.455195160605287,8.537604839394708,9.432106236232041,9.48650460374015,9.529811808052813,9.443197399427486,325377,446905.0333333333,37.69771138240854,50.41913154031837,NaN,NaN,NaN,NaN,0.20037959036201647,32.25663836166227,-10599646,-0.07296171915200234,-0.02601033293590227,0.046951386216100066
2023-04-25T09:30:00-04:00,9.33,9.36,9.1,9.115,NaN,NaN,NaN,9.8829235416755,9.8829235416755,9.8829235416755,9.499199999999997,10.452691185066826,8.545708814933167,9.395598392950804,9.191666666666668,9.191666666666668,9.191666666666668,302324,432294.36666666664,30.717496909168403,47.92191322413675,NaN,NaN,NaN,NaN,0.20713819105044387,34.431999674139114,-10901970,-0.09255272085646818,-0.06873951485448515,0.02381320600198302
2023-04-25T13:30:00-04:00,9.11,9.21,9.05,9.09,NaN,NaN,NaN,9.77506338069025,NaN,NaN,9.504899999999997,10.445037202752934,8.564762797247061,9.395598392950804,9.154493669724618,9.191992243951102,9.116995095498133,297097,425231.5333333333,30.180165704290275,45.634012245890176,NaN,NaN,NaN,NaN,0.20377117740398362,36.5433159369871,-11199067,-0.10179275666965915,-0.1034277398350909,-0.001634983165431765
2023-04-26T09:30:00-04:00,9.12,9.25,9.015,9.03,NaN,NaN,NaN,9.77506338069025,NaN,NaN,9.500199999999996,10.447410557373694,8.552989442626298,9.395598392950804,9.098333333333334,9.098333333333334,9.098333333333334,260790,412974.56666666665,28.874687984384934,44.28685729916648,NaN,NaN,NaN,NaN,0.2060018075894133,38.16767915273685,-11459857,-0.10606224159857838,-0.13421278516365476,-0.028150543565076368
2023-04-26T13:30:00-04:00,9.03,9.035,8.8,8.81,NaN,NaN,NaN,9.567888328273554,NaN,NaN,9.489799999999995,10.455495521373205,8.524104478626786,9.387782971488514,8.934976369486384,9.028295773664972,8.841656965307795,799139,429588.4,24.662224038236957,42.15529368936791,NaN,NaN,NaN,NaN,0.2080731070473123,40.09029438153475,-12258996,-0.11696155698188399,-0.17435248979243134,-0.057390932810547364
2023-04-27T09:30:00-04:00,8.9,8.92,8.72,8.81,NaN,NaN,NaN,9.468097949715666,NaN,NaN,9.481699999999996,10.463145077424217,8.500254922575776,9.387782971488514,8.816666666666668,8.816666666666668,8.816666666666668,622927,422447.9,24.662224038236957,40.25239124746475,NaN,NaN,NaN,NaN,0.20749645654393278,42.01025265844914,-12258996,-0.11713849644304264,-0.20381405336435066,-0.08667555692130802
2023-04-27T13:30:00-04:00,8.81,8.94,8.81,8.815,NaN,NaN,NaN,9.468097949715666,NaN,NaN,9.479399999999996,10.46652844149088,8.492271558509113,9.301226377190812,8.832664263060353,8.851567122757578,8.813761403363129,446161,420677.9666666667,24.950814233407627,38.22143580522112,NaN,NaN,NaN,NaN,0.20196099536222323,43.622166867742635,-11812835,-0.10999951229704603,-0.22417494729261556,-0.11417543499556952
2023-04-28T09:30:00-04:00,8.79,8.94,8.72,8.845,NaN,NaN,NaN,9.467440487240927,NaN,NaN,9.479699999999996,10.46604762634694,8.493352373653051,9.265481101752648,8.835,8.835,8.835,298612,411091.06666666665,26.76353978084981,36.48774992238043,NaN,NaN,NaN,NaN,0.20324949569349293,45.28324470795867,-11514223,-0.09680313357803969,-0.23517935196811912,-0.13837621839007944
2023-04-28T13:30:00-04:00,8.85,8.88,8.805,8.84,NaN,NaN,NaN,9.46119319236634,NaN,NaN,9.485299999999997,10.453713981724858,8.516886018275136,9.19538488140212,8.838350750631704,8.841684038460205,8.835017462803204,301749,409635.26666666666,26.648012559454017,34.63870423593054,NaN,NaN,NaN,NaN,0.19408881742967207,46.825674131016434,-11815972,-0.08251485758127114,-0.24151979036666837,-0.15900493278539723
2023-05-01T09:30:00-04:00,8.81,8.85,8.65,8.75,NaN,NaN,NaN,9.367843501804233,NaN,NaN,9.487699999999997,10.448185731284019,8.527214268715975,9.069307905121695,8.75,8.75,8.75,467818,406601.6666666667,24.590400199523486,32.7479357865298,NaN,NaN,NaN,NaN,0.19451104475612402,48.52955861845493,-12283790,-0.0735276499354097,-0.25091449520465936,-0.17738684526924967
2023-05-01T13:30:00-04:00,8.755,8.845,8.71,8.82,NaN,NaN,NaN,9.367843501804233,NaN,NaN,9.490699999999997,10.441842491953832,8.539557508046162,8.835946324097357,8.767885740452005,8.788509500389944,8.747261980514066,351848,408910.4666666667,29.171274518445955,31.378100297564107,NaN,NaN,NaN,NaN,0.19026025584497228,50.11173707107639,-11931942,-0.05795576291044485,-0.24983154890730574,-0.1918757859968609
2023-05-02T09:30:00-04:00,8.74,8.79,8.42,8.48,NaN,NaN,NaN,9.240070215486915,NaN,NaN,9.487299999999998,10.451563885043996,8.523036114956,8.73310564742231,8.563333333333334,8.563333333333334,8.563333333333334,613950,408259.93333333335,22.137162820857284,29.89664256656252,NaN,NaN,NaN,NaN,0.20524166614175998,51.99858208183452,-12545892,-0.06510617972459234,-0.2732585106526013,-0.20815233092800897
2023-05-02T13:30:00-04:00,8.48,8.54,8.415,8.45,NaN,NaN,NaN,9.10074884205569,NaN,NaN,9.484099999999998,10.460967831387693,8.507232168612303,8.73310564742231,8.517094556935923,8.564577809931055,8.469611303940791,582190,411350.76666666666,21.641297013136764,28.15305262234859,NaN,NaN,NaN,NaN,0.1995101185602057,53.75683815627589,-13128082,-0.06619179377932174,-0.29089207315216115,-0.2247002793728394
2023-05-03T09:30:00-04:00,8.42,8.465,8.33,8.45,NaN,NaN,NaN,9.010828440144069,NaN,NaN,9.480799999999997,10.470420856692161,8.491179143307832,8.503984517937848,8.415000000000001,8.415000000000001,8.415000000000001,279637,404389.4,21.641297013136764,26.738450585395565,NaN,NaN,NaN,NaN,0.19490225294876243,55.49519393665455,-13128082,-0.061353802874785784,-0.3013925329663216,-0.24003873009153584
2023-05-03T13:30:00-04:00,8.45,8.59,8.33,8.37,NaN,NaN,NaN,9.010828440144069,NaN,NaN,9.474999999999996,10.486942686124202,8.46305731387579,8.455150091480222,8.425192283225764,8.432192398298527,8.418192168153,592826,410420.9666666667,20.239213344447933,25.49141501125552,NaN,NaN,NaN,NaN,0.1995520920238508,55.950789977185735,-13720908,-0.058022201996760725,-0.31256648258748676,-0.25454428059072604
2023-05-04T09:30:00-04:00,8.36,8.545,8.21,8.54,NaN,NaN,NaN,9.010828440144069,NaN,NaN,9.464499999999997,10.503767530523334,8.425232469476661,8.455150091480222,8.431666666666667,8.431666666666667,8.431666666666667,426537,412092.2,30.537906758203235,25.478587143329435,NaN,NaN,NaN,NaN,0.2092269425935757,56.6082032603238,-13294371,-0.0397227649375117,-0.30419773676261563,-0.26447497182510393
2023-05-04T13:30:00-04:00,8.545,8.6,8.42,8.48,NaN,NaN,NaN,9.010828440144069,NaN,NaN,9.451899999999997,10.522847038839997,8.380952961159997,8.444196058547343,8.464165647249171,8.498291589496095,8.430039705002248,386836,406854.86666666664,29.109303840924582,25.402097010231888,NaN,NaN,NaN,NaN,0.2071393038368917,56.73798843904978,-13681207,-0.027588591325759526,-0.29896071098230337,-0.27137211965654384
2023-05-05T09:30:00-04:00,8.63,8.82,8.6,8.76,NaN,NaN,NaN,9.010828440144069,NaN,NaN,9.440699999999996,10.528510663672801,8.352889336327191,8.444196058547343,8.726666666666667,8.726666666666667,8.726666666666667,402338,402076.8,42.60355341981623,26.382730255619837,NaN,NaN,NaN,NaN,0.216629353562828,55.16886027510177,-13278869,0.0018061068448404494,-0.26911448610049327,-0.2709205929453337
2023-05-05T13:30:00-04:00,8.77,8.86,8.735,8.86,NaN,NaN,NaN,9.010828440144069,NaN,NaN,9.428499999999996,10.528338624526429,8.328661375473564,8.4185854774703,8.766535363437526,8.811978927944564,8.72109179893049,309678,392018.1,46.51903667021375,27.943931157903894,NaN,NaN,NaN,NaN,0.21008439973691173,53.43836674465462,-12969191,0.028987152796441984,-0.23468665194978122,-0.2636738047462232
2023-05-08T09:30:00-04:00,8.82,8.9,8.76,8.835,NaN,NaN,NaN,9.010828440144069,NaN,NaN,9.411399999999997,10.520987382769,8.301812617230993,8.4185854774703,8.831666666666667,8.831666666666667,8.831666666666667,326674,375913.36666666664,45.68005651371211,29.44520490615212,NaN,NaN,NaN,NaN,0.20507837118427522,51.55385725216687,-13295865,0.04531257351748291,-0.20703308784936958,-0.2523456613668525
2023-05-08T13:30:00-04:00,8.84,8.945,8.81,8.91,NaN,NaN,NaN,9.010828440144069,NaN,NaN,9.395599999999996,10.51078364406953,8.280416355930463,8.471359887679888,8.861730311291485,8.890010760379184,8.833449862203786,369169,376616.26666666666,48.67087967946608,31.13949529515629,NaN,NaN,NaN,NaN,0.20007277324254127,49.488918187667515,-12926696,0.060256582982672724,-0.1770249326385116,-0.23728151562118432
2023-05-09T09:30:00-04:00,8.85,9.17,8.82,9.115,8.356648180451106,8.356648180451106,8.356648180451106,NaN,NaN,NaN,9.383699999999997,10.497907898015512,8.269492101984483,8.61608791014391,9.035,9.035000168587395,9.034999831412605,471422,382782.5,55.829665874637485,33.21564715899827,NaN,NaN,NaN,NaN,0.21078186086807402,46.19187803386891,-12455274,0.08171032032013134,-0.13514361522102014,-0.21685393554115148
2023-05-09T13:30:00-04:00,9.11,9.17,9.065,9.11,8.4938459904306,NaN,NaN,NaN,NaN,NaN,9.370799999999996,10.48244627467568,8.25915372532431,8.674370328115128,9.07894016059419,9.118745626731846,9.039134694456534,574444,394982.3,55.62588971763617,35.285495527439856,NaN,NaN,NaN,NaN,0.2032260136632116,43.13034074819878,-13029718,0.09253164486167609,-0.10118937946405637,-0.19372102432573246
2023-05-10T09:30:00-04:00,9.3,9.38,8.79,8.88,8.4938459904306,NaN,NaN,NaN,NaN,NaN,9.352799999999997,10.466504018130593,8.2390959818694,8.688496262492102,9.016666666666667,9.016666666666667,9.016666666666667,745486,412986.2,47.10810783935847,36.893903215999494,NaN,NaN,NaN,NaN,0.23085272697298231,41.54758517001991,-13775204,0.08155163463810727,-0.09178148102809836,-0.17333311566620563
2023-05-10T13:30:00-04:00,8.875,9.09,8.865,9.07,8.4938459904306,NaN,NaN,NaN,NaN,NaN,9.339199999999998,10.449773473481223,8.228626526518774,8.688496262492102,9.013204491874063,9.017311169643854,9.009097814104273,529854,423427.6666666667,53.44949654469721,38.62806193216029,NaN,NaN,NaN,NaN,0.2304346750463407,40.077883561710955,-13245350,0.084100106557212,-0.06820798246969062,-0.15230808902690263
2023-05-11T09:30:00-04:00,9.57,9.96,9.18,9.45,8.803625114329245,NaN,NaN,NaN,NaN,NaN,9.335399999999998,10.443127114410427,8.22767288558957,8.982437607994946,9.53,9.53,9.53,2259898,491396.63333333336,63.0032411750049,41.54706752888512,NaN,NaN,NaN,NaN,0.2775464839716021,39.182560802745776,-10985452,0.1069280488547518,-0.018648027958462876,-0.12557607681321467
2023-05-11T13:30:00-04:00,9.46,9.66,9.45,9.655,8.803625114329245,NaN,NaN,NaN,NaN,NaN,9.333499999999997,10.438699077089794,8.2283009229102,8.982437607994946,9.5443805140078,9.56952139971264,9.51923962830296,739395,505565.93333333335,66.94460515378108,44.78301811035972,NaN,NaN,NaN,NaN,0.27272173511648773,38.35118966942096,-10246057,0.12985829002949073,0.036746785723648756,-0.09311150430584197
2023-05-12T09:30:00-04:00,9.62,9.62,8.875,8.91,8.803625114329245,NaN,NaN,NaN,NaN,NaN,9.311299999999996,10.404981507569847,8.217618492430145,8.982437607994946,9.135,9.135,9.135,1146879,531811.1666666666,47.24601503902073,46.611926540780004,NaN,NaN,NaN,NaN,0.3089558968938814,35.7864915408352,-11392936,0.09072785508840586,0.020298314554665353,-0.07042954053374051
2023-05-12T13:30:00-04:00,8.91,8.935,8.71,8.73,NaN,NaN,NaN,9.64735047109287,9.64735047109287,9.64735047109287,9.285899999999996,10.373395636772937,8.198404363227056,8.982437607994946,8.965378640324118,9.137033122245652,8.793724158402584,1119872,556657.0666666667,43.885962253227866,48.30098003426428,NaN,NaN,NaN,NaN,0.302959047115747,33.87700445455605,-12512808,0.05060046565547882,-0.007178958464391982,-0.057779424119870804
2023-05-15T09:30:00-04:00,8.72,8.745,8.51,8.72,NaN,NaN,NaN,9.44690272240683,NaN,NaN,9.262599999999997,10.347671868587588,8.177528131412407,8.982437607994946,8.658333333333333,8.658333333333333,8.658333333333333,833262,572806.3,43.70002143210108,49.24113108239984,NaN,NaN,NaN,NaN,0.2981048294646222,32.63166020220107,-13346070,0.02268542267507527,-0.029422645776026712,-0.05210806845110198
2023-05-15T13:30:00-04:00,8.715,8.715,8.61,8.65,NaN,NaN,NaN,9.44690272240683,NaN,NaN,9.235999999999997,10.314610216899593,8.1573897831004,8.982437607994946,8.658333333333333,8.658333333333333,8.658333333333333,541014,579994.2,42.34745333130309,50.18671318885545,NaN,NaN,NaN,NaN,0.28466877021714926,31.475269110728586,-13887084,0.000007430042976465379,-0.0520987808973814,-0.05210621094035787
2023-05-16T09:30:00-04:00,8.53,8.59,8.32,8.35,NaN,NaN,NaN,9.260922728473991,NaN,NaN,9.204499999999998,10.292733890301218,8.116266109698778,8.982437607994946,8.42,8.42,8.42,660390,591929.7333333333,37.054198393649614,49.79033068698641,NaN,NaN,NaN,NaN,0.28790671520163863,31.118864500543967,-14547474,-0.032877342654581525,-0.09320288925858478,-0.06032554660400325
2023-05-16T13:30:00-04:00,8.35,8.4,8.31,8.34,NaN,NaN,NaN,9.136562604452447,NaN,NaN,9.172299999999996,10.26565851393776,8.078941486062233,8.982437607994946,8.387387146578629,8.422305644989017,8.35246864816824,576059,601228.4666666667,36.88867780163429,49.1024479106593,NaN,NaN,NaN,NaN,0.2737705212586644,30.811251480451553,-15123533,-0.051853596613230746,-0.12514254237054168,-0.07328894575731093
2023-05-17T09:30:00-04:00,8.4,8.66,8.34,8.615,NaN,NaN,NaN,9.136562604452447,NaN,NaN,9.143799999999997,10.219345554590888,8.068254445409107,8.982437607994946,8.538333333333334,8.538333333333334,8.538333333333334,750409,617549.1,44.262302211962485,49.00117974624862,NaN,NaN,NaN,NaN,0.27707262688304557,29.523286791261764,-14373124,-0.04281127486621124,-0.12680303934007497,-0.08399176447386374
2023-05-17T13:30:00-04:00,8.615,8.65,8.45,8.465,NaN,NaN,NaN,9.136562604452447,NaN,NaN,9.113099999999998,10.176699341857729,8.049500658142266,8.982437607994946,8.5315422521013,8.539731629543875,8.523352874658725,516029,608112.1,41.41965197170492,48.483234909979956,NaN,NaN,NaN,NaN,0.2715674392485424,28.32731957987125,-14889153,-0.043706397691854595,-0.13862476158868198,-0.09491836389682738
2023-05-18T09:30:00-04:00,8.41,8.67,8.39,8.53,NaN,NaN,NaN,9.136562604452447,NaN,NaN,9.083299999999998,10.126896876193179,8.039703123806817,8.772950086395955,8.530000000000001,8.530000000000001,8.530000000000001,333442,598462.6,43.12425519811295,47.57570557594249,NaN,NaN,NaN,NaN,0.2721697650165036,27.395977885975864,-14555711,-0.03696278099567661,-0.14112184014142315,-0.10415905914574654
2023-05-18T13:30:00-04:00,8.54,8.635,8.445,8.615,NaN,NaN,NaN,9.136562604452447,NaN,NaN,9.054199999999996,10.066803298434468,8.041596701565524,8.520360069116764,8.546027204624819,8.563465119459721,8.528589289789917,281674,592979.7,45.36321723289421,46.84265754131807,NaN,NaN,NaN,NaN,0.26630049608675327,26.53116059878729,-14274037,-0.024424262953666162,-0.13468938783782924,-0.11026512488416308
2023-05-19T09:30:00-04:00,8.58,8.67,8.43,8.54,NaN,NaN,NaN,9.136562604452447,NaN,NaN,9.023899999999998,10.005081512259672,8.042718487740323,8.04524464228702,8.546666666666667,8.546666666666667,8.546666666666667,326059,593894.6,43.727525149027535,46.60118734915157,NaN,NaN,NaN,NaN,0.26442188922341375,25.57092731498358,-14600096,-0.019066061223697153,-0.13409770141378452,-0.11503164019008737
2023-05-19T13:30:00-04:00,8.54,8.54,8.445,8.48,NaN,NaN,NaN,9.136562604452447,NaN,NaN,8.993599999999997,9.946106251948132,8.041093748051862,8.04524464228702,8.52060061129914,8.549602001851982,8.491599220746297,263396,592616.1666666666,42.41005374597419,45.81265572067135,NaN,NaN,NaN,NaN,0.25232032570745555,24.679282122880135,-14863492,-0.017488508073505493,-0.13689227528196923,-0.11940376720846374
2023-05-22T09:30:00-04:00,8.47,8.78,8.45,8.705,NaN,NaN,NaN,9.136562604452447,NaN,NaN,8.974199999999998,9.909764770606582,8.038635229393414,8.177156571063692,8.644999999999998,8.644999999999998,8.644999999999998,635331,598199.9333333333,48.65720161598534,44.787938609312825,NaN,NaN,NaN,NaN,0.25786887387120877,23.046225951144123,-14228161,-0.00013539611720311817,-0.11957301235496764,-0.11943761623776453
2023-05-22T13:30:00-04:00,8.71,8.77,8.625,8.76,NaN,NaN,NaN,9.136562604452447,NaN,NaN,8.952099999999998,9.854051417760523,8.050148582239473,8.215225256850955,8.67720254642606,8.713596448043177,8.640808644808942,497420,603052.3333333334,50.08264997748066,43.58351323957707,NaN,NaN,NaN,NaN,0.24980681145183667,21.529816648817825,-13730741,0.015347157418135388,-0.10025366946509529,-0.11560082688323067
2023-05-23T09:30:00-04:00,8.72,8.865,8.59,8.65,NaN,NaN,NaN,9.136562604452447,NaN,NaN,8.929499999999997,9.803537184563798,8.055462815436197,8.283680205480763,8.701666666666666,8.701666666666666,8.701666666666666,386497,595470.5666666667,47.256788698850706,43.58428278670778,NaN,NaN,NaN,NaN,0.25160632491956264,20.521831234133817,-14117238,0.018280766327842257,-0.09274986897342785,-0.11103063530127011
2023-05-23T13:30:00-04:00,8.635,8.695,8.61,8.68,NaN,NaN,NaN,9.136562604452447,NaN,NaN,8.906299999999998,9.74322726087766,8.069372739122336,8.283680205480763,8.6880228530026,8.706985945979703,8.669059760025497,200078,582733.5,48.11660403233665,43.88647148521555,NaN,NaN,NaN,NaN,0.23970587313959396,19.58584477764152,-13917160,0.02208796260324801,-0.08342068204721009,-0.1055086446504581
2023-05-24T09:30:00-04:00,8.56,8.66,8.46,8.545,NaN,NaN,NaN,9.136562604452447,NaN,NaN,8.881599999999997,9.686200372856149,8.076999627143845,8.283680205480763,8.555,8.555,8.555,215440,580593.6,44.5936360254516,43.95030109902631,NaN,NaN,NaN,NaN,0.23829831077248004,18.382766744125824,-14132600,0.015662869530800302,-0.08593005773695772,-0.10159292726775802
2023-05-24T13:30:00-04:00,8.545,8.645,8.545,8.61,NaN,NaN,NaN,9.136562604452447,NaN,NaN,8.857399999999998,9.61930088594268,8.095499114057317,8.283680205480763,8.574372652319989,8.59665425227409,8.552091052365887,162859,566261.3666666667,46.62017584390745,44.25549556421233,NaN,NaN,NaN,NaN,0.22841986000301714,17.265622855861245,-13969741,0.01588902363892418,-0.0817316477191028,-0.09762067135802698
2023-05-25T09:30:00-04:00,8.65,8.74,8.58,8.67,NaN,NaN,NaN,9.136562604452447,NaN,NaN,8.835099999999997,9.550975659594762,8.119224340405232,8.28973141216492,8.663333333333334,8.663333333333334,8.663333333333334,363534,564161.2666666667,48.49294724227796,45.072549053400074,NaN,NaN,NaN,NaN,0.2235327271456588,16.313216006034033,-13606207,0.019916892633730032,-0.07272455556586443,-0.09264144819959447
2023-05-25T13:30:00-04:00,8.67,8.735,8.58,8.59,NaN,NaN,NaN,9.136562604452447,NaN,NaN,8.812499999999998,9.485253298022531,8.139746701977465,8.297285129731936,8.64815542232843,8.662285950604108,8.63402489405275,419423,565247.5,46.1671894446726,45.73529988504567,NaN,NaN,NaN,NaN,0.21863753234954025,15.42883821690876,-14025630,0.017136587758046454,-0.0712207135020364,-0.08835730126008286
2023-05-26T09:30:00-04:00,8.6,8.84,8.6,8.75,NaN,NaN,NaN,9.136562604452447,NaN,NaN,8.795999999999998,9.43263804473207,8.159361955267926,8.36482810378555,8.729999999999999,8.729999999999999,8.729999999999999,434762,566328.3,51.207461706206935,46.23138270606313,NaN,NaN,NaN,NaN,0.22087770861028738,15.135135316456822,-13590868,0.025511981138770748,-0.056467324836619426,-0.08197930597539017
2023-05-26T13:30:00-04:00,8.74,8.88,8.74,8.825,NaN,NaN,NaN,9.136562604452447,NaN,NaN,8.779599999999997,9.368357471290407,8.190842528709586,8.42986248302844,8.762225490154075,8.803464845719388,8.720986134588761,265477,564854.9333333333,53.40952619381933,47.08780229335702,NaN,NaN,NaN,NaN,0.21510072942383832,15.056079329126145,-13325391,0.03495784971406178,-0.038281993832812944,-0.07323984354687472
2023-05-30T09:30:00-04:00,8.98,9.18,8.92,8.995,8.357559038597884,8.357559038597884,8.357559038597884,NaN,NaN,NaN,8.769199999999998,9.322959370124087,8.215440629875909,8.642389986422751,9.031666666666666,9.031666666666666,9.031666666666666,752490,579048.8,58.03288959039245,48.15270474994842,NaN,NaN,NaN,NaN,0.22509353446499275,16.198781606159358,-12572901,0.05056250541541559,-0.010036711777605234,-0.060599217193020825
2023-05-30T13:30:00-04:00,8.99,9.02,8.91,8.92,8.357559038597884,NaN,NaN,NaN,NaN,NaN,8.759699999999997,9.285796607098273,8.23360339290172,8.642389986422751,9.006265707989112,9.044070508260889,8.968460907717335,339709,578066.8,55.419980514405694,48.8710449843421,NaN,NaN,NaN,NaN,0.21687256771749322,17.193784573555895,-12912610,0.053458777921604,0.006224255208984175,-0.047234522712619825
2023-05-31T09:30:00-04:00,8.82,9.03,8.74,8.85,8.357559038597884,NaN,NaN,NaN,NaN,NaN,8.754399999999997,9.271331871720331,8.237468128279662,8.642389986422751,8.873333333333333,8.873333333333333,8.873333333333333,363638,574474,53.02050976151519,49.53482959951979,NaN,NaN,NaN,NaN,0.2220959557376722,17.05399089489354,-13276248,0.048435099603324594,0.013309351791535917,-0.03512574781178868
2023-05-31T13:30:00-04:00,8.85,8.945,8.84,8.91,8.357559038597884,NaN,NaN,NaN,NaN,NaN,8.750799999999996,9.260793568587276,8.240806431412716,8.642389986422751,8.884827523024827,8.897286991137124,8.87236805491253,309476,565641.7333333333,54.825921604129476,50.42167730367373,NaN,NaN,NaN,NaN,0.21373195889926708,16.924182478992787,-12966772,0.04689660196878007,0.023495004649186413,-0.02340159731959366
2023-06-01T09:30:00-04:00,8.89,9.08,8.79,8.98,8.357559038597884,NaN,NaN,NaN,NaN,NaN,8.749799999999997,9.25779196844072,8.241808031559273,8.642389986422751,8.95,8.95,8.95,365800,552985.5333333333,56.906624051606705,51.01092176336097,NaN,NaN,NaN,NaN,0.21917967612074807,17.380942496644565,-12600972,0.04815448845196436,0.036791513245361784,-0.011362975206602571
2023-06-01T13:30:00-04:00,8.985,9.12,8.96,9.015,8.371801379511897,NaN,NaN,NaN,NaN,NaN,8.753899999999998,9.267052180157355,8.24074781984264,8.642389986422751,8.99278440848389,9.033571102599312,8.951997714368469,402511,548740.7666666667,57.94953251730899,51.57284194477728,NaN,NaN,NaN,NaN,0.2149525563978374,17.96680068625603,-12198461,0.048755781783717735,0.0495817520230446,0.0008259702393268644
2023-06-02T09:30:00-04:00,9.15,9.15,8.93,9.085,8.372174044079538,NaN,NaN,NaN,NaN,NaN,8.759399999999998,9.280670141097955,8.23812985890204,8.642389986422751,9.055,9.055,9.055,620076,494080.0333333333,60.03284122666309,52.48541712533531,NaN,NaN,NaN,NaN,0.2153130880837062,18.51081186232382,-11578385,0.05103650840309022,0.06462160574318965,0.013585097340099423
2023-06-02T13:30:00-04:00,9.085,9.35,9.075,9.33,8.537529769348648,NaN,NaN,NaN,NaN,NaN,8.769699999999998,9.314766638128011,8.224633361871986,8.802879488480643,9.148496580406965,9.246710888252622,9.050282272561308,561936,488164.73333333334,66.32186897731061,53.78579319283345,NaN,NaN,NaN,NaN,0.21957643893487006,19.793032956526922,-11016449,0.06530208045481778,0.09521269790862164,0.029910617453803863
2023-06-05T09:30:00-04:00,9.29,9.33,9.04,9.05,8.537529769348648,NaN,NaN,NaN,NaN,NaN,8.773799999999998,9.32412921056423,8.223470789435765,8.802879488480643,9.139999999999999,9.139999999999999,9.139999999999999,308654,460223.9,55.561423950040385,54.56920661601837,NaN,NaN,NaN,NaN,0.2246066932966651,20.722319948307437,-11325103,0.05267858642393212,0.09575885048371902,0.0430802640597869
2023-06-05T13:30:00-04:00,9.06,9.115,8.985,9.04,8.537529769348648,NaN,NaN,NaN,NaN,NaN,8.777799999999997,9.332882552419242,8.222717447580752,8.802879488480643,9.086841473295781,9.133054388493006,9.040628558098556,408405,436508.3333333333,55.21685842505224,55.18325537181442,NaN,NaN,NaN,NaN,0.21784907234690337,21.17349096343448,-11733508,0.04097399519320127,0.09429775805128848,0.053323762858087216
2023-06-06T09:30:00-04:00,8.72,9.12,8.61,9.035,8.537529769348648,NaN,NaN,NaN,NaN,NaN,8.783499999999997,9.343157931240455,8.223842068759538,8.802879488480643,8.921666666666665,8.921666666666665,8.921666666666665,1032602,443153,55.03308740726185,55.65040824074184,NaN,NaN,NaN,NaN,0.238716995750696,19.9228375029962,-12766110,0.030684628744594586,0.09167954878883045,0.06099492004423586
2023-06-06T13:30:00-04:00,9.04,9.12,8.94,9.11,8.537529769348648,NaN,NaN,NaN,NaN,NaN,8.789299999999997,9.356313262631714,8.22228673736828,8.802879488480643,8.960480363637032,9.021581476707848,8.899379250566216,416682,439008.6,57.32728863341495,56.447558182794864,NaN,NaN,NaN,NaN,0.23452292462564625,18.761516432589225,-12349428,0.026857159993209867,0.09456637003574819,0.06770921004253833
2023-06-07T09:30:00-04:00,9.2,9.575,9.165,9.35,8.63665132396465,NaN,NaN,NaN,NaN,NaN,8.806699999999998,9.387897419127334,8.22550258087266,8.835347550785336,9.363333333333332,9.363333333333332,9.363333333333332,688447,439943.8333333333,63.708186202627196,57.34046707539631,NaN,NaN,NaN,NaN,0.2509855728666715,19.038822280131228,-11660981,0.03774922739686874,0.11489574428862426,0.07714651689175551
2023-06-07T13:30:00-04:00,9.345,9.45,9.3,9.4,8.654530809238985,NaN,NaN,NaN,NaN,NaN,8.825699999999998,9.420954600990422,8.230445399009573,8.835347550785336,9.37057946125794,9.380192795154542,9.360966127361337,391142,433779.93333333335,64.88620639023421,58.16022994656878,NaN,NaN,NaN,NaN,0.24377231766190915,19.296320567134515,-11269839,0.04508484047564107,0.13350256748630684,0.08841772701066578
2023-06-08T09:30:00-04:00,9.37,9.465,9.17,9.36,8.654530809238985,NaN,NaN,NaN,NaN,NaN,8.843899999999998,9.447679065553162,8.240120934446834,8.835347550785336,9.331666666666665,9.331666666666665,9.331666666666665,378565,421385.13333333336,63.12101143088302,58.52366722088954,NaN,NaN,NaN,NaN,0.24743143782891566,18.855889405778367,-11648404,0.04396044470966902,0.14336828289775205,0.09940783818808303
2023-06-08T13:30:00-04:00,9.37,9.53,9.33,9.5,8.707867948087587,NaN,NaN,NaN,NaN,NaN,8.866499999999997,9.48211107852304,8.250888921476953,8.885297946002092,9.401435750291363,9.461609222945034,9.341262277637691,508928,421148.43333333335,66.55088172539703,59.31873159310321,NaN,NaN,NaN,NaN,0.24404347798399306,18.6956997262435,-11139476,0.048979406722850644,0.16063209659164635,0.1116526898687957
2023-06-09T09:30:00-04:00,9.62,9.79,9.435,9.485,8.874783041356334,NaN,NaN,NaN,NaN,NaN,8.885399999999997,9.51755770184365,8.253242298156344,9.096738356801675,9.57,9.57,9.57,445569,424886,65.84429615931565,60.234716335803235,NaN,NaN,NaN,NaN,0.2519689438422792,19.424157067546428,-11585045,0.047582432226038335,0.1711307301513436,0.12354829792530528
2023-06-09T13:30:00-04:00,9.48,9.5,9.4,9.41,8.874783041356334,NaN,NaN,NaN,NaN,NaN,8.903999999999998,9.542050154768498,8.265949845231498,9.096738356801675,9.533550554468363,9.592975835210773,9.474125273725953,167631,421084.56666666665,62.28356567218761,60.767405197807385,NaN,NaN,NaN,NaN,0.24111401928211637,19.908121303501567,-11752676,0.03829979491658267,0.1714230415710336,0.13312324665445094
2023-06-12T09:30:00-04:00,9.38,9.41,9.23,9.32,8.874783041356334,NaN,NaN,NaN,NaN,NaN,8.915199999999997,9.562341282874309,8.268058717125685,9.096738356801675,9.32,9.32,9.32,511018,427249.86666666664,58.21517123313804,60.86087285363106,NaN,NaN,NaN,NaN,0.2367487321905366,19.469000730277582,-12263694,0.02351663017630018,0.16251903437482618,0.139002404198526
2023-06-12T13:30:00-04:00,9.325,9.41,9.31,9.36,8.874783041356334,NaN,NaN,NaN,NaN,NaN,8.925199999999997,9.583968426687436,8.266431573312557,9.096738356801675,9.337706221097635,9.357574250148467,9.317838192046803,405862,431998.73333333334,59.48194861533861,60.97033114634746,NaN,NaN,NaN,NaN,0.22698096560549824,19.061245912283876,-11857832,0.01430349646820503,0.1568817747837823,0.14257827831557726
2023-06-13T09:30:00-04:00,9.47,9.68,9.37,9.67,8.874783041356334,NaN,NaN,NaN,NaN,NaN,8.941899999999999,9.632253213942034,8.251546786057963,9.112840030945966,9.573333333333332,9.573333333333332,9.573333333333332,835123,438658.4666666667,67.6638820217697,61.51540548885508,NaN,NaN,NaN,NaN,0.23362518234796267,19.62916342949127,-11022709,0.026262686663630908,0.1754066366451159,0.149143949981485
2023-06-13T13:30:00-04:00,9.68,9.69,9.59,9.6,8.954997805719627,NaN,NaN,NaN,NaN,NaN,8.955699999999998,9.670117273027504,8.241282726972493,9.186272024756773,9.593066056714305,9.618815455573149,9.56731665785546,490445,438425.9666666667,64.49674942429162,61.38503980649658,NaN,NaN,NaN,NaN,0.22408052646596532,20.188273458967384,-11513154,0.026554788568024235,0.18233743569151528,0.15578264712349105
2023-06-14T09:30:00-04:00,9.65,9.98,9.585,9.855,9.07477063273237,NaN,NaN,NaN,NaN,NaN,8.970499999999998,9.726929111021054,8.214070888978942,9.37951761980542,9.806666666666667,9.806666666666667,9.806666666666667,651200,447249.4,70.00469287260613,62.41670187239413,NaN,NaN,NaN,NaN,0.2362890602898249,21.535668440585916,-10861954,0.04019909010226716,0.206031509751325,0.16583241964905784
2023-06-14T13:30:00-04:00,9.85,9.94,9.64,9.94,9.07477063273237,NaN,NaN,NaN,NaN,NaN,8.987099999999998,9.790044805076915,8.18415519492308,9.37951761980542,9.82194092363634,9.838549324312643,9.805332522960038,550781,458939.5,71.5870382763026,63.586000433197725,NaN,NaN,NaN,NaN,0.24083984169769448,22.786820923517407,-10311173,0.050556410150058795,0.22902793233663132,0.17847152218657253
2023-06-15T09:30:00-04:00,9.82,10.13,9.82,9.89,9.248825101311933,NaN,NaN,NaN,NaN,NaN,9.007299999999997,9.84836411170616,8.166235888293834,9.470691276675469,9.946666666666667,9.946666666666667,9.946666666666667,790537,478109.4,69.27208619462023,64.60307177515189,NaN,NaN,NaN,NaN,0.24577985300500207,24.420075918830715,-11101710,0.049579953149363615,0.24044646362327704,0.19086651047391343
2023-06-15T13:30:00-04:00,9.895,10.03,9.895,9.97,9.250242142161389,NaN,NaN,NaN,NaN,NaN,9.025299999999998,9.908431722904409,8.142168277095587,9.470691276675469,9.953864207443491,9.962816878609756,9.944911536277226,510958,489712.7,70.89388337835604,65.5721142569334,NaN,NaN,NaN,NaN,0.2382241492189304,25.93666984305022,-10590752,0.0497341853099969,0.25303424211140957,0.20330005680141267
2023-06-16T09:30:00-04:00,10.07,10.17,9.945,10.08,9.346935681154054,NaN,NaN,NaN,NaN,NaN,9.037899999999997,9.961939155014623,8.113860844985371,9.5795424170723,10.065,10.065,10.065,802540,504346.23333333334,73.00374678831388,66.23608287019674,NaN,NaN,NaN,NaN,0.2372795671318639,27.673770262658227,-9788212,0.052390202073162084,0.2687878093928653,0.2163976073197032
2023-06-16T13:30:00-04:00,10.081,10.22,9.99,10.04,9.395370422919779,NaN,NaN,NaN,NaN,NaN,9.045599999999997,9.99611699616585,8.095083003834144,9.632633933657841,10.07625911248857,10.085183766444812,10.067334458532327,1277298,532942.0666666667,70.98858199935549,66.67196684227683,NaN,NaN,NaN,NaN,0.2367595980510165,29.398900975843862,-11065510,0.04678299872936367,0.2748763557314078,0.2280933570020441
2023-06-20T09:30:00-04:00,9.95,10.03,9.64,9.915,9.395370422919779,NaN,NaN,NaN,NaN,NaN,9.065699999999998,10.045936726510512,8.085463273489484,9.632633933657841,9.861666666666666,9.861666666666666,9.861666666666666,397944,531714.8,64.95452342409762,66.80293198464929,NaN,NaN,NaN,NaN,0.24841962676165807,28.916997331607654,-11463454,0.030759378630610817,0.26654258029030764,0.23578320165969682
2023-06-20T13:30:00-04:00,9.91,10.05,9.86,10.02,9.395370422919779,NaN,NaN,NaN,NaN,NaN,9.091499999999998,10.10246043443846,8.080539565561537,9.632633933657841,9.926759297832353,9.983755806076237,9.869762789588469,519026,540166.4333333333,67.45685315460969,66.86764422959305,NaN,NaN,NaN,NaN,0.24424679627868257,28.534081145957202,-10944428,0.023654890784913868,0.26535181514083916,0.2416969243559253
2023-06-21T09:30:00-04:00,9.96,10.06,9.765,9.79,9.395370422919779,NaN,NaN,NaN,NaN,NaN,9.112899999999998,10.136716565601478,8.089083434398518,9.632633933657841,9.871666666666668,9.871666666666668,9.871666666666668,434692,529573.1666666666,57.732587621067744,66.28823647686106,NaN,NaN,NaN,NaN,0.24787202511591952,27.6806857594339,-11379120,0.0010803395756972811,0.2430473488255469,0.24196700924984962
2023-06-21T13:30:00-04:00,9.785,9.86,9.75,9.755,9.395370422919779,NaN,NaN,NaN,NaN,NaN,9.134999999999996,10.165576537672056,8.104423462327937,9.632633933657841,9.8393701260551,9.879969533055831,9.798770719054367,275077,527418.7666666667,56.400182981154636,65.867994856073,NaN,NaN,NaN,NaN,0.23802402332192524,26.80912980205586,-11654197,-0.017565170235755573,0.22001054645515516,0.23757571669091074
2023-06-22T09:30:00-04:00,9.71,9.71,9.1,9.375,NaN,NaN,NaN,10.175468404686814,10.175468404686814,10.175468404686814,9.155499999999996,10.163327862286065,8.147672137713927,9.632633933657841,9.395000000000001,9.395000000000001,9.395000000000001,1340027,559965.0666666667,44.414992476313984,64.88226780201413,NaN,NaN,NaN,NaN,0.26780802165607354,26.322270692855927,-12994224,-0.0547476640237676,0.16914113666120123,0.22388880068496883
2023-06-22T13:30:00-04:00,9.37,9.47,9.335,9.455,NaN,NaN,NaN,10.156356204473775,NaN,NaN,9.177799999999996,10.161517764402063,8.194082235597929,9.632633933657841,9.401718943976515,9.412801786177177,9.390636101775854,492508,566066.1333333333,46.969915508272045,63.98855115150938,NaN,NaN,NaN,NaN,0.2583217343949254,25.870187234313136,-12501716,-0.07211870612495747,0.133740418028772,0.20585912415372948
2023-06-23T09:30:00-04:00,9.33,9.535,9.3,9.5,NaN,NaN,NaN,10.156356204473775,NaN,NaN,9.195499999999997,10.169878263304373,8.221121736695622,9.632633933657841,9.445,9.445,9.445,605621,574060.1666666666,48.406471613669055,62.61302183664504,NaN,NaN,NaN,NaN,0.25665589622385926,25.155560982324726,-11896095,-0.07823094050346113,0.10807044852440306,0.1863013890278642
2023-06-23T13:30:00-04:00,9.5,9.58,9.46,9.495,NaN,NaN,NaN,10.156356204473775,NaN,NaN,9.216099999999997,10.171192225913343,8.261007774086652,9.632633933657841,9.468760148410597,9.500689214189926,9.436831082631269,335372,571822.2,48.250070299635105,61.45254475631243,NaN,NaN,NaN,NaN,0.2468947607792978,24.285031189166464,-12231467,-0.07997853794760895,0.08632821659335299,0.16630675454096194
2023-06-26T09:30:00-04:00,9.49,9.735,9.38,9.64,NaN,NaN,NaN,10.156356204473775,NaN,NaN,9.238299999999997,10.18007833910113,8.296521660898865,9.632633933657841,9.585,9.585,9.585,350605,562839.8333333334,52.99335216240118,60.23744899129779,NaN,NaN,NaN,NaN,0.25461656358077644,22.791754268156144,-11880862,-0.06914391673395684,0.0798768586235159,0.14902077535747274
2023-06-26T13:30:00-04:00,9.635,9.73,9.61,9.63,NaN,NaN,NaN,10.156356204473775,NaN,NaN,9.258599999999998,10.189455606418097,8.327744393581899,9.419085717541018,9.615006797769668,9.650363257732423,9.579650337806914,252534,552526.4333333333,52.63504060877527,58.8837348721887,NaN,NaN,NaN,NaN,0.24500109475357817,21.405139984360847,-12133396,-0.06072511829018351,0.07311437749474337,0.13383949578492688
2023-06-27T09:30:00-04:00,9.64,9.95,9.56,9.875,NaN,NaN,NaN,10.156356204473775,NaN,NaN,9.285299999999998,10.208731448457335,8.36186855154266,9.419085717541018,9.795,9.795,9.795,835555,570089.8,59.805637836511586,58.20755998946665,NaN,NaN,NaN,NaN,0.2553581594140368,20.540110673327334,-11297841,-0.03784992898061641,0.08652708455915636,0.12437701353977278
2023-06-27T13:30:00-04:00,9.88,10.02,9.87,9.935,NaN,NaN,NaN,10.156356204473775,NaN,NaN,9.3144,10.2261162716547,8.402683728345298,9.413496663076485,9.858229060211968,9.93086294653557,9.785595173888368,633184,577582.4333333333,61.348866372035175,57.52577306044373,NaN,NaN,NaN,NaN,0.24783257659874844,19.99806728198006,-10664657,-0.018832909328135333,0.1008358768796036,0.11966878620773894
2023-06-28T09:30:00-04:00,10.02,10.52,9.98,10.14,9.466282161974798,9.466282161974798,9.466282161974798,NaN,NaN,NaN,9.343099999999998,10.266545482960417,8.419654517039579,9.742297330461188,10.213333333333333,10.213333333333333,10.213333333333333,1146401,581375.7333333333,66.1332492681485,57.03502323757478,NaN,NaN,NaN,NaN,0.27191596398455203,20.966532308064597,-9518256,0.006065465997560332,0.12725061870468934,0.12118515270712901
2023-06-28T13:30:00-04:00,10.145,10.18,10.1,10.175,9.466282161974798,NaN,NaN,NaN,NaN,NaN,9.371399999999998,10.308262935546091,8.434537064453904,9.742297330461188,10.196313186588794,10.223879294777909,10.16874707839968,437031,582054.0333333333,66.88688689300272,56.74204501569244,NaN,NaN,NaN,NaN,0.2582076808427983,21.86582126085738,-9081225,0.022482119868314693,0.14928780254252239,0.1268056826742077
2023-06-29T09:30:00-04:00,9.95,10.15,9.71,9.95,9.466282161974798,NaN,NaN,NaN,NaN,NaN,9.397399999999998,10.324846472849023,8.469953527150972,9.742297330461188,9.936666666666664,9.936666835254059,9.93666649807927,1005171,592611.5,57.957923982386895,56.2422879127131,NaN,NaN,NaN,NaN,0.2729785607825984,21.018398623148933,-10086396,0.016078173034786564,0.1469033989676909,0.13082522593290433
2023-06-29T13:30:00-04:00,9.96,9.99,9.875,9.97,9.466282161974798,NaN,NaN,NaN,NaN,NaN,9.423199999999998,10.3411057903729,8.505294209627095,9.742297330461188,9.939127016456979,9.942928278597737,9.93532575431622,421093,593609.8666666667,58.48839507343016,55.60168376405742,NaN,NaN,NaN,NaN,0.2616943778695557,20.231506173848235,-9665303,0.011305103490052038,0.1449566052954694,0.13365150180541735
2023-06-30T09:30:00-04:00,10.14,10.14,9.86,9.99,9.466282161974798,NaN,NaN,NaN,NaN,NaN,9.452099999999998,10.348321155742312,8.555878844257684,9.742297330461188,9.996666666666668,9.996666666666668,9.996666666666668,750623,606011.8,59.04490155346695,55.6954204735145,NaN,NaN,NaN,NaN,0.2630019223074446,19.96966026956949,-8914680,0.007778681809608529,0.143374854067428,0.13559617225781948
2023-06-30T13:30:00-04:00,9.99,10.05,9.97,9.97,9.466282161974798,NaN,NaN,NaN,NaN,NaN,9.479299999999997,10.353931373779934,8.60466862622006,9.742297330461188,9.996666666666668,9.996666666666668,9.996666666666668,517735,606305.3666666667,58.20458564310959,55.82430637793986,NaN,NaN,NaN,NaN,0.24993035642834144,19.726517644167803,-9432415,0.0026480599685276274,0.138906247218479,0.13625818724995137
2023-07-03T09:30:00-04:00,10,10.8,9.98,10.67,9.563845782441941,NaN,NaN,NaN,NaN,NaN,9.519299999999998,10.424619855078916,8.61398014492108,9.921750711396419,10.483333333333334,10.483333333333334,10.483333333333334,1561575,643505.5666666667,72.79705597963645,57.851596628177184,NaN,NaN,NaN,NaN,0.29136390239774557,21.272053466591554,-7870840,0.04272359470454243,0.1896626806306294,0.14693908592608698
2023-07-05T09:30:00-04:00,10.72,10.76,10.4,10.75,9.742307337785489,NaN,NaN,NaN,NaN,NaN,9.562499999999998,10.492134874560966,8.63286512543903,9.921750711396419,10.636666666666667,10.636666666666667,10.636666666666667,988167,670856.7666666667,73.91783613688237,59.77644810164935,NaN,NaN,NaN,NaN,0.2962664807979065,22.707193873127892,-6882673,0.06936831956037276,0.23364948537655295,0.16428116581618019
2023-07-05T13:30:00-04:00,10.76,10.76,10.61,10.72,9.86492973152251,NaN,NaN,NaN,NaN,NaN,9.601899999999999,10.557087709301172,8.646712290698826,9.978920455293707,10.654400399969393,10.681778104425748,10.62702269551304,414607,667643.0666666667,72.70806542537869,61.51227623105718,NaN,NaN,NaN,NaN,0.2858188750266275,24.039824250625923,-7297280,0.07902006502407705,0.2630562470962765,0.18403618207219946
2023-07-06T09:30:00-04:00,10.57,10.64,10.195,10.33,9.86492973152251,NaN,NaN,NaN,NaN,NaN,9.631999999999998,10.582202083769596,8.6817979162304,9.978920455293707,10.388333333333334,10.388333333333334,10.388333333333334,748123,679051.7666666667,59.15409150602469,62.29113488865643,NaN,NaN,NaN,NaN,0.3029032410961542,23.55660517854154,-8045403,0.0543605180808871,0.2519868296733083,0.19762631159242122
2023-07-06T13:30:00-04:00,10.33,10.42,10.305,10.42,9.86492973152251,NaN,NaN,NaN,NaN,NaN,9.660499999999999,10.618022323499538,8.70297767650046,9.978920455293707,10.386512255121037,10.38948280987507,10.383541700367005,281161,660586.3666666667,60.96262775566524,62.86036885960386,NaN,NaN,NaN,NaN,0.28948158101785754,23.10790175446318,-7764242,0.03999659199175451,0.24762205158211437,0.20762545959035986
2023-07-07T09:30:00-04:00,10.43,10.91,10.4,10.875,9.86492973152251,NaN,NaN,NaN,NaN,NaN,9.699599999999998,10.692004836747616,8.707195163252381,10.041087273110378,10.728333333333333,10.728333333333333,10.728333333333333,1214250,684713.2,68.5452365754375,63.996811428651164,NaN,NaN,NaN,NaN,0.30523289665943915,23.80920980265382,-6549992,0.05604102930529736,0.2776767462219816,0.2216357169166842
2023-07-07T13:30:00-04:00,10.87,10.885,10.74,10.79,9.96896066318997,NaN,NaN,NaN,NaN,NaN,9.738399999999999,10.746476266956035,8.730323733043962,10.117369818488303,10.749575756042235,10.78388822051936,10.71526329156511,465385,678519.3666666667,65.96737558362938,64.4369355534453,NaN,NaN,NaN,NaN,0.2937876897551934,24.460424418830844,-7015377,0.05571449647233001,0.2912788375070967,0.2355643410347667
2023-07-10T09:30:00-04:00,10.89,11.15,10.54,11.01,9.96896066318997,NaN,NaN,NaN,NaN,NaN,9.780399999999997,10.821370393431131,8.739429606568862,10.230895854790642,10.899999999999999,10.899999999999999,10.899999999999999,1128314,697770.4666666667,69.19640538293217,64.99747405422364,NaN,NaN,NaN,NaN,0.3163742833441083,25.573352438983566,-5887063,0.06448147695764284,0.3161661872318202,0.2516847102741774
2023-07-10T13:30:00-04:00,11.005,11.27,11,11.2,10.250184199311523,NaN,NaN,NaN,NaN,NaN,9.824799999999998,10.913700289282737,8.73589971071726,10.399716683832512,11.01329939753857,11.140749094356467,10.885849700720671,891677,701141.8,71.69425773406564,65.3946889446463,NaN,NaN,NaN,NaN,0.3130618345338148,26.81744117807615,-4995386,0.07642701957266018,0.3472184847400026,0.2707914651673424
2023-07-11T09:30:00-04:00,11.47,12.02,11.33,11.91,10.718584917524636,NaN,NaN,NaN,NaN,NaN,9.882699999999998,11.094177131439169,8.671222868560827,10.91377334706601,11.753333333333336,11.753333333333336,11.753333333333336,2046347,752321.4333333333,78.6585709170514,66.23552351779264,NaN,NaN,NaN,NaN,0.3492717034956852,28.98548879706678,-2949039,0.12274961081662461,0.4242284786881232,0.3014788678714986
2023-07-11T13:30:00-04:00,11.915,11.96,11.66,11.82,10.856149239455334,NaN,NaN,NaN,NaN,NaN,9.937399999999998,11.243176764994729,8.631623235005268,10.925018677652808,11.772666471470567,11.800706051674965,11.744626891266169,972839,757998.0666666667,76.10250789272965,67.53156522567426,NaN,NaN,NaN,NaN,0.3457522961031363,30.99867587184379,-3921878,0.13685686112277012,0.4725499442749612,0.3356930831521911
2023-07-12T09:30:00-04:00,12.05,12.115,11.7,11.95,10.940415183116453,NaN,NaN,NaN,NaN,NaN,9.989799999999997,11.399977237087654,8.57962276291234,11.079514942122247,11.921666666666667,11.921666666666667,11.921666666666667,1161376,754134,77.25237359290861,68.87184940563701,NaN,NaN,NaN,NaN,0.350698560667198,33.04018155990936,-2760502,0.14376059604187702,0.5153938282045374,0.37163323216266037
2023-07-12T13:30:00-04:00,11.945,12,11.84,11.935,10.975055402065706,NaN,NaN,NaN,NaN,NaN,10.047499999999998,11.533208248614168,8.561791751385828,11.091611953697797,11.922792080565058,11.924368412781185,11.921215748348931,591973,760601.6333333333,76.7932281196989,70.13958701751072,NaN,NaN,NaN,NaN,0.33707723490525526,34.9358654131131,-3352475,0.13620618114761063,0.5418909585971736,0.405684777449563
2023-07-13T09:30:00-04:00,12,12.61,11.84,12.5,11.218007429244537,NaN,NaN,NaN,NaN,NaN,10.116699999999998,11.725472960986155,8.507927039013842,11.498289562958236,12.316666666666668,12.316666666666668,12.316666666666668,1344199,788107.4,81.30130776726102,71.78935288352153,NaN,NaN,NaN,NaN,0.36800028955487984,37.28604963449405,-2008276,0.1566894965387976,0.60154664812306,0.4448571515842624
2023-07-13T13:30:00-04:00,12.5,12.61,12.445,12.45,11.543779818824332,NaN,NaN,NaN,NaN,NaN,10.184999999999997,11.89129071380003,8.478709286199964,11.63813165036659,12.402222074705433,12.494461017904616,12.30998313150625,1156458,812166.2666666667,79.82351366925357,72.29124271849419,NaN,NaN,NaN,NaN,0.35350026887238833,39.468363554347796,-3164734,0.15406755854642562,0.6374415997672944,0.4833740412208688
2023-07-14T09:30:00-04:00,12.5,12.505,12.06,12.3,11.543779818824332,NaN,NaN,NaN,NaN,NaN,10.2488,12.026594768807712,8.471005231192287,11.63813165036659,12.288333333333334,12.288333333333334,12.288333333333334,1260414,845010.8333333334,75.39589668212926,72.3968184717261,NaN,NaN,NaN,NaN,0.360035963952932,39.935085250056986,-4425148,0.1303682241661328,0.6463343214285349,0.5159660972624021
2023-07-14T13:30:00-04:00,12.3,12.42,12.265,12.37,11.543779818824332,NaN,NaN,NaN,NaN,NaN,10.309199999999999,12.16427235438408,8.454127645615918,11.63813165036659,12.312219720947702,12.342915731040959,12.281523710854445,763221,825783.9666666667,76.06316035121549,72.63646810928587,NaN,NaN,NaN,NaN,0.34539053795629393,40.36846968178695,-3661927,0.10844309482265346,0.6515199657907189,0.5430768709680655
2023-07-17T09:30:00-04:00,12.33,12.84,12.23,12.69,11.543779818824332,NaN,NaN,NaN,NaN,NaN,10.374999999999998,12.32725510628097,8.422744893719026,11.833003404987695,12.586666666666666,12.586666666666666,12.586666666666666,1163628,848154.6333333333,78.88262406822406,74.04564900658583,NaN,NaN,NaN,NaN,0.36429121381655866,41.316036635449706,-2498299,0.10448660653946251,0.6736851291423935,0.569198522602931
2023-07-17T13:30:00-04:00,12.68,12.71,12.42,12.5,11.557326217662622,NaN,NaN,NaN,NaN,NaN,10.4378,12.456303564524973,8.419296435475026,11.833003404987695,12.567519733679074,12.58903938485206,12.546000082506088,921175,858673.1,73.35761247296065,74.93100505782124,NaN,NaN,NaN,NaN,0.35898469854394743,42.19592023527941,-3419474,0.07921476535724903,0.6682169792994923,0.5890022139422433
2023-07-18T09:30:00-04:00,12.5,12.755,12.39,12.56,11.560856844132504,NaN,NaN,NaN,NaN,NaN,10.498999999999999,12.584501378565859,8.413498621434139,11.833003404987695,12.568333333333335,12.568333333333335,12.568333333333335,995122,880664.7666666667,73.97745859107494,75.31902091608104,NaN,NaN,NaN,NaN,0.35941436293366547,43.070116052893255,-2424352,0.05768153508010909,0.6611041327923797,0.6034225977122706
2023-07-18T13:30:00-04:00,12.56,12.615,12.51,12.6,11.582522442126479,NaN,NaN,NaN,NaN,NaN,10.5613,12.707149771069744,8.415450228930254,11.833003404987695,12.570712093086588,12.573905821382803,12.567518364790372,552054,887379.7333333333,74.4049817181481,75.92170706854667,NaN,NaN,NaN,NaN,0.3412419084384037,43.881869312106105,-1872298,0.03821258003986994,0.651188322762108,0.6129757427222381
2023-07-19T09:30:00-04:00,12.71,13.23,12.69,12.935,11.938657785666186,NaN,NaN,NaN,NaN,NaN,10.631799999999998,12.852049319333336,8.411550680666661,12.26949419468296,12.951666666666668,12.951666666666668,12.951666666666668,1437698,926885.2,77.70811566189005,76.52968637418651,NaN,NaN,NaN,NaN,0.36186748640708916,45.33475577964111,-434600,0.03979718414728517,0.6627222229063445,0.6229250387590594
2023-07-19T13:30:00-04:00,12.94,13.16,12.93,13.12,12.03871879540863,NaN,NaN,NaN,NaN,NaN,10.707799999999997,13.002147105387557,8.413452894612437,12.276595355746368,12.997904611929677,13.05564145118561,12.940167772673744,922059,929768.6666666666,79.29707931786487,77.0727450587436,NaN,NaN,NaN,NaN,0.35244838023515423,46.68386464235218,487459,0.04483132828202163,0.6789641991115865,0.6341328708295648
2023-07-20T09:30:00-04:00,12.95,13.07,12.57,12.96,12.03871879540863,NaN,NaN,NaN,NaN,NaN,10.779799999999998,13.125809343544937,8.43379065645506,12.276595355746368,12.866666666666667,12.866666666666667,12.866666666666667,953243,940437.3,74.36032622670047,76.7657275808614,NaN,NaN,NaN,NaN,0.3665592102183574,46.44373166416417,-465784,0.02964440544042135,0.6711883776300915,0.6415439721896702
2023-07-20T13:30:00-04:00,12.95,13.06,12.785,12.81,12.03871879540863,NaN,NaN,NaN,NaN,NaN,10.842599999999997,13.23408258617959,8.451117413820405,12.276595355746368,12.873377811812661,12.882209470311567,12.864546153313755,550443,920572.0333333333,69.96281029994245,76.32717775280516,NaN,NaN,NaN,NaN,0.36001926663133194,46.220751041561016,-1016227,0.0031500441975065296,0.6454815274365533,0.6423314832390468
2023-07-21T09:30:00-04:00,12.94,12.95,12.655,12.855,12.03871879540863,NaN,NaN,NaN,NaN,NaN,10.9077,13.337245809405545,8.478154190594456,12.276595355746368,12.819999999999999,12.819999999999999,12.819999999999999,525970,923536.6666666666,70.52594458416257,75.84671853789473,NaN,NaN,NaN,NaN,0.3553750333005225,45.49565822024137,-490257,-0.016605457321126393,0.6215746615876387,0.6381801189087651
2023-07-21T13:30:00-04:00,12.86,12.91,12.72,12.76,12.03871879540863,NaN,NaN,NaN,NaN,NaN,10.9658,13.430555046652723,8.501044953347277,12.276595355746368,12.808976265725976,12.820625203403555,12.797327328048397,471027,905731.8666666667,67.64277707462637,75.19311489181813,NaN,NaN,NaN,NaN,0.34356253092191374,44.8223577433017,-961284,-0.039998181822262335,0.5881823916309372,0.6281805734531996
2023-07-24T09:30:00-04:00,12.67,12.93,12.65,12.775,12.03871879540863,NaN,NaN,NaN,NaN,NaN,11.022499999999997,13.52046577238365,8.524534227616344,12.276595355746368,12.784999999999998,12.784999999999998,12.784999999999998,502759,908454.0666666667,67.86615282516077,74.23346096738238,NaN,NaN,NaN,NaN,0.339022350141777,43.89942001225579,-458525,-0.057333254984001436,0.5565140047231978,0.6138472597071992
2023-07-24T13:30:00-04:00,12.78,12.85,12.675,12.73,12.03871879540863,NaN,NaN,NaN,NaN,NaN,11.079299999999998,13.600721829048076,8.55787817095192,12.276595355746368,12.767106932870208,12.783728416550078,12.750485449190338,582626,902854.1666666666,66.38553097197897,73.2736050604342,NaN,NaN,NaN,NaN,0.3273064679887928,43.04240640485602,-1041151,-0.0736611622060519,0.5217708069496343,0.5954319691556862
2023-07-25T09:30:00-04:00,12.72,12.88,12.67,12.75,12.03871879540863,NaN,NaN,NaN,NaN,NaN,11.134899999999998,13.678530861583543,8.591269138416454,12.276595355746368,12.766666666666666,12.766666666666666,12.766666666666666,428478,899878.9333333333,66.73291340947708,72.65482054095905,NaN,NaN,NaN,NaN,0.31892743456102196,42.31955907056527,-612673,-0.08418582461505031,0.49019968838687333,0.5743855130019236
2023-07-25T13:30:00-04:00,12.75,12.755,12.52,12.545,12.03871879540863,NaN,NaN,NaN,NaN,NaN,11.184199999999999,13.739661101249654,8.628738898750344,12.276595355746368,12.695618458184931,12.77511603946023,12.616120876909633,342237,859234.3333333334,59.89984385216441,71.50029793388397,NaN,NaN,NaN,NaN,0.3129326178066633,40.93890029802535,-954910,-0.10468850324373635,0.4435248839472532,0.5482133871909896
2023-07-26T09:30:00-04:00,12.42,12.72,12.4,12.47,12.03871879540863,NaN,NaN,NaN,NaN,NaN,11.232799999999997,13.791796021880494,8.673803978119501,12.276595355746368,12.530000000000001,12.530000000000001,12.530000000000001,588074,845897.9,57.57701615325213,69.97846879710026,NaN,NaN,NaN,NaN,0.3134374308204731,39.125523300780515,-1542984,-0.12183552226834315,0.3959189843555606,0.5177545066239038
2023-07-26T13:30:00-04:00,12.46,12.8,12.44,12.75,12.03871879540863,NaN,NaN,NaN,NaN,NaN,11.289499999999999,13.85481187187837,8.724188128121627,12.203935018349421,12.598122145810168,12.664772922436981,12.531471369183354,614325,852555.1666666666,63.299045907113396,69.2599997566826,NaN,NaN,NaN,NaN,0.31676332861901085,37.69270179619769,-928659,-0.11304744533635613,0.3764451999534586,0.48949264528981473
2023-07-27T09:30:00-04:00,12.91,12.94,12.54,12.58,12.03871879540863,NaN,NaN,NaN,NaN,NaN,11.340699999999996,13.904806089848936,8.776593910151057,12.203935018349421,12.686666666666666,12.686666666666666,12.686666666666666,533629,845405.3666666667,58.169056230687154,68.13082815951203,NaN,NaN,NaN,NaN,0.3227088051462244,36.78265445525288,-1462288,-0.11692472894234385,0.3433367341118849,0.46026146305422877
2023-07-27T13:30:00-04:00,12.57,12.58,12.09,12.24,12.03871879540863,NaN,NaN,NaN,NaN,NaN,11.389699999999998,13.926895625094817,8.852504374905179,12.203935018349421,12.446620113368887,12.632080345441981,12.261159881295793,893982,865832.7333333333,49.52430676962178,66.35363709176015,NaN,NaN,NaN,NaN,0.3346581762072084,34.168012757532864,-2356270,-0.13911966929149316,0.28636187643986233,0.4254815457313555
2023-07-28T09:30:00-04:00,12.45,12.71,12.37,12.645,12.03871879540863,NaN,NaN,NaN,NaN,NaN,11.447499999999998,13.964697052278627,8.93030294772137,12.203935018349421,12.574999999999998,12.574999999999998,12.574999999999998,680728,848048.6666666666,57.60636287931417,64.91779760729045,NaN,NaN,NaN,NaN,0.344325449335265,32.13610195828634,-1675542,-0.12377102515528182,0.27076776428725324,0.39453878944253506
2023-07-28T13:30:00-04:00,12.64,12.74,12.615,12.72,12.03871879540863,NaN,NaN,NaN,NaN,NaN,11.514399999999998,13.985087871828448,9.04371212817155,12.203935018349421,12.622856695616813,12.68024151800001,12.565471873233616,473440,848317.1666666666,58.91820011895628,63.46216337879697,NaN,NaN,NaN,NaN,0.3286593458113175,30.346454952628793,-1202102,-0.10647312074899268,0.26144738850629423,0.3679205092552869
2023-07-31T09:30:00-04:00,12.81,13.015,12.72,12.81,12.03871879540863,NaN,NaN,NaN,NaN,NaN,11.581499999999998,14.00663607865626,9.156363921343736,12.220748141728121,12.848333333333333,12.848333571751912,12.848333094914754,812319,837784,60.49786784144948,62.47198777985049,NaN,NaN,NaN,NaN,0.32625510682479486,29.5118523956301,-389783,-0.08766030376452555,0.25834512954962996,0.3460054333141555
2023-07-31T13:30:00-04:00,12.81,12.875,12.78,12.865,12.03871879540863,NaN,NaN,NaN,NaN,NaN,11.6488,14.02542496831116,9.272175031688839,12.220748141728121,12.845365823981838,12.84935620402008,12.841375443943598,449244,823036.2333333333,61.47283108285766,61.86556069291585,NaN,NaN,NaN,NaN,0.30973688490873813,28.736864306988462,59461,-0.07091799054730319,0.2573579451300265,0.3282759356773297
2023-08-01T09:30:00-04:00,12.69,12.86,12.54,12.775,12.03871879540863,NaN,NaN,NaN,NaN,NaN,11.714399999999998,14.029889270111225,9.39891072988877,12.220748141728121,12.725,12.725,12.725,561654,773546.4666666667,58.9105583969484,61.03589025097199,NaN,NaN,NaN,NaN,0.31082710741525693,27.067773939732977,-502193,-0.06544301351114451,0.24647216878839906,0.31191518229954357
2023-08-01T13:30:00-04:00,12.77,12.89,12.73,12.88,12.03871879540863,NaN,NaN,NaN,NaN,NaN,11.779199999999998,14.039539231177564,9.518860768822432,12.242943048564799,12.773826098579129,12.827728845357889,12.719923351800368,460841,756479.8666666667,60.95528775141062,60.55821244217087,NaN,NaN,NaN,NaN,0.30005374259988143,25.618317234495397,-41352,-0.05472358954190937,0.24351069537215686,0.29823428491406623
2023-08-02T09:30:00-04:00,12.51,12.56,12.18,12.325,12.03871879540863,NaN,NaN,NaN,NaN,NaN,11.833099999999996,14.012966867494523,9.65323313250547,12.242943048564799,12.354999999999999,12.354999999999999,12.354999999999999,722276,741843.2,47.5001308631891,59.10349658774432,NaN,NaN,NaN,NaN,0.32862133241417574,25.034125454945077,-763628,-0.08327390974396687,0.19414189773410762,0.2774158074780745
2023-08-02T13:30:00-04:00,12.325,12.47,12.305,12.45,12.03871879540863,NaN,NaN,NaN,NaN,NaN,11.884599999999999,13.997636525950313,9.771563474049685,12.242943048564799,12.380479171472155,12.407119384802169,12.353838958142141,660691,744133.8,50.16813346175263,57.945111051299584,NaN,NaN,NaN,NaN,0.31693409438459186,24.49166165964835,-102937,-0.09135528036816493,0.1632217070178683,0.25457698738603324
2023-08-03T09:30:00-04:00,11.38,11.8,10.89,11.64,NaN,NaN,NaN,12.46725674653129,12.46725674653129,12.46725674653129,11.9187,13.958548827732137,9.878851172267861,12.242943048564799,11.443333333333333,11.443333333333333,11.443333333333333,1934289,763803.4666666667,37.03429214596086,55.82378096104842,NaN,NaN,NaN,NaN,0.4057245162142638,26.367922337421863,-2037226,-0.14564476965074297,0.07252102532260452,0.21816579497334748
2023-08-03T13:30:00-04:00,11.64,11.74,11.53,11.54,NaN,NaN,NaN,12.46725674653129,NaN,NaN,11.946699999999998,13.925643768781796,9.9677562312182,12.242943048564799,11.500476566502876,11.577141866411145,11.423811266594607,1074616,761075.4,35.78860701367161,54.10154975829893,NaN,NaN,NaN,NaN,0.3917441936275307,28.110164395354413,-3111842,-0.18040817256956881,-0.007344420738613522,0.1730637518309553
2023-08-04T09:30:00-04:00,11.68,11.76,11.395,11.5,NaN,NaN,NaN,12.46725674653129,NaN,NaN,11.973199999999999,13.891078786576534,10.055321213423463,12.242943048564799,11.551666666666668,11.551666666666668,11.551666666666668,980273,751737.3666666667,35.277459550079826,52.50872428664377,NaN,NaN,NaN,NaN,0.38983389408270713,29.878308999699023,-4092115,-0.19687040126677968,-0.07302424975251931,0.12384615151426037
2023-08-04T13:30:00-04:00,11.51,11.52,11.22,11.27,NaN,NaN,NaN,12.460584121865727,NaN,NaN,11.999599999999997,13.84013344441235,10.159066555587644,12.242943048564799,11.453761530983904,11.560832482127257,11.346690579840551,819624,753617.4666666667,32.41099662527154,50.3024350522265,NaN,NaN,NaN,NaN,0.3834171873625137,31.709759167687135,-4911739,-0.21267547994177338,-0.14199819841295636,0.07067728152881703
2023-08-07T09:30:00-04:00,11.33,11.5,11.075,11.3,NaN,NaN,NaN,12.38646666178092,NaN,NaN,12.0262,13.785275393495162,10.267124606504836,12.242943048564799,11.291666666666666,11.291666666666666,11.291666666666666,632054,735898.3333333334,33.17373277723091,48.51705480555105,NaN,NaN,NaN,NaN,0.3863873882651913,33.56240821014011,-4279685,-0.2101628183419514,-0.19202624139862223,0.018136576943329173
2023-08-07T13:30:00-04:00,11.3,11.46,11.29,11.35,NaN,NaN,NaN,12.38646666178092,NaN,NaN,12.0534,13.725607451245263,10.381192548754736,12.242943048564799,11.320766445609173,11.357313487708126,11.284219403510221,400709,718549.4666666667,34.50042506156714,47.44392039783286,NaN,NaN,NaN,NaN,0.3709311462462492,35.28272517813216,-3878976,-0.19454531303359232,-0.22504506434866123,-0.030499751315068914
2023-08-08T09:30:00-04:00,11.09,11.16,10.93,11.015,NaN,NaN,NaN,12.125732020341706,NaN,NaN,12.0743,13.666012298124336,10.482587701875662,12.242943048564799,11.035000000000002,11.035000000000002,11.035000000000002,499652,702033.8,30.177604147964004,45.484723345593565,NaN,NaN,NaN,NaN,0.3744360643715171,37.24647289496078,-4378628,-0.19565903345562724,-0.27507354313460297,-0.07941450967897573
2023-08-08T13:30:00-04:00,11.02,11.16,11.005,11.1,NaN,NaN,NaN,12.125732020341706,NaN,NaN,12.0829,13.648603790632194,10.517196209367807,11.693383551081471,11.05696531184069,11.083214280847859,11.030716342833522,349879,695294.6333333333,32.489009322188735,43.596924002967306,NaN,NaN,NaN,NaN,0.3587620597735515,39.06995291773021,-4028749,-0.17995181364449347,-0.3043542767345926,-0.12440246309009911
2023-08-09T09:30:00-04:00,11.04,11.1,10.75,10.95,NaN,NaN,NaN,11.977619464815481,NaN,NaN,12.0869,13.639933019610343,10.533866980389657,11.693383551081471,10.933333333333332,10.933333333333332,10.933333333333332,660913,669401.8,30.566018453846553,41.45893476099567,NaN,NaN,NaN,NaN,0.35813619836115496,41.003742012100304,-4689662,-0.16911195720176866,-0.33579240959230994,-0.16668045239054127
2023-08-09T13:30:00-04:00,10.96,10.98,10.76,10.81,NaN,NaN,NaN,11.904773125505688,NaN,NaN,12.0887,13.635588244185762,10.541811755814237,10.596672378153713,10.898067840287286,10.939239870689077,10.856895809885495,484886,654829.3666666667,28.849678952832264,39.128709608851004,NaN,NaN,NaN,NaN,0.3482693270496439,42.799403314015386,-5174548,-0.16086749601213282,-0.3677648224057073,-0.20689732639357447
2023-08-10T09:30:00-04:00,10.92,11.1,10.75,10.75,NaN,NaN,NaN,11.904773125505688,NaN,NaN,12.097099999999998,13.609881663030185,10.58431833696981,10.596672378153713,10.866666666666667,10.866666666666667,10.866666666666667,479645,639042.7666666667,28.120890808749778,36.92944763826539,NaN,NaN,NaN,NaN,0.3483929465460979,43.90840024203004,-5654193,-0.14920990389588734,-0.39340970626343363,-0.2441998023675463
2023-08-10T13:30:00-04:00,10.75,10.79,10.665,10.735,NaN,NaN,NaN,11.73294410815704,NaN,NaN,12.103399999999999,13.590599300699193,10.616200699300805,10.596672378153713,10.804671059875986,10.872709855182423,10.736632264569549,398225,633968.8333333334,27.93092722261386,34.57056474335133,NaN,NaN,NaN,NaN,0.3324363075070909,45.0413272729809,-6052418,-0.13281226325533202,-0.4102151314367113,-0.27740286818137927
2023-08-11T09:30:00-04:00,10.58,10.79,10.58,10.69,NaN,NaN,NaN,11.673378466877175,NaN,NaN,12.099699999999999,13.599968522631961,10.599431477368036,10.5133762576147,10.686666666666664,10.68666687314321,10.686666460190118,463050,631871.5,27.33436437515607,33.130152851348974,NaN,NaN,NaN,NaN,0.32369085697087,46.1967030871981,-6515468,-0.11591506734934737,-0.4222967023680635,-0.3063816350187161
2023-08-11T13:30:00-04:00,10.69,10.75,10.615,10.72,NaN,NaN,NaN,11.644361263837304,NaN,NaN,12.0983,13.60357686489898,10.59302313510102,10.5133762576147,10.689979109713363,10.694057272679045,10.685900946747681,305489,626353.5666666667,28.43181322667364,31.57755854884334,NaN,NaN,NaN,NaN,0.31021293861580784,47.269552057542654,-6209979,-0.09454002013964719,-0.4245566601932751,-0.3300166400536279
2023-08-14T09:30:00-04:00,10.68,10.68,10.515,10.58,NaN,NaN,NaN,11.543594842753789,NaN,NaN,12.089699999999999,13.624375744253507,10.55502425574649,10.5133762576147,10.591666666666667,10.591666666666667,10.591666666666667,468845,625223.1,26.42605316154824,30.819827192813857,NaN,NaN,NaN,NaN,0.3026977287146787,48.39537750782567,-6678824,-0.08211238479812305,-0.43265712105128173,-0.3505447362531587
2023-08-14T13:30:00-04:00,10.575,10.66,10.54,10.65,NaN,NaN,NaN,11.519454168083163,NaN,NaN,12.0787,13.646258368929255,10.511141631070744,10.308660804873409,10.601712780688034,10.613969552025367,10.589456009350702,314973,616301.3333333334,29.118588833078647,30.343397322771505,NaN,NaN,NaN,NaN,0.28964789094934457,49.44078685451704,-6363851,-0.062355430919403765,-0.42848902490241336,-0.3661335939830096
2023-08-15T09:30:00-04:00,10.55,10.6,10.4,10.455,NaN,NaN,NaN,11.411751705897565,NaN,NaN,12.049599999999998,13.681313013982612,10.417886986017384,10.308660804873409,10.485,10.485,10.485,293045,611786.9,26.237951462277323,29.697718173642755,NaN,NaN,NaN,NaN,0.2868158987386771,50.59795735219846,-6656896,-0.05580985461461435,-0.43589591225127755,-0.3800860576366632
2023-08-15T13:30:00-04:00,10.46,10.535,10.395,10.41,NaN,NaN,NaN,11.354399355629493,NaN,NaN,12.021399999999998,13.715552342618631,10.327247657381365,10.289114332095185,10.464102754939379,10.483191133853444,10.445014376025314,351216,612086.2,25.60835463935689,29.211815174648855,NaN,NaN,NaN,NaN,0.27632904882877163,51.67911902644872,-7008112,-0.048188192231709115,-0.4403212979262996,-0.3921331056945905
2023-08-16T09:30:00-04:00,10.34,10.42,10.16,10.25,NaN,NaN,NaN,11.174426657646334,NaN,NaN,11.987400000000001,13.752661725637283,10.222138274362718,10.289114332095185,10.276666666666666,10.276666666666666,10.276666666666666,294488,602300,23.45343438565199,28.51750814667893,NaN,NaN,NaN,NaN,0.2751626881981451,52.978101962623604,-7302600,-0.047520800780070094,-0.4515341066696781,-0.404013305889608
2023-08-16T13:30:00-04:00,10.245,10.31,10.17,10.185,NaN,NaN,NaN,11.103316355026047,NaN,NaN,11.9524,13.788406797373018,10.116393202626984,10.289114332095185,10.250693833868887,10.278151396767564,10.22323627097021,263501,590605.8666666667,22.620649831258447,27.668952773085458,NaN,NaN,NaN,NaN,0.26550821046970624,54.18430040335743,-7566101,-0.04507620980411231,-0.4603585681447484,-0.4152823583406361
2023-08-17T09:30:00-04:00,10.26,10.31,10.07,10.15,NaN,NaN,NaN,11.046801975252137,NaN,NaN,11.9054,13.802236144742123,10.008563855257878,10.143326538032735,10.176666666666668,10.176666666666668,10.176666666666668,397348,586063.1666666666,22.164277646045193,27.096572308662683,NaN,NaN,NaN,NaN,0.26368619543615585,55.425208712297206,-7963449,-0.03962858638019118,-0.46481809131587504,-0.42518950493568386
2023-08-17T13:30:00-04:00,10.145,10.145,10.05,10.07,NaN,NaN,NaN,10.928992794558857,NaN,NaN,11.8578,13.816037125580092,9.899562874419907,10.143326538032735,10.132542501540854,10.176709147757897,10.088375855323811,396584,569483.2333333333,21.115641102387556,26.284188864391176,NaN,NaN,NaN,NaN,0.25199432433357327,56.601758179063225,-8360033,-0.035365767125341674,-0.4693967138423609,-0.43403094671701925
2023-08-18T09:30:00-04:00,9.87,10.3,9.84,10.145,NaN,NaN,NaN,10.926424940260727,NaN,NaN,11.8147,13.826245087737313,9.803154912262688,10.143326538032735,10.095,10.095,10.095,582739,566216.9333333333,24.711921765940232,25.866039100969296,NaN,NaN,NaN,NaN,0.26685187259546095,57.933221877301314,-7777294,-0.022096680570732108,-0.4616517974304344,-0.4395551168597023
2023-08-18T13:30:00-04:00,10.15,10.29,10.13,10.24,NaN,NaN,NaN,10.926424940260727,NaN,NaN,11.7721,13.824601001217825,9.719598998782175,10.12972898434095,10.150998000295552,10.21315887223142,10.088837128359684,472917,566199.5,29.119848238982556,25.885336907122888,NaN,NaN,NaN,NaN,0.2592195959814993,59.16958102566525,-7304377,-0.002551511515271776,-0.442744506253792,-0.44019299473852025
2023-08-21T09:30:00-04:00,10.31,10.325,10.13,10.28,NaN,NaN,NaN,10.926424940260727,NaN,NaN,11.7239,13.800958776250713,9.646841223749288,10.12972898434095,10.245,10.245,10.245,417580,553041.5333333333,30.952899644467053,26.087623252531266,NaN,NaN,NaN,NaN,0.2546324819828207,60.036091169362805,-6886797,0.016398638305940683,-0.4196946968560944,-0.4360933351620351
2023-08-21T13:30:00-04:00,10.27,10.445,10.27,10.4,NaN,NaN,NaN,10.926424940260727,NaN,NaN,11.6819,13.779314494085535,9.584485505914467,10.05078318747276,10.30015296223637,10.362955769815725,10.237350154657014,322047,548801.6333333333,36.27706702763181,26.683776095746833,NaN,NaN,NaN,NaN,0.24894444755547637,59.90248176639259,-6564750,0.039050480722908176,-0.38728023425839986,-0.42633071498130803
2023-08-22T09:30:00-04:00,10.5,10.6,10.32,10.395,NaN,NaN,NaN,10.926424940260727,NaN,NaN,11.638600000000002,13.75105169412226,9.526148305877744,10.039733328034554,10.438333333333334,10.438333333333334,10.438333333333334,382744,542837.9666666667,36.151980139938416,27.313605793231286,NaN,NaN,NaN,NaN,0.25116270130151375,58.689535574515595,-6947494,0.054768813413424766,-0.3578696982145271,-0.41263851162795184
2023-08-22T13:30:00-04:00,10.4,10.45,10.34,10.38,NaN,NaN,NaN,10.926424940260727,NaN,NaN,11.5942,13.71725191646368,9.471148083536322,10.039733328034554,10.41528172202892,10.439422650538953,10.391140793518888,348982,539109.3333333334,35.753683766458764,27.83659654607308,NaN,NaN,NaN,NaN,0.24107965120854843,57.5632283963441,-7296476,0.06455436971632056,-0.33194554948255117,-0.39649991919887173
2023-08-23T09:30:00-04:00,10.4,10.6,10.34,10.505,NaN,NaN,NaN,10.926424940260727,NaN,NaN,11.545600000000002,13.654863037176725,9.43633696282328,10.067429329942115,10.481666666666667,10.481666666666667,10.481666666666667,408796,528660,41.53435711590584,28.915761114241473,NaN,NaN,NaN,NaN,0.2424311046936521,55.520852388322396,-6887680,0.07889574215305234,-0.2978802415075563,-0.37677598366060866
2023-08-23T13:30:00-04:00,10.51,10.54,10.45,10.505,NaN,NaN,NaN,10.926424940260727,NaN,NaN,11.493300000000001,13.57329481730126,9.413305182698743,10.06894346395369,10.489048790658314,10.497327658047102,10.480769923269527,325033,517471.4,41.53435711590584,29.80260170587199,NaN,NaN,NaN,NaN,0.23154316864410548,53.62436038087366,-6887680,0.08718378610797922,-0.26779625102563465,-0.35498003713361387
2023-08-24T09:30:00-04:00,10.51,10.52,10.27,10.39,NaN,NaN,NaN,10.926424940260727,NaN,NaN,11.441900000000002,13.501292036500086,9.382507963499918,10.06894346395369,10.393333333333333,10.393333333333333,10.393333333333333,467050,468563.43333333335,37.89618772763447,30.635332867683214,NaN,NaN,NaN,NaN,0.2328615137409551,52.47015180236586,-7354730,0.0837055072604706,-0.2503481530580256,-0.3340536603184962
2023-08-24T13:30:00-04:00,10.39,10.46,10.37,10.38,NaN,NaN,NaN,10.926424940260727,NaN,NaN,11.393300000000004,13.43587740122617,9.350722598773837,10.06894346395369,10.397801996989475,10.402773685000883,10.392830308978068,377321,445320.26666666666,37.58786191245072,31.49101195861849,NaN,NaN,NaN,NaN,0.22265711990231557,51.398386693751476,-7732051,0.07954473527464245,-0.2346227412251931,-0.31416747649983556
2023-08-25T09:30:00-04:00,10.39,10.59,10.33,10.55,NaN,NaN,NaN,10.926424940260727,NaN,NaN,11.347200000000004,13.359558973940707,9.334841026059301,10.10281905354429,10.49,10.49,10.49,372688,425067.43333333335,45.679099128183275,33.07855944022787,NaN,NaN,NaN,NaN,0.2253244684807216,49.509073959383834,-7359363,0.08648018529989593,-0.20606724487496564,-0.29254743017486157
2023-08-25T13:30:00-04:00,10.54,10.57,10.5,10.54,NaN,NaN,NaN,10.926424940260727,NaN,NaN,11.302800000000005,13.286268840188756,9.319331159811254,10.145255242835432,10.514442519181287,10.537749474177451,10.491135564185123,409889,411409.6,45.30700995200766,34.699013734567096,NaN,NaN,NaN,NaN,0.2142298635892415,47.754712134613875,-7769252,0.08832267923891923,-0.1821440811262125,-0.27046676036513173
2023-08-28T09:30:00-04:00,10.63,10.72,10.51,10.625,NaN,NaN,NaN,10.926424940260727,NaN,NaN,11.259800000000006,13.206621984671331,9.31297801532868,10.275204194268346,10.618333333333334,10.618333333333334,10.618333333333334,325631,401195.5,49.102188598624515,36.623150231179906,NaN,NaN,NaN,NaN,0.21392773047572433,45.15625960000489,-7443621,0.09273779320404013,-0.15454451886008158,-0.2472823120641217
2023-08-28T13:30:00-04:00,10.625,10.64,10.54,10.55,NaN,NaN,NaN,10.926424940260727,NaN,NaN,11.216200000000004,13.126670685459443,9.305729314540566,10.275204194268346,10.596111075283302,10.61689805837189,10.575324092194714,372151,400243.56666666665,46.064823557204065,38.40523469223823,NaN,NaN,NaN,NaN,0.20579003544174412,42.743410817867975,-7815772,0.08811173359144059,-0.137142645074821,-0.22525437866626158
2023-08-29T09:30:00-04:00,10.47,11.05,10.45,11.01,10.000717452313424,10.000717452313424,10.000717452313424,NaN,NaN,NaN,11.181400000000004,13.041575303566827,9.32122469643318,10.42533068433174,10.836666666666666,10.836666666666666,10.836666666666666,631185,404628,61.70954714560049,41.04792221935681,NaN,NaN,NaN,NaN,0.23394789005304822,40.91534702030394,-7184587,0.11200297290448097,-0.08525066253566038,-0.19725363544014135
2023-08-29T13:30:00-04:00,11.005,11.08,10.93,11.02,10.269321204480995,NaN,NaN,NaN,NaN,NaN,11.150900000000004,12.970202822511949,9.331597177488058,10.50526454746539,10.908125565682488,10.993447514290018,10.822803617074957,442739,407723.3333333333,61.96781710554159,43.394205709825314,NaN,NaN,NaN,NaN,0.2279516121921162,39.33493502999568,-6741848,0.12354265831996547,-0.04282531254018451,-0.16636797086014998
2023-08-30T09:30:00-04:00,10.95,11.15,10.92,11.085,10.301397513368224,NaN,NaN,NaN,NaN,NaN,11.123200000000004,12.903070512144033,9.343329487855975,10.575211637972313,11.051666666666666,11.051666873143212,11.05166646019012,449850,400687.9,63.68255113330112,45.73203795902776,NaN,NaN,NaN,NaN,0.22809792560696507,38.14212324445979,-6291998,0.12996409246546908,-0.003912855278313643,-0.13387694774378273
2023-08-30T13:30:00-04:00,11.09,11.13,10.97,11.06,10.327924899124215,NaN,NaN,NaN,NaN,NaN,11.089400000000005,12.807529960160114,9.371270039839896,10.590169310377851,11.052476683744432,11.05330969086238,11.051643676626485,425362,398703.76666666666,62.51509190426436,47.60618259307294,NaN,NaN,NaN,NaN,0.22323378806361044,37.034512300747885,-6717360,0.1268010794837791,0.02462440161094115,-0.10217667787283795
2023-08-31T09:30:00-04:00,11.12,11.17,10.77,10.85,10.327924899124215,NaN,NaN,NaN,NaN,NaN,11.054800000000006,12.720337702965544,9.389262297034467,10.590169310377851,10.93,10.93,10.93,710607,406402.5,53.622430892122246,48.854071932514636,NaN,NaN,NaN,NaN,0.23585994605906688,34.81784185207869,-7427967,0.10570125797585705,0.029949894596983384,-0.07575136337887367
2023-08-31T13:30:00-04:00,10.855,10.955,10.825,10.9,10.327924899124215,NaN,NaN,NaN,NaN,NaN,11.028000000000006,12.659160323205459,9.396839676794553,10.590169310377851,10.909143716190181,10.927302621223383,10.89098481115698,937398,424374.93333333335,55.254474900244965,50.246985584927934,NaN,NaN,NaN,NaN,0.22829852134056217,32.759505006885874,-6490569,0.09081675793116632,0.037769584035084236,-0.05304717389608209
2023-09-01T09:30:00-04:00,11.16,11.365,11.125,11.19,10.486951774116205,NaN,NaN,NaN,NaN,NaN,10.998900000000006,12.56421822962607,9.433581770373943,10.676106686913458,11.226666666666667,11.226666666666667,11.226666666666667,648405,430553.43333333335,63.317461576591825,51.80292161783408,NaN,NaN,NaN,NaN,0.2452057698162363,32.485451921600145,-5842164,0.0957174206112294,0.06659960186795466,-0.029117818743274737
2023-09-01T13:30:00-04:00,11.185,11.205,11.06,11.12,10.486951774116205,NaN,NaN,NaN,NaN,NaN,10.966900000000008,12.453615695753381,9.480184304246634,10.676106686913458,11.190895591585864,11.238202242673546,11.143588940498182,370737,432728.36666666664,60.484285204682834,53.15648790988958,NaN,NaN,NaN,NaN,0.23804821482936225,31.862909501311538,-6212901,0.08956962081164437,0.08284420727128072,-0.006725413540363642
2023-09-05T09:30:00-04:00,11.02,11.02,10.68,10.7,10.486951774116205,NaN,NaN,NaN,NaN,NaN,10.924700000000007,12.316510921066373,9.532889078933641,10.676106686913458,10.799999999999999,10.799999999999999,10.799999999999999,628116,438037.4,46.91885782593654,53.800964345482576,NaN,NaN,NaN,NaN,0.25247334234155067,29.666540675693494,-6841017,0.05427880697827131,0.061123095182475495,0.006844288204204185
2023-09-05T13:30:00-04:00,10.7,10.83,10.66,10.83,10.486951774116205,NaN,NaN,NaN,NaN,NaN,10.884000000000006,12.16073333159267,9.607266668407341,10.676106686913458,10.789617274900852,10.802620031871223,10.776614517930481,400490,440887.9666666667,50.61116999427705,54.7312006370416,NaN,NaN,NaN,NaN,0.24658238931715418,27.70663761949273,-6440527,0.037547722038113164,0.05377894075184564,0.016231218713732475
2023-09-06T09:30:00-04:00,10.78,10.93,10.7,10.77,10.486951774116205,NaN,NaN,NaN,NaN,NaN,10.843900000000009,12.000872411079662,9.686927588920355,10.676106686913458,10.799999999999999,10.799999999999999,10.799999999999999,404216,444593.6666666667,48.91981210291733,54.962680135236894,NaN,NaN,NaN,NaN,0.24539793293735748,25.98611846297878,-6844743,0.02111565174688817,0.04262578339734269,0.02151013165045452
2023-09-06T13:30:00-04:00,10.77,10.81,10.74,10.8,10.486951774116205,NaN,NaN,NaN,NaN,NaN,10.802300000000008,11.80238041676637,9.802219583233645,10.676106686913458,10.792985764064005,10.801214034020973,10.784757494107037,293736,442677.6666666667,49.822735293832494,55.28523194536724,NaN,NaN,NaN,NaN,0.23286950915611768,24.38849353193011,-6551007,0.011427857224113807,0.03579495318059678,0.02436709595648297
2023-09-07T09:30:00-04:00,10.6,10.685,10.525,10.66,10.486951774116205,NaN,NaN,NaN,NaN,NaN,10.769000000000007,11.67003052112551,9.867969478874505,10.676106686913458,10.623333333333333,10.623333333333333,10.623333333333333,319756,443519.93333333335,45.75778895552631,55.04634625657451,NaN,NaN,NaN,NaN,0.2358788299306807,23.311781057011487,-6870763,-0.004399954955358578,0.018867152262284748,0.023267107217643326
2023-09-07T13:30:00-04:00,10.665,10.77,10.64,10.74,10.486951774116205,NaN,NaN,NaN,NaN,NaN,10.734800000000007,11.497154143426574,9.97244585657344,10.676106686913458,10.663108216189507,10.709263184434372,10.616953247944641,237465,442652.06666666665,48.350988284337745,55.20964373708406,NaN,NaN,NaN,NaN,0.22831605636420346,21.917959206393895,-6633298,-0.009196576754223404,0.01177138627486407,0.020967963029087475
2023-09-08T09:30:00-04:00,10.67,10.76,10.515,10.75,10.486951774116205,NaN,NaN,NaN,NaN,NaN,10.717000000000008,11.434205688766951,9.999794311233064,10.676106686913458,10.674999999999999,10.674999999999999,10.674999999999999,285598,438927.06666666665,48.681258349099146,54.27905168019111,NaN,NaN,NaN,NaN,0.22950776662390315,21.132213266152984,-6347700,-0.011273890899995233,0.006875599404093435,0.018149490304088668
2023-09-08T13:30:00-04:00,10.745,10.8,10.73,10.745,10.486951774116205,NaN,NaN,NaN,NaN,NaN,10.701100000000006,11.378779245661097,10.023420754338915,10.676106686913458,10.72016364167069,10.761683303000234,10.678643980341144,337929,436971.9,48.51421434711756,53.318080054589394,NaN,NaN,NaN,NaN,0.21811435472219579,20.205567279464134,-6685629,-0.0124694689298597,0.0025626541417640425,0.015032123071623743
2023-09-11T09:30:00-04:00,10.86,10.9,10.715,10.855,10.486951774116205,NaN,NaN,NaN,NaN,NaN,10.688200000000005,11.32805860938161,10.0483413906184,10.581385349530768,10.823333333333332,10.823333333333332,10.823333333333332,446770,432439.6,52.385174095493156,52.51112455188882,NaN,NaN,NaN,NaN,0.2157490436706104,18.86030963359091,-6238859,-0.00568226588738272,0.007929290712395343,0.013611556599778063
2023-09-11T13:30:00-04:00,10.855,10.88,10.815,10.85,10.486951774116205,NaN,NaN,NaN,NaN,NaN,10.679800000000007,11.29959983865731,10.060000161342705,10.472659065013204,10.833515975828972,10.845799291920457,10.821232659737486,307025,426909.86666666664,52.19308342687537,51.77383823207532,NaN,NaN,NaN,NaN,0.20498125483699545,17.611141819565766,-6545884,-0.0015734870254058998,0.011644697818020688,0.013218184843426588
2023-09-12T09:30:00-04:00,10.8,11.01,10.8,10.94,10.486951774116205,NaN,NaN,NaN,NaN,NaN,10.672600000000006,11.271422978850751,10.073777021149262,10.579127252010563,10.916666666666666,10.916666666666666,10.916666666666666,353302,424767.26666666666,55.36574231869593,51.89836047683058,NaN,NaN,NaN,NaN,0.20533973663435284,16.881056598579413,-6192582,0.006707382830444019,0.02160241338148161,0.014895030551037592
2023-09-12T13:30:00-04:00,10.945,10.95,10.79,10.79,10.486951774116205,NaN,NaN,NaN,NaN,NaN,10.661400000000006,11.229273366165234,10.093526633834777,10.579127252010563,10.882532925029679,10.91911200013072,10.845953849928637,307644,424287.1666666667,49.472795376388795,51.48538336798372,NaN,NaN,NaN,NaN,0.20210118401761337,16.14858733478366,-6500226,0.001837614814613699,0.017192049069304716,0.015354434254691017
2023-09-13T09:30:00-04:00,10.73,10.81,10.6,10.75,10.486951774116205,NaN,NaN,NaN,NaN,NaN,10.656100000000006,11.21555791620085,10.09664208379916,10.579127252010563,10.719999999999999,10.719999999999999,10.719999999999999,226370,419074.7,48.00544011012134,50.39166754895012,NaN,NaN,NaN,NaN,0.20266538515921248,15.48899740078695,-6726596,-0.004003682238625437,0.01034983145640922,0.014353513695034657
2023-09-13T13:30:00-04:00,10.75,10.78,10.59,10.605,10.486951774116205,NaN,NaN,NaN,NaN,NaN,10.646200000000006,11.19121948589002,10.101180514109991,10.579127252010563,10.683559871573616,10.713879144209919,10.653240598937312,326995,418341.8,43.023821221165214,49.14449155012743,NaN,NaN,NaN,NaN,0.20176071479069727,14.924038223069044,-7053591,-0.016839433926220584,-0.006695778712741074,0.01014365521347951
2023-09-14T09:30:00-04:00,10.66,10.66,10.42,10.47,NaN,NaN,NaN,11.195111602190401,11.195111602190401,11.195111602190401,10.636600000000005,11.176764567516082,10.096435432483927,10.579127252010563,10.516666666666666,10.516666666666666,10.516666666666666,432041,419116.63333333336,38.96918566980341,48.57665782468935,NaN,NaN,NaN,NaN,0.20449209230564747,15.163215612871253,-7485632,-0.03270974584562671,-0.03074352709355388,0.0019662187520728316
2023-09-14T13:30:00-04:00,10.47,10.57,10.47,10.56,NaN,NaN,NaN,11.158970165727201,NaN,NaN,10.631600000000006,11.169876657491008,10.093323342509004,10.579127252010563,10.524477199464254,10.532794117406224,10.516160281522284,381032,420983.26666666666,42.8368804094909,48.02135142577605,NaN,NaN,NaN,NaN,0.19702837142667265,15.385308903401876,-7104600,-0.03521658686761173,-0.042054514832441825,-0.0068379279648301
2023-09-15T09:30:00-04:00,10.46,10.68,10.44,10.64,NaN,NaN,NaN,11.158970165727201,NaN,NaN,10.629400000000006,11.166621146270122,10.092178853729889,10.579127252010563,10.586666666666666,10.586666666666666,10.586666666666666,341216,416788.8,46.106317927572974,47.82038755610859,NaN,NaN,NaN,NaN,0.2000977734676246,14.91663881962868,-6763384,-0.029773961388935684,-0.04405537970099971,-0.014281418312064023
2023-09-15T13:30:00-04:00,10.64,10.695,10.58,10.665,NaN,NaN,NaN,11.158970165727201,NaN,NaN,10.628000000000004,11.16447739933745,10.091522600662557,10.579127252010563,10.618472007040072,10.648417636873392,10.588526377206753,384913,417041.86666666664,47.12408804642444,47.627627038436586,NaN,NaN,NaN,NaN,0.19401936107708,14.391309327502913,-6378471,-0.02307618636482301,-0.043126651268092786,-0.020050464903269775
2023-09-18T09:30:00-04:00,10.66,10.79,10.58,10.73,NaN,NaN,NaN,11.158970165727201,NaN,NaN,10.628800000000005,11.165763909401475,10.091836090598536,10.579127252010563,10.699999999999998,10.699999999999998,10.699999999999998,375562,417137.6666666667,49.77961032664651,47.9148999935166,NaN,NaN,NaN,NaN,0.19516083528585995,13.386321969579448,-6002909,-0.01333751450696586,-0.0367223580369771,-0.02338484353001124
2023-09-18T13:30:00-04:00,10.73,10.75,10.58,10.6,NaN,NaN,NaN,11.158970165727201,NaN,NaN,10.626400000000006,11.162784339815905,10.090015660184106,10.579127252010563,10.67433794817181,10.702545075514749,10.646130820828873,310847,413836.26666666666,44.92055472588176,47.669869025055455,NaN,NaN,NaN,NaN,0.19336363276544138,12.453119422936231,-6313756,-0.014617430247840707,-0.04165663133981212,-0.027039201091971415
2023-09-19T09:30:00-04:00,10.59,10.6,10.36,10.505,NaN,NaN,NaN,11.10812209385859,NaN,NaN,10.624900000000004,11.162213651417726,10.087586348582281,10.52530180160845,10.488333333333335,10.488333333333335,10.488333333333335,285294,412491.7,41.71599809206197,47.17235043526709,NaN,NaN,NaN,NaN,0.19669480185362415,12.719220438158816,-6599050,-0.020469553618034132,-0.05262614311451408,-0.03215658949647995
2023-09-19T13:30:00-04:00,10.51,10.56,10.425,10.46,NaN,NaN,NaN,11.10812209385859,NaN,NaN,10.621100000000006,11.160333863921524,10.081866136078487,10.365241441286761,10.484667270901996,10.487983956357299,10.481350585446693,348565,411705.5,40.251208138710176,46.58213570609514,NaN,NaN,NaN,NaN,0.19228803029265099,12.966314238008358,-6947615,-0.025643132730518464,-0.06421050540962803,-0.03856737267910956
2023-09-20T09:30:00-04:00,10.48,10.65,10.43,10.455,NaN,NaN,NaN,11.10812209385859,NaN,NaN,10.621100000000006,11.160333863921524,10.081866136078487,10.339727612384676,10.511666666666665,10.511666666666665,10.511666666666665,213305,397776.1666666667,40.08279619119898,45.703394427216985,NaN,NaN,NaN,NaN,0.19426745670031884,12.595075392413602,-7160920,-0.02750905344257417,-0.07295368948232728,-0.04544463603975311
2023-09-20T13:30:00-04:00,10.46,10.495,10.21,10.22,NaN,NaN,NaN,10.983076982646917,NaN,NaN,10.617300000000007,11.1650415814046,10.069558418595415,10.339727612384676,10.38864370295618,10.488041991108727,10.289245414803634,326750,393909.86666666664,33.0777303497204,44.338012064563046,NaN,NaN,NaN,NaN,0.20074835265029595,13.30477263394142,-7487670,-0.04181934728297777,-0.09771882014347533,-0.055899472860497554
2023-09-21T09:30:00-04:00,10.02,10.02,9.82,9.94,NaN,NaN,NaN,10.576459847072059,NaN,NaN,10.611100000000008,11.181865415910544,10.040334584089472,10.339727612384676,9.926666666666668,9.926666666666668,9.926666666666668,558704,397538.3333333333,27.01880957161852,42.31323115405752,NaN,NaN,NaN,NaN,0.2149806131752748,15.258855869646546,-8046374,-0.06595584398306045,-0.13834427783932313,-0.07238843385626267
2023-09-21T13:30:00-04:00,9.93,9.97,9.82,9.84,NaN,NaN,NaN,10.542075308568783,NaN,NaN,10.604200000000008,11.203053437828974,10.005346562171042,10.339727612384676,9.907326178949592,9.9316771526609,9.882975205238285,352439,395107.56666666665,25.240588699538534,40.58235924856821,NaN,NaN,NaN,NaN,0.21033914080561233,17.07336173137273,-8398813,-0.08334843303260328,-0.17657397514701678,-0.0932255421144135
2023-09-22T09:30:00-04:00,9.93,9.97,9.73,9.75,NaN,NaN,NaN,10.500390067270203,NaN,NaN,10.596200000000009,11.228843849254476,9.963556150745541,10.339727612384676,9.816666666666668,9.816666666666668,9.816666666666668,317859,382015.9666666667,23.727060150905757,38.848189251481394,NaN,NaN,NaN,NaN,0.21245777360521148,19.008100214074712,-8716672,-0.09477417858341164,-0.21169326534367805,-0.11691908676026641
2023-09-22T13:30:00-04:00,9.745,9.765,9.645,9.695,NaN,NaN,NaN,10.34219051875792,NaN,NaN,10.588700000000008,11.254158668889044,9.923241331110972,10.339727612384676,9.752809510418022,9.809957008739678,9.695662012096365,396880,363998.7,22.826255390361226,37.405505977852535,NaN,NaN,NaN,NaN,0.20585364691912503,21.030249148324625,-9113552,-0.09941143800680222,-0.24118338426876917,-0.14177194626196696
2023-09-25T09:30:00-04:00,9.56,9.765,9.55,9.705,NaN,NaN,NaN,10.295045495178016,NaN,NaN,10.57990000000001,11.279364051970822,9.880435948029197,10.304782089907741,9.673333333333334,9.673333333333334,9.673333333333334,228186,349991.4,23.395713532598393,36.29311511090932,NaN,NaN,NaN,NaN,0.20650695785347323,23.147814144766894,-8885366,-0.09517598611444378,-0.2607419289050217,-0.1655659427905779
2023-09-25T13:30:00-04:00,9.705,9.725,9.63,9.68,NaN,NaN,NaN,10.295045495178016,NaN,NaN,10.568700000000009,11.30646096399813,9.830939036001887,10.181248430032763,9.675332867851322,9.677782262533556,9.672883473169088,152065,342702.3333333333,22.939981054086843,34.87190801409474,NaN,NaN,NaN,NaN,0.19854217514965364,25.11412449860615,-9037431,-0.0876180129584477,-0.27508845898863754,-0.18747044603018984
2023-09-26T09:30:00-04:00,9.62,9.77,9.585,9.615,NaN,NaN,NaN,10.295045495178016,NaN,NaN,10.55540000000001,11.336219671882963,9.774580328117056,10.181248430032763,9.656666666666666,9.656666666666666,9.656666666666666,319751,332423.5,21.753499867606934,33.13242100981146,NaN,NaN,NaN,NaN,0.1975748769246783,26.93998411288546,-9357182,-0.0807267566620056,-0.28837889185769683,-0.20765213519569123
2023-09-26T13:30:00-04:00,9.61,9.62,9.49,9.54,NaN,NaN,NaN,10.16311080304692,NaN,NaN,10.53820000000001,11.368288573586844,9.708111426413177,10.181248430032763,9.590866256487677,9.642721983648487,9.539010529326868,514844,336235.3,20.439854350179786,31.22640431722255,NaN,NaN,NaN,NaN,0.19274810000148693,28.895221123432762,-9872026,-0.07506882064940135,-0.3014881610074429,-0.22641934035804157
2023-09-27T09:30:00-04:00,9.63,9.77,9.44,9.53,NaN,NaN,NaN,10.16311080304692,NaN,NaN,10.52090000000001,11.396986046001958,9.644813953998062,9.97749874402621,9.58,9.58,9.58,293548,332546.36666666664,20.264142641282348,29.11815662541082,NaN,NaN,NaN,NaN,0.20255180714423787,29.482711985087455,-10165574,-0.06616125907712744,-0.30912091420445087,-0.24295965512732343
2023-09-27T13:30:00-04:00,9.52,9.69,9.47,9.58,NaN,NaN,NaN,10.16311080304692,NaN,NaN,10.50490000000001,11.419087048693761,9.590712951306259,9.405998995220969,9.58,9.58000011920929,9.57999988079071,274875,331917.6666666667,23.791744895121553,27.608955923213664,NaN,NaN,NaN,NaN,0.2037981066339351,30.02823921376681,-9890699,-0.0517039895348862,-0.3075896420459312,-0.255885652511045
2023-09-28T09:30:00-04:00,9.58,9.84,9.48,9.7,NaN,NaN,NaN,10.16311080304692,NaN,NaN,10.48880000000001,11.430357348226517,9.547242651773503,9.403799196176776,9.673333333333334,9.673333333333334,9.673333333333334,349055,332894.3,31.611690572660905,26.887219671827868,NaN,NaN,NaN,NaN,0.21495538473151113,29.414025752270984,-9541644,-0.029941064193660605,-0.29331198275312076,-0.26337091855946015
2023-09-28T13:30:00-04:00,9.7,9.73,9.64,9.7,NaN,NaN,NaN,10.16311080304692,NaN,NaN,10.472700000000009,11.439782643831144,9.505617356168873,9.39703935694142,9.679373054190101,9.687384532597019,9.671361575783184,198382,331591.5333333333,31.611690572660905,26.27011127425292,NaN,NaN,NaN,NaN,0.20603000010783173,28.843684680882,-9541644,-0.012329821755987402,-0.27878319575444444,-0.26645337399845703
2023-09-29T09:30:00-04:00,9.84,10.01,9.69,9.74,NaN,NaN,NaN,10.16311080304692,NaN,NaN,10.459700000000009,11.4481197691262,9.471280230873818,9.431777256524207,9.813333333333333,9.813333333333333,9.813333333333333,318251,332679.9666666667,34.22106653785315,25.85141629901393,NaN,NaN,NaN,NaN,0.21417071438584379,26.97484906577,-9223393,0.004336824549976082,-0.2610323433109869,-0.265369167860963
2023-09-29T13:30:00-04:00,9.75,9.835,9.7,9.8,NaN,NaN,NaN,10.16311080304692,NaN,NaN,10.44810000000001,11.45345742897701,9.442742571023011,9.431777256524207,9.796484047953097,9.813971945781827,9.778996150124367,295432,331263.4,38.040000411166226,26.20586416054578,NaN,NaN,NaN,NaN,0.20851566335828364,25.23950170888029,-8927961,0.02080419193672245,-0.2393639279400599,-0.26016811987678234
2023-10-02T09:30:00-04:00,9.78,9.9,9.59,9.635,NaN,NaN,NaN,10.16311080304692,NaN,NaN,10.429800000000009,11.46007367238006,9.399526327619958,9.431777256524207,9.708333333333334,9.708333333333334,9.708333333333334,303923,326501.8333333333,32.45904638924122,26.59445250466169,NaN,NaN,NaN,NaN,0.21576454454697772,23.853683905973657,-9231884,0.02187701722747437,-0.23282184834243935,-0.2546988655699137
2023-10-02T13:30:00-04:00,9.63,9.735,9.63,9.73,NaN,NaN,NaN,10.16311080304692,NaN,NaN,10.41360000000001,11.461750828840646,9.365449171159373,9.431777256524207,9.703842897749935,9.708816864386561,9.698868931113308,247705,324524.5,38.090845429636786,27.512327985382992,NaN,NaN,NaN,NaN,0.20785279136505067,22.56685308898892,-8984179,0.029787332944864797,-0.21746469938883273,-0.24725203233369752
2023-10-03T09:30:00-04:00,9.63,9.78,9.55,9.56,NaN,NaN,NaN,10.16311080304692,NaN,NaN,10.39230000000001,11.465389390497954,9.319210609502065,9.431777256524207,9.63,9.63,9.63,229900,320411.1,32.81740339886072,28.161638217379767,NaN,NaN,NaN,NaN,0.20943473483897554,21.811779750644586,-9214079,0.024589011107564923,-0.21651576844924136,-0.2411047795568063
2023-10-03T13:30:00-04:00,9.56,9.595,9.49,9.54,NaN,NaN,NaN,10.16311080304692,NaN,NaN,10.372100000000012,11.470285940539744,9.27391405946028,9.431777256524207,9.581025526229764,9.624929733719682,9.537121318739846,286066,319691.8333333333,32.2516959735611,28.834883973322615,NaN,NaN,NaN,NaN,0.2019751109219059,21.42600672847567,-9500145,0.020963560070518084,-0.21490032946865867,-0.23586388953917675
2023-10-04T09:30:00-04:00,9.55,9.68,9.43,9.64,NaN,NaN,NaN,10.16311080304692,NaN,NaN,10.344700000000012,11.446214248659157,9.243185751340867,9.431777256524207,9.583333333333334,9.583333333333334,9.583333333333334,366370,324358.5,38.00599037801413,29.878475176566603,NaN,NaN,NaN,NaN,0.20540546014176977,20.476597607236037,-9133775,0.026124345577861197,-0.20320845756685024,-0.22933280314471144
2023-10-04T13:30:00-04:00,9.64,9.69,9.57,9.68,NaN,NaN,NaN,10.16311080304692,NaN,NaN,10.31790000000001,11.417592848025878,9.218207151974143,9.431777256524207,9.61060888744541,9.641969625770598,9.579248149120223,277137,322696.56666666665,40.19416454356314,31.11091685438634,NaN,NaN,NaN,NaN,0.1993050701316433,19.526047952940438,-8856638,0.0326330345324084,-0.18854150997920094,-0.22117454451160934
2023-10-05T09:30:00-04:00,9.58,9.73,9.49,9.71,NaN,NaN,NaN,10.16311080304692,NaN,NaN,10.290400000000012,11.380715257161508,9.200084742838516,9.431777256524207,9.643333333333333,9.643333452542622,9.643333214124043,390516,321312.4,41.851894094778345,32.54651644204144,NaN,NaN,NaN,NaN,0.20221185083652596,19.11697353185917,-8466122,0.03893281309947749,-0.17250852813726247,-0.21144134123673997
2023-10-05T13:30:00-04:00,9.705,9.82,9.685,9.73,NaN,NaN,NaN,10.16311080304692,NaN,NaN,10.263800000000012,11.34254846002168,9.185051539978344,9.431777256524207,9.686284184684553,9.736502649969399,9.636065719399706,285664,318133.4666666667,42.98649027954833,34.15699043699633,NaN,NaN,NaN,NaN,0.19741100434820266,18.08977794309214,-8180458,0.04404449348603734,-0.1563857243791933,-0.20043021786523063
2023-10-06T09:30:00-04:00,9.65,9.9,9.65,9.89,NaN,NaN,NaN,10.16311080304692,NaN,NaN,10.244600000000009,11.315072493807948,9.17412750619207,9.406769616234202,9.813333333333334,9.813333333333334,9.813333333333334,339967,318091.8333333333,51.19144788079054,36.36608366838978,NaN,NaN,NaN,NaN,0.2011673611804739,16.98927595330994,-7840491,0.05697762084235905,-0.12920819181228183,-0.18618581265464088
2023-10-06T13:30:00-04:00,9.9,9.99,9.855,9.94,NaN,NaN,NaN,10.16311080304692,NaN,NaN,10.22540000000001,11.282516530946053,9.168283469053966,9.527915692987362,9.87829134390077,9.935305623501254,9.821277064300286,441301,319971.43333333335,53.44614851141141,38.48425535526763,NaN,NaN,NaN,NaN,0.19644112109615433,16.516781701375496,-7399190,0.06698529718248977,-0.10245419117652865,-0.16943948835901843
2023-10-09T09:30:00-04:00,9.8,9.94,9.72,9.805,NaN,NaN,NaN,10.16311080304692,NaN,NaN,10.19770000000001,11.224407767575231,9.170992232424789,9.527915692987362,9.821666666666667,9.821666666666667,9.821666666666667,260814,316146.5,47.117337199372784,39.591801542889904,NaN,NaN,NaN,NaN,0.19812389816071466,15.488591841061705,-7660004,0.0626757977221464,-0.09109474120633543,-0.15377053892848183
2023-10-09T13:30:00-04:00,9.81,9.955,9.805,9.88,NaN,NaN,NaN,10.16311080304692,NaN,NaN,10.172900000000011,11.168737516866754,9.177062483133268,9.527915692987362,9.850212139011257,9.87937218980156,9.821052088220954,249936,314116.13333333336,50.616015711443325,40.949253338517224,NaN,NaN,NaN,NaN,0.19468647686352078,14.43634305026478,-7410068,0.06287733950336744,-0.07517386454927255,-0.13805120405264
2023-10-10T09:30:00-04:00,9.87,10.19,9.86,10.09,9.405705590401428,9.405705590401428,9.405705590401428,NaN,NaN,NaN,10.160700000000011,11.145291306075434,9.176108693924588,9.65801283480953,10.046666666666665,10.046666666666665,10.046666666666665,343497,316056.23333333334,58.82937619994833,42.706989742952594,NaN,NaN,NaN,NaN,0.20435172851612646,14.675460106996038,-7066571,0.0743678238280832,-0.045091424267535984,-0.11945924809561918
2023-10-10T13:30:00-04:00,10.085,10.11,9.98,10.04,9.436128063565,NaN,NaN,NaN,NaN,NaN,10.144900000000012,11.111207383806667,9.178592616193358,9.65801283480953,10.045365615846144,10.046991685588475,10.043739546103813,219904,311767.5333333333,56.42319767111541,44.02007526152039,NaN,NaN,NaN,NaN,0.1990408907649745,14.89749737396078,-7286475,0.07556955655431177,-0.02499730240272946,-0.10056685895704123
2023-10-11T09:30:00-04:00,10.06,10.18,9.7,9.755,9.436128063565,NaN,NaN,NaN,NaN,NaN,10.12460000000001,11.080112093068138,9.169087906931882,9.65801283480953,9.878333333333332,9.878333333333332,9.878333333333332,518343,321935.4666666667,45.09998758443116,44.92299963260539,NaN,NaN,NaN,NaN,0.21910939856747635,14.268722596878463,-7804818,0.05509011298688764,-0.03170421772343168,-0.08679433071031932
2023-10-11T13:30:00-04:00,9.75,9.75,9.68,9.73,9.436128063565,NaN,NaN,NaN,NaN,NaN,10.10320000000001,11.045078463497006,9.161321536503014,9.65801283480953,9.816453549594188,9.893709777755745,9.73919732143263,332543,322128.56666666665,44.260891187905074,45.36371718676741,NaN,NaN,NaN,NaN,0.20881587009837096,13.78785662025696,-8137361,0.03856192550677549,-0.03859192382684995,-0.07715384933362544
2023-10-12T09:30:00-04:00,9.73,9.77,9.41,9.41,NaN,NaN,NaN,10.238053437577435,10.238053437577435,10.238053437577435,10.078200000000011,11.02597372827024,9.130426271729783,9.65801283480953,9.53,9.530000119209289,9.52999988079071,441936,318236.3,35.22648857075599,45.535794699045645,NaN,NaN,NaN,NaN,0.21961473651991587,14.546670906815118,-8579297,0.006462642438167687,-0.06907554628591583,-0.07553818872408352
2023-10-12T13:30:00-04:00,9.41,9.43,9.28,9.28,NaN,NaN,NaN,9.994051008596644,NaN,NaN,10.04900000000001,11.003356327583884,9.094643672416137,9.65801283480953,9.425544743359273,9.525445447502259,9.325644039216288,483151,322593.36666666664,32.33861143530129,45.54200294631279,NaN,NaN,NaN,NaN,0.2146422553399219,15.718041427081971,-9062448,-0.02160297776707254,-0.1025419109329242,-0.08093893316585166
2023-10-13T09:30:00-04:00,9.34,9.36,9.17,9.19,NaN,NaN,NaN,9.900912326387704,NaN,NaN,10.01780000000001,10.980411364985612,9.055188635014408,9.65801283480953,9.24,9.24,9.24,412859,325760.0333333333,30.4758831945924,45.00413814749696,NaN,NaN,NaN,NaN,0.21288209424421314,17.165928162887063,-9475307,-0.04306718593832119,-0.13477291558875315,-0.09170572965043196
2023-10-13T13:30:00-04:00,9.18,9.225,9.12,9.13,NaN,NaN,NaN,9.79382540246099,NaN,NaN,9.985500000000009,10.956683298867736,9.014316701132282,9.65801283480953,9.19993546044073,9.240761555860416,9.159109365021045,397600,325784.0333333333,29.265621449886766,44.22352792652008,NaN,NaN,NaN,NaN,0.2051762303696265,18.668193186955737,-9872907,-0.05725587893412708,-0.1632755783180908,-0.10601969938396373
2023-10-16T09:30:00-04:00,9.16,9.35,9.14,9.315,NaN,NaN,NaN,9.79382540246099,NaN,NaN,9.95470000000001,10.91119654468771,8.998203455312309,9.65801283480953,9.268333333333333,9.268333333333333,9.268333333333333,373084,330613.9666666667,37.50632399753723,43.91313006243142,NaN,NaN,NaN,NaN,0.20623507105751024,19.22391932091253,-9499823,-0.0503747998704826,-0.16898819922206698,-0.11861339935158438
2023-10-16T13:30:00-04:00,9.315,9.38,9.3,9.32,NaN,NaN,NaN,9.79382540246099,NaN,NaN,9.924100000000008,10.861779454824317,8.986420545175699,9.65801283480953,9.291777975792678,9.322990961868902,9.260564989716455,210486,332561.3333333333,37.71751847770725,43.53677493372849,NaN,NaN,NaN,NaN,0.1972182802676881,19.54574953212008,-9289337,-0.04202067853275096,-0.17113924751752307,-0.12911856898477211
2023-10-17T09:30:00-04:00,9.2,9.64,9.2,9.53,NaN,NaN,NaN,9.79382540246099,NaN,NaN,9.895900000000008,10.793632009009182,8.998167990990835,9.619410267847623,9.456666666666665,9.456666666666665,9.456666666666665,337426,333150.5,45.975455712251595,43.16420406454713,NaN,NaN,NaN,NaN,0.21455983167713905,18.367451694236042,-8951911,-0.020002824971341343,-0.15412210019894879,-0.13411927522760744
2023-10-17T13:30:00-04:00,9.535,9.63,9.48,9.61,NaN,NaN,NaN,9.79382540246099,NaN,NaN,9.87230000000001,10.73617547713751,9.00842452286251,9.547528214278099,9.517320836902318,9.575607983803351,9.459033690001284,365388,328168.63333333336,48.76253108185245,42.82965996243578,NaN,NaN,NaN,NaN,0.209948415128772,17.27331798762944,-8586523,0.001174273158890654,-0.13265143377899413,-0.1338257069378848
2023-10-18T09:30:00-04:00,9.49,9.535,9.15,9.225,NaN,NaN,NaN,9.79382540246099,NaN,NaN,9.84180000000001,10.687052057080958,8.996547942919062,9.206522571422479,9.303333333333335,9.303333333333335,9.303333333333335,413675,332172.86666666664,38.47536454918522,42.212376201708096,NaN,NaN,NaN,NaN,0.22780924261957392,17.624687048015968,-9000198,-0.00896362648575691,-0.14503024004508092,-0.136066613559324
2023-10-18T13:30:00-04:00,9.22,9.225,9.15,9.205,NaN,NaN,NaN,9.79382540246099,NaN,NaN,9.81380000000001,10.648760022994828,8.97883997700519,9.155218057137983,9.250037649811066,9.305011237154028,9.195064062468104,388808,335970.63333333336,38.02656687470374,41.313129856226695,NaN,NaN,NaN,NaN,0.21689429671817573,17.95095831837489,-9389006,-0.014883837400557653,-0.15467141031002107,-0.13978757290946342
2023-10-19T09:30:00-04:00,9.2,9.23,9.05,9.11,NaN,NaN,NaN,9.779040760002081,NaN,NaN,9.786600000000009,10.622888084334352,8.950311915665665,9.095856481896304,9.13,9.13,9.13,424657,338490.7,35.88533754694316,39.67426995244061,NaN,NaN,NaN,NaN,0.2142589898097346,18.61456116844396,-9813663,-0.022602537001056522,-0.16804074416078407,-0.14543820715972755
2023-10-19T13:30:00-04:00,9.105,9.125,8.96,8.965,NaN,NaN,NaN,9.67499345272926,NaN,NaN,9.754700000000009,10.592230680034838,8.91716931996518,9.095856481896304,9.078975679857072,9.135360740261401,9.022590619452743,347748,343469.56666666665,32.84530364682891,37.99013466499157,NaN,NaN,NaN,NaN,0.21074049053761065,19.53828161198309,-10161411,-0.03418323491666833,-0.18816725080556296,-0.15398401588889463
2023-10-20T09:30:00-04:00,8.94,9.22,8.89,9.195,NaN,NaN,NaN,9.67499345272926,NaN,NaN,9.72580000000001,10.538497631348505,8.913102368651515,9.095856481896304,9.101666666666667,9.101666666666667,9.101666666666667,415066,346696.73333333334,41.33487748580534,37.721198229375446,NaN,NaN,NaN,NaN,0.21925902692778135,19.803833754742506,-9746345,-0.02356794479736124,-0.18344394688559618,-0.15987600208823494
2023-10-20T13:30:00-04:00,9.2,9.23,9.09,9.13,NaN,NaN,NaN,9.67499345272926,NaN,NaN,9.695100000000009,10.479024715772864,8.911175284227154,9.095856481896304,9.125935893898864,9.150102342937338,9.101769444860391,418604,350802.4666666667,39.80343647404125,37.402808606956604,NaN,NaN,NaN,NaN,0.2135976678615113,19.987964292917617,-10164949,-0.01836960514721478,-0.1828380085222534,-0.16446840337503862
2023-10-23T09:30:00-04:00,9.09,9.39,8.98,9.29,NaN,NaN,NaN,9.67499345272926,NaN,NaN,9.666300000000009,10.400239534293982,8.932360465706035,9.095856481896304,9.22,9.22,9.22,435068,355173.9666666667,45.18687198024382,38.11426456477716,NaN,NaN,NaN,NaN,0.22762640587140334,19.20683072506022,-9729881,-0.002438168256784168,-0.16751611369601882,-0.16507794543923465
2023-10-23T13:30:00-04:00,9.295,9.35,9.14,9.16,NaN,NaN,NaN,9.67499345272926,NaN,NaN,9.63750000000001,10.33471804336914,8.94028195663088,9.095856481896304,9.218611444502706,9.220254743599263,9.216968145406149,310635,357271.63333333336,41.90752142589926,38.79775813553416,NaN,NaN,NaN,NaN,0.22636737688058875,18.48149241204978,-10040516,0.0008838483734863178,-0.16397313497237676,-0.16485698334586307
2023-10-24T09:30:00-04:00,9.35,9.595,9.25,9.315,NaN,NaN,NaN,9.67499345272926,NaN,NaN,9.613700000000009,10.27093910413154,8.956460895868478,9.095856481896304,9.386666666666665,9.386666666666665,9.386666666666665,524510,367091.9666666667,46.859452793145145,39.96801310685936,NaN,NaN,NaN,NaN,0.24126970710340387,17.777290802201815,-9516006,0.0143143987874291,-0.1469639848615767,-0.1612783836490058
2023-10-24T13:30:00-04:00,9.315,9.35,9.29,9.32,NaN,NaN,NaN,9.67499345272926,NaN,NaN,9.590900000000007,10.206924967026293,8.97487503297372,8.890105993774196,9.369633762806235,9.398709648177201,9.340557877435268,179997,363556.3333333333,47.01635157080781,41.235922401210864,NaN,NaN,NaN,NaN,0.2283218708817322,17.12338930734299,-9336009,0.02377145571351391,-0.1315640640071134,-0.1553355197206273
2023-10-25T09:30:00-04:00,9.21,9.28,9.08,9.115,NaN,NaN,NaN,9.67499345272926,NaN,NaN,9.564100000000007,10.142890773941401,8.985309226058613,8.890105993774196,9.158333333333333,9.158333452542623,9.158333214124044,466825,366904.8333333333,41.5939437459196,41.527895240381035,NaN,NaN,NaN,NaN,0.2291560229616085,16.360995390008,-9802834,0.016786359991907945,-0.1343525697307424,-0.15113892972265033
2023-10-25T13:30:00-04:00,9.11,9.12,9.015,9.025,NaN,NaN,NaN,9.67499345272926,NaN,NaN,9.540200000000006,10.107251884751099,8.973148115248913,8.890105993774196,9.116675482023176,9.16804373887328,9.065307225173072,307014,367900.73333333334,39.443199728728594,41.65115818688255,NaN,NaN,NaN,NaN,0.2202877356072078,15.948467537539003,-10109848,0.007162583617285556,-0.14218570020104337,-0.14934828381832893
2023-10-26T09:30:00-04:00,9.06,9.23,8.94,8.98,NaN,NaN,NaN,9.67499345272926,NaN,NaN,9.521000000000006,10.09753447425089,8.944465525749122,8.890105993774196,9.05,9.05,9.05,341735,366274.7,38.37473856562102,41.108249819266085,NaN,NaN,NaN,NaN,0.2252671830638359,14.976440691023871,-10451583,-0.0007551025159228397,-0.15029216196323247,-0.14953705944730963
2023-10-26T13:30:00-04:00,8.98,9.23,8.97,9.105,NaN,NaN,NaN,9.67499345272926,NaN,NaN,9.506300000000005,10.087016144084084,8.925583855915926,8.890105993774196,9.072920529998997,9.09858912341295,9.047251936585045,272480,365835.23333333334,42.9941654027511,40.696223699330275,NaN,NaN,NaN,NaN,0.22774809855927616,14.073844333545535,-10179103,0.0036623377325638584,-0.1449591372816048,-0.14862147501416867
2023-10-27T09:30:00-04:00,9.2,9.2,8.92,8.955,NaN,NaN,NaN,9.67499345272926,NaN,NaN,9.490400000000005,10.086875783246786,8.893924216753224,8.890105993774196,9.024999999999999,9.024999999999999,9.024999999999999,308478,364785.6,39.19709117626671,40.74777560126467,NaN,NaN,NaN,NaN,0.23148037723361353,13.499540766419424,-10487581,-0.0019785780496776317,-0.1510946975762657,-0.14911611952658807
2023-10-27T13:30:00-04:00,8.95,8.98,8.89,8.9,NaN,NaN,NaN,9.594669447965169,NaN,NaN,9.474500000000004,10.090380670260016,8.858619329739993,8.890105993774196,8.975937957424634,9.026740421014669,8.925135493834599,287704,359665.7,37.87621457738077,40.73703615145588,NaN,NaN,NaN,NaN,0.22137463600264112,13.126368391128738,-10775285,-0.007560982760488527,-0.15856734797719874,-0.1510063652167102
2023-10-30T09:30:00-04:00,9,9.09,8.91,8.98,NaN,NaN,NaN,9.594669447965169,NaN,NaN,9.460000000000006,10.087518924017255,8.832481075982757,8.890105993774196,8.993333333333334,8.993333333333334,8.993333333333334,222604,358392.0333333333,40.99107159472521,41.10173144058318,NaN,NaN,NaN,NaN,0.219133590573881,12.263475917838731,-10552681,-0.004181457361318558,-0.1562331869183584,-0.15205172955703986
2023-10-30T13:30:00-04:00,8.98,9.14,8.955,9.075,NaN,NaN,NaN,9.594669447965169,NaN,NaN,9.447900000000006,10.081288001149211,8.8145119988508,8.890105993774196,9.026933239130665,9.058540838916485,8.995325639344845,251551,358445.86666666664,44.54677336444706,41.93755070612733,NaN,NaN,NaN,NaN,0.21669547696146094,11.748027436218775,-10301130,0.005604867247934242,-0.14504564549712207,-0.1506505127450563
2023-10-31T09:30:00-04:00,9.115,9.16,9.05,9.125,NaN,NaN,NaN,9.594669447965169,NaN,NaN,9.438100000000006,10.07598992780864,8.800210072191371,8.756084795019355,9.111666666666666,9.111666666666666,9.111666666666666,246958,355227.9,46.3781614441298,42.29778527457908,NaN,NaN,NaN,NaN,0.20907437146421368,11.385513348900291,-10054172,0.016009264676589252,-0.13063893189931974,-0.146648196575909
2023-10-31T13:30:00-04:00,9.13,9.15,9.07,9.14,NaN,NaN,NaN,9.594669447965169,NaN,NaN,9.430100000000005,10.07269315278007,8.78750684721994,8.740680050690276,9.1158430793511,9.120009734620501,9.111676424081699,248116,356168.3,46.94425977960044,42.80784408211902,NaN,NaN,NaN,NaN,0.19985477350248412,11.048893124961701,-9806056,0.02398553588256558,-0.11666627672270202,-0.1406518126052676
2023-11-01T09:30:00-04:00,9.13,9.23,8.945,8.95,NaN,NaN,NaN,9.594669447965169,NaN,NaN,9.418500000000005,10.074265964349912,8.762734035650098,8.76004404055222,9.041666666666666,9.041666666666666,9.041666666666666,257638,347478.13333333336,41.034779276381286,42.51126603184313,NaN,NaN,NaN,NaN,0.20593657539516383,10.624229652264484,-10063694,0.016884486325336207,-0.11954620469859734,-0.13643069102393354
2023-11-01T13:30:00-04:00,8.945,9.095,8.92,9.09,NaN,NaN,NaN,9.594669447965169,NaN,NaN,9.408700000000007,10.069147757206954,8.74825224279306,8.76004404055222,9.038552013257423,9.041878165717543,9.035225860797302,225915,343923.86666666664,46.389936752076714,42.83143855514152,NaN,NaN,NaN,NaN,0.20372682000979503,10.387330407682938,-9837779,0.021726858861803755,-0.10927211744667886,-0.13099897630848262
2023-11-02T09:30:00-04:00,9.23,9.5,9.22,9.41,NaN,NaN,NaN,9.594669447965169,NaN,NaN,9.402900000000006,10.05808574465544,8.747714255344572,8.924228185953421,9.376666666666667,9.376666666666667,9.376666666666667,676466,351741.5333333333,56.18497263084923,43.49754711497752,NaN,NaN,NaN,NaN,0.21846061858052396,11.33361279710222,-9161313,0.04523895139500218,-0.07445028706472989,-0.11968923845973208
2023-11-02T13:30:00-04:00,9.41,9.5,9.41,9.48,NaN,NaN,NaN,9.594669447965169,NaN,NaN,9.398500000000006,10.048580764212954,8.748419235787058,8.994382548762736,9.407557061052545,9.449065506555945,9.366048615549145,374645,348124.6666666667,57.99303641351067,44.28159603231344,NaN,NaN,NaN,NaN,0.2092848601104865,12.212303587277267,-8786668,0.06316279531154617,-0.04073574432029936,-0.10389853963184553
2023-11-03T09:30:00-04:00,9.66,9.76,9.56,9.73,9.016069856189448,9.016069856189448,9.016069856189448,NaN,NaN,NaN,9.398300000000004,10.047966406704099,8.74863359329591,9.21550603901019,9.683333333333334,9.683333333333334,9.683333333333334,862437,363110.6,63.74693315036865,45.86395241834551,NaN,NaN,NaN,NaN,0.214335941531166,13.992318323464387,-7924231,0.08798765444182917,0.006086028420440925,-0.08190162602138824
2023-11-03T13:30:00-04:00,9.73,9.79,9.66,9.69,9.092612135453564,NaN,NaN,NaN,NaN,NaN,9.396100000000004,10.04103810555728,8.751161894442728,9.28940483120815,9.693484822099599,9.707679607720038,9.67929003647916,441092,364560.3333333333,62.27708088229545,47.49494392931457,NaN,NaN,NaN,NaN,0.20831194570751124,15.741693622148704,-8365323,0.09712891190678935,0.039509513862098444,-0.057619398044690906
2023-11-06T09:30:00-05:00,9.77,9.81,9.535,9.57,9.092612135453564,NaN,NaN,NaN,NaN,NaN,9.394800000000004,10.038066538846707,8.7515334611533,9.28940483120815,9.638333333333334,9.638333333333334,9.638333333333334,432377,366536.76666666666,57.959458573536025,48.8938525013085,NaN,NaN,NaN,NaN,0.21307537815697475,16.496129726930256,-8797700,0.09063400232544834,0.055673104862119516,-0.034960897463328824
2023-11-06T13:30:00-05:00,9.565,9.61,9.52,9.595,9.092612135453564,NaN,NaN,NaN,NaN,NaN,9.392100000000005,10.03083340291528,8.75336659708473,9.28940483120815,9.613293933084137,9.64425935117609,9.582328514992183,282720,368944.56666666665,58.603368106682176,50.008795551589294,NaN,NaN,NaN,NaN,0.20428427971719085,17.09528945421704,-8514980,0.08372610808385052,0.06969673764148432,-0.014029370442366195
2023-11-07T09:30:00-05:00,9.61,9.85,9.595,9.695,9.092612135453564,NaN,NaN,NaN,NaN,NaN,9.394800000000004,10.03747864442492,8.752121355575087,9.342195273578573,9.713333333333333,9.713333333333333,9.713333333333333,537966,375629.23333333334,61.16559665667631,51.57797451447569,NaN,NaN,NaN,NaN,0.20790683116596287,18.52207599156837,-7977014,0.08151698233889758,0.08786685748125578,0.006349875142358203
2023-11-07T13:30:00-05:00,9.69,9.82,9.68,9.78,9.12890637044577,NaN,NaN,NaN,NaN,NaN,9.399600000000003,10.050082405603652,8.749117594396354,9.34375621886286,9.742718022075152,9.765253006924134,9.720183037226171,914708,393939.9,63.24787563654046,53.39023601870138,NaN,NaN,NaN,NaN,0.203056343225537,19.84694920482318,-7062306,0.08122570103011995,0.10788200143000815,0.026656300399888193
2023-11-08T09:30:00-05:00,8.8,8.9,8.28,8.38,NaN,NaN,NaN,9.387407555483582,9.387407555483582,9.387407555483582,9.374400000000003,10.080891726773904,8.667908273226102,9.34375621886286,8.520000000000001,8.520000000000001,8.520000000000001,2607005,467050.9,32.416889643744796,52.77779445077421,NaN,NaN,NaN,NaN,0.2956951758522844,20.904412167388724,-9669311,-0.012802603665507999,0.010653045818003193,0.02345564948351119
2023-11-08T13:30:00-05:00,8.375,8.4,8.31,8.37,NaN,NaN,NaN,9.128434484779783,NaN,NaN,9.348200000000004,10.102931104433795,8.593468895566213,9.34375621886286,8.468223653485714,8.543079684531381,8.393367622440046,1247243,495665.4,32.29578967621923,51.902724187329376,NaN,NaN,NaN,NaN,0.28100266329140694,21.886342061199585,-10916554,-0.0719186070955363,-0.06644260938590918,0.005475997709627114
2023-11-09T09:30:00-05:00,8.54,8.62,8.105,8.135,NaN,NaN,NaN,9.128434484779783,NaN,NaN,9.316700000000004,10.137020937194587,8.496379062805422,9.34375621886286,8.286666666666667,8.286666666666667,8.286666666666667,1340839,526204.8,29.506210654209937,50.69758484519224,NaN,NaN,NaN,NaN,0.29771675877059206,21.96080339271016,-12257393,-0.12024835517735652,-0.14483444626206854,-0.02458609108471202
2023-11-09T13:30:00-05:00,8.13,8.14,7.92,7.92,NaN,NaN,NaN,8.831755387991498,NaN,NaN,9.280500000000004,10.180544998874979,8.380455001125029,9.34375621886286,8.145398449473339,8.291965730455093,7.998831168491584,1245637,556134.4333333333,27.19206725527488,49.28671395059756,NaN,NaN,NaN,NaN,0.2921655617155498,22.432250445125415,-13503030,-0.15773353851429767,-0.2217530142275841,-0.06401947571328644
2023-11-10T09:30:00-05:00,8,8.285,7.99,8.27,NaN,NaN,NaN,8.831755387991498,NaN,NaN,9.248100000000004,10.174302763977664,8.321897236022345,9.34375621886286,8.181666666666667,8.181666666666667,8.181666666666667,1013319,576076.2,35.9928194680367,48.92657396428723,NaN,NaN,NaN,NaN,0.29736802159301057,22.336493942418553,-12489711,-0.15004003681395883,-0.251569521730735,-0.10152948491677616
2023-11-10T13:30:00-05:00,8.27,8.3,8.19,8.23,NaN,NaN,NaN,8.831755387991498,NaN,NaN,9.213900000000006,10.161421588144412,8.2663784118556,9.34375621886286,8.201093513355902,8.22858588231964,8.173601144392164,505972,578988.4666666667,35.465200807701564,48.14623568254615,NaN,NaN,NaN,NaN,0.28398459147922417,22.191952376562455,-12995683,-0.13897963395588286,-0.27525402736162974,-0.13627439340574687
2023-11-13T09:30:00-05:00,8.16,8.405,8.13,8.36,NaN,NaN,NaN,8.831755387991498,NaN,NaN,9.185000000000006,10.146683939763868,8.223316060236144,9.34375621886286,8.298333333333334,8.298333333333334,8.298333333333334,483579,580605.5,38.61466692034308,46.89121384608143,NaN,NaN,NaN,NaN,0.28334283494499374,21.66037073835438,-12512104,-0.11522296172664176,-0.2803030955640491,-0.16508013383740733
2023-11-13T13:30:00-05:00,8.36,8.405,8.29,8.31,NaN,NaN,NaN,8.831755387991498,NaN,NaN,9.153600000000006,10.124939363971095,8.182260636028918,9.34375621886286,8.31469928866571,8.332926755162406,8.296471822169012,389850,583246,37.84957205783938,45.45239496353348,NaN,NaN,NaN,NaN,0.27131834673463706,21.16675921716117,-12901954,-0.09597844088765953,-0.28505318494698173,-0.1890747440593222
2023-11-14T09:30:00-05:00,8.57,8.71,8.455,8.575,NaN,NaN,NaN,8.831755387991498,NaN,NaN,9.123300000000006,10.070117004494415,8.176482995505596,9.34375621886286,8.58,8.58,8.58,838661,593717.7,44.16405006290641,44.05361760014332,NaN,NaN,NaN,NaN,0.2805098933964487,19.705971659426304,-12063293,-0.06024956032384393,-0.2643866944641271,-0.20413713414028317
2023-11-14T13:30:00-05:00,8.575,8.575,8.48,8.49,NaN,NaN,NaN,8.831755387991498,NaN,NaN,9.092300000000005,10.018300453563489,8.166299546436521,7.970354457721644,8.556849287042397,8.587975495160588,8.525723078924205,463941,603182.5,42.666644121248616,42.65287211721141,NaN,NaN,NaN,NaN,0.2672591867252737,18.34952607010107,-12527234,-0.03826043079892466,-0.251962672638939,-0.21370224184001435
2023-11-15T09:30:00-05:00,8.52,8.61,8.34,8.37,NaN,NaN,NaN,8.831755387991498,NaN,NaN,9.064600000000006,9.992506978096268,8.136693021903744,7.970354457721644,8.44,8.44,8.44,919686,618277.8666666667,40.57505314451036,41.411128872281,NaN,NaN,NaN,NaN,0.2674549591020398,17.46932272915806,-13446920,-0.028182232519520733,-0.24893003248941525,-0.22074779996989452
2023-11-15T13:30:00-05:00,8.36,8.41,8.31,8.33,NaN,NaN,NaN,8.831755387991498,NaN,NaN,9.036600000000007,9.966990111727158,8.106209888272856,7.970354457721644,8.410299370574352,8.452618742734284,8.36797999841442,452994,623143.8666666667,39.873380159467565,40.073272590337105,NaN,NaN,NaN,NaN,0.2554938905947512,16.75411190159453,-13899914,-0.02092824488495748,-0.24690810607609137,-0.2259798611911339
2023-11-16T09:30:00-05:00,8.28,8.29,7.91,8.025,NaN,NaN,NaN,8.831755387991498,NaN,NaN,9.008900000000006,9.974958569652863,8.04284143034715,7.970354457721644,8.075000000000001,8.075000000000001,8.075000000000001,1282033,654487.1333333333,34.91527576502183,38.19824966950464,NaN,NaN,NaN,NaN,0.2672443269808404,17.275129612212968,-15181947,-0.03268866499521811,-0.2668406924351565,-0.2341520274399384
2023-11-16T13:30:00-05:00,8.025,8.04,7.94,7.94,NaN,NaN,NaN,8.742268254956194,NaN,NaN,8.982100000000006,9.99002874748155,7.974171252518463,7.970354457721644,8.041870326774978,8.089521225995659,7.994219427554297,619714,666061.6,33.65913214420188,36.084767991480454,NaN,NaN,NaN,NaN,0.25529830362506595,17.75893177207295,-15801661,-0.04163605673464149,-0.28619709835824025,-0.24456104162359876
2023-11-17T09:30:00-05:00,7.97,8.02,7.925,7.995,NaN,NaN,NaN,8.70352878882182,NaN,NaN,8.958200000000005,10.00133328007489,7.915066719925119,7.970354457721644,7.98,7.98,7.98,589769,675437.9666666667,35.28161435347124,36.28939118503234,NaN,NaN,NaN,NaN,0.2438484247947041,18.250151413872775,-15211892,-0.0393218897989151,-0.29371340387224265,-0.25439151407332755
2023-11-17T13:30:00-05:00,7.995,8.135,7.995,8.11,NaN,NaN,NaN,8.70352878882182,NaN,NaN,8.937800000000005,10.006283336322882,7.869316663677127,7.970354457721644,8.029036939359585,8.07902766364103,7.9790462150781405,567479,684763.8,38.65965479657249,36.7439529793433,NaN,NaN,NaN,NaN,0.2364306801665109,18.17172811038901,-14644413,-0.02615182614308964,-0.28708129675218963,-0.2609294706091
2023-11-20T09:30:00-05:00,8.1,8.27,7.985,8.245,NaN,NaN,NaN,8.70352878882182,NaN,NaN,8.916400000000005,9.996603758556533,7.836196241443476,7.970354457721644,8.166666666666666,8.166666666666666,8.166666666666666,585864,696872.4666666667,42.456755588752934,37.668991903239224,NaN,NaN,NaN,NaN,0.23989991729747434,17.508508565221874,-14058549,-0.005531934658008553,-0.26784438893161067,-0.2623124542736021
2023-11-20T13:30:00-05:00,8.24,8.265,8.12,8.135,NaN,NaN,NaN,8.70352878882182,NaN,NaN,8.892700000000005,9.988331708193787,7.797068291806223,7.970354457721644,8.169118663308534,8.172333372742461,8.165903953874608,340842,699848.8333333334,40.26937478425744,38.60308529816655,NaN,NaN,NaN,NaN,0.23312135177622628,16.89266184470953,-14399391,0.003053716561651265,-0.258495308571538,-0.2615490251331893
2023-11-21T09:30:00-05:00,8.08,8.13,7.96,8.005,NaN,NaN,NaN,8.70352878882182,NaN,NaN,8.862200000000007,9.970007131227952,7.754392868772062,7.963626852941852,8.031666666666666,8.031666666666666,8.031666666666666,678256,714225.4333333333,37.79135158498772,38.73155187794877,NaN,NaN,NaN,NaN,0.22896982664935298,16.896156022229654,-15077647,0.0023631517867705454,-0.2585950853997261,-0.26095823718649663
2023-11-21T13:30:00-05:00,8.005,8.02,7.97,7.97,NaN,NaN,NaN,8.671582568847754,NaN,NaN,8.829400000000007,9.943796051679804,7.71500394832021,7.963626852941852,8.016633059244167,8.037858114765351,7.995408003722984,340269,717297.2,37.12890330335015,38.8503877704951,NaN,NaN,NaN,NaN,0.2161862676029706,16.8994006156412,-15417916,0.0019519270450231163,-0.2585183283802177,-0.2604702554252408
2023-11-22T09:30:00-05:00,8.02,8.125,7.98,8.125,NaN,NaN,NaN,8.671582568847754,NaN,NaN,8.807400000000007,9.933062898029233,7.68173710197078,7.842901482353483,8.076666666666666,8.076666666666666,8.076666666666666,612384,729122.0666666667,41.97944012588395,39.090728713748014,NaN,NaN,NaN,NaN,0.21181581991704415,16.37581599839515,-14805532,0.013858251593591664,-0.24314744093325125,-0.2570056925268429
2023-11-22T13:30:00-05:00,8.12,8.25,8.07,8.21,NaN,NaN,NaN,8.671582568847754,NaN,NaN,8.787500000000005,9.91950574203478,7.655494257965231,7.8350319774474535,8.128586847685163,8.178549963128988,8.078623732241338,661298,743634.8333333334,44.50782079257622,39.56631790908636,NaN,NaN,NaN,NaN,0.20954326135154097,15.304370674449256,-14144234,0.02836200597378885,-0.22155318505960686,-0.2499151910333957
2023-11-24T09:30:00-05:00,8.22,8.3,8.14,8.29,NaN,NaN,NaN,8.671582568847754,NaN,NaN,8.771100000000004,9.907691905654696,7.634508094345313,7.888025581957963,8.243333333333334,8.243333333333334,8.243333333333334,474341,736897.3333333334,46.85516797828063,39.75854061732737,NaN,NaN,NaN,NaN,0.20600445696928804,14.33892482152823,-13669893,0.04334973721319729,-0.1957280195168991,-0.2390777567300964
2023-11-27T09:30:00-05:00,8.27,8.46,8.21,8.415,NaN,NaN,NaN,8.671582568847754,NaN,NaN,8.760100000000005,9.899614791479118,7.6205852085208905,8.00542046556637,8.361666666666666,8.361666666666666,8.361666666666666,449634,739396.9666666667,50.386587836539704,40.309965168419595,NaN,NaN,NaN,NaN,0.20914699575719606,14.123634952430338,-13220259,0.06062812618608365,-0.16329259899749182,-0.22392072518357548
2023-11-27T13:30:00-05:00,8.415,8.44,8.38,8.4,NaN,NaN,NaN,8.671582568847754,NaN,NaN,8.744200000000005,9.881180844165677,7.607219155834332,8.046336372453096,8.382886433842037,8.405349982179708,8.360422885504367,401221,724023.1,49.957589389825735,40.98014632879927,NaN,NaN,NaN,NaN,0.19849363891739627,13.923722931125152,-13621480,0.06936383664989765,-0.13721592937120342,-0.20657976602110106
2023-11-28T09:30:00-05:00,8.38,8.615,8.345,8.56,NaN,NaN,NaN,8.671582568847754,NaN,NaN,8.732800000000005,9.865501478766477,7.600098521233532,8.165069097962478,8.506666666666668,8.506666666666668,8.506666666666668,657069,731222.3333333334,54.41587418919613,42.01889590235131,NaN,NaN,NaN,NaN,0.20360123613758224,14.432714047503975,-12964411,0.08329721829932363,-0.10245824314694651,-0.18575546144627014
2023-11-28T13:30:00-05:00,8.555,8.65,8.55,8.63,NaN,NaN,NaN,8.671582568847754,NaN,NaN,8.719600000000003,9.841350132605207,7.5978498673948,8.240055278369983,8.554794997028237,8.606340361714343,8.503249632342131,572840,735904.4333333333,56.25219515583975,43.542961573124025,NaN,NaN,NaN,NaN,0.19620114784204062,15.035478756444377,-12391571,0.0938245477089937,-0.068474776810028,-0.1622993245190217
2023-11-29T09:30:00-05:00,8.84,9.175,8.77,9.015,8.29874970209499,8.29874970209499,8.29874970209499,NaN,NaN,NaN,8.716700000000005,9.834624165585337,7.598775834414672,8.574544222695987,8.986666666666666,8.986666666666666,8.986666666666666,1038854,761108.9,64.67982076262487,45.758725045868516,NaN,NaN,NaN,NaN,0.22111535156760914,17.091150982720276,-11352717,0.12155388853732157,-0.010356963847369727,-0.1319108523846913
2023-11-29T13:30:00-05:00,9.015,9.03,8.85,8.91,8.29874970209499,NaN,NaN,NaN,NaN,NaN,8.708600000000004,9.81487490254447,7.6023250974555365,8.574544222695987,8.967763576580513,8.994481516060597,8.941045637100428,520013,760510.4666666667,61.2162131808781,47.61119639068329,NaN,NaN,NaN,NaN,0.21817854074135132,18.999989478547892,-11872730,0.1270637978272824,0.026918894899411683,-0.1001449029278707
2023-11-30T09:30:00-05:00,9.21,9.21,8.79,8.85,8.305405203768368,NaN,NaN,NaN,NaN,NaN,8.699200000000005,9.792445370445158,7.6059546295548515,8.574544222695987,8.950000000000001,8.950000000000001,8.950000000000001,934468,761169.1333333333,59.263259066049656,49.08288240993166,NaN,NaN,NaN,NaN,0.23259435925982633,21.163575171616202,-12807198,0.12094035011542648,0.05103053471641239,-0.06990981539901409
2023-11-30T13:30:00-05:00,8.845,8.87,8.69,8.79,8.305405203768368,NaN,NaN,NaN,NaN,NaN,8.692700000000004,9.779826873920351,7.605573126079657,8.574544222695987,8.882743278668224,8.964511163507053,8.800975393829395,632223,695343.0666666667,57.294804023400694,50.142743012406505,NaN,NaN,NaN,NaN,0.22883761931269583,22.585141075992254,-13439421,0.1075706933363513,0.06455355127142504,-0.04301714206492626
2023-12-01T09:30:00-05:00,8.83,9.31,8.82,9.175,8.33777622905341,NaN,NaN,NaN,NaN,NaN,8.695700000000004,9.787297013553898,7.604102986446109,8.574544222695987,9.101666666666668,9.101666666666668,9.101666666666668,1081194,689808.1,65.2669770391121,51.92828603061041,NaN,NaN,NaN,NaN,0.24963493221893193,24.776600684147684,-12358227,0.11851379762644312,0.10512510496812766,-0.013388692658315472
2023-12-01T13:30:00-05:00,9.16,9.39,9.15,9.325,8.543104582278254,NaN,NaN,NaN,NaN,NaN,8.702600000000004,9.805599981867548,7.59960001813246,8.66325865089302,9.18488057635824,9.277663701851361,9.09209745086512,869676,674102.6666666666,67.78989619110483,54.071039216761626,NaN,NaN,NaN,NaN,0.24894672277472255,26.941564700733046,-11488551,0.12885474601390848,0.14767973985907012,0.018824993845161647
2023-12-04T09:30:00-05:00,9.46,9.74,9.33,9.53,8.78455437399288,NaN,NaN,NaN,NaN,NaN,8.711100000000004,9.832765351163074,7.589434648836934,8.951106920714416,9.533333333333333,9.533333452542623,9.533333214124044,1549645,684236.2666666667,70.90081619335793,56.48331870890504,NaN,NaN,NaN,NaN,0.2608076711479567,29.449388159045842,-9938906,0.14149247062439765,0.1956905821256587,0.05419811150126106
2023-12-04T13:30:00-05:00,9.525,9.57,9.455,9.56,8.78455437399288,NaN,NaN,NaN,NaN,NaN,8.723200000000004,9.867944093673248,7.578455906326759,8.951106920714416,9.532182076840506,9.534287045000289,9.530077108680723,463538,665910.2333333333,71.33709983235862,58.58029440222466,NaN,NaN,NaN,NaN,0.2503928374945313,31.7780813703363,-9475368,0.14341669853897088,0.23346898467497468,0.09005228613600379
2023-12-05T09:30:00-05:00,9.77,10.45,9.67,10.1,9.23989355151004,NaN,NaN,NaN,NaN,NaN,8.747200000000003,9.954378793716929,7.540021206283077,9.454108429257225,10.073333333333332,10.073333333333332,10.073333333333332,2701609,739098.1333333333,77.79159956450263,60.95770717164798,NaN,NaN,NaN,NaN,0.29607906338777895,34.784494650322614,-6773759,0.1707451759533683,0.30348375607771416,0.13273858012434586
2023-12-05T13:30:00-05:00,10.11,10.635,10.105,10.53,9.514216571895949,NaN,NaN,NaN,NaN,NaN,8.778200000000004,10.083332575641194,7.473067424358813,9.570786743405781,10.19426910782031,10.36070846470352,10.027829750937098,1426330,770523.1666666666,81.38610465509527,63.42420264856331,NaN,NaN,NaN,NaN,0.3131448445743662,37.69908753120075,-5347429,0.20515483503378876,0.3891821239165818,0.18402728888279304
2023-12-06T09:30:00-05:00,10.86,11.64,10.73,11.28,10.216752182264315,NaN,NaN,NaN,NaN,NaN,8.822300000000004,10.301916450300483,7.342683549699523,10.233629394724625,11.216666666666667,11.216666666666667,11.216666666666667,4828765,918487,85.72573754735407,65.9484276279072,NaN,NaN,NaN,NaN,0.3700630699619115,40.89044088696351,-518664,0.2621530934629793,0.5117186557115172,0.24956556224853788
2023-12-06T13:30:00-05:00,11.28,11.4,11.13,11.28,10.303945264888664,NaN,NaN,NaN,NaN,NaN,8.865400000000003,10.495653771656382,7.2351462283436225,10.233629394724625,11.23369513746606,11.258559093135423,11.208831181796699,2264889,966027.9333333333,85.72573754735407,68.50329535344494,NaN,NaN,NaN,NaN,0.36291570782177496,43.85384043160037,-518664,0.28186075766670493,0.601891509331919,0.3200307516652141
2023-12-07T09:30:00-05:00,11.07,11.7,10.815,11.66,10.303945264888664,NaN,NaN,NaN,NaN,NaN,8.915800000000004,10.723095615000423,7.108504384999587,10.24942281262376,11.391666666666666,11.391666666666666,11.391666666666666,1804300,1010706.5666666667,87.44563368399652,70.86256388878782,NaN,NaN,NaN,NaN,0.40020744297736244,45.409478196381386,1285636,0.3007705860952615,0.695993984284291,0.3952233981890295
2023-12-07T13:30:00-05:00,11.66,11.675,11.415,11.5,10.518677400446075,NaN,NaN,NaN,NaN,NaN,8.966800000000005,10.913609451384426,7.019990548615583,10.384538250099007,11.447491520612726,11.515359214039766,11.379623827185686,1220781,1020743.0666666667,82.91555619317704,72.76708967716907,NaN,NaN,NaN,NaN,0.3901926256218367,46.85399897796376,64855,0.28304200659647194,0.7490259064346194,0.4659838998381475
2023-12-08T09:30:00-05:00,11.21,11.68,11.02,11.565,10.518677400446075,NaN,NaN,NaN,NaN,NaN,9.016300000000003,11.094545230958042,6.938054769041964,10.384538250099007,11.421666666666667,11.421666666666667,11.421666666666667,1887735,1068567.7666666666,83.29418463684473,74.0966870967562,NaN,NaN,NaN,NaN,0.40946458093456267,46.80166625807411,1952590,0.2569924086175811,0.7872244106101238,0.5302320019925427
2023-12-08T13:30:00-05:00,11.56,11.74,11.535,11.74,10.588495317348594,NaN,NaN,NaN,NaN,NaN,9.062900000000004,11.274573655854258,6.85122634414575,10.547604480063365,11.510981455730912,11.630779476250703,11.39118343521112,1049273,1060809.1,84.30284010914434,75.74573187734664,NaN,NaN,NaN,NaN,0.3948599680106653,46.82582965436425,3001863,0.23352712576773638,0.8221409092022132,0.5886137834344768
2023-12-11T09:30:00-05:00,11.53,11.79,11.325,11.62,10.588495317348594,NaN,NaN,NaN,NaN,NaN,9.105700000000004,11.428060015156941,6.783339984843067,10.603583584050691,11.578333333333333,11.578333333333333,11.578333333333333,1349502,1085135.3666666667,80.70451115137902,77.2772498834416,NaN,NaN,NaN,NaN,0.39986997029561777,46.14914526788031,1652361,0.19355326409228735,0.830555363549836,0.6370020994575486
2023-12-11T13:30:00-05:00,11.62,11.765,11.565,11.72,10.621392427584151,NaN,NaN,NaN,NaN,NaN,9.145500000000004,11.5750277318853,6.715972268114708,10.715866867240553,11.616772837931107,11.66735497379995,11.566190702062263,779354,1091454.8666666667,81.41636803846384,79.00021874166039,NaN,NaN,NaN,NaN,0.38559354384593086,45.52079548043093,2431715,0.15892637991519087,0.8356600743515372,0.6767336944363463
2023-12-12T09:30:00-05:00,11.83,11.895,11.55,11.65,10.679283680875782,NaN,NaN,NaN,NaN,NaN,9.184700000000003,11.709485464153303,6.659914535846704,10.883193493792442,11.698333333333332,11.698333333333332,11.698333333333332,912188,1102945.1666666667,79.21335021803046,79.99638825444026,NaN,NaN,NaN,NaN,0.3826940049997929,45.14129499745446,1519527,0.11825484791633789,0.8245522543317687,0.7062974064154308
2023-12-12T13:30:00-05:00,11.65,11.73,11.615,11.63,10.679283680875782,NaN,NaN,NaN,NaN,NaN,9.225900000000003,11.840136936469198,6.611663063530807,10.883193493792442,11.684333262076288,11.703412068512467,11.66525445564011,491182,1099789.1,78.5592859083355,80.7656303770996,NaN,NaN,NaN,NaN,0.3635730046426649,44.78890169183346,1028345,0.07884807315298414,0.8048574978566609,0.7260094247036768
2023-12-13T09:30:00-05:00,11.62,11.67,11.125,11.29,10.679283680875782,NaN,NaN,NaN,NaN,NaN,9.259800000000004,11.935539120317934,6.584060879682075,10.883193493792442,11.361666666666666,11.361666666666666,11.361666666666666,1495710,1138284.7,68.24319777325044,80.57580048994906,NaN,NaN,NaN,NaN,0.3765320757396174,42.79773725180597,-467365,0.02169842884242945,0.7531324607567136,0.7314340319142841
2023-12-13T13:30:00-05:00,11.28,12.02,11.25,12,10.679283680875782,NaN,NaN,NaN,NaN,NaN,9.305900000000003,12.087378520499454,6.5244214795005515,10.883193493792442,11.587748604323096,11.783169490719024,11.392327717927168,2001876,1182405.3666666667,75.48328643904789,80.87195667614115,NaN,NaN,NaN,NaN,0.40463692747250185,41.62134723824637,1534511,0.02338286832633729,0.7606626173222057,0.7372797489958685
2023-12-14T09:30:00-05:00,12.37,12.39,11.8,12.025,10.966877911517328,NaN,NaN,NaN,NaN,NaN,9.350800000000003,12.232129109976825,6.469470890023181,11.168724055057385,12.071666666666667,12.071666666666667,12.071666666666667,1753485,1229512.5666666667,75.69342091160101,80.72208677236246,NaN,NaN,NaN,NaN,0.4178771469387517,41.130308986834,3287996,0.01808667662396779,0.7598880947758282,0.7418014181518604
2023-12-14T13:30:00-05:00,12.03,12.15,11.87,12.07,10.966877911517328,NaN,NaN,NaN,NaN,NaN,9.424600000000003,12.390472444998235,6.458727555001773,11.168724055057385,12.055513486775826,12.075814322757234,12.035212650794419,1110172,1246105.5,76.09066706382397,80.3438412301288,NaN,NaN,NaN,NaN,0.40802877930026954,40.67434489623681,4398168,0.009927925733687504,0.7542113253189697,0.7442833995852822
2023-12-15T09:30:00-05:00,12.02,12.02,11.57,11.61,10.966877911517328,NaN,NaN,NaN,NaN,NaN,9.489400000000003,12.501493385006475,6.477306614993532,11.168724055057385,11.733333333333334,11.733333333333334,11.733333333333334,934136,1255200.1,64.48829575581141,78.82688110216147,NaN,NaN,NaN,NaN,0.41459815220739316,39.31707381184897,3464032,-0.03184787457410376,0.7044735563676525,0.7363214309417563
2023-12-15T13:30:00-05:00,11.61,11.71,11.53,11.665,10.966877911517328,NaN,NaN,NaN,NaN,NaN,9.560000000000004,12.607076631789852,6.512923368210156,11.168724055057385,11.68946022895144,11.738341097493405,11.640579360409474,752539,1264473.3666666667,65.17210062774407,77.35876417933217,NaN,NaN,NaN,NaN,0.39784114133543663,37.93733047952216,4216571,-0.0595655490885314,0.6618644945810921,0.7214300436696235
2023-12-18T09:30:00-05:00,11.54,11.9,11.44,11.83,10.966877911517328,NaN,NaN,NaN,NaN,NaN,9.638200000000005,12.713468937832877,6.562931062167133,11.168724055057385,11.723333333333334,11.723333333333334,11.723333333333334,1002368,1282897.8333333333,67.21187970841156,75.91349603821898,NaN,NaN,NaN,NaN,0.40228105981147694,37.03141421921431,5218939,-0.06986315145231381,0.6341011043542313,0.7039642558065451
2023-12-18T13:30:00-05:00,11.835,11.98,11.82,11.94,10.966877911517328,NaN,NaN,NaN,NaN,NaN,9.711600000000002,12.827660615584996,6.59553938441501,11.168724055057385,11.80271821544353,11.89642610248257,11.70901032840449,719367,1293502.7,68.53493475429735,74.88630879258471,NaN,NaN,NaN,NaN,0.38497526982494285,36.34459802618277,5938306,-0.07205311199901154,0.6138978658077807,0.6859509778067923
2023-12-19T09:30:00-05:00,12.11,12.95,12.05,12.74,11.322713823927936,NaN,NaN,NaN,NaN,NaN,9.801800000000004,13.00107726838419,6.602522731615817,11.719294638688961,12.58,12.58,12.58,2439240,1352908.4,76.09112019492088,74.37180418959015,NaN,NaN,NaN,NaN,0.42961989340887546,37.127934537738675,8377546,-0.024848146724005593,0.6548907944017852,0.6797389411257908
2023-12-19T13:30:00-05:00,12.75,13.19,12.745,13.165,11.782363195567575,NaN,NaN,NaN,NaN,NaN,9.897900000000003,13.205016623283774,6.590783376716233,11.98043571095117,12.768221010688032,12.991603439079705,12.544838582296359,1731780,1391539.7333333334,78.97918624783458,73.99154319949659,NaN,NaN,NaN,NaN,0.43107561530824146,38.111477343367106,10109326,0.02696704885610779,0.7134477521959255,0.6864807033398177
2023-12-20T09:30:00-05:00,13.31,13.45,12.81,13.11,11.911460323041776,NaN,NaN,NaN,NaN,NaN,9.993900000000004,13.388579537158096,6.599220462841911,12.162348568760937,13.123333333333333,13.123333333333333,13.123333333333333,2800578,1450263.8666666667,77.67160520247153,73.77490706028891,NaN,NaN,NaN,NaN,0.445998785643367,39.28278884098847,7308748,0.04826166731190695,0.7468077874797014,0.6985461201677945
2023-12-20T13:30:00-05:00,13.11,13.13,12.595,12.62,11.911460323041776,NaN,NaN,NaN,NaN,NaN,10.074800000000003,13.522744291893348,6.626855708106659,12.162348568760937,13.02566133984078,13.18003570989766,12.8712869697839,1121082,1470299.5,67.02500616814336,72.74695264098031,NaN,NaN,NaN,NaN,0.45235601524026936,39.69185690441,6187666,0.021439598358059975,0.7253456181153695,0.7039060197573095
2023-12-21T09:30:00-05:00,12.81,13.05,12.51,12.66,11.911460323041776,NaN,NaN,NaN,NaN,NaN,10.158200000000003,13.650223917443856,6.666176082556149,12.162348568760937,12.74,12.74,12.74,1216782,1479709.9666666666,67.41763288190087,71.90440140268534,NaN,NaN,NaN,NaN,0.45861629986596447,39.807475007580315,7404448,-0.0003605242711650636,0.7034553644183532,0.7038158886895183
2023-12-21T13:30:00-05:00,12.67,12.92,12.625,12.9,11.911460323041776,NaN,NaN,NaN,NaN,NaN,10.248800000000003,13.785321205931046,6.712278794068959,12.162348568760937,12.76209493197198,12.796284607008252,12.727905256935708,508169,1475574.8333333333,69.74531510537253,71.27483205961656,NaN,NaN,NaN,NaN,0.44692942130410984,39.914834674809896,7912617,-0.005105835312893214,0.6974335945484018,0.702539429861295
2023-12-22T09:30:00-05:00,13,13.15,12.83,12.98,11.911460323041776,NaN,NaN,NaN,NaN,NaN,10.341800000000003,13.915957109025832,6.767642890974172,12.162348568760937,12.986666666666665,12.986666905085244,12.986666428248085,810540,1466553.0333333334,70.50179956035895,71.43616075869573,NaN,NaN,NaN,NaN,0.43786303406810206,40.32525259525848,8723157,-0.009111952791465816,0.6911494888719627,0.7002614416634285
2023-12-22T13:30:00-05:00,12.975,12.99,12.79,12.96,11.911460323041776,NaN,NaN,NaN,NaN,NaN,10.440500000000004,14.025834712408301,6.855165287591706,12.162348568760937,12.960506046623841,12.995635342501208,12.925376750746475,449502,1452547.2333333334,70.03036819273008,71.04666659824447,NaN,NaN,NaN,NaN,0.42087281734895204,40.563895913489745,8273655,-0.018805749165386354,0.6767542552066956,0.695560004372082
2023-12-26T09:30:00-05:00,13.02,13.14,12.86,12.87,11.911460323041776,NaN,NaN,NaN,NaN,NaN,10.539100000000003,14.115094233776096,6.96310576622391,12.206283503209267,12.956666666666665,12.956666666666665,12.956666666666665,699593,1424212.1666666667,67.8322468006173,70.48515416174563,NaN,NaN,NaN,NaN,0.41081047325259845,40.996335710593065,7574062,-0.035980682018976196,0.6505841518483617,0.6865648338673379
2023-12-26T13:30:00-05:00,12.87,12.985,12.87,12.95,11.911460323041776,NaN,NaN,NaN,NaN,NaN,10.638200000000005,14.201295710193564,7.075104289806445,12.206283503209267,12.950595408715666,12.960325966213098,12.940864851218233,272350,1417839.2333333334,68.77058893581787,69.96229143831661,NaN,NaN,NaN,NaN,0.3896811537345557,41.39788695076043,7846412,-0.04601329782244035,0.6290482115892875,0.6750615094117278
2023-12-27T09:30:00-05:00,13.03,13.51,12.92,13.35,12.044709383983768,NaN,NaN,NaN,NaN,NaN,10.743000000000004,14.310728128655516,7.175271871344492,12.57142144205393,13.26,13.26,13.26,1666146,1383323.8,73.0099370099401,70.57098009932582,NaN,NaN,NaN,NaN,0.40398964275351595,42.43951563354994,9512558,-0.030516795335108426,0.6369155152428423,0.6674323105779507
2023-12-27T13:30:00-05:00,13.35,13.37,13.16,13.26,12.119268048348143,NaN,NaN,NaN,NaN,NaN,10.843300000000005,14.406454001723707,7.280145998276302,12.57142144205393,13.260921506399901,13.262412316222637,13.259430696577166,636598,1356999.4,70.68490383115157,70.96475175671208,NaN,NaN,NaN,NaN,0.3901332396996933,43.40674226756876,8875960,-0.031032589672631117,0.6286415734871618,0.6596741631597929
2023-12-28T09:30:00-05:00,13.09,13.28,13.07,13.23,12.119268048348143,NaN,NaN,NaN,NaN,NaN,10.945200000000005,14.484048377650511,7.406351622349499,12.57142144205393,13.193333333333333,13.193333333333333,13.193333333333333,606919,1216271.2,69.88598856049207,71.15575953186068,NaN,NaN,NaN,NaN,0.37726657972114375,43.92946497987118,8269041,-0.037657753280580186,0.6126019715590676,0.6502597248396478
2023-12-28T13:30:00-05:00,13.235,13.24,13.09,13.19,12.119268048348143,NaN,NaN,NaN,NaN,NaN,11.048900000000003,14.54060175702333,7.557198242976677,12.57142144205393,13.18565330978625,13.195380473259604,13.175926146312896,378341,1153386.2666666666,68.76990706306782,71.17254326820144,NaN,NaN,NaN,NaN,0.36103325259820496,44.41485035558056,7890700,-0.04831719616625896,0.589863229631824,0.638180425798083
2023-12-29T09:30:00-05:00,13.18,13.18,12.52,12.63,12.119268048348143,NaN,NaN,NaN,NaN,NaN,11.142100000000005,14.547809376913964,7.736390623086045,12.57142144205393,12.776666666666666,12.776666666666666,12.776666666666666,1403760,1140034.9333333333,55.42478546359695,69.6963765016783,NaN,NaN,NaN,NaN,0.38310230598404743,42.72962572224116,6486940,-0.09402152205783643,0.5206535232257874,0.6146750452836238
2023-12-29T13:30:00-05:00,12.64,12.77,12.635,12.75,12.119268048348143,NaN,NaN,NaN,NaN,NaN,11.234600000000006,14.557735170287186,7.911464829712825,12.57142144205393,12.758024821034624,12.785226339128883,12.730823302940365,659302,1121318.9666666666,57.33538568767359,68.15039074738108,NaN,NaN,NaN,NaN,0.3657378555566154,41.16477427699743,7146242,-0.11568509993587228,0.4700686703637835,0.5857537702996558
2024-01-02T09:30:00-05:00,12.745,12.745,12.28,12.57,12.119268048348143,NaN,NaN,NaN,NaN,NaN,11.321800000000003,14.55036299923044,8.093237000769566,12.57142144205393,12.531666666666666,12.531666666666666,12.531666666666666,805468,1085243.4,53.6225975115212,66.43260448374177,NaN,NaN,NaN,NaN,0.3731851515882858,38.629988536097564,6340774,-0.14002639155782803,0.41072078085237074,0.5507471724101988
2024-01-02T13:30:00-05:00,12.57,12.6,12.3,12.38,12.119268048348143,NaN,NaN,NaN,NaN,NaN,11.403600000000004,14.526273879866366,8.280926120133643,12.57142144205393,12.479320352244237,12.531820127298149,12.426820577190325,800766,1076959.8333333333,49.94601705422301,65.21267668989033,NaN,NaN,NaN,NaN,0.36795764076055104,36.27625891954769,5540008,-0.16508903971702815,0.3443858727639135,0.5094749124809417
2024-01-03T09:30:00-05:00,11.72,11.97,11.55,11.915,NaN,NaN,NaN,12.928247691418582,12.928247691418582,12.928247691418582,11.473600000000003,14.479906065589429,8.467293934410577,12.57142144205393,11.811666666666667,11.811666666666667,11.811666666666667,939978,1063309.0333333334,42.301709070970155,63.4186821319667,NaN,NaN,NaN,NaN,0.4009606664205117,35.0530740430656,4600030,-0.20646358098246953,0.25139543625285476,0.4578590172353243
2024-01-03T13:30:00-05:00,11.915,11.95,11.74,11.8,NaN,NaN,NaN,12.928247691418582,NaN,NaN,11.541600000000003,14.41773312626517,8.665466873734836,12.57142144205393,11.819491930040225,11.82855991851675,11.810423941563702,699993,1060663.6666666667,40.64489823476252,61.34008092692313,NaN,NaN,NaN,NaN,0.3873206188190465,33.91725951490365,3900037,-0.2330864244111659,0.16650098672136693,0.3995874111325328
2024-01-04T09:30:00-05:00,11.65,12.145,11.63,12.115,NaN,NaN,NaN,12.928247691418582,NaN,NaN,11.612700000000004,14.363523302213306,8.861876697786702,12.533247778331614,11.963333333333333,11.963333333333333,11.963333333333333,784623,1056411.5,46.79224033406213,59.64654098218764,NaN,NaN,NaN,NaN,0.39644057461768595,32.299494164675785,4684660,-0.2210947294276096,0.12321899934802083,0.34431372877563043
2024-01-04T13:30:00-05:00,12.12,12.17,11.935,11.975,NaN,NaN,NaN,12.928247691418582,NaN,NaN,11.679600000000002,14.296450656801017,9.062749343198988,12.533247778331614,11.9886947745286,12.019727368837051,11.957662180220149,524050,1057507.1,44.58223495893498,57.82881717977371,NaN,NaN,NaN,NaN,0.3849091050021369,30.725341284744655,4160610,-0.2140619317473585,0.07673631409143233,0.2907982458387908
2024-01-05T09:30:00-05:00,11.8,12.16,11.77,11.94,NaN,NaN,NaN,12.928247691418582,NaN,NaN,11.738100000000005,14.242423373687938,9.233776626312071,12.533247778331614,11.956666666666665,11.956666666666665,11.956666666666665,537709,1025573.7333333333,44.02245360596652,56.128117665870086,NaN,NaN,NaN,NaN,0.3852727403591271,29.65109945763857,3622901,-0.20331720055897412,0.03665174514007319,0.2399689456990473
2024-01-05T13:30:00-05:00,11.94,11.99,11.87,11.9,NaN,NaN,NaN,12.928247691418582,NaN,NaN,11.797900000000002,14.168464565667827,9.427335434332177,12.27959822266529,11.93904443283172,11.957363970179598,11.920724895483842,497554,975429.6666666666,43.35249599044289,54.31253959834329,NaN,NaN,NaN,NaN,0.3663246874763324,28.653589189611488,3125347,-0.19066484521569155,0.001637889179432861,0.1923027343951244
2024-01-08T09:30:00-05:00,11.98,12.4,11.97,12.23,NaN,NaN,NaN,12.928247691418582,NaN,NaN,11.865500000000003,14.083838342092992,9.647161657907013,11.979678578132232,12.200000000000001,12.200000000000001,12.200000000000001,1230529,957997.8,50.09957724878396,52.676085329689286,NaN,NaN,NaN,NaN,0.3758729240851658,26.712411893214366,4355876,-0.15343298602074387,0.000511501869194575,0.15394448788993845
2024-01-08T13:30:00-05:00,12.23,12.58,12.225,12.43,NaN,NaN,NaN,12.928247691418582,NaN,NaN,11.938300000000003,13.98002046078784,9.896579539212167,11.877742862505785,12.299583464403044,12.405232097062516,12.193934831743572,1093298,957435.3333333334,53.698949356424066,51.46280286720876,NaN,NaN,NaN,NaN,0.3743820009362254,25.37115945097813,5449174,-0.11069351706227562,0.015577591562093929,0.12627110862436955
2024-01-09T09:30:00-05:00,12.245,12.355,12.145,12.245,NaN,NaN,NaN,12.928247691418582,NaN,NaN,11.999700000000002,13.883897877081877,10.115502122918128,11.756194290004629,12.248333333333333,12.248333333333333,12.248333333333333,543164,944402.9333333333,50.09914226206382,50.04945670303531,NaN,NaN,NaN,NaN,0.3679975722979236,23.891198310192546,4906010,-0.09105996624401096,0.01244615081935585,0.1035061170633668
2024-01-09T13:30:00-05:00,12.24,12.275,12.135,12.2,NaN,NaN,NaN,12.928247691418582,NaN,NaN,12.057200000000002,13.779949151791957,10.334450848208046,11.675630365413744,12.22944972158766,12.251657191862245,12.207242251313074,392738,932409.5666666667,49.23455481843738,48.654074399847424,NaN,NaN,NaN,NaN,0.3517120314195005,22.48646478887914,4513272,-0.07779596343972231,0.006261162763713912,0.08405712620343622
2024-01-10T09:30:00-05:00,12.18,12.345,11.78,12.23,NaN,NaN,NaN,12.928247691418582,NaN,NaN,12.111200000000004,13.675696800891524,10.546703199108483,11.675630365413744,12.118333333333334,12.118333333333334,12.118333333333334,762041,924398.6666666666,49.85584201096583,48.25629272465949,NaN,NaN,NaN,NaN,0.36694688631810773,21.582628750436164,5275313,-0.0642559533531607,0.0037371845119853475,0.06799313786514605
2024-01-10T13:30:00-05:00,12.23,12.325,12.09,12.14,NaN,NaN,NaN,12.928247691418582,NaN,NaN,12.162800000000002,13.547132561200467,10.778467438799538,11.675630365413744,12.143263447538553,12.17552018357001,12.111006711507097,455183,915592.5333333333,47.959549898514,47.586590168290954,NaN,NaN,NaN,NaN,0.3575221087239572,20.743352429024828,4820130,-0.05876440429454677,-0.005462367503037413,0.053302036791509355
2024-01-11T09:30:00-05:00,12.55,12.58,11.635,11.78,NaN,NaN,NaN,12.928247691418582,NaN,NaN,12.196400000000004,13.454641693793237,10.938158306206772,11.675630365413744,11.998333333333333,11.998333333333333,11.998333333333333,1148046,872552.7333333333,41.20784086981387,46.69982183674042,NaN,NaN,NaN,NaN,0.3994848152436745,21.039638786691654,3672084,-0.07570218402622295,-0.041325693241269335,0.03437649078495361
2024-01-11T13:30:00-05:00,11.78,11.83,11.7,11.725,NaN,NaN,NaN,12.897420405892332,NaN,NaN,12.220300000000002,13.393549180694313,11.04705081930569,11.675630365413744,11.907914334825453,12.026774579121625,11.78905409052928,664363,836972.1666666666,40.274975909843775,46.00903318357048,NaN,NaN,NaN,NaN,0.38023589986912637,21.31476183309656,3007721,-0.08617339805869591,-0.07334025678841627,0.012833141270279635
2024-01-12T09:30:00-05:00,11.53,11.53,10.99,11.105,NaN,NaN,NaN,12.441174023806315,NaN,NaN,12.216800000000003,13.402229474916048,11.031370525083958,11.675630365413744,11.208333333333334,11.208333333333334,11.208333333333334,1505027,793787.1333333333,31.592609598289044,45.2440975069504,NaN,NaN,NaN,NaN,0.4055761927356173,22.815386877473617,1502694,-0.12790314909837838,-0.14704579510269333,-0.01914264600431496
2024-01-12T13:30:00-05:00,11.11,11.17,11.01,11.025,NaN,NaN,NaN,12.239302477269666,NaN,NaN,12.211700000000002,13.415262395557383,11.008137604442622,11.675630365413744,11.166425336115429,11.230541163955968,11.10230950827489,642995,777850.9,30.673742781878232,44.53187211745867,NaN,NaN,NaN,NaN,0.38803503611164464,24.208824418680884,859699,-0.1522845474405617,-0.20949833030501708,-0.05721378286445539
2024-01-16T09:30:00-05:00,10.9,11.02,10.62,10.98,NaN,NaN,NaN,11.972288728302862,NaN,NaN,12.198100000000004,13.441015749357003,10.955184250643004,11.675630365413744,10.873333333333335,10.873333333333335,10.873333333333335,975739,769816.1333333333,30.142667653956295,43.34261692602254,NaN,NaN,NaN,NaN,0.3892468192465272,26.033395607125314,-116040,-0.16193351569471556,-0.25963067748284985,-0.09769716178813428
2024-01-16T13:30:00-05:00,10.975,10.98,10.875,10.94,NaN,NaN,NaN,11.972288728302862,NaN,NaN,12.186900000000003,13.464387988201716,10.90941201179829,11.512203433864796,10.893181389645052,10.92081936977231,10.865543409517795,503219,769651.1333333333,29.651234857212557,42.27611691875665,NaN,NaN,NaN,NaN,0.3689434750146324,27.727640282109427,-619259,-0.16115449976710525,-0.29914028649701585,-0.1379857867299106
2024-01-17T09:30:00-05:00,10.7,10.74,10.53,10.585,NaN,NaN,NaN,11.754492415664386,NaN,NaN,12.167300000000003,13.51072280760742,10.823877192392585,11.512203433864796,10.618333333333334,10.618333452542624,10.618333214124045,654389,764446.1,25.65375376325173,40.964066929991304,NaN,NaN,NaN,NaN,0.3718760839421587,29.71980802523823,-1273648,-0.1736155230795699,-0.35500519057937296,-0.18138966749980306
2024-01-17T13:30:00-05:00,10.58,10.67,10.52,10.66,NaN,NaN,NaN,11.684060942225093,NaN,NaN,12.145700000000003,13.549291122798826,10.742108877201181,11.493310197673468,10.61750595489109,10.618339266963662,10.616672642818518,645103,770966.1333333333,27.86633500418455,39.85791257382999,NaN,NaN,NaN,NaN,0.35602779223200454,31.581186970525287,-628545,-0.16588461871512208,-0.38874544089370566,-0.22286082217858358
2024-01-18T09:30:00-05:00,10.78,10.825,10.53,10.56,NaN,NaN,NaN,11.684060942225093,NaN,NaN,12.124500000000003,13.589872648850736,10.65912735114927,11.493310197673468,10.638333333333334,10.638333333333334,10.638333333333334,696295,770856.2,26.72432389940505,38.18825162030293,NaN,NaN,NaN,NaN,0.3516686642154328,32.67383910228829,-1324840,-0.15669307861395948,-0.4187271704460329,-0.26203409183207343
2024-01-18T13:30:00-05:00,10.57,10.71,10.56,10.68,NaN,NaN,NaN,11.684060942225093,NaN,NaN,12.103700000000003,13.620084924746905,10.587315075253102,11.442148158138775,10.643220097677142,10.648976119301997,10.637464076052288,501870,778506.8666666667,30.409887750303113,36.524747219865716,NaN,NaN,NaN,NaN,0.3372637596286162,33.68844465321107,-822970,-0.13267085478884505,-0.42787266031812976,-0.2952018055292847
2024-01-19T09:30:00-05:00,10.71,10.72,10.38,10.59,NaN,NaN,NaN,11.599742523097916,NaN,NaN,12.082500000000003,13.652360184857141,10.512639815142865,10.85471852651102,10.563333333333334,10.563333333333334,10.563333333333334,588736,742593.2,29.22272368142393,35.033574464105726,NaN,NaN,NaN,NaN,0.33745920536942936,34.90170774119559,-1411706,-0.11371165607849315,-0.43734137562740116,-0.323629719548908
2024-01-19T13:30:00-05:00,10.59,10.75,10.57,10.71,NaN,NaN,NaN,11.599742523097916,NaN,NaN,12.064100000000003,13.675753424281954,10.452446575718053,10.382274821208815,10.622343495067852,10.678961682446062,10.565725307689643,639532,742691,32.9795956120353,33.87250594936272,NaN,NaN,NaN,NaN,0.326212119271613,35.892025980826936,-772174,-0.08525885468054917,-0.4302032878995945,-0.34494443321904533
2024-01-22T09:30:00-05:00,10.82,11.17,10.81,10.84,NaN,NaN,NaN,11.599742523097916,NaN,NaN,12.055100000000003,13.688819057855344,10.421380942144662,10.403111098667402,10.94,10.94,10.94,958747,754418.6,36.88793038213041,32.94622654730305,NaN,NaN,NaN,NaN,0.3357683964664977,35.108119299471554,186573,-0.05151469109088758,-0.40933779708265483,-0.35782310599176725
2024-01-22T13:30:00-05:00,10.84,11.035,10.83,11,NaN,NaN,NaN,11.599742523097916,NaN,NaN,12.035100000000002,13.695296964218365,10.374903035781639,10.403111098667402,10.94509322131391,10.952196559708637,10.937989882919181,492906,758237.4333333333,41.41611567368797,32.4788383883869,NaN,NaN,NaN,NaN,0.3264277967188907,34.3802059524987,679479,-0.01419098668925961,-0.37556183935334175,-0.36137085266408214
2024-01-23T09:30:00-05:00,11.16,11.29,10.93,10.945,NaN,NaN,NaN,11.599742523097916,NaN,NaN,12.013500000000004,13.701529916796387,10.325470083203621,10.537191103147137,11.055,11.055,11.055,627361,732357.4666666667,40.34453740426511,32.41717385513341,NaN,NaN,NaN,NaN,0.3288258112389699,32.79924410006726,52118,0.009731280695257083,-0.3492067517950108,-0.3589380324902679
2024-01-23T13:30:00-05:00,10.95,11,10.875,10.94,NaN,NaN,NaN,11.599742523097916,NaN,NaN,11.990900000000003,13.705349987605274,10.276450012394733,10.537191103147137,11.009489874817755,11.066396316548863,10.952583433086646,401246,723755.6,40.24260023585339,32.41486130699125,NaN,NaN,NaN,NaN,0.3142668247219006,31.47548711597894,-349128,0.027168445834201804,-0.32497747519751563,-0.35214592103171743
2024-01-24T09:30:00-05:00,11.12,11.22,10.77,10.8,NaN,NaN,NaN,11.599742523097916,NaN,NaN,11.974700000000002,13.718300194998811,10.231099805001193,10.537191103147137,10.930000000000001,10.930000000000001,10.930000000000001,644960,718405.3333333334,37.393628447499374,32.82921979622056,NaN,NaN,NaN,NaN,0.3239620515274792,29.510000267755537,-994088,0.030949482513746795,-0.3134590678895339,-0.3444085504032807
2024-01-24T13:30:00-05:00,10.805,10.87,10.74,10.81,NaN,NaN,NaN,11.599742523097916,NaN,NaN,11.957600000000005,13.729553994888024,10.185646005111986,10.537191103147137,10.883008725896296,10.94290372260613,10.823113729186462,396996,704946.3333333334,37.73272130945934,33.33343254819064,NaN,NaN,NaN,NaN,0.3101076192755163,27.774596917889266,-597092,0.0354750236890673,-0.3000647707919466,-0.3355397944810139
2024-01-25T09:30:00-05:00,10.83,10.895,10.62,10.695,NaN,NaN,NaN,11.599742523097916,NaN,NaN,11.934900000000004,13.741551587882833,10.128248412117175,10.537191103147137,10.736666666666666,10.736666666666666,10.736666666666666,449348,688592,35.360777263328444,33.706154663145796,NaN,NaN,NaN,NaN,0.307599932184408,26.524132558733253,-1046440,0.03217190678032206,-0.2953249110056113,-0.32749681778593337
2024-01-25T13:30:00-05:00,10.695,10.73,10.655,10.71,NaN,NaN,NaN,11.599742523097916,NaN,NaN,11.910300000000005,13.749212080551827,10.071387919448183,10.537191103147137,10.721289632641602,10.740077921428457,10.702501343854747,300991,675291.9333333333,35.926550654734044,34.154391505825906,NaN,NaN,NaN,NaN,0.29098565131409326,25.362987082374094,-745449,0.032358063510331325,-0.2870492383980192,-0.31940730190835054
2024-01-26T09:30:00-05:00,10.77,11.01,10.71,10.81,NaN,NaN,NaN,11.599742523097916,NaN,NaN,11.871700000000002,13.720326095239292,10.023073904760713,10.537191103147137,10.843333333333334,10.843333333333334,10.843333333333334,435727,663662.0666666667,39.71489821065193,35.15875896635449,NaN,NaN,NaN,NaN,0.2916295333630865,23.81103695340395,-309722,0.040072221567649335,-0.26931702494878884,-0.3093892465164382
2024-01-26T13:30:00-05:00,10.82,10.83,10.75,10.79,NaN,NaN,NaN,11.599742523097916,NaN,NaN,11.824200000000003,13.659462771376269,9.988937228623737,10.537191103147137,10.820658497671907,10.847024695659753,10.794292299684061,322261,656935.7666666667,39.21550321893471,35.969413838836644,NaN,NaN,NaN,NaN,0.27651313812286604,22.36994040507453,-631983,0.04435094374604731,-0.25395056683387907,-0.2983015105799264
2024-01-29T09:30:00-05:00,10.81,11.17,10.765,11.15,NaN,NaN,NaN,11.599742523097916,NaN,NaN,11.785000000000002,13.592247631067675,9.977752368932329,10.544290825307778,11.028333333333334,11.028333333333334,11.028333333333334,812377,666091.3666666667,51.12811541174722,37.71254180400394,NaN,NaN,NaN,NaN,0.28569077111408986,22.069724012863354,180394,0.07040173106278835,-0.2102993467514409,-0.28070107781422926
2024-01-29T13:30:00-05:00,11.145,11.33,11.12,11.33,NaN,NaN,NaN,11.599742523097916,NaN,NaN,11.759200000000003,13.55482396954363,9.963576030456377,10.724432660246222,11.144868966016482,11.260700170304338,11.029037761728626,822288,676915.8333333334,55.79318466552042,39.52563444080518,NaN,NaN,NaN,NaN,0.2802842874630835,22.205934904842888,1002682,0.0970855624221435,-0.1593441247865499,-0.2564296872086934
2024-01-30T09:30:00-05:00,11.25,11.28,11.015,11.09,NaN,NaN,NaN,11.599742523097916,NaN,NaN,11.727800000000004,13.514202149573165,9.941397850426842,10.724432660246222,11.128333333333336,11.128333333333336,11.128333333333336,619201,656538.2333333333,49.06777431622935,40.943138057576995,NaN,NaN,NaN,NaN,0.28276398121572033,21.909325122764116,383481,0.09574266655193861,-0.13675135401877014,-0.23249402057070875
2024-01-30T13:30:00-05:00,11.09,11.09,10.955,11.01,NaN,NaN,NaN,11.599742523097916,NaN,NaN,11.690000000000005,13.45544951782809,9.92455048217192,10.724432660246222,11.083884301457745,11.137862788576655,11.029905814338836,419870,634090.6333333333,47.03260701051847,41.946924586040076,NaN,NaN,NaN,NaN,0.27220941112888314,21.393058503148783,-36389,0.08689616714973175,-0.12387381163354405,-0.2107699787832758
2024-01-31T09:30:00-05:00,10.94,11.105,10.87,11.06,NaN,NaN,NaN,11.599742523097916,NaN,NaN,11.651600000000004,13.386401936821496,9.916798063178511,10.724432660246222,11.011666666666668,11.011666666666668,11.011666666666668,357441,627899.8666666667,48.47113731700999,42.774296509960045,NaN,NaN,NaN,NaN,0.26955159604824874,20.571626858087956,321052,0.08190854489350988,-0.10838429766638846,-0.19029284255989834
2024-01-31T13:30:00-05:00,11.055,11.17,10.7,10.74,NaN,NaN,NaN,11.599742523097916,NaN,NaN,11.607200000000004,13.319269110754451,9.895130889245557,10.724432660246222,10.912091054706138,10.976830861088382,10.847351248323895,845605,642995.4333333333,40.82857041663339,42.732328991599,NaN,NaN,NaN,NaN,0.2838693391876596,19.16117620424472,-524553,0.05580182971910094,-0.12054055541102215,-0.1763423851301231
2024-02-01T09:30:00-05:00,10.81,10.94,10.62,10.91,NaN,NaN,NaN,11.599742523097916,NaN,NaN,11.568000000000005,13.252146074424545,9.883853925575465,10.724432660246222,10.823333333333332,10.823333333333332,10.823333333333332,537474,635509.8666666667,45.72458619502759,43.11661819093918,NaN,NaN,NaN,NaN,0.2864501006742554,18.02263936544339,12921,0.04897010501031199,-0.11512975386723312,-0.1640998588775451
2024-02-01T13:30:00-05:00,10.91,10.93,10.82,10.93,NaN,NaN,NaN,11.599742523097916,NaN,NaN,11.527600000000005,13.17368291407191,9.8815170859281,10.724432660246222,10.851712377260638,10.886080428422552,10.817344326098723,366474,632552.9,46.28766674085672,43.54840865558227,NaN,NaN,NaN,NaN,0.2738465220546657,16.965426586556447,379395,0.04489343885727648,-0.10798306030594951,-0.152876499163226
2024-02-02T09:30:00-05:00,10.72,10.94,10.66,10.89,NaN,NaN,NaN,11.599742523097916,NaN,NaN,11.478400000000004,13.048985164834928,9.90781483516508,10.724432660246222,10.83,10.83,10.83,439303,608928.1333333333,45.275971204832146,44.1114331382489,NaN,NaN,NaN,NaN,0.2742860561936181,16.572504775930643,-59908,0.038825914551523955,-0.10434410597382104,-0.143170020525345
2024-02-02T13:30:00-05:00,10.89,11.015,10.87,10.92,NaN,NaN,NaN,11.599742523097916,NaN,NaN,11.431600000000003,12.924581500220164,9.938618499779842,10.724432660246222,10.88852555616008,10.940678625800565,10.836372486519593,553217,605223.2666666667,46.2252824576189,44.71804464883172,NaN,NaN,NaN,NaN,0.2650513378940741,15.879438790772573,493309,0.036207372929493775,-0.09791080436347777,-0.13411817729297154
2024-02-05T09:30:00-05:00,10.8,10.88,10.51,10.61,NaN,NaN,NaN,11.57009966236236,NaN,NaN,11.379200000000004,12.79809867150533,9.960301328494678,10.724432660246222,10.666666666666666,10.666666785875956,10.666666547457377,748484,580005.1666666666,38.745673355436544,44.959822941125154,NaN,NaN,NaN,NaN,0.2754048137587831,16.404404024086812,-255175,0.01410732548957383,-0.11648402043100425,-0.13059134592057808
2024-02-05T13:30:00-05:00,10.6,10.69,10.545,10.56,NaN,NaN,NaN,11.472595132254979,NaN,NaN,11.326600000000006,12.665843726884471,9.987356273115541,10.638046128196978,10.64356485866403,10.675890235906403,10.611239481421658,382285,571314.8333333334,37.68647371515659,45.08553173115534,NaN,NaN,NaN,NaN,0.2660901842045843,16.89187174073575,-637460,-0.002484392227931842,-0.13369683620549289,-0.13121244397756104
2024-02-06T09:30:00-05:00,10.58,10.77,10.54,10.69,NaN,NaN,NaN,11.472595132254979,NaN,NaN,11.287800000000006,12.585515161350658,9.990084838649354,10.522649522046066,10.666666666666664,10.666666905085243,10.666666428248085,417766,552715.7333333333,42.11707920020738,45.257116087552156,NaN,NaN,NaN,NaN,0.2635123139042569,16.963290214621786,-219694,-0.0032609884106371,-0.13528867949085743,-0.13202769108022033
2024-02-06T13:30:00-05:00,10.69,10.8,10.675,10.785,NaN,NaN,NaN,11.472595132254979,NaN,NaN,11.248500000000005,12.484246333192814,10.012753666807196,10.522649522046066,10.69983610868955,10.741960603834501,10.657711613544597,259024,544575.9,45.18433753874814,45.68346139611026,NaN,NaN,NaN,NaN,0.25361857719680997,16.88484919293252,39330,0.0036895518686156925,-0.1274157512444507,-0.1311053031130664
2024-02-07T09:30:00-05:00,10.84,11.07,10.645,11.05,NaN,NaN,NaN,11.472595132254979,NaN,NaN,11.218100000000007,12.395731334501335,10.040468665498679,10.469119617636853,10.921666666666667,10.921666666666667,10.921666666666667,472467,538511.8333333334,52.71196529854821,45.79659353088176,NaN,NaN,NaN,NaN,0.26586010739703786,15.727550984114766,511797,0.025959546390025026,-0.09865587012553512,-0.12461541651556014
2024-02-07T13:30:00-05:00,11.07,11.075,10.98,10.99,NaN,NaN,NaN,11.472595132254979,NaN,NaN,11.190300000000006,12.321620308312141,10.05897969168787,10.507425268703557,10.968284785667068,11.01495142708151,10.921618144252626,471485,532724.5666666667,51.00411901724401,45.454517413147734,NaN,NaN,NaN,NaN,0.2536558140115351,14.673065306370049,40312,0.035864140332998284,-0.07978524109931229,-0.11564938143231057
2024-02-08T09:30:00-05:00,11.05,11.34,11.005,11.175,NaN,NaN,NaN,11.472595132254979,NaN,NaN,11.175500000000007,12.287710861302585,10.063289138697428,10.710940214962847,11.173333333333332,11.173333333333332,11.173333333333332,551878,527910.6666666666,55.76325282930342,45.932765878367306,NaN,NaN,NaN,NaN,0.2605375415821397,14.68067688626252,592190,0.05305271157490776,-0.04933349196367587,-0.10238620353858363
2024-02-08T13:30:00-05:00,11.175,11.245,11.17,11.225,NaN,NaN,NaN,11.472595132254979,NaN,NaN,11.164000000000009,12.261943532245256,10.06605646775476,10.710940214962847,11.185887776567652,11.204450203252655,11.167325349882649,252446,519596.5333333333,56.979513385834366,46.64325919088987,NaN,NaN,NaN,NaN,0.24728486004055825,14.687744781876958,844636,0.0651693828899079,-0.020924474926198755,-0.08609385781610665
2024-02-09T09:30:00-05:00,11.41,11.52,11.25,11.52,10.577474634766876,10.577474634766876,10.577474634766876,NaN,NaN,NaN,11.152100000000008,12.221071636667402,10.083128363332614,10.939901737576221,11.43,11.43,11.43,860120,528642.6666666666,63.37730929805078,47.70798576096421,NaN,NaN,NaN,NaN,0.2506930843233755,15.569348981806353,1704756,0.08895870308688145,0.025104521042495165,-0.06385418204438628
2024-02-09T13:30:00-05:00,11.52,11.6,11.475,11.55,10.749634878641109,NaN,NaN,NaN,NaN,NaN,11.143600000000008,12.192839800998469,10.094360199001548,11.073421390060977,11.48316230148143,11.538931707968601,11.42739289499426,781582,533377.6666666666,63.96422117541383,49.36053224373425,NaN,NaN,NaN,NaN,0.24171500687170583,16.612596638816715,2486338,0.10170270220106266,0.06327419570694204,-0.03842850649412062
2024-02-12T09:30:00-05:00,11.73,12.13,11.66,12.02,11.063856020521058,NaN,NaN,NaN,NaN,NaN,11.145200000000006,12.199524352369563,10.09087564763045,11.418737112048783,11.936666666666667,11.936666666666667,11.936666666666667,1903894,564882.5666666667,71.63398879783578,51.21120385822054,NaN,NaN,NaN,NaN,0.265878220666584,18.754193752202777,4390232,0.13470361760106725,0.12995101550721344,-0.004752602093853808
2024-02-12T13:30:00-05:00,12.02,12.05,11.89,12.01,11.154817110497374,NaN,NaN,NaN,NaN,NaN,11.147400000000006,12.208452760233687,10.086347239766326,11.418737112048783,11.951477095002515,11.973198157011803,11.929756032993227,885148,577957.3,71.28633943888453,52.996823336651104,NaN,NaN,NaN,NaN,0.2583154906189709,20.74281964320412,3505084,0.14773171774591565,0.17991204508854075,0.032180327342625104
2024-02-13T09:30:00-05:00,11.61,11.93,11.43,11.805,11.154817110497374,NaN,NaN,NaN,NaN,NaN,11.138900000000005,12.17155539266479,10.10624460733522,11.418737112048783,11.721666666666666,11.721666666666666,11.721666666666666,1576096,609581.8,64.38769558599728,54.36194650673433,NaN,NaN,NaN,NaN,0.2812929555747587,20.585208869962152,1928988,0.13477713477681252,0.20065174581364076,0.06587461103682823
2024-02-13T13:30:00-05:00,11.8,11.905,11.62,11.845,11.154817110497374,NaN,NaN,NaN,NaN,NaN,11.127200000000006,12.113283485309255,10.141116514690756,11.418737112048783,11.758053585392869,11.792148036436265,11.723959134349473,1795171,656045.9666666667,65.0974456434204,55.709958162863,NaN,NaN,NaN,NaN,0.28155774446227594,20.438856009094607,3724159,0.12154435332833984,0.21780505269725303,0.0962606993689132
2024-02-14T09:30:00-05:00,13.62,13.9,12.77,13.11,12.236613566896713,NaN,NaN,NaN,NaN,NaN,11.144500000000004,12.233410005464076,10.055589994535932,12.240606721095181,13.26,13.260000168587394,13.259999831412605,6297211,844454.3333333334,79.20940845088757,58.60022495539522,NaN,NaN,NaN,NaN,0.4082321912863991,23.157123501572702,10021370,0.18673050074177183,0.329673825296128,0.14294332455435615
2024-02-14T13:30:00-05:00,13.11,13.465,13.07,13.37,12.236613566896713,NaN,NaN,NaN,NaN,NaN,11.167900000000007,12.388816196960095,9.946983803039918,12.240606721095181,13.27373455104583,13.293321155341474,13.254147946750187,3096413,934434.9,80.91721788565502,61.68813525328797,NaN,NaN,NaN,NaN,0.40728703476594197,25.68122903030236,13117783,0.23308859925667877,0.4343040736252046,0.20121547436852585
2024-02-15T09:30:00-05:00,13.4,13.545,13.04,13.32,12.236613566896713,NaN,NaN,NaN,NaN,NaN,11.189700000000006,12.51974272111823,9.85965727888178,12.240606721095181,13.301666666666668,13.301666666666668,13.301666666666668,2361191,998163,79.56368506364319,64.36289281496195,NaN,NaN,NaN,NaN,0.41426653228266047,28.09116244775454,10756592,0.24490074150447638,0.5073414012491213,0.2624406597446449
2024-02-15T13:30:00-05:00,13.31,13.41,13.26,13.41,12.244422261742153,NaN,NaN,NaN,NaN,NaN,11.215100000000005,12.66028717126871,9.7699128287313,12.240606721095181,13.321146571663887,13.348657680197595,13.293635463130178,1183828,1027590.9,80.20552827686544,66.8644064391132,NaN,NaN,NaN,NaN,0.3953903514053276,30.32895776396014,11940420,0.24281723022142893,0.5659621975214311,0.32314496730000214
2024-02-16T09:30:00-05:00,13.36,14.355,13.32,14.075,12.655357613481147,NaN,NaN,NaN,NaN,NaN,11.261000000000006,12.906883349450874,9.615116650549139,12.835092512960586,13.916666666666666,13.916666666666666,13.916666666666666,3579509,1132383.6333333333,84.16333014340637,69.1109324994602,NaN,NaN,NaN,NaN,0.4410767548763756,33.085276446253886,15519929,0.2682751407236941,0.6584888932046198,0.39021375248092566
2024-02-16T13:30:00-05:00,14.08,14.18,13.99,14,12.930682267413822,NaN,NaN,NaN,NaN,NaN,11.306500000000005,13.118569811017116,9.494430188982895,12.869074010368468,13.964511866558022,14.030913408951013,13.89811032416503,1858420,1183588.9333333333,82.16789957886058,71.33691682528995,NaN,NaN,NaN,NaN,0.4231427009566344,35.64471522266952,13661509,0.2618244105619944,0.7174942656834187,0.45566985512142427
2024-02-20T09:30:00-05:00,13.98,14.235,13.68,13.89,12.930682267413822,NaN,NaN,NaN,NaN,NaN,11.362200000000005,13.312045286170077,9.412354713829933,12.908759208294775,13.935,13.935,13.935,1173107,1195613.2666666666,79.20193733005965,73.01110857534397,NaN,NaN,NaN,NaN,0.43256107945973193,37.034863911110456,12488402,0.23288175151269885,0.7467720445122978,0.513890292999599
2024-02-20T13:30:00-05:00,13.88,14.14,13.77,14.1,12.930682267413822,NaN,NaN,NaN,NaN,NaN,11.423700000000006,13.5159034413507,9.331496558649311,12.908759208294775,13.962122951214369,13.995555677452062,13.928690224976675,772090,1193940,80.6387745472133,74.70105580115676,NaN,NaN,NaN,NaN,0.42809243092689403,38.32571626466276,13260492,0.21124967699339037,0.7779523892413369,0.5667027122479465
2024-02-21T09:30:00-05:00,13.79,13.89,13.42,13.535,12.930682267413822,NaN,NaN,NaN,NaN,NaN,11.474800000000005,13.64452990024096,9.305070099759051,12.908759208294775,13.615,13.615,13.615,999824,1206627.4333333333,67.18947232239398,74.97335316003841,NaN,NaN,NaN,NaN,0.44608582871783015,38.452975354466865,12260668,0.14539355411555488,0.7484446548923902,0.6030511007768353
2024-02-21T13:30:00-05:00,13.54,13.635,13.39,13.595,12.930682267413822,NaN,NaN,NaN,NaN,NaN,11.527900000000006,13.771376846325726,9.284423153674286,12.908759208294775,13.586874044773218,13.623183510269213,13.550564579277223,599927,1212629.3333333333,67.80358884816346,75.24759370809196,NaN,NaN,NaN,NaN,0.4317225552379851,38.48260118597751,12860595,0.09482559983824446,0.7215831005746409,0.6267575007363965
2024-02-22T09:30:00-05:00,13.705,14.09,13.595,14.01,12.930682267413822,NaN,NaN,NaN,NaN,NaN,11.596400000000006,13.927957453720486,9.264842546279526,12.908759208294775,13.898333333333333,13.898333501920728,13.898333164745939,900915,1230745.1333333333,71.74311018613672,75.2553880929706,NaN,NaN,NaN,NaN,0.4362423727209861,39.061452333207804,13761510,0.0789299731134927,0.7254199671282624,0.6464899940147697
2024-02-22T13:30:00-05:00,14.01,14.05,13.92,13.98,12.930682267413822,NaN,NaN,NaN,NaN,NaN,11.662800000000006,14.071721053085703,9.253878946914309,13.024161417374033,13.926395517658696,13.966368001676582,13.88642303364081,444022,1217359.0333333334,71.06616004460356,75.23966099337909,NaN,NaN,NaN,NaN,0.41436791752663005,39.598956969921645,13317488,0.05702080682978605,0.7177660025520023,0.6607451957222162
2024-02-23T09:30:00-05:00,14.04,14.49,14.01,14.42,13.065264252200578,NaN,NaN,NaN,NaN,NaN,11.740000000000007,14.247975278984917,9.232024721015097,13.414329133899226,14.306666666666667,14.306666666666667,14.306666666666667,1206865,1239672.0666666667,74.8190414950255,75.98475712973826,NaN,NaN,NaN,NaN,0.42119878056044213,40.57132272665166,14524353,0.06235532519333398,0.7386893522138838,0.6763340270205498
2024-02-23T13:30:00-05:00,14.42,14.5,14.35,14.49,13.273661331646005,NaN,NaN,NaN,NaN,NaN,11.816200000000006,14.420393971270084,9.212006028729927,13.56446330711938,14.35763415125101,14.424997073968026,14.290271228533996,690881,1250485.6333333333,75.36645527828799,76.7182578179431,NaN,NaN,NaN,NaN,0.40182743909183916,41.48434941614102,15215234,0.06073135701657306,0.7522482232912662,0.6915168662746931
2024-02-26T09:30:00-05:00,14.68,15.38,14.68,15.29,13.809631271116643,NaN,NaN,NaN,NaN,NaN,11.910200000000005,14.66548217066775,9.15491782933226,14.186570645695504,15.116666666666667,15.116666666666667,15.116666666666667,2236157,1310380.7666666666,80.56616039902937,76.8151686713818,NaN,NaN,NaN,NaN,0.43669690772813635,43.074864132833916,17451391,0.10127955091950425,0.8181163049240734,0.7168367540045691
2024-02-26T13:30:00-05:00,15.29,15.61,15.27,15.59,14.22873894061134,NaN,NaN,NaN,NaN,NaN,12.007800000000005,14.92696300332812,9.08863699667189,14.485256516556403,15.289218853016253,15.475351133638906,15.1030865723936,1921763,1355998.9666666666,82.09266693143229,76.89912931750874,NaN,NaN,NaN,NaN,0.42978998574755517,44.70462934851267,19373154,0.13399516718420912,0.8843307129848306,0.7503355458006215
2024-02-27T09:30:00-05:00,15.87,16.245,15.55,15.96,14.646523534219916,NaN,NaN,NaN,NaN,NaN,12.110200000000004,15.211822130434273,9.008577869565736,14.997705213245123,15.918333333333335,15.918333333333335,15.918333333333335,1908335,1394660.6666666667,83.78442254039035,77.20061056584782,NaN,NaN,NaN,NaN,0.4487335581941584,46.58177888299148,21281489,0.16424830323971862,0.9556459248502698,0.7913976216105512
2024-02-27T13:30:00-05:00,15.955,16.29,15.95,16.245,14.879522464482644,NaN,NaN,NaN,NaN,NaN,12.215100000000001,15.508299957488163,8.92190004251184,15.122164170596097,16.00042930112763,16.11548119189259,15.885377410362672,971652,1414306.2333333334,84.9628429824975,77.54041875910725,NaN,NaN,NaN,NaN,0.4409668754660042,48.34819838082574,22253141,0.18557322849170554,1.023364157225183,0.8377909287334775
2024-02-28T09:30:00-05:00,16.08,16.53,15.9,16.05,14.944998716097071,NaN,NaN,NaN,NaN,NaN,12.317200000000003,15.759718357249499,8.874681642750508,15.28073133647688,16.16,16.16,16.16,2262893,1475810.4666666666,80.64450090777444,77.28907381370497,NaN,NaN,NaN,NaN,0.45446924150414686,50.112997996521756,19990248,0.16912879880293885,1.049201927237151,0.8800731284342123
2024-02-28T13:30:00-05:00,16.06,16.18,15.97,16.13,14.944998716097071,NaN,NaN,NaN,NaN,NaN,12.421000000000001,16.001376516513304,8.840623483486697,15.28073133647688,16.13826837995838,16.16951756170439,16.10701919821237,1094387,1503655.9,81.06959777686419,77.21062368499095,NaN,NaN,NaN,NaN,0.43700715282527913,51.75174049681092,21084635,0.14703769213486861,1.063870243602798,0.9168325514679294
2024-02-29T09:30:00-05:00,16.18,16.51,15.67,16.42,14.944998716097071,NaN,NaN,NaN,NaN,NaN,12.533400000000002,16.25330722464954,8.813492775350465,15.28073133647688,16.2,16.2,16.2,1658076,1543176.2,82.56449316715246,77.45080624478328,NaN,NaN,NaN,NaN,0.46579235619490217,53.44349470815671,22742711,0.13563199080451582,1.0863725399735742,0.9507405491690584
2024-02-29T13:30:00-05:00,16.42,16.45,16.23,16.29,15.069997005050242,NaN,NaN,NaN,NaN,NaN,12.643000000000002,16.474581396760325,8.811418603239682,15.29717444427616,16.234159452672536,16.28935121796431,16.178967687380762,635152,1548631.7666666666,79.53251738655392,77.37178787616475,NaN,NaN,NaN,NaN,0.44823575932383763,55.014409332977806,22107559,0.10440904869391265,1.0812518600364491,0.9768428113425365
2024-03-01T09:30:00-05:00,16.28,16.6,16.13,16.485,15.088633504820686,NaN,NaN,NaN,NaN,NaN,12.7588,16.69639802925589,8.821201970744111,15.44273955542093,16.405,16.405,16.405,1074814,1566062.9666666666,80.67867727496743,78.3353025156343,NaN,NaN,NaN,NaN,0.4497903479435637,56.55120833847002,23182373,0.08290457360389303,1.0804735283474027,0.9975689547435097
2024-03-01T13:30:00-05:00,16.48,16.6,16.37,16.59,15.235286527328835,NaN,NaN,NaN,NaN,NaN,12.876400000000004,16.9122146835552,8.840585316444807,15.559191644336744,16.4517584440938,16.508246221325845,16.39527066686176,736452,1582196.5,81.28636206881444,79.29835774568078,NaN,NaN,NaN,NaN,0.43409103737616633,57.97823598642707,23918825,0.06268619944635567,1.0759267040514544,1.0132405046050987
2024-03-04T09:30:00-05:00,17.01,17.215,16.54,16.65,15.592546230632069,NaN,NaN,NaN,NaN,NaN,12.993200000000002,17.120043229394575,8.866356770605428,16.044853315469393,16.801666666666666,16.801666666666666,16.801666666666666,1299383,1596838.6,81.64168317841462,80.00539867370063,NaN,NaN,NaN,NaN,0.45129882042072594,59.59616352141713,25218208,0.041319139619554246,1.0648894291295417,1.0235702895099874
2024-03-04T13:30:00-05:00,16.66,16.9,16.59,16.62,15.592546230632069,NaN,NaN,NaN,NaN,NaN,13.109800000000002,17.309849980654974,8.90975001934503,16.044853315469393,16.769413048140255,16.815579160318308,16.7232469359622,634231,1591926.9,80.8154325994049,80.70177528475787,NaN,NaN,NaN,NaN,0.44120604753353115,61.098524803907914,24583977,0.014514438031725918,1.0417133370496447,1.0271988990179188
2024-03-05T09:30:00-05:00,16.3,16.33,15.66,15.92,15.592546230632069,NaN,NaN,NaN,NaN,NaN,13.205200000000001,17.439409234319886,8.970990765680117,16.044853315469393,15.969999999999999,15.969999999999999,15.969999999999999,1441726,1576521.3,64.43025521729075,79.95971912206254,NaN,NaN,NaN,NaN,0.4782627584239933,59.468017949676636,23142251,-0.05708424141546464,0.9558435972485881,1.0129278386640528
2024-03-05T13:30:00-05:00,15.92,16.03,15.69,15.94,15.592546230632069,NaN,NaN,NaN,NaN,NaN,13.297400000000003,17.564898677211236,9.02990132278877,16.044853315469393,15.939588196652371,15.979706012680273,15.89947038062447,828500,1574633.0333333334,64.65077793949905,79.19431359786333,NaN,NaN,NaN,NaN,0.4683868471079939,57.953975870747584,23970751,-0.10692677281165253,0.8792693726494871,0.9861961454611397
2024-03-06T09:30:00-05:00,16.15,16.57,15.77,16.5,15.592546230632069,NaN,NaN,NaN,NaN,NaN,13.405599999999998,17.71784286885608,9.093357131143913,16.044853315469393,16.28,16.28,16.28,1016403,1555976.6,70.21833076608561,78.45518290979591,NaN,NaN,NaN,NaN,0.4920735008859944,57.149401123539235,24987154,-0.10581489803359856,0.8539275229191414,0.95974242095274
2024-03-06T13:30:00-05:00,16.5,16.58,16.33,16.4,15.592546230632069,NaN,NaN,NaN,NaN,NaN,13.513399999999999,17.85012200630845,9.176677993691548,16.044853315469393,16.34286429339752,16.419655047492917,16.26607353930212,681171,1518843.2666666666,68.15403133996011,77.45956608183361,NaN,NaN,NaN,NaN,0.47478253653699476,56.412624591865445,24305983,-0.11470255949245456,0.8163642215871718,0.9310667810796264
2024-03-07T09:30:00-05:00,16.63,16.68,16.14,16.435,15.592546230632069,NaN,NaN,NaN,NaN,NaN,13.620899999999999,17.97546757439819,9.266332425601806,16.044853315469393,16.418333333333333,16.418333333333333,16.418333333333333,720220,1332943.5666666667,68.50304584505848,76.36803917502418,NaN,NaN,NaN,NaN,0.47944092678435224,55.176982235300244,25026203,-0.12051501569114942,0.7804230114656896,0.900938027156839
2024-03-07T13:30:00-05:00,16.44,16.45,16.32,16.35,15.592546230632069,NaN,NaN,NaN,NaN,NaN,13.7331,18.074041782608923,9.392158217391078,16.044853315469393,16.400546864066833,16.422547605599345,16.37854612253432,470728,1245420.7333333334,66.5942421842974,75.05599626086703,NaN,NaN,NaN,NaN,0.4544808605854699,54.02960004706113,24555475,-0.13147873581051672,0.7365896073936931,0.8680683432042098
2024-03-08T09:30:00-05:00,16.56,17.615,16.56,16.985,15.65882788529575,NaN,NaN,NaN,NaN,NaN,13.854599999999998,18.212710067448977,9.496489932551018,16.11950138721946,17.05333333333333,17.05333357175191,17.053333094914752,1894451,1229862.7333333334,72.7116580928646,74.48936463123063,NaN,NaN,NaN,NaN,0.5123750848293647,54.147790721450775,26449926,-0.09884804745040354,0.7445082838912054,0.8433563313416089
2024-03-08T13:30:00-05:00,16.98,17.1,16.85,16.98,15.65882788529575,NaN,NaN,NaN,NaN,NaN,13.975599999999996,18.33813900383715,9.613060996162845,16.11950138721946,17.033508772410446,17.067077653658792,16.9999398911621,660719,1212425.7666666666,72.59892333863893,73.88431645707168,NaN,NaN,NaN,NaN,0.4936340073415529,54.25753920481257,25789207,-0.0812217931711463,0.741829089877676,0.8230508830488223
2024-03-11T09:30:00-04:00,16.95,17.475,16.93,17.33,15.793895862428567,NaN,NaN,NaN,NaN,NaN,14.104399999999996,18.475197931728292,9.7336020682717,16.14538088782046,17.245,17.245,17.245,1079560,1129094.1333333333,75.46638750181789,73.37730890954778,NaN,NaN,NaN,NaN,0.49730300681715633,54.651392676269396,26868767,-0.05108363331351495,0.7591963414069287,0.8102799747204437
2024-03-11T13:30:00-04:00,17.34,17.36,16.76,16.86,15.793895862428567,NaN,NaN,NaN,NaN,NaN,14.223199999999997,18.56412790080649,9.882272099193504,16.14538088782046,17.145050291384013,17.2681927525797,17.021907830188326,711204,1090853.6,65.54674545143341,72.37832519989631,NaN,NaN,NaN,NaN,0.5046385063302165,54.5253958491212,26157563,-0.06689719997293742,0.7266584747542719,0.7935556747272093
2024-03-12T09:30:00-04:00,16.87,16.9,16.19,16.22,15.793895862428567,NaN,NaN,NaN,NaN,NaN,14.335399999999998,18.58603046617795,10.084769533822048,16.14538088782046,16.436666666666667,16.436666666666667,16.436666666666667,829401,1079396.7333333334,54.95399974642334,70.54084823357174,NaN,NaN,NaN,NaN,0.5193071844494865,52.938122594688885,25328162,-0.12137997588375715,0.6418307048725129,0.7632106807562701
2024-03-12T13:30:00-04:00,16.22,16.51,16.21,16.38,15.793895862428567,NaN,NaN,NaN,NaN,NaN,14.451799999999997,18.600028904002315,10.303571095997679,16.14538088782046,16.40860195877887,16.442907960051006,16.374295957506735,555067,1072162.6333333333,56.83220052530564,68.7941224090354,NaN,NaN,NaN,NaN,0.5036423855602375,51.46422600128745,25883229,-0.14591300529270235,0.5808194241403921,0.7267324294330945
2024-03-13T09:30:00-04:00,16.31,17.36,16.23,17.13,15.793895862428567,NaN,NaN,NaN,NaN,NaN,14.580599999999995,18.652844413097082,10.508355586902908,16.14538088782046,16.906666666666666,16.906666666666666,16.906666666666666,1131466,1076550.7,64.33829246260318,67.55816592933458,NaN,NaN,NaN,NaN,0.5483822151630776,51.00887424662446,27014695,-0.11240306497010333,0.5862285982204654,0.6986316631905687
2024-03-13T13:30:00-04:00,17.13,17.255,17.07,17.155,15.793895862428567,NaN,NaN,NaN,NaN,NaN,14.707999999999995,18.69496977666002,10.721030223339971,16.14538088782046,16.97717086620334,17.090705978526493,16.86363575388019,436326,1071097.3333333333,64.5595087658291,66.3970285126506,NaN,NaN,NaN,NaN,0.5224263426514291,50.58604761729454,27451021,-0.09028117908915811,0.585780189329121,0.6760613684182791
2024-03-14T09:30:00-04:00,19.11,19.23,17.93,18.06,16.886228656146574,NaN,NaN,NaN,NaN,NaN,14.848199999999995,18.803664453133234,10.892735546866756,17.087836327456806,18.406666666666666,18.406666666666666,18.406666666666666,4357109,1186303.8,71.46105196926686,66.8992282806489,NaN,NaN,NaN,NaN,0.6333244610334698,51.51633404151609,31808130,-0.020091457692835046,0.6509470463022353,0.6710385039950704
2024-03-14T13:30:00-04:00,18.06,18.14,17.75,18.05,16.886228656146574,NaN,NaN,NaN,NaN,NaN,14.989399999999996,18.887503969880804,11.091296030119187,17.087836327456806,18.305669265258985,18.487030092091935,18.124308438426034,1351238,1216544.3333333333,71.29583800190304,67.37387542796347,NaN,NaN,NaN,NaN,0.615944142388222,52.005690780675174,30456892,0.01819942070019953,0.6937877798703198,0.6755883591701203
2024-03-15T09:30:00-04:00,17.76,18.35,17.5,18.02,16.886228656146574,NaN,NaN,NaN,NaN,NaN,15.126299999999997,18.959189150497355,11.29341084950264,17.087836327456806,17.956666666666667,17.956666666666667,17.956666666666667,1180684,1215671.6333333333,70.76725203991717,67.41308409038001,NaN,NaN,NaN,NaN,0.6326624179319206,51.942718691033605,29276208,0.03317161772652377,0.717052881328275,0.6838812636017513
2024-03-15T13:30:00-04:00,18.025,18.36,17.98,18.14,16.886228656146574,NaN,NaN,NaN,NaN,NaN,15.264599999999996,19.022726043655332,11.506473956344658,17.087836327456806,18.031582290477044,18.129666401408674,17.933498179545413,688781,1215601.6333333333,71.67196855382927,67.66436531994209,NaN,NaN,NaN,NaN,0.6146151023653548,51.891109353565945,29964989,0.04224029446754418,0.7366816316861815,0.6944413372186373
2024-03-18T09:30:00-04:00,18.05,18.41,17.84,18.15,16.886228656146574,NaN,NaN,NaN,NaN,NaN,15.397199999999996,19.08467347651484,11.709726523485154,17.087836327456806,18.133333333333333,18.133333333333333,18.133333333333333,992002,1174129.8,71.75043033254107,67.89632135476228,NaN,NaN,NaN,NaN,0.6114283093392581,51.532183838612035,30956991,0.04001714684851909,0.7444627707792861,0.704445623930767
2024-03-18T13:30:00-04:00,18.145,18.27,18.12,18.2,16.886228656146574,NaN,NaN,NaN,NaN,NaN,15.530199999999995,19.13173909322121,11.92866090677878,17.087836327456806,18.155372560902002,18.18554026207673,18.125204859727273,529445,1127719.2,72.16555543945907,68.29427230155954,NaN,NaN,NaN,NaN,0.5784691443864539,51.198895860440544,31486436,0.03329454293177547,0.7460638025954864,0.712769259663711
2024-03-19T09:30:00-04:00,17.71,17.83,16.7,17.31,NaN,NaN,NaN,19.024585685777836,19.024585685777836,19.024585685777836,15.635999999999994,19.12799140892424,12.144008591075748,17.087836327456806,17.28,17.28,17.28,1172009,1103175,56.30498802858598,67.12236729696822,NaN,NaN,NaN,NaN,0.6442927769302786,48.235278296470995,30314427,-0.035960312004270856,0.6678188696583724,0.7037791816626433
2024-03-19T13:30:00-04:00,17.305,17.33,17.14,17.23,NaN,NaN,NaN,18.94051360915157,NaN,NaN,15.740399999999996,19.102221434877297,12.378578565122694,17.087836327456806,17.268392262992943,17.288565384596396,17.24821914138949,388043,1083721.3666666667,55.13204338996868,65.87473301492034,NaN,NaN,NaN,NaN,0.6118432928638301,45.483347701356415,29926384,-0.08900444797683937,0.5925236216915941,0.6815280696684335
2024-03-20T09:30:00-04:00,17.225,18.09,17.12,17.91,NaN,NaN,NaN,18.94051360915157,NaN,NaN,15.862499999999995,19.084268613665575,12.640731386334416,17.087836327456806,17.706666666666667,17.706666666666667,17.706666666666667,878470,1037573.9333333333,62.31777221273556,64.93554620855731,NaN,NaN,NaN,NaN,0.6374259148021278,43.803358042466925,30804854,-0.0804030744558436,0.581024226598629,0.6614273010544726
2024-03-20T13:30:00-04:00,17.91,18.57,17.85,18.555,NaN,NaN,NaN,18.94051360915157,NaN,NaN,15.996699999999997,19.0945209180003,12.898879081999693,17.087836327456806,18.03265025748944,18.34135921239636,17.72394130258252,979535,1033745.5333333333,67.61568424658981,65.08332755106848,NaN,NaN,NaN,NaN,0.643324063744833,42.71446089831698,31784389,-0.03566475143239167,0.616846361763983,0.6525111131963747
2024-03-21T09:30:00-04:00,18.69,19.41,18.4,19.25,17.069677729681377,17.069677729681377,17.069677729681377,NaN,NaN,NaN,16.119499999999995,19.23658982867044,13.00241017132955,17.484138374133693,19.02,19.02,19.02,1403100,1025246.3333333334,72.15800948289034,66.31218538938755,NaN,NaN,NaN,NaN,0.6695152020487736,42.40446218721097,33187489,0.03265042500432347,0.693324144451779,0.6606737194474556
2024-03-21T13:30:00-04:00,19.24,19.265,18.93,19.06,17.299919651059497,NaN,NaN,NaN,NaN,NaN,16.233299999999996,19.356021639852077,13.110578360147914,17.556810699306954,19.039847009629014,19.06978280483539,19.009911214422637,616733,1024632.3666666667,69.29641715824481,67.20248657745464,NaN,NaN,NaN,NaN,0.6456212590452898,42.11660624118396,32570756,0.05560887256491176,0.7301848101535953,0.6745759375886835
2024-03-22T09:30:00-04:00,18.64,18.92,18.28,18.5,17.299919651059497,NaN,NaN,NaN,NaN,NaN,16.336899999999996,19.409440896391853,13.26435910360814,17.556810699306954,18.566666666666666,18.566666666666666,18.566666666666666,763699,1014261.8666666667,61.54889879334502,67.00324417250764,NaN,NaN,NaN,NaN,0.6552197405420547,40.76437074008897,31807057,0.025195801932009543,0.7060706900036955,0.680874888071686
2024-03-22T13:30:00-04:00,18.505,18.54,18.24,18.31,17.299919651059497,NaN,NaN,NaN,NaN,NaN,16.4349,19.439596650246067,13.430203349753933,17.556810699306954,18.468197134940088,18.56981351865551,18.366580751224664,717131,1013617.8333333334,59.13324975227597,66.61565424296812,NaN,NaN,NaN,NaN,0.6298469019319081,39.445176884207264,31089926,-0.013520089625303378,0.6639747760400567,0.6774948656653601
2024-03-25T09:30:00-04:00,18.4,19.07,18.37,18.935,17.299919651059497,NaN,NaN,NaN,NaN,NaN,16.532099999999996,19.539577408061536,13.524622591938456,17.556810699306954,18.791666666666668,18.791666666666668,18.791666666666668,1231048,1011340,64.12160785351553,66.09140823470017,NaN,NaN,NaN,NaN,0.6391435517939147,38.73875177750796,32320974,-0.003368266444770285,0.6732845326093972,0.6766527990541675
2024-03-25T13:30:00-04:00,18.94,19.1,18.94,19.08,17.299919651059497,NaN,NaN,NaN,NaN,NaN,16.633699999999997,19.635374739208125,13.632025260791872,17.71814566243613,18.88031106521362,18.999288078030027,18.76133405239721,683363,1012977.7333333333,65.18341669458331,65.65480671274875,NaN,NaN,NaN,NaN,0.6052761552372067,38.111279385018165,33004337,0.006255916590350852,0.684472694792106,0.6782167782017552
2024-03-26T09:30:00-04:00,19.315,19.59,19.17,19.29,17.64613483448406,NaN,NaN,NaN,NaN,NaN,16.741699999999994,19.729280700165425,13.754119299834564,18.2295165299489,19.35,19.35,19.35,704959,988418.8333333334,66.71958254356757,65.36568746300951,NaN,NaN,NaN,NaN,0.5984707155774063,37.98184308645916,33709296,0.019178759075307417,0.7021902270458895,0.6830114679705821
2024-03-26T13:30:00-04:00,19.29,19.485,19.22,19.27,17.66131052382569,NaN,NaN,NaN,NaN,NaN,16.845099999999995,19.817635947638095,13.872564052361895,18.26411322395912,19.339668774376552,19.351979193450767,19.327358355302337,496503,977352.2666666667,66.41901659208978,64.99047660859954,NaN,NaN,NaN,NaN,0.5746513787504488,37.86165223779722,33212793,0.01876992569125502,0.7064738750846509,0.6877039493933959
2024-03-27T09:30:00-04:00,20.53,20.55,19.62,20.17,18.29613731819725,NaN,NaN,NaN,NaN,NaN,16.977799999999995,19.93979065494825,14.01580934505174,18.933290579167295,20.113333333333333,20.113333333333333,20.113333333333333,2507410,1027052.5,72.43653548561095,65.0394841195331,NaN,NaN,NaN,NaN,0.6250334231254168,38.595859100972824,35720203,0.06869595812638563,0.7735738970513779,0.7048779389249923
2024-03-27T13:30:00-04:00,20.16,20.16,19.8,19.99,18.29613731819725,NaN,NaN,NaN,NaN,NaN,17.1057,20.024322284571962,14.187077715428035,18.933290579167295,20.073187218876363,20.133247891312788,20.01312654643994,1120294,1041689.9333333333,69.744691478209,64.8665652651581,NaN,NaN,NaN,NaN,0.6068167500450299,39.27762261677874,34599909,0.0784740552820653,0.802970508027574,0.7244964527455087
2024-03-28T09:30:00-04:00,20.02,20.53,19.88,20,18.438267680423525,NaN,NaN,NaN,NaN,NaN,17.225499999999997,20.117633641448887,14.333366358551109,19.02230597066707,20.136666666666667,20.136666666666667,20.136666666666667,1274332,1060160.3333333333,69.81180985939615,65.83133825307311,NaN,NaN,NaN,NaN,0.6099012678989565,40.16880220182423,35874241,0.07452211826860111,0.8176491005812601,0.743126982312659
2024-03-28T13:30:00-04:00,20,20.16,19.965,20.12,18.438267680423525,NaN,NaN,NaN,NaN,NaN,17.3483,20.199914707494727,14.49668529250527,19.02230597066707,20.117809204535025,20.143915842372508,20.091702566697542,664886,1066632.2666666666,70.65314190072743,66.93998814669874,NaN,NaN,NaN,NaN,0.580265463049031,40.9963261022236,36539127,0.06902172093952641,0.829404133487067,0.7603824125475406
2024-04-01T09:30:00-04:00,19.96,20.15,19.37,19.42,18.438267680423525,NaN,NaN,NaN,NaN,NaN,17.448299999999996,20.232014504039597,14.664585495960397,19.02230597066707,19.646666666666665,19.646666666666665,19.646666666666665,1292937,1046581.8,60.12633695407631,66.78345705679452,NaN,NaN,NaN,NaN,0.5945322156883858,40.518085640192865,35246190,0.010351319806092607,0.7733215623051564,0.7629702424990638
2024-04-01T13:30:00-04:00,19.425,19.56,19.39,19.4,18.438267680423525,NaN,NaN,NaN,NaN,NaN,17.546499999999995,20.25114433891053,14.841855661089456,19.02230597066707,19.57726556149925,19.671246254292708,19.48328486870579,705071,1048060.2,59.85195215009505,66.22890476418773,NaN,NaN,NaN,NaN,0.5642084859963581,40.07400521116433,34541119,-0.03519699161779655,0.7189740029768181,0.7541709945946147
2024-04-02T09:30:00-04:00,18.37,19.33,18.03,19.04,NaN,NaN,NaN,20.47574121151028,20.47574121151028,20.47574121151028,17.621499999999997,20.279262404730765,14.963737595269231,19.02230597066707,18.8,18.8,18.8,1466509,1060958.5,54.98767970049692,65.00245263687393,NaN,NaN,NaN,NaN,0.6217650227109038,37.42031054829799,33074610,-0.0917506983134968,0.6394826217027436,0.7312333200162404
2024-04-02T13:30:00-04:00,19.03,19.24,19.015,19.215,NaN,NaN,NaN,20.47574121151028,NaN,NaN,17.693999999999996,20.323763487464372,15.064236512535617,19.02230597066707,18.89147547948685,19.04722685509241,18.73572410388129,505860,1054113.7,56.824623772298885,64.1116102521635,NaN,NaN,NaN,NaN,0.5934246639458391,34.956165504207824,33580470,-0.11788616625690884,0.5838756121951043,0.7017617784520132
2024-04-03T09:30:00-04:00,18.91,19.53,18.86,19.485,NaN,NaN,NaN,20.47574121151028,NaN,NaN,17.764499999999995,20.39353955847007,15.135460441529919,19.02230597066707,19.291666666666668,19.291666905085247,19.29166642824809,749975,1051466.1666666667,59.566313303287124,63.96999700287365,NaN,NaN,NaN,NaN,0.5988943308068507,33.0468045360665,34330445,-0.11725464255169682,0.5551934752623922,0.672448117814089
2024-04-03T13:30:00-04:00,19.49,19.5,19.19,19.215,NaN,NaN,NaN,20.47574121151028,NaN,NaN,17.823899999999995,20.447131053491248,15.200668946508742,19.02230597066707,19.294729878636076,19.299339526365834,19.290120230906318,331181,1044003.3,55.753554052638734,63.72859016718528,NaN,NaN,NaN,NaN,0.5782590214635042,31.27382649422099,33999264,-0.13407348397308327,0.5048562628477349,0.6389297468208182
2024-04-04T09:30:00-04:00,19.24,19.29,18.75,18.805,NaN,NaN,NaN,20.47574121151028,NaN,NaN,17.878999999999998,20.46636622842619,15.291633771573805,19.02230597066707,18.948333333333334,18.948333333333334,18.948333333333334,1102627,1043042,50.470544146505794,62.75351418811315,NaN,NaN,NaN,NaN,0.5755262342161108,29.130356177669377,32896637,-0.16957709707116386,0.42695837548186333,0.5965354725530272
2024-04-04T13:30:00-04:00,18.805,18.84,18.3,18.47,NaN,NaN,NaN,20.280449479642773,NaN,NaN,17.925799999999995,20.469208233060648,15.382391766939344,19.02230597066707,18.769156620941885,18.973256561341525,18.565056680542245,849779,1056823.7666666666,46.586248808952874,61.42514505342526,NaN,NaN,NaN,NaN,0.5729886460578172,27.7611452891895,32046858,-0.20975797971400856,0.33433799791051655,0.5440959776245251
2024-04-05T09:30:00-04:00,18.25,18.825,17.87,18.5,NaN,NaN,NaN,20.110429048749918,NaN,NaN,17.967399999999994,20.478771131474005,15.456028868525985,18.856344776533653,18.398333333333333,18.398333333333333,18.398333333333333,941102,942956.8666666667,46.979777978875084,60.01515901309009,NaN,NaN,NaN,NaN,0.6002751713394014,27.02420012775458,32987960,-0.22699260787095116,0.26035521778583615,0.4873478256567873
2024-04-05T13:30:00-04:00,18.505,18.58,18.38,18.41,NaN,NaN,NaN,20.110429048749918,NaN,NaN,18.009799999999995,20.47766787328675,15.541932126713238,18.717075821226924,18.422672987247378,18.451437451301683,18.393908523193073,673834,920376.7333333333,45.88752208949221,58.548623691475974,NaN,NaN,NaN,NaN,0.5716840876723014,26.33989390642215,32314126,-0.23608225816099104,0.19224500295554847,0.4283272611165395
2024-04-08T09:30:00-04:00,18.88,19.1,18.44,18.68,NaN,NaN,NaN,20.110429048749918,NaN,NaN,18.053699999999996,20.489391942754793,15.618008057245198,18.32866065698154,18.740000000000002,18.740000000000002,18.740000000000002,611594,901407.0666666667,49.66813648285212,56.92230947699319,NaN,NaN,NaN,NaN,0.580135224267137,24.828785540327168,32925720,-0.2160778614351188,0.15822993432264099,0.3743077957577598
2024-04-08T13:30:00-04:00,18.68,18.72,18.485,18.57,NaN,NaN,NaN,20.110429048749918,NaN,NaN,18.093299999999996,20.49668395600888,15.689916043991111,18.14992340509964,18.685268731722598,18.75684358578479,18.613693877660406,357613,890368.1333333333,48.190921192196015,55.3827544565637,NaN,NaN,NaN,NaN,0.5554827082480558,23.425613486096108,32568107,-0.2026447703135444,0.12100183286582933,0.3236466031793737
2024-04-09T09:30:00-04:00,18.665,18.75,18.005,18.43,NaN,NaN,NaN,20.082727803471126,NaN,NaN,18.128899999999994,20.498204784108836,15.759595215891153,18.14992340509964,18.395,18.395,18.395,519991,874634.4333333333,46.30337073502174,53.7035802333941,NaN,NaN,NaN,NaN,0.5690196576589089,22.803429829999587,32048116,-0.19548729256328312,0.07928748747526981,0.27477478003855293
2024-04-09T13:30:00-04:00,18.435,18.45,18.25,18.3,NaN,NaN,NaN,20.004990176040625,NaN,NaN,18.162499999999994,20.49258347489983,15.83241652510016,18.14992340509964,18.36752077580539,18.398171133003167,18.33687041860761,417959,870918.2333333333,44.558110831493934,51.83964944273456,NaN,NaN,NaN,NaN,0.5426611106832725,22.225687863624245,31630157,-0.19155472278522528,0.03533137655702134,0.22688609934224663
2024-04-10T09:30:00-04:00,17.66,18.44,17.59,18.28,NaN,NaN,NaN,19.71067244076605,NaN,NaN,18.209699999999994,20.450052124109202,15.969347875890788,18.14992340509964,18.103333333333335,18.103333333333335,18.103333333333335,666899,854081.2333333333,44.2815810255165,50.707881162123144,NaN,NaN,NaN,NaN,0.5646138884916103,22.530786589498877,30963258,-0.1823930796726144,-0.0011052502485213722,0.18128782942409302
2024-04-10T13:30:00-04:00,18.28,18.37,18.12,18.335,NaN,NaN,NaN,19.71067244076605,NaN,NaN,18.257599999999996,20.40215891968507,16.11304108031492,17.939938724079713,18.156584146928854,18.235992839895403,18.077175453962305,299900,851143.1333333333,45.28717280299341,49.66753978018731,NaN,NaN,NaN,NaN,0.5421414678850668,22.814092549239607,31263158,-0.16523218765952935,-0.02525240515031868,0.13997978250921067
2024-04-11T09:30:00-04:00,17.71,18.82,17.71,18.79,NaN,NaN,NaN,19.71067244076605,NaN,NaN,18.303399999999996,20.392965926215453,16.21383407378454,17.678174901383052,18.44,18.44,18.44,836582,849746.8666666667,52.86582879795552,49.51597900143435,NaN,NaN,NaN,NaN,0.582702791607562,22.187322058503238,32099740,-0.1180534606174057,-0.007587043262546445,0.11046641735485925
2024-04-11T13:30:00-04:00,18.79,19.045,18.72,18.995,NaN,NaN,NaN,19.71067244076605,NaN,NaN,18.355299999999996,20.381118757934875,16.329481242065118,17.678174901383052,18.664238015198233,18.90371987220441,18.424756158192057,733469,841544.6666666666,55.83418768515431,49.44523356663831,NaN,NaN,NaN,NaN,0.5642954493498792,21.195116327578354,32833209,-0.07021867118979688,0.02269307836761314,0.09291174955741002
2024-04-12T09:30:00-04:00,18.87,18.885,18.145,18.17,NaN,NaN,NaN,19.71067244076605,NaN,NaN,18.389999999999997,20.341119678543784,16.43888032145621,17.678174901383052,18.400000000000002,18.400000000000002,18.400000000000002,525933,812305.7666666667,43.862428397708136,48.323527501954096,NaN,NaN,NaN,NaN,0.5847029172534592,21.071103581512368,32307276,-0.09005240445081394,-0.019653756006107415,0.07039864844470653
2024-04-12T13:30:00-04:00,18.17,18.17,17.83,17.97,NaN,NaN,NaN,19.701104879239548,NaN,NaN,18.422399999999996,20.28890822660947,16.555891773390524,17.678174901383052,18.193846145847118,18.39884289855464,17.988849393139596,531887,809477.5666666667,41.537250175559784,47.308077225019886,NaN,NaN,NaN,NaN,0.567224137449641,21.341403155166514,31775389,-0.11116845217318436,-0.06856191677177392,0.042606535401410434
2024-04-15T09:30:00-04:00,18.07,18.26,17.21,17.21,NaN,NaN,NaN,19.50196374836502,NaN,NaN,18.426899999999996,20.280565439069502,16.57323456093049,17.64889894507853,17.56,17.56,17.56,962232,816095.3333333334,34.13264651360491,46.14108453695554,NaN,NaN,NaN,NaN,0.6017081276318095,22.2598875184595,30813157,-0.1674658079914728,-0.16672572458793056,0.0007400834035422299
2024-04-15T13:30:00-04:00,17.215,17.26,16.97,17.19,NaN,NaN,NaN,18.84119266889389,NaN,NaN,18.431099999999997,20.272544313575825,16.58965568642417,17.64889894507853,17.365202663620405,17.57465165268188,17.15575367455893,832318,819934.9,33.96107444645364,45.23928636820559,NaN,NaN,NaN,NaN,0.5794432613723947,23.344412561487943,29980839,-0.1952561660537867,-0.24333012416369115,-0.04807395810990445
2024-04-16T09:30:00-04:00,17.11,17.46,16.84,17.42,NaN,NaN,NaN,18.84119266889389,NaN,NaN,18.432899999999997,20.27020682249878,16.595593177501215,17.64889894507853,17.24,17.24,17.24,751991,803966.3333333334,37.831255154182685,44.585820452156135,NaN,NaN,NaN,NaN,0.5823401712743665,23.93562658799661,30732830,-0.18732262945084582,-0.28222724492346174,-0.09490461547261592
2024-04-16T13:30:00-04:00,17.4,17.58,17.27,17.305,NaN,NaN,NaN,18.84119266889389,NaN,NaN,18.441799999999997,20.25266472161795,16.630935278382044,17.64889894507853,17.295443733450288,17.36590885795491,17.224978608945666,465553,796706,36.673961020351975,43.92770894721754,NaN,NaN,NaN,NaN,0.562887301897626,24.234147966062288,30267277,-0.1790040847099467,-0.3186597213600493,-0.13965563665010258
2024-04-17T09:30:00-04:00,17.38,17.45,16.46,16.835,NaN,NaN,NaN,18.708725611065574,NaN,NaN,18.454099999999997,20.212013183294548,16.696186816705445,17.64889894507853,16.915,16.915,16.915,688776,796166.5666666667,32.32208009003742,42.688704919159356,NaN,NaN,NaN,NaN,0.5933953517620812,25.34438422882545,29578501,-0.19312758032550204,-0.3810651120569801,-0.1879375317314781
2024-04-17T13:30:00-04:00,16.84,17.29,16.84,17.08,NaN,NaN,NaN,18.708725611065574,NaN,NaN,18.468099999999996,20.169974131656176,16.766225868343817,17.64889894507853,16.981967201354294,17.05874812445871,16.90518627824988,523957,797081.7,36.54887724413692,41.857130351440844,NaN,NaN,NaN,NaN,0.5835099694933611,26.37531790139124,30102458,-0.17450712863288526,-0.40607144252258465,-0.2315643138896994
2024-04-18T09:30:00-04:00,17.18,17.59,16.89,17.18,NaN,NaN,NaN,18.708725611065574,NaN,NaN,18.469099999999997,20.16788390621069,16.770316093789305,17.64889894507853,17.220000000000002,17.220000000000002,17.220000000000002,581615,732888.5333333333,38.24423177703246,41.281477568727325,NaN,NaN,NaN,NaN,0.5918306859581209,26.682167065291353,30684073,-0.14519534417799157,-0.41305849411218887,-0.2678631499341973
2024-04-18T13:30:00-04:00,17.17,17.185,16.95,17.1,NaN,NaN,NaN,18.708725611065574,NaN,NaN,18.467999999999996,20.170253800113468,16.765746199886525,17.34311915606282,17.172157622106404,17.239155958497182,17.105159285715626,296574,705431.2,37.383678187708426,40.769018094171216,NaN,NaN,NaN,NaN,0.5663427798182551,26.967098431770026,30387499,-0.12187526157758799,-0.4202072269061823,-0.2983319653285943
2024-04-19T09:30:00-04:00,16.94,17.23,16.6,16.73,NaN,NaN,NaN,18.628390972122993,NaN,NaN,18.441399999999998,20.208649886122622,16.674150113877374,16.766495324850254,16.853333333333335,16.853333333333335,16.853333333333335,665888,685149.7333333333,33.61615107706578,40.007201669281876,NaN,NaN,NaN,NaN,0.5708897241169512,27.632835795045025,29721611,-0.12176248301870685,-0.4505350691019778,-0.328772586083271
2024-04-19T13:30:00-04:00,16.74,16.8,16.5,16.635,NaN,NaN,NaN,18.32641865520831,NaN,NaN,18.413099999999996,20.248518088611103,16.57768191138889,16.612196259880204,16.767401058311233,16.869959341281046,16.66484277534142,467490,678569.8666666667,32.704786305633206,39.108459776613294,NaN,NaN,NaN,NaN,0.5515404581085975,28.361695997095875,29254121,-0.11837412619259496,-0.4767402438240147,-0.35836611763141973
2024-04-22T09:30:00-04:00,16.93,17.22,16.67,17.22,NaN,NaN,NaN,18.32641865520831,NaN,NaN,18.397099999999995,20.25969291311898,16.53450708688101,16.24052448505866,17.036666666666665,17.036666666666665,17.036666666666665,478177,651411.2,42.95991987434248,38.40089485349807,NaN,NaN,NaN,NaN,0.5539304253865547,28.062824208628072,29732298,-0.06944451365667398,-0.4451717597022622,-0.3757272460455882
2024-04-22T13:30:00-04:00,17.215,17.34,17.15,17.2,NaN,NaN,NaN,18.32641865520831,NaN,NaN,18.378299999999996,20.269647255265667,16.486952744734324,16.24052448505866,17.110717451797566,17.204701313958815,17.016733589636317,296853,637803.9333333333,42.72023008115943,37.464183596069866,NaN,NaN,NaN,NaN,0.5279353950018009,27.52284666673324,29435445,-0.03298690397994658,-0.41696087602052145,-0.3839739720405749
2024-04-23T09:30:00-04:00,17.16,17.82,17.05,17.625,NaN,NaN,NaN,18.32641865520831,NaN,NaN,18.3678,20.269899008989995,16.465700991010003,16.525184412472946,17.498333333333335,17.498333333333335,17.498333333333335,510120,605924.3,49.2057427217961,37.84584890493329,NaN,NaN,NaN,NaN,0.5452257239302437,26.048353918220425,29945565,0.022216372010481378,-0.35620350702747317,-0.37841987903795454
2024-04-23T13:30:00-04:00,17.62,17.72,17.58,17.625,NaN,NaN,NaN,18.32641865520831,NaN,NaN,18.356299999999997,20.26923994678378,16.443360053216214,16.614147529978354,17.55548593242867,17.62566750375304,17.4853043611043,338297,600338.8666666667,49.2057427217961,38.393598372521595,NaN,NaN,NaN,NaN,0.5162810293637977,24.679182080315663,29945565,0.05910207880769891,-0.3045422805283309,-0.3636443593360298
2024-04-24T09:30:00-04:00,17.65,17.89,17.09,17.32,NaN,NaN,NaN,18.32641865520831,NaN,NaN,18.356499999999997,20.269004379080172,16.44399562091982,16.614147529978354,17.433333333333334,17.433333333333334,17.433333333333334,560565,594025.2,44.96806860131586,39.16755709307238,NaN,NaN,NaN,NaN,0.5365466701235265,24.192982147622338,29385000,0.06297398534673393,-0.2849268776526124,-0.3479008629993463
2024-04-24T13:30:00-04:00,17.31,17.395,17.12,17.31,NaN,NaN,NaN,18.32641865520831,NaN,NaN,18.358099999999997,20.266962373247726,16.449237626752268,16.614147529978354,17.388865230075282,17.46002259658391,17.317707863566653,218919,590283.1333333333,44.831741494489194,39.94403331078921,NaN,NaN,NaN,NaN,0.5178647651147031,23.74151078154997,29166081,0.06463319010401314,-0.2671093753693299,-0.331742565473343
2024-04-25T09:30:00-04:00,16.8,17.17,16.57,17.04,NaN,NaN,NaN,18.32641865520831,NaN,NaN,18.3407,20.28118242455337,16.400217575446625,16.614147529978354,16.926666666666666,16.926666666666666,16.926666666666666,423249,567637.2,41.19993299622135,40.18465315664911,NaN,NaN,NaN,NaN,0.53373156760651,24.10367508044749,28742832,0.048078633289777906,-0.27164427386112067,-0.31972290715089857
2024-04-25T13:30:00-04:00,17.04,17.26,17,17.13,NaN,NaN,NaN,18.32641865520831,NaN,NaN,18.312199999999997,20.280908368448955,16.34349163155104,16.614147529978354,17.000497885787375,17.098279780691254,16.902715990883497,241301,547354.6,42.86154363132848,40.62662334314742,NaN,NaN,NaN,NaN,0.5141793127774736,24.22895171283772,28984133,0.043840638848804514,-0.26492210858989296,-0.30876274743869747
2024-04-26T09:30:00-04:00,17.12,17.77,16.92,17.76,NaN,NaN,NaN,18.32641865520831,NaN,NaN,18.2824,20.23849226776262,16.326307732237378,16.614147529978354,17.483333333333334,17.483333333333334,17.483333333333334,598121,535921.9,52.89596390592851,42.09618647285394,NaN,NaN,NaN,NaN,0.5381665047219396,23.241538926730705,29582254,0.08190620654103364,-0.20637998926240542,-0.28828619580343906
2024-04-26T13:30:00-04:00,17.75,17.9,17.645,17.89,NaN,NaN,NaN,18.32641865520831,NaN,NaN,18.258999999999997,20.205291858895013,16.31270814110498,16.682575410098647,17.605337941458806,17.763998129483284,17.44667775343433,353676,525249.9666666667,54.66518895450519,43.390208737880236,NaN,NaN,NaN,NaN,0.5179403258132296,22.06753360266716,29935930,0.11239585474190683,-0.14779137737605552,-0.26018723211796235
2024-04-29T09:30:00-04:00,17.785,18.28,17.58,17.675,NaN,NaN,NaN,18.32641865520831,NaN,NaN,18.242499999999996,20.194319919972337,16.290680080027656,16.95606032807892,17.845,17.845,17.845,764646,530351.7,51.237564539175985,44.318303935176196,NaN,NaN,NaN,NaN,0.530944588255142,20.71530323223732,29171284,0.11426547872970758,-0.11735538370582788,-0.23162086243553545
2024-04-29T13:30:00-04:00,17.67,17.67,17.3,17.34,NaN,NaN,NaN,18.32641865520831,NaN,NaN,18.223099999999995,20.191066351338634,16.255133648661356,16.95606032807892,17.72414018476183,17.9105375996655,17.53774276985816,321473,529147.0333333333,46.359859690793854,44.95945975682516,NaN,NaN,NaN,NaN,0.5198056890940604,19.518331933685857,28849811,0.09018006342624119,-0.11889578315273397,-0.20907584657897516
2024-04-30T09:30:00-04:00,17.13,17.3,16.63,16.7,NaN,NaN,NaN,18.32641865520831,NaN,NaN,18.178399999999996,20.180883897563547,16.175916102436446,16.95606032807892,16.876666666666665,16.876666666666665,16.876666666666665,782564,537899.4666666667,38.76694577376064,45.32737366373193,NaN,NaN,NaN,NaN,0.5333909970159133,19.439734931845372,28067247,0.031419203526663525,-0.16980184217064576,-0.20122104569730928
2024-04-30T13:30:00-04:00,16.7,16.77,16.47,16.475,NaN,NaN,NaN,18.208343534514952,NaN,NaN,18.126299999999993,20.16742205416575,16.085177945834236,16.95606032807892,16.772978047225283,16.917455378069963,16.628500716380604,403072,537403.2333333333,36.503411646351765,45.59870404521183,NaN,NaN,NaN,NaN,0.5167202115147768,19.583977772879212,27664175,-0.01958249213307403,-0.22569916086365183,-0.2061166687305778
2024-05-01T09:30:00-04:00,16.39,16.72,16.32,16.62,NaN,NaN,NaN,18.090691555673367,NaN,NaN,18.072899999999994,20.12909852154445,16.016701478455538,16.95606032807892,16.55333333333333,16.55333333333333,16.55333333333333,582768,534598.8666666667,38.97624338768223,45.3141557247361,NaN,NaN,NaN,NaN,0.5083830535494355,19.921398414599413,28246943,-0.03939013273123809,-0.2553543346446254,-0.21596420191338733
2024-05-01T13:30:00-04:00,16.61,17.355,16.58,16.63,NaN,NaN,NaN,18.090691555673367,NaN,NaN,18.020099999999996,20.086186629355396,15.954013370644597,16.95606032807892,16.710909592739487,16.86159213118489,16.560227054294085,637311,545845.9,39.1522404619187,45.05929932336176,NaN,NaN,NaN,NaN,0.5274271211530474,18.97482189373702,28884254,-0.04713320123043413,-0.27488070345143,-0.22774750222099588
2024-05-02T09:30:00-04:00,16.96,17.29,16.76,17.28,NaN,NaN,NaN,18.090691555673367,NaN,NaN,17.962299999999995,19.944572645223484,15.980027354776507,16.95606032807892,17.11,17.11,17.11,475521,533810.5333333333,49.3730699307707,45.07125126685995,NaN,NaN,NaN,NaN,0.5368966124992582,18.095857981507653,29359775,-0.005957794279084133,-0.23519474506985105,-0.22923695079076692
2024-05-02T13:30:00-04:00,17.29,17.63,17.265,17.63,NaN,NaN,NaN,18.090691555673367,NaN,NaN,17.915099999999995,19.812572518905437,16.017627481094554,16.95606032807892,17.304170589158865,17.50327458289269,17.10506659542504,452248,524436.5,53.86668233280332,45.40417552478904,NaN,NaN,NaN,NaN,0.5246182830350253,16.94390346169989,29812023,0.04458856237778808,-0.17350124781853182,-0.2180898101963199
2024-05-03T09:30:00-04:00,17.93,18.135,17.63,17.715,16.310639568565463,16.310639568565463,16.310639568565463,NaN,NaN,NaN,17.869399999999995,19.67148394921033,16.06731605078966,16.95606032807892,17.826666666666668,17.826666666666668,17.826666666666668,691065,529940.9,54.9133234795154,46.11455087323186,NaN,NaN,NaN,NaN,0.5232169771039523,16.67720761070714,30503088,0.08134541796009537,-0.11640803774620068,-0.19775345570629604
2024-05-03T13:30:00-04:00,17.71,17.95,17.67,17.94,16.310639568565463,NaN,NaN,NaN,NaN,NaN,17.825799999999997,19.509571195857966,16.14202880414203,16.95606032807892,17.83654368678471,17.84942125164697,17.823666121922454,406540,525762.6666666666,57.65213953706539,47.03029359055874,NaN,NaN,NaN,NaN,0.5058443358822412,16.42956146335673,30909628,0.11628149658089745,-0.05240158498017422,-0.16868308156107167
2024-05-06T09:30:00-04:00,17.64,18.46,17.5,17.895,16.35999317319443,NaN,NaN,NaN,NaN,NaN,17.795299999999997,19.416543238999335,16.17405676100066,17.04004803938055,17.951666666666668,17.951666666666668,17.951666666666668,1397750,540279.9333333333,56.907579986614806,48.15226837558684,NaN,NaN,NaN,NaN,0.538284026176367,16.933647683127504,29511878,0.1307491422233009,-0.005246653781945554,-0.13599579600524644
2024-05-06T13:30:00-04:00,17.89,17.9,17.635,17.76,16.35999317319443,NaN,NaN,NaN,NaN,NaN,17.7625,19.31756302123116,16.20743697876884,17.04004803938055,17.896576514380563,17.981715049806155,17.81143797895497,585228,532043.6,54.62824983952793,48.992747390458234,NaN,NaN,NaN,NaN,0.5187637385923406,17.401727744343223,28926650,0.1255875592365097,0.02098865304039066,-0.10459890619611903
2024-05-07T09:30:00-04:00,17.79,18.26,17.67,18.105,16.373971052435422,NaN,NaN,NaN,NaN,NaN,17.7438,19.258939016724433,16.228660983275567,17.04004803938055,18.01166666666667,18.01166666666667,18.01166666666667,1222018,547711.1666666666,59.13308572493705,49.43825609181598,NaN,NaN,NaN,NaN,0.523852042978602,18.319332225206665,30148668,0.13873957391680192,0.06882556119988337,-0.06991401271691855
2024-05-07T13:30:00-04:00,18.105,18.16,17.85,17.99,16.44401782277927,NaN,NaN,NaN,NaN,NaN,17.719299999999997,19.17701740745629,16.261582592543704,17.04004803938055,18.00773248875624,18.013248011073657,18.002216966438823,621745,552917.5666666667,57.09802235675118,49.61202990626212,NaN,NaN,NaN,NaN,0.5085768970515588,19.171393528865575,29526923,0.1330084055700472,0.09634649424564046,-0.03666191132440675
2024-05-08T09:30:00-04:00,17.63,17.93,17.37,17.87,16.44401782277927,NaN,NaN,NaN,NaN,NaN,17.686999999999998,19.05563727846395,16.318362721536044,17.04004803938055,17.723333333333333,17.723333333333333,17.723333333333333,770290,555634.7,54.972050926980046,49.87877893396241,NaN,NaN,NaN,NaN,0.5165356901193044,18.84411772585161,28756633,0.11511981986481466,0.10723786350661157,-0.007881956358203084
2024-05-08T13:30:00-04:00,17.86,17.93,17.745,17.86,16.44401782277927,NaN,NaN,NaN,NaN,NaN,17.659899999999997,18.958299768946834,16.36150023105316,17.04004803938055,17.79174022481352,17.85210027502362,17.73138017460342,989361,571148.1666666666,54.78897427367047,50.48085854702503,NaN,NaN,NaN,NaN,0.4928545693964969,18.540218765910073,27767272,0.09730651137388013,0.11375118285914709,0.016444671485266953
2024-05-09T09:30:00-04:00,19.06,19.47,17.135,17.21,16.52532626378276,NaN,NaN,NaN,NaN,NaN,17.627999999999997,18.890166391567004,16.36583360843299,17.414258513235378,17.938333333333336,17.938333333333336,17.938333333333336,4522238,702502.2666666667,44.430993722269065,50.88543340048991,NaN,NaN,NaN,NaN,0.6244363858681756,20.14361164372764,23245034,0.039409102182890184,0.06570604921387968,0.026296947030989497
2024-05-09T13:30:00-04:00,17.22,17.55,17.04,17.29,16.52532626378276,NaN,NaN,NaN,NaN,NaN,17.604399999999995,18.846679582059323,16.362120417940666,17.414258513235378,17.78678623235971,18.060248032826173,17.513324431893246,1388850,738911.4666666667,45.78939319282749,51.54871779666674,NaN,NaN,NaN,NaN,0.6162623583061632,21.429859030878465,24633884,0.005919906363279999,0.033696829985089494,0.027776923621809495
2024-05-10T09:30:00-04:00,17.41,17.69,16.485,16.53,NaN,NaN,NaN,18.937486813371496,18.937486813371496,18.937486813371496,17.564999999999994,18.816090724128955,16.313909275871033,17.414258513235378,16.901666666666667,16.901666666666667,16.901666666666667,1924089,780851.5,36.62876194313049,51.38104055062734,NaN,NaN,NaN,NaN,0.6583150469985802,21.51546432783864,22709795,-0.06413546546859407,-0.052392408213933095,0.011743057254660974
2024-05-10T13:30:00-04:00,16.53,16.6,16.22,16.225,NaN,NaN,NaN,18.227714685490977,NaN,NaN,17.521299999999997,18.80353057208966,16.239069427910334,17.414258513235378,16.7094160769939,16.9728897386555,16.4459424153323,1024439,799416.4666666667,33.71376132240373,50.9925777549477,NaN,NaN,NaN,NaN,0.6384354007843961,21.11652255474467,21685356,-0.12425417493185648,-0.14357466141015962,-0.019320486478303145
2024-05-13T09:30:00-04:00,16.66,17.61,16.57,16.93,NaN,NaN,NaN,18.227714685490977,NaN,NaN,17.486299999999996,18.735211221825335,16.237388778174658,17.414258513235378,17.036666666666665,17.036666666666665,17.036666666666665,2058666,852099.4333333333,44.67399228110231,50.65692935139996,NaN,NaN,NaN,NaN,0.6917614435855105,21.845792265525805,23744022,-0.11025421398154571,-0.15713825395523529,-0.046884039973689576
2024-05-13T13:30:00-04:00,16.92,16.97,16.775,16.91,NaN,NaN,NaN,18.227714685490977,NaN,NaN,17.453099999999996,18.672930955502068,16.233269044497924,17.414258513235378,16.999436899559157,17.064709092100156,16.93416470701816,669746,864529.2,44.449455065563576,49.98427026088283,NaN,NaN,NaN,NaN,0.6562784833294026,22.52297128267972,23074276,-0.09654852203213199,-0.16756969251385456,-0.07102117048172257
2024-05-14T09:30:00-04:00,17.77,18.665,17.65,17.87,16.139774539600683,16.139774539600683,16.139774539600683,NaN,NaN,NaN,17.441899999999997,18.6356518837686,16.248148116231395,17.414258513235378,18.061666666666667,18.061666666666667,18.061666666666667,2907702,944448.6,55.90569268989394,50.055153775909865,NaN,NaN,NaN,NaN,0.7347585916630166,24.440766777946507,25981978,-0.020984383058329878,-0.09725164930463492,-0.07626726624630505
2024-05-14T13:30:00-04:00,17.87,18.06,17.87,18,16.139774539600683,NaN,NaN,NaN,NaN,NaN,17.435899999999997,18.615268797281463,16.25653120271853,17.414258513235378,18.044337984946942,18.078582031670773,18.01009393822311,744579,957991.3333333334,57.19312388475305,50.022366943601845,NaN,NaN,NaN,NaN,0.6958472636870867,26.221576880694236,26726557,0.03646940176929864,-0.03068051403468175,-0.06714991580398039
2024-05-15T09:30:00-04:00,18.305,18.46,17.575,18.17,16.139774539600683,NaN,NaN,NaN,NaN,NaN,17.433699999999998,18.60715781347304,16.260242186526956,17.414258513235378,18.06833333333333,18.06833333333333,18.06833333333333,1365052,984807.5666666667,58.88374132794849,50.16352132512568,NaN,NaN,NaN,NaN,0.7093581734237234,28.1178166994177,28091609,0.08202973054450209,0.035387247376647224,-0.04664248316785487
2024-05-15T13:30:00-04:00,18.165,18.57,18.16,18.52,16.41538922907982,NaN,NaN,NaN,NaN,NaN,17.437399999999997,18.623302592965015,16.25149740703498,17.414258513235378,18.19854165452932,18.367069668940296,18.03001364011834,814859,1004672.2333333333,62.19424119912649,50.70394927938272,NaN,NaN,NaN,NaN,0.6879754467506004,29.944339613997013,28906468,0.1290473408996664,0.11466669295672816,-0.014380647942938266
2024-05-16T09:30:00-04:00,18.34,19.24,18.1,18.15,16.65355335503074,NaN,NaN,NaN,NaN,NaN,17.424599999999998,18.56476286555961,16.284437134440385,17.205364783592888,18.496666666666666,18.496666666666666,18.496666666666666,1892420,1053644.6,56.97196819180902,50.54958374130215,NaN,NaN,NaN,NaN,0.7202629148398431,32.01523704330059,27014048,0.12827076334695758,0.14595780624075871,0.01768704289380113
2024-05-16T13:30:00-04:00,18.15,18.265,17.86,17.89,16.65355335503074,NaN,NaN,NaN,NaN,NaN,17.402499999999996,18.459880253268082,16.34511974673191,17.205364783592888,18.371660190751815,18.585751055349487,18.157569326154142,645188,1067107.5,53.56810579393188,50.297446843957914,NaN,NaN,NaN,NaN,0.6977441352084258,33.46273760552027,26368860,0.10430601222319624,0.14806955817279643,0.04376354594960019
2024-05-17T09:30:00-04:00,18.93,20.34,18.46,19.97,17.175892623075526,NaN,NaN,NaN,NaN,NaN,17.438499999999998,18.700684217933755,16.17631578206624,17.65083346149945,19.59,19.59,19.59,5114583,1217656.2333333334,69.34656498691837,51.32419784823916,NaN,NaN,NaN,NaN,0.8229052684078239,35.76313635164,31483443,0.21615923382099583,0.313962588225845,0.09780335440484916
2024-05-17T13:30:00-04:00,19.98,20.24,19.665,20.08,17.75107932202664,NaN,NaN,NaN,NaN,NaN,17.4807,18.93726721094528,16.02413278905472,17.801166769199558,19.701970594301603,19.88310777078381,19.520833417819397,1954353,1271012.1333333333,69.92855629950657,52.405596564370306,NaN,NaN,NaN,NaN,0.8051977492358364,37.89922090160832,33437796,0.28106353044524907,0.4491327674614105,0.16806923701616144
2024-05-20T09:30:00-04:00,19.94,20.84,19.54,20.42,17.91137117102543,NaN,NaN,NaN,NaN,NaN,17.5449,19.21534843081161,15.874451569188388,18.238933415359647,20.266666666666666,20.266666666666666,20.266666666666666,2291242,1321898.6666666667,71.71606474800444,54.35453020906569,NaN,NaN,NaN,NaN,0.8405407671475624,40.0936093610684,35729038,0.32717622200847596,0.5770395145267564,0.24986329251828043
2024-05-20T13:30:00-04:00,20.42,20.89,20.37,20.84,18.384036117797002,NaN,NaN,NaN,NaN,NaN,17.6179,19.52253129240306,15.71326870759694,18.549146732287717,20.401290503740118,20.60182334034497,20.200757667135264,1032628,1345603.8333333333,73.78876440367159,56.35448529555456,NaN,NaN,NaN,NaN,0.8176449980655937,42.148421097284825,36761666,0.36345310839848877,0.7041796780163914,0.3407265696179026
2024-05-21T09:30:00-04:00,21.02,21.21,20.41,20.77,18.557034476078957,NaN,NaN,NaN,NaN,NaN,17.6849,19.782848988893882,15.586951011106116,18.937317385830177,20.796666666666667,20.796666666666667,20.796666666666667,1875506,1382035.2333333334,72.83080939970593,58.94034582816709,NaN,NaN,NaN,NaN,0.8163846410609085,44.167976859947906,34886160,0.3595643699041692,0.7901820319981141,0.4306176620939449
2024-05-21T13:30:00-04:00,20.765,21.04,20.72,20.94,18.685805636257186,NaN,NaN,NaN,NaN,NaN,17.757599999999996,20.041534534964025,15.47366546503597,19.061853908664137,20.827024386043725,20.874092137315927,20.779956634771523,780207,1394606.4,73.72301703691235,61.79814980777484,NaN,NaN,NaN,NaN,0.7809285952708436,46.043278639563624,35666367,0.34520116935235223,0.8621191237843853,0.516917954432033
2024-05-22T09:30:00-04:00,20.86,21.03,19.9,20.07,18.685805636257186,NaN,NaN,NaN,NaN,NaN,17.8223,20.18011526842139,15.464484731578608,19.061853908664137,20.333333333333332,20.333333333333332,20.333333333333332,1953621,1440301.5,62.42498730598556,63.066078023837925,NaN,NaN,NaN,NaN,0.8058622670372121,46.20603209006844,33712746,0.2578685679515944,0.839253664371526,0.5813850964199316
2024-05-22T13:30:00-04:00,20.06,20.09,19.59,19.65,18.685805636257186,NaN,NaN,NaN,NaN,NaN,17.873699999999996,20.276174399447573,15.47122560055242,19.061853908664137,20.127297208967416,20.396076966426797,19.858517451508035,1147979,1457323.7666666666,57.818389220011056,64.02100189201275,NaN,NaN,NaN,NaN,0.7840149622488398,45.825861845930504,32564767,0.15750849311678294,0.7782707128159103,0.6207622196991274
2024-05-23T09:30:00-04:00,19.92,19.935,19.17,19.87,18.685805636257186,NaN,NaN,NaN,NaN,NaN,17.9275,20.385268296646572,15.469731703353425,19.061853908664137,19.658333333333335,19.658333333333335,19.658333333333335,1412002,1488539.8,59.504129532403766,64.27803309504917,NaN,NaN,NaN,NaN,0.7826567506596368,44.78673025505877,33976769,0.09472840240440517,0.7391727227046339,0.6444443203002287
2024-05-23T13:30:00-04:00,19.86,19.88,19.115,19.22,18.685805636257186,NaN,NaN,NaN,NaN,NaN,17.969899999999996,20.442206202718694,15.497593797281299,19.061853908664137,19.560813044358273,19.684080773760634,19.437545314955912,883744,1502923,52.79130535159028,63.96361748553754,NaN,NaN,NaN,NaN,0.7813955541839485,43.732518257486355,33093025,0.0030564810769834194,0.648264921646458,0.6452084405694746
2024-05-24T09:30:00-04:00,19.32,20.185,19.07,20.08,18.685805636257186,NaN,NaN,NaN,NaN,NaN,18.036899999999996,20.552363289336814,15.521436710663178,19.061853908664137,19.778333333333332,19.778333333333332,19.778333333333332,1474119,1529024.8,59.328846480780975,63.99541071073986,NaN,NaN,NaN,NaN,0.8052244431708092,43.022576528475646,34567144,-0.0055609803294900395,0.638257215157612,0.6438181954871021
2024-05-24T13:30:00-04:00,20.08,20.565,20.04,20.52,18.685805636257186,NaN,NaN,NaN,NaN,NaN,18.1146,20.691311733974285,15.537888266025714,19.061853908664137,20.067878256123787,20.366082115283707,19.769674396963868,1389754,1561798.6,62.21210787864268,63.996686902133874,NaN,NaN,NaN,NaN,0.7852084115157515,42.6818152941824,35956898,0.011539482072445706,0.6582425480776593,0.6467030660052135
2024-05-28T09:30:00-04:00,20.62,20.99,20.05,20.61,18.685805636257186,NaN,NaN,NaN,NaN,NaN,18.182399999999998,20.838561320402206,15.52623867959779,19.061853908664137,20.55,20.55,20.55,1261250,1557248.6,62.793133310270775,64.41248441059543,NaN,NaN,NaN,NaN,0.7962649535503405,42.69630429840768,37218148,0.02150052323221041,0.6735787200454766,0.6520781968132662
2024-05-28T13:30:00-04:00,20.6,20.725,20.15,20.47,18.685805636257186,NaN,NaN,NaN,NaN,NaN,18.247799999999998,20.964328048815375,15.531271951184621,19.061853908664137,20.51078366650189,20.560271777119702,20.461295555884078,792015,1564141.5,61.21632132363232,64.95878551985975,NaN,NaN,NaN,NaN,0.7804603140110308,42.70975837375973,36426133,0.011737472513898228,0.666750037455639,0.6550125649417408
2024-05-29T09:30:00-04:00,20.77,21.01,20.28,20.89,18.685805636257186,NaN,NaN,NaN,NaN,NaN,18.3131,21.122002910390606,15.504197089609391,19.11311797556882,20.726666666666674,20.726666666666674,20.726666666666674,1977269,1589316.5333333334,64.12667226833128,64.58593603996067,NaN,NaN,NaN,NaN,0.7768560058673858,42.94717524467559,38403402,0.02583467804068529,0.6873059124925973,0.661471234451912
2024-05-29T13:30:00-04:00,20.895,21.135,20.74,21.09,18.745177814402467,NaN,NaN,NaN,NaN,NaN,18.382399999999997,21.289243814173886,15.475556185826107,19.419994380455055,20.824221128568134,20.950751274491097,20.69769098264517,1175363,1607770.4666666666,65.45600680955577,64.2664682192499,NaN,NaN,NaN,NaN,0.7495805768768584,43.26546808023432,39578765,0.040049262626718596,0.7115328127353102,0.6714835501085916
2024-05-30T09:30:00-04:00,21.29,22.25,20.92,22.06,19.310965186475087,NaN,NaN,NaN,NaN,NaN,18.477199999999996,21.544034954802964,15.410365045197029,20.212995504364045,21.743333333333336,21.743333333333336,21.743333333333336,3926076,1712963.3333333333,71.05772992126953,64.21944430305454,NaN,NaN,NaN,NaN,0.7910391070999399,44.29744155996616,43504841,0.10264058688953404,0.7997842837205091,0.6971436968309751
2024-05-30T13:30:00-04:00,22.06,22.26,21.73,21.83,19.752057677998945,NaN,NaN,NaN,NaN,NaN,18.5676,21.755561881829983,15.379638118170014,20.365396403491236,21.800314666730348,21.889530453146154,21.71109888031454,1601550,1733369.6333333333,68.23232901873804,63.82255606127358,NaN,NaN,NaN,NaN,0.7723934565928013,45.261410315974324,41903291,0.1154572384826783,0.841465244934323,0.7260080064516446
2024-05-31T09:30:00-04:00,21.92,22.33,20.17,20.59,19.752057677998945,NaN,NaN,NaN,NaN,NaN,18.6386,21.845383460104674,15.431816539895324,20.365396403491236,21.03,21.03,21.03,2383610,1662082.0333333334,55.434712734308704,62.579977728030926,NaN,NaN,NaN,NaN,0.8715082096933153,43.440634510910755,39519681,0.03168522863015688,0.7656145422393408,0.7339293136091839
2024-05-31T13:30:00-04:00,20.6,20.92,20.46,20.9,19.752057677998945,NaN,NaN,NaN,NaN,NaN,18.713999999999995,21.952481743039712,15.475518256960278,20.365396403491236,20.960236553505958,21.078427890272803,20.842045216739113,830462,1643469.1,57.57694013853369,61.42668652100387,NaN,NaN,NaN,NaN,0.8421147661437928,41.749914120494594,40350143,-0.009390053927960995,0.7221917461992327,0.7315818001271936
2024-06-03T09:30:00-04:00,21.9,22.4,20.74,20.95,19.752057677998945,NaN,NaN,NaN,NaN,NaN,18.7778,22.063929735722695,15.491670264277303,20.365396403491236,21.363333333333333,21.363333333333333,21.363333333333333,2435599,1660519.4333333333,57.928219589484875,61.105488826968106,NaN,NaN,NaN,NaN,0.9005351399906647,41.38092217545684,42785742,-0.038121811565902775,0.6839295356698152,0.722051347235718
2024-06-03T13:30:00-04:00,20.95,21.32,20.86,21.295,19.752057677998945,NaN,NaN,NaN,NaN,NaN,18.845899999999997,22.196115927369657,15.495684072630336,20.365396403491236,21.31669347086907,21.402634700989356,21.23075224074878,717327,1650282.3666666667,60.36683484653353,61.287520657434,NaN,NaN,NaN,NaN,0.8690683442770458,41.03828679792178,43503069,-0.038697622559318745,0.6736793190365695,0.7123769415958883
2024-06-04T09:30:00-04:00,21.05,21.62,20.66,21.17,19.752057677998945,NaN,NaN,NaN,NaN,NaN,18.915799999999997,22.310919650321786,15.520680349678209,20.365396403491236,21.150000000000006,21.150000000000006,21.150000000000006,1764950,1640491.8333333333,59.03173560537175,61.25377823407457,NaN,NaN,NaN,NaN,0.8755634625429712,40.932810647515325,41738119,-0.051501748988283635,0.6479997553605337,0.6995015043488173
2024-06-04T13:30:00-04:00,21.17,21.27,20.75,20.76,19.752057677998945,NaN,NaN,NaN,NaN,NaN,18.984199999999998,22.38736873516451,15.581031264835485,20.365396403491236,21.084527808203728,21.186191542819106,20.98286407358835,732005,1642567.1333333333,54.75422306404103,61.39398664210677,NaN,NaN,NaN,NaN,0.8501660723613303,40.83486850785219,41006114,-0.08936978444955113,0.5877892737868784,0.6771590582364295
2024-06-05T09:30:00-04:00,20.97,21.55,20.4,21.09,19.752057677998945,NaN,NaN,NaN,NaN,NaN,19.072,22.46140525756375,15.68259474243625,20.365396403491236,21.013333333333335,21.013333333333335,21.013333333333335,1475654,1594832.2,57.4281123044988,61.25821991522947,NaN,NaN,NaN,NaN,0.8715827814783783,40.14843709823602,42481768,-0.09353352448933305,0.5602421526247632,0.6537756771140962
2024-06-05T13:30:00-04:00,21.095,21.59,21.09,21.57,19.752057677998945,NaN,NaN,NaN,NaN,NaN,19.173899999999996,22.55120382998055,15.796596170019441,20.365396403491236,21.120935556954542,21.299320884262954,20.94255022964613,536919,1587910.2,61.03514750824914,61.17415131734422,NaN,NaN,NaN,NaN,0.8450411542299227,39.546890035970975,43018687,-0.06656796359165074,0.5705657226245329,0.6371336862161836
2024-06-06T09:30:00-04:00,22.25,23.19,21.75,23.085,19.925854698440396,NaN,NaN,NaN,NaN,NaN,19.303199999999993,22.773250581764145,15.833149418235841,20.705608261015964,22.675,22.675,22.675,4263049,1684510.1,69.74764615140822,61.67090223456832,NaN,NaN,NaN,NaN,0.900395357499214,40.15477122992972,47281736,0.0446982647037496,0.6930065170958706,0.648308252392121
2024-06-06T13:30:00-04:00,23.09,23.24,22.74,22.96,20.493315848511287,NaN,NaN,NaN,NaN,NaN,19.429799999999997,22.961829988547834,15.89777001145216,21.00248660881277,22.75396586462498,22.88756594297286,22.6203657862771,1489312,1706991.8666666667,68.38890293900587,62.18322949280928,NaN,NaN,NaN,NaN,0.871795689106413,40.748860012211956,45792424,0.09820691355498257,0.7710668943358492,0.6728599807808666
2024-06-07T09:30:00-04:00,22.52,23.68,22.51,22.74,20.55225603721532,NaN,NaN,NaN,NaN,NaN,19.538999999999998,23.13544268687838,15.942557313121615,21.30498928705022,22.976666666666663,22.976666666666663,22.976666666666663,2450470,1725593.5333333334,65.95365031227158,62.3137279245193,NaN,NaN,NaN,NaN,0.8930959970273834,41.55945485914085,43341954,0.10642270728535586,0.8058883648875614,0.6994656576022056
2024-06-07T13:30:00-04:00,22.725,22.88,22.15,22.18,20.55225603721532,NaN,NaN,NaN,NaN,NaN,19.629999999999995,23.2587358680402,16.00126413195979,21.30498928705022,22.78276369020403,23.054006525238744,22.511520855169312,1252281,1745829.9666666666,60.08824617479988,61.93031645060817,NaN,NaN,NaN,NaN,0.881446282953999,41.67799865639767,42089673,0.0638785668360825,0.7793138661473087,0.7154352993112262
2024-06-10T09:30:00-04:00,22.11,23.37,22.06,23.32,20.55225603721532,NaN,NaN,NaN,NaN,NaN,19.742099999999997,23.472162782313642,16.012037217686352,21.30498928705022,22.916666666666668,22.916666666666668,22.916666666666668,1713289,1632453.5,66.60011424133498,61.61191533061284,NaN,NaN,NaN,NaN,0.9120572627429991,42.10774229646868,43802962,0.10009375348445648,0.8405524911667968,0.7404587376823403
2024-06-10T13:30:00-04:00,23.31,23.52,23.24,23.42,20.869071953479626,NaN,NaN,NaN,NaN,NaN,19.851699999999997,23.684149665683982,16.019250334316013,21.40639451496971,23.076813845448264,23.301957584011433,22.851670106885095,866861,1596203.7666666666,67.10708967319158,61.53154109164523,NaN,NaN,NaN,NaN,0.8669103154042136,42.60140999261138,44669823,0.11717679632760547,0.8869297330918471,0.7697529367642416
2024-06-11T09:30:00-04:00,22.87,23.11,22.14,22.935,20.869071953479626,NaN,NaN,NaN,NaN,NaN,19.952499999999997,23.83853564059844,16.066464359401554,21.40639451496971,22.728333333333335,22.728333333333335,22.728333333333335,1507757,1570087.6,62.177596340524815,62.013175634946386,NaN,NaN,NaN,NaN,0.8964167214467699,41.28571382357872,43162066,0.08377225779603648,0.8744682590092872,0.7906960012132507
2024-06-11T13:30:00-04:00,22.94,23.305,22.93,23.2,20.869071953479626,NaN,NaN,NaN,NaN,NaN,20.061299999999996,23.999962112951703,16.12263788704829,21.40639451496971,22.847039806941268,23.035108421530506,22.65897119235203,600686,1555689.5333333334,63.74468781104663,62.45372904012588,NaN,NaN,NaN,NaN,0.8591726699148577,40.231002632576235,43762752,0.0681465164163354,0.87587914673367,0.8077326303173346
2024-06-12T09:30:00-04:00,23.99,24.16,23.54,24.12,21.327384049697113,NaN,NaN,NaN,NaN,NaN,20.181599999999996,24.239536145382452,16.12366385461754,22.03823399166449,23.94,23.94,23.94,1843603,1554626.1,68.60759951811289,63.21654189217073,NaN,NaN,NaN,NaN,0.8663746220637966,39.918754103043064,45606355,0.10612855794736142,0.9403933277515364,0.834264769804175
2024-06-12T13:30:00-04:00,24.12,24.28,23.57,23.69,21.420230229256333,NaN,NaN,NaN,NaN,NaN,20.295599999999997,24.420563340443344,16.17063665955665,22.227587193331594,23.900160769721573,23.946325300370102,23.853996239073044,1373006,1574386.0666666667,64.26860669611028,63.49523988142622,NaN,NaN,NaN,NaN,0.8552050062020969,39.71516751973286,44233349,0.08932410326708029,0.9459198988880253,0.856595795620945
2024-06-13T09:30:00-04:00,23.68,23.74,22.92,23.09,21.420230229256333,NaN,NaN,NaN,NaN,NaN,20.4,24.538325265128528,16.26167473487147,22.227587193331594,23.25,23.25,23.25,1455589,1557785,58.6909084240283,63.47089508275883,NaN,NaN,NaN,NaN,0.8526903629019469,38.55623445267487,42777760,0.028008860885988862,0.8916068717284311,0.8635980108424423
2024-06-13T13:30:00-04:00,23.09,23.39,23.04,23.3,21.420230229256333,NaN,NaN,NaN,NaN,NaN,20.508799999999997,24.660312765246097,16.357287234753898,22.227587193331594,23.248244259704137,23.25118063695919,23.245307882449083,520398,1536865.6333333333,59.999412938655055,63.845551502374114,NaN,NaN,NaN,NaN,0.8167839084089508,37.48008231897817,43298158,-0.0063621647517273505,0.855645304902783,0.8620074696545104
2024-06-14T09:30:00-04:00,23.11,23.56,22.53,22.73,21.420230229256333,NaN,NaN,NaN,NaN,NaN,20.619199999999996,24.707040192571306,16.531359807428686,22.227587193331594,22.94,22.94,22.94,1054998,1524965.5,54.91478571481856,63.666028174539804,NaN,NaN,NaN,NaN,0.8320136292368827,35.75141067580322,42243160,-0.07180656848893763,0.7722492590433383,0.8440558275322759
2024-06-14T13:30:00-04:00,22.73,22.745,22.36,22.415,21.420230229256333,NaN,NaN,NaN,NaN,NaN,20.721699999999995,24.72666172765754,16.71673827234245,22.227587193331594,22.765352735108173,22.977905820992085,22.552799649224262,712263,1519249.4666666666,52.27813509563296,63.04052728792436,NaN,NaN,NaN,NaN,0.8000840842913911,33.9129589745054,41530897,-0.136859293873817,0.6729817101900046,0.8098410040638216
2024-06-17T09:30:00-04:00,22.25,22.6,21.7,22.26,21.420230229256333,NaN,NaN,NaN,NaN,NaN,20.836299999999998,24.679588597022253,16.993011402977743,22.227587193331594,22.186666666666667,22.186666666666667,22.186666666666667,1188271,1509721.2,50.98102254343729,61.7000541730693,NaN,NaN,NaN,NaN,0.8072209354134348,31.620636859895857,40342626,-0.18773359527096845,0.575174009975111,0.7629076052460795
2024-06-17T13:30:00-04:00,22.25,22.72,22.19,22.23,21.420230229256333,NaN,NaN,NaN,NaN,NaN,20.956399999999995,24.585096206628716,17.327703793371274,22.227587193331594,22.266679774509587,22.361901113624942,22.171458435394232,839014,1491363.2,50.71872144322609,60.43789835194217,NaN,NaN,NaN,NaN,0.7874194400267607,29.38200716635184,39503612,-0.21864912943385817,0.4895961934537567,0.7082453228876149
2024-06-18T09:30:00-04:00,21.96,22.21,21.8,22.025,21.420230229256333,NaN,NaN,NaN,NaN,NaN,21.058299999999996,24.51087909974582,17.60572090025417,22.227587193331594,22.011666666666667,22.011666666666667,22.011666666666667,836237,1477196.1,48.86844187929992,59.21752632101561,NaN,NaN,NaN,NaN,0.7618894800248491,27.745608108354887,38667375,-0.24610399714751297,0.40061532645322373,0.6467193236007367
2024-06-18T13:30:00-04:00,22.01,22.06,21.83,21.855,21.420230229256333,NaN,NaN,NaN,NaN,NaN,21.1572,24.406089754977998,17.908310245022,22.227587193331594,21.97989399512657,22.025301655186336,21.934486335066804,409429,1464443.2333333334,47.32655094819564,58.30597666197246,NaN,NaN,NaN,NaN,0.7238973743087885,26.22609469735771,38257946,-0.26715601761763297,0.31277430157869546,0.5799303191963284
2024-06-20T09:30:00-04:00,22.07,22.07,21.19,21.31,NaN,NaN,NaN,23.90542074816175,23.90542074816175,23.90542074816175,21.225999999999996,24.33626751261072,18.11573248738927,22.227587193331594,21.523333333333337,21.523333333333337,21.523333333333337,1201875,1438596.7666666666,42.67757634158041,56.59722395484713,NaN,NaN,NaN,NaN,0.7350475618581607,25.573981871775803,37056071,-0.3064139971067784,0.19691282281285538,0.5033268199196338
2024-06-20T13:30:00-04:00,21.31,21.835,21.21,21.75,NaN,NaN,NaN,23.779719805063486,NaN,NaN,21.300999999999995,24.27432541105104,18.32767458894895,21.688069754665275,21.545652019757796,21.579941635067108,21.511362404448484,509180,1416390.6666666667,47.18808089654372,55.17443761365799,NaN,NaN,NaN,NaN,0.7271870217254348,24.96844853373546,37565251,-0.29146637250447177,0.1389938542890441,0.43046022679351587
2024-06-21T09:30:00-04:00,21.51,22.32,21.25,21.93,NaN,NaN,NaN,23.779719805063486,NaN,NaN,21.376199999999997,24.21617222521654,18.536227774783455,21.591764642985776,21.833333333333332,21.833333333333332,21.833333333333332,1620183,1339527.5666666667,48.95752488186127,54.23014679518202,NaN,NaN,NaN,NaN,0.751673663030761,23.646940442641977,39185434,-0.2592555863482021,0.10639074385826319,0.3656463302064653
2024-06-21T13:30:00-04:00,21.93,22.31,21.93,22.29,NaN,NaN,NaN,23.779719805063486,NaN,NaN,21.451599999999996,24.182327697886006,18.720872302113985,21.591764642985776,21.94866084870723,22.110819241878882,21.78650245553558,819504,1313459.3666666667,52.393026236101875,53.41931382554312,NaN,NaN,NaN,NaN,0.7251255442428494,22.419825786626596,40004938,-0.2058350521985564,0.10835251495826981,0.3141875671568262
2024-06-24T09:30:00-04:00,21.845,22.32,20.88,21.17,NaN,NaN,NaN,23.779719805063486,NaN,NaN,21.511999999999997,24.0764843536277,18.947515646372295,20.977911714388622,21.456666666666667,21.456666666666667,21.456666666666667,1785904,1293535.8333333333,42.75214898297236,51.57249593017594,NaN,NaN,NaN,NaN,0.7761880053683602,22.520413663281293,38219034,-0.23590205431116923,0.019309999267864697,0.2552120535790339
2024-06-24T13:30:00-04:00,21.17,21.68,21.15,21.37,NaN,NaN,NaN,23.7227882953203,NaN,NaN,21.581599999999998,23.928791036111317,19.23440896388868,20.964063497208716,21.43954867639245,21.465567782023452,21.41352957076145,772999,1291620.4,44.70872327980738,50.17536140044002,NaN,NaN,NaN,NaN,0.7586031478420489,22.613816691603514,38992033,-0.2319442800573292,-0.03471829649262759,0.1972259835647016
2024-06-25T09:30:00-04:00,21.48,22.28,21.22,22.12,NaN,NaN,NaN,23.7227882953203,NaN,NaN,21.624599999999997,23.93053134329741,19.318668656702584,20.964063497208716,21.873333333333335,21.873333571751914,21.873333094914756,1211745,1250825.2666666666,51.41464509843248,49.655628305754604,NaN,NaN,NaN,NaN,0.7801314944247598,21.731726795882818,40203778,-0.17123954518127849,-0.016823447911896494,0.154416097269382
2024-06-25T13:30:00-04:00,22.11,22.19,21.9,22.16,NaN,NaN,NaN,23.7227882953203,NaN,NaN,21.6662,23.933900650438872,19.398499349561128,20.68885658141228,21.930721162092492,22.02430578235645,21.837136541828535,455661,1242103.0666666667,51.75075076842552,49.066438150738215,NaN,NaN,NaN,NaN,0.7451221019658486,20.912643321285028,40659439,-0.12306940901944383,0.0005793359950772015,0.12364874501452103
2024-06-26T09:30:00-04:00,22.685,23.32,22.22,22.39,NaN,NaN,NaN,23.7227882953203,NaN,NaN,21.7056,23.95369398380071,19.45750601619929,21.322991724597173,22.643333333333338,22.643333333333338,22.643333333333338,1687423,1239518.8333333333,53.73272020991452,48.98200490038793,NaN,NaN,NaN,NaN,0.7747562375397166,20.20624339363746,42346862,-0.07287501842823232,0.03255497197923063,0.10542999040746295
2024-06-26T13:30:00-04:00,22.38,22.62,22.29,22.31,NaN,NaN,NaN,23.7227882953203,NaN,NaN,21.735,23.975480305649004,19.494519694350995,21.322991724597173,22.581759330992373,22.685591677220255,22.47792698476449,593408,1234898.9333333333,52.918465146603616,49.027742761171545,NaN,NaN,NaN,NaN,0.7429879348583084,19.55030060367901,41753454,-0.043660516149481965,0.0508543452206105,0.09451486137009246
2024-06-27T09:30:00-04:00,22.48,22.79,22.27,22.74,NaN,NaN,NaN,23.7227882953203,NaN,NaN,21.774399999999996,24.01490140816771,19.533898591832283,21.322991724597173,22.599999999999998,22.599999999999998,22.599999999999998,518806,1203004,56.71527988118212,49.43733257101046,NaN,NaN,NaN,NaN,0.7270602252255721,19.14831661200602,42272260,0.0035192457937976707,0.09891391861233956,0.09539467281854189
2024-06-27T13:30:00-04:00,22.73,22.73,22.51,22.59,NaN,NaN,NaN,23.7227882953203,NaN,NaN,21.807399999999998,24.04637497976224,19.568425020237754,21.322991724597173,22.60353454764789,22.60831497119217,22.59875412410361,283622,1194560.7666666666,55.047592619063046,49.74653765499881,NaN,NaN,NaN,NaN,0.6915559234237454,18.775045762595386,41988638,0.022463777280683744,0.12347439441939656,0.10101061713871282
2024-06-28T09:30:00-04:00,22.75,23.08,22.34,22.68,NaN,NaN,NaN,23.7227882953203,NaN,NaN,21.859599999999997,24.05540039165709,19.663799608342902,21.549145410395003,22.7,22.7,22.7,759859,1077787.7666666666,55.885757181840475,50.247774462323136,NaN,NaN,NaN,NaN,0.6950162146077634,18.872301919888194,42748497,0.037982949503779145,0.14848930401843674,0.1105063545146576
2024-06-28T13:30:00-04:00,22.68,22.73,22.42,22.71,NaN,NaN,NaN,23.7227882953203,NaN,NaN,21.920799999999996,24.03594194322786,19.80565805677213,21.549145410395003,22.67089775857594,22.709384624621272,22.632410892530608,434471,1042626.4,56.17906350351141,50.88009678770283,NaN,NaN,NaN,NaN,0.6675150564214946,18.962611208802947,43182968,0.04662600159427728,0.1687888565075042,0.12216285491322691
2024-07-01T09:30:00-04:00,22.88,22.96,22.43,22.735,NaN,NaN,NaN,23.7227882953203,NaN,NaN,21.978099999999994,24.021935502187503,19.934264497812485,21.591253062652804,22.708333333333332,22.708333333333332,22.708333333333332,910842,991305.4666666667,56.43898608471893,51.863054626498446,NaN,NaN,NaN,NaN,0.6576925523913879,19.343963272026084,44093810,0.05008079331750312,0.1847638465601058,0.13468305324260268
2024-07-01T13:30:00-04:00,22.73,23.13,22.645,22.79,NaN,NaN,NaN,23.7227882953203,NaN,NaN,22.0495,23.947139849919175,20.15186015008082,21.792502450122242,22.765131012533477,22.83657574586073,22.693686279206222,575657,968751.3333333334,57.04266643094556,52.56695359324143,NaN,NaN,NaN,NaN,0.6453573700777173,19.913581574241114,44669467,0.05190296372118258,0.19956175789408093,0.14765879417289834
2024-07-02T09:30:00-04:00,22.59,22.8,22.07,22.45,NaN,NaN,NaN,23.7227882953203,NaN,NaN,22.096899999999994,23.91199436669335,20.28180563330664,21.792502450122242,22.44,22.44,22.44,957743,943566.4666666667,52.22447499961319,52.80030717308085,NaN,NaN,NaN,NaN,0.6514032722150233,19.289606915256957,43711724,0.02728004296615691,0.1817588478805945,0.15447880491443758
2024-07-02T13:30:00-04:00,22.45,22.57,22.39,22.45,NaN,NaN,NaN,23.7227882953203,NaN,NaN,22.135499999999997,23.896083142030253,20.37491685796974,21.792502450122242,22.44706255683011,22.459790360882057,22.434334752778167,294894,924500.9,52.22447499961318,52.78826779904595,NaN,NaN,NaN,NaN,0.6177316099139502,18.710201874771666,43711724,0.009008454554736173,0.1657393731078578,0.15673091855312163
2024-07-03T09:30:00-04:00,22.45,23.12,22.44,22.88,NaN,NaN,NaN,23.7227882953203,NaN,NaN,22.180899999999998,23.898333771649217,20.46346622835078,21.792502450122242,22.813333333333333,22.813333333333333,22.813333333333333,1272191,916648.7,57.490998666816814,53.841042776463404,NaN,NaN,NaN,NaN,0.6221793520629537,18.95442329757647,44983915,0.023096648418866633,0.1856017290767049,0.16250508065783828
2024-07-05T09:30:00-04:00,22.04,22.57,21.72,22.51,NaN,NaN,NaN,23.7227882953203,NaN,NaN,22.221699999999995,23.870156987610503,20.573243012389486,21.792502450122242,22.266666666666666,22.266666666666666,22.266666666666666,864508,925442.7666666667,52.16261065084932,54.3734633029664,NaN,NaN,NaN,NaN,0.6605951126298856,17.88941033693848,44119407,0.005622027510309213,0.1695326150457248,0.1639105875354156
2024-07-05T13:30:00-04:00,22.505,22.74,22.49,22.67,NaN,NaN,NaN,23.7227882953203,NaN,NaN,22.257299999999997,23.865573869712698,20.649026130287297,21.792502450122242,22.360995025815985,22.521273613536295,22.200716438095675,299435,873970.5,54.141924909066844,54.568269003726,NaN,NaN,NaN,NaN,0.6312668902991795,17.149179009348508,44418842,0.003091042364482488,0.16777439049101872,0.16468334812653623
2024-07-08T09:30:00-04:00,22.7,22.87,22.01,22.1,NaN,NaN,NaN,23.7227882953203,NaN,NaN,22.2775,23.851629918399517,20.703370081600482,21.792502450122242,22.326666666666668,22.326666666666668,22.326666666666668,807890,855133.3,46.72481920315954,54.209273891921285,NaN,NaN,NaN,NaN,0.6476049695635238,16.14988642820633,43610952,-0.03653482266569949,0.11901481979441186,0.15554964246011135
2024-07-08T13:30:00-04:00,22.11,22.22,21.91,22.07,NaN,NaN,NaN,23.7227882953203,NaN,NaN,22.2777,23.851721867700864,20.703678132299135,21.792502450122242,22.234045502090662,22.358555833638917,22.109535170542408,447056,821515.5333333333,46.36480445584582,53.68299419520209,NaN,NaN,NaN,NaN,0.6234903288804148,15.372829981694641,43163896,-0.06278897772399919,0.07706342030511237,0.13985239802911156
2024-07-09T09:30:00-04:00,22.21,23.26,22.15,22.69,NaN,NaN,NaN,23.7227882953203,NaN,NaN,22.2949,23.867771882894715,20.722028117105282,21.792502450122242,22.7,22.7,22.7,1128052,841770.6666666666,54.21608824640254,53.77568155947345,NaN,NaN,NaN,NaN,0.6639553053889566,15.374395421584927,44291948,-0.03766112757128487,0.09277598856500546,0.13043711613629033
2024-07-09T13:30:00-04:00,22.68,22.72,22.52,22.605,NaN,NaN,NaN,23.7227882953203,NaN,NaN,22.3352,23.832727241822464,20.837672758177536,21.792502450122242,22.677910506908812,22.715188666839012,22.640632346978613,396088,819807,53.06913753149042,53.51524282020976,NaN,NaN,NaN,NaN,0.6308156407183169,15.375849044340193,43895860,-0.026550891077631755,0.09724850228925064,0.1237993933668824
2024-07-10T09:30:00-04:00,22.73,22.87,22.08,22.265,NaN,NaN,NaN,23.7227882953203,NaN,NaN,22.3625,23.803061348919336,20.921938651080666,21.78960125446259,22.405,22.405,22.405,1027157,830303.4666666667,48.63686154952642,53.0573334581,NaN,NaN,NaN,NaN,0.64218595209558,14.653009859120875,42868703,-0.04102202963701007,0.0725218563206198,0.11354388595762988
2024-07-10T13:30:00-04:00,22.26,22.36,22.1,22.3,NaN,NaN,NaN,23.7227882953203,NaN,NaN,22.389499999999998,23.77261279366536,21.006387206334637,21.78960125446259,22.37334362400666,22.434980389694953,22.31170685831837,270944,799725.9,49.1080640081862,52.573212517124695,NaN,NaN,NaN,NaN,0.6148869555173242,13.981802044274366,43139647,-0.04674335605526281,0.055114690888551365,0.10185804694381417
2024-07-11T09:30:00-04:00,22.62,22.98,22.13,22.285,NaN,NaN,NaN,23.7227882953203,NaN,NaN,22.409299999999998,23.7570655730878,21.061534426912196,21.78960125446259,22.465,22.465,22.465,910134,802096.5666666667,48.90101091134686,52.05335161768436,NaN,NaN,NaN,NaN,0.631680744408944,14.20822256637068,42229513,-0.049764893977825866,0.039651929471531844,0.08941682344935771
2024-07-11T13:30:00-04:00,22.28,22.29,21.98,22.02,NaN,NaN,NaN,23.7227882953203,NaN,NaN,22.4263,23.731892294707638,21.120707705292364,21.5282869390623,22.326522280404273,22.504931588532116,22.14811297227643,548315,792499.1666666666,45.26960403701819,51.255538614277164,NaN,NaN,NaN,NaN,0.6087035483797336,14.153400629052785,41681198,-0.06677685445876534,0.0059457553759010295,0.07272260983466637
2024-07-12T09:30:00-04:00,22.01,22.44,21.75,22.28,NaN,NaN,NaN,23.7227882953203,NaN,NaN,22.4567,23.67344255288459,21.239957447115412,21.5282869390623,22.156666666666666,22.156666666666666,22.156666666666666,968426,811132.4,49.251521533367864,50.69902826445019,NaN,NaN,NaN,NaN,0.6145104377811813,13.699722770158468,42649624,-0.058009474217271415,0.0002107670630770997,0.058220241280348514
2024-07-12T13:30:00-04:00,22.28,22.37,22.2,22.27,NaN,NaN,NaN,23.7227882953203,NaN,NaN,22.480300000000003,23.634246983184113,21.326353016815894,21.5282869390623,22.195577958613796,22.25289262252315,22.138263294704444,446361,785948.6,49.103546698327825,50.47610481435837,NaN,NaN,NaN,NaN,0.5827596922253828,13.278450472613748,42203263,-0.05064225710436822,-0.005082580100111755,0.04555967700425646
2024-07-15T09:30:00-04:00,22.98,24.01,22.76,23.63,21.360039626073473,21.360039626073473,21.360039626073473,NaN,NaN,NaN,22.5215,23.68951412662717,21.35348587337283,22.14010995926627,23.46666666666667,23.46666666666667,23.46666666666667,2218042,842910.6666666666,64.65621379258764,51.3640861567137,NaN,NaN,NaN,NaN,0.6654197142092843,14.805727492124019,44421305,0.04300678656840916,0.09931816021476791,0.056311373646358756
2024-07-15T13:30:00-04:00,23.63,23.965,23.44,23.95,21.69799237034286,NaN,NaN,NaN,NaN,NaN,22.538800000000002,23.76391478645869,21.313685213541312,22.206587967413014,23.540107685997068,23.674216377612186,23.40599899438195,665171,811076.9333333333,67.19623206274943,52.05731711356602,NaN,NaN,NaN,NaN,0.6553897346229067,16.223913295954983,45086476,0.11935797841879354,0.2055088466698507,0.08615086825105715
2024-07-16T09:30:00-04:00,24.02,24.81,23.35,24.28,21.967515444418183,NaN,NaN,NaN,NaN,NaN,22.5652,23.879151231971786,21.251248768028216,22.673270373930414,24.14666666666667,24.14666666666667,24.14666666666667,1695781,840286.1666666666,69.62087439549109,53.304335952469,NaN,NaN,NaN,NaN,0.7128618964355561,18.232779509974247,46782257,0.18123089188254055,0.31268948310423283,0.1314585912216923
2024-07-16T13:30:00-04:00,24.28,24.66,24.18,24.62,22.338082924217357,NaN,NaN,NaN,NaN,NaN,22.6028,24.036726302151067,21.16887369784893,22.71061629914433,24.26438379384158,24.42614442319625,24.102623164486914,898056,810691.2333333333,71.92346693116892,54.574446096904865,NaN,NaN,NaN,NaN,0.6962289038330164,20.098155280134993,47680313,0.2310107353568313,0.42022201041773144,0.18921127506090013
2024-07-17T09:30:00-04:00,24.13,24.88,23.57,23.94,22.338082924217357,NaN,NaN,NaN,NaN,NaN,22.637999999999998,24.114460632729653,21.161539367270343,22.71061629914433,24.13,24.13,24.13,1353925,830055.4333333333,61.82969263134407,55.653365627489485,NaN,NaN,NaN,NaN,0.7400696964163723,20.69174030584467,46326388,0.2049807979026514,0.4454372724392144,0.240456474536563
2024-07-17T13:30:00-04:00,23.94,24.4,23.86,24.19,22.338082924217357,NaN,NaN,NaN,NaN,NaN,22.6554,24.183212606310132,21.12758739368987,22.71061629914433,24.13450748464966,24.14286405542543,24.12615091387389,393919,802794.5666666667,63.8389684878114,56.90152020120131,NaN,NaN,NaN,NaN,0.7257790038152028,21.242926401146516,46720307,0.19168252542445852,0.48005963131713614,0.2883771058926776
2024-07-18T09:30:00-04:00,24.22,24.44,23.165,23.5,22.338082924217357,NaN,NaN,NaN,NaN,NaN,22.656999999999996,24.188176018621178,21.125823981378815,22.71061629914433,23.701666666666668,23.701666666666668,23.701666666666668,1104572,824424.9333333333,55.20198019360028,56.971941054572575,NaN,NaN,NaN,NaN,0.7650090749712598,20.586838238644617,45615735,0.12663584408010475,0.44667191099280856,0.3200360669127038
2024-07-18T13:30:00-04:00,23.51,23.53,22.66,22.84,22.338082924217357,NaN,NaN,NaN,NaN,NaN,22.6551,24.18512678407933,21.125073215920672,22.71061629914433,23.42386007621425,23.762936847311185,23.084783305117316,741452,792892.5666666667,48.449745920730216,56.64198451094684,NaN,NaN,NaN,NaN,0.7725084267590271,19.252349242729576,44874283,0.034190018322404814,0.36277358981570984,0.328583571493305
2024-07-19T09:30:00-04:00,22.925,23.87,22.8,23.58,22.338082924217357,NaN,NaN,NaN,NaN,NaN,22.6627,24.20718465191461,21.118215348085393,22.71061629914433,23.416666666666668,23.416666666666668,23.416666666666668,773032,798880.0333333333,55.083657749308834,57.10246995378844,NaN,NaN,NaN,NaN,0.793757824847668,18.445141202902494,45647315,0.018683905978800763,0.351938453966806,0.33325454798800525
2024-07-19T13:30:00-04:00,23.57,23.685,23.33,23.4,22.338082924217357,NaN,NaN,NaN,NaN,NaN,22.6483,24.151028997524286,21.145571002475712,22.71061629914433,23.438242670779736,23.46509702373343,23.41138831782604,499011,798220.2,53.287319056787915,57.400988171545706,NaN,NaN,NaN,NaN,0.7624179802156917,17.69559088020592,45148304,-0.0065398636484473305,0.3250797184274461,0.3316195820758934
2024-07-22T09:30:00-04:00,23.24,24.01,23.175,23.36,22.338082924217357,NaN,NaN,NaN,NaN,NaN,22.6417,24.128888770802106,21.154511229197894,22.71061629914433,23.515,23.515,23.515,1177548,828017.7333333333,52.8746658176701,57.68482066485451,NaN,NaN,NaN,NaN,0.7676024102002853,17.420183103122294,43970756,-0.027582822308009958,0.297141054190881,0.32472387649889095
2024-07-22T13:30:00-04:00,23.34,23.51,23.09,23.42,22.338082924217357,NaN,NaN,NaN,NaN,NaN,22.6483,24.146278117330144,21.150321882669854,22.71061629914433,23.444778865543785,23.53055584850262,23.359001882584952,789174,828994.9,53.456893296459285,58.269627040528874,NaN,NaN,NaN,NaN,0.7427736666145508,17.020529390681336,44759930,-0.03845758977078123,0.2766518892854144,0.31510947905619563
2024-07-23T09:30:00-04:00,23.24,23.4,22.93,23.02,22.338082924217357,NaN,NaN,NaN,NaN,NaN,22.6427,24.1329646878993,21.152435312100703,22.71061629914433,23.116666666666664,23.116666666666664,23.116666666666664,896480,844395.2,49.101508648617084,58.258911834475235,NaN,NaN,NaN,NaN,0.7247184047135116,16.37276873360094,43863450,-0.07165753143176973,0.22553756476648346,0.2971950961982532
2024-07-23T13:30:00-04:00,23.02,23.02,22.82,22.86,22.338082924217357,NaN,NaN,NaN,NaN,NaN,22.6453,24.136618088135467,21.15398191186453,22.665493039315464,23.052640625826776,23.151498983809102,22.95378226784445,376034,826568.2666666667,47.436634742266605,58.13984669475658,NaN,NaN,NaN,NaN,0.6872385186625464,15.578484971263979,43487416,-0.10163050264232959,0.17015696789534118,0.27178747053767077
2024-07-24T09:30:00-04:00,22.66,22.9,21.92,22.07,NaN,NaN,NaN,24.53779235862273,24.53779235862273,24.53779235862273,22.638399999999997,24.137090681895497,21.139709318104497,22.35839443145237,22.296666666666667,22.296666666666667,22.296666666666667,969708,839703.3,40.19056635136186,56.39230044895474,NaN,NaN,NaN,NaN,0.7081500530437929,15.447782388187239,42517708,-0.1679831303443961,0.06180855760717563,0.22979168795157173
2024-07-24T13:30:00-04:00,22.07,22.17,21.36,21.4,NaN,NaN,NaN,23.906529069594427,NaN,NaN,22.621199999999995,24.15616783028197,21.08623216971802,22.169215545161897,22.0334760168174,22.35391619282542,21.71303584080938,654166,829584.0666666667,35.26988745438908,54.11184726264328,NaN,NaN,NaN,NaN,0.7154250492549508,15.991269989949988,41863542,-0.24561852036594298,-0.077231462505857,0.16838705786008598
2024-07-25T09:30:00-04:00,21.16,21.78,20.63,21.58,NaN,NaN,NaN,23.406005020976494,NaN,NaN,22.608199999999997,24.16702489074314,21.049375109256854,21.955266687298312,21.33,21.33,21.33,707061,843322.9666666667,37.484368206929354,51.816382534888874,NaN,NaN,NaN,NaN,0.7464661171653116,17.219019892076386,42570603,-0.2714511232581361,-0.17092684621258414,0.10052427704555195
2024-07-25T13:30:00-04:00,21.585,21.66,21.13,21.18,NaN,NaN,NaN,23.406005020976494,NaN,NaN,22.591299999999997,24.19278782074685,20.989812179253143,21.955266687298312,21.327944389718688,21.33102311263916,21.324865666798217,315208,811423.5333333333,34.64767834646996,49.15382620741037,NaN,NaN,NaN,NaN,0.7310042516535038,18.359073372622323,42255395,-0.2998561080298693,-0.2742958579917847,0.02556025003808461
2024-07-26T09:30:00-04:00,21.55,21.98,21.23,21.49,NaN,NaN,NaN,23.406005020976494,NaN,NaN,22.583999999999996,24.20208776029007,20.965912239709922,21.955266687298312,21.566666666666666,21.566666666666666,21.566666666666666,632082,803676,38.53016603280848,47.48957430751498,NaN,NaN,NaN,NaN,0.7359325193925393,18.821300715973003,42887477,-0.28239040165423834,-0.3274277520297133,-0.045037350375474974
2024-07-26T13:30:00-04:00,21.49,21.5,21.13,21.195,NaN,NaN,NaN,23.406005020976494,NaN,NaN,22.5817,24.20733416548723,20.956065834512774,21.955266687298312,21.442878773253735,21.58703618613872,21.29872136036875,466075,809230.6666666666,36.318968325420805,45.52386001020136,NaN,NaN,NaN,NaN,0.7097944822930724,19.36145608051051,42421402,-0.2750554776819329,-0.3888566974778911,-0.1138012197959582
2024-07-29T09:30:00-04:00,21.55,21.83,20.95,21.16,NaN,NaN,NaN,23.406005020976494,NaN,NaN,22.569899999999997,24.227757038468745,20.91204296153125,21.671970679870917,21.313333333333333,21.31333357175191,21.313333094914753,604949,802465.9666666667,36.05459476168614,44.156189622207485,NaN,NaN,NaN,NaN,0.7219520192721386,19.245473498254448,41816453,-0.25723534102494744,-0.4353453960771425,-0.17811005505219507
2024-07-29T13:30:00-04:00,21.15,21.24,21.015,21.17,NaN,NaN,NaN,23.217812842898972,NaN,NaN,22.554699999999997,24.24927535683733,20.860124643162663,21.671970679870917,21.25325057180044,21.33513017343118,21.1713709701697,325737,798422,36.19749694949923,43.28102898140528,NaN,NaN,NaN,NaN,0.6864554464669856,19.137775386159532,42142190,-0.23031935095212003,-0.4660092437423451,-0.23568989279022506
2024-07-30T09:30:00-04:00,21.29,21.35,20.55,20.64,NaN,NaN,NaN,23.054389531858117,NaN,NaN,22.521699999999996,24.29790675598325,20.745493244016743,21.537576543896733,20.846666666666668,20.846666666666668,20.846666666666668,520619,778174.2333333333,32.102706053345585,41.63953243169362,NaN,NaN,NaN,NaN,0.694565771719344,19.628610400887176,41621571,-0.23304983092229292,-0.5270021814430912,-0.29395235052079827
2024-07-30T13:30:00-04:00,20.63,20.67,20.295,20.4,NaN,NaN,NaN,22.542371825864564,NaN,NaN,22.506299999999996,24.34149024626894,20.671109753731052,21.22406123511739,20.61257558370169,20.80463557182399,20.420515595579392,773421,790752,30.42431171309235,40.0064604785725,NaN,NaN,NaN,NaN,0.6717396451679623,20.380639628659473,40848150,-0.23518071748298075,-0.5879282473745242,-0.35274752989154345
2024-07-31T09:30:00-04:00,20.82,21.13,20.77,20.79,NaN,NaN,NaN,22.542371825864564,NaN,NaN,22.494699999999995,24.365460711582596,20.623939288417393,20.42424898809391,20.896666666666665,20.896666666666665,20.896666666666665,678915,779143.9333333333,36.25643580536106,38.819444049121856,NaN,NaN,NaN,NaN,0.6759010990845364,20.165961802918382,41527065,-0.19608293328358106,-0.5978511964960198,-0.40176826321243875
2024-07-31T13:30:00-04:00,20.79,21.205,20.53,20.56,NaN,NaN,NaN,22.542371825864564,NaN,NaN,22.463499999999996,24.408767333813202,20.51823266618679,20.10617548190408,20.838213210741376,20.903631596437744,20.772794825045008,542046,788180.6666666666,34.423800803167566,37.45993744245816,NaN,NaN,NaN,NaN,0.6758367348642123,20.275236535425112,40985019,-0.17231342633610353,-0.6171600461325681,-0.4448466197964646
2024-08-01T09:30:00-04:00,20.85,21.29,20.1,20.14,NaN,NaN,NaN,22.542371825864564,NaN,NaN,22.423099999999994,24.472992572795235,20.373207427204754,20.10617548190408,20.51,20.51,20.51,779187,783815.7666666667,31.311374095466817,36.18921354580457,NaN,NaN,NaN,NaN,0.7125626823739112,20.889320718134982,40205832,-0.17113004241479668,-0.6587591728149604,-0.48762913040016376
2024-08-01T13:30:00-04:00,20.13,20.25,19.83,20.24,NaN,NaN,NaN,22.132736290920896,NaN,NaN,22.38009999999999,24.519223642990568,20.240976357009416,20.10617548190408,20.309961651051086,20.511621743845705,20.108301558256468,766705,791095.4333333333,32.86772341983716,35.14857702277389,NaN,NaN,NaN,NaN,0.691665347918632,21.756031724131898,40972537,-0.1505900126130867,-0.6758666461665221,-0.5252766335534355
2024-08-02T09:30:00-04:00,19.2,19.28,17.96,18.08,NaN,NaN,NaN,20.928521004969948,NaN,NaN,22.295499999999993,24.750310990687638,19.84068900931235,20.04275230841861,18.44,18.44,18.44,2723782,849607.3,21.523520339255185,33.8152165933377,NaN,NaN,NaN,NaN,0.805117823067301,24.01168855292507,38248755,-0.26287904960502995,-0.8538754455597228,-0.5909963959546929
2024-08-02T13:30:00-04:00,18.08,18.105,17.69,17.88,NaN,NaN,NaN,20.15767914110768,NaN,NaN,22.19829999999999,24.9427909254726,19.453809074527378,20.04275230841861,18.249832424054212,18.51081425075695,17.988850597351473,1446188,882934.8666666667,20.807404616376203,32.782182104908216,NaN,NaN,NaN,NaN,0.7772522642767793,26.256328333515643,36802567,-0.32685461985699704,-0.9995646707759391,-0.6727100509189421
2024-08-05T09:30:00-04:00,14.7,16.66,13.98,16.51,NaN,NaN,NaN,18.009261907420964,NaN,NaN,22.07669999999999,25.24677104652258,18.906628953477405,19.716161477387914,15.716666666666667,15.716666905085246,15.716666428248088,4836286,970209.6666666666,16.70687174613026,31.298075214851135,NaN,NaN,NaN,NaN,1.000305673971295,29.613540165745427,31966281,-0.4311162389086307,-1.2116053495547305,-0.7804891106460998
2024-08-05T13:30:00-04:00,16.52,16.72,16.205,16.415,NaN,NaN,NaN,18.009261907420964,NaN,NaN,21.95139999999999,25.490018397058567,18.41278160294141,19.716161477387914,15.86247924491295,16.15433858456988,15.57061990525602,1207132,988275.0333333333,16.464567825062844,29.999281606179203,NaN,NaN,NaN,NaN,0.9656409829733453,32.64535448424298,30759149,-0.47281268404074817,-1.371504965697035,-0.8986922816562869
2024-08-06T09:30:00-04:00,17.01,17.3,16.25,17.295,NaN,NaN,NaN,18.009261907420964,NaN,NaN,21.843099999999986,25.606533480214885,18.079666519785086,19.61897467642261,16.948333333333334,16.948333333333334,16.948333333333334,1579152,984387.4,27.02290708684839,29.17733453861062,NaN,NaN,NaN,NaN,0.9716666270466778,34.63512841786513,32338301,-0.4098088357256937,-1.410953326313404,-1.0011444905877103
2024-08-06T13:30:00-04:00,17.3,17.515,17.15,17.205,NaN,NaN,NaN,18.009261907420964,NaN,NaN,21.732499999999987,25.703875202622104,17.76112479737787,19.61897467642261,17.080148471085806,17.246466263854376,16.913830678317236,991921,987516.2333333333,26.651887042073625,28.486828732657248,NaN,NaN,NaN,NaN,0.9283332965433438,36.18340099708112,31346380,-0.3454527343680147,-1.4329604085477285,-1.0875076741797138
2024-08-07T09:30:00-04:00,17.62,17.64,17.06,17.13,NaN,NaN,NaN,18.009261907420964,NaN,NaN,21.61929999999999,25.781719974005718,17.45688002599426,19.61897467642261,17.276666666666667,17.276666666666667,17.276666666666667,1652549,997470.3666666667,26.327489030639654,27.792035466153926,NaN,NaN,NaN,NaN,0.903452346790248,37.44147025240404,29693831,-0.28187809856050405,-1.439855297380344,-1.15797719881984
2024-08-07T13:30:00-04:00,17.13,17.265,16.87,17.125,NaN,NaN,NaN,18.009261907420964,NaN,NaN,21.51279999999999,25.853429521164074,17.17217047883591,19.42617974113809,17.182670684971942,17.277665379282894,17.08767599066099,1617984,1038272.5333333333,26.304502483714884,27.085393004312184,NaN,NaN,NaN,NaN,0.867134322019516,38.694353934746076,28075847,-0.2170162640095381,-1.4292475288317625,-1.2122312648222244
2024-08-08T09:30:00-04:00,17.665,18.1,16.68,17.65,14.820781512413722,14.820781512413722,14.820781512413722,NaN,NaN,NaN,21.416799999999995,25.880837526724036,16.952762473275953,18.54894379291047,17.476666666666667,17.476666666666667,17.476666666666667,3535301,1119296.8333333333,32.92650323752157,27.14423566032476,NaN,NaN,NaN,NaN,0.9066247275895508,38.659040709468165,31611148,-0.12042981698270205,-1.362768536050602,-1.2423387190679
2024-08-08T13:30:00-04:00,17.64,17.865,17.49,17.72,15.173927807304006,NaN,NaN,NaN,NaN,NaN,21.313599999999994,25.875075655969333,16.752124344030655,16.77915503432838,17.534555948308956,17.629923797315293,17.43918809930262,1302623,1138002.5333333334,33.780891008423126,27.383991324276955,NaN,NaN,NaN,NaN,0.8686515327617258,38.62624985742439,32913771,-0.037784771742237266,-1.2895696837456967,-1.2517849120034594
2024-08-09T09:30:00-04:00,17.81,18.275,17.56,17.96,15.43022654333564,NaN,NaN,NaN,NaN,NaN,21.222599999999993,25.865783924851645,16.57941607514834,16.21823506194185,17.931666666666665,17.931666666666665,17.931666666666665,1323696,1156358,36.75546622955044,27.419636354576195,NaN,NaN,NaN,NaN,0.8576764232787454,38.02245164208733,34237467,0.04272480509927257,-1.1983789056293688,-1.2411037107286413
2024-08-09T13:30:00-04:00,17.97,18.065,17.71,17.9,15.46487533682039,NaN,NaN,NaN,NaN,NaN,21.127199999999995,25.842953242060126,16.411446757939864,16.242088049553484,17.916745228050548,17.936089690157964,17.897400765943132,787583,1165977.0666666667,36.31626105878553,27.554812087120332,NaN,NaN,NaN,NaN,0.8217709644731207,37.46178187070291,33449884,0.09843278904695607,-1.1180627244199464,-1.2164955134669024
2024-08-12T09:30:00-04:00,18.36,18.78,18.105,18.34,16.009994639692188,NaN,NaN,NaN,NaN,NaN,21.051999999999992,25.82289928629823,16.281100713701754,16.881670439642786,18.408333333333335,18.408333333333335,18.408333333333335,1515457,1177240.7,41.80782688311897,28.304558714809776,NaN,NaN,NaN,NaN,0.8259301812964693,35.963724798866345,34965341,0.1673597941555609,-1.0072957707724512,-1.1746555649280122
2024-08-12T13:30:00-04:00,18.34,18.61,18.29,18.57,16.08442670152436,NaN,NaN,NaN,NaN,NaN,20.98199999999999,25.793631739857236,16.17036826014274,16.931336351714226,18.428480451075245,18.463686155096056,18.393274747054434,496299,1167478.2,44.50187763714225,29.135569730331564,NaN,NaN,NaN,NaN,0.7897923112038644,34.57267180358953,35461640,0.22717580190257158,-0.8906858125497976,-1.1178616144523692
2024-08-13T09:30:00-04:00,18.77,18.84,18.47,18.62,16.346498215091437,NaN,NaN,NaN,NaN,NaN,20.900599999999994,25.731566627912173,16.069633372087814,17.31206908137138,18.643333333333334,18.643333333333334,18.643333333333334,670058,1159930.8,45.09694286984683,30.819385625373826,NaN,NaN,NaN,NaN,0.7598071461178743,32.966975058102946,36131698,0.26614059995266337,-0.7851858645115399,-1.0513264644642033
2024-08-13T13:30:00-04:00,18.62,18.635,18.365,18.4,16.346498215091437,NaN,NaN,NaN,NaN,NaN,20.81649999999999,25.67219655147451,15.960803448525471,17.31206908137138,18.56941744685111,18.65656625639075,18.482268637311467,482020,1163463.6666666667,42.91648456295838,32.39860562155827,NaN,NaN,NaN,NaN,0.7248209213951692,31.590347605465386,35649678,0.27215630712695693,-0.7111310805555071,-0.983287387682464
2024-08-14T09:30:00-04:00,18.74,19.055,18.58,18.69,16.589629572015127,NaN,NaN,NaN,NaN,NaN,20.74499999999999,25.618525212820956,15.871474787179025,17.641624212077684,18.775000000000002,18.775000000000002,18.775000000000002,1017809,1165067.0333333334,46.582894620986984,34.5326072554766,NaN,NaN,NaN,NaN,0.7198337127240857,29.72118370834113,36667487,0.28913151843120866,-0.6218729896434532,-0.9110045080746618
2024-08-14T13:30:00-04:00,18.68,18.745,18.6,18.64,16.589629572015127,NaN,NaN,NaN,NaN,NaN,20.671799999999994,25.559627230989324,15.783972769010663,17.641624212077684,18.745861536560064,18.79539242730791,18.696330645812218,352247,1155003.0666666667,46.033904128351324,36.644702705711495,NaN,NaN,NaN,NaN,0.6787741618152224,27.98553151815432,36315240,0.28972907106266077,-0.5488431692463358,-0.8385722403089966
2024-08-15T09:30:00-04:00,19.34,20.06,19.135,19.77,17.355049878633622,NaN,NaN,NaN,NaN,NaN,20.62149999999999,25.493624895772,15.749375104227981,18.387439495729716,19.655,19.65500023841858,19.654999761581422,1551906,1183164.5666666667,58.06291062418887,38.86184581552153,NaN,NaN,NaN,NaN,0.7317188645427064,27.17294859091685,37867146,0.35467459197535456,-0.39522900033980335,-0.7499035923151579
2024-08-15T13:30:00-04:00,19.77,19.925,19.485,19.565,17.504479429604817,NaN,NaN,NaN,NaN,NaN,20.572399999999995,25.436635701526072,15.708164298473918,18.387439495729716,19.656142009890075,19.657723943213966,19.654560076566185,808777,1199616.8666666667,55.63990062994121,40.93241821465493,NaN,NaN,NaN,NaN,0.710881802789656,26.418407301339204,37058369,0.3705426649208088,-0.28672526116414687,-0.6572679260849557
2024-08-16T09:30:00-04:00,19.52,19.925,19.4,19.82,17.504479429604817,NaN,NaN,NaN,NaN,NaN,20.523199999999996,25.367074796069844,15.679325203930148,18.41606127726702,19.715,19.715,19.715,900219,1208554.7666666666,57.988431646649914,43.19391411579852,NaN,NaN,NaN,NaN,0.6976045311618236,25.589284077094277,37958588,0.3833296973337129,-0.17810580441781454,-0.5614355017515275
2024-08-16T13:30:00-04:00,19.83,20.04,19.755,19.97,17.78527981085894,NaN,NaN,NaN,NaN,NaN,20.477199999999996,25.29747350261378,15.656926497386213,18.690349021813613,19.792653935653103,19.89274562518107,19.692562246125135,541850,1211080.6,59.351701779355345,45.55442835120141,NaN,NaN,NaN,NaN,0.6681327789359791,24.953133013432392,38500438,0.3859407352411286,-0.07900958270011671,-0.4649503179412453
2024-08-19T09:30:00-04:00,19.9,20.18,19.81,19.88,17.928335274001707,NaN,NaN,NaN,NaN,NaN,20.402199999999997,25.139905841438505,15.664494158561489,18.91527921745089,19.956666666666663,19.956666666666663,19.956666666666663,706549,1214467.2666666666,58.13279590514235,47.35487782746004,NaN,NaN,NaN,NaN,0.6468375804405521,24.529113456512196,37793889,0.3658409056930029,-0.007649185824991633,-0.37349009151799456
2024-08-19T13:30:00-04:00,19.875,20.31,19.855,20.3,18.04772912518345,NaN,NaN,NaN,NaN,NaN,20.329199999999997,24.957204477093864,15.70119552290613,19.07072337396071,20.038531404937157,20.13617704514382,19.940885764730492,496627,1220163.6,62.0497059991339,49.37407889822509,NaN,NaN,NaN,NaN,0.6331348961233696,24.292989549745155,38290516,0.3642731938055911,0.08185140073899433,-0.28242179306659676
2024-08-20T09:30:00-04:00,20.365,20.43,19.69,19.84,18.04772912518345,NaN,NaN,NaN,NaN,NaN,20.240399999999998,24.73009078668015,15.750709213319844,19.07072337396071,19.986666666666668,19.986666666666668,19.986666666666668,675463,1225325.0666666667,55.88313635733821,50.74034105020993,NaN,NaN,NaN,NaN,0.6407681178288431,23.76283466050395,37615053,0.31741343983567283,0.1143450067279943,-0.20306843310767853
2024-08-20T13:30:00-04:00,19.84,19.95,19.81,19.82,18.04772912518345,NaN,NaN,NaN,NaN,NaN,20.144399999999997,24.457186403243348,15.831613596756647,19.07072337396071,19.94239659493928,20.002792813098903,19.882000376779654,362913,1211641.4666666666,55.62429997673591,52.11948668720639,NaN,NaN,NaN,NaN,0.6049989665553543,23.270547977637122,37252140,0.27197829972053633,0.13690444154299186,-0.13507385817754444
2024-08-21T09:30:00-04:00,19.7,20.04,19.52,19.855,18.04772912518345,NaN,NaN,NaN,NaN,NaN,20.0627,24.23733780943933,15.888062190560667,19.07072337396071,19.805000000000003,19.805000000000003,19.805000000000003,544911,1207174.6666666667,56.00830593638423,53.13380661958247,NaN,NaN,NaN,NaN,0.5989276118014004,22.244121323610173,37797051,0.23270794304241568,0.15581107062547517,-0.07689687241694051
2024-08-21T13:30:00-04:00,19.86,20.205,19.84,20.18,18.110600477660352,NaN,NaN,NaN,NaN,NaN,19.982499999999998,23.987522471847154,15.977477528152843,19.072652293974308,19.90079757248964,20.029980271320387,19.771614873658894,299658,1199095.0666666667,59.511947241360254,54.20595444845519,NaN,NaN,NaN,NaN,0.5822184966727288,21.552013643340413,38096709,0.21733690421212548,0.19477425784821634,-0.022562646363909138
2024-08-22T09:30:00-04:00,20.13,20.36,19.89,20.195,18.235914092312154,NaN,NaN,NaN,NaN,NaN,19.916399999999996,23.79409469659499,16.038705303405003,19.219121835179447,20.148333333333333,20.148333333333333,20.148333333333333,522067,1190524.4,59.67159124803275,55.247000761182754,NaN,NaN,NaN,NaN,0.5742028897675339,21.152912467561567,38618776,0.19747243950613463,0.22427790301875916,0.026805463512624528
2024-08-22T13:30:00-04:00,20.19,20.205,19.85,19.91,18.235914092312154,NaN,NaN,NaN,NaN,NaN,19.857799999999994,23.64448570652505,16.07111429347494,19.219121835179447,20.081343977186812,20.1602789070125,20.002409047361123,376010,1177501.2333333334,55.21672511403978,56.125589371974286,NaN,NaN,NaN,NaN,0.5585455404984241,20.69351209302111,38242766,0.15623753179823913,0.22210237826042345,0.06586484646218432
2024-08-23T09:30:00-04:00,20.07,21.01,20,20.99,18.587537427086076,NaN,NaN,NaN,NaN,NaN,19.805999999999997,23.455989589026334,16.15601041097366,19.587837974514848,20.666666666666668,20.666666666666668,20.666666666666668,905613,1116895.6,65.67465136506453,57.48928628226561,NaN,NaN,NaN,NaN,0.597220859034251,21.41545329667823,39148379,0.19052466060307363,0.30402067221602636,0.11349601161295272
2024-08-23T13:30:00-04:00,20.99,21.205,20.99,21.11,19.237876634945792,NaN,NaN,NaN,NaN,NaN,19.760199999999994,23.283936630340207,16.23646336965978,19.959770379611875,20.859493786792367,21.075589827937858,20.643397745646876,721083,1092725.4333333333,66.60772915882245,58.95884521301355,NaN,NaN,NaN,NaN,0.5699193691032332,22.31755231417185,39869462,0.20865094933471023,0.37430969828134053,0.1656587489466303
2024-08-26T09:30:00-04:00,21.07,21.155,20.79,20.945,19.237876634945792,NaN,NaN,NaN,NaN,NaN,19.711899999999996,23.100558076584434,16.32324192341556,19.9763163036895,20.963333333333335,20.963333333333335,20.963333333333335,491844,947910.7,64.030362312889,59.385091762206415,NaN,NaN,NaN,NaN,0.5552822713101452,22.683830849919076,39377618,0.19703413468107223,0.4119514172979706,0.21491728261689835
2024-08-26T13:30:00-04:00,20.94,21.025,20.79,20.96,19.237876634945792,NaN,NaN,NaN,NaN,NaN,19.662699999999994,22.902752598338687,16.4226474016613,19.9763163036895,20.95073274226613,20.96873962323408,20.93272586129818,240842,915701.0333333333,64.16611159610495,59.99410683121811,NaN,NaN,NaN,NaN,0.5324049662165634,23.023946633112928,39618460,0.17842199050356006,0.4379447707463484,0.25952278024278835
2024-08-27T09:30:00-04:00,20.75,21.115,20.59,21.055,19.237876634945792,NaN,NaN,NaN,NaN,NaN,19.623399999999997,22.74511839857485,16.501681601425144,20.00414243436128,20.919999999999998,20.919999999999998,20.919999999999998,515882,880258.7,65.06535012485718,60.499601008232915,NaN,NaN,NaN,NaN,0.5318760400582374,22.84806429977223,40134342,0.1610997419534313,0.46089745768457746,0.29979771573114616
2024-08-27T13:30:00-04:00,21.06,21.535,21.03,21.35,19.528939208988856,NaN,NaN,NaN,NaN,NaN,19.593199999999996,22.616761317387336,16.569638682612656,20.393813947489026,21.091225849921322,21.282546681349405,20.89990501849324,413204,860968.1333333333,67.77007651276595,61.100913489190816,NaN,NaN,NaN,NaN,0.5299563229112204,23.30242157241733,40547546,0.1578903897502663,0.49716070291897907,0.33927031316871276
2024-08-28T09:30:00-04:00,21.14,21.19,20.15,20.235,19.528939208988856,NaN,NaN,NaN,NaN,NaN,19.5565,22.502467582985332,16.610532417014667,20.393813947489026,20.525000000000002,20.525000000000002,20.525000000000002,609712,826206.9,51.530666768204505,60.6293328365524,NaN,NaN,NaN,NaN,0.5778165855604191,21.904399574546204,39937834,0.07335219699174506,0.43096055940839406,0.357608362416649
2024-08-28T13:30:00-04:00,20.235,20.37,20,20.3,19.528939208988856,NaN,NaN,NaN,NaN,NaN,19.534499999999998,22.441239238390803,16.627760761609192,20.393813947489026,20.393037342060435,20.5426855697634,20.24338911435747,474115,788077.9333333333,52.24901947147997,59.92928379886283,NaN,NaN,NaN,NaN,0.562972543734675,20.34740545460079,40411949,0.017407953142014487,0.3793683038441671,0.3619603507021526
2024-08-29T09:30:00-04:00,20.39,20.65,20.33,20.52,19.528939208988856,NaN,NaN,NaN,NaN,NaN,19.513299999999997,22.3751711431511,16.651428856848895,20.393813947489026,20.5,20.5,20.5,495699,686757.8666666667,54.69637811291413,59.844515352832545,NaN,NaN,NaN,NaN,0.5477602191821981,19.369818189670283,40907648,-0.007829406137191408,0.3521735930306633,0.3600029991678547
2024-08-29T13:30:00-04:00,20.51,20.54,20.095,20.17,19.528939208988856,NaN,NaN,NaN,NaN,NaN,19.493099999999995,22.321693919247,16.66450608075299,20.393813947489026,20.400273697776043,20.514981695142993,20.285565700409094,374671,655826.1333333333,50.281174063310154,59.46286350187355,NaN,NaN,NaN,NaN,0.5404202035263268,18.035512035752053,40532977,-0.04885552455838316,0.2989335934698758,0.34778911802825896
2024-08-30T09:30:00-04:00,20.38,20.4,19.835,20.025,19.528939208988856,NaN,NaN,NaN,NaN,NaN,19.463799999999996,22.23889175343833,16.68870824656166,20.393813947489026,20.086666666666666,20.086666666666666,20.086666666666666,618336,632314.1333333333,48.53327461101662,58.92893269291873,NaN,NaN,NaN,NaN,0.5421759032744461,17.14777730353392,39914641,-0.08443310170504442,0.24224774089695345,0.32668084260199787
2024-08-30T13:30:00-04:00,20.03,20.19,19.995,20.12,19.528939208988856,NaN,NaN,NaN,NaN,NaN,19.442299999999996,22.1798114319398,16.70478856806019,20.393813947489026,20.093439299590184,20.10090394540977,20.0859746537706,509004,623028.1666666666,49.76539824054515,58.23275062143194,NaN,NaN,NaN,NaN,0.5173776244691285,16.32345219504566,40423645,-0.09922192391934409,0.20265343770281774,0.30187536162216183
2024-09-03T09:30:00-04:00,19.755,19.96,19.41,19.61,NaN,NaN,NaN,21.399753084420688,21.399753084420688,21.399753084420688,19.411299999999994,22.10505857121635,16.717541428783637,20.393813947489026,19.66,19.66,19.66,867126,601417.1333333333,43.714932379655025,57.09298927369067,NaN,NaN,NaN,NaN,0.5311363655784765,16.503908851965534,39556519,-0.13858904256384752,0.12863905841735246,0.2672281009812
2024-09-03T13:30:00-04:00,19.6,19.6,19.22,19.37,NaN,NaN,NaN,21.09999158058338,NaN,NaN,19.375299999999992,22.021777968924276,16.72882203107571,20.393813947489026,19.56086047507729,19.688446117534266,19.433274832620317,523567,602326.0666666667,41.177760973213275,56.090206120774496,NaN,NaN,NaN,NaN,0.5210551966085853,16.942603734558524,39032952,-0.1737510301471988,0.05003931329720146,0.22379034344440027
2024-09-04T09:30:00-04:00,19.03,19.605,18.815,19.45,NaN,NaN,NaN,20.930901054193228,NaN,NaN,19.35149999999999,21.973344579680912,16.72965542031907,20.393813947489026,19.290000000000003,19.290000238418582,19.289999761581424,776971,605889.8333333334,42.378281614714446,54.42617971003521,NaN,NaN,NaN,NaN,0.5402655397079721,17.885712544964925,39809923,-0.18361640739121945,-0.0057301657946240425,0.1778862415965954
2024-09-04T13:30:00-04:00,19.45,19.475,19.03,19.1,NaN,NaN,NaN,20.930901054193228,NaN,NaN,19.32549999999999,21.9309705908918,16.720029409108182,19.677051157991222,19.256818905169595,19.299597540677258,19.214040269661933,467447,605404.0666666667,38.66069982594202,52.429963329115175,NaN,NaN,NaN,NaN,0.5334608583002598,18.761456440342297,39342476,-0.2041322964818017,-0.0772791290056567,0.126853167476145
2024-09-05T09:30:00-04:00,19,19.25,18.84,18.92,NaN,NaN,NaN,20.726843729130607,NaN,NaN,19.28809999999999,21.861901771699277,16.714298228300702,19.35871274111438,19.003333333333334,19.003333333333334,19.003333333333334,596186,591349.9666666667,36.86938379429716,50.48989343493004,NaN,NaN,NaN,NaN,0.524642225564527,19.824686022326237,38746290,-0.21893398161167812,-0.14681430953845265,0.07211967207322548
2024-09-05T13:30:00-04:00,18.925,19.68,18.92,19.68,NaN,NaN,NaN,20.726843729130607,NaN,NaN,19.27049999999999,21.821202844316005,16.719797155683978,19.35871274111438,19.2470959347835,19.456315027478762,19.037876842088234,809307,606585.3,47.855345195133225,49.32483869200349,NaN,NaN,NaN,NaN,0.5414534951670606,19.77293833059595,39555597,-0.168890586789889,-0.13899356141413577,0.029897025375753228
2024-09-06T09:30:00-04:00,19.79,20.235,18.71,18.9,NaN,NaN,NaN,20.726843729130607,NaN,NaN,19.24569999999999,21.786196809681545,16.705203190318432,19.284470192891504,19.281666666666666,19.281666666666666,19.281666666666666,962231,586929.4666666667,40.13574120594219,47.54415234065242,NaN,NaN,NaN,NaN,0.611706816940842,18.60697336813528,38593366,-0.1787211760305582,-0.19350444466244454,-0.01478326863188633
2024-09-06T13:30:00-04:00,18.89,19.03,18.81,18.95,NaN,NaN,NaN,20.705699171250803,NaN,NaN,19.21989999999999,21.745640675525117,16.69415932447486,19.113076154313205,19.158376822969746,19.326175937413197,18.990577708526295,519463,577285.6666666666,40.795040697066945,45.61736406810248,NaN,NaN,NaN,NaN,0.5837277585879248,17.524291617278944,39112829,-0.17218828011706483,-0.2300186187782174,-0.057830338661152544
2024-09-09T09:30:00-04:00,19.15,19.83,19.04,19.75,NaN,NaN,NaN,20.705699171250803,NaN,NaN,19.253299999999985,21.761971847811648,16.744628152188323,19.062960923450564,19.54,19.54,19.54,780044,573279.8333333334,50.23817372234375,45.52504313625529,NaN,NaN,NaN,NaN,0.6048900615459301,17.35706529165417,39892873,-0.10748583413746854,-0.19218763133298822,-0.08470179719551968
2024-09-09T13:30:00-04:00,19.74,19.825,19.49,19.66,NaN,NaN,NaN,20.705699171250803,NaN,NaN,19.288899999999988,21.768964749155213,16.808835250844762,18.703368738760453,19.584023333472874,19.64121925906351,19.526827407882237,462120,570622.1666666666,49.285779275982414,45.31338312229118,NaN,NaN,NaN,NaN,0.585612200006935,17.20178370357402,39430753,-0.06626838908143892,-0.16753728354731834,-0.10126889446587942
2024-09-10T09:30:00-04:00,19.66,19.68,18.83,19.32,NaN,NaN,NaN,20.705699171250803,NaN,NaN,19.34509999999999,21.694649309974555,16.99555069002543,18.39969499100836,19.276666666666667,19.276666666666667,19.276666666666667,680257,569745.7666666667,45.75671974372438,44.674836095920476,NaN,NaN,NaN,NaN,0.6044970428635826,16.097997098683674,38750496,-0.0577349510936435,-0.1734375833329338,-0.1157026322392903
2024-09-10T13:30:00-04:00,19.32,19.73,19.31,19.7,NaN,NaN,NaN,20.705699171250803,NaN,NaN,19.41079999999999,21.607696319811616,17.213903680188366,18.36827205465362,19.400504962374793,19.549596744668875,19.25141318008071,469327,568835.7666666667,50.06068996312927,44.65908723162185,NaN,NaN,NaN,NaN,0.5913186826590412,14.986923061043964,39219823,-0.024054244881097503,-0.14577043834066217,-0.12171619345956466
2024-09-11T09:30:00-04:00,19.59,20.49,19.54,20.485,NaN,NaN,NaN,20.705699171250803,NaN,NaN,19.474599999999995,21.60632591108735,17.34287408891264,18.783619669495117,20.171666666666667,20.171666666666667,20.171666666666667,1027292,580563.4,57.55337124497697,45.30337984833329,NaN,NaN,NaN,NaN,0.6169387767548239,15.044458889674765,40247115,0.049523661932700705,-0.05981161604368879,-0.10933527797638949
2024-09-11T13:30:00-04:00,20.49,20.795,20.48,20.635,18.834080846804248,18.834080846804248,18.834080846804248,NaN,NaN,NaN,19.543199999999995,21.597723555474925,17.488676444525066,19.272395735596096,20.32893431201455,20.548926000069976,20.108942623959123,525001,585966.3333333334,58.82464295015772,45.95046875616276,NaN,NaN,NaN,NaN,0.5953717212723365,15.492523565111348,40772116,0.10361419472186904,0.020182465425946816,-0.08343172929592223
2024-09-12T09:30:00-04:00,20.775,21.7,20.67,21.61,19.31832717194951,NaN,NaN,NaN,NaN,NaN,19.63279999999999,21.648936066837294,17.616663933162684,19.949416588476875,21.32666666666667,21.32666666666667,21.32666666666667,988521,600753.3333333334,65.96091089098978,47.5394672212581,NaN,NaN,NaN,NaN,0.6289165983243122,16.882671966005088,41760637,0.19506831883720244,0.1604036692505808,-0.03466464958662162
2024-09-12T13:30:00-04:00,21.61,21.73,21.435,21.65,19.76044866413362,NaN,NaN,NaN,NaN,NaN,19.72329999999999,21.686574417905387,17.760025582094595,20.1820332707815,21.435862912317933,21.571764107953555,21.29996171668231,638197,612037.9666666667,66.21957663726195,49.32816834011872,NaN,NaN,NaN,NaN,0.6050654127297186,18.202094334987578,42398834,0.2450329260094133,0.271626507925145,0.026593581915731704
2024-09-13T09:30:00-04:00,21.72,22.425,21.61,22.405,20.167132815763907,NaN,NaN,NaN,NaN,NaN,19.818399999999993,21.830788073906568,17.80601192609342,20.7791266166252,22.146666666666665,22.146666666666665,22.146666666666665,961261,626677.7666666667,70.7393495147114,51.353958904404216,NaN,NaN,NaN,NaN,0.6200607403918816,20.041454790311644,43360095,0.31144463050280957,0.4158993700442437,0.10445473954143411
2024-09-13T13:30:00-04:00,22.41,22.42,21.99,22.06,20.380104051411003,NaN,NaN,NaN,NaN,NaN,19.90519999999999,21.922447590158875,17.887952409841105,20.88830129330016,22.149739558111378,22.15435326081755,22.145125855405205,426419,628358.0666666667,66.3694016790754,53.333151893913744,NaN,NaN,NaN,NaN,0.6064849732210332,21.749432355969706,42933676,0.31377437016310294,0.4966727022453128,0.18289833208220985
2024-09-16T09:30:00-04:00,21.63,22.44,21.51,22.39,20.380104051411003,NaN,NaN,NaN,NaN,NaN,19.993799999999993,22.0502829782911,17.937317021708886,20.88830129330016,22.113333333333333,22.113333333333333,22.113333333333333,528530,615788.6333333333,68.38144243098262,55.58401322510556,NaN,NaN,NaN,NaN,0.6295931894195308,22.345401751834665,43462206,0.31817841475455894,0.5806213505254085,0.2624429357708496
2024-09-16T13:30:00-04:00,22.39,22.535,22.18,22.21,20.52527042700879,NaN,NaN,NaN,NaN,NaN,20.079999999999988,22.139515476999883,18.020484523000093,21.0052128277121,22.19671813873869,22.29319099130106,22.100245286176317,394851,604914.2333333333,66.05986533025235,56.88433609189978,NaN,NaN,NaN,NaN,0.6099793901752787,22.999213481123206,43067355,0.2903795246809691,0.625417341622061,0.33503781694109186
2024-09-17T09:30:00-04:00,22.53,22.92,22.4,22.73,20.814235407599295,NaN,NaN,NaN,NaN,NaN,20.16779999999999,22.296264385420216,18.039335614579763,21.341170262169683,22.683333333333334,22.683333333333334,22.683333333333334,578692,607809.1666666666,69.30226609366787,58.967659298165906,NaN,NaN,NaN,NaN,0.617123719448473,24.001098734357246,43646047,0.2878642537848695,0.6948681341721787,0.4070038803873092
2024-09-17T13:30:00-04:00,22.73,22.83,22.475,22.63,20.842224707253873,NaN,NaN,NaN,NaN,NaN,20.248999999999988,22.43640576939946,18.061594230600516,21.389436209735745,22.669698487277692,22.688049511007875,22.65134746354751,319468,610430.0333333333,67.9577273589714,60.90785120258765,NaN,NaN,NaN,NaN,0.5984005966307248,24.93142075521742,43326579,0.2611050677904999,0.7333852151254341,0.4722801473349342
2024-09-18T09:30:00-04:00,22.71,23.1,22.34,22.96,20.888373584196877,NaN,NaN,NaN,NaN,NaN,20.335799999999985,22.600811576129967,18.070788423870003,21.567548967788596,22.8,22.8,22.8,663071,615336.3333333334,70.02449215519997,62.321159662077385,NaN,NaN,NaN,NaN,0.6099434111571017,26.072293687732078,43989650,0.2473995104184843,0.7815295353580396,0.5341300249395553
2024-09-18T13:30:00-04:00,22.96,23.49,22.74,22.94,21.26435660309702,NaN,NaN,NaN,NaN,NaN,20.426599999999986,22.73745736470308,18.115742635296893,21.889039174230874,22.96436534472844,23.08753652073675,22.841194168720126,1180762,640921.6,69.7309341240283,63.78152786550923,NaN,NaN,NaN,NaN,0.6199474532173088,27.500685109257123,42808888,0.21969412667674404,0.8087476832854854,0.5890535566087414
2024-09-19T09:30:00-04:00,23.93,24.05,23.06,23.13,21.637113121138064,NaN,NaN,NaN,NaN,NaN,20.515399999999985,22.89277825345539,18.13802174654458,22.214231339384703,23.41333333333333,23.41333333333333,23.41333333333333,1184261,660073.2333333333,70.9757724679694,65.58288877438387,NaN,NaN,NaN,NaN,0.6549512065589296,29.285773447751325,43993149,0.1975672670323474,0.8360126403991757,0.6384453733668283
2024-09-19T13:30:00-04:00,23.13,23.15,22.74,22.795,21.637113121138064,NaN,NaN,NaN,NaN,NaN,20.598499999999987,22.998221025453226,18.198778974546748,22.214231339384703,23.23084899299605,23.47841147387686,22.983286512115242,643471,665718.4333333333,65.83479922517797,66.7096108645302,NaN,NaN,NaN,NaN,0.6374546918047204,30.199651930892497,43349678,0.14614227549406833,0.8211232177344137,0.6749809422403453
2024-09-20T09:30:00-04:00,22.81,22.955,22.31,22.6,21.637113121138064,NaN,NaN,NaN,NaN,NaN,20.655099999999983,23.10691850062416,18.203281499375805,22.214231339384703,22.62166666666667,22.62166666666667,22.62166666666667,528935,666826.3,62.97536320132148,67.0968960042691,NaN,NaN,NaN,NaN,0.6379936423900975,30.13567906391627,42820743,0.08765095064312378,0.78454463054425,0.6968936799011263
2024-09-20T13:30:00-04:00,22.61,22.95,22.49,22.72,21.637113121138064,NaN,NaN,NaN,NaN,NaN,20.71819999999998,23.21650483328252,18.219895166717443,22.214231339384703,22.674224309525172,22.72327390066995,22.625174718380396,607300,674580.6,64.01127469421576,67.46736970027325,NaN,NaN,NaN,NaN,0.6252798107908049,30.076275687438347,43428043,0.047699586726529075,0.7565181633092877,0.7088185765827586
2024-09-23T09:30:00-04:00,22.8,23.32,22.785,23.03,21.637113121138064,NaN,NaN,NaN,NaN,NaN,20.782399999999985,23.34912027303364,18.21567972696633,22.214231339384703,23.045,23.045,23.045,621982,674702.1333333333,66.61029436189764,67.51375423390952,NaN,NaN,NaN,NaN,0.6234741100200332,30.436940925382576,44050025,0.033479666776434214,0.7506681600533014,0.7171884932768672
2024-09-23T13:30:00-04:00,23.03,23.1,22.62,22.68,21.637113121138064,NaN,NaN,NaN,NaN,NaN,20.836599999999986,23.44649918579283,18.226700814207142,22.214231339384703,22.942967599390176,23.06374560804707,22.82218959073328,443893,672531.7666666667,61.23350236737817,67.15760607177498,NaN,NaN,NaN,NaN,0.6132259593043166,30.404666114353336,43606132,-0.006062815947764921,0.709609973342161,0.715672789289926
2024-09-24T09:30:00-04:00,22.68,22.75,22.26,22.68,21.637113121138064,NaN,NaN,NaN,NaN,NaN,20.892599999999984,23.537911505286708,18.24728849471326,22.214231339384703,22.563333333333333,22.563333333333333,22.563333333333333,323689,654417.2,61.23350236737817,66.4786169898226,NaN,NaN,NaN,NaN,0.6044241050682938,29.612873343964186,43606132,-0.037054107433840855,0.6693551549976249,0.7064092624314657
2024-09-24T13:30:00-04:00,22.67,22.84,22.6,22.77,21.637113121138064,NaN,NaN,NaN,NaN,NaN,20.941999999999986,23.633057041387644,18.250942958612328,22.214231339384703,22.64028382037746,22.726404125559828,22.55416351519509,258428,645579.2333333333,62.144781595314385,66.17685841241111,NaN,NaN,NaN,NaN,0.5783938118491297,29.002193038708153,43864560,-0.055233019655877014,0.6373679878616194,0.6926010075174964
2024-09-25T09:30:00-04:00,22.595,22.81,22.44,22.56,21.637113121138064,NaN,NaN,NaN,NaN,NaN,20.996399999999984,23.706055358159503,18.286744641840464,22.214231339384703,22.603333333333335,22.603333333333335,22.603333333333335,232154,627418.6666666666,58.67871450915706,65.48380641799498,NaN,NaN,NaN,NaN,0.5635085395741918,28.091526030094133,43632406,-0.08344782407535034,0.5882912274233085,0.6717390514986589
2024-09-25T13:30:00-04:00,22.55,22.6,22.33,22.4,21.637113121138064,NaN,NaN,NaN,NaN,NaN,21.047999999999984,23.764335030883025,18.331664969116943,22.214231339384703,22.529489206346998,22.60925201238731,22.449726400306687,198979,618469.7333333333,56.1108929000853,64.77316553012591,NaN,NaN,NaN,NaN,0.5425436438903212,27.00859580169458,43433427,-0.11309278696450675,0.5303730677930254,0.6434658547575322
2024-09-26T09:30:00-04:00,22.76,22.87,22.19,22.46,21.637113121138064,NaN,NaN,NaN,NaN,NaN,21.100099999999983,23.82282987275683,18.377370127243136,21.772709156611974,22.50666666666667,22.50666666666667,22.50666666666667,832313,626340.6333333333,56.87305768236239,63.88536492931838,NaN,NaN,NaN,NaN,0.5523619550410125,26.43984301108419,44265740,-0.12778246015736194,0.48373777956082975,0.6115202397181917
2024-09-26T13:30:00-04:00,22.485,22.52,22.345,22.4,21.637113121138064,NaN,NaN,NaN,NaN,NaN,21.144499999999983,23.878146831615684,18.410853168384282,21.772709156611974,22.48319224818741,22.521195896009683,22.44518860036514,317560,609949.0666666667,55.82897127791435,63.019025209242876,NaN,NaN,NaN,NaN,0.5254075296809402,25.911715419803116,43948180,-0.13969526814206223,0.43690115454061385,0.5765964226826761
2024-09-27T09:30:00-04:00,22.535,23.78,22.415,23.78,21.637113121138064,NaN,NaN,NaN,NaN,NaN,21.216199999999986,24.0332563075668,18.399143692433174,22.24403314505657,23.325,23.325,23.325,1083393,613987.8,69.63602483774675,62.9912775437105,NaN,NaN,NaN,NaN,0.5864498489894446,27.01400431355177,45031573,-0.057027272060596546,0.5053123326069304,0.562339604667527
2024-09-27T13:30:00-04:00,23.775,23.98,23.52,23.895,21.991083821655906,NaN,NaN,NaN,NaN,NaN,21.295899999999982,24.185187586932557,18.406612413067407,22.521226516045253,23.531726340596833,23.766491516859823,23.296961164333844,840060,624674.3666666667,70.46455894943765,63.04367931695403,NaN,NaN,NaN,NaN,0.5774177169187701,28.2259540951111,45871633,-0.000010821322986909188,0.5623260780137933,0.5623368993367802
2024-09-30T09:30:00-04:00,23.965,24.14,23.09,23.47,21.991083821655906,NaN,NaN,NaN,NaN,NaN,21.345499999999983,24.296566417416287,18.39443358258368,22.521226516045253,23.566666666666666,23.566666666666666,23.566666666666666,633836,619800.7666666667,63.561785392698816,62.51410881157756,NaN,NaN,NaN,NaN,0.6111735942817151,28.38155781702897,45237797,0.003477327385673634,0.5666835585688723,0.5632062311831987
2024-09-30T13:30:00-04:00,23.47,23.62,23.18,23.43,21.991083821655906,NaN,NaN,NaN,NaN,NaN,21.391899999999982,24.39911724522895,18.384682754771013,22.521226516045253,23.512465624134734,23.586989067773075,23.437942180496393,335279,615572.7333333333,62.93688061182017,62.30711462490915,NaN,NaN,NaN,NaN,0.5989469089758784,28.526046987381275,44902518,-0.002206006083776524,0.5604487235784781,0.5626547296622546
2024-10-01T09:30:00-04:00,23.4,23.45,22.285,22.295,21.991083821655906,NaN,NaN,NaN,NaN,NaN,21.41889999999998,24.433814453181554,18.403985546818404,22.521226516045253,22.676666666666666,22.676666666666666,22.676666666666666,681570,615616.5,48.397105181929554,61.265810480666865,NaN,NaN,NaN,NaN,0.6393792726204585,26.93311693292243,44220948,-0.08321523111584828,0.45863569076744426,0.5418509218832925
2024-10-01T13:30:00-04:00,22.29,22.545,22.29,22.325,21.991083821655906,NaN,NaN,NaN,NaN,NaN,21.446199999999987,24.468709262186284,18.42369073781369,22.521226516045253,22.56108338127863,22.703068087854167,22.41909867470309,451666,615027.8,48.734229476505604,60.17459296511614,NaN,NaN,NaN,NaN,0.611923610290426,25.453967596639217,44672614,-0.1326533855447657,0.3760341899523354,0.5086875754971011
2024-10-02T09:30:00-04:00,22.27,23.18,22.27,22.76,21.991083821655906,NaN,NaN,NaN,NaN,NaN,21.480299999999986,24.522791354137688,18.437808645862283,22.521226516045253,22.736666666666665,22.736667003841454,22.736666329491875,800644,607472.8666666667,53.480016286626515,59.23671595973963,NaN,NaN,NaN,NaN,0.633214780983967,24.967145943655414,45473258,-0.13356327706023474,0.34173347917180763,0.47529675623204237
2024-10-02T13:30:00-04:00,22.76,22.8,22.565,22.61,21.991083821655906,NaN,NaN,NaN,NaN,NaN,21.505499999999984,24.564086765158486,18.44691323484148,22.521226516045253,22.71513876246261,22.750108775852848,22.680168749072376,303425,600087,51.70263699732791,58.555939861878905,NaN,NaN,NaN,NaN,0.6047708680565407,24.51509726588474,45169833,-0.1410378111213091,0.298999492330406,0.4400373034517151
2024-10-03T09:30:00-04:00,22.42,22.7,22.06,22.34,21.991083821655906,NaN,NaN,NaN,NaN,NaN,21.547599999999985,24.592996683521317,18.502203316478653,22.521226516045253,22.366666666666664,22.366666666666664,22.366666666666664,556252,585678.0333333333,48.57336059925364,57.65164402129857,NaN,NaN,NaN,NaN,0.6072872346239306,23.1732747001686,44613581,-0.15957177448270377,0.24057258534833537,0.40014435983103913
2024-10-03T13:30:00-04:00,22.33,22.5,22.27,22.41,21.991083821655906,NaN,NaN,NaN,NaN,NaN,21.589799999999986,24.6233286120296,18.556271387970373,22.521226516045253,22.374659082850005,22.38687597205261,22.3624421936474,238071,572340.5,49.427956281856275,56.743299356051565,NaN,NaN,NaN,NaN,0.5803381464365069,21.927296603432186,44851652,-0.16200429083736223,0.19763899628433634,0.3596432871216986
2024-10-04T09:30:00-04:00,23.1,23.39,22.61,22.81,21.991083821655906,NaN,NaN,NaN,NaN,NaN,21.635599999999986,24.67228545621738,18.59891454378259,22.521226516045253,22.936666666666667,22.936666666666667,22.936666666666667,501636,557019.6666666666,54.11980929786468,56.417663269530685,NaN,NaN,NaN,NaN,0.6088854216910422,21.995400939771777,45353288,-0.13278814600945987,0.19365810460987376,0.32644625061933363
2024-10-04T13:30:00-04:00,22.8,22.975,22.7,22.89,21.991083821655906,NaN,NaN,NaN,NaN,NaN,21.689999999999987,24.71715443940376,18.662845560596214,22.447981212836204,22.90807554080333,22.947030507975008,22.869120573631655,270225,551813.2,55.01864660702518,56.339645677169244,NaN,NaN,NaN,NaN,0.5850364629988251,22.058640680658538,45623513,-0.10538579345467242,0.1947140088009931,0.3000998022556655
2024-10-07T09:30:00-04:00,22.95,23.24,22.74,23.22,21.991083821655906,NaN,NaN,NaN,NaN,NaN,21.753899999999984,24.772645626912354,18.735154373087614,22.046384970268964,23.066666666666663,23.066666666666663,23.066666666666663,492839,550623.5,58.6199180652742,56.4644214188058,NaN,NaN,NaN,NaN,0.5789624299274804,22.442986990381705,46116352,-0.0643621558637873,0.2196471074259314,0.2840092632897187
2024-10-07T13:30:00-04:00,23.215,23.425,23,23.32,21.991083821655906,NaN,NaN,NaN,NaN,NaN,21.817899999999987,24.831051897930433,18.804748102069542,22.126897659810275,23.148529726618555,23.238919043685097,23.058140409552013,404247,550936.7,59.67353853569164,56.73903336578989,NaN,NaN,NaN,NaN,0.567965113504089,23.020416178438566,46520599,-0.03148285587699928,0.2446556934434696,0.2761385493204689
2024-10-08T09:30:00-04:00,23.47,25.36,23.45,25.14,22.464999068706376,NaN,NaN,NaN,NaN,NaN,21.928499999999985,25.014448314538377,18.842551685461594,23.301518127848222,24.650000000000002,24.650000000000002,24.650000000000002,4471628,680701.2333333333,73.09875516096929,56.98637124602006,NaN,NaN,NaN,NaN,0.6731104625395111,25.164412181297813,50992227,0.10440628140905428,0.40664640108178673,0.30224011967273245
2024-10-08T13:30:00-04:00,25.14,25.8,25.065,25.62,23.480453656492447,NaN,NaN,NaN,NaN,NaN,22.053499999999982,25.220056015611128,18.886943984388836,23.78571450227858,24.875863602974132,25.249815976097548,24.501911229850716,1631269,724427.9333333333,75.42267103158339,57.34052210903047,NaN,NaN,NaN,NaN,0.6775311437866888,27.401857140626934,52623496,0.21198282340920044,0.567218648934233,0.3552358255250326
2024-10-09T09:30:00-04:00,25.495,25.505,24.17,25.07,23.480453656492447,NaN,NaN,NaN,NaN,NaN,22.165899999999983,25.353724769337656,18.97807523066231,23.78571450227858,24.915000000000003,24.915000000000003,24.915000000000003,1800011,762325.9333333333,68.15716786996242,57.66876371454931,NaN,NaN,NaN,NaN,0.7327074906590682,27.929198553643253,50823485,0.22995889363034733,0.6426844425629668,0.4127255489326194
2024-10-09T13:30:00-04:00,25.06,25.69,25.05,25.64,23.480453656492447,NaN,NaN,NaN,NaN,NaN,22.296699999999984,25.507208128007548,19.08619187199242,23.78571450227858,25.072670227630855,25.319794434008514,24.825546021253196,732730,747391.5333333333,71.24834239105833,58.26243955592346,NaN,NaN,NaN,NaN,0.7260855270405634,28.55838319191024,51556215,0.26178444932627154,0.7399561105904588,0.4781716612641873
2024-10-10T09:30:00-04:00,25.445,25.87,24.7,25.705,23.480453656492447,NaN,NaN,NaN,NaN,NaN,22.43239999999998,25.634095950586698,19.230704049413262,23.78571450227858,25.425,25.425,25.425,885154,737421.3,71.58707034453883,59.91886563896698,NaN,NaN,NaN,NaN,0.7577937036805232,28.580927642145117,52441369,0.2677976660483671,0.8129187438246461,0.545121077776279
2024-10-10T13:30:00-04:00,25.7,25.775,25.34,25.48,23.480453656492447,NaN,NaN,NaN,NaN,NaN,22.54839999999998,25.763054843059106,19.333745156940854,23.78571450227858,25.462820172256432,25.51384748139549,25.411792863117373,486251,732180.6333333333,68.5753806553905,61.33609072317305,NaN,NaN,NaN,NaN,0.7347370105604858,28.60186177450607,51955118,0.23819949845488153,0.842870450844881,0.6046709523899995
2024-10-11T09:30:00-04:00,25.745,26.65,25.7,26.21,24.026463423549536,NaN,NaN,NaN,NaN,NaN,22.694599999999976,25.89713452128211,19.492065478717844,24.395758928106645,26.186666666666667,26.186666666666667,26.186666666666667,1192271,754291.8333333334,72.60263819225439,62.701992287860755,NaN,NaN,NaN,NaN,0.7658272240918796,29.347367375186877,53147389,0.24823535403953856,0.9149651449394227,0.6667297908998842
2024-10-11T13:30:00-04:00,26.2,26.4,26.07,26.27,24.13912417702456,NaN,NaN,NaN,NaN,NaN,22.84099999999998,26.014548802209177,19.667451197790783,24.431607142485316,26.205795810242055,26.233756934692884,26.177834685791225,558029,752649.4666666667,72.90993811290033,64.21679951040164,NaN,NaN,NaN,NaN,0.7346967080853167,30.039622575819052,53705418,0.2392633380378827,0.9658089634472375,0.7265456254093549
2024-10-14T09:30:00-04:00,26.92,27.14,26.16,27.05,24.515754896250716,NaN,NaN,NaN,NaN,NaN,22.98699999999998,26.248757195133102,19.72524280486686,25.075285713988254,26.78333333333333,26.78333333333333,26.78333333333333,1150216,770257.2666666667,76.58654534634375,66.21774127805094,NaN,NaN,NaN,NaN,0.7522183717935084,31.21776197430369,54855634,0.2642512726772789,1.0568597162559534,0.7926084435786745
2024-10-14T13:30:00-04:00,27.04,27.06,26.625,27,24.74594785551205,NaN,NaN,NaN,NaN,NaN,23.13379999999998,26.443736289417593,19.823863710582366,25.1907285711906,26.818527896210373,26.87040662273028,26.766649169690467,529361,773106.2,75.87565960296672,68.10686294384453,NaN,NaN,NaN,NaN,0.7295599166654005,32.31174855861085,54326273,0.25564379456888353,1.112163186789779,0.8565193922208955
2024-10-15T09:30:00-04:00,27.125,27.33,25.905,26.57,24.74594785551205,NaN,NaN,NaN,NaN,NaN,23.27879999999998,26.542627544464235,20.014972455535723,25.1907285711906,26.60166666666667,26.60166666666667,26.60166666666667,1707904,819246.7,69.86922968027953,69.23182154258845,NaN,NaN,NaN,NaN,0.7792342083321575,32.05245670704029,52618369,0.2015972046571426,1.1085158980423238,0.9069186933851812
2024-10-15T13:30:00-04:00,26.57,26.835,26.55,26.805,24.74594785551205,NaN,NaN,NaN,NaN,NaN,23.42089999999998,26.667729647518264,20.174070352481692,25.1907285711906,26.625041520931585,26.674573219388613,26.575509822474558,380360,823311.1,71.2105467225234,70.38838583655262,NaN,NaN,NaN,NaN,0.7439317648798606,31.811685702010482,52998729,0.16388273695028366,1.1117721145730357,0.947889377622752
2024-10-16T09:30:00-04:00,27.055,27.17,26.565,26.97,24.74739158432542,NaN,NaN,NaN,NaN,NaN,23.550599999999978,26.835830975137675,20.26536902486228,25.340433028449592,26.901666666666667,26.901666666666667,26.901666666666667,642383,836985.4,72.14805999328875,71.35468168855365,NaN,NaN,NaN,NaN,0.7340080673884419,31.902345194409392,53641112,0.13354122337824392,1.114815906845557,0.9812746834673131
2024-10-16T13:30:00-04:00,26.97,27.045,26.79,26.935,24.858987421401537,NaN,NaN,NaN,NaN,NaN,23.676599999999976,26.988021712800133,20.365178287199818,25.45384642275967,26.910122764788646,26.920692053494378,26.899553476082914,411190,844059.1,71.61531582853496,72.2076657808996,NaN,NaN,NaN,NaN,0.6997932054321249,31.98652900877981,53229922,0.09634358667424214,1.1017041668101157,1.0053605801358736
2024-10-17T09:30:00-04:00,27.01,27.06,26.09,26.54,24.858987421401537,NaN,NaN,NaN,NaN,NaN,23.775199999999977,27.12794273394241,20.422457266057542,25.45384642275967,26.563333333333336,26.563333333333336,26.563333333333336,682325,839059.5,65.7175298392867,71.68043540077943,NaN,NaN,NaN,NaN,0.7190936907584016,30.828511259880713,52547597,0.03360468090181823,1.0473664312631463,1.013761750361328
2024-10-17T13:30:00-04:00,26.55,26.62,26.23,26.325,24.858987421401537,NaN,NaN,NaN,NaN,NaN,23.868699999999976,27.239859331743943,20.497540668256008,25.45384642275967,26.51303978021424,26.591169704912442,26.434909855516036,282736,837898.7,62.69120353296994,70.77104486516417,NaN,NaN,NaN,NaN,0.695586998561373,29.753209064474404,52264861,-0.030443532772493676,0.975707334395711,1.0061508671682047
2024-10-18T09:30:00-04:00,26.54,27.04,26.42,26.69,24.858987421401537,NaN,NaN,NaN,NaN,NaN,23.95439999999998,27.389617978528207,20.51918202147175,25.45384642275967,26.716666666666665,26.716667143503823,26.716666189829507,634723,822943.0333333333,65.58840325472144,70.58756167836127,NaN,NaN,NaN,NaN,0.696973641521275,29.25395619658599,52899584,-0.054871250095208546,0.937561804549194,0.9924330546444026
2024-10-18T13:30:00-04:00,26.695,26.93,26.48,26.83,24.858987421401537,NaN,NaN,NaN,NaN,NaN,24.049799999999976,27.533870010778216,20.565729989221737,25.45384642275967,26.730574209167603,26.745534374164144,26.715614044171062,548545,813225.8666666667,66.65790127028761,70.25967302687765,NaN,NaN,NaN,NaN,0.6793326671268981,28.790364247832468,53448129,-0.06741897825505816,0.9081593318255798,0.975578310080638
2024-10-21T09:30:00-04:00,26.72,27.1,26.18,26.91,24.858987421401537,NaN,NaN,NaN,NaN,NaN,24.14019999999997,27.681403162769012,20.59899683723093,25.45384642275967,26.73,26.73,26.73,884111,821568.3666666667,67.28363114275095,69.95228451246422,NaN,NaN,NaN,NaN,0.6965231909035483,27.795853876127595,54332240,-0.07553818505714305,0.8811555787592091,0.9566937638163522
2024-10-21T13:30:00-04:00,26.91,26.995,26.75,26.96,24.872493166283704,NaN,NaN,NaN,NaN,NaN,24.235199999999978,27.818783100753173,20.651616899246783,25.521551836647912,26.77195964734011,26.84573268298556,26.698186611694663,286006,819925.9333333333,67.69173647839862,69.88916707125053,NaN,NaN,NaN,NaN,0.6642715344104378,26.872379959544503,54618246,-0.08219842134096089,0.8539457371401511,0.936144158481112
2024-10-22T09:30:00-04:00,26.88,27.59,26.84,27.49,25.203629840543535,NaN,NaN,NaN,NaN,NaN,24.330399999999976,28.000830950175246,20.659969049824706,26.036241469318327,27.30666666666667,27.30666666666667,27.30666666666667,958269,829149.2333333333,71.71885745584045,69.82603987579238,NaN,NaN,NaN,NaN,0.6703949962382637,26.798607269557355,55576515,-0.056775237115620714,0.865175112086586,0.9219503492022068
2024-10-22T13:30:00-04:00,27.47,27.56,27.3,27.4,25.47460121142792,NaN,NaN,NaN,NaN,NaN,24.425799999999978,28.16186014940925,20.689739850590705,26.186993175454663,27.33833378200549,27.3891878235823,27.287479740428676,371581,826479.7333333333,70.1204874923387,69.62679340289512,NaN,NaN,NaN,NaN,0.6410810679355304,26.730104057426434,55204934,-0.0520130611183115,0.8569340228043174,0.9089470839226289
2024-10-23T09:30:00-04:00,27.13,27.38,26.32,26.58,25.47460121142792,NaN,NaN,NaN,NaN,NaN,24.49819999999998,28.258058912246995,20.738341087752964,26.186993175454663,26.76,26.76,26.76,581699,819181.5666666667,57.53827985094853,68.26620301036688,NaN,NaN,NaN,NaN,0.6724324202258496,24.890735675683896,54623235,-0.10691879224243528,0.7752985936195849,0.8822173858620201
2024-10-23T13:30:00-04:00,26.57,26.75,26.28,26.69,25.47460121142792,NaN,NaN,NaN,NaN,NaN,24.573199999999975,28.355278666554184,20.791121333445766,26.186993175454663,26.6988103712332,26.786433960339906,26.611186782126495,283669,818523.0333333333,58.611178017111285,67.03302575423434,NaN,NaN,NaN,NaN,0.6579729616382889,23.120655124708954,54906904,-0.13675084553247796,0.7112788289464227,0.8480296744789007
2024-10-24T09:30:00-04:00,26.95,27.32,26.69,26.85,25.47460121142792,NaN,NaN,NaN,NaN,NaN,24.647599999999976,28.459431181991643,20.835768818008308,26.186993175454663,26.953333333333337,26.953333333333337,26.953333333333337,502913,816745.0666666667,60.186967363751386,66.34143558876805,NaN,NaN,NaN,NaN,0.6559748929498397,22.30965841014692,55409817,-0.1458007917556834,0.6657786847842964,0.8115794765399797
2024-10-24T13:30:00-04:00,26.85,27.26,26.775,27.225,25.47460121142792,NaN,NaN,NaN,NaN,NaN,24.736199999999975,28.577492261727038,20.894907738272913,26.186993175454663,26.991831280725474,27.05225451879521,26.93140804265574,204155,815614.5333333333,63.67746401425153,65.80335825246291,NaN,NaN,NaN,NaN,0.64376240059628,21.55659003233931,55613972,-0.12729739553268526,0.6524577321241232,0.7797551276568084
2024-10-25T09:30:00-04:00,27.53,27.75,27.1,27.29,25.47460121142792,NaN,NaN,NaN,NaN,NaN,24.829999999999977,28.687073502022464,20.97292649797749,26.237989123732984,27.38,27.38,27.38,522331,816304.3666666667,64.2623281549831,65.24009169258395,NaN,NaN,NaN,NaN,0.6442079434108313,21.514156210397335,56136303,-0.11198741593622041,0.6397708577365329,0.7517582736727533
2024-10-25T13:30:00-04:00,27.27,27.28,26.92,27.06,25.47460121142792,NaN,NaN,NaN,NaN,NaN,24.916799999999977,28.77536748548001,21.058232514519943,26.237989123732984,27.270851934130256,27.41263862499178,27.129065243268734,309533,817614.6333333333,60.54721403059378,64.449512992731,NaN,NaN,NaN,NaN,0.6246216617386289,21.132620566410267,55826770,-0.11805255129606329,0.6041925845526741,0.7222451358487374
2024-10-28T09:30:00-04:00,27.82,28.23,27.52,28.14,25.883568408286706,NaN,NaN,NaN,NaN,NaN,25.018999999999977,28.942402095121494,21.09559790487846,26.529313039189113,27.963333333333335,27.963333333333335,27.963333333333335,804122,827990.7333333333,69.47194990887968,64.71768585484479,NaN,NaN,NaN,NaN,0.663577257328727,21.878371963854494,56630892,-0.0533270449428811,0.6555863296701361,0.7089133746130172
2024-10-28T13:30:00-04:00,28.135,28.16,27.81,27.895,26.03636075336458,NaN,NaN,NaN,NaN,NaN,25.123299999999976,29.069640892523626,21.176959107476325,26.62445043135129,27.960688179436247,27.96456711100215,27.956809247870343,373938,826980.4333333333,65.83369646682166,64.94214963583418,NaN,NaN,NaN,NaN,0.6411788818052466,22.57085540433842,56256954,-0.032061215239498786,0.6688368555636437,0.7008980708031425
2024-10-29T09:30:00-04:00,28.15,28.36,27.601,28.16,26.03636075336458,NaN,NaN,NaN,NaN,NaN,25.232899999999976,29.206022746657162,21.25977725334279,26.75206034508103,28.040333333333333,28.040333333333333,28.040333333333333,878878,707222.1,67.79809455865424,65.09998472897225,NaN,NaN,NaN,NaN,0.6495946759620147,22.79306667437442,57135832,-0.00652977629767193,0.6927358504310526,0.6992656267287245
2024-10-29T13:30:00-04:00,28.15,28.275,27.96,28.02,26.20023366164004,NaN,NaN,NaN,NaN,NaN,25.337899999999976,29.3225917521942,21.353208247805753,26.831148276064823,28.052633713803903,28.072586599172134,28.032680828435673,334006,663980,65.65057614822794,65.02803293453941,NaN,NaN,NaN,NaN,0.6256950562504421,22.999405710836417,56801826,-0.005494407506941412,0.6923976173450477,0.6978920248519891
2024-10-30T09:30:00-04:00,27.93,28.57,27.56,28.39,26.20023366164004,NaN,NaN,NaN,NaN,NaN,25.454499999999975,29.448404480580994,21.460595519418955,26.909918620851858,28.173333333333332,28.173333333333332,28.173333333333332,1166393,642859.4,68.49117548039276,65.11428610151383,NaN,NaN,NaN,NaN,0.6531454093754105,22.379442161740908,57968219,0.012692554751068896,0.7137577182908252,0.7010651635397563
2024-10-30T13:30:00-04:00,28.38,28.495,28.135,28.22,26.387511456163757,NaN,NaN,NaN,NaN,NaN,25.570899999999973,29.54110386882141,21.600696131178537,26.98693489668149,28.22699782010909,28.281981603212458,28.172014037005724,1111091,655471.4333333333,65.79877170515731,64.9790743319966,NaN,NaN,NaN,NaN,0.6322064515628812,21.803761723295082,56857128,0.006185945537438453,0.7087975954615544,0.702611649924116
2024-10-31T09:30:00-04:00,25.87,26.48,23.36,24.01,NaN,NaN,NaN,27.422602700934597,27.422602700934597,27.422602700934597,25.601899999999972,29.497971298116212,21.705828701883732,26.98693489668149,24.616666666666674,24.616666666666674,24.616666666666674,3580259,745308.2666666667,32.12216831638206,62.150739393463844,NaN,NaN,NaN,NaN,0.9341917050226753,23.762562202277905,53276869,-0.27329448951852586,0.36099353802595857,0.6342880275444844
2024-10-31T13:30:00-04:00,24.005,24.04,23.29,23.475,NaN,NaN,NaN,26.156120759983022,NaN,NaN,25.623399999999975,29.459966923696854,21.786833076303097,26.98693489668149,24.290247940740738,24.7643426804073,23.816153201074176,1697205,785673.4,30.019502040513615,59.28638328976206,NaN,NaN,NaN,NaN,0.9210351546639128,25.612997838134323,51579664,-0.4740659960521858,0.04170553247925213,0.5157715285314379
2024-11-01T09:30:00-04:00,23.7,23.95,23,23.905,NaN,NaN,NaN,25.982433452711067,NaN,NaN,25.62589999999998,29.45781893964417,21.79398106035579,26.98693489668149,23.618333333333336,23.618333333333336,23.618333333333336,1663108,801367.9666666667,33.771885751513295,57.58878371123097,NaN,NaN,NaN,NaN,0.923104072187919,27.465580841201398,53242772,-0.552314959018983,-0.17462217024229076,0.3776927887766922
2024-11-01T13:30:00-04:00,23.905,24.12,23.64,23.99,NaN,NaN,NaN,25.982433452711067,NaN,NaN,25.627799999999976,29.45637684264066,21.799223157359293,26.98693489668149,23.722947631835336,23.86530556429906,23.58058969937161,898130,812704.6666666666,34.519329450660194,55.86793738505589,NaN,NaN,NaN,NaN,0.8914537813173534,28.936393686887236,54140902,-0.5704254818988436,-0.3353390635968623,0.23508641830198132
2024-11-04T09:30:00-05:00,23.68,24.55,23.55,24.15,NaN,NaN,NaN,25.982433452711067,NaN,NaN,25.641399999999976,29.443962841032874,21.838837158967078,26.98693489668149,24.083333333333332,24.083333333333332,24.083333333333332,1000250,807705.8,35.983902478849814,54.139147036134354,NaN,NaN,NaN,NaN,0.8992070826518281,29.67753500396907,55141152,-0.5438065722270401,-0.4446717969818188,0.0991347752452213
2024-11-04T13:30:00-05:00,24.16,24.38,24.12,24.34,NaN,NaN,NaN,25.982433452711067,NaN,NaN,25.659599999999973,29.428210799751714,21.89098920024823,26.98693489668149,24.153998242821565,24.248358736494385,24.059637749148745,560965,808759.2666666667,37.764056155746495,52.28818933195542,NaN,NaN,NaN,NaN,0.853549433890983,30.365737655545054,55702117,-0.4873935529222245,-0.5101071659075593,-0.022713612985334836
2024-11-05T09:30:00-05:00,24.49,25.27,24.43,24.93,NaN,NaN,NaN,25.982433452711067,NaN,NaN,25.712299999999978,29.363089070872686,22.06151092912727,26.98693489668149,24.876666666666665,24.876666666666665,24.876666666666665,854925,780326.6333333333,43.05916872413813,50.77367794403792,NaN,NaN,NaN,NaN,0.8590101886130557,29.76917027066404,56557042,-0.3886254925735614,-0.5084954787022866,-0.11986998612872521
2024-11-05T13:30:00-05:00,24.93,24.99,24.585,24.98,NaN,NaN,NaN,25.982433452711067,NaN,NaN,25.76539999999998,29.29271900457046,22.238080995429495,26.98693489668149,24.86705811914234,24.879219101926342,24.854897136358336,533711,785438.3333333334,43.497902593631956,49.55586998425495,NaN,NaN,NaN,NaN,0.8265808894264087,29.215214841845956,57090753,-0.30206348033517944,-0.4974493365476995,-0.19538585621252008
2024-11-06T09:30:00-05:00,27.73,29.66,26.75,29.59,25.305887182752727,25.305887182752727,25.305887182752727,NaN,NaN,NaN,25.901999999999976,29.48179775965131,22.32220224034864,26.98693489668149,28.666666666666668,28.666666666666668,28.666666666666668,4803113,924129.3333333334,67.98848752528144,49.4499083854265,NaN,NaN,NaN,NaN,1.1018251116102367,29.307124734453417,61893866,0.06400730448103409,-0.11537672561122747,-0.17938403009226156
2024-11-06T13:30:00-05:00,29.59,30.06,29.41,29.85,26.879028674445788,NaN,NaN,NaN,NaN,NaN,26.046799999999976,29.667716878361652,22.4258831216383,26.564711823485204,28.973707696287647,29.46920530365785,28.478210088917443,1844304,971899.8,68.8096184009782,49.66247423786625,NaN,NaN,NaN,NaN,1.0695518893523626,29.582028564837444,63738170,0.30832601431981155,0.2060234878075029,-0.10230252651230866
2024-11-07T09:30:00-05:00,29.04,30.03,28.68,29.845,26.879028674445788,NaN,NaN,NaN,NaN,NaN,26.196899999999978,29.81294695212931,22.580853047870647,26.564711823485204,29.518333333333334,29.518333333333334,29.518333333333334,1995196,1015662.1666666666,68.77308366056667,49.73211631657427,NaN,NaN,NaN,NaN,1.0895838972557654,29.173322828321957,61742974,0.44591087353886205,0.45508606541126895,0.009175191872406868
2024-11-07T13:30:00-05:00,29.845,29.96,29.325,29.34,26.879028674445788,NaN,NaN,NaN,NaN,NaN,26.33549999999998,29.891063668394025,22.77993633160593,26.86551556703053,29.52634724505102,29.537427339471222,29.51526715063082,1043729,1041028.6,65.01818863673584,49.686945780039125,NaN,NaN,NaN,NaN,1.0571136188803538,28.793810358700433,60699245,0.4764594443111789,0.6047494972613805,0.1282900529502016
2024-11-08T09:30:00-05:00,29.345,30.415,29.21,30.29,26.91383635932029,NaN,NaN,NaN,NaN,NaN,26.485099999999978,30.0640978988544,22.906102101145557,27.336912453624425,29.971666666666668,29.971666666666668,29.971666666666668,2284372,1096016.9,68.50217739777092,49.68773163128043,NaN,NaN,NaN,NaN,1.0676769318174713,28.702670045000694,62983617,0.5300870899668615,0.7908989154087784,0.26081182544191694
2024-11-08T13:30:00-05:00,30.285,30.63,30.105,30.54,27.529002888442093,NaN,NaN,NaN,NaN,NaN,26.638099999999977,30.24323350099616,23.032966499003795,27.90502996289954,30.142969855983104,30.362771273524963,29.923168438441245,1387512,1123982.4666666666,69.36680255700652,49.94259097784108,NaN,NaN,NaN,NaN,1.028914293830509,28.741583714813512,64371129,0.5494884624667058,0.9476724035252992,0.39818394105859345
2024-11-11T09:30:00-05:00,33.07,34.31,32.23,33.54,30.046434575331087,NaN,NaN,NaN,NaN,NaN,26.84449999999998,30.807176999201847,22.88182300079811,30.245023970319632,33.35999999999999,33.35999999999999,33.35999999999999,3725821,1218706.1333333333,77.38817771819609,53.17587736368494,NaN,NaN,NaN,NaN,1.2247061299854727,30.321573985063388,68096950,0.7206665981624047,1.2990171887615993,0.5783505905991946
2024-11-11T13:30:00-05:00,33.54,33.875,32.655,32.8,30.046434575331087,NaN,NaN,NaN,NaN,NaN,27.034099999999977,31.205752761197168,22.862447238802787,30.245023970319632,33.29651927498487,33.40533277968601,33.18770577028372,1268061,1251441.3,72.35523913961413,56.199858585049256,NaN,NaN,NaN,NaN,1.2243699778436532,31.78870780743828,66828889,0.7376814202619715,1.5004523659266589,0.7627709456646874
2024-11-12T09:30:00-05:00,31.67,33.76,31.46,32.52,30.046434575331087,NaN,NaN,NaN,NaN,NaN,27.181699999999978,31.590344059118838,22.773055940881118,30.245023970319632,32.580000000000005,32.580000000000005,32.580000000000005,1774116,1278636.2,70.48727419659494,58.822386331126516,NaN,NaN,NaN,NaN,1.3012006937119636,32.03921572950868,65054773,0.6848525191307973,1.618836594578184,0.9339840754473867
2024-11-12T13:30:00-05:00,32.52,33.07,32.48,32.99,30.046434575331087,NaN,NaN,NaN,NaN,NaN,27.329099999999976,32.00382253294301,22.65437746705694,30.245023970319632,32.6554593384298,32.77557752394569,32.53534115291391,700149,1289588.4666666666,71.80317588278726,61.4855182191356,NaN,NaN,NaN,NaN,1.2504006441611093,32.271830228574046,65754922,0.6373186341100088,1.7306323680848976,1.0933137339748888
2024-11-13T09:30:00-05:00,33.63,34.1,32.9,33.15,30.15287391846939,NaN,NaN,NaN,NaN,NaN,27.490699999999975,32.39487373672716,22.586526263272788,30.55066581824292,33.38333333333333,33.38333333333333,33.38333333333333,1792448,1329946.7666666666,72.25667807414968,64.07643076165702,NaN,NaN,NaN,NaN,1.2468005981496018,32.9199458237776,67547370,0.5743593135375955,1.8112628758968832,1.2369035623592877
2024-11-13T13:30:00-05:00,33.16,33.26,31.83,31.92,30.15287391846939,NaN,NaN,NaN,NaN,NaN,27.616299999999974,32.64455091259427,22.58804908740568,30.55066581824292,33.05568935663012,33.54105875562373,32.57031995763651,816782,1347717.2,63.766072346313855,65.93371763241183,NaN,NaN,NaN,NaN,1.2598862697103446,32.56572577219835,66730588,0.41501642665847394,1.7556740956823802,1.3406576690239063
2024-11-14T09:30:00-05:00,32.86,33,31.6,32.25,30.15287391846939,NaN,NaN,NaN,NaN,NaN,27.747199999999975,32.90861614675711,22.585783853242837,30.55066581824292,32.28333333333333,32.28333333333333,32.28333333333333,899575,1360939.2666666666,64.95586037985416,67.49776703639154,NaN,NaN,NaN,NaN,1.2698943933024627,32.0407495150939,67630163,0.30222485428012535,1.718438736874063,1.4162138825939377
2024-11-14T13:30:00-05:00,32.25,32.5,31.89,32.23,30.15287391846939,NaN,NaN,NaN,NaN,NaN,27.882199999999976,33.15133091885224,22.61306908114771,30.55066581824292,32.253899770571515,32.29118567311563,32.2166138680274,560575,1372819.9333333333,64.81694718642768,69.02055593587694,NaN,NaN,NaN,NaN,1.222759079495144,31.553271562068335,67069588,0.20149845067245642,1.6680869459345082,1.4665884952620518
2024-11-15T09:30:00-05:00,32.01,32.21,31.27,31.645,30.15287391846939,NaN,NaN,NaN,NaN,NaN,27.990899999999975,33.34117763391811,22.64062236608184,30.55066581824292,31.70833333333333,31.708333810170487,31.70833285649617,1150225,1393749.7333333334,60.726119034659234,68.50181532940393,NaN,NaN,NaN,NaN,1.2039905738169192,30.538517151078143,65919363,0.07709826984368506,1.5629613325666583,1.4858630627229732
2024-11-15T13:30:00-05:00,31.64,32.35,31.46,32.33,30.15287391846939,NaN,NaN,NaN,NaN,NaN,28.112099999999973,33.57433547277167,22.649864527228274,30.55066581824292,31.827039316751584,31.988504732730853,31.665573900772316,621683,1404154.7333333334,63.62138344353502,68.13122711815798,NaN,NaN,NaN,NaN,1.1815626756871394,29.685113094847726,66541046,0.025253797626684005,1.5174303097563282,1.4921765121296442
2024-11-18T09:30:00-05:00,33.1,35.27,32.9,34.73,30.53166226635004,NaN,NaN,NaN,NaN,NaN,28.26569999999997,34.02374897860429,22.50765102139565,31.529192140257475,34.300000000000004,34.300000000000004,34.300000000000004,2722135,1468088.5,71.53822205553168,68.32873700351264,NaN,NaN,NaN,NaN,1.3071653417094868,30.361954872648422,69263181,0.13099334576661326,1.6559181943379109,1.5249248485712976
2024-11-18T13:30:00-05:00,34.73,35.61,33.95,35,31.161813981515948,NaN,NaN,NaN,NaN,NaN,28.42569999999997,34.471577276293814,22.379822723706123,31.787353712205977,34.487686610956395,34.7496541549966,34.22571906691619,1397273,1502199.6666666667,72.26936555681995,68.84667821209008,NaN,NaN,NaN,NaN,1.332367817301666,31.12391066532308,70660454,0.19373027885279548,1.767087697137292,1.5733574182844965
2024-11-19T09:30:00-05:00,34.56,36.32,34,35.605,31.389913345992493,NaN,NaN,NaN,NaN,NaN,28.606399999999976,34.952258504568476,22.26054149543147,32.10188296976478,35.30833333333333,35.30833333333333,35.30833333333333,2073839,1542031.7,73.88802895886604,69.23138189502545,NaN,NaN,NaN,NaN,1.4029129732086898,32.103563104362856,72734293,0.2471625991079478,1.8823106671694312,1.6351480680614834
2024-11-19T13:30:00-05:00,35.6,35.98,35.14,35.23,31.846735466629205,NaN,NaN,NaN,NaN,NaN,28.774899999999974,35.36326200887629,22.186537991123657,32.185506375811826,35.352316634271105,35.41786384528542,35.28676942325679,933775,1562024,71.1170633665062,69.35640052427543,NaN,NaN,NaN,NaN,1.3627049036937833,33.01324036918551,71800518,0.22885731367988393,1.9212197101613384,1.6923623964814545
2024-11-20T09:30:00-05:00,37.01,38.11,35.845,36.54,33.040292945418784,NaN,NaN,NaN,NaN,NaN,28.966299999999976,35.88172531157734,22.05087468842261,33.63440510064946,36.83166666666667,36.83166666666667,36.83166666666667,2955085,1621647.0666666667,74.68818793964192,69.16354411152156,NaN,NaN,NaN,NaN,1.4710831248585132,34.58103361655142,74755603,0.273559031529955,2.0343111858938983,1.7607521543639433
2024-11-20T13:30:00-05:00,36.55,36.74,35.725,36.065,33.040292945418784,NaN,NaN,NaN,NaN,NaN,29.148899999999976,36.3176492047082,21.980150795291756,33.63440510064946,36.691508734705444,36.960133379038744,36.42288409037214,804477,1611426.6,71.24829349001894,69.08447656512189,NaN,NaN,NaN,NaN,1.438505758797191,35.91495225678996,73951126,0.24087095418779447,2.0618408470986864,1.820969892910892
2024-11-21T09:30:00-05:00,37.08,37.2,34.63,35.96,33.040292945418784,NaN,NaN,NaN,NaN,NaN,29.337299999999978,36.71400419903115,21.960595800968804,33.63440510064946,35.93000000000001,35.93000000000001,35.93000000000001,2243024,1566852.1,70.47559103254076,69.08364205340375,NaN,NaN,NaN,NaN,1.519326776025963,36.08465770174224,71708102,0.18445355752213843,2.051536839813565,1.8670832822914265
2024-11-21T13:30:00-05:00,35.95,36.075,35.06,35.085,33.040292945418784,NaN,NaN,NaN,NaN,NaN,29.512499999999978,37.00982972464222,22.015170275357736,33.63440510064946,35.780367848996,36.0168371107285,35.5438985872635,898120,1540215.9333333333,64.22468137280802,68.54232101697666,NaN,NaN,NaN,NaN,1.4833034348812515,36.242241329197924,70809982,0.06656056826804946,1.9502839926264883,1.8837234243584389
2024-11-22T09:30:00-05:00,34.98,36.62,34.18,36.325,33.040292945418784,NaN,NaN,NaN,NaN,NaN,29.705199999999977,37.395252785254755,22.015147214745195,33.63440510064946,35.708333333333336,35.708333333333336,35.708333333333336,1575774,1537304.8,68.4899977080463,68.27327241939784,NaN,NaN,NaN,NaN,1.5516389038183047,35.56455396453703,72385756,0.05113866784076104,1.9476467591593902,1.8965080913186292
2024-11-22T13:30:00-05:00,36.325,36.835,36.19,36.68,33.040292945418784,NaN,NaN,NaN,NaN,NaN,29.902199999999976,37.78966858250505,22.0147314174949,33.63440510064946,35.99414612627073,36.39925111182275,35.589041140718706,784372,1533512.8666666667,69.6071949903928,68.69049546540349,NaN,NaN,NaN,NaN,1.4868789821169976,35.04763843119366,73170128,0.04415691435217517,1.9517042342588482,1.907547319906673
2024-11-25T09:30:00-05:00,39.23,39.74,37.57,37.76,34.35129231587402,NaN,NaN,NaN,NaN,NaN,30.119199999999974,38.25843494193433,21.979965058065616,35.04547605070465,38.35666666666666,38.35666666666666,38.35666666666666,2282980,1576270.5333333334,72.77023976024822,69.24866542114592,NaN,NaN,NaN,NaN,1.5992447691086409,35.78661166557661,75453108,0.0889984402345958,2.0187953701999177,1.929796929965322
2024-11-25T13:30:00-05:00,37.77,37.925,37.305,37.86,34.35129231587402,NaN,NaN,NaN,NaN,NaN,30.337199999999974,38.706919507845214,21.967480492154735,35.04547605070465,38.221230570666705,38.48777303869068,37.95468810264273,589438,1577219.6333333333,73.04991602188494,69.83673462367857,NaN,NaN,NaN,NaN,1.5292987141723093,36.23543014635567,76042546,0.10122697077000442,2.0563306434278275,1.955103672657823
2024-11-26T09:30:00-05:00,36.98,37.9,36.79,36.85,34.35129231587402,NaN,NaN,NaN,NaN,NaN,30.52439999999998,39.048297615527986,22.000502384471975,35.04547605070465,37.18,37.18,37.18,975766,1581247.6666666667,65.70911482825174,70.19266289464947,NaN,NaN,NaN,NaN,1.4993488060171443,36.18891556474589,75066780,0.021304944283154104,1.9817348530117656,1.9604299087286114
2024-11-26T13:30:00-05:00,36.84,36.89,36.15,36.39,34.35129231587402,NaN,NaN,NaN,NaN,NaN,30.70419999999998,39.33547971044875,22.072920289551206,35.04547605070465,36.91080297450132,37.252662891324434,36.56894305767821,605048,1583625.5666666667,62.62254845636695,70.12131753842317,NaN,NaN,NaN,NaN,1.4451096055873482,35.58809192995551,74461732,-0.07713446457681639,1.864011828007591,1.9411462925844074
2024-11-27T09:30:00-05:00,37.51,38.29,37.05,38.085,34.35129231587402,NaN,NaN,NaN,NaN,NaN,30.934299999999975,39.72546488527004,22.14313511472991,35.04547605070465,37.80833333333334,37.80833333333334,37.80833333333334,1075038,1459356.4,68.49507521971988,69.90394990729376,NaN,NaN,NaN,NaN,1.4776017766168235,35.64635645992306,75536770,-0.04431698291655928,1.8857500639387084,1.9300670468552676
2024-11-27T13:30:00-05:00,38.08,38.2,37.55,37.66,34.35129231587402,NaN,NaN,NaN,NaN,NaN,31.15369999999998,40.05705393208671,22.25034606791325,35.04547605070465,37.80688698999943,37.80915410448294,37.80461987551591,437542,1412464.3333333333,65.70745334502712,69.43524189216569,NaN,NaN,NaN,NaN,1.4184873640013365,35.700459237750074,75099228,-0.06614301168868075,1.8473882822444168,1.9135312939330975
2024-11-29T09:30:00-05:00,38.61,39.145,37.51,37.51,34.35129231587402,NaN,NaN,NaN,NaN,NaN,31.366899999999976,40.357915046144925,22.375884953855028,35.71050991383592,38.055,38.055,38.055,1395513,1392474.9,64.70650997903994,68.77941910789241,NaN,NaN,NaN,NaN,1.4339525522869556,36.139127612833285,73703715,-0.10337376683221478,1.784314085392829,1.8876878522250438
2024-12-02T09:30:00-05:00,37.99,38.79,37.53,37.745,34.35129231587402,NaN,NaN,NaN,NaN,NaN,31.577299999999976,40.66263240118405,22.491967598815904,35.71050991383592,38.02166666666667,38.02166666666667,38.02166666666667,1273431,1400131.6333333333,65.59087148400235,68.38469111628498,NaN,NaN,NaN,NaN,1.422955941409316,36.5464625325534,74977146,-0.12350279802590891,1.7333093546926577,1.8568121527185666
2024-12-02T13:30:00-05:00,37.74,38.045,37.59,37.63,34.35129231587402,NaN,NaN,NaN,NaN,NaN,31.78409999999998,40.94011107251425,22.628088927485713,35.71050991383592,37.94966142496903,38.06805332905953,37.83126952087853,471042,1339687.3,64.73600987674888,67.67382125464977,NaN,NaN,NaN,NaN,1.3538162313086506,36.924702100864934,74506104,-0.153912297363904,1.6644217810136865,1.8183340783775905
2024-12-03T09:30:00-05:00,37.1,38.34,36.61,38,34.35129231587402,NaN,NaN,NaN,NaN,NaN,32.00289999999998,41.21955168919835,22.786248310801618,35.71050991383592,37.65,37.65,37.65,948127,1325041.1333333333,66.25967739550529,67.31749153361308,NaN,NaN,NaN,NaN,1.38068650050089,36.2657032738483,75454231,-0.15786891455384322,1.6209979351852866,1.7788668497391298
2024-12-03T13:30:00-05:00,37.99,38.705,37.92,38.66,34.385014999187874,NaN,NaN,NaN,NaN,NaN,32.21329999999998,41.54717349603596,22.879426503964005,35.74045286070719,38.01943070062189,38.408096606109275,37.6307647951345,856603,1229400.5333333334,68.84554239420663,67.20105948801779,NaN,NaN,NaN,NaN,1.3381374647508262,35.85237567183666,76310834,-0.12617102758279541,1.6211530652606356,1.747324092843431
2024-12-04T09:30:00-05:00,39.97,40.57,37.79,39.98,35.05194613558842,NaN,NaN,NaN,NaN,NaN,32.454999999999984,41.953496302047114,22.956503697952854,36.80836228856575,39.446666666666665,39.446667143503824,39.44666618982951,3094670,1290287.5,73.259610458381,67.84641156555871,NaN,NaN,NaN,NaN,1.441127645840053,36.33584653727526,79405504,-0.03138001634617038,1.7080990724107181,1.7394790887568885
2024-12-04T13:30:00-05:00,39.99,40.14,39.18,40,35.58867585669804,NaN,NaN,NaN,NaN,NaN,32.69179999999998,42.33936627549164,23.044233724508317,36.80836228856575,39.5370394945978,39.683171429605885,39.390907559589714,1183586,1270603.1666666667,73.32128762913823,68.19150370277956,NaN,NaN,NaN,NaN,1.4067613854229066,36.78478376946824,80589090,0.015095999861249876,1.7583490885834507,1.7432530887222009
2024-12-05T09:30:00-05:00,42.71,42.76,38.795,39.34,36.35055422684813,NaN,NaN,NaN,NaN,NaN,32.91819999999998,42.64755429717739,23.18884570282256,37.98605186468208,40.29833333333334,40.29833333333334,40.29833333333334,4715613,1404451.9666666666,67.76646532211072,68.06002301218798,NaN,NaN,NaN,NaN,1.589492715035556,38.10954770365171,75873477,-0.014577654599505108,1.7250310204728194,1.7396086750723245
2024-12-05T13:30:00-05:00,39.33,39.49,38.79,38.94,36.35055422684813,NaN,NaN,NaN,NaN,NaN,33.129199999999976,42.91402751202111,23.34437248797885,37.98605186468208,40.04507331894386,40.541160894618784,39.54898574326893,1229008,1385670.6333333333,64.57349333343096,67.47454112455819,NaN,NaN,NaN,NaN,1.525957521104445,39.334636740338304,74644469,-0.07379908735439833,1.6473598158793266,1.721158903233725
2024-12-06T09:30:00-05:00,39.59,41.295,38.95,41.02,36.35055422684813,NaN,NaN,NaN,NaN,NaN,33.385199999999976,43.3116225096459,23.458777490354052,37.98605186468208,40.421666666666674,40.421666666666674,40.421666666666674,2383496,1437894.4333333333,71.96952496463143,67.39737033475436,NaN,NaN,NaN,NaN,1.5851748410255564,40.952586930690465,77027965,0.00999999957123543,1.7336589026977691,1.7236589031265337
2024-12-06T13:30:00-05:00,41.01,41.71,40.83,41.675,36.906191321829496,NaN,NaN,NaN,NaN,NaN,33.73849999999997,43.5619766249025,23.915023375097448,37.98605186468208,40.78850805380032,41.26406536969395,40.31295073790669,1418291,1455184.9666666666,73.82286533505761,67.97692394238335,NaN,NaN,NaN,NaN,1.534805209523731,42.55240415809844,78446256,0.08808572789466229,1.8337660629948616,1.7456803351001993
2024-12-09T09:30:00-05:00,41.39,42.085,39.25,40.09,36.906191321829496,NaN,NaN,NaN,NaN,NaN,34.07079999999998,43.6028076290362,24.538792370963755,37.98605186468208,40.475,40.475,40.475,2078271,1505774.8333333333,62.972415780378,68.001914465527,NaN,NaN,NaN,NaN,1.6276762659863218,42.54146586783744,76367985,0.015344718679771274,1.7648612334499134,1.7495165147701421
2024-12-09T13:30:00-05:00,40.09,40.49,39.42,39.52,36.906191321829496,NaN,NaN,NaN,NaN,NaN,34.38309999999998,43.57967912269583,25.186520877304126,37.98605186468208,40.337674899546876,40.60686443980938,40.068485359284374,540861,1485462.7,59.58089760618973,67.36518749313198,NaN,NaN,NaN,NaN,1.5878422469872988,42.531308884023666,75827124,-0.08337840866566859,1.6452935039380563,1.7286719126037249
2024-12-10T09:30:00-05:00,39.67,40.5,37.56,37.725,36.906191321829496,NaN,NaN,NaN,NaN,NaN,34.65779999999997,43.40579226337143,25.909807736628515,37.98605186468208,38.595,38.595,38.595,1932441,1529154.6333333333,50.3791751902873,66.27031048207914,NaN,NaN,NaN,NaN,1.684424943631063,41.006196560243275,73894683,-0.2711979967479483,1.3896744166687895,1.6608724134167379
2024-12-10T13:30:00-05:00,37.73,37.88,37.195,37.36,36.906191321829496,NaN,NaN,NaN,NaN,NaN,34.921999999999976,43.16816298650504,26.675837013494913,37.98605186468208,38.1354016304307,38.68493554025053,37.58586772061087,1351681,1483472.8333333333,48.73108394341538,65.12920862239166,NaN,NaN,NaN,NaN,1.6130374476574159,39.32576232336104,72543002,-0.4131383328188103,1.144449497393225,1.5575878302120354
2024-12-11T09:30:00-05:00,38.37,38.55,37.72,38.22,36.906191321829496,NaN,NaN,NaN,NaN,NaN,35.199599999999975,42.919885186442635,27.479314813557316,37.98605186468208,38.163333333333334,38.163333333333334,38.163333333333334,1500556,1486915.6,52.660634684336515,64.2056202795584,NaN,NaN,NaN,NaN,1.5828204871104574,38.10084481401752,74043558,-0.4397634315891874,1.007883540725551,1.4476469723147385
2024-12-11T13:30:00-05:00,38.23,38.37,37.81,37.85,36.906191321829496,NaN,NaN,NaN,NaN,NaN,35.45799999999998,42.631598539088046,28.28440146091191,37.98605186468208,38.10548282644514,38.179804626133205,38.031161026757076,909147,1448092.5333333334,50.85467679168941,63.21409648776843,NaN,NaN,NaN,NaN,1.5097618808882813,36.96342141248425,73134411,-0.4702088586537134,0.8598858989975966,1.33009475765131
2024-12-12T09:30:00-05:00,37.38,39.98,35.64,39.96,NaN,NaN,NaN,42.105640071286444,42.105640071286444,42.105640071286444,35.757599999999975,42.38631306966936,29.128886930330587,37.65973855471722,38.52666666666667,38.52666666666667,38.52666666666667,1675109,1472803.6666666667,59.40462531359193,62.7244499104889,NaN,NaN,NaN,NaN,1.711921746539118,34.37010225892977,74809520,-0.34211328651539974,0.9024531495070605,1.2445664360224602
2024-12-12T13:30:00-05:00,39.96,40.19,38.95,39.34,NaN,NaN,NaN,42.105640071286444,NaN,NaN,35.952599999999975,42.41567055199036,29.489529448009595,37.65973855471722,38.82237806708122,39.267809455062554,38.37694667909988,738274,1398909.9666666666,56.30491215364693,61.82869060759179,NaN,NaN,NaN,NaN,1.6782130503577524,32.08993065898393,74071246,-0.29480474592554096,0.876060503615534,1.170865249541075
2024-12-13T09:30:00-05:00,39.385,40.15,38.96,39.83,NaN,NaN,NaN,42.105640071286444,NaN,NaN,36.15219999999997,42.463722846350755,29.840677153649185,37.65973855471722,39.64666666666667,39.64666666666667,39.64666666666667,1209508,1412411,58.162936966523084,60.75035678674478,NaN,NaN,NaN,NaN,1.6433406896179128,29.972628459034222,75280754,-0.2291024169903053,0.8844872283031933,1.1135896452934986
2024-12-13T13:30:00-05:00,39.84,40.34,39.45,40.19,NaN,NaN,NaN,42.105640071286444,NaN,NaN,36.35909999999998,42.5061264974218,30.21207350257815,37.427290843773775,39.77170188946128,39.9381703157854,39.60523346313717,682354,1360388.6666666667,59.52469554845519,59.76488592383886,NaN,NaN,NaN,NaN,1.5895306403594904,28.135913778558553,75963108,-0.163089568063143,0.9097276852145697,1.0728172532777127
2024-12-16T09:30:00-05:00,41.05,43.25,40.55,43.2,37.098866238665856,37.098866238665856,37.098866238665856,NaN,NaN,NaN,36.63629999999998,42.74211585375824,30.530484146241715,38.63882519181322,42.333333333333336,42.333333810170494,42.33333285649618,2478537,1413069.2333333334,68.69855359949129,59.83146365793749,NaN,NaN,NaN,NaN,1.6945641660480983,28.033464457678914,78441645,0.0691459293894181,1.1592496650144852,1.0901037356250671
2024-12-16T13:30:00-05:00,43.2,43.82,43.08,43.18,38.76619050054468,NaN,NaN,NaN,NaN,NaN,36.89409999999998,42.9948132992794,30.793386700720557,39.76106015345057,42.68446758076304,43.17150204324351,42.197433118282575,1288316,1403487.3,68.58731541820958,60.11816523542168,NaN,NaN,NaN,NaN,1.6263810113303772,28.185023906817854,77153329,0.1998672752150501,1.3399378296438798,1.1400705544288297
2024-12-17T09:30:00-05:00,42.215,42.31,40.33,41.55,38.76619050054468,NaN,NaN,NaN,NaN,NaN,37.11429999999998,43.074918763182595,31.153681236817363,39.76106015345057,41.39666666666667,41.39666666666667,41.39666666666667,1908226,1440949.1,60.05274885433349,59.26696694182897,NaN,NaN,NaN,NaN,1.713782367663922,26.497404361590625,75245103,0.15690691180625005,1.3362041941866423,1.1792972823803922
2024-12-17T13:30:00-05:00,41.56,41.78,41.25,41.615,38.76619050054468,NaN,NaN,NaN,NaN,NaN,37.275799999999975,43.27772481125895,31.273875188741005,39.76106015345057,41.43544536281122,41.501609161877624,41.36928156374482,655504,1386699.9,60.26508327826889,58.29855393777263,NaN,NaN,NaN,NaN,1.629226484259356,24.930329069593917,75900607,0.11515158864160968,1.3232367681824044,1.2080851795407948
2024-12-18T09:30:00-05:00,41.4,41.5,39.41,40.06,38.76619050054468,NaN,NaN,NaN,NaN,NaN,37.42099999999998,43.33338429062299,31.50861570937697,39.76106015345057,40.32333333333333,40.32333333333333,40.32333333333333,1379761,1413044,53.00631633964442,57.58668969200595,NaN,NaN,NaN,NaN,1.6703531639551166,23.81284251766844,74520846,-0.027306624753708375,1.1739518985986592,1.2012585233523676
2024-12-18T13:30:00-05:00,40.04,40.1,36.64,37.06,NaN,NaN,NaN,43.421229361312285,43.421229361312285,43.421229361312285,37.51179999999997,43.257420161480084,31.76617983851986,39.76106015345057,38.971395857041,40.156045859588076,37.78674585449393,1796954,1440416.9333333333,42.39660208932106,56.35924001222962,NaN,NaN,NaN,NaN,1.7981850808154654,23.920268033549846,72723892,-0.3175698507543663,0.8042962099094098,1.121866060663776
2024-12-19T09:30:00-05:00,38.51,38.65,36.205,36.745,NaN,NaN,NaN,42.58253711761626,NaN,NaN,37.58689999999998,43.190550199647056,31.9832498003529,39.76106015345057,37.199999999999996,37.199999999999996,37.199999999999996,1624400,1474395.3333333333,41.45826017023604,55.722031796511665,NaN,NaN,NaN,NaN,1.8443861464715035,24.174827447916837,71099492,-0.5131840839748456,0.480385955695219,0.9935700396700646
2024-12-19T13:30:00-05:00,36.76,36.97,36.505,36.93,NaN,NaN,NaN,41.7216263395428,NaN,NaN,37.66249999999998,43.12488674939846,32.2001132506015,39.76106015345057,37.09064557188156,37.268412618653784,36.912878525109335,614700,1459050.7333333334,42.2664331287767,55.26027102403747,NaN,NaN,NaN,NaN,1.7458585645806814,24.411204046971903,71714192,-0.6061412585911199,0.2358934664311647,0.8420347250222846
2024-12-20T09:30:00-05:00,35.32,38.38,34.03,38.085,NaN,NaN,NaN,41.55575696047267,NaN,NaN,37.78579999999998,42.996657265364675,32.574942734635286,39.76106015345057,36.83166666666667,36.83166666666667,36.83166666666667,1713921,1501596.7,47.17002208123576,54.86808440953028,NaN,NaN,NaN,NaN,1.9318686671106329,25.46316046513774,73428113,-0.5665973565329272,0.13378802935612555,0.7003853858890527
2024-12-20T13:30:00-05:00,38.08,38.47,38.01,38.34,NaN,NaN,NaN,41.55575696047267,NaN,NaN,37.90759999999998,42.87415383138083,32.94104616861913,39.76106015345057,37.32936515865224,38.014793154156735,36.64393716314774,903649,1485201.2333333334,48.215767785579466,54.67959090909386,NaN,NaN,NaN,NaN,1.826735190888445,26.377817718984254,74331762,-0.5022218107261919,0.07260812248131288,0.5748299332075048
2024-12-23T09:30:00-05:00,37.93,38.49,37.08,37.39,NaN,NaN,NaN,41.55575696047267,NaN,NaN,38.01079999999998,42.70831822135945,33.313281778640516,39.76106015345057,37.65333333333333,37.65333333333333,37.65333333333333,925659,1473608.8333333333,44.66833986251532,53.62699909115982,NaN,NaN,NaN,NaN,1.7969683915392707,27.514068812019215,73406103,-0.5014125639781024,-0.051935771765123206,0.44947679221297915
2024-12-23T13:30:00-05:00,37.4,37.625,37.23,37.49,NaN,NaN,NaN,41.55575696047267,NaN,NaN,38.127699999999976,42.46265569066229,33.792744309337664,37.77727849820837,37.58507657093828,37.681687391649,37.488465750227554,462052,1473309.1666666667,45.12600951417422,52.828506045483195,NaN,NaN,NaN,NaN,1.6968277921436086,28.569159112694535,73868155,-0.4723364963806792,-0.14094382826286989,0.3313926681178093
2024-12-24T09:30:00-05:00,38.02,39.59,37.7,39.575,NaN,NaN,NaN,41.55575696047267,NaN,NaN,38.27259999999998,42.29582817647763,34.24937182352234,37.77727849820837,38.955000000000005,38.955000000000005,38.955000000000005,1059453,1477020.0333333334,53.721128901848545,52.51123404086359,NaN,NaN,NaN,NaN,1.7256258069904937,28.151173373517985,74927608,-0.2993129355064313,-0.04274850126522978,0.2565644342412015
2024-12-26T09:30:00-05:00,39.34,40.33,38.8,40.29,NaN,NaN,NaN,41.55575696047267,NaN,NaN,38.38379999999998,42.31552916666498,34.45207083333498,37.19532279856669,39.806666666666665,39.806666666666665,39.806666666666665,560107,1467136.8333333333,56.25176981060068,52.27745363101684,NaN,NaN,NaN,NaN,1.7116525350626013,27.299974264500342,75487715,-0.13188406024694593,0.09170935893251908,0.22359341917946501
2024-12-26T13:30:00-05:00,40.3,40.46,40.15,40.37,NaN,NaN,NaN,41.55575696047267,NaN,NaN,38.49119999999998,42.3398291377587,34.64257086224126,37.03731428596018,39.999864052745195,40.25113564042197,39.74859246506842,331121,1375018.5333333334,56.53813796806564,51.40885251448644,NaN,NaN,NaN,NaN,1.6115344968438443,26.42741667339954,75818836,-0.01696234992143064,0.2023904817776767,0.21935283169910735
2024-12-27T09:30:00-05:00,40.21,40.44,38.23,39.29,NaN,NaN,NaN,41.55575696047267,NaN,NaN,38.56489999999997,42.32985072477801,34.799949275221934,37.03731428596018,39.31999999999999,39.31999999999999,39.31999999999999,919620,1366219.6666666667,51.62516741049725,50.19727051393555,NaN,NaN,NaN,NaN,1.65428203278357,26.442020354848715,74899216,-0.014965328699977049,0.20064617082413605,0.2156114995241131
2024-12-27T13:30:00-05:00,39.28,39.47,38.99,39.03,NaN,NaN,NaN,41.55575696047267,NaN,NaN,38.64089999999998,42.28498160720969,34.996818392790274,37.03731428596018,39.26945933908035,39.342696477686474,39.196222200474224,437953,1223631,50.48774210859126,49.51405574638254,NaN,NaN,NaN,NaN,1.5704047447276004,26.455580916194382,74461263,-0.03148740870475236,0.17625223864317263,0.207739647347925
2024-12-30T09:30:00-05:00,37.9,38.96,37.46,38.76,NaN,NaN,NaN,41.55575696047267,NaN,NaN,38.68529999999998,42.27966748816873,35.09093251183123,37.03731428596018,38.39333333333334,38.39333333333334,38.39333333333334,737284,1207240.2,49.27365106553821,48.72895344547321,NaN,NaN,NaN,NaN,1.5703758343899146,27.053273879139027,73723979,-0.059317198312723696,0.1335931494570204,0.19291034776974408
2024-12-30T13:30:00-05:00,38.75,38.87,38.24,38.28,NaN,NaN,NaN,41.55575696047267,NaN,NaN,38.72959999999998,42.24748165804436,35.211718341955596,37.03731428596018,38.41357457852955,38.44531066455841,38.381838492500684,299918,1137787.6,47.10497712853242,48.30742921610806,NaN,NaN,NaN,NaN,1.5032061319334917,27.608274487587625,73424061,-0.10604207118355835,0.060357758790296145,0.1663998299738545
2024-12-31T09:30:00-05:00,39.13,39.13,37.75,37.75,NaN,NaN,NaN,41.55575696047267,NaN,NaN,38.76539999999998,42.20538246507232,35.32541753492764,37.03731428596018,38.21,38.21,38.21,719475,1114493.7333333334,44.76230621224365,48.47640808203111,NaN,NaN,NaN,NaN,1.4944056939382424,28.309003910587883,72704586,-0.16510981300042946,-0.03998743627668233,0.12512237672374713
2024-12-31T13:30:00-05:00,37.73,37.91,37.04,37.25,NaN,NaN,NaN,41.55575696047267,NaN,NaN,38.80869999999998,42.114160216067354,35.50323978393261,37.03731428596018,37.87718513259902,38.27570025983002,37.478670005368016,501801,1061944.7333333334,42.609382943235,48.558631137245314,NaN,NaN,NaN,NaN,1.4498052872283675,29.22117713098425,72202785,-0.22652654874407474,-0.1580358092063463,0.06849073953772844
2025-01-02T09:30:00-05:00,38.52,39.7,37.36,38.82,NaN,NaN,NaN,41.55575696047267,NaN,NaN,38.85859999999998,42.08700768181535,35.63019231818461,37.03731428596018,38.626666666666665,38.626666666666665,38.626666666666665,1495714,1093773.1666666667,50.63772068516034,49.15658024841559,NaN,NaN,NaN,NaN,1.5212477667120559,28.687038231462402,73698499,-0.15357715767066143,-0.12348070755059837,0.030096450120063074
2025-01-02T13:30:00-05:00,38.82,39.67,38.55,39.46,NaN,NaN,NaN,41.55575696047267,NaN,NaN,38.91419999999998,42.08586855771604,35.74253144228392,37.03731428596018,38.81728989046834,39.09664042443736,38.537939356499315,696468,1052574.0666666667,53.49374012509263,49.60827439440536,NaN,NaN,NaN,NaN,1.4925872119469095,28.191052110477827,74394967,-0.059234202978621434,-0.04394630360321372,0.015287899375407716
2025-01-03T09:30:00-05:00,39.77,40.59,39.03,40.53,NaN,NaN,NaN,41.55575696047267,NaN,NaN,38.96959999999998,42.15542726462122,35.78377273537874,37.06854877500352,40.050000000000004,40.050000000000004,40.050000000000004,1330686,1051874.2333333334,57.8813580378874,50.29867369814165,NaN,NaN,NaN,NaN,1.4974024110935589,27.07371000074474,75725653,0.07114881152011282,0.10422391377554874,0.03307510225543592
2025-01-03T13:30:00-05:00,40.53,41.38,40.405,41.37,NaN,NaN,NaN,41.55575696047267,NaN,NaN,39.039799999999985,42.27897270919644,35.80062729080353,38.075339020002815,40.46895966397282,40.96305553528069,39.97486379266495,956748,1033747.3,60.99267162043001,51.464697395135545,NaN,NaN,NaN,NaN,1.4600879531583046,25.51134675610796,76682401,0.20244591901450976,0.2861325010235731,0.08368658200906337
2025-01-06T09:30:00-05:00,42.14,43.03,41.48,43.01,37.738333033130566,37.738333033130566,37.738333033130566,NaN,NaN,NaN,39.16299999999998,42.52587198685951,35.80012801314046,39.556271216002244,42.50666666666666,42.50666666666666,42.50666666666666,1781374,1062821.5333333334,66.23668458267986,52.97260275717167,NaN,NaN,NaN,NaN,1.4743673850755687,24.279772058023124,78463775,0.3780258668107265,0.5562189155224715,0.17819304871174502
2025-01-06T13:30:00-05:00,43,43.12,42.4,42.71,38.35045425889736,NaN,NaN,NaN,NaN,NaN,39.28939999999998,42.7006071998056,35.878192800194356,39.9810169728018,42.5779639626918,42.686547520250166,42.46938040513343,768021,1032585.2666666667,64.52774722531593,53.74450406599077,NaN,NaN,NaN,NaN,1.4204840004273136,23.185079787215727,77695754,0.447489384787857,0.7375547796965662,0.29006539490870925
2025-01-07T09:30:00-05:00,42.34,43.19,40.13,41.26,38.35045425889736,NaN,NaN,NaN,NaN,NaN,39.352899999999984,42.790169317351186,35.91563068264878,39.9810169728018,41.526666666666664,41.526666666666664,41.526666666666664,1310827,1051670.3666666667,56.88798969355792,53.78994834334486,NaN,NaN,NaN,NaN,1.5375922861110765,22.20143438567507,76384927,0.37238955575983773,0.7555523396085064,0.3831627838486687
2025-01-07T13:30:00-05:00,41.25,41.28,39.865,40.555,38.35045425889736,NaN,NaN,NaN,NaN,NaN,39.41079999999999,42.82953389429512,35.99206610570486,39.9810169728018,41.205080405818805,41.65818644997158,40.75197436166603,660299,1033363.4,53.56722560635037,53.57774031750805,NaN,NaN,NaN,NaN,1.5288356942459995,21.42234142614605,75724628,0.25731248704057025,0.7048033926493815,0.4474909056088113
2025-01-08T09:30:00-05:00,40.255,40.75,39.22,40.375,38.35045425889736,NaN,NaN,NaN,NaN,NaN,39.46809999999998,42.85335324902083,36.08284675097913,39.9810169728018,40.115,40.115,40.115,757377,1035864.1666666666,52.72103262996665,53.65601640461301,NaN,NaN,NaN,NaN,1.5289188589427138,21.02581235658227,74967251,0.1561287953661164,0.6426518998164568,0.48652310445034036
2025-01-08T13:30:00-05:00,40.35,40.825,40.1,40.82,38.35045425889736,NaN,NaN,NaN,NaN,NaN,39.52959999999998,42.89909482267068,36.16010517732928,39.9810169728018,40.262375454698756,40.47929868431012,40.04545222508739,349583,964899.0333333333,54.629210219735434,53.951835555409026,NaN,NaN,NaN,NaN,1.4714960833039488,20.604476095247012,75316834,0.10848761035940235,0.6221326173995934,0.513645007040191
2025-01-10T09:30:00-05:00,40.06,40.52,38.78,39.97,38.35045425889736,NaN,NaN,NaN,NaN,NaN,39.57639999999998,42.90379720502456,36.2490027949754,39.9810169728018,39.75666666666667,39.75666666666667,39.75666666666667,939851,953283.5333333333,50.44144855807786,54.035249662019,NaN,NaN,NaN,NaN,1.5121035059250951,20.870849006493014,74376983,0.014012121030002378,0.5311601583276939,0.5171480372976915
2025-01-10T13:30:00-05:00,39.98,40.33,39.765,40.08,38.35045425889736,NaN,NaN,NaN,NaN,NaN,39.61799999999998,42.91741449351327,36.31858550648669,39.9810169728018,39.84214663680697,39.97808644835607,39.70620682525787,371616,902063.2,50.96531295697874,54.310987935479446,NaN,NaN,NaN,NaN,1.4444532555018739,21.118195281221446,74748599,-0.043632620846839165,0.46260726123914253,0.5062398820859817
2025-01-13T09:30:00-05:00,39.18,39.79,38.43,38.92,38.35045425889736,NaN,NaN,NaN,NaN,NaN,39.62319999999998,42.91737410590328,36.32902589409669,39.9810169728018,39.04666666666667,39.04666666666667,39.04666666666667,1064696,915702.9333333333,45.502845923242724,54.363883629122235,NaN,NaN,NaN,NaN,1.4591351658231684,21.95792561239928,73683903,-0.156119716607523,0.31109023632657795,0.46720995293410095
2025-01-13T13:30:00-05:00,38.93,39.63,38.72,39.59,38.35045425889736,NaN,NaN,NaN,NaN,NaN,39.61539999999998,42.908004343070374,36.322795656929586,39.9810169728018,39.11966473943227,39.23856568186063,39.000763797003906,401308,883087.8333333334,48.90896870925102,54.813854040980516,NaN,NaN,NaN,NaN,1.4199112254072281,22.737675205635835,74085211,-0.17994202467350745,0.24228242209221662,0.42222444676572407
2025-01-14T09:30:00-05:00,41.85,43.25,41.28,43.15,38.35045425889736,NaN,NaN,NaN,NaN,NaN,39.67839999999998,43.115405347683435,36.24139465231653,39.9810169728018,42.56,42.56,42.56,2476576,905741.9,62.3677683599957,55.651714589183044,NaN,NaN,NaN,NaN,1.5799175664495686,21.251795363887798,76561787,0.03790101592428585,0.4696007166710814,0.43169970074679553
2025-01-14T13:30:00-05:00,43.14,43.77,41.66,41.76,38.35045425889736,NaN,NaN,NaN,NaN,NaN,39.72679999999998,43.2112108598159,36.242389140184066,39.17089740884712,42.499988726309695,42.57873190632785,42.42124554629154,1438439,899543.2,56.148370992356675,55.8413310797019,NaN,NaN,NaN,NaN,1.617780597417457,20.144866263534517,75123348,0.07981170309271468,0.5314643296126889,0.4516526265199742
2025-01-15T09:30:00-05:00,44,46.21,43.65,45.61,39.78002483965999,NaN,NaN,NaN,NaN,NaN,39.860199999999985,43.705895754997506,36.01450424500246,40.305717927077694,45.156666666666666,45.156666666666666,45.156666666666666,3277007,988286.7666666667,66.20176556096908,56.43564590277917,NaN,NaN,NaN,NaN,1.8200819833162103,20.224039442543777,78400355,0.34347702342116027,0.8809989057964245,0.5375218823752642
2025-01-15T13:30:00-05:00,45.61,46.02,45.34,45.56,40.67138734694817,NaN,NaN,NaN,NaN,NaN,39.950999999999986,44.10404755571184,35.797952444288136,40.956574341662154,45.25601331329865,45.451327904857514,45.06069872173979,847841,959417.4333333333,65.99017308418973,56.79261029304772,NaN,NaN,NaN,NaN,1.738647555936481,20.29755739448095,77552514,0.4826403374317253,1.1408223041649208,0.6581819667331955
2025-01-16T09:30:00-05:00,45.47,46.84,45.25,46.21,41.04723337663234,NaN,NaN,NaN,NaN,NaN,40.041699999999985,44.52624350408215,35.557156495917816,41.99425947332972,46.1,46.1,46.1,1830977,990328.3666666667,67.44681297525105,56.87904803537424,NaN,NaN,NaN,NaN,1.7280298733695896,20.70462752475563,79383491,0.5800453647252654,1.3832386726397772,0.8031933079145118
2025-01-16T13:30:00-05:00,46.19,46.59,46.06,46.07,41.48213185951269,NaN,NaN,NaN,NaN,NaN,40.16129999999999,44.9530595139993,35.36954048600068,42.448407578663776,46.1503118899993,46.21748612855261,46.083137651445995,1027114,993710.2,66.783352044477,57.04016266531431,NaN,NaN,NaN,NaN,1.6424563109860475,21.082621217153545,78356377,0.5944329792788552,1.5462345320130808,0.9518015527342256
2025-01-17T09:30:00-05:00,47.74,49.27,46.98,49,43.065898593171205,NaN,NaN,NaN,NaN,NaN,40.35089999999999,45.73922764037264,34.96257235962734,44.356726062931024,48.416666666666664,48.416666666666664,48.416666666666664,2994657,1078130.3666666667,72.81126747781661,58.17753964990421,NaN,NaN,NaN,NaN,1.7537094316299016,22.416150592588664,81351034,0.7505980602312992,1.8900491280233496,1.1394510677920504
2025-01-17T13:30:00-05:00,49,49.115,47.77,48.11,43.42994865711797,NaN,NaN,NaN,NaN,NaN,40.558599999999984,46.31413474144711,34.803065258552856,44.51188085034482,48.387541916084416,48.42788237596099,48.34720145620784,1560953,1094847.0333333334,68.7311556792934,59.26067751225729,NaN,NaN,NaN,NaN,1.7245159007991941,23.65442786977842,79790081,0.7419458382493829,2.066883365603779,1.3249375273543962
2025-01-21T09:30:00-05:00,49.93,50.355,48.16,50.335,44.166655536339874,NaN,NaN,NaN,NaN,NaN,40.81809999999999,47.117669474178705,34.51853052582127,45.55000468027585,49.61666666666667,49.61666666666667,49.61666666666667,2792352,1169255.2,72.83021633296697,60.697047776757316,NaN,NaN,NaN,NaN,1.7616933364563945,25.194561432035506,82582433,0.8275438657498262,2.359367359541679,1.5318234937918527
2025-01-21T13:30:00-05:00,50.34,50.63,49.87,50.02,45.28692119377897,NaN,NaN,NaN,NaN,NaN,41.05409999999999,47.813965291557444,34.29423470844254,46.40600374422068,49.74934725518115,49.986528035115654,49.512166475246644,873828,1187345.4333333333,71.40311473282166,61.895183813406334,NaN,NaN,NaN,NaN,1.6901438124237953,26.70765170285832,81708605,0.8037459276876251,2.536505903401384,1.7327599757137588
2025-01-22T09:30:00-05:00,50.21,51.09,50.01,50.59,45.665242957698105,NaN,NaN,NaN,NaN,NaN,41.308899999999994,48.51233370622664,34.10546629377335,47.17080299537655,50.56333333333333,50.56333333333333,50.56333333333333,2011140,1223729.4333333333,72.45492227471033,63.46757479316579,NaN,NaN,NaN,NaN,1.6465621115363818,28.253568989235667,83719745,0.7672749779285906,2.691853698124497,1.9245787201959064
2025-01-22T13:30:00-05:00,50.6,50.81,49.72,50.14,45.665242957698105,NaN,NaN,NaN,NaN,NaN,41.51249999999999,49.116258873084014,33.90874112691596,47.17080299537655,50.43836973892111,50.602295704440806,50.274443773401416,1168729,1248088.6333333333,70.25789708793965,64.84561651680586,NaN,NaN,NaN,NaN,1.606807674998069,29.430848585134544,82551016,0.65792990543429,2.746991101988769,2.089061196554479
2025-01-23T09:30:00-05:00,49.42,50.9,49.3,50.565,45.665242957698105,NaN,NaN,NaN,NaN,NaN,41.736999999999995,49.72410135155443,33.74989864844556,47.17080299537655,50.254999999999995,50.254999999999995,50.254999999999995,1390360,1269857.8333333333,71.14772952946173,66.67739391725007,NaN,NaN,NaN,NaN,1.6063214124982073,30.145504009464545,83941376,0.5629816945006407,2.79278831468028,2.229806620179639
2025-01-23T13:30:00-05:00,50.575,50.68,50.16,50.355,45.75692289925265,NaN,NaN,NaN,NaN,NaN,41.94749999999999,50.27019241291561,33.62480758708437,47.42457113363279,50.29699332010508,50.36222830775882,50.23175833245134,576138,1279065.1666666667,70.0327856378201,68.18623798357643,NaN,NaN,NaN,NaN,1.5287270258911927,30.80911261777097,83365238,0.4402271339057946,2.7800905375618825,2.339863403656088
2025-01-24T09:30:00-05:00,50.91,52.05,50.6,51.78,46.642744585650256,NaN,NaN,NaN,NaN,NaN,42.17929999999999,50.92798127434087,33.43061872565911,48.598156906906226,51.47666666666667,51.47666666666667,51.47666666666667,2277541,1331000.7,73.11194144699057,68.95367891836177,NaN,NaN,NaN,NaN,1.5406036668989647,31.95163432848641,85642779,0.40981760260542144,2.852135406912865,2.4423178043074434
2025-01-24T13:30:00-05:00,51.78,51.865,50.82,51.1,46.73057437721161,NaN,NaN,NaN,NaN,NaN,42.3373,51.43249284237568,33.24210715762432,48.598156906906226,51.431167682451566,51.51898638229635,51.343348982606784,611358,1334652.6,69.44499174314412,69.90343754341802,NaN,NaN,NaN,NaN,1.5052034049776102,33.01254734557932,85031421,0.30361202497634254,2.8218328355278715,2.518220810551529
2025-01-27T09:30:00-05:00,48.32,50.14,46.67,46.725,NaN,NaN,NaN,53.41138354902529,53.41138354902529,53.41138354902529,42.408199999999994,51.583480215884535,33.23291978411545,48.598156906906226,47.845,47.845,47.845,2858498,1380078.7333333334,51.535692873300476,68.85586092287026,NaN,NaN,NaN,NaN,1.7141174474792094,30.85779086766058,82172923,-0.08103183522800617,2.4169310165165214,2.4979628517445276
2025-01-27T13:30:00-05:00,46.72,47.915,46.71,47.74,NaN,NaN,NaN,52.25563884225141,NaN,NaN,42.532,51.82392057650096,33.24007942349903,48.598156906906226,47.735257371934345,47.910631772948776,47.559882970919915,1119325,1394173.9666666666,54.46938057600505,68.03294717228565,NaN,NaN,NaN,NaN,1.6777519155164085,28.85694556673603,83292248,-0.27586985403810527,2.153125534196896,2.428995388235001
2025-01-28T09:30:00-05:00,47.97,49.69,47.02,48.84,NaN,NaN,NaN,52.25563884225141,NaN,NaN,42.6765,52.130190549198325,33.22280945080167,48.598156906906226,48.51666666666667,48.51666666666667,48.51666666666667,1148015,1388084.9333333333,57.47379492598472,67.32058874019519,NaN,NaN,NaN,NaN,1.7486267786938074,27.89647207699899,84440263,-0.3354742530873174,2.009652571875854,2.3451268249631716
2025-01-28T13:30:00-05:00,48.84,49.8,48.75,49.4,NaN,NaN,NaN,52.25563884225141,NaN,NaN,42.8633,52.47066376119898,33.25593623880103,48.598156906906226,48.82653115536125,49.21624334352296,48.43681896719954,725777,1380385.9,58.958563765419264,66.76167529169108,NaN,NaN,NaN,NaN,1.6987248659299639,27.05630681692115,85166040,-0.34088920287051483,1.9190153213750278,2.2599045242455427
2025-01-29T09:30:00-05:00,48.75,49.915,48.6,49.91,NaN,NaN,NaN,52.25563884225141,NaN,NaN,43.1203,52.78029263146718,33.460307368532824,48.598156906906226,49.475,49.475,49.475,989038,1353974.7,60.3174061956127,65.8692566286765,NaN,NaN,NaN,NaN,1.6713159469349663,26.173205359827982,86155078,-0.31446932280519,1.8668178707390553,2.1812871935442453
2025-01-29T13:30:00-05:00,49.91,51.71,49.21,51.18,NaN,NaN,NaN,52.25563884225141,NaN,NaN,43.409,53.152059683692826,33.66594031630717,48.598156906906226,50.06450082560184,50.67656886755232,49.45243278365136,917450,1358955.6666666667,63.55349660596926,65.49942383772478,NaN,NaN,NaN,NaN,1.73050766501104,26.193352959177407,87072528,-0.22026279820505756,1.9059586957879233,2.126221493992981
2025-01-30T09:30:00-05:00,52.12,53.5,51.09,52.68,47.13347006173941,47.13347006173941,47.13347006173941,NaN,NaN,NaN,43.724,53.625930720824144,33.82206927917585,48.598156906906226,52.42333333333334,52.42333333333334,52.42333333333334,1596154,1368466.5666666667,66.9787044126337,65.08145870055812,NaN,NaN,NaN,NaN,1.7790428317959655,26.889603803991974,88668682,-0.07332729359473689,2.0345623769995598,2.1078896705942967
2025-01-30T13:30:00-05:00,52.71,53.12,52.37,52.98,47.715812331660345,NaN,NaN,NaN,NaN,NaN,44.021899999999995,54.12156690341824,33.92223309658175,48.81844678103246,52.517448004351486,52.68711914835226,52.34777686035071,491104,1362826.7333333334,67.63384845813255,64.81222539522318,NaN,NaN,NaN,NaN,1.7055397723819679,27.5361224456055,89159786,0.02254104335829643,2.1360659747921673,2.113524931433871
2025-01-31T09:30:00-05:00,53.26,53.49,52.47,52.57,48.04032086203942,NaN,NaN,NaN,NaN,NaN,44.3065,54.55062831821236,34.06237168178764,49.538757424825974,52.843333333333334,52.843333333333334,52.843333333333334,1254929,1379411.8,65.71494071556177,64.33079814099828,NaN,NaN,NaN,NaN,1.6565726457832561,28.27369442694903,87904857,0.0360139754132387,2.1585424007004193,2.1225284252871806
2025-01-31T13:30:00-05:00,52.52,52.82,51.64,51.95,48.04032086203942,NaN,NaN,NaN,NaN,NaN,44.597699999999996,54.86657456540401,34.328825434595984,49.538757424825974,52.64280290845999,52.96138683085844,52.324218986061545,497201,1384332.4,62.812722083821114,63.7989999264184,NaN,NaN,NaN,NaN,1.6225317425130237,28.293301449472036,87407656,-0.016347001955524743,2.1020946728427745,2.1184416747982993
2025-02-03T09:30:00-05:00,48.24,52.01,48.08,51.81,48.04032086203942,NaN,NaN,NaN,NaN,NaN,44.88409999999999,55.14282871071279,34.62537128928719,49.538757424825974,50.63333333333333,50.63333333333333,50.63333333333333,1516539,1403555.3333333333,62.1453079804796,63.155969815776814,NaN,NaN,NaN,NaN,1.7873509037620934,26.417068549008384,85891117,-0.07655681262361425,2.0227456590187813,2.0993024716423956
2025-02-03T13:30:00-05:00,51.84,52.32,51.75,51.9,48.04032086203942,NaN,NaN,NaN,NaN,NaN,45.130599999999994,55.45926741453134,34.80193258546865,49.538757424825974,50.93777701405138,51.50376521072837,50.37178881737439,438786,1405794.3333333333,62.4217369939458,62.6123234840715,NaN,NaN,NaN,NaN,1.7003972677790866,24.544414849249957,86329903,-0.12367727103945736,1.944705882843074,2.0683831538825315
2025-02-04T09:30:00-05:00,52,53.3,51.55,52.87,48.04032086203942,NaN,NaN,NaN,NaN,NaN,45.38219999999999,55.839040471194146,34.925359528805835,49.538757424825974,52.57333333333333,52.57333333333333,52.57333333333333,1406154,1417176.2666666666,65.35791161345277,62.05846421024738,NaN,NaN,NaN,NaN,1.7039403200805805,23.298402438306915,87736057,-0.1036820150758806,1.9387806350376806,2.042462650113561
2025-02-04T13:30:00-05:00,52.87,53.17,52.425,52.57,48.04032086203942,NaN,NaN,NaN,NaN,NaN,45.62619999999999,56.1727991788824,35.07960082111758,49.538757424825974,52.61563362238564,52.68260547036861,52.54866177440267,560964,1422498.1333333333,63.700158339499595,61.64811896712991,NaN,NaN,NaN,NaN,1.635444582931968,22.141390913859805,87175093,-0.12348023470830016,1.8881123567281861,2.0115925914364863
2025-02-05T09:30:00-05:00,52.32,54.27,52.23,54.125,48.28076041405448,NaN,NaN,NaN,NaN,NaN,45.92289999999999,56.57396587905656,35.271834120943424,50.21209026637358,53.541666666666664,53.541666666666664,53.541666666666664,1787371,1399524.6333333333,68.20222827278734,62.838585781378974,NaN,NaN,NaN,NaN,1.6643413984368276,21.614961779645743,88962464,-0.048519175714270446,1.9509436217936482,1.9994627975079187
2025-02-05T13:30:00-05:00,54.14,54.33,53.82,54.2,49.26208948614291,NaN,NaN,NaN,NaN,NaN,46.226299999999995,56.93876298663391,35.51383701336608,50.828672213098855,53.704862044385244,53.96410056559738,53.44562352317311,708323,1375187.4333333333,68.40575946652996,63.83404141641647,NaN,NaN,NaN,NaN,1.5818884414056256,21.155521007112974,89670787,-0.01243397668349222,1.9839203266535534,1.9963543033370457
2025-02-06T09:30:00-05:00,54.8,54.85,52.98,53.05,49.26208948614291,NaN,NaN,NaN,NaN,NaN,46.51209999999999,57.174909965482975,35.849290034517004,51.11393777047909,53.626666666666665,53.626666666666665,53.626666666666665,1304512,1309437.6,61.86673789500589,64.14782305706083,NaN,NaN,NaN,NaN,1.6024678384480813,20.170749074652257,88366275,-0.0807553579169189,1.895410105940897,1.9761654638578159
2025-02-06T13:30:00-05:00,53.05,53.235,52.16,53.16,49.26208948614291,NaN,NaN,NaN,NaN,NaN,46.80969999999999,57.36694498342256,36.25245501657742,51.11393777047909,53.390904360300816,53.74745999737606,53.03434872322557,570351,1300187.9333333333,62.23857099740907,64.38210928791725,NaN,NaN,NaN,NaN,1.5647915642732184,18.745766002599463,88936626,-0.13034092706229616,1.8132393050299456,1.9435802320922417
2025-02-07T09:30:00-05:00,54.39,55.98,54.115,55.88,50.104697194888196,NaN,NaN,NaN,NaN,NaN,47.17229999999999,57.705337588464346,36.63926241153564,51.74892017310661,55.324999999999996,55.324999999999996,55.324999999999996,2163547,1311273.6,70.02252190465288,65.07533183856297,NaN,NaN,NaN,NaN,1.6544493096822743,18.80198082189583,91100173,0.0012772812091239594,1.9451768336036466,1.9438995523945226
2025-02-07T13:30:00-05:00,55.87,55.92,55.04,55.91,50.64187004966601,NaN,NaN,NaN,NaN,NaN,47.54549999999999,57.96756299155804,37.12343700844194,52.095136138485294,55.4100463671732,55.54472851757593,55.27536421677047,862696,1305793,70.0957405607343,65.54263497818906,NaN,NaN,NaN,NaN,1.5991315018478265,18.85418029695675,91962869,0.06789843584673783,2.028772597202945,1.960874161356207
2025-02-10T09:30:00-05:00,57.21,57.26,55.55,56.37,51.553603229226646,NaN,NaN,NaN,NaN,NaN,47.89649999999999,58.30157515590368,37.4914248440963,53.34510891078823,56.393333333333345,56.393333333333345,56.393333333333345,1870892,1268334.1666666667,71.25507592844325,65.84809008646117,NaN,NaN,NaN,NaN,1.6070506802872675,19.47025995819491,93833761,0.11757514662837276,2.107843094641673,1.9902679480133003
2025-02-10T13:30:00-05:00,56.36,56.6,56.04,56.275,51.612757627898155,NaN,NaN,NaN,NaN,NaN,48.23279999999999,58.61235570532777,37.85324429467221,53.34510891078823,56.37160161882114,56.409645900460724,56.33355733718155,610461,1236651.1,70.64594072002764,66.06323953373939,NaN,NaN,NaN,NaN,1.5322613459810341,20.042333929344633,93223300,0.11834049204249819,2.138193563066423,2.019853071023925
2025-02-11T09:30:00-05:00,55.83,55.99,53.9,53.98,51.612757627898155,NaN,NaN,NaN,NaN,NaN,48.501799999999996,58.76540107564594,38.23819892435405,53.34510891078823,54.623333333333335,54.623333333333335,54.623333333333335,1397747,1190164.2666666666,57.79265141141203,65.49736172630013,NaN,NaN,NaN,NaN,1.592456964125246,19.165565488465084,91825553,-0.05225956177446367,1.9545286188058455,2.006788180580309
2025-02-11T13:30:00-05:00,53.975,54.32,53.29,53.35,51.612757627898155,NaN,NaN,NaN,NaN,NaN,48.741399999999985,58.88651075149036,38.596289248509606,53.34510891078823,54.24642003688197,54.71922260087275,53.773617472891196,888284,1190646.1333333333,54.84287030435039,64.92808659919507,NaN,NaN,NaN,NaN,1.5522814666877285,18.002599961260675,90937269,-0.21494947083696236,1.7381013420341063,1.9530508128710686
2025-02-12T09:30:00-05:00,53.295,56.74,52.66,56.39,51.612757627898155,NaN,NaN,NaN,NaN,NaN,49.008999999999986,59.24076446171447,38.7772355382855,53.34510891078823,55.26333333333334,55.26333333333334,55.26333333333334,2251135,1198645.9666666666,64.30936442723284,65.08266205967745,NaN,NaN,NaN,NaN,1.7328327904957483,18.047872484204373,93188404,-0.1294522410122847,1.7912355116057128,1.9206877526179975
2025-02-12T13:30:00-05:00,56.4,56.55,55.52,55.94,51.612757627898155,NaN,NaN,NaN,NaN,NaN,49.27359999999999,59.52434924871363,39.02285075128635,53.34510891078823,55.564803350241796,55.928401537004554,55.20120516347904,1547556,1211273.5333333334,62.22974217611508,65.0689481441181,NaN,NaN,NaN,NaN,1.6826304483174803,18.089911255509232,91640848,-0.11530662566277394,1.77655447053953,1.891861096202304
2025-02-13T09:30:00-05:00,61.91,66.15,61.2,62.15,57.52033902611915,NaN,NaN,NaN,NaN,NaN,49.69139999999999,60.29830078015265,39.084499219847324,57.45930439030967,63.166666666666664,63.166666666666664,63.166666666666664,6757689,1390184.5,74.48971139532554,65.72121955710902,NaN,NaN,NaN,NaN,2.2917282734376605,20.61252498240151,98398537,0.27866409166270034,2.2401912107806794,1.961527119117979
2025-02-13T13:30:00-05:00,62.16,64.25,62.07,63.81,57.52033902611915,NaN,NaN,NaN,NaN,NaN,50.15649999999999,61.15240637464703,39.160593625352945,57.45930439030967,63.21463847398448,63.302801874775355,63.1264750731936,2000754,1437671.7,76.66973076476533,66.64761758748514,NaN,NaN,NaN,NaN,2.2837476824778276,22.95495201451577,100399291,0.5990437262605117,2.710331776943619,2.111288050683107
2025-02-14T09:30:00-05:00,63.305,66.07,61.73,63.89,57.52033902611915,NaN,NaN,NaN,NaN,NaN,50.62679999999998,61.9166065102997,39.33699348970026,57.465954809798184,63.896666666666675,63.896666666666675,63.896666666666675,3835724,1489611.1333333333,76.77274788294278,67.25979755963911,NaN,NaN,NaN,NaN,2.4306228480151253,25.41591459101044,104235015,0.7543058153948099,3.0541703199266195,2.2998645045318096
2025-02-14T13:30:00-05:00,63.88,65.45,63.51,65.285,58.02671531939232,NaN,NaN,NaN,NaN,NaN,51.11609999999999,62.777885161801066,39.45431483819891,57.59676384783855,64.15809759316444,64.55091545987187,63.76527972645701,1698943,1525863.9666666666,78.5512732597898,67.98447711630052,NaN,NaN,NaN,NaN,2.395578358871188,27.701094126326918,105933958,0.8801373430067216,3.4000361832902115,2.51989884028349
2025-02-18T09:30:00-05:00,65.27,65.58,60.46,60.69,58.02671531939232,NaN,NaN,NaN,NaN,NaN,51.53049999999998,63.05023285280556,40.01076714719441,57.59676384783855,62.24333333333334,62.24333333333334,62.24333333333334,3357128,1542484.9666666666,61.772706699492694,67.9777606023353,NaN,NaN,NaN,NaN,2.5901799046661034,28.21464101857932,102576830,0.5966522509109597,3.2657141539221897,2.66906190301123
2025-02-18T13:30:00-05:00,60.67,61.38,59.91,60.44,58.02671531939232,NaN,NaN,NaN,NaN,NaN,51.937699999999985,63.24708622737786,40.628313772622114,57.59676384783855,61.74114300805966,62.5058578259212,60.97642819019812,1447790,1553433.8,61.00915957692968,67.88994550087249,NaN,NaN,NaN,NaN,2.5101670543328107,28.431072503827753,101129040,0.3474040464452539,3.1033169610677973,2.7559129146225434
2025-02-19T09:30:00-05:00,61.075,61.91,59.165,59.7,58.02671531939232,NaN,NaN,NaN,NaN,NaN,52.35329999999998,63.23791053230688,41.46868946769309,57.59676384783855,60.258333333333326,60.258333333333326,60.258333333333326,1736480,1573049.3,58.69641749305415,67.08093804290114,NaN,NaN,NaN,NaN,2.526940836166181,28.27642997711245,99392560,0.10061840324342919,2.8816859186768298,2.7810675154334006
2025-02-19T13:30:00-05:00,59.7,59.795,58.65,59.21,58.02671531939232,NaN,NaN,NaN,NaN,NaN,52.745699999999985,63.16624873987004,42.32515126012993,57.59676384783855,59.87843622658934,60.379206812088285,59.3776656410904,999365,1582168.9,57.151487714328546,66.15634855387216,NaN,NaN,NaN,NaN,2.4282307764400253,27.88513345611919,98393195,-0.11596175679494092,2.6361153194397247,2.7520770762346656
2025-02-20T09:30:00-05:00,59.09,59.1,54.23,55.11,NaN,NaN,NaN,63.702209148296674,63.702209148296674,63.702209148296674,52.98489999999999,63.05664095973509,42.91315904026489,57.59676384783855,56.14666666666667,56.14666666666667,56.14666666666667,2816971,1643100,46.195138160485456,64.36635299901805,NaN,NaN,NaN,NaN,2.610500006694309,26.040663453067047,95576224,-0.5323736813743287,2.0866099745167546,2.6189836558910833
2025-02-20T13:30:00-05:00,55.1,56.59,54.945,56.06,NaN,NaN,NaN,62.70915418701046,NaN,NaN,53.27089999999998,62.85157903439038,43.69022096560958,57.59676384783855,56.06482376847465,56.1927071385418,55.93694039840751,1153762,1650977.0666666667,48.65149023626537,62.79532082160646,NaN,NaN,NaN,NaN,2.5415357205018587,24.327941307375774,96729986,-0.7287146938217104,1.7080902886139455,2.436804982435656
2025-02-21T09:30:00-05:00,57.88,57.88,52.88,53.03,NaN,NaN,NaN,62.68794263305544,NaN,NaN,53.419299999999986,62.74725862126356,44.09134137873641,57.59676384783855,54.59666666666667,54.59666666666667,54.59666666666667,2056908,1666335.5333333334,42.05660800917774,61.67131772144687,NaN,NaN,NaN,NaN,2.7171403118945827,23.429080495180415,94673078,-1.029160415519427,1.150354463036372,2.179514878555799
2025-02-21T13:30:00-05:00,53.04,53.34,51.45,51.59,NaN,NaN,NaN,59.62849069518929,NaN,NaN,53.53989999999999,62.610669204428255,44.46913079557172,57.59676384783855,53.586955593642784,54.80123311520896,52.37267807207661,1422241,1697373.4333333333,39.32814009013501,60.56312270614576,NaN,NaN,NaN,NaN,2.65805886104497,23.02724946631501,93250837,-1.2752913407026703,0.585400702677461,1.8606920433801313
2025-02-24T09:30:00-05:00,52.27,52.55,47.97,50.83,NaN,NaN,NaN,57.78924111813522,NaN,NaN,53.63229999999999,62.49424069264775,44.77035930735222,57.59676384783855,50.449999999999996,50.449999999999996,50.449999999999996,3208819,1762503.1,37.92952628273547,58.67884855296738,NaN,NaN,NaN,NaN,2.795340370970329,23.549465115479485,90042018,-1.4281735555465485,0.0754750989469457,1.5036486544934942
2025-02-24T13:30:00-05:00,50.83,51.15,49.84,49.9,NaN,NaN,NaN,57.78924111813522,NaN,NaN,53.708899999999986,62.37203206409825,45.04576793590172,56.73741107827084,50.41386704620344,50.478942355640704,50.34879173676618,989281,1778905.7666666666,36.23153604412273,56.82183382925364,NaN,NaN,NaN,NaN,2.689244630186734,24.0343796468465,89052737,-1.5221888533755348,-0.39908741222592425,1.1231014411496105
2025-02-25T09:30:00-05:00,47.51,48.83,44.03,45.89,NaN,NaN,NaN,54.2612920105323,NaN,NaN,53.64669999999998,62.487022304079666,44.8063776959203,54.290243090093334,46.25,46.25,46.25,4840492,1889704.2,29.996078108262026,53.64371716589197,NaN,NaN,NaN,NaN,2.916441442316253,25.618973616470036,84212245,-1.7674680990505942,-1.0862336826636323,0.6812344163869619
2025-02-25T13:30:00-05:00,45.9,46.975,45.615,45.92,NaN,NaN,NaN,53.95577873732629,NaN,NaN,53.602899999999984,62.573260770894564,44.632539229105404,54.290243090093334,46.23153764594437,46.265244170639704,46.19783112124904,1452231,1923485.7,30.093009350809055,50.31680849346652,NaN,NaN,NaN,NaN,2.8052670535793776,27.09038230254904,85664476,-1.8328469342597697,-1.6098242514377503,0.22302268282201942
2025-02-26T09:30:00-05:00,47.21,50.51,46.55,49.05,NaN,NaN,NaN,53.95577873732629,NaN,NaN,53.57719999999998,62.592115897555956,44.56228410244401,53.12669447207467,48.70333333333334,48.70333333333334,48.70333333333334,3498980,1993246.5666666667,39.504759361281266,47.65480931334783,NaN,NaN,NaN,NaN,2.9327479783237074,27.009434793751737,89163456,-1.580028224119229,-1.7520125973270169,-0.17198437320778787
2025-02-26T13:30:00-05:00,49.03,49.31,48.11,48.83,NaN,NaN,NaN,53.95577873732629,NaN,NaN,53.55339999999998,62.61193309095951,44.494866909040454,51.27535557765973,48.71608864879115,48.73688648478865,48.69529081279365,1316096,2018417.6333333333,39.106231426330226,44.837306325243574,NaN,NaN,NaN,NaN,2.8089802655862997,26.934269249868525,87847360,-1.3512106014725678,-1.8609976250484976,-0.5097870235759299
2025-02-27T09:30:00-05:00,51.87,52.93,48.45,51.48,NaN,NaN,NaN,53.95577873732629,NaN,NaN,53.57119999999998,62.60984670401528,44.532553295984684,49.71422756970223,50.95333333333333,50.95333333333333,50.95333333333333,3650693,2080528.3666666667,46.15283827047181,43.72160143745638,NaN,NaN,NaN,NaN,2.9283388180444208,25.593059229185826,91498053,-0.9631950159318208,-1.713780793490706,-0.7505857775588851
2025-02-27T13:30:00-05:00,51.47,51.63,48.43,48.77,NaN,NaN,NaN,53.95577873732629,NaN,NaN,53.54379999999998,62.632056281598096,44.45554371840187,49.71422756970223,50.61682810428894,51.198895902609515,50.03476030596837,1220146,2097589.1333333333,40.93585808093864,42.28779418774273,NaN,NaN,NaN,NaN,2.947743188184105,24.35316116898177,90277907,-0.8356050113725677,-1.7950920417745948,-0.9594870304020271
2025-02-28T09:30:00-05:00,48.185,51.11,47.415,49.9,NaN,NaN,NaN,53.95577873732629,NaN,NaN,53.53049999999998,62.638080194541764,44.4229198054582,45.862382055761785,49.475,49.475,49.475,2945149,2152277.033333333,43.78907844433848,41.22298425569161,NaN,NaN,NaN,NaN,3.0011186747423833,23.48957309726727,93223056,-0.6309688526558175,-1.748198096221799,-1.1172292435659814
2025-02-28T13:30:00-05:00,49.91,50.55,49.33,50.11,NaN,NaN,NaN,53.95577873732629,NaN,NaN,53.52559999999998,62.64026963526418,44.41093036473578,44.8077536973005,49.62687943785606,49.86386694055983,49.38989193515229,1209635,2173586.5,44.32732227537135,40.30697243862324,NaN,NaN,NaN,NaN,2.8738959122607843,22.687669887818092,94432691,-0.44604316779552144,-1.6747832033103833,-1.2287400355148619
2025-03-03T09:30:00-05:00,54.735,54.81,48.63,48.63,43.23794228948078,43.23794228948078,43.23794228948078,NaN,NaN,NaN,53.46259999999998,62.66775665048726,44.2574433495127,45.90352791441428,50.69,50.69,50.69,3267352,2210380,41.32409105944207,39.95904050283443,NaN,NaN,NaN,NaN,3.1100462042421566,21.602999584473213,91165339,-0.3900009653158907,-1.7162412421597253,-1.3262402768438346
2025-03-03T13:30:00-05:00,48.68,49.46,46.69,46.9,43.23794228948078,NaN,NaN,NaN,NaN,NaN,53.378599999999985,62.743724246907156,44.01347575309281,45.90352791441428,49.6623730454546,51.08845668686268,48.23628940404652,1696590,2238176.466666667,38.07662383333867,39.20369290262538,NaN,NaN,NaN,NaN,3.0857571896534313,20.134378898076985,89468749,-0.43274378242918976,-1.8671700048803217,-1.434426222451132
2025-03-04T09:30:00-05:00,45.05,45.9,42.135,45.19,NaN,NaN,NaN,52.756317046154905,52.756317046154905,52.756317046154905,53.34789999999999,62.80963368680417,43.88616631319581,45.90352791441428,44.40833333333333,44.40833333333333,44.40833333333333,4181698,2315203.3333333335,35.137318061563164,38.7094579063672,NaN,NaN,NaN,NaN,3.2057031046781863,19.953516503127418,85287051,-0.5328998230456743,-2.100551001258225,-1.5676511782125506
2025-03-04T13:30:00-05:00,45.19,48.26,45,46.17,NaN,NaN,NaN,52.756317046154905,NaN,NaN,53.31649999999999,62.86251262308009,43.77048737691989,45.90352791441428,45.038177172780046,45.99002996908468,44.08632437647541,1830960,2355886.6333333333,38.08704954359143,38.620808581614085,NaN,NaN,NaN,NaN,3.20958145434403,19.068210429587122,87118011,-0.4909069125650656,-2.1812848189188827,-1.6903779063538171
2025-03-05T09:30:00-05:00,46.59,47.115,44.92,46.445,NaN,NaN,NaN,52.756317046154905,NaN,NaN,53.268599999999985,62.92735023799695,43.60984976200302,45.90352791441428,46.16,46.16,46.16,1954071,2374430.7666666666,38.926379167120565,38.69201235907017,NaN,NaN,NaN,NaN,3.1371113504623134,18.26666144049726,89072082,-0.4058917080144564,-2.1977425413718876,-1.7918508333574312
2025-03-05T13:30:00-05:00,46.43,48.29,46.21,48.12,NaN,NaN,NaN,52.756317046154905,NaN,NaN,53.24299999999998,62.94929671914119,43.536703280858774,45.90352791441428,46.690587497472194,47.36192024212064,46.01925475282375,1220615,2385508.466666667,43.91377735653093,39.240743881385036,NaN,NaN,NaN,NaN,3.0616033968578624,17.16142891637084,90292697,-0.20809776187387996,-2.051973035699781,-1.8438752738259012
2025-03-06T09:30:00-05:00,46.09,48.77,45.67,45.91,NaN,NaN,NaN,52.756317046154905,NaN,NaN,53.16299999999999,63.04225685464276,43.28374314535722,45.90352791441428,46.78333333333333,46.78333333333333,46.78333333333333,2480299,2393147.2666666666,39.34808992986403,39.90874472578518,NaN,NaN,NaN,NaN,3.0643460113680154,16.292505599894067,87812398,-0.19744229792615897,-2.0906781462336,-1.893235848307441
2025-03-06T13:30:00-05:00,45.91,46.11,44.66,44.81,NaN,NaN,NaN,52.756317046154905,NaN,NaN,53.035599999999995,63.17473302802588,42.896466971974114,45.90352791441428,46.223988009725815,46.983258629132344,45.46471739031929,1346080,2386431.4,37.270971821902286,40.42145633086327,NaN,NaN,NaN,NaN,2.9490355819845857,15.781909504464227,86466318,-0.23335256839645813,-2.1849265588030136,-1.9515739904065554
2025-03-07T09:30:00-05:00,43.65,45.35,40.96,43.09,NaN,NaN,NaN,51.7854921692947,NaN,NaN,52.8438,63.358454071342685,42.32914592865732,45.90352791441428,43.13333333333333,43.13333333333333,43.13333333333333,3538084,2279111.2333333334,34.22837592790417,40.044571799907764,NaN,NaN,NaN,NaN,3.0519616118428297,16.261321365678512,82928234,-0.33560195721603003,-2.371076436926593,-2.035474479710563
2025-03-07T13:30:00-05:00,43.11,44.73,43.05,44.415,NaN,NaN,NaN,51.7854921692947,NaN,NaN,52.67249999999999,63.44852268928589,41.8964773107141,45.90352791441428,43.391170849929594,43.807990276857524,42.974351423001664,1353831,2257547.1333333333,38.4001909049279,39.99414033409332,NaN,NaN,NaN,NaN,2.953964353854056,16.706489522520346,84282065,-0.2789816472230333,-2.3842015387393545,-2.105219891516321
2025-03-10T09:30:00-04:00,40.925,41.18,36.74,37.3,NaN,NaN,NaN,48.08900216251852,NaN,NaN,52.36709999999999,63.97114448285188,40.76305551714811,41.08655298159622,38.406666666666666,38.406666666666666,38.406666666666666,5841645,2324411.1666666665,28.094944836909733,38.70429080312459,NaN,NaN,NaN,NaN,3.291181185721623,18.36645080749455,78440420,-0.6637382450571798,-2.934892697837796,-2.2711544527806162
2025-03-10T13:30:00-04:00,37.305,37.33,35.23,35.61,NaN,NaN,NaN,45.28041115513131,NaN,NaN,52.040299999999995,64.55735914502307,39.523240854976926,41.08655298159622,37.369220789258016,38.5361414649501,36.20230011356593,4617250,2421688.066666667,26.29020175633596,37.6581724942244,NaN,NaN,NaN,NaN,3.206096815312936,20.143111885421053,73823170,-0.9572481412553584,-3.467714629349814,-2.5104664880944556
2025-03-11T09:30:00-04:00,36.195,38.34,35.57,35.98,NaN,NaN,NaN,45.28041115513131,NaN,NaN,51.72369999999999,65.02431063410276,38.42308936589721,41.08655298159622,36.629999999999995,36.629999999999995,36.629999999999995,4453148,2458222.066666667,27.389925961562994,36.48680445974044,NaN,NaN,NaN,NaN,3.1749470427905835,21.404014820131042,78276318,-1.0445339492399706,-3.8161339246444186,-2.771599975404448
2025-03-11T13:30:00-04:00,35.97,37.31,35.94,36.35,NaN,NaN,NaN,45.28041115513131,NaN,NaN,51.412699999999994,65.39214651407931,37.433253485920666,41.08655298159622,36.59235572679221,36.639492284840166,36.54521916874426,2840202,2504635.8,28.53812623104035,35.35900474228823,NaN,NaN,NaN,NaN,3.046022254019828,22.57485325950461,81116520,-0.9956061235114939,-4.016107629793815,-3.0205015062823213
2025-03-12T09:30:00-04:00,38.89,39.67,36.86,39.25,NaN,NaN,NaN,45.28041115513131,NaN,NaN,51.140299999999996,65.52058934479427,36.76001065520572,41.08655298159622,38.593333333333334,38.593333333333334,38.593333333333334,3597917,2566683.7,36.95331698043849,35.04680659378797,NaN,NaN,NaN,NaN,3.065592093018412,22.742996549973142,84714437,-0.7001392313377615,-3.895675545454523,-3.1955363141167616
2025-03-12T13:30:00-04:00,39.26,39.65,38.47,38.9,NaN,NaN,NaN,45.28041115513131,NaN,NaN,50.866899999999994,65.64242718382675,36.091372816173234,41.08655298159622,38.716947703505134,38.9061920618306,38.52770334517967,1535123,2584542.3,36.39625818945449,34.92678047636767,NaN,NaN,NaN,NaN,2.930906943517097,22.899129605408206,83179314,-0.4714469397707801,-3.784844988830237,-3.313398049059457
2025-03-13T09:30:00-04:00,38.35,38.67,35.95,36.2,NaN,NaN,NaN,45.28041115513131,NaN,NaN,50.508399999999995,65.81076366578722,35.206036334212776,39.23824238527697,36.940000000000005,36.940000000000005,36.940000000000005,3037808,2591903.533333333,32.34545392637652,34.727361609568625,NaN,NaN,NaN,NaN,2.932270733265876,23.599909554950763,80141506,-0.44549308907702523,-3.8702644104057384,-3.424771321328713
2025-03-13T13:30:00-04:00,36.2,36.95,35.91,36,NaN,NaN,NaN,44.758962588561914,NaN,NaN,50.1444,65.93622100202518,34.35257899797482,37.73607512657726,36.70868142530203,37.021123183825566,36.3962396667785,1665111,2608948.5,32.06080479951309,34.29691555642017,NaN,NaN,NaN,NaN,2.7971085380325995,24.2591348030062,78476395,-0.38741278075823926,-3.9090372972765124,-3.521624516518273
2025-03-14T09:30:00-04:00,37.4,39.45,37.01,38.93,NaN,NaN,NaN,44.758962588561914,NaN,NaN,49.861999999999995,65.9383252019858,33.78567479801418,37.73607512657726,38.46333333333334,38.46333333333334,38.46333333333334,3061926,2642449.1,40.34358380034735,34.39814445879352,NaN,NaN,NaN,NaN,2.843743642458843,23.861949149270067,81538321,-0.11160861708603376,-3.6611352878758154,-3.5495266707897817
2025-03-14T13:30:00-04:00,38.92,39.3,38.84,39.235,NaN,NaN,NaN,44.758962588561914,NaN,NaN,49.5835,65.90227719070897,33.26472280929103,33.90417474374921,38.61565701550901,38.894197854325505,38.33711617669251,915697,2625564.3,41.14791411679416,34.20058279881232,NaN,NaN,NaN,NaN,2.6734762394260683,23.493133899372225,82454018,0.11893554219828406,-3.4008572430419264,-3.5197927852402104
2025-03-17T09:30:00-04:00,39.25,41.92,38.98,41.8,NaN,NaN,NaN,44.758962588561914,NaN,NaN,49.3019,65.66222553343609,32.94157446656392,36.133339794999365,40.9,40.9,40.9,3035574,2619789.466666667,47.55227960237001,34.78659634684846,NaN,NaN,NaN,NaN,2.692513650895635,22.179919729608844,85489592,0.4529829438474886,-2.95356410543085,-3.4065470492783385
2025-03-17T13:30:00-04:00,41.81,42.91,41.64,42.03,NaN,NaN,NaN,44.758962588561914,NaN,NaN,49.02430000000001,65.39772627674485,32.650873723255174,37.645671835999494,41.34648777400995,41.961391171880514,40.73158437613939,1600465,2640162.2666666666,48.09769332137946,35.55993359681112,NaN,NaN,NaN,NaN,2.590905532974518,20.626283353721835,87090057,0.6843461710660628,-2.55111433544576,-3.235460506511823
2025-03-18T09:30:00-04:00,40.84,41.55,38.84,39.87,NaN,NaN,NaN,44.758962588561914,NaN,NaN,48.69430000000001,65.12721940100711,32.261380598992915,37.645671835999494,40.086666666666666,40.086666666666666,40.086666666666666,3844584,2606965.3333333335,43.52045555769286,36.22365357036745,NaN,NaN,NaN,NaN,2.6336979949049097,20.032836855022992,83245473,0.6851365245170902,-2.3790398508654604,-3.0641763753825506
2025-03-18T13:30:00-04:00,39.86,40.41,39.66,40.09,NaN,NaN,NaN,44.758962588561914,NaN,NaN,48.3706,64.8310699373985,31.910130062601507,37.645671835999494,40.07836872203075,40.092781989153096,40.06395545490841,1274282,2601033.7,44.1039197261824,36.63106277188563,NaN,NaN,NaN,NaN,2.499148138125988,19.481779391945494,84519755,0.691691311153368,-2.1995622364408405,-2.8912535475942085
2025-03-19T09:30:00-04:00,40.73,42.47,40.18,41.7,NaN,NaN,NaN,44.758962588561914,NaN,NaN,48.12500000000001,64.60979044452787,31.640209555472136,37.645671835999494,41.45,41.45,41.45,2590436,2570748.9,48.31214870349491,38.075148762355994,NaN,NaN,NaN,NaN,2.490637556831274,18.22829699219211,87110191,0.788645568381467,-1.9054465871173747,-2.6940921554988417
2025-03-19T13:30:00-04:00,41.7,43.83,41.62,42.82,NaN,NaN,NaN,44.758962588561914,NaN,NaN,47.91440000000001,64.39585316894107,31.43294683105894,38.560091184025396,42.09747823144858,42.75078532786398,41.44417113503317,2544418,2611692.966666667,51.07179920919769,39.84526286613184,NaN,NaN,NaN,NaN,2.4705920170576117,17.237309962129018,89654609,0.9041098220269292,-1.5639548779651804,-2.4680646999921096
2025-03-20T09:30:00-04:00,42.1,44.23,41.94,42.85,NaN,NaN,NaN,44.758962588561914,NaN,NaN,47.643600000000006,64.00361088508183,31.283589114918183,38.86907294722031,43.00666666666666,43.00666666666666,43.00666666666666,3096539,2593221.1666666665,51.14703845229456,41.54219947261266,NaN,NaN,NaN,NaN,2.457692587267782,16.448026679722346,92751148,0.9535010531285915,-1.2761883835813705,-2.229689436709962
2025-03-20T13:30:00-04:00,42.84,43.82,42.79,43.69,NaN,NaN,NaN,44.758962588561914,NaN,NaN,47.39860000000001,63.620619361349455,31.176580638650563,39.01625835777625,43.11401434610007,43.299157945173654,42.92887074702649,1040985,2587249.1333333333,53.31191886745638,43.31175608949952,NaN,NaN,NaN,NaN,2.355714545320083,15.715120774630437,93792133,1.0084089097162583,-0.9691782995646392,-1.9775872092808975
2025-03-21T09:30:00-04:00,41.95,43.9,41.5,43.21,NaN,NaN,NaN,44.758962588561914,NaN,NaN,47.019800000000004,62.72251313627041,31.3170868637296,39.01625835777625,42.870000000000005,42.870000000000005,42.870000000000005,2111479,2559460.1333333333,51.89668165616307,44.3791392806227,NaN,NaN,NaN,NaN,2.3588777920829345,14.65793794124628,91680654,0.97735843558579,-0.7558891647986599,-1.73324760038445
2025-03-21T13:30:00-04:00,43.2,44.72,43.12,44.36,NaN,NaN,NaN,44.758962588561914,NaN,NaN,46.63080000000001,61.596862055196695,31.66473794480332,39.8856053489768,43.32656656357299,43.9078624957536,42.74527063139238,1302568,2562557.9,54.980221502547835,45.70656523155794,NaN,NaN,NaN,NaN,2.3046722355055818,13.861185964933004,92983222,0.9958538566619934,-0.48843027955695817,-1.4842841362189516
2025-03-24T09:30:00-04:00,46.45,48.98,46.1,48.36,39.942294374794585,39.942294374794585,39.942294374794585,NaN,NaN,NaN,46.320200000000014,60.46254548580943,32.1778545141906,42.80248427918144,47.81333333333333,47.81333333333333,47.81333333333333,3690634,2576667.3,63.69712734372223,47.945970475654065,NaN,NaN,NaN,NaN,2.4700527901123257,14.477430155788609,96673856,1.2240447139556851,0.04577175622565477,-1.1782729577300304
2025-03-24T13:30:00-04:00,48.37,48.59,47.74,48.34,40.79673553957666,NaN,NaN,NaN,NaN,NaN,45.98130000000001,59.06181219333545,32.900787806664574,43.22298742334516,47.92550308374923,48.10828039295968,47.742725774538776,1389978,2566446.9,63.63078650162118,50.200969168661786,NaN,NaN,NaN,NaN,2.354334733675731,15.049656904440242,95283878,1.3123696123390576,0.4621890576937915,-0.850180554645266
2025-03-25T09:30:00-04:00,48.74,49.87,47.2,47.29,41.13756574232316,NaN,NaN,NaN,NaN,NaN,45.71330000000001,58.108534989301226,33.318065010698795,44.24138993867612,48.12,48.12,48.12,3489509,2543373.933333333,60.09225072702779,51.611588234853244,NaN,NaN,NaN,NaN,2.376882252698892,15.936241672785087,91794369,1.2396757506643237,0.6994141336851385,-0.5402616169791851
2025-03-25T13:30:00-04:00,47.31,48.33,47.295,48.17,41.13756574232316,NaN,NaN,NaN,NaN,NaN,45.46790000000001,57.1526653104373,33.783134689562715,44.24138993867612,48.083724980329166,48.15799420894308,48.00945575171525,832457,2510090.5,61.999567781739906,53.100992068063654,NaN,NaN,NaN,NaN,2.2813906632204,16.759498957676726,92626826,1.1902118013585365,0.9475031347189855,-0.24270866663955093
2025-03-26T09:30:00-04:00,47.96,47.99,44.36,44.53,41.13756574232316,NaN,NaN,NaN,NaN,NaN,45.164500000000004,56.12039763552029,34.20860236447972,44.24138993867612,45.626666666666665,45.626666666666665,45.626666666666665,2867793,2540547.9,51.11693742602729,53.355610484039175,NaN,NaN,NaN,NaN,2.390577044418943,16.196937102686842,89759033,0.8667323191390891,0.8407067322843105,-0.026025586854778626
2025-03-26T13:30:00-04:00,44.52,44.88,43.81,44.72,41.13756574232316,NaN,NaN,NaN,NaN,NaN,44.87470000000001,55.06928079765896,34.68011920234106,44.24138993867612,45.25311066333788,45.79397634866121,44.712244978014546,1367982,2545460.1333333333,51.59455068260092,53.60538600984071,NaN,NaN,NaN,NaN,2.2962501126747332,15.452325928502496,91127015,0.6309087325792574,0.7626103288692931,0.13170159629003575
2025-03-27T09:30:00-04:00,44.12,45.59,43.24,44.2,41.13756574232316,NaN,NaN,NaN,NaN,NaN,44.65650000000001,54.42351290057502,34.889487099425,44.24138993867612,44.34333333333335,44.34333333333335,44.34333333333335,3996262,2595992.2333333334,50.15035383393708,54.078950172429586,NaN,NaN,NaN,NaN,2.3000893903408235,15.018050413576997,87130753,0.4156399153976337,0.6512514905370779,0.2356115751394442
2025-03-27T13:30:00-04:00,44.19,44.83,43.84,44.01,41.13756574232316,NaN,NaN,NaN,NaN,NaN,44.41550000000001,53.62378263032784,35.20721736967218,44.24138993867612,44.32032333336414,44.36674574064356,44.27390092608473,981820,2583850.2333333334,49.60399974763805,54.471813031104986,NaN,NaN,NaN,NaN,2.20651157674505,14.614794578289034,86148933,0.24465167817905914,0.5414261728632681,0.29677449468420897
2025-03-28T09:30:00-04:00,42.65,43.07,40.58,41.19,NaN,NaN,NaN,48.97997760038196,48.97997760038196,48.97997760038196,44.178700000000006,53.092942045176905,35.26445795482311,44.24138993867612,41.61333333333334,41.61333333333334,41.61333333333334,3145456,2570762.6333333333,42.24735320501897,54.03861335264242,NaN,NaN,NaN,NaN,2.2939036069775463,14.222149913543161,83003477,-0.058016929939374295,0.2242533322599911,0.2822702621993654
2025-03-28T13:30:00-04:00,41.21,42,41.12,41.915,NaN,NaN,NaN,48.50975134581914,NaN,NaN,43.985200000000006,52.66446839313085,35.30593160686916,44.24138993867612,41.630460216574996,41.65909441432041,41.601826018829584,1125305,2563145.1,44.525240355114306,53.57100200592218,NaN,NaN,NaN,NaN,2.192910492193436,13.857551296279139,84128782,-0.20098800433882827,0.031035256775830078,0.23202326111465835
2025-03-31T09:30:00-04:00,39.72,41.73,38.84,41.41,NaN,NaN,NaN,47.338171739191,NaN,NaN,43.796800000000005,52.28032232507225,35.31327767492776,44.24138993867612,40.66,40.66,40.66,2892781,2464849.6333333333,43.24573631118957,53.00662328155754,NaN,NaN,NaN,NaN,2.2559168856081904,14.301817932519581,81236001,-0.31440661266820746,-0.16098500472060095,0.15342160794760648
2025-03-31T13:30:00-04:00,41.4,41.95,41.03,41.61,NaN,NaN,NaN,47.338171739191,NaN,NaN,43.631,51.95342969330476,35.30857030669524,44.24138993867612,40.893175371244105,41.278521733918765,40.507829008569445,1059201,2346248,43.932910288630765,52.3366940973557,NaN,NaN,NaN,NaN,2.160494250921891,14.608203834220944,82295202,-0.35764866766764364,-0.2936392266369481,0.06400944103069556
2025-04-01T09:30:00-04:00,41.7,43.365,40.62,41.85,NaN,NaN,NaN,47.338171739191,NaN,NaN,43.550200000000004,51.86177216415756,35.23862783584245,43.3071119509409,41.945,41.945,41.945,3142985,2302575.9,44.79668267696646,51.829551313127375,NaN,NaN,NaN,NaN,2.202244661570328,14.22389827821442,85438187,-0.3512707383972416,-0.37507898196585643,-0.023808243568614842
2025-04-01T13:30:00-04:00,41.85,42.5,41.26,42.15,NaN,NaN,NaN,47.338171739191,NaN,NaN,43.4748,51.76739065913652,35.18220934086349,42.06668956075272,41.95225857891837,41.963606596590935,41.9409105612458,1285895,2250765.6666666665,45.918278813654,51.18226969249211,NaN,NaN,NaN,NaN,2.1335129000295905,13.867043119065503,86724082,-0.3094966289801008,-0.4106790297937408,-0.10118240081364005
2025-04-02T09:30:00-04:00,40.62,43.59,40.56,43.32,NaN,NaN,NaN,47.338171739191,NaN,NaN,43.360200000000006,51.498370300503446,35.22202969949657,40.196081318881745,42.49,42.49,42.49,2585014,2217002.2333333334,50.170421524768386,50.21607641970969,NaN,NaN,NaN,NaN,2.19754769288462,13.021610724210857,89309096,-0.1914999744854879,-0.3405573689204999,-0.14905739443501204
2025-04-02T13:30:00-04:00,43.31,43.34,41.9,42.68,NaN,NaN,NaN,47.338171739191,NaN,NaN,43.2372,51.225492473363595,35.24890752663641,40.196081318881745,42.538630956722514,42.608842590779446,42.46841932266558,1240139,2207169.433333333,47.94956357381514,49.09598906772354,NaN,NaN,NaN,NaN,2.1434371433928616,12.236566357560116,88068957,-0.14698758935289197,-0.332791881126127,-0.18580429177323504
2025-04-03T09:30:00-04:00,37.96,39.87,37.44,38.31,NaN,NaN,NaN,45.82606797080403,NaN,NaN,42.973800000000004,50.7224761604804,35.22512383951961,40.01986505510539,38.54,38.54,38.54,5134762,2277067.9,36.17453161699074,47.38758055986375,NaN,NaN,NaN,NaN,2.364620204579086,13.174442772450082,82934195,-0.3885720050026428,-0.6715192980265385,-0.28294729302389576
2025-04-03T13:30:00-04:00,38.3,38.83,37.835,38.25,NaN,NaN,NaN,45.3132921539493,NaN,NaN,42.76339999999999,50.44209635810674,35.08470364189324,38.33424434240355,38.48872290428792,38.58578359121901,38.391662217356824,1433113,2269334.6333333333,36.04365539148582,45.53358681770275,NaN,NaN,NaN,NaN,2.266790189966294,14.045328014847906,81501082,-0.5208723332454377,-0.9340377095806929,-0.4131653763352552
2025-04-04T09:30:00-04:00,35.58,36.25,31.58,34.17,NaN,NaN,NaN,41.488028874224334,NaN,NaN,42.44879999999999,50.22052582120607,34.677074178793916,38.33424434240355,34,34,34,5981717,2366661,28.49430601014636,43.917684573711256,NaN,NaN,NaN,NaN,2.581305176397273,16.342642916663287,75519365,-0.8330999460016318,-1.454540308837295,-0.6214403628356632
2025-04-04T13:30:00-04:00,34.155,35.14,33.73,34.5,NaN,NaN,NaN,41.488028874224334,NaN,NaN,42.13659999999999,49.90634914395574,34.36685085604424,38.33424434240355,34.125219567893204,34.32894404479199,33.92149509099442,2259872,2411466.8333333335,29.77547948563351,42.35917948821358,NaN,NaN,NaN,NaN,2.4976405209403256,18.475863896920426,77779237,-0.9584003067961023,-1.8194407463307911,-0.8610404395346888
2025-04-07T09:30:00-04:00,30.46,37.1,29.67,35.45,NaN,NaN,NaN,41.48193333374573,NaN,NaN,41.87299999999999,49.63797083059557,34.10802916940441,38.33424434240355,34.07333333333334,34.07333333333334,34.07333333333334,5878921,2506245.066666667,33.470976135661786,41.1677953669082,NaN,NaN,NaN,NaN,2.849951912301731,21.12410837038457,83658158,-0.9182184957511608,-2.00881355922364,-1.090595063472479
2025-04-07T13:30:00-04:00,35.46,36.25,34.45,35.455,NaN,NaN,NaN,41.48193333374573,NaN,NaN,41.64409999999999,49.477285224415546,33.81091477558443,38.33424434240355,34.46316049286489,35.062625318030626,33.86369566769915,2486076,2535765.433333333,33.490814083537074,40.01685353375813,NaN,NaN,NaN,NaN,2.7749553471373214,23.583192524315557,86144234,-0.834636948871331,-2.1338912495616427,-1.2992543006903117
2025-04-08T09:30:00-04:00,37.135,37.86,34.31,34.38,NaN,NaN,NaN,41.48193333374573,NaN,NaN,41.427899999999994,49.452071007649295,33.40372899235069,38.33424434240355,35.51666666666667,35.51666666666667,35.51666666666667,4467757,2556537.8666666667,31.327896496435372,39.23689234028787,NaN,NaN,NaN,NaN,2.8303156794846553,25.04470760970033,81676477,-0.7952555416490921,-2.2933237277516767,-1.4980681861025846
2025-04-08T13:30:00-04:00,34.38,35.8,33.085,34.16,NaN,NaN,NaN,41.48193333374573,NaN,NaN,41.187699999999985,49.347560589495565,33.027839410504406,38.33424434240355,35.13425373089758,35.68247460473732,34.586032857057845,2173920,2586525.8,30.888247150713397,38.26282139711639,NaN,NaN,NaN,NaN,2.822078845235751,26.63025015077852,79502557,-0.7292657132993392,-2.4096503277267587,-1.6803846144274195
2025-04-09T09:30:00-04:00,33.71,39.74,33.55,38.155,NaN,NaN,NaN,41.48193333374573,NaN,NaN,41.02189999999998,49.084034429541866,32.959765570458096,38.33424434240355,37.14833333333333,37.14833333333333,37.14833333333333,4018768,2634136.8666666667,45.77106207123921,38.4432018085485,NaN,NaN,NaN,NaN,3.0626446420046265,26.364617898248184,83521325,-0.37940394085540396,-2.1546395404966745,-1.7752355996412705
2025-04-09T13:30:00-04:00,38.2,42.69,37.98,42.23,31.50827693454164,31.50827693454164,31.50827693454164,NaN,NaN,NaN,40.90409999999998,48.71618184544972,33.09201815455024,33.245395473922834,39.406887589857575,41.28381211502228,37.52996306469287,5819161,2743294.966666667,56.14508028514714,39.31549966544252,NaN,NaN,NaN,NaN,3.1803128818614392,25.08572532295909,89340486,0.13601308583478744,-1.6052192423477862,-1.7412323281825737
2025-04-10T09:30:00-04:00,40.2,42.13,37.78,39.5,31.50827693454164,NaN,NaN,NaN,NaN,NaN,40.77589999999998,48.4645851125537,33.08721488744626,33.03281637913827,39.803333333333335,39.803333333333335,39.803333333333335,5354607,2818563.9,49.33584700290619,39.63972568872394,NaN,NaN,NaN,NaN,3.271004818871336,23.953833707326794,83985879,0.29358872270848124,-1.3742464247969721,-1.6678351475054534
2025-04-10T13:30:00-04:00,39.5,41.25,39.38,40.49,31.50827693454164,NaN,NaN,NaN,NaN,NaN,40.68949999999998,48.29151558798737,33.08748441201259,32.63861107001141,39.96400774852282,40.22046076363772,39.70755473340792,2101868,2853926.6666666665,51.626963069524336,40.04748884985753,NaN,NaN,NaN,NaN,3.170933046094812,22.90279149281109,86087747,0.45534849503439156,-1.098649528712464,-1.5539980237468556
2025-04-11T09:30:00-04:00,40.61,42.24,40.09,41.94,32.39854129327482,NaN,NaN,NaN,NaN,NaN,40.666499999999985,48.246251513077496,33.086748486922474,33.84668886784584,41.42333333333333,41.42333381017049,41.423332856496174,3302813,2893637.8,54.847619840061995,40.38157444380708,NaN,NaN,NaN,NaN,3.09800925708804,21.563326193370244,89390560,0.6395693818693122,-0.7545362964102154,-1.3941056782795276
2025-04-11T13:30:00-04:00,41.975,43.785,41.83,43.68,34.17292577994414,NaN,NaN,NaN,NaN,NaN,40.65179999999998,48.20522061850144,33.09837938149852,36.092851094276675,42.235612940258534,43.07273311190244,41.39849276861463,3109707,2953875.7666666666,58.4248041958295,41.12980591680811,NaN,NaN,NaN,NaN,3.0163657387246086,20.266802161613853,92500267,0.8452607113501736,-0.33752978909181053,-1.182790500441984
2025-04-14T09:30:00-04:00,44.93,45.05,42.51,43.33,35.19154278994668,NaN,NaN,NaN,NaN,NaN,40.77239999999998,48.30041706693093,33.24438293306903,37.62628087542134,43.629999999999995,43.629999999999995,43.629999999999995,3557899,2949451.2666666666,57.43904382400451,42.64869964588052,NaN,NaN,NaN,NaN,2.9823396145299936,19.47801528343908,88942368,0.9183211814309761,-0.03488902365326396,-0.95321020508424
2025-04-14T13:30:00-04:00,43.305,44.46,43.225,44.135,35.476018117676375,NaN,NaN,NaN,NaN,NaN,40.94289999999998,48.381132072206704,33.50466792779326,37.90352470033707,43.70990163097889,43.84549379509897,43.574309466858814,1235480,2944301.3333333335,59.14637287384751,44.2988937517635,NaN,NaN,NaN,NaN,2.8575296420635654,18.745570325133937,90177848,0.9760376097378528,0.266836807088076,-0.7092008026497768
2025-04-15T09:30:00-04:00,44.19,45.55,43.69,43.84,36.38017638505472,NaN,NaN,NaN,NaN,NaN,41.100099999999976,48.44376897129807,33.75643102870188,39.37481976026966,44.35999999999999,44.36000047683715,44.359999523162834,2401113,2908021.466666667,58.22460154047839,46.42248628964437,NaN,NaN,NaN,NaN,2.7862775247733107,18.433213730642724,87776735,0.9486870820364756,0.4766580498958177,-0.47202903214065783
2025-04-15T13:30:00-04:00,43.84,44.385,43.84,44.1,36.38017638505472,NaN,NaN,NaN,NaN,NaN,41.255099999999985,48.517899044445905,33.992300955554065,39.37481976026966,44.29563365726848,44.40543273214599,44.185834582390974,825150,2907777.9,58.833541678133415,48.49806216053722,NaN,NaN,NaN,NaN,2.626186273003788,18.14316832147231,88601885,0.9027085478458081,0.6563566526666023,-0.24635189517920583
2025-04-16T09:30:00-04:00,41.79,43.12,41.015,41.35,36.38017638505472,NaN,NaN,NaN,NaN,NaN,41.29709999999998,48.537285105368994,34.056914894630964,39.37481976026966,41.828333333333326,41.828333333333326,41.828333333333326,2632569,2899937.1,50.45609511950576,49.71128494509751,NaN,NaN,NaN,NaN,2.658958682074946,17.010544992577984,85969316,0.6533159873394394,0.5702930889950935,-0.08302289834434595
2025-04-16T13:30:00-04:00,41.35,41.35,40.08,40.7,36.38017638505472,NaN,NaN,NaN,NaN,NaN,41.33309999999999,48.543088318992176,34.1231116810078,39.37481976026966,41.39895813583528,41.94285291944928,40.85506335222128,1640680,2909027.033333333,48.69126433368491,50.797031391536635,NaN,NaN,NaN,NaN,2.5597473476410215,16.30329293034382,84328636,0.4220290807760646,0.44451345262573483,0.022484371849670212
2025-04-17T09:30:00-04:00,41.145,41.55,40.13,41.05,36.38017638505472,NaN,NaN,NaN,NaN,NaN,41.43009999999998,48.49018569069847,34.370014309301496,39.37481976026966,40.910000000000004,40.910000000000004,40.910000000000004,1548419,2827432.2666666666,49.71126283873936,52.110128987415486,NaN,NaN,NaN,NaN,2.4783368228095197,15.56055550085257,85877055,0.27707066333976044,0.36882270102437076,0.09175203768461032
2025-04-17T13:30:00-04:00,41.06,41.75,41.05,41.18,36.38017638505472,NaN,NaN,NaN,NaN,NaN,41.53369999999999,48.42195110169506,34.64544889830492,39.37481976026966,41.05223406382128,41.24980345504237,40.854664672600194,802521,2821455.6333333333,50.107996597417554,53.48296823360864,NaN,NaN,NaN,NaN,2.3513127640374116,14.780388274191,86679576,0.17914884407472037,0.3156880927780108,0.13653924870329043
2025-04-21T09:30:00-04:00,40.765,41.54,39.21,39.56,36.38017638505472,NaN,NaN,NaN,NaN,NaN,41.54629999999998,48.41773851315029,34.67486148684967,39.37481976026966,40.10333333333333,40.10333333333333,40.10333333333333,1775266,2775782.6333333333,45.310810131463136,53.450093095053205,NaN,NaN,NaN,NaN,2.349790423749025,14.777645772813376,84904310,0.0037526487324580082,0.14123005961886292,0.13747741088640492
2025-04-21T13:30:00-04:00,39.56,39.97,39.29,39.845,36.38017638505472,NaN,NaN,NaN,NaN,NaN,41.55849999999999,48.415631834812764,34.70136816518721,39.37481976026966,39.99452798329131,40.17303534467853,39.816020621904094,659556,2760257.6666666665,46.285101486123736,52.74580889512297,NaN,NaN,NaN,NaN,2.230519679195523,14.775099164391294,85563866,-0.08944432969150315,0.025671998772025972,0.11511632846352912
2025-04-22T09:30:00-04:00,41.11,43.36,40.85,42.11,36.38017638505472,NaN,NaN,NaN,NaN,NaN,41.56469999999999,48.423254486187524,34.70614551381245,39.37481976026966,42.10666666666667,42.10666666666667,42.10666666666667,3011672,2764220.7,53.391655565114824,53.03550950670929,NaN,NaN,NaN,NaN,2.3222682735387,14.179689744030163,88575538,0.0003279442742209343,0.1155262588063053,0.11519831453208436
2025-04-22T13:30:00-04:00,42.12,42.555,41.6,42.085,36.38017638505472,NaN,NaN,NaN,NaN,NaN,41.56579999999999,48.424670274323816,34.70692972567616,39.37481976026966,42.101042650419025,42.11192126281901,42.09016403801904,804922,2755744.7333333334,53.30782319590431,53.15557094430786,NaN,NaN,NaN,NaN,2.224606254000221,13.62680956798054,87770616,0.053932592397611445,0.18261405502909867,0.12868146263148722
2025-04-23T09:30:00-04:00,45.23,47.22,44.86,45.4,38.573599126863655,NaN,NaN,NaN,NaN,NaN,41.67639999999999,48.60035841697535,34.75244158302463,41.10203879090632,45.82666666666666,45.82666666666666,45.82666666666666,4050153,2785983.6666666665,61.85952674623537,53.656421437605964,NaN,NaN,NaN,NaN,2.4324915215716336,14.634240539214991,91820769,0.29508610295775095,0.4975390913286759,0.20245298837092496
2025-04-23T13:30:00-04:00,45.41,45.59,44.27,44.65,38.573599126863655,NaN,NaN,NaN,NaN,NaN,41.76759999999997,48.72561559067008,34.809584409329865,41.10203879090632,45.62209233974291,46.02293885453125,45.22124582495458,1054915,2778284.3333333335,59.21701199810799,53.71300770919728,NaN,NaN,NaN,NaN,2.3530278414593746,15.295422981184794,90765854,0.38105857721992376,0.6787762098958297,0.2977176326759059
2025-04-24T09:30:00-04:00,45.09,48.28,44.93,47.87,39.13511821270016,NaN,NaN,NaN,NaN,NaN,41.89099999999998,49.055624763377764,34.72637523662219,42.02150482618004,47.026666666666664,47.02666734101624,47.026665992317085,3704632,2815604.933333333,65.94352276089097,54.32047049040346,NaN,NaN,NaN,NaN,2.444240138497991,16.608639262682473,94470486,0.6177473809016014,1.0699018588029077,0.45215447790130625
2025-04-24T13:30:00-04:00,47.88,48.28,47.51,48.13,40.65965829394105,NaN,NaN,NaN,NaN,NaN,41.997199999999985,49.36820404558312,34.62619595441685,42.88820386094403,47.19657048710826,47.559854088651974,46.83328688556455,810326,2801277.8333333335,66.4250581705029,54.8403765830217,NaN,NaN,NaN,NaN,2.3246515571767064,17.828054381216027,95280812,0.7461863856653992,1.3848874599830552,0.638701074317656
2025-04-25T09:30:00-04:00,48.9,49.99,48.48,49.94,42.07490109876191,NaN,NaN,NaN,NaN,NaN,42.13899999999998,49.83576139684768,34.44223860315228,44.74656308875523,49.47,49.47,49.47,2942085,2728188.6,69.64299381721344,55.65597603135992,NaN,NaN,NaN,NaN,2.2914621602355134,19.370676896355445,98222897,0.8972601979559295,1.7602763217625679,0.8630161238066384
2025-04-25T13:30:00-04:00,49.93,49.93,48.67,49.445,42.29217832154546,NaN,NaN,NaN,NaN,NaN,42.25409999999999,50.20802398505316,34.300176014946814,45.10025047100418,49.44122307243768,49.49292492244112,49.38952122243424,911448,2710799.7666666666,67.73110961876495,56.291516598547894,NaN,NaN,NaN,NaN,2.218500577361548,20.803112088984903,97311449,0.9054567776292852,1.9948370958432449,1.0893803182139596
2025-04-28T09:30:00-04:00,50.5,51.07,47.75,47.91,42.29217832154546,NaN,NaN,NaN,NaN,NaN,42.34809999999999,50.454615870582266,34.24158412941771,45.54620037680335,48.910000000000004,48.910000000000004,48.910000000000004,2879424,2607390,62.043037818970596,57.11915536279538,NaN,NaN,NaN,NaN,2.2971791075500088,22.404805756283277,94432025,0.7552369081178161,2.03342645336123,1.2781895452434138
2025-04-28T13:30:00-04:00,47.91,49.025,47.88,48.915,42.29217832154546,NaN,NaN,NaN,NaN,NaN,42.439199999999985,50.73428995972935,34.14411004027062,45.54620037680335,48.84450912170488,48.96931501610041,48.71970322730935,792861,2558489.6333333333,64.16494932369892,58.2244185763678,NaN,NaN,NaN,NaN,2.214880599867865,23.892092733060338,95224886,0.6739749794948242,2.120658269611944,1.4466832901171198
2025-04-29T09:30:00-04:00,49.38,49.87,48.46,48.9,42.316193974063914,NaN,NaN,NaN,NaN,NaN,42.44999999999998,50.777240599382445,34.12275940061752,45.54620037680335,49.07666666666666,49.07666666666666,49.07666666666666,1835804,2423719.066666667,64.10734521072821,59.25271017436702,NaN,NaN,NaN,NaN,2.157389128448732,25.480749468025753,93389082,0.5735642944573911,2.1636386581888587,1.5900743637314676
2025-04-29T13:30:00-04:00,48.91,49.43,48.75,49.355,42.45977606615192,NaN,NaN,NaN,NaN,NaN,42.47029999999998,50.85959327416825,34.08100672583171,45.54620037680335,49.11682117317327,49.16652017150525,49.067122174841295,1198394,2380796.3333333335,65.12996191028788,60.3257076967149,NaN,NaN,NaN,NaN,2.0518613335595366,26.95593072192221,94587476,0.4951022668500116,2.208952197293982,1.7138499304439705
2025-04-30T09:30:00-04:00,46.49,48,46.19,47.47,42.45977606615192,NaN,NaN,NaN,NaN,NaN,42.473899999999986,50.871613329234485,34.07618667076549,45.54620037680335,47.22,47.22,47.22,2230009,2306204.7333333334,57.78473726359473,61.21670249186716,NaN,NaN,NaN,NaN,2.131371238305284,26.73441683725081,92357467,0.28404857009478524,2.068910643062452,1.7848620729676667
2025-04-30T13:30:00-04:00,47.47,49.89,47.41,49.04,42.45977606615192,NaN,NaN,NaN,NaN,NaN,42.49129999999998,50.93960321662308,34.042996783376886,45.54620037680335,47.83330124345555,48.59527993381795,47.071322553093154,1444670,2281896.4,61.662822705123745,62.31511115036716,NaN,NaN,NaN,NaN,2.15627329271205,27.11671757660758,93802137,0.22079539172045437,2.0608563126182347,1.8400609208977803
2025-05-01T09:30:00-04:00,51.14,51.3,46.54,47.44,42.45977606615192,NaN,NaN,NaN,NaN,NaN,42.54949999999998,51.09273972506935,34.00626027493061,45.54620037680335,48.42666666666667,48.42666666666667,48.42666666666667,7726997,2405504.033333333,56.01528144331476,62.50251299881001,NaN,NaN,NaN,NaN,2.342253771804046,27.859373847707285,86075140,0.05069131936466276,1.9034250701036086,1.8527337507389459
2025-05-01T13:30:00-04:00,47.44,47.53,46.55,46.61,42.45977606615192,NaN,NaN,NaN,NaN,NaN,42.58729999999998,51.18516931977944,33.989430680220515,45.54620037680335,48.11355654344817,48.73082515536879,47.49628793152755,1988184,2277804.8,53.28872714324455,62.5011489950486,NaN,NaN,NaN,NaN,2.2449499309609,28.54898324229987,84086956,-0.12844362136738452,1.692179224029715,1.8206228453970996
2025-05-02T09:30:00-04:00,46.71,50.06,46.7,48.87,42.45977606615192,NaN,NaN,NaN,NaN,NaN,42.68069999999998,51.44643921811526,33.9149607818847,45.54620037680335,48.54333333333333,48.54333333333333,48.54333333333333,6432200,2313724.566666667,59.123175609758654,62.30569534244312,NaN,NaN,NaN,NaN,2.331024935892265,29.825751969733176,90519156,-0.10635905564989478,1.6876740258347311,1.794033081484626
2025-05-02T13:30:00-04:00,48.89,49.02,48.15,48.57,42.45977606615192,NaN,NaN,NaN,NaN,NaN,42.77189999999998,51.684714345648814,33.85908565435115,45.54620037680335,48.55134273260209,48.566492897508304,48.53619256769587,1797731,2303586.6666666665,58.08601224613385,62.224909645873545,NaN,NaN,NaN,NaN,2.2266660118999604,31.011322930921242,88721425,-0.12244251655856564,1.6409799357864188,1.7634224523449844
2025-05-05T09:30:00-04:00,47.205,48.125,45.56,47.57,42.45977606615192,NaN,NaN,NaN,NaN,NaN,42.89949999999999,51.90031557415783,33.89868442584215,45.331414592923316,47.085,47.085,47.085,3564010,2312293.2333333334,54.64487286860544,61.417863224996005,NaN,NaN,NaN,NaN,2.2826184396213915,30.597966392578467,85157415,-0.20599912893103567,1.5059235411811898,1.7119226701122254
2025-05-05T13:30:00-04:00,47.58,48.335,47.56,48.01,42.45977606615192,NaN,NaN,NaN,NaN,NaN,43.021399999999986,52.13002668902409,33.91277331097588,45.331414592923316,47.30652211458342,47.68941350993318,46.923630719233664,1192949,2248401.3,55.883301725935,60.664880621812586,NaN,NaN,NaN,NaN,2.1749314082198636,30.28081490543154,86350364,-0.23509948019590388,1.4180483198673457,1.6531478000632496
2025-05-06T09:30:00-04:00,46.35,47.97,45.83,47.69,42.45977606615192,NaN,NaN,NaN,NaN,NaN,43.14699999999999,52.336119435506376,33.95788056449361,45.331414592923316,47.163333333333334,47.163333333333334,47.163333333333334,2387209,2209378.3,54.71321277803738,59.59846769044287,NaN,NaN,NaN,NaN,2.1752934504898733,29.0877734390393,83963155,-0.27650779872259745,1.3075130516600026,1.5840208503826
2025-05-06T13:30:00-04:00,47.68,48.88,47.28,48.68,42.45977606615192,NaN,NaN,NaN,NaN,NaN,43.28839999999998,52.59539080046848,33.981409199531484,44.81672427157673,47.450487141132484,47.93854223642551,46.962432045839456,826384,2195741.7666666666,57.66640598014186,58.87956028768407,NaN,NaN,NaN,NaN,2.134201061169168,28.309987794245334,84789539,-0.2392284633966706,1.2849852711367618,1.5242137345334323
2025-05-07T09:30:00-04:00,48.81,50.51,48.47,48.77,42.83813151258724,NaN,NaN,NaN,NaN,NaN,43.426799999999986,52.84920813380546,34.00439186619451,45.55233917916685,49.25,49.25,49.25,3286233,2225245.7666666666,57.934961226032016,58.58612624533132,NaN,NaN,NaN,NaN,2.1274724139427987,28.13402421635488,88075772,-0.21147412280494637,1.2598710810272493,1.4713452038321957
2025-05-07T13:30:00-04:00,48.76,50.02,48.35,49.99,42.83813151258724,NaN,NaN,NaN,NaN,NaN,43.58359999999999,53.17521405395368,33.9919859460463,45.55233917916685,49.311570221744546,49.40499605444275,49.218144389046344,1427269,2245316.4,61.50035295172999,58.395797933047824,NaN,NaN,NaN,NaN,2.094795812946885,27.90449062960252,89503041,-0.11854884036184976,1.3231591533798834,1.4417079937417332
2025-05-08T09:30:00-04:00,51.655,54.64,51.61,54.6,46.21263635754333,NaN,NaN,NaN,NaN,NaN,43.80919999999998,53.88386155461335,33.73453844538662,48.47409707466679,53.61666666666666,53.616667620340976,53.616665712992344,5128842,2328525.5,71.37391218625773,58.91483843129993,NaN,NaN,NaN,NaN,2.277310397736393,28.94492800138621,94631883,0.22696510613434695,1.7254143764096668,1.4984492702753198
2025-05-08T13:30:00-04:00,54.59,54.84,54.02,54.06,47.72001652310956,NaN,NaN,NaN,NaN,NaN,44.036799999999985,54.50560618981951,33.56799381018046,49.497277659733435,53.77528770643876,54.06561146224497,53.48496395063255,1531002,2324869.566666667,69.13721901333655,59.20107108151769,NaN,NaN,NaN,NaN,2.173216797898079,29.9553464866278,93100881,0.38350605374520486,1.9778318374568258,1.594325783711621
2025-05-09T09:30:00-04:00,54.92,56.31,53.75,54.13,48.2759248629682,NaN,NaN,NaN,NaN,NaN,44.35319999999999,55.06401617058212,33.64238382941785,50.75582212778674,54.73,54.73,54.73,4687451,2429503.966666667,69.27164868347786,60.02156475436649,NaN,NaN,NaN,NaN,2.2008441694767877,31.213178681285452,97788332,0.45145093858166985,2.158639456938708,1.7071885183570383
2025-05-09T13:30:00-04:00,54.13,54.69,54.07,54.65,48.2759248629682,NaN,NaN,NaN,NaN,NaN,44.68119999999998,55.62621028962536,33.7361897103746,50.75582212778674,54.687137626696114,54.783610597078784,54.59066465631344,925290,2433596.2666666666,70.30634688398075,60.63895933857056,NaN,NaN,NaN,NaN,2.087926728799874,32.38116571918185,98713622,0.48799274523516756,2.3171794499009977,1.82918670466583
2025-05-12T09:30:00-04:00,59.19,59.33,55.89,57.51,50.73709269539045,NaN,NaN,NaN,NaN,NaN,45.147999999999975,56.24975950018767,34.04624049981228,53.18732616178352,57.57666666666666,57.57666666666666,57.57666666666666,3640327,2495764.966666667,75.24382658736057,62.01242684885955,NaN,NaN,NaN,NaN,2.2730748195998833,34.302764238207445,102353949,0.6511572281312108,2.6431332398298437,1.991976011698633
2025-05-12T13:30:00-04:00,57.515,57.675,56.96,57.44,50.73709269539045,NaN,NaN,NaN,NaN,NaN,45.60679999999998,56.80609207762726,34.407507922372695,53.18732616178352,57.52753324229064,57.61871093107094,57.43635555351033,1057103,2509016.533333333,74.91548192513746,63.557195047566175,NaN,NaN,NaN,NaN,2.1617837610570345,36.08710572015978,101296846,0.6966631255730302,2.8628049186649207,2.1661417930918905
2025-05-13T09:30:00-04:00,58.92,63.37,58.83,62.685,53.93599768319667,NaN,NaN,NaN,NaN,NaN,46.15149999999998,57.95479178661644,34.348208213383515,56.18768874354145,61.62833333333334,61.62833333333334,61.62833333333334,5896703,2605184.2333333334,81.44801488611066,65.15182642444846,NaN,NaN,NaN,NaN,2.430942063838675,38.44590675289473,107193549,1.003640453746145,3.420692360274572,2.417051906528427
2025-05-13T13:30:00-04:00,62.69,63.41,62.165,62.54,55.77936142486954,NaN,NaN,NaN,NaN,NaN,46.693199999999976,58.960121661117995,34.42627833888196,57.04165099483316,61.88172131431693,62.33845857352783,61.42498405510602,1814882,2638849.566666667,80.82138754067809,66.77578180263019,NaN,NaN,NaN,NaN,2.3462319164216265,40.64024254583082,105378667,1.1121460427725376,3.807234459994099,2.6950884172215614
2025-05-14T09:30:00-04:00,62.375,63.77,61.23,61.35,55.77936142486954,NaN,NaN,NaN,NaN,NaN,47.23259999999998,59.6571768121094,34.808023187890555,57.40532079586653,62.116666666666674,62.116666666666674,62.116666666666674,3274333,2612988.9,75.67563878782329,68.27797936828861,NaN,NaN,NaN,NaN,2.360072493820082,42.147878004373624,102104334,1.0213410839796104,3.9717647721960745,2.950423688216464
2025-05-14T13:30:00-04:00,61.34,61.84,61.09,61.34,55.77936142486954,NaN,NaN,NaN,NaN,NaN,47.776199999999974,60.243684679758324,35.308715320241625,57.40532079586653,61.900201872993534,62.22148873865601,61.57891500733106,1486317,2627368.966666667,75.63206092453301,69.68860502533133,NaN,NaN,NaN,NaN,2.245067315690076,43.46669040722372,100618017,0.8833492814669031,4.054610290050093,3.1712610085831896
2025-05-15T09:30:00-04:00,60.205,60.38,57.68,59.77,55.77936142486954,NaN,NaN,NaN,NaN,NaN,48.20849999999998,60.80982298609973,35.60717701390023,57.40532079586653,59.27666666666667,59.27666666666667,59.27666666666667,2682881,2593310.6,68.92163982691606,70.70349267167981,NaN,NaN,NaN,NaN,2.3461339359979285,42.90674902067519,97935136,0.6214465505288649,3.948069196744271,3.326622646215406
2025-05-15T13:30:00-04:00,59.79,60.825,59.55,60.68,55.77936142486954,NaN,NaN,NaN,NaN,NaN,48.57749999999997,61.53251312234027,35.622486877659675,57.40532079586653,59.587048455208595,60.074207123430604,59.09988978698659,1089063,2602601.8333333335,70.55250699572107,71.62392845850688,NaN,NaN,NaN,NaN,2.269624369140934,42.485171079096375,99024199,0.45245962801037587,3.8921971812283758,3.439737553218
2025-05-16T09:30:00-04:00,60.88,62.13,60.49,61.54,55.77936142486954,NaN,NaN,NaN,NaN,NaN,49.01829999999998,62.20561126651695,35.83098873348302,57.40532079586653,61.38666666666666,61.38666666666666,61.38666666666666,1901561,2567917.7,72.04548757543014,72.63182319774963,NaN,NaN,NaN,NaN,2.2246511999165817,42.37848069670815,100925760,0.34634697764070266,3.8726712752688783,3.5263242976281757
2025-05-16T13:30:00-04:00,61.55,61.94,61.08,61.73,55.77936142486954,NaN,NaN,NaN,NaN,NaN,49.44309999999998,62.87037789092063,36.01582210907933,57.40532079586653,61.43682935890465,61.522555864609885,61.35110285319942,651091,2559239.1333333333,72.37867619070941,73.40884628624815,NaN,NaN,NaN,NaN,2.1271761142082544,42.279411055919084,101576851,0.24165807387338667,3.828396889969909,3.5867388160965223
2025-05-19T09:30:00-04:00,59.82,63.48,59.7,63.32,55.77936142486954,NaN,NaN,NaN,NaN,NaN,49.87069999999998,63.67150331140205,36.06989668859791,57.853889534711634,62.166666666666664,62.166666666666664,62.166666666666664,2602729,2550015.966666667,75.05784685919271,73.67198447717207,NaN,NaN,NaN,NaN,2.245234963193379,42.523395934343654,104179580,0.23214345393154057,3.876918133510948,3.6447746795794074
2025-05-19T13:30:00-04:00,63.31,64.35,63.16,64.27,57.10170761030747,NaN,NaN,NaN,NaN,NaN,50.282499999999985,64.54100837219679,36.02399162780318,59.254111627769305,62.688001832253605,63.49159348014197,61.88441018436524,1095449,2560102.2333333334,76.52308457949846,74.1995463033265,NaN,NaN,NaN,NaN,2.1698610372509943,42.929365134969466,105275029,0.24140859662612568,3.9465354253620646,3.705126828735939
2025-05-20T09:30:00-04:00,64.1,65.27,63.65,64.69,57.88822090074804,NaN,NaN,NaN,NaN,NaN,50.70969999999998,65.3832873473398,36.03611265266016,60.383289302215445,64.53666666666666,64.53666666666666,64.53666666666666,2474752,2581400.5,77.16185578173045,74.76313252463024,NaN,NaN,NaN,NaN,2.1305852488759234,43.491452403133124,107749781,0.22758525577977728,3.9896083984606605,3.7620231426808832
2025-05-20T13:30:00-04:00,64.69,65.25,63.36,64.885,57.88822090074804,NaN,NaN,NaN,NaN,NaN,51.124699999999976,66.19925676429692,36.05014323570303,60.39563144177236,64.52312892227768,64.5414503944794,64.50480745007596,1351150,2586492.3666666667,77.4683813384924,75.27470641423822,NaN,NaN,NaN,NaN,2.113400588241929,43.83348303976452,109100931,0.18513745592472208,3.9934449625867856,3.8083075066620635
2025-05-21T09:30:00-04:00,64,66.88,63.84,63.85,58.711519457086546,NaN,NaN,NaN,NaN,NaN,51.52489999999998,66.86474791189295,36.18505208810702,61.47650515341789,64.85666666666667,64.85666666666667,64.85666666666667,3082640,2614913.4,71.94863807444881,75.0393358061731,NaN,NaN,NaN,NaN,2.1795862605103618,44.4902852537033,106018291,0.048055891313769195,3.868377370804275,3.820321479490506
2025-05-21T13:30:00-04:00,63.83,65.21,63.32,63.83,58.711519457086546,NaN,NaN,NaN,NaN,NaN,51.91949999999998,67.48841149053163,36.350588509468324,61.47650515341789,64.58933777109706,64.943551757266,64.23512378492813,1755833,2625285.5,71.84211398543033,74.81980952476545,NaN,NaN,NaN,NaN,2.158901527616764,44.765912891965996,104262458,-0.0764888418741263,3.7247104271478477,3.801199269021974
2025-05-22T09:30:00-04:00,64.89,65.68,63.75,65.01,58.711519457086546,NaN,NaN,NaN,NaN,NaN,52.39269999999998,68.08559905785442,36.69980094214553,61.47650515341789,64.81333333333333,64.81333333333333,64.81333333333333,2012846,2434813.8,74.26323197393859,74.30661074532459,NaN,NaN,NaN,NaN,2.1425514185012813,45.128495380130786,106275304,-0.10989136116678733,3.6638350675634896,3.773726428730277
2025-05-22T13:30:00-04:00,65.03,65.87,64.7,64.79,58.856950759962295,NaN,NaN,NaN,NaN,NaN,52.87449999999998,68.58107381480775,37.167926185192215,61.47650515341789,64.91703460384382,65.06211309794577,64.77195610974186,1028425,2402821.8333333335,73.00291020384503,73.74814807840794,NaN,NaN,NaN,NaN,2.073083460036904,45.50970385080964,105246879,-0.17351095595554344,3.556837733785848,3.7303486897413913
2025-05-23T09:30:00-04:00,62.85,64.45,62.64,63.84,58.856950759962295,NaN,NaN,NaN,NaN,NaN,53.33029999999998,68.9603773395402,37.70022266045976,61.47650515341789,63.64333333333334,63.64333333333334,63.64333333333334,2088558,2258033.7666666666,67.6628803922494,73.17580819300981,NaN,NaN,NaN,NaN,2.0785774986056973,44.501766127046196,103158321,-0.29892641199861103,3.3566906747431275,3.6556170867417386
2025-05-23T13:30:00-04:00,63.83,64.14,62.93,63.13,58.856950759962295,NaN,NaN,NaN,NaN,NaN,53.76929999999997,69.24188155706435,38.2967184429356,61.47650515341789,63.564327379641696,63.678269651630636,63.45038510765276,1004145,2231580.9,63.9007905217103,72.3378603070939,NaN,NaN,NaN,NaN,2.0165362487052905,43.56582395498014,102154176,-0.4405022781703307,3.104989239028825,3.5454915171991557
2025-05-27T09:30:00-04:00,64.9,67.13,63.84,66.37,58.92417411607915,NaN,NaN,NaN,NaN,NaN,54.30549999999998,69.62870504985847,38.982294950141494,61.53706464693757,65.78,65.78,65.78,2752589,2204533.533333333,71.64783790612418,72.53258874132294,NaN,NaN,NaN,NaN,2.1582122309406264,43.55822020918828,104906765,-0.33170176960760145,3.130864305189654,3.4625660747972553
2025-05-27T13:30:00-04:00,66.36,66.36,65.24,66.02,59.383302565348274,NaN,NaN,NaN,NaN,NaN,54.82899999999998,69.92715485415381,39.730845145846146,61.53706464693757,65.80555479691544,65.84717290274673,65.76393669108415,1037819,2199362.533333333,69.90265908147,72.48617103316215,NaN,NaN,NaN,NaN,2.084768500159154,43.55115958809584,103868946,-0.3000231000770297,3.087537199700968,3.3875602997779977
2025-05-28T09:30:00-04:00,66.19,66.61,64.81,65.21,59.383302565348274,NaN,NaN,NaN,NaN,NaN,55.290999999999976,70.21681254069635,40.3651874593036,61.678521374040045,65.54333333333334,65.54333333333334,65.54333333333334,1364818,2165282.8333333335,65.9019517667382,72.04734704682701,NaN,NaN,NaN,NaN,2.0644278930049285,43.25268679484372,102504128,-0.34701586537945195,2.9537904680536826,3.3008063334331346
2025-05-28T13:30:00-04:00,65.21,65.95,65.05,65.1,59.383302565348274,NaN,NaN,NaN,NaN,NaN,55.75129999999997,70.43727355438207,41.06532644561786,61.678521374040045,65.49064095774492,65.5714648397888,65.40981707570103,580084,2157072.8333333335,65.35491853384292,71.54565007133654,NaN,NaN,NaN,NaN,1.9812544720760052,42.975533486823906,101924044,-0.3953916394835386,2.8065667840787114,3.20195842356225
2025-05-29T09:30:00-04:00,66.3,66.53,63.78,64.44,59.383302565348274,NaN,NaN,NaN,NaN,NaN,56.13209999999998,70.71171976047411,41.55248023952585,61.678521374040045,64.91666666666667,64.91666666666667,64.91666666666667,1928216,2111805.6,62.02802195987637,70.61494829281393,NaN,NaN,NaN,NaN,2.0361648669277193,41.833111681642194,99995828,-0.47629685626929774,2.6065873532256276,3.0828842094949254
2025-05-29T13:30:00-04:00,64.44,64.805,63.635,63.96,59.383302565348274,NaN,NaN,NaN,NaN,NaN,56.51829999999998,70.88227237674896,42.154327623251,61.678521374040045,64.70613509821663,65.05339991643478,64.35887027999848,708710,2087853.6333333333,59.64980203125646,69.40971382508238,NaN,NaN,NaN,NaN,1.9742959478614543,40.67421465189637,99287118,-0.560776956006888,2.381913014486315,2.9426899704932032
2025-05-30T09:30:00-04:00,63.59,65.18,62.92,63.79,59.383302565348274,NaN,NaN,NaN,NaN,NaN,56.83669999999997,71.1253301106863,42.548069889313645,61.678521374040045,63.96333333333334,63.96333333333334,63.96333333333334,1820071,1977561.2666666666,58.79007523069841,68.09744378572294,NaN,NaN,NaN,NaN,1.994703380157065,39.11088279619591,97467047,-0.6220075367969837,2.1651805494969736,2.7871880862939573
2025-05-30T13:30:00-04:00,63.78,66.49,63.75,66.12,59.383302565348274,NaN,NaN,NaN,NaN,NaN,57.19650000000001,71.49604436337039,42.89695563662963,61.678521374040045,64.51787696343719,65.23812092985655,63.79763299701783,1078948,1962492.8,66.0190767504395,67.27963631514774,NaN,NaN,NaN,NaN,2.0479388530029885,38.22061076481374,98545995,-0.5044941207653482,2.1565704353372723,2.6610645561026205
2025-06-02T09:30:00-04:00,66,68.2,65.37,67.32,60.39534086646057,NaN,NaN,NaN,NaN,NaN,57.5441,71.96560972540661,43.12259027459339,62.662866467076356,66.96333333333332,66.96333333333332,66.96333333333332,2390629,1885932.0666666667,69.032073292207,67.07131025927333,NaN,NaN,NaN,NaN,2.103800363502775,38.021375270326956,100936624,-0.3520717937866813,2.220974813869269,2.57304660765595
2025-06-02T13:30:00-04:00,67.33,68.18,67.25,68,61.488961736166914,NaN,NaN,NaN,NaN,NaN,57.915200000000006,72.43854382434012,43.3918561756599,63.28529317366109,67.21210730032566,67.5977757314074,66.82643886924392,994704,1888245.8666666667,70.62172541583915,66.98413964715967,NaN,NaN,NaN,NaN,2.0199574803954343,37.836370882589236,101931328,-0.2181422103209143,2.300368844754807,2.5185110550757215
2025-06-03T09:30:00-04:00,69.9,72.62,69.06,72.47,64.26696347543205,NaN,NaN,NaN,NaN,NaN,58.406400000000005,73.20171885969334,43.611081140306666,66.39423453892887,71.38333333333334,71.38333333333334,71.38333333333334,3940390,1898247.9666666666,78.45204275490575,67.28334041722876,NaN,NaN,NaN,NaN,2.205674803224332,38.88694870540647,105871718,0.1395418057934128,2.6929383123174873,2.5533965065240745
2025-06-03T13:30:00-04:00,72.47,72.71,71.26,71.73,65.51301059018515,NaN,NaN,NaN,NaN,NaN,58.8627,73.8648049469733,43.86059505302669,67.00438763114309,71.50266362074429,71.7204117879795,71.28491545350907,1183400,1902457.8666666667,74.89323484835104,67.41836360612204,NaN,NaN,NaN,NaN,2.1516980315654504,39.88198395205959,104688318,0.28591230578679694,2.9107868887575705,2.6248745829707736
2025-06-04T09:30:00-04:00,72.99,73,71.14,71.82,65.63855556335854,NaN,NaN,NaN,NaN,NaN,59.321099999999994,74.4774032814735,44.164796718526496,67.50551010491448,71.98666666666666,71.98666666666666,71.98666666666666,2966000,1804767.7666666666,75.04152550914105,67.9454096859,NaN,NaN,NaN,NaN,2.130862457882204,40.87190161093354,107654318,0.34447961321289045,3.0554740994868865,2.710994486273996
2025-06-04T13:30:00-04:00,71.82,72.53,71.6,72.29,65.79907576502406,NaN,NaN,NaN,NaN,NaN,59.779799999999994,75.08932134588159,44.4702786541184,67.66940808393157,72.0227386165931,72.08777588861787,71.95770134456833,912401,1774685.0666666667,75.84392284875825,68.79849056640344,NaN,NaN,NaN,NaN,2.0450865680334758,41.791110865602214,108566719,0.3684089590663069,3.1715056851068795,2.8030967260405726
2025-06-05T09:30:00-04:00,73.525,76.75,71.77,73.925,67.5997995938866,NaN,NaN,NaN,NaN,NaN,60.308899999999994,75.70844860247553,44.90935139752445,70.37152646714526,74.14833333333333,74.14833333333333,74.14833333333333,5510677,1849229.8666666667,78.44057192738036,69.28368585363602,NaN,NaN,NaN,NaN,2.2547232417453706,43.46503763848741,114077396,0.44288138561218426,3.356698458055803,2.9138170724436185
2025-06-05T13:30:00-04:00,73.93,74.03,71.22,72.53,67.5997995938866,NaN,NaN,NaN,NaN,NaN,60.7787,76.20765405528194,45.34974594471807,70.37152646714526,73.81263126789386,74.4524131330767,73.17284940271102,1517222,1850260.0333333334,71.3893938667327,69.3898811954405,NaN,NaN,NaN,NaN,2.294385867334987,44.62197636505477,112560174,0.35075233066347833,3.3522574857729666,3.0015051551094882
2025-06-06T09:30:00-04:00,74.56,76.37,73.11,76.29,67.78211078699174,NaN,NaN,NaN,NaN,NaN,61.3557,76.90353805035285,45.80786194964715,70.37152646714526,75.25666666666667,75.25666666666667,75.25666666666667,3332449,1871912.3,77.30986568013856,70.20473218925481,NaN,NaN,NaN,NaN,2.40478687681106,46.08140745705927,115892623,0.4872108734860685,3.610518746967074,3.1233078734810054
2025-06-06T13:30:00-04:00,76.3,77.8,74.7,74.89,69.18565120576483,NaN,NaN,NaN,NaN,NaN,61.9213,77.33930840705443,46.50329159294557,70.54902155117837,75.53965668589183,75.8093440222698,75.26996934951386,3669312,1957920.6,71.38647886656267,70.63555792730622,NaN,NaN,NaN,NaN,2.454444957038841,47.638421565121384,112223311,0.4293807143797652,3.6600337664557117,3.2306530520759464
2025-06-09T09:30:00-04:00,72.06,72.06,68.57,71.17,NaN,NaN,NaN,77.92006021267903,77.92006021267903,77.92006021267903,62.36729999999999,77.53751690154773,47.197083098452254,70.54902155117837,70.60000000000001,70.60000000000001,70.60000000000001,5147741,2066126.6,58.54961812408458,70.38710051046395,NaN,NaN,NaN,NaN,2.730556031536067,45.82483387390154,107075570,0.10377008784239816,3.3603656618789444,3.256595574036546
2025-06-09T13:30:00-04:00,71.17,73.72,70.55,73.4,NaN,NaN,NaN,77.92006021267903,NaN,NaN,62.8639,77.81908081335028,47.90871918664972,70.54902155117837,71.10515322143169,71.96144563224303,70.24886081062036,1791508,2104140.5,62.86102837059729,70.61647382041686,NaN,NaN,NaN,NaN,2.761944886426348,44.54868597746202,108867078,0.00686748587249264,3.265179931377162,3.2583124455046693
2025-06-10T09:30:00-04:00,73.23,74.64,70.75,71.7,NaN,NaN,NaN,77.92006021267903,NaN,NaN,63.346500000000006,77.84683396167134,48.846166038328676,70.54902155117837,72.36333333333333,72.36333333333333,72.36333333333333,3519254,2134691.3333333335,57.91548250278019,70.55400291127985,NaN,NaN,NaN,NaN,2.842520251681609,43.5797911722456,105347824,-0.19242463378292118,3.0177816532760176,3.2102062870589387
2025-06-10T13:30:00-04:00,71.72,73.05,71.6,72.47,NaN,NaN,NaN,77.92006021267903,NaN,NaN,63.8357,77.87652690015089,49.79487309984911,70.54902155117837,72.36554221585025,72.36969066887201,72.3613937628285,997754,2131434.8333333335,59.47082832697853,70.08627088103263,NaN,NaN,NaN,NaN,2.7430545194186373,42.680103138830354,106345578,-0.2873770929885504,2.850984920823251,3.1383620138118014
2025-06-11T09:30:00-04:00,73.02,75.38,72.32,74.8,NaN,NaN,NaN,77.92006021267903,NaN,NaN,64.37790000000001,77.96949579887503,50.78630420112499,70.54902155117837,74.16666666666667,74.16666666666667,74.16666666666667,3325406,2159789.966666667,63.82730471387707,69.71450169686621,NaN,NaN,NaN,NaN,2.7656934823173063,42.38598620514704,109670984,-0.21174336352543222,2.873682809405011,3.0854261729304433
2025-06-11T13:30:00-04:00,74.79,74.94,73.24,74.89,NaN,NaN,NaN,77.92006021267903,NaN,NaN,64.9021,78.04587222718045,51.758327772819555,70.54902155117837,74.21300552958691,74.29459654464858,74.13141451452523,1072632,2150506.033333333,63.98832560401742,69.24068742459323,NaN,NaN,NaN,NaN,2.689572519294642,42.11287762386968,110743616,-0.17562332188048524,2.865897020579837,3.041520342460322
2025-06-12T09:30:00-04:00,73.46,75.59,73.22,74.83,NaN,NaN,NaN,77.92006021267903,NaN,NaN,65.42330000000001,78.02241244651768,52.824187553482346,70.54902155117837,74.54666666666667,74.54666666666667,74.54666666666667,1697526,2104335.566666667,63.784476047997444,68.19300408838549,NaN,NaN,NaN,NaN,2.6667459107735962,42.009831675524445,109046090,-0.1753355350183301,2.8223509236874094,2.9976864587057395
2025-06-12T13:30:00-04:00,74.84,75.03,73.36,73.87,NaN,NaN,NaN,77.92006021267903,NaN,NaN,65.90090000000001,77.92080127912857,53.88099872087145,70.54902155117837,74.41668945113975,74.62380160092096,74.20957730135854,668559,2068093.1,60.46537524547685,67.1624426881802,NaN,NaN,NaN,NaN,2.595549774289768,41.91414615206101,108377531,-0.25455806981561535,2.67948887143622,2.9340469412518355
2025-06-13T09:30:00-04:00,71.99,74.81,71.69,73.41,NaN,NaN,NaN,77.92006021267903,NaN,NaN,66.2771,78.03320566301603,54.520994336983975,70.54902155117837,73.30333333333333,73.30333333333333,73.30333333333333,1980638,2067019.5,58.88421593897788,66.00834914745425,NaN,NaN,NaN,NaN,2.633010504697642,40.89340439800641,106396893,-0.34697413643328856,2.5003292707102247,2.8473034071435133
2025-06-13T13:30:00-04:00,73.37,73.65,72.06,72.59,NaN,NaN,NaN,77.92006021267903,NaN,NaN,66.64770000000001,78.00130105164847,55.29409894835157,68.70953976440968,73.14889341576645,73.39185651506864,72.90593031646426,800283,2059414.7666666666,56.069489563561966,64.59588962708308,NaN,NaN,NaN,NaN,2.5585097543620963,39.94557276924144,105596610,-0.46499858500415003,2.266055175888326,2.731053760892476
2025-06-16T09:30:00-04:00,73.7,76.4,73.36,76.07,NaN,NaN,NaN,77.92006021267903,NaN,NaN,67.08650000000002,78.16354965232136,56.009450347678666,69.6148434875022,75.27666666666666,75.27666666666666,75.27666666666666,2599055,2076431.3333333333,63.946103635551935,63.560570463381055,NaN,NaN,NaN,NaN,2.647901914764804,39.843340918647876,108195665,-0.31741105439551554,2.3342899428980814,2.651700997293597
2025-06-16T13:30:00-04:00,76.08,76.88,75.97,76.75,NaN,NaN,NaN,77.92006021267903,NaN,NaN,67.52850000000001,78.3459354169551,56.711064583044916,70.99687479000175,75.59425300922611,76.14036571325629,75.04814030519593,878971,2072258.8666666667,65.25696110249297,63.12253955164965,NaN,NaN,NaN,NaN,2.5237660637101746,39.869215053001575,109074636,-0.18904587791849536,2.415393649895478,2.604439527813973
2025-06-17T09:30:00-04:00,76.17,77.03,73.56,73.6,NaN,NaN,NaN,77.92006021267903,NaN,NaN,67.8503,78.41070291087411,57.2898970891259,70.99687479000175,74.73,74.73,74.73,2020687,2047862.1333333333,55.23790537131121,61.54597095816199,NaN,NaN,NaN,NaN,2.5913542020165905,38.59661528934681,107053949,-0.32344879390241754,2.200128535435951,2.5235773293383685
2025-06-17T13:30:00-04:00,73.58,75.17,72.88,74.95,NaN,NaN,NaN,77.92006021267903,NaN,NaN,68.2005,78.51524968188754,57.88575031811247,70.99687479000175,74.61008468902645,74.79225692862063,74.42791244943227,875556,2042453.3666666667,58.19990572543827,60.6040728766531,NaN,NaN,NaN,NaN,2.5698289018725484,37.08491445339705,107929505,-0.32758734422303837,2.1140931490595705,2.441680493282609
2025-06-18T09:30:00-04:00,75.23,78.17,74.55,77.08,68.99985570442354,68.99985570442354,68.99985570442354,NaN,NaN,NaN,68.48840000000001,78.97346069414931,58.00333930585072,71.3214398924809,76.60000000000001,76.60000000000001,76.60000000000001,2791371,2090005.1333333333,62.42471848773648,60.88086575977109,NaN,NaN,NaN,NaN,2.644841123167367,36.580168060137744,110720876,-0.19933734854023832,2.192508807607311,2.3918461561475493
2025-06-18T13:30:00-04:00,77.08,78.74,76.85,78.34,70.20559167001909,NaN,NaN,NaN,NaN,NaN,68.80440000000002,79.50349896019246,58.10530103980758,72.31615191398471,77.08590465328943,77.74379933123828,76.42800997534059,1522674,2121424.8,64.6977635702284,61.01206113117331,NaN,NaN,NaN,NaN,2.5909239000839834,36.26266523027279,112243550,-0.04989889109385626,2.3294725422802287,2.379371433374085
2025-06-20T09:30:00-04:00,78.465,78.56,75.8,77.57,70.20559167001909,NaN,NaN,NaN,NaN,NaN,69.12880000000001,79.88757271067631,58.37002728932372,72.31615191398471,77.31,77.31,77.31,2710488,2147500.533333333,62.22065386672029,61.319573371454744,NaN,NaN,NaN,NaN,2.603000764363699,35.43358327320394,109533062,-0.024449855060989734,2.348809114547848,2.3732589696088375
2025-06-20T13:30:00-04:00,77.55,79.37,77.3,78.53,70.77832836049261,NaN,NaN,NaN,NaN,NaN,69.47260000000001,80.31214652926009,58.63305347073994,73.11973722495021,77.65081445660927,78.15611957618279,77.14550933703575,1233037,2164978.1,64.06781503409735,61.64792956482038,NaN,NaN,NaN,NaN,2.564929281194864,34.90543829920275,110766099,0.032411217752692956,2.4137729917997035,2.3813617740470105
2025-06-23T09:30:00-04:00,77.86,79.045,74.4,76.52,70.77832836049261,NaN,NaN,NaN,NaN,NaN,69.80760000000002,80.46071695983795,59.15448304016209,73.11973722495021,76.65499999999999,76.65499999999999,76.65499999999999,2719541,2194960.433333333,57.70600271986141,61.210693708104984,NaN,NaN,NaN,NaN,2.7135057611095164,33.065013915752154,108046558,-0.08363233798687819,2.276821351563413,2.3604536895502912
2025-06-23T13:30:00-04:00,76.52,77.06,76.06,76.33,70.77832836049261,NaN,NaN,NaN,NaN,NaN,70.12060000000001,80.60083447065924,59.64036552934078,73.11973722495021,76.61826773343337,76.68866976716386,76.54786569970288,740322,2183672.9,57.128523756803425,60.720707861875404,NaN,NaN,NaN,NaN,2.5911124924588367,31.356048416833744,107306236,-0.18562720707607872,2.1284196807051927,2.3140468877812714
2025-06-24T09:30:00-04:00,77.815,82.05,76.84,81.1,71.38535395816322,NaN,NaN,NaN,NaN,NaN,70.51180000000002,81.1408548516784,59.88274514832164,74.10346545917452,79.99666666666666,79.99666666666666,79.99666666666666,3922873,2234747.7,66.2578278647832,60.89737584878867,NaN,NaN,NaN,NaN,2.8146044572832056,31.245918603388446,111229109,0.04348880252414533,2.368407890936453,2.3249190884123077
2025-06-24T13:30:00-04:00,81.09,82.26,81.08,81.99,73.81579241461036,NaN,NaN,NaN,NaN,NaN,70.91700000000002,81.71933234074912,60.11466765925091,75.3127723673396,80.40619168332479,81.15535374215034,79.65702962449924,1172232,2240665.3,67.6423579989805,61.41001747403893,NaN,NaN,NaN,NaN,2.6978469960486917,31.194827334081694,112401341,0.22041640099333248,2.6004395896539734,2.380023188660641
2025-06-25T09:30:00-04:00,84.96,85.55,81.94,82.96,75.75552912303715,NaN,NaN,NaN,NaN,NaN,71.30980000000002,82.40298582914701,60.21661417085304,78.18721789387168,83.48333333333333,83.48333333333333,83.48333333333333,3267190,2218225.3,69.12913092099907,62.14179711561187,NaN,NaN,NaN,NaN,2.763000782045214,31.87639180690896,115668531,0.3599615168942618,2.829975084778468,2.470013567884206
2025-06-25T13:30:00-04:00,82.95,83.03,81.91,82.75,75.75552912303715,NaN,NaN,NaN,NaN,NaN,71.67940000000002,83.03800495659516,60.32079504340487,78.18721789387168,83.30961381702042,83.66967420731618,82.94955342672466,760538,2204129.9,68.3964187868581,63.02229206013302,NaN,NaN,NaN,NaN,2.645643583327699,32.49479107390659,114907993,0.39263556296299607,2.960808021587951,2.568172458624955
2025-06-26T09:30:00-04:00,83.335,84.28,82.53,84.06,75.75552912303715,NaN,NaN,NaN,NaN,NaN,72.06680000000001,83.761747415016,60.371852584984026,78.24481945207788,83.62333333333333,83.62333333333333,83.62333333333333,1608380,2158875.9,70.49716108081394,63.490224734794594,NaN,NaN,NaN,NaN,2.581669041661435,33.32692419237491,116516373,0.45272001854418864,3.134072481805191,2.6813524632610024
2025-06-26T13:30:00-04:00,84.08,84.79,83.63,84.52,76.736101634903,NaN,NaN,NaN,NaN,NaN,72.45950000000002,84.47762202467536,60.441377975324684,79.3818555616623,83.85407782915185,84.17960920976257,83.52854644854112,808101,2155399.2333333334,71.22057979701597,63.916197498689094,NaN,NaN,NaN,NaN,2.4801212529713332,34.20329238996603,117324474,0.4715582065903883,3.2708002214989875,2.7992420149085993
2025-06-27T09:30:00-04:00,84.59,84.89,81.97,83.75,76.736101634903,NaN,NaN,NaN,NaN,NaN,72.85750000000002,85.02589319713147,60.68910680286856,79.3818555616623,83.53666666666668,83.53666762034099,83.53666571299236,1679101,2027680.0333333334,68.20573870339103,64.84247130812336,NaN,NaN,NaN,NaN,2.511541163473381,34.14887275134302,115645373,0.38398600123766835,3.2792245164556846,2.8952385152180162
2025-06-27T13:30:00-04:00,83.78,83.93,81.93,83.05,76.736101634903,NaN,NaN,NaN,NaN,NaN,73.24190000000003,85.45951202363148,61.02428797636858,79.3818555616623,83.33475226373544,83.60613526900788,83.063369258463,929493,2008089.0666666667,65.4915731031773,65.36330469224758,NaN,NaN,NaN,NaN,2.4750025089395677,34.0777361810302,114715880,0.23790055722322068,3.192614211747042,2.9547136545238213
2025-06-30T09:30:00-04:00,85.67,92.59,85.51,92.3,80.6255998535722,NaN,NaN,NaN,NaN,NaN,73.78770000000003,86.89167698563226,60.6837230143678,83.3166300475711,90.13333333333334,90.13333333333334,90.13333333333334,6928657,2127962.6666666665,77.96813751906782,66.47354890877125,NaN,NaN,NaN,NaN,2.9796451868724563,35.61174781572173,121644537,0.6972417206689161,3.8262658053599665,3.1290240846910504
2025-06-30T13:30:00-04:00,92.28,94.24,91.925,93.65,84.72534531477345,NaN,NaN,NaN,NaN,NaN,74.36490000000002,88.34580705068845,60.38399294931159,85.66380403805687,90.99033763252712,92.38858968066891,89.59208558438532,2602820,2092412.9333333333,79.1527991454973,67.50605144986189,NaN,NaN,NaN,NaN,2.932170530667281,37.24043635164437,124247357,1.0062244307165793,4.386804623086775,3.3805801923701955
2025-07-01T09:30:00-04:00,95.15,99.17,89.74,92.32,85.19180689137465,NaN,NaN,NaN,NaN,NaN,74.93450000000001,89.46367592294861,60.40532407705142,87.5940432304455,93.74333333333334,93.74333333333334,93.74333333333334,9186709,2227045.2,74.88093974052202,68.41035758370488,NaN,NaN,NaN,NaN,3.39630120704819,39.26225582925891,115060648,1.0314432628240473,4.669884270900255,3.6384410080762075
2025-07-01T13:30:00-04:00,92.32,94.37,91.74,92.33,85.19180689137465,NaN,NaN,NaN,NaN,NaN,75.51850000000002,90.44476225818067,60.59223774181936,87.5940432304455,93.53626693029811,93.9231716466758,93.14936221392043,2631305,2255038.433333333,74.89191203252784,69.18350736930705,NaN,NaN,NaN,NaN,3.3415654065447487,41.13965962990099,117691953,0.9606471824873943,4.83924998618545,3.878602803698056
2025-07-02T09:30:00-04:00,91.25,100.88,90.9,99.12,85.74653272540542,NaN,NaN,NaN,NaN,NaN,76.17350000000002,92.26523902970048,60.081760970299555,87.5940432304455,96.96666666666665,96.96666666666665,96.96666666666665,7724001,2395196.6666666665,80.9702146305279,70.84523679149751,NaN,NaN,NaN,NaN,3.815739306077266,43.39490370387343,125415954,1.2638763141008802,5.458448196324156,4.194571882223276
2025-07-02T13:30:00-04:00,99.14,99.65,97.3,97.97,88.47214487425062,NaN,NaN,NaN,NaN,NaN,76.81250000000001,93.7556487333374,59.86935126666263,87.7145101339881,97.30335916333277,97.8845700615619,96.72214826510364,2592040,2448339.533333333,77.54615217367441,72.303638821274,NaN,NaN,NaN,NaN,3.711043641357462,45.48905891541927,122823914,1.2760485498626934,5.789632569551642,4.513584019688949
2025-07-03T09:30:00-04:00,95.49,95.75,92.11,94.26,88.47214487425062,NaN,NaN,NaN,NaN,NaN,77.39350000000002,94.69389956185941,60.09310043814063,87.7145101339881,94.04,94.04,94.04,5659869,2526154.966666667,67.61259601863898,72.40040797512086,NaN,NaN,NaN,NaN,3.8645405241176434,45.4435965866222,117164045,0.9388722811650378,5.687174371145247,4.748302089980209
2025-07-07T09:30:00-04:00,93.59,95.685,91.25,93.18,88.47214487425062,NaN,NaN,NaN,NaN,NaN,77.95510000000002,95.44478044190598,60.465419558094055,87.7145101339881,93.37166666666667,93.37166666666667,93.37166666666667,3782681,2616489.933333333,65.00219604404526,72.21182497833976,NaN,NaN,NaN,NaN,3.905287629537812,45.111878918829085,113381364,0.566107051037231,5.455935903776748,4.889828852739517
2025-07-07T13:30:00-04:00,93.17,94.42,92.63,93.49,88.47214487425062,NaN,NaN,NaN,NaN,NaN,78.53610000000002,96.12111331133957,60.95108668866047,87.7145101339881,93.40216595128103,93.46039417146632,93.34393773109575,1037796,2594498.933333333,65.414949277373,71.94652628950932,NaN,NaN,NaN,NaN,3.754195655999397,44.80385537016406,114419160,0.27799259891196115,5.237319601379468,4.959327002467507
2025-07-08T09:30:00-04:00,95.43,98.04,90.7,92.14,88.47214487425062,NaN,NaN,NaN,NaN,NaN,79.09970000000001,96.58599136323622,61.6134086367638,87.7145101339881,93.62666666666667,93.62666666666667,93.62666666666667,4218574,2712832.7666666666,61.9864563549426,71.4886718300868,NaN,NaN,NaN,NaN,4.010324537713727,45.02602239167883,110200586,-0.048531873154800564,4.898662161024006,4.947194034178807
2025-07-08T13:30:00-04:00,92.15,92.84,91.07,91.25,88.47214487425062,NaN,NaN,NaN,NaN,NaN,79.64890000000001,96.90066318988838,62.397136810111654,87.7145101339881,93.18847066316695,93.99064145287345,92.38629987346046,1258835,2688772.6666666665,59.762649755164034,70.7219210211118,NaN,NaN,NaN,NaN,3.8503013564484614,45.23232034022825,108941751,-0.3525473099012739,4.506509896802214,4.859057206703488
2025-07-09T09:30:00-04:00,92.97,94.65,91.745,93.6,88.47214487425062,NaN,NaN,NaN,NaN,NaN,80.19850000000001,97.4421439594417,62.954856040558326,87.7145101339881,93.33166666666666,93.33166666666666,93.33166666666666,2646181,2750302.6,63.4874649585503,70.16955567550711,NaN,NaN,NaN,NaN,3.818136973845,45.66626516909874,111587932,-0.41894477042404077,4.335376243673437,4.754321014097478
2025-07-09T13:30:00-04:00,93.63,94.6,93.21,94.53,88.47214487425062,NaN,NaN,NaN,NaN,NaN,80.74270000000001,98.0436113297533,63.44178867024672,87.7145101339881,93.53555417332758,93.8787770634938,93.19233128316137,933788,2694793.7,64.87330288803832,69.93152454583905,NaN,NaN,NaN,NaN,3.644698618570357,46.06921393876421,112521720,-0.4225934450232387,4.2260792078184295,4.648672652841668
2025-07-10T09:30:00-04:00,95.88,97.68,93.54,97.43,88.47214487425062,NaN,NaN,NaN,NaN,NaN,81.33130000000001,98.85907507956988,63.80352492043015,88.51816162852107,96.2166666666667,96.2166666666667,96.2166666666667,3086288,2768370.933333333,68.84436594684838,70.17100974895843,NaN,NaN,NaN,NaN,3.6800772886724746,46.83961771815768,115608008,-0.2600371530360235,4.323626211546639,4.583663364582662
2025-07-10T13:30:00-04:00,97.43,98.75,97.21,98.735,88.47214487425062,NaN,NaN,NaN,NaN,NaN,81.85660000000001,99.85850072631187,63.854699273688155,90.65052930281685,96.92576512013119,97.88806069168085,95.96346954858153,1675840,2756876.033333333,70.46259149744859,69.63489931884276,NaN,NaN,NaN,NaN,3.52721462519587,47.68097680464564,117283848,-0.10302477387253894,4.454882397241988,4.557907171114527
2025-07-11T09:30:00-04:00,97.51,101.5,97.33,100.76,89.23263368155224,NaN,NaN,NaN,NaN,NaN,82.43720000000002,100.96024739075037,63.914152609249676,92.93542344225348,99.86333333333333,99.86333333333333,99.86333333333333,5384331,2907168.533333333,72.82158020375668,69.18266939443272,NaN,NaN,NaN,NaN,3.573127866253308,48.76268701312095,122668179,0.08846547201822652,4.668489011137311,4.580023539119084
2025-07-11T13:30:00-04:00,100.75,100.8,97.82,98.33,89.23263368155224,NaN,NaN,NaN,NaN,NaN,82.9674,101.76014671143089,64.1746532885691,92.93542344225348,99.6488597429349,100.02666635824548,99.27105312762433,1735163,2871961.6,66.00884462628943,68.54894831484468,NaN,NaN,NaN,NaN,3.5307615900923577,49.76713220670517,120933016,0.007018218700987511,4.588796312495319,4.581778093794331
2025-07-14T09:30:00-04:00,100.87,101.89,99.09,99.755,90.33891829248873,NaN,NaN,NaN,NaN,NaN,83.5167,102.6317657451132,64.4016342548868,93.43667100304222,100.245,100.24500134869916,100.24499865130085,3821004,2948572.6,67.90507489583419,68.04988851936656,NaN,NaN,NaN,NaN,3.5328500479429037,50.81836644590542,124754020,0.004769726239347349,4.587740251593516,4.582970525354169
2025-07-14T13:30:00-04:00,99.75,100.02,98.9,99.93,90.33891829248873,NaN,NaN,NaN,NaN,NaN,84.0368,103.49175769823208,64.58184230176792,93.43667100304222,100.08433708237536,100.35844890896695,99.81022525578376,1312663,2901978.433333333,68.14013393775755,67.13345418416868,NaN,NaN,NaN,NaN,3.3605036159469814,51.6968770707222,126066683,-0.027503598505653315,4.548591027222102,4.576094625727755
2025-07-15T09:30:00-04:00,98.9,101.22,98.12,100.38,90.33891829248873,NaN,NaN,NaN,NaN,NaN,84.59380000000002,104.29227410943268,64.89532589056735,93.81186944194702,99.90666666666668,99.90666801536584,99.90666531796752,3636347,2982088.7666666666,68.77345463879314,66.50683293167717,NaN,NaN,NaN,NaN,3.3418962148079108,52.65357764829498,129703030,-0.05929154162167283,4.5019801987006645,4.561271740322337
2025-07-15T13:30:00-04:00,100.4,101.26,97.17,99.55,90.33891829248873,NaN,NaN,NaN,NaN,NaN,85.05900000000001,105.04757233521164,65.07042766478838,93.81186944194702,99.67858650144926,99.9618989333376,99.39527406956093,2356726,2969994.933333333,66.16109662468517,66.40315440353761,NaN,NaN,NaN,NaN,3.3953321994644887,53.02754872440889,127346304,-0.17066035270064273,4.347946299446534,4.518606652147176
2025-07-16T09:30:00-04:00,100,104.16,99.71,104.02,91.82848319121602,NaN,NaN,NaN,NaN,NaN,85.6416,106.10312999557951,65.18007000442049,95.4777964428461,102.63,102.63,102.63,5635563,3133169.6333333333,72.27014503833593,66.9222936174155,NaN,NaN,NaN,NaN,3.4820941852170253,53.75205509167416,132981867,0.012551814722275623,4.534296420550021,4.521744605827745
2025-07-16T13:30:00-04:00,104.03,104.61,103.16,103.26,94.04014304616074,NaN,NaN,NaN,NaN,NaN,86.2834,106.90147570458504,65.66532429541496,96.93923715427688,102.855243276048,103.28538289933701,102.42510365275899,1545333,3053918.3,69.95763741392597,67.246771341455,NaN,NaN,NaN,NaN,3.3369446005586667,54.4788140087755,131436534,0.037002358037105054,4.567997553374127,4.530995195337022
2025-07-17T09:30:00-04:00,103.535,106.48,102.7,104.935,94.67718199860799,NaN,NaN,NaN,NaN,NaN,86.9141,107.84412462397015,65.98407537602986,98.45338972342151,104.705,104.705,104.705,3881947,3144242.1333333333,72.07821119432934,67.96761097283978,NaN,NaN,NaN,NaN,3.3685914148044764,55.37045862676872,135318481,0.1159741287388254,4.675962856260554,4.559988727521729
2025-07-17T13:30:00-04:00,104.93,106.63,104.61,105.45,95.88231008958036,NaN,NaN,NaN,NaN,NaN,87.5891,108.68915428334248,66.48904571665753,99.19871177873719,104.94151610511285,105.32501289637582,104.55801931384988,1476548,3084554.066666667,72.71589604623736,68.89284285077359,NaN,NaN,NaN,NaN,3.2722634566041564,56.215442683743774,136795029,0.150686099273047,4.748346351613037,4.59766025233999
2025-07-18T09:30:00-04:00,109.75,113.44,107.665,108.41,100.16788690369034,NaN,NaN,NaN,NaN,NaN,88.3079,109.7447703956524,66.87102960434761,103.49996942298976,109.83833333333332,109.83833333333332,109.83833333333332,7203515,3299319.966666667,76.09513105031766,69.79339042875696,NaN,NaN,NaN,NaN,3.609244638275288,57.611062063330735,143998544,0.3115279695961721,4.987070214335205,4.675542244739033
2025-07-18T13:30:00-04:00,108.43,109.76,106.95,109.75,100.16788690369034,NaN,NaN,NaN,NaN,NaN,89.0069,110.91053055659947,67.10326944340054,103.49996942298976,109.61506367232595,110.03638729687553,109.19374004777636,2022890,3313136.966666667,77.45635803171805,70.69218008187696,NaN,NaN,NaN,NaN,3.5521557355413393,58.54741692541088,146021434,0.43889937030087545,5.2241664576151265,4.785267087314251
2025-07-21T09:30:00-04:00,108.98,110.31,106.48,107.95,100.16788690369034,NaN,NaN,NaN,NaN,NaN,89.6681,111.82175937176078,67.51444062823921,103.49996942298976,108.24666666666667,108.24666666666667,108.24666666666667,3132245,3390608.433333333,71.5614666833537,70.88625870591304,NaN,NaN,NaN,NaN,3.572001754431244,59.465363915673905,142889189,0.3372273049507175,5.2068012185026475,4.86957391355193
2025-07-21T13:30:00-04:00,107.93,108.02,104.32,104.35,100.16788690369034,NaN,NaN,NaN,NaN,NaN,90.2585,112.37232945127327,68.14467054872672,103.49996942298976,107.40146467910377,108.6478964930615,106.15503286514604,1440256,3382646.933333333,61.48311969071443,70.24486786257489,NaN,NaN,NaN,NaN,3.581144486257584,59.22475929039891,141448933,-0.01831535405639073,4.846679720981442,4.864995075037832
2025-07-22T09:30:00-04:00,103.7,105.93,98.75,102.76,NaN,NaN,NaN,113.23122357413855,113.23122357413855,113.23122357413855,90.8363,112.71556889180718,68.95703110819281,103.49996942298976,102.48,102.48,102.48,3837599,3479583.8,57.623129327361326,69.15926422854665,NaN,NaN,NaN,NaN,3.838205594382043,56.78621581727511,137611334,-0.3860258005152044,4.382462824393826,4.768488624909031
2025-07-22T13:30:00-04:00,102.77,102.77,101.66,101.86,NaN,NaN,NaN,112.7625315934959,NaN,NaN,91.40529999999998,112.91890141027099,69.89169858972897,103.49996942298976,102.4204230980706,102.55930580095763,102.28154039518357,706186,3272168.1,55.49916677152036,68.408572953206,NaN,NaN,NaN,NaN,3.6433337662118968,54.521854020803005,136905148,-0.697172772284925,3.8970226595528743,4.594195431837799
2025-07-23T09:30:00-04:00,102.13,102.68,100.66,100.95,NaN,NaN,NaN,112.01355288470063,NaN,NaN,91.9725,112.9609502762829,70.98404972371709,103.49996942298976,101.43,101.43,101.43,2594622,3271894.8333333335,53.35760829691173,67.3694681961401,NaN,NaN,NaN,NaN,3.5273813543396195,52.064320608206685,134310526,-0.9556051943965338,3.3996889388421323,4.355294133238666
2025-07-23T13:30:00-04:00,100.91,102.145,100.59,102.09,NaN,NaN,NaN,111.45293684448697,NaN,NaN,92.49289999999999,113.16630621087893,71.81949378912105,103.49996942298976,101.47968591351007,101.55963567632713,101.399736150693,1002089,2999074.1666666665,55.66559095127768,66.47842941139155,NaN,NaN,NaN,NaN,3.386496971886789,49.7567099024481,135312615,-1.0344454750632686,3.0622372894095804,4.096682764472849
2025-07-24T09:30:00-04:00,102.98,103,100.33,101.52,NaN,NaN,NaN,111.45293684448697,NaN,NaN,92.9883,113.31316187997352,72.66343812002647,103.49996942298976,101.61666666666666,101.61666666666666,101.61666666666666,2062752,2980122.4,54.220905878140485,65.43896164277349,NaN,NaN,NaN,NaN,3.3353186167520184,47.83051206424166,133249863,-1.1033584376040864,2.717484717467741,3.8208431550718274
2025-07-24T13:30:00-04:00,101.54,102.87,101.54,101.92,NaN,NaN,NaN,111.45293684448697,NaN,NaN,93.5547,113.2556213398764,73.8537786601236,103.49996942298976,101.76235715076325,101.98740882260155,101.53730547892495,864460,2751471.033333333,55.10152432250222,64.64899219261757,NaN,NaN,NaN,NaN,3.1935101441268747,46.041899785907106,134114323,-1.0980187071291425,2.4483197711603992,3.5463384782895417
2025-07-25T09:30:00-04:00,101.55,106.38,101.06,105.44,NaN,NaN,NaN,111.45293684448697,NaN,NaN,94.16449999999999,113.4063532631346,74.92264673686537,100.90938043071345,104.29333333333334,104.29333333333334,104.29333333333334,3132796,2769496.2333333334,62.02448157180485,63.91715908786536,NaN,NaN,NaN,NaN,3.34540227668924,45.22196996812972,137247119,-0.8448050268296128,2.4903321947525257,3.3351372215821384
2025-07-25T13:30:00-04:00,105.44,105.68,104.5,104.83,NaN,NaN,NaN,111.45293684448697,NaN,NaN,94.71949999999998,113.55474985233823,75.88425014766173,100.90938043071345,104.44700835914512,104.73940065515569,104.15461606313454,865380,2609679.933333333,60.28958261784615,63.22658374528823,NaN,NaN,NaN,NaN,3.1907306854971518,44.46060656590786,136381739,-0.7111441064578186,2.4462070885098655,3.157351194967684
2025-07-28T09:30:00-04:00,105.865,106.76,104.68,106.55,NaN,NaN,NaN,111.45293684448697,NaN,NaN,95.2837,113.81009110134498,76.75730889865501,100.15726673249442,105.99666666666667,105.99666666666667,105.99666666666667,1712651,2540678.933333333,63.39839469875773,62.606596852747394,NaN,NaN,NaN,NaN,3.1113927793902123,43.994829309672475,138094390,-0.5091072682335458,2.5209671096757518,3.0300743779092976
2025-07-28T13:30:00-04:00,106.56,107.12,105.81,106.78,NaN,NaN,NaN,111.45293684448697,NaN,NaN,95.86789999999999,113.96025165366856,77.77554834633142,101.18281338599553,106.14270265134537,106.39250415066057,105.89290115203018,585327,2525596.6333333333,63.80643722469452,61.970206936922914,NaN,NaN,NaN,NaN,2.9827218665766257,43.64294583220931,138679717,-0.3687327949129524,2.569158384268107,2.9378911791810594
2025-07-29T09:30:00-04:00,106.555,107.4,103,105.1,NaN,NaN,NaN,111.45293684448697,NaN,NaN,96.3993,113.97695502107732,78.82164497892268,101.18281338599553,105.16666666666667,105.16666801536583,105.16666531796751,1716503,2442194.2666666666,58.66210436793153,60.72499074532391,NaN,NaN,NaN,NaN,3.08395601896401,41.998906926128974,136963214,-0.3954170804299064,2.4436198286436763,2.8390369090735827
2025-07-29T13:30:00-04:00,105.1,105.46,103.22,103.32,NaN,NaN,NaN,111.45293684448697,NaN,NaN,96.93529999999998,113.66974153953188,80.20085846046808,101.18281338599553,104.7826475254299,105.33087341920849,104.2344216316513,842231,2428307.466666667,53.72016609598776,59.02954846420032,NaN,NaN,NaN,NaN,3.023673446180866,40.47229937048295,136120983,-0.5308922560505707,2.1754215890103694,2.70631384506094
2025-07-30T09:30:00-04:00,103.83,107.07,103.37,106.41,NaN,NaN,NaN,111.45293684448697,NaN,NaN,97.53689999999999,113.40539607114677,81.66840392885321,101.18281338599553,105.61666666666667,105.61666666666667,105.61666666666667,1641842,2394829.5,60.017200146062414,58.204957997250936,NaN,NaN,NaN,NaN,3.0755539143108046,39.51387118969964,137762825,-0.4154515877583038,2.1869993603630604,2.6024509481213642
2025-07-30T13:30:00-04:00,106.43,107.46,104.4,106.15,NaN,NaN,NaN,111.45293684448697,NaN,NaN,98.0379,113.3717275834835,82.70407241651648,101.18281338599553,105.78721694206365,105.97920316565606,105.59523071847124,1295675,2406892.4,59.28623333118215,58.048037542998635,NaN,NaN,NaN,NaN,3.0744429204314607,38.73169974506603,136467150,-0.36163559572108195,2.150406453470012,2.512042049191094
2025-07-31T09:30:00-04:00,103.75,109.06,101.08,103.12,NaN,NaN,NaN,111.45293684448697,NaN,NaN,98.4605,113.15319604259199,83.767803957408,101.18281338599553,104.42,104.42,104.42,3991751,2437074.5,51.42563575891759,57.605359430966935,NaN,NaN,NaN,NaN,3.4248398546863568,36.54133700229502,132475399,-0.5252165682223784,1.855521338913121,2.3807379071354995
2025-07-31T13:30:00-04:00,103.08,104.47,101.92,103.05,NaN,NaN,NaN,111.45293684448697,NaN,NaN,98.86229999999999,112.92264796297731,84.80195203702267,101.18281338599553,104.14013116073366,104.66742591209058,103.61283640937674,1124516,2418697.033333333,51.25655615486375,57.30231581549146,NaN,NaN,NaN,NaN,3.362351293637331,34.50742874115052,131350883,-0.6263852018344114,1.5977564048424853,2.2241416066768966
2025-08-01T09:30:00-04:00,97.8,104.58,93.36,101.13,NaN,NaN,NaN,110.02016845331259,NaN,NaN,99.2299,112.52635689497768,85.93344310502232,101.18281338599553,99.69,99.69,99.69,5178778,2411845.2666666666,46.71927663731113,56.82814926837714,NaN,NaN,NaN,NaN,3.923611915520379,33.95835803318919,126172105,-0.7997665830944256,1.2244333778088645,2.02419996090329
2025-08-01T13:30:00-04:00,101.1,101.6,99,99.89,NaN,NaN,NaN,110.02016845331259,NaN,NaN,99.5465,112.11708522901765,86.97591477098234,101.18281338599553,99.8347069529621,100.0527769466917,99.6166369592325,2280417,2430020.4,44.00971045975352,55.99558637612541,NaN,NaN,NaN,NaN,3.829068207268923,33.44850666151081,123891688,-0.9641017358669397,0.8190727910696154,1.783174526936555
2025-08-04T09:30:00-04:00,101.185,106.22,97.2,105.93,NaN,NaN,NaN,110.02016845331259,NaN,NaN,99.97470000000001,111.91130176264525,88.03809823735477,101.18281338599553,103.11666666666667,103.11666666666667,103.11666666666667,3061930,2404717.933333333,57.07026915055289,56.19911232415486,NaN,NaN,NaN,NaN,4.199849049606857,31.45228189721937,126953618,-0.6473621921524053,0.9739717867460485,1.6213339788984538
2025-08-04T13:30:00-04:00,105.96,106.79,105.28,106.41,NaN,NaN,NaN,110.02016845331259,NaN,NaN,100.42790000000001,111.55959692185274,89.29620307814727,100.45025070879643,103.93421608083372,105.28317432302562,102.58525783864182,1124673,2398451.6,57.91052497732971,56.399755228071115,NaN,NaN,NaN,NaN,4.007716974634939,29.43400539403686,128078291,-0.3990491003566077,1.122522603452694,1.5215717038093017
2025-08-05T09:30:00-04:00,105.96,107.3,103.24,104.12,NaN,NaN,NaN,110.02016845331259,NaN,NaN,100.8493,110.85607670581244,90.84252329418756,100.15492836290377,104.88666666666666,104.88666666666666,104.88666666666666,1913597,2341026.6,52.619066034296345,55.727939832534794,NaN,NaN,NaN,NaN,4.011451476446729,28.096916960059275,126164694,-0.38250678072855737,1.043438227898605,1.4259450086271623
2025-08-05T13:30:00-04:00,104.12,105.6,103.5,105.45,NaN,NaN,NaN,110.02016845331259,NaN,NaN,101.11230000000002,110.89519204887704,91.329407951123,100.15492836290377,104.87459338528312,104.89182483493659,104.85736193562965,939415,2293782.9,55.180514583259836,55.36300640149292,NaN,NaN,NaN,NaN,3.874919228129105,26.855334842794377,127104109,-0.28020931333262156,1.0756833669613854,1.355892680294007
2025-08-06T09:30:00-04:00,104.48,105.45,101.18,103.815,NaN,NaN,NaN,110.02016845331259,NaN,NaN,101.31560000000002,110.89000058489236,91.74119941510767,100.15492836290377,103.48166666666667,103.48166666666667,103.48166666666667,2595020,2192431.466666667,51.495002000291834,54.51276406588821,NaN,NaN,NaN,NaN,3.90313928326274,26.29502985247198,124509089,-0.31810550246230074,0.958260802216131,1.2763663046784317
2025-08-06T13:30:00-04:00,103.79,105.89,103.6,105.65,NaN,NaN,NaN,110.02016845331259,NaN,NaN,101.58220000000001,110.8781206450995,92.28627935490053,99.22594269032302,103.92652053377405,104.63242515831114,103.22061590923697,1030584,2175273.1666666665,55.118148629245255,53.89217202335612,NaN,NaN,NaN,NaN,3.7879150487439732,25.616422011781907,125539673,-0.2197134584115692,1.0017244816639703,1.2214379400755395
2025-08-07T09:30:00-04:00,107.89,112.62,107.4,109.92,98.55635514657949,98.55635514657949,98.55635514657949,NaN,NaN,NaN,101.93400000000001,111.13358390363301,92.73441609636701,101.6129611158987,109.98,109.98,109.98,4402102,2192611.6666666665,62.19479517300333,54.14450708086125,NaN,NaN,NaN,NaN,4.015206830976546,24.545580159345008,129941775,0.11484031913171822,1.3649883389901873,1.2501480198584691
2025-08-07T13:30:00-04:00,109.92,111.29,108.58,111.23,98.63242991264406,NaN,NaN,NaN,NaN,NaN,102.17620000000001,111.69867143550402,92.65372856449599,101.6129611158987,110.0600142299499,110.21665572695873,109.90337273294107,1148632,2181681.1333333333,64.06669256172574,54.88354468555682,NaN,NaN,NaN,NaN,3.9219777716210795,23.5512270106536,131090407,0.39071580495493863,1.7385427760521424,1.3478269710972037
2025-08-08T09:30:00-04:00,111.545,117,110.93,114.11,102.3484558257057,NaN,NaN,NaN,NaN,NaN,102.49900000000001,112.51091989580341,92.48708010419661,105.83649511417516,114.01333333333334,114.01333333333334,114.01333333333334,3940755,2072922.4666666666,67.83712514184103,55.44211075668386,NaN,NaN,NaN,NaN,4.075407930791002,23.825885460043423,135031162,0.7146542373265237,2.241144767755358,1.5264905304288345
2025-08-08T13:30:00-04:00,114.14,115.87,114.01,114.62,103.59784419726452,NaN,NaN,NaN,NaN,NaN,102.90620000000003,113.19688968728408,92.61551031271597,106.00919609134013,114.2131709989236,114.56521047568137,113.86113152216583,1269847,2047821.0333333334,68.46809208614538,56.0979578106098,NaN,NaN,NaN,NaN,3.917164507163073,24.08092544876255,136301009,0.8988595007384075,2.6500649063518438,1.7512054056134363
2025-08-11T09:30:00-04:00,116.22,117.46,114.1,116.52,104.49521491557068,NaN,NaN,NaN,NaN,NaN,103.373,113.96949055112114,92.77650944887887,107.8913568730721,116.02666666666667,116.02666666666667,116.02666666666667,2873761,2039204.9,70.76882461879306,57.47961415774376,NaN,NaN,NaN,NaN,3.877367042365711,24.61407416342758,139174770,1.0724842467186453,3.091810714011743,2.0193264672930975
2025-08-11T13:30:00-04:00,116.52,116.83,113.4,113.64,104.49521491557068,NaN,NaN,NaN,NaN,NaN,103.77600000000002,114.3710452570991,93.18095474290095,107.8913568730721,115.56409647101088,116.22376986645524,114.90442307556653,1413019,2038297,63.2368370651533,58.33534850847873,NaN,NaN,NaN,NaN,3.8454122536253026,24.86130578142556,137761751,0.9228827916778757,3.1729299568904423,2.2500471652125666
2025-08-12T09:30:00-04:00,115.01,117.69,113.18,114.56,104.49521491557068,NaN,NaN,NaN,NaN,NaN,104.2244,114.70879729121302,93.74000270878699,107.93906839876615,115.14333333333333,115.14333333333333,115.14333333333333,2688219,1999984.3333333333,64.53534143966407,59.60792456578965,NaN,NaN,NaN,NaN,3.8928828069377803,25.26412025055307,140449970,0.8189354571920582,3.2737164867026394,2.454781029510581
2025-08-12T13:30:00-04:00,114.58,114.96,113.92,114.09,104.49521491557068,NaN,NaN,NaN,NaN,NaN,104.6812,114.8501489250364,94.51225107496361,107.93906839876615,115.01326185973656,115.3128282465468,114.71369547292632,506807,1993338.3666666667,63.30517333046837,60.98617191369785,NaN,NaN,NaN,NaN,3.6891054635850815,25.63816225760004,139943163,0.6584792597742561,3.2778801042284016,2.6194008444541454
2025-08-13T09:30:00-04:00,115.94,116.32,107.28,109.49,104.49521491557068,NaN,NaN,NaN,NaN,NaN,104.99900000000001,114.74733626830741,95.25066373169261,107.93906839876615,111.02999999999999,111.02999999999999,111.02999999999999,4738663,2064806.4,52.714133906714714,60.675019396280845,NaN,NaN,NaN,NaN,4.071312216186146,23.823606903302178,135204500,0.20594802184258665,2.876835871757379,2.6708878499147923
2025-08-13T13:30:00-04:00,109.5,109.73,107.94,108.64,104.49521491557068,NaN,NaN,NaN,NaN,NaN,105.28120000000001,114.60879702388519,95.95360297611484,107.93906839876615,110.5631100360384,111.47808822162807,109.64813185044872,1233853,2072531.8666666667,51.015698642669214,60.182531800947956,NaN,NaN,NaN,NaN,3.9083613436014217,22.138662645739878,133970647,-0.16708091566907868,2.462036705328444,2.6291176209975227
2025-08-14T09:30:00-04:00,107.88,110.89,106.35,109.69,104.49521491557068,NaN,NaN,NaN,NaN,NaN,105.52640000000001,114.65806294603546,96.39473705396456,107.93906839876615,108.97666666666667,108.97666666666667,108.97666666666667,2435748,2084965.0666666667,53.02899110772491,60.21181216333571,NaN,NaN,NaN,NaN,3.9534783904870348,20.97382453724454,136406395,-0.3490901857301907,2.1927548888347843,2.541845074564975
2025-08-14T13:30:00-04:00,109.69,111.46,109.1,110.73,104.49521491557068,NaN,NaN,NaN,NaN,NaN,105.76630000000002,114.80142076510279,96.73117923489724,107.93906839876615,109.41176156974149,110.07736682146347,108.7461563180195,1040799,2090843.0333333334,55.00175125346976,60.19904335406499,NaN,NaN,NaN,NaN,3.8396585054522463,19.719623373236285,137447194,-0.4016733316977592,2.039753409942776,2.441426741640535
2025-08-15T09:30:00-04:00,110.69,113.29,108.66,112.49,104.49521491557068,NaN,NaN,NaN,NaN,NaN,106.0009,115.11269821769571,96.8891017823043,107.93906839876615,111.48,111.48000134869916,111.47999865130085,2784660,2079238.5,58.20117991796388,60.67805606247014,NaN,NaN,NaN,NaN,3.896111469348515,18.607523249982414,140231854,-0.323513982361221,2.0370342636890086,2.3605482460502296
2025-08-15T13:30:00-04:00,112.5,114.355,112.05,114.17,104.49521491557068,NaN,NaN,NaN,NaN,NaN,106.3177,115.44210336898789,97.19329663101212,107.93906839876615,112.07903164477091,113.00971999331765,111.14834329622417,1153621,2088846.5333333334,61.04817017419728,61.10162902996671,NaN,NaN,NaN,NaN,3.7824606501093356,17.87499354860048,141385475,-0.1718730714149963,2.1457069067814842,2.3175799781964805
2025-08-18T09:30:00-04:00,112.97,114.46,109.79,113.86,104.49521491557068,NaN,NaN,NaN,NaN,NaN,106.59980000000002,115.76723125635488,97.43236874364516,107.93906839876615,112.70333333333332,112.70333468203248,112.70333198463416,2724077,2122560.7333333334,60.23291616400653,60.961494815038364,NaN,NaN,NaN,NaN,3.845856317958668,16.706388474369376,138661398,-0.10873002585381375,2.1816674458792136,2.2903974717330273
2025-08-18T13:30:00-04:00,113.87,115.085,113.66,115.03,104.49521491557068,NaN,NaN,NaN,NaN,NaN,106.90180000000001,116.16482018998113,97.63877981001889,107.93906839876615,113.19917550334219,114.03011222785376,112.36823877883062,969997,2135383.066666667,62.28029152017905,60.83389474064217,NaN,NaN,NaN,NaN,3.6729380095330484,15.596349846742447,139631395,-0.009667830441774328,2.2783126836808094,2.2879805141225837
2025-08-19T09:30:00-04:00,116.22,117.46,107.22,108.41,104.49521491557068,NaN,NaN,NaN,NaN,NaN,107.06240000000001,116.14423004465515,97.98056995534488,106.77593740739898,111.03000000000002,111.03000000000002,111.03000000000002,3812362,2205245.033333333,47.40788837700345,59.37466354315377,NaN,NaN,NaN,NaN,4.142013865994973,16.036495610751537,135819033,-0.39040277794722744,1.7999770416885497,2.190379819635777
2025-08-19T13:30:00-04:00,108.4,109.4,106.49,107.41,104.49521491557068,NaN,NaN,NaN,NaN,NaN,107.21960000000001,116.04431321686967,98.39488678313036,106.77593740739898,110.28922858574549,111.65621130704827,108.92224586444271,1119532,2214488.4,45.63510268253728,57.74373572861033,NaN,NaN,NaN,NaN,4.0540128755667615,16.595635050172756,134699501,-0.6923614467785888,1.324928011162541,2.01728945794113
2025-08-20T09:30:00-04:00,106.71,107.98,99.29,104.07,NaN,NaN,NaN,116.0653403396052,116.0653403396052,116.0653403396052,107.22060000000002,116.04387391391553,98.3973260860845,106.77593740739898,103.78000000000002,103.78000000000002,103.78000000000002,4494889,2309589.966666667,40.2246999874792,55.562012540659346,NaN,NaN,NaN,NaN,4.385154813026278,18.32397484691621,130204612,-1.07687079944976,0.6712009586289298,1.7480717580786898
2025-08-20T13:30:00-04:00,104.07,105.44,102.92,105.34,NaN,NaN,NaN,116.0653403396052,NaN,NaN,107.2622,116.02982594092578,98.49457405907424,106.77593740739898,103.94085785862762,104.2581373328679,103.62357838438734,1155366,2304913,42.99231636008931,54.11597534744049,NaN,NaN,NaN,NaN,4.251929469238687,19.928861801035133,131359978,-1.1963108692606814,0.2526831715028379,1.4489940407635193
2025-08-21T09:30:00-04:00,105,108.2,104.35,105.63,NaN,NaN,NaN,116.0653403396052,NaN,NaN,107.27610000000003,116.03111851282868,98.52108148717137,106.77593740739898,106.06,106.06,106.06,2874283,2267664.066666667,43.634086690310504,52.62302857962952,NaN,NaN,NaN,NaN,4.223220221435924,20.514472123967092,134234261,-1.20316407807679,-0.0549610568324681,1.148203021244322
2025-08-21T13:30:00-04:00,105.61,107.41,105.57,106.31,NaN,NaN,NaN,116.0653403396052,NaN,NaN,107.29330000000003,116.03727292081689,98.54932707918317,106.77593740739898,106.14313573716544,106.2975658895232,105.98870558480768,832992,2257946.6,45.19214826915591,51.32924107525006,NaN,NaN,NaN,NaN,4.052990205619073,21.058253138118204,135067253,-1.1114596238628631,-0.24112150858425707,0.870338115278606
2025-08-22T09:30:00-04:00,105.56,111.88,103.8,110.085,NaN,NaN,NaN,116.0653403396052,NaN,NaN,107.32680000000003,116.10041379592107,98.553186204079,106.77593740739898,108.58833333333332,108.58833333333332,108.58833333333332,3522748,2202745.6,52.9650239806505,51.3471617948169,NaN,NaN,NaN,NaN,4.340633762360568,20.240355706706378,138590001,-0.762739524041643,-0.08308628977344767,0.6796532342681953
2025-08-22T13:30:00-04:00,110.1,110.21,108.85,109.3,NaN,NaN,NaN,116.0653403396052,NaN,NaN,107.31780000000005,116.08237099006898,98.55322900993112,106.77593740739898,108.75105440812872,109.08910112311712,108.41300769314033,816236,2153939.566666667,51.334651100706225,51.36994411324811,NaN,NaN,NaN,NaN,4.127731350763384,19.480879520395398,137773765,-0.5604775899864374,-0.020943753214851313,0.5395338367715861
2025-08-25T09:30:00-04:00,108.49,109.84,105.95,107.72,NaN,NaN,NaN,116.0653403396052,NaN,NaN,107.31320000000005,116.07668030407771,98.54971969592239,106.77593740739898,107.83666666666666,107.83666666666666,107.83666666666666,2503185,2135314.7333333334,48.12373325586183,51.019568552400756,NaN,NaN,NaN,NaN,4.110750539994571,19.408966573252563,135270580,-0.5100733026068754,-0.09805779148700822,0.41201551111986723
2025-08-25T13:30:00-04:00,107.68,109.2,107.55,107.97,NaN,NaN,NaN,116.0653403396052,NaN,NaN,107.38560000000005,116.10968657453346,98.66151342546665,105.69274992591919,107.93257187253164,108.10428080606339,107.76086293899989,780893,2123855.4,48.670812918501056,50.567358671331554,NaN,NaN,NaN,NaN,3.9349826442806735,19.342190265191363,136051473,-0.4395438372054902,-0.13741428538699552,0.30212955181849466
2025-08-26T09:30:00-04:00,106.96,107.94,105.13,107.7,NaN,NaN,NaN,116.0653403396052,NaN,NaN,107.48440000000004,116.10802189337942,98.86077810662066,100.24270795344904,106.92333333333333,106.92333333333333,106.92333333333333,1770472,2119084.566666667,48.08106774115235,49.84449351584502,NaN,NaN,NaN,NaN,3.856769598260626,19.785059168885375,134281001,-0.3922809470998906,-0.18822163205636855,0.204059315043522
2025-08-26T13:30:00-04:00,107.72,109.33,107.01,108.8,NaN,NaN,NaN,116.0653403396052,NaN,NaN,107.62320000000004,116.10244212650919,99.14395787349089,101.30133309020738,107.32816258056376,107.98070725391511,106.6756179072124,681416,2110484.6,50.70190205246828,49.10547436429295,NaN,NaN,NaN,NaN,3.747000341242009,19.73986342524068,134962417,-0.27375440737986245,-0.13813369418130605,0.1356207131985564
2025-08-27T09:30:00-04:00,108.67,109.2,103.63,104.63,NaN,NaN,NaN,116.0653403396052,NaN,NaN,107.69680000000004,116.00523493324556,99.38836506675452,101.30133309020738,105.82,105.82,105.82,2405588,2104170.2,42.03848993974689,47.805872491131545,NaN,NaN,NaN,NaN,3.877214602581866,20.37709623827821,132556829,-0.4524696964056097,-0.4299664073084557,0.022503289097153975
2025-08-27T13:30:00-04:00,104.63,105.65,102.8,102.935,NaN,NaN,NaN,115.69246332497701,NaN,NaN,107.71370000000003,115.97977713731086,99.4476228626892,101.30133309020738,105.13743768238236,106.09467191481606,104.18020344994865,1223121,2110588.1,39.11296507792907,46.151063459542264,NaN,NaN,NaN,NaN,3.8038421309688766,21.122521856108225,131333708,-0.6491418664822919,-0.7889240440057108,-0.13978217752341898
2025-08-28T09:30:00-04:00,104.01,105.37,102.77,104.15,NaN,NaN,NaN,115.37076044656897,NaN,NaN,107.76630000000003,115.90657071048463,99.62602928951543,101.30133309020738,104.09666666666665,104.09666666666665,104.09666666666665,1783260,2023293.3666666667,42.21714537423033,45.780296102201326,NaN,NaN,NaN,NaN,3.717853407328243,21.820498630048586,133116968,-0.6595702542473045,-0.9642449953325496,-0.3046747410852451
2025-08-28T13:30:00-04:00,104.17,104.19,102.87,103.66,NaN,NaN,NaN,114.49708951717948,NaN,NaN,107.80110000000002,115.8555249428489,99.74667505715114,101.30133309020738,103.94595182196838,104.18293101440163,103.70897262953513,721284,2009048.4333333333,41.302602612255875,45.470831811466944,NaN,NaN,NaN,NaN,3.546578163947654,22.468619920136064,132395684,-0.6600237968646225,-1.1297044871660233,-0.4696806903014008
2025-08-29T09:30:00-04:00,102.745,104.38,101.93,103.3,NaN,NaN,NaN,113.95767635730769,NaN,NaN,107.75830000000003,115.88487630493783,99.63172369506223,101.30133309020738,103.20333333333333,103.20333333333333,103.20333333333333,1646289,1932566.2333333334,40.60661258124345,45.498111282450104,NaN,NaN,NaN,NaN,3.4682511522371064,23.272217296371796,130749395,-0.6444009002963537,-1.2751818156718429,-0.6307809153754892
2025-08-29T13:30:00-04:00,103.31,104.13,103.07,104.05,NaN,NaN,NaN,113.95767635730769,NaN,NaN,107.74270000000003,115.89465638113778,99.59074361886228,101.30133309020738,103.34535992532804,103.58508821066407,103.10563163999201,577839,1909499.3,42.77028077740914,45.48225159797295,NaN,NaN,NaN,NaN,3.296233212791599,24.01841486001926,131327234,-0.5472142543143772,-1.3147987332684608,-0.7675844789540835
2025-09-02T09:30:00-04:00,100.35,101.88,97.91,100.72,NaN,NaN,NaN,110.71318238341463,NaN,NaN,107.62610000000002,116.00653394819064,99.24566605180941,101.30133309020738,100.17000000000002,100.17000000000002,100.17000000000002,2755841,1905568.6333333333,36.42538652261122,44.967344443137286,NaN,NaN,NaN,NaN,3.4993594118779137,25.688938301697856,128571393,-0.6631285713284066,-1.5964951931145919,-0.9333666217861852
2025-09-02T13:30:00-04:00,100.71,101.75,100.12,100.83,NaN,NaN,NaN,110.71318238341463,NaN,NaN,107.50710000000002,116.09853273034166,98.91566726965839,101.30133309020738,100.37623613014927,100.70489862211784,100.0475736381807,1085134,1894639.1333333333,36.759130360302365,44.36498602107632,NaN,NaN,NaN,NaN,3.3658337396009195,27.240138640399415,129656527,-0.6854898557755003,-1.7902289415055606,-1.1047390857300603
2025-09-03T09:30:00-04:00,101.605,102.69,100.11,100.47,NaN,NaN,NaN,110.71318238341463,NaN,NaN,107.41450000000003,116.20520810572053,98.62379189427953,101.30133309020738,101.08999999999999,101.08999999999999,101.08999999999999,1794693,1864854.9333333333,36.09135979603648,43.159724293603894,NaN,NaN,NaN,NaN,3.3097027582008534,28.24038975849591,127861834,-0.6764736283047224,-1.9503311211109633,-1.273857492806241
2025-09-03T13:30:00-04:00,100.51,100.84,99.41,100.81,NaN,NaN,NaN,110.26736636483875,NaN,NaN,107.36430000000001,116.2757997637882,98.45280023621183,99.9920664721659,100.87012619645122,101.20721552061161,100.53303687229084,763567,1873413.6,37.25075538707555,42.15373174263027,NaN,NaN,NaN,NaN,3.1754382754722212,29.30533074311203,128625401,-0.602049044882053,-2.026418798908807,-1.4243697540267541
2025-09-04T09:30:00-04:00,100.6,104.74,100.54,104.3,NaN,NaN,NaN,110.26736636483875,NaN,NaN,107.32210000000003,116.27118064328256,98.3730193567175,97.93106434159932,103.19333333333333,103.19333333333333,103.19333333333333,2394110,1795261.8333333333,47.73252844009496,42.125788541504065,NaN,NaN,NaN,NaN,3.248621255795633,28.628380672726912,131019511,-0.2881313981820328,-1.7845340017542952,-1.4964026035722624
2025-09-04T13:30:00-04:00,104.3,104.64,102.705,102.905,NaN,NaN,NaN,110.26736636483875,NaN,NaN,107.25720000000001,116.2860511251427,98.22834887485732,97.93106434159932,103.25596391622697,103.3562879259744,103.15563990647955,933055,1785235.2333333334,44.53055433279771,41.83005578538239,NaN,NaN,NaN,NaN,3.154791166095945,27.99978417879787,130086456,-0.151652798945612,-1.6859686022542775,-1.5343158033086655
2025-09-05T09:30:00-04:00,104.98,106.03,95.66,99.76,NaN,NaN,NaN,110.26736636483875,NaN,NaN,107.19000000000001,116.38942476462503,97.99057523537499,97.93106434159932,100.48333333333333,100.48333333333333,100.48333333333333,4970653,1869732.0666666667,38.293746545084105,41.13096141423466,NaN,NaN,NaN,NaN,3.6701632256605206,28.873280927431583,125115803,-0.24487925506185193,-1.8404148721359803,-1.5955356170741284
2025-09-05T13:30:00-04:00,99.75,101.34,99.01,101.25,NaN,NaN,NaN,110.26736636483875,NaN,NaN,107.15400000000001,116.43170187061453,97.87629812938549,97.93106434159932,100.49391207713899,100.51433332513272,100.47349082914525,1333881,1879501.4666666666,42.40911135975387,40.538619221897925,NaN,NaN,NaN,NaN,3.574437280970483,29.68438505116288,126449684,-0.18084030371655202,-1.8215859967198185,-1.6407456930032664
2025-09-08T09:30:00-04:00,110.6,116.77,110.12,114.97,100.99439164398926,100.99439164398926,100.99439164398926,NaN,NaN,NaN,107.4308,116.79847748377372,98.06312251622629,101.31363756071127,113.95333333333333,113.95333333333333,113.95333333333333,8302458,2063428.0666666667,65.3348955824714,42.20264819637824,NaN,NaN,NaN,NaN,4.427691760901163,28.62301318078451,134752142,0.759314730761979,-0.6916022795507928,-1.4509170103127718
2025-09-08T13:30:00-04:00,114.97,117.29,114.54,117.25,103.65532838744431,NaN,NaN,NaN,NaN,NaN,107.778,117.28775457096584,98.26824542903417,103.54991004856903,114.49588728924388,115.50156205052815,113.49021252795961,2416448,2105522.3,67.64026633045688,44.240312571558796,NaN,NaN,NaN,NaN,4.3078566351225085,27.722923263985482,137168590,1.4675131665803691,0.3834744479126897,-1.0840387186676794
2025-09-09T09:30:00-04:00,116.515,117.65,113.75,115.13,103.65532838744431,NaN,NaN,NaN,NaN,NaN,107.962,117.67544182048778,98.24855817951223,104.70792803885521,115.50999999999999,115.50999999999999,115.50999999999999,3658729,2136677.3666666667,63.417080356498474,45.75459364172082,NaN,NaN,NaN,NaN,4.2787240183280435,26.70092552190866,133509861,1.7090582877048814,1.0522841409634225,-0.656774146741459
2025-09-09T13:30:00-04:00,115.17,118.69,114.88,118.49,104.58732400591515,NaN,NaN,NaN,NaN,NaN,108.20360000000002,118.34223285458125,98.06496714541879,106.43134243108418,116.1068355787858,116.9693633805372,115.24430777703441,1751836,2162738.6666666665,66.94016941178347,47.58584841311564,NaN,NaN,NaN,NaN,4.245243731304612,25.942849575397847,135261697,1.9912774655487429,1.8323226851944696,-0.15895478035427324
2025-09-10T09:30:00-04:00,120.955,123.44,117.88,118.76,108.25858200564629,NaN,NaN,NaN,NaN,NaN,108.49640000000004,118.98591343771368,98.0068865622864,110.85307394486733,120.02666666666666,120.02666666666666,120.02666666666666,4077508,2171576.8666666667,67.21341341090627,49.48633418666299,NaN,NaN,NaN,NaN,4.339154893354283,26.029037445352092,139339205,2.082460853174628,2.4441212861140116,0.36166043293938377
2025-09-10T13:30:00-04:00,118.79,119.31,116.69,117.42,108.25858200564629,NaN,NaN,NaN,NaN,NaN,108.73580000000001,119.47957258880666,97.99202741119336,110.85307394486733,119.37754785639027,120.38734413731154,118.36775157546899,1684906,2190422.6666666665,64.369879430777,51.029162661903555,NaN,NaN,NaN,NaN,4.216358115257548,25.79715080531499,137654299,1.9416339363480608,2.78870285337446,0.847068917026399
2025-09-11T09:30:00-04:00,117.88,121.68,117.4,120.65,108.25858200564629,NaN,NaN,NaN,NaN,NaN,109.07250000000002,120.22570102033464,97.9192989796654,110.85307394486733,119.91000000000001,119.91000000000001,119.91000000000001,2703508,2130709.966666667,67.89561131434219,53.27703586131291,NaN,NaN,NaN,NaN,4.220903964167723,25.960235156391853,140357807,1.9499911823163465,3.284557894921832,1.3345667126054856
2025-09-11T13:30:00-04:00,120.64,120.85,117.65,117.72,108.25858200564629,NaN,NaN,NaN,NaN,NaN,109.31390000000002,120.68078423271719,97.94701576728285,110.85307394486733,119.60505938848365,120.11866598785555,119.09145278911176,953009,2123964.7333333334,61.91082857957917,55.073585734118396,NaN,NaN,NaN,NaN,4.147982252441457,26.11167062524894,139404798,1.6538548372395956,3.40188525915498,1.7480304219153846
2025-09-12T09:30:00-04:00,117.93,118.57,114.05,115.07,108.25858200564629,NaN,NaN,NaN,NaN,NaN,109.4169,120.89665816644285,97.93714183355715,110.85307394486733,115.89666666666666,115.89666666666666,115.89666666666666,2568165,2113760.8,57.015700210751646,56.568181478026624,NaN,NaN,NaN,NaN,4.174554948695638,25.265787245184057,136836633,1.1964912410224455,3.2436444731934415,2.047153232170996
2025-09-12T13:30:00-04:00,115.05,116.98,114.42,115.01,108.25858200564629,NaN,NaN,NaN,NaN,NaN,109.49250000000002,121.06840691911421,97.91659308088583,110.85307394486733,115.74469155965836,115.94901062184744,115.54037249746929,1420856,2133356.2666666666,56.905990387667465,57.97212683521176,NaN,NaN,NaN,NaN,4.059229595217379,24.480324106552384,135415777,0.8246099864767666,3.077915715266954,2.2533057287901874
2025-09-15T09:30:00-04:00,115.37,116.52,112.43,115.02,108.25858200564629,NaN,NaN,NaN,NaN,NaN,109.51070000000001,121.11840657968224,97.90299342031778,110.85307394486733,114.65666666666664,114.65666857401527,114.656664759318,2845731,2110789.033333333,56.920868622983775,58.628436848275236,NaN,NaN,NaN,NaN,4.061427481273279,23.223207579310095,138261508,0.5283898209971376,2.9137930050366094,2.385403184039472
2025-09-15T13:30:00-04:00,115.02,115.23,113.95,114.79,108.25858200564629,NaN,NaN,NaN,NaN,NaN,109.51410000000001,121.12788882019105,97.90031117980898,110.85307394486733,114.65666666666665,114.65666801536581,114.6566653179675,973051,2116016.2,56.438231817752786,59.478985240057746,NaN,NaN,NaN,NaN,3.8627540897537593,22.055885089727973,137288457,0.2786003642997259,2.733653639414129,2.455053275114403
2025-09-16T09:30:00-04:00,115.09,118.13,113.8,116.84,108.25858200564629,NaN,NaN,NaN,NaN,NaN,109.52050000000001,121.15006667292471,97.89093332707532,110.85307394486733,116.25666666666666,116.25666666666666,116.25666666666666,3029927,2133574.2666666666,59.7167956005581,61.00920302973446,NaN,NaN,NaN,NaN,3.896128797628491,21.62720832551845,140318384,0.21587643935125023,2.724898824303466,2.5090223849522157
2025-09-16T13:30:00-04:00,116.85,118.06,116.55,117.33,108.25858200564629,NaN,NaN,NaN,NaN,NaN,109.59430000000002,121.37336940466876,97.81523059533127,110.85307394486733,116.55888555817174,117.03638777838447,116.08138333795901,1213737,2148002.4,60.482384747875564,62.30015112888601,NaN,NaN,NaN,NaN,3.7256910263693137,21.229151330181033,141532121,0.17364207580545932,2.72607497970904,2.5524329039035805
2025-09-17T09:30:00-04:00,117.05,118.97,115.75,117.07,108.25858200564629,NaN,NaN,NaN,NaN,NaN,109.64450000000002,121.52871764358089,97.76028235641915,110.97129929982087,117.26333333333332,117.26333333333332,117.26333333333332,1943329,2153764.3,59.83259693324344,61.907129796798294,NaN,NaN,NaN,NaN,3.6895702387715055,21.067061504829027,139588792,0.09820515424596454,2.6751893467110364,2.576984192465072
2025-09-17T13:30:00-04:00,117.08,119.13,114.88,118.6,108.25858200564629,NaN,NaN,NaN,NaN,NaN,109.73470000000002,121.81928380085947,97.65011619914057,110.97129929982087,117.40599836099825,117.54253332883393,117.26946339316258,2121747,2201775.3333333335,62.393031870632605,61.53232733538227,NaN,NaN,NaN,NaN,3.7296009360021123,20.624168857318033,141710539,0.11992182946787944,2.726886479299921,2.6069646498320416
2025-09-18T09:30:00-04:00,120.02,124.36,119.86,123.26,110.50079894504994,NaN,NaN,NaN,NaN,NaN,110.01010000000002,122.67357874637918,97.34662125362087,114.66083155188535,122.49333333333334,122.4933346820325,122.49333198463418,3167246,2227163.933333333,68.8962944715255,61.923699772169925,NaN,NaN,NaN,NaN,3.8746294405733903,21.320741195601567,144877785,0.40087003461645354,3.1080521931026084,2.707182158486155
2025-09-18T13:30:00-04:00,123.245,123.37,120.6,120.88,110.52576262936584,NaN,NaN,NaN,NaN,NaN,110.25490000000002,123.27128160012177,97.23851839987827,114.66083155188535,122.23797906059237,122.63629397933593,121.8396641418488,1301712,2229783.6333333333,62.9125129836903,61.63601002730612,NaN,NaN,NaN,NaN,3.7957273376752916,21.967558366864854,143576073,0.37938175424206433,3.1814093512887354,2.802027597046671
2025-09-19T09:30:00-04:00,121.67,123.54,121.01,122.82,110.9739097825765,NaN,NaN,NaN,NaN,NaN,110.51750000000001,123.99916773808093,97.0358322619191,114.89453219320663,122.45666666666666,122.45666666666666,122.45666666666666,2773814,2262802.1,65.53979770539175,61.51646604834081,NaN,NaN,NaN,NaN,3.714603956412771,22.602095797513773,146349887,0.4442862150085287,3.357385365807332,2.913099150798803
2025-09-19T13:30:00-04:00,122.81,125.22,122.51,124.74,112.70805024700483,NaN,NaN,NaN,NaN,NaN,110.79770000000002,124.85544038883909,96.73995961116096,116.9486257545653,123.24419871828984,124.0919001724737,122.39649726410597,2394021,2318560,67.95898856074263,61.772830986195494,NaN,NaN,NaN,NaN,3.642846530954716,23.52559099035004,148743908,0.5576486017034288,3.610159902928089,3.0525113012246603