time,open,high,low,close,Long Stop,Long Stop Start,Buy Label,Short Stop,Short Stop Start,Sell Label,Basis,Upper,Lower,ATR Trailing Stoploss,VWAP,Upper Band #1,Lower Band #1,Volume,Volume MA,RSI,RSI-based MA,Regular Bullish,Regular Bullish Label,Regular Bearish,Regular Bearish Label,ATR,ADX,OnBalanceVolume,Histogram,MACD,Signal
2021-10-15T09:30:00-04:00,302.24,303.35,300.54,303.21,291.5126134058625,NaN,NaN,NaN,NaN,NaN,294.49719999999985,307.27522491156344,281.71917508843626,295.2870712294216,302.36666666666673,302.36666666666673,302.36666666666673,526010,501328.13333333336,66.39307827167934,56.797802961477196,NaN,NaN,NaN,NaN,3.5102537197507426,17.508399879184257,68691821,1.379143764566241,2.2875941661111483,0.9084504015449073
2021-10-15T13:30:00-04:00,303.23,304.44,303.23,304.17,293.54995353715987,NaN,NaN,NaN,NaN,NaN,294.6649999999999,307.723280591273,281.6067194087268,297.37465698353725,303.00442070646324,303.77961175878465,302.2292296541418,356027,504558,67.60355228490715,57.814566356654645,NaN,NaN,NaN,NaN,3.347378454054262,18.40963276780199,69047848,1.4171776554713493,2.679922470884094,1.2627448154127445
2021-10-18T09:30:00-04:00,303.33,307.34,302.71,307.22,294.57609201274346,NaN,NaN,NaN,NaN,NaN,294.88979999999987,308.40972810041643,281.3698718995833,299.3727255868298,305.75666666666666,305.75666666666666,305.75666666666666,495232,498047.9666666667,71.15795094618606,58.80945359690372,NaN,NaN,NaN,NaN,3.4389942787646715,19.82825212700881,69543080,1.5498574381754342,3.200066613132037,1.650209174956603
2021-10-18T13:30:00-04:00,307.29,307.69,306.3,307.19,296.83149692125517,NaN,NaN,NaN,NaN,NaN,295.0923999999999,309.0333856523998,281.1514143476,300.62118046946387,306.27025970567206,306.9071310567352,305.63338835460894,322065,494606.4666666667,71.07534832288304,59.9685559690926,NaN,NaN,NaN,NaN,3.2926375445671936,21.211344431280228,69221015,1.5348132956473002,3.5687257945157285,2.0339124988684283
2021-10-19T09:30:00-04:00,308.33,309.3,307.255,308.22,298.2882470611981,NaN,NaN,NaN,NaN,NaN,295.2479999999999,309.5920998323526,280.9039001676472,302.5899443755711,308.2583333333334,308.2583333333334,308.2583333333334,380349,472616.3333333333,72.26573411400221,61.28393791918616,NaN,NaN,NaN,NaN,3.208163434240966,22.79465142636818,69601364,1.4921158711673144,3.8990573378275712,2.406941466660257
2021-10-19T13:30:00-04:00,308.24,308.69,307.71,308.33,298.5311676493254,NaN,NaN,NaN,NaN,NaN,295.4165999999999,310.1678476001341,280.6653523998657,302.83195550045684,308.25240355830704,308.25973734133146,308.2450697752826,248658,448526.36666666664,72.39638899511016,62.534347129166086,NaN,NaN,NaN,NaN,3.0490089032237555,24.264865064664136,69850022,1.3722110902316786,4.122205329449855,2.7499942392181764
2021-10-20T09:30:00-04:00,309.27,309.65,306.12,306.37,298.5311676493254,NaN,NaN,NaN,NaN,NaN,295.45459999999986,310.3083726978903,280.6008273021094,303.19856440036546,307.38,307.38,307.38,348276,437319.6,66.39448504864595,63.25838370003104,NaN,NaN,NaN,NaN,3.0833654101363424,24.881584634993985,69501746,1.0749697300276968,4.093706401752797,3.0187366717251005
2021-10-20T13:30:00-04:00,306.32,307.71,306.16,307.48,298.5311676493254,NaN,NaN,NaN,NaN,NaN,295.50799999999987,310.5143351955284,280.5016648044713,303.19856440036546,307.2921110611611,307.4162868304375,307.1679352918847,174469,424376.9,68.01186709675977,64.29816196193492,NaN,NaN,NaN,NaN,2.973839309412315,25.45425280744313,69676215,0.8756292752501795,4.113273265787825,3.2376439905376455
2021-10-21T09:30:00-04:00,307.17,309.59,306.42,309.5,298.5311676493254,NaN,NaN,NaN,NaN,NaN,295.64679999999987,311.03499882379293,280.2586011762068,303.25608121623395,308.50333333333333,308.50333333333333,308.50333333333333,297963,413349.8,70.76900643734606,65.57913330255,NaN,NaN,NaN,NaN,2.9878507873114324,26.422610200724243,69974178,0.8041793052064032,4.24286812204565,3.4386888168392464
2021-10-21T13:30:00-04:00,309.53,311.02,309.22,310.65,300.8235409364476,NaN,NaN,NaN,NaN,NaN,295.7547999999999,311.48311751461455,280.0264824853852,305.05286497298715,309.33266519454224,310.2268000474234,308.4385303416611,256338,404589.9,72.23617584460833,67.10244654445911,NaN,NaN,NaN,NaN,2.9030043025034695,27.62428655224986,70230516,0.7592798840117321,4.387788671853912,3.6285087878421796
2021-10-22T09:30:00-04:00,310.51,311.05,307.91,309.41,300.8235409364476,NaN,NaN,NaN,NaN,NaN,295.9371999999999,312.0777888566845,279.7966111433153,305.05286497298715,309.4566666666667,309.4566666666667,309.4566666666667,402980,397626.36666666664,68.2578719242008,68.10422513477663,NaN,NaN,NaN,NaN,2.9199325666103637,28.084157754638095,69827536,0.5791207653515356,4.352409744531599,3.7732889791800632
2021-10-22T13:30:00-04:00,309.41,310.26,308.59,309.1,300.8235409364476,NaN,NaN,NaN,NaN,NaN,296.1229999999999,312.6469638101936,279.59903618980616,305.05286497298715,309.4089724459628,309.475323423618,309.3426214683075,208219,389088.93333333335,67.2605659501838,68.840874353352,NaN,NaN,NaN,NaN,2.830651668995339,28.5111810139986,69619317,0.38165822141681005,4.250361755951076,3.8687035345342657
2021-10-25T09:30:00-04:00,309.36,309.36,306.53,308.81,300.8235409364476,NaN,NaN,NaN,NaN,NaN,296.43899999999985,313.3133441946825,279.5646558053172,305.05286497298715,308.23333333333335,308.23333333333335,308.23333333333335,357254,375472.36666666664,66.28487759339926,68.98341125839106,NaN,NaN,NaN,NaN,2.8306051212099606,27.90527785915019,69262063,0.18410801557572265,4.098838554003919,3.9147305384281963
2021-10-25T13:30:00-04:00,308.8,308.88,307.51,308.27,300.8235409364476,NaN,NaN,NaN,NaN,NaN,296.7193999999999,313.902050044755,279.5367499552448,305.05286497298715,308.2278846786243,308.2344391344929,308.22133022275574,246878,366608.0333333333,64.41121015606578,68.89415092756984,NaN,NaN,NaN,NaN,2.7262761839806777,27.34265350107667,69015185,-0.01951526218666233,3.8903364606948685,3.909851722881531
2021-10-26T09:30:00-04:00,311.04,312.39,308.64,309.69,301.502519326581,NaN,NaN,NaN,NaN,NaN,297.01799999999986,314.5690282320024,279.46697176799734,305.8504971943484,310.24,310.24,310.24,511485,368458.76666666666,67.0489197296639,68.94099674599731,NaN,NaN,NaN,NaN,2.8258278851249155,27.799325557456495,69526670,-0.09114365476990871,3.795922154419145,3.8870658091890538
2021-10-26T13:30:00-04:00,309.66,310.77,309.39,309.98,301.502519326581,NaN,NaN,NaN,NaN,NaN,297.3235999999999,315.2310356667996,279.4161643332002,305.8504971943484,310.15661843279577,310.2523678484618,310.06086901712973,387883,369366.1,67.57743251135764,68.93913104788663,NaN,NaN,NaN,NaN,2.7225544647588498,28.223378181237763,69914553,-0.14819155707747367,3.701826362842212,3.8500179199196856
2021-10-27T09:30:00-04:00,316.1,325.9,316.1,325.76,310.43767773351703,NaN,NaN,NaN,NaN,NaN,297.8781999999999,317.4765753163506,278.27982468364917,313.202718204383,322.58666666666664,322.58666666666664,322.58666666666664,1391810,397928.9,83.28643515487015,69.80545134850692,NaN,NaN,NaN,NaN,3.6652291458475004,30.801320031929926,71306363,0.7957632258251754,4.844721952201155,4.04895872637598
2021-10-27T13:30:00-04:00,325.78,326.08,323.14,323.14,314.12687420017534,NaN,NaN,NaN,NaN,NaN,298.36999999999995,319.2061566513691,277.5338433486308,314.4521745635064,323.0808216265348,323.7974213386847,322.3642219143849,661840,399752.36666666664,76.64637793350303,70.20338203497978,NaN,NaN,NaN,NaN,3.6134270640012502,33.21010484363196,70644523,1.141584710038801,5.475939613924481,4.33435490388568
2021-10-28T09:30:00-04:00,324.16,324.37,321.39,323.2,314.12687420017534,NaN,NaN,NaN,NaN,NaN,298.83339999999987,320.7967405874582,276.87005941254154,314.4521745635064,322.9866666666667,322.9866666666667,322.9866666666667,655787,405056.23333333334,76.69220619242662,70.5195586120101,NaN,NaN,NaN,NaN,3.568182273715448,34.76557250155488,71300310,1.2628087333147633,5.9128658205291345,4.650057087214371
2021-10-28T13:30:00-04:00,323.22,324.87,322.78,324.31,314.12687420017534,NaN,NaN,NaN,NaN,NaN,299.3283999999999,322.421484803911,276.2353151960887,315.1911917206441,323.36774511025294,323.85339690258945,322.88209331791643,403777,407679.7,77.56916843716887,70.88904285787143,NaN,NaN,NaN,NaN,3.462597825592918,36.26628133134311,71704087,1.3010350061028761,6.276350844842966,4.97531583874009
2021-10-29T09:30:00-04:00,324.13,329.94,323.94,329.67,316.3619094635447,NaN,NaN,NaN,NaN,NaN,299.94899999999984,324.5530868963009,275.3449131036988,319.19695337651524,327.84999999999997,327.84999999999997,327.84999999999997,676092,420320.9,81.23982044711698,71.94942395776222,NaN,NaN,NaN,NaN,3.643840838050567,38.167208959922824,72380179,1.5534957617072314,6.917185540874129,5.363689779166898
2021-10-29T13:30:00-04:00,329.66,332,329.56,331.49,320.35000448792897,NaN,NaN,NaN,NaN,NaN,300.59199999999987,326.7313266937123,274.45267330628747,322.18556270121223,329.3176635511052,330.89676612722025,327.7385609749902,584034,432787.1666666667,82.29903989168187,72.96993630025666,NaN,NaN,NaN,NaN,3.5578522067612406,40.106480014701155,72964213,1.6975448697534086,7.4856208663586585,5.78807599660525
2021-11-01T09:30:00-04:00,331.48,331.49,326.39,327.62,320.35000448792897,NaN,NaN,NaN,NaN,NaN,301.2585999999999,328.40175354118907,274.1154464588107,322.18556270121223,328.5,328.5,328.5,679603,442440.86666666664,72.87663954665159,73.12048152234992,NaN,NaN,NaN,NaN,3.668005620564011,40.748263571480656,72284610,1.399100809860415,7.536952008930768,6.1378511990703535
2021-11-01T13:30:00-04:00,327.59,330.17,327.46,329.37,320.35000448792897,NaN,NaN,NaN,NaN,NaN,301.9619999999999,330.14010951786014,273.7838904821396,322.18556270121223,328.69733625010355,328.9417263674346,328.45294613277247,443100,448815.8,74.30902261278561,73.26854200579115,NaN,NaN,NaN,NaN,3.5995766476665843,41.344205445633044,72727710,1.19442197249598,7.630878664690329,6.436456692194349
2021-11-02T09:30:00-04:00,330.31,333.27,330.25,332.54,321.1703729867309,NaN,NaN,NaN,NaN,NaN,302.89759999999984,331.95453048070726,273.8406695192924,323.5790081030206,332.02,332.02,332.02,516535,456552.76666666666,76.70851190381545,73.87215914719219,NaN,NaN,NaN,NaN,3.621035458547541,42.26181305956355,73244245,1.1471417162876882,7.870383837553959,6.723242121266271
2021-11-02T13:30:00-04:00,332.58,333.42,332.06,333.23,322.4462651236977,NaN,NaN,NaN,NaN,NaN,303.8917999999998,333.62253364450976,274.1610663554899,324.9872064824165,332.4065062452838,332.84471483982827,331.9682976507394,401838,460176,77.20751627995767,74.5826555993189,NaN,NaN,NaN,NaN,3.459532925794146,43.13086735377702,73646083,1.0401119763059654,8.023382091648728,6.983270115342762
2021-11-03T09:30:00-04:00,333.92,333.96,330.76,332.07,322.4462651236977,NaN,NaN,NaN,NaN,NaN,304.8423999999998,335.0725747424771,274.61222525752254,325.6137651859332,332.2633333333333,332.2633333333333,332.2633333333333,342407,458468.3333333333,74.32459201491122,75.15692091514119,NaN,NaN,NaN,NaN,3.440994859665992,43.427983447415954,73303676,0.7808097896133743,7.95928235235948,7.178472562746106
2021-11-03T13:30:00-04:00,332.05,334.89,331.87,334,323.1724440486584,NaN,NaN,NaN,NaN,NaN,305.8419999999998,336.5534657416543,275.13053425834534,326.70301214874655,332.9815209399518,333.64076911864834,332.32227276125525,406369,457132.0333333333,75.93467891146821,75.98002582624136,NaN,NaN,NaN,NaN,3.410923798261277,43.833339030779875,73710045,0.6350761901773598,7.972317800467806,7.337241610290446
2021-11-04T09:30:00-04:00,332.89,336.115,329.635,335.86,323.1724440486584,NaN,NaN,NaN,NaN,NaN,306.90799999999984,338.0105884453477,275.805411554652,326.70301214874655,333.87,333.87,333.87,509331,455336.3333333333,77.4052302821307,76.7197622942747,NaN,NaN,NaN,NaN,3.630143526956901,43.33939128196636,74219376,0.5622500735730238,8.040054202256727,7.477804128683703
2021-11-04T13:30:00-04:00,335.84,336.5,335.34,336.5,325.61766079640154,NaN,NaN,NaN,NaN,NaN,308.00339999999983,339.33887168562666,276.667928314373,328.0883277751978,334.8384382617557,335.9495895417509,333.72728698176047,386899,452650.26666666666,77.90552277155633,77.45748302714604,NaN,NaN,NaN,NaN,3.4537047036028383,42.94801475803617,74606275,0.45979958862004544,8.052553614458759,7.592754025838714
2021-11-05T09:30:00-04:00,338.51,338.79,334.56,334.59,326.2641307602015,NaN,NaN,NaN,NaN,NaN,308.9633999999998,340.5559699138386,277.370830086161,329.9456622201582,335.98,335.98,335.98,470068,450785.5333333333,72.72984975893306,76.70344121315054,NaN,NaN,NaN,NaN,3.5091543676312082,42.97211440177007,74136207,0.18036872821279637,7.8182149361047095,7.637846207891913
2021-11-05T13:30:00-04:00,334.51,337,334.45,335.96,326.2641307602015,NaN,NaN,NaN,NaN,NaN,309.9005999999998,341.85866687771943,277.9425331222802,329.9456622201582,335.9023911833375,335.9900710699171,335.8147112967579,368284,451194.1,74.06099015127131,76.51877065727685,NaN,NaN,NaN,NaN,3.4406433413718367,42.948476382954055,74504491,0.013569065096099564,7.654807539262038,7.641238474165938
2021-11-08T09:30:00-05:00,337.52,337.6,334.47,335.82,326.2641307602015,NaN,NaN,NaN,NaN,NaN,310.99939999999987,342.6673364430445,279.3314635569552,329.9456622201582,335.96333333333337,335.96333333333337,335.96333333333337,412306,448429.9,73.6652671888369,76.30256072844902,NaN,NaN,NaN,NaN,3.418454531273848,43.031948877369175,74092185,-0.17028723063261264,7.428379435875172,7.598666666507785
2021-11-08T13:30:00-05:00,335.83,337.44,335.64,337,326.5155362481429,NaN,NaN,NaN,NaN,NaN,312.0751999999998,343.5479064587834,280.60249354121623,329.9456622201582,336.26408618313565,336.6233873154281,335.9047850508432,288883,447323.8333333333,74.88341765704752,76.11072138701176,NaN,NaN,NaN,NaN,3.30285063618286,43.109459050754644,74381068,-0.2705688071269057,7.260455657599152,7.531024464726058
2021-11-09T09:30:00-05:00,336.91,338.44,335.08,335.08,326.7330118732273,NaN,NaN,NaN,NaN,NaN,312.9807999999998,344.4433763319039,281.51822366809574,330.7629592453768,336.2,336.2,336.2,534362,452457.6,69.26887890648295,75.25565413410935,NaN,NaN,NaN,NaN,3.3069327335983707,43.3705574225086,73846706,-0.5104285195620486,6.8929888152734975,7.403417334835546
2021-11-09T13:30:00-05:00,335.06,336.65,334.57,335.77,326.7330118732273,NaN,NaN,NaN,NaN,NaN,313.91959999999983,345.2445939722386,282.5946060277611,330.7629592453768,336.01496501555795,336.2700417938922,335.7598882372237,281191,453542.0333333333,70.13547472154302,74.386828050528,NaN,NaN,NaN,NaN,3.219294681198486,43.34712385774818,74127897,-0.6574717886425967,6.5815775990323,7.239049387674897
2021-11-10T09:30:00-05:00,334.48,334.61,330.41,331.06,326.7330118732273,NaN,NaN,NaN,NaN,NaN,314.72979999999984,345.6885137950006,283.7710862049991,330.7629592453768,332.0266666666666,332.0266720614632,332.02666127186995,409638,455587.43333333335,58.092936964855994,73.33084929468545,NaN,NaN,NaN,NaN,3.3722022039700197,41.46376265236404,73718259,-1.0817481314552655,5.886864223355815,6.96861235481108
2021-11-10T13:30:00-05:00,331.05,331.63,329.95,330.78,326.7330118732273,NaN,NaN,NaN,NaN,NaN,315.48319999999984,346.13262033776203,284.83377966223765,330.7629592453768,331.38742113550364,332.0071223615227,330.7677199094846,435884,464301.26666666666,57.46128562477836,72.1274395098278,NaN,NaN,NaN,NaN,3.2513306179721617,39.537483537958614,73282375,-1.3723697534934853,5.253150162944223,6.6255199164377085
2021-11-11T09:30:00-05:00,330.92,333.76,330.92,333.23,326.7330118732273,NaN,NaN,NaN,NaN,NaN,316.2239999999998,346.7626564210151,285.68534357898454,330.7629592453768,332.6366666666667,332.636670481364,332.63666285196945,361311,466412.86666666664,61.41467001888823,71.03502223233299,NaN,NaN,NaN,NaN,3.23194985954558,38.333623208267014,73643686,-1.3866341897234502,4.892227179283395,6.2788613690068455
2021-11-11T13:30:00-05:00,333.29,333.45,332,332.43,326.7330118732273,NaN,NaN,NaN,NaN,NaN,316.9787999999998,347.2152737732563,286.74232622674333,330.7629592453768,332.63234312320776,332.63729714910164,332.6273890973139,275197,467041.5,59.471104118681936,69.76813564938472,NaN,NaN,NaN,NaN,3.1046677267208946,37.21575290212481,73368489,-1.4311825181009663,4.489883221380637,5.9210657394816035
2021-11-12T09:30:00-05:00,333.92,336.97,333.81,336.57,326.7330118732273,NaN,NaN,NaN,NaN,NaN,317.8287999999998,347.83004174498257,287.827558255017,330.7629592453768,335.7833333333333,335.7833333333333,335.7833333333333,585079,473111.4666666667,65.54746272814242,69.14119784318696,NaN,NaN,NaN,NaN,3.207191460526546,37.03411178406898,73953568,-1.1738556926774422,4.453746123634801,5.627601816312243
2021-11-12T13:30:00-05:00,336.58,337.22,336.15,336.77,327.19043842759373,NaN,NaN,NaN,NaN,NaN,318.66819999999984,348.3924596382273,288.9439403617724,330.7629592453768,336.1110284126003,336.55529450263873,335.6667623225619,318323,476781.6,65.81411165001757,68.41830018165476,NaN,NaN,NaN,NaN,3.054534927631796,36.920140357214684,74271891,-0.9895750074174599,4.390633057040418,5.380208064457878
2021-11-15T09:30:00-05:00,337.54,337.87,334.06,335.17,327.19043842759373,NaN,NaN,NaN,NaN,NaN,319.45679999999976,348.79572661705487,290.11787338294465,330.7629592453768,335.70000000000005,335.70000000000005,335.70000000000005,437851,479468.1666666667,61.69997884822825,67.29649650780459,NaN,NaN,NaN,NaN,3.1084967185152395,35.890848432070015,73834040,-0.9733548789633142,4.163514465753735,5.1368693447170495
2021-11-15T13:30:00-05:00,335.18,336.28,334.5,336.12,327.19043842759373,NaN,NaN,NaN,NaN,NaN,320.29459999999983,349.0915901788488,291.4976098211509,330.7629592453768,335.68042456761884,335.71078624233604,335.65006289290164,182011,477305.93333333335,63.17203804395852,66.2441047415476,NaN,NaN,NaN,NaN,3.013604095764149,34.9350773587214,74016051,-0.8983686221833818,4.013908566987823,4.9122771891712045
2021-11-16T09:30:00-05:00,335.68,340.54,335.51,339.97,328.37620166021276,NaN,NaN,NaN,NaN,NaN,321.2159999999998,349.5198239112832,292.91217608871636,332.6722328718009,338.67333333333335,338.67333333333335,338.67333333333335,503723,477047.2,68.46230947852355,65.93928043580406,NaN,NaN,NaN,NaN,3.1576323746381405,35.06660748690211,74519774,-0.6033610092648685,4.158075927590119,4.761436936854987
2021-11-16T13:30:00-05:00,339.95,340.67,339.2,339.44,330.52432885747584,NaN,NaN,NaN,NaN,NaN,322.14679999999976,349.71610102561567,294.57749897438384,333.6407862974407,339.1478837368975,339.69123033317715,338.6045371406178,384240,476925.76666666666,67.03473109026109,65.43740478858903,NaN,NaN,NaN,NaN,3.0370872050211326,35.21590197031405,74135534,-0.46405924512065067,4.181362880454174,4.645422125574824
2021-11-17T09:30:00-05:00,338.94,342.18,338.02,340.12,330.5498139094087,NaN,NaN,NaN,NaN,NaN,323.0541999999998,349.934842876257,296.1735571237426,334.47662903795253,340.1066666666667,340.1066666666667,340.1066666666667,416651,444420.4666666667,67.95791228800331,65.02973658138664,NaN,NaN,NaN,NaN,3.117295261805339,35.66859572358686,74552185,-0.351376261017764,4.206201799302619,4.557578060320383
2021-11-17T13:30:00-05:00,340.08,340.36,339,339.15,330.5498139094087,NaN,NaN,NaN,NaN,NaN,323.9101999999998,350.0504918086402,297.76990819135943,334.47662903795253,339.8153996903082,340.1168870436051,339.5139123370113,388881,435321.8333333333,65.15490053363698,64.33484250114303,NaN,NaN,NaN,NaN,2.9917741716763873,36.088954208768754,74163304,-0.3657827285040085,4.100349649690372,4.466132378194381
2021-11-18T09:30:00-05:00,338.18,342.43,337.15,341.22,330.5498139094087,NaN,NaN,NaN,NaN,NaN,324.7045999999998,350.48411782638476,298.92508217361484,334.47662903795253,340.2666666666666,340.2666720614632,340.26666127186996,419510,427445.93333333335,68.171923259035,64.25648852632533,NaN,NaN,NaN,NaN,3.1552188736995044,36.89718671033834,74582814,-0.26425180044905705,4.13581762763306,4.400069428082117
2021-11-18T13:30:00-05:00,341.23,341.69,340.6,341.21,331.8339262410813,NaN,NaN,NaN,NaN,NaN,325.4763999999998,350.87279210913516,300.0800078908644,334.65367406743167,340.65532062142876,341.101119525357,340.20952171750054,318853,424615.13333333336,68.14122871606577,64.11404238307695,NaN,NaN,NaN,NaN,3.0077032398638237,37.64768831893866,74263961,-0.22751443540495053,4.115676383825928,4.343190819230879
2021-11-19T09:30:00-05:00,342.72,345.09,342.31,343.24,334.2830659573958,NaN,NaN,NaN,NaN,NaN,326.2769999999998,351.3367909807879,301.21720901921174,337.5209392539453,343.5466666666666,343.5466666666666,343.5466666666666,481077,418114.63333333336,70.99613718200399,65.03569954144466,NaN,NaN,NaN,NaN,3.0700101513021214,38.946235221289065,74745038,-0.10260766816960132,4.214931234018877,4.3175389021884785
2021-11-19T13:30:00-05:00,343.21,343.69,342.66,342.82,334.2830659573958,NaN,NaN,NaN,NaN,NaN,327.0499999999998,351.7157479108354,302.3842520891642,337.5209392539453,343.37026533685605,343.60546572471077,343.13506494900133,270609,407667.13333333336,69.60634478777646,65.90320376737309,NaN,NaN,NaN,NaN,2.924295140494825,40.152028773471585,74474429,-0.08510525962516713,4.21115732765702,4.296262587282187
2021-11-22T09:30:00-05:00,344.54,349.65,341.61,342.67,335.81926051076766,NaN,NaN,NaN,NaN,NaN,327.7589999999998,352.14032145723155,303.377678542768,340.37380112252504,344.6433333333334,344.64333714803064,344.6433295186361,749570,409999.36666666664,69.08618939956301,66.45116943742129,NaN,NaN,NaN,NaN,3.2897026304594776,42.046652992879146,73724859,-0.11841458618479273,4.148244354551196,4.266658940735988
2021-11-22T13:30:00-05:00,342.72,343.85,339.55,339.86,335.81926051076766,NaN,NaN,NaN,NaN,NaN,328.41239999999976,352.299826503517,304.5249734964825,340.37380112252504,343.31659863319675,345.0366358766659,341.5965613897276,445969,410095,60.03531005656345,66.4914698615557,NaN,NaN,NaN,NaN,3.3618667282838013,42.80867764864958,73278890,-0.35131068894167594,3.827520579558893,4.178831268500569
2021-11-23T09:30:00-05:00,336.72,339.41,333.59,334.96,NaN,NaN,NaN,346.85383494783355,346.85383494783355,346.85383494783355,328.9471999999998,352.1910410044652,305.70335899553436,340.37380112252504,335.9866666666667,335.9866666666667,335.9866666666667,777268,418786.1,48.181580336341185,65.25104969071275,NaN,NaN,NaN,NaN,3.56959053340639,41.2585521426117,72501622,-0.8296733270874901,3.1417396096412062,3.9714129367286963
2021-11-23T13:30:00-05:00,334.93,337.93,334.3,337.71,NaN,NaN,NaN,346.4932060865684,NaN,NaN,329.5347999999998,352.1408272458668,306.9287727541328,340.37380112252504,336.22468561397795,336.5416075064819,335.907763721474,438419,420005.4666666667,53.70608642267679,64.3861907459027,NaN,NaN,NaN,NaN,3.573905495305933,39.819149887005096,72940041,-0.9467169526464994,2.7880167459205722,3.7347336985670716
2021-11-24T09:30:00-05:00,336.38,336.73,333.94,336.29,NaN,NaN,NaN,345.7555603553608,NaN,NaN,330.13319999999976,351.82011123790863,308.4462887620909,340.37380112252504,335.65333333333336,335.65333333333336,335.65333333333336,417355,422503.73333333334,50.70028669007988,63.6004984488921,NaN,NaN,NaN,NaN,3.5879122456412227,38.35892997845908,72522686,-1.0951190994547138,2.3658348242486795,3.4609539237033933
2021-11-24T13:30:00-05:00,336.32,338.15,335.48,338.01,NaN,NaN,NaN,345.7555603553608,NaN,NaN,330.74379999999985,351.54622558551125,309.94137441448845,340.37380112252504,336.2206127639331,336.971045945065,335.4701795828012,238493,416907.86666666664,54.054598073556996,62.94925273672056,NaN,NaN,NaN,NaN,3.5223470852382754,37.332621257518355,72761179,-1.0525132117729585,2.145312408987195,3.1978256207601534
2021-11-26T09:30:00-05:00,334.44,337.875,328.2,330.21,NaN,NaN,NaN,344.21753536511176,NaN,NaN,331.1579999999998,351.0570837980277,311.2589162019719,340.37380112252504,332.095,332.095,332.095,1271037,442298.06666666665,40.57287028591618,60.95714993724861,NaN,NaN,NaN,NaN,3.971465150578399,35.07903845837944,71490142,-1.497565928581603,1.3258682100331498,2.823434138614753
2021-11-26T13:30:00-05:00,330.08,330.08,330.08,330.08,NaN,NaN,NaN,344.21753536511176,NaN,NaN,331.54659999999984,350.5680672872711,312.5251327127286,340.37380112252504,332.0948414805014,332.11271301230755,332.0769699486952,100,429404.76666666666,40.39205203594628,59.05410143336898,NaN,NaN,NaN,NaN,3.6970747826799415,32.98642585917902,71490042,-1.732048475178643,0.6583735446414494,2.3904220198200923
2021-11-29T09:30:00-05:00,334.94,339.03,334.75,337.74,NaN,NaN,NaN,344.21753536511176,NaN,NaN,332.1131999999998,350.1242634622405,314.10213653775907,340.37380112252504,333.844013003626,336.25726013073614,331.43076587651586,667835,435997,53.532871890916624,58.02374140500564,NaN,NaN,NaN,NaN,4.072283726774231,32.14434158593296,72157877,-1.3211704659806278,0.7389589373443073,2.060129403324935
2021-11-29T13:30:00-05:00,337.74,337.93,336.3,336.3,NaN,NaN,NaN,344.21753536511176,NaN,NaN,332.6571999999998,349.4574504933924,315.85694950660724,340.37380112252504,334.36984220409414,336.8403474681119,331.8993369400764,412198,437460.8,51.24572358796941,57.03022876602938,NaN,NaN,NaN,NaN,3.8978348891474996,31.362406189347336,71745679,-1.1050613933111884,0.6788026616859497,1.783864054997138
2021-11-30T09:30:00-05:00,335.51,337.72,329,330.63,NaN,NaN,NaN,344.21753536511176,NaN,NaN,333.0935999999998,348.4663123228413,317.7208876771583,334.27904089802007,332.45,332.45,332.45,743525,448501.43333333335,43.38567252705755,55.25978228517385,NaN,NaN,NaN,NaN,4.242275254208395,29.29079332501457,71002154,-1.289788570951577,0.1716283413076667,1.4614169122592437
2021-11-30T13:30:00-05:00,330.53,332.49,330.07,330.51,NaN,NaN,NaN,342.8836106001919,NaN,NaN,333.5383999999998,347.2046359763348,319.87216402366477,328.620015151829,331.90719146217833,332.5998427009235,331.2145402234332,456625,454092.8333333333,43.23453184809757,53.48073250889041,NaN,NaN,NaN,NaN,4.112112736050654,27.367152808134144,70545529,-1.3589407176598611,-0.2372589848155826,1.1216817328442785
2021-12-01T09:30:00-05:00,335.2,339.28,333.93,335.92,NaN,NaN,NaN,342.8836106001919,NaN,NaN,334.0629999999998,345.92129886622683,322.2047011337728,328.620015151829,336.3766666666667,336.376670481364,336.37666285196946,779953,462279.2,51.446645927385816,52.08434027641768,NaN,NaN,NaN,NaN,4.444818969189892,26.511092849109712,71325482,-0.9960186225487393,-0.12334154534164554,0.8726770772070938
2021-12-01T13:30:00-05:00,335.9,335.97,329.43,329.97,NaN,NaN,NaN,342.8836106001919,NaN,NaN,334.46279999999985,344.20553229852794,324.72006770147175,328.620015151829,334.38263445294314,336.6563531289418,332.10891577694446,599873,472901.93333333335,43.9209471556177,50.24966901697777,NaN,NaN,NaN,NaN,4.5944747571049005,24.80885908571894,70725609,-1.1040042723142678,-0.507328263185741,0.5966760091285268
2021-12-02T09:30:00-05:00,330.45,333.45,327.83,330.2,NaN,NaN,NaN,342.8836106001919,NaN,NaN,334.55159999999984,344.05338455663787,325.0498154433618,328.620015151829,330.49333333333334,330.49333333333334,330.49333333333334,643281,480690.0333333333,44.26037647214977,48.476396665019685,NaN,NaN,NaN,NaN,4.667726560168837,23.14204741240266,71368890,-1.1045755759241138,-0.7840434607766156,0.3205321151474983
2021-12-02T13:30:00-05:00,330.32,331.4,328.57,329.46,NaN,NaN,NaN,342.58855552530537,NaN,NaN,334.6779999999998,343.7265349090776,325.62946509092205,327.0785582061892,330.18584580736564,330.52579859447144,329.84589302025984,526282,483703.3,43.351220131153504,47.28467595606183,NaN,NaN,NaN,NaN,4.536460377299632,21.594293715751828,70842608,-1.0971772823789234,-1.050939487826156,0.04623779455276744
2021-12-03T09:30:00-05:00,331.99,332.7,319.25,319.48,NaN,NaN,NaN,339.83975754688237,NaN,NaN,334.6035999999998,344.07949679982653,325.1277032001731,327.0785582061892,323.81,323.81,323.81,821166,499031.8,33.389808234897245,46.22812080595869,NaN,NaN,NaN,NaN,5.173141778921086,21.667463650272715,70021442,-1.6723461552189187,-2.044194899470881,-0.37184874425196224
2021-12-03T13:30:00-05:00,319.38,323.42,318.03,323.11,NaN,NaN,NaN,334.6945412947514,NaN,NaN,334.57959999999986,344.1651040222601,324.9940959777396,327.0785582061892,322.8542080191397,323.9834667695984,321.72494926868103,588262,509467.3,38.890171871710294,45.16984119517537,NaN,NaN,NaN,NaN,5.188631651855297,21.897719136939823,70609704,-1.7101355192849048,-2.5095181433580933,-0.7993826240731885
2021-12-06T09:30:00-05:00,323.95,324.99,319.31,324.99,NaN,NaN,NaN,334.6945412947514,NaN,NaN,334.4859999999998,344.3488263697977,324.62317363020196,327.0785582061892,323.09666666666664,323.09666666666664,323.09666666666664,576621,509185.36666666664,41.58073220594599,44.51844444630866,NaN,NaN,NaN,NaN,5.22372939100849,21.76267220252095,71186325,-1.5169080040218437,-2.695517629100493,-1.1786096250786495
2021-12-06T13:30:00-05:00,324.995,327.4,324.45,326.54,NaN,NaN,NaN,334.6945412947514,NaN,NaN,334.38699999999983,344.4651532038762,324.3088467961235,325.58066180156885,324.6503088675701,326.16652474522334,323.1340929899169,605439,518755.9,43.778552738733694,43.784441208107005,NaN,NaN,NaN,NaN,5.061320148793597,21.116774883222604,71791764,-1.2066153788590785,-2.6868788486524977,-1.4802634697934192
2021-12-07T09:30:00-05:00,331.88,335.78,330.17,334.81,318.4753998938118,318.4753998938118,318.4753998938118,NaN,NaN,NaN,334.5307999999999,344.4220784532952,324.63952154670454,325.58066180156885,333.58666666666664,333.58666666666664,333.58666666666664,740954,528859.3333333334,53.77170468137629,44.727215093497016,NaN,NaN,NaN,NaN,5.359797281022622,20.191430539093105,72532718,-0.4076098415081746,-1.9897757716786373,-1.5821659301704627
2021-12-07T13:30:00-05:00,334.83,335.68,332.58,334.76,319.86674535318394,NaN,NaN,NaN,NaN,NaN,334.6385999999999,344.41941796991745,324.8577820300823,325.58066180156885,333.92388348829394,334.29847858637004,333.54928839021784,600462,542807.7,53.70954609487619,45.67846466913486,NaN,NaN,NaN,NaN,5.198383189521008,19.332182219544286,71932256,0.125792353014607,-1.424925488902204,-1.550717841916811
2021-12-08T09:30:00-05:00,335.34,335.44,330.81,332.08,319.86674535318394,NaN,NaN,NaN,NaN,NaN,334.62939999999986,344.41895803704614,324.8398419629536,321.7405294412551,332.77666666666664,332.77666666666664,332.77666666666664,516673,543239.3666666667,50.34988637096687,45.45110856056702,NaN,NaN,NaN,NaN,5.157784390269507,18.19892452875852,71415583,0.2966305313441726,-1.1799296777365953,-1.476560209080768
2021-12-08T13:30:00-05:00,332.06,335.3,331.9,335.02,319.86674535318394,NaN,NaN,NaN,NaN,NaN,334.6651999999998,344.44711493731586,324.88328506268374,322.5965488106899,333.3814757744963,334.02834651344125,332.7346050355514,451666,545486.9,53.766514165031715,45.63116503035718,NaN,NaN,NaN,NaN,5.032228362393115,17.146613815886028,71867249,0.589244178423435,-0.7400049860514741,-1.3292491644749092
2021-12-09T09:30:00-05:00,334.67,336.48,333.17,334.67,320.9504685120057,NaN,NaN,NaN,NaN,NaN,334.7171999999999,344.470980838255,324.96341916174475,324.6622390485519,334.7733333333333,334.77334096272784,334.7733257039388,471624,547319.3333333334,53.296316986836395,46.33906820605567,NaN,NaN,NaN,NaN,4.909212050793607,16.393384899300383,71395625,0.7315419185965368,-0.41482176622923816,-1.146363684825775
2021-12-09T13:30:00-05:00,334.6,334.83,332.14,333.1,320.9504685120057,NaN,NaN,NaN,NaN,NaN,334.69919999999985,344.46152664075544,324.93687335924426,324.6622390485519,334.08124534576876,334.78939236430347,333.37309832723406,450476,549372.5,51.13603005927636,46.90346093542558,NaN,NaN,NaN,NaN,4.75069690430835,15.468403003978768,70945149,0.6926401958824636,-0.2805634399726955,-0.9732036358551591
2021-12-10T09:30:00-05:00,334.9,342.7,334.9,340.82,324.4988876318068,NaN,NaN,NaN,NaN,NaN,334.79839999999984,344.7056194767682,324.89118052323147,329.26063299107324,339.4733333333333,339.4733333333333,339.4733333333333,1111997,572455.4,59.770917787910626,47.49805178260592,NaN,NaN,NaN,NaN,5.097075696857751,15.96112966815759,72057146,1.1334928825872812,0.44366246737894244,-0.6898304152083388
2021-12-10T13:30:00-05:00,340.85,342.99,339.61,342.02,327.18802910308835,NaN,NaN,NaN,NaN,NaN,334.9087999999998,345.0105191725353,324.80708082746435,330.5485063928586,340.1838135332997,341.1654161168679,339.2022109497315,582554,581245.4333333333,60.92675340809694,48.71275222921158,NaN,NaN,NaN,NaN,4.974427432796483,16.461454484053185,72639700,1.433261484764254,1.1017464407469788,-0.3315150440172752
2021-12-13T09:30:00-05:00,340.68,343.78,339.88,340.96,327.8276641438571,NaN,NaN,NaN,NaN,NaN,335.0361999999998,345.2783207882386,324.79407921176096,331.87680511428687,341.53999999999996,341.53999999999996,341.53999999999996,525515,582726.7,59.30582946772893,49.78742744318153,NaN,NaN,NaN,NaN,4.897682616168161,17.047856216061813,72114185,1.481392337471228,1.5202253778217596,0.038833040350531756
2021-12-13T13:30:00-05:00,340.975,342.21,339.08,339.15,327.8276641438571,NaN,NaN,NaN,NaN,NaN,335.0999999999998,345.40389984427526,324.79610015572433,331.87680511428687,340.9412028872593,341.6309608120792,340.2514449624394,396051,586908.1,56.539742568114285,50.7294647601073,NaN,NaN,NaN,NaN,4.771419572156148,17.38244569173345,71718134,1.3180387843570376,1.6863815207968287,0.36834273643979115
2021-12-14T09:30:00-05:00,333.18,334.35,324.12,325.97,NaN,NaN,NaN,344.45028948875836,344.45028948875836,344.45028948875836,334.9029999999998,345.51630278475824,324.28969721524135,331.87680511428687,328.1466666666667,328.1466666666667,328.1466666666667,1019375,595901.6,41.398167052978756,51.30149038997026,NaN,NaN,NaN,NaN,5.504175317002136,17.38764235805016,70698759,0.30208325138300574,0.7459468006685483,0.4438635492855426
2021-12-14T13:30:00-05:00,325.98,329.67,325.17,328.63,NaN,NaN,NaN,342.55732178472385,NaN,NaN,334.73559999999975,345.474610874425,323.9965891255745,331.87680511428687,328.01768261390424,328.17601125278367,327.8593539750248,676530,603586.9666666667,44.62152925191791,51.71087305998509,NaN,NaN,NaN,NaN,5.43244850864484,17.392467833915678,71375289,-0.18482533105989551,0.21283188546067322,0.39765721652056873
2021-12-15T09:30:00-05:00,328.61,330.57,325.3,325.78,NaN,NaN,NaN,342.55732178472385,NaN,NaN,334.54959999999977,345.5765988374408,323.5226011625587,331.87680511428687,327.21666666666664,327.21666666666664,327.21666666666664,563230,596452.3666666667,41.95855862595298,51.73786066141416,NaN,NaN,NaN,NaN,5.420845043741636,17.212651656146825,70812059,-0.6658270551020206,-0.43462660235695694,0.2312004527450636
2021-12-15T13:30:00-05:00,325.8,335.17,324.61,334.66,NaN,NaN,NaN,342.55732178472385,NaN,NaN,334.52739999999983,345.54894966239976,323.5058503375999,331.87680511428687,329.7068301622254,331.8081351856507,327.6055251388001,790976,608204.2666666667,51.64224741603833,52.29955313836449,NaN,NaN,NaN,NaN,5.7879275406172335,16.16056462043782,71603035,-0.36781281841874114,-0.22856557027836288,0.13924724814037828
2021-12-16T09:30:00-05:00,335.57,336.66,325.9,327.01,NaN,NaN,NaN,342.55732178472385,NaN,NaN,334.44639999999987,345.62707029120435,323.2657297087954,331.87680511428687,329.8566666666666,329.8566666666666,329.8566666666666,854115,622762.9333333333,44.720131611248654,51.653012204783934,NaN,NaN,NaN,NaN,6.143075573430292,15.094310386931783,70748920,-0.6512165314239835,-0.6747734161396011,-0.023556884715617593
2021-12-16T13:30:00-05:00,326.98,327.89,323.03,325.18,NaN,NaN,NaN,342.0275116454429,NaN,NaN,334.3343999999998,345.76904501245264,322.89975498754694,331.87680511428687,327.68115147787955,329.92507591087417,325.43722704488493,802831,641574.2,43.22744834215694,50.90429093673257,NaN,NaN,NaN,NaN,6.051427318185273,14.433955214127694,69946089,-0.9112822027967921,-1.1626596382116077,-0.2513774354148156
2021-12-17T09:30:00-05:00,320.8,323.8,317.25,323.07,NaN,NaN,NaN,337.42080657065003,NaN,NaN,334.1311999999998,345.99034441436515,322.27205558563446,331.87680511428687,321.3733333333333,321.3733333333333,321.3733333333333,733182,623645.7,41.507150819188844,50.27266696874842,NaN,NaN,NaN,NaN,6.18561108117204,14.706757181294053,69212907,-1.1588789189712496,-1.6999760841288776,-0.541097165157628
2021-12-17T13:30:00-05:00,323.06,324.88,321.7,323.84,NaN,NaN,NaN,337.42080657065003,NaN,NaN,333.9593999999998,346.15622018236246,321.7625798176371,331.87680511428687,322.18352990979,323.20577954567034,321.1612802739097,460552,638994.1,42.40789174091075,49.46133679559692,NaN,NaN,NaN,NaN,5.970924575374037,14.741933416059153,69673459,-1.1992447153268093,-2.0401530593161397,-0.8409083439893303
2021-12-20T09:30:00-05:00,320.05,322.72,317.61,318.48,NaN,NaN,NaN,336.82320392077827,NaN,NaN,333.59759999999983,346.51512890303513,320.6800710969645,331.1224440914295,319.60333333333335,319.60333333333335,319.60333333333335,418357,630678.1666666666,38.018984720775364,48.370098776592556,NaN,NaN,NaN,NaN,5.989429962847318,15.351783350252765,69255102,-1.4960751020374543,-2.7110022215361482,-1.214927119498694
2021-12-20T13:30:00-05:00,318.54,320.4,317.99,320.15,NaN,NaN,NaN,335.42464919710653,NaN,NaN,333.2651999999998,346.6846821003203,319.84571789967936,317.96495527314363,319.5675491562585,319.61159536624535,319.52350294627166,276129,626142.5333333333,40.09906299766373,47.58174398647737,NaN,NaN,NaN,NaN,5.733756394072507,15.918072574861123,69531231,-1.4860441516569858,-3.072482309069926,-1.5864381574129403
2021-12-21T09:30:00-05:00,323.34,325.98,319.81,325.53,NaN,NaN,NaN,335.42464919710653,NaN,NaN,333.07239999999985,346.6529087150953,319.4918912849044,317.95285709984955,323.7733333333333,323.7733333333333,323.7733333333333,498584,617977.8333333334,46.34608321984013,46.62282723161519,NaN,NaN,NaN,NaN,5.7649166516387575,15.290197160977154,70029815,-1.0440537710931512,-2.8915053712793792,-1.847451600186228
2021-12-21T13:30:00-05:00,325.61,327.71,325.61,327.36,NaN,NaN,NaN,335.42464919710653,NaN,NaN,332.89719999999977,346.5417933849617,319.25260661503785,317.95285709984955,325.1502553242032,326.6994752706843,323.60103537772216,393850,615885.3333333334,48.32037854505263,45.72237188425488,NaN,NaN,NaN,NaN,5.508851176521704,14.386461121293795,70423665,-0.5786625510568153,-2.570779789007247,-1.9921172379504317
2021-12-22T09:30:00-05:00,328.3,331.55,325.8,330.54,NaN,NaN,NaN,335.42464919710653,NaN,NaN,332.70859999999976,346.2169381717012,319.2002618282983,318.6522558804905,329.2966666666667,329.2966666666667,329.2966666666667,585405,609400.4,51.64980645912178,45.17551309792581,NaN,NaN,NaN,NaN,5.526076092484439,13.838041772398505,71009070,-0.03552797980641431,-2.0365272127084495,-2.000999232902035
2021-12-22T13:30:00-05:00,330.65,333.59,330.03,333.17,NaN,NaN,NaN,335.42464919710653,NaN,NaN,332.58319999999986,345.95497591199825,319.2114240880015,321.49180470439234,330.42596032905595,331.8664233411476,328.9854973169643,359804,601398.1,54.273605467201186,45.0136461621463,NaN,NaN,NaN,NaN,5.385642085878408,13.658770499439877,71368874,0.49284386648647827,-1.3849443997939375,-1.8777882662804157
2021-12-23T09:30:00-05:00,332.97,336.38,332.75,334.63,319.0736081455657,319.0736081455657,319.0736081455657,NaN,NaN,NaN,332.4733999999998,345.6850255533099,319.2617744466897,324.8864437635139,334.5866666666667,334.5866666666667,334.5866666666667,446811,594849.1,55.710468026118214,46.0359533745134,NaN,NaN,NaN,NaN,5.260239079744236,13.922841825288588,71815685,0.908474639971357,-0.7421949663162195,-1.6506696062875765
2021-12-23T13:30:00-05:00,334.66,336.09,334.38,334.51,320.2145805025855,NaN,NaN,NaN,NaN,NaN,332.38059999999984,345.46793214069146,319.29326785930823,326.04015501081113,334.7458774544852,334.94436585571196,334.5473890532584,287474,586888.8333333334,55.55594546926641,46.81698310432402,NaN,NaN,NaN,NaN,5.0066505740482175,14.168050913576677,71528211,1.1287509349323481,-0.23973093762214148,-1.3684818725544896
2021-12-27T09:30:00-05:00,335.76,341,335.5,340.87,323.027326843377,NaN,NaN,NaN,NaN,NaN,332.37359999999984,345.44237424094587,319.3048257590538,329.7151240086489,339.12333333333333,339.12333333333333,339.12333333333333,555866,578045.5,61.63034708449958,48.22211085136305,NaN,NaN,NaN,NaN,5.112604104473346,15.114962930553084,72084077,1.6260013898635575,0.6640198647749571,-0.9619815250886002
2021-12-27T13:30:00-05:00,340.84,342.44,340.68,342.37,326.7892665323144,NaN,NaN,NaN,NaN,NaN,332.39679999999987,345.5321869771961,319.26141302280365,332.5320992069191,340.41427040695663,341.7661645662304,339.0623762476829,506868,575332.3666666667,62.917636115430426,49.027495758462486,NaN,NaN,NaN,NaN,4.87313238272525,16.186327753835197,72590945,1.9569273596403352,1.4841776744618187,-0.4727496851785164
2021-12-28T09:30:00-05:00,343.02,343.8,340.38,341.55,327.5242998717547,NaN,NaN,NaN,NaN,NaN,332.3629999999999,345.39489579457756,319.3311042054222,334.1636793655353,341.91,341.91,341.91,422246,570186.5333333333,61.69900122419336,50.24027215938712,NaN,NaN,NaN,NaN,4.76933721253059,17.362467113881415,72168699,2.013739464842845,2.04442464587504,0.03068518103219492
2021-12-28T13:30:00-05:00,341.56,342.29,340.58,341.28,327.5242998717547,NaN,NaN,NaN,NaN,NaN,332.3321999999999,345.272046855381,319.39235314461877,334.1636793655353,341.6814405198689,341.94246776672026,341.4204132730175,323737,560796.4666666667,61.27813762596425,51.52960710823049,NaN,NaN,NaN,NaN,4.550813125921264,18.45459651963862,71844962,1.926274121287681,2.438527832641796,0.5122537113541151
2021-12-29T09:30:00-05:00,341.63,344.3,339.7,340.67,327.8785046352145,NaN,NaN,NaN,NaN,NaN,332.29219999999987,345.1158165195638,319.46858348043594,335.1487547939426,341.5566666666667,341.5566666666667,341.5566666666667,487641,552352.7,60.27774386828365,52.87036375459441,NaN,NaN,NaN,NaN,4.5543264740697476,19.750639819501917,71357321,1.7268751717430328,2.6708476760329063,0.9439725042898734
2021-12-29T13:30:00-05:00,340.68,342.76,340.61,341.96,327.9122089699775,NaN,NaN,NaN,NaN,NaN,332.3341999999999,345.26995144476234,319.39844855523745,335.1487547939426,341.63566420230137,341.74120493952717,341.5301234650756,273204,541444.1,61.70167743146551,54.24849130391975,NaN,NaN,NaN,NaN,4.38258886877905,20.954108597946405,71630525,1.5850888923309987,2.925333619703622,1.3402447273726232
2021-12-30T09:30:00-05:00,342.07,343.12,340.67,340.91,328.41415401679666,NaN,NaN,NaN,NaN,NaN,332.4531999999999,345.5912737949164,319.31512620508346,335.17820306812325,341.56666666666666,341.56666666666666,341.56666666666666,387559,537140.3,59.82192575433373,55.8058442348882,NaN,NaN,NaN,NaN,4.2445468067234025,22.126081063066106,71242966,1.3338997179232688,3.0076193747767093,1.6737196568534405
2021-12-30T13:30:00-05:00,340.95,341.37,338.83,339.27,328.41415401679666,NaN,NaN,NaN,NaN,NaN,332.4843999999999,345.67954587114383,319.28925412885593,335.17820306812325,340.6980072919215,341.5696687709392,339.8263458129038,384894,534914.5666666667,56.90584453811395,57.00632863063464,NaN,NaN,NaN,NaN,4.122793463386018,22.605146894011828,70858072,0.986614031081634,2.906987195705483,1.9203731646238489
2021-12-31T09:30:00-05:00,338.59,339.32,335.85,337.84,328.41415401679666,NaN,NaN,NaN,NaN,NaN,332.5153999999999,345.75337640731937,319.2774235926804,335.17820306812325,337.67,337.67,337.67,429816,533520.9666666667,54.41506521011253,57.582684487082666,NaN,NaN,NaN,NaN,4.076165358858444,22.150815704252256,70428256,0.608455217965199,2.6809421870803476,2.0724869691151486
2021-12-31T13:30:00-05:00,337.82,338,336.13,336.32,328.41415401679666,NaN,NaN,NaN,NaN,NaN,332.4815999999999,345.6718311488737,319.2913688511261,335.17820306812325,337.27309625586594,337.6987235727809,336.84746893895095,373761,530963.8,51.818749269359664,57.83256811024746,NaN,NaN,NaN,NaN,3.918582118939984,21.728936742332653,70054495,0.22363905500981085,2.352035787877412,2.1283967328676012
2022-01-03T09:30:00-05:00,335.29,337.77,329.78,332.33,328.41415401679666,NaN,NaN,NaN,NaN,NaN,332.5239999999999,345.69837026960755,319.3496297303922,335.17820306812325,333.2933333333333,333.2933333333333,333.2933333333333,729640,518218.56666666665,45.6600529766406,57.40472857578452,NaN,NaN,NaN,NaN,4.209397681872843,20.631574043657654,69324855,-0.3033164549831793,1.7492511641386272,2.0525676191218065
2022-01-03T13:30:00-05:00,332.37,334.76,332.17,334.72,328.41415401679666,NaN,NaN,NaN,NaN,NaN,332.61679999999996,345.7863682176958,319.44723178230413,335.17820306812325,333.51545715521974,333.801313872231,333.2296004382085,440557,513485.3333333333,49.529502088544255,57.065864048737595,NaN,NaN,NaN,NaN,4.093726418881923,19.612594394888013,69765412,-0.4838902607038935,1.4477047932419396,1.931595053945833
2022-01-04T09:30:00-05:00,334.73,334.75,326.59,327.7,NaN,NaN,NaN,344.1992813045403,344.1992813045403,344.1992813045403,332.41599999999994,345.5731449790807,319.25885502091916,335.17820306812325,329.68,329.68,329.68,722653,520056.6,40.42418462946895,55.97398666326264,NaN,NaN,NaN,NaN,4.38417453181893,19.772848938461113,69042759,-1.0373140801746492,0.6349524537275215,1.6722665339021707
2022-01-04T13:30:00-05:00,327.655,330.3,326.15,329.06,NaN,NaN,NaN,341.7052230634249,NaN,NaN,332.2711999999999,345.4135277329644,319.12887226703543,335.17820306812325,329.14546938497074,329.7313374406124,328.5596013293291,601555,526906.7333333333,42.62478867889122,55.050332606807274,NaN,NaN,NaN,NaN,4.3674477795461515,19.99898472329994,69644314,-1.2582654024448259,0.09943478084613844,1.3577001832909643
2022-01-05T09:30:00-05:00,325.72,325.98,320.15,321.39,NaN,NaN,NaN,337.14748565145106,NaN,NaN,332.08639999999986,345.5712334124243,318.6015665875754,335.17820306812325,322.50666666666666,322.50666666666666,322.50666666666666,936674,524150.0333333333,34.814409990568535,53.13490852866935,NaN,NaN,NaN,NaN,4.691915795292857,21.139505685592855,68707640,-1.8326524340145782,-0.9331153592272585,0.8995370747873197
2022-01-05T13:30:00-05:00,321.36,324,316,316.22,NaN,NaN,NaN,334.53328175820326,NaN,NaN,331.8005999999999,345.99407084263186,317.607129157368,335.17820306812325,320.71938043190835,322.6002630436944,318.8384978201223,845772,529791.4333333333,30.727318355976365,50.835600117279775,NaN,NaN,NaN,NaN,4.92820752420051,22.710100452849062,67861868,-2.434734658512583,-2.1438812483534093,0.29085341015917376
2022-01-06T09:30:00-05:00,313.15,318.67,311.57,314.84,NaN,NaN,NaN,329.96085986010314,NaN,NaN,331.37899999999985,346.29204891699965,316.46595108300005,333.7465624544986,315.02666666666664,315.02666666666664,315.02666666666664,1007932,544614.8333333334,29.724230030874196,48.55168788918554,NaN,NaN,NaN,NaN,5.08333555818619,24.631297983509928,66853936,-2.775195349639217,-3.1781407768898475,-0.40294542725063054
2022-01-06T13:30:00-05:00,314.88,316.21,313.06,313.85,NaN,NaN,NaN,329.23082077555296,NaN,NaN,331.0565999999999,346.75391524053197,315.3592847594678,331.4862499635989,314.7870088481121,315.1018748060131,314.47214289021116,583933,537713.4,28.99300912510799,46.24560728198152,NaN,NaN,NaN,NaN,4.945240161172889,26.41526711912359,66270003,-2.9026150996314852,-4.031214301789987,-1.1285992021585018
2022-01-07T09:30:00-05:00,313.91,316.47,310.1,313.9,NaN,NaN,NaN,328.0860107403006,NaN,NaN,330.7305999999999,347.14613576830646,314.3150642316934,330.7979999708791,313.49,313.49,313.49,633867,530371.8,29.087889826857847,44.01776056473682,NaN,NaN,NaN,NaN,5.047008721089112,28.363801271076433,66903870,-2.8168393438427834,-4.649648381961981,-1.8328090381191977
2022-01-07T13:30:00-05:00,313.9,315.67,313.34,314,NaN,NaN,NaN,328.0860107403006,NaN,NaN,330.42139999999995,347.49041520769373,313.35238479230617,328.0133999767033,313.824657618542,314.23859931576226,313.41071592132175,414306,517420.9666666667,29.291389521293183,41.70273999972451,NaN,NaN,NaN,NaN,4.852936669582749,30.173154412175496,67318176,-2.592322252326537,-5.0732118535273685,-2.4808896012008317
2022-01-10T09:30:00-05:00,309.34,310.34,304.74,309.86,NaN,NaN,NaN,322.59205730676143,NaN,NaN,330.22899999999987,347.98984919143044,312.4681508085693,325.6597199813626,308.31333333333333,308.31333333333333,308.31333333333333,854682,521470.9666666667,25.96877580322834,39.28465786035984,NaN,NaN,NaN,NaN,5.167726907469695,32.56327196997098,66463494,-2.5572928041777665,-5.67750560642304,-3.1202128022452733
2022-01-10T13:30:00-05:00,309.97,314.72,309.36,314.07,NaN,NaN,NaN,322.59205730676143,NaN,NaN,330.04819999999995,348.2732283687153,311.8231716312846,323.3897759850901,310.10143094138164,312.2639056221258,307.9389562606375,584366,525598.1,34.1490583985247,37.65917313610346,NaN,NaN,NaN,NaN,5.1814606997932895,33.55147355881326,67047860,-2.1041607609960264,-5.750413753490307,-3.64625299249428
2022-01-11T09:30:00-05:00,313.38,316.59,309.92,315.03,NaN,NaN,NaN,322.59205730676143,NaN,NaN,329.84899999999993,348.50348503713076,311.1945149628691,319.1368207880721,313.84666666666664,313.84666666666664,313.84666666666664,643490,533102.5333333333,35.88870778053007,36.335861891133284,NaN,NaN,NaN,NaN,5.287784935522337,33.986032767372535,67691350,-1.6153356411148732,-5.665422543887871,-4.050086902772998
2022-01-11T13:30:00-05:00,315.05,316.18,313.305,314.97,NaN,NaN,NaN,322.59205730676143,NaN,NaN,329.61759999999987,348.71237522676483,310.5228247732349,312.59445663045767,314.28154567166945,314.7646995645338,313.79839177880507,521324,541275.7,35.82500612608682,35.1934516666138,NaN,NaN,NaN,NaN,5.115443154413598,34.389552032463286,67170026,-1.1911761531967766,-5.539057094268969,-4.347880941072193
2022-01-12T09:30:00-05:00,319.9,323.38,317.83,318.96,305.1231912220977,305.1231912220977,305.1231912220977,NaN,NaN,NaN,329.3005999999999,348.56555155873906,310.0356484412608,309.2915653043661,320.0566666666667,320.0566666666667,320.0566666666667,731508,549039.8333333334,43.06263905078959,35.007922100481586,NaN,NaN,NaN,NaN,5.350768643384053,33.05867284311869,67901534,-0.5686065019938935,-5.05863906856456,-4.490032566570666
2022-01-12T13:30:00-05:00,318.95,319.34,317.1,318.22,305.1231912220977,NaN,NaN,NaN,NaN,NaN,328.9697999999999,348.41558658323123,309.5240134167686,308.5052908647157,319.5081757202467,320.3487426241543,318.6676088163391,311468,546293.7666666667,42.114000600611135,34.478243422772074,NaN,NaN,NaN,NaN,5.128570883142332,31.93314977672413,67590066,-0.15487491477348048,-4.683626210037517,-4.528751295264036
2022-01-13T09:30:00-05:00,320.5,320.79,308.63,310.09,305.1231912220977,NaN,NaN,NaN,NaN,NaN,328.52999999999986,348.65726508993816,308.40273491006155,308.5052908647157,313.17,313.17,313.17,954860,558608.9333333333,33.40680130252895,33.977001756562075,NaN,NaN,NaN,NaN,5.6308158200607386,31.988795515056218,66635206,-0.3649870180066106,-4.9849850677723,-4.619998049765689
2022-01-13T13:30:00-05:00,309.92,311.01,304,304.69,NaN,NaN,NaN,323.787196759218,323.787196759218,323.787196759218,327.9233999999999,349.0357893901331,306.8110106098667,308.5052908647157,309.63732338361274,312.9308985202876,306.3437482469379,1098531,583233.1666666666,29.102780450463356,33.01114402596008,NaN,NaN,NaN,NaN,5.729328975770685,32.51559669970856,65536675,-0.7800437354445835,-5.595052719071418,-4.815008983626835
2022-01-14T09:30:00-05:00,304.25,309.69,303.79,307.44,NaN,NaN,NaN,323.0866423610717,NaN,NaN,327.37879999999984,349.1611523578316,305.5964476421681,308.5052908647157,306.9733333333334,306.9733333333334,306.9733333333334,971920,600736.8,33.78165511393685,32.93737582048639,NaN,NaN,NaN,NaN,5.741519763215635,33.02558236890994,66508595,-0.7799059700786675,-5.78989144622517,-5.009985476146502
2022-01-14T13:30:00-05:00,307.45,310.8,306.88,310.17,NaN,NaN,NaN,323.0866423610717,NaN,NaN,326.92019999999985,349.1621080080971,304.6782919919026,308.5052908647157,307.8177370641447,308.93019153851736,306.705282589772,559972,609820.0666666667,38.14577070191869,33.46726527376798,NaN,NaN,NaN,NaN,5.6114112087002335,33.233537439033064,67068567,-0.5190383582449911,-5.658783423952741,-5.13974506570775
2022-01-18T09:30:00-05:00,304.16,309.79,302.38,303.85,NaN,NaN,NaN,322.55187868023273,NaN,NaN,326.18079999999986,348.97636968888247,303.38523031111725,308.5052908647157,305.34000000000003,305.34000000000003,305.34000000000003,868912,620254.9333333333,32.76262932052546,33.68429379445735,NaN,NaN,NaN,NaN,5.767024693793076,33.903176286859456,66199655,-0.6847923052382212,-5.995735447255527,-5.310943142017305
2022-01-18T13:30:00-05:00,303.83,304.93,301.77,302.67,NaN,NaN,NaN,319.4992932856767,NaN,NaN,325.3937999999999,348.6598851507214,302.1277148492784,308.5052908647157,304.42239898417637,305.5141974824421,303.3306004859106,613760,623818,31.858634054715296,33.8889812894293,NaN,NaN,NaN,NaN,5.580808644236429,34.58637223709829,65585895,-0.7796717122686143,-6.285532782353073,-5.505861070084459
2022-01-19T09:30:00-05:00,306.29,313.9,305.33,309.88,NaN,NaN,NaN,319.4992932856767,NaN,NaN,324.7721999999999,348.0022427171503,301.5421572828495,308.5052908647157,309.7033333333333,309.7033333333333,309.7033333333333,1001475,643125.6333333333,42.329427886191766,34.834805436524576,NaN,NaN,NaN,NaN,5.984322312505253,33.25641168561541,66587370,-0.2879473664471721,-5.865795278143423,-5.577847911696251
2022-01-19T13:30:00-05:00,309.99,310.12,302.74,303.31,NaN,NaN,NaN,319.4992932856767,NaN,NaN,324.0553999999999,347.6751389350651,300.4356610649347,308.5052908647157,308.2362585863245,310.2797052079564,306.19281196469257,516200,649541.0666666667,36.782807584587104,35.36990672675986,NaN,NaN,NaN,NaN,6.084013575897735,32.359095919776976,66071170,-0.33307927259881076,-5.994197002444764,-5.661117729845953
2022-01-20T09:30:00-05:00,309.02,311.57,307.45,308.55,NaN,NaN,NaN,319.4992932856767,NaN,NaN,323.7069999999999,347.71422133027227,299.6997786697275,306.32023269177256,309.19,309.19,309.19,616640,653841.0333333333,43.17799389769244,36.599136590650154,NaN,NaN,NaN,NaN,6.239441177619325,31.243082173814024,66687810,0.042109376968026524,-5.60848100863592,-5.650590385603946
2022-01-20T13:30:00-05:00,308.56,309.02,301.15,301.52,NaN,NaN,NaN,319.4992932856767,NaN,NaN,323.1647999999999,347.91581848087657,298.41378151912323,304.2941861534181,306.8082743325204,309.4416468301734,304.1749018348674,504418,661548.1666666666,37.671893031609386,36.85076763587049,NaN,NaN,NaN,NaN,6.35590966493223,30.998171922405206,66183392,-0.12205991191394894,-5.803165275496383,-5.681105363582434
2022-01-21T09:30:00-05:00,302.685,304.05,297.63,299.86,NaN,NaN,NaN,318.71061151966717,NaN,NaN,322.6463999999999,348.2284233007605,297.06437669923935,296.8435629750016,300.5133333333334,300.5133333333334,300.5133333333334,1094955,685128.0333333333,36.48864211226753,36.893620088137446,NaN,NaN,NaN,NaN,6.3604875460085,31.152976251733698,65088437,-0.272703228185593,-6.021984398814425,-5.749281170628832
2022-01-21T13:30:00-05:00,299.86,301.52,295.67,295.87,NaN,NaN,NaN,316.45103826877323,NaN,NaN,321.87059999999997,348.2873442081798,295.45385579182016,296.8435629750016,299.25619768965737,300.6608732368419,297.85152214247285,877018,701532.1666666666,33.745053343659535,36.74505203224978,NaN,NaN,NaN,NaN,6.324024149865033,31.49990006625473,64211419,-0.5550453661774455,-6.443087878350639,-5.888042512173193
2022-01-24T09:30:00-05:00,292.2,292.78,276.05,286.17,NaN,NaN,NaN,304.1621274383744,NaN,NaN,321.0537999999999,349.2499926195827,292.8576073804171,296.8435629750016,285,285,285,2036934,755102.7666666667,28.19478881407983,35.683062729627665,NaN,NaN,NaN,NaN,7.288022424874673,33.259570966687576,62174485,-1.268266732506783,-7.473375927806671,-6.2051091952998885
2022-01-24T13:30:00-05:00,286.25,297.09,285.49,296.81,NaN,NaN,NaN,304.1621274383744,NaN,NaN,320.48639999999995,349.45873874164346,291.51406125835643,296.8435629750016,288.1362079349322,292.093678124315,284.1787377455494,1279238,785285.3333333334,39.87640833975316,35.52323471099495,NaN,NaN,NaN,NaN,7.596020823097908,34.12122635582645,63453723,-0.9132246905961399,-7.346640058545063,-6.433415367948923
2022-01-25T09:30:00-05:00,291.48,293.6,285.2,289.96,NaN,NaN,NaN,304.1621274383744,NaN,NaN,319.8241999999999,350.01786267017985,289.63053732981996,296.8435629750016,289.58666666666664,289.58666666666664,289.58666666666664,1070374,796643.1333333333,35.83453672719736,35.696644384185554,NaN,NaN,NaN,NaN,7.882733621448059,34.940835043910425,62383349,-1.0213172469928633,-7.710061926690003,-6.688744679697139
2022-01-25T13:30:00-05:00,289.85,294.98,287.78,288.41,NaN,NaN,NaN,304.1621274383744,NaN,NaN,319.1155999999999,350.5370390911776,287.69416090882225,296.8435629750016,289.96035001232525,290.36104072202943,289.55965930262107,930946,812989.4333333333,34.97076803205262,36.11578635429907,NaN,NaN,NaN,NaN,7.833966934201773,35.44243915178726,61452403,-1.0734657999489272,-8.030576929633298,-6.957111129684371
2022-01-26T09:30:00-05:00,307.985,308.47,298.57,302.15,280.6348504570107,280.6348504570107,280.6348504570107,NaN,NaN,NaN,318.78899999999993,350.56752060748755,287.0104793925123,293.571880304001,303.0633333333333,303.0633387281299,303.06332793853664,1829022,849868.4,47.13543097172735,37.06962748699839,NaN,NaN,NaN,NaN,8.707255010330218,33.798926251388025,63281425,-0.10959729657653838,-7.094107750405044,-6.984510453828506
2022-01-26T13:30:00-05:00,302.03,306.59,293.1,296.94,280.6348504570107,NaN,NaN,NaN,NaN,NaN,318.32479999999987,350.68302250743403,285.9665774925657,293.571880304001,301.2546934477477,303.3285772644669,299.18080963102847,1391087,876186.1333333333,43.79035779531876,37.472812279384115,NaN,NaN,NaN,NaN,9.048879652449484,32.79364250301195,61890338,0.23146849958068305,-6.695174829352652,-6.926643328933335
2022-01-27T09:30:00-05:00,302.69,307.29,298.99,299.13,280.6348504570107,NaN,NaN,NaN,NaN,NaN,317.7967999999999,350.5269308130688,285.066669186931,290.68650424320083,301.80333333333334,301.80333333333334,301.80333333333334,1319122,888934.4,45.539912592548966,38.385475370242936,NaN,NaN,NaN,NaN,9.141816820131664,31.763139247227954,63209460,0.6360175406487638,-6.131621403122381,-6.767638943771145
2022-01-27T13:30:00-05:00,299.2,302.05,297.96,299.79,280.6348504570107,NaN,NaN,NaN,NaN,NaN,317.24539999999985,350.24037688074236,284.25042311925733,286.1732033945607,301.1561666884786,302.045760393295,300.26657298366223,698126,884012.8666666667,46.08455869107979,39.40161284426897,NaN,NaN,NaN,NaN,8.780972761550833,30.909223710044742,63907586,0.9600588822644553,-5.567565340940575,-6.527624223205031
2022-01-28T09:30:00-05:00,300.23,305.4,294.5,303.38,280.6348504570107,NaN,NaN,NaN,NaN,NaN,316.7021999999999,349.69808563200934,283.70631436799044,284.29356271564853,301.0933333333333,301.0933333333333,301.0933333333333,1063627,885869.3666666667,49.0682887375934,39.882960047940514,NaN,NaN,NaN,NaN,8.932331850011487,30.460289320470384,64971213,1.401450361569431,-4.775811271243242,-6.177261632812673
2022-01-28T13:30:00-05:00,303.43,308.44,299.96,308.13,280.6348504570107,NaN,NaN,NaN,NaN,NaN,316.20139999999986,348.9414183286561,283.46138167134364,283.51825163244786,303.0004250393761,305.1881155095008,300.81273456925146,808278,893347.5333333333,52.79096548361562,41.026399897871116,NaN,NaN,NaN,NaN,8.900022432153524,29.56479697733568,65779491,1.9640904641882795,-3.7221485525773232,-5.686239016765603
2022-01-31T09:30:00-05:00,308.76,312.38,306.4,307.49,285.6903957387624,NaN,NaN,NaN,NaN,NaN,315.65859999999986,348.0566290783363,283.26057092166343,289.4526013059583,308.75666666666666,308.75666666666666,308.75666666666666,1010757,905910.5333333333,52.2369575549751,41.67346873053417,NaN,NaN,NaN,NaN,8.691449401285416,28.145274062770536,64768734,2.224778563586396,-2.9052658122826074,-5.130044375869003
2022-01-31T13:30:00-05:00,307.56,311.49,307,311.1,286.0103777506368,NaN,NaN,NaN,NaN,NaN,315.19039999999984,347.1589452806471,283.22185471935256,290.9030810447666,309.1924842488927,309.73319473150997,308.6517737662754,656639,913988.3,55.099298808266745,42.918283428866836,NaN,NaN,NaN,NaN,8.391345872622173,26.827145642102906,65425373,2.548697647063248,-1.9441723170399428,-4.492869964103191
2022-02-01T09:30:00-05:00,310.51,310.63,305.33,306.65,286.0103777506368,NaN,NaN,NaN,NaN,NaN,314.50599999999986,345.7020574432204,283.30994255677933,291.2754648358133,307.5366666666667,307.5366666666667,307.5366666666667,868140,914436.9,51.03890404034214,43.95758785230073,NaN,NaN,NaN,NaN,8.204106881720593,25.817181413859792,64557233,2.375088944909565,-1.5240087829662343,-3.8990977278757994
2022-02-01T13:30:00-05:00,306.66,309.24,305.14,308.8,286.0103777506368,NaN,NaN,NaN,NaN,NaN,313.83459999999985,344.0320065668034,283.63719343319633,291.70637186865065,307.6130500217434,307.70620806245205,307.51989198103473,583642,914412.7666666667,52.846892438669336,45.322004930515725,NaN,NaN,NaN,NaN,7.910956390169124,24.90460655815773,65140875,2.314523593539378,-1.0059432359515768,-3.3204668294909547
2022-02-02T09:30:00-05:00,309.63,315.09,308.9,311.27,289.6785812686559,NaN,NaN,NaN,NaN,NaN,313.2289999999998,342.37502991834106,284.0829700816586,297.9180974949205,311.75333333333333,311.75333333333333,311.75333333333333,756117,918167,54.907031386200785,47.2300222570958,NaN,NaN,NaN,NaN,7.795173790871327,23.149822364263798,65896992,2.343132945196931,-0.3915506479947908,-2.734683593191722
2022-02-02T13:30:00-05:00,311.31,314.08,311.09,313.4,290.8752366655351,NaN,NaN,NaN,NaN,NaN,312.67139999999984,340.69462322932907,284.6481767706706,298.8474779959364,312.2023315871306,312.7443604684242,311.66030270583695,518840,918084.2,56.66531594110473,48.429229942906616,NaN,NaN,NaN,NaN,7.451947091523375,21.520379898505144,66415832,2.3990970439754533,0.2641877117775948,-2.1349093321978585
2022-02-03T09:30:00-05:00,309.49,311.2,305.9,306.08,290.8752366655351,NaN,NaN,NaN,NaN,NaN,311.97959999999983,338.8896109134277,285.06958908657197,298.8474779959364,307.72666666666663,307.72666666666663,307.72666666666663,794601,920187.3,49.51919918370719,49.40670583265732,NaN,NaN,NaN,NaN,7.455379442128849,20.737112385622726,65621231,1.8607278872379833,0.19100052684962066,-1.6697273603883627
2022-02-03T13:30:00-05:00,306.07,306.52,300.12,301.22,290.8752366655351,NaN,NaN,NaN,NaN,NaN,311.16479999999984,336.8328474489368,285.4967525510629,298.8474779959364,305.04742277316683,307.597649751683,302.4971957946507,877033,939039.4666666667,45.423368439748366,50.15332014749273,NaN,NaN,NaN,NaN,7.379995196262501,20.745788240193423,64744198,1.1308148386505636,-0.2562088120751582,-1.3870236507257219
2022-02-04T09:30:00-05:00,300.93,307.71,299.99,307.11,290.8752366655351,NaN,NaN,NaN,NaN,NaN,310.48879999999986,334.7283114274345,286.2492885725652,298.8474779959364,304.93666666666667,304.93666666666667,304.93666666666667,692303,930287.5666666667,50.74099387148886,50.41086035461855,NaN,NaN,NaN,NaN,7.404281253672321,20.53884095989384,65436501,1.0025715678867972,-0.13380919086722542,-1.1363807587540227
2022-02-04T13:30:00-05:00,307.2,308.79,305.83,305.83,290.8752366655351,NaN,NaN,NaN,NaN,NaN,309.8199999999999,332.65051677033716,286.9894832296626,298.8474779959364,305.6397288417502,306.54937738217797,304.7300803013224,413558,907455.1333333333,49.60974701436714,50.82653101312201,NaN,NaN,NaN,NaN,7.086832592695729,20.14663944981565,65022943,0.7983082687725247,-0.1384954227883668,-0.9368036915608915
2022-02-07T09:30:00-05:00,305.76,307.77,301.82,303.48,290.8752366655351,NaN,NaN,NaN,NaN,NaN,309.13279999999986,330.57457083733436,287.69102916266536,298.8474779959364,304.3566666666666,304.3566666666666,304.3566666666666,444094,889860.9333333333,47.515276490248795,50.96762843438628,NaN,NaN,NaN,NaN,7.005630264646034,20.309003905490588,64578849,0.4870005019988142,-0.3280530640623738,-0.815053566061188
2022-02-07T13:30:00-05:00,303.53,304.9,299.91,300.88,290.8752366655351,NaN,NaN,NaN,NaN,NaN,308.42399999999986,328.52517250313446,288.3228274968653,298.8474779959364,303.1121198952402,304.34203387248414,301.88220591799626,454724,886352.6666666666,45.239571847101736,50.90727223124499,NaN,NaN,NaN,NaN,6.861656674314171,20.695916149044933,64124125,0.10785421562960096,-0.6802357965241868,-0.7880900121537877
2022-02-08T09:30:00-05:00,301.13,305.53,299.98,303.94,290.8752366655351,NaN,NaN,NaN,NaN,NaN,307.8561999999999,326.79442331267614,288.91797668732363,298.8474779959364,303.15000000000003,303.15000000000003,303.15000000000003,574683,876545.0333333333,48.37349349715989,50.85764399978546,NaN,NaN,NaN,NaN,6.767966911863155,20.92127983283355,64698808,0.06702568990328928,-0.7043078997746761,-0.7713335896779654
2022-02-08T13:30:00-05:00,303.99,305.55,302.83,304.37,290.8752366655351,NaN,NaN,NaN,NaN,NaN,307.24919999999986,324.58187704195785,289.91652295804187,298.8474779959364,303.606848232163,304.1489024251237,303.06479403920224,408213,869693.4666666667,48.81677606187348,50.573773326803874,NaN,NaN,NaN,NaN,6.478826418158646,21.126038489484394,65107021,0.07239526008270336,-0.6808395145745862,-0.7532347746572896
2022-02-09T09:30:00-05:00,309.875,311.88,307.39,308.69,290.8752366655351,NaN,NaN,NaN,NaN,NaN,306.86899999999986,323.1953817179694,290.54261828203033,298.8474779959364,309.32,309.32,309.32,660357,858322.8666666667,53.16744226162411,50.64023652013594,NaN,NaN,NaN,NaN,6.552481674004456,20.00778202265807,65767378,0.3545251288372493,-0.31007836361072805,-0.6646034924479773
2022-02-09T13:30:00-05:00,308.69,311.25,308.2,311.21,290.8752366655351,NaN,NaN,NaN,NaN,NaN,306.5119999999999,321.61674256651764,291.40725743348213,298.55975921992365,309.7425161364962,310.1916760604241,309.2933562125683,584337,860594.1,55.54146436010467,50.671819773838656,NaN,NaN,NaN,NaN,6.302304411575568,18.969401017747913,66351715,0.6796534477296264,0.18496331721405568,-0.49469013051557076
2022-02-10T09:30:00-05:00,304.04,309.02,302.47,302.56,290.8752366655351,NaN,NaN,NaN,NaN,NaN,306.13539999999983,320.6656102999539,291.60518970004574,298.55975921992365,304.68333333333334,304.68333333333334,304.68333333333334,1153900,878502.7666666667,46.776250161866614,50.367344496804684,NaN,NaN,NaN,NaN,6.476425525034452,18.913081088482738,65197815,0.30029622589419674,-0.11931984814782481,-0.41961607404202156
2022-02-10T13:30:00-05:00,302.56,303.49,300.72,302.29,290.8752366655351,NaN,NaN,NaN,NaN,NaN,305.85679999999985,320.1348802295275,291.5787197704722,298.55975921992365,303.7111627778342,304.936525435326,302.4858001203424,726313,885899.2666666667,46.529416065840984,49.91609618445981,NaN,NaN,NaN,NaN,6.211680844674847,19.108295267352577,64471502,0.0333752346596467,-0.37789703071746317,-0.41127226537710987
2022-02-11T09:30:00-05:00,303.19,304.26,299.04,299.15,290.8752366655351,NaN,NaN,NaN,NaN,NaN,305.54299999999984,319.70676913116023,291.37923086883944,298.55975921992365,300.81666666666666,300.81666666666666,300.81666666666666,607720,869658.1,43.64495697698838,49.11166229808749,NaN,NaN,NaN,NaN,6.140846498626642,19.524337420873866,63863782,-0.33231323012703134,-0.826663803035899,-0.4943505729088677
2022-02-11T13:30:00-05:00,299.16,299.16,294.26,294.94,290.8752366655351,NaN,NaN,NaN,NaN,NaN,305.16479999999984,319.4306194240911,290.8989805759086,298.55975921992365,298.0893666766023,300.40692006704455,295.77181328616007,841608,868477.7666666667,40.05923537210829,47.925513686016316,NaN,NaN,NaN,NaN,6.052214605867598,20.52135650490852,63022174,-0.8082647315100332,-1.5046814872964092,-0.696416755786376
2022-02-14T09:30:00-05:00,293.38,296.72,292.04,295.51,290.8752366655351,NaN,NaN,NaN,NaN,NaN,304.7969999999998,319.091244016419,290.5027559835806,298.55975921992365,294.75666666666666,294.75666666666666,294.75666666666666,550785,818939.4666666667,40.768765313800216,47.30048269530868,NaN,NaN,NaN,NaN,5.9541992768770555,21.70322969030975,63572959,-1.0214861720398154,-1.9732744708361452,-0.9517882987963298
2022-02-14T13:30:00-05:00,295.49,295.64,291.35,294.9,290.8752366655351,NaN,NaN,NaN,NaN,NaN,304.41499999999985,318.72591010385923,290.10408989614047,298.55975921992365,294.3622477571362,294.7589080551756,293.96558745909675,544578,794450.8,40.22007039610462,46.92881854933412,NaN,NaN,NaN,NaN,5.835327899957264,22.880338447793637,63028381,-1.1318327498029594,-2.366579236050029,-1.2347464862470696
2022-02-15T09:30:00-05:00,300.01,300.8,297.13,298.74,290.8752366655351,NaN,NaN,NaN,NaN,NaN,304.19259999999986,318.50374631889144,289.88145368110827,298.55975921992365,298.89000000000004,298.89000000000004,298.89000000000004,454424,773919.1333333333,45.21839232656402,46.53434701041092,NaN,NaN,NaN,NaN,5.839947335674604,22.7407104691378,63482805,-0.8853465268842506,-2.341429644852383,-1.4560831179681322
2022-02-15T13:30:00-05:00,298.76,300.73,298.24,300.57,290.8752366655351,NaN,NaN,NaN,NaN,NaN,303.9225999999998,317.98539221779333,289.8598077822063,298.55975921992365,299.3422209896628,299.81984105126617,298.8646009280594,407378,756466.8666666667,47.47242758029427,46.38168133654857,NaN,NaN,NaN,NaN,5.600665383126419,22.611055917528805,63890183,-0.554381253054375,-2.149059684286101,-1.594678431231726
2022-02-16T09:30:00-05:00,298.49,298.66,293.69,296.65,290.8752366655351,NaN,NaN,NaN,NaN,NaN,303.55499999999984,317.3963480557617,289.713651944238,298.55975921992365,296.3333333333333,296.3333333333333,296.3333333333333,488686,711789,43.35708782400186,46.08466786038807,NaN,NaN,NaN,NaN,5.692046427188818,23.130332201301194,63401497,-0.5535039132289981,-2.2865583227679736,-1.7330544095389755
2022-02-16T13:30:00-05:00,296.65,300.87,295.81,299.67,290.8752366655351,NaN,NaN,NaN,NaN,NaN,303.24899999999985,316.7394281622471,289.7585718377526,294.4978073759389,297.57118564189784,298.796118218893,296.34625306490267,499049,682054.4,47.15768343819907,46.22167583118074,NaN,NaN,NaN,NaN,5.646900253818188,23.09367391198485,63900546,-0.31540915289982996,-2.127315850663763,-1.8119066977639329
2022-02-17T09:30:00-05:00,296.23,296.74,293.14,293.45,290.8752366655351,NaN,NaN,NaN,NaN,NaN,302.73879999999986,315.73438487489767,289.74321512510204,291.24779672060095,294.4433333333333,294.4433333333333,294.4433333333333,551931,656481.3666666667,41.048642766246296,45.69847220754406,NaN,NaN,NaN,NaN,5.709978807116891,23.43455088284026,63348615,-0.5300687622485138,-2.4744926505745752,-1.9444238883260614
2022-02-17T13:30:00-05:00,293.42,293.86,290.02,290.75,NaN,NaN,NaN,309.660630220709,309.660630220709,309.660630220709,302.1893999999998,314.8386279037382,289.5401720962614,291.24779672060095,292.9929301794683,294.44293012342115,291.5429302355155,552238,651618.4333333333,38.70472382026061,44.97618276171456,NaN,NaN,NaN,NaN,5.57640889232283,24.156294179951793,62796377,-0.7914069172020923,-2.9336825348286766,-2.1422756176265842
2022-02-18T09:30:00-05:00,293.05,293.81,286.31,286.81,NaN,NaN,NaN,307.99787430158585,NaN,NaN,301.7237999999998,314.87919243963483,288.5684075603648,289.2867612294065,288.9766666666667,288.9766666666667,288.9766666666667,660907,638194.4333333333,35.51756226049909,43.71547704734849,NaN,NaN,NaN,NaN,5.713808257156913,25.260837268788627,62135470,-1.1456326289880026,-3.5743164038615873,-2.4286837748735848
2022-02-18T13:30:00-05:00,286.79,290.5,286.67,287.99,NaN,NaN,NaN,306.2297891060593,NaN,NaN,301.3897999999998,315.0647274162881,287.7148725837115,289.2867612294065,288.69620163604543,288.99084334165457,288.4015599304363,598838,631213.1,37.185839162920374,42.40436096183533,NaN,NaN,NaN,NaN,5.5792505245028465,26.286484422708543,62734308,-1.2101517974778448,-3.941373521720891,-2.731221724243046
2022-02-22T09:30:00-05:00,284.79,291.52,284.53,286.175,NaN,NaN,NaN,305.8209350557838,NaN,NaN,300.9644999999998,315.1726292576039,286.75637074239575,289.2867612294065,287.4083333333333,287.4083333333333,287.4083333333333,794303,623997.9666666667,35.657712093278576,41.61017967122189,NaN,NaN,NaN,NaN,5.680018344181215,27.487629521268676,61940005,-1.2780820381518732,-4.328824271932888,-3.0507422337810146
2022-02-22T13:30:00-05:00,286.15,290.23,285.12,287.73,NaN,NaN,NaN,305.35884709870277,NaN,NaN,300.51569999999975,314.94823657680604,286.08316342319347,289.2867612294065,287.53481324560596,287.67640987974374,287.3932166114682,633758,623235.2666666667,38.008182038708355,41.00152009785528,NaN,NaN,NaN,NaN,5.639302748168271,28.602978541360223,62573763,-1.1266107227621496,-4.459005637233702,-3.332394914471552
2022-02-23T09:30:00-05:00,290.18,291.56,284.77,284.87,NaN,NaN,NaN,305.35884709870277,NaN,NaN,300.1360999999998,315.18320461055214,285.0889953894474,289.2867612294065,287.06666666666666,287.06666666666666,287.06666666666666,646836,615858.4666666667,35.44360134230844,40.41570898109243,NaN,NaN,NaN,NaN,5.721495409013396,29.23067075032838,61926927,-1.1247503512211874,-4.7383328534980365,-3.613582502276849
2022-02-23T13:30:00-05:00,285.05,285.41,280.11,280.29,NaN,NaN,NaN,300.47931109613205,NaN,NaN,299.6884999999998,315.70754294896636,283.66945705103325,288.2643271868202,284.25875161534424,286.8122232282318,281.7052800024567,782168,622476,31.749107697430773,39.822128432901174,NaN,NaN,NaN,NaN,5.691388594083868,30.398899631551977,61144759,-1.3239635927916593,-5.268536993266423,-3.9445734004747637
2022-02-24T09:30:00-05:00,272.51,286.37,271.52,283.67,NaN,NaN,NaN,297.8838878644897,NaN,NaN,299.1642999999998,315.526715715315,282.8018842846846,288.2643271868202,280.52,280.52,280.52,1415422,644452.8333333334,36.97061684563383,39.550832113746424,NaN,NaN,NaN,NaN,6.345575123077879,32.28532392631517,62560181,-1.1277566074828567,-5.354269159828334,-4.226512552345477
2022-02-24T13:30:00-05:00,283.65,295.11,283.65,294.37,NaN,NaN,NaN,297.8838878644897,NaN,NaN,298.98549999999983,315.35817995780826,282.6128200421914,283.3904617494561,284.8713222658092,290.0536392363299,279.68900529528855,997885,660421,50.00917990456312,40.250054221493464,NaN,NaN,NaN,NaN,6.710891185715176,31.972323904052974,63558066,-0.2242776943400644,-4.506859670270558,-4.282581975930493
2022-02-25T09:30:00-05:00,295.19,297.39,291.66,295.82,NaN,NaN,NaN,297.8838878644897,NaN,NaN,298.7308999999998,314.895324603457,282.56647539654256,281.26036939956487,294.95666666666665,294.95666666666665,294.95666666666665,851668,662323.2333333333,51.474149917232594,40.69689404939836,NaN,NaN,NaN,NaN,6.640827529592661,31.231855183731266,64409734,0.485341487398542,-3.6759051166823156,-4.161246604080858
2022-02-25T13:30:00-05:00,295.83,297.61,294.94,297.43,NaN,NaN,NaN,297.8838878644897,NaN,NaN,298.6490999999998,314.7976268294296,282.50057317057,280.73607865533626,295.6784881641858,296.52019853193565,294.83677779643597,626332,653966.5333333333,53.11699448416723,41.100077399675,NaN,NaN,NaN,NaN,6.357196991764615,30.500061754342507,65036066,1.0453583698698248,-2.854548641743577,-3.8999070116134016
2022-02-28T09:30:00-05:00,294.34,298.49,293.82,295.4,277.3763282444256,277.3763282444256,277.3763282444256,NaN,NaN,NaN,298.5598999999998,314.72994396904346,282.38985603095614,282.655862924269,295.9033333333333,295.9033333333333,295.9033333333333,741268,655598.7,50.782503114378144,41.63046420613045,NaN,NaN,NaN,NaN,6.236682920924287,29.973769533949163,64294798,1.2475715395998757,-2.3404425871135572,-3.588014126713433
2022-02-28T13:30:00-05:00,295.28,299.11,293.02,298.99,277.3763282444256,NaN,NaN,NaN,NaN,NaN,298.62229999999977,314.774411343133,282.4701886568665,283.3976903394152,296.4168091262072,296.98248874226863,295.8511295101458,610765,662172.2666666667,54.583968625041535,42.16091314804776,NaN,NaN,NaN,NaN,6.226205569429697,29.597393016653704,64905563,1.5707317282535547,-1.6245994663964893,-3.195331194650044
2022-03-01T09:30:00-05:00,296.55,299.96,294.3,294.3,278.45515652023084,NaN,NaN,NaN,NaN,NaN,298.78489999999977,314.59232692410325,282.9774730758963,284.56015227153216,296.18666666666667,296.18666666666667,296.18666666666667,783936,673500.3333333334,49.23390559852551,42.74557477892485,NaN,NaN,NaN,NaN,6.185762314470431,29.044162839704725,64121627,1.4207683024041038,-1.4193708166449142,-2.840139119049018
2022-03-01T13:30:00-05:00,294.25,296.37,292.16,294.73,278.45515652023084,NaN,NaN,NaN,NaN,NaN,298.74329999999975,314.58221354989183,282.90438645010767,284.56015227153216,295.37841754080506,296.25855397315866,294.49828110845147,661106,680379.7333333333,49.720497701024186,43.53241577040796,NaN,NaN,NaN,NaN,6.044636434865398,28.85640216762053,64782733,1.3056297118907918,-1.2081019791855283,-2.51373169107632
2022-03-02T09:30:00-05:00,295.71,300.58,293.72,300.04,278.65083476326816,NaN,NaN,NaN,NaN,NaN,298.94489999999973,314.58687615267985,283.3029238473196,285.6100974537806,298.1133333333333,298.1133333333333,298.1133333333333,802115,687960.8,55.404950934994396,44.95294353287191,NaN,NaN,NaN,NaN,6.102876689517866,27.687940100627458,65584848,1.52680881388433,-0.6052206737209076,-2.1320294876052377
2022-03-02T13:30:00-05:00,300.09,301.44,299.13,300.2,282.31170591039233,NaN,NaN,NaN,NaN,NaN,299.1806999999997,314.53310385219885,283.8282961478006,288.3090779630245,299.03286182578427,300.0936744484491,297.9720492031194,602684,694443.1666666666,55.567957146536486,46.265951960273064,NaN,NaN,NaN,NaN,5.831956925980876,26.41292461031376,66187532,1.615049881187554,-0.1132171361207952,-1.7282670173083492
2022-03-03T09:30:00-05:00,302.9,302.9,295.71,298.2,282.31170591039233,NaN,NaN,NaN,NaN,NaN,299.10169999999977,314.4328102807601,283.7705897192394,288.80026237041955,298.93666666666667,298.93666666666667,298.93666666666667,743972,697230.3333333334,52.961946746275785,47.50196872120143,NaN,NaN,NaN,NaN,5.9289600026965275,25.821206296134836,65443560,1.473815042008819,0.11400178520267445,-1.3598132568061445
2022-03-03T13:30:00-05:00,298.04,298.35,294.05,295.88,282.31170591039233,NaN,NaN,NaN,NaN,NaN,299.0804999999998,314.4264329139932,283.7345670860064,288.80026237041955,297.77996266393666,299.1767199434346,296.3832053844387,510222,694759.8333333334,50.03083652083708,48.36072975563919,NaN,NaN,NaN,NaN,5.8126057167896334,25.539960255845035,64933338,1.172372138958914,0.10565191689249787,-1.066720222066416
2022-03-04T09:30:00-05:00,294.36,295.66,287.175,290.4,282.31170591039233,NaN,NaN,NaN,NaN,NaN,298.90589999999975,314.44306855674904,283.36873144325045,288.80026237041955,291.0783333333333,291.0783333333333,291.0783333333333,807945,683228,43.85663533370923,48.961660755024965,NaN,NaN,NaN,NaN,6.019205308447516,26.226352391003754,64125393,0.5819801693942346,-0.33924501032362286,-0.9212251797178574
2022-03-04T13:30:00-05:00,290.4,291.89,287.72,289.75,282.31170591039233,NaN,NaN,NaN,NaN,NaN,298.7050999999998,314.44950325832815,282.9606967416714,288.80026237041955,290.5706589326362,291.201541492033,289.9397763732394,523185,676457.0666666667,43.17601788456876,49.77786862553482,NaN,NaN,NaN,NaN,5.887119214986976,26.863716516508283,63602208,0.14834271114351005,-0.7357967907884699,-0.88413950193198
2022-03-07T09:30:00-05:00,288.53,289.69,279,282.58,NaN,NaN,NaN,303.00255208650145,303.00255208650145,303.00255208650145,298.2890999999998,314.60618131869103,281.97201868130855,288.80026237041955,283.75666666666666,283.75666666666666,283.75666666666666,957181,688105.7666666667,36.455257367438676,49.741057234235164,NaN,NaN,NaN,NaN,6.2344678424879065,28.38141371450836,62645027,-0.5807413352781763,-1.6100661710297004,-1.0293248357515241
2022-03-07T13:30:00-05:00,282.52,284.3,278.53,279.01,NaN,NaN,NaN,300.0112997189332,NaN,NaN,297.7066999999998,314.6441618653663,280.76923813463327,288.80026237041955,282.3071083492695,283.87402432090096,280.7401923776381,819170,687357.8333333334,33.646886481383675,48.57232198972235,NaN,NaN,NaN,NaN,6.201291568024487,29.833210827182917,61825857,-1.225718572227572,-2.561473051035989,-1.335754478808417
2022-03-08T09:30:00-05:00,277.8,283.93,270,280.86,NaN,NaN,NaN,296.6155588226181,NaN,NaN,297.1740999999998,314.5174223680118,279.83077763198776,288.80026237041955,278.2633333333334,278.2633333333334,278.2633333333334,2017380,736244.3333333334,36.38192237885579,47.494305736981154,NaN,NaN,NaN,NaN,6.753342170308453,31.85219344235581,63843237,-1.4354831194289726,-3.130108378094633,-1.6946252586656603
2022-03-08T13:30:00-05:00,280.86,280.89,275.52,275.71,NaN,NaN,NaN,296.6155588226181,NaN,NaN,296.46629999999976,314.35845077180085,278.5741492281987,288.80026237041955,278.034349339003,278.4234021442787,277.6452965337272,698845,741386.5666666667,32.3805732897184,46.013132794520516,NaN,NaN,NaN,NaN,6.654532015286421,33.72696301358778,63144392,-1.8049204703095763,-3.950775846552631,-2.1458553762430546
2022-03-09T09:30:00-05:00,283.56,287.56,280.79,286.82,NaN,NaN,NaN,296.6155588226181,NaN,NaN,296.0696999999998,313.92039639092184,278.21900360907773,288.80026237041955,285.0566666666667,285.0566666666667,285.0566666666667,940641,757593.8,46.14197660146723,45.68166661502688,NaN,NaN,NaN,NaN,7.025636871337392,33.859615231322664,64085033,-1.2132821322356855,-3.6624580415376613,-2.449175909301976
2022-03-09T13:30:00-05:00,286.75,289.59,285.61,288.42,NaN,NaN,NaN,296.6155588226181,NaN,NaN,295.6620999999998,313.2603783351345,278.0638216648651,288.80026237041955,286.18010290714227,287.55931878010284,284.8008870341817,624103,764817.9666666667,47.78989761111768,45.19637582831803,NaN,NaN,NaN,NaN,6.808091380527576,33.55091165947583,64709136,-0.6544154982779635,-3.26719528214943,-2.6127797838714666
2022-03-10T09:30:00-05:00,282.88,285.09,280.59,283.79,NaN,NaN,NaN,296.6155588226181,NaN,NaN,295.1124999999998,312.44104226416107,277.7839577358385,284.9202098963357,283.1566666666667,283.1566666666667,283.1566666666667,696655,771750.2666666667,43.6297005402147,44.79607546701011,NaN,NaN,NaN,NaN,6.881084853347038,33.798535095789624,64012481,-0.5414787462910287,-3.2896282167352524,-2.7481494704442238
2022-03-10T13:30:00-05:00,283.83,286.56,283.4,285.61,NaN,NaN,NaN,296.6155588226181,NaN,NaN,294.5566999999998,311.275309704183,277.83809029581664,280.5636679170686,283.98358161232017,284.98238359243874,282.9847796322016,477508,771032.2333333333,45.63318854729366,44.50412481317222,NaN,NaN,NaN,NaN,6.615293078107966,33.711452964934885,64489989,-0.3011044651676871,-3.1245300519038324,-2.8234255867361453
2022-03-11T09:30:00-05:00,288.15,288.92,283.25,285.64,NaN,NaN,NaN,296.6155588226181,NaN,NaN,294.14789999999977,310.71838968379666,277.5774103162029,277.72793433365484,285.93666666666667,285.93666666666667,285.93666666666667,540947,770666.1,45.66746776494736,43.80859030102601,NaN,NaN,NaN,NaN,6.547772143957397,33.128366729516536,65030936,-0.10700296692327038,-2.957179295390233,-2.850176328466963
2022-03-11T13:30:00-05:00,285.67,286.24,279.45,280,NaN,NaN,NaN,296.6155588226181,NaN,NaN,293.72349999999983,310.6312658193134,276.81573418068626,272.9853474669239,283.9040847482797,285.92404556357,281.8841239329893,547728,770515.7666666667,40.497711655032326,42.73214419449,NaN,NaN,NaN,NaN,6.565074133674727,33.034792912380546,64483208,-0.31368174625020684,-3.2422785112797214,-2.9285967650295146
2022-03-14T09:30:00-04:00,280.51,285.35,278.25,278.47,NaN,NaN,NaN,296.6155588226181,NaN,NaN,293.1506999999998,310.14592921412896,276.15547078587065,272.75638225047635,280.69,280.69,280.69,615570,769004.5333333333,39.201248920367355,41.74923720692511,NaN,NaN,NaN,NaN,6.603283124126534,33.083502085147806,63867638,-0.4977218535802388,-3.5507490820048133,-3.0530272284245745
2022-03-14T13:30:00-04:00,278.64,279.65,275.85,276.42,NaN,NaN,NaN,296.6155588226181,NaN,NaN,292.56249999999983,309.79578271110137,275.3292172888983,272.75638225047635,279.0931636228054,280.7821702324171,277.40415701319364,550219,767383.9,37.47037776987176,40.852061581856155,NaN,NaN,NaN,NaN,6.40304861526035,33.3965961491367,63317419,-0.6899755697505108,-3.915496690612713,-3.225521120862202
2022-03-15T09:30:00-04:00,280.64,285.23,278.73,283.27,NaN,NaN,NaN,296.6155588226181,NaN,NaN,292.1582999999998,309.2961301555565,275.02046984444314,272.75638225047635,282.41,282.41,282.41,649343,762551.9,46.0433464318759,41.008255231725194,NaN,NaN,NaN,NaN,6.5749737141703255,32.46895572099813,63966762,-0.30774935746357723,-3.6102078176916734,-3.302458460228096
2022-03-15T13:30:00-04:00,283.27,287.81,282.5,287.33,NaN,NaN,NaN,296.6155588226181,NaN,NaN,291.88729999999975,308.8929170967402,274.88168290325933,272.75638225047635,284.1572320891317,285.892188969289,282.4222752089744,658564,763378.7666666667,50.38521516167937,41.52319789437596,NaN,NaN,NaN,NaN,6.484618448872445,31.107107043479846,64625326,0.23716295579334945,-3.0060047654864093,-3.2431677212797587
2022-03-16T09:30:00-04:00,289.11,292.8,287.71,288.21,NaN,NaN,NaN,296.6155588226181,NaN,NaN,291.57269999999977,308.2536926815191,274.8917073184804,277.34525098866885,289.5733333333333,289.5733333333333,289.5733333333333,737709,766407.8666666667,51.29996486842312,42.583534144446276,NaN,NaN,NaN,NaN,6.412145702524415,28.966900679438467,65363035,0.6519978482093944,-2.428170411018016,-3.08016825922741
2022-03-16T13:30:00-04:00,288.4,294.52,283.21,294.42,NaN,NaN,NaN,296.6155588226181,NaN,NaN,291.3736999999998,307.67228924081456,275.07511075918507,277.34525098866885,290.17220187317923,290.74322099358534,289.6011827527731,811422,767383,57.28498168390294,44.2719695160548,NaN,NaN,NaN,NaN,6.761992438058385,27.650438645380504,66174457,1.3022185158846047,-1.4523951143716545,-2.754613630256259
2022-03-17T09:30:00-04:00,293.29,294.48,289.39,293.28,NaN,NaN,NaN,296.6155588226181,NaN,NaN,291.0654999999998,306.60790782506956,275.52309217493007,277.51996063274805,292.3833333333333,292.3833333333333,292.3833333333333,672424,742616.4,55.92620103125769,45.66798941979779,NaN,NaN,NaN,NaN,6.642564406768503,26.428009613755254,65502033,1.5938609370045134,-0.7622874590006177,-2.356148396005131
2022-03-17T13:30:00-04:00,293.27,295.45,292.19,295.42,NaN,NaN,NaN,296.6155588226181,NaN,NaN,290.7496999999998,305.24867877924004,276.25072122075954,280.2519685061984,293.3122354249205,294.29563667805525,292.3288341717858,599959,729352.2,57.94290189707091,47.49387003460868,NaN,NaN,NaN,NaN,6.400952663427894,25.10971726918219,66101992,1.8511542882088001,-0.042205535744130884,-1.893359823952931
2022-03-18T09:30:00-04:00,294.21,298.22,292.76,298.15,276.4014552466886,276.4014552466886,276.4014552466886,NaN,NaN,NaN,290.6614999999998,304.9237497874917,276.3992502125079,283.3315748049588,296.37666666666667,296.37666666666667,296.37666666666667,735093,725466.3666666667,60.430364742220306,48.514469187519616,NaN,NaN,NaN,NaN,6.333741758897332,23.371966112900317,66837085,2.1068638317944393,0.7402199657901178,-1.3666438660043212
2022-03-18T13:30:00-04:00,298.1,300.98,297.75,300.39,280.7036618263846,NaN,NaN,NaN,NaN,NaN,290.62349999999975,304.771281769629,276.4757182303705,287.454259843967,298.07557683897375,299.7402314879029,296.4109221900446,765658,730110.5666666667,62.39564932674789,49.55773716720749,NaN,NaN,NaN,NaN,6.112045918976095,22.126860126125035,67602743,2.3121033345153568,1.5234853021398749,-0.7886180323754819
2022-03-21T09:30:00-04:00,298.87,300.11,294.91,295.38,280.7036618263846,NaN,NaN,NaN,NaN,NaN,290.5480999999998,304.5527719190741,276.54342808092554,287.454259843967,296.8,296.8,296.8,536738,723292.9,55.72884328512074,50.42196164898649,NaN,NaN,NaN,NaN,6.066899781906372,20.642835862863773,67066005,2.0070023856467176,1.7201349496829152,-0.2868674359638025
2022-03-21T13:30:00-04:00,295.37,299.33,295.33,299.33,280.7036618263846,NaN,NaN,NaN,NaN,NaN,290.63589999999976,304.80370289109555,276.468097108904,287.454259843967,297.2802177282023,297.8667767462196,296.69365871018493,359762,714926.1333333333,59.41110609200528,51.40609861646589,NaN,NaN,NaN,NaN,5.919264083198774,19.264813332692604,67425767,1.9652557279489795,2.169702223972422,0.2044464960234424
2022-03-22T09:30:00-04:00,299.69,305,298.8,302.64,283.6224743777373,NaN,NaN,NaN,NaN,NaN,290.7784999999998,305.27928015145767,276.2777198485419,291.6212210401111,302.14666666666665,302.14666666666665,302.14666666666665,525946,706326.4666666667,62.245002309403965,52.59020822678422,NaN,NaN,NaN,NaN,5.939316648684575,18.78733232110198,67951713,2.045440346538573,2.761246929196659,0.7158065826580857
2022-03-22T13:30:00-04:00,302.66,304.43,302.34,304.17,285.6532709969311,NaN,NaN,NaN,NaN,NaN,290.9638999999998,305.90119470690456,276.02660529309503,292.6819768320889,302.77685615929124,303.51722460968773,302.03648770889475,381055,696991.4333333333,63.51312567956627,54.23416637139378,NaN,NaN,NaN,NaN,5.664365459492822,18.343957096053547,68332768,2.079588302803282,3.3152919611621883,1.235703658358906
2022-03-23T09:30:00-04:00,300.47,303.21,297.76,300.8,285.6532709969311,NaN,NaN,NaN,NaN,NaN,291.0050999999998,306.03901080061735,275.97118919938225,292.6819768320889,300.59,300.59,300.59,563327,689031.8333333334,58.82627057124451,55.63595363217072,NaN,NaN,NaN,NaN,5.71762506952905,17.052427887841272,67769441,1.7656449236007419,3.4427598128598333,1.6771148892590915
2022-03-23T13:30:00-04:00,300.67,301.83,299.39,299.43,285.6532709969311,NaN,NaN,NaN,NaN,NaN,290.98229999999984,305.96147637391476,276.0031236260849,292.6819768320889,300.4466480181382,300.6282197189205,300.2650763173559,351133,680646.8,56.985261466016595,57.029873896181066,NaN,NaN,NaN,NaN,5.483508993134118,15.853150765929877,67418308,1.3735931353829494,3.3941063084877783,2.020513173104829
2022-03-24T09:30:00-04:00,299.48,301.73,298.43,300.75,285.6532709969311,NaN,NaN,NaN,NaN,NaN,291.0642999999998,306.2106408135753,275.91795918642424,292.6819768320889,300.30333333333334,300.30333333333334,300.30333333333334,390759,668873.0333333333,58.338147594097755,57.90807397919691,NaN,NaN,NaN,NaN,5.32754406505311,14.931764972699673,67809067,1.1216753312436385,3.422607337159377,2.3009320059157385
2022-03-24T13:30:00-04:00,300.78,304.2,300.45,304.11,285.6532709969311,NaN,NaN,NaN,NaN,NaN,291.15309999999977,306.55019958274306,275.7560004172565,293.7712497104236,301.59790467336364,302.9061656254056,300.2896437213217,382624,664619.7666666667,61.645008141539535,58.71234490632978,NaN,NaN,NaN,NaN,5.2148623461207455,14.165791024405387,68191691,1.0984282502622604,3.673967318743564,2.5755390684813038
2022-03-25T09:30:00-04:00,305.23,305.5,299.35,301.31,285.6532709969311,NaN,NaN,NaN,NaN,NaN,291.31029999999976,306.95647453695886,275.66412546304065,294.0819997683389,302.05333333333334,302.05333333333334,302.05333333333334,453433,652802.7,57.54584931147118,59.158479509404636,NaN,NaN,NaN,NaN,5.281657892826405,13.71407989751556,67738258,0.8241058495788378,3.605671380454851,2.781565530876013
2022-03-25T13:30:00-04:00,301.43,303.79,300.95,303.69,285.9428214487956,NaN,NaN,NaN,NaN,NaN,291.56909999999976,307.5931541299926,275.5450458700069,294.0819997683389,302.3894712446724,302.76544419244294,302.01349829690184,362439,647444.5,59.98174447970635,59.35110542339059,NaN,NaN,NaN,NaN,5.1072537576245205,13.294633851117869,68100697,0.7354919308284216,3.70093044441154,2.9654385135831185
2022-03-28T09:30:00-04:00,304.46,310.49,304.46,307.54,290.86723865566853,NaN,NaN,NaN,NaN,NaN,291.98369999999977,308.55706378774295,275.4103362122566,298.6464798517369,307.49666666666667,307.49666666666667,307.49666666666667,544143,633676.5666666667,63.61829740141622,59.90054087840191,NaN,NaN,NaN,NaN,5.228164203508484,14.121828061399363,68644840,0.8600574097578071,4.0405102757803775,3.1804528660225704
2022-03-28T13:30:00-04:00,307.57,310.8,307.35,310.76,292.75168235313816,NaN,NaN,NaN,NaN,NaN,292.43909999999977,309.78196062796286,275.0962393720367,299.6001838813895,308.48791896151624,309.5550172695242,307.42082065350826,469540,622022.2333333333,66.37080224485834,60.502533760386726,NaN,NaN,NaN,NaN,5.101152474686449,14.93890528184328,69114380,1.069544303927699,4.517383245932194,3.4478389420044953
2022-03-29T09:30:00-04:00,313.91,314.39,309.1,312.1,295.4422877007228,NaN,NaN,NaN,NaN,NaN,292.9575999999998,311.05413030171377,274.8610696982858,302.7851471051116,311.86333333333334,311.8633371480306,311.8633295186361,709502,578426.3,67.47364619273792,61.00562529256656,NaN,NaN,NaN,NaN,5.114641583637415,16.240920583052272,69823882,1.1988617310237029,4.946416105784124,3.747554374760421
2022-03-29T13:30:00-04:00,312.11,315.81,311.98,315.42,297.8110473506899,NaN,NaN,NaN,NaN,NaN,293.5113999999998,312.60161110833667,274.42118889166295,304.6111176840893,313.12513632133823,314.3951098679066,311.85516277476984,700402,578478.2,70.09075055125852,61.55527538003161,NaN,NaN,NaN,NaN,5.022881470520455,17.649050187209674,70524284,1.3947779820523278,5.491026852325831,4.096248870273503
2022-03-30T09:30:00-04:00,313.66,315.95,311.59,314.54,297.82259065293124,NaN,NaN,NaN,NaN,NaN,294.10479999999984,313.91464411449857,274.2949558855011,304.8108941472714,314.02666666666664,314.02666666666664,314.02666666666664,633060,568225.5,68.51708014404046,62.468720869954446,NaN,NaN,NaN,NaN,4.975532794054709,18.83825546954539,69891224,1.3509536628832697,5.7849409488775905,4.433987285994321
2022-03-30T13:30:00-04:00,314.49,314.89,312.33,313.79,298.03838198688896,NaN,NaN,NaN,NaN,NaN,294.7747999999998,314.93334647143115,274.61625352856845,304.8108941472714,313.87908682619485,314.0547484339575,313.7034252184322,446833,562316.5,67.13365197354892,63.0203312900647,NaN,NaN,NaN,NaN,4.802994737336516,19.942517517428556,69444391,1.1643791417168234,5.8894612131403505,4.725082071423527
2022-03-31T09:30:00-04:00,314.15,315.11,310.59,311.76,298.03838198688896,NaN,NaN,NaN,NaN,NaN,295.3365999999998,315.7894470820283,274.8837529179713,304.8108941472714,312.4866666666667,312.4866666666667,312.4866666666667,538841,557056.0333333333,63.40217000068556,63.10298612515625,NaN,NaN,NaN,NaN,4.782780827526769,20.39889702185704,68905550,0.8137716388884098,5.74229662003404,4.92852498114563
2022-03-31T13:30:00-04:00,311.77,312.8,308,308,298.03838198688896,NaN,NaN,NaN,NaN,NaN,295.6091999999998,316.36434156638677,274.85405843361286,304.8108941472714,310.8554840582611,312.2865409267969,309.4244271897253,700087,564475.3333333334,57.07429199065979,62.643069433091505,NaN,NaN,NaN,NaN,4.784010768417715,20.0391612369689,68205463,0.26647155707229153,5.261614427485995,4.995142870413703
2022-04-01T09:30:00-04:00,309.41,310.09,305.55,306.56,298.03838198688896,NaN,NaN,NaN,NaN,NaN,295.82399999999984,316.8045002800384,274.8434997199613,304.8108941472714,307.40000000000003,307.40000000000003,307.40000000000003,731342,570821.8333333334,54.81779445020357,62.35674971016,NaN,NaN,NaN,NaN,4.766581427816447,19.035480412752158,67474121,-0.22797161054877613,4.710178357227733,4.938149967776509
2022-04-01T13:30:00-04:00,306.57,309.61,305.87,309.26,298.03838198688896,NaN,NaN,NaN,NaN,NaN,296.06059999999985,317.3724094623788,274.7487905376209,304.8108941472714,307.76416702056565,308.1833453341045,307.3449887070268,551981,570963.6,58.15813909861492,62.44052668391703,NaN,NaN,NaN,NaN,4.6932541829724155,18.103491075979463,68026102,-0.3986408388662408,4.439848919193707,4.838489758059948
2022-04-04T09:30:00-04:00,310.18,314.35,309.76,313.34,298.03838198688896,NaN,NaN,NaN,NaN,NaN,296.4193999999998,318.2718500814167,274.56694991858296,304.8108941472714,312.48333333333335,312.48333333333335,312.48333333333335,548747,568736.1666666666,62.651562764078776,62.7486277674871,NaN,NaN,NaN,NaN,4.72159316990296,18.27369193354908,68574849,-0.2684511124289184,4.5029258675238,4.771376979952718
2022-04-04T13:30:00-04:00,313.34,315.11,313.12,315,299.3669623809325,NaN,NaN,NaN,NaN,NaN,296.7395999999999,319.1942191096762,274.28498089032354,305.32477906827387,313.3442362574184,314.3021084422144,312.3863640726224,443267,565171.1,64.32998888561055,62.940412106349314,NaN,NaN,NaN,NaN,4.526479372052749,18.579056148014935,69018116,-0.11034047439738792,4.633451386955983,4.743791861353371
2022-04-05T09:30:00-04:00,313.27,314.84,310.56,312.31,299.3669623809325,NaN,NaN,NaN,NaN,NaN,297.09979999999985,319.96046052940665,274.23913947059305,305.32477906827387,312.57,312.57,312.57,649823,565187.1,59.65175534026779,63.090833965549066,NaN,NaN,NaN,NaN,4.520302274048981,18.1097958392613,68368293,-0.22037332015374744,4.468325211161186,4.688698531314934
2022-04-05T13:30:00-04:00,312.47,312.55,309.88,311.05,299.3669623809325,NaN,NaN,NaN,NaN,NaN,297.4261999999999,320.6059977178553,274.24640228214446,305.32477906827387,311.9749468339163,312.6713207950579,311.2785728727747,474484,559051.1,57.54094899482103,62.9164914309144,NaN,NaN,NaN,NaN,4.388137825902627,17.48195244201323,67893809,-0.4009436685178285,4.187518945667648,4.5884626141854765
2022-04-06T09:30:00-04:00,305.19,306.86,297.15,298.25,NaN,NaN,NaN,317.6266300141045,317.6266300141045,317.6266300141045,297.3903999999999,320.5594662600087,274.22133373999105,305.32477906827387,300.75333333333333,300.75333333333333,300.75333333333333,1043621,569248.1666666666,41.4822175369237,61.33534286916494,NaN,NaN,NaN,NaN,5.06755655262387,18.11450959960979,66850188,-1.3518017696709785,2.8987104020967536,4.250512171767732
2022-04-06T13:30:00-04:00,298.25,302.89,296.75,299.4,NaN,NaN,NaN,315.56882864982697,NaN,NaN,297.37439999999987,320.5367871516035,274.2120128483962,305.32477906827387,300.2717578386184,300.8055893418672,299.7379263353696,849304,570510.9,43.020808068205326,59.667486142261154,NaN,NaN,NaN,NaN,5.144159656007878,18.759324864322615,67699492,-1.8422783185068803,1.9476642736341319,3.789942592141012
2022-04-07T09:30:00-04:00,296.66,302.64,296.36,300.48,NaN,NaN,NaN,315.3893364384712,NaN,NaN,297.4199999999999,320.5976813335722,274.2423186664276,305.32477906827387,299.82666666666665,299.82666666666665,299.82666666666665,1006108,581633.7,44.49673323760496,58.02627807403737,NaN,NaN,NaN,NaN,5.225291109150171,19.417060200999494,68705600,-2.018753349783897,1.2665009049111404,3.2852542546950376
2022-04-07T13:30:00-04:00,300.46,303.63,299.95,301.4,NaN,NaN,NaN,315.3893364384712,NaN,NaN,297.5303999999999,320.7302634340959,274.33053656590386,305.32477906827387,300.57872659088207,301.480492856676,299.67696032508815,699780,584961.0666666667,45.785030332489484,56.29015520126815,NaN,NaN,NaN,NaN,5.114913172782302,19.753139392160772,69405380,-1.9947768792994034,0.7917831555707835,2.786560034870187
2022-04-08T09:30:00-04:00,300.44,301.1,296.8,299.77,NaN,NaN,NaN,314.5339615069542,NaN,NaN,297.7177999999999,320.8354781844683,274.6001218155315,305.32477906827387,299.22333333333336,299.22333333333336,299.22333333333336,616263,581000.0666666667,43.84331599966033,54.52774347666957,NaN,NaN,NaN,NaN,5.078133660440707,20.571189838583418,68789117,-2.0046067198289923,0.2808016350839466,2.285408354912939
2022-04-08T13:30:00-04:00,299.81,299.81,296.29,296.91,NaN,NaN,NaN,313.4055996202744,NaN,NaN,297.8609999999999,320.8679197416941,274.85408025830566,305.32477906827387,298.4991851002329,299.27407407632415,297.7242961241417,538198,573418.0666666667,40.59057041033617,52.63180907929723,NaN,NaN,NaN,NaN,4.966838398980655,21.409512565303874,68250919,-2.1090372269724926,-0.350888178802677,1.7581490481698157
2022-04-11T09:30:00-04:00,291.79,292.51,285.36,286.89,NaN,NaN,NaN,305.1676178193528,NaN,NaN,297.94719999999984,320.7559032652188,275.13849673478086,305.32477906827387,288.25333333333333,288.25333333333333,288.25333333333333,907513,585777.2333333333,31.713378868916706,50.368323998456596,NaN,NaN,NaN,NaN,5.437064227624894,23.492943731716927,67343406,-2.7194147299622866,-1.6411193642830426,1.078295365679244
2022-04-11T13:30:00-04:00,286.96,287.8,285.01,285.42,NaN,NaN,NaN,302.2802261002913,NaN,NaN,298.0753999999999,320.526151866269,275.6246481337308,304.79182325461903,287.4359710039414,288.49003179889115,286.38191020899166,545696,591975.0333333333,30.654187242602404,48.48117365930964,NaN,NaN,NaN,NaN,5.247988211365974,25.460112127061297,66797710,-3.063073888927049,-2.750546995479567,0.31252689344748175
2022-04-12T09:30:00-04:00,289.29,290.7,284.38,285.19,NaN,NaN,NaN,302.2802261002913,NaN,NaN,298.1619999999999,320.37864565141916,275.9453543485807,303.17645860369527,286.75666666666666,286.75666666666666,286.75666666666666,814061,601578.8666666667,30.482641554366694,46.74294845246414,NaN,NaN,NaN,NaN,5.324560481982689,26.466563444457552,65983649,-3.1354287079441963,-3.6067589914827636,-0.47133028353856743
2022-04-12T13:30:00-04:00,285.22,285.54,280.5,282.13,NaN,NaN,NaN,298.99474113683567,NaN,NaN,298.2903999999999,320.0561532688563,276.52464673114355,292.4111668829562,285.0176620186781,287.0151224683105,283.0202015690457,617024,609444.5,28.219954057667522,44.604506663825056,NaN,NaN,NaN,NaN,5.304234733269641,27.827426105068465,65366625,-3.2073999758937215,-4.480580253405719,-1.2731802775119978
2022-04-13T09:30:00-04:00,282.55,286.835,281.31,286.54,NaN,NaN,NaN,298.99474113683567,NaN,NaN,298.2847999999999,320.062495834057,276.5071041659428,289.91539744407356,284.895,284.895,284.895,619685,611323.1,35.63514929733455,42.674762844771884,NaN,NaN,NaN,NaN,5.320003680893236,28.73486337604541,65986310,-2.7913297266185393,-4.762342435785172,-1.9710127091666325
2022-04-13T13:30:00-04:00,286.58,288.57,285.31,287.63,NaN,NaN,NaN,298.99474113683567,NaN,NaN,298.2689999999999,320.0764270834675,276.4615729165323,289.91539744407356,285.8904492956852,287.01904481552134,284.76185377584903,482095,615688.5,37.35765032503257,40.748167233302034,NaN,NaN,NaN,NaN,5.172860560829433,29.104519417569936,66468405,-2.2966882380724742,-4.8418730067572255,-2.5451847686847513
2022-04-14T09:30:00-04:00,287.94,288.21,281.46,282.34,NaN,NaN,NaN,298.99474113683567,NaN,NaN,298.2399999999999,320.1280752922838,276.35192470771597,289.91539744407356,284.00333333333333,284.00333333333333,284.00333333333333,719279,626639.1666666666,32.773605991131745,38.828299422649465,NaN,NaN,NaN,NaN,5.285513377913044,29.925518305322125,65749126,-2.1806518212051267,-5.2709995451911595,-3.090347723986033
2022-04-14T13:30:00-04:00,282.32,283.5,279.34,279.95,NaN,NaN,NaN,297.1885536593852,NaN,NaN,298.12679999999983,320.3312400749232,275.9223599250765,287.8283179552589,282.54027984998976,284.07518230411193,281.0053773958676,653516,635668.9,30.927161601052276,36.92731460880884,NaN,NaN,NaN,NaN,5.2051195652049715,30.92809384086631,65095610,-2.1179591775078355,-5.737796695870827,-3.6198375183629916
2022-04-18T09:30:00-04:00,279.27,282.43,278.64,279.27,NaN,NaN,NaN,296.1036194021404,NaN,NaN,297.99939999999987,320.55920794600866,275.4395920539911,287.4326543642071,280.1133333333333,280.1133333333333,280.1133333333333,474098,636357.7333333333,30.402336425416877,36.135894529415495,NaN,NaN,NaN,NaN,5.104039596261761,31.938049576906245,64621512,-1.9780323668573665,-6.092377976934699,-4.114345610077333
2022-04-18T13:30:00-04:00,279.23,281.41,278.37,280.51,NaN,NaN,NaN,295.1655003384068,NaN,NaN,298.00959999999986,320.53728464269733,275.4819153573024,276.83312349136565,280.1073440589666,280.1153409246785,280.0993471932547,265936,633140.9666666667,32.646888649318996,35.394900285209324,NaN,NaN,NaN,NaN,4.956608196528779,32.90776891923734,64887448,-1.6699936208586816,-6.201837636150685,-4.531844015292004
2022-04-19T09:30:00-04:00,279.38,284.86,278.43,283.22,NaN,NaN,NaN,295.1655003384068,NaN,NaN,298.1045999999999,320.3400532079002,275.86914679209957,276.390799034474,282.17,282.17,282.17,490453,631351.3,37.398613607243284,34.88789174018349,NaN,NaN,NaN,NaN,5.061850468205295,32.76232029521807,65377901,-1.1751152516494514,-6.000738079853818,-4.8256228282043665
2022-04-19T13:30:00-04:00,283.13,286.15,282.91,285.27,NaN,NaN,NaN,295.1655003384068,NaN,NaN,298.2815999999999,319.9576344565308,276.605565543469,276.390799034474,283.3166500540367,284.6105310871281,282.0227690209453,385186,628539.5,40.80095275906213,34.5318861992244,NaN,NaN,NaN,NaN,4.931718291904914,32.26323193515254,65763087,-0.6285131009183207,-5.611264204352267,-4.982751103433946
2022-04-20T09:30:00-04:00,289.38,289.7,285.38,286.93,NaN,NaN,NaN,295.1655003384068,NaN,NaN,298.35479999999984,319.8515414237794,276.8580585762203,278.33068380296936,287.33666666666664,287.33666666666664,287.33666666666664,403483,618338.8666666667,43.47973111358356,34.50591585021892,NaN,NaN,NaN,NaN,4.895881271054563,30.87023925873073,66166570,-0.10160165434071633,-5.109753171359841,-5.008151517019125
2022-04-20T13:30:00-04:00,287.02,288.1,285.53,286.34,NaN,NaN,NaN,295.1655003384068,NaN,NaN,298.33499999999987,319.8741053667686,276.7958946332311,278.33068380296936,287.03885077132804,287.376223712361,286.70147783029506,314413,605472.5666666667,42.739478600387066,34.65940929236541,NaN,NaN,NaN,NaN,4.7297468945506695,29.576746059196196,65852157,0.24198829876871386,-4.705666143558233,-4.947654442326947
2022-04-21T09:30:00-04:00,288.58,293.27,285.19,286.16,NaN,NaN,NaN,295.1655003384068,NaN,NaN,298.29399999999987,319.9176799828521,276.6703200171476,280.92563763390035,288.2066666666667,288.2066666666667,288.2066666666667,508526,601321.4333333333,42.501737154954995,35.43000631279672,NaN,NaN,NaN,NaN,4.969050687797049,27.75077942191177,65343631,0.4782780400854758,-4.349806892220101,-4.828084932305577
2022-04-21T13:30:00-04:00,286.15,286.69,280.12,281.04,NaN,NaN,NaN,295.1655003384068,NaN,NaN,298.02639999999985,320.16036729375014,275.89243270624956,280.92563763390035,285.9670588378576,288.70632234036674,283.2277953353485,339930,597758,36.313999387415045,35.83427860885477,NaN,NaN,NaN,NaN,5.0834042100972585,26.490664683972536,65003701,0.3185780370526725,-4.429862385989736,-4.748440423042409
2022-04-22T09:30:00-04:00,281.53,283.18,276.87,277.28,NaN,NaN,NaN,295.1655003384068,NaN,NaN,297.70639999999986,320.55664490373715,274.85615509626257,280.92563763390035,279.10999999999996,279.10999999999996,279.10999999999996,423674,593919.1,32.56450840924286,35.98298338420307,NaN,NaN,NaN,NaN,5.171018195090312,25.870804001051567,64580027,0.005116990912322983,-4.742044184402005,-4.747161175314328
2022-04-22T13:30:00-04:00,277.26,277.66,273.38,274.06,NaN,NaN,NaN,290.96514108605874,NaN,NaN,297.27919999999983,321.06401997915543,273.49438002084423,280.92563763390035,276.9280202795847,278.96128575493964,274.89475480422976,487916,586846.7333333333,29.733167770064327,36.091070077945695,NaN,NaN,NaN,NaN,5.107374038298149,25.824558308148344,64092111,-0.3538364763886799,-5.189456770800177,-4.835620294411497
2022-04-25T09:30:00-04:00,273.29,278,270.82,277.32,NaN,NaN,NaN,290.1321801276015,NaN,NaN,296.8625999999998,321.292752454721,272.43244754527865,280.92563763390035,275.37999999999994,275.37999999999994,275.37999999999994,740442,587150.0666666667,35.817470785141666,36.104093041360485,NaN,NaN,NaN,NaN,5.255418749848282,26.136765850345107,64832553,-0.30814185159821417,-5.220797608909265,-4.912655757311051
2022-04-25T13:30:00-04:00,277.48,281.09,275.36,280.69,NaN,NaN,NaN,290.1321801276015,NaN,NaN,296.4685999999998,321.29077234975324,271.6464276502464,280.92563763390035,276.69523261403344,278.45383511481936,274.93663011324753,414153,582555.8,41.46043071932359,36.39714878380984,NaN,NaN,NaN,NaN,5.2893174105734015,25.686825435645634,65246706,-0.003494769129002151,-4.917024218722304,-4.913529449593302
2022-04-26T09:30:00-04:00,277.57,278.3,272,272.72,NaN,NaN,NaN,290.1321801276015,NaN,NaN,296.0153999999999,321.7125507245596,270.31824927544017,280.92563763390035,274.34,274.34,274.34,689530,587248.5666666667,33.874967160251856,36.475817438746994,NaN,NaN,NaN,NaN,5.532223309818158,25.756998975965068,64557176,-0.27619574880444286,-5.2587741355988555,-4.982578386794413
2022-04-26T13:30:00-04:00,272.75,274.54,270,270.1,NaN,NaN,NaN,288.4063937041433,NaN,NaN,295.43079999999986,322.11087191596005,268.7507280840397,280.92563763390035,273.13894795145666,274.5218480559232,271.7560478469901,520110,589810,31.814342368981897,36.53918749359911,NaN,NaN,NaN,NaN,5.461350216259719,26.09348435416276,64037066,-0.5544178653653287,-5.675600718501073,-5.121182853135744
2022-04-27T09:30:00-04:00,282.125,290.94,279.195,288.72,266.8227605551359,266.8227605551359,266.8227605551359,NaN,NaN,NaN,295.15239999999983,321.81625555318095,268.4885444468187,280.92563763390035,286.285,286.285,286.285,1420894,615512.3666666667,53.47492683906356,38.187229666002445,NaN,NaN,NaN,NaN,6.559825200812595,24.978321515548892,65457960,0.5352351494762004,-4.452138916290494,-4.987374065766694
2022-04-27T13:30:00-04:00,288.8,289.79,282.71,283.25,267.8691123480843,NaN,NaN,NaN,NaN,NaN,294.7339999999998,321.4751473202057,267.99285267979394,280.92563763390035,286.0167177889962,286.47025581790405,285.5631797600883,497185,616269.0666666667,48.59144798525768,39.326126761426636,NaN,NaN,NaN,NaN,6.596980543611698,23.942813165407443,64960775,0.8865369543913459,-3.879202872777512,-4.765739827168858
2022-04-28T09:30:00-04:00,285.38,289.33,281.5,289.2,267.8691123480843,NaN,NaN,NaN,NaN,NaN,294.50199999999984,321.2298874586249,267.7741125413748,273.5295101071203,286.6766666666667,286.6766666666667,286.6766666666667,713548,605266.6333333333,53.55954327756059,40.48047888073501,NaN,NaN,NaN,NaN,6.6850533619251475,22.77487362513347,65674323,1.483415827802924,-2.9114700424152034,-4.394885870218127
2022-04-28T13:30:00-04:00,289.16,290.96,288.46,289.74,271.6020217882338,NaN,NaN,NaN,NaN,NaN,294.30819999999983,321.0308692349559,267.58553076504376,272.92429207552857,287.84504907335935,289.3251367991802,286.3649613475385,444650,591778.1666666666,53.994083230166524,41.422845342956755,NaN,NaN,NaN,NaN,6.386120978930494,21.931647461362598,66118973,1.8542937073005943,-2.077018736092384,-3.9313124433929785
2022-04-29T09:30:00-04:00,288.12,289.7,282.9,283.73,271.6020217882338,NaN,NaN,NaN,NaN,NaN,293.96779999999984,320.7870036541132,267.14859634588646,272.92429207552857,285.4433333333333,285.4433333333333,285.4433333333333,594331,578052.2666666667,48.54928867791301,41.78495659755172,NaN,NaN,NaN,NaN,6.41854090900689,20.519935175381903,65524642,1.6418445024401955,-1.8790068153427342,-3.5208513177829297
2022-04-29T13:30:00-04:00,283.68,284.09,276.51,277.39,271.6020217882338,NaN,NaN,NaN,NaN,NaN,293.43339999999984,320.48675634927434,266.3800436507253,272.92429207552857,282.03154137126387,285.0675086200444,278.99557412248333,750584,579745.7333333333,43.55913374967212,41.84350339392922,NaN,NaN,NaN,NaN,6.501502272649255,20.102129547218713,64774058,1.0501121956103607,-2.208211073269979,-3.2583232688803396
2022-05-02T09:30:00-04:00,277.69,282.49,276.22,280.04,271.6020217882338,NaN,NaN,NaN,NaN,NaN,293.00799999999987,320.22100453828546,265.7949954617143,272.92429207552857,279.5833333333333,279.5833333333333,279.5833333333333,928800,590163.6333333333,46.05501288878942,42.09730880348882,NaN,NaN,NaN,NaN,6.4849663960314485,19.75200090755795,65702858,0.822999553327219,-2.2295738272213157,-3.0525733805485347
2022-05-02T13:30:00-04:00,280.01,284.94,277.42,284.5,271.6020217882338,NaN,NaN,NaN,NaN,NaN,292.62419999999986,319.76496051699377,265.48343948300595,272.92429207552857,280.66065415517187,281.9841862232439,279.33712208709983,615380,592736.3666666667,50.05787445382399,43.07901416537517,NaN,NaN,NaN,NaN,6.558897367743486,18.98700802935887,66318238,0.9499632619718206,-1.865119303083759,-2.8150825650555795
2022-05-03T09:30:00-04:00,283.96,284.11,280.29,282.53,271.6020217882338,NaN,NaN,NaN,NaN,NaN,292.12399999999985,319.0678865793488,265.1801134206509,272.92429207552857,282.31,282.31,282.31,505094,579322.4,48.35122999749525,44.206637135964634,NaN,NaN,NaN,NaN,6.391118984333235,18.27665749960258,65813144,0.8796867835949143,-1.7154740855619366,-2.595160869156851
2022-05-03T13:30:00-04:00,282.55,283.47,280.19,281.84,271.6020217882338,NaN,NaN,NaN,NaN,NaN,291.5455999999998,318.10330416585225,264.98789583414737,272.92429207552857,282.12063339435065,282.353882268609,281.88738452009227,332920,572229.8666666667,47.73733182719724,45.492648854331264,NaN,NaN,NaN,NaN,6.168896199738006,17.63344539747164,65480224,0.7691496118576948,-1.6337238543347326,-2.4028734661924274
2022-05-04T09:30:00-04:00,282.67,284.05,276.75,282.1,271.6020217882338,NaN,NaN,NaN,NaN,NaN,290.94559999999984,316.9688690214136,264.9223309785861,272.92429207552857,280.96666666666664,280.96666666666664,280.96666666666664,478762,561053.2333333333,48.005222428943846,46.36320254317428,NaN,NaN,NaN,NaN,6.24968932832815,17.590347656523882,65958986,0.698046091776356,-1.5303158514719826,-2.2283619432483386
2022-05-04T13:30:00-04:00,281.98,290.85,278.3,290.03,271.6020217882338,NaN,NaN,NaN,NaN,NaN,290.43779999999987,315.5042407653103,265.3713592346894,272.92429207552857,284.41223794966896,287.0249004542507,281.7995754450872,832675,568241.6,55.49780968236823,47.36587246910604,NaN,NaN,NaN,NaN,6.699711519161854,16.40482491508453,66791661,1.1432766778499235,-0.7992660959359341,-1.9425427737858576
2022-05-05T09:30:00-04:00,285.3,286.31,275.28,276.81,271.6020217882338,NaN,NaN,NaN,NaN,NaN,289.68319999999983,314.0641933973357,265.30220660266394,272.92429207552857,279.46666666666664,279.46666666666664,279.46666666666664,784956,573750.6333333333,44.09098353683156,48.095587924576016,NaN,NaN,NaN,NaN,7.2747321249360075,15.6570155275733,66006705,0.536446407023264,-1.2719847650067777,-1.8084311720300417
2022-05-05T13:30:00-04:00,276.79,278.03,274.35,277.4,271.6020217882338,NaN,NaN,NaN,NaN,NaN,288.9553999999999,312.57516298273805,265.3356370172617,272.22362578038235,278.1043247320775,279.5390675471149,276.6695819170401,707733,581271.9,44.63788226520331,49.0115550600204,NaN,NaN,NaN,NaN,7.017965544583432,15.11208542678711,66714438,0.1821150858820042,-1.5807873146775364,-1.7629024005595406
2022-05-06T09:30:00-04:00,274.95,279.2,271.4,276.79,NaN,NaN,NaN,295.2295363903091,295.2295363903091,295.2295363903091,288.25599999999986,311.19444667803003,265.3175533219697,272.22362578038235,275.7966666666666,275.7966666666666,275.7966666666666,782784,583388.7333333333,44.15694701831469,48.34598507282406,NaN,NaN,NaN,NaN,7.073825148541759,15.070040946203441,65931654,-0.07237642565510138,-1.8533729326284174,-1.780996506973316
2022-05-06T13:30:00-04:00,276.89,277.25,271.27,274.8,NaN,NaN,NaN,294.09910291802237,NaN,NaN,287.5919999999998,310.1243728000605,265.05962719993914,272.22362578038235,275.23599576958793,275.9040464130381,274.5679451261378,551365,579983.7,42.54647017560029,47.91420094356281,NaN,NaN,NaN,NaN,6.995694780788777,15.051394776468669,65380289,-0.3388528287428192,-2.20456254290184,-1.8657097141590209
2022-05-09T09:30:00-04:00,270.14,272.3,264.57,267.15,NaN,NaN,NaN,288.7673255126577,NaN,NaN,286.80379999999985,309.3841014647897,264.22349853521,272.22362578038235,268.00666666666666,268.00666666666666,268.00666666666666,789145,590485.2666666667,36.96510507320224,46.728883928965786,NaN,NaN,NaN,NaN,7.226716582161009,15.985829387604038,64591144,-0.9593076593556957,-3.0648442883536404,-2.1055366289979447
2022-05-09T13:30:00-04:00,267.24,267.5,263.33,264.59,NaN,NaN,NaN,285.39176526208234,NaN,NaN,285.9103999999998,308.4006449822339,263.4201550177657,272.22362578038235,266.82838696548214,268.23884507871765,265.41792885224663,550723,599978.1666666666,35.296433249981334,45.3933375018097,NaN,NaN,NaN,NaN,7.008379683435224,17.00870555075112,64040421,-1.4420856781303724,-3.90814372666091,-2.4660580485305377
2022-05-10T09:30:00-04:00,271.74,273.52,265.08,269.66,NaN,NaN,NaN,285.39176526208234,NaN,NaN,285.0367999999998,306.5703509157435,263.5032490842561,272.22362578038235,269.42,269.42,269.42,611402,604009.8,40.97892460040256,44.852597210558955,NaN,NaN,NaN,NaN,7.145638277475565,16.688172105972225,64651823,-1.3230469370976752,-4.119866719902632,-2.7968197828049566
2022-05-10T13:30:00-04:00,269.8,273.73,268.78,269.44,NaN,NaN,NaN,285.39176526208234,NaN,NaN,284.12559999999985,304.3248578715371,263.9263421284626,272.22362578038235,269.95209267016975,270.561478733883,269.3427066064565,466140,606708.2666666667,40.811433469128964,44.65633290480587,NaN,NaN,NaN,NaN,6.9888069719415995,16.349534409462358,64185683,-1.167621267653888,-4.256346367372316,-3.0887250997184283
2022-05-11T09:30:00-04:00,265.68,271.29,262.27,263.35,NaN,NaN,NaN,285.39176526208234,NaN,NaN,283.1463999999998,302.5153416376065,263.7774583623931,272.22362578038235,265.63666666666666,265.63666666666666,265.63666666666666,1029525,627576.3333333334,36.37882636720875,43.96517672469297,NaN,NaN,NaN,NaN,7.133892188231488,16.95032641821147,63156158,-1.3694850883901402,-4.800581460206104,-3.4310963718159635
2022-05-11T13:30:00-04:00,263.24,264.41,259.31,260.79,NaN,NaN,NaN,281.98853636592037,NaN,NaN,282.1411999999998,300.81765604071956,263.46474395928004,264.03390062430583,263.8474868452365,265.89544000921006,261.799533681263,785787,643288.8,34.673968062218464,42.86632626814971,NaN,NaN,NaN,NaN,6.988614174786383,17.86567532408817,62370371,-1.5563113178653492,-5.37648551914765,-3.820174201282301
2022-05-12T09:30:00-04:00,257.62,259.85,252.39,253.15,NaN,NaN,NaN,276.47905744019675,NaN,NaN,281.2391999999998,301.03908114714096,261.43931885285866,259.57129639955576,255.13,255.13,255.13,973075,658773.7666666667,30.13507492638132,41.56517233449872,NaN,NaN,NaN,NaN,7.08942744801593,19.435261605917812,61397296,-2.044565120690753,-6.375880602145742,-4.331315481454989
2022-05-12T13:30:00-04:00,253.18,255.76,250.03,255.46,NaN,NaN,NaN,273.11000937473324,NaN,NaN,280.3603999999998,300.7497681942563,259.9710318057433,259.57129639955576,254.56749204633036,255.24561134123178,253.88937275142894,669563,669761.5333333333,32.99122735249085,40.51187915773398,NaN,NaN,NaN,NaN,6.992325487443362,21.107790957318745,62066859,-2.0565070832555,-6.901949335524364,-4.845442252268864
2022-05-13T09:30:00-04:00,257.55,263.03,255.35,260.54,NaN,NaN,NaN,273.11000937473324,NaN,NaN,279.5615999999998,299.8647526064515,259.2584473935482,258.5570371196446,259.64000000000004,259.64000000000004,259.64000000000004,662817,677732.9666666667,38.90623721904529,39.86195164274123,NaN,NaN,NaN,NaN,7.0414450954831205,21.207991751624707,62729676,-1.5878178702215369,-6.8302145900457845,-5.242396719824248
2022-05-13T13:30:00-04:00,260.54,261.81,257.85,260.96,NaN,NaN,NaN,273.11000937473324,NaN,NaN,278.75279999999987,298.73103016788065,258.7745698321191,256.0730824042064,259.8882554323024,260.1694089822013,259.6071018824035,516778,678695.0333333333,39.38265828734862,38.71086940023982,NaN,NaN,NaN,NaN,6.821341874377182,21.301035346337386,63246454,-1.136219165996529,-6.662670677319909,-5.52645151132338
2022-05-16T09:30:00-04:00,259.67,262.52,255.8,262.42,NaN,NaN,NaN,273.11000937473324,NaN,NaN,278.00579999999985,297.5736475423543,258.4379524576454,256.0730824042064,260.24666666666667,260.24666666666667,260.24666666666667,443187,668786.5333333333,41.10207955473934,38.49737625866181,NaN,NaN,NaN,NaN,6.8141031690645235,21.633700442112854,63689641,-0.650045968218552,-6.33900897159657,-5.688963003378018
2022-05-16T13:30:00-04:00,262.44,265.82,260.81,261.69,NaN,NaN,NaN,273.11000937473324,NaN,NaN,277.30139999999983,296.6307265314887,257.972073468511,256.0730824042064,261.45729918511717,262.71953281453284,260.1950655557015,407692,668571.1666666666,40.48374884471686,38.20065244291278,NaN,NaN,NaN,NaN,6.685238656988486,21.29833459186768,63281949,-0.305967247599769,-6.07142206287773,-5.765454815277961
2022-05-17T09:30:00-04:00,266.07,268.28,262.46,264.73,NaN,NaN,NaN,273.11000937473324,NaN,NaN,276.85819999999984,296.3036382064509,257.4127617935488,256.0730824042064,265.1566666666667,265.1566666666667,265.1566666666667,593044,665354.9666666667,44.24535630272659,38.20696739179935,NaN,NaN,NaN,NaN,6.678435895775022,20.532847224353468,63874993,0.17230218630579497,-5.550077082395717,-5.722379268701512
2022-05-17T13:30:00-04:00,264.81,266.93,262.62,266.85,NaN,NaN,NaN,273.11000937473324,NaN,NaN,276.48679999999985,295.9732590688208,257.00034093117887,252.6544659233651,265.2748373646532,265.42539832406175,265.12427640524464,365327,660195.5333333333,46.771894534742295,38.508783417452356,NaN,NaN,NaN,NaN,6.509261903219664,19.822037525947415,64240320,0.6505031233173293,-4.90925036455485,-5.55975348787218
2022-05-18T09:30:00-04:00,263,263.58,256.16,256.48,NaN,NaN,NaN,273.11000937473324,NaN,NaN,275.9125999999998,296.02143818028424,255.80376181971545,252.54287043520935,258.74,258.74,258.74,470174,628504.8666666667,37.75852077279088,38.56545596742296,NaN,NaN,NaN,NaN,6.807886052989688,20.069254064575095,63770146,0.30502779521103296,-5.178468743858389,-5.483496539069422
2022-05-18T13:30:00-04:00,256.44,257.05,252.82,254.2,NaN,NaN,NaN,273.11000937473324,NaN,NaN,275.35399999999987,296.27623009147834,254.43176990852143,252.54287043520935,256.6832991940777,258.7080510452683,254.65854734288706,485129,628103,36.11081202528525,38.62362587994467,NaN,NaN,NaN,NaN,6.623751334918998,20.700448909569722,63285017,-0.02301179080106941,-5.512261277570758,-5.489249486769689
2022-05-19T09:30:00-04:00,253.9,257.62,252.12,252.85,NaN,NaN,NaN,273.11000937473324,NaN,NaN,274.68019999999984,296.2771432985503,253.0832567014494,252.54287043520935,254.1966666666667,254.196669364065,254.19666396926837,578552,623603.1333333333,35.133199445724074,38.206074083181925,NaN,NaN,NaN,NaN,6.543483382424784,21.36919754786726,62706465,-0.2635237384200355,-5.8186541597947325,-5.555130421374697
2022-05-19T13:30:00-04:00,252.83,256.35,251.88,253.04,NaN,NaN,NaN,273.11000937473324,NaN,NaN,273.98839999999984,296.0918315381324,251.8849684618673,252.54287043520935,254.00276190181566,254.2212087802616,253.78431502336971,455856,623976.6666666666,35.39828015419053,37.81942027497204,NaN,NaN,NaN,NaN,6.395377426537301,22.020015506344603,63162321,-0.3376871980805971,-5.977239418975444,-5.6395522208948465
2022-05-20T09:30:00-04:00,257,258.5,248,248.15,NaN,NaN,NaN,273.06048296990014,NaN,NaN,273.3045999999999,296.42431564186643,250.18488435813333,252.54287043520935,251.54999999999998,251.5500026973983,251.54999730260167,561184,622871.7666666667,31.79681507822339,37.492133754330226,NaN,NaN,NaN,NaN,6.688564753213208,23.092076779710915,62601137,-0.6271229518519892,-6.4234559107098335,-5.796332958857844
2022-05-20T13:30:00-04:00,248.15,252.91,246.45,252.56,NaN,NaN,NaN,269.4709155621774,NaN,NaN,272.7567999999999,296.5100119731371,249.00358802686264,252.54287043520935,251.10725154834805,251.56208657292368,250.65241652377242,531755,615577.4666666667,37.93009183511806,37.72471402382306,NaN,NaN,NaN,NaN,6.672238699412264,24.2627340533914,63132892,-0.44138089500668354,-6.348059077616199,-5.906678182609515
2022-05-23T09:30:00-04:00,255.65,261.5,253.52,259.6,NaN,NaN,NaN,269.4709155621774,NaN,NaN,272.36339999999984,296.32274877581096,248.40405122418875,252.54287043520935,258.20666666666665,258.20666666666665,258.20666666666665,691099,607654.1,46.241155099126,38.875148321876246,NaN,NaN,NaN,NaN,6.8342216494542445,23.470795123184438,63823991,0.2013029544475824,-5.655049489550038,-5.85635244399762
2022-05-23T13:30:00-04:00,259.59,260.905,258.88,260.44,NaN,NaN,NaN,269.4709155621774,NaN,NaN,271.9619999999999,296.0341817873,247.88981821269977,252.54287043520935,258.8547159498115,259.7439876765182,257.96544422310484,367018,599375.3666666667,47.15045686190265,39.88652185826282,NaN,NaN,NaN,NaN,6.490705817350368,22.735423259420827,64191009,0.7005701918803187,-4.980639704147222,-5.681209896027541
2022-05-24T09:30:00-04:00,257.73,259.57,253.54,257.27,NaN,NaN,NaN,269.4709155621774,NaN,NaN,271.44299999999987,295.64055103312796,247.24544896687178,252.18529634816753,256.79333333333335,256.79333333333335,256.79333333333335,450091,597541.9333333333,44.11771285190324,40.25877011775266,NaN,NaN,NaN,NaN,6.519941116111056,22.79490828743084,63740918,0.8262686886663584,-4.648374035194593,-5.474642723860951
2022-05-24T13:30:00-04:00,257.21,261.29,256.81,259.73,NaN,NaN,NaN,269.4709155621774,NaN,NaN,270.93219999999985,295.0186792911047,246.84572070889502,246.4919909860942,257.8269967052346,259.0511170998364,256.6028763106328,320930,597142.2666666667,46.96837227567604,40.80060683120462,NaN,NaN,NaN,NaN,6.3742310363888395,22.498287162437563,64061848,1.0686424269507473,-4.138839690172517,-5.207482117123265
2022-05-25T09:30:00-04:00,258.3,261.3,257.15,259.63,NaN,NaN,NaN,269.4709155621774,NaN,NaN,270.38619999999986,294.23385879999233,246.53854120000736,247.38659278887533,259.36,259.36,259.36,300243,591191.6333333333,46.86371787918752,41.212152425808064,NaN,NaN,NaN,NaN,6.215357390932496,22.220738570280872,63761605,1.2056314427384125,-3.700442813700249,-4.906074256438662
2022-05-25T13:30:00-04:00,259.5,264.55,258.98,262.59,NaN,NaN,NaN,269.4709155621774,NaN,NaN,269.91119999999984,293.4124529504471,246.40994704955256,250.63427423110028,260.84251500481435,262.1749148972587,259.51011511237,371708,575826.0666666667,50.3875789900733,41.91956886476209,NaN,NaN,NaN,NaN,6.169260434437318,21.28249337850023,64133313,1.4619203388851396,-3.078673832832237,-4.540594171717377
2022-05-26T09:30:00-04:00,262.27,266.7,261.49,266.04,NaN,NaN,NaN,269.4709155621774,NaN,NaN,269.50879999999984,292.5682493048055,246.44935069519423,252.9624193848802,264.74333333333334,264.74333333333334,264.74333333333334,471193,565367.3,54.200034926867175,42.63061733791499,NaN,NaN,NaN,NaN,6.1007418319775075,19.98952065535648,64604506,1.807487644487085,-2.28123461610852,-4.088722260595605
2022-05-26T13:30:00-04:00,266.06,267,264.88,265.75,NaN,NaN,NaN,269.4709155621774,NaN,NaN,269.20299999999986,292.0471884951258,246.35881150487393,254.94993550790417,265.218126560227,265.7772959282737,264.6589571921803,339720,553100.2,53.82560811177055,43.13445402198844,NaN,NaN,NaN,NaN,5.8164031296934,18.729442106011902,64264786,1.948100025705846,-1.6535972284632976,-3.6016972541691437
2022-05-27T09:30:00-04:00,268.49,272.42,267.56,271.36,251.7704902019748,251.7704902019748,251.7704902019748,NaN,NaN,NaN,269.0845999999999,291.8212235699317,246.3479764300681,259.44494840632336,270.44666666666666,270.44666666666666,270.44666666666666,632253,548082.5,59.63489717800752,44.69705233664677,NaN,NaN,NaN,NaN,5.877374334715301,18.215748582369496,64897039,2.3249636000889877,-0.6954927540579092,-3.020456354146897
2022-05-27T13:30:00-04:00,271.4,273.34,270.43,273.16,254.0968315564305,NaN,NaN,NaN,NaN,NaN,269.0665999999999,291.7888599615616,246.34434003843813,261.50495872505866,271.1984619216685,272.11260034283725,270.2843235004998,427628,543957.9333333333,61.31656851472607,46.49746351446397,NaN,NaN,NaN,NaN,5.665419025092777,17.891667498856584,65324667,2.5817046726129624,0.2066744866193062,-2.3750301859936562
2022-05-31T09:30:00-04:00,272.53,273.88,268.99,271.94,254.0968315564305,NaN,NaN,NaN,NaN,NaN,268.9589999999999,291.5746099188298,246.34339008116996,261.96696698004695,271.6033333333333,271.6033333333333,271.6033333333333,615913,538183.5333333333,59.506999625049964,48.238449241558676,NaN,NaN,NaN,NaN,5.610031951871862,17.27247672727464,64708754,2.551082924961626,0.8138234702083764,-1.7372594547532496
2022-05-31T13:30:00-04:00,271.91,274.74,270.99,272.04,255.50931346360713,NaN,NaN,NaN,NaN,NaN,268.7859999999999,291.1711779532958,246.40082204670398,263.33457358403757,272.0798286334724,272.5728745323533,271.5867827345915,575257,539001.3333333334,59.612213298913204,49.96801589475315,NaN,NaN,NaN,NaN,5.477172526738158,16.85694944617145,65284011,2.42037785360157,1.288212862248713,-1.132164991352857
2022-06-01T09:30:00-04:00,275.14,277.61,270.06,270.89,256.238662851625,NaN,NaN,NaN,NaN,NaN,268.7493999999999,291.1147050629883,246.38409493701153,264.71065886723005,272.85333333333335,272.85333333333335,272.85333333333335,466662,534176.6666666666,57.75374605567824,51.822082393142786,NaN,NaN,NaN,NaN,5.625231631971148,16.984631107558155,64817349,2.1485056592051066,1.5534670826535262,-0.5950385765515804
2022-06-01T13:30:00-04:00,270.76,274.69,270.34,272.37,256.238662851625,NaN,NaN,NaN,NaN,NaN,268.7947999999999,291.1800941870456,246.4095058129542,264.71065886723005,272.68163364891706,272.8737527863648,272.48951451146934,372735,531063.1666666666,59.50353372106588,53.363042527853345,NaN,NaN,NaN,NaN,5.534143658258925,17.10319265027438,65190084,1.9653482134739932,1.861646690290911,-0.10370152318308212
2022-06-02T09:30:00-04:00,264.4,271.37,261.64,271.28,256.238662851625,NaN,NaN,NaN,NaN,NaN,268.4459999999999,290.1104353722998,246.78156462770005,264.71065886723005,268.09666666666664,268.09666666666664,268.09666666666664,1032944,531177.1333333333,57.610964564859486,54.17517177540574,NaN,NaN,NaN,NaN,5.905276254097574,16.43169624239059,64157140,1.678906047335572,1.994931035986383,0.31602498865081097
2022-06-02T13:30:00-04:00,271.29,274.63,271.13,274.63,256.238662851625,NaN,NaN,NaN,NaN,NaN,268.2735999999999,289.5985981983735,246.9486018016262,264.71065886723005,269.96501095224244,272.52158495464874,267.40843694983613,551663,523373,61.64831495957954,55.21073306809694,NaN,NaN,NaN,NaN,5.733470807376319,15.340528267231642,64708803,1.6222666519364102,2.3438583035713236,0.7215916516349135
2022-06-03T09:30:00-04:00,270.21,273.39,268.42,269.82,256.238662851625,NaN,NaN,NaN,NaN,NaN,267.88599999999985,288.3631283143082,247.4088716856915,264.71065886723005,270.5433333333333,270.5433333333333,270.5433333333333,587469,510519.4666666667,53.73457652633692,55.897651901985064,NaN,NaN,NaN,NaN,5.767508606849438,14.657741915383603,64121334,1.1881827013133799,2.2068200282766384,1.0186373269632585
2022-06-03T13:30:00-04:00,269.78,270.77,268.52,270.04,256.238662851625,NaN,NaN,NaN,NaN,NaN,267.49199999999985,287.0075125989735,247.97648740102616,264.71065886723005,270.23816837427034,270.613447136946,269.8628896115947,388460,501149.36666666664,54.02527443980793,56.40171634228021,NaN,NaN,NaN,NaN,5.516257992074478,14.023726017238996,64509794,0.858573954055498,2.091854769532631,1.233280815477133
2022-06-06T09:30:00-04:00,272.24,274.14,268.2,268.79,256.238662851625,NaN,NaN,NaN,NaN,NaN,267.1931999999999,286.1547157368981,248.23168426310167,264.71065886723005,270.3766666666666,270.3766666666666,270.3766666666666,387288,491965.06666666665,52.02508918297683,56.7703857211223,NaN,NaN,NaN,NaN,5.546525278354872,13.289094249238426,64122506,0.5159580459048445,1.8782283728581888,1.3622703269533443
2022-06-06T13:30:00-04:00,268.72,270.25,267.28,268.64,256.238662851625,NaN,NaN,NaN,NaN,NaN,267.01819999999987,285.76029324063535,248.27610675936438,264.71065886723005,269.71262514928605,270.5231378503736,268.9021124481985,259959,483404.43333333335,51.777358920087444,56.86965571612331,NaN,NaN,NaN,NaN,5.362487758472383,12.415924653165598,63862547,0.2521734507936051,1.6774871404453506,1.4253136896517455
2022-06-07T09:30:00-04:00,266.51,272,266.03,271.01,256.238662851625,NaN,NaN,NaN,NaN,NaN,266.8375999999999,285.24534209295143,248.42985790704833,264.71065886723005,269.68,269.68,269.68,423433,482745.9666666667,55.39165796162547,56.95477164717748,NaN,NaN,NaN,NaN,5.4058814900100725,11.959575040394514,64285980,0.21187257835497286,1.6901544125954615,1.4782818342404886
2022-06-07T13:30:00-04:00,271.08,273.13,270.5,272.52,256.238662851625,NaN,NaN,NaN,NaN,NaN,266.5979999999999,284.3811853164897,248.81481468351012,264.71065886723005,270.7879760431601,271.9704701488649,269.6054819374553,371747,481547.8,57.57350131652962,57.22247830466027,NaN,NaN,NaN,NaN,5.207604240723638,11.76204826238253,64657727,0.2583935206689052,1.8012737350766201,1.542880214407715
2022-06-08T09:30:00-04:00,271.8,272.97,270.49,270.67,256.238662851625,NaN,NaN,NaN,NaN,NaN,266.3607999999999,283.5955564369359,249.12604356306397,262.66409187557014,271.3766666666667,271.3766666666667,271.3766666666667,327711,472703.36666666664,54.08330260642817,56.825935835261745,NaN,NaN,NaN,NaN,5.012775366386236,11.576126122409727,64330016,0.1418777082548346,1.7202273497262581,1.5783496414714235
2022-06-08T13:30:00-04:00,270.58,271.45,269.61,270.43,256.238662851625,NaN,NaN,NaN,NaN,NaN,266.13259999999985,282.8354365543311,249.42976344566856,262.66409187557014,271.0253703982097,271.4563363458394,270.59440445058,217747,467784.0333333333,53.629097308574174,56.276830749108036,NaN,NaN,NaN,NaN,4.786148554501503,11.173225404589735,64112269,0.031704638694483256,1.6179804398395277,1.5862758011450444
2022-06-09T09:30:00-04:00,267.31,272.66,267.25,270.65,256.238662851625,NaN,NaN,NaN,NaN,NaN,265.90359999999987,282.02845374075207,249.7787462592477,262.66409187557014,270.18666666666667,270.18666666666667,270.18666666666667,402631,465532.6,54.010378123159356,55.88421492754442,NaN,NaN,NaN,NaN,4.830709372037112,10.545828450505821,64514900,-0.039433604094468055,1.5369837960269592,1.5764174001214273
2022-06-09T13:30:00-04:00,270.5,270.87,264.69,264.73,256.238662851625,NaN,NaN,NaN,NaN,NaN,265.3975999999999,279.9760188772497,250.81918112275005,262.66409187557014,268.58329185080726,270.29152943757225,266.87505426404226,354716,461185.5,43.617344481153786,54.741724297704465,NaN,NaN,NaN,NaN,4.927087274034461,10.549502105973396,64160184,-0.4741269681361575,0.9837586899512303,1.4578856580873878
2022-06-10T09:30:00-04:00,260.12,260.52,253.9,254.79,NaN,NaN,NaN,273.76853502260406,273.76853502260406,273.76853502260406,264.9571999999999,279.4601911618467,250.45420883815305,262.66409187557014,256.4033333333333,256.4033333333333,256.4033333333333,718548,465852.0333333333,32.358326183803314,52.927765735427684,NaN,NaN,NaN,NaN,5.348723897317714,12.316939863776307,63441636,-1.3693686717867048,-0.2538251816459933,1.1155434901407115
2022-06-10T13:30:00-04:00,254.79,256.47,252.87,252.89,NaN,NaN,NaN,270.96678343066753,NaN,NaN,264.46699999999987,278.911344637283,250.0226553627168,262.66409187557014,255.45522944414026,256.59847951775777,254.31197937052275,494180,467129.5,30.725670614565317,50.87220408496336,NaN,NaN,NaN,NaN,5.223815047509307,14.085758516221675,62947456,-1.9901280176861083,-1.372116531966924,0.6180114857191843
2022-06-13T09:30:00-04:00,245.11,249,244.25,244.68,NaN,NaN,NaN,263.3592023656372,NaN,NaN,263.82479999999987,278.86351443443795,248.7860855655618,262.66409187557014,245.9766666666667,245.9766666666667,245.9766666666667,911821,478817.4,24.88328216107108,48.53451248469276,NaN,NaN,NaN,NaN,5.467828258401498,16.623837588814343,62035635,-2.804459463061486,-2.8875628431076734,-0.08310338004618723
2022-06-13T13:30:00-04:00,244.64,246.12,241.53,242.52,NaN,NaN,NaN,260.42446589447184,NaN,NaN,263.1791999999998,279.0275719492166,247.33082805078303,262.66409187557014,244.98025273753674,246.2390418296859,243.7214636453876,571325,480136.4,23.61123548118502,45.81757823623601,NaN,NaN,NaN,NaN,5.4051262399442495,19.20886334234868,61464310,-3.304940753791091,-4.214279322285051,-0.9093385684939602
2022-06-14T09:30:00-04:00,243.86,245.71,241.52,244.77,NaN,NaN,NaN,260.03130835381404,NaN,NaN,262.73159999999984,279.3514682834933,246.11173171650634,262.66409187557014,244,244,244,545171,475272.13333333336,27.754292256628446,43.96184364554255,NaN,NaN,NaN,NaN,5.318331508519661,21.610090531299125,62009481,-3.2935022656759125,-5.026216400588851,-1.7327141349129382
2022-06-14T13:30:00-04:00,244.7,245.61,242.26,244.47,NaN,NaN,NaN,260.03130835381404,NaN,NaN,262.3291999999999,279.70662528226234,244.95177471773744,262.66409187557014,244.05425372358906,244.11086899372663,243.9976384534515,500639,479726.1666666667,27.539817650402043,42.07002530344213,NaN,NaN,NaN,NaN,5.177736400768258,23.839801492467398,61508842,-3.1170304870277854,-5.62900224369767,-2.5119717566698845
2022-06-15T09:30:00-04:00,248.31,250.78,247.44,250.05,NaN,NaN,NaN,260.03130835381404,NaN,NaN,261.93699999999984,279.5188848819088,244.3551151180909,262.6232188003649,249.42333333333332,249.42333333333332,249.42333333333332,620064,485391.93333333335,37.25251145164814,41.014841179775786,NaN,NaN,NaN,NaN,5.258612372141954,24.482053241179432,62128906,-2.4640177751040215,-5.5919939755499115,-3.12797620044589
2022-06-15T13:30:00-04:00,250.02,255.29,246.42,251.74,NaN,NaN,NaN,260.03130835381404,NaN,NaN,261.58299999999986,279.2588625249432,243.90713747505654,262.6232188003649,250.29368016892147,251.15698501382923,249.4303753240137,630221,495701.63333333336,39.88090213434583,40.16509426650854,NaN,NaN,NaN,NaN,5.516568631274672,24.039907229457196,62759127,-1.7891851610681866,-5.364457651781123,-3.5752724907129365
2022-06-16T09:30:00-04:00,245.98,247.4,243.59,245.87,NaN,NaN,NaN,260.03130835381404,NaN,NaN,261.23339999999985,279.4391496896083,243.02765031039135,259.7505750402919,245.62,245.62000269739832,245.6199973026017,796968,512259.13333333336,34.478595647154464,38.671304101189186,NaN,NaN,NaN,NaN,5.7046708718979104,24.031303805758224,61962159,-1.6144357194105825,-5.593317139976165,-3.9788814205655822
2022-06-16T13:30:00-04:00,245.83,246.07,243.03,245.11,NaN,NaN,NaN,260.03130835381404,NaN,NaN,260.91979999999984,279.6771275239485,242.16247247605116,246.2094600322335,245.20697709670716,245.64771395614932,244.766240237265,699891,523198.56666666665,33.83945306208588,36.976014940157484,NaN,NaN,NaN,NaN,5.514337238190917,24.10192009832816,61262268,-1.4325014887905603,-5.769508281553783,-4.337006792763223
2022-06-17T09:30:00-04:00,244.67,250.46,244.06,249.85,NaN,NaN,NaN,260.03130835381404,NaN,NaN,260.8537999999998,279.7427800211871,241.96481997881253,243.2215680257868,248.12333333333333,248.12333333333333,248.12333333333333,900484,537508.2666666667,41.164899827630364,36.05327188452907,NaN,NaN,NaN,NaN,5.577598864034423,23.195683374980376,62162752,-0.9013391529871537,-5.463680733997165,-4.562341581010012
2022-06-17T13:30:00-04:00,249.99,250.42,247.51,247.53,NaN,NaN,NaN,260.03130835381404,NaN,NaN,260.6951999999998,279.89330917358325,241.4970908264163,240.35775344855185,248.26697202357371,248.4446139408622,248.08933010628522,588746,545809.1333333333,38.89491880885528,35.00083056312057,NaN,NaN,NaN,NaN,5.387056088031963,22.35417784615743,61574006,-0.6276301861753542,-5.346879313729204,-4.71924912755385
2022-06-21T09:30:00-04:00,250.255,254.74,249.51,253.39,NaN,NaN,NaN,260.03130835381404,NaN,NaN,260.5521999999998,279.85901093916806,241.24538906083154,240.58264145002147,252.54666666666665,252.54666666666665,252.54666666666665,583758,544192.6333333333,46.8651183562073,34.49045486548114,NaN,NaN,NaN,NaN,5.5172663674582525,20.821324863245536,62157764,-0.006177293490454261,-4.726970744416917,-4.720793450926463
2022-06-21T13:30:00-04:00,253.51,254.47,252.66,253.74,NaN,NaN,NaN,260.03130835381404,NaN,NaN,260.4077999999998,279.8080248605746,241.00757513942494,242.23911316001718,252.96885681538998,253.49451215728178,252.4432014734982,376571,542490.7333333333,47.30719573548563,34.75401566936198,NaN,NaN,NaN,NaN,5.252461626925521,19.397961379113063,62534335,0.44903591914164576,-4.159498551999405,-4.608534471141051
2022-06-22T09:30:00-04:00,251.68,257.17,250.37,255.26,NaN,NaN,NaN,260.03130835381404,NaN,NaN,260.2645999999998,279.7089506284167,240.82024937158292,243.98529052801373,254.26666666666668,254.26666666666668,254.26666666666668,571841,541021.6666666666,49.28076116759286,35.96276102534695,NaN,NaN,NaN,NaN,5.363000082145128,18.601121763804592,63106176,0.849833515080407,-3.546242577290542,-4.396076092370949
2022-06-22T13:30:00-04:00,255.27,256.45,252.69,253.13,NaN,NaN,NaN,260.03130835381404,NaN,NaN,260.0933999999998,279.63502720350385,240.55177279649573,244.02223242241098,254.2041421124723,254.28862101337003,254.1196632115746,313242,532287.8333333334,46.644310816547794,37.09980675405999,NaN,NaN,NaN,NaN,5.248500076277618,17.8611992638753,62792934,0.9606425689967653,-3.1952728811249926,-4.155915450121758
2022-06-23T09:30:00-04:00,255.5,258.49,253.65,256.13,NaN,NaN,NaN,260.03130835381404,NaN,NaN,259.9213999999998,279.4481431017251,240.39465689827446,245.8677859379288,256.09,256.09,256.09,499628,533386.7,50.648963045587394,38.94021253152544,NaN,NaN,NaN,NaN,5.256464356543503,17.573964787388526,63292562,1.2090787457273713,-2.644567017962544,-3.853645763689915
2022-06-23T13:30:00-04:00,256.15,259.35,255.8,258.85,NaN,NaN,NaN,260.03130835381404,NaN,NaN,259.7613999999998,279.18928429450676,240.33351570549283,247.47722875034304,256.8163440342734,257.7435664721793,255.88912159636754,306594,531182,54.018711934666605,41.112175135345545,NaN,NaN,NaN,NaN,5.134574045361825,17.47310402182713,63599156,1.510128820950038,-1.9659847375023674,-3.4761135584524054
2022-06-24T09:30:00-04:00,261.785,266.7,261.73,264.13,247.9766016841127,247.9766016841127,247.9766016841127,NaN,NaN,NaN,259.91439999999983,279.3569928970576,240.47180710294208,253.27678300027443,264.18666666666667,264.18666666666667,264.18666666666667,594192,516556.93333333335,59.76230951546441,43.39846208240527,NaN,NaN,NaN,NaN,5.328533042121692,18.56962727631914,64193348,1.9883060563647246,-0.9907309879964998,-2.9790370443612244
2022-06-24T13:30:00-04:00,264.07,267.87,263.65,267.83,249.68425615301663,NaN,NaN,NaN,NaN,NaN,260.1869999999998,279.68359878032095,240.69040121967865,255.02142640021953,265.18974981562747,266.3140877200958,264.0654119111591,472941,513932.86666666664,63.22860412867525,45.94766111656764,NaN,NaN,NaN,NaN,5.249352110541573,19.74592147033812,64666289,2.447072662906286,0.0798037842716326,-2.367268878634653
2022-06-27T09:30:00-04:00,268.01,268.28,264.64,265.13,250.61860814606132,NaN,NaN,NaN,NaN,NaN,260.4325999999998,279.8625825260017,241.00261747399793,256.1811411201756,266.01666666666665,266.01666666666665,266.01666666666665,403092,507786.9666666667,59.21952982884589,47.51673385779604,NaN,NaN,NaN,NaN,5.134398388360031,20.895182346465642,64263197,2.455613337701964,0.702247793492802,-1.7533655442091622
2022-06-27T13:30:00-04:00,265.1,265.43,263.36,264.82,250.61860814606132,NaN,NaN,NaN,NaN,NaN,260.6681999999998,280.01942970358266,241.3169702964169,256.1811411201756,265.3937424359969,266.1244224372416,264.6630624347522,292968,504603.9,58.758863456561,48.86515966652569,NaN,NaN,NaN,NaN,4.915512789191458,21.577608961621163,63970229,2.3284407815276285,1.1571854327003734,-1.171255348827255
2022-06-28T09:30:00-04:00,263.85,266.91,258.03,259.14,250.61860814606132,NaN,NaN,NaN,NaN,NaN,260.88799999999975,279.9123856142809,241.86361438571865,256.1811411201756,261.36,261.36,261.36,585924,511225.1,50.93987212820808,50.040965129458094,NaN,NaN,NaN,NaN,5.198690447106357,20.804525567116166,63384305,1.7748645546837192,1.047325344527394,-0.7275392101563252
2022-06-28T13:30:00-04:00,259.02,259.33,256.33,256.44,250.61860814606132,NaN,NaN,NaN,NaN,NaN,260.96559999999977,279.88483599305226,242.04636400694727,256.1811411201756,259.73391181590756,261.695887699047,257.77193593276814,402478,515975.73333333334,47.691131197429556,51.030370710554074,NaN,NaN,NaN,NaN,5.041641129455903,19.696638854699458,62981827,1.1691775112667775,0.7339326789271468,-0.4352448323396308
2022-06-29T09:30:00-04:00,257.59,261.95,255.82,259.82,250.61860814606132,NaN,NaN,NaN,NaN,NaN,260.96999999999974,279.88806586310716,242.05193413689233,256.1811411201756,259.19666666666666,259.19666666666666,259.19666666666666,523880,519323.9666666667,51.83254432304842,51.79234531736965,NaN,NaN,NaN,NaN,5.119381048780482,19.179552308213015,63505707,0.9479261372053968,0.7496628391671152,-0.1982632980382816
2022-06-29T13:30:00-04:00,259.67,261.6,259.33,260.27,250.61860814606132,NaN,NaN,NaN,NaN,NaN,260.96659999999974,279.885106752936,242.04809324706346,256.1811411201756,259.70543905517724,260.2998912659213,259.11098684443317,383747,519723.9666666667,52.37318074765416,52.75507831299814,NaN,NaN,NaN,NaN,4.91585383101045,18.69940051504703,63889454,0.7900836851702,0.7893413084244685,-0.0007423767457315766
2022-06-30T09:30:00-04:00,257.05,259.52,252.94,258.01,250.61860814606132,NaN,NaN,NaN,NaN,NaN,260.9813999999997,279.88947108514463,242.0733289148548,256.1811411201756,256.8233333333333,256.8233333333333,256.8233333333333,513370,525912.6,49.375771133386834,52.934410654225246,NaN,NaN,NaN,NaN,5.08829284308113,17.889597225814203,63376084,0.5055124497021078,0.6311481853819032,0.12563573567979539
2022-06-30T13:30:00-04:00,258.07,259.23,255.2,256.92,250.61860814606132,NaN,NaN,NaN,NaN,NaN,260.92519999999973,279.8644934356307,241.98590656436872,256.1811411201756,256.97954998447534,257.1259054043413,256.83319456460936,584881,538150.4,47.95038673162388,52.98035286823512,NaN,NaN,NaN,NaN,5.012700497146766,17.137637028669435,62791203,0.22994226385689973,0.41306356550092005,0.18312130164402032
2022-07-01T09:30:00-04:00,256.18,258.96,254.715,256.89,250.61860814606132,NaN,NaN,NaN,NaN,NaN,260.87039999999973,279.84019829520855,241.9006017047909,256.1811411201756,256.85499999999996,256.85499999999996,256.85499999999996,409349,538374.3333333334,47.90939292779043,52.88239799396352,NaN,NaN,NaN,NaN,4.957864747350567,16.54047431631372,62381854,0.04158224475098782,0.2350991075827551,0.19351686283176728
2022-07-01T13:30:00-04:00,256.89,259.77,256.87,259.51,250.61860814606132,NaN,NaN,NaN,NaN,NaN,260.80879999999974,279.7758651984142,241.8417348015853,256.1811411201756,257.6721222710636,258.59598399705123,256.74826054507594,320224,537224.6,51.78610083098878,53.24966870928073,NaN,NaN,NaN,NaN,4.810874408254096,15.778189120222445,62702078,0.08678004683705778,0.3019919213780895,0.21521187454103172
2022-07-05T09:30:00-04:00,256.16,259.85,254.79,259.66,250.61860814606132,NaN,NaN,NaN,NaN,NaN,260.68119999999976,279.5915352228568,241.77086477714275,254.7159128961405,258.09999999999997,258.09999999999997,258.09999999999997,417626,527193.8666666667,52.006323656453844,53.346623038628344,NaN,NaN,NaN,NaN,4.828669093378807,15.53334336341016,63119704,0.1181706040980614,0.36292512966360846,0.24475452556554705
2022-07-05T13:30:00-04:00,259.73,262.98,259.04,262.98,250.61860814606132,NaN,NaN,NaN,NaN,NaN,260.62579999999974,279.49259202834634,241.75900797165315,253.8987303169124,259.8249315624049,261.60730834943536,258.04255477537447,391140,523759.2,56.71852301446654,53.53946668718548,NaN,NaN,NaN,NaN,4.765192729566034,14.500363427877492,63510844,0.3412941625031692,0.6713722286945085,0.33007806619133934
2022-07-06T09:30:00-04:00,263.77,266.12,262.49,265,250.61860814606132,NaN,NaN,NaN,NaN,NaN,260.4985999999997,279.15882422590226,241.8383757740972,255.52634158139256,264.5366666666667,264.5366666666667,264.5366666666667,314160,503837.1666666667,59.334668679576,53.50892091319344,NaN,NaN,NaN,NaN,4.6841075345970316,14.094458126094345,63825004,0.5891549045181773,1.066521696839061,0.47736679232088364
2022-07-06T13:30:00-04:00,264.99,267.99,264.24,266.24,251.5567017713697,NaN,NaN,NaN,NaN,NaN,260.36019999999974,278.74333248173116,241.97706751826834,257.64007326511404,265.43169754207537,266.23722206077167,264.62617302337907,387855,497721.5,60.897179149635704,53.342390557547766,NaN,NaN,NaN,NaN,4.617385567840101,14.102123509909434,64212859,0.788406583335105,1.462875021489765,0.67446843815466
2022-07-07T09:30:00-04:00,265.22,269.03,265.15,267.41,252.66435169085284,NaN,NaN,NaN,NaN,NaN,260.26959999999974,278.46727455915465,242.07192544084484,258.8100586120912,267.19666666666666,267.19666666666666,267.19666666666666,359000,491515.8,62.36651774625666,53.567175408791385,NaN,NaN,NaN,NaN,4.564715170137236,14.318572743753991,64571859,0.9404817662532212,1.8500706459711864,0.9095888797179652
2022-07-07T13:30:00-04:00,267.39,268.97,267.3,268.34,254.137335704905,NaN,NaN,NaN,NaN,NaN,260.19559999999973,278.2305820781964,242.16061792180304,259.959046889673,267.6960184970719,268.1993360827914,267.19270091135246,353365,486606.6666666667,63.539308333808094,53.908635757166174,NaN,NaN,NaN,NaN,4.357949800841721,14.519561318038225,64925224,1.0375558156202547,2.2065336492432834,1.1689778336230288
2022-07-08T09:30:00-04:00,264.79,268.02,263.285,266.42,254.137335704905,NaN,NaN,NaN,NaN,NaN,260.1061999999997,277.97176593676636,242.2406340632331,259.959046889673,265.90833333333336,265.90833333333336,265.90833333333336,431743,480329.3,59.42215157942686,54.51451286082466,NaN,NaN,NaN,NaN,4.407739100781594,13.596379998170665,64493481,0.9108222964912922,2.307505704237144,1.3966834077458519
2022-07-08T13:30:00-04:00,266.38,268.07,266.2,267.63,254.137335704905,NaN,NaN,NaN,NaN,NaN,260.01139999999975,277.6647011122825,242.35809888771698,259.959046889673,266.43393717787393,267.108626698262,265.75924765748584,262020,468055.93333333335,61.13146580620978,55.474536761451816,NaN,NaN,NaN,NaN,4.226472022154338,12.751622288869827,64755501,0.8481274492873145,2.456842719354995,1.6087152700676806
2022-07-11T09:30:00-04:00,265.55,266.05,262.19,265.96,254.137335704905,NaN,NaN,NaN,NaN,NaN,259.9049999999998,277.3482255044978,242.4617744955018,259.959046889673,264.73333333333335,264.73333333333335,264.73333333333335,285132,450994.73333333334,57.52950242098529,55.88146233987588,NaN,NaN,NaN,NaN,4.313152592000457,12.681047360927856,64470369,0.643129442689107,2.4126270734290642,1.7694976307399573
2022-07-11T13:30:00-04:00,265.89,266.51,263.95,264.57,254.137335704905,NaN,NaN,NaN,NaN,NaN,259.7037999999998,276.6890617948849,242.7185382051147,259.959046889673,264.8650788568195,265.00325523653424,264.7269024771047,259209,436305.3333333333,54.64350432617246,56.04362830977004,NaN,NaN,NaN,NaN,4.187927406857567,12.48648663841796,64211160,0.37608803067925445,2.2396076690890254,1.863519638409771
2022-07-12T09:30:00-04:00,265.93,265.93,255.95,257.17,254.137335704905,NaN,NaN,NaN,NaN,NaN,259.4507999999998,276.20101472819965,242.7005852717999,259.959046889673,259.68333333333334,259.68333333333334,259.68333333333334,650032,427956.93333333335,42.4378645734461,55.54806355548857,NaN,NaN,NaN,NaN,4.6016468777963135,13.800331727625794,63561128,-0.3002435740204201,1.4882151708842457,1.7884587449046658
2022-07-12T13:30:00-04:00,257.18,257.25,252.05,253.73,NaN,NaN,NaN,268.96789366213875,268.96789366213875,268.96789366213875,259.12459999999976,275.6712546274738,242.5779453725257,259.959046889673,256.9771525170034,259.64690736502615,254.30739766898063,667891,430595.1,38.16960276111663,54.849436129023765,NaN,NaN,NaN,NaN,4.644386386525148,15.557140131584134,62893237,-0.9442536573698188,0.6081416731923923,1.5523953305622111
2022-07-13T09:30:00-04:00,249.77,253.53,248.11,252.36,NaN,NaN,NaN,265.2534439502233,NaN,NaN,258.79599999999976,275.21388829298235,242.37811170701718,259.959046889673,251.33333333333334,251.33333603073166,251.33333063593503,629667,432125.4,36.591189001841315,54.04099299145597,NaN,NaN,NaN,NaN,4.714073073201921,17.653930470534856,62263570,-1.39999045537284,-0.19759273865383875,1.2023977167190012
2022-07-13T13:30:00-04:00,252.26,253.39,250.51,252.67,NaN,NaN,NaN,265.2534439502233,NaN,NaN,258.4765999999998,274.73663916848955,242.21656083151004,259.959046889673,251.6824015413859,252.10333679100106,251.26146629177074,433013,434006.8,37.223781704478284,53.00082733956236,NaN,NaN,NaN,NaN,4.583067853687497,19.6009500709891,62696583,-1.6034261929093498,-0.801885024417686,0.8015411684916638
2022-07-14T09:30:00-04:00,250.76,252.36,245.94,252.31,NaN,NaN,NaN,263.59373715299273,NaN,NaN,258.10259999999977,274.0495318980455,242.15566810195406,259.959046889673,250.20333333333332,250.20333603073163,250.203330635935,565978,433811.36666666664,36.76507455475042,51.91216668944069,NaN,NaN,NaN,NaN,4.736420149852675,21.89906414601308,62130605,-1.6771633782303044,-1.2949130542962166,0.38225032393408775
2022-07-14T13:30:00-04:00,252.25,255.12,251.91,254.02,NaN,NaN,NaN,263.59373715299273,NaN,NaN,257.73259999999976,273.1747997448832,242.2904002551163,259.34599000939073,251.41210903533482,253.06903412272348,249.75518394794616,301221,433410.6666666667,40.514822465549535,50.754759507375184,NaN,NaN,NaN,NaN,4.627390139148913,23.22051189849584,62431826,-1.5298174399048892,-1.5300214759470236,-0.00020403604213453663
2022-07-15T09:30:00-04:00,255.77,260.33,255.28,255.93,NaN,NaN,NaN,263.59373715299273,NaN,NaN,257.43779999999975,272.43725827824653,242.438341721753,259.34599000939073,257.18,257.18,257.18,501141,433461.1,44.47534824563949,49.69337947637972,NaN,NaN,NaN,NaN,4.747576557781132,23.121634999924698,62932967,-1.2353747041750012,-1.5444224162608862,-0.3090477120858849
2022-07-15T13:30:00-04:00,255.95,256.9,254.78,256.67,NaN,NaN,NaN,263.59373715299273,NaN,NaN,257.1625999999998,271.6961538998806,242.62904610011907,257.47063360601004,256.73240531511044,257.25738278731495,256.20742784290593,364291,435384.3333333333,45.97611409259079,48.62758911516222,NaN,NaN,NaN,NaN,4.559892517939621,23.105084415873616,63297258,-0.9360207181463012,-1.4790736097687613,-0.5430528916224602
2022-07-18T09:30:00-04:00,259.68,260.83,256.91,258.37,NaN,NaN,NaN,263.59373715299273,NaN,NaN,256.9169999999998,270.936512830363,242.8974871696366,257.47063360601004,258.7033333333333,258.7033333333333,258.7033333333333,428039,429845.9,49.36224265300698,47.698712322787244,NaN,NaN,NaN,NaN,4.531328766658217,22.190681669165304,63725297,-0.5858827483645929,-1.2754063270782012,-0.6895235787136084
2022-07-18T13:30:00-04:00,258.36,258.39,253.34,254.3,NaN,NaN,NaN,263.59373715299273,NaN,NaN,256.70839999999976,270.5661466335932,242.85065336640633,253.70850688480806,257.34090692922985,258.99061811946854,255.69119573899115,291940,423812.5333333333,42.49495596695483,46.19554429658344,NaN,NaN,NaN,NaN,4.5683767118969145,21.925073743614384,63433357,-0.5891617472996896,-1.4259757628382204,-0.8368140155385307
2022-07-19T09:30:00-04:00,257.59,258.04,253.69,257.71,NaN,NaN,NaN,263.59373715299273,NaN,NaN,256.76679999999976,270.6163247225619,242.91727527743762,249.87856634163913,256.48,256.48,256.48,537797,428302.7,48.90831003104728,45.44455561455633,NaN,NaN,NaN,NaN,4.552778375332851,21.67843781274567,63971154,-0.3350848207062129,-1.255670041421297,-0.920585220715084
2022-07-19T13:30:00-04:00,257.72,259.71,257.68,259.48,NaN,NaN,NaN,263.59373715299273,NaN,NaN,256.89859999999976,270.72344720207894,243.0737527979206,249.87856634163913,257.66178109355036,258.89882243829356,256.42473974880716,490822,434897.8333333333,51.90656553364967,44.785634166516324,NaN,NaN,NaN,NaN,4.372579919951931,21.050999662362887,64461976,-0.036918560712341675,-0.966733421605511,-0.9298148608931693
2022-07-20T09:30:00-04:00,260.08,264.85,258.91,261.51,248.04408284293658,248.04408284293658,248.04408284293658,NaN,NaN,NaN,257.2351999999998,270.66765576358637,243.80274423641322,253.89749277353542,261.75666666666666,261.75666666666666,261.75666666666666,551478,433749.63333333336,55.15685394843874,44.616159275620134,NaN,NaN,NaN,NaN,4.484538497098221,19.7148839313188,65013454,0.28992840871962555,-0.5674043499936374,-0.857332758713263
2022-07-20T13:30:00-04:00,261.66,263,261.09,262.25,248.57753362280306,NaN,NaN,NaN,NaN,NaN,257.62979999999976,270.4554352607113,244.8041647392882,253.89749277353542,261.9125310996318,262.0894432989898,261.7356189002738,428062,434602.43333333335,56.31584585643859,44.73561224206771,NaN,NaN,NaN,NaN,4.300642890162636,18.474205038206428,65441516,0.5346324411482845,-0.18904220727790744,-0.7236746484261919
2022-07-21T09:30:00-04:00,259.61,264.6,257.08,263.9,248.57753362280306,NaN,NaN,NaN,NaN,NaN,258.0123999999998,270.41508781195284,245.60971218804676,253.89749277353542,261.86,261.86,261.86,531119,434843.73333333334,58.86852108029468,45.909230563985474,NaN,NaN,NaN,NaN,4.530596969436736,17.782789480306747,65972635,0.7718786208979922,0.24117362769629835,-0.5307049932016938
2022-07-21T13:30:00-04:00,263.86,264.86,263.19,264.85,250.54745315631436,NaN,NaN,NaN,NaN,NaN,258.41999999999973,270.346047459275,246.49395254072448,254.7981163000501,262.72755331863533,263.89553505514317,261.5595715821275,293030,431819.8333333333,60.306700845365825,47.49045185571755,NaN,NaN,NaN,NaN,4.32626861447697,17.08214534591622,66265665,0.9455818941135806,0.651272374440282,-0.29430951967329866
2022-07-22T09:30:00-04:00,265.26,265.33,259.38,259.71,250.54745315631436,NaN,NaN,NaN,NaN,NaN,258.6131999999997,270.30122288844905,246.92517711155037,254.7981163000501,261.47333333333336,261.47333333333336,261.47333333333336,443790,429500.5,50.099699601614404,48.45534546998706,NaN,NaN,NaN,NaN,4.442249427728615,17.1307611344659,65821875,0.6795471468734096,0.5551244139184632,-0.12442273295494627
2022-07-22T13:30:00-04:00,259.63,260.93,259.07,260.45,250.54745315631436,NaN,NaN,NaN,NaN,NaN,258.78739999999976,270.319057858295,247.25574214170447,254.7981163000501,260.92064466857204,261.5732751711465,260.26801416599756,318276,420613.6666666667,51.375666886068316,49.46619441152921,NaN,NaN,NaN,NaN,4.257803040033715,17.23014929733137,66140151,0.5255381464464383,0.5324999501031016,0.0069618036566633235
2022-07-25T09:30:00-04:00,261.16,261.43,256.85,259.22,250.54745315631436,NaN,NaN,NaN,NaN,NaN,259.05439999999976,269.97960986346897,248.12919013653058,254.7981163000501,259.1666666666667,259.1666666666667,259.1666666666667,366990,419201.7,49.12705161968535,50.34919277331028,NaN,NaN,NaN,NaN,4.280817108602735,17.70936416981319,65773161,0.3228995146508752,0.41058619697025733,0.08768668231938213
2022-07-25T13:30:00-04:00,259.23,259.41,256.89,258.74,250.54745315631436,NaN,NaN,NaN,NaN,NaN,259.32699999999977,269.501240610522,249.15275938947755,254.7981163000501,258.82611700602234,259.23019206139617,258.4220419506485,260670,417216.56666666665,48.23972539177275,50.90097155375479,NaN,NaN,NaN,NaN,4.155044457988256,18.154349408546302,65512491,0.14753071850267707,0.2721000804477285,0.1245693619450514
2022-07-26T09:30:00-04:00,259.86,259.88,249.93,251.14,NaN,NaN,NaN,268.7336488813798,268.7336488813798,268.7336488813798,259.35279999999983,269.4369253780715,249.26867462192814,254.7981163000501,253.65,253.65,253.65,606375,423508.2,36.88114508256542,50.358528470678074,NaN,NaN,NaN,NaN,4.568969853846237,19.62520926266301,64906116,-0.4562707696206207,-0.44576910008072446,0.010501669539896216
2022-07-26T13:30:00-04:00,251.14,252.33,249.59,251.79,NaN,NaN,NaN,264.53371029586253,NaN,NaN,259.4379999999998,269.18756081065885,249.68843918934076,254.7981163000501,252.70735953955204,253.88478665273925,251.52993242636484,388656,423425.4,38.22096006145771,49.80458889702571,NaN,NaN,NaN,NaN,4.4383291500000785,21.035362994344727,65294772,-0.7694176373375663,-0.9512703771320616,-0.18185273979449534
2022-07-27T09:30:00-04:00,261.16,265.5,258.89,264.05,247.3687310812221,247.3687310812221,247.3687310812221,NaN,NaN,NaN,259.6511999999998,269.32836374979775,249.97403625020183,254.7981163000501,262.81333333333333,262.81333333333333,262.81333333333333,721078,436989.3333333333,56.83316187589498,50.33822598437485,NaN,NaN,NaN,NaN,5.100591353571502,19.679530682751263,66015850,-0.14129540828732684,-0.3584720001536539,-0.21717659186632704
2022-07-27T13:30:00-04:00,264.18,270,263.74,268.48,251.86401603207565,NaN,NaN,NaN,NaN,NaN,259.9459999999998,269.78166489874377,250.1103351012558,254.7981163000501,265.45994651466646,267.72979567587737,263.19009735345554,980323,456738.26666666666,61.36276897010475,51.68592691317127,NaN,NaN,NaN,NaN,5.183406256887823,19.110239731770825,66996173,0.5444985831585485,0.4634466370818586,-0.08105194607668989
2022-07-28T09:30:00-04:00,269.83,275.98,267.94,275.87,256.53974257607223,NaN,NaN,NaN,NaN,NaN,260.35819999999984,271.0628664142459,249.6535335857538,259.2717729583925,273.2633333333334,273.2633333333334,273.2633333333334,721179,468810.9,67.49104950939426,53.01326544733892,NaN,NaN,NaN,NaN,5.387448667110123,19.36133583123537,67717352,1.4181489262224705,1.6916342117013983,0.2734852854789278
2022-07-28T13:30:00-04:00,275.88,277.83,275.6,276.42,261.69157245897804,NaN,NaN,NaN,NaN,NaN,260.8239999999998,272.2336786983868,249.41432130161272,263.348418366714,274.6741656244721,276.3296242303936,273.0187070185506,523790,474491.73333333334,67.89913607559836,54.15559191462096,NaN,NaN,NaN,NaN,5.161916619459397,19.81314589947984,68241142,1.9240007276983524,2.6784861951018684,0.754485467403516
2022-07-29T09:30:00-04:00,277.69,281.1,276.65,279.16,263.89627371084265,NaN,NaN,NaN,NaN,NaN,261.2845999999998,273.713042354551,248.85615764544855,267.1747346933712,278.97,278.97,278.97,634971,481266,69.92463847780209,55.210433666718345,NaN,NaN,NaN,NaN,5.127494003783726,20.604429162618036,68876113,2.308181438351775,3.6397122653432348,1.3315308269914596
2022-07-29T13:30:00-04:00,279.3,282,279.24,280.82,265.9348521785316,NaN,NaN,NaN,NaN,NaN,261.7239999999998,275.2794511544387,248.16854884556096,269.43978775469697,279.73134075718497,280.58417635170383,278.8785051626661,506036,489399.86666666664,71.11382055565865,56.267431859519775,NaN,NaN,NaN,NaN,4.964101574942029,21.439577324126073,69382149,2.5217777894392452,4.483753063790516,1.9619752743512708
2022-08-01T09:30:00-04:00,277.83,281.26,276.78,276.94,265.9348521785316,NaN,NaN,NaN,NaN,NaN,261.9801999999998,276.1769153891446,247.78348461085497,269.43978775469697,278.32666666666665,278.32666666666665,278.32666666666665,525910,497425.8,64.67667263761925,56.68229982790011,NaN,NaN,NaN,NaN,4.9295228910176,21.681353371114866,68856239,2.2579605958085867,4.784426019112004,2.5264654233034176
2022-08-01T13:30:00-04:00,277.06,279,275.85,278,265.9348521785316,NaN,NaN,NaN,NaN,NaN,262.1835999999998,276.9881380934491,247.37906190655048,269.43978775469697,278.04274671212784,278.3905579068128,277.6949355174429,350442,500466.9,65.5929885991113,57.059891810310496,NaN,NaN,NaN,NaN,4.80241411308777,21.705448089977118,69206681,2.018852484936272,5.050031029473757,3.0311785445374855
2022-08-02T09:30:00-04:00,275.64,277.88,272.46,275.305,265.9348521785316,NaN,NaN,NaN,NaN,NaN,262.38709999999975,277.62153101531607,247.15266898468346,269.43978775469697,275.215,275.215,275.215,517233,496040.26666666666,61.243097531079094,57.85584880527227,NaN,NaN,NaN,NaN,4.8550988192957885,21.021134354472267,68689448,1.5635292899012914,4.9855901569141,3.4220608670128083
2022-08-02T13:30:00-04:00,275.17,275.64,273.49,274.83,265.9348521785316,NaN,NaN,NaN,NaN,NaN,262.5872999999998,278.20268052179233,246.9719194782073,269.43978775469697,274.9694335485551,275.248043685025,274.69082341208525,401819,487171.2,60.48178135149726,58.50628555280291,NaN,NaN,NaN,NaN,4.661877475060373,20.385700171503473,68287629,1.1346670773192344,4.840394713661851,3.705727636342617
2022-08-03T09:30:00-04:00,276.81,283.5,276.63,283.17,265.9348521785316,NaN,NaN,NaN,NaN,NaN,263.0678999999998,279.67685229568553,246.45894770431403,270.6925656514591,281.09999999999997,281.09999999999997,281.09999999999997,422188,480255.23333333334,68.00280485373226,59.85455364094912,NaN,NaN,NaN,NaN,4.94817194112749,20.919222299870352,68709817,1.30483833251286,5.336775551983692,4.031937219470832
2022-08-03T13:30:00-04:00,283.05,283.3,282.3,282.47,268.6616137429527,NaN,NaN,NaN,NaN,NaN,263.5884999999998,280.94863228637456,246.22836771362498,272.5540525211673,281.73104107381624,282.50895011126926,280.95313203636323,277820,475082.13333333336,66.85275786126938,61.184055960198876,NaN,NaN,NaN,NaN,4.666159659618384,21.41463570478246,68431997,1.2616658302965238,5.609019507341486,4.347353677044962
2022-08-04T09:30:00-04:00,281.8,283.74,280.2,282.77,268.6616137429527,NaN,NaN,NaN,NaN,NaN,264.0474999999998,282.1811630883099,245.91383691168963,273.37324201693383,282.2366666666667,282.2366666666667,282.2366666666667,353783,468008.9666666667,67.10948239087311,63.34322291079228,NaN,NaN,NaN,NaN,4.585719683931359,21.39473686710049,68785780,1.1479788401780313,5.782327227267501,4.63434838708947
2022-08-04T13:30:00-04:00,282.74,283.77,282.11,283.71,269.3705612823185,NaN,NaN,NaN,NaN,NaN,264.5162999999998,283.43026825736024,245.6023317426393,274.64659361354705,282.611017054563,283.0792458015073,282.1427883076187,226140,465506.26666666666,67.94716161060512,65.46652302144567,NaN,NaN,NaN,NaN,4.376739706507688,21.380809992333177,69011920,1.0342812238702583,5.927199916927293,4.892918693057035
2022-08-05T09:30:00-04:00,279.02,283.62,278.81,281.8,269.3705612823185,NaN,NaN,NaN,NaN,NaN,264.99209999999977,284.4174494269834,245.56675057301612,274.64659361354705,281.41,281.41,281.41,365179,460974.2,64.36029476031835,66.00417537033304,NaN,NaN,NaN,NaN,4.414115441757137,20.611775591870067,68646741,0.7422994861929899,5.820793050798272,5.0784935646052825
2022-08-05T13:30:00-04:00,281.84,283.17,281.3,282.95,269.3705612823185,NaN,NaN,NaN,NaN,NaN,265.51269999999977,285.4337013011501,245.59169869884943,274.64659361354705,281.8363593181674,282.3574925130368,281.31522612329803,244433,456978.93333333335,65.53982891697669,66.30253679510962,NaN,NaN,NaN,NaN,4.232392910203056,19.89767222001146,68891174,0.5474690809460068,5.7628299157877905,5.215360834841784
2022-08-08T09:30:00-04:00,284.15,285.87,280.3,280.5,269.6713324601382,NaN,NaN,NaN,NaN,NaN,265.98489999999975,286.1833122633552,245.78648773664432,276.0978159301361,282.22333333333336,282.22333333333336,282.22333333333336,474287,458520.5333333333,60.914426676067436,65.83277802130056,NaN,NaN,NaN,NaN,4.32793627375998,19.723214391466087,68416887,0.19275319799665347,5.4563023323376,5.263549134340947
2022-08-08T13:30:00-04:00,280.53,280.82,279.35,280.34,269.6713324601382,NaN,NaN,NaN,NaN,NaN,266.40149999999977,286.90548012583105,245.89751987416852,276.0978159301361,281.43928199914853,282.4368702132248,280.4416937850723,292973,458554.9666666667,60.61357482838954,65.31238078935708,NaN,NaN,NaN,NaN,4.123797968491408,19.324777662460228,68123914,-0.09787788554148058,5.141201777414096,5.239079662955577
2022-08-09T09:30:00-04:00,279.64,281.93,277.62,281.24,269.6713324601382,NaN,NaN,NaN,NaN,NaN,266.8330999999998,287.65728660021097,246.00891339978858,276.0978159301361,280.2633333333333,280.2633333333333,280.2633333333333,341814,452022.2,61.7577260802517,64.72902990381775,NaN,NaN,NaN,NaN,4.137098113599165,18.52777900616249,68465728,-0.26523668954686297,4.907533801021998,5.172770490568861
2022-08-09T13:30:00-04:00,281.36,283.07,280.89,282.3,269.6713324601382,NaN,NaN,NaN,NaN,NaN,267.21949999999975,288.4562562730376,245.98274372696193,276.0978159301361,281.19878581611204,282.11014213834784,280.28742949387623,360128,447665.73333333334,63.1167107542282,64.15780777514415,NaN,NaN,NaN,NaN,3.9973053911992245,18.02277324834238,68825856,-0.3357422375905763,4.753092693580641,5.088834931171217
2022-08-10T09:30:00-04:00,288.17,289.63,286.95,288.32,275.16071653737845,NaN,NaN,NaN,NaN,NaN,267.6858999999997,289.7166533861327,245.65514661386675,279.33479340498377,288.29999999999995,288.29999999999995,288.29999999999995,499328,445927.4,69.7018164824646,64.51674662120453,NaN,NaN,NaN,NaN,4.235355006113564,18.70311425738275,69325184,-0.02454518681479101,5.058153447652728,5.082698634467519
2022-08-10T13:30:00-04:00,288.32,289.8,287.97,289.13,276.10295669477034,NaN,NaN,NaN,NaN,NaN,268.14369999999974,290.9721137696974,245.3152862303021,280.648834723987,288.5868699868299,288.91694917205905,288.2567908016008,377155,444230.5,70.46588152705058,64.86481040177162,NaN,NaN,NaN,NaN,4.063543934248308,19.36097261732424,69702339,0.1771481094181695,5.304133771240231,5.1269856618220615
2022-08-11T09:30:00-04:00,290.85,291.07,287.05,288.74,276.3107768450081,NaN,NaN,NaN,NaN,NaN,268.57029999999975,292.113920487098,245.02667951290147,281.7390677791896,288.9533333333333,288.9533333333333,288.9533333333333,355887,438389.43333333335,69.55635612367958,65.45861458695738,NaN,NaN,NaN,NaN,4.060433653230571,20.172713292924467,69346452,0.22264852491707643,5.405296317968407,5.182647793051331
2022-08-11T13:30:00-04:00,288.72,288.8,286.53,287.36,276.3107768450081,NaN,NaN,NaN,NaN,NaN,268.95069999999976,293.07461411111495,244.82678588888456,281.7390677791896,288.35202207511855,289.04067831712445,287.66336583311266,271335,437666.26666666666,66.29558930907987,65.87388658392756,NaN,NaN,NaN,NaN,3.9325455351426757,20.76856577303748,69075117,0.10417811355964623,5.312870435000889,5.208692321441243
2022-08-12T09:30:00-04:00,288.725,289.725,287,289.62,276.3107768450081,NaN,NaN,NaN,NaN,NaN,269.41469999999975,294.2092011976544,244.6201988023451,281.7390677791896,288.7816666666667,288.7816666666667,288.7816666666667,250829,431234.23333333334,68.86944295317782,65.93578930531653,NaN,NaN,NaN,NaN,3.8462922826324863,21.482083964340354,69325946,0.12120323260026389,5.360196362191573,5.238993129591309
2022-08-12T13:30:00-04:00,289.62,291.9,289.555,291.9,278.6824628438786,NaN,NaN,NaN,NaN,NaN,269.9000999999998,295.4738584637143,244.32634153628527,284.13366270294506,290.1299010646532,291.2843006422392,288.9755014870672,342134,432029.5,71.25439501816088,66.2501919593802,NaN,NaN,NaN,NaN,3.739057119587307,22.508705827285976,69668080,0.22326194682930112,5.518070563127935,5.294808616298634
2022-08-15T09:30:00-04:00,291.07,293.15,290.17,292.91,279.7561008964296,NaN,NaN,NaN,NaN,NaN,270.43909999999977,296.78240136411233,244.0957986358872,285.44693016235607,292.07666666666665,292.07666666666665,292.07666666666665,256747,428354.73333333334,72.26794692601399,66.61865371189026,NaN,NaN,NaN,NaN,3.6848387539024965,23.661645245939106,69924827,0.2917106925175439,5.659446981945564,5.36773628942802
2022-08-15T13:30:00-04:00,293,294.16,292.77,293.5,281.91264176477375,NaN,NaN,NaN,NaN,NaN,271.01769999999976,298.0809429106438,243.95445708935574,287.3025441298849,292.7224743406554,293.42037346788476,292.0245752134261,219850,426994.06666666665,72.86973543714095,66.9702661280714,NaN,NaN,NaN,NaN,3.520921700052321,24.892316394910033,70144677,0.3080368782238594,5.752782387207844,5.444745508983985
2022-08-16T09:30:00-04:00,291.82,293.47,290.435,292.77,281.91264176477375,NaN,NaN,NaN,NaN,NaN,271.7296999999997,299.16878966494073,244.29061033505866,287.3025441298849,292.22499999999997,292.22499999999997,292.22499999999997,284303,416258.3333333333,70.82194618885966,67.4318126586815,NaN,NaN,NaN,NaN,3.488355864334298,25.196082810142833,69860374,0.2058964128885803,5.7021160250947105,5.49621961220613
2022-08-16T13:30:00-04:00,292.82,294,291.18,292.75,281.91264176477375,NaN,NaN,NaN,NaN,NaN,272.51009999999974,300.0763229904739,244.9438770095256,287.3025441298849,292.41613221910626,292.62451996624463,292.2077444719679,239169,411275.43333333335,70.76327325592577,67.80491582574929,NaN,NaN,NaN,NaN,3.4406161597389904,25.57923059990393,69621205,0.0796989794699039,5.59584333654351,5.516144357073606
2022-08-17T09:30:00-04:00,289.72,292.42,289.52,291.8,281.91264176477375,NaN,NaN,NaN,NaN,NaN,273.2988999999997,300.77058952140726,245.82721047859215,287.3025441298849,291.24666666666667,291.24666666666667,291.24666666666667,273102,396342.9,67.88633464515888,68.30290925211297,NaN,NaN,NaN,NaN,3.425572148329064,25.346431198944984,69348103,-0.11449349493752159,5.3730274884017035,5.487520983339225
2022-08-17T13:30:00-04:00,291.91,293.335,290.73,291.31,281.91264176477375,NaN,NaN,NaN,NaN,NaN,274.07169999999974,301.3519621402462,246.7914378597533,287.3025441298849,291.5079646212524,291.7802342746714,291.23569496783347,251535,372049.9666666667,66.38712050001917,68.71530537151507,NaN,NaN,NaN,NaN,3.3669598520198423,25.33062811877766,69096568,-0.311506974166754,5.098137265630783,5.409644239797537
2022-08-18T09:30:00-04:00,290.54,291.58,289.1,291.03,281.91264176477375,NaN,NaN,NaN,NaN,NaN,274.8460999999997,301.80783045560395,247.88436954439547,287.3025441298849,290.57,290.57,290.57,233859,355805.9666666667,65.49699888754465,68.98239628632172,NaN,NaN,NaN,NaN,3.303605576875565,24.736893200998143,68862709,-0.485849135628615,4.802332820261768,5.288181955890383
2022-08-18T13:30:00-04:00,291.1,291.89,289.61,290.19,281.91264176477375,NaN,NaN,NaN,NaN,NaN,275.5694999999997,302.1961480241241,248.94285197587536,287.3025441298849,290.56681964243785,290.57014946456417,290.56348982031153,213336,345457.5,62.777580523045756,68.95817269838012,NaN,NaN,NaN,NaN,3.230490892813023,24.263191750339704,68649373,-0.6714725934203347,4.448841214114964,5.1203138075352985
2022-08-19T09:30:00-04:00,288.77,289.25,285.93,286.13,281.91264176477375,NaN,NaN,NaN,NaN,NaN,276.1734999999997,302.3571639338469,249.98983606615252,287.3025441298849,287.10333333333335,287.10333333333335,287.10333333333335,357205,336198.63333333336,51.62139362845268,67.66671392309355,NaN,NaN,NaN,NaN,3.304027257612092,22.61349559166617,68292168,-1.0583987164384343,3.797315411987256,4.85571412842569
2022-08-19T13:30:00-04:00,286.12,286.83,285.57,286.16,281.91264176477375,NaN,NaN,NaN,NaN,NaN,276.76329999999973,302.4876132938584,251.03898670614112,287.3025441298849,286.758808502038,287.2027871831862,286.31482982088977,215097,326500.6666666667,51.68971093693936,66.32555888094275,NaN,NaN,NaN,NaN,3.1580253106397995,21.02241021570407,68507265,-1.2877875936249907,3.245979636394452,4.533767230019443
2022-08-22T09:30:00-04:00,282.1,282.4,277.8,278.53,NaN,NaN,NaN,291.2653720644161,291.2653720644161,291.2653720644161,277.1664999999997,302.35130956848093,251.98169043151847,287.3025441298849,279.57666666666665,279.57666666666665,279.57666666666665,513683,326093.1,37.27315512105299,64.01961595218371,NaN,NaN,NaN,NaN,3.529594931308386,21.374696284316247,67993582,-1.8923184095634777,2.168369218065095,4.060687627628573
2022-08-22T13:30:00-04:00,278.47,278.515,277.22,277.78,NaN,NaN,NaN,288.70399151603357,NaN,NaN,277.6360999999997,301.9587746300775,253.3134253699219,286.9752282431263,278.7497779140991,279.6179157328942,277.8816400953041,466028,329945.9666666667,36.2042518635784,61.87023470607646,NaN,NaN,NaN,NaN,3.3710524362149257,21.80888855126154,67527554,-2.256911917195707,1.2395477311339391,3.496459648329646
2022-08-23T09:30:00-04:00,276.41,278.86,275.4,277.19,NaN,NaN,NaN,287.9457419016684,NaN,NaN,278.0256999999997,301.67389891748087,254.3775010825185,286.9752282431263,277.15000000000003,277.15000000000003,277.15000000000003,433846,327166.4,35.345530669375194,59.47566954294769,NaN,NaN,NaN,NaN,3.377405833628148,22.54386498509551,67093708,-2.436649989210922,0.4506471618159935,2.8872971510269156
2022-08-23T13:30:00-04:00,277.21,277.51,276.03,276.34,NaN,NaN,NaN,287.2959354515925,NaN,NaN,278.36289999999974,301.4170619748063,255.30873802519318,286.2446460756008,276.9612689808981,277.212565291593,276.70997267020323,244709,321929.4,34.09099258997617,56.82114079807735,NaN,NaN,NaN,NaN,3.241876845511853,23.226343102227055,66848999,-2.502141063071748,-0.24037917781276974,2.2617618852589785
2022-08-24T09:30:00-04:00,275.74,277.21,275.11,275.53,NaN,NaN,NaN,286.4938474765201,NaN,NaN,278.6432999999997,301.20655097233606,256.0800490276634,286.2446460756008,275.95,275.95,275.95,514104,324993.26666666666,32.892868322522034,54.00863518354221,NaN,NaN,NaN,NaN,3.160314213689575,24.03554861610541,66334895,-2.4843355893443926,-0.843657601421512,1.6406779879228803
2022-08-24T13:30:00-04:00,275.51,276.94,275.5,275.87,NaN,NaN,NaN,286.280490773042,NaN,NaN,278.91569999999973,301.00460128640685,256.8267987135926,285.22017348838455,276.0107991917617,276.08580586510504,275.93579251841834,337790,326992.26666666666,33.94232397405399,51.228105793321724,NaN,NaN,NaN,NaN,3.0374346269974626,24.78695373613531,66672685,-2.336202228938074,-1.2795747982497119,1.0566274306883618
2022-08-25T09:30:00-04:00,277.285,277.66,274.54,276.11,NaN,NaN,NaN,286.12865028335824,NaN,NaN,279.1598999999997,300.84568063987246,257.47411936012696,285.22017348838455,276.10333333333335,276.10333333333335,276.10333333333335,459075,330502,34.71839813632876,48.649280932426656,NaN,NaN,NaN,NaN,3.0433321536405016,25.68077700175441,67131760,-2.115204358500338,-1.5873780174370609,0.5278263410632772
2022-08-25T13:30:00-04:00,276.11,279,276.07,279,NaN,NaN,NaN,286.12865028335824,NaN,NaN,279.4428999999998,300.74015128650484,258.1456487134947,281.7841387907077,276.90465428800485,277.8514493875707,275.957859188439,328840,333925.3333333333,43.34930552682581,46.69114038034809,NaN,NaN,NaN,NaN,3.0352369998090376,25.92903513606807,67460600,-1.6861837106333744,-1.5799032972284408,0.10628041340493355
2022-08-26T09:30:00-04:00,279.01,280.28,271.15,272.76,NaN,NaN,NaN,286.12865028335824,NaN,NaN,279.70389999999975,300.3369398429453,259.0708601570542,280.2273110325661,274.72999999999996,274.72999999999996,274.72999999999996,339708,333076.3,33.15628410783356,44.21042248482485,NaN,NaN,NaN,NaN,3.470577214108392,27.12091420519454,67120892,-1.7280805041277305,-2.0538202167547297,-0.3257397126269991
2022-08-26T13:30:00-04:00,272.745,272.745,267.98,268.13,NaN,NaN,NaN,281.2891022045624,NaN,NaN,279.85749999999973,300.0239910433278,259.6910089566717,272.93784882605286,271.83838022797,274.37205966612987,269.3047007898101,442471,339677.56666666665,27.911932681863206,41.462194783528,NaN,NaN,NaN,NaN,3.5641074131006474,28.705055126129764,66678421,-1.956257843764171,-2.7710620173322127,-0.8148041735680418
2022-08-29T09:30:00-04:00,265.66,267.3,263.87,265.71,NaN,NaN,NaN,276.5958475589005,NaN,NaN,279.9872999999997,299.69921509825036,260.2753849017491,272.26254835412544,265.6266666666667,265.6266666666667,265.6266666666667,292931,333632.36666666664,25.630044532107505,38.61455518671106,NaN,NaN,NaN,NaN,3.6138140264506005,30.682601357551015,66385490,-2.1437350433064415,-3.4944729777010934,-1.3507379343946522
2022-08-29T13:30:00-04:00,265.74,266.78,264.72,265.28,NaN,NaN,NaN,276.54126357895046,NaN,NaN,280.11809999999974,299.3451568616355,260.891043138364,272.26254835412544,265.6109888195763,265.6276261274179,265.59435151173466,260119,332537.23333333334,25.235269064521304,35.93296151110217,NaN,NaN,NaN,NaN,3.5028273102755536,32.51889428672789,66125371,-2.1639911621452077,-4.055726887076162,-1.891735724930954
2022-08-30T09:30:00-04:00,266.67,267,261,261.45,NaN,NaN,NaN,275.1189334162709,NaN,NaN,280.32429999999977,298.49601032238115,262.1525896776184,272.26254835412544,263.15000000000003,263.15000000000003,263.15000000000003,354929,332974.4,21.98680594201319,33.81620524778506,NaN,NaN,NaN,NaN,3.681196788113014,34.6228306259318,65770442,-2.290422371379622,-4.754763689155482,-2.4643413177758595
2022-08-30T13:30:00-04:00,261.4,263.39,260.66,263.03,NaN,NaN,NaN,273.01080007916767,NaN,NaN,280.5490999999997,297.5432118850214,263.5549881149781,272.26254835412544,262.7447315739211,263.13959808227094,262.3498650655713,373875,333432.63333333336,26.206960867138008,31.99600881422782,NaN,NaN,NaN,NaN,3.613254160390653,36.61028811447286,66144317,-2.126300440272225,-5.122216868116141,-2.9959164278439157
2022-08-31T09:30:00-04:00,265.45,267.1,262.18,262.99,NaN,NaN,NaN,273.01080007916767,NaN,NaN,280.52789999999976,297.60672245239755,263.449077547602,272.26254835412544,264.09,264.09,264.09,634352,337933.43333333335,26.168366445631918,31.20280962312631,NaN,NaN,NaN,NaN,3.706593148934179,36.97537659614748,65509965,-1.8872073191504404,-5.354925576781966,-3.4677182576315255
2022-08-31T13:30:00-04:00,263.01,263.92,261.345,261.45,NaN,NaN,NaN,273.01080007916767,NaN,NaN,280.38729999999975,297.9688884618123,262.8057115381872,272.26254835412544,263.2603683162734,264.1811900165726,262.3395466159742,514932,342526,24.66248715620881,30.378397858314198,NaN,NaN,NaN,NaN,3.625765066867451,37.439254373502386,64995033,-1.7050825335562019,-5.599071424576778,-3.8939888910205758
2022-09-01T09:30:00-04:00,258.98,259.79,255.43,257.46,NaN,NaN,NaN,268.9321867518005,NaN,NaN,280.01909999999975,298.7003840768647,261.3378159231348,272.26254835412544,257.56,257.56,257.56,493862,347125.1666666667,21.25041760665846,29.371604068120146,NaN,NaN,NaN,NaN,3.7967818478054887,38.62193413183569,64501171,-1.720678727574927,-6.044837300489235,-4.324158572914308
2022-09-01T13:30:00-04:00,257.41,260.87,256.09,260.39,NaN,NaN,NaN,268.9321867518005,NaN,NaN,279.69849999999974,299.15016010911603,260.24683989088345,270.32503868330036,258.25066080977416,259.02404060418235,257.477281015366,393867,351209.56666666665,29.01675510446384,29.00915853344069,NaN,NaN,NaN,NaN,3.8670117158193844,39.33158720526225,64895038,-1.4138450143652381,-6.091464840870856,-4.677619826505618
2022-09-02T09:30:00-04:00,261.54,264.72,257.44,257.65,NaN,NaN,NaN,268.9321867518005,NaN,NaN,279.2682999999997,299.67649694242016,258.8601030575793,262.3910309466403,259.93666666666667,259.93666666666667,259.93666666666667,469189,358488.23333333334,26.395191257769483,28.545038743101223,NaN,NaN,NaN,NaN,4.110796593260859,38.72341992727026,64425849,-1.2796269271422842,-6.277153485433473,-4.997526558291189
2022-09-02T13:30:00-04:00,257.64,257.96,254.48,256.13,NaN,NaN,NaN,268.0834251980113,NaN,NaN,278.77449999999976,300.1791023322198,257.3698976677797,257.4194598058498,258.08130559180717,259.9545527126336,256.20805847098075,460272,362426.1666666667,25.043479852336816,27.909407020121424,NaN,NaN,NaN,NaN,4.065739693742225,38.6033189698025,63965577,-1.1798628256180752,-6.472355090313783,-5.292492264695708
2022-09-06T09:30:00-04:00,256.24,257.77,252.29,252.57,NaN,NaN,NaN,267.1014513253744,NaN,NaN,278.2870999999997,300.9116795620736,255.66252043792588,257.4194598058498,254.20999999999995,254.20999999999995,254.20999999999995,611401,374247.9666666667,22.178728675781826,27.013716344368074,NaN,NaN,NaN,NaN,4.166758287046351,38.79262265458504,63354176,-1.234422502046188,-6.835520392253443,-5.601097890207255
2022-09-06T13:30:00-04:00,252.51,254.3,251.93,253.31,NaN,NaN,NaN,264.9609308105847,NaN,NaN,277.7932999999997,301.474475951389,254.1121240486104,256.8354034205951,253.73739682401995,254.2506487205657,253.2241449274742,518392,384199.36666666664,24.121742914660132,25.640319014927666,NaN,NaN,NaN,NaN,4.038418409400183,39.017515357683,63872568,-1.105619771356352,-6.983122604402695,-5.877502833046343
2022-09-07T09:30:00-04:00,254.66,256.62,253.27,255.42,NaN,NaN,NaN,264.9609308105847,NaN,NaN,277.3955999999997,301.88468464113345,252.906515358866,256.8354034205951,255.10333333333332,255.10333333333332,255.10333333333332,480087,390725.5,29.524913723931945,25.380935416077556,NaN,NaN,NaN,NaN,3.989245665871598,38.464691898197984,64352655,-0.7786909576513441,-6.8508665301105225,-6.072175572459178
2022-09-07T13:30:00-04:00,255.45,258.81,255.42,258.08,NaN,NaN,NaN,264.9609308105847,NaN,NaN,277.06059999999974,302.1322408430037,251.9889591569958,256.8354034205951,256.05450199678376,257.201093345834,254.9079106477335,330383,393765.9666666667,35.737505204465066,25.939904881977686,NaN,NaN,NaN,NaN,3.9464424040236277,37.28605187926402,64683038,-0.3078441927859288,-6.456980813441589,-6.149136620655661
2022-09-08T09:30:00-04:00,256.99,260.43,254.81,257.47,NaN,NaN,NaN,264.9609308105847,NaN,NaN,276.5465999999997,302.1444072842301,250.94879271576934,254.4208227364761,257.57,257.57,257.57,490033,400997,34.97605606749677,26.60747713450549,NaN,NaN,NaN,NaN,4.065982232307655,35.725546432346945,64193005,0.02054286876322653,-6.123458034701628,-6.144000903464854
2022-09-08T13:30:00-04:00,257.37,258.65,256.07,258.55,NaN,NaN,NaN,264.9609308105847,NaN,NaN,276.0681999999997,302.09579203308374,250.04060796691567,252.37802124107577,257.6372713302547,257.7268921040874,257.54765055642196,276101,401815.86666666664,37.51453900851627,27.48456784479084,NaN,NaN,NaN,NaN,3.9598406442856784,34.27650566020966,64469106,0.35022938627506406,-5.706214170621024,-6.056443556896088
2022-09-09T09:30:00-04:00,260.29,265.17,260.29,264.215,250.62430755253,250.62430755253,250.62430755253,NaN,NaN,NaN,275.6970999999997,301.860651447781,249.5335485522184,253.93355975694118,263.22499999999997,263.22499999999997,263.22499999999997,708919,417651.2,48.804524097034886,29.400119141578102,NaN,NaN,NaN,NaN,4.149852026836702,32.37299607377408,65178025,0.955253410569119,-4.862376793684689,-5.817630204253808
2022-09-09T13:30:00-04:00,264.22,265.22,264,264.43,252.88820266377863,NaN,NaN,NaN,NaN,NaN,275.3114999999997,301.5594704548881,249.06352954511127,255.62084780555296,263.7452563813692,264.3923058407866,263.09820692195177,458307,425816.9,49.179819995551235,31.041037650750475,NaN,NaN,NaN,NaN,3.9405768820626537,30.61632153527642,65636332,1.3511538072751978,-4.128687945159811,-5.479841752435009
2022-09-12T09:30:00-04:00,265.53,267.42,265.18,266.82,254.7032843608796,NaN,NaN,NaN,NaN,NaN,275.0118999999997,301.2987276435305,248.72507235646884,258.24567824444233,266.47333333333336,266.47333333333336,266.47333333333336,396693,427133.1666666667,53.27988082474691,32.977574392115834,NaN,NaN,NaN,NaN,3.8726785333438936,29.462113551565878,66033025,1.730949678583615,-3.3161546542054907,-5.047104332789106
2022-09-12T13:30:00-04:00,266.87,267.01,265.84,266.7,255.19586234447593,NaN,NaN,NaN,NaN,NaN,274.6868999999997,300.97493430385543,248.39886569614396,259.0855425955538,266.49305045215107,266.5146292309405,266.47147167336163,331198,431003.2,53.04846399324823,35.00514416619008,NaN,NaN,NaN,NaN,3.6796300666764736,28.390348995263224,65701827,1.916614497577486,-2.6513362108172487,-4.567950708394735
2022-09-13T09:30:00-04:00,258.84,260.4,254.64,256.82,NaN,NaN,NaN,269.8832677620911,269.8832677620911,269.8832677620911,274.21329999999966,300.915327609167,247.51127239083235,259.0855425955538,257.28666666666663,257.28666666666663,257.28666666666663,581622,433267.8333333333,38.298919656833434,36.22289431263115,NaN,NaN,NaN,NaN,4.278227919056726,27.77831023012572,65120205,1.3436401263241367,-2.888400550489564,-4.232040676813701
2022-09-13T13:30:00-04:00,256.82,256.96,251.59,252.03,NaN,NaN,NaN,266.8085737729051,NaN,NaN,273.6470999999997,300.9981682855474,246.2960317144519,259.0855425955538,255.23415146489774,257.1062194404636,253.3620834893319,699150,441038.56666666665,33.44394914196661,36.53912245816706,NaN,NaN,NaN,NaN,4.356211639124101,27.6723906370512,64421055,0.6469711524372919,-3.423326736267086,-4.070297888704378
2022-09-14T09:30:00-04:00,253.28,254.19,251,252.04,NaN,NaN,NaN,264.99386587413676,NaN,NaN,273.06309999999974,300.98180132295795,245.14439867704152,259.0855425955538,252.41,252.41,252.41,406487,440126.6,33.46291240331968,37.04395968284921,NaN,NaN,NaN,NaN,4.272910807758094,27.661123194437042,64827542,0.21414354498402055,-3.8026184574743525,-4.016762002458373
2022-09-14T13:30:00-04:00,252.01,252.71,249.88,252.31,NaN,NaN,NaN,263.51619015258507,NaN,NaN,272.4632999999997,300.8471776498309,244.07942235016853,259.0855425955538,252.00837821249206,252.39648411911799,251.62027230586614,435292,446479.36666666664,34.00961931805443,37.68439821611476,NaN,NaN,NaN,NaN,4.1698457500610875,27.820021631872105,65262834,-0.014519350912148177,-4.0349111910985584,-4.02039184018641
2022-09-15T09:30:00-04:00,249.79,251.4,245.22,247.7,NaN,NaN,NaN,260.94249969110393,NaN,NaN,271.6508999999997,300.4943987954069,242.8074012045925,259.0855425955538,248.10666666666665,248.10666936406497,248.10666396926834,710844,453037.36666666664,29.545784191360156,38.2106164672275,NaN,NaN,NaN,NaN,4.378428196485296,28.607779593685517,64551990,-0.4146259809742183,-4.538674316404183,-4.124048335429965
2022-09-15T13:30:00-04:00,247.665,247.78,244.02,245.33,NaN,NaN,NaN,258.4710224324174,NaN,NaN,270.7748999999997,300.0982624600003,241.45153753999915,259.0855425955538,246.98110627966702,248.1772278771839,245.78498468215014,629450,462759.36666666664,27.54422243015057,38.45507928976253,NaN,NaN,NaN,NaN,4.334254753879203,29.4888142550814,63922540,-0.757319388069206,-5.070697570516472,-4.313378182447266
2022-09-16T09:30:00-04:00,244.26,244.58,242.32,242.49,NaN,NaN,NaN,255.8600668673075,NaN,NaN,269.84989999999976,299.76010471278113,239.9396952872184,259.0855425955538,243.13000000000002,243.13000000000002,243.13000000000002,684204,470263.6666666667,25.32980262390214,38.155428496903255,NaN,NaN,NaN,NaN,4.239665128602119,30.516321036154853,63238336,-1.0743309625324517,-5.656291885612831,-4.581960923080379
2022-09-16T13:30:00-04:00,242.5,245.3,242.07,244.67,NaN,NaN,NaN,255.8600668673075,NaN,NaN,268.99609999999973,299.29293727983077,238.69926272016866,259.0855425955538,243.48657240904853,243.91996416227292,243.05318065582415,463148,474740.6,29.983043216477355,37.74439549776128,NaN,NaN,NaN,NaN,4.167546190844826,31.242907234408378,63701484,-1.035814101328647,-5.876728549741188,-4.840914448412541
2022-09-19T09:30:00-04:00,242.43,244.59,240.86,242.73,NaN,NaN,NaN,254.97249894314592,NaN,NaN,268.05829999999975,298.6449881901346,237.4716118098649,259.0855425955538,242.72666666666666,242.72667048136393,242.7266628519694,744201,488223.7,28.293296250330584,37.26705551082084,NaN,NaN,NaN,NaN,4.142007177213051,32.080811324482674,62957283,-1.0370459669576864,-6.137221907109648,-5.100175940151962
2022-09-19T13:30:00-04:00,242.72,245.14,241.75,244.52,NaN,NaN,NaN,254.97249894314592,NaN,NaN,267.1106999999997,297.61977576509935,236.60162423490007,248.03043407644304,243.08766703435913,243.59595415506874,242.57937991364952,375394,485987.8,32.095874084116176,36.88000801622083,NaN,NaN,NaN,NaN,4.0882923788406895,32.6698353816884,63332677,-0.8227234645014914,-6.128580270778826,-5.305856806277335
2022-09-20T09:30:00-04:00,241.92,243.5,240.91,241,NaN,NaN,NaN,254.2979277560482,NaN,NaN,266.0724999999997,296.53207072909333,235.61292927090608,244.37934726115446,241.8033333333333,241.8033333333333,241.8033333333333,634576,497375.9666666667,28.85532476407346,35.45506520672359,NaN,NaN,NaN,NaN,4.0541286374949275,33.34271594710674,62698101,-0.8215274415177971,-6.332766108174582,-5.5112386666567845
2022-09-20T13:30:00-04:00,241,243.1,239.65,242.45,NaN,NaN,NaN,253.38870376713695,NaN,NaN,265.05149999999975,295.18580047305795,234.91719952694157,242.5304778089236,241.77246438706285,241.8072197374371,241.7377090366886,500592,505391.73333333334,31.905276124194103,34.22116921591237,NaN,NaN,NaN,NaN,4.010976591959575,34.15595568647948,63198693,-0.634931448031633,-6.304902976696326,-5.669971528664693
2022-09-21T09:30:00-04:00,244.37,245.69,243.46,245.04,NaN,NaN,NaN,253.38870376713695,NaN,NaN,264.0968999999997,293.67734305889644,234.516456941103,241.96738224713886,244.73000000000002,244.73000000000002,244.73000000000002,432265,507969.6,37.09287949438366,33.06495483517214,NaN,NaN,NaN,NaN,3.9559068353910343,33.96416578252771,63630958,-0.2677127411870259,-6.004612455148475,-5.736899713961449
2022-09-21T13:30:00-04:00,245.04,247.64,238.92,238.92,NaN,NaN,NaN,253.38870376713695,NaN,NaN,263.0202999999997,292.26746112105104,233.77313887894834,239.2609057977111,242.60054646604723,243.88426803774811,241.31682489434635,1189446,535155.3,31.06968958829151,31.495042377675226,NaN,NaN,NaN,NaN,4.296199204291675,34.5077117235398,62441512,-0.3617751086276595,-6.189118599746024,-5.827343491118365
2022-09-22T09:30:00-04:00,238.175,241.66,237.59,240.35,NaN,NaN,NaN,252.16641534442667,NaN,NaN,261.9912999999997,290.73177284302454,233.25082715697482,236.5320754492385,239.86666666666667,239.86666666666667,239.86666666666667,825586,541529.7666666667,33.77565941121142,31.171952360130796,NaN,NaN,NaN,NaN,4.28004211827084,35.197909029244634,63267098,-0.25738069172344247,-6.149069355772667,-5.891688664049225
2022-09-22T13:30:00-04:00,240.35,243.86,239.79,240.78,NaN,NaN,NaN,252.16641534442667,NaN,NaN,260.98069999999973,289.0726236799578,232.88877632004164,236.5320754492385,240.6710436058052,241.47604336468314,239.86604384692728,824309,551842.3333333334,34.60696615334112,31.2550250038004,NaN,NaN,NaN,NaN,4.265039109822925,35.08332777304371,64091407,-0.0973009761348198,-6.013314884217749,-5.916013908082929
2022-09-23T09:30:00-04:00,239.52,241.14,237.5,237.61,NaN,NaN,NaN,251.7733350555623,NaN,NaN,259.91229999999973,287.4086378805355,232.41596211946398,236.5320754492385,238.75,238.75,238.75,933926,566511.1333333333,31.470616978224115,31.112718187722148,NaN,NaN,NaN,NaN,4.220393459121286,35.33736803130455,63157481,-0.14023225848170728,-6.091304231185063,-5.951071972703356
2022-09-23T13:30:00-04:00,237.58,238.44,235.21,238.03,NaN,NaN,NaN,249.1527289166731,NaN,NaN,258.8690999999997,285.63966605230047,232.09853394769897,236.5320754492385,238.05495604656,238.81370338604714,237.29620870707285,783687,579505.1333333333,32.34546478143773,30.99385000653524,NaN,NaN,NaN,NaN,4.149651069184051,35.904798730261014,63941168,-0.07873134180821673,-6.049486149963627,-5.9707548081554105
2022-09-26T09:30:00-04:00,237.045,241.44,236.98,237.77,NaN,NaN,NaN,249.1527289166731,NaN,NaN,257.90189999999967,284.15228155076454,231.6515184492348,236.5320754492385,238.72999999999996,238.73000381469723,238.7299961853027,761924,589262.9666666667,32.07250584475385,31.174330124634785,NaN,NaN,NaN,NaN,4.17181884995662,35.44481138485951,63179244,0.0017851076035571012,-5.968523423650964,-5.970308531254521
2022-09-26T13:30:00-04:00,237.79,239.58,236.9,237.47,NaN,NaN,NaN,249.1527289166731,NaN,NaN,256.92809999999974,282.5172533967133,231.33894660328622,236.5320754492385,238.40319216100718,238.77361510327506,238.0327692187393,593063,593689.3333333334,31.739678473560815,31.474005556306945,NaN,NaN,NaN,NaN,4.065260360674005,35.03159373306687,62586181,0.08744254404430585,-5.86100535119914,-5.948447895243445
2022-09-27T09:30:00-04:00,239.95,241.79,234.51,235.59,NaN,NaN,NaN,249.1527289166731,NaN,NaN,256.0692999999997,281.582990756937,230.5556092430624,236.5320754492385,237.29666666666665,237.29666666666665,237.29666666666665,887216,602883.1666666666,29.66231512867644,31.783470735219396,NaN,NaN,NaN,NaN,4.2948846206258615,35.05786821989735,61698965,0.07080073911931617,-5.8599469713443,-5.930747710463616
2022-09-27T13:30:00-04:00,235.51,236.98,234.7,236.45,NaN,NaN,NaN,248.1950277791967,NaN,NaN,255.2426999999997,280.5666084827093,229.91879151729012,236.5320754492385,236.80630943060834,237.41797179681686,236.19464706439982,570205,604610.2666666667,31.859372291654097,31.917494240589168,NaN,NaN,NaN,NaN,4.1509642905811575,35.082265957668504,62269170,0.16561117213978704,-5.723733745288882,-5.889344917428669
2022-09-28T09:30:00-04:00,236.8,241.05,234.75,240.61,NaN,NaN,NaN,248.1950277791967,NaN,NaN,254.51109999999971,279.36575632754983,229.6564436724496,235.9536603593908,238.80333333333337,238.80333333333337,238.80333333333337,913522,619058.1,41.39534431685349,32.85335481676937,NaN,NaN,NaN,NaN,4.304466841253933,33.76262890644,63182692,0.5355284183873863,-5.2199343944444365,-5.755462812831823
2022-09-28T13:30:00-04:00,240.63,242.32,239.62,240.98,NaN,NaN,NaN,248.1950277791967,NaN,NaN,253.80389999999971,278.1407156742129,229.46708432578652,232.71774263001012,239.41814487582613,240.3959729867046,238.44031676494765,361142,620083.4,42.17052186998579,33.57297251576006,NaN,NaN,NaN,NaN,4.189862066878651,32.16609858968515,63543834,0.8153960886928306,-4.736217701965785,-5.551613790658616
2022-09-29T09:30:00-04:00,238.86,239.92,234.45,235.53,NaN,NaN,NaN,248.1950277791967,NaN,NaN,253.00389999999967,277.0595346239441,228.94826537605525,232.71774263001012,236.63333333333333,236.63333333333333,236.63333333333333,542019,621816.2666666667,34.856833337474654,34.00165169957443,NaN,NaN,NaN,NaN,4.357014776387318,31.71774814941682,63001815,0.6508740475684771,-4.738021231198019,-5.388895278766496
2022-09-29T13:30:00-04:00,235.5,238,234.54,237.53,NaN,NaN,NaN,248.1950277791967,NaN,NaN,252.2370999999997,275.7668316678417,228.70736833215773,231.90272478976087,236.663973309313,236.69221259361916,236.63573402500685,638093,633882.6666666666,39.03536448662389,34.51094372546227,NaN,NaN,NaN,NaN,4.292942292359653,31.30142274059623,63639908,0.6903997836637572,-4.525895549186799,-5.216295332850557
2022-09-30T09:30:00-04:00,238.4,240.52,236.14,236.69,NaN,NaN,NaN,248.1950277791967,NaN,NaN,251.44869999999966,274.35952126945057,228.53787873054875,231.90272478976087,237.7833333333333,237.78333603073162,237.783330635935,757182,635491.4333333333,37.93477277313404,34.57107895965873,NaN,NaN,NaN,NaN,4.299160700048251,30.154346023868904,62882726,0.6729309830559655,-4.375131604030599,-5.048062587086565
2022-09-30T13:30:00-04:00,236.7,236.77,232.76,232.76,NaN,NaN,NaN,247.41872762327392,NaN,NaN,250.5238999999997,272.6304642097682,228.41733579023122,231.90272478976087,235.73727342861838,237.56942509129036,233.9051217659464,944309,651691.5,33.21615017967416,34.724397573328915,NaN,NaN,NaN,NaN,4.27850636433052,29.748269355262785,61938417,0.42192452737712305,-4.520656927865161,-4.942581455242284
2022-10-03T09:30:00-04:00,235.5,239.14,234.67,238.91,NaN,NaN,NaN,247.41872762327392,NaN,NaN,249.8468999999997,271.2502162748367,228.44358372516268,231.90272478976087,237.57333333333332,237.57333333333332,237.57333333333332,774596,664288.2666666667,44.789667529225824,35.51111243890137,NaN,NaN,NaN,NaN,4.428613052592625,28.695863204498284,62713013,0.6800197669887957,-4.09255674650629,-4.7725765134950855
2022-10-03T13:30:00-04:00,238.93,241.63,238.92,240.66,NaN,NaN,NaN,247.41872762327392,NaN,NaN,249.2974999999997,270.19976726938125,228.39523273061818,231.90272478976087,238.80364779635553,240.20654346332935,237.40075212938171,595740,673106.3333333334,47.57380010381358,36.43731486393512,NaN,NaN,NaN,NaN,4.306569263121723,27.068442598687458,63308753,0.9613326839265621,-3.5709106585868824,-4.5322433425134445
2022-10-04T09:30:00-04:00,245.145,250.35,244.97,247.42,234.18641702487415,234.18641702487415,234.18641702487415,NaN,NaN,NaN,248.9316999999997,269.30575031996955,228.55764968002984,236.84436848582965,247.58,247.58000269739833,247.5799973026017,1151063,692087.7,56.664662135898695,38.23688951805473,NaN,NaN,NaN,NaN,4.691100030041601,26.451686752590003,64459816,1.5599865273399631,-2.582260183338491,-4.142246710678454
2022-10-04T13:30:00-04:00,247.41,249.1,247.31,248.96,235.0997617055617,NaN,NaN,NaN,NaN,NaN,248.6052999999997,268.43695372934644,228.77364627065293,237.4004947886637,247.8546420789397,248.26126387413734,247.44802028374204,525112,686286.4333333333,58.43299543475702,40.10028456472039,NaN,NaN,NaN,NaN,4.483878599324343,25.878984895499507,64984928,1.9894773618757462,-1.6554000083337712,-3.6448773702095174
2022-10-05T09:30:00-04:00,245.85,248.88,244.11,248.22,235.0997617055617,NaN,NaN,NaN,NaN,NaN,248.3406999999997,267.82986129649066,228.85153870350877,237.4004947886637,247.07000000000002,247.07000000000002,247.07000000000002,375543,685254.9666666667,57.224623678552334,41.89686440999172,NaN,NaN,NaN,NaN,4.510030127944033,24.593324056043635,64609385,2.140386785590934,-0.9693938882208499,-3.109780673811784
2022-10-05T13:30:00-04:00,248.25,250.53,247.42,249.33,235.97867750444775,NaN,NaN,NaN,NaN,NaN,248.06669999999974,267.10201871129345,229.03138128870603,239.54731666474478,248.0277195858612,249.03794686568634,247.01749230603608,337519,681995.8666666667,58.6073665118633,43.81598498415618,NaN,NaN,NaN,NaN,4.410027975948031,23.709749440296886,64946904,2.221960160288006,-0.33233047345177624,-2.5542906337397824
2022-10-06T09:30:00-04:00,248.09,250.34,246.07,248.48,235.97867750444775,NaN,NaN,NaN,NaN,NaN,247.77649999999977,266.32922942185326,229.22377057814626,239.54731666474478,248.29666666666662,248.2966704813639,248.29666285196936,607623,678555.1666666666,57.08557694537237,45.774789399634464,NaN,NaN,NaN,NaN,4.40002597766603,22.569544730714007,64339281,2.1256519138835075,0.10277425861460188,-2.0228776552689056
2022-10-06T13:30:00-04:00,248.39,248.55,246.45,246.81,235.97867750444775,NaN,NaN,NaN,NaN,NaN,247.48369999999977,265.6214618034989,229.34593819650067,239.54731666474478,247.91255747289227,248.40935947858932,247.41575546719523,363226,669681.0333333333,54.11265526009754,47.36430961166614,NaN,NaN,NaN,NaN,4.235738407832744,21.51078321467276,63976055,1.8657242759131623,0.3092776896225473,-1.556446586290615
2022-10-07T09:30:00-04:00,240.86,241.29,234.38,234.8,NaN,NaN,NaN,251.63732087070898,251.63732087070898,251.63732087070898,247.03049999999976,265.2805634793551,228.7804365206444,239.54731666474478,236.82333333333335,236.82333333333335,236.82333333333335,930184,677880.3666666667,38.55998026113215,47.16178360768604,NaN,NaN,NaN,NaN,4.821042807273263,21.672783223087006,63045871,0.852742002539534,-0.4905190831161974,-1.3432610856557314
2022-10-07T13:30:00-04:00,234.73,235.16,233.17,234.23,NaN,NaN,NaN,247.61130628567676,NaN,NaN,246.5072999999998,264.6952077642374,228.31939223576217,239.54731666474478,235.63699509872043,236.94870393519713,234.32528626224374,760871,687804.4666666667,38.0017335260606,46.864013011691384,NaN,NaN,NaN,NaN,4.618825463896601,21.989922665744874,62285000,0.14899237999017467,-1.1570206106680132,-1.3060129906581879
2022-10-10T09:30:00-04:00,232.9,234.55,226.75,227.74,NaN,NaN,NaN,244.54874690905513,NaN,NaN,245.90909999999977,264.5534760625141,227.26472393748546,239.54731666474478,229.67999999999998,229.6800026973983,229.67999730260166,784942,689162.5,32.272724080468805,46.67943377904811,NaN,NaN,NaN,NaN,4.846052216475416,23.07030902164467,61500058,-0.7021846433220174,-2.1837437948107095,-1.481559151488692
2022-10-10T13:30:00-04:00,227.72,230.77,227.69,229.25,NaN,NaN,NaN,242.91698568591627,NaN,NaN,245.37149999999977,264.353107123751,226.38989287624855,239.54731666474478,229.50272191534174,229.71989872100417,229.2855451096793,523023,694083.4666666667,34.737933865442315,46.37247444896371,NaN,NaN,NaN,NaN,4.719905629584316,24.073524923551624,62023081,-1.0890044678427704,-2.842814736292155,-1.7538102684493846
2022-10-11T09:30:00-04:00,227.75,229.05,224.95,227.51,NaN,NaN,NaN,240.6512136092837,NaN,NaN,244.87029999999976,264.38116327255693,225.35943672744256,239.54731666474478,227.17000000000002,227.17000000000002,227.17000000000002,593459,692712.9,33.236644424487054,46.036893852631785,NaN,NaN,NaN,NaN,4.689912370328295,25.313430679439573,61429622,-1.369421807806373,-3.465587528207351,-2.096165720400978
2022-10-11T13:30:00-04:00,227.68,228.49,224.11,225.43,NaN,NaN,NaN,239.92797662704353,NaN,NaN,244.31269999999978,264.41160178194787,224.2137982180517,239.54731666474478,226.68346554567918,227.25588513983755,226.11104595152082,428735,690317.6666666666,31.484935188718552,45.91323563899209,NaN,NaN,NaN,NaN,4.667775772447702,26.557483711767738,61000887,-1.587025007872112,-4.079946980241118,-2.492921972369006
2022-10-12T09:30:00-04:00,225.31,226.85,223.98,226.49,NaN,NaN,NaN,238.81488678035973,NaN,NaN,243.73409999999978,264.1832775570652,223.28492244293437,239.54731666474478,225.7733333333333,225.7733333333333,225.7733333333333,506041,692776.8666666667,33.4110157695538,45.100474799015515,NaN,NaN,NaN,NaN,4.539363217272866,27.727729761002664,61506928,-1.5498457872397222,-4.430229206418659,-2.8803834191789366
2022-10-12T13:30:00-04:00,226.53,227.85,225.63,225.69,NaN,NaN,NaN,238.81488678035973,NaN,NaN,243.0862999999998,263.7278372305547,222.44476276944488,239.41885333179582,226.07237565188123,226.38056897025356,225.7641823335089,476436,669009.8666666667,32.66467775485938,44.03553748837594,NaN,NaN,NaN,NaN,4.37369441603909,28.51233560880353,61030492,-1.470091320100963,-4.71799756930514,-3.2479062492041773
2022-10-13T09:30:00-04:00,219.93,235.06,219.17,234.69,NaN,NaN,NaN,238.81488678035973,NaN,NaN,242.6306999999998,262.9858304599207,222.2755695400789,238.76308266543666,229.64000000000001,229.64000000000001,229.64000000000001,1458932,690121.4,47.00653528694707,43.345671284879394,NaN,NaN,NaN,NaN,5.1962876720362985,27.39010713766042,62489424,-0.7390686333264855,-4.171742040862284,-3.4326734075357987
2022-10-13T13:30:00-04:00,234.72,236.11,233.67,234.31,NaN,NaN,NaN,238.81488678035973,NaN,NaN,242.14589999999978,262.1122718977798,222.1795281022198,227.2454661323493,231.28435801891817,233.65312501631288,228.91559102152345,703045,686079.2666666667,46.555655591132535,42.49728986747764,NaN,NaN,NaN,NaN,4.999409981176565,26.11871116965269,61786379,-0.2350902605409968,-3.7265362332120446,-3.491445972671048
2022-10-14T09:30:00-04:00,235.65,237.2,229.02,230.21,NaN,NaN,NaN,238.81488678035973,NaN,NaN,241.4657999999998,260.6814057786476,222.25019422135196,222.92937290587943,232.14333333333337,232.14333333333337,232.14333333333337,665704,677138.5333333333,41.88724372910484,41.40176272823139,NaN,NaN,NaN,NaN,5.226594982521094,25.7099618056151,61120675,-0.13670413541476334,-3.662326141939502,-3.525622006524739
2022-10-14T13:30:00-04:00,230.05,230.69,228.35,228.52,NaN,NaN,NaN,238.81488678035973,NaN,NaN,240.7475999999998,259.14312665623976,222.35207334375986,222.21379423426487,230.81732085100745,232.2877860164493,229.3468556855656,541336,669060.1666666666,40.10218588356676,40.0799641119245,NaN,NaN,NaN,NaN,5.020409626626731,25.43393950095616,60579339,-0.1435807905706521,-3.705097994738054,-3.561517204167402
2022-10-17T09:30:00-04:00,235.82,238.92,235.16,236.51,221.83634870822758,221.83634870822758,221.83634870822758,NaN,NaN,NaN,240.14139999999978,256.9931199169828,223.28968008301675,223.05154264794362,236.8633333333333,236.86333714803055,236.86332951863602,583284,663105.5,50.78150568741808,39.629673307784905,NaN,NaN,NaN,NaN,5.404666081867677,23.746218966892314,61162623,0.4020086039180688,-3.059006449269816,-3.461015053187885
2022-10-17T13:30:00-04:00,236.51,238,236.42,237.54,222.48196922148995,NaN,NaN,NaN,NaN,NaN,239.55819999999983,254.61584321002195,224.5005567899777,224.5152341183549,237.06846632904265,237.29561794240698,236.84131471567832,475685,659192.9,51.97032912285468,39.476650012267555,NaN,NaN,NaN,NaN,5.131475647448558,22.179049899547316,61638308,0.8201851185779838,-2.4357836549654053,-3.255968773543389
2022-10-18T09:30:00-04:00,243.4,243.93,235.38,238.11,224.4305160750586,NaN,NaN,NaN,NaN,NaN,239.1839999999998,253.4143450415077,224.9536549584919,228.8671872946839,239.14000000000001,239.14000000000001,239.14000000000001,569304,648595.8333333334,52.65190445485591,40.48321602610497,NaN,NaN,NaN,NaN,5.3756559583450905,21.702739977998537,62207612,1.1053547115087117,-1.8742753841574995,-2.979630095666211
2022-10-18T13:30:00-04:00,238.18,239.28,236.24,238.58,224.4305160750586,NaN,NaN,NaN,NaN,NaN,238.91499999999982,252.66421394117975,225.1657860588199,228.8671872946839,238.6838558537722,239.2285870165423,238.1391246910021,399194,642895.4666666667,53.2411224688605,41.57174380773353,NaN,NaN,NaN,NaN,5.208823389891869,21.260452193703244,62606806,1.2833079880304483,-1.375495110628151,-2.6588030986585993
2022-10-19T09:30:00-04:00,237.11,239.62,234.28,235.17,224.4305160750586,NaN,NaN,NaN,NaN,NaN,238.5775999999998,251.8413204795791,225.31387952042047,228.8671872946839,236.35666666666665,236.35666666666665,236.35666666666665,670500,634794.7333333333,48.52306792939591,42.732482654085466,NaN,NaN,NaN,NaN,5.218193147756736,20.430751505465,61936306,1.1341940956393648,-1.241060479109393,-2.375254574748758
2022-10-19T13:30:00-04:00,235.08,236.64,234.52,236.54,224.4305160750586,NaN,NaN,NaN,NaN,NaN,238.26219999999984,250.94187715047582,225.58252284952385,228.8671872946839,236.19724697433168,236.41493257606237,235.97956137260098,359603,634743.4333333333,50.42387990981685,43.85290737154079,NaN,NaN,NaN,NaN,4.996893637202682,19.660315152100914,62295909,1.090361010036502,-1.0123033122031302,-2.102664322239632
2022-10-20T09:30:00-04:00,235.99,241.3,235.87,237.17,224.4305160750586,NaN,NaN,NaN,NaN,NaN,238.0515999999998,250.44379390424368,225.65940609575594,229.08023191590254,238.11333333333334,238.11333333333334,238.11333333333334,501253,633384.5666666667,51.31417444788889,45.1441595160695,NaN,NaN,NaN,NaN,5.027829805973918,19.737654591223404,62797162,1.0651034727540711,-0.7712849812970433,-1.8363884540511144
2022-10-20T13:30:00-04:00,237.08,237.08,234.87,236.04,224.4305160750586,NaN,NaN,NaN,NaN,NaN,237.86579999999984,250.09339573425268,225.638204265747,229.08023191590254,237.14832450853967,238.202535104465,236.09411391261435,420015,626115.3,49.59384535172471,46.437653099141365,NaN,NaN,NaN,NaN,4.832984819832923,19.57141102998942,62377147,0.9380660965493548,-0.663805833364421,-1.6018719299137758
2022-10-21T09:30:00-04:00,234.73,240.25,234.5,239.91,224.4305160750586,NaN,NaN,NaN,NaN,NaN,237.8141999999998,249.98494728356403,225.64345271643558,229.08023191590254,238.22,238.22,238.22,478025,616810.0666666667,55.14066703804182,47.98977104689051,NaN,NaN,NaN,NaN,4.898485904130571,19.925064631310377,62855172,1.0708448749943205,-0.2633158361708752,-1.3341607111651956
2022-10-21T13:30:00-04:00,239.89,242.9,239.86,242.07,227.1635111561783,NaN,NaN,NaN,NaN,NaN,237.76219999999984,249.83717663104423,225.68722336895544,232.08747874094212,239.7696236466942,241.45837783718105,238.08086945620738,402504,598749.9,57.92374387561027,49.79399005551558,NaN,NaN,NaN,NaN,4.765736910978387,20.64135471407149,63257676,1.2479420255177494,0.22576682073199095,-1.0221752047857584
2022-10-24T09:30:00-04:00,244.01,246.7,241.32,245.19,229.70607883089747,NaN,NaN,NaN,NaN,NaN,237.81139999999985,249.98657277742942,225.63622722257028,235.3599829927537,244.40333333333334,244.40333333333334,244.40333333333334,483810,589057.0333333333,61.626999342858795,50.83830891665213,NaN,NaN,NaN,NaN,4.809612845908502,21.8068084930501,63741486,1.5019539927569023,0.8552672861603696,-0.6466867065965327
2022-10-24T13:30:00-04:00,245.07,247.84,244.91,247.28,232.32171161131123,NaN,NaN,NaN,NaN,NaN,237.86659999999986,250.18709389270848,225.54610610729125,237.30298639420295,245.23238817468342,246.32663955166842,244.13813679769842,277720,578456.3666666667,63.9179421960794,52.078472245576904,NaN,NaN,NaN,NaN,4.6753547854864665,23.029942634184323,64019206,1.7217034992725697,1.5054426674941794,-0.21626083177839028
2022-10-25T09:30:00-04:00,247.305,249.99,245.83,249.01,233.92822471988802,NaN,NaN,NaN,NaN,NaN,238.02679999999987,250.70909029159387,225.34450970840587,239.48038911536236,248.27666666666667,248.27666666666667,248.27666666666667,891042,569789,65.74118828431887,53.782325428092186,NaN,NaN,NaN,NaN,4.63854372938029,24.426409580545357,64910248,1.8815598574165093,2.1356889899922464,0.2541291325757371
2022-10-25T13:30:00-04:00,249,251.04,248.51,251,236.08375995989306,NaN,NaN,NaN,NaN,NaN,238.19779999999983,251.3363943175186,225.05920568248106,241.36731129228988,249.07708263823142,250.01807186500363,248.1360934114592,644704,573775.4,67.75932146383923,55.757835112397366,NaN,NaN,NaN,NaN,4.487933462995984,25.848117781139322,65554952,2.007800553117253,2.763879823972303,0.7560792708550503
2022-10-26T09:30:00-04:00,231.13,238.27,230.17,233.44,NaN,NaN,NaN,250.12936549282932,250.12936549282932,250.12936549282932,237.9657999999998,251.02233251979192,224.9092674802077,241.36731129228988,233.96,233.96,233.96,1983389,627370.2666666667,43.44100485108564,55.233513624087905,NaN,NaN,NaN,NaN,5.655223929924843,24.591754938597465,63571563,0.8541423457385262,1.823757203028208,0.9696148572896819
2022-10-26T13:30:00-04:00,233.46,235.76,230.14,231.15,NaN,NaN,NaN,248.90257615224618,NaN,NaN,237.81039999999982,251.00206461673227,224.61873538326736,241.36731129228988,233.51773573990215,234.23637875489914,232.79909272490517,751182,641159.0333333333,41.356495515559054,54.475382652138215,NaN,NaN,NaN,NaN,5.652707934930212,23.429335726073766,62820381,-0.06870606545303204,0.8837322754733918,0.9524383409264239
2022-10-27T09:30:00-04:00,231.09,233.68,225.8,226.73,NaN,NaN,NaN,246.04200450896226,NaN,NaN,237.53799999999984,251.06683084380424,224.00916915619544,241.36731129228988,228.73666666666668,228.73666666666668,228.73666666666668,1052622,655992.3333333334,37.60565491154466,53.400650541901705,NaN,NaN,NaN,NaN,5.811800225292339,22.94493777469557,61767759,-0.9342851581845736,-0.21541810680429307,0.7188670513802805
2022-10-27T13:30:00-04:00,226.725,227.98,226.1,226.94,NaN,NaN,NaN,242.85736794037305,NaN,NaN,237.26119999999983,251.07667517243954,223.44572482756013,241.36731129228988,228.0950473186183,228.93070639044063,227.25938824679596,620539,664569.4333333333,37.893859657126846,52.30441748392072,NaN,NaN,NaN,NaN,5.530957352057172,22.495139676987243,62388298,-1.4209886569160812,-1.057368769764821,0.3636198871512602
2022-10-28T09:30:00-04:00,226.225,235.19,226.06,233.47,NaN,NaN,NaN,242.85736794037305,NaN,NaN,237.17839999999987,251.03408669392445,223.3227133060753,241.36731129228988,231.57333333333332,231.5733371480306,231.57332951863606,1174518,672713.9,46.21355308182735,52.13945213766583,NaN,NaN,NaN,NaN,5.78803182691023,20.94046997168058,63562816,-1.238140115812258,-1.1840552576140624,0.054084858198195696
2022-10-28T13:30:00-04:00,233.47,236.6,233.46,235.77,NaN,NaN,NaN,242.85736794037305,NaN,NaN,237.13319999999985,250.99222417344873,223.27417582655096,241.36731129228988,233.19103955179352,235.02786615034074,231.3542129532463,911009,677718.5,48.81442922678925,52.024491374592436,NaN,NaN,NaN,NaN,5.598886696416641,19.71255033655818,64473825,-0.9123412963605468,-1.0863417622524878,-0.17400046589194101
2022-10-31T09:30:00-04:00,233.78,234.91,231.16,233.57,NaN,NaN,NaN,242.85736794037305,NaN,NaN,237.04919999999984,250.94263720755438,223.1557627924453,241.36731129228988,233.21333333333337,233.21333333333337,233.21333333333337,608790,671846.7666666667,46.49829679104952,51.68050011338961,NaN,NaN,NaN,NaN,5.5282519323868815,18.4126120220502,63865035,-0.7991230011375552,-1.172904217313885,-0.37378121617632987
2022-10-31T13:30:00-04:00,233.555,233.85,231.54,232.25,NaN,NaN,NaN,242.85736794037305,NaN,NaN,236.94479999999984,250.90232198064814,222.98727801935155,241.36731129228988,232.87711019995203,233.21043100660978,232.54378939329428,619438,675060.6,45.1151338112745,51.36059214621461,NaN,NaN,NaN,NaN,5.298376794359248,17.20552644429279,63245597,-0.7671002431268757,-1.3326565200849245,-0.5655562769580488
2022-11-01T09:30:00-04:00,234.67,235.74,227.325,228,NaN,NaN,NaN,242.85736794037305,NaN,NaN,236.79299999999984,250.9695356840182,222.61646431598146,241.36731129228988,230.35500000000002,230.35500000000002,230.35500000000002,639515,676595.8,40.89693755443689,50.34318289738568,NaN,NaN,NaN,NaN,5.520992737619303,16.7693101059581,62606082,-0.9728853390751848,-1.7816629508020299,-0.808777611726845
2022-11-01T13:30:00-04:00,227.95,229.07,227.39,228.17,NaN,NaN,NaN,242.85736794037305,NaN,NaN,236.62739999999988,251.00806580378622,222.24673419621354,221.65971949140604,229.46205107200558,230.51941461523094,228.40468752878022,456095,677507.8,41.13402771374649,49.143917457252556,NaN,NaN,NaN,NaN,5.246636113503639,16.364252077504453,63062177,-1.0326447194515773,-2.099583511041317,-1.0669387915897395
2022-11-02T09:30:00-04:00,229.28,229.34,224.5,225.54,NaN,NaN,NaN,242.3423654751089,NaN,NaN,236.32599999999988,250.98907362049854,221.66292637950122,221.65971949140604,226.46,226.46,226.46,551405,679019.9333333333,38.55711568439108,47.49606862450486,NaN,NaN,NaN,NaN,5.217590676824807,16.444264839517306,62510772,-1.1740811773199955,-2.534540263239734,-1.3604590859197383
2022-11-02T13:30:00-04:00,225.55,231.21,220.1,220.1,NaN,NaN,NaN,241.89134886260393,NaN,NaN,235.9083999999999,251.19362285608412,220.62317714391565,221.65971949140604,224.62084735247694,225.84703374641643,223.39466095853746,1240490,704488.4,33.835422197092456,45.3473171960058,NaN,NaN,NaN,NaN,5.638477057051608,17.13958596140254,61270282,-1.535948579010657,-3.2803948096830595,-1.7444462306724025
2022-11-03T09:30:00-04:00,220.11,220.41,215.91,216.89,NaN,NaN,NaN,234.2719693688492,NaN,NaN,235.5355999999999,251.72221875006906,219.34898124993074,221.65971949140604,217.73666666666668,217.73666666666668,217.73666666666668,1012818,689617.9333333333,31.39249824677762,42.893839336181415,NaN,NaN,NaN,NaN,5.557157267262207,18.299448408263267,60257464,-1.8711940108624896,-4.083438744250515,-2.212244733388025
2022-11-03T13:30:00-04:00,216.88,216.99,213.98,214.25,NaN,NaN,NaN,231.27506167026516,NaN,NaN,235.06999999999988,252.30564399725608,217.83435600274368,221.65971949140604,216.72742444756773,218.01946879150597,215.43538010362948,617970,686782.1,29.505690266866367,40.16143710782621,NaN,NaN,NaN,NaN,5.375217462457765,19.596041285378902,59639494,-2.131538290237672,-4.876667596185115,-2.745129305947443
2022-11-04T09:30:00-04:00,217.55,219.97,213.47,216.82,NaN,NaN,NaN,231.27506167026516,NaN,NaN,234.6725999999999,252.6412049809131,216.7039950190867,221.65971949140604,216.75333333333333,216.75333333333333,216.75333333333333,835737,692449.8666666667,33.68430228273516,39.464529781515466,NaN,NaN,NaN,NaN,5.4555590722822105,20.105498136423687,60475231,-1.9939400655742254,-5.237554387915225,-3.2436143223409992
2022-11-04T13:30:00-04:00,216.83,221.58,216.36,221.53,NaN,NaN,NaN,231.27506167026516,NaN,NaN,234.44799999999992,252.7836095071867,216.11239049281315,221.4838763795999,218.06676835026423,219.5856936144854,216.54784308604306,624905,695235.5,40.63002325227041,39.41263890556627,NaN,NaN,NaN,NaN,5.438733424262053,20.218208319329154,61100136,-1.473017921802139,-5.084886724593673,-3.611868802791534
2022-11-07T09:30:00-05:00,222.06,226.51,221.3,225.57,NaN,NaN,NaN,231.27506167026516,NaN,NaN,234.1811999999999,252.63716386646038,215.72523613353943,221.4838763795999,224.46,224.46,224.46,542843,693887.4666666667,45.867303256504236,40.00275664449196,NaN,NaN,NaN,NaN,5.422395322529048,19.314250144108414,61642979,-0.7785439002638102,-4.5850486781212965,-3.8065047778574863
2022-11-07T13:30:00-05:00,225.62,228.4,225.26,227.96,NaN,NaN,NaN,231.27506167026516,NaN,NaN,233.9271999999999,252.36907671144255,215.48532328855728,221.4838763795999,225.8561225814594,227.22926681810088,224.48297834481792,561163,696736.7333333333,48.74770742362763,40.778031484956294,NaN,NaN,NaN,NaN,5.259367085205546,18.123597017377953,62204142,-0.11522108604034198,-3.950531135407914,-3.835310049367572
2022-11-08T09:30:00-05:00,228.7,231.62,227.59,228.66,214.13128010738998,214.13128010738998,214.13128010738998,NaN,NaN,NaN,233.5519999999999,251.64052498132693,215.46347501867288,219.7168385273462,229.29,229.29,229.29,537576,695679.1333333333,49.593693980053345,41.01947012054387,NaN,NaN,NaN,NaN,5.1715551505480075,17.20753884521131,62741718,0.3862150372368043,-3.352541252821567,-3.738756290058371
2022-11-08T13:30:00-05:00,228.65,230.5,225.85,228.83,214.13128010738998,NaN,NaN,NaN,NaN,NaN,233.1493999999999,250.73739745736,215.5614025426398,219.7168385273462,228.83717806987255,229.2854889333166,228.3888672064285,548449,700654.3,49.81036447313624,41.0906083524258,NaN,NaN,NaN,NaN,5.134301211223151,16.032770530223537,63290167,0.725193984712583,-2.8322638091676424,-3.5574577938802254
2022-11-09T09:30:00-05:00,227.37,228.555,225.3,226.28,214.13128010738998,NaN,NaN,NaN,NaN,NaN,232.7105999999999,249.86206426868742,215.5591357313124,219.7168385273462,226.71166666666667,226.71166666666667,226.71166666666667,438943,692935.7333333333,46.57625018357899,41.096176451892184,NaN,NaN,NaN,NaN,5.019708267564354,14.937289595940156,62851224,0.7693411757848767,-2.5957813241491294,-3.365122499934006
2022-11-09T13:30:00-05:00,226.21,226.21,224.33,224.52,214.13128010738998,NaN,NaN,NaN,NaN,NaN,232.21439999999993,248.84143781676178,215.58736218323807,219.7168385273462,225.74851120187378,226.58616837831744,224.91085402543013,580321,700293,44.43193772837064,41.047376731684764,NaN,NaN,NaN,NaN,4.800443391309757,14.109632479495996,62270903,0.6750417353326297,-2.5213203307682193,-3.196362066100849
2022-11-10T09:30:00-05:00,235.74,240.73,235,239.5,221.56423806248426,NaN,NaN,NaN,NaN,NaN,232.03479999999993,248.14101556542755,215.92858443457231,224.649465060801,238.41,238.41,238.41,1110317,720595.1333333333,60.9224648623974,42.47777153939624,NaN,NaN,NaN,NaN,5.615411720501916,15.085370404850126,63381220,1.5656790965346339,-1.2392631954325566,-2.8049422919671905
2022-11-10T13:30:00-05:00,239.55,243.32,238.66,243.03,224.79472724146225,NaN,NaN,NaN,NaN,NaN,231.9591999999999,247.8209259287915,216.0974740712083,228.1255720486408,239.69366091104263,241.28644125856655,238.1008805635187,721167,730633.5333333333,63.65930886502556,44.08672019305902,NaN,NaN,NaN,NaN,5.54716802618035,16.273521204289356,64102387,2.292686331356569,0.06091562222852076,-2.2317707091280483
2022-11-11T09:30:00-05:00,242.82,247.61,242.37,247.29,228.8163305486685,NaN,NaN,NaN,NaN,NaN,232.20899999999995,248.62551034781754,215.79248965218235,232.83445763891265,245.75666666666663,245.7566704813639,245.75666285196937,822209,742106.3333333334,66.69112220655978,46.09629208749971,NaN,NaN,NaN,NaN,5.525227452881755,17.810233299440746,64924596,2.920383851108902,1.4187091047580793,-1.5016747463508229
2022-11-11T13:30:00-05:00,247.29,247.98,245.95,247.18,231.24967916009263,NaN,NaN,NaN,NaN,NaN,232.46799999999996,249.40426877443727,215.53173122556265,235.1445661111301,246.3183611245151,246.95355262482082,245.68316962420937,642944,750121,66.53676080932479,48.432101988373454,NaN,NaN,NaN,NaN,5.275568349104487,19.273559862804817,64281652,3.1673916877853516,2.457564863380867,-0.7098268244044849
2022-11-14T09:30:00-05:00,241.985,243.46,239.23,243.41,231.24967916009263,NaN,NaN,NaN,NaN,NaN,232.78139999999996,249.9346560221089,215.62814397789103,235.1445661111301,242.0333333333333,242.03333603073162,242.033330635935,607025,754228.1666666666,61.29998043888141,50.56835071638086,NaN,NaN,NaN,NaN,5.46659918131131,19.268911283425048,63674627,2.922050271408316,2.9427360148559103,0.020685743447594218
2022-11-14T13:30:00-05:00,243.27,243.89,241.38,241.6,231.24967916009263,NaN,NaN,NaN,NaN,NaN,233.02839999999998,250.3262007203203,215.73059927967967,235.1445661111301,242.14067350539085,242.2672781325478,242.0140688782339,436347,759515.7333333333,58.90301305553055,52.66815948699974,NaN,NaN,NaN,NaN,5.255413525503359,19.318965594127675,63238280,2.499397761505514,3.1449329453294865,0.6455351838239727
2022-11-15T09:30:00-05:00,246.14,246.99,241.77,242.26,231.24967916009263,NaN,NaN,NaN,NaN,NaN,233.32339999999996,250.73739970598317,215.90940029401676,235.1445661111301,243.67333333333332,243.67333333333332,243.67333333333332,561158,748519.6,59.52451697631188,54.51388910796951,NaN,NaN,NaN,NaN,5.265026845110263,19.75509306265165,63799438,2.1396992327916626,3.320159224813551,1.1804599920218886
2022-11-15T13:30:00-05:00,242.19,243.32,240.03,242.01,231.24967916009263,NaN,NaN,NaN,NaN,NaN,233.65499999999997,251.08657055459875,216.2234294454012,235.1445661111301,242.81685773901555,243.75618383306144,241.87753164496965,466533,742580.5666666667,59.15956174362998,55.837427571638045,NaN,NaN,NaN,NaN,5.123953499030959,19.805550115182804,63332905,1.7753641496723553,3.3996651791123327,1.6243010294399773
2022-11-16T09:30:00-05:00,242.695,243.79,240.47,243.22,231.24967916009263,NaN,NaN,NaN,NaN,NaN,233.9896,251.50028197872157,216.47891802127842,235.1445661111301,242.49333333333334,242.49333333333334,242.49333333333334,504492,693284,60.424304824846956,56.87721339794824,NaN,NaN,NaN,NaN,4.995099677671604,19.91705713471736,63837397,1.5163493863263962,3.5197377623479724,2.0033883760215763
2022-11-16T13:30:00-05:00,243.23,243.3,241.62,241.73,231.24967916009263,NaN,NaN,NaN,NaN,NaN,234.31039999999996,251.78880860490395,216.83199139509597,235.1445661111301,242.38818983424372,242.52248259664043,242.253897071847,309253,678553.0333333333,58.04072169038557,57.541000131288094,NaN,NaN,NaN,NaN,4.758306843552204,20.020599367142307,63528144,1.1611615816318586,3.4548403530613996,2.293678771429541
2022-11-17T09:30:00-05:00,237.89,243.13,237.63,242.69,231.24967916009263,NaN,NaN,NaN,NaN,NaN,234.4704,252.10554262374654,216.83525737625348,235.1445661111301,241.15000000000003,241.15000000000003,241.15000000000003,379124,656103.1,59.158585920819775,58.224206698485695,NaN,NaN,NaN,NaN,4.811284926155618,19.24329215650411,63907268,0.9180206636734507,3.4412046010213544,2.5231839373479037
2022-11-17T13:30:00-05:00,242.66,243.25,240.23,241.71,231.24967916009263,NaN,NaN,NaN,NaN,NaN,234.6184,252.36949928313956,216.86730071686046,235.1445661111301,241.423311575647,241.7128309989971,241.1337921522969,337864,646680.6,57.475209879391045,58.77169565607532,NaN,NaN,NaN,NaN,4.6833360028587885,18.542617433439855,63569404,0.6319557897077672,3.3131286744826127,2.6811728847748455
2022-11-18T09:30:00-05:00,243.26,243.71,239.07,240.24,231.24967916009263,NaN,NaN,NaN,NaN,NaN,234.819,252.59297074375655,217.04502925624342,235.1445661111301,241.00666666666666,241.00666666666666,241.00666666666666,383902,620326.7333333333,54.949391120894425,59.36977715159786,NaN,NaN,NaN,NaN,4.680240574083162,17.635973656980465,63185502,0.3012719947381073,3.0577628781974795,2.756490883459372
2022-11-18T13:30:00-05:00,240.25,242.055,239.08,241.28,231.24967916009263,NaN,NaN,NaN,NaN,NaN,235.0742,252.84549419709958,217.3029058029004,234.1752578488986,240.9097799609501,241.01053602901882,240.80902389288136,354982,601792.5,56.408943552642576,60.22527756761728,NaN,NaN,NaN,NaN,4.558437675934364,16.794090150268175,63540484,0.11945259182194157,2.905806623236799,2.7863540314148576
2022-11-21T09:30:00-05:00,241.265,244.66,241.25,242.46,231.24967916009263,NaN,NaN,NaN,NaN,NaN,235.1932,253.08066306886198,217.305736931138,235.17533128546665,242.79,242.79,242.79,452269,596575.1333333333,58.06887040068529,60.021449391780706,NaN,NaN,NaN,NaN,4.476406413367624,16.54091759448982,63992753,0.04913199572048521,2.847769026065464,2.798637030344979
2022-11-21T13:30:00-05:00,242.5,243.13,242.03,242.09,231.24967916009263,NaN,NaN,NaN,NaN,NaN,235.28419999999997,253.26454708897282,217.30385291102712,235.17533128546665,242.61553069401617,242.80179842830537,242.42926295972697,396789,589153.5,57.331661645726435,59.569474590402194,NaN,NaN,NaN,NaN,4.235234526698507,16.305828792695635,63595964,-0.04664634718743743,2.740329096360682,2.7869754435481195
2022-11-22T09:30:00-05:00,243.425,243.9,240.71,243.64,231.24967916009263,NaN,NaN,NaN,NaN,NaN,235.3948,253.51083410903928,217.27876589096073,235.79481202269866,242.75,242.75,242.75,457742,583094.4,59.64308614196585,59.066043442931196,NaN,NaN,NaN,NaN,4.1605749176486135,15.730384606234512,64053706,-0.030724022602968137,2.7485704152944095,2.7792944378973776
2022-11-22T13:30:00-05:00,243.65,245.27,243.56,245.07,231.374482672279,NaN,NaN,NaN,NaN,NaN,235.5246,253.82215227782794,217.22704772217205,237.93084961815893,243.57409298243243,244.50839086848498,242.63979509637988,356125,579762.0666666667,61.704254794736656,58.72086444188919,NaN,NaN,NaN,NaN,3.985533852102285,15.504241892591564,64409831,0.04678734840332455,2.837778623401533,2.7909912749982086
2022-11-23T09:30:00-05:00,245,247.73,244.31,246.32,233.105869823539,NaN,NaN,NaN,NaN,NaN,235.74759999999998,254.29253723256898,217.20266276743098,240.14867969452715,246.11999999999998,246.11999999999998,246.11999999999998,298618,571335.8333333334,63.46100818411257,58.87522356654856,NaN,NaN,NaN,NaN,3.945138576952121,15.814858636901022,64708449,0.14724444906079004,2.9750468363241964,2.8278023872634064
2022-11-23T13:30:00-05:00,246.33,248.28,246.13,247.76,234.58469392246903,NaN,NaN,NaN,NaN,NaN,235.972,254.81893248249864,217.12506751750138,241.13994375562172,246.6581581070076,247.28573013296398,246.03058608105124,219588,537305.7666666667,65.42851168620011,59.341330611596376,NaN,NaN,NaN,NaN,3.8169143928841125,16.215928071554817,64928037,0.2686071175584379,3.163561284211454,2.894954166653016
2022-11-25T09:30:00-05:00,247.39,248.69,246.74,247.58,235.40243510781139,NaN,NaN,NaN,NaN,NaN,236.18019999999996,255.3034400978482,217.0569599021517,242.00295500449738,247.67,247.67,247.67,475254,519386.9666666667,64.95766011625221,59.72941226444925,NaN,NaN,NaN,NaN,3.683563364820961,16.675618761653542,64452783,0.2927141340060806,3.260846834160617,2.9681327001545363
2022-11-25T13:30:00-05:00,247.5,247.5,247.5,247.5,235.40243510781139,NaN,NaN,NaN,NaN,NaN,236.40939999999998,255.79335312004028,217.02544687995967,242.1103640035979,247.6699910578839,247.67122397252524,247.66875814324254,25,498788.8,64.73468510915094,60.127635361986464,NaN,NaN,NaN,NaN,3.426165981619465,17.102474402459507,64452758,0.26031407392709216,3.2935252925634018,3.0332112186363096
2022-11-28T09:30:00-05:00,246.2,246.64,241.98,242.44,235.40243510781139,NaN,NaN,NaN,NaN,NaN,236.45999999999995,255.8933865293722,217.0266134706277,242.1103640035979,245.2723648509052,247.22221410866882,243.3225155931416,718637,494885.4666666667,52.46712271817768,59.55926521151009,NaN,NaN,NaN,NaN,3.5757255543609325,15.974480692388562,63734121,-0.12421033654946934,2.877948297949473,3.0021586344989424
2022-11-28T13:30:00-05:00,242.43,242.55,240.82,241.71,235.40243510781139,NaN,NaN,NaN,NaN,NaN,236.4528,255.8781323431005,217.0274676568995,242.1103640035979,244.34532108045755,246.64219860301463,242.04844355790047,417352,487967.0333333333,50.96652834272841,59.05396568667743,NaN,NaN,NaN,NaN,3.4438880147637243,15.225534105276624,63316769,-0.4326684782666592,2.4613230366656182,2.8939915149322775
2022-11-29T09:30:00-05:00,241.46,242.75,238.25,239.15,235.40243510781139,NaN,NaN,NaN,NaN,NaN,236.33199999999997,255.6130804676479,217.05091953235203,242.1103640035979,240.04999999999998,240.04999999999998,240.04999999999998,415598,483725.5333333333,45.99811324627606,58.11393192421002,NaN,NaN,NaN,NaN,3.519324585137744,15.14950065299305,62901171,-0.7930800566867644,1.9026414440738222,2.6957215007605866
2022-11-29T13:30:00-05:00,239.09,240.89,239.05,240.3,235.40243510781139,NaN,NaN,NaN,NaN,NaN,236.1924,255.25422092455705,217.13057907544294,242.1103640035979,240.06313176041786,240.07801496202785,240.04824855880787,323539,475804.73333333334,48.430155954472475,57.467856643858696,NaN,NaN,NaN,NaN,3.399372829056475,15.078898161586874,63224710,-0.928590549597927,1.5349833137631776,2.4635738633611046
2022-11-30T09:30:00-05:00,240.55,243.91,239.9,242.05,235.40243510781139,NaN,NaN,NaN,NaN,NaN,236.05319999999995,254.83822486130785,217.26817513869204,242.1103640035979,241.95333333333332,241.95333800536423,241.9533286613024,457279,473128.1666666667,51.9746761656847,57.25537700420086,NaN,NaN,NaN,NaN,3.4429890555524407,14.106996210387557,63681989,-0.8756266712235963,1.3690405243316093,2.2446671955552056
2022-11-30T13:30:00-05:00,242.05,255.25,241.57,255.15,235.56916856354502,NaN,NaN,NaN,NaN,NaN,236.1362,255.21896914496057,217.05343085503944,242.39363846135916,248.10809205606986,252.06863012748528,244.14755398465445,1104320,491657.2,69.09744408425583,58.16169847074466,NaN,NaN,NaN,NaN,4.174204123012982,15.241722020033718,64786309,0.019019052329363628,2.26844101096691,2.2494219586375466
2022-12-01T09:30:00-05:00,253.87,256.09,250.93,253.94,240.54920635611114,NaN,NaN,NaN,NaN,NaN,236.5462,256.2504163569088,216.8419836430912,243.22491076908733,253.65333333333334,253.65333333333334,253.65333333333334,732208,501432.7,66.7308220626407,58.78040930374147,NaN,NaN,NaN,NaN,4.244618114226338,16.416104376487432,64054101,0.4810417256944741,2.8507241157556393,2.369682390061165
2022-12-01T13:30:00-05:00,253.93,256.11,253.79,254.71,242.26196970356065,NaN,NaN,NaN,NaN,NaN,237.0174,257.3011964138825,216.73360358611748,244.6579286152699,254.0809508444337,254.6618219454815,253.50007974338587,396813,495315.76666666666,67.49381919053926,59.506277699799526,NaN,NaN,NaN,NaN,4.107145391781601,17.5096207842271,64450914,0.7729472434703948,3.3358664443991586,2.562919200928764
2022-12-02T09:30:00-05:00,250.04,253.94,249.8,253.19,242.26196970356065,NaN,NaN,NaN,NaN,NaN,237.54660000000004,258.10797100875754,216.98522899124254,244.6579286152699,252.31000000000003,252.31000000000003,252.31000000000003,400585,471658.0333333333,64.3561411723222,59.84292448768212,NaN,NaN,NaN,NaN,4.164492149511487,17.421281658063435,64050329,0.7950203009857066,3.556694577160897,2.7616742761751905
2022-12-02T13:30:00-05:00,253.28,256.06,252.98,255.02,242.26196970356065,NaN,NaN,NaN,NaN,NaN,238.10820000000004,259.0111657953078,217.20523420469223,245.22667431377272,253.32910639764248,254.50532846653033,252.15288432875462,300715,457642.9666666667,66.38243670887766,60.177080338692186,NaN,NaN,NaN,NaN,4.087028424546381,17.71543565438965,64351044,0.858787655491331,3.835158845539354,2.976371190048023
2022-12-05T09:30:00-05:00,252.01,253.8,249.04,249.54,242.26196970356065,NaN,NaN,NaN,NaN,NaN,238.4296,259.5306577782233,217.32854222177667,245.22667431377272,250.79333333333332,250.79333333333332,250.79333333333332,412427,443983.56666666665,56.098018145697196,59.65115247880537,NaN,NaN,NaN,NaN,4.222240679935926,17.017850076935922,63938617,0.47688092421509864,3.5724723453168963,3.0955914211017976
2022-12-05T13:30:00-05:00,249.53,250.49,248.06,250.19,242.26196970356065,NaN,NaN,NaN,NaN,NaN,238.718,260.0585863087208,217.37741369127917,245.22667431377272,250.31649268331927,250.90910524635484,249.7238801202837,267025,431452.93333333335,56.94997469550761,59.04554269375591,NaN,NaN,NaN,NaN,4.094223488511932,16.14585993265999,64205642,0.2257698631499836,3.377803750039277,3.1520338868892934
2022-12-06T09:30:00-05:00,250.84,251.78,244.79,244.83,242.26196970356065,NaN,NaN,NaN,NaN,NaN,238.9432,260.29937323023836,217.58702676976162,245.22667431377272,247.13333333333333,247.13333333333333,247.13333333333333,427601,425472.13333333336,48.578309785013076,57.8755890986674,NaN,NaN,NaN,NaN,4.301064667903938,15.357321211885708,63778041,-0.31425608372845293,2.759213782228727,3.07346986595718
2022-12-06T13:30:00-05:00,244.78,245.94,243.78,245.12,242.26196970356065,NaN,NaN,NaN,NaN,NaN,239.20059999999998,260.5381122861115,217.8630877138884,245.22667431377272,246.17786446153303,247.26247091921232,245.09325800385375,331839,421988.5333333333,49.01500514018821,56.752754815170064,NaN,NaN,NaN,NaN,4.148131477339371,14.831910212701132,64109880,-0.6457731775851934,2.2662533939756884,2.9120265715608817
2022-12-07T09:30:00-05:00,244.66,246.14,242.2,245.62,NaN,NaN,NaN,256.8230219757413,256.8230219757413,256.8230219757413,239.55299999999997,260.7202650099148,218.38573499008515,245.22667431377272,244.65333333333334,244.65333333333334,244.65333333333334,560339,421961.23333333334,49.80647900136895,56.562708835398006,NaN,NaN,NaN,NaN,4.133264943243701,14.665286018295575,64670219,-0.8143487308897837,1.8940906579486523,2.708439388838436
2022-12-07T13:30:00-05:00,245.62,245.63,243.83,244.29,NaN,NaN,NaN,256.8230219757413,NaN,NaN,239.87539999999998,260.8293175182089,218.9214824817911,245.22667431377272,244.63178341177004,244.66409587662054,244.59947094691955,249231,414717.8333333333,47.6859184942668,56.328379560507884,NaN,NaN,NaN,NaN,3.9666031615834356,14.510563552061843,64420988,-0.9868889335191686,1.4748282219394753,2.461717155458644
2022-12-08T09:30:00-05:00,244.84,248.03,243.09,248.03,NaN,NaN,NaN,256.8230219757413,NaN,NaN,240.32519999999997,260.9924901910218,219.65790980897816,245.22667431377272,246.38333333333333,246.38333333333333,246.38333333333333,429767,412227,53.66066238863576,56.87570449924787,NaN,NaN,NaN,NaN,4.036131507184619,13.72970672785176,64850755,-0.8270643839442076,1.4278866755283843,2.254951059472592
2022-12-08T13:30:00-05:00,248.13,248.71,246.09,247.4,NaN,NaN,NaN,256.8230219757413,NaN,NaN,240.8712,260.80167782266864,220.94072217733134,245.22667431377272,246.85477283542056,247.36176556022858,246.34778011061255,371605,414305.4,52.57147038535009,57.17151267288198,NaN,NaN,NaN,NaN,3.9349792566714323,12.82984752103519,64479150,-0.7442964575033013,1.3245804875934653,2.0688769450967666
2022-12-09T09:30:00-05:00,245.12,248.31,244.22,246.87,NaN,NaN,NaN,256.8230219757413,NaN,NaN,241.47079999999997,260.2499607224579,222.69163927754207,245.22667431377272,246.46666666666667,246.46666666666667,246.46666666666667,433835,416129.1,51.62216781527756,57.14633350499576,NaN,NaN,NaN,NaN,3.9460521669091873,12.456030814003762,64045315,-0.7060867925154,1.1862684544525166,1.8923552469679166
2022-12-09T13:30:00-05:00,246.86,247.5,245.2,245.33,NaN,NaN,NaN,256.8230219757413,NaN,NaN,242.09239999999997,259.2103744409177,224.97442555908222,242.14333945101816,246.2776011596348,246.50253259128988,246.05266972797972,306513,415084.06666666665,48.86127911582987,55.70089315010819,NaN,NaN,NaN,NaN,3.82847701212996,12.108915300331722,63738802,-0.7606549221754619,0.9415365942485892,1.702191516424051
2022-12-12T09:30:00-05:00,247.445,252.16,247.2,250.25,NaN,NaN,NaN,256.8230219757413,NaN,NaN,242.761,258.428326638577,227.09367336142301,241.79487726931873,249.87,249.87000269739832,249.8699973026017,574970,421453,56.80888220604179,54.99218316035113,NaN,NaN,NaN,NaN,4.042871511263533,11.922921033923618,64313772,-0.4565180298955056,1.131543979054669,1.5880620089501747
2022-12-12T13:30:00-05:00,250.31,252.53,249.78,252.52,NaN,NaN,NaN,256.8230219757413,NaN,NaN,243.3808,258.0602800125843,228.70131998741564,242.862901815455,250.63742616608016,251.5013582285675,249.7734941035928,453690,424743.26666666666,59.90502971009564,54.45012676889087,NaN,NaN,NaN,NaN,3.9505235461732804,11.836882041705255,64767462,-0.11157144977294142,1.448597696733998,1.5601691465069394
2022-12-13T09:30:00-05:00,261.69,263.91,253.07,255.48,245.30348200556895,245.30348200556895,245.30348200556895,NaN,NaN,NaN,243.97899999999998,258.13488372373456,229.82311627626538,250.481321452364,257.4866666666667,257.4866666666667,257.4866666666667,1224934,450498.76666666666,63.57204351823609,54.39411979359901,NaN,NaN,NaN,NaN,4.481914721446619,13.718220804967027,65992396,0.28515966428393313,1.9166187268618557,1.6314590625779226
2022-12-13T13:30:00-05:00,255.49,257.89,254.6,256.95,245.30348200556895,NaN,NaN,NaN,NaN,NaN,244.55880000000002,258.4143205690661,230.70327943093392,250.481321452364,257.1866306866348,257.6470811515026,256.72618022176704,520108,454609.4,65.27078735389195,54.31471626824288,NaN,NaN,NaN,NaN,4.396777955629003,15.465178227995816,66512504,0.5978127647666569,2.378725018536244,1.780912253769587
2022-12-14T09:30:00-05:00,257.16,262.55,257.16,261.11,246.6481313315205,NaN,NaN,NaN,NaN,NaN,245.2078,259.06363908104737,231.3519609189526,250.481321452364,260.27333333333337,260.27333333333337,260.27333333333337,505581,456204.0333333333,69.59231348375859,55.278594506675844,NaN,NaN,NaN,NaN,4.4827223873697895,17.650128612518614,67018085,1.0116845824943868,3.0455179818875706,2.033833399393184
2022-12-14T13:30:00-05:00,261.08,262.04,254.47,257.23,246.6481313315205,NaN,NaN,NaN,NaN,NaN,245.7758,259.2219093792894,232.32969062071058,250.481321452364,258.84409053182065,259.9974673245022,257.6907137391391,776355,470211.7,61.86054207530878,55.62934931951879,NaN,NaN,NaN,NaN,4.703242216843377,18.913185208874967,66241730,0.9519026357825431,3.223711694121363,2.2718090583388197
2022-12-15T09:30:00-05:00,253.57,254.18,247.35,247.77,246.6481313315205,NaN,NaN,NaN,NaN,NaN,246.2056,258.4518318514662,233.95936814853383,250.481321452364,249.76666666666665,249.76666666666665,249.76666666666665,531282,477967.1666666667,47.890164238582315,55.580196066202305,NaN,NaN,NaN,NaN,5.073010629925995,18.413328996788675,65710448,0.24010541139027541,2.5719408225766642,2.331835411186389
2022-12-15T13:30:00-05:00,247.75,250.16,247.5,249.12,246.6481313315205,NaN,NaN,NaN,NaN,NaN,246.69760000000002,257.2834498458933,236.11175015410674,250.481321452364,249.32978526627406,249.74944586523813,248.91012466731,575779,489840.2,49.63809371682064,55.62470239310462,NaN,NaN,NaN,NaN,4.900652727788424,17.9491767998514,66286227,-0.15372707365721627,2.1396765691148687,2.293403642772085
2022-12-16T09:30:00-05:00,248.55,249.79,243.55,243.77,NaN,NaN,NaN,260.9569719260748,260.9569719260748,260.9569719260748,246.78300000000002,257.2028021094365,236.36319789056353,250.481321452364,245.70333333333335,245.70333333333335,245.70333333333335,558144,492603.2,43.421985366819875,55.16866713349397,NaN,NaN,NaN,NaN,4.9963203900892506,16.717341353491662,65728083,-0.7548480429222715,1.3498435891192457,2.104691632041517
2022-12-16T13:30:00-05:00,243.76,247.5,243.6,243.85,NaN,NaN,NaN,259.71938229307136,NaN,NaN,246.79940000000005,257.1980825396192,236.40071746038092,250.481321452364,245.23834724963245,245.58269870126767,244.89399579799723,1017706,526525.9,43.535852175129655,54.87223382498418,NaN,NaN,NaN,NaN,4.918011790797161,15.573494153300476,66745789,-1.1061312978256144,0.7220275097594993,1.8281588075851136
2022-12-19T09:30:00-05:00,244.86,245.1,239.08,240.3,NaN,NaN,NaN,256.4362285524772,NaN,NaN,246.65960000000004,257.2149087761455,236.10429122385457,250.481321452364,241.49333333333334,241.49333333333334,241.49333333333334,499159,519209.9666666667,39.71606869202929,53.876191418083714,NaN,NaN,NaN,NaN,4.996725234311648,15.254962730037263,66246630,-1.5115432875208186,-0.061270301815909534,1.450272985704909
2022-12-19T13:30:00-05:00,240.27,240.91,238.71,240.4,NaN,NaN,NaN,253.80412725463734,NaN,NaN,246.52400000000006,257.2223146336101,235.82568536639005,250.481321452364,240.78968844074763,241.53196148491838,240.04741539657687,448558,520250.1666666667,39.87609640433107,52.969378990868066,NaN,NaN,NaN,NaN,4.796959146146529,15.024191392983719,66695188,-1.6932501672838236,-0.6662897233998706,1.026960443883953
2022-12-20T09:30:00-05:00,239.97,242.49,238.5,242.11,NaN,NaN,NaN,253.80412725463734,NaN,NaN,246.49800000000008,257.23271676383075,235.7632832361694,249.83964572951297,241.03333333333333,241.03333603073165,241.03333063593502,497116,522967.43333333335,42.6782618609698,52.33052856556038,NaN,NaN,NaN,NaN,4.739319207136063,14.450070173371563,67192304,-1.618611944748979,-0.9963044870522708,0.6223074576967083
2022-12-20T13:30:00-05:00,242.19,242.9,241.35,241.88,NaN,NaN,NaN,253.80412725463734,NaN,NaN,246.5036000000001,257.22837786062183,235.77882213937835,249.83964572951297,241.38806895003628,241.8701950902848,240.90594280978777,269120,521153.4666666667,42.39207631040013,51.86844265088682,NaN,NaN,NaN,NaN,4.5115106923406305,13.822114322675322,66923184,-1.507331361055482,-1.2618567436226442,0.24547461743283772
2022-12-21T09:30:00-05:00,241.69,245.58,240.11,244.68,NaN,NaN,NaN,253.80412725463734,NaN,NaN,246.55200000000008,257.22143672363586,235.8825632763643,248.08671658361035,243.4566666666667,243.4566666666667,243.4566666666667,539970,523909.8333333333,47.04733362241284,51.17118918062761,NaN,NaN,NaN,NaN,4.5799742143163,13.037005577192387,67463154,-1.1821145329067497,-1.2321685487005993,-0.050054015793849715
2022-12-21T13:30:00-05:00,244.66,245.61,243.66,244.46,NaN,NaN,NaN,253.80412725463734,NaN,NaN,246.60100000000006,257.2088749992515,235.9931250007486,238.07737326688826,243.94800221624848,244.503776624849,243.39222780764797,422016,501166.36666666664,46.72782223415809,50.22996007520349,NaN,NaN,NaN,NaN,4.392118913293708,12.314692138889898,67041138,-0.9298900814858352,-1.2124166176511437,-0.28252653616530854
2022-12-22T09:30:00-05:00,241.1,241.94,234.4,234.56,NaN,NaN,NaN,252.20075266235378,NaN,NaN,246.42780000000002,257.52245549892456,235.33314450107548,235.9478986135106,236.9666666666667,236.9666666666667,236.9666666666667,398990,490059.1,35.157077940895334,48.200319676822005,NaN,NaN,NaN,NaN,4.796967562344158,13.01539015349583,66642148,-1.352273438387054,-1.9728683341491262,-0.6205948957620722
2022-12-22T13:30:00-05:00,234.47,238.62,233.88,238.24,NaN,NaN,NaN,250.28935481406498,NaN,NaN,246.35800000000003,257.6127568609812,235.10324313901884,235.9427960282497,236.9327673993895,236.95843451078127,236.9071002879977,695967,500030.9,41.004959475999456,46.467046256972544,NaN,NaN,NaN,NaN,4.792898450748148,13.746720415758789,67338115,-1.305619887348606,-2.2526197549478297,-0.9469998675992237
2022-12-23T09:30:00-05:00,236.43,238.83,233.98,237.99,NaN,NaN,NaN,250.28935481406498,NaN,NaN,246.26400000000004,257.7164994651723,234.81150053482776,235.9427960282497,236.9333333333333,236.9333333333333,236.9333333333333,443276,501453.93333333335,40.736181807516765,44.405893994383845,NaN,NaN,NaN,NaN,4.7969771328375685,14.370624519998762,66894839,-1.2152563923856694,-2.4660703580813106,-1.2508139656956412
2022-12-23T13:30:00-05:00,237.95,238.86,237.18,238.69,NaN,NaN,NaN,250.28935481406498,NaN,NaN,246.20360000000005,257.7826878811662,234.6245121188339,235.9427960282497,237.37012213405274,237.98770522359638,236.7525390445091,221731,498821.13333333336,41.88483515879113,42.97905778606116,NaN,NaN,NaN,NaN,4.574335909063457,14.941534893535735,67116570,-1.0388367593316166,-2.549359914860162,-1.5105231555285452
2022-12-27T09:30:00-05:00,238.7,238.93,235.85,237.22,NaN,NaN,NaN,250.28935481406498,NaN,NaN,246.14320000000004,257.8765681029704,234.40983189702968,235.9427960282497,237.33333333333334,237.33333333333334,237.33333333333334,238801,493033.6,40.125984232134364,42.424473499886304,NaN,NaN,NaN,NaN,4.467597629844639,15.715539063957767,66877769,-0.9538436261655765,-2.702827688235516,-1.7489840620699393
2022-12-27T13:30:00-05:00,237.21,237.71,235.99,236.97,NaN,NaN,NaN,249.9249796530043,NaN,NaN,246.05700000000004,257.9935805823838,234.12041941761626,235.9427960282497,237.1157005268626,237.33733048667904,236.89407056704619,230265,491808.26666666666,39.819732945679796,41.72316201623339,NaN,NaN,NaN,NaN,4.271340656284307,16.434257222206796,66647504,-0.8505787799644489,-2.8122075370255004,-1.9616287570610516
2022-12-28T09:30:00-05:00,236.92,239.72,235.28,236.86,NaN,NaN,NaN,249.9249796530043,NaN,NaN,245.945,258.11724268571226,233.77275731428773,235.9427960282497,237.28666666666666,237.28666666666666,237.28666666666666,323371,488333.93333333335,39.676243443217935,41.45560902169039,NaN,NaN,NaN,NaN,4.283387752264,16.45870416650239,66324133,-0.7304017778613328,-2.8746309793877174,-2.1442292015263846
2022-12-28T13:30:00-05:00,236.8,236.81,234.17,234.5,NaN,NaN,NaN,248.34811162598118,NaN,NaN,245.79319999999998,258.33758037688136,233.24881962311864,235.9427960282497,236.42325304775375,237.46762361683375,235.37888247867375,221019,484639.93333333335,36.62677289408969,40.96210335875897,NaN,NaN,NaN,NaN,4.169574341388001,16.72407688683925,66103114,-0.7478494513079919,-3.0790410156613746,-2.3311915643533827
2022-12-29T09:30:00-05:00,235.7,241.135,235.7,240.52,NaN,NaN,NaN,248.34811162598118,NaN,NaN,245.73080000000002,258.3482297477677,233.11337025223236,235.9427960282497,239.11833333333334,239.11833333333334,239.11833333333334,386648,478850.23333333334,47.67457388501048,41.53056801540048,NaN,NaN,NaN,NaN,4.345676174146001,15.715144522439427,66489762,-0.3141464463173005,-2.7238746222500083,-2.409728175932708
2022-12-29T13:30:00-05:00,240.57,241.92,240.41,240.96,NaN,NaN,NaN,248.34811162598118,NaN,NaN,245.64860000000002,258.3355388017696,232.96166119823042,232.81717316639924,239.98551235715667,240.96712822369602,239.0038964906173,301752,480600.93333333335,48.382853721727685,42.13819353807167,NaN,NaN,NaN,NaN,4.143127875992715,14.610658897252263,66791514,0.024207074688884056,-2.3794693325716025,-2.4036764072604866
2022-12-30T09:30:00-05:00,238.2,239.36,236.69,237.88,NaN,NaN,NaN,248.34811162598118,NaN,NaN,245.47979999999998,258.3497833659532,232.60981663404675,232.81717316639924,237.9766666666667,237.9766666666667,237.9766666666667,257102,474845.43333333335,43.90295139838798,42.22567136217297,NaN,NaN,NaN,NaN,4.152190170564665,14.438489765831223,66534412,0.060366986228264974,-2.3282176744751553,-2.3885846607034202
2022-12-30T13:30:00-05:00,237.915,239.93,237.03,239.79,NaN,NaN,NaN,248.34811162598118,NaN,NaN,245.3204,258.27064321624323,232.37015678375676,232.81717316639924,238.52163524243383,238.98561769106743,238.05765279380023,354687,474281.5,47.1697833207035,42.566936148623206,NaN,NaN,NaN,NaN,4.062748015524332,14.11765110233135,66889099,0.22353478938015714,-2.109166173978224,-2.332700963358381
2023-01-03T09:30:00-05:00,243.35,245.73,237.4,238.43,NaN,NaN,NaN,248.34811162598118,NaN,NaN,245.13739999999999,258.2127427855592,232.06205721444076,234.37795266119642,240.52,240.52,240.52,636539,481038.3,45.153425048515444,42.43165696477339,NaN,NaN,NaN,NaN,4.367551728701164,13.815441025714769,66252560,0.2485619108945718,-2.0219985747401665,-2.2705604856347383
2023-01-03T13:30:00-05:00,238.45,240.36,237.92,239.61,NaN,NaN,NaN,248.34811162598118,NaN,NaN,244.9796,258.1273225160797,231.83187748392035,234.37795266119642,240.1036943283124,240.68332368639176,239.52406497023304,328359,481766.5,47.25997580164416,42.46966793387954,NaN,NaN,NaN,NaN,4.229869462365369,13.534817383142231,66580919,0.3472235095462728,-1.8365310987018972,-2.18375460824817
2023-01-04T09:30:00-05:00,232,232.84,226,228.85,NaN,NaN,NaN,243.58783763784365,NaN,NaN,244.7078,258.5953577636898,230.8202422363102,234.37795266119642,229.23000000000005,229.23000000000005,229.23000000000005,1268287,504877.06666666665,34.31672867228515,42.409642986121675,NaN,NaN,NaN,NaN,4.899878786482129,14.22192308111408,65312632,-0.27590853069841215,-2.5286402716211853,-2.252731740922773
2023-01-04T13:30:00-05:00,228.86,229.4,225.96,229.03,NaN,NaN,NaN,241.67293592703257,NaN,NaN,244.4542,258.9990113580011,229.90938864199887,234.37795266119642,228.82202304964895,229.3533698792733,228.2906762200246,747709,514677.7,34.63921545688726,41.95494698475652,NaN,NaN,NaN,NaN,4.795601730304834,14.865907744723577,66060341,-0.6199871355930751,-3.027715660414117,-2.407728524821042
2023-01-05T09:30:00-05:00,227.21,227.51,221.77,222.73,NaN,NaN,NaN,238.9868933848947,NaN,NaN,244.12579999999997,259.83008786796404,228.42151213203593,234.37795266119642,224.00333333333333,224.00333333333333,224.00333333333333,762875,499275.73333333334,29.229953646655375,41.13307354469499,NaN,NaN,NaN,NaN,4.971630178140202,16.062027015440712,65297466,-1.1832486697881879,-3.886789362056277,-2.703540692268089
2023-01-05T13:30:00-05:00,222.8,224.68,221.84,222.27,NaN,NaN,NaN,237.3420345946722,NaN,NaN,243.7652,260.5921922398458,226.93820776015414,234.37795266119642,223.4941997630159,224.03015968663118,222.95823983940062,688418,504886.06666666665,28.875385504748976,40.20382714083484,NaN,NaN,NaN,NaN,4.819370879701617,17.172709195392336,64609048,-1.4789706976615915,-4.552254064345078,-3.0732833666834867
2023-01-06T09:30:00-05:00,223.06,223.64,219.37,222.87,NaN,NaN,NaN,235.52921484036895,NaN,NaN,243.3816,261.1931824608551,225.57001753914486,234.37795266119642,221.96,221.96,221.96,1085048,524201.63333333336,30.066989393552177,39.48532750950754,NaN,NaN,NaN,NaN,4.780130102580072,18.543092896276594,65694096,-1.520484311683774,-4.973888756288204,-3.45340444460443
2023-01-06T13:30:00-05:00,222.88,225.76,222.88,224.87,NaN,NaN,NaN,235.52921484036895,NaN,NaN,242.77599999999998,261.0001650563162,224.5518349436838,234.37795266119642,223.070755707484,224.33220082097057,221.80931059399745,841297,526366.3666666667,34.03427748465481,39.07208069086289,NaN,NaN,NaN,NaN,4.645120809538637,19.228422247818912,66535393,-1.3076785838409366,-5.088002674405601,-3.7803240905646645
2023-01-09T09:30:00-05:00,226.5,231.22,226.41,230.56,NaN,NaN,NaN,235.52921484036895,NaN,NaN,242.3084,260.56252977273306,224.05427022726695,234.37795266119642,229.39666666666668,229.39666666666668,229.39666666666668,622869,529419.2666666667,43.80211523701272,39.36678581899109,NaN,NaN,NaN,NaN,4.766897894571591,18.553645658832245,67158262,-0.7081584039039037,-4.665522095444544,-3.9573636915406403
2023-01-09T13:30:00-05:00,230.575,230.575,226.78,227.16,NaN,NaN,NaN,235.52921484036895,NaN,NaN,241.7574,260.1436121427938,223.37118785720617,234.37795266119642,228.87446733850553,229.48027427034995,228.2686604066611,462808,525653.5666666667,39.99146762052037,39.60712115659328,NaN,NaN,NaN,NaN,4.697476616387904,17.927067397630346,66695454,-0.4761694636449043,-4.55257552109677,-4.076406057451866
2023-01-10T09:30:00-05:00,227.72,231.26,227.45,228.56,NaN,NaN,NaN,235.52921484036895,NaN,NaN,241.2648,259.71905533148924,222.81054466851074,230.05836212895713,229.09,229.09,229.09,369162,519354.1666666667,42.22047484918586,39.21754265403439,NaN,NaN,NaN,NaN,4.654799715217338,17.18513630621718,67064616,-0.17929315489306852,-4.300522501068201,-4.121229346175133
2023-01-10T13:30:00-05:00,228.54,229.1,227.49,228.88,NaN,NaN,NaN,235.52921484036895,NaN,NaN,240.74200000000002,259.08867490309245,222.3953250969076,219.74371355746987,228.8369410067525,229.13324581920756,228.54063619429746,269267,494406.2,42.74398632405387,38.8147664113434,NaN,NaN,NaN,NaN,4.437314021273242,16.4962002927621,67333883,0.07417612112744099,-4.028509194765832,-4.102685315893273
2023-01-11T09:30:00-05:00,231.58,234.5,231.11,234.02,NaN,NaN,NaN,235.52921484036895,NaN,NaN,240.4316,258.6973473364706,222.1658526635294,223.67557667678074,233.21,233.21,233.21,378641,490388.93333333335,50.501801892683524,39.286112875221654,NaN,NaN,NaN,NaN,4.5217915911822955,15.98768520366288,67712524,0.594583508895588,-3.3594559297737874,-3.9540394386693754
2023-01-11T13:30:00-05:00,233.99,235.95,233.72,235.82,221.57273161336315,221.57273161336315,221.57273161336315,NaN,NaN,NaN,240.1442,258.2381318402541,222.05026815974597,226.17546134142458,234.20980104556796,235.18619368087369,233.23340841026223,397014,488670.8,52.90814847491144,39.69599610052222,NaN,NaN,NaN,NaN,4.358092191812131,15.7971384784347,68109538,1.0405157452176974,-2.653394757147254,-3.693910502364951
2023-01-12T09:30:00-05:00,235.28,239.7,233.64,238.43,223.18419835821027,NaN,NaN,NaN,NaN,NaN,240.01620000000003,258.06622421715184,221.9661757828482,228.85036907313966,237.25666666666666,237.25666666666666,237.25666666666666,438029,486701.23333333334,56.230837599934006,40.487239854194975,NaN,NaN,NaN,NaN,4.479657035254122,16.28940104732448,68547567,1.465712656575028,-1.861769681646166,-3.327482338221194
2023-01-12T13:30:00-05:00,238.41,239.9,237.46,238.55,225.47446206920074,NaN,NaN,NaN,NaN,NaN,239.88480000000004,257.879865652554,221.88973434744614,230.00029525851176,237.77842282365168,238.44759694844365,237.10924869885972,266293,486607,56.383215859206665,41.138899858306594,NaN,NaN,NaN,NaN,4.333967247021684,16.780572183335117,68813860,1.6933769047230323,-1.2107612073174039,-2.904138112040436
2023-01-13T09:30:00-05:00,237.17,237.47,234.93,236.71,225.47446206920074,NaN,NaN,NaN,NaN,NaN,239.70660000000004,257.64734451520195,221.76585548479812,230.00029525851176,236.37,236.37,236.37,343845,480069.5,53.31807462326517,42.49613885480517,NaN,NaN,NaN,NaN,4.282969586520136,16.554559295197937,68470015,1.6563548007463345,-0.8336946111075179,-2.4900494118538523
2023-01-13T13:30:00-05:00,236.72,239.37,236.62,239.17,225.47446206920074,NaN,NaN,NaN,NaN,NaN,239.60420000000005,257.4975172284991,221.710882771501,230.21118896544752,237.42505676018993,238.4323069934961,236.41780652688377,377259,478577.6,56.706698174233196,44.07238762032988,NaN,NaN,NaN,NaN,4.173471758911555,16.70876818657282,68847274,1.726013965730163,-0.3325319546911487,-2.0585459204213117
2023-01-17T09:30:00-05:00,237.81,240.91,237.1,239.495,226.19232468283883,NaN,NaN,NaN,NaN,NaN,239.43350000000007,257.1641422049424,221.70285779505775,231.677951172358,239.16833333333332,239.16833333333332,239.16833333333332,610809,485638.23333333334,57.1492518083147,46.06662320330553,NaN,NaN,NaN,NaN,4.147509490417873,17.136357438606222,69458083,1.718702587588736,0.08983231406460845,-1.6288702735241276
2023-01-17T13:30:00-05:00,239.5,240.79,239.15,240.36,227.5160826518007,NaN,NaN,NaN,NaN,NaN,239.29270000000005,256.8792811583644,221.7061188416357,232.5843609378864,239.629596705931,240.09540762238092,239.16378578948107,598941,482404.0333333333,58.36902535501681,48.17331176403895,NaN,NaN,NaN,NaN,3.9684016696737383,17.533404601208673,70057024,1.6940751063138908,0.4887236093682361,-1.2053514969456547
2023-01-18T09:30:00-05:00,241.565,242.36,236.28,236.78,227.5160826518007,NaN,NaN,NaN,NaN,NaN,239.09090000000003,256.5562027102244,221.62559728977567,232.75548875030913,238.47333333333336,238.47333333333336,238.47333333333336,742627,492382.4,51.79729837706944,49.72547669143304,NaN,NaN,NaN,NaN,4.119230121839901,17.063098381460744,69314397,1.3723545848141285,0.5100917340720059,-0.8622628507421226
2023-01-18T13:30:00-05:00,236.78,237.95,235.52,235.83,227.5160826518007,NaN,NaN,NaN,NaN,NaN,238.90090000000004,256.29713426951207,221.504665730488,232.75548875030913,237.70102635422285,238.6904949830291,236.71155772541658,452425,500072.2,50.18265733395437,50.87893239495444,NaN,NaN,NaN,NaN,3.9985708274227636,16.41577791241698,68861972,1.0459996048479037,0.4452366553177569,-0.6007629495301468
2023-01-19T09:30:00-05:00,234.02,235.45,230.69,232.27,227.5160826518007,NaN,NaN,NaN,NaN,NaN,238.5413,255.72632427230872,221.3562757276913,232.75548875030913,232.8033333333333,232.8033333333333,232.8033333333333,732463,516527.6,44.57511653020544,50.93414677303963,NaN,NaN,NaN,NaN,4.080101482606853,15.858937766422546,68129509,0.5648997561775759,0.10536174569182322,-0.4595380104857527
2023-01-19T13:30:00-05:00,232.36,234.39,231.59,231.89,227.5160826518007,NaN,NaN,NaN,NaN,NaN,238.12870000000004,254.9379523105513,221.31944768944877,232.75548875030913,232.7377520723986,232.82437611736486,232.65112802743232,419825,522846.26666666666,44.00980670881859,51.22117099363236,NaN,NaN,NaN,NaN,3.988665662420648,15.341871916570565,67709684,0.21368152088530917,-0.19243610937911626,-0.40611763026442543
2023-01-20T09:30:00-05:00,234.855,238.84,234.51,238.005,227.5160826518007,NaN,NaN,NaN,NaN,NaN,237.77920000000003,253.84089908321567,221.7175009167844,232.75548875030913,237.11833333333334,237.11833603073165,237.11833063593502,678525,534684.7333333333,54.09818673311502,52.069578985341586,NaN,NaN,NaN,NaN,4.200189543676317,14.725950649656067,68388209,0.37629070797436825,0.06424575470353489,-0.31204495327083337
2023-01-20T13:30:00-05:00,238.03,240.71,238.03,240.17,227.5160826518007,NaN,NaN,NaN,NaN,NaN,237.4436,252.56257404455187,222.32462595544814,232.75548875030913,238.32264020622466,239.5806112303254,237.06466918212394,621869,548046.4,57.04891825189695,53.09135983733038,NaN,NaN,NaN,NaN,4.093390290556582,14.55425824677801,69010078,0.5994953119154888,0.43732418662352757,-0.16217112529196118
2023-01-23T09:30:00-05:00,241.1,245.16,239.69,244.13,229.66718405814314,NaN,NaN,NaN,NaN,NaN,237.104,250.77480173215366,223.43319826784636,234.43363180296103,242.99333333333334,242.99333333333334,242.99333333333334,732639,559579.4333333333,61.876351518655994,53.90382766775698,NaN,NaN,NaN,NaN,4.191719555516825,15.230298519807617,69742717,0.96216553051588,1.040535787852889,0.07837025733700884
2023-01-23T13:30:00-05:00,244.12,244.52,241.645,242.58,230.51253932822752,NaN,NaN,NaN,NaN,NaN,236.81100000000004,249.3226697526658,224.29933024733427,234.50140544236882,242.95946594047038,242.99827245395772,242.92065942698304,558013,568121.4666666667,59.077465433467275,54.34449316479669,NaN,NaN,NaN,NaN,4.097668158694195,15.858050201906536,69184704,1.0394100248381428,1.3776327883846875,0.33822276354654457
2023-01-24T09:30:00-05:00,242.71,243.94,240.9,241.86,230.51253932822752,NaN,NaN,NaN,NaN,NaN,236.69279999999998,248.8959722367529,224.48962776324706,234.50140544236882,242.23333333333338,242.23333333333338,242.23333333333338,618907,580181.6333333333,57.770240913994336,54.45445054437243,NaN,NaN,NaN,NaN,4.022120433073181,16.217302506948343,68565797,0.984305556036232,1.5686047085918347,0.5842991525556026
2023-01-24T13:30:00-05:00,241.85,242.85,240.47,242.07,230.51253932822752,NaN,NaN,NaN,NaN,NaN,236.55180000000001,248.33298020572607,224.77061979427395,234.50140544236882,242.0328008601121,242.25040732559467,241.81519439462954,525595,585878.5666666667,58.06172201830229,54.57434384145068,NaN,NaN,NaN,NaN,3.904826116425096,16.417475308451337,69091392,0.9062429843676787,1.717102883015201,0.8108598986475224
2023-01-25T09:30:00-05:00,234.475,241.08,230.9,241.025,230.51253932822752,NaN,NaN,NaN,NaN,NaN,236.49689999999998,248.1680918654377,224.82570813456226,234.50140544236882,237.66833333333332,237.66833333333332,237.66833333333332,1661529,620044.9,55.99067855932449,54.76524412259777,NaN,NaN,NaN,NaN,4.423767108109017,16.18375021234508,67429863,0.735726208427149,1.7305176591814586,0.9947914507543096
2023-01-25T13:30:00-05:00,241.05,243.3,239.6,240.59,230.51253932822752,NaN,NaN,NaN,NaN,NaN,236.4317,247.97356061429653,224.88983938570348,234.50140544236882,238.49553414078784,239.9810662495652,237.01000203201048,515188,626272.5333333333,55.10946105795213,54.65115575714913,NaN,NaN,NaN,NaN,4.372069457529802,15.455595924231538,66914675,0.5534516056226124,1.6866059577825752,1.1331543521599627
2023-01-26T09:30:00-05:00,243.5,246.03,242.01,244.15,230.82096120375945,NaN,NaN,NaN,NaN,NaN,236.50870000000003,248.20312188565842,224.81427811434165,234.50140544236882,244.06333333333333,244.06333333333333,244.06333333333333,783573,610115.4,60.57778052658785,54.89605066559721,NaN,NaN,NaN,NaN,4.448350210563388,14.508877779232135,67698248,0.6270526993908221,1.9169702263984902,1.2899175270076682
2023-01-26T13:30:00-05:00,244.17,248.24,244.17,248,233.04819023995222,NaN,NaN,NaN,NaN,NaN,236.66070000000002,248.74456147056569,224.57683852943435,236.36366794828433,245.2635030238525,246.62293587103028,243.90407017667474,610730,605549.4333333333,65.47577620390848,55.403675726232336,NaN,NaN,NaN,NaN,4.422753766951717,14.070725110575975,68308978,0.8742513742449138,2.3827317448138103,1.5084803705688965
2023-01-27T09:30:00-05:00,248.89,249.34,246.84,247.99,235.19031795631804,NaN,NaN,NaN,NaN,NaN,236.77830000000003,249.18221238439736,224.3743876156027,238.58893435862745,248.0566666666667,248.0566666666667,248.0566666666667,766398,605666.8666666667,65.45302884246996,56.37908504518951,NaN,NaN,NaN,NaN,4.285414212169452,13.878059152179626,67542580,0.9689703087063837,2.719693256451876,1.7507229477454924
2023-01-27T13:30:00-05:00,248,249.81,247.83,248.17,236.23666714012177,NaN,NaN,NaN,NaN,NaN,236.90410000000003,249.63568351344554,224.1725164865545,240.219147486902,248.31288676307915,248.58568384558387,248.04008968057443,676085,605255.7666666667,65.68413024012372,57.4863331099159,NaN,NaN,NaN,NaN,4.120741768443062,13.79307259044504,68218665,0.9730694496423851,2.967059759798474,1.9939903101560887
2023-01-30T09:30:00-05:00,244.61,245.57,242.26,243.26,236.23666714012177,NaN,NaN,NaN,NaN,NaN,236.87570000000002,249.54395244616592,224.20744755383413,240.219147486902,243.69666666666666,243.69666666666666,243.69666666666666,653146,590859.0333333333,54.896398913963914,58.22356756589865,NaN,NaN,NaN,NaN,4.248545927839986,13.182981890962667,67565519,0.5931052449130596,2.735371866297413,2.1422666213843535
2023-01-30T13:30:00-05:00,243.26,243.6,242.2,242.76,236.23666714012177,NaN,NaN,NaN,NaN,NaN,236.84170000000003,249.43726534815977,224.2461346518403,240.219147486902,243.35674623070798,243.77041316380192,242.94307929761405,441025,577516.6333333333,53.92514191730211,58.931805795076045,NaN,NaN,NaN,NaN,4.045078361565702,12.628944868570557,67124494,0.272420017747002,2.482791643568106,2.210371625821104
2023-01-31T09:30:00-05:00,243.5,246.47,242.96,245.89,236.23666714012177,NaN,NaN,NaN,NaN,NaN,237.06830000000002,249.8970225568182,224.23957744318184,240.219147486902,245.10666666666665,245.10666666666665,245.10666666666665,382367,569499.9,58.83508586490626,59.27015573306114,NaN,NaN,NaN,NaN,4.021144192882438,11.992348047549115,67506861,0.23673777414100483,2.5062938434973603,2.2695560693563555
2023-01-31T13:30:00-05:00,245.915,247.95,245.74,247.87,236.23666714012177,NaN,NaN,NaN,NaN,NaN,237.2609,250.4386103762329,224.08318962376708,240.219147486902,246.07783424559875,247.1155539080342,245.0401145831633,334895,565236.1333333333,61.62126311213825,59.59675179450694,NaN,NaN,NaN,NaN,3.8917767505336904,11.717232587265729,67841756,0.3076305147123546,2.6540942127467986,2.346463698034444
2023-02-01T09:30:00-05:00,247.83,248.33,245.63,247.02,236.23666714012177,NaN,NaN,NaN,NaN,NaN,237.44150000000002,250.8987753928807,223.98422460711933,240.219147486902,246.99333333333334,246.99333603073165,246.99333063593502,424325,567074.9,59.751574428217346,59.444982002332765,NaN,NaN,NaN,NaN,3.8066498397812856,11.544086466695775,67417431,0.26030093528580434,2.671839867141699,2.411538931855895
2023-02-01T13:30:00-05:00,247.035,255.17,245.49,252.71,237.62815090852789,NaN,NaN,NaN,NaN,NaN,237.72190000000003,251.8395921470839,223.60420785291618,243.82384115880643,249.86898345487012,251.7682126091478,247.96975430059243,972783,590525.4333333333,66.97522315737208,60.009107554040256,NaN,NaN,NaN,NaN,4.226174851225478,12.65075606472061,68390214,0.5581272336760028,3.1091979739508986,2.5510707402748958
2023-02-02T09:30:00-05:00,258.765,263.1,257.24,262.02,246.62868950359484,NaN,NaN,NaN,NaN,NaN,238.21790000000004,253.88751481210764,222.54828518789245,248.82807292704516,260.7866666666667,260.7866666666667,260.7866666666667,1099637,614558.6333333333,74.90994121088715,61.233371860961164,NaN,NaN,NaN,NaN,4.666448076137946,14.701405056813055,69489851,1.286425860961844,4.159103066477201,2.8726772055153567
2023-02-02T13:30:00-05:00,262.05,264.67,260.87,264.6,249.32602179888596,NaN,NaN,NaN,NaN,NaN,238.77050000000003,256.0873125531183,221.45368744688176,251.35245834163612,261.85559200161083,263.1321022171039,260.57908178611774,771073,627027.2666666667,76.58864065725747,62.55672319231511,NaN,NaN,NaN,NaN,4.604558927842378,16.773841525592843,70260924,1.8139326846186483,5.140093061288667,3.3261603766700185
2023-02-03T09:30:00-05:00,259.75,264.21,259.07,259.2,249.32602179888596,NaN,NaN,NaN,NaN,NaN,239.21730000000002,257.4428489036647,220.99175109633535,251.35245834163612,260.82666666666665,260.82666666666665,260.82666666666665,835974,640292.1,66.55194494675152,63.31109936284561,NaN,NaN,NaN,NaN,4.670661861567924,18.213148770713204,69424950,1.6745350396105882,5.419329176183254,3.744794136572666
2023-02-03T13:30:00-05:00,259.1,259.22,257.1,258.35,249.32602179888596,NaN,NaN,NaN,NaN,NaN,239.69430000000003,258.6353955343109,220.75320446568915,251.35245834163612,259.75841061907124,261.0389790842387,258.4778421539038,581752,650807.4,65.10565633426563,64.02511331115372,NaN,NaN,NaN,NaN,4.488471728598786,19.033653952698234,68843198,1.4109958149164408,5.5085389052182165,4.097543090301776
2023-02-06T09:30:00-05:00,257.46,258.29,254.79,255.86,249.32602179888596,NaN,NaN,NaN,NaN,NaN,240.00110000000004,259.4751966712154,220.5270033287847,251.35245834163612,256.31333333333333,256.31333333333333,256.31333333333333,402925,652776.7333333333,60.92850831393555,64.05016529596426,NaN,NaN,NaN,NaN,4.4221523194131604,19.21688928505699,68440273,0.9755853011952418,5.317024716795828,4.341439415600586
2023-02-06T13:30:00-05:00,255.84,257.25,255.7,256.76,249.32602179888596,NaN,NaN,NaN,NaN,NaN,240.31710000000004,260.3479840633624,220.2862159366377,251.35245834163612,256.43184706792846,256.55980416977457,256.30388996608235,345647,651723,61.88050647854752,63.79336031558133,NaN,NaN,NaN,NaN,4.216998582312221,19.38703637939012,68785920,0.6693924559229485,5.178179985504272,4.508787529581324
2023-02-07T09:30:00-05:00,260.3,268.29,260.085,263.69,250.43970468105832,NaN,NaN,NaN,NaN,NaN,240.8333,261.8903346069885,219.7762653930115,254.7266439493873,264.0216666666667,264.0216666666667,264.0216666666667,1085762,667554.7666666667,68.28784025144265,63.99584684479367,NaN,NaN,NaN,NaN,4.739355826432779,20.985221438074813,69871682,0.8435367087903183,5.563208415569221,4.719671706778903
2023-02-07T13:30:00-05:00,263.69,268.77,261.46,267.68,250.99528628646476,NaN,NaN,NaN,NaN,NaN,241.3911,263.74566752343753,219.03653247656246,254.7266439493873,264.8718895649833,265.838139344673,263.9056397852936,840662,675612.1333333333,71.2809624768097,64.39562057598552,NaN,NaN,NaN,NaN,4.922973267401866,22.51874595714011,70712344,1.1200714971874337,6.1197610782631955,4.999689581075762
2023-02-08T09:30:00-05:00,273.14,276.75,267.57,269.2,257.4302732734436,NaN,NaN,NaN,NaN,NaN,242.0065,265.65765568000757,218.3553443199924,260.55545212760785,271.17333333333335,271.17333333333335,271.17333333333335,1449071,699160.2666666667,72.35155621424849,65.64241752600584,NaN,NaN,NaN,NaN,5.227046605444591,24.664578354897113,72161415,1.286103779921559,6.607319305977711,5.321215526056152
2023-02-08T13:30:00-05:00,269.27,269.59,266.22,266.66,257.4302732734436,NaN,NaN,NaN,NaN,NaN,242.5475,267.17209317430206,217.922906825698,260.55545212760785,270.048889726285,271.74515833527374,268.3526211172962,636760,705304.7666666667,67.80295118783565,66.63368961675825,NaN,NaN,NaN,NaN,5.094400419341403,26.319295330525478,71524655,1.1121405405129376,6.7113912016973245,5.599250661184387
2023-02-09T09:30:00-05:00,273.89,273.96,266.83,266.83,257.4302732734436,NaN,NaN,NaN,NaN,NaN,243.3071,268.5305827959973,218.08361720400268,260.55545212760785,269.20666666666665,269.20666666666665,269.20666666666665,852212,709296.4,67.9481900364504,67.2846256290114,NaN,NaN,NaN,NaN,5.251943246531299,28.219272422096147,72376867,0.9046052107946236,6.730007174677667,5.825401963883043
2023-02-09T13:30:00-05:00,266.87,267.5,262.8,263.64,257.4302732734436,NaN,NaN,NaN,NaN,NaN,243.99929999999998,269.51546781650404,218.4831321834959,260.55545212760785,267.2071062670731,269.4697935257319,264.94441900841423,665530,717486.5666666667,62.27165186334083,67.33108196838302,NaN,NaN,NaN,NaN,5.21251872892192,29.01893042711584,71711337,0.4704177615037981,6.413424165762791,5.943006404258993
2023-02-10T09:30:00-05:00,261.68,264.07,260.68,262.28,257.4302732734436,NaN,NaN,NaN,NaN,NaN,244.7903,270.0710469359574,219.5095530640426,260.55545212760785,262.3433333333333,262.3433333333333,262.3433333333333,500910,711566.0666666667,59.971362381776174,67.34678110792292,NaN,NaN,NaN,NaN,5.08233881971321,29.28699823056084,71210427,0.03264412575088205,5.983811561447595,5.951167435696713
2023-02-10T13:30:00-05:00,262.3,263.53,261.06,263.07,257.4302732734436,NaN,NaN,NaN,NaN,NaN,245.60629999999998,270.5584827349824,220.65411726501753,260.55545212760785,262.42520759870996,262.5276292781733,262.3227859192466,320089,701506.7333333333,60.875457747283264,66.91108357863087,NaN,NaN,NaN,NaN,4.895743189733693,29.535918333759763,71530516,-0.24729487018556373,5.642048847964759,5.8893437181503225
2023-02-13T09:30:00-05:00,267.55,274.6,267.23,272.37,257.4302732734436,NaN,NaN,NaN,NaN,NaN,246.59629999999999,271.7883528587877,221.4042471412123,260.55545212760785,271.40000000000003,271.40000000000003,271.40000000000003,773826,702879.6333333333,69.58463309156544,66.53070442725074,NaN,NaN,NaN,NaN,5.369618676181289,30.842372715735202,72304342,0.13002064721417206,6.051869527168037,5.921848879953865
2023-02-13T13:30:00-05:00,272.4,272.5,270.23,271.3,257.4302732734436,NaN,NaN,NaN,NaN,NaN,247.52489999999997,272.867543705027,222.18225629497297,260.55545212760785,271.3775066495528,271.40523159083864,271.34978170826696,509343,701257.3,67.71691869761466,65.89701000156197,NaN,NaN,NaN,NaN,5.148217342168338,32.055508927569534,71794999,0.23742554038613406,6.218630805436533,5.981205265050399
2023-02-14T09:30:00-05:00,272.585,274.94,269.28,272.21,257.4302732734436,NaN,NaN,NaN,NaN,NaN,248.3579,274.1493276526122,222.5664723473878,261.3885700112254,272.1433333333334,272.1433333333334,272.1433333333334,908240,710901.7333333333,68.49150024611704,66.03554966580236,NaN,NaN,NaN,NaN,5.184773246299173,33.38377013619244,72703239,0.29584317487778566,6.3510092336476305,6.055166058769845
2023-02-14T13:30:00-05:00,272.29,273.94,271.7,272.11,258.27109019845227,NaN,NaN,NaN,NaN,NaN,249.25689999999997,275.163459778557,223.35034022144296,261.9788560089803,272.28237576819214,272.486938405734,272.07781313065027,419607,707368.8,68.29757215430394,66.26354365294796,NaN,NaN,NaN,NaN,4.974432300134947,34.61715554419941,72283632,0.2553640688445604,6.374371144825545,6.119007075980985
2023-02-15T09:30:00-05:00,268.32,270.71,266.17,268.1,258.27109019845227,NaN,NaN,NaN,NaN,NaN,250.0477,275.79230022684277,224.3030997731572,261.9788560089803,268.32666666666665,268.32666666666665,268.32666666666665,623167,672756.7333333333,60.85643043354757,66.25839523292025,NaN,NaN,NaN,NaN,5.04340142155388,34.42180250359649,71660465,-0.09508870846936723,6.000146190394275,6.095234898863643
2023-02-15T13:30:00-05:00,268.15,269.32,267.56,269.32,258.27109019845227,NaN,NaN,NaN,NaN,NaN,250.8565,276.43062389506116,225.2823761049389,261.9788560089803,268.48882184093804,268.6879419144214,268.2897017674547,413272,669359.5333333333,62.20558611477242,66.28161520693631,NaN,NaN,NaN,NaN,4.8088727485857445,34.24040325160805,72073737,-0.28747255590407583,5.735894203983548,6.023366759887624
2023-02-16T09:30:00-05:00,264.05,266.74,263.14,264.91,258.27109019845227,NaN,NaN,NaN,NaN,NaN,251.4743,276.88358483920683,226.06501516079314,261.9788560089803,264.93,264.93,264.93,546263,661449.2,54.84664768299349,65.32153002347566,NaN,NaN,NaN,NaN,4.906810409401048,33.096684880044805,71527474,-0.7293350204016535,5.1116979843855574,5.841033004787211
2023-02-16T13:30:00-05:00,264.97,265.98,261.91,262.18,258.27109019845227,NaN,NaN,NaN,NaN,NaN,252.00150000000002,277.18253232593753,226.82046767406254,261.9788560089803,264.20541770276816,264.98963066842924,263.4212047371071,466347,656636.4333333333,50.83727191839242,63.861266412160134,NaN,NaN,NaN,NaN,4.847038237300972,31.78052795478411,71061127,-1.1955267110837138,4.346624615932569,5.542151327016283
2023-02-17T09:30:00-05:00,259.39,260.07,256,256.46,NaN,NaN,NaN,272.58614333530426,272.58614333530426,272.58614333530426,252.3621,277.27032491387075,227.45387508612922,261.9788560089803,257.51,257.51,257.51,719443,655071.2666666667,43.63912406806275,61.810378401718296,NaN,NaN,NaN,NaN,4.942249791779474,29.566184934630602,70341684,-1.8406189182420105,3.2413776792137696,5.08199659745578
2023-02-17T13:30:00-05:00,256.48,258.3,256.37,258.06,NaN,NaN,NaN,271.48790954733596,NaN,NaN,252.7523,277.3926328070051,228.11196719299485,261.9788560089803,257.53829425517625,257.57124450255986,257.50534400779264,530488,650218.0333333333,45.94473062741736,60.24907693311699,NaN,NaN,NaN,NaN,4.727089092366655,27.51000927305948,70872172,-2.0926852618061806,2.466140020198054,4.558825282004235
2023-02-21T09:30:00-05:00,254.4,255.475,251.6,252.57,NaN,NaN,NaN,267.92800456791156,NaN,NaN,253.06949999999998,277.28019526056573,228.85880473943422,261.9788560089803,253.215,253.215,253.215,477572,644365.5666666667,39.91158889922862,58.246462566172575,NaN,NaN,NaN,NaN,4.850868442911895,26.394429848459527,70394600,-2.532894457445206,1.3927072101977274,3.9256016676429333
2023-02-21T13:30:00-05:00,252.57,252.99,251.81,252.65,NaN,NaN,NaN,266.29729981482467,NaN,NaN,253.3391,277.2226805263769,229.45551947362313,261.9788560089803,252.89150499375052,253.2548801357707,252.52812985173034,378498,642281.3333333334,40.03515713438681,56.658141514104436,NaN,NaN,NaN,NaN,4.5886635541324745,25.358534668473858,70773098,-2.7067140881006337,0.542209057517141,3.2489231456177747
2023-02-22T09:30:00-05:00,254.06,254.3,251.41,253.34,NaN,NaN,NaN,266.29729981482467,NaN,NaN,253.61599999999999,277.16989555890774,230.06210444109226,261.9788560089803,253.01666666666668,253.016669364065,253.01666396926836,278530,638820.1,41.15908725901911,55.31440757676465,NaN,NaN,NaN,NaN,4.467330443123013,24.12135533625208,71051628,-2.6593560641380076,-0.0752719345547348,2.584084129583273
2023-02-22T13:30:00-05:00,253.33,253.82,250.35,251.49,NaN,NaN,NaN,265.59698185606953,NaN,NaN,253.8386,277.09567763584863,230.5815223641514,258.4088678457474,252.3940866252978,252.9561449308434,251.8320283197522,341743,639048.3666666667,39.04595822080775,53.75515761058783,NaN,NaN,NaN,NaN,4.396092554328512,23.16395186913653,70709885,-2.6318864127498145,-0.7057738863539953,1.9261125263958192
2023-02-23T09:30:00-05:00,255.59,256.85,250.49,251.38,NaN,NaN,NaN,265.59698185606953,NaN,NaN,254.1306,276.8848197088788,231.37638029112117,258.4088678457474,252.9066666666667,252.9066666666667,252.9066666666667,690189,647910.5,38.918015198304666,51.56468490392634,NaN,NaN,NaN,NaN,4.536371657590762,21.623938400117336,70019696,-2.5012810759534374,-1.2004888185459777,1.3007922574074597
2023-02-23T13:30:00-05:00,251.35,255.59,251.06,254.83,NaN,NaN,NaN,265.59698185606953,NaN,NaN,254.51059999999998,276.65609820076133,232.3651017992386,254.92109427659793,253.26825199637793,253.71760102850322,252.81890296425263,446912,630381.4666666667,45.00465428651558,49.94238030313356,NaN,NaN,NaN,NaN,4.535916539191422,20.193925893170942,70466608,-2.079987028463297,-1.2991915281716615,0.7807955002916355
2023-02-24T09:30:00-05:00,250.085,250.96,248.17,248.755,NaN,NaN,NaN,263.6049740767337,NaN,NaN,254.84029999999998,276.1256680644683,233.55493193553167,254.48987542127836,249.295,249.295,249.295,564475,612542.7333333333,37.85202940030298,47.75384667128969,NaN,NaN,NaN,NaN,4.687636786392035,19.452623024129174,69902133,-2.1017023954985605,-1.8463324940815653,0.2553699014169952
2023-02-24T13:30:00-05:00,248.76,249.76,248.11,249.36,NaN,NaN,NaN,262.56179343688217,NaN,NaN,255.1897,275.5082620957755,234.8711379042245,247.78790033702265,249.20573442869372,249.31307178248403,249.0983970749034,390401,599853.6666666666,38.89359948413888,45.653562909135054,NaN,NaN,NaN,NaN,4.470662730221174,18.776268054189853,70292534,-1.968856926424835,-2.2057012566140486,-0.23684433018921358
2023-02-27T09:30:00-05:00,252.54,252.82,249.52,250.66,NaN,NaN,NaN,262.56179343688217,NaN,NaN,255.44279999999998,275.2065058427796,235.67909415722036,247.50932026961814,251,251,251,441234,586695.6666666666,41.17497272963859,44.24774450171298,NaN,NaN,NaN,NaN,4.398472535205374,17.45102966897231,70733768,-1.6972589990771103,-2.3584180790356015,-0.6611590799584912
2023-02-27T13:30:00-05:00,250.68,251,249.39,250.2,NaN,NaN,NaN,262.56179343688217,NaN,NaN,255.64339999999996,274.9819984435269,236.30480155647305,246.19622206594846,250.67163186748886,251.066553930707,250.27670980427072,305048,577472.2,40.59739954673199,42.7043026039958,NaN,NaN,NaN,NaN,4.199295925547848,16.218870133144033,70428720,-1.461382022850958,-2.4878866085221887,-1.0265045856712307
2023-02-28T09:30:00-05:00,248.85,251.26,248.73,251.25,NaN,NaN,NaN,262.56179343688217,NaN,NaN,255.7858,274.88657918410365,236.68502081589637,246.19622206594846,250.41333333333336,250.41333333333336,250.41333333333336,221992,571441.1,42.577432675213025,41.82793010344005,NaN,NaN,NaN,NaN,4.0800605022944305,15.235778578742536,70650712,-1.1605638500180042,-2.477209398193736,-1.3166455481757318
2023-02-28T13:30:00-05:00,251.41,251.49,248.89,249.42,NaN,NaN,NaN,262.56179343688217,NaN,NaN,255.92260000000002,274.73895801529625,237.1062419847038,246.19622206594846,250.17090932873145,250.41089708716646,249.93092157029645,226522,567470.2666666667,40.0705240991926,41.05887668778293,NaN,NaN,NaN,NaN,3.9743418949876874,14.261377588254334,70424190,-1.0159608909931166,-2.5865966619171274,-1.5706357709240109
2023-03-01T09:30:00-05:00,250.76,250.98,246.58,247.43,NaN,NaN,NaN,261.41426432123285,NaN,NaN,256.034,274.5800263129303,237.4879736870697,246.19622206594846,248.33000000000004,248.33000000000004,248.33000000000004,599549,551263.1666666666,37.48580953813629,40.619354221359615,NaN,NaN,NaN,NaN,4.0047460453457076,13.942502084502548,69824641,-0.9847461734811327,-2.8015684877754268,-1.816822314294294
2023-03-01T13:30:00-05:00,247.38,247.58,245.79,246.27,NaN,NaN,NaN,258.98907048844956,NaN,NaN,256.118,274.4470550765693,237.78894492343068,246.19622206594846,247.6341174191147,248.50402433149185,246.76421050673753,383664,536029.9,36.02697847286727,39.91094335317746,NaN,NaN,NaN,NaN,3.8465498992495872,13.838318472634334,69440977,-0.9710242394343069,-3.0306026135871775,-2.0595783741528706
2023-03-02T09:30:00-05:00,246.57,247.9,245.63,247.145,NaN,NaN,NaN,258.8193400117018,NaN,NaN,256.2404,274.24350027078157,238.2372997292185,244.80197765275875,246.89166666666665,246.89166666666665,246.89166666666665,438521,502344.9,37.987414585959606,39.7735023308011,NaN,NaN,NaN,NaN,3.7339391921603315,13.638518929194445,69879498,-0.8369036631004692,-3.105707953028457,-2.2688042899279877
2023-03-02T13:30:00-05:00,247.12,251.4,247.07,251.11,NaN,NaN,NaN,258.8193400117018,NaN,NaN,256.4508,273.95638269352384,238.9452173064762,243.5199302698048,248.35563254995094,249.83966173524735,246.87160336465453,426744,495344.36666666664,46.054729780954226,40.20347180555592,NaN,NaN,NaN,NaN,3.7765149641488804,12.916730894526603,70306242,-0.43524631859257656,-2.812862188168708,-2.3776158695761316
2023-03-03T09:30:00-05:00,252.07,255.42,251.4,255.06,NaN,NaN,NaN,258.8193400117018,NaN,NaN,256.669,273.8243184756191,239.51368152438087,246.8356075508096,253.96,253.96,253.96,527628,484524.9,52.66167440734695,41.025085173293625,NaN,NaN,NaN,NaN,3.8146210381382444,13.208924279874307,70833870,0.11307709689596024,-2.2362694984561813,-2.3493465953521415
2023-03-03T13:30:00-05:00,255.05,255.59,254.44,255.27,NaN,NaN,NaN,258.8193400117018,NaN,NaN,256.8144,273.7957085055268,239.8330914944731,248.14748604064772,254.4081283450755,254.96494725613212,253.8513094340189,341747,473732.13333333336,52.99130866327074,42.02118163346955,NaN,NaN,NaN,NaN,3.624290963985513,13.517716674573215,71175617,0.485648156524789,-1.7422863996961553,-2.2279345562209443
2023-03-06T09:30:00-05:00,256.37,260.1,256,258.28,246.18502036312503,246.18502036312503,246.18502036312503,NaN,NaN,NaN,257.0202,273.81715388574776,240.22324611425222,251.7309888325182,258.12666666666667,258.12666666666667,258.12666666666667,575132,476206.2,57.55368705038807,43.35230105147552,NaN,NaN,NaN,NaN,3.7104130379865485,14.705492544957579,71750749,0.9061128221036938,-1.095293528591327,-2.001406350695021
2023-03-06T13:30:00-05:00,258.3,258.515,256.665,256.87,246.18502036312503,NaN,NaN,NaN,NaN,NaN,257.1942,273.7999904792217,240.58840952077833,251.7309888325182,257.84056330722115,258.21519887709684,257.46592773734545,335425,476717.4,54.86732686336375,44.05677766410753,NaN,NaN,NaN,NaN,3.5775263924160785,15.808427281743057,71415324,1.050415531000772,-0.6883869369440561,-1.738802467944828
2023-03-07T09:30:00-05:00,256.27,257.67,254.04,255.06,246.18502036312503,NaN,NaN,NaN,NaN,NaN,257.4302,273.5659033884442,241.29449661155581,251.7309888325182,255.58999999999997,255.5900046720309,255.58999532796906,667631,473177.56666666665,51.54155284731186,45.03460076746531,NaN,NaN,NaN,NaN,3.5812745072435033,15.962543553821293,70747693,0.9861395141471168,-0.5061280752609321,-1.4922675894080488
2023-03-07T13:30:00-05:00,255.02,255.18,253.39,254.2,246.18502036312503,NaN,NaN,NaN,NaN,NaN,257.659,273.2721060330717,242.0458939669283,251.7309888325182,254.97855828955522,255.64293367191772,254.31418290719273,565483,475048.9,49.99103897342477,45.827275016700014,NaN,NaN,NaN,NaN,3.453326328154683,15.900476218631795,70182210,0.8528790170473977,-0.4261688180988017,-1.2790478351461994
2023-03-08T09:30:00-05:00,254.11,254.55,250.82,252.04,246.18502036312503,NaN,NaN,NaN,NaN,NaN,257.782,273.11672099517614,242.4472790048238,251.7309888325182,252.47,252.47,252.47,513325,461885.06666666665,46.22940571502718,46.18830594422777,NaN,NaN,NaN,NaN,3.4730887332864926,15.07055306447252,69668885,0.5984592728788796,-0.5309737440475999,-1.1294330169264795
2023-03-08T13:30:00-05:00,252,253.96,251.46,253.72,246.18502036312503,NaN,NaN,NaN,NaN,NaN,257.89900000000006,273.01717052423163,242.78082947576848,251.7309888325182,252.68634256852957,252.9655440027915,252.40714113426765,308206,458171.7,49.41745605364856,46.8183099804361,NaN,NaN,NaN,NaN,3.4035823951946003,14.299910135610336,69977091,0.5251321826114314,-0.47301778866219024,-0.9981499712736216
2023-03-09T09:30:00-05:00,255.825,259.55,254.9,255.23,246.18502036312503,NaN,NaN,NaN,NaN,NaN,258.06320000000005,272.88051780855636,243.2458821914437,251.7309888325182,256.56,256.56,256.56,573008,456499.73333333334,52.16280999712646,47.502979789144206,NaN,NaN,NaN,NaN,3.576897938394987,14.894131607560817,70550099,0.5571085013840291,-0.30176434454358514,-0.8588728459276143
2023-03-09T13:30:00-05:00,255.225,255.225,251.58,252.29,246.18502036312503,NaN,NaN,NaN,NaN,NaN,258.0548,272.8847181332835,243.22488186671646,251.7309888325182,255.06506704369104,256.80856847385473,253.32156561352735,421269,456766.3,46.83307719516747,47.986019295999554,NaN,NaN,NaN,NaN,3.5821195142239146,14.489849097537471,70128830,0.36815233845375717,-0.3986824228604178,-0.7668347613141749
2023-03-10T09:30:00-05:00,251.01,252.79,247.77,248.94,246.18502036312503,NaN,NaN,NaN,NaN,NaN,257.7932,272.7945757715697,242.7918242284303,251.7309888325182,249.83333333333334,249.83333333333334,249.83333333333334,703261,461999.56666666665,41.61536279870419,48.28098738604012,NaN,NaN,NaN,NaN,3.6848252632079195,13.722741658993327,69425569,0.023621034647467343,-0.7373084680048407,-0.7609295026523081
2023-03-10T13:30:00-05:00,248.87,250.1,247.6,248.59,246.18502036312503,NaN,NaN,NaN,NaN,NaN,257.473,272.5627472477136,242.3832527522864,251.7309888325182,249.42086284830992,249.94164256946607,248.90008312715378,441158,461159.93333333335,41.1001590290744,48.643357425769196,NaN,NaN,NaN,NaN,3.6001948872644967,13.049473345545529,68984411,-0.2089616988750621,-1.0221316262461357,-0.8131699273710736
2023-03-13T09:30:00-04:00,247.4,256.8,245.73,255,NaN,NaN,NaN,260.19748021104454,260.19748021104454,260.19748021104454,257.389,272.48611575102547,242.29188424897455,250.89479106601453,252.51,252.51,252.51,958935,469143,52.659495324829706,49.69136319283135,NaN,NaN,NaN,NaN,4.133752395317034,13.25743326431182,69943346,0.07269880725580946,-0.7222964183013119,-0.7949952255571213
2023-03-13T13:30:00-04:00,255,257.91,253.8,253.92,NaN,NaN,NaN,260.19748021104454,NaN,NaN,257.3004,272.4258864172968,242.17491358270323,250.74274593651162,253.55031757448018,254.86431787711916,252.2363172718412,601077,471495.9666666667,50.84878182677873,50.033795481818814,NaN,NaN,NaN,NaN,4.1320557956515325,13.651593291018148,69342269,0.18375190701951127,-0.5653053417827323,-0.7490572488022436
2023-03-14T09:30:00-04:00,256.76,260.33,255.89,258.97,245.45613033109657,245.45613033109657,245.45613033109657,NaN,NaN,NaN,257.3626,272.489459851272,242.23574014872798,250.74274593651162,258.3966666666667,258.3966666666667,258.3966666666667,1037334,490154.7,58.10325153886742,50.4224795626417,NaN,NaN,NaN,NaN,4.294766095962137,14.44057855324192,70379603,0.5728334741278547,-0.03301540614242526,-0.6058488802702799
2023-03-14T13:30:00-04:00,258.95,261.06,257.38,260.6,246.6394880433195,NaN,NaN,NaN,NaN,NaN,257.4394,272.59221183675146,242.28658816324847,250.74274593651162,258.97075298457526,259.6088509453888,258.33265502376173,839650,505526.43333333335,60.14783218730454,50.9336598143584,NaN,NaN,NaN,NaN,4.250854231964842,15.297650467117178,71219253,0.8962195859704425,0.5144256021927731,-0.3817939837776693
2023-03-15T09:30:00-04:00,259.85,264.87,259.24,264.12,249.27860222316858,NaN,NaN,NaN,NaN,NaN,257.448,272.6154732239757,242.28052677602426,252.28458028209977,262.74333333333334,262.74333333333334,262.74333333333334,1388597,542528.6666666666,64.20972706262404,51.40909124380382,NaN,NaN,NaN,NaN,4.349364643967354,16.698143098426026,72607850,1.2800493437243177,1.2182676958777279,-0.06178164784658985
2023-03-15T13:30:00-04:00,264.12,266.46,262.9,265.43,251.9988930312063,NaN,NaN,NaN,NaN,NaN,257.403,272.46173912384216,242.34426087615788,254.6116642256798,263.58190822577245,264.6451466348727,262.51866981667223,863771,559929.6,65.61437338814802,52.176737424145564,NaN,NaN,NaN,NaN,4.292981455112543,18.227245264572105,73471621,1.5376884891785176,1.8603289636265572,0.32264047444803956
2023-03-16T09:30:00-04:00,265.205,276.51,263.29,274.45,255.99257971160606,NaN,NaN,NaN,NaN,NaN,257.508,272.96231991386355,242.05368008613638,260.42133138054385,271.4166666666667,271.4166666666667,271.4166666666667,1775225,596097.4666666667,73.36552239156471,53.7355923915922,NaN,NaN,NaN,NaN,4.930625636890217,20.755848415472265,75246846,2.1912574187534775,3.0617122478898864,0.8704548291364089
2023-03-16T13:30:00-04:00,274.46,276.55,274.1,276.03,261.7156442701695,NaN,NaN,NaN,NaN,NaN,257.69539999999995,273.80254001181004,241.58825998818986,262.45406510443513,272.8952425025626,274.8801974250298,270.9102875800954,985007,614033.9666666667,74.45190522395295,55.482797123772784,NaN,NaN,NaN,NaN,4.753438091398058,23.107393713623797,76231853,2.5789285656144307,4.0941155361544475,1.5151869705400167
2023-03-17T09:30:00-04:00,278.23,283.31,276.33,279.94,265.8365240760708,NaN,NaN,NaN,NaN,NaN,257.95759999999996,275.0478155913857,240.86738440861424,268.3932520835481,279.85999999999996,279.85999999999996,279.85999999999996,1543082,646654.2,76.95678109944681,57.67760965123133,NaN,NaN,NaN,NaN,4.933906799155342,25.831880410511708,77774935,2.9224350282821416,5.168230755892694,2.245795727610552
2023-03-17T13:30:00-04:00,280.01,281.2,276.89,279.42,265.8365240760708,NaN,NaN,NaN,NaN,NaN,258.2732,276.32713727251803,240.21926272748195,268.3932520835481,279.5937365250015,279.9296316866834,279.2578413633195,969627,665961.7333333333,75.89109384034109,59.56858377885222,NaN,NaN,NaN,NaN,4.889342027787103,28.361760914764773,76805308,2.930879674829592,5.909395321147542,2.97851564631795
2023-03-20T09:30:00-04:00,277.06,277.47,269.86,271.05,265.8365240760708,NaN,NaN,NaN,NaN,NaN,258.44859999999994,276.8224119115233,240.07478808847657,268.3932520835481,272.79333333333335,272.79333333333335,272.79333333333335,1199112,691224.3333333334,61.20035553628767,60.214122745935164,NaN,NaN,NaN,NaN,5.222960454373739,28.813989938280482,75606196,2.2212226553291954,5.7550439654794445,3.533821310150249
2023-03-20T13:30:00-04:00,271.09,272.24,270.28,272.18,265.8365240760708,NaN,NaN,NaN,NaN,NaN,258.63079999999997,277.3615153477927,239.90008465220723,268.3932520835481,272.41862276306927,272.9836333423665,271.85361218377204,527398,698636,62.262452462387266,61.31622097930801,NaN,NaN,NaN,NaN,4.9898918504899035,29.23391688868793,76133594,1.6998800076350982,5.658671319694122,3.9587913120590237
2023-03-21T09:30:00-04:00,274.73,274.94,269.53,271.53,265.8365240760708,NaN,NaN,NaN,NaN,NaN,258.614,277.2968388635138,239.93116113648614,268.3932520835481,272,272,272,672371,713648.6333333333,61.224256061116535,62.71685621233746,NaN,NaN,NaN,NaN,5.019899575454913,29.94267004043819,75461223,1.2064289910203545,5.466827550834466,4.260398559814112
2023-03-21T13:30:00-04:00,271.53,273.82,270.94,273.79,265.8365240760708,NaN,NaN,NaN,NaN,NaN,258.6638,277.49432464059464,239.83327535940535,268.3932520835481,272.35932401002447,272.77921883535754,271.9394291846914,492380,722510.5666666667,63.50297383964394,64.31705727023528,NaN,NaN,NaN,NaN,4.867049605779561,30.600797967063436,75953603,0.9392871320989418,5.434507474937789,4.495220342838847
2023-03-22T09:30:00-04:00,273.73,278.21,272.67,277.06,265.8365240760708,NaN,NaN,NaN,NaN,NaN,258.76079999999996,277.9165999947799,239.60500000522,268.3932520835481,275.98,275.98,275.98,433722,716983,66.56465658715116,65.31028307468681,NaN,NaN,NaN,NaN,4.915117491081019,31.70807910464336,76387325,0.890310501641876,5.608108469891192,4.717797968249316
2023-03-22T13:30:00-04:00,277.08,281.02,272.18,272.27,265.8365240760708,NaN,NaN,NaN,NaN,NaN,258.76399999999995,277.9287702829972,239.5992297170027,268.3932520835481,275.3983599924105,275.7732979977376,275.02342198708345,1043761,738986.2333333333,58.78529664379257,65.8771769901878,NaN,NaN,NaN,NaN,5.195466241718087,33.017136997659705,75343564,0.4642434776271882,5.298102315283302,4.833858837656114
2023-03-23T09:30:00-04:00,277.92,281.06,275.33,279.48,265.8365240760708,NaN,NaN,NaN,NaN,NaN,258.99159999999995,278.8521275297535,239.1310724702464,268.3932520835481,278.62333333333333,278.62333333333333,278.62333333333333,787954,750634,65.34965355908352,66.39477713448896,NaN,NaN,NaN,NaN,5.45221865302394,34.236677842276,76131518,0.5889124988463745,5.569999461214081,4.981086962367707
2023-03-23T13:30:00-04:00,279.49,279.92,275.22,277.63,265.8365240760708,NaN,NaN,NaN,NaN,NaN,259.1578,279.4946432319276,238.8209567680724,268.3932520835481,278.08748005167354,278.60379034427376,277.5711697590733,848733,764700.3,62.594794571984345,66.5695601619661,NaN,NaN,NaN,NaN,5.398488749236515,35.33375568748562,75282785,0.4727065626921716,5.571970165732921,5.099263603040749
2023-03-24T09:30:00-04:00,277.24,279.77,275.31,278.5,265.8365240760708,NaN,NaN,NaN,NaN,NaN,259.4296,280.41946239497656,238.43973760502342,267.11160166683845,277.85999999999996,277.85999999999996,277.85999999999996,851094,775482.5,63.37668508364483,66.51005716346756,NaN,NaN,NaN,NaN,5.3314538385767625,36.35247082946597,76133879,0.38412322868307847,5.579417638894597,5.195294410211519
2023-03-24T13:30:00-04:00,278.54,280.61,277.72,280.57,265.8365240760708,NaN,NaN,NaN,NaN,NaN,259.79740000000004,281.596055026399,237.99874497360108,267.6451797150113,278.5320967570115,279.39240921866104,277.671784295362,519432,781405.3333333334,65.23854751898578,66.4832124585274,NaN,NaN,NaN,NaN,5.157064278678421,37.400583417383835,76653311,0.3932025933484269,5.686797651897052,5.293595058548625
2023-03-27T09:30:00-04:00,280.455,281.45,275.52,276.17,265.8365240760708,NaN,NaN,NaN,NaN,NaN,260.19160000000005,282.4427503019476,237.94044969805245,268.113143772009,277.71333333333337,277.71333333333337,277.71333333333337,587593,781820.7,58.43788193422236,65.4169524258601,NaN,NaN,NaN,NaN,5.212273973058535,37.574424101406976,76065718,0.04922261705616471,5.355123329868832,5.305900712812667
2023-03-27T13:30:00-04:00,276.21,277.23,275.73,276.23,265.8365240760708,NaN,NaN,NaN,NaN,NaN,260.555,283.2442127673042,237.86578723269582,268.113143772009,277.19513026420947,277.83837694069996,276.551883587719,381348,783351.4666666667,58.501409722735005,64.27763131863024,NaN,NaN,NaN,NaN,4.947111546411497,37.73584759371417,76447066,-0.21350152316926607,5.039023808851084,5.25252533202035
2023-03-28T09:30:00-04:00,275.87,275.97,272.06,273.29,265.8365240760708,NaN,NaN,NaN,NaN,NaN,260.9694,283.8164362751925,238.12236372480757,268.113143772009,273.7733333333333,273.7733333333333,273.7733333333333,254903,769593.8666666667,54.13499549108766,62.64750377517601,NaN,NaN,NaN,NaN,4.891603578810677,36.63330360633707,76192163,-0.6024900242683051,4.499412801684969,5.101902825953274
2023-03-28T13:30:00-04:00,273.3,275.32,272.14,275.26,265.8365240760708,NaN,NaN,NaN,NaN,NaN,261.4216,284.48607124388377,238.35712875611625,268.113143772009,273.9908295227861,274.2236247747044,273.7580342708678,222500,758161.1,56.47901333866378,61.260926596484786,NaN,NaN,NaN,NaN,4.7693461803242,35.60951276091547,76414663,-0.7355092346337972,4.182516282661027,4.918025517294824
2023-03-29T09:30:00-04:00,279.22,280.65,278.41,280.09,265.8365240760708,NaN,NaN,NaN,NaN,NaN,261.9566,285.48277023146846,238.4304297685315,269.5018236890149,279.71666666666664,279.71666666666664,279.71666666666664,407568,754635.8666666667,61.65353695867398,61.29329669808381,NaN,NaN,NaN,NaN,4.813678596015328,35.62662682247653,76822231,-0.5169238728631074,4.27187067621594,4.788794549079047
2023-03-29T13:30:00-04:00,280.08,281.13,278.98,280.57,266.146392055802,NaN,NaN,NaN,NaN,NaN,262.5382,286.4354878595042,238.64091214049586,271.1364589512119,279.9575522365387,280.21216131501666,279.7029431580607,364816,756522.8666666667,62.13535638324751,61.28421840671668,NaN,NaN,NaN,NaN,4.623415839157088,35.71872175597188,77187047,-0.3658468463868223,4.331485991095519,4.6973328374823415
2023-03-30T09:30:00-04:00,284.13,284.46,281.6,281.75,269.2231469623564,NaN,NaN,NaN,NaN,NaN,263.14560000000006,287.4184583928615,238.8727416071386,274.52016716096955,282.6033333333333,282.6033333333333,282.6033333333333,647682,759012,63.35436478772302,61.43636903004572,NaN,NaN,NaN,NaN,4.57102899350301,36.302223736720215,77834729,-0.2194962403516394,4.4229625370427925,4.642458777394432
2023-03-30T13:30:00-04:00,281.76,284.12,281.48,284.09,269.26073119134026,NaN,NaN,NaN,NaN,NaN,263.73080000000004,288.57759684466276,238.8840031553373,274.8481337287756,282.8448635020524,283.1498587206047,282.53986828350014,406180,758509.0333333333,65.71178110879225,61.59414097784203,NaN,NaN,NaN,NaN,4.433098351109936,36.800155162418136,78240909,-0.009251237324447104,4.6308947307388735,4.640145968063321
2023-03-31T09:30:00-04:00,283.77,286.85,283.03,286.34,271.49524340991564,NaN,NaN,NaN,NaN,NaN,264.4825,289.742254729608,239.222745270392,277.5225069830205,285.4066666666667,285.4066666666667,285.4066666666667,1979448,801048.6,67.85320690918687,61.686180286558866,NaN,NaN,NaN,NaN,4.389305611744944,37.64631322387067,80220357,0.22429764112272466,4.920518019466726,4.696220378344002
2023-03-31T13:30:00-04:00,286.35,288.84,285.97,288.23,274.18000507310126,NaN,NaN,NaN,NaN,NaN,265.2599,290.99816151782574,239.5216384821743,279.9430055864164,286.3851091491198,287.5107095305283,285.2595087677113,1495706,836200.2,69.57226929603954,62.456678333147934,NaN,NaN,NaN,NaN,4.280783782334587,38.68589929464159,81716063,0.43672434041334895,5.242125803860688,4.805401463447339
2023-04-03T09:30:00-04:00,286.65,288.28,283.95,284.16,274.18000507310126,NaN,NaN,NaN,NaN,NaN,265.92990000000003,291.85647019275706,240.00332980724298,279.9430055864164,285.46333333333337,285.46333333333337,285.46333333333337,1889331,867213.4,61.896257049321385,62.21000715387921,NaN,NaN,NaN,NaN,4.284299226453544,38.88658046653401,79826732,0.2434276489527063,5.109686024638222,4.866258375685516
2023-04-03T13:30:00-04:00,284.16,287.6,284.09,287.13,274.18000507310126,NaN,NaN,NaN,NaN,NaN,266.66850000000005,292.8632720165664,240.47372798343372,279.9430055864164,285.7679118559655,286.16026441029004,285.375559301641,1138554,885129.3,64.93645611605665,62.37726869274151,NaN,NaN,NaN,NaN,4.228992138849723,39.07292726900554,80965286,0.2546858607354263,5.184615701604798,4.929929840869372
2023-04-04T09:30:00-04:00,286.97,290.45,286.31,288.07,275.3182599532298,NaN,NaN,NaN,NaN,NaN,267.4049,293.8930193360345,240.9167806639655,281.0351388602452,288.27666666666664,288.27666666666664,288.27666666666664,1819292,911194.5666666667,65.86476679089849,62.55498881468821,NaN,NaN,NaN,NaN,4.222635557503312,39.67727268939268,82784578,0.263434610774941,5.259223104338048,4.995788493563107
2023-04-04T13:30:00-04:00,288.08,288.45,285.69,287.26,275.3182599532298,NaN,NaN,NaN,NaN,NaN,268.16170000000005,294.71336568108194,241.6100343189182,281.0351388602452,287.90771409208895,288.4422323561651,287.3731958280128,866799,912099.5333333333,64.28536900072811,62.48690463481265,NaN,NaN,NaN,NaN,4.118161589110218,39.98965339163185,81917779,0.15787052243036115,5.193126646601058,5.035256124170697
2023-04-05T09:30:00-04:00,285.84,287.15,282.92,283.37,275.3182599532298,NaN,NaN,NaN,NaN,NaN,268.88050000000004,295.0920122989874,242.6689877010127,281.0351388602452,284.47999999999996,284.47999999999996,284.47999999999996,1669799,921472.9333333333,57.19243061353259,62.39794382619196,NaN,NaN,NaN,NaN,4.134007189888058,39.23014235493554,80247980,-0.21072701787129233,4.771847351831582,4.982574369702874
2023-04-05T13:30:00-04:00,283.37,284.76,283.35,284.4,275.3182599532298,NaN,NaN,NaN,NaN,NaN,269.64310000000006,295.3935709774396,243.89262902256056,281.0351388602452,284.36965020945155,284.51807985211616,284.22122056678694,922924,923444.7,58.498161534348974,62.397711812735814,NaN,NaN,NaN,NaN,3.9394352477531944,38.52488210657468,81170904,-0.4104031424313579,4.469570441663677,4.879973584095035
2023-04-06T09:30:00-04:00,283.36,289.1,282.03,288.86,275.3182599532298,NaN,NaN,NaN,NaN,NaN,270.47740000000005,295.95979606002436,244.99500393997573,281.0351388602452,286.66333333333336,286.66333333333336,286.66333333333336,1347845,909198.7,63.666205423725515,63.07851252220995,NaN,NaN,NaN,NaN,4.163047015770827,38.659044120751524,82518749,-0.27390526508540525,4.537592002738279,4.811497267823684
2023-04-06T13:30:00-04:00,288.87,292.08,288.7,291.58,277.6554006442924,NaN,NaN,NaN,NaN,NaN,271.2868,296.8279409110865,245.74565908891356,282.34945030172514,288.9310637569719,290.9824065300127,286.8797209839311,1647200,931271.8,66.41313224871345,63.78809244435636,NaN,NaN,NaN,NaN,4.107115086072911,39.224832605702034,84165949,-0.04427392993832324,4.75615485540078,4.800428785339103
2023-04-10T09:30:00-04:00,289.07,289.23,284.71,288.75,277.6554006442924,NaN,NaN,NaN,NaN,NaN,271.96060000000006,297.53140754610604,246.38979245389407,282.34945030172514,287.56333333333333,287.56333333333333,287.56333333333333,1738704,937792.5333333333,61.22658228078489,63.75759568164999,NaN,NaN,NaN,NaN,4.304464008496274,38.38892477758261,82427245,-0.12239312671851721,4.647437376940957,4.769830503659474
2023-04-10T13:30:00-04:00,288.78,289.6,288.08,289.38,277.6554006442924,NaN,NaN,NaN,NaN,NaN,272.6428000000001,298.21609389499724,247.06950610500292,282.34945030172514,287.99287391152006,288.6570970170401,287.32865080600004,727120,929708.9666666667,61.939175349905334,63.74358275069698,NaN,NaN,NaN,NaN,4.105573722175114,37.679082105817315,83154365,-0.1682211819086632,4.559554026273645,4.727775208182308
2023-04-11T09:30:00-04:00,285.89,285.92,281.64,283.21,277.6554006442924,NaN,NaN,NaN,NaN,NaN,273.14140000000003,298.54669488433507,247.736105115665,282.34945030172514,283.59,283.59,283.59,2341180,967777.9,51.88243652959992,62.92415930368819,NaN,NaN,NaN,NaN,4.3651755991626064,35.242570490494664,80813185,-0.6249840966120583,3.9465450874172348,4.571529184029293
2023-04-11T13:30:00-04:00,283.21,284.18,282.37,282.91,277.6554006442924,NaN,NaN,NaN,NaN,NaN,273.6622,298.7778812497717,248.54651875022827,282.34945030172514,283.46364989723554,283.6616613356675,283.2656384588036,953247,981972.8666666667,51.445059270740124,61.90510774382732,NaN,NaN,NaN,NaN,4.182663056365278,32.980095419123636,79859938,-0.9393346015863511,3.397360932046354,4.336695533632705
2023-04-12T09:30:00-04:00,284.67,286.77,281.95,286.6,277.6554006442924,NaN,NaN,NaN,NaN,NaN,274.293,299.0904473686315,249.49555263136855,282.34945030172514,285.1066666666667,285.1066666666667,285.1066666666667,1842583,1020979.9333333333,56.3224131350935,61.08147961710637,NaN,NaN,NaN,NaN,4.228187123767757,31.450016993306402,81702521,-0.891171582021637,3.2227310561056584,4.113902638127295
2023-04-12T13:30:00-04:00,286.6,287.02,282.98,283.58,277.6554006442924,NaN,NaN,NaN,NaN,NaN,274.8806,299.132071678231,250.62912832176906,282.34945030172514,284.8678080798763,285.1532630777652,284.5823530819874,1290130,1047571.6,51.7414703869772,59.807851123601914,NaN,NaN,NaN,NaN,4.2147451863557714,30.08318210805229,80412391,-1.0445022573166702,2.8082748164814575,3.8527770737981277
2023-04-13T09:30:00-04:00,283.52,288.5,283.19,288.13,277.6554006442924,NaN,NaN,NaN,NaN,NaN,275.6024,299.2320039949921,251.9727960050079,282.34945030172514,286.6066666666667,286.6066666666667,286.6066666666667,1411657,1080169.4333333333,57.36751755770599,59.484369731343676,NaN,NaN,NaN,NaN,4.292977673044645,29.137396987864093,81824048,-0.8306070825771865,2.8145182205766446,3.645125303153831
2023-04-13T13:30:00-04:00,288.14,289.89,287.87,289.82,277.6554006442924,NaN,NaN,NaN,NaN,NaN,276.3244,299.435806416747,253.21299358325302,282.34945030172514,287.6930590359394,288.96972913762175,286.4163889342571,1022222,1079451.4666666666,59.26700162488545,59.07940869626002,NaN,NaN,NaN,NaN,4.130622124970026,28.55399512015571,82846270,-0.5783799948506596,2.9221503095905064,3.500530304441166
2023-04-14T09:30:00-04:00,286.83,288.48,284,284.32,277.6554006442924,NaN,NaN,NaN,NaN,NaN,276.9062,299.318241724039,254.49415827596098,282.34945030172514,285.59999999999997,285.59999999999997,285.59999999999997,1361298,1098562.9333333333,51.26216224162678,58.03636551416918,NaN,NaN,NaN,NaN,4.2512919731864525,26.892907803941,81484972,-0.7728801252470099,2.5344301478824036,3.3073102731294135
2023-04-14T13:30:00-04:00,284.31,286.43,283.7,286.16,277.6554006442924,NaN,NaN,NaN,NaN,NaN,277.58360000000005,299.0041082143266,256.1630917856735,280.03835390713306,285.52937872798,285.6131537372251,285.44560371873484,967376,1102517.7,53.52373568420994,57.267677420132166,NaN,NaN,NaN,NaN,4.142628260815993,25.2699987489773,82452348,-0.7670010006221188,2.3485590223517647,3.1155600229738836
2023-04-17T09:30:00-04:00,289.93,291.59,286.15,286.99,277.6554006442924,NaN,NaN,NaN,NaN,NaN,278.3446,298.29362632611753,258.3955736738825,280.8715572004521,288.24333333333334,288.24333333333334,288.24333333333334,1555221,1125988.6,54.548300683026056,57.07881099652456,NaN,NaN,NaN,NaN,4.235297670757708,24.89514732134138,84007569,-0.6985439243959055,2.2423801174790015,2.940924041874907
2023-04-17T13:30:00-04:00,286.97,288.8,286.44,288.79,277.6554006442924,NaN,NaN,NaN,NaN,NaN,279.1486,297.40454698064707,260.8926530193529,280.8715572004521,288.16838416982773,288.2773371919894,288.0594311476661,735948,1133205.8,56.77383407477018,56.95564474941178,NaN,NaN,NaN,NaN,4.101347837132159,24.54707099567945,84743517,-0.530957576690354,2.277227071011964,2.8081846477023182
2023-04-18T09:30:00-04:00,291.56,291.8,287.01,287.94,277.6554006442924,NaN,NaN,NaN,NaN,NaN,279.80740000000003,296.8682978943106,262.74650210568944,281.60119660828934,288.9166666666667,288.9166666666667,288.9166666666667,1418195,1160892.5333333334,55.39446195941543,56.36480593053249,NaN,NaN,NaN,NaN,4.150537277337006,24.79704681649087,83325322,-0.47793072474255416,2.2107712417741254,2.6887019665166796
2023-04-18T13:30:00-04:00,287.95,288.71,287.32,288.26,277.6554006442924,NaN,NaN,NaN,NaN,NaN,280.49420000000003,296.02773074610076,264.9606692538993,281.60119660828934,288.62488318404024,289.0174705692058,288.2322957988747,783402,1174294.3333333333,55.82955360317333,55.60883602727962,NaN,NaN,NaN,NaN,3.9533560432415045,25.029167221530045,84108724,-0.4237313330874981,2.159037800157307,2.5827691332448053
2023-04-19T09:30:00-04:00,285.7,289.05,284.545,288.46,277.6554006442924,NaN,NaN,NaN,NaN,NaN,281.084,295.50315892138366,266.66484107861635,281.60119660828934,287.3516666666667,287.3516666666667,287.3516666666667,1525883,1216660.3333333333,56.11765574108097,55.24391270301505,NaN,NaN,NaN,NaN,3.9927591830099685,24.355895935075385,85634607,-0.378330588168577,2.109855898034084,2.488186486202661
2023-04-19T13:30:00-04:00,288.45,288.93,287.76,288.45,277.6554006442924,NaN,NaN,NaN,NaN,NaN,281.641,294.96181994473585,268.3201800552642,281.60119660828934,287.65702618009396,288.1268845990386,287.18716776114934,644481,1230726.3666666667,56.09795346509757,54.82668256838593,NaN,NaN,NaN,NaN,3.791133527080686,23.73071545479606,84990126,-0.35336406409846566,2.046481406079579,2.3998454701780445
2023-04-20T09:30:00-04:00,285.25,289.02,285.18,288.74,277.6554006442924,NaN,NaN,NaN,NaN,NaN,282.1334,294.6212837983123,269.6455162016877,281.60119660828934,287.6466666666667,287.6466666666667,287.6466666666667,1422231,1264548.4666666666,56.57410841430053,55.16180198872168,NaN,NaN,NaN,NaN,3.794623989432064,22.36701285224381,86412357,-0.32256341290108814,1.9966412040516843,2.3192046169527725
2023-04-20T13:30:00-04:00,288.74,288.88,285.08,286.11,277.6554006442924,NaN,NaN,NaN,NaN,NaN,282.547,294.13180746495385,270.9621925350462,281.60119660828934,287.22115901185606,287.6965664428428,286.7457515808693,1139339,1290365.9,51.15538111348295,55.141110691774735,NaN,NaN,NaN,NaN,3.7950079901869174,21.07124405855123,85273018,-0.4753330559593776,1.7250382970035503,2.200371352962928
2023-04-21T09:30:00-04:00,285.08,285.94,283.07,285.13,277.6554006442924,NaN,NaN,NaN,NaN,NaN,282.7606,294.13223587880424,271.3889641211958,281.60119660828934,284.7133333333333,284.7133333333333,284.7133333333333,1432703,1316533.2666666666,49.26196394903763,54.63679289277075,NaN,NaN,NaN,NaN,3.7410788480307104,19.849775624304677,83840315,-0.6287700404968368,1.4144088023418817,2.0431788428387185
2023-04-21T13:30:00-04:00,285.11,286.27,285,285.77,277.6554006442924,NaN,NaN,NaN,NaN,NaN,282.9554,294.1920701188636,271.71872988113637,281.60119660828934,285.0234338305731,285.47465605480335,284.5722116063428,676675,1325549.7666666666,50.54922511660992,54.55163251631594,NaN,NaN,NaN,NaN,3.5645732160285157,18.613704588897786,84516990,-0.6697641719788106,1.2059736278652053,1.875737799844016
2023-04-24T09:30:00-04:00,282.1,284.95,278.73,280.49,277.6554006442924,NaN,NaN,NaN,NaN,NaN,282.9664,294.1923127094455,271.74048729055454,281.60119660828934,281.39000000000004,281.39000000000004,281.39000000000004,2068303,1328511.6,41.250893911329094,53.40044511300331,NaN,NaN,NaN,NaN,3.8128179863121905,18.99129314461886,82448687,-1.0144063632071478,0.607729845835081,1.6221362090422289
2023-04-24T13:30:00-04:00,280.5,281.98,280.28,281.82,277.6554006442924,NaN,NaN,NaN,NaN,NaN,283.0144,294.19969760712803,271.829102392872,281.60119660828934,281.38069025779674,281.3945690533539,281.3668114622396,930649,1309676.3666666667,44.04309441376722,52.31302316935201,NaN,NaN,NaN,NaN,3.661902415861323,19.341911089217003,83379336,-1.1071557673557242,0.2381914998475736,1.3453472672032978
2023-04-25T09:30:00-04:00,279.36,281.6,277,278.35,NaN,NaN,NaN,290.9794104547745,290.9794104547745,290.9794104547745,283.1604,293.89885423513806,272.4219457648619,280.87641266344417,278.98333333333335,278.98333333333335,278.98333333333335,2225822,1320892.7333333334,38.85450573272383,51.426761990144655,NaN,NaN,NaN,NaN,3.7446236718712282,20.305339073085232,81153514,-1.3409629298867485,-0.33085639515513776,1.0101065347316107
2023-04-25T13:30:00-04:00,278.37,278.49,275.37,275.56,NaN,NaN,NaN,288.5039827068302,NaN,NaN,283.228,293.72904147216497,272.72695852783505,280.87641266344417,277.9496909287693,279.18501510279634,276.7143667547423,1558365,1334886.4333333333,35.2579417760807,50.12206242527828,NaN,NaN,NaN,NaN,3.7000076953089978,21.48345472099498,79595149,-1.6044734676589927,-0.9954852998421302,0.6089881678168625
2023-04-26T09:30:00-04:00,296.705,299.57,292.75,297.22,281.8380165071166,281.8380165071166,281.8380165071166,NaN,NaN,NaN,283.7418,294.41562494891724,273.0679750510828,280.87641266344417,296.5133333333333,296.5133333333333,296.5133333333333,5486716,1457133.9,63.50300090097375,50.7616838694174,NaN,NaN,NaN,NaN,5.150721431358355,21.731621820312853,85081865,-0.3087890478355474,0.22300185802242822,0.5317909058579756
2023-04-26T13:30:00-04:00,297.23,297.3,294.61,295.35,281.917197574975,NaN,NaN,NaN,NaN,NaN,284.173,294.9453611153785,273.4006388846215,280.69064535859036,296.3393723214217,296.65866518915504,296.02007945368837,1628688,1482530.2,61.02757496632138,51.0655225045282,NaN,NaN,NaN,NaN,4.9749556148327585,21.962062698250875,83453177,0.3953208095507297,1.0259419177963878,0.6306211082456581
2023-04-27T09:30:00-04:00,295.75,303.68,295.25,303.25,284.9157340488398,NaN,NaN,NaN,NaN,NaN,284.69680000000005,296.5295203567055,272.8640796432946,286.1775162868723,300.7266666666667,300.7266666666667,300.7266666666667,4022235,1560944.7333333334,66.89812105623591,51.88721244001538,NaN,NaN,NaN,NaN,5.221744499487563,22.909234999602372,87475412,1.3143301491030153,2.273533794624427,0.9592036455214119
2023-04-27T13:30:00-04:00,303.23,305.22,302.68,304.72,289.7157006829834,NaN,NaN,NaN,NaN,NaN,285.3458,297.91754297542457,272.7740570245754,289.9480130294978,301.8486075174858,303.4751384542059,300.2220765807657,1913739,1593971.9,67.86803517534827,52.747103980885015,NaN,NaN,NaN,NaN,5.0301913209527385,23.947623970051065,89389151,1.9065151299928977,3.342347558012534,1.4358324280196364
2023-04-28T09:30:00-04:00,304.15,308.93,303.32,305.67,291.7727142883023,NaN,NaN,NaN,NaN,NaN,285.86960000000005,299.5533310467601,272.18586895324,293.90741042359826,305.97333333333336,305.97333333333336,305.97333333333336,2798601,1642330.4333333333,68.51019272373085,53.63228519393143,NaN,NaN,NaN,NaN,5.0716062265989725,25.277311119965525,92187752,2.2252791004608303,4.217431303595674,1.992152203134844
2023-04-28T13:30:00-04:00,305.66,307.42,304.83,307.32,292.0719090933795,NaN,NaN,NaN,NaN,NaN,286.4634,301.2015272134629,271.72527278653706,294.10692833887856,306.13012238464904,306.37841892425035,305.88182584504773,1115915,1624620.9333333333,69.64489284595423,54.59992372113548,NaN,NaN,NaN,NaN,4.894348638984762,26.512020616314665,93303667,2.395558448051843,4.986600263199648,2.591041815147805
2023-05-01T09:30:00-04:00,306.98,308.6,305.77,307.6,293.38477686186224,NaN,NaN,NaN,NaN,NaN,287.04540000000003,302.746505291034,271.34429470896606,296.5345426711029,307.3233333333333,307.3233333333333,307.3233333333333,1483165,1616102.9666666666,69.84347997314892,55.54773597533893,NaN,NaN,NaN,NaN,4.746895164771567,27.778695923221253,94786832,2.370954024169736,5.554734345359975,3.183780321190239
2023-05-01T13:30:00-04:00,307.62,307.98,305.15,305.57,293.38477686186224,NaN,NaN,NaN,NaN,NaN,287.54540000000003,303.965604242338,271.1251957576621,296.9126341368823,306.9505307907902,307.46761205674716,306.43344952483324,770956,1617564.1666666667,66.4493181682742,56.64016005068116,NaN,NaN,NaN,NaN,4.6099740815736014,28.786926702705923,94015876,2.072667345176605,5.774614502660995,3.70194715748439
2023-05-02T09:30:00-04:00,307.77,309.15,303.91,306.11,293.38477686186224,NaN,NaN,NaN,NaN,NaN,288.1442,305.03823543976813,271.2501645602319,297.6761073095058,306.39,306.39,306.39,2021565,1606910.3333333333,66.90998405557337,57.900732915433714,NaN,NaN,NaN,NaN,4.654975932889769,29.37933424195993,96037441,1.7777659792686622,5.924154631570218,4.146388652301556
2023-05-02T13:30:00-04:00,306.12,306.65,305.18,305.42,293.38477686186224,NaN,NaN,NaN,NaN,NaN,288.728,305.94907871186155,271.50692128813847,297.6761073095058,306.2306576583404,306.50740504642584,305.953910270255,670167,1597474.3333333333,65.66922737004691,58.9807330763935,NaN,NaN,NaN,NaN,4.4274776519690695,29.92942695698151,95367274,1.4178980641528458,5.9187612324926135,4.500863168339768
2023-05-03T09:30:00-04:00,306.75,307.53,304.27,307.23,293.38477686186224,NaN,NaN,NaN,NaN,NaN,289.40680000000003,306.81489716884994,271.9987028311501,297.9687086780837,306.3433333333333,306.3433333333333,306.3433333333333,1264273,1578197.3333333333,67.37813523329355,60.84696459939096,NaN,NaN,NaN,NaN,4.344086391114135,30.165466593397,96631547,1.1924877284132505,5.991472828856331,4.798985100443081
2023-05-03T13:30:00-04:00,307.24,308.63,304.1,304.41,293.38477686186224,NaN,NaN,NaN,NaN,NaN,289.98980000000006,307.41619996786534,272.5634000321348,298.715966942467,306.0136421625017,306.3282993879049,305.6989849370985,1387970,1581458.6666666667,62.18448907653534,62.142778503874396,NaN,NaN,NaN,NaN,4.357365934605981,30.552715561825384,95243577,0.7649754765986891,5.755204446191442,4.990228969592753
2023-05-04T09:30:00-04:00,306.39,307.73,303.39,307.5,293.38477686186224,NaN,NaN,NaN,NaN,NaN,290.53800000000007,308.4032010344133,272.6727989655868,298.715966942467,306.2066666666667,306.2066666666667,306.2066666666667,1765088,1593239.7,65.33737910085452,64.03441231588373,NaN,NaN,NaN,NaN,4.356125510705556,30.68072950265716,97008665,0.6086194171362393,5.751003241013052,5.142383823876813
2023-05-04T13:30:00-04:00,307.51,307.76,305.13,305.51,293.5827067232651,NaN,NaN,NaN,NaN,NaN,291.0368000000001,309.1518264432573,272.9217735567429,298.715966942467,306.17896059167015,306.2145155102257,306.1434056731146,1071808,1594892.5666666667,61.76575391279676,65.92782746850631,NaN,NaN,NaN,NaN,4.232830831369444,30.804851877085817,95936857,0.3048343499184174,5.523426761274834,5.218592411356417
2023-05-05T09:30:00-04:00,305.835,310,304.29,309.98,294.08872005402577,NaN,NaN,NaN,NaN,NaN,291.6014000000001,310.2745653492361,272.9282346507641,299.6282150745431,308.09,308.09,308.09,1735767,1607374.8666666667,66.23114619623885,66.12269498959664,NaN,NaN,NaN,NaN,4.338342914843054,31.30808018628666,97672624,0.336135881135597,5.638762262775913,5.302626381640316
2023-05-05T13:30:00-04:00,309.97,311.97,309.71,310.67,298.06900550611556,NaN,NaN,NaN,NaN,NaN,292.1330000000001,311.4237216039198,272.8422783960804,302.5425720596345,309.23808902768366,310.5700342339066,307.9061438214607,1289644,1618117.1333333333,66.8742761169008,66.54031650035232,NaN,NaN,NaN,NaN,4.189889849497125,32.089381713571704,98962268,0.33382543165876655,5.719908171213774,5.3860827395550075
2023-05-08T09:30:00-04:00,310.07,310.28,306.68,307.33,298.06900550611556,NaN,NaN,NaN,NaN,NaN,292.5528000000001,312.2306608756106,272.8749391243896,302.5425720596345,308.09666666666664,308.09666666666664,308.09666666666664,1811374,1626655.5666666667,60.8345815103303,66.10720653278763,NaN,NaN,NaN,NaN,4.175612003104474,31.749266462832576,97150894,0.052622720564772685,5.451861140260974,5.399238419696201
2023-05-08T13:30:00-04:00,307.35,308.85,306.08,308.64,298.06900550611556,NaN,NaN,NaN,NaN,NaN,292.96100000000007,313.10450049023297,272.8174995097672,302.5425720596345,308.00988894641716,308.1251984437392,307.89457944909515,1025875,1636319.8,62.27374168236485,65.70761414043167,NaN,NaN,NaN,NaN,4.075211145739872,31.234484430878556,98176769,-0.09201094736141435,5.284224735494433,5.376235682855848
2023-05-09T09:30:00-04:00,308,310.03,306.61,308.17,298.06900550611556,NaN,NaN,NaN,NaN,NaN,293.4412000000001,313.86537024605826,273.0170297539419,302.5425720596345,308.27,308.27,308.27,1298718,1632337.2333333334,61.40197563442504,65.1998843483384,NaN,NaN,NaN,NaN,4.0284103496155925,30.99514007011018,96878051,-0.2568495789781071,5.055173709133214,5.312023288111321
2023-05-09T13:30:00-04:00,308.18,308.3,306.31,306.93,298.06900550611556,NaN,NaN,NaN,NaN,NaN,293.8372000000001,314.52267279227357,273.15172720772665,302.5425720596345,307.83036228824557,308.365080707797,307.2956438686941,877919,1635487.8,59.05317189200144,64.44333285162749,NaN,NaN,NaN,NaN,3.8828096103573366,30.663472116466668,96000132,-0.4742653659422915,4.719191580683457,5.193456946625749
2023-05-10T09:30:00-04:00,308.74,311.58,307.69,309.51,298.06900550611556,NaN,NaN,NaN,NaN,NaN,294.2660000000001,315.3407097726161,273.19129022738406,302.74914841250103,309.5933333333333,309.5933333333333,309.5933333333333,1995958,1651156.9666666666,62.2857742525024,63.903496728724164,NaN,NaN,NaN,NaN,3.9376089239032397,31.005741715708623,97996090,-0.46837377798782764,4.607989724140964,5.076363502128792
2023-05-10T13:30:00-04:00,309.49,313,309.38,312.29,299.03285015479617,NaN,NaN,NaN,NaN,NaN,294.7666000000001,316.33517514440814,273.19802485559205,304.1253187300008,310.38476304229806,311.34782033258585,309.42170575201027,1347944,1674605.7333333334,65.45081697024264,63.83217521457906,NaN,NaN,NaN,NaN,3.914922572195866,31.57477688521549,99344034,-0.30899524904725073,4.690119440819728,4.999114689866979
2023-05-11T09:30:00-04:00,310.145,310.31,306.27,309.52,299.03285015479617,NaN,NaN,NaN,NaN,NaN,295.2896000000001,316.9951694087925,273.58403059120775,304.1253187300008,308.7,308.7,308.7,2219991,1701197.7333333334,60.04374890860711,63.341729846938605,NaN,NaN,NaN,NaN,4.06528524561045,30.972699847807256,97124043,-0.41525273639248983,4.480048769376367,4.895301505768857
2023-05-11T13:30:00-04:00,309.51,311.11,308.76,310.09,299.03285015479617,NaN,NaN,NaN,NaN,NaN,295.8034000000001,317.6692011003461,273.9375988996542,304.1253187300008,309.05149129929356,309.6248201795603,308.47816241902683,834397,1691033,60.76209274662957,62.991220230980225,NaN,NaN,NaN,NaN,3.9427648709239906,30.581517528579163,97958440,-0.4683380973178153,4.309878884121588,4.778216981439403
2023-05-12T09:30:00-04:00,310.54,310.65,306.87,307.91,299.03285015479617,NaN,NaN,NaN,NaN,NaN,296.1844000000001,318.21622540235796,274.15257459764223,304.1253187300008,308.4766666666667,308.4766666666667,308.4766666666667,1398488,1689892.5,56.572971332448056,62.21942280949126,NaN,NaN,NaN,NaN,3.9311388087151324,29.571135626310372,96559952,-0.6597445154190069,3.9535363371656445,4.613280852584651
2023-05-12T13:30:00-04:00,307.95,309.23,306.6,309.02,299.03285015479617,NaN,NaN,NaN,NaN,NaN,296.5332000000001,318.8132102118462,274.253189788154,304.1253187300008,308.4065920798438,308.49952918606573,308.31365497362185,795063,1693838.7666666666,58.154896864922286,61.931594794376046,NaN,NaN,NaN,NaN,3.838200322378337,28.541565934276353,97355015,-0.7163502465495757,3.717843044397682,4.434193290947258
2023-05-15T09:30:00-04:00,309.09,309.9,307.6,309.02,299.03285015479617,NaN,NaN,NaN,NaN,NaN,296.9386000000001,319.3744823352202,274.50271766478005,304.1253187300008,308.84,308.84,308.84,1074016,1660695.8666666667,58.154896864922286,61.41856034895232,NaN,NaN,NaN,NaN,3.728328870779881,27.758360936194048,97355015,-0.7547030523707878,3.4908144754837735,4.245517527854561
2023-05-15T13:30:00-04:00,309.01,309.59,308.38,309.48,299.03285015479617,NaN,NaN,NaN,NaN,NaN,297.3406000000001,319.9400412001692,274.741158799831,304.1253187300008,308.94377649604894,309.0900678239734,308.79748516812447,540470,1647689.9,58.874904430914064,61.21207110024641,NaN,NaN,NaN,NaN,3.548448237152745,27.03109915226048,97895485,-0.7485285144966625,3.3098568847337333,4.058385399230396
2023-05-16T09:30:00-04:00,309.78,313.71,309.78,312.76,300.3318760078359,NaN,NaN,NaN,NaN,NaN,297.9316000000001,320.5675082380165,275.29569176198373,305.8923430025259,312.0833333333333,312.0833333333333,312.0833333333333,1868801,1635789.2,63.67450068353241,61.02945356362452,NaN,NaN,NaN,NaN,3.597130505927546,27.350795442912446,99764286,-0.5330969198484867,3.3920142494197876,3.9251111692682743
2023-05-16T13:30:00-04:00,312.76,313.46,311.715,311.77,301.4551998256615,NaN,NaN,NaN,NaN,NaN,298.50880000000006,321.05475152660557,275.96284847339456,306.3333744020207,312.1589727132349,312.267608836253,312.05033659021683,905963,1614042.4666666666,61.347271928657655,60.63466755017858,NaN,NaN,NaN,NaN,3.4648354697898647,27.647656284232124,98858323,-0.46908672495918413,3.3387527630692944,3.8078394880284785
2023-05-17T09:30:00-04:00,312.2,313.8,310.74,313.72,301.4551998256615,NaN,NaN,NaN,NaN,NaN,299.05120000000005,321.7295603075715,276.3728396924286,306.56869952161657,312.75333333333333,312.75333333333333,312.75333333333333,1370448,1476833.5333333334,64.12832503548611,60.86993494483256,NaN,NaN,NaN,NaN,3.43591865051916,27.506912338182154,100228771,-0.3146469749500178,3.4145307693409563,3.729177744290974
2023-05-17T13:30:00-04:00,313.72,314.43,313.07,313.99,303.02296616346433,NaN,NaN,NaN,NaN,NaN,299.65940000000006,322.2764991632425,277.04230083675765,307.9649596172933,313.18554533912015,313.71331521476674,312.65777546347357,919109,1453180.9,64.50909270753496,61.02960287520185,NaN,NaN,NaN,NaN,3.287638746910649,27.535080261722655,101147880,-0.2181202497097008,3.456527432153848,3.674647681863549
2023-05-18T09:30:00-04:00,314.59,318,313.75,316.63,305.0560131560341,NaN,NaN,NaN,NaN,NaN,300.22940000000006,323.0907103421485,277.3680896578516,310.7029676938346,316.12666666666667,316.12666666666667,316.12666666666667,1898161,1382378.4333333333,68.07717288701025,61.50640267895794,NaN,NaN,NaN,NaN,3.3563788364170315,28.356455536264967,103046041,-0.011207373454523495,3.6606384650453947,3.671845838499918
2023-05-18T13:30:00-04:00,316.59,319.05,316.1,318.555,306.8455125580326,NaN,NaN,NaN,NaN,NaN,300.80410000000006,324.03158696609387,277.57661303390626,311.7373741550677,316.7879352515235,317.6461168155387,315.9297536875083,1127017,1356154.3666666667,70.41294631345602,62.31781513763327,NaN,NaN,NaN,NaN,3.327351776672957,29.322215526089074,104173058,0.20844260308257478,3.932399092353137,3.723956489270562
2023-05-19T09:30:00-04:00,316.77,318.67,316.37,318.08,306.9645801690311,NaN,NaN,NaN,NaN,NaN,301.4793000000001,324.7135648697987,278.2450351302015,311.7373741550677,317.7066666666666,317.7066720614632,317.70666127186996,1765019,1321701.6333333333,69.06997654901835,62.802401015955844,NaN,NaN,NaN,NaN,3.2539695069106034,30.218992659497168,102408039,0.27092405657476837,4.062611559989023,3.7916875034142543
2023-05-19T13:30:00-04:00,318.07,318.75,317.27,318.33,307.7325537977115,NaN,NaN,NaN,NaN,NaN,302.12270000000007,325.40609367102604,278.8393063289741,312.4099194592433,317.8294866319427,318.0172935590889,317.6416797047965,754856,1309666.3333333333,69.40076879107153,63.08454043172934,NaN,NaN,NaN,NaN,3.127257399274133,31.06874993175396,103162895,0.27727025918558024,4.138275327396229,3.861005068210649
2023-05-22T09:30:00-04:00,318.47,322.6,318,320.67,309.8624377159974,NaN,NaN,NaN,NaN,NaN,302.79630000000003,326.2377541195727,279.3548458804274,315.22793556739464,320.42333333333335,320.42333333333335,320.42333333333335,1587740,1313152.1666666667,72.37848369296125,63.96559291632605,NaN,NaN,NaN,NaN,3.2324532993259822,32.5828932659232,104750635,0.3808462580091678,4.337062890722109,3.956216632712941
2023-05-22T13:30:00-04:00,320.69,321.6,320.58,321.23,310.98778145617933,NaN,NaN,NaN,NaN,NaN,303.4451000000001,327.0947933164033,279.79540668359687,315.22793556739464,320.6468364540918,320.97771193092996,320.3159609772536,724465,1311602.4666666666,73.05428520761065,64.84360666353898,NaN,NaN,NaN,NaN,3.0744209208027007,33.98888350479463,105475100,0.4254709171805162,4.488055279188586,4.06258436200807
2023-05-23T09:30:00-04:00,320.235,322.71,316.92,317.37,310.98778145617933,NaN,NaN,NaN,NaN,NaN,304.0337,327.5751904209589,280.4922095790411,315.22793556739464,319,319,319,1846622,1305771.0333333334,61.82570855056882,65.21880217911904,NaN,NaN,NaN,NaN,3.2683908550310763,33.532254065910536,103628478,0.14776291200432556,4.247288002013477,4.099525090009151
2023-05-23T13:30:00-04:00,317.35,317.5,315.25,315.29,310.98778145617933,NaN,NaN,NaN,NaN,NaN,304.57430000000005,327.8823319212073,281.2662680787928,315.22793556739464,317.7860386650133,319.25300687563157,316.319070454395,1264580,1325584.8,56.76276303791397,65.11936404861845,NaN,NaN,NaN,NaN,3.195648651100285,32.4361370666623,102363898,-0.20416039001184938,3.844324602494339,4.0484849925061885
2023-05-24T09:30:00-04:00,314.77,316.5,312.61,313.73,310.98778145617933,NaN,NaN,NaN,NaN,NaN,305.07970000000006,328.06176103986274,282.0976389601374,315.22793556739464,314.28000000000003,314.28000000000003,314.28000000000003,1431946,1331173.9,53.241257296066664,64.7683897937002,NaN,NaN,NaN,NaN,3.2452451760216925,30.476691850501492,100931952,-0.5505014932693024,3.3603581259195607,3.910859619188863
2023-05-24T13:30:00-04:00,313.74,315.32,313.4,313.88,310.98778145617933,NaN,NaN,NaN,NaN,NaN,305.58830000000006,328.19830447677896,282.97829552322116,315.22793556739464,314.25214582992885,314.2902572297779,314.2140344300798,764887,1310404.4666666666,53.53972544313124,64.38730558028713,NaN,NaN,NaN,NaN,3.1505848063058584,28.657207006923596,101696839,-0.764805100169287,2.9548532439772544,3.7196583441465414
2023-05-25T09:30:00-04:00,323.19,325.59,320.01,325.4,311.5418889887681,NaN,NaN,NaN,NaN,NaN,306.32150000000007,329.07568715313585,283.5673128468643,315.22793556739464,323.66666666666663,323.66666666666663,323.66666666666663,2928189,1349174.5,69.59278248136991,64.81003999441837,NaN,NaN,NaN,NaN,3.7619716058554387,29.239237389625643,104625028,-0.157766030015833,3.5224508066267504,3.6802168366425834
2023-05-25T13:30:00-04:00,325.41,326.9,324.5,325.92,314.62634858018777,NaN,NaN,NaN,NaN,NaN,307.1177,329.7730528518119,284.46234714818814,316.3165989931033,324.3238057824747,325.29978798166513,323.3478235832843,1327486,1357697.1,70.09507219354602,65.43488287048184,NaN,NaN,NaN,NaN,3.6646879197229056,29.978145840897685,105952514,0.23061800562175216,3.9684893436697735,3.7378713380480213
2023-05-26T09:30:00-04:00,324,332.97,323.86,331.88,316.60242364472475,NaN,NaN,NaN,NaN,NaN,308.0527,330.8593901772283,285.2460098227717,319.94827919448267,329.57,329.57,329.57,2885712,1396028.6,75.15984049024675,66.2228482601076,NaN,NaN,NaN,NaN,4.053638782599842,31.44068306996264,108838226,0.8082360348385027,4.74816638159615,3.939930346757647
2023-05-26T13:30:00-04:00,331.88,333.4,331.32,332.86,320.80072256996453,NaN,NaN,NaN,NaN,NaN,308.9945,331.93154080739447,286.05745919260556,321.9426233555861,330.54535046121475,331.9354863088249,329.1552146136046,1420561,1400392.5,75.88311399090381,67.0352783517768,NaN,NaN,NaN,NaN,3.912664583842709,32.8466707551815,110258787,1.1545284743741844,5.383090939725378,4.228562465351193
2023-05-30T09:30:00-04:00,335.23,335.74,330.585,331.6,321.42568972587526,NaN,NaN,NaN,NaN,NaN,310.01670000000007,332.3283211522151,287.70507884778505,323.9965986844689,332.6416666666667,332.6416666666667,332.6416666666667,2209552,1413665.1,72.94237014353119,67.3827924415283,NaN,NaN,NaN,NaN,4.001402827853946,34.40888178301723,108049235,1.1920943230358452,5.718680369146,4.526586046110155
2023-05-30T13:30:00-04:00,331.6,333.09,330.53,331.21,321.42568972587526,NaN,NaN,NaN,NaN,NaN,311.0045,332.5969433309458,289.4120566690542,323.9965986844689,332.2814611048583,332.7732578357058,331.7896643740108,1185315,1418979.7666666666,72.01212708711567,67.49701963964684,NaN,NaN,NaN,NaN,3.8984454830072357,35.838979766476584,106863920,1.0869914051274794,5.8853253025195045,4.798333897392025
2023-05-31T09:30:00-04:00,332.335,335.93,327.34,330.16,321.42568972587526,NaN,NaN,NaN,NaN,NaN,312.0407,332.18984668267717,291.89155331732286,323.9965986844689,331.1433333333334,331.1433333333334,331.1433333333334,2175874,1448218.3,69.44431841486346,67.52375834435006,NaN,NaN,NaN,NaN,4.233556519935292,36.020225362050034,104688046,0.8533790055097041,5.8650576542791555,5.011678648769451
2023-05-31T13:30:00-04:00,330.17,331.31,328.48,328.68,321.42568972587526,NaN,NaN,NaN,NaN,NaN,313.10310000000004,330.9119552007141,295.294244799286,323.9965986844689,330.4773396322769,331.28824158434384,329.6664376802099,1467700,1467877.6666666667,65.87851090211143,67.27216849513863,NaN,NaN,NaN,NaN,4.133302482797056,36.18852484365395,103220346,0.5220790815969583,5.66427750076565,5.142198419168691
2023-06-01T09:30:00-04:00,326.025,331.34,324.71,330.55,321.42568972587526,NaN,NaN,NaN,NaN,NaN,313.7697,331.64559487662405,295.89380512337596,323.9965986844689,328.8666666666666,328.8666666666666,328.8666666666666,1626584,1455565.2,68.10685904266437,66.96705244868885,NaN,NaN,NaN,NaN,4.311638019740124,35.11212297778704,104846930,0.35951704939323115,5.591594730910231,5.232077681517
2023-06-01T13:30:00-04:00,330.56,333.53,330.49,332.59,321.42568972587526,NaN,NaN,NaN,NaN,NaN,314.5145,332.36168961069404,296.66731038930595,323.9965986844689,330.20108344969594,331.8356585775357,328.5665083218562,1084051,1446768.7666666666,70.37945075361266,66.77599284483185,NaN,NaN,NaN,NaN,4.220806732615826,34.520383281855175,105930981,0.32126801983618947,5.633662706312236,5.312394686476047
2023-06-02T09:30:00-04:00,334.01,337.49,332.54,334.53,322.6574701810946,NaN,NaN,NaN,NaN,NaN,315.14009999999996,333.5481193926517,296.7320806073482,325.69579540554145,334.8533333333333,334.8533333333333,334.8533333333333,1666548,1428320.6666666667,72.39402579733115,67.53087264817201,NaN,NaN,NaN,NaN,4.272891966000409,34.61652173932938,107597529,0.3558270481431176,5.757178496654944,5.401351448511827
2023-06-02T13:30:00-04:00,334.57,336.75,334.12,335.28,323.2805397183176,NaN,NaN,NaN,NaN,NaN,315.7513,334.7545598056239,296.74804019437613,325.99963632443314,335.03552073550406,335.2872489096174,334.7837925613907,872953,1429605.8666666667,73.1541962252003,68.70168930440674,NaN,NaN,NaN,NaN,4.155542539857523,34.70579316412685,108470482,0.3574550934606622,5.848170315337654,5.490715221876992
2023-06-05T09:30:00-04:00,335.26,338.55,334.7,337.65,324.4980151856668,NaN,NaN,NaN,NaN,NaN,316.3909,336.13225676087626,296.6495432391237,328.0247090595465,336.96666666666664,336.96666666666664,336.96666666666664,1014873,1416818.7,75.45433704510867,70.28833785790974,NaN,NaN,NaN,NaN,4.133718072724844,35.0687537114496,109485355,0.4409271947147353,6.041874215270411,5.600947020555676
2023-06-05T13:30:00-04:00,337.66,337.92,335.77,335.92,324.9760599499547,NaN,NaN,NaN,NaN,NaN,316.9629,337.26907621218214,296.65672378781784,328.4247672476372,336.7797944404641,336.99294656528616,336.56664231564207,780049,1416318.2333333334,70.69291843050694,71.51356592843658,NaN,NaN,NaN,NaN,3.9920239246730715,35.40578850539215,108705306,0.30866443524855924,5.986777564616375,5.678113129367816
2023-06-06T09:30:00-04:00,335.49,335.49,332.17,333.2,324.9760599499547,NaN,NaN,NaN,NaN,NaN,317.4749,338.0994140054281,296.85038599457187,328.4247672476372,333.62000000000006,333.62000000000006,333.62000000000006,1454160,1428989.7,63.86877383206035,71.1047081677716,NaN,NaN,NaN,NaN,3.9747365014821376,34.478675764441704,107251146,-0.015766318897055598,5.658405230746496,5.674171549643551
2023-06-06T13:30:00-04:00,333.22,334.34,332.47,333.66,324.9760599499547,NaN,NaN,NaN,NaN,NaN,318.0367,338.8628030065669,297.2105969934331,328.4247672476372,333.57921610130506,333.6395367478352,333.5188954547749,664749,1433132.3333333333,64.4930253267865,70.70456196300309,NaN,NaN,NaN,NaN,3.824398179947696,33.617785362130576,107915895,-0.24066094739612698,5.373345365398393,5.61400631279452
2023-06-07T09:30:00-04:00,331.52,334.49,323.5,324.2,NaN,NaN,NaN,341.52587939551745,341.52587939551745,341.52587939551745,318.3985,339.01068515829974,297.7863148417003,328.4247672476372,327.3966666666667,327.39667048136397,327.39666285196944,2973343,1469950.4,46.644708631969095,68.66776683026897,NaN,NaN,NaN,NaN,4.3362268813800044,31.92419503404794,104942552,-1.0239016227199533,4.334129284394578,5.358030907114531
2023-06-07T13:30:00-04:00,324.24,324.82,322.5,323.46,NaN,NaN,NaN,335.9376576048121,NaN,NaN,318.75929999999994,339.0796261794761,298.43897382052376,328.4247672476372,326.0817998350061,327.8906674544765,324.2729322155357,1571068,1492120.5666666667,45.58202642579483,66.50340343276119,NaN,NaN,NaN,NaN,4.192210675567146,30.54935309318768,103371484,-1.5572203053865383,3.411505525381358,4.968725830767896
2023-06-08T09:30:00-04:00,323.935,326.64,323.35,324.31,NaN,NaN,NaN,335.9376576048121,NaN,NaN,319.1009,339.20760870033183,298.9941912996682,328.4247672476372,324.76666666666665,324.76666666666665,324.76666666666665,1440029,1494439.9333333333,47.07360196317154,64.6556342770212,NaN,NaN,NaN,NaN,4.127767055883776,28.815442531903795,104811513,-1.8009159726970339,2.717580864896604,4.518496837593638
2023-06-08T13:30:00-04:00,324.32,325.95,323.5,325.23,NaN,NaN,NaN,335.9376576048121,NaN,NaN,319.5173,339.2486366207178,299.7859633792822,328.4247672476372,324.8056814842081,324.86415986399464,324.74720310442154,640973,1485168.7333333334,48.71219309636361,62.991353277681775,NaN,NaN,NaN,NaN,4.007926551892077,27.205382724997328,105452486,-1.841734727087288,2.2163284287345277,4.058063155821816
2023-06-09T09:30:00-04:00,324.99,329.98,324.42,327.71,NaN,NaN,NaN,335.9376576048121,NaN,NaN,319.9215,339.4788137470394,300.36418625296056,328.4247672476372,327.37000000000006,327.37000000000006,327.37000000000006,1635267,1476405.6,52.94164008289524,61.812590539684045,NaN,NaN,NaN,NaN,4.118788941042643,25.78050627124358,107087753,-1.6495011347399346,1.9961867373968971,3.6456878721368318
2023-06-09T13:30:00-04:00,327.7,328.48,326.26,326.86,NaN,NaN,NaN,335.9376576048121,NaN,NaN,320.34849999999994,339.5577509224145,301.13924907758536,328.4247672476372,327.3241945714457,327.39961861008345,327.2487705328079,603119,1458942.3333333333,51.37778410462798,60.77682433986381,NaN,NaN,NaN,NaN,3.9831611595395993,24.457406707043674,106484634,-1.5300253227605132,1.7331562186861902,3.2631815414467034
2023-06-12T09:30:00-04:00,328.43,329.08,325.16,328.2,NaN,NaN,NaN,335.9376576048121,NaN,NaN,320.7129,339.81251759722096,301.613282402779,328.4247672476372,327.48,327.48,327.48,1138300,1438051.7,53.699736858982234,59.7477441838865,NaN,NaN,NaN,NaN,3.978649648143911,22.93197797679724,107622934,-1.3191678764879993,1.6142216958367044,2.9333895723247037
2023-06-12T13:30:00-04:00,328.25,332.1,328.18,331.91,NaN,NaN,NaN,335.9376576048121,NaN,NaN,321.1377,340.26973566900557,302.0056643309944,326.01881379810976,328.98690504909626,330.6076081627527,327.36620193543985,984060,1445691.8333333333,59.47062123412537,58.968542075351706,NaN,NaN,NaN,NaN,3.974460387562204,22.22689458977299,108606994,-0.9078331742774965,1.7985981044778327,2.7064312787553293
2023-06-13T09:30:00-04:00,334.33,336.98,330.4,333.9,321.4332876656397,321.4332876656397,321.4332876656397,NaN,NaN,NaN,321.6691,340.7133417218452,302.6248582781548,326.0203250183339,333.76,333.76,333.76,1666618,1448321.1,62.19268678303017,58.23987500290163,NaN,NaN,NaN,NaN,4.160570359879193,22.514364962501514,110273612,-0.5001033030496025,2.081302149943326,2.5814054529929287
2023-06-13T13:30:00-04:00,333.94,334.49,332.78,334.35,321.7022291353833,NaN,NaN,NaN,NaN,NaN,322.1833,341.18091454604604,303.1856854539539,326.0203250183339,333.7967555260947,333.8498088729054,333.74370217928407,799937,1450836.8333333333,62.801105803772174,57.50036854422819,NaN,NaN,NaN,NaN,3.9855296198878247,22.781301737178,111073549,-0.21314610932684275,2.3149728163343752,2.528118925661218
2023-06-14T09:30:00-04:00,334.2,339.04,333.59,336.84,324.18144599286586,NaN,NaN,NaN,NaN,NaN,322.75669999999997,341.75853965936113,303.7548603406388,328.61680801173367,336.49,336.49,336.49,1522270,1440025.1,66.056168425414,56.829070785678574,NaN,NaN,NaN,NaN,4.090134647038697,23.771610566871022,112595819,0.11374417690821037,2.6702991467964807,2.5565549698882704
2023-06-14T13:30:00-04:00,336.84,338.1,332.8,337.34,324.18144599286586,NaN,NaN,NaN,NaN,NaN,323.36490000000003,342.2478377470766,304.4819622529235,328.61680801173367,336.3074064695252,336.5111782784405,336.1036346606098,1222290,1438615.4333333333,66.68655108181704,56.54290168934358,NaN,NaN,NaN,NaN,4.176553600821648,24.44056828696868,113818109,0.3212712259479851,2.9581440023232517,2.6368727763752666
2023-06-15T09:30:00-04:00,337.41,346.78,337.21,345.27,328.94455099763195,NaN,NaN,NaN,NaN,NaN,324.0801,343.5107280382305,304.6494719617695,333.2041571275095,343.08666666666664,343.0866704813639,343.0866628519694,2631703,1478607.3333333333,74.70886396339597,57.31719384158185,NaN,NaN,NaN,NaN,4.561799772191529,26.17464386210418,116449812,0.9165377995858561,3.782545025857587,2.866007226271731
2023-06-15T13:30:00-04:00,345.29,349.84,344.82,348.12,334.1882077704668,NaN,NaN,NaN,NaN,NaN,324.79670000000004,345.0601663974344,304.5332336025657,336.4693257020076,344.95628465336495,347.17670660513414,342.73586270159575,1865828,1515305.3666666667,76.86513488681439,58.200915953012405,NaN,NaN,NaN,NaN,4.5945283598921325,28.082577953136912,118315640,1.397344430821979,4.612687764799205,3.2153433339772257
2023-06-16T09:30:00-04:00,351.375,351.59,345,345.9,334.85192559908194,NaN,NaN,NaN,NaN,NaN,325.5243,346.15069571132454,304.8979042886754,337.5984605616061,347.4966666666666,347.4966666666666,347.4966666666666,2145199,1489205.7,71.7346681037109,59.99305591527968,NaN,NaN,NaN,NaN,4.737062048471264,30.01465976147112,116170441,1.4544647233464656,5.033424238160308,3.578959514813842
2023-06-16T13:30:00-04:00,345.9,346.21,341.95,342.52,334.85192559908194,NaN,NaN,NaN,NaN,NaN,326.1729,346.8566223042666,305.4891776957335,337.5984605616061,345.9798529212587,347.89569899358,344.0640068489374,1344655,1489778,64.65845036948511,61.35565762554328,NaN,NaN,NaN,NaN,4.702986187866173,30.898698398113705,114825786,1.165688777473,5.036070486655092,3.870381709182092
2023-06-20T09:30:00-04:00,339.24,342.04,335.86,339.1,334.85192559908194,NaN,NaN,NaN,NaN,NaN,326.79670000000004,347.11777217742133,306.47562782257876,337.5984605616061,339.00000000000006,339.00000000000006,339.00000000000006,1927409,1457834.5666666667,58.38289964411334,62.1634646027534,NaN,NaN,NaN,NaN,4.842772888732873,30.1930263322009,112898377,0.6700403356865472,4.707932128790276,4.037891793103729
2023-06-20T13:30:00-04:00,339.13,339.31,337.8,338.06,334.85192559908194,NaN,NaN,NaN,NaN,NaN,327.3775,347.28892207377464,307.46607792622535,337.5984605616061,338.83501621517286,339.1059783148525,338.5640541154932,714561,1434301.2333333334,56.58438062226409,62.725763711746296,NaN,NaN,NaN,NaN,4.604717682394811,29.537759413853298,112183816,0.22106981401251158,4.314229060619368,4.093159246606857
2023-06-21T09:30:00-04:00,336.15,337.73,332.08,333.66,NaN,NaN,NaN,348.4102768448404,348.4102768448404,348.4102768448404,327.8703,347.149591523292,308.591008476708,337.5984605616061,334.49,334.49,334.49,1558095,1412586,49.619892328948836,62.488496015035835,NaN,NaN,NaN,NaN,4.7029521336523255,27.71459508517405,110625721,-0.39003932825314447,3.605610086290426,3.9956494145435704
2023-06-21T13:30:00-04:00,333.62,335.78,333.16,333.51,NaN,NaN,NaN,347.71867335189313,NaN,NaN,328.3509,346.9588397774154,309.74296022258466,337.5984605616061,334.3939284301668,334.54701202563456,334.24084483469903,613658,1393530.7666666666,49.39668230552623,62.34698874367143,NaN,NaN,NaN,NaN,4.5541698383914415,26.02165677997189,110012063,-0.798624415960119,2.9973688945934214,3.7959933105535404
2023-06-22T09:30:00-04:00,333.97,338.75,333.34,337.25,NaN,NaN,NaN,347.71867335189313,NaN,NaN,328.84069999999997,347.06664941395707,310.6147505860429,337.5984605616061,336.4466666666666,336.44667429606113,336.44665903727207,1625066,1375170.5,54.850222478177116,62.42916628789963,NaN,NaN,NaN,NaN,4.615300564220626,24.984548967441906,111637129,-0.808781705520345,2.785016178653109,3.593797884173454
2023-06-22T13:30:00-04:00,337.27,340.08,337.09,339.69,NaN,NaN,NaN,347.71867335189313,NaN,NaN,329.39910000000003,347.2047696240247,311.59343037597534,337.5984605616061,337.38598996351004,338.599349820056,336.1726301069641,973917,1358711.0666666667,58.02826262772657,62.32614067315687,NaN,NaN,NaN,NaN,4.499207666776297,24.25073348091314,112611046,-0.6497992939848238,2.781548766692424,3.431348060677248
2023-06-23T09:30:00-04:00,334.37,337.96,333.45,337.65,NaN,NaN,NaN,347.71867335189313,NaN,NaN,329.87770000000006,347.25311633572545,312.50228366427467,337.5984605616061,336.3533333333333,336.3533333333333,336.3533333333333,1470622,1353512.3333333333,54.5698144953017,61.78164979546198,NaN,NaN,NaN,NaN,4.623549976292276,22.778201382507593,111140424,-0.6775596251729068,2.5843985292111142,3.261958154384021
2023-06-23T13:30:00-04:00,337.65,337.77,334.7,335.09,NaN,NaN,NaN,347.71867335189313,NaN,NaN,330.29970000000003,347.1274354875766,313.4719645124235,337.5984605616061,336.18412879161065,336.42071301320084,335.94754457002045,752235,1342451.8,50.502142000439314,60.9031523809382,NaN,NaN,NaN,NaN,4.512582120842827,21.41085014827387,110388189,-0.8525523370026145,2.196267733130753,3.0488200701333676
2023-06-26T09:30:00-04:00,333.86,336.11,329.415,330.22,NaN,NaN,NaN,346.3166392119461,NaN,NaN,330.5715,346.94003179121313,314.2029682087869,332.8867684492849,331.915,331.915,331.915,1466353,1335778.6333333333,43.81166691386433,59.314259415827514,NaN,NaN,NaN,NaN,4.668469112211197,20.657075067936614,108921836,-1.2561297097265944,1.4786579329751248,2.7347876427017193
2023-06-26T13:30:00-04:00,330.25,331,328.49,328.65,NaN,NaN,NaN,343.02531470231213,NaN,NaN,330.77340000000004,346.7893123923649,314.7574876076352,329.15869238836933,330.8414371520334,332.09401235180053,329.58886195226626,1077174,1342586,41.885193330803574,57.542733862183695,NaN,NaN,NaN,NaN,4.514292747053253,20.12067026307354,107844662,-1.56836206242449,0.7743350646711065,2.3426971270955965
2023-06-27T09:30:00-04:00,331.9,334.11,329.3,333.31,NaN,NaN,NaN,343.02531470231213,NaN,NaN,331.078,346.690920290584,315.46507970941593,329.15869238836933,332.24,332.24,332.24,1591952,1361821.9666666666,49.0468755823685,55.7097346921103,NaN,NaN,NaN,NaN,4.581843265120881,18.93496720632025,109436614,-1.4058147303778519,0.5854287141232817,1.9912434445011336
2023-06-27T13:30:00-04:00,333.34,336.14,333.34,334.56,NaN,NaN,NaN,343.02531470231213,NaN,NaN,331.4026,346.61150676412944,316.19369323587057,329.15869238836933,333.14695887500136,334.3261133407291,331.96780440927364,941811,1367214.0333333334,50.79840023576804,53.847825074178424,NaN,NaN,NaN,NaN,4.456711603326531,17.748255481621484,110378425,-1.168619787167549,0.5304687105416974,1.6990884977092464
2023-06-28T09:30:00-04:00,334.5,337.98,333.93,335.24,NaN,NaN,NaN,343.02531470231213,NaN,NaN,331.694,346.6249793382732,316.76302066172684,329.15869238836933,335.7166666666667,335.7166666666667,335.7166666666667,1245247,1360250.2666666666,51.76969056804651,52.421755250202395,NaN,NaN,NaN,NaN,4.427660774517494,17.010570731221506,111623672,-0.9307838658072047,0.5356086654502406,1.4663925312574453
2023-06-28T13:30:00-04:00,335.3,336.17,333.81,335.93,NaN,NaN,NaN,343.02531470231213,NaN,NaN,331.98799999999994,346.6598871315218,317.31611286847806,329.15869238836933,335.57056694623884,335.76815934529594,335.37297454718174,680791,1360785,52.78815456281175,51.57387697829716,NaN,NaN,NaN,NaN,4.279970719194817,16.29754543824074,112304463,-0.7022543224165967,0.5885746282366995,1.2908289506532962
2023-06-29T09:30:00-04:00,334.74,336.12,332.63,334.54,NaN,NaN,NaN,343.02531470231213,NaN,NaN,332.3314,346.4104170168239,318.25238298317606,329.15869238836933,334.43,334.43,334.43,1248434,1303288.0333333334,50.47577551781908,51.00908239784757,NaN,NaN,NaN,NaN,4.223544239252331,15.35069683756449,111056029,-0.6226778938231321,0.512481583374381,1.135159477197513
2023-06-29T13:30:00-04:00,334.5,335.28,333.26,335.05,NaN,NaN,NaN,343.02531470231213,NaN,NaN,332.72659999999996,345.95356131997323,319.4996386800267,327.45086170996535,334.46649816554685,334.5146406673187,334.418355663775,717547,1274837.3333333333,51.31838736489523,50.63294002232122,NaN,NaN,NaN,NaN,4.0661482221628775,14.471480279793683,111773576,-0.5179611496354779,0.4877080401531657,1.0056691897886436
2023-06-30T09:30:00-04:00,337.7,342.71,337.16,340.62,NaN,NaN,NaN,343.02531470231213,NaN,NaN,333.26439999999997,345.5081897139741,321.0206102860258,332.0383049564018,340.16333333333336,340.16333333333336,340.16333333333336,1743204,1284943.1666666667,59.43587588039233,51.334081704567176,NaN,NaN,NaN,NaN,4.322851920579812,15.136026900313126,113516780,-0.07887845029854001,0.9070711269154685,0.9859495772140086
2023-06-30T13:30:00-04:00,340.62,341.5,340.18,340.41,NaN,NaN,NaN,343.02531470231213,NaN,NaN,333.795,344.8769047099246,322.71309529007544,332.30264396512143,340.34328494161616,340.5954587105207,340.09111117271163,887687,1293166.9666666666,59.03618540653881,52.0226176403538,NaN,NaN,NaN,NaN,4.108362497681254,15.75310590508118,112629093,0.17807459440950257,1.2085428202258868,1.0304682258163842
2023-07-03T09:30:00-04:00,339.24,340.9,336.58,337.92,NaN,NaN,NaN,343.02531470231213,NaN,NaN,334.04540000000003,344.9211059246686,323.16969407533145,332.30264396512143,338.4666666666667,338.4666666666667,338.4666666666667,1462531,1287409.1,54.36765227086264,51.98814833983133,NaN,NaN,NaN,NaN,4.123479462132592,15.37770227189505,111166562,0.1614922553098901,1.2323335449537467,1.0708412896438566
2023-07-05T09:30:00-04:00,335.02,341.65,334.71,338.565,NaN,NaN,NaN,343.02531470231213,NaN,NaN,334.2982999999999,344.9930425607198,323.60355743928005,332.30264396512143,338.30833333333334,338.30833333333334,338.30833333333334,1207947,1307570.0333333334,55.35257825101276,51.79702802720892,NaN,NaN,NaN,NaN,4.324659500551692,14.582298513670791,112374509,0.17403281306919394,1.288382305980349,1.114349492911155
2023-07-05T13:30:00-04:00,338.565,338.8,337.62,338.2,NaN,NaN,NaN,343.02531470231213,NaN,NaN,334.42470000000003,345.15147107240693,323.6979289275931,332.30264396512143,338.2752550301861,338.3228868120547,338.22762324831746,582560,1289045.3666666667,54.63393868539607,51.80160832650137,NaN,NaN,NaN,NaN,4.1000409647980005,13.843709309605408,111791949,0.13931714517531568,1.2884959243802996,1.149178779204984
2023-07-06T09:30:00-04:00,337.3,343,335.5,342.04,NaN,NaN,NaN,343.02531470231213,NaN,NaN,334.60829999999993,345.5340650734456,323.68253492655424,332.30264396512143,340.18,340.18,340.18,2151304,1327953.5,60.4513290389881,52.512264543540574,NaN,NaN,NaN,NaN,4.342895181598143,14.03687615064125,113943253,0.3448377876216484,1.5802260137320445,1.2353882261103961
2023-07-06T13:30:00-04:00,342.1,342.5,340.5,341.32,NaN,NaN,NaN,343.02531470231213,NaN,NaN,334.80269999999996,345.85262944954974,323.7527705504502,332.447234374491,340.50550399272987,341.05703112857304,339.9539768568867,749343,1297377.6666666667,58.92556682482486,53.5918288228949,NaN,NaN,NaN,NaN,4.175545525769705,14.21624536017453,113193910,0.3983656614746838,1.7333453029537509,1.3349796414790671
2023-07-07T09:30:00-04:00,339.34,341.68,337.58,341.68,NaN,NaN,NaN,343.02531470231213,NaN,NaN,335.0121,346.17797338097677,323.8462266190232,332.447234374491,340.31333333333333,340.31333333333333,340.31333333333333,1405146,1317551.3,59.47630443245195,54.84833675872692,NaN,NaN,NaN,NaN,4.170149416786156,13.601170874397765,114599056,0.42183651396414823,1.8622752839342525,1.4404387699701042
2023-07-07T13:30:00-04:00,341.7,341.79,337,337.18,NaN,NaN,NaN,343.02531470231213,NaN,NaN,335.1525,346.24711279180406,324.0578872081959,332.447234374491,339.7639100576439,340.5438749868873,338.9839451284005,697245,1290050.4666666666,50.382465331377524,54.94373602651329,NaN,NaN,NaN,NaN,4.21442445844429,12.881513259171259,113901811,0.11412252999503769,1.5830919324639012,1.4689694024688635
2023-07-10T09:30:00-04:00,334.59,335.23,327.59,330.87,NaN,NaN,NaN,343.02531470231213,NaN,NaN,335.19629999999995,346.20531826867824,324.18728173132166,332.447234374491,331.22999999999996,331.22999999999996,331.22999999999996,2871093,1345010.5666666667,40.93174204299076,54.238974727029195,NaN,NaN,NaN,NaN,4.598394139983986,13.60226677723797,111030718,-0.5008108976774044,0.8429557803721082,1.3437666780495126
2023-07-10T13:30:00-04:00,330.9,331.88,329.48,331.85,NaN,NaN,NaN,343.02531470231213,NaN,NaN,335.22229999999996,346.1933778340159,324.251222165984,332.447234374491,331.18521667638146,331.2570483245597,331.1133850282032,1115959,1294485.7666666666,42.728564237236554,53.5931799891142,NaN,NaN,NaN,NaN,4.441365987127986,14.271537901157059,112146677,-0.8096954758552275,0.3316473332304781,1.1413428090857056
2023-07-11T09:30:00-04:00,331.13,332.86,327,331.02,NaN,NaN,NaN,343.02531470231213,NaN,NaN,335.19089999999994,346.2008514422231,324.1809485577768,332.447234374491,330.29333333333335,330.29333333333335,330.29333333333335,1724526,1289775.7,41.575056560134946,52.79224441749442,NaN,NaN,NaN,NaN,4.542696988047417,15.292215290540351,110422151,-1.0242268360616937,-0.13894073599141166,0.8852861000702821
2023-07-11T13:30:00-04:00,331.04,332.73,330.13,332.48,NaN,NaN,NaN,343.02531470231213,NaN,NaN,335.1499,346.1846307153351,324.1151692846649,332.447234374491,330.76288406332964,331.4539611433855,330.07180698327375,796126,1244806.6,44.41754907263354,52.35951395712403,NaN,NaN,NaN,NaN,4.403932917472603,16.23998715211055,111218277,-1.0198964684893728,-0.3895844855414339,0.6303119829479389
2023-07-12T09:30:00-04:00,336.57,341.66,335.68,337.9,NaN,NaN,NaN,343.02531470231213,NaN,NaN,335.2023,346.26385453993555,324.1407454600644,332.447234374491,338.41333333333336,338.41333333333336,338.41333333333336,2408721,1280275.4666666666,53.468238044337234,52.513074719941315,NaN,NaN,NaN,NaN,4.74508056622456,15.175350918389332,113626998,-0.6235723159517832,-0.1491534119917901,0.4744189039599931
2023-07-12T13:30:00-04:00,337.91,338.7,336.85,337.42,NaN,NaN,NaN,343.02531470231213,NaN,NaN,335.19769999999994,346.25536977441897,324.1400302255809,332.447234374491,338.2174071454408,338.54886414774916,337.88595014313245,841622,1244082.5666666667,52.65057624118819,52.02841045999816,NaN,NaN,NaN,NaN,4.5382890972085175,14.186760129933921,112785376,-0.377432989230698,0.002627667421620572,0.3800606566523186
2023-07-13T09:30:00-04:00,339.34,342.47,339.01,340.95,NaN,NaN,NaN,343.02531470231213,NaN,NaN,335.2982999999999,346.4713460681112,324.12525393188866,332.447234374491,340.81,340.81000381469727,340.80999618530274,1459888,1268926.8,57.76575403562798,51.93766536207597,NaN,NaN,NaN,NaN,4.574839875979338,13.989175675397341,114245264,0.018439446037677942,0.403109964199416,0.3846705181617381
2023-07-13T13:30:00-04:00,340.94,343.75,340.75,342.67,328.9912336030995,328.9912336030995,328.9912336030995,NaN,NaN,NaN,335.48769999999996,346.8317996487142,324.1436003512857,332.71881226050215,341.4125759396585,342.18002119608326,340.64513068323373,900012,1246990.7,60.03145603493897,52.342222773795704,NaN,NaN,NaN,NaN,4.462351313409385,14.033663355869805,115145276,0.37185740698872904,0.8494922768976494,0.47763486990892035
2023-07-14T09:30:00-04:00,347.54,351.43,345.56,346.66,334.64435934841316,NaN,NaN,NaN,NaN,NaN,335.74769999999995,347.50085195341416,323.99454804658575,338.2250498084017,347.8833333333334,347.8833333333334,347.8833333333334,2244773,1301361.2,64.754968619675,53.01382208584298,NaN,NaN,NaN,NaN,4.7693262195944275,15.22673614301309,117390049,0.8241575310255866,1.5078317836909036,0.683674252665317
2023-07-14T13:30:00-04:00,346.66,347.05,344.3,345.39,334.64435934841316,NaN,NaN,NaN,NaN,NaN,336.17150000000004,347.7554596425333,324.58754035746676,338.2250498084017,347.2142073541211,348.25990836112345,346.1685063471187,919122,1277829.7333333334,62.23387428629132,53.55667462876407,NaN,NaN,NaN,NaN,4.62508863248054,16.03307783897326,116470927,0.9771654259221882,1.9051310350680524,0.9279656091458641
2023-07-17T09:30:00-04:00,345.75,347,342.2,345.81,334.64435934841316,NaN,NaN,NaN,NaN,NaN,336.6185,347.927538906995,325.309461093005,338.2250498084017,345.00333333333333,345.0033371480306,345.00332951863606,1244130,1286836.8333333333,62.75037175169267,53.72089196538582,NaN,NaN,NaN,NaN,4.637582301589073,16.28680925794578,117715057,1.0401865173495997,2.2281987558328638,1.188012238483264
2023-07-17T13:30:00-04:00,345.83,346.67,344.96,345.78,334.64435934841316,NaN,NaN,NaN,NaN,NaN,337.0478999999999,348.08200786426266,326.01379213573716,338.2250498084017,345.3160936454631,345.70646428580676,344.9257230051195,798610,1264436.4333333333,62.684426722281394,53.98938195806129,NaN,NaN,NaN,NaN,4.428469280046999,16.522417004134553,116916447,1.0124132097474698,2.4535287506676013,1.4411155409201315
2023-07-18T09:30:00-04:00,345.955,366.77,342.17,363.76,338.47142487466164,NaN,NaN,NaN,NaN,NaN,337.8185,350.67486499948836,324.9621350005116,346.1372524015213,357.56666666666666,357.56667048136393,357.5666628519694,5260330,1414706.2666666666,77.76578961108336,55.29577375653496,NaN,NaN,NaN,NaN,5.869292902900781,18.91315959702226,122176777,2.076236285352154,4.036410897610324,1.9601746122581698
2023-07-18T13:30:00-04:00,363.72,365.5,359.46,359.53,346.3849964712679,NaN,NaN,NaN,NaN,NaN,338.45489999999995,352.3546373342137,324.5551626657862,346.1372524015213,358.60841547758963,360.3430140599223,356.87381689525694,1897322,1429071.9,70.54247503966043,56.73577444998374,NaN,NaN,NaN,NaN,5.881486266979299,21.133134861846564,120279455,2.346360986843105,4.893125845812051,2.546764858968946
2023-07-19T09:30:00-04:00,361.73,362.455,353.94,354.08,346.3849964712679,NaN,NaN,NaN,NaN,NaN,338.9993,353.1694579398398,324.8291420601602,346.1372524015213,356.825,356.825,356.825,3383740,1505957.4333333333,62.488851853020954,58.27556800784304,NaN,NaN,NaN,NaN,6.069594390766491,22.042910641427234,116895715,2.021645159553619,5.07382130841097,3.052176148857351
2023-07-19T13:30:00-04:00,354.07,356.31,352.42,355.03,346.3849964712679,NaN,NaN,NaN,NaN,NaN,339.53589999999997,354.05727372151756,325.0145262784824,346.1372524015213,356.122151378866,357.1610032993724,355.08329945835965,1548864,1504521.1666666667,63.275904009251036,59.7432351344155,NaN,NaN,NaN,NaN,5.913909077140311,22.59231806639979,118444579,1.744942263212276,5.233353977872696,3.48841171466042
2023-07-20T09:30:00-04:00,353.585,357.43,347.73,348.46,346.3849964712679,NaN,NaN,NaN,NaN,NaN,339.86689999999993,354.432299670458,325.30150032954185,346.1372524015213,351.2066666666667,351.2066666666667,351.2066666666667,2579842,1559122.2,54.72426191786728,60.68246408853924,NaN,NaN,NaN,NaN,6.184344143058859,22.239826260656685,115864737,1.0289522565880214,4.774602035395446,3.745649778807425
2023-07-20T13:30:00-04:00,348.42,349,345.36,346.84,NaN,NaN,NaN,363.7943685808319,363.7943685808319,363.7943685808319,340.12569999999994,354.717635308249,325.5337646917509,346.1372524015213,349.54816404833286,351.57685079223114,347.5194773044346,1724231,1575088.3333333333,52.82837370119736,61.28323727629379,NaN,NaN,NaN,NaN,6.002605275697511,21.50728501571622,114140506,0.3887112244776354,4.231538809404469,3.842827584926834
2023-07-21T09:30:00-04:00,349.175,350.29,344.94,346.29,NaN,NaN,NaN,363.7943685808319,NaN,NaN,340.36449999999996,354.9613374999551,325.7676625000448,346.1372524015213,347.17333333333335,347.17333333333335,347.17333333333335,1956139,1617599.9333333333,52.16758004656322,61.190333133595644,NaN,NaN,NaN,NaN,5.955990613147691,20.999875125438844,112184367,-0.10309037628142903,3.7139646145750476,3.8170549908564766
2023-07-21T13:30:00-04:00,346.26,347.25,339.83,343.7,NaN,NaN,NaN,360.3865011242703,NaN,NaN,340.5016999999999,355.0924041105003,325.91099588949953,346.1372524015213,345.3205726027357,347.1094720103769,343.53167319509447,2098295,1645928.6333333333,49.05578752520608,60.93356251102551,NaN,NaN,NaN,NaN,6.060562712208571,19.67107373860323,110086072,-0.6060250350112595,3.059523697092402,3.6655487321036615
2023-07-24T09:30:00-04:00,345.87,346.91,342.3,344.93,NaN,NaN,NaN,360.3865011242703,NaN,NaN,340.6534999999999,355.2673822015299,326.03961779846986,346.1372524015213,344.71333333333337,344.71333333333337,344.71333333333337,1695788,1678536.6666666667,50.5639351875682,60.419146879021234,NaN,NaN,NaN,NaN,5.95695108990796,18.437186736541587,111781860,-0.8444082834986508,2.6100383777303477,3.4544466612289986
2023-07-24T13:30:00-04:00,344.94,346.23,344.11,345.12,NaN,NaN,NaN,360.3865011242703,NaN,NaN,340.65049999999997,355.26065129969817,326.04034870030176,346.1372524015213,344.8584090183244,345.0652576273457,344.65156040930304,834172,1648235.6,50.80620123028498,59.76020010726024,NaN,NaN,NaN,NaN,5.682883154914535,17.291434520341493,112616032,-0.968925182549321,2.2432901830423475,3.2122153655916685
2023-07-25T09:30:00-04:00,347.11,350.9,345.06,350.81,NaN,NaN,NaN,360.3865011242703,NaN,NaN,340.70429999999993,355.4433197788089,325.96528022119094,345.97380192121705,348.92333333333335,348.92333333333335,348.92333333333335,2099223,1688620.1333333333,57.52010932069135,59.24342444304712,NaN,NaN,NaN,NaN,5.694105786706352,16.97335026691394,114715255,-0.6623399506466008,2.3842904272834176,3.0466303779300183
2023-07-25T13:30:00-04:00,350.81,351.89,349.63,350.9,NaN,NaN,NaN,360.3865011242703,NaN,NaN,340.80429999999996,355.7493749091504,325.8592250908495,342.57654153697365,349.69041000088185,350.61575017796406,348.76506982379965,1442558,1687954.3666666667,57.61863623583351,58.91376458230013,NaN,NaN,NaN,NaN,5.448812516227327,16.826417015400107,116157813,-0.4574892700166089,2.4747687904092572,2.932258060425866
2023-07-26T09:30:00-04:00,341.44,344.67,333.11,335.13,NaN,NaN,NaN,356.4593816085692,NaN,NaN,340.65649999999994,355.67675995115263,325.63624004884724,339.6807008177502,337.63666666666666,337.63666666666666,337.63666666666666,4931757,1812081.3666666667,40.077829725370435,57.29429729470569,NaN,NaN,NaN,NaN,6.330325907925372,17.021025954604756,111226056,-1.3382478839381404,1.2594482055031904,2.597696089441331
2023-07-26T13:30:00-04:00,335.11,338.18,334.03,337.87,NaN,NaN,NaN,353.44168244454335,NaN,NaN,340.6319,355.6662985433432,325.59750145665674,339.6807008177502,337.34354285906227,337.78011117203613,336.9069745460884,2223307,1866772.9333333333,43.30720140324089,55.91020977191708,NaN,NaN,NaN,NaN,6.174588343073563,17.20173425529479,113449363,-1.6689594551190021,0.5114967705425784,2.1804562256615805
2023-07-27T09:30:00-04:00,340.48,341.32,333.62,333.65,NaN,NaN,NaN,353.44168244454335,NaN,NaN,340.54369999999994,355.68875210423954,325.39864789576035,339.6807008177502,336.19666666666666,336.19666666666666,336.19666666666666,2914853,1892224.5666666667,39.75371401514831,53.19506151506458,NaN,NaN,NaN,NaN,6.283546318568308,16.839952107282837,110534510,-2.0779427930327365,-0.4169722656293402,1.6609705274033963
2023-07-27T13:30:00-04:00,333.66,334.6,329.04,330.65,NaN,NaN,NaN,349.3768945414124,NaN,NaN,340.4835,355.7608723198732,325.20612768012677,339.6807008177502,334.22070992768073,336.5689693018041,331.87245055355737,2063856,1936041.6666666667,37.40404486383126,50.828030788219635,NaN,NaN,NaN,NaN,6.231864438670572,17.06111672705998,108470654,-2.4319521737646626,-1.3789696898024317,1.0529824839622308
2023-07-28T09:30:00-04:00,333.64,340.01,333.16,338.08,NaN,NaN,NaN,349.3768945414124,NaN,NaN,340.57489999999996,355.7385558243733,325.4112441756266,339.6807008177502,337.0833333333333,337.0833333333333,337.0833333333333,2468627,1971491.0333333334,45.92821238318654,49.64512796894575,NaN,NaN,NaN,NaN,6.455302693051246,16.397257809512574,110939281,-2.061786041891303,-1.5242500684018978,0.5375359734894051
2023-07-28T13:30:00-04:00,338.07,339.4,336.93,338.41,NaN,NaN,NaN,349.3768945414124,NaN,NaN,340.5981,355.74487693636615,325.4513230636338,339.6807008177502,337.4006920135768,337.9188400613503,336.88254396580334,926080,1979118.8666666667,46.27813066330511,48.43100130137818,NaN,NaN,NaN,NaN,6.170638214976155,15.780817386075698,111865361,-1.7055316342907592,-1.5943785693740438,0.11115306491671528
2023-07-31T09:30:00-04:00,336.88,337.71,333.35,334.09,NaN,NaN,NaN,349.3768945414124,NaN,NaN,340.4861,355.7405135632907,325.23168643670937,339.6807008177502,335.04999999999995,335.04999999999995,335.04999999999995,1664769,1938908.0666666667,42.409040580985355,47.551342634458045,NaN,NaN,NaN,NaN,6.09130691390643,15.684353938008266,110200592,-1.6695371558425407,-1.9757683798864605,-0.3062312240439199
2023-07-31T13:30:00-04:00,334.08,336,333.95,335.95,NaN,NaN,NaN,349.3768945414124,NaN,NaN,340.4521,355.73919025158364,325.1650097484163,339.6807008177502,335.14654538167474,335.268263641237,335.02482712211247,1047383,1936622.2,44.55827434023159,46.96062125153192,NaN,NaN,NaN,NaN,5.802642134341686,15.594780736231364,111247975,-1.437963911275443,-2.103686113138224,-0.6657222018627807
2023-08-01T09:30:00-04:00,335.04,338.54,333.7,337.27,NaN,NaN,NaN,349.3768945414124,NaN,NaN,340.4957,355.73372533269975,325.25767466730025,339.6807008177502,336.50333333333333,336.50333333333333,336.50333333333333,1339885,1923800.8333333333,46.09571478607813,46.5269165900687,NaN,NaN,NaN,NaN,5.73388198188871,15.05298466362147,112587860,-1.127129265069775,-2.0746337831999995,-0.9475045181302244
2023-08-01T13:30:00-04:00,337.29,338.08,336.3,336.36,NaN,NaN,NaN,349.3768945414124,NaN,NaN,340.61850000000004,355.62044044115186,325.6165595588482,326.8741203200689,336.6346912745528,336.8260073668796,336.44337518222596,631651,1918318.3333333333,45.16584141219927,46.24906329628249,NaN,NaN,NaN,NaN,5.451461840325229,14.549888310483707,111956209,-0.9226540083730179,-2.1008220285964967,-1.1781680202234788
2023-08-02T09:30:00-04:00,333.535,333.63,326.37,327.93,NaN,NaN,NaN,346.9209472413861,NaN,NaN,340.6041,355.6532737567196,325.5549262432804,326.8741203200689,329.31,329.31,329.31,2411703,1918417.7333333334,37.59906111335062,45.32300086240981,NaN,NaN,NaN,NaN,5.775643137444857,15.415334752639605,109544506,-1.2733676041221447,-2.7698775253761596,-1.496509921254015
2023-08-02T13:30:00-04:00,327.93,329.05,326.62,327.56,NaN,NaN,NaN,344.3181769122322,NaN,NaN,340.4891,355.8442392947085,325.13396070529154,326.8741203200689,328.84929248496394,329.56310176795387,328.135483201974,1004639,1923851.6333333333,37.303660561278534,44.358533671766494,NaN,NaN,NaN,NaN,5.5366686276273684,16.21896359178437,108539867,-1.4364051978570402,-3.292016418575315,-1.855611220718275
2023-08-03T09:30:00-04:00,325.98,329.86,325.97,328.79,NaN,NaN,NaN,344.1793961434944,NaN,NaN,340.37370000000004,355.9898522546322,324.7575477453679,326.8741203200689,328.2066666666667,328.2066666666667,328.2066666666667,1437126,1923092.9,39.018872623192095,43.03701676480226,NaN,NaN,NaN,NaN,5.419049439939698,16.794867911485742,109976993,-1.3678822892382518,-3.5654640822660895,-2.1975817930278376
2023-08-03T13:30:00-04:00,328.83,328.93,326.58,326.64,NaN,NaN,NaN,343.6005599551537,NaN,NaN,340.2017000000001,356.2243916103287,324.1790083896714,326.8741203200689,327.95046214823475,328.33164578494757,327.56927851152193,649232,1914733.5666666667,37.107876644567966,41.571962508283285,NaN,NaN,NaN,NaN,5.19983162280115,17.329636208351303,109327761,-1.3703998511874937,-3.9105816070122046,-2.540181755824711
2023-08-04T09:30:00-04:00,331.88,335.14,328.975,332.34,NaN,NaN,NaN,343.6005599551537,NaN,NaN,340.1299000000001,356.2603289453101,323.99947105469005,326.8741203200689,332.15166666666664,332.15166666666664,332.15166666666664,1926446,1904122.6666666667,44.82333267613472,41.91092700476646,NaN,NaN,NaN,NaN,5.435557935458211,16.55334771915064,111254207,-0.9132201496158538,-3.681706942844528,-2.768486793228674
2023-08-04T13:30:00-04:00,332.31,332.81,327.24,327.76,NaN,NaN,NaN,343.6005599551537,NaN,NaN,339.99430000000007,356.42167301091473,323.5669269890854,326.8741203200689,331.14414447030833,332.5182777073033,329.77001123331337,1035639,1908006.5666666667,40.521744921087326,41.711965827469776,NaN,NaN,NaN,NaN,5.445160940068338,16.10882867141988,110218568,-0.8458413950944084,-3.8257885370966846,-2.9799471420022763
2023-08-07T09:30:00-04:00,328.56,331.11,327.52,329.05,NaN,NaN,NaN,343.6005599551537,NaN,NaN,339.8743,356.5304553799175,323.2181446200825,326.8741203200689,329.2266666666667,329.2266666666667,329.2266666666667,1111087,1903571.8,42.20414865837503,41.886996873414546,NaN,NaN,NaN,NaN,5.312649444349174,15.696060984241313,111329655,-0.6497768978896699,-3.7921682643643635,-3.1423913664746936
2023-08-07T13:30:00-04:00,329.05,330.26,328.7,330.11,NaN,NaN,NaN,343.6005599551537,NaN,NaN,339.6641,356.5411143911743,322.78708560882575,326.8741203200689,329.36499646884187,329.5770287168166,329.15296422086715,472907,1892715.0333333334,43.6154918737996,42.33067165984085,NaN,NaN,NaN,NaN,5.044603055467091,15.31277670328979,111802562,-0.3965297848443048,-3.6380535975300745,-3.2415238126857697
2023-08-08T09:30:00-04:00,326.96,328.75,322.99,324.47,NaN,NaN,NaN,341.67005073284304,NaN,NaN,339.34530000000007,356.74792697525186,321.9426730247483,326.8741203200689,325.40333333333336,325.40333333333336,325.40333333333336,1663971,1772836.4,38.26173596165247,41.78306620115985,NaN,NaN,NaN,NaN,5.1928456943622985,15.887496463803014,110138591,-0.5473919241271803,-3.9257637178447453,-3.378371793717565
2023-08-08T13:30:00-04:00,324.45,326.4,323.9,326.08,NaN,NaN,NaN,340.572775699532,NaN,NaN,339.1085,356.90012907099486,321.3168709290051,322.36522534648014,325.42031003415406,325.4462677821214,325.3943522861867,711735,1733316.8333333333,40.50673944455413,41.37082397124907,NaN,NaN,NaN,NaN,5.00049957333642,16.421164812851007,110850326,-0.4797077916439867,-3.9780065332725485,-3.498298741628562
2023-08-09T09:30:00-04:00,326.395,327.11,321.05,324.08,NaN,NaN,NaN,339.62810407682605,NaN,NaN,338.81879999999995,357.10133795948633,320.5362620405136,322.36522534648014,324.08,324.08,324.08,1186394,1660071.9666666666,38.62764074525668,41.100723982982736,NaN,NaN,NaN,NaN,5.076178175240961,17.341427856066908,109663932,-0.5078796193198722,-4.133148265778402,-3.62526864645853
2023-08-09T13:30:00-04:00,324.1,325.44,322.1,322.32,NaN,NaN,NaN,339.0668266187884,NaN,NaN,338.50120000000004,357.3583979424247,319.6440020575754,322.36522534648014,323.7623378969587,324.1510572345382,323.37361855937917,792296,1634853.0333333334,37.000958826413424,40.56091573199573,NaN,NaN,NaN,NaN,4.952165448438033,18.195957824767387,108871636,-0.5781814923242732,-4.347995511863871,-3.769814019539598
2023-08-10T09:30:00-04:00,325.8,328.26,322.1,322.72,NaN,NaN,NaN,339.0668266187884,NaN,NaN,338.11480000000006,357.45177359567424,318.7778264043259,322.36522534648014,324.36,324.36,324.36,1351032,1593892.7,37.64367169791822,39.95719836855573,NaN,NaN,NaN,NaN,5.038439344978172,18.234387193443915,110222668,-0.5320403747734277,-4.434864488006383,-3.9028241132329553
2023-08-10T13:30:00-04:00,322.7,324,321.18,322.98,NaN,NaN,NaN,337.71417466711927,NaN,NaN,337.74800000000005,357.518773581221,317.9772264187791,322.36522534648014,323.82039327633936,324.59096424036596,323.04982231231276,662514,1558502.1333333333,38.08582329718007,39.4514827889115,NaN,NaN,NaN,NaN,4.879979391765445,18.432141565869443,110885182,-0.42305568554452044,-4.431643720163606,-4.008588034619086
2023-08-11T09:30:00-04:00,320.25,322.33,319.22,321.2,NaN,NaN,NaN,335.7244394549774,NaN,NaN,337.33840000000004,357.6086356611817,317.06816433881835,319.80518027718415,320.9166666666667,320.9166666666667,320.9166666666667,1340855,1537992.6666666667,36.193677011858924,39.35109821023352,NaN,NaN,NaN,NaN,4.7999808637821975,18.95546778635345,109544327,-0.40961882527340787,-4.520611566210846,-4.110992740937438
2023-08-11T13:30:00-04:00,321.2,322.4,320.43,321.2,NaN,NaN,NaN,335.7244394549774,NaN,NaN,337.01880000000006,357.7867490138003,316.2508509861998,319.72091537739783,321.0742123784126,321.28012219462494,320.86830256220026,784948,1494214.4333333333,36.19367701185892,39.27181367098926,NaN,NaN,NaN,NaN,4.597839373512039,19.420662452649015,109544327,-0.3422448297871563,-4.538798778171383,-4.196553948384227
2023-08-14T09:30:00-04:00,321.22,324.06,320.11,322.44,NaN,NaN,NaN,335.7244394549774,NaN,NaN,336.85020000000003,357.949315996644,315.7510840033561,319.72091537739783,322.2033333333334,322.2033333333334,322.2033333333334,1199560,1477673.5,38.655942670549116,39.24589010294333,NaN,NaN,NaN,NaN,4.551565132546893,19.353357029170574,110743887,-0.1646819907276562,-4.402406436793797,-4.2377244460661405
2023-08-14T13:30:00-04:00,322.46,324.04,321.44,324.04,NaN,NaN,NaN,335.7244394549774,NaN,NaN,336.6940000000001,358.05291008454833,315.3350899154518,316.75873230191826,322.5232103569129,322.9792360170003,322.0671846968255,590214,1469541.5666666667,41.778002846722096,39.57947054595434,NaN,NaN,NaN,NaN,4.412167623079259,19.29085913594059,111334101,0.09598664588176131,-4.117741138713939,-4.2137277845957
2023-08-15T09:30:00-04:00,322.76,325.1,321.1,324.72,NaN,NaN,NaN,335.7244394549774,NaN,NaN,336.56800000000004,358.13264996237587,315.0033500376242,316.3531767508657,323.64000000000004,323.64000000000004,323.64000000000004,1214237,1440042.0333333334,43.10334830856043,39.45661451969902,NaN,NaN,NaN,NaN,4.3827270785735974,18.897511305342103,112548338,0.3361486820086803,-3.7935419320848496,-4.12969061409353
2023-08-15T13:30:00-04:00,324.72,324.97,320.91,321.97,NaN,NaN,NaN,335.7244394549774,NaN,NaN,336.35780000000005,358.279674478243,314.4359255217571,316.3531767508657,323.2654350395819,323.7583913255618,322.77247875360206,701037,1415324.6666666667,39.2155089101849,39.3633119474917,NaN,NaN,NaN,NaN,4.35967514438977,18.579003541600745,111847301,0.3312071497125517,-3.7156816769528405,-4.046888826665392
2023-08-16T09:30:00-04:00,320.86,324.4,319.8,321.39,NaN,NaN,NaN,335.7244394549774,NaN,NaN,336.0276,358.34048831504987,313.71471168495015,316.3531767508657,321.86333333333334,321.86333333333334,321.86333333333334,944820,1282426.7666666666,38.4282316778528,39.09360359174012,NaN,NaN,NaN,NaN,4.376841205504784,18.561800246806452,110902481,0.31062793485634543,-3.6586039080949604,-3.969231842951306
2023-08-16T13:30:00-04:00,321.33,323.65,320.25,320.35,NaN,NaN,NaN,335.7101267815435,NaN,NaN,335.6862000000001,358.4217808863471,312.9506191136531,316.3531767508657,321.6700536691176,321.89135562287845,321.4487517153567,720694,1232339.6666666667,36.99408949931632,38.62064627927703,NaN,NaN,NaN,NaN,4.307066833683011,18.54582575878318,110181787,0.2512620107187815,-3.655154329552829,-3.9064163402716106
2023-08-17T09:30:00-04:00,320.55,321.89,318.67,319.47,NaN,NaN,NaN,333.8537573823824,NaN,NaN,335.2566000000001,358.3864296093934,312.1267703906068,315.93830092617895,320.01,320.01,320.01,846014,1163378.3666666667,35.77738688308723,38.443192773665224,NaN,NaN,NaN,NaN,4.229419202705651,18.939167588461604,109335773,0.1803355377312914,-3.680996918107496,-3.8613324558387876
2023-08-17T13:30:00-04:00,319.44,319.45,316.2,316.92,NaN,NaN,NaN,331.22767750136506,NaN,NaN,334.7416000000001,358.330366601067,311.15283339893324,315.93830092617895,318.8117979728815,320.0543119337655,317.56928401199747,786747,1120808.0666666667,32.44717975953695,37.86750993902114,NaN,NaN,NaN,NaN,4.16088925965525,19.876151690941,108549026,-0.001105300140003429,-3.8627140810137917,-3.8616087808737882
2023-08-18T09:30:00-04:00,314.39,316.9,311.57,316,NaN,NaN,NaN,327.7580103422121,NaN,NaN,334.1284000000001,358.0378499677344,310.2189500322658,315.93830092617895,314.8233333333333,314.8233333333333,314.8233333333333,1562859,1090615.8,31.31466787452412,37.34515473396881,NaN,NaN,NaN,NaN,4.245825741108448,21.597591005468765,106986167,-0.13827766113803852,-4.0344558572963365,-3.896178196158298
2023-08-18T13:30:00-04:00,316.03,318.38,315.39,316.52,NaN,NaN,NaN,327.7580103422121,NaN,NaN,333.55100000000004,357.73750044962594,309.36449955037415,315.93830092617895,315.4859180468009,316.40591578679596,314.5659203068059,810642,1086767.8666666667,32.743561436753964,37.04105492042171,NaN,NaN,NaN,NaN,4.156123902457845,22.610377333551153,107796809,-0.14829999796689153,-4.081553193616912,-3.9332531956500207
2023-08-21T09:30:00-04:00,317.93,322.03,317.07,321.56,NaN,NaN,NaN,327.7580103422121,NaN,NaN,333.06600000000003,357.2222824954457,308.90971750455435,315.93830092617895,320.21999999999997,320.21999999999997,320.21999999999997,1034523,1065759.6666666667,44.74241273936932,37.54810785195394,NaN,NaN,NaN,NaN,4.2528293379965705,22.276595538302995,108831332,0.21069207065511053,-3.6698881073311327,-3.880580177986243
2023-08-21T13:30:00-04:00,321.58,322.77,321.36,321.83,NaN,NaN,NaN,327.7580103422121,NaN,NaN,332.58700000000005,356.665545886323,308.5084541136771,315.93830092617895,320.913743965635,321.7764916978444,320.05099623342556,668915,1053144.0666666667,45.30536099313767,38.063789115950904,NaN,NaN,NaN,NaN,4.049770099568241,21.731738592413656,109500247,0.47726579591539764,-3.283997933091996,-3.7612637290073936
2023-08-22T09:30:00-04:00,325.51,326.07,322.39,323.07,NaN,NaN,NaN,327.7580103422121,NaN,NaN,331.7732,354.28170237221264,309.2646976277873,316.8052876167136,323.8433333333333,323.8433333333333,323.8433333333333,1049975,1043480.4,47.929063274705996,38.90203099186856,NaN,NaN,NaN,NaN,4.063357949599082,20.258604897269162,110550222,0.7327546074402997,-2.845320469707019,-3.578075077147319
2023-08-22T13:30:00-04:00,323.1,323.93,321.46,322.43,NaN,NaN,NaN,327.7580103422121,NaN,NaN,331.03119999999996,352.23919043379624,309.8232095662037,316.8052876167136,323.4530832656488,324.02781288472886,322.8783536465687,484103,1038562.1333333333,46.68430879495085,39.651361833517974,NaN,NaN,NaN,NaN,3.9495466674848636,19.135131536483023,110066119,0.846255160162344,-2.520256126944389,-3.366511287106733
2023-08-23T09:30:00-04:00,323.77,329.2,323.495,328.83,313.23240043804924,313.23240043804924,313.23240043804924,NaN,NaN,NaN,330.52619999999996,350.69168056060187,310.36071943939805,318.89758407469674,327.17499999999995,327.17499999999995,327.17499999999995,1208736,998463.2333333333,58.33686876604945,41.05714226891085,NaN,NaN,NaN,NaN,4.151007619807372,18.746584478306932,111274855,1.312157903098524,-1.7263139082335783,-3.0384718113321023
2023-08-23T13:30:00-04:00,328.84,329.2,326.66,327.01,315.0646776908652,NaN,NaN,NaN,NaN,NaN,329.9658,348.8957923254036,311.0358076745964,319.68806725975736,327.32991946300973,327.54312246301635,327.1167164630031,638200,986248.6,54.6771456049725,41.978509608785885,NaN,NaN,NaN,NaN,4.035935646963986,18.385790781429137,110636655,1.4469442501789223,-1.2297914986084493,-2.6767357487873715
2023-08-24T09:30:00-04:00,332.85,332.98,321.07,321.84,315.0646776908652,NaN,NaN,NaN,NaN,NaN,329.43340000000006,347.7399634612195,311.12683653878065,319.68806725975736,325.2966666666666,325.2966666666666,325.2966666666666,1534176,989483.6,45.87335911880204,42.176367523803144,NaN,NaN,NaN,NaN,4.598368815037988,17.528535650552396,109102479,1.150040479667569,-1.2391851492029105,-2.3892256288704794
2023-08-24T13:30:00-04:00,321.79,322.65,319.99,320.05,315.0646776908652,NaN,NaN,NaN,NaN,NaN,328.8976,346.6961004132326,311.0990995867674,319.68806725975736,324.01050620073295,326.01173015270837,322.00928224875753,633686,988965.4,43.27528929874908,42.46635183727201,NaN,NaN,NaN,NaN,4.45991389967813,16.96951892214472,108468793,0.8112084217587512,-1.3752151016720404,-2.1864235234307916
2023-08-25T09:30:00-04:00,321.55,325.4,318.83,320.73,315.0646776908652,NaN,NaN,NaN,NaN,NaN,328.3864,345.616560886072,311.15623911392794,319.68806725975736,321.65333333333336,321.65333333333336,321.65333333333336,1272378,967163.1333333333,44.55985175018716,42.90432469958161,NaN,NaN,NaN,NaN,4.610634335415406,15.758512318695184,109741171,0.6196393835099583,-1.4118742940433435,-2.031513677553302
2023-08-25T13:30:00-04:00,320.84,324.2,320.06,322.93,315.0646776908652,NaN,NaN,NaN,NaN,NaN,327.97100000000006,344.69850704677003,311.2434929532301,319.68806725975736,321.9223781713853,322.27959641192894,321.5651599308416,721769,956700.8,48.61422991614128,43.73433472935482,NaN,NaN,NaN,NaN,4.577017597171448,14.634006186920615,110462940,0.6260048840708088,-1.2490075724647909,-1.8750124565355997
2023-08-28T09:30:00-04:00,325.66,326.12,322.04,324.16,315.0646776908652,NaN,NaN,NaN,NaN,NaN,327.5556,343.59531778304915,311.5158822169509,319.68806725975736,324.10666666666674,324.10666666666674,324.10666666666674,906282,949873.9666666667,50.781415508738576,44.80605105975849,NaN,NaN,NaN,NaN,4.541516340230629,14.067799369663152,111369222,0.6927683032086742,-1.009052077524757,-1.7018203807334311
2023-08-28T13:30:00-04:00,324.16,324.31,321.71,323.74,315.0646776908652,NaN,NaN,NaN,NaN,NaN,327.1280000000001,342.3931640017295,311.8628359982707,319.68806725975736,323.7444548098464,324.1662249154141,323.3226847042787,668401,956390.4333333333,50.00587738883974,46.06024374756583,NaN,NaN,NaN,NaN,4.402836601642728,13.44877100465324,110700821,0.6870100144612201,-0.8430578626569059,-1.530067877118126
2023-08-29T09:30:00-04:00,321.85,328.98,321.85,327.82,315.0646776908652,NaN,NaN,NaN,NaN,NaN,326.6682000000001,340.3558187497878,312.9805812502125,319.68806725975736,326.2166666666667,326.2166666666667,326.2166666666667,1210337,941269.3,56.89305316027866,47.88727126797687,NaN,NaN,NaN,NaN,4.597633987239676,13.935985656968935,111911158,0.9217120355901312,-0.37792783263046204,-1.2996398682205932
2023-08-29T13:30:00-04:00,327.83,328.55,326.88,328.32,315.0646776908652,NaN,NaN,NaN,NaN,NaN,326.21660000000014,338.03941699763396,314.3937830023663,319.68806725975736,326.77658612414615,327.5755562605288,325.9776159877635,594424,937358.9333333333,57.66278426085117,49.667215755412386,NaN,NaN,NaN,NaN,4.388517273865415,14.38839926269065,112505582,1.0642584480454373,0.030683191836203605,-1.0335752562092337
2023-08-30T09:30:00-04:00,328.67,329.83,326.42,328.27,315.0646776908652,NaN,NaN,NaN,NaN,NaN,326.0794000000001,337.6416284426357,314.51717155736446,319.68806725975736,328.1733333333333,328.17333994058276,328.1733267260838,918396,928425.6666666666,57.552112270243036,50.58219429333194,NaN,NaN,NaN,NaN,4.318623182875026,15.079493391663162,111587186,1.104045616467091,0.3464817643746301,-0.757563852092461
2023-08-30T13:30:00-04:00,328.33,329.13,327.38,328.73,315.31211314667416,NaN,NaN,NaN,NaN,NaN,325.8966000000001,336.9867784367847,314.8064215632155,320.05508074393265,328.2500238600297,328.36193583220233,328.1381118878571,431281,916391.8333333334,58.344230100726584,51.51354208673115,NaN,NaN,NaN,NaN,4.135150098383953,15.721223654280497,112018467,1.1073702376535957,0.6266489449745336,-0.4807212926790621
2023-08-31T09:30:00-04:00,329.1,330.9,326.78,328.32,315.9236080036435,NaN,NaN,NaN,NaN,NaN,325.79000000000013,336.6806940090873,314.899305990913,321.5800645951461,328.6666666666667,328.6666666666667,328.6666666666667,1098484,907973.5666666667,57.317557228014856,52.18414879768178,NaN,NaN,NaN,NaN,4.134067948499385,16.70169262392703,110919983,1.029621270202834,0.8063052950744805,-0.2233159751283536
2023-08-31T13:30:00-04:00,328.34,329.03,327.57,327.89,315.9236080036435,NaN,NaN,NaN,NaN,NaN,325.7348000000001,336.55414655326024,314.91545344674,321.5800645951461,328.48315337764933,328.72541610328125,328.2408906520174,630312,906900.1666666666,56.20058016565818,52.863882467018016,NaN,NaN,NaN,NaN,3.9430630950351415,17.61212809574167,110289671,0.9015096089763652,0.903571036092103,0.0020614271157377018
2023-09-01T09:30:00-04:00,331.31,331.99,327.3,327.35,317.04655192067514,NaN,NaN,NaN,NaN,NaN,325.52020000000016,335.7618033822597,315.2785966177406,323.0962413408935,328.88,328.88,328.88,1012416,895952.2,54.75743614436596,52.608208708326345,NaN,NaN,NaN,NaN,3.9964157311040602,19.06675350484466,109277255,0.7394727461793509,0.9264023598399262,0.18692961366057542
2023-09-01T13:30:00-04:00,327.3,328.74,326.78,328.57,317.04655192067514,NaN,NaN,NaN,NaN,NaN,325.3234000000001,334.92485123195434,315.7219487680459,323.0962413408935,328.6532851491373,329.0291947122337,328.2773755860409,368258,882062.5333333333,57.41783855129486,52.803972490206505,NaN,NaN,NaN,NaN,3.85095746459663,20.19711039641813,109645513,0.6753001447298789,1.031054794572924,0.35575464984304517
2023-09-05T09:30:00-04:00,329,334.85,328.65,333.04,319.15934792772265,NaN,NaN,NaN,NaN,NaN,325.30240000000015,334.83138278723777,315.7734172127625,325.2339944581719,332.18,332.18,332.18,1328152,886348.9333333333,65.43722442577467,54.20139144070455,NaN,NaN,NaN,NaN,4.024460502839729,22.27236237744544,110973665,0.8816992619338216,1.4578787272603222,0.5761794653265006
2023-09-05T13:30:00-04:00,333.05,334.31,332.94,333.56,321.41983211282616,NaN,NaN,NaN,NaN,NaN,325.25460000000015,334.5914998794859,315.9177001205144,325.9321955665375,332.5387116111576,333.15668586080795,331.9207373615073,447505,881591.9666666667,66.23388801636415,55.84129134910563,NaN,NaN,NaN,NaN,3.83485618120832,24.199382074113657,111421170,0.9927783647151529,1.8171524212204417,0.8243740565052888
2023-09-06T09:30:00-04:00,333.45,334.46,330.19,331.14,321.41983211282616,NaN,NaN,NaN,NaN,NaN,325.1320000000001,333.9829335100611,316.2810664899391,325.9321955665375,331.93,331.93,331.93,1362056,886519.2666666667,59.37481631515696,56.89950310374633,NaN,NaN,NaN,NaN,3.8659378825505817,24.88820003445848,110059114,0.8484031046590668,1.8848779373291222,1.0364748326700555
2023-09-06T13:30:00-04:00,331.12,333.29,330.82,332.99,321.41983211282616,NaN,NaN,NaN,NaN,NaN,325.06460000000015,333.6188543426927,316.5103456573076,325.9321955665375,332.0667105162735,332.26921276361907,331.8642082689279,620782,883844.1,62.566274715944246,57.89607773230369,NaN,NaN,NaN,NaN,3.7662280337969705,25.527816711921535,110679896,0.822050130862428,2.0640374962480905,1.2419873653856626
2023-09-07T09:30:00-04:00,331.145,333.09,330.02,330.69,321.41983211282616,NaN,NaN,NaN,NaN,NaN,325.1198000000001,333.7822389082779,316.4573610917223,325.9321955665375,331.26666666666665,331.26666666666665,331.26666666666665,1110823,889377.5333333333,56.61182295635363,58.31253540713333,NaN,NaN,NaN,NaN,3.7164974599543292,25.7999736484328,109569073,0.6043357826790885,1.9974070937345232,1.3930713110554347
2023-09-07T13:30:00-04:00,330.74,331,329.05,329.95,321.41983211282616,NaN,NaN,NaN,NaN,NaN,325.1676000000001,333.90938522726344,316.42581477273677,325.9321955665375,330.7391718618146,331.3635990529064,330.1147446707228,792716,891778.2666666667,54.8046188179032,58.65530265206643,NaN,NaN,NaN,NaN,3.5903190699575904,25.663764243837477,108776357,0.3762709302659588,1.863409973887883,1.4871390436219243
2023-09-08T09:30:00-04:00,329.95,336.16,329.42,334.98,321.41983211282616,NaN,NaN,NaN,NaN,NaN,325.2914000000002,334.4024052222281,316.1803947777723,326.775545043243,333.52000000000004,333.52000000000004,333.52000000000004,1549612,915231.5333333333,63.36538528260418,59.117612089375406,NaN,NaN,NaN,NaN,3.815296279246335,26.593603944545624,110325969,0.521044441413061,2.1384445953882505,1.6174001539751894
2023-09-08T13:30:00-04:00,335.01,336.05,333.17,334.3,322.75991815210335,NaN,NaN,NaN,NaN,NaN,325.44460000000015,334.8925324383444,315.9966675616559,327.1024360345944,333.8220486785565,334.2767881189069,333.3673092382061,683678,911795.9,61.66486432943814,59.40347495141733,NaN,NaN,NaN,NaN,3.7484894021573107,27.457026523774626,109642291,0.5263301230017707,2.2753128077274027,1.748982684725632
2023-09-11T09:30:00-04:00,337.41,338.08,335.43,337.01,324.9281036906441,NaN,NaN,NaN,NaN,NaN,325.53800000000024,335.3423606624449,315.7336393375556,329.03194882767554,336.84,336.84,336.84,944601,891187.3,65.62424464069096,59.98005583502076,NaN,NaN,NaN,NaN,3.7507401591460723,28.615462790202322,110586892,0.6590527187144974,2.572798583118754,1.9137458644042564
2023-09-11T13:30:00-04:00,337.04,338.42,337.04,337.95,326.2484171592512,NaN,NaN,NaN,NaN,NaN,325.7418000000002,336.1287623586231,315.3548376413773,330.47655906214044,337.22830938046934,337.70084212528565,336.75577663565304,637882,885428.6333333333,66.90122829452275,60.59126999172048,NaN,NaN,NaN,NaN,3.5835444334927833,29.749394815256647,111224774,0.7502333861399895,2.8515375970792434,2.101304210939254
2023-09-12T09:30:00-04:00,335.77,336.74,332.23,333.9,326.2484171592512,NaN,NaN,NaN,NaN,NaN,325.83880000000016,336.4359842599589,315.2416157400414,330.47655906214044,334.29,334.29,334.29,1049300,885921.2,57.06526731641544,60.57324928374909,NaN,NaN,NaN,NaN,3.736148402529011,28.93739357089941,110175474,0.4904364603668858,2.714349786397861,2.223913326030975
2023-09-12T13:30:00-04:00,333.95,334.16,331.48,331.91,326.2484171592512,NaN,NaN,NaN,NaN,NaN,325.87480000000016,336.54177875874205,315.2078212412583,330.47655906214044,333.6208558704772,334.4804265328595,332.76128520809493,635881,884820.0666666667,52.946188132793836,60.34079270997307,NaN,NaN,NaN,NaN,3.6607092309197964,27.934376177862735,109539593,0.15461914645193753,2.417187259095897,2.2625681126439594
2023-09-13T09:30:00-04:00,331.03,336.44,331.03,335.99,326.2484171592512,NaN,NaN,NaN,NaN,NaN,326.1052000000002,337.1324210388383,315.0779789611621,330.47655906214044,334.4866666666667,334.4866666666667,334.4866666666667,1042695,884577.4,59.41450005657978,60.67344013227405,NaN,NaN,NaN,NaN,3.785658571568384,27.537546467161413,110582288,0.17577863557882178,2.4822914071174864,2.3065127715386646
2023-09-13T13:30:00-04:00,336.01,336.85,334.46,335.96,326.2484171592512,NaN,NaN,NaN,NaN,NaN,326.3028000000002,337.66997804203726,314.9356219579632,330.47655906214044,334.9485002795151,335.5594326835997,334.33756787543047,595857,888302.5333333333,59.34989568919826,60.811444213552875,NaN,NaN,NaN,NaN,3.6859686735992168,27.26189630320667,109986431,0.1568838203205467,2.502617546939348,2.345733726618801
2023-09-14T09:30:00-04:00,339.1,340.86,336.6,339.36,327.01431050539014,NaN,NaN,NaN,NaN,NaN,326.6084000000002,338.5282633280549,314.6885366719455,331.26235727348217,338.94,338.94,338.94,1277071,890580.3666666667,64.11260147746444,60.716828288673575,NaN,NaN,NaN,NaN,3.7726851969135606,27.82323443292423,111263502,0.33241125742623767,2.761247798401598,2.4288365409753605
2023-09-14T13:30:00-04:00,339.42,339.85,338.18,338.64,327.60411457332697,NaN,NaN,NaN,NaN,NaN,326.9348000000002,339.2541553337577,314.61544466624275,331.33688581878573,338.9221092195857,338.9460770936488,338.8981413455226,711565,893025.8666666667,62.44411808221906,60.44613043623464,NaN,NaN,NaN,NaN,3.6224933971340216,28.34447698194768,110551937,0.3569109500060055,2.8749752284828674,2.518064278476862
2023-09-15T09:30:00-04:00,337.11,337.49,331.04,331.15,327.60411457332697,NaN,NaN,NaN,NaN,NaN,327.1034000000002,339.41815057642117,314.7886494235792,331.33688581878573,333.22666666666663,333.22666666666663,333.22666666666663,1448774,890179.1333333333,48.34821415212522,59.65851599601808,NaN,NaN,NaN,NaN,3.906601011624446,26.546865767209937,109103163,-0.14739399245468565,2.333821787908505,2.4812157803631907
2023-09-15T13:30:00-04:00,331.14,331.75,329.66,330.16,327.60411457332697,NaN,NaN,NaN,NaN,NaN,327.2470000000002,339.533489653253,314.96051034674736,331.33688581878573,332.2470751912802,333.54652231594673,330.9476280666137,823329,896500.5666666667,46.8430474699828,58.535428335592265,NaN,NaN,NaN,NaN,3.7768437965084125,24.769298620381576,108279834,-0.5415561815639229,1.804270553408287,2.34582673497221
2023-09-18T09:30:00-04:00,327.45,330.42,326.85,328.47,NaN,NaN,NaN,340.2626662224285,340.2626662224285,340.2626662224285,327.3924000000002,339.5607041118932,315.2240958881072,331.33688581878573,328.58,328.58,328.58,1023336,888199.1666666666,44.307246773882284,57.65653003684431,NaN,NaN,NaN,NaN,3.7620692396149544,23.77371675202773,107256498,-0.8894584420059828,1.2340036824647314,2.123462124470714
2023-09-18T13:30:00-04:00,328.51,329.32,326.36,329.09,NaN,NaN,NaN,339.34277230322726,NaN,NaN,327.55020000000013,339.5972288386664,315.50317116133385,331.33688581878573,328.45887591939135,328.61537643005175,328.30237540873094,612982,884572.9333333333,45.47343271452369,56.990016743745784,NaN,NaN,NaN,NaN,3.7047785796424564,22.958863913839235,107869480,-1.040682204862544,0.8226093683925342,1.863291573255078
2023-09-19T09:30:00-04:00,326,328.75,324.51,326.78,NaN,NaN,NaN,338.23446447126236,NaN,NaN,327.63700000000017,339.59773124852944,315.6762687514709,331.33688581878573,326.68,326.68,326.68,970302,886706.9333333333,41.94895152221971,55.46027147514689,NaN,NaN,NaN,NaN,3.76729439538228,22.611589527502733,106899178,-1.2453181259263564,0.3066439158471326,1.551962041773489
2023-09-19T13:30:00-04:00,326.8,329.39,326.8,328.65,NaN,NaN,NaN,338.23446447126236,NaN,NaN,327.7292000000002,339.6486005486608,315.80979945133964,331.33688581878573,327.2094858304453,327.9623617060352,326.4566099548554,479920,880424.2333333333,45.62317536371822,54.31443654902404,NaN,NaN,NaN,NaN,3.6846305099978323,22.088477303957347,107379098,-1.2031082331931855,0.0480767502820072,1.2511849834751927
2023-09-20T09:30:00-04:00,329.49,329.57,324.83,326.08,NaN,NaN,NaN,338.23446447126236,NaN,NaN,327.7564000000002,339.6543963086013,315.85840369139913,331.33688581878573,326.8266666666666,326.8266732739161,326.8266600594171,928675,871035.5,41.715411808449325,52.606662775292484,NaN,NaN,NaN,NaN,3.7600140449979875,22.044953281508015,106450423,-1.2890011792190375,-0.3600664905486042,0.9289346886704333
2023-09-20T13:30:00-04:00,326.08,326.62,320.52,320.79,NaN,NaN,NaN,335.4359668922202,NaN,NaN,327.7328000000002,339.6811870308709,315.78441296912956,331.33688581878573,324.44710959729457,326.51886937113136,322.3753498234578,1225116,892058.5666666667,35.05887964219019,50.33220930012588,NaN,NaN,NaN,NaN,3.927155898926704,22.82844374326683,105225307,-1.6213300038110863,-1.0977278160934247,0.5236021877176615
2023-09-21T09:30:00-04:00,319.24,325.34,316.8,322.75,NaN,NaN,NaN,333.5611502153011,NaN,NaN,327.7600000000002,339.65658640112537,315.86341359887507,331.33688581878573,321.63,321.63,321.63,2132532,932529.7666666667,38.94619115913213,49.03798957460564,NaN,NaN,NaN,NaN,4.25664476328908,24.13080395028296,107357839,-1.6243254349814984,-1.5068046060092115,0.11752082897228694
2023-09-21T13:30:00-04:00,322.81,323.08,319.5,319.56,NaN,NaN,NaN,333.5611502153011,NaN,NaN,327.7442000000002,339.68213623033057,315.80626376966984,326.8795086550286,321.3479377989555,321.77101927148163,320.9248563264294,947845,949748.5666666667,35.24804634001255,47.773836589406976,NaN,NaN,NaN,NaN,4.208312994482716,25.34013842822651,106409994,-1.7457028523790752,-2.064607736501557,-0.3189048841224819
2023-09-22T09:30:00-04:00,321.43,321.45,317.81,318.24,NaN,NaN,NaN,331.97375463832185,NaN,NaN,327.7196000000002,339.7304823722293,315.7087176277711,322.21660692402287,319.1666666666667,319.1666666666667,319.1666666666667,1477014,962366.2333333333,33.817100417164696,45.945450900877326,NaN,NaN,NaN,NaN,4.167719209162521,26.71371063535819,104932980,-1.8115991592579745,-2.58340383319495,-0.7718046739369756
2023-09-22T13:30:00-04:00,318.19,319.3,316.12,316.95,NaN,NaN,NaN,329.9263112456709,NaN,NaN,327.7202000000002,339.7289271531768,315.7114728468236,321.0082855392183,318.5898100760291,319.39830326947623,317.78131688258196,751913,966419.6,32.43144595277438,44.022704491132764,NaN,NaN,NaN,NaN,4.097167837079485,28.22770778297045,104181067,-1.8332230567691066,-3.063333494898359,-1.2301104381292522
2023-09-25T09:30:00-04:00,316.63,317.67,315.07,315.66,NaN,NaN,NaN,328.3855698254131,NaN,NaN,327.7134000000002,339.7490208713701,315.67777912863033,320.48700219607974,316.1333333333334,316.1333333333334,316.1333333333334,977126,965243.2666666667,31.06082838004977,41.66186355560315,NaN,NaN,NaN,NaN,3.9902272772880947,29.777738455513425,103203941,-1.8217860191790405,-3.5073429621030527,-1.6855569429240123
2023-09-25T13:30:00-04:00,315.66,317.63,315,317.59,NaN,NaN,NaN,328.14304392425794,NaN,NaN,327.7348000000002,339.6942991466806,315.7753008533198,320.48700219607974,316.33998017861296,316.6274916290476,316.0524687281783,504775,969793.8333333334,35.45583233584114,39.73412885943329,NaN,NaN,NaN,NaN,3.8930681860532306,31.226975058688893,103708716,-1.5805814800335471,-3.6612837929659463,-2.080702312932399
2023-09-26T09:30:00-04:00,315.16,315.88,310.83,311.59,NaN,NaN,NaN,325.56722374588264,NaN,NaN,327.5354000000002,340.2110732112926,314.8597267887078,320.48700219607974,312.76666666666665,312.76666666666665,312.76666666666665,1820378,986201.3666666667,29.2193181839977,38.36777914742419,NaN,NaN,NaN,NaN,4.097849029906571,33.111578241010385,101888338,-1.7104790719253087,-4.218801152839035,-2.508322080913726
2023-09-26T13:30:00-04:00,311.58,312.44,310.07,312.07,NaN,NaN,NaN,323.2353044847061,NaN,NaN,327.3402000000002,340.6462302058665,314.0341697941339,320.0776017568638,312.27740516638613,312.8834641112674,311.67134622150485,1186353,1010829.6333333333,30.27592080827513,37.18441295730221,NaN,NaN,NaN,NaN,3.974431242056102,34.94876902429285,103074691,-1.648729854357864,-4.569234398861056,-2.920504544503192
2023-09-27T09:30:00-04:00,312.3,313.7,310.18,310.37,NaN,NaN,NaN,323.2353044847061,NaN,NaN,327.0862000000002,341.1706816106049,313.0017183893955,315.9760814054911,311.4166666666667,311.4166666666667,311.4166666666667,1280898,1008124.3666666667,28.644981298760058,36.06567970907919,NaN,NaN,NaN,NaN,3.941971867623522,36.09987439580243,101793793,-1.605461843738405,-4.927331849176198,-3.3218700054377934
2023-09-27T13:30:00-04:00,310.35,314.29,309.69,312.87,NaN,NaN,NaN,323.2353044847061,NaN,NaN,326.8950000000002,341.4778667963294,312.312133203671,312.55486512439285,311.7749950888473,312.2017878266715,311.3482023510231,902907,1017528.5333333333,34.253984662082615,35.26429056247626,NaN,NaN,NaN,NaN,3.9889738770789864,36.909047300483586,102696700,-1.3043523158794939,-4.9523104002871605,-3.6479580844076667
2023-09-28T09:30:00-04:00,311.125,315.48,309.45,313.93,NaN,NaN,NaN,323.2353044847061,NaN,NaN,326.5970000000002,341.61207735576187,311.58192264423855,311.0618920995143,312.9533333333334,312.9533333333334,312.9533333333334,1400549,1027186.0666666667,36.53205005550118,34.877369029139224,NaN,NaN,NaN,NaN,4.134761457287633,37.137234788965884,104097249,-0.9463419323716571,-4.830885499872238,-3.884543567500581
2023-09-28T13:30:00-04:00,313.93,314.65,312.72,313.66,NaN,NaN,NaN,323.2353044847061,NaN,NaN,326.33000000000015,341.7748381020867,310.88516189791363,310.01551367961144,313.1811130259138,313.5170848341505,312.8451412176771,643758,1022220.8,36.18809236650057,34.20343452933796,NaN,NaN,NaN,NaN,3.977278496052798,37.34912317112802,103453491,-0.6541552789717722,-4.7022376662152965,-4.048082387243524
2023-09-29T09:30:00-04:00,317.77,319.49,315.23,315.98,NaN,NaN,NaN,323.2353044847061,NaN,NaN,326.2128000000002,341.87948671543427,310.5461132845661,308.7655023766643,316.90000000000003,316.90000000000003,316.90000000000003,1299049,1013868.7,41.30211163844389,34.17391308862329,NaN,NaN,NaN,NaN,4.1096157463347405,35.64587499853065,104752540,-0.2517638700821987,-4.362787224846272,-4.1110233547640735
2023-09-29T13:30:00-04:00,315.94,317.87,314.98,315.71,NaN,NaN,NaN,323.2353044847061,NaN,NaN,326.1260000000002,341.9753290709577,310.2766709290427,308.7655023766643,316.627541071221,316.97412463689335,316.28095750554866,802808,1017839.7,40.891384958085595,34.590520611187245,NaN,NaN,NaN,NaN,4.022500335882258,34.128855654021585,103949732,0.033893793451842846,-4.06865611294927,-4.102549906401113
2023-10-02T09:30:00-04:00,316.38,321.4,315.17,318.55,NaN,NaN,NaN,323.2353044847061,NaN,NaN,326.0824000000002,342.0026997760578,310.16210022394256,310.2653215210652,318.3733333333333,318.3733333333333,318.3733333333333,1385779,1032545.6333333333,46.875683775476205,35.1569129409261,NaN,NaN,NaN,NaN,4.180178883319237,31.782546959018397,105335511,0.42980604381786325,-3.565292351628784,-3.9950983954466475
2023-10-02T13:30:00-04:00,318.56,321.88,318.28,321.81,NaN,NaN,NaN,323.2353044847061,NaN,NaN,326.0600000000002,342.00111664845207,310.1188833515483,311.17225721685213,319.2294981118096,320.3348901009267,318.1241061226925,831335,1038994.0666666667,52.784869323918535,36.40954315406224,NaN,NaN,NaN,NaN,4.138737534510722,29.742637722728354,106166846,0.8998931627343731,-2.8702319420286813,-3.7701251047630544
2023-10-03T09:30:00-04:00,320.8,321.37,312.54,312.73,NaN,NaN,NaN,323.2353044847061,NaN,NaN,325.8314000000002,342.19711049968305,309.46568950031735,311.17225721685213,315.5466666666667,315.5466666666667,315.5466666666667,1544889,1055513.7,39.579341375939144,36.8211317939747,NaN,NaN,NaN,NaN,4.505256282045669,28.879016129048736,104621957,0.602267898639139,-3.0172902314641306,-3.6195581301032695
2023-10-03T13:30:00-04:00,312.75,313.49,311.215,313.35,NaN,NaN,NaN,323.2353044847061,NaN,NaN,325.6236000000002,342.350125884341,308.89707411565934,311.17225721685213,314.45939387870345,315.8483683851181,313.0704193722888,946642,1065872.4,40.67079520723342,37.40965674072178,NaN,NaN,NaN,NaN,4.345952261899552,28.358643306371988,105568599,0.45671604274290134,-3.048663076674643,-3.5053791194175443
2023-10-04T09:30:00-04:00,314.02,319.25,314.02,317.22,NaN,NaN,NaN,323.2353044847061,NaN,NaN,325.4116000000002,342.2894137731014,308.533786226899,311.17225721685213,316.83,316.83,316.83,1490523,1080800,47.09501602909716,38.55495585851088,NaN,NaN,NaN,NaN,4.456955671763868,26.380645067257436,107059122,0.6204773809152617,-2.7297823932734673,-3.350259774188729
2023-10-04T13:30:00-04:00,317.21,320.04,316.16,318.96,NaN,NaN,NaN,323.2353044847061,NaN,NaN,325.2244000000002,342.1764963470449,308.27230365295543,311.17225721685213,317.3907779307697,318.1380880568692,316.64346780467014,839303,1088914.8666666667,49.73061005636892,39.57458283854857,NaN,NaN,NaN,NaN,4.415744552352163,24.730738735855436,107898425,0.8321797793952674,-2.310035049944645,-3.1422148293399124
2023-10-05T09:30:00-04:00,319.18,319.97,314.9,316.7,NaN,NaN,NaN,323.2353044847061,NaN,NaN,324.9930000000002,342.08775252817225,307.8982474718282,311.17225721685213,317.19,317.19,317.19,1147943,1084610.6,46.49098639381325,40.80827342496398,NaN,NaN,NaN,NaN,4.462477084327012,23.04901547483131,106750482,0.8056655548329039,-2.1351328857987824,-2.9407984406316863
2023-10-05T13:30:00-04:00,316.71,319.91,316.26,319.395,NaN,NaN,NaN,323.2353044847061,NaN,NaN,324.8063000000002,341.93758516018113,307.67501483981926,311.17225721685213,317.7877770333849,318.4501231421741,317.12543092459566,935037,1092059.6666666667,50.62184779158004,42.26155392377147,NaN,NaN,NaN,NaN,4.404443006875085,21.48741530388034,107685519,0.9456119348823941,-1.7587835220286934,-2.7043954569110875
2023-10-06T09:30:00-04:00,316.47,326.66,316.23,326.44,307.77907380510226,307.77907380510226,307.77907380510226,NaN,NaN,NaN,324.7687000000002,341.8772097901429,307.6601902098575,312.3276501406836,323.11000000000007,323.11000000000007,323.11000000000007,1902818,1107194.4666666666,59.43734751701477,44.4610086536468,NaN,NaN,NaN,NaN,4.834839934955437,21.399087348026555,109588337,1.4580079732617954,-0.8818854903338433,-2.3398934635956388
2023-10-06T13:30:00-04:00,326.47,329.18,326.34,327.22,314.2576900242885,NaN,NaN,NaN,NaN,NaN,324.7553000000002,341.8550572391961,307.6555427608043,316.29412011254686,324.8301634397284,327.00505845241133,322.6552684270454,1190310,1119427.1666666667,60.28279963913069,46.32020972343595,NaN,NaN,NaN,NaN,4.692351368172908,21.764192696931122,110778647,1.773846835993864,-0.12258491860330878,-1.8964317545971727
2023-10-09T09:30:00-04:00,324.71,328.76,323.18,328.75,314.2576900242885,NaN,NaN,NaN,NaN,NaN,324.7833000000002,341.90453168581354,307.6620683141869,316.29412011254686,326.8966666666667,326.8966666666667,326.8966666666667,1551176,1137021.8333333333,61.95778117032358,48.1363333744947,NaN,NaN,NaN,NaN,4.755754841874841,21.237164500575652,112329823,1.993750966003778,0.5957569529075499,-1.397994013096228
2023-10-09T13:30:00-04:00,328.77,330.31,328.71,329.91,316.2627712824612,NaN,NaN,NaN,NaN,NaN,324.8101000000002,341.959129650665,307.66107034933543,319.03103687203,327.82613569856255,329.1257621550258,326.5265092420993,793403,1143035.8666666667,63.22410812327622,50.067477357121525,NaN,NaN,NaN,NaN,4.530343781740926,21.042457568076273,113123226,2.113840628880215,1.2443067730040411,-0.8695338558761743
2023-10-10T09:30:00-04:00,330.84,331.1,327.69,328.36,316.28491804234926,NaN,NaN,NaN,NaN,NaN,324.7165000000002,341.7354252598184,307.69757474018206,320.371829497624,329.05,329.05,329.05,1680664,1166714.6,60.33408616370763,51.42690410892608,NaN,NaN,NaN,NaN,4.45031922590229,20.582127822985193,111442562,1.9873094795930712,1.614602993615165,-0.37270648597790645
2023-10-10T13:30:00-04:00,328.35,329.58,327.88,328.41,316.28491804234926,NaN,NaN,NaN,NaN,NaN,324.6135000000002,341.4787345669827,307.7482654330177,320.371829497624,328.9144254501053,329.11308264904324,328.71576825116733,782760,1176809.2666666666,60.39697445379067,52.820160501476444,NaN,NaN,NaN,NaN,4.2538678526235545,20.15467877397205,112225322,1.810412936822279,1.8903096850499423,0.0798967482276633
2023-10-11T09:30:00-04:00,331.25,332.57,329.31,329.57,318.20610300966126,NaN,NaN,NaN,NaN,NaN,324.5821000000002,341.4044044901525,307.7597955098479,322.9439708784794,330.48333333333335,330.48333333333335,330.48333333333335,1328897,1190150,61.90594978702477,53.89375093087277,NaN,NaN,NaN,NaN,4.247163006007584,20.373464555180227,113554219,1.6779328597811891,2.17731282295415,0.4993799631729607
2023-10-11T13:30:00-04:00,329.56,332.81,329.14,332.45,318.3194619637676,NaN,NaN,NaN,NaN,NaN,324.5713000000002,341.37267932550355,307.7699206744968,323.2741767027835,330.8393260047902,331.3119026421261,330.36674936745436,754100,1174449.4666666666,65.4280141133022,54.79683270154304,NaN,NaN,NaN,NaN,4.205937077007044,20.624059595613478,114308319,1.6861790208889336,2.6071037392841276,0.9209247183951941
2023-10-12T09:30:00-04:00,330.63,333.62,329.59,330.89,318.97516823814175,NaN,NaN,NaN,NaN,NaN,324.5753000000002,341.3825984634488,307.7680015365516,323.9763413622268,331.3666666666667,331.36667048136394,331.3666628519694,1631085,1157734.5666666667,62.07984378720655,56.40401144520499,NaN,NaN,NaN,NaN,4.193370142935114,21.02246875788703,112677234,1.495003813938744,2.789679485818624,1.29467567187988
2023-10-12T13:30:00-04:00,330.87,331.67,328.71,331.18,318.97516823814175,NaN,NaN,NaN,NaN,NaN,324.5999000000002,341.4421573890598,307.75764261094065,323.9763413622268,331.0666252557014,331.4716069997574,330.6616435116454,895299,1155983.0333333334,62.464387218790726,57.960696588887664,NaN,NaN,NaN,NaN,4.1052722755826085,21.082035121842942,113572533,1.3035121391366313,2.924065845800669,1.6205537066640379
2023-10-13T09:30:00-04:00,332.38,333.83,326.66,326.76,318.97516823814175,NaN,NaN,NaN,NaN,NaN,324.4355000000002,341.02788045005525,307.8431195499452,323.9763413622268,329.08333333333326,329.08333994058273,329.0833267260838,1670320,1162426.5666666667,53.55084083198786,58.42182693195128,NaN,NaN,NaN,NaN,4.324181398755276,21.602989856653384,111902213,0.8183082540144502,2.6434390241821006,1.8251307701676505
2023-10-13T13:30:00-04:00,326.76,329.64,326.35,327.73,318.97516823814175,NaN,NaN,NaN,NaN,NaN,324.30410000000023,340.6846266935846,307.92357330641585,323.9763413622268,328.6415125070977,329.21131088930434,328.071714124891,1004268,1170838.4,55.06623294590757,58.80294285263261,NaN,NaN,NaN,NaN,4.250311298844182,21.970006816904473,112906481,0.5165585529737398,2.470828961384825,1.9542704084110853
2023-10-16T09:30:00-04:00,331.05,336.14,330.6,333.48,320.06763962981546,NaN,NaN,NaN,NaN,NaN,324.2335000000002,340.4236913824165,308.04330861758393,323.9763413622268,333.4066666666667,333.4066666666667,333.4066666666667,1850703,1199957.6333333333,62.81150331635052,59.96869406138528,NaN,NaN,NaN,NaN,4.54743192035531,23.47911318413998,114757184,0.6494836899805865,2.766125020886818,2.1166413309062317
2023-10-16T13:30:00-04:00,333.5,334.5,332.23,332.66,320.35774691936933,NaN,NaN,NaN,NaN,NaN,324.1277000000002,340.0244482473437,308.23095175265667,323.9763413622268,333.3065893314112,333.43952762441677,333.17365103840564,1048837,1218093.0333333334,61.19161032469097,60.72367709946463,NaN,NaN,NaN,NaN,4.3847582117585,24.880426239430093,113708347,0.6271240831058678,2.9005464347885663,2.2734223516826986
2023-10-17T09:30:00-04:00,329.59,333.45,327.41,332.21,320.35774691936933,NaN,NaN,NaN,NaN,NaN,324.0939000000002,339.9143959833525,308.2734040166479,323.9763413622268,331.0233333333333,331.0233333333333,331.0233333333333,1351019,1202447.7333333334,60.272954227204906,60.783363293049646,NaN,NaN,NaN,NaN,4.502989768061462,24.535185698912628,112357328,0.5307903276444099,2.9369102612382108,2.406119933593801
2023-10-17T13:30:00-04:00,332.2,332.24,329.9,332.04,320.35774691936933,NaN,NaN,NaN,NaN,NaN,324.0965000000002,339.9221751198565,308.27082488014395,323.9763413622268,331.15396817575646,331.33079981772363,330.9771365337893,737326,1187480.1666666667,59.90705613145985,60.75652447107315,NaN,NaN,NaN,NaN,4.3484904989142175,24.214605197003554,111620002,0.4098001509558791,2.91837012228865,2.5085699713327707
2023-10-18T09:30:00-04:00,332.5,335.56,331.35,332.72,320.5129216022051,NaN,NaN,NaN,NaN,NaN,324.0311000000002,339.6857362831994,308.376463716801,324.8755762240382,333.21000000000004,333.21000000000004,333.21000000000004,1519590,1195436.5666666667,60.928793248495246,60.6830253337997,NaN,NaN,NaN,NaN,4.338598320420344,24.56801705249387,113139592,0.33300930891221414,2.9248316074730383,2.591822298560824
2023-10-18T13:30:00-04:00,332.69,332.69,328.31,330.14,320.5129216022051,NaN,NaN,NaN,NaN,NaN,323.9147000000002,339.296996370806,308.5324036291944,324.8755762240382,332.1024571021861,333.48365047399494,330.7212637303773,977099,1197909.6333333333,55.182736217794684,60.1086416262653,NaN,NaN,NaN,NaN,4.343698440390321,23.96380058864074,112162493,0.07914267674982822,2.6907506444981095,2.6116079677482813
2023-10-19T09:30:00-04:00,332.11,336.88,332.02,335,321.1646145177116,NaN,NaN,NaN,NaN,NaN,323.8275000000002,338.9049916016987,308.7500083983017,324.9079687833844,334.6333333333333,334.6333333333333,334.6333333333333,2187598,1224144.6,62.37999962985613,60.254778302418764,NaN,NaN,NaN,NaN,4.514862837505299,24.18436858381457,114350091,0.20221951485609946,2.8643823613184054,2.662162846462306
2023-10-19T13:30:00-04:00,335.05,335.64,330.91,331.26,321.1646145177116,NaN,NaN,NaN,NaN,NaN,323.6799000000002,338.3124036121389,309.0473963878615,324.9079687833844,333.8567609743008,334.84335980869616,332.87016213990546,1355346,1247864.2,55.05304621356313,59.87306914240252,NaN,NaN,NaN,NaN,4.5302297776834894,24.06357782015834,112994745,0.005812518278710321,2.6694284943106936,2.6636159760319833
2023-10-20T09:30:00-04:00,331.89,331.9,325.45,328.22,321.1646145177116,NaN,NaN,NaN,NaN,NaN,323.62130000000025,338.156816338926,309.0857836610745,324.9079687833844,328.5233333333333,328.5233333333333,328.5233333333333,1619365,1258541.4,49.920384418896546,59.01695733039336,NaN,NaN,NaN,NaN,4.667356222134667,22.554060262518853,111375380,-0.335885660372758,2.2437589005660357,2.5796445609387937
2023-10-20T13:30:00-04:00,328.28,328.74,326.38,326.63,321.1646145177116,NaN,NaN,NaN,NaN,NaN,323.55070000000023,337.99248354772084,309.10891645227963,324.9079687833844,328.0763997889238,328.6841380440658,327.46866153378187,875785,1260973.9666666666,47.429693506707906,57.731363001350914,NaN,NaN,NaN,NaN,4.502545063410763,21.1523653875679,110499595,-0.6574359901376323,1.7578495732667534,2.4152855634043857
2023-10-23T09:30:00-04:00,325.51,332.71,324.4,331.59,321.1646145177116,NaN,NaN,NaN,NaN,NaN,323.61310000000026,338.16590054007133,309.0602994599292,324.9079687833844,329.5666666666666,329.5666666666666,329.5666666666666,1540105,1266118.1666666667,54.976309341728545,57.22396768381676,NaN,NaN,NaN,NaN,4.7745061303099945,20.673741315535892,112039700,-0.5299977113132206,1.7527884242628602,2.282786135576081
2023-10-23T13:30:00-04:00,331.6,332.25,329.08,329.17,321.1646145177116,NaN,NaN,NaN,NaN,NaN,323.61470000000025,338.16992619676665,309.05947380323386,324.9079687833844,329.7688538850901,330.05246040791053,329.48524736226966,782754,1264498.8,51.12042034805647,56.41368433590718,NaN,NaN,NaN,NaN,4.659898549573567,20.22930467722046,111256946,-0.5975889831203793,1.5357999066756065,2.133388889795986
2023-10-24T09:30:00-04:00,331.36,331.8,327.6,329.18,321.1646145177116,NaN,NaN,NaN,NaN,NaN,323.66270000000026,338.2750806697985,309.050319330202,324.9079687833844,329.5266666666667,329.5266666666667,329.5266666666667,1503039,1263103.8,51.13567176489985,56.2411722596866,NaN,NaN,NaN,NaN,4.627048653175454,19.417571361629122,112759985,-0.627438803506406,1.3490903854129783,1.9765291889193843
2023-10-24T13:30:00-04:00,329.24,331.65,329.04,330.79,321.1646145177116,NaN,NaN,NaN,NaN,NaN,323.70550000000026,338.3884275350346,309.0225724649659,324.9079687833844,329.9292900527046,330.40583702362477,329.4527430817844,1072894,1267312.2,53.643533629810264,56.13955087996537,NaN,NaN,NaN,NaN,4.482973749377204,18.663818997151452,113832879,-0.5285299143467668,1.3158667959859258,1.8443967103326926
2023-10-25T09:30:00-04:00,345.01,346.2,337.64,338.64,327.09735450361404,NaN,NaN,NaN,NaN,NaN,323.95670000000024,339.2121265243266,308.7012734756739,329.856965215201,340.82666666666665,340.82666666666665,340.82666666666665,3956359,1349506.7333333334,63.48413671867921,56.18759612298885,NaN,NaN,NaN,NaN,5.263475624421687,20.291421126321232,117789238,0.04532432088414806,1.9010521114378776,1.8557277905537295
2023-10-25T13:30:00-04:00,338.6,341.2,337.93,340.71,327.09735450361404,NaN,NaN,NaN,NaN,NaN,324.3551000000002,340.28446765722947,308.42573234277097,329.856965215201,340.5875531438835,340.97901785917435,340.19608842859265,1476110,1370733.6333333333,65.56027573299463,56.49964365215339,NaN,NaN,NaN,NaN,5.121084508391566,21.802765960550317,119265348,0.5178133103905449,2.5029944285419106,1.9851811181513657
2023-10-26T09:30:00-04:00,340.54,341.63,326.94,327.86,NaN,NaN,NaN,350.21957988410367,350.21957988410367,350.21957988410367,324.45730000000026,340.4097171472265,308.504882852774,329.856965215201,332.1433333333333,332.1433333333333,332.1433333333333,3160233,1437809.9666666666,47.504170960765805,55.587587704550586,NaN,NaN,NaN,NaN,5.804578472077883,20.796362389160983,116105115,-0.05133987136971907,1.9210062789392168,1.972346150308936
2023-10-26T13:30:00-04:00,327.87,331.5,327.31,327.93,NaN,NaN,NaN,345.18664443482623,NaN,NaN,324.62470000000025,340.54367011867186,308.70572988132864,329.856965215201,331.15085230310007,332.6410519985444,329.6606526076557,1401763,1453367.5,47.5888520746884,54.70771598620978,NaN,NaN,NaN,NaN,5.689251438358034,19.861844787156603,117506878,-0.4188970053726955,1.4487248935930666,1.867621898965762
2023-10-27T09:30:00-04:00,330.33,336.73,329.78,331.63,NaN,NaN,NaN,345.18664443482623,NaN,NaN,324.89250000000027,340.8233357909765,308.96166420902404,329.856965215201,332.7133333333333,332.7133333333333,332.7133333333333,2567692,1475529.9666666666,51.996650011764395,54.06970575501471,NaN,NaN,NaN,NaN,5.911447764189604,19.760879398036717,120074570,-0.40821681921453035,1.357350874947599,1.7655676941621294
2023-10-27T13:30:00-04:00,331.52,331.66,328.4,329.84,NaN,NaN,NaN,345.18664443482623,NaN,NaN,325.15030000000024,340.9755090551479,309.3250909448526,329.856965215201,331.74887139741685,333.0599276985826,330.4378150962511,1389538,1482170.9,49.81399369243795,53.68622414606066,NaN,NaN,NaN,NaN,5.7220586381760645,19.396412032253103,118685032,-0.5104532471147536,1.1275011352686874,1.637954382383441
2023-10-30T09:30:00-04:00,333.34,339.42,331.83,336.95,NaN,NaN,NaN,345.18664443482623,NaN,NaN,325.5761000000003,341.50234843329724,309.6498515667033,329.856965215201,336.0666666666667,336.0666666666667,336.0666666666667,1803243,1490573.1333333333,57.453646025018955,53.33434174571515,NaN,NaN,NaN,NaN,5.997625878306349,20.0474210586932,120488275,-0.10896358447876087,1.50174990178499,1.6107134862637509
2023-10-30T13:30:00-04:00,337.06,338.15,336.2,337.33,NaN,NaN,NaN,345.18664443482623,NaN,NaN,325.97090000000026,342.06350795393644,309.8782920460641,329.856965215201,336.45423217228483,337.0013783733478,335.9070859712219,904769,1494285.3333333333,57.82318767249106,53.53220899278143,NaN,NaN,NaN,NaN,5.708509744141609,20.65192944038757,121393044,0.15796055392093877,1.8081641786649243,1.6502036247439855
2023-10-31T09:30:00-04:00,338.85,339,334.69,336.87,NaN,NaN,NaN,345.18664443482623,NaN,NaN,326.47650000000027,342.31657301116724,310.6364269888333,329.856965215201,336.85333333333335,336.85333333333335,336.85333333333335,1330770,1482622.2,57.1757885254854,54.05045214325206,NaN,NaN,NaN,NaN,5.608616190988637,20.888897337670556,120062274,0.27258216262922175,1.9909313280305128,1.718349165401291
2023-10-31T13:30:00-04:00,336.89,338.49,336.88,338.14,NaN,NaN,NaN,345.18664443482623,NaN,NaN,326.99790000000024,342.62158971655333,311.37421028344716,329.856965215201,337.21062558953906,337.6835733973436,336.73767778173453,759493,1481846.6333333333,58.555436340162004,54.84514805992735,NaN,NaN,NaN,NaN,5.323715034489449,21.108938956576186,120821767,0.39551813070372766,2.2127468287809506,1.817228698077223
2023-11-01T09:30:00-04:00,339.8,346.51,339.64,343.98,327.2160312177055,327.2160312177055,327.2160312177055,NaN,NaN,NaN,327.6701000000003,343.26640218863093,312.0737978113696,332.50315815756744,343.3766666666667,343.3766666666667,343.3766666666667,2150907,1509246.9666666666,64.25778915399928,55.50811090366097,NaN,NaN,NaN,NaN,5.541306817740202,22.284036686186276,122972674,0.8079661293863238,2.8271863598101277,2.019220230423804
2023-11-01T13:30:00-04:00,343.99,347.42,343.04,346.11,329.4946207078098,NaN,NaN,NaN,NaN,NaN,328.3349000000003,344.1827945591885,312.4870054408121,334.024526526054,344.23296269219196,345.2841235987466,343.18180178563733,1427352,1531688.7,66.09036143455819,56.57739240983967,NaN,NaN,NaN,NaN,5.458356330758759,23.470535152267818,124400026,1.1416484034379617,3.446280734721256,2.3046323312832944
2023-11-02T09:30:00-04:00,347.07,348.8,344.78,347.48,331.2216834029093,NaN,NaN,NaN,NaN,NaN,329.00590000000034,345.19470770035116,312.8170922996495,336.07362122084317,347.02,347.02,347.02,1816489,1537868.8333333333,67.25334167585474,57.72865454633644,NaN,NaN,NaN,NaN,5.355616592847421,24.719512938436278,126216515,1.357366198902315,4.001340079911188,2.643973881008873
2023-11-02T13:30:00-04:00,347.5,348.81,346.91,348.4,332.74024324823165,NaN,NaN,NaN,NaN,NaN,329.70070000000027,346.17483925032485,313.2265607496757,337.67889697667454,347.3522590657612,347.8302843373777,346.8742337941447,877576,1537278.0666666667,68.04589372701727,58.75739455327981,NaN,NaN,NaN,NaN,5.108786836215461,25.880387922789,127094091,1.45602620039273,4.464006631499785,3.0079804311070553
2023-11-03T09:30:00-04:00,349.64,353.78,347.34,353.37,335.2493231005847,NaN,NaN,NaN,NaN,NaN,330.44850000000025,347.7377653689857,313.1592346310148,341.6551175813396,351.4966666666666,351.4966666666666,351.4966666666666,2029680,1549256.7333333334,71.98982925468385,59.36494402013728,NaN,NaN,NaN,NaN,5.203873490771499,27.47891237350769,129123771,1.731287684327528,5.172090036516465,3.4408023521889373
2023-11-03T13:30:00-04:00,353.37,354.38,352.61,352.88,338.63889932328544,NaN,NaN,NaN,NaN,NaN,331.19190000000026,349.0688132559051,313.3149867440954,343.7950940650717,352.0986896214499,352.94556398885277,351.2518152540471,1025689,1549970.7666666666,71.05862636682042,59.75768335112484,NaN,NaN,NaN,NaN,4.9585968128592475,29.021642802227426,128098082,1.7504194950028262,5.62882672094247,3.878407225939644
2023-11-06T09:30:00-05:00,353.45,357.53,353.35,354.56,340.62508571768154,NaN,NaN,NaN,NaN,NaN,331.9121000000003,350.5778256049457,313.2463743950549,346.73707525205737,355.1466666666667,355.1466666666667,355.1466666666667,1729139,1545918.6333333333,72.37787931719896,61.53437680515577,NaN,NaN,NaN,NaN,4.9365541833693,30.752430012479532,129827221,1.7425060377877077,6.056539773174279,4.314033735386571
2023-11-06T13:30:00-05:00,354.53,356.67,354.37,356.62,341.064854548696,NaN,NaN,NaN,NaN,NaN,332.6083000000003,352.284294674703,312.93230532529765,346.8856602016459,355.3833980949234,355.72856397942826,355.0382322104185,813366,1538069.6,73.94615831318521,63.41704153647697,NaN,NaN,NaN,NaN,4.748228884557208,32.35958956485649,130640587,1.73833515563431,6.486952679929459,4.748617524295149
2023-11-07T09:30:00-05:00,359.32,362.46,357.59,362.1,345.43054297830076,NaN,NaN,NaN,NaN,NaN,333.5957000000003,354.1191991178189,313.07220088218173,351.7125281613167,360.7166666666667,360.7166666666667,360.7166666666667,1740794,1551062.1,77.59105873080033,65.24521358783669,NaN,NaN,NaN,NaN,4.826212535660263,34.34877472838381,132381381,1.9510230843660166,7.18739637975267,5.236373295386653
2023-11-07T13:30:00-05:00,362.12,362.43,359.94,360.51,346.91438193383254,NaN,NaN,NaN,NaN,NaN,334.5389000000003,355.5820652837463,313.4957347162543,352.5870225290534,360.7998357168047,360.91525110261296,360.68442033099643,903948,1556616.1666666667,74.34134173395962,66.99716701937395,NaN,NaN,NaN,NaN,4.659340211684531,36.19587523737346,131477433,1.8328468023814048,7.527431798363409,5.694584995982004
2023-11-08T09:30:00-05:00,361.735,363.88,360.55,362.97,348.1335009368402,NaN,NaN,NaN,NaN,NaN,335.45390000000026,357.36591855510216,313.54188144489837,354.3206180232427,362.4666666666667,362.4666666666667,362.4666666666667,1444396,1554109.7,76.01510615120156,68.32298559981555,NaN,NaN,NaN,NaN,4.567244482278493,38.02877984473017,132921829,1.7677703488555672,7.904297932051463,6.136527583195896
2023-11-08T13:30:00-05:00,362.98,363.34,361.39,363.19,348.65765998516565,NaN,NaN,NaN,NaN,NaN,336.3385000000003,359.0714252187015,313.6055747812991,354.71749441859413,362.5298051784761,362.6132170303255,362.4463933266268,827598,1549126.3333333333,76.16485052881103,69.63310437526698,NaN,NaN,NaN,NaN,4.380298447830029,39.730762694418544,133749427,1.5924065811608354,8.12703580964694,6.534629228486105
2023-11-09T09:30:00-05:00,362.16,364.79,361.11,363.01,349.3639027131127,NaN,NaN,NaN,NaN,NaN,337.2647000000003,360.48990961453444,314.03949038546614,356.05199553487535,362.97,362.97,362.97,1406200,1523079.7333333334,75.74815456988853,70.95970194986721,NaN,NaN,NaN,NaN,4.330277130127884,41.43606894039561,132343227,1.3279532378065069,8.19457077574424,6.866617537937732
2023-11-09T13:30:00-05:00,363,363.61,360.37,360.78,349.3639027131127,NaN,NaN,NaN,NaN,NaN,338.0924000000003,361.65850839657367,314.5262916034269,356.05199553487535,362.4699780448521,363.13456444428766,361.80539164541653,796017,1504435.4333333333,70.59519341760446,71.81968459825596,NaN,NaN,NaN,NaN,4.252400192261607,42.732384311604605,131547210,0.887670470755241,7.976205626381784,7.088535155626543
2023-11-10T09:30:00-05:00,361.85,368.77,361.055,368.39,351.02215102579066,NaN,NaN,NaN,NaN,NaN,338.9314000000003,363.7329941455207,314.12980585447986,357.8866771423202,366.0716666666667,366.0716666666667,366.0716666666667,1915499,1514306.5666666667,76.47625526698386,72.69243217775485,NaN,NaN,NaN,NaN,4.519371607100064,44.38584737334731,133462709,0.9862042089000864,8.321290416751651,7.335086207851565
2023-11-10T13:30:00-05:00,368.45,370.1,368.42,369.59,355.7678487064365,NaN,NaN,NaN,NaN,NaN,339.7788000000003,365.787839856156,313.76976014384456,360.53834171385614,367.1928237809235,368.755179888555,365.630467673292,986404,1517993.8666666667,77.2489709681874,73.48947571587122,NaN,NaN,NaN,NaN,4.318702206592919,46.02222736564758,134449113,1.00597340856668,8.592552968559914,7.586579559993234
2023-11-13T09:30:00-05:00,368.23,368.47,365.9,367.18,355.7678487064365,NaN,NaN,NaN,NaN,NaN,340.54740000000027,367.4628691015984,313.6319308984021,360.53834171385614,367.18333333333334,367.18333333333334,367.18333333333334,1443265,1514765.8666666667,72.12485762350815,73.83744114070362,NaN,NaN,NaN,NaN,4.273794906121996,46.60982117569446,133005848,0.7426636040567853,8.514909065064217,7.772245461007431
2023-11-13T13:30:00-05:00,367.2,368.005,366.3,366.64,355.7678487064365,NaN,NaN,NaN,NaN,NaN,341.28200000000027,368.98935440274147,313.57464559725906,360.53834171385614,367.1131574098001,367.2092172053398,367.0170976142604,770263,1514349.5,70.98860199134069,74.04763458815528,NaN,NaN,NaN,NaN,4.090309555684709,47.15544399930941,132235585,0.4333748496919938,8.313964023122423,7.88058917343043
2023-11-14T09:30:00-05:00,371.05,371.96,368.45,370.25,357.06446157685093,NaN,NaN,NaN,NaN,NaN,342.1198000000002,370.7320912021959,313.5075087978046,362.54163095749436,370.21999999999997,370.21999999999997,370.21999999999997,1874228,1526722.4666666666,73.94388372296956,74.18720990731856,NaN,NaN,NaN,NaN,4.1781445874215155,48.0683131342626,134109813,0.3753363637958218,8.349759628175207,7.974423264379385
2023-11-14T13:30:00-05:00,370.26,371.33,367.36,370.26,357.06446157685093,NaN,NaN,NaN,NaN,NaN,342.95680000000027,372.35363505139884,313.5599649486017,362.54163095749436,369.9914281682804,370.2707861139624,369.71207022259836,1254717,1532783.2333333334,73.95179935217121,74.39386512055789,NaN,NaN,NaN,NaN,4.163277116891405,48.50950457060087,135364530,0.24722009474452022,8.283448382810036,8.036228288065516
2023-11-15T09:30:00-05:00,371.33,373.13,367.11,368.65,357.06446157685093,NaN,NaN,NaN,NaN,NaN,343.73840000000024,373.74181723469457,313.7349827653059,362.54163095749436,369.62999999999994,369.62999999999994,369.62999999999994,1913257,1464679.8333333333,70.25145904635886,74.24197795835504,NaN,NaN,NaN,NaN,4.295900179970589,49.113677680800464,133451273,-0.02205158461848633,8.008663807292407,8.030715391910894
2023-11-15T13:30:00-05:00,368.65,370.4,368.41,369.73,357.06446157685093,NaN,NaN,NaN,NaN,NaN,344.4840000000003,375.1732846446266,313.794715355374,362.54163095749436,369.5921814134747,369.6467883999104,369.537574427039,917672,1446065.2333333334,71.28927338674193,74.05220046360908,NaN,NaN,NaN,NaN,4.1311930242584,49.67469556884296,134368945,-0.19396129845606946,7.788263768840807,7.982225067296876
2023-11-16T09:30:00-05:00,370.94,376.07,370.18,375.91,359.873233884842,NaN,NaN,NaN,NaN,NaN,345.3844000000003,377.0516234741062,313.71717652589444,365.3035160401897,374.05333333333334,374.05333333333334,374.05333333333334,1954595,1405877.3,76.36943478118773,73.96494161006532,NaN,NaN,NaN,NaN,4.288964951097084,50.74455698967616,136323540,0.03007753525327317,8.019821986363468,7.9897444511101945
2023-11-16T13:30:00-05:00,375.92,376.35,375.05,376.19,362.87331416280375,NaN,NaN,NaN,NaN,NaN,346.2846000000003,378.8322451277048,313.73695487229577,367.0868128321518,374.64030852725404,375.4875896038121,373.79302745069594,938083,1390421.3,76.5717032939311,74.12425315006328,NaN,NaN,NaN,NaN,4.07546745459015,51.76175303290261,137261623,0.11395199258618405,8.132184441842924,8.01823244925674
2023-11-17T09:30:00-05:00,373.805,374.38,369.21,372.25,362.87331416280375,NaN,NaN,NaN,NaN,NaN,347.1944000000003,380.0498047084932,314.33899529150744,367.0868128321518,371.94666666666666,371.94666666666666,371.94666666666666,2194885,1377994.4,67.77989988470739,73.53602413102799,NaN,NaN,NaN,NaN,4.28293406497657,50.65042528470441,135066738,-0.1639929643596556,7.81324124380717,7.977234208166825
2023-11-17T13:30:00-05:00,372.27,373.4,367,369.92,362.87331416280375,NaN,NaN,NaN,NaN,NaN,348.0382000000003,381.0175393966421,315.0588606033585,367.0868128321518,371.03641106794834,371.9563594614129,370.1164626744838,2148877,1403305.7,63.161351899399214,72.60720280035572,NaN,NaN,NaN,NaN,4.434153060335385,48.97271551197414,132917861,-0.5510287747584854,7.2884482397187185,7.839477014477204
2023-11-20T09:30:00-05:00,371.005,378.81,371.005,378.54,362.87331416280375,NaN,NaN,NaN,NaN,NaN,348.9394000000003,382.7308437477727,315.1479562522279,367.0868128321518,376.11833333333334,376.11833333333334,376.11833333333334,3406104,1456734.4,71.02699314887498,72.26997698456904,NaN,NaN,NaN,NaN,4.752427841739999,48.189656663411725,136323965,-0.28609223709044596,7.481861718114146,7.767953955204592
2023-11-20T13:30:00-05:00,378.54,378.87,376.88,377.65,364.1746342962239,NaN,NaN,NaN,NaN,NaN,349.8392000000003,384.23927973012366,315.4391202698769,367.0868128321518,376.6436149013952,377.42299143290484,375.8642383698856,1547204,1478148.9,69.37985041923446,72.18316677039977,NaN,NaN,NaN,NaN,4.55511156733,47.47039256921553,134776761,-0.23265439437597202,7.477135962234627,7.709790356610599
2023-11-21T09:30:00-05:00,375.64,376.22,371.12,371.69,364.1746342962239,NaN,NaN,NaN,NaN,NaN,350.62880000000024,385.1860729572087,316.0715270427918,367.0868128321518,373.01,373.01,373.01,2081498,1503173.1666666667,59.439064796533366,70.966224593939,NaN,NaN,NaN,NaN,4.6961750268064275,45.27237142234405,132695263,-0.6376064253943259,6.912782324867692,7.550388750262018
2023-11-21T13:30:00-05:00,371.715,373.25,371.58,373.08,364.1746342962239,NaN,NaN,NaN,NaN,NaN,351.44960000000026,386.15105955660874,316.7481404433918,367.0868128321518,372.9086599109308,373.07468346219514,372.74263635966645,775531,1503707.7666666666,60.84801097400004,69.79472745149705,NaN,NaN,NaN,NaN,4.480019667748826,43.23135178596339,133470794,-0.838127031085607,6.502729961405009,7.340856992490616
2023-11-22T09:30:00-05:00,377.98,379.79,374.95,378.85,364.1746342962239,NaN,NaN,NaN,NaN,NaN,352.3722000000003,387.48324174812853,317.2611582518721,367.4411982904573,377.8633333333334,377.8633333333334,377.8633333333334,1978890,1497973.8666666667,66.11056395700442,69.36513504674679,NaN,NaN,NaN,NaN,4.6393039771953415,42.34523708084297,135449684,-0.6185707298207959,6.567643580214622,7.186214310035417
2023-11-22T13:30:00-05:00,378.88,379.15,376.84,377.91,364.4504897529366,NaN,NaN,NaN,NaN,NaN,353.3276000000003,388.5663113407805,318.0888886592201,368.1159586323658,377.8912081911851,377.9370709677666,377.8453454146036,731015,1474762.6333333333,64.58746673598012,68.90791109993532,NaN,NaN,NaN,NaN,4.472925121681389,41.52241628323116,134718669,-0.5740345420292501,6.468671132498855,7.042705674528105
2023-11-24T09:30:00-05:00,377.02,377.99,375.14,377.45,364.4504897529366,NaN,NaN,NaN,NaN,NaN,354.17660000000024,389.6528274454181,318.7003725545824,368.1159586323658,376.85999999999996,376.85999999999996,376.85999999999996,992312,1447290.0666666667,63.81268664052199,68.18425416547478,NaN,NaN,NaN,NaN,4.357001898704148,40.30383556476256,133726357,-0.609591411747247,6.280716409844047,6.890307821591294
2023-11-27T09:30:00-05:00,376.8,380.63,376.22,379.93,365.1114896302584,NaN,NaN,NaN,NaN,NaN,355.1500000000003,390.7283367795467,319.57166322045396,370.22321352471414,378.9266666666667,378.9266666666667,378.9266666666667,1443029,1466138.5,66.16895194598669,67.62833649360445,NaN,NaN,NaN,NaN,4.360787477368135,39.57818844718161,135169386,-0.5044717946272508,6.25971807830723,6.764189872934481
2023-11-27T13:30:00-05:00,379.93,380.05,378.23,378.59,366.1834673743375,NaN,NaN,NaN,NaN,NaN,356.1574000000003,391.4801309951941,320.83466900480647,370.8145708197713,378.93697685345,378.9512248605945,378.9227288463055,755614,1423669.6333333333,63.753439560344034,67.1641922446034,NaN,NaN,NaN,NaN,4.179302657556126,38.90437326657073,134413772,-0.55932310746448,6.065035988603881,6.624359096068361
2023-11-28T09:30:00-05:00,378.26,383,378.16,381.37,367.5524006755041,NaN,NaN,NaN,NaN,NaN,357.25220000000024,392.23799146795204,322.26640853204844,373.19165665581704,380.8433333333335,380.8433333333335,380.8433333333335,1439623,1437467.4333333333,66.4867923625587,66.82115788573317,NaN,NaN,NaN,NaN,4.226495324873544,38.7219210229451,135853395,-0.44736211816034555,6.065156448367929,6.512518566528275
2023-11-28T13:30:00-05:00,381.34,382.76,380.52,382.67,368.89910973570835,NaN,NaN,NaN,NaN,NaN,358.2738000000003,393.1855777009264,323.36202229907417,373.7933253246536,381.1964406091066,381.7235625553114,380.66931866290184,646011,1401363.1666666667,67.7129341920112,66.2028364150777,NaN,NaN,NaN,NaN,4.084602801668291,38.55250108243558,136499406,-0.3301461033222868,6.099835937375417,6.429982040697704
2023-11-29T09:30:00-05:00,383.65,384.25,377.44,379.23,368.89910973570835,NaN,NaN,NaN,NaN,NaN,359.2750000000002,393.6580351772379,324.89196482276253,373.7933253246536,380.3066666666667,380.3066666666667,380.3066666666667,1996930,1440815.3,61.31964810422393,65.11340390152719,NaN,NaN,NaN,NaN,4.279274030120556,37.44934033691335,134502476,-0.5175242542189453,5.783076722924022,6.300600977142968
2023-11-29T13:30:00-05:00,379.26,380.02,378.55,378.91,368.89910973570835,NaN,NaN,NaN,NaN,NaN,360.2696000000003,393.98342694620743,326.5557730537932,373.7933253246536,379.97156078241795,380.493057468506,379.4500640963299,824563,1410274.2666666666,60.745082202699905,64.61091692424094,NaN,NaN,NaN,NaN,4.078611599397656,36.424976787499844,133677913,-0.6857028013599269,5.443472475443059,6.129175276802986
2023-11-30T09:30:00-05:00,378.42,380.09,376.02,376.06,368.89910973570835,NaN,NaN,NaN,NaN,NaN,361.17500000000024,394.0956063735019,328.2543936264986,373.7933253246536,377.38999999999993,377.38999999999993,377.38999999999993,1210938,1420507.2666666666,55.73602753187848,64.08053661227517,NaN,NaN,NaN,NaN,4.077996485154967,34.729117336028715,132466975,-0.9929270455530084,4.888016469861725,5.880943515414733
2023-11-30T13:30:00-05:00,376.08,379.34,375.47,378.81,368.89910973570835,NaN,NaN,NaN,NaN,NaN,361.97840000000025,394.61944590479516,329.33735409520534,373.7933253246536,377.62418631835516,377.8657371870337,377.3826354496766,1138224,1410301.5333333334,59.229543547480745,63.237861640747006,NaN,NaN,NaN,NaN,4.063139593358179,32.997920116356646,133605199,-1.0115552373867036,4.616499468681354,5.628054706068058
2023-12-01T09:30:00-05:00,377.07,378.1,371.33,373.45,368.89910973570835,NaN,NaN,NaN,NaN,NaN,362.6332000000003,394.85218581642494,330.4142141835756,373.7933253246536,374.29333333333335,374.29333333333335,374.29333333333335,2558970,1468013.9333333333,50.811832919989826,61.91157467651526,NaN,NaN,NaN,NaN,4.307201050975453,30.965893670275392,131046229,-1.363576208597273,3.9235844453214668,5.28716065391874
2023-12-01T13:30:00-05:00,373.45,375.58,372.8,374.5,368.89910973570835,NaN,NaN,NaN,NaN,NaN,363.56600000000026,394.37369747967387,332.75830252032665,373.7933253246536,374.29333333333335,374.29333333333335,374.29333333333335,987854,1454069.0666666667,52.24367684542217,61.397618394293026,NaN,NaN,NaN,NaN,4.198115261620062,29.0790119703428,132034083,-1.49392870295822,3.4197497752209642,4.913678478179184
2023-12-04T09:30:00-05:00,369.14,369.46,362.9,368.38,NaN,NaN,NaN,380.0338801353609,380.0338801353609,380.0338801353609,364.3750000000003,393.4740774424042,335.27592255759635,373.7933253246536,366.91333333333324,366.91333333333324,366.91333333333324,2857497,1522785.0666666667,44.1725476972502,60.20651387452518,NaN,NaN,NaN,NaN,4.726821314361487,29.19551176585192,129176586,-1.9326780811779871,2.4978308767067006,4.430508957884688
2023-12-04T13:30:00-05:00,368.38,369.52,367.32,369.26,NaN,NaN,NaN,380.0338801353609,NaN,NaN,365.12760000000026,392.7069570802342,337.5482429197663,373.7933253246536,367.3722712237488,368.1528767858619,366.59166566163566,987712,1491858.8333333333,45.47690623803586,58.732681180313136,NaN,NaN,NaN,NaN,4.54633407762138,29.287018721440045,130164298,-2.090596073143528,1.8172638664552778,3.9078599395988056
2023-12-05T09:30:00-05:00,366.37,373.07,365.6,371.73,NaN,NaN,NaN,380.0338801353609,NaN,NaN,365.9654000000003,391.68860857434004,340.2421914256605,373.7933253246536,370.13333333333344,370.13333333333344,370.13333333333344,1882811,1521739.0666666667,49.07350452129717,57.6245410221215,NaN,NaN,NaN,NaN,4.755167357791279,28.419938534206906,132047109,-1.9579810939221471,1.4603835721961218,3.418364666118269
2023-12-05T13:30:00-05:00,371.76,372.62,370.84,372.58,NaN,NaN,NaN,380.0338801353609,NaN,NaN,366.6780000000002,391.0870357039971,342.26896429600333,373.6716602597229,370.64768473907367,371.4857916977417,369.8095777804056,709133,1497268,50.28877394810107,56.658547258377155,NaN,NaN,NaN,NaN,4.542655403663333,27.614792646061854,132756242,-1.7491395536791319,1.231940224019354,2.981079777698486
2023-12-06T09:30:00-05:00,373.41,374.16,368.05,369.54,NaN,NaN,NaN,380.0338801353609,NaN,NaN,367.32220000000024,390.2545336064851,344.3898663935154,370.8223282077783,370.5833333333333,370.5833333333333,370.5833333333333,1467279,1520501.8666666667,46.055738788767336,55.22188917571863,NaN,NaN,NaN,NaN,4.654608589115953,27.371251764044263,131288963,-1.7477325697688255,0.7964140654874541,2.5441466352562796
2023-12-06T13:30:00-05:00,369.55,370.53,368.41,368.81,NaN,NaN,NaN,380.0338801353609,NaN,NaN,367.9610000000003,389.18009112094427,346.7419088790563,370.69686256622265,370.17766886432435,370.7911200011421,369.5642177275066,641633,1479415.3666666667,45.07456412805589,53.88768378769805,NaN,NaN,NaN,NaN,4.47356511846481,27.145106659313644,130647330,-1.7250130640388965,0.38788030520765915,2.1128933692465557
2023-12-07T09:30:00-05:00,368.175,371.25,366.3,369.99,NaN,NaN,NaN,380.0338801353609,NaN,NaN,368.59800000000024,388.03540558816974,349.16059441183074,369.8904900529781,369.18,369.18,369.18,1397018,1484158.7333333334,47.03867170037439,52.49853231182774,NaN,NaN,NaN,NaN,4.507596181431609,27.311475018591093,132044348,-1.564302884958277,0.15751476304870948,1.7218176480069864
2023-12-07T13:30:00-05:00,370,371.45,369.89,370.85,NaN,NaN,NaN,380.0338801353609,NaN,NaN,369.13540000000023,387.2621643929938,351.0086356070067,366.80039204238255,369.7072324441768,370.4415595091039,368.97290537924965,720157,1444388.7333333334,48.48454560692763,51.125075984321775,NaN,NaN,NaN,NaN,4.297053597043637,27.400795708502194,132764505,-1.3423838080142416,0.04383788798918431,1.386221696003426
2023-12-08T09:30:00-05:00,369.06,373.37,368.23,372.93,NaN,NaN,NaN,380.0338801353609,NaN,NaN,369.67180000000025,386.5882737176277,352.7553262823728,365.150313633906,371.51,371.51,371.51,1211318,1454176.9333333333,51.9045385817675,50.45256816128917,NaN,NaN,NaN,NaN,4.357264054397662,26.860207602425305,133975823,-1.0128164303278093,0.12020115809366416,1.1330175884214735
2023-12-08T13:30:00-05:00,372.97,374.46,372.63,374.33,NaN,NaN,NaN,380.0338801353609,NaN,NaN,370.2088000000003,385.9362102839304,354.48138971607017,365.18787592335224,372.38116630653315,373.49554859447437,371.2667840185919,740273,1413699.5333333334,54.11269393783215,49.978826142370046,NaN,NaN,NaN,NaN,4.176745193369256,26.017068169780067,134716096,-0.6741412476323656,0.2903410288810164,0.964482276513382
2023-12-11T09:30:00-05:00,368.48,370.55,366.1,369.74,NaN,NaN,NaN,380.0338801353609,NaN,NaN,370.6356000000003,385.07826189311885,356.19293810688174,365.18787592335224,368.7966666666667,368.7966666666667,368.7966666666667,2265890,1457959.7666666666,46.56439894723155,49.32370981489526,NaN,NaN,NaN,NaN,4.466263393842878,26.475246600121416,132450206,-0.7282426839156093,0.05417892161887039,0.7824216055344797
2023-12-11T13:30:00-05:00,369.74,371.6,369.3,371.33,NaN,NaN,NaN,380.0338801353609,NaN,NaN,370.9948000000002,384.5692202026894,357.42037979731106,365.18787592335224,369.2944880969626,370.1437620267456,368.4452141671796,778557,1410748.8333333333,49.20752691548743,48.60785148403859,NaN,NaN,NaN,NaN,4.311530294282673,26.577098047628546,133228763,-0.629639834160536,-0.004628187166190401,0.6250116469943456
2023-12-12T09:30:00-05:00,370.57,373.16,370.46,372.33,NaN,NaN,NaN,380.0338801353609,NaN,NaN,371.3838000000003,383.93571388748643,358.83188611251416,365.18787592335224,371.9833333333334,371.9833333333334,371.9833333333334,1557230,1391027.2666666666,50.854031515213485,48.61086566941172,NaN,NaN,NaN,NaN,4.1964209875481995,26.197576445685606,134785993,-0.4767111657152503,0.029122689850282768,0.5058338555655331
2023-12-12T13:30:00-05:00,372.33,374.37,372.21,374.34,NaN,NaN,NaN,380.0338801353609,NaN,NaN,371.77940000000024,383.3975089063192,360.16129109368126,365.5692579782051,372.5921597312567,373.3908792166899,371.7934402458235,904797,1307650.3666666667,54.07643504144165,48.74177696912739,NaN,NaN,NaN,NaN,4.050962345580473,25.485297314872035,135690790,-0.23220653845228795,0.21557568250017312,0.44778222095246106
2023-12-13T09:30:00-05:00,376.11,377.63,373.16,373.29,NaN,NaN,NaN,380.0338801353609,NaN,NaN,372.1128000000003,382.89861441704124,361.3269855829593,368.35440638256404,374.6933333333333,374.6933333333333,374.6933333333333,1279541,1298728.2666666666,52.15269362332608,49.31178739241852,NaN,NaN,NaN,NaN,4.080893606610437,23.930797560962656,134411249,-0.13787401651968534,0.27543970030285436,0.4133137168225397
2023-12-13T13:30:00-05:00,373.31,375.68,370.77,374.31,NaN,NaN,NaN,380.0338801353609,NaN,NaN,372.35700000000026,382.7714601395815,361.942539860419,368.35440638256404,374.06052046910236,374.60811592375927,373.51292501444544,1708776,1286304.2,53.869503972880494,49.911258659193145,NaN,NaN,NaN,NaN,4.1401154918525505,23.025706952114593,136120025,-0.010194720692615622,0.4005703159567702,0.4107650366493858
2023-12-14T09:30:00-05:00,373.26,373.81,364.9,365.29,NaN,NaN,NaN,380.0338801353609,NaN,NaN,372.45260000000025,382.5120089766221,362.3931910233784,368.35440638256404,368,368,368,3000427,1360467.4,40.1499289405045,49.27386040342224,NaN,NaN,NaN,NaN,4.516535813863085,23.272625222297442,133119598,-0.5090135815888676,-0.22550194033669868,0.2835116412521689
2023-12-14T13:30:00-05:00,365.29,366.275,364.11,366.06,NaN,NaN,NaN,378.2868341654572,NaN,NaN,372.51440000000025,382.3760470510222,362.6527529489783,368.35440638256404,367.1469952348187,368.33885647010965,365.95513399952773,1536861,1345733.1,41.519170516044504,48.647460158275344,NaN,NaN,NaN,NaN,4.348568970015719,23.629300677793637,134656459,-0.7484253671955631,-0.6520200677422849,0.09640529945327811
2023-12-15T09:30:00-05:00,366.89,372.16,366.64,370.62,NaN,NaN,NaN,378.2868341654572,NaN,NaN,372.66300000000024,382.17590176544593,363.15009823455455,368.35440638256404,369.8066666666667,369.8066666666667,369.8066666666667,2093386,1391145.4666666666,48.96543750656526,48.8552957809752,NaN,NaN,NaN,NaN,4.473671186443169,22.467894714251702,136749845,-0.5691207034785614,-0.6149955798949236,-0.04587487641636223
2023-12-15T13:30:00-05:00,370.65,372.4,367.22,368.88,NaN,NaN,NaN,378.2868341654572,NaN,NaN,372.78040000000016,381.9526747101988,363.60812528980154,368.35440638256404,369.69244500361873,369.8407062203568,369.54418378688064,1242485,1399484.5666666667,46.53079797429615,48.959312484278065,NaN,NaN,NaN,NaN,4.524123244554367,21.33496250673886,135507360,-0.5375262688167715,-0.7177827124373266,-0.18025644362055512
2023-12-18T09:30:00-05:00,369.5,372.71,368.68,372.27,NaN,NaN,NaN,378.2868341654572,NaN,NaN,373.01020000000017,381.52016262267165,364.5002373773287,368.35440638256404,371.21999999999997,371.21999999999997,371.21999999999997,1372215,1397124.1,51.58191859770876,49.28383011980195,NaN,NaN,NaN,NaN,4.488828727086196,20.20844041323871,136879575,-0.2715602300948108,-0.5197067312390686,-0.24814650114425782
2023-12-18T13:30:00-05:00,372.28,373,371.97,372.58,NaN,NaN,NaN,378.2868341654572,NaN,NaN,373.0940000000002,381.5022388167257,364.68576118327474,368.35440638256404,371.62617376161074,372.22758448061893,371.02476304260256,625898,1392800.2333333334,52.02820808547871,49.536948868269874,NaN,NaN,NaN,NaN,4.241769532294323,19.08877609645056,137505473,-0.06857645358133269,-0.3338670681209237,-0.265290614539591
2023-12-19T09:30:00-05:00,371.495,372.93,369.82,372.16,NaN,NaN,NaN,378.2868341654572,NaN,NaN,373.1454000000002,381.4985706171402,364.7922293828602,368.35440638256404,371.6366666666667,371.6366666666667,371.6366666666667,1115134,1381983.9333333333,51.33778000619962,49.49646611287218,NaN,NaN,NaN,NaN,4.160928851416158,18.542141289037883,136390339,0.037859921191872536,-0.21796571304975032,-0.25582563424162286
2023-12-19T13:30:00-05:00,372.13,373.25,371.55,373.25,NaN,NaN,NaN,378.2868341654572,NaN,NaN,373.2668000000002,381.4442386600636,365.08936133993683,368.35440638256404,372.0395296500958,372.54880823059784,371.53025106959376,697800,1383710.2333333334,53.07805343223736,49.422563219615405,NaN,NaN,NaN,NaN,3.985148219172146,17.94335948596028,137088139,0.1744810662908253,-0.03772430137809124,-0.21220536766891654
2023-12-20T09:30:00-05:00,375,376.03,371.83,375.61,NaN,NaN,NaN,378.2868341654572,NaN,NaN,373.44620000000026,381.4254138860294,365.46698611397113,367.17569708001315,374.48999999999995,374.48999999999995,374.48999999999995,1666989,1372712.2,56.689559585881966,50.145788979519004,NaN,NaN,NaN,NaN,4.0004947749455635,16.69778447380283,138755128,0.40351028987648896,0.29218249467669466,-0.1113277951997943
2023-12-20T13:30:00-05:00,375.59,375.76,370.54,370.58,NaN,NaN,NaN,378.2868341654572,NaN,NaN,373.4528000000002,381.4219676252456,365.4836323747548,367.17569708001315,373.6194394190919,374.69389541369065,372.5449834244932,1094343,1381704.8666666667,48.17812279546921,50.07226011380341,NaN,NaN,NaN,NaN,4.087602291020878,15.800270026253232,137660785,0.2059207992775293,0.1460732038971173,-0.059847595380411976
2023-12-21T09:30:00-05:00,372.52,374.41,370.03,371.04,NaN,NaN,NaN,378.2868341654572,NaN,NaN,373.4684000000002,381.4155296553664,365.521270344634,367.17569708001315,371.82666666666665,371.82666666666665,371.82666666666665,999761,1374665.6333333333,48.93323702595099,49.93506050742752,NaN,NaN,NaN,NaN,4.108487841662248,15.098807821656216,138660546,0.10118257040786097,0.06663061762941425,-0.03455195277844673
2023-12-21T13:30:00-05:00,371.06,373.83,370.7,373.54,NaN,NaN,NaN,378.2868341654572,NaN,NaN,373.56620000000026,381.3931829589044,365.73921704109614,367.17569708001315,372.18364628584845,372.6088026759975,371.7584898956994,704832,1360219.2333333334,52.94616529512224,49.854326954119,NaN,NaN,NaN,NaN,4.038595852972087,14.447450060244698,139365378,0.19008968323425102,0.20306015126436705,0.012970468030116027
2023-12-22T09:30:00-05:00,373.56,375.18,372.71,374.92,NaN,NaN,NaN,378.2868341654572,NaN,NaN,373.67000000000024,381.42808429956204,365.91191570043844,367.17569708001315,374.27,374.27,374.27,1010650,1308608.5666666667,55.04613886139118,50.0610016139808,NaN,NaN,NaN,NaN,3.926553292045511,13.419836309461283,140376028,0.3238002506205725,0.4177207813058317,0.09392053068525916
2023-12-22T13:30:00-05:00,374.94,375.02,373.15,374.63,NaN,NaN,NaN,378.2868341654572,NaN,NaN,373.64440000000025,381.38116744894296,365.90763255105753,367.17569708001315,374.2688481777103,374.27043333016553,374.2672630252551,533616,1293467.3,54.495730680461605,50.10573209309373,NaN,NaN,NaN,NaN,3.7796566283279747,12.465623540876683,139842412,0.37126992160450023,0.5580079326908844,0.18673801108638421
2023-12-26T09:30:00-05:00,375,376.93,373.75,373.96,NaN,NaN,NaN,378.2868341654572,NaN,NaN,373.59980000000024,381.30299257445233,365.89660742554815,368.92694881534294,374.88000000000005,374.88000000000005,374.88000000000005,749515,1223201.2333333334,53.17288337106772,51.03594312384825,NaN,NaN,NaN,NaN,3.736824012018834,12.170868005909615,139092897,0.33710011939220347,0.6081131603266385,0.27101304093443507
2023-12-26T13:30:00-05:00,373.97,374.95,373.5,374.74,NaN,NaN,NaN,378.2868341654572,NaN,NaN,373.6496000000003,381.34943787874215,365.94976212125846,368.92694881534294,374.69255502320186,374.9280604076688,374.45704963873493,474817,1206104.7333333334,54.555905644982765,51.96713849020098,NaN,NaN,NaN,NaN,3.5734794397317735,11.806666253798891,139567714,0.34531880766992296,0.7026615505218388,0.3573427428519158
2023-12-27T09:30:00-05:00,373.69,375.07,372.82,374.03,NaN,NaN,NaN,378.2868341654572,NaN,NaN,373.7318000000003,381.35802180629867,366.10557819370194,368.92694881534294,373.9733333333334,373.9733333333334,373.9733333333334,818512,1170628.1,53.02084055420583,52.25681013646102,NaN,NaN,NaN,NaN,3.4789451940366467,11.215161074995672,138749202,0.2837995728632082,0.7120922089309261,0.42829263606771784
2023-12-27T13:30:00-05:00,374.04,374.28,372.97,374.05,NaN,NaN,NaN,378.2868341654572,NaN,NaN,373.6420000000003,381.1443729578726,366.139627042128,368.92694881534294,373.8903013116331,373.99162077921756,373.78898184404864,549706,1165313.8666666667,53.06090656039038,52.72324646403918,NaN,NaN,NaN,NaN,3.3240205373197393,10.665906266106969,139298908,0.2277349568131446,0.7129613320841486,0.485226375271004
2023-12-28T09:30:00-05:00,375.26,376.47,374.16,375.81,NaN,NaN,NaN,378.2868341654572,NaN,NaN,373.60520000000025,381.0463743588579,366.1640256411426,370.36675023476454,375.47999999999996,375.4800053947966,375.47999460520333,781262,1142446.6333333333,56.57099490667776,53.07960905753697,NaN,NaN,NaN,NaN,3.259447641796902,10.914549197083375,140080170,0.2885518709520458,0.8459162139610612,0.5573643430090154
2023-12-28T13:30:00-05:00,375.83,376.3,375.22,375.3,NaN,NaN,NaN,378.2868341654572,NaN,NaN,373.67740000000026,381.11289413011974,366.2419058698808,370.8774001878116,375.5402029733636,375.6034588981141,375.47694704861306,707669,1144647.8333333333,55.28096099863775,53.31194855133405,NaN,NaN,NaN,NaN,3.1037728102399798,11.145431918704322,139372501,0.27391597575950555,0.8997593127083974,0.6258433369488918
2023-12-29T09:30:00-05:00,376,377.15,373.48,375.22,NaN,NaN,NaN,378.2868341654572,NaN,NaN,373.72020000000026,381.16607562608533,366.2743243739152,370.97692015024927,375.2833333333333,375.2833333333333,375.2833333333333,1041306,1132790.7666666666,55.068823423193564,53.578451652547905,NaN,NaN,NaN,NaN,3.14421760950855,10.608869605007742,138331195,0.23957224477780825,0.9253086429211521,0.6857363981433439
2023-12-29T13:30:00-05:00,375.26,376.85,375.2,375.97,NaN,NaN,NaN,378.2868341654572,NaN,NaN,373.6626000000002,380.9925067496932,366.3326932503073,371.08653612019947,375.5810189283807,375.9369812863165,375.22505657044485,728259,1133060.8333333333,56.744682443238894,53.840353724762295,NaN,NaN,NaN,NaN,3.037487780257942,10.110633170860918,139059454,0.24709900661844464,0.9946101564163996,0.747511149797955
2024-01-02T09:30:00-05:00,373.645,375.9,366.8,369.62,NaN,NaN,NaN,378.2868341654572,NaN,NaN,373.4968000000003,380.80992183947774,366.18367816052285,371.08653612019947,370.77333333333337,370.77333333333337,370.77333333333337,1681541,1148734.9333333333,42.34410781837833,52.81567859851204,NaN,NaN,NaN,NaN,3.4755243673823757,11.647408322687555,137377913,-0.17319378482370396,0.531018918768325,0.7042127035920289
2024-01-02T13:30:00-05:00,369.64,371.2,368.28,370.73,NaN,NaN,NaN,378.2868341654572,NaN,NaN,373.3624000000003,380.626812499223,366.09798750077766,371.08653612019947,370.53862608566334,370.87027339646613,370.20697877486054,842185,1152132,44.97295176308857,52.586737810484856,NaN,NaN,NaN,NaN,3.435844055426493,13.074413820812289,138220098,-0.3631286256442833,0.25030192153667485,0.6134305471809581
2024-01-03T09:30:00-05:00,368.995,373.28,368.51,371.6,NaN,NaN,NaN,378.2868341654572,NaN,NaN,373.1958000000003,380.2284724251118,366.1631275748888,371.08653612019947,371.12999999999994,371.12999999999994,371.12999999999994,1344957,1121434.2333333334,47.0122355358811,52.449523418337,NaN,NaN,NaN,NaN,3.531140908610314,13.56263721570812,139565055,-0.41321146330707603,0.09691621804711303,0.5101276813541891
2024-01-03T13:30:00-05:00,371.62,372.3,369.5,370.64,NaN,NaN,NaN,378.2868341654572,NaN,NaN,373.03680000000037,379.9326056120207,366.14099438798,371.08653612019947,371.0297569422918,371.1770490477211,370.8824648368625,622957,1116247.5666666667,45.029191932295916,51.88402532099227,NaN,NaN,NaN,NaN,3.478916557995292,14.01598751096854,138942098,-0.48885688194325017,-0.10094342107487364,0.3879134608683765
2024-01-04T09:30:00-05:00,370.74,373.1,369.95,370.58,NaN,NaN,NaN,378.2868341654572,NaN,NaN,372.82100000000037,379.32433360660207,366.31766639339867,371.08653612019947,371.21,371.21,371.21,1009351,1097984.9333333333,44.90170991100389,51.15942325310747,NaN,NaN,NaN,NaN,3.4554225181384877,14.10987913916223,137932747,-0.5180088721056002,-0.25959762926362373,0.2584112428419765
2024-01-04T13:30:00-05:00,370.58,370.75,367.19,368.01,NaN,NaN,NaN,378.2868341654572,NaN,NaN,372.5278000000003,378.53120875162057,366.52439124838,371.08653612019947,370.0704746499167,371.3427430464048,368.79820625342865,809716,1094815.5666666667,39.71516952057582,50.1036688845442,NaN,NaN,NaN,NaN,3.4628923382714527,14.948523219470625,137123031,-0.6754931757126001,-0.5859552267987738,0.08953794891382641
2024-01-05T09:30:00-05:00,368.97,372.06,367.99,369,NaN,NaN,NaN,378.2868341654572,NaN,NaN,372.32320000000027,378.09169573450214,366.5547042654984,371.08653612019947,369.68333333333334,369.68333333333334,369.68333333333334,1299693,1095487.3,42.47182344760391,49.33930746143964,NaN,NaN,NaN,NaN,3.506257171252063,15.190431257989385,138422724,-0.6764276309746242,-0.7559965898044538,-0.07956895882982964
2024-01-05T13:30:00-05:00,369,369.13,366.5,367.7,NaN,NaN,NaN,378.2868341654572,NaN,NaN,372.09900000000033,377.69484881842965,366.503151181571,371.08653612019947,368.9530021742663,369.87988645760714,368.0261178909255,806918,1065425.3666666667,39.89220715934778,48.29190042675142,NaN,NaN,NaN,NaN,3.4436673733054866,15.812669882862847,137615806,-0.7237914232237999,-0.9843082378595795,-0.26051681463577964
2024-01-08T09:30:00-05:00,369.38,372.04,369,371.75,NaN,NaN,NaN,378.2868341654572,NaN,NaN,372.01280000000037,377.49352847701203,366.5320715229887,371.08653612019947,370.93,370.93,370.93,1214558,1005896.4,50.0672460377185,48.08092938985947,NaN,NaN,NaN,NaN,3.5076911323550966,15.280760563434335,138830364,-0.4546991676701385,-0.8288907742234528,-0.3741916065533143
2024-01-08T13:30:00-05:00,371.75,375.21,371.6,374.65,NaN,NaN,NaN,378.2868341654572,NaN,NaN,371.9296000000003,377.1133175230697,366.74588247693083,366.7042288961595,372.3716180196448,373.8166140619027,370.9266219773869,1208886,994963.9,55.832703486850015,48.278914884606586,NaN,NaN,NaN,NaN,3.5149989086154436,14.584305511085741,140039250,-0.07371861482707487,-0.4663398750871579,-0.39262126026008304
2024-01-09T09:30:00-05:00,372.01,375.99,371.2,375.15,NaN,NaN,NaN,378.2868341654572,NaN,NaN,371.96360000000027,377.208697916998,366.71850208300253,366.3821526317076,374.1133333333334,374.1133333333334,374.1133333333334,1231595,966237.5333333333,56.759732473002984,48.29239613934409,NaN,NaN,NaN,NaN,3.6060704151429133,14.15935516763725,141270845,0.2044253514724212,-0.13708957091955654,-0.3415149223919777
2024-01-09T13:30:00-05:00,375.15,375.8,374.3,375.73,NaN,NaN,NaN,378.2868341654572,NaN,NaN,371.9882000000003,377.29186166330453,366.68453833669605,367.3637221053661,374.5297142797562,375.0874030296532,373.9720255298592,686540,947706.0333333333,57.86453079009413,48.47693683873384,NaN,NaN,NaN,NaN,3.4556368140612763,13.764758420149361,141957385,0.40817205765601844,0.16870014967804536,-0.23947190797797308
2024-01-10T09:30:00-05:00,376.49,382.81,376.32,382.05,368.36296183873714,368.36296183873714,368.36296183873714,NaN,NaN,NaN,372.2616000000003,378.16816361674864,366.355036383252,372.52097768429286,380.3933333333334,380.3933333333334,380.3933333333334,1759865,960627.7,67.58374647854293,49.37085991411594,NaN,NaN,NaN,NaN,3.714519898771184,15.063420241584652,143717250,0.9199903471291132,0.9105160259334184,-0.009474321195694774
2024-01-10T13:30:00-05:00,382.06,384.17,381.32,382.65,371.6635090278854,NaN,NaN,NaN,NaN,NaN,372.5294000000003,379.0496274928737,366.0091725071269,374.5137821474343,381.1991958741732,382.3038164696756,380.0945752786708,936645,970985.9333333333,68.33061116153971,50.19842625113743,NaN,NaN,NaN,NaN,3.6527684774303864,16.515333138467952,144653895,1.230937695062822,1.5291977976328326,0.2982601025700107
2024-01-11T09:30:00-05:00,385.895,390.69,380.38,383.38,373.5513040720724,NaN,NaN,NaN,NaN,NaN,372.7624000000003,379.9501624445262,365.5746375554744,377.81002571794744,384.8166666666666,384.8166666666666,384.8166666666666,2230443,1008162.9,69.25863377936841,52.120892391208145,NaN,NaN,NaN,NaN,4.128285014756787,18.819587063794167,146884338,1.40517339485781,2.054726846142273,0.6495534512844632
2024-01-11T13:30:00-05:00,383.39,385.53,383.27,384.6,373.5513040720724,NaN,NaN,NaN,NaN,NaN,373.00280000000026,380.9173688852294,365.08823111477113,377.81002571794744,384.7265558237343,384.87958794799886,384.5735236994698,773357,1010681.4666666667,70.79871119463915,53.96558949346176,NaN,NaN,NaN,NaN,3.9948360851313014,20.959251423025652,147657695,1.5126551397164902,2.540372375930076,1.0277172362135858
2024-01-12T09:30:00-05:00,385.54,388.48,384.65,387.75,374.82270680947096,NaN,NaN,NaN,NaN,NaN,373.36700000000025,382.22978443825787,364.5042155617426,377.81002571794744,386.96,386.9600053947966,386.95999460520335,1404503,1001931.9333333333,74.36912264359339,55.91965285829834,NaN,NaN,NaN,NaN,3.986633507621922,23.304832768062482,149062198,1.6923828723154917,3.1431958266079505,1.4508129542924588
2024-01-12T13:30:00-05:00,387.83,388.68,387.22,388.41,376.5423564999496,NaN,NaN,NaN,NaN,NaN,373.7590000000003,383.4737485813479,364.0442514186527,379.0802531675891,387.35457173147665,387.89811580675973,386.8110276561936,740125,990124.6666666666,75.05726514554851,58.06451523067353,NaN,NaN,NaN,NaN,3.806159685648926,25.50632948070503,149802323,1.7452080998580304,3.6323230791149967,1.8871149792569664
2024-01-16T09:30:00-05:00,393.65,394.1,387.63,389,379.09361302267916,NaN,NaN,NaN,NaN,NaN,374.1392000000003,384.68646265145793,363.5919373485427,383.18520253407127,390.24333333333334,390.24333333333334,390.24333333333334,2144213,1028273.0666666667,75.68571294343995,60.26337259013325,NaN,NaN,NaN,NaN,3.996433993816862,28.113516457660914,151946536,1.7072791912778125,4.021213968354232,2.3139347770764194
2024-01-16T13:30:00-05:00,389.02,390.38,388,390.36,379.09361302267916,NaN,NaN,NaN,NaN,NaN,374.52940000000024,385.967029411685,363.09177058831546,383.18520253407127,390.0828578709928,390.3669288997028,389.7987868422828,684276,1027587.8666666667,77.11694707263909,62.934928129566345,NaN,NaN,NaN,NaN,3.8809744228299428,30.53447579340566,152630812,1.6597040109536176,4.3885647907684415,2.728860779814824
2024-01-17T09:30:00-05:00,387.745,390.11,384.81,388.42,379.09361302267916,NaN,NaN,NaN,NaN,NaN,374.8392000000003,386.9084467635294,362.76995323647117,383.18520253407127,387.78000000000003,387.78000000000003,387.78000000000003,1341153,1038604.6333333333,70.72180785683446,64.9527841587971,NaN,NaN,NaN,NaN,4.000190535484948,31.56791792272882,151289659,1.3941956121836254,4.471605295044355,3.07740968286073
2024-01-17T13:30:00-05:00,388.4,389.82,387.06,389.4,379.09361302267916,NaN,NaN,NaN,NaN,NaN,375.1406000000003,387.87810205333756,362.403097946663,383.18520253407127,388.11253917287695,388.576550043354,387.6485283023999,688823,1043778.2,71.98564142731149,67.24517232079451,NaN,NaN,NaN,NaN,3.9116054972360224,32.52754275710033,151978482,1.1891792076858017,4.563883692467982,3.3747044847821805
2024-01-18T09:30:00-05:00,391.65,393.19,390.11,390.33,380.0293856689419,NaN,NaN,NaN,NaN,NaN,375.55240000000026,388.8824319939209,362.22236800607965,383.3350189579556,391.21,391.21,391.21,1599315,1072104.8666666667,73.16928105509714,68.8953176791787,NaN,NaN,NaN,NaN,3.902919390290594,33.866241096077054,153577797,1.0269240488190388,4.658359545805979,3.6314354969869402
2024-01-18T13:30:00-05:00,390.35,393.99,390.28,393.84,380.5366863203536,NaN,NaN,NaN,NaN,NaN,376.00260000000026,390.2225734514164,361.7826265485841,384.2510151663645,391.71899927366024,392.4268306952562,391.01116785206426,827006,1083844.5,77.10163142638606,70.41452681771698,NaN,NaN,NaN,NaN,3.8891394338412684,35.207842363683866,154404803,1.062285498849472,4.959292370548781,3.8970068716993085
2024-01-19T09:30:00-05:00,395.505,396.56,393.54,396.29,383.56706421488303,NaN,NaN,NaN,NaN,NaN,376.48180000000025,391.75060358898605,361.21299641101444,387.25881213309157,395.46333333333337,395.46333333333337,395.46333333333337,1735832,1114421.8333333333,79.37399899438554,72.02983156924431,NaN,NaN,NaN,NaN,3.827058045709748,36.75528195474377,156140635,1.149587618047243,5.333991394258362,4.184403776211119
2024-01-19T13:30:00-05:00,396.32,398.65,395.97,398.65,385.98356129602473,NaN,NaN,NaN,NaN,NaN,376.96800000000025,393.43427292373855,360.50172707626194,389.8690497064733,396.39648392590146,397.52309625076043,395.2698716010425,1190864,1135793.7666666666,81.29915477845526,73.70373328269868,NaN,NaN,NaN,NaN,3.745125328159048,38.415387250502846,157331499,1.2565048886100678,5.755034886973704,4.498529998363636
2024-01-22T09:30:00-05:00,400.06,400.63,393.6,395.89,385.98356129602473,NaN,NaN,NaN,NaN,NaN,377.42000000000024,394.6792607025611,360.16073929743936,390.09023976517864,396.70666666666665,396.70666666666665,396.70666666666665,2290025,1186085.8666666667,72.74749085501661,74.0725721667325,NaN,NaN,NaN,NaN,3.979759233290543,39.02793274571351,155041474,1.0405015084922304,5.799156883978924,4.758655375486693
2024-01-22T13:30:00-05:00,395.88,397.9,395.88,396.51,385.98356129602473,NaN,NaN,NaN,NaN,NaN,377.86400000000026,395.90489842549135,359.82310157450917,390.09023976517864,396.7201879447137,396.7443412227332,396.6960346666942,717668,1186419.1666666667,73.42376888236461,74.43636914679142,NaN,NaN,NaN,NaN,3.8397764309126456,39.59672499126626,155759142,0.8467531649488507,5.817096831672757,4.970343666723906
2024-01-23T09:30:00-05:00,395.74,397.57,393.93,397.36,385.98356129602473,NaN,NaN,NaN,NaN,NaN,378.50540000000024,396.9874865531704,360.02331344683006,390.09023976517864,396.2866666666667,396.2866666666667,396.2866666666667,1096186,1188248.5,74.36305306127758,74.80097052407065,NaN,NaN,NaN,NaN,3.8255066858474556,39.369105404635256,156855328,0.6898585964356361,5.832666912268451,5.142808315832815
2024-01-23T13:30:00-05:00,397.38,399.38,396.945,398.89,386.86861529443087,NaN,NaN,NaN,NaN,NaN,379.1620000000002,398.15448651438413,360.1695134856163,390.6637427597715,397.1804370221071,398.2266100899909,396.13426395422334,800072,1190642.2666666666,76.00684966564788,75.172980414857,NaN,NaN,NaN,NaN,3.7261847797154948,39.46263716484186,157655400,0.6061116167832736,5.900447836811907,5.294336220028633
2024-01-24T09:30:00-05:00,401.54,405.63,400.45,405.46,391.34038278104754,NaN,NaN,NaN,NaN,NaN,379.8588000000002,400.06429297193836,359.65330702806204,395.28699420781714,403.84666666666664,403.84667206146327,403.84666127187,2009331,1201568.6,81.49405940121225,75.68190446897263,NaN,NaN,NaN,NaN,3.941457295450103,40.39589638990929,159664731,0.8928618584459,6.410413543086008,5.517551684640108
2024-01-24T13:30:00-05:00,405.45,405.49,402,402.48,392.10127447281815,NaN,NaN,NaN,NaN,NaN,380.5308000000002,401.4532850684378,359.60831493156263,395.47059536625375,403.68656764409997,403.92771792528214,403.4454173629178,885632,1203016.8333333333,73.3050095017808,75.55674335156064,NaN,NaN,NaN,NaN,3.9092103457750964,41.26249424175762,158779099,0.785306956963054,6.499185380843926,5.713878423880872
2024-01-25T09:30:00-05:00,404.33,407.01,403.36,405.41,393.4528074513264,NaN,NaN,NaN,NaN,NaN,381.1936000000002,403.1036859915953,359.28351400840506,396.729476293003,405.26,405.26,405.26,1736543,1216069.7,75.87221727402213,75.57006508945938,NaN,NaN,NaN,NaN,3.9535524639340163,42.24804778321052,160515642,0.8116199561346651,6.728403369049204,5.916783412914539
2024-01-25T13:30:00-05:00,405.41,405.41,402.53,405.08,393.4528074513264,NaN,NaN,NaN,NaN,NaN,381.84360000000015,404.60477633513494,359.08242366486536,396.729476293003,404.9133408935697,405.3591590648701,404.4675227222693,1049966,1230303.3333333333,74.99741770318624,75.41867013449847,NaN,NaN,NaN,NaN,3.87687014508159,42.826379876842154,159465676,0.7105639609881012,6.804988364149665,6.094424403161564
2024-01-26T09:30:00-05:00,404.115,406.18,402.7,403.52,393.4528074513264,NaN,NaN,NaN,NaN,NaN,382.47080000000017,405.8499609224793,359.09163907752105,396.729476293003,404.1333333333334,404.1333333333334,404.1333333333334,1353981,1241791,70.83931257465441,75.42706332862846,NaN,NaN,NaN,NaN,3.8485222775757637,43.46798716731077,158111695,0.45485782450790957,6.66299668379645,6.208138859288541
2024-01-26T13:30:00-05:00,403.55,404.36,402.43,403.99,393.4528074513264,NaN,NaN,NaN,NaN,NaN,383.0856000000001,407.0713765052396,359.09982349476064,396.729476293003,403.95744085004105,404.21050956651754,403.70437213356456,654079,1236603.1,71.35461450494081,75.38198997703056,NaN,NaN,NaN,NaN,3.7114849720346386,43.944353351784265,158765774,0.24413765827909906,6.513310932137415,6.269173273858316
2024-01-29T09:30:00-05:00,406.01,409.12,404.36,407.16,395.27512934969184,NaN,NaN,NaN,NaN,NaN,383.7166000000002,408.5282948586559,358.9049051413445,399.721217489614,406.88000000000005,406.88000000000005,406.88000000000005,1435476,1241129.2,74.61312646145504,75.48512179177041,NaN,NaN,NaN,NaN,3.8128074740321645,45.0025818618544,160201250,0.24441137919356937,6.574687497850277,6.330276118656708
2024-01-29T13:30:00-05:00,407.18,409.98,406.93,409.74,397.0953507428877,NaN,NaN,NaN,NaN,NaN,384.49980000000016,410.06419633238244,358.9354036676179,400.93597399169124,407.65336095464176,408.62866224807385,406.67805966120966,902574,1244317.7333333334,76.9147985131919,75.47177658368511,NaN,NaN,NaN,NaN,3.7583212258870105,46.08110803339855,161103824,0.3387081474110154,6.753661302920477,6.414953155509462
2024-01-30T09:30:00-05:00,412.25,413.05,406.46,408.02,398.0130620727564,NaN,NaN,NaN,NaN,NaN,385.23940000000016,411.3375419752279,359.1412580247724,402.519779193353,409.1766666666667,409.1766666666667,409.1766666666667,1908051,1267434.1666666667,72.21422952561028,74.96036447877259,NaN,NaN,NaN,NaN,3.9605839954665116,47.399553730288524,159195773,0.21180560894336242,6.679710166688665,6.467904557745302
2024-01-30T13:30:00-05:00,408.07,409.42,407.31,408.61,398.0130620727564,NaN,NaN,NaN,NaN,NaN,385.94080000000014,412.6220646896506,359.2595353103497,402.519779193353,408.93062067621247,409.27569305072257,408.5855483017024,970068,1259473.5666666667,72.8276744556506,74.35525874142938,NaN,NaN,NaN,NaN,3.828399424361762,48.6238247345435,160165841,0.09984812674326626,6.592714716174385,6.492866589431118
2024-01-31T09:30:00-05:00,407.1,415.32,401.31,403.155,398.0130620727564,NaN,NaN,NaN,NaN,NaN,386.50550000000015,413.423969365829,359.5870306341713,402.519779193353,406.59499999999997,406.59499999999997,406.59499999999997,3369820,1330747.7333333334,59.70329286349282,73.42353031346342,NaN,NaN,NaN,NaN,4.555656608335921,47.39437629371601,156796021,-0.3828784393600939,6.014268540231001,6.397146979591095
2024-01-31T13:30:00-05:00,403.2,404.18,397.21,397.45,NaN,NaN,NaN,413.9436774177501,413.9436774177501,413.9436774177501,386.9619000000002,413.83328172031815,360.0905182796822,402.519779193353,404.1338098117454,407.4693386086401,400.79828101485066,1834711,1369020.1,49.6299845996858,71.72397429327206,NaN,NaN,NaN,NaN,4.728109707740501,45.04147262870521,154961310,-1.087772318542985,5.037431581412363,6.125203899955348
2024-02-01T09:30:00-05:00,401.9,407.98,401.8,403.87,NaN,NaN,NaN,413.9436774177501,NaN,NaN,387.56010000000015,414.57836304482,360.5418369551803,402.519779193353,404.55,404.55,404.55,2454445,1392172.7666666666,58.18089958594388,70.56810618789109,NaN,NaN,NaN,NaN,5.142530442901895,43.55386411918739,157415755,-1.1186962366025428,4.72683360420217,5.845529840804713
2024-02-01T13:30:00-05:00,403.83,405.11,402.96,403.8,NaN,NaN,NaN,413.9436774177501,NaN,NaN,388.1413000000002,415.28141266076585,361.0011873392345,402.519779193353,404.38824459136237,404.652460532551,404.1240286501737,919926,1391615.4666666666,58.065154174288395,69.28655650993684,NaN,NaN,NaN,NaN,4.928778268408905,42.17251336034941,156495829,-1.1371946602783263,4.424036515456805,5.561231175735132
2024-02-02T09:30:00-05:00,403.92,412.28,403.6,411.59,NaN,NaN,NaN,413.9436774177501,NaN,NaN,388.89250000000015,416.5038297216748,361.28117027832553,402.519779193353,409.1566666666667,409.1566666666667,409.1566666666667,2380517,1396617.9333333333,66.13850134254945,68.18973093431808,NaN,NaN,NaN,NaN,5.196722677808266,41.97141403955573,158876346,-0.6427365725914465,4.757810459995824,5.40054703258727
2024-02-02T13:30:00-05:00,411.6,412.65,410.68,411.12,NaN,NaN,NaN,413.9436774177501,NaN,NaN,389.6339000000002,417.5997325311229,361.6680674688775,402.519779193353,409.8286373482097,410.8831074468085,408.77416724961097,966726,1403063.5666666667,65.32139401398547,67.61947268518983,NaN,NaN,NaN,NaN,4.9662424865362444,41.83224837498219,157909620,-0.3783565676839782,4.927601322982298,5.305957890666276
2024-02-05T09:30:00-05:00,409.705,411.15,403.98,405.11,NaN,NaN,NaN,413.9436774177501,NaN,NaN,390.2199000000002,418.2303795024812,362.20942049751926,402.519779193353,406.74666666666667,406.74666666666667,406.74666666666667,1613278,1410022.7333333334,55.82395235026703,66.18745376206446,NaN,NaN,NaN,NaN,5.123653737497938,39.93889403832667,156296342,-0.6247317908324579,4.525043152125704,5.149774942958162
2024-02-05T13:30:00-05:00,405.12,406.26,404.45,405.53,NaN,NaN,NaN,413.9436774177501,NaN,NaN,390.82450000000017,418.82572241972514,362.8232775802752,402.519779193353,406.28108563301186,406.9167026659978,405.64546860002594,865583,1414204.6666666667,56.30211005552757,64.85207464437455,NaN,NaN,NaN,NaN,4.886964184819514,38.18077929714655,157161925,-0.7665516311709224,4.191585403994509,4.958137035165431
2024-02-06T09:30:00-05:00,405.85,407.97,403.55,404.35,NaN,NaN,NaN,413.9436774177501,NaN,NaN,391.4071000000002,419.2973467604532,363.5168532395472,400.7316586837459,405.28999999999996,405.28999999999996,405.28999999999996,1226587,1383617.1333333333,54.516726734113576,63.6861756557645,NaN,NaN,NaN,NaN,4.85360960018955,36.848348936785854,155935338,-0.9357648886451182,3.7884309243590337,4.724195813004152
2024-02-06T13:30:00-05:00,404.38,405.61,402.92,405.47,NaN,NaN,NaN,413.9436774177501,NaN,NaN,391.9971000000002,419.804119839582,364.19008016041846,400.7316586837459,405.08102489688997,405.3752876262097,404.78676216757026,618610,1381428.2666666666,55.944717793409254,62.58546874779796,NaN,NaN,NaN,NaN,4.699066057318867,35.44625825713537,156553948,-0.9643639464652614,3.518740879922575,4.483104826387836
2024-02-07T09:30:00-05:00,407.595,412.68,407.4,412.57,NaN,NaN,NaN,413.9436774177501,NaN,NaN,392.8561000000002,420.4980897467413,365.2141102532591,400.04942997411507,410.88333333333327,410.88333333333327,410.88333333333327,1480057,1386058.4,63.720735781002084,61.80744084205132,NaN,NaN,NaN,NaN,4.878418481796089,35.26297016733002,158034005,-0.5195019280889079,3.8337274162767017,4.35322934436561
2024-02-07T13:30:00-05:00,412.6,414.3,412.09,414.11,399.5920236903983,399.5920236903983,399.5920236903983,NaN,NaN,NaN,393.7237000000002,421.2562588211299,366.19114117887045,403.0905439792921,411.7917366420435,413.0374461132038,410.5460271708831,787050,1389332.6333333333,65.15727801953807,60.967617949647476,NaN,NaN,NaN,NaN,4.6878171616678,35.30660977011067,158821055,-0.15484624256850488,4.159671541154978,4.314517783723483
2024-02-08T09:30:00-05:00,413.96,415.56,412.63,413.81,400.71079534083475,NaN,NaN,NaN,NaN,NaN,394.56790000000024,421.9231775229728,367.21262247702765,405.12743518343365,414,414,414,997659,1369277.4333333333,64.62047457991038,60.42520688209748,NaN,NaN,NaN,NaN,4.562258792977244,35.512091021479584,157823396,0.023350238257175526,4.343705581544953,4.320355343287777
2024-02-08T13:30:00-05:00,413.83,414.22,412.51,414.18,400.71079534083475,NaN,NaN,NaN,NaN,NaN,395.43870000000027,422.4617502208534,368.41564977914715,405.12743518343365,413.8831764459194,414.0528766184587,413.7134762733801,472801,1357470.6,65.00342543849719,59.86633195230081,NaN,NaN,NaN,NaN,4.358526022050301,35.66657129582534,158296197,0.11804096275635256,4.467906546733218,4.349865583976865
2024-02-09T09:30:00-05:00,415.36,420.39,415.15,419.57,404.5054870770829,NaN,NaN,NaN,NaN,NaN,396.4185000000002,423.31746624405616,369.5195337559443,409.92415851739753,418.3699999999999,418.3700076293944,418.36999237060536,1470775,1348635.3666666667,70.08353465310557,60.607777794416,NaN,NaN,NaN,NaN,4.4907741633324205,36.563618596511155,159766972,0.47552368585141913,4.944270191291139,4.46874650543972
2024-02-09T13:30:00-05:00,419.58,420.8,419.29,420.64,407.17751039176096,NaN,NaN,NaN,NaN,NaN,397.4711000000002,423.95682395006173,370.9853760499387,411.67232681391806,418.90297735500013,419.7481870237185,418.05776768628175,584837,1328434.4666666666,70.98399546563368,62.13306428484085,NaN,NaN,NaN,NaN,4.27786172309439,37.44085503827338,160351809,0.702203385121611,5.346500736841733,4.644297351720122
2024-02-12T09:30:00-05:00,420.5,420.75,416.76,418.27,407.17751039176096,NaN,NaN,NaN,NaN,NaN,398.45650000000023,424.28998170492787,372.6230182950726,411.67232681391806,418.5933333333333,418.5933333333333,418.5933333333333,1221250,1292808.6333333333,66.22898079972073,62.70792722868206,NaN,NaN,NaN,NaN,4.257300171444792,37.472094154125124,159130559,0.6138821316392784,5.4116500162692205,4.797767884629942
2024-02-12T13:30:00-05:00,418.25,418.33,414.74,415.33,407.17751039176096,NaN,NaN,NaN,NaN,NaN,399.4091000000002,424.1242614754792,374.6939385245212,411.67232681391806,417.5560046799266,418.7708206133926,416.34118874646066,890464,1298568.5,60.78896872703228,62.902485411020905,NaN,NaN,NaN,NaN,4.209635873484447,36.91435727657516,158240095,0.2949790996760777,5.166491759225039,4.871512659548961
2024-02-13T09:30:00-05:00,404.83,410.08,403.36,407.43,NaN,NaN,NaN,420.50669902910425,420.50669902910425,420.50669902910425,400.1227000000002,423.63327270334105,376.6121272966593,411.67232681391806,406.9566666666667,406.9566666666667,406.9566666666667,2072819,1331122.9333333333,49.114742445083465,61.68650263263048,NaN,NaN,NaN,NaN,4.763947596806984,34.61769222828721,156167276,-0.46893862960169397,4.285339372546844,4.754278002148538
2024-02-13T13:30:00-05:00,407.43,407.53,404.56,406.54,NaN,NaN,NaN,419.61003089141764,NaN,NaN,400.76050000000026,423.17713973477646,378.34386026522407,411.67232681391806,406.6833758943123,407.0430552845211,406.3236965041035,1196686,1344343.4,47.99643828495916,60.44900579484288,NaN,NaN,NaN,NaN,4.63580848274934,32.4850746834484,154970590,-1.0233064907507687,3.4751448887100764,4.498451379460845
2024-02-14T09:30:00-05:00,408.07,408.78,404.57,406.72,NaN,NaN,NaN,419.61003089141764,NaN,NaN,401.39190000000025,422.6352638475345,380.148536152466,411.67232681391806,406.68999999999994,406.6900076293945,406.6899923706054,1461195,1326072.2,48.253063834576494,59.908228043722126,NaN,NaN,NaN,NaN,4.605393591124385,30.259984094940094,156431785,-1.3466544521104415,2.815133314322793,4.161787766433235
2024-02-14T13:30:00-05:00,406.75,409.85,405.97,409.21,NaN,NaN,NaN,419.61003089141764,NaN,NaN,402.06150000000025,422.103810670149,382.0191893298515,411.67232681391806,407.2262923533803,408.00028236364136,406.45230234311924,701521,1319935.1666666667,51.79674540881511,59.58641628324266,NaN,NaN,NaN,NaN,4.553579763186929,28.21518216704512,157133306,-1.357765080124408,2.464581416277724,3.8223464964021323
2024-02-15T09:30:00-05:00,408.14,409.15,404.3,406.03,NaN,NaN,NaN,419.61003089141764,NaN,NaN,402.5411000000002,421.77641286875513,383.30578713124527,411.67232681391806,406.49333333333334,406.49333333333334,406.49333333333334,1564274,1314192.8666666667,47.338190133787535,59.073663668933655,NaN,NaN,NaN,NaN,4.579038351530717,26.423643018426375,155569032,-1.531340491740547,1.9081708817264484,3.4395113734669955
2024-02-15T13:30:00-05:00,406.05,407.2,404.84,406.65,NaN,NaN,NaN,419.22411021614727,NaN,NaN,403.0211000000002,421.42690987511315,384.6152901248873,411.67232681391806,406.39492654503135,406.5223231369234,406.26752995313933,933356,1310305.8666666667,48.27307387533998,58.52568910335729,NaN,NaN,NaN,NaN,4.420535612135667,24.76007095185182,156502388,-1.5516492151098276,1.499949854579711,3.0515990696895385
2024-02-16T09:30:00-05:00,407.93,408.28,403.54,405.13,NaN,NaN,NaN,419.1602870245042,NaN,NaN,403.4561000000002,420.99208897008265,385.9201110299178,411.67232681391806,405.6499999999999,405.6499999999999,405.6499999999999,1152750,1303598.1666666667,46.111796768728546,57.267907745337745,NaN,NaN,NaN,NaN,4.443354496983116,23.49637814416161,155349638,-1.607862008859736,1.0417715586148688,2.6496335674746048
2024-02-16T13:30:00-05:00,405.14,407.45,403.54,404.06,NaN,NaN,NaN,418.6761830688449,NaN,NaN,403.8453000000002,420.5333189848568,387.15728101514355,411.4528614511344,405.39423822076213,405.70499274196794,405.0834836995563,780857,1307824.1,44.59807355334089,55.799393140609375,NaN,NaN,NaN,NaN,4.405257747198606,22.322949108449276,154568781,-1.6512494193380425,0.5855717933020514,2.236821212640094
2024-02-20T09:30:00-05:00,403.29,404.5,398.01,399.67,NaN,NaN,NaN,414.7220383838974,NaN,NaN,404.0837000000002,420.1750826391305,387.9923173608699,409.0972891609075,400.7266666666667,400.7266666666667,400.7266666666667,1549540,1311626.2333333334,38.948784899639065,53.96570102059,NaN,NaN,NaN,NaN,4.5541679081129915,22.341500514946794,153019241,-1.8924348007336327,-0.12872228827694698,1.7637125124566857
2024-02-20T13:30:00-05:00,399.65,402.99,399.54,402.91,NaN,NaN,NaN,414.590354820993,NaN,NaN,404.37370000000016,419.83504571241906,388.91235428758125,398.4295616403078,401.06736227815986,401.57149426960655,400.5632302867132,707697,1305130.3333333333,44.5331796512789,52.50354060721725,NaN,NaN,NaN,NaN,4.475298771819205,22.3587268209802,153726938,-1.7537107654441746,-0.42842594434853254,1.325284821095642
2024-02-21T09:30:00-05:00,400,400.71,397.22,399.04,NaN,NaN,NaN,412.46056596549334,NaN,NaN,404.57450000000017,419.4828783490734,389.6661216509269,398.4295616403078,398.99,398.99,398.99,1080896,1277558.5,39.844980470715946,50.34364387990371,NaN,NaN,NaN,NaN,4.562063145260691,22.790149016579605,152646042,-1.833885539175349,-0.9670721028735443,0.8668134363018047
2024-02-21T13:30:00-05:00,399.08,402.33,397.55,402.2,NaN,NaN,NaN,412.46056596549334,NaN,NaN,404.8113000000002,419.1752252030529,390.4473747969475,398.4295616403078,399.6462727577416,400.47522229267787,398.8173232228053,677480,1267805.5666666667,44.941863416051994,48.48349159064787,NaN,NaN,NaN,NaN,4.577630063456354,22.70034311618394,153323522,-1.5942409787657146,-1.1259877871553385,0.46825319161037604
2024-02-22T09:30:00-05:00,410.17,412.81,408.59,410.2,396.33441200251536,396.33441200251536,396.33441200251536,NaN,NaN,NaN,405.24690000000027,418.89946120875015,391.5943387912504,398.4295616403078,410.5333333333333,410.5333333333333,410.5333333333333,1604939,1208976.2,55.27381246435159,47.70097956669293,NaN,NaN,NaN,NaN,5.00851363035233,21.89698445126213,154928461,-0.8541913289473226,-0.5994859695737773,0.2547053593735453
2024-02-22T13:30:00-05:00,410.23,412.06,410.12,411.61,397.1128478205829,NaN,NaN,NaN,NaN,NaN,405.69110000000023,418.6815717835349,392.7006282164656,399.32662595343845,410.8136643006315,411.1687081780591,410.4586204232039,1000545,1181170.6666666667,56.8120969971965,47.41691730027609,NaN,NaN,NaN,NaN,4.789334085327163,21.151008548120455,155929006,-0.2579036187971836,-0.06767416412293414,0.19022945467424943
2024-02-23T09:30:00-05:00,415.675,415.85,408.96,410.14,398.1236274651018,NaN,NaN,NaN,NaN,NaN,406.08730000000025,418.3686193443866,393.8059806556139,402.2183007627508,411.6499999999999,411.6499999999999,411.6499999999999,1184633,1138843.6,54.699854063054644,47.81585384441689,NaN,NaN,NaN,NaN,4.93938165066094,21.104726619190764,154744373,0.033811448336555416,0.23249376509494368,0.19868231675838827
2024-02-23T13:30:00-05:00,410.14,410.85,409.53,410.32,398.1236274651018,NaN,NaN,NaN,NaN,NaN,406.4169000000002,418.2418656049746,394.5919343950259,402.2183007627508,411.20016934593696,411.8596482886658,410.5406904032081,551163,1126551.5,54.9208673842825,48.31045592293999,NaN,NaN,NaN,NaN,4.680854389899449,21.061750542327477,155295536,0.22455617969380193,0.4793775413756407,0.2548213616818388
2024-02-26T09:30:00-05:00,411.31,412.16,408.01,408.88,398.1236274651018,NaN,NaN,NaN,NaN,NaN,406.6687000000002,418.15160987681776,395.1857901231826,402.2183007627508,409.6833333333334,409.6833333333334,409.6833333333334,939319,1078511.5666666667,52.7054818858173,48.62848578374291,NaN,NaN,NaN,NaN,4.6429362191923484,20.631239029350187,154356217,0.2381190823571921,0.5524702146283289,0.3143511322711368
2024-02-26T13:30:00-05:00,408.89,409.46,407.37,407.49,398.1236274651018,NaN,NaN,NaN,NaN,NaN,406.8455000000002,418.09904099824035,395.59195900176,402.2183007627508,409.06942256473934,409.8382178647685,408.30062726471016,598966,1066252.9,50.58436212308728,48.54188697761949,NaN,NaN,NaN,NaN,4.460583632107179,20.065808484544466,153757251,0.14256501924411802,0.4925574063262843,0.3499923870821663
2024-02-27T09:30:00-05:00,407.98,408.35,403.85,404.57,398.1236274651018,NaN,NaN,NaN,NaN,NaN,407.0191000000002,417.8511833988124,396.187016601188,402.2183007627508,405.59,405.59,405.59,947492,1044060.0333333333,46.36316875409709,48.47224259335589,NaN,NaN,NaN,NaN,4.463399086956666,18.681850303600896,152809759,-0.11433830234458259,0.20706950915143807,0.32140781149602066
2024-02-27T13:30:00-05:00,404.57,407.85,404.44,407.46,398.1236274651018,NaN,NaN,NaN,NaN,NaN,407.2381000000002,417.6459068563493,396.8302931436511,402.2183007627508,406.00759264934703,406.4979242489683,405.5172610497258,687229,1038114.9,50.744196948763005,48.64875138431467,NaN,NaN,NaN,NaN,4.388156295031192,17.39674627843901,153496988,-0.087863689761006,0.21157819929476318,0.2994418890557692
2024-02-28T09:30:00-05:00,408.225,409.31,405.31,407.19,398.1236274651018,NaN,NaN,NaN,NaN,NaN,407.43470000000025,417.4527773424256,397.4166226575749,402.2183007627508,407.2699999999999,407.27000762939446,407.2699923706054,805874,1024091.1333333333,50.3305826932633,48.950093236067154,NaN,NaN,NaN,NaN,4.360430845386107,16.54969702175439,152691114,-0.08662467946185037,0.19116103972845622,0.2777857191903066
2024-02-28T13:30:00-05:00,407.215,407.985,406.22,407.74,398.1236274651018,NaN,NaN,NaN,NaN,NaN,407.6117000000002,417.32782383818494,397.8955761618155,402.2183007627508,407.2902138083476,407.31259735908316,407.267830257612,657212,1025377.8666666667,51.203121525920004,49.42188237696566,NaN,NaN,NaN,NaN,4.175042927858526,15.763151283404381,153348326,-0.04873988724956568,0.2168608601283495,0.26560074737791517
2024-02-29T09:30:00-05:00,408.76,410.205,405.93,409.32,398.1236274651018,NaN,NaN,NaN,NaN,NaN,407.6889000000002,417.39674740088367,397.98105259911677,402.2183007627508,408.48499999999996,408.48499999999996,408.48499999999996,1093950,1012507.6333333333,53.71838390859748,50.47685373474841,NaN,NaN,NaN,NaN,4.182182718725772,15.567569633619785,154442276,0.07597106950396582,0.3605645842578724,0.2845935147539066
2024-02-29T13:30:00-05:00,409.37,414.2,409.02,413.41,398.636943212311,NaN,NaN,NaN,NaN,NaN,407.9075000000002,417.6285608988414,398.186439101159,404.2261071539971,410.51261755363157,412.36778397297127,408.6574511342919,1306784,1029832.1,59.53325898373318,51.54828797278085,NaN,NaN,NaN,NaN,4.253455381673932,16.213151440158175,155749060,0.40857461240907583,0.7953117802652514,0.38673716785617557
2024-03-01T09:30:00-05:00,411.25,415.1,410.87,414.91,400.02480942993327,NaN,NaN,NaN,NaN,NaN,408.09750000000014,417.98579737615194,398.20920262384834,405.00588572319765,413.6266666666667,413.6266666666667,413.6266666666667,1225886,1037439.6666666666,61.446410333885844,53.09124724872156,NaN,NaN,NaN,NaN,4.2517799972686525,16.981141258227158,156974946,0.6878265999693494,1.2465204178178624,0.558693817848513
2024-03-01T13:30:00-05:00,414.9,415.88,414.49,415.49,402.62436354675447,NaN,NaN,NaN,NaN,NaN,408.30570000000023,418.367933153675,398.2434668463255,407.1097085785581,414.24130246887586,415.0428748375753,413.4397301001764,720776,1045705.5,62.19074901809198,54.323310506010124,NaN,NaN,NaN,NaN,4.047367140320891,17.84231525028876,157695722,0.8587200689343215,1.6320939040164149,0.7733738350820933
2024-03-04T09:30:00-05:00,413.53,417.35,412.33,415.61,402.62436354675447,NaN,NaN,NaN,NaN,NaN,408.5475000000001,418.7185696093997,398.37643039060055,407.8237668628465,415.09666666666664,415.09666666666664,415.09666666666664,1338741,1041304.3666666667,62.35269775538284,54.828945169655206,NaN,NaN,NaN,NaN,4.116840916012259,17.922811966637127,159034463,0.9214246775714998,1.9251546820464682,1.0037300044749684
2024-03-04T13:30:00-05:00,415.63,415.93,414.58,414.86,402.97276719859235,NaN,NaN,NaN,NaN,NaN,408.7649000000002,419.0014889806594,398.52831101934095,407.8237668628465,415.10521871727695,415.11766528705664,415.09277214749727,632030,1042877.4666666667,60.605444595614586,55.09989856954222,NaN,NaN,NaN,NaN,3.919209422011385,17.99755891753204,158402433,0.8554100445759036,2.072992560194848,1.2175825156189444
2024-03-05T09:30:00-05:00,413.99,414.25,402.13,402.59,NaN,NaN,NaN,419.41462058430835,419.41462058430835,419.41462058430835,408.6735000000002,419.04647609169547,398.30052390830497,407.8237668628465,406.3233333333333,406.3233333333333,406.3233333333333,2215515,1076019.6333333333,40.573872669965404,54.090899898607276,NaN,NaN,NaN,NaN,4.54855160615343,18.270039358444283,156186918,-0.02495185892614793,1.1863926919612595,1.2113445508874074
2024-03-05T13:30:00-05:00,402.58,402.87,400.63,402.81,NaN,NaN,NaN,414.9035013748363,NaN,NaN,408.5349000000002,419.031625677988,398.0381743220124,407.8237668628465,404.83495768373257,406.8513116127175,402.81860375474764,1207164,1086576.3,40.95073323929024,53.09303317396497,NaN,NaN,NaN,NaN,4.383655062856757,18.76087625208307,157394082,-0.5724413379262758,0.49579287847956266,1.0682342164058385
2024-03-06T09:30:00-05:00,402.79,405.16,398.39,404.285,NaN,NaN,NaN,414.9035013748363,NaN,NaN,408.4602000000002,419.0234689939667,397.89693100603375,407.8237668628465,402.6116666666667,402.6116666666667,402.6116666666667,1711027,1074516.5666666667,43.5361341802891,52.43807976642724,NaN,NaN,NaN,NaN,4.554108272652706,18.631793791983654,159105109,-0.8011966491931822,0.06673840491436067,0.8679350541075429
2024-03-06T13:30:00-05:00,404.31,404.44,400.43,402.3,NaN,NaN,NaN,414.9035013748363,NaN,NaN,408.3340000000002,419.0369433334534,397.63105666654695,407.8237668628465,402.53048178931925,402.6372759690537,402.4236876095848,988808,1067587.3,40.93838467924635,51.749081377581454,NaN,NaN,NaN,NaN,4.515243396034655,18.511931507605624,158116301,-1.0371668551952171,-0.42852351488647855,0.6086433403087386
2024-03-07T09:30:00-05:00,406.265,408.82,402.24,408.57,NaN,NaN,NaN,414.9035013748363,NaN,NaN,408.44230000000016,419.0425251315303,397.84207486847004,407.8237668628465,406.54333333333335,406.54333333333335,406.54333333333335,1321073,1062916.5666666667,50.903639708343135,52.07340073145617,NaN,NaN,NaN,NaN,4.662726010603606,17.341833000114274,159437374,-0.7361105414454473,-0.3114948364980705,0.42461570494737677
2024-03-07T13:30:00-05:00,408.57,409.79,407.67,409.08,NaN,NaN,NaN,414.9035013748363,NaN,NaN,408.67490000000015,418.7998415780585,398.5499584219418,407.8237668628465,407.35293809952526,408.45263340611126,406.25324279293926,716025,1063400.0333333334,51.6187085790409,52.1358658479046,NaN,NaN,NaN,NaN,4.481102724131921,16.164992610575776,160153399,-0.48015027725255566,-0.1755721416183178,0.30457813563423786
2024-03-08T09:30:00-05:00,407.915,410.42,404.56,404.89,NaN,NaN,NaN,414.9035013748363,NaN,NaN,408.69530000000015,418.7854858079607,398.6051141920396,407.8237668628465,406.6233333333333,406.6233333333333,406.6233333333333,1353497,1056374.1333333333,45.726296234938275,51.80698824373852,NaN,NaN,NaN,NaN,4.579595386693927,15.611249504837762,158799902,-0.5647218636062863,-0.40132419387362006,0.16339766973266626
2024-03-08T13:30:00-05:00,404.82,407.73,404.32,406.24,NaN,NaN,NaN,414.9035013748363,NaN,NaN,408.7441000000001,418.7624574880919,398.7257425119083,407.8237668628465,406.4542023395614,406.7001095652565,406.20829511386626,640267,1046604.5,47.79410316007302,51.56348693189231,NaN,NaN,NaN,NaN,4.496052859072934,15.146693076083537,159440169,-0.5034618614712647,-0.46592965710641465,0.03753220436485008
2024-03-11T09:30:00-04:00,403.77,404.63,401.28,404.5,NaN,NaN,NaN,414.9035013748363,NaN,NaN,408.6023000000001,418.65616079270796,398.5484392072923,407.6340134902772,403.46999999999997,403.46999999999997,403.46999999999997,1021786,1042239.0333333333,45.393531578406304,50.968854622592936,NaN,NaN,NaN,NaN,4.529191940567727,15.324218277873383,158418383,-0.5500578852125493,-0.6500401521508365,-0.09998226693828724
2024-03-11T13:30:00-04:00,404.58,405.68,403.51,404.53,NaN,NaN,NaN,414.9035013748363,NaN,NaN,408.47050000000013,418.56159592656655,398.3794040734337,401.24821079222176,403.91226665478274,404.45297706567794,403.37155624388754,683595,1038996.9666666667,45.444410311441985,49.962508288857855,NaN,NaN,NaN,NaN,4.360678230527176,15.205825597607776,159101978,-0.5476023777509085,-0.7844852391269228,-0.23688286137601436
2024-03-12T09:30:00-04:00,407.675,414.45,406.78,413.64,NaN,NaN,NaN,414.9035013748363,NaN,NaN,408.64110000000005,418.78744225519097,398.49475774480914,401.2171493611176,411.6233333333333,411.6233333333333,411.6233333333333,1382409,1033425.9333333333,58.18537270189598,49.729577029430004,NaN,NaN,NaN,NaN,4.757772642632379,15.03252692142937,160484387,0.0661814414758487,-0.15415605953120348,-0.22033750100705218
2024-03-12T13:30:00-04:00,413.61,415.57,413.58,415.26,401.0238536994285,401.0238536994285,401.0238536994285,NaN,NaN,NaN,408.8357000000001,419.1083460096319,398.5630539903683,403.9887194888941,412.7833225349713,414.31407095104754,411.2525741188951,793847,1036297.6,59.97544594904989,49.571341095926996,NaN,NaN,NaN,NaN,4.560074596730067,15.064779679820854,161278234,0.5528132981993512,0.4706791217421369,-0.08213417645721435
2024-03-13T09:30:00-04:00,418.08,418.18,411.46,415.44,401.0238536994285,NaN,NaN,NaN,NaN,NaN,409.05750000000006,419.4117308743482,398.7032691256519,405.5549755911153,415.02666666666664,415.02666666666664,415.02666666666664,1177249,1039509.3666666667,60.17942813355102,49.41610755151044,NaN,NaN,NaN,NaN,4.714354982677922,15.530571585834602,162455483,0.8410813128915473,0.9692174646572198,0.12813615176567247
2024-03-13T13:30:00-04:00,415.45,416.62,413.93,415.2,401.6862489286115,NaN,NaN,NaN,NaN,NaN,409.25210000000004,419.6946778598745,398.8095221401256,405.5549755911153,415.09746357964633,415.20138233462615,414.9935448246665,546398,1035139.9666666667,59.74223770815378,49.35444991669181,NaN,NaN,NaN,NaN,4.569758198200928,15.9630926414188,161909085,0.9611868154255155,1.329619671047567,0.3684328556220514
2024-03-14T09:30:00-04:00,420.19,427.83,418,423.84,408.2216467045837,NaN,NaN,NaN,NaN,NaN,409.4775000000001,420.65730684088356,398.2976931591166,412.3589843783138,423.2233333333333,423.2233333333333,423.2233333333333,3122281,1085718.0333333334,68.5891140324343,51.35553858543959,NaN,NaN,NaN,NaN,5.14548975547229,17.846213714124204,165031366,1.5341052998006222,2.286064480372829,0.751959180572207
2024-03-14T13:30:00-04:00,423.81,427.19,422.63,425.46,410.2627082180117,NaN,NaN,NaN,NaN,NaN,409.70450000000005,421.6836646202663,397.7253353797338,412.533187502651,423.79062129470526,424.6502798645321,422.93096272487844,1359650,1097688.2,69.92371216478567,53.42503708011784,NaN,NaN,NaN,NaN,5.103669058652841,19.594826138779222,166391016,1.9093083187987818,3.138594579070684,1.2292862602719024
2024-03-15T09:30:00-04:00,419.285,422.69,412.81,414.11,410.2627082180117,NaN,NaN,NaN,NaN,NaN,409.7105,421.69818138546606,397.722818614534,412.533187502651,416.5366666666667,416.5366666666667,416.5366666666667,2055758,1126725.7,52.94926043886293,54.097403241444546,NaN,NaN,NaN,NaN,5.642692697320493,19.065260843860088,164335258,1.308851552647334,2.86535070108107,1.5564991484337358
2024-03-15T13:30:00-04:00,414.1,417.27,414.07,416.42,410.2627082180117,NaN,NaN,NaN,NaN,NaN,409.75530000000003,421.82591529664177,397.6846847033583,412.533187502651,416.35501059059106,416.63611967427835,416.0739015069038,858464,1136969.0666666667,55.326235531640336,55.12510687375839,NaN,NaN,NaN,NaN,5.468214647511886,18.573521641435175,165193722,0.9971132210318794,2.802890674723585,1.8057774536917057
2024-03-18T09:30:00-04:00,413.84,420.73,413.76,418.59,410.2627082180117,NaN,NaN,NaN,NaN,NaN,409.73570000000007,421.74553363912577,397.72586636087436,412.533187502651,417.69333333333327,417.6933409627278,417.69332570393874,1312060,1149393.7666666666,57.49841517167916,55.59616226399668,NaN,NaN,NaN,NaN,5.575485029832467,18.616579520016117,166505782,0.8714727535840083,2.895118395671716,2.0236456420877076
2024-03-18T13:30:00-04:00,418.61,419.69,416.93,417.36,410.2627082180117,NaN,NaN,NaN,NaN,NaN,409.67010000000005,421.47505599142403,397.86514400857607,412.533187502651,417.7991318762969,417.9424714426187,417.6557923099751,714794,1153254.7,55.841018062506436,55.897755798529936,NaN,NaN,NaN,NaN,5.374378956273004,18.65656183584128,165790988,0.6500947833299677,2.836264121250167,2.1861693379201994
2024-03-19T09:30:00-04:00,417.72,421.66,415.58,420.77,410.2627082180117,NaN,NaN,NaN,NaN,NaN,409.7201000000001,421.69035254366867,397.74984745633157,412.533187502651,419.33666666666664,419.33666666666664,419.33666666666664,1304161,1165143.6666666667,59.34022498411111,56.87017928061372,NaN,NaN,NaN,NaN,5.424780459396364,18.982178817986952,167095149,0.6749476626732802,3.0298539162618,2.3549062535885197
2024-03-19T13:30:00-04:00,420.8,421.56,419.08,421.43,410.2627082180117,NaN,NaN,NaN,NaN,NaN,409.8421,422.1579220334446,397.5262779665554,412.533187502651,419.84940259074307,420.5059119124224,419.19289326906375,795494,1168752.5,60.00088076678014,57.74209196680708,NaN,NaN,NaN,NaN,5.214438998010911,19.284537444265077,167890643,0.6757935215076065,3.199648155473028,2.5238546339654215
2024-03-20T09:30:00-04:00,422,423.39,420.66,422.21,410.2627082180117,NaN,NaN,NaN,NaN,NaN,410.1377,422.9088273127959,397.3665726872041,412.533187502651,422.08666666666664,422.08666666666664,422.08666666666664,745801,1166750.0666666667,60.811294035531134,58.84336071374456,NaN,NaN,NaN,NaN,5.036979069581557,19.84548691582661,168636444,0.6676657531860135,3.3584368254479386,2.690771072261925
2024-03-20T13:30:00-04:00,422.24,425.95,421.02,425.17,410.2627082180117,NaN,NaN,NaN,NaN,NaN,410.5103,423.91136330257973,397.1092366974202,414.13082306860474,423.223697159614,424.1910344453255,422.2563598739025,1030413,1179190.1,63.80804051267135,60.15504858526095,NaN,NaN,NaN,NaN,5.029337707468589,20.738288477683255,169666857,0.7919403220731729,3.6806964748533915,2.8887561527802186
2024-03-21T09:30:00-04:00,429.86,430.82,427.11,429.13,414.07326074585364,NaN,NaN,NaN,NaN,NaN,410.95849999999996,425.28927503137,396.62772496862993,418.5396584548838,429.0199999999999,429.02000762939446,429.0199923706054,1342285,1187467.9333333333,67.39972740843814,60.81321677858539,NaN,NaN,NaN,NaN,5.073670728363688,22.184461175137073,171009142,1.0547001042388269,4.207131283078752,3.152431178839925
2024-03-21T13:30:00-04:00,429.1,429.93,428.63,429.4,414.8878852574057,NaN,NaN,NaN,NaN,NaN,411.36229999999995,426.5833850086216,396.1412149913783,419.4557267639071,429.11864768576504,429.2595836280809,428.97771174344916,657620,1165829.1333333333,67.63556210681006,61.36036793271112,NaN,NaN,NaN,NaN,4.804122819194854,23.52733582277276,171666762,1.152594378843259,4.593174152393999,3.44057977355074
2024-03-22T09:30:00-04:00,429.69,429.7,426.09,428.5,414.8878852574057,NaN,NaN,NaN,NaN,NaN,411.8117,427.68919899825875,395.9342010017412,419.5155814111256,428.09666666666664,428.09666666666664,428.09666666666664,946048,1156501.2,65.92361280068552,61.77066683750644,NaN,NaN,NaN,NaN,4.718828332109508,24.052162607554422,170720714,1.064728705244657,4.771490655106561,3.706761949861904
2024-03-22T13:30:00-04:00,428.48,429.85,428.07,428.69,415.1338995837106,NaN,NaN,NaN,NaN,NaN,412.25249999999994,428.7442089775424,395.76079102245745,420.8124651289005,428.37586493114,428.747296827513,428.0044330347669,534540,1150293.3333333333,66.11858518767937,62.22612022890113,NaN,NaN,NaN,NaN,4.508912022673117,24.561917044476886,171255254,0.9321728801514007,4.871978050051155,3.939805169899754
2024-03-25T09:30:00-04:00,425.495,427.45,421.61,423.73,415.1338995837106,NaN,NaN,NaN,NaN,NaN,412.62449999999995,429.2949279789039,395.954072021096,420.8124651289005,424.2633333333333,424.2633333333333,424.2633333333333,1039938,1140333.2333333334,56.956839984211236,61.395243511170904,NaN,NaN,NaN,NaN,4.692561163910751,23.405413115584007,170215316,0.44776935006882645,4.499516857485787,4.051747507416961
2024-03-25T13:30:00-04:00,423.72,424.4,422.32,422.86,415.1338995837106,NaN,NaN,NaN,NaN,NaN,413.00049999999993,429.72924319845697,396.2717568015429,420.8124651289005,423.84784866430437,424.3693283721505,423.3263689564582,660150,1141270.5666666667,55.50405406274124,60.36526793245345,NaN,NaN,NaN,NaN,4.5059496522028395,22.33151661018348,169555166,0.028221416498537266,4.087024278040133,4.058802861541595
2024-03-26T09:30:00-04:00,425.615,425.99,422.19,422.72,415.1338995837106,NaN,NaN,NaN,NaN,NaN,413.46149999999994,429.9642900974309,396.958709902569,420.8124651289005,423.6333333333334,423.6333333333334,423.6333333333334,785604,1093606.8666666667,55.2597906402315,60.53030580397977,NaN,NaN,NaN,NaN,4.455524677045495,21.643907644593273,168769562,-0.28216031742162073,3.7061024647645695,3.9882627821861902
2024-03-26T13:30:00-04:00,422.76,423.72,421.38,421.9,415.1338995837106,NaN,NaN,NaN,NaN,NaN,413.8412999999999,430.228948374313,397.45365162568675,420.8124651289005,423.05893766897617,423.70452576096494,422.4133495769874,621892,1074097.8,53.76726373778496,60.41895067584725,NaN,NaN,NaN,NaN,4.3044157715422475,20.80178928561032,168147670,-0.5506009798856497,3.300011557329128,3.850612537214778
2024-03-27T09:30:00-04:00,424.17,424.45,419.28,419.98,415.1338995837106,NaN,NaN,NaN,NaN,NaN,414.26009999999985,430.17681630582433,398.3433836941754,420.8124651289005,421.2366666666667,421.2366666666667,421.2366666666667,918632,1047684.6333333333,50.33888654352796,59.90755577383645,NaN,NaN,NaN,NaN,4.366243216432088,19.50223138975235,167229038,-0.8476261873821431,2.791079802987099,3.638705990369242
2024-03-27T13:30:00-04:00,420.01,422.05,419.01,421.49,415.1338995837106,NaN,NaN,NaN,NaN,NaN,414.6459,430.30771747945215,398.9840825205478,420.8124651289005,421.06244814363356,421.2548342184769,420.8700620687902,753326,1039835.2333333333,52.883401421328735,59.69629744232375,NaN,NaN,NaN,NaN,4.271511558115511,18.229165777025155,167982364,-0.9261705833097347,2.4809927612320735,3.407163344541808
2024-03-28T09:30:00-04:00,421.09,421.76,419.09,420.06,415.1338995837106,NaN,NaN,NaN,NaN,NaN,414.8430999999999,430.5243209843531,399.16187901564666,420.8124651289005,420.3033333333333,420.3033333333333,420.3033333333333,899191,1025772.5,50.25718521780885,59.047508887587874,NaN,NaN,NaN,NaN,4.157117875392976,17.0470334223499,167083173,-1.0491710137191212,2.0956995773929066,3.144870591112028
2024-03-28T13:30:00-04:00,420.05,421.89,419.91,420.03,415.1338995837106,NaN,NaN,NaN,NaN,NaN,415.01149999999984,430.73102088965663,399.29197911034305,420.8124651289005,420.442924514717,420.59564080171555,420.29020822771844,751272,1026947.4,50.20086138955769,58.34750750350056,NaN,NaN,NaN,NaN,4.001609455722046,15.984653738351055,166331901,-1.1018517371641479,1.7675559196568429,2.8694076568209907
2024-04-01T09:30:00-04:00,424.02,427.86,422.49,422.965,415.1338995837106,NaN,NaN,NaN,NaN,NaN,415.26799999999986,431.0794610330696,399.4565389669301,420.8124651289005,424.43833333333333,424.43833333333333,424.43833333333333,1007987,1015430.4,55.46001228220712,57.96527309254884,NaN,NaN,NaN,NaN,4.275065923170474,16.3898000796196,167339888,-0.9159651038191736,1.7244512770470237,2.6404163808661973
2024-04-01T13:30:00-04:00,423,425.2,422.21,424.64,415.1338995837106,NaN,NaN,NaN,NaN,NaN,415.5543999999999,431.51504956573314,399.5937504342666,417.55507014848024,424.28355812245917,424.48680226456946,424.0803139803489,584550,1013573.1666666666,58.17472569023825,57.56289346237505,NaN,NaN,NaN,NaN,4.18327550008687,16.679464893564475,167924438,-0.6686161441969363,1.8046462006200272,2.4732623448169635
2024-04-02T09:30:00-04:00,420.1,422.08,417.83,421.95,415.1338995837106,NaN,NaN,NaN,NaN,NaN,415.81579999999997,431.7587451934018,399.8728548065981,417.55507014848024,420.61999999999995,420.6200053947966,420.6199946052033,971640,1011901.6333333333,52.6271192361143,56.50770716435193,NaN,NaN,NaN,NaN,4.370898678652094,15.712421102633334,166952798,-0.6727504214997944,1.6323243179422207,2.305074739442015
2024-04-02T13:30:00-04:00,422,422.38,420.99,421.46,415.1338995837106,NaN,NaN,NaN,NaN,NaN,416.0952,431.9340221733718,400.2563778266282,417.55507014848024,420.971629421001,421.4454119418393,420.4978469001627,535202,1006955.2,51.66071200372881,55.366646442703264,NaN,NaN,NaN,NaN,4.157977344462657,14.887000639105525,166417596,-0.6923605993267148,1.4396239902836214,2.131984589610336
2024-04-03T09:30:00-04:00,419.73,423.26,419.07,422.35,415.1338995837106,NaN,NaN,NaN,NaN,NaN,416.45079999999996,432.0349543062098,400.86664569379013,417.55507014848024,421.55999999999995,421.55999999999995,421.55999999999995,1015502,994724.9666666667,53.336825653335644,54.46759021789256,NaN,NaN,NaN,NaN,4.160264677001039,14.028206412591695,167433098,-0.6309963679337183,1.3432391296931883,1.9742354976269065
2024-04-03T13:30:00-04:00,422.35,423,419.81,420.49,415.1338995837106,NaN,NaN,NaN,NaN,NaN,416.7113999999999,432.12025031921416,401.30254968078566,417.55507014848024,421.3893037289903,421.6115267424917,421.16708071548885,599171,988235.7666666667,49.47579197917203,53.27881927442775,NaN,NaN,NaN,NaN,4.09096005721525,13.230754630828853,166833927,-0.6961561671245247,1.1040402887212508,1.8001964558457755
2024-04-04T09:30:00-04:00,424.99,428.67,423.32,427.71,415.1338995837106,NaN,NaN,NaN,NaN,NaN,417.12179999999995,432.5873723153024,401.6562276846975,417.55507014848024,426.56666666666666,426.56666666666666,426.56666666666666,873205,978100.9666666667,61.21314003578553,53.58284070668305,NaN,NaN,NaN,NaN,4.383034338842733,13.45916471489598,167707132,-0.25615192497521977,1.4800065496267507,1.7361584746019705
2024-04-04T13:30:00-04:00,427.705,427.84,417.57,418,415.1338995837106,NaN,NaN,NaN,NaN,NaN,417.3269999999999,432.55971952082064,402.09428047917913,417.55507014848024,423.60280604674887,426.3063765362725,420.8992355572252,1049437,994868.9333333333,45.80234888375233,52.8898617653267,NaN,NaN,NaN,NaN,4.80353188606825,12.738164446578923,166657695,-0.6024356241955209,0.9831139443575694,1.5855495685530903
2024-04-05T09:30:00-04:00,419.755,426.49,418.35,425.65,415.1338995837106,NaN,NaN,NaN,NaN,NaN,417.65359999999987,432.8858649714377,402.42133502856205,417.55507014848024,423.49666666666667,423.49666666666667,423.49666666666667,1199967,930791.8,55.34152838873931,52.8957001759344,NaN,NaN,NaN,NaN,5.066851037063377,12.06866419742737,167857662,-0.3141488918953421,1.1928634536839127,1.5070123455792548
2024-04-05T13:30:00-04:00,425.65,426.51,423.37,425.55,415.1338995837106,NaN,NaN,NaN,NaN,NaN,417.8963999999999,433.236989563636,402.55581043636386,417.55507014848024,424.10509088023946,424.89988132307025,423.31030043740867,703197,908910.0333333333,55.20474598848919,52.99837747955614,NaN,NaN,NaN,NaN,4.929218820130278,11.441925439369125,167154465,-0.1371090593852382,1.3356260213477071,1.4727350807329453
2024-04-08T09:30:00-04:00,424.935,427.29,423.28,424.64,415.1338995837106,NaN,NaN,NaN,NaN,NaN,418.0909999999999,433.52171015864366,402.66028984135613,417.0214148690032,425.07,425.07,425.07,763798,865844.7,53.89921381917907,53.25268657067407,NaN,NaN,NaN,NaN,4.8635603329781185,10.653523139351199,166390667,-0.09045715742918192,1.359663633946468,1.45012079137565
2024-04-08T13:30:00-04:00,424.64,426.23,423.63,424.6,415.1338995837106,NaN,NaN,NaN,NaN,NaN,418.27319999999986,433.7916464119373,402.75475358806244,417.0214148690032,424.9808295101657,425.1005844524068,424.86107456792456,423481,851345.2666666667,53.838942462862704,53.320939502212205,NaN,NaN,NaN,NaN,4.701877452051112,9.921435289334553,165967186,-0.07224791641884609,1.3598108958520925,1.4320588122709386
2024-04-09T09:30:00-04:00,426.43,427.74,421.61,424.34,415.1338995837106,NaN,NaN,NaN,NaN,NaN,418.4477999999999,434.0387368749934,402.85686312500644,417.0214148690032,424.56333333333333,424.56333333333333,424.56333333333333,935692,838799.6666666666,53.420787877865415,53.546911120787684,NaN,NaN,NaN,NaN,4.803886205476032,9.793109208452622,165031494,-0.08669576119062894,1.3236891107826523,1.4103848719732812
2024-04-09T13:30:00-04:00,424.34,426.49,422.48,426.24,415.1338995837106,NaN,NaN,NaN,NaN,NaN,418.6753999999999,434.3820161651696,402.9687838348302,417.0214148690032,424.76096711685784,425.00810136773936,424.5138328659763,598397,834919.7666666667,56.103855716651985,53.968553572722996,NaN,NaN,NaN,NaN,4.747180047942029,9.673949276205116,165629891,0.01718869626180064,1.4318707423005321,1.4146820460387315
2024-04-10T09:30:00-04:00,422.21,424,419.7,421.79,415.1338995837106,NaN,NaN,NaN,NaN,NaN,419.05939999999987,434.09884209603604,404.0199579039637,417.0214148690032,421.83,421.83,421.83,1287388,834360.6666666666,48.98666673332089,53.50617174780255,NaN,NaN,NaN,NaN,4.875238615946172,10.285871262643482,164342503,-0.2154855884077027,1.1453250605291032,1.360810648936806
2024-04-10T13:30:00-04:00,421.76,423.79,420.22,423.2,415.1338995837106,NaN,NaN,NaN,NaN,NaN,419.4671999999999,433.8118066742901,405.12259332570966,417.0214148690032,422.03191374969157,422.305765389942,421.75806210944114,699859,831172.8333333334,51.103269664527886,53.0010677459661,NaN,NaN,NaN,NaN,4.782007286235731,10.854084535764823,165042362,-0.27244855671882573,1.0202499530382738,1.2926985097570995
2024-04-11T09:30:00-04:00,426.015,427.5,422.37,427.16,415.1338995837106,NaN,NaN,NaN,NaN,NaN,419.92469999999986,433.7531096569409,406.0962903430588,415.19922225896244,425.6766666666667,425.6766666666667,425.6766666666667,1180074,845648.6,56.555244086859545,53.281648092447895,NaN,NaN,NaN,NaN,4.806863908647464,10.15198533335985,166222436,-0.05293697499811101,1.226527291009461,1.279464266007572
2024-04-11T13:30:00-04:00,427.18,429.37,426.94,427.94,415.1338995837106,NaN,NaN,NaN,NaN,NaN,420.43749999999994,433.493619523036,407.3813804769639,418.31437780716993,426.6592573209641,427.84217058100245,425.4763440609258,814233,838442.6,57.55903518217195,53.702956890908126,NaN,NaN,NaN,NaN,4.6370879151726445,9.882199658786659,167036669,0.12553682177479608,1.436385293226067,1.310848471451271
2024-04-12T09:30:00-04:00,424.05,425.15,419.78,420.09,415.1338995837106,NaN,NaN,NaN,NaN,NaN,420.6678999999999,433.2771258430042,408.0586741569956,418.31437780716993,421.67333333333335,421.67333333333335,421.67333333333335,1364477,839182.3333333334,46.03183145091986,53.18117159073557,NaN,NaN,NaN,NaN,4.888724492660314,10.483492070503262,165672192,-0.2820995239211286,0.9582240665498603,1.2403235904709888
2024-04-12T13:30:00-04:00,420.06,422.27,419.78,422.11,415.1338995837106,NaN,NaN,NaN,NaN,NaN,420.9285,433.09998080554357,408.7570191944564,418.31437780716993,421.58249883096505,421.71587168116673,421.44912598076337,632897,838358.2333333333,48.869470486227065,53.137862912668076,NaN,NaN,NaN,NaN,4.717387028898863,11.04183502424011,166305089,-0.40520607748934134,0.733815993609312,1.1390220710986534
2024-04-15T09:30:00-04:00,426.6,426.8,416.1,416.14,415.1338995837106,NaN,NaN,NaN,NaN,NaN,421.1535,432.52003619180806,409.78696380819196,418.31437780716993,419.68,419.68,419.68,1226434,847704.4333333333,41.86357813447396,51.755751348288676,NaN,NaN,NaN,NaN,5.144716526834658,10.33123870710176,165078655,-0.8525010079358498,0.07339581117884109,0.9258968191146909
2024-04-15T13:30:00-04:00,416.2,416.21,413.43,413.58,NaN,NaN,NaN,429.41781077936383,429.41781077936383,429.41781077936383,421.3003,432.06633815893116,410.5342618410688,418.31437780716993,417.45784006921923,420.061720880055,414.85395925838344,893208,859660.0333333333,39.264180711762684,51.288739336003694,NaN,NaN,NaN,NaN,4.975808203489324,10.268514005546026,164185447,-1.2599817372047541,-0.6490803523912518,0.6109013848135023
2024-04-16T09:30:00-04:00,414.77,417.65,413.73,416.14,NaN,NaN,NaN,429.41781077936383,NaN,NaN,421.5331,431.2922538342,411.7739461658,418.31437780716993,415.84,415.84,415.84,1098758,861620.7,43.07093686893993,50.41226851316088,NaN,NaN,NaN,NaN,4.911107617525801,9.844435760111422,165284205,-1.2915286913528918,-1.0035094793776125,0.28801921197527935
2024-04-16T13:30:00-04:00,416.28,418.39,414.22,414.56,NaN,NaN,NaN,429.41781077936383,NaN,NaN,421.73369999999994,430.44240939001696,413.0249906099829,418.31437780716993,415.7957927342251,415.85238983625106,415.7391956321991,670349,861960.6666666666,41.34839180465797,49.422528928601515,NaN,NaN,NaN,NaN,4.858171359131098,9.262534677827073,164613856,-1.347055367905623,-1.3957999979067495,-0.04874463000112644
2024-04-17T09:30:00-04:00,417.41,418.87,410.33,412.99,NaN,NaN,NaN,429.41781077936383,NaN,NaN,421.7207,430.47949489652945,412.9619051034706,418.31437780716993,414.06333333333333,414.06333333333333,414.06333333333333,1154302,874250.6,39.65142883861487,48.404830001418354,NaN,NaN,NaN,NaN,5.121159119193164,9.600134691045879,163459554,-1.4109928814558752,-1.8124857318209706,-0.4014928503650953
2024-04-17T13:30:00-04:00,412.98,414.5,411.3,411.86,NaN,NaN,NaN,427.56800486724546,NaN,NaN,421.6527,430.66033081168877,412.6450691883112,418.31437780716993,413.57378636165026,414.2805817278983,412.8669909954022,553759,871979.5,38.428965319935095,47.3041173483521,NaN,NaN,NaN,NaN,4.983933467822223,9.913620417606198,162905795,-1.4455547243079931,-2.2084362557500867,-0.7628815314420936
2024-04-18T09:30:00-04:00,410.635,411.89,406.37,407.62,NaN,NaN,NaN,423.88400464600704,NaN,NaN,421.49629999999996,431.17643900932046,411.81616099067946,418.31437780716993,408.6266666666667,408.6266666666667,408.6266666666667,1483756,890816.9666666667,34.17183048536515,45.92919182031636,NaN,NaN,NaN,NaN,5.022223934406349,11.158499600853391,161422039,-1.655070899805364,-2.8317201561987986,-1.1766492563934345
2024-04-18T13:30:00-04:00,407.62,407.74,404.02,404.15,NaN,NaN,NaN,420.47064079846126,NaN,NaN,421.2753,431.97155100862426,410.57904899137577,412.2255022457359,407.21097520125085,408.85433526876227,405.5676151337394,1101119,902410.0666666667,31.132225276130228,44.145503931707665,NaN,NaN,NaN,NaN,4.9292079390916115,12.69753469649862,160320920,-1.9103500349408458,-3.564586800069492,-1.654236765128646
2024-04-19T09:30:00-04:00,404.07,405.43,398.07,399.18,NaN,NaN,NaN,416.681066216713,NaN,NaN,420.7821,433.10958021127664,408.4546197887234,412.182321437271,400.8933333333334,400.8933333333334,400.8933333333334,1473563,921555.8,27.37616050676607,42.60189634409661,NaN,NaN,NaN,NaN,5.102835943442211,14.931979434153705,158847357,-2.272302774081844,-4.4946152327309505,-2.2223124586491068
2024-04-19T13:30:00-04:00,399.17,402.14,397.77,399.15,NaN,NaN,NaN,414.8032904795897,NaN,NaN,420.25589999999994,433.91402661970113,406.59777338029875,412.182321437271,400.35178522484404,400.95194661740817,399.7516238322799,1199794,936506.5333333333,27.354706692322452,40.9055704175105,NaN,NaN,NaN,NaN,5.0504905189106255,17.042895256651942,157647563,-2.3617040039970276,-5.174442463645391,-2.8127384596483638
2024-04-22T09:30:00-04:00,400.2,402.5,395.75,399.92,NaN,NaN,NaN,414.21882273051745,NaN,NaN,419.9721,434.67871049866864,405.2654895013314,406.30314857588274,399.39000000000004,399.39000000000004,399.39000000000004,1119915,940237.4666666667,28.894940457526232,38.92983444398669,NaN,NaN,NaN,NaN,5.171884053274153,19.24635143384993,158767478,-2.21915173572615,-5.586678129306051,-3.3675263935799014
2024-04-22T13:30:00-04:00,399.94,402.84,399.82,401.05,NaN,NaN,NaN,414.21882273051745,NaN,NaN,419.6646999999999,435.2704902600203,404.0589097399795,406.30314857588274,400.02602736243125,400.9035236436549,399.1485310812076,588364,940364.6,31.20029710890637,37.04706743875344,NaN,NaN,NaN,NaN,5.0181780494688555,21.176214976844427,159355842,-1.9106560792691707,-5.755846492666365,-3.845190413397194
2024-04-23T09:30:00-04:00,404.235,408.2,403.07,407,NaN,NaN,NaN,414.21882273051745,NaN,NaN,419.43289999999996,435.43492913257444,403.4308708674255,406.30314857588274,406.09,406.09,406.09,937003,939210.0333333333,41.88472185589937,36.7508453248234,NaN,NaN,NaN,NaN,5.170451045935365,21.32415265939221,160292845,-1.2023662627393463,-5.348148241821377,-4.145781979082031
2024-04-23T13:30:00-04:00,407.01,407.88,406.54,407.61,NaN,NaN,NaN,414.21882273051745,NaN,NaN,419.2378999999999,435.5704307395994,402.90536926040045,404.93051886070623,406.538779201395,407.13966784402993,405.9378905587601,522659,938791.9333333333,42.864367859583844,36.321909422920314,NaN,NaN,NaN,NaN,4.896847399797123,21.461523364615154,160815504,-0.6186688234116335,-4.919118008346572,-4.300449184934939
2024-04-24T09:30:00-04:00,409.38,412.5,406.8,408.74,NaN,NaN,NaN,414.21882273051745,NaN,NaN,418.9972999999999,435.584906603727,402.40969339627276,401.74841508856497,409.34666666666664,409.34667206146327,409.34666127187,848249,933216.8333333334,44.7232615458894,36.5261725237357,NaN,NaN,NaN,NaN,4.954215442668756,20.392457301058858,161663753,-0.10906660006500779,-4.436782435016198,-4.32771583495119
2024-04-24T13:30:00-04:00,408.76,410.15,407.55,408.84,NaN,NaN,NaN,414.21882273051745,NaN,NaN,418.74549999999994,435.55845027649406,401.9325497235058,400.4251990911881,409.18963548426484,409.421706160938,408.95756480759167,388378,926190.4,44.89412597135775,36.928311470849636,NaN,NaN,NaN,NaN,4.786057196763843,19.39975309918516,162052131,0.26189637785321196,-4.000345362634675,-4.262241740487887
2024-04-25T09:30:00-04:00,394.15,396.57,388.06,395.93,NaN,NaN,NaN,408.90772257434713,NaN,NaN,418.2198999999999,436.1713294127213,400.26847058727844,400.4251990911881,393.52,393.52,393.52,2578189,983023.2,31.399890161970987,36.09466527749471,NaN,NaN,NaN,NaN,5.928481682709282,21.14562367881822,159473942,-0.30434825075342964,-4.642677053929674,-4.338328803176244
2024-04-25T13:30:00-04:00,395.92,399.88,395.75,399.31,NaN,NaN,NaN,408.90772257434713,NaN,NaN,417.7027,436.30179322627384,399.10360677372614,400.4251990911881,394.9047921838752,397.07737616204327,392.73220820570714,1047444,982956.7666666667,36.759454890749595,35.7668840693584,NaN,NaN,NaN,NaN,5.800018705372905,22.067332025418462,160521386,-0.3880495564783315,-4.823390748774159,-4.4353411922958275
2024-04-26T09:30:00-04:00,412.2,413,405.77,409.35,391.8620234394895,391.8620234394895,391.8620234394895,NaN,NaN,NaN,417.30709999999993,435.7579813979128,398.8562186020871,400.4251990911881,409.3733333333333,409.3733333333333,409.3733333333333,2367267,1021866.7666666667,49.40445141567656,36.46352853914851,NaN,NaN,NaN,NaN,6.363588797846268,20.76724691905312,162888653,0.26099578937660617,-4.10909645557507,-4.370092244951676
2024-04-26T13:30:00-04:00,409.37,410.19,406.11,406.3,391.8620234394895,NaN,NaN,NaN,NaN,NaN,416.8450999999999,435.21830576165473,398.47189423834504,400.4251990911881,408.8789714204744,409.6945891120444,408.06335372890436,869689,1027416.5,46.37110923564968,37.030824533128126,NaN,NaN,NaN,NaN,6.200475312285819,19.560025034571023,162018964,0.49932042968255086,-3.7459417078484876,-4.245262137531038
2024-04-29T09:30:00-04:00,405.81,406.32,399.19,401,391.8620234394895,NaN,NaN,NaN,NaN,NaN,416.29509999999993,434.88496632442195,397.7052336755779,400.4251990911881,402.17,402.17,402.17,1242456,1043371.7666666667,41.592208417316876,37.56085152826754,NaN,NaN,NaN,NaN,6.2668699328368325,19.270321573831627,160776508,0.3229921214239848,-3.841521985751058,-4.164514107175043
2024-04-29T13:30:00-04:00,401.02,402.28,399.2,402.17,391.8620234394895,NaN,NaN,NaN,NaN,NaN,415.76469999999995,434.42290531668874,397.10649468331115,400.4251990911881,401.8827211836474,402.3201492957703,401.4452930715245,535889,1047118.7,42.989007087382,38.40776451478552,NaN,NaN,NaN,NaN,6.039236366205629,19.001311217430754,161312397,0.3081749199763788,-3.7792954572045687,-4.0874703771809475
2024-04-30T09:30:00-04:00,401.23,402.16,394.8,395.44,391.8620234394895,NaN,NaN,NaN,NaN,NaN,415.1988999999999,434.55916604052345,395.8386339594764,400.4251990911881,397.46666666666664,397.46667429606117,397.4666590372721,1383157,1062034.2,37.44225328473854,39.12677114178355,NaN,NaN,NaN,NaN,6.134290911476656,19.246156539923373,159929240,-0.10949544366765274,-4.224339681765514,-4.114844238097861
2024-04-30T13:30:00-04:00,395.42,396.105,389.18,389.29,NaN,NaN,NaN,410.12278550617464,410.12278550617464,410.12278550617464,414.5274999999999,435.07070035923914,393.9842996407607,400.4251990911881,394.8314115502981,397.7832309815639,391.87959211903234,1102395,1078834.1333333333,33.223608051384915,39.54597838171659,NaN,NaN,NaN,NaN,6.190770132085468,20.03485874976638,158826845,-0.720507586904942,-5.015478721729039,-4.294971134824097
2024-05-01T09:30:00-04:00,393.01,395.65,390.38,394.86,NaN,NaN,NaN,410.12278550617464,NaN,NaN,413.9702999999999,435.0974548874865,392.8431451125133,399.1901592729505,393.62999999999994,393.62999999999994,393.62999999999994,1237302,1077164.6,39.83536770104041,40.32743747053903,NaN,NaN,NaN,NaN,6.202857979793646,20.76722508747774,160064147,-0.6710871432631382,-5.133830063903019,-4.462742920639881
2024-05-01T13:30:00-04:00,394.9,401.72,394.23,395.08,NaN,NaN,NaN,410.12278550617464,NaN,NaN,413.43389999999994,435.08390778659805,391.7838922134018,392.2419615477507,395.28611732398554,396.97577763431804,393.59645701365304,1188664,1093458.1,40.08769388151577,40.962251525725414,NaN,NaN,NaN,NaN,6.294796695522672,20.399257517775666,161252811,-0.5502060082680043,-5.150500430974887,-4.600294422706883
2024-05-02T09:30:00-04:00,397.51,399.91,394.65,396.98,NaN,NaN,NaN,410.12278550617464,NaN,NaN,412.9738999999999,435.0217295793471,390.9260704206527,392.2419615477507,397.18,397.18,397.18,970970,1086487.9666666666,42.33692682082509,40.99455188036296,NaN,NaN,NaN,NaN,6.220882645842485,20.057573345909457,162223781,-0.2824037791975673,-4.953299146703841,-4.670895367506274
2024-05-02T13:30:00-04:00,396.97,398.7,396.12,397.91,NaN,NaN,NaN,410.12278550617464,NaN,NaN,412.50229999999993,434.8085532227998,390.1960467772001,392.2419615477507,397.33344656618783,397.5266337532489,397.14025937912675,612581,1079766.2333333334,43.455900121977706,41.03680418481967,NaN,NaN,NaN,NaN,5.960819599710878,19.740295186319408,162836362,0.002187631368689047,-4.668160828295413,-4.670348459664102
2024-05-03T09:30:00-04:00,402.42,406.68,401.82,405.84,NaN,NaN,NaN,410.12278550617464,NaN,NaN,412.21789999999993,434.494048508205,389.94175149179483,391.5435692382006,404.78,404.78,404.78,1294271,1077426.0333333334,52.007882112136606,41.5571342252659,NaN,NaN,NaN,NaN,6.1614753425886715,18.503608588510087,164130633,0.7291020842983276,-3.758970854291192,-4.48807293858952
2024-05-03T13:30:00-04:00,405.83,407.08,405.6,406.84,NaN,NaN,NaN,410.12278550617464,NaN,NaN,411.9541,434.1662557431821,389.7419442568179,393.66439090355357,405.2781900744838,406.06050385101815,404.49587629794945,524872,1073825.2,52.973779637310926,42.13425234426255,NaN,NaN,NaN,NaN,5.827084246689478,17.41347756525185,164655505,1.2512318127796176,-2.9240331726149975,-4.175264985394615
2024-05-06T09:30:00-04:00,408.59,410.83,406.37,410.42,391.72068646887,391.72068646887,391.72068646887,NaN,NaN,NaN,411.7031999999999,433.694496984025,389.7119030159748,397.8675127228429,409.2066666666667,409.2066666666667,409.2066666666667,891508,1062661,56.359988224397156,43.91711649157871,NaN,NaN,NaN,NaN,5.729435371925943,16.938771615503455,165547013,1.7794333024206446,-1.9509733573688095,-3.730406659789454
2024-05-06T13:30:00-04:00,410.41,413.93,410.41,413.69,395.5779279930122,NaN,NaN,NaN,NaN,NaN,411.4842,433.171805341289,389.796594658711,401.8000101782743,410.38066415508104,412.0224623101523,408.73886600000975,455848,1048082.3333333334,59.24659074980624,45.52334048151132,NaN,NaN,NaN,NaN,5.5716185596455166,16.910734424195077,166002861,2.259912095206416,-0.9055165407814343,-3.1654286359878503
2024-05-07T09:30:00-04:00,414.64,414.98,411.43,412.25,396.8830221751481,NaN,NaN,NaN,NaN,NaN,411.29019999999997,432.7724242758877,389.8079757241122,403.50100814261947,412.8866666666667,412.8866666666667,412.8866666666667,862257,1040198.9666666667,57.44460722795013,46.09763732524515,NaN,NaN,NaN,NaN,5.4272172339565525,17.022260718778607,165140604,2.3795597404948348,-0.19097896036930706,-2.570538700864142
2024-05-07T13:30:00-04:00,412.25,412.45,409.09,409.32,396.8830221751481,NaN,NaN,NaN,NaN,NaN,411.0473999999999,432.33793078154184,389.756869218458,403.50100814261947,411.7754916543642,413.06170513744456,410.48927817128384,643540,1039305.3333333334,53.855338134962146,46.632225103767475,NaN,NaN,NaN,NaN,5.279558860102513,16.681736404237398,164497064,2.1662614686461614,0.13728813494356018,-2.0289733337026012
2024-05-08T09:30:00-04:00,408.07,412.24,406.73,411.01,396.8830221751481,NaN,NaN,NaN,NaN,NaN,410.8205999999999,431.8648666434303,389.7763333565695,403.50100814261947,409.99333333333334,409.99333333333334,409.99333333333334,649573,1022481.0333333333,55.57936980007385,47.63130805967869,NaN,NaN,NaN,NaN,5.296018941523762,15.933159250272919,165146637,2.0453608528001546,0.527727732297592,-1.5176331205025626
2024-05-08T13:30:00-04:00,410.99,411.97,409.86,410.5,396.8830221751481,NaN,NaN,NaN,NaN,NaN,410.6207999999999,431.4829647352269,389.7586352647729,403.50100814261947,410.23181195920415,410.5922786038947,409.8713453145136,284313,1013499.5,54.912618185401854,48.4829945666801,NaN,NaN,NaN,NaN,5.068446159986351,15.238051893020188,164862324,1.8436504562416616,0.7869299497995144,-1.0567205064421472
2024-05-09T09:30:00-04:00,410.57,412.72,409.12,412,396.8830221751481,NaN,NaN,NaN,NaN,NaN,410.30659999999995,430.59511758408206,390.01808241591783,403.50100814261947,411.28000000000003,411.28000000000003,411.28000000000003,586736,983598.8333333334,56.563115757308886,49.84877045757798,NaN,NaN,NaN,NaN,4.963557148558756,14.723158966807839,165449060,1.7259354989279814,1.1006988672178295,-0.6252366317101519
2024-05-09T13:30:00-04:00,412.01,412.59,411.3,412.36,397.0697688355599,NaN,NaN,NaN,NaN,NaN,410.19379999999995,430.3723850405677,390.0152149594322,403.9696759481735,411.60019782457545,411.9935156844395,411.2068799647114,388859,959856.8333333334,56.97023791795571,51.54495830519018,NaN,NaN,NaN,NaN,4.701160209375985,14.245044106753513,165837919,1.590352175372982,1.3627035875060756,-0.22764858786690634
2024-05-10T09:30:00-04:00,412.96,415.37,411.8,414.01,398.89909752485266,NaN,NaN,NaN,NaN,NaN,409.96100000000007,429.68438845125814,390.237611548742,406.68874075853887,413.7266666666667,413.7266666666667,413.7266666666667,720039,934739.3666666667,58.87289425483276,52.904781630461066,NaN,NaN,NaN,NaN,4.620363051563414,14.308877702945571,166557958,1.5293768599091526,1.6840724870195345,0.15469562711038187
2024-05-10T13:30:00-04:00,414.03,415.13,413.64,414.64,400.1634567282684,NaN,NaN,NaN,NaN,NaN,409.7428,429.00757865534274,390.47802134465724,407.4399926068311,413.9793607918738,414.3314710664288,413.62725051731877,370842,907107.6333333333,59.60729919293656,54.299039152705404,NaN,NaN,NaN,NaN,4.396765690737457,14.368151756552486,166928800,1.4497810489943075,1.9669219383532663,0.5171408893589589
2024-05-13T09:30:00-04:00,418.01,418.18,410.83,414.81,400.1634567282684,NaN,NaN,NaN,NaN,NaN,409.54619999999994,428.3949953524734,390.69740464752647,408.35299408546484,414.6066666666666,414.60667206146326,414.60666127187,869463,898759.2333333333,59.81582296591483,55.547531734497525,NaN,NaN,NaN,NaN,4.607710998541926,14.965984165298693,167798263,1.3300263465762985,2.179673822579332,0.8496474760030335
2024-05-13T13:30:00-04:00,414.86,415.26,413.38,413.75,400.1634567282684,NaN,NaN,NaN,NaN,NaN,409.32919999999996,427.7241214034627,390.93427859653724,408.35299408546484,414.4789958005377,414.69008013473086,414.2679114663445,318070,889749.4333333333,57.81176384702715,56.57295057200106,NaN,NaN,NaN,NaN,4.412874498646073,15.521114259134455,167480193,1.109851442780935,2.236961779479202,1.127110336698267
2024-05-14T09:30:00-04:00,412,415.57,411.55,413.3,400.1634567282684,NaN,NaN,NaN,NaN,NaN,409.10839999999996,427.0364108701297,391.1803891298702,408.35299408546484,413.47333333333336,413.47333333333336,413.47333333333336,631837,879577.2333333333,56.9395958263911,56.925215837304954,NaN,NaN,NaN,NaN,4.384812034457067,15.522346310823718,166848356,0.8746762334943798,2.220455628566242,1.3457793950718622
2024-05-14T13:30:00-04:00,413.35,417.49,413.28,416.42,401.37551308385,NaN,NaN,NaN,NaN,NaN,408.912,426.29177859466006,391.5322214053399,408.35299408546484,414.45875335083196,415.5779994789469,413.33950722271703,489775,878481.1,61.29905190651968,57.519878142248444,NaN,NaN,NaN,NaN,4.372325460567279,15.898478228973275,167338131,0.8682628921736604,2.4311080102889377,1.5628451181152774
2024-05-15T09:30:00-04:00,417.7,422.6,417.25,422.58,405.70958067094773,NaN,NaN,NaN,NaN,NaN,408.9278,426.3557491805329,391.4998508194671,412.0331783774064,420.81,420.81,420.81,1141047,888241.0333333333,68.15420426284248,58.362322144994536,NaN,NaN,NaN,NaN,4.50144507052676,17.103304156264347,168479178,1.1975960070325864,3.0598401269060105,1.862244119873424
2024-05-15T13:30:00-04:00,422.6,423.81,422.24,423.16,409.24164518590464,NaN,NaN,NaN,NaN,NaN,408.927,426.35233201976814,391.5016679802319,414.5715427019251,421.6219334087287,422.70624592989356,420.53762088756383,639787,896621.3333333334,68.71609062457081,59.03871499319201,NaN,NaN,NaN,NaN,4.292056136917705,18.40037753804144,169118965,1.3612721824057186,3.5638343478805723,2.2025621654748537
2024-05-16T09:30:00-04:00,421.8,425.45,421.66,421.92,409.8813431319999,NaN,NaN,NaN,NaN,NaN,408.8222,425.8665047567007,391.7778952432993,416.1642341615401,423.00999999999993,423.01000762939447,423.0099923706054,736041,835216.4,66.03359096250293,59.652213831374354,NaN,NaN,NaN,NaN,4.256194984280723,19.842518664651756,168382924,1.2932868590333597,3.8191707392665535,2.5258838802331938
2024-05-16T13:30:00-04:00,421.95,422.42,420.35,420.91,409.8813431319999,NaN,NaN,NaN,NaN,NaN,408.68159999999995,425.2006563216966,392.1625436783033,416.1642341615401,422.30364439124037,423.1758423368294,421.4314464456513,482746,816393.1333333333,63.84729911908705,60.36592533024042,NaN,NaN,NaN,NaN,4.1000381996892425,20.76241884832725,167900178,1.0953948995892584,3.895127504719767,2.7997326051305085
2024-05-17T09:30:00-04:00,422.54,422.84,418.02,419.08,409.8813431319999,NaN,NaN,NaN,NaN,NaN,408.6614,425.1269883635926,392.1958116364074,416.1642341615401,419.97999999999996,419.97999999999996,419.97999999999996,599358,757462.8333333334,59.972830354541166,60.6797439412738,NaN,NaN,NaN,NaN,4.151464042568582,20.90530587847325,167300820,0.7716266899978845,3.764265967627864,2.9926392776299795
2024-05-17T13:30:00-04:00,419.22,420.41,418.12,420.33,409.8813431319999,NaN,NaN,NaN,NaN,NaN,408.6258,424.9822617640605,392.26933823593953,416.1642341615401,419.84307803170884,420.0178472601724,419.6683088032453,367877,740735.7666666667,61.68324709556129,61.163360291999474,NaN,NaN,NaN,NaN,4.018502325242257,21.03798669218025,167668697,0.5807338612387274,3.7185566041783886,3.1378227429396612
2024-05-20T09:30:00-04:00,420.07,426.77,419.99,424.7,409.96102592315447,NaN,NaN,NaN,NaN,NaN,408.797,425.6365350291883,391.95746497081177,416.5882303125668,423.82,423.82,423.82,726510,723537.5666666667,66.99336763899134,61.90837828354821,NaN,NaN,NaN,NaN,4.2157521591535225,22.220098298579064,168395207,0.6809191656512104,3.988971700003674,3.3080525343524636
2024-05-20T13:30:00-04:00,424.67,425.51,423.82,425.44,411.62552474482925,NaN,NaN,NaN,NaN,NaN,409.0342,426.46044094402794,391.60795905597206,416.5882303125668,424.163271301982,424.67406233859424,423.6524802653697,328118,716611.8666666667,67.80697055158505,62.68243061452175,NaN,NaN,NaN,NaN,4.035341290642557,23.317773361663676,168723325,0.7250846534370616,4.214408351148791,3.489323697711729
2024-05-21T09:30:00-04:00,426.96,432.96,424.85,430.3,415.35231907460974,NaN,NaN,NaN,NaN,NaN,409.31739999999996,427.6338519751872,391.0009480248127,421.7126674000428,429.36999999999995,429.36999999999995,429.36999999999995,1261915,712570.4666666667,72.58631123713623,63.66196039897199,NaN,NaN,NaN,NaN,4.326388341310943,25.259066242001317,169985240,0.9930989379298665,4.730697370124062,3.7375984321941957
2024-05-21T13:30:00-04:00,430.3,430.92,428.71,429.05,416.57698638940025,NaN,NaN,NaN,NaN,NaN,409.60720000000003,428.6888070769542,390.52559292304585,421.7126674000428,429.4236633295727,429.5091985838239,429.33812807532155,496701,692380.6666666666,69.71937486755876,64.38425151858787,NaN,NaN,NaN,NaN,4.175217745503021,27.061695345171984,169488539,0.995178160572284,4.981571132909551,3.9863929723372666
2024-05-22T09:30:00-04:00,430.01,432.41,429.41,430.58,417.8155324626093,NaN,NaN,NaN,NaN,NaN,409.959,429.9060768785641,390.0119231214359,422.6477071360274,430.8,430.8,430.8,723682,675260,71.21786023502834,65.19868275209598,NaN,NaN,NaN,NaN,4.116987906538521,28.89743330831801,170212221,1.005610335259795,5.24340589141201,4.237795556152215
2024-05-22T13:30:00-04:00,430.57,430.64,427.13,430.53,417.8155324626093,NaN,NaN,NaN,NaN,NaN,410.33240000000006,431.09034654967303,389.5744534503271,422.6477071360274,430.26752379980417,430.933997032427,429.60105056718135,461937,651035.7666666667,71.09404213548397,66.14741691555717,NaN,NaN,NaN,NaN,4.073631627500054,29.83665542800252,169750284,0.9176072084301206,5.384804566689866,4.467197358259745
2024-05-23T09:30:00-04:00,433.125,433.58,429.61,430.1,418.6656401157246,NaN,NaN,NaN,NaN,NaN,410.78200000000004,432.24722434075807,389.316775659242,423.94313256705755,431.09666666666664,431.09666666666664,431.09666666666664,855079,647172.7333333333,69.96743039719243,67.07797652775727,NaN,NaN,NaN,NaN,4.066229368392905,31.076222126777324,168895205,0.7461778862532764,5.39991971607634,4.653741829823064
2024-05-23T13:30:00-04:00,430.12,430.12,425.45,427.15,418.6656401157246,NaN,NaN,NaN,NaN,NaN,411.24200000000013,433.10117875856184,389.3828212414384,423.94313256705755,429.83195524981403,431.5220750455893,428.14183545403876,478800,642713.3666666667,62.634267821220426,67.17334909309304,NaN,NaN,NaN,NaN,4.109355842079127,30.97464247956539,168416405,0.3689240462493091,5.1148968876347,4.745972841385391
2024-05-24T09:30:00-04:00,427.16,430.48,424.41,430.27,418.6656401157246,NaN,NaN,NaN,NaN,NaN,411.86380000000014,434.080977818952,389.64662218104826,423.94313256705755,428.3866666666667,428.3866666666667,428.3866666666667,743537,624355.5666666667,66.61910537972776,67.06369917287056,NaN,NaN,NaN,NaN,4.249401853359189,30.5924902335659,169159942,0.2689720224763539,5.082187869480833,4.8132158470044795
2024-05-24T13:30:00-04:00,430.25,431.05,429.16,430.15,418.6656401157246,NaN,NaN,NaN,NaN,NaN,412.48380000000014,434.9756861423112,389.9919138576891,423.94313256705755,428.99178775188153,429.8180474083757,428.16552809538734,398799,620153.1333333333,66.32612866152405,66.89298760408151,NaN,NaN,NaN,NaN,4.080873149547818,30.333333838300142,168761143,0.14068478272128537,4.989071825406086,4.8483870426848
2024-05-28T09:30:00-04:00,429.64,430.82,426.6,429.06,418.6656401157246,NaN,NaN,NaN,NaN,NaN,413.0666000000001,435.7355220246327,390.3976779753675,423.94313256705755,428.82666666666665,428.82666666666665,428.82666666666665,772884,616199,63.59050396528972,66.71848138999484,NaN,NaN,NaN,NaN,4.090810781722972,29.365864072326804,167988259,-0.0608611753550079,4.7723105734910405,4.833171748846048
2024-05-28T13:30:00-04:00,429.02,430.46,427.9,430.29,418.6656401157246,NaN,NaN,NaN,NaN,NaN,413.65140000000014,436.55755219016254,390.74524780983774,423.94313256705755,429.09998099472983,429.4506897657631,428.74927222369655,469403,616650.8333333334,65.32834381243313,66.8242702966624,NaN,NaN,NaN,NaN,3.9814671544570457,28.467499289637278,168457662,-0.149563211669971,4.646217734258585,4.795780945928556
2024-05-29T09:30:00-04:00,425.69,430.9,425.68,430.16,418.6656401157246,NaN,NaN,NaN,NaN,NaN,414.1146000000001,437.39757685775913,390.8316231422411,423.94313256705755,428.91333333333336,428.91333333333336,428.91333333333336,763891,613371.9666666667,64.9753503699472,67.1815931549057,NaN,NaN,NaN,NaN,4.06993378628154,27.01105376073267,167693771,-0.2493380946373005,4.48410832763193,4.73344642226923
2024-05-29T13:30:00-04:00,430.16,430.56,428.58,429.39,418.6656401157246,NaN,NaN,NaN,NaN,NaN,414.55020000000013,438.1430011020056,390.95739889799466,423.94313256705755,429.1323128696452,429.4198989482948,428.8447267909956,442897,606683.8666666667,62.81049319562583,67.26211073348172,NaN,NaN,NaN,NaN,3.9206528015471456,25.658640055321246,167250874,-0.3910978720240381,4.244574082239183,4.635671954263221
2024-05-30T09:30:00-04:00,424.335,424.42,417.6,419.55,NaN,NaN,NaN,434.5070786533706,434.5070786533706,434.5070786533706,414.76640000000015,438.34037845419573,391.19242154580456,423.94313256705755,420.52333333333326,420.5233387281299,420.5233279385366,1830599,646051.4,43.064185087228594,65.55288340835583,NaN,NaN,NaN,NaN,4.482749030008061,25.56221413480254,165420275,-1.1296765057376925,3.2235763220911053,4.353252827828798
2024-05-30T13:30:00-04:00,419.56,419.67,414.24,414.64,NaN,NaN,NaN,430.579029623672,NaN,NaN,414.88240000000013,438.39559070136806,391.3692092986322,423.94313256705755,418.9069851208413,421.0051675957918,416.80880264589075,1086367,672786.5333333333,36.84046703570533,63.3409903000787,NaN,NaN,NaN,NaN,4.550409813578915,25.95859307055092,164333908,-1.886416279984099,1.995232477848674,3.881648757832773
2024-05-31T09:30:00-04:00,416.9,416.97,404.51,406.63,NaN,NaN,NaN,425.4438464589596,NaN,NaN,415.0964000000002,438.1050862762477,392.0877137237527,421.567795378927,409.37000000000006,409.37000000000006,409.37000000000006,2238856,727857.2,29.3806142781322,60.254869088721264,NaN,NaN,NaN,NaN,5.115380541180423,27.40390268554907,162095052,-2.8084047894073327,0.3711427710736075,3.1795475604809402
2024-05-31T13:30:00-04:00,406.62,415.75,405.21,415.3,NaN,NaN,NaN,425.4438464589596,NaN,NaN,415.4162000000002,437.9784923976875,392.85390760231286,421.567795378927,410.5003975140852,411.839469844752,409.1613251834184,1595440,768076.5666666667,42.86619219208111,58.33678461190143,NaN,NaN,NaN,NaN,5.5028533596675375,28.745975899475923,163690492,-2.7147562883861034,-0.21389780000168912,2.5008584883844143
2024-06-03T09:30:00-04:00,415.52,416.43,408.93,410.95,NaN,NaN,NaN,425.4438464589596,NaN,NaN,415.44820000000016,437.9805055863975,392.9158944136028,421.567795378927,412.1033333333333,412.1033333333333,412.1033333333333,1227634,784996.4,38.856892374225474,56.025286907558375,NaN,NaN,NaN,NaN,5.645506691119857,29.81012430444955,162462858,-2.8141538987333017,-1.016833885032213,1.7973200137010887
2024-06-03T13:30:00-04:00,410.92,413.73,410.64,413.64,NaN,NaN,NaN,425.4438464589596,NaN,NaN,415.59500000000014,437.9821614100329,393.20783858996737,421.567795378927,412.2842037742992,412.5483611770978,412.02004637150065,575544,791819.8,42.44203754114976,53.978715150820214,NaN,NaN,NaN,NaN,5.462970498897012,30.798262109067903,163038402,-2.5736481055240286,-1.419740118203947,1.1539079873200815
2024-06-04T09:30:00-04:00,412.43,413.56,409.7,413.56,NaN,NaN,NaN,425.4438464589596,NaN,NaN,415.8462000000002,437.8512622866362,393.84113771336416,421.567795378927,412.27333333333337,412.27333333333337,412.27333333333337,688944,785802.5,42.36248335469429,52.0069332192132,NaN,NaN,NaN,NaN,5.354186891832939,31.82527708742474,162349458,-2.3036142192326903,-1.7256097867207814,0.5780044325119089
2024-06-04T13:30:00-04:00,413.495,416.44,412.94,416.06,NaN,NaN,NaN,425.4438464589596,NaN,NaN,416.12400000000014,437.7793609066895,394.4686390933108,421.567795378927,413.4423952733689,414.85391885495386,412.03087169178394,472588,790953.1,45.78259472314423,50.80324228363633,NaN,NaN,NaN,NaN,5.2217449709877295,31.925164899406283,162822046,-1.8593283433525172,-1.7461559966787377,0.11317234667377957
2024-06-05T09:30:00-04:00,417.94,423.34,416.3,422.87,NaN,NaN,NaN,425.4438464589596,NaN,NaN,416.67260000000016,437.5810973386143,395.764102661386,421.567795378927,420.83666666666664,420.83666666666664,420.83666666666664,1085242,806066.6,53.82102206639713,49.88909347554129,NaN,NaN,NaN,NaN,5.368763187345747,30.350629705239086,163907288,-1.049822979529257,-1.1991063777377917,-0.1492833982085347
2024-06-05T13:30:00-04:00,422.89,424.07,422.14,424.01,NaN,NaN,NaN,425.4438464589596,NaN,NaN,417.3670000000002,436.84927266000267,397.8847273399977,411.3312363031416,421.6440940848646,422.83705235283384,420.4511358168954,497145,806312.2666666667,55.02318540124072,49.08174038552105,NaN,NaN,NaN,NaN,5.1231372453924795,28.734948070945972,164404433,-0.41329411987475484,-0.6659010480519783,-0.2526069281772234
2024-06-06T09:30:00-04:00,423.89,425.31,420.57,423.08,NaN,NaN,NaN,425.4438464589596,NaN,NaN,417.93140000000017,436.3805361358372,399.48226386416314,412.725966307103,422.9866666666667,422.9866666666667,422.9866666666667,816038,795478.6333333333,53.79289714888992,48.38191132720677,NaN,NaN,NaN,NaN,5.095770299293017,27.520475110035886,163588395,-0.04971205976120724,-0.3147470028787325,-0.26503494311752523
2024-06-06T13:30:00-04:00,423.1,424.7,422.06,424.43,NaN,NaN,NaN,425.4438464589596,NaN,NaN,418.51840000000016,435.85610382025726,401.18069617974305,413.31277304568243,423.2545983603838,423.6114949371184,422.8977017836492,459911,789482.7666666667,55.35347109222291,47.669420418620334,NaN,NaN,NaN,NaN,4.920358135057801,26.392750217762234,164048306,0.2693502392204535,0.0716528559080416,-0.19769738331241188
2024-06-07T09:30:00-04:00,426.07,426.32,423.64,425.77,410.6553402982429,410.6553402982429,410.6553402982429,NaN,NaN,NaN,419.0942000000001,435.41487503012627,402.77352496987396,415.87021843654594,425.24333333333334,425.24333333333334,425.24333333333334,664494,787097.8666666667,56.909137631844374,47.093262365898696,NaN,NaN,NaN,NaN,4.760332553982244,24.95184357540299,164712800,0.5425305611603641,0.48046581813804323,-0.06206474302232087
2024-06-07T13:30:00-04:00,425.8,426.23,423,423.94,410.6553402982429,NaN,NaN,NaN,NaN,NaN,419.6148000000002,434.82194476286753,404.4076552371328,416.25517474923674,424.8540440217294,425.2790703476666,424.4290176957922,557448,789587.9333333333,54.134939704131966,46.47357997364914,NaN,NaN,NaN,NaN,4.651023085840657,23.75156770279079,164155352,0.5690938536934271,0.6493025740944631,0.08020872040103594
2024-06-10T09:30:00-04:00,424.89,427.84,423.95,425.72,411.8907336188535,NaN,NaN,NaN,NaN,NaN,420.0124000000001,434.7916820177059,405.23311798229435,417.91013979938936,425.83666666666664,425.83666666666664,425.83666666666664,719649,793597.6333333333,56.3631805110581,47.42350821820839,NaN,NaN,NaN,NaN,4.59737857970918,22.229492825285234,164875001,0.6687745646450562,0.9161769262073562,0.2474023615623
2024-06-10T13:30:00-04:00,425.73,428.08,425.49,427.94,413.06410936345105,NaN,NaN,NaN,NaN,NaN,420.43440000000015,434.88644548010006,405.98235451990024,418.84111183951154,426.42319880204474,427.0850317880482,425.7613658160413,565207,800175.3,59.03617643835496,49.008916032683366,NaN,NaN,NaN,NaN,4.453994395444237,20.754686148140276,165440208,0.8356139289268023,1.291919772720803,0.45630584379400063
2024-06-11T09:30:00-04:00,425.34,429.01,425.28,428.19,413.53914984693057,NaN,NaN,NaN,NaN,NaN,420.7898000000002,435.1126932775038,406.46690672249656,419.7538894716092,427.49333333333334,427.49333333333334,427.49333333333334,641823,797352.4,59.33824328585251,51.14874667609196,NaN,NaN,NaN,NaN,4.402280510055364,19.40487228657858,166082031,0.9081757099797739,1.591525481268718,0.6833497712889441
2024-06-11T13:30:00-04:00,428.2,432.82,428.2,432.66,416.89123394479736,NaN,NaN,NaN,NaN,NaN,421.1692000000001,435.72286116958037,406.61553883041984,423.10011157728735,429.4465613820818,431.3112199491015,427.58190281506216,704243,809889.9,64.39391635254361,52.686441258982136,NaN,NaN,NaN,NaN,4.418546187908552,19.062578391599256,166786274,1.1850829450222486,2.164703452566755,0.9796205075445064
2024-06-12T09:30:00-04:00,435.2,440.4,433.21,439.78,422.74981422003384,NaN,NaN,NaN,NaN,NaN,421.7198000000001,436.94941561691746,406.4901843830827,428.7540892618299,437.7966666666666,437.7966666666666,437.7966666666666,1282338,810570.6666666666,70.65303509666809,54.957594310585186,NaN,NaN,NaN,NaN,4.655792888772224,20.073180499239317,168068612,1.7419697823350277,3.157082735463291,1.4151129531282634
2024-06-12T13:30:00-04:00,439.79,443.4,437.88,441.08,426.47095902821417,NaN,NaN,NaN,NaN,NaN,422.35500000000013,438.10340499857244,406.6065950014278,431.3232714094639,439.2433738524829,440.73759365028013,437.7491540546856,1202084,834083.4333333333,71.63352340730823,57.04270044388222,NaN,NaN,NaN,NaN,4.717521968145634,21.41686047528763,169270696,2.0697603771038144,4.002313424508031,1.932553047404217
2024-06-13T09:30:00-04:00,441.05,443.39,439.32,441.2,427.2750063451135,NaN,NaN,NaN,NaN,NaN,422.9588000000001,439.2274189407402,406.69018105926,431.69361712757114,441.30333333333334,441.30333333333334,441.30333333333334,959571,841946.4,71.72742375250044,59.14019618658266,NaN,NaN,NaN,NaN,4.671270398992375,22.664563310189635,170230267,2.1567523148779366,4.628493441001638,2.471741126123701
2024-06-13T13:30:00-04:00,441.21,442.13,440.21,441.22,427.46818787488104,NaN,NaN,NaN,NaN,NaN,423.57320000000016,440.2290695671826,406.9173304328177,431.8128937020569,441.26134671637783,441.31734281073574,441.2053506220199,539490,844531.5,71.74421189517933,60.9945974131566,NaN,NaN,NaN,NaN,4.474751084778635,23.823144514027213,170769757,2.076958617194056,5.067939397616271,2.9909807804222153
2024-06-14T09:30:00-04:00,438.26,443.13,436.75,442.57,427.46818787488104,NaN,NaN,NaN,NaN,NaN,424.18460000000016,441.33329987371883,407.0359001262815,431.8128937020569,440.81666666666666,440.81666666666666,440.81666666666666,827907,843625.7666666667,72.91338923796764,62.35833792541164,NaN,NaN,NaN,NaN,4.610840293008732,23.81738489253892,171597664,1.9769535159286002,5.462172675332965,3.485219159404365
2024-06-14T13:30:00-04:00,442.61,443.01,441.35,442.5,428.6386794479805,NaN,NaN,NaN,NaN,NaN,424.78740000000005,442.34516332450505,407.22963667549504,433.02505196931645,441.37917715814825,442.093650649216,440.6647036670805,513181,844771.8,72.74530503859772,63.62420361379428,NaN,NaN,NaN,NaN,4.40006598636525,23.812036672585506,171084483,1.7743957715366498,5.703213873825177,3.9288181022885276
2024-06-17T09:30:00-04:00,442.28,447.99,440.74,447.92,430.4505576548905,NaN,NaN,NaN,NaN,NaN,425.46560000000005,443.9033986364759,407.0278013635242,436.3770415754532,445.55,445.55,445.55,1060257,855329.1333333333,77.13960130574277,65.29182533928376,NaN,NaN,NaN,NaN,4.603632701624875,24.64575016910784,172144740,1.8644931963519777,6.2594345977285,4.3949414013765224
2024-06-17T13:30:00-04:00,447.91,450.94,447.8,448.46,435.6598504887591,NaN,NaN,NaN,NaN,NaN,426.14200000000005,445.40456099274564,406.87943900725446,440.0796332603625,447.224270945233,448.9805937020337,445.46794818843233,963505,874152.6666666666,77.52834400238527,66.87574483286679,NaN,NaN,NaN,NaN,4.499087508651669,25.832073977558778,173108245,1.8176183990929458,6.666964400242705,4.849346001149759
2024-06-18T09:30:00-04:00,449.805,450.14,444.89,447.77,435.6598504887591,NaN,NaN,NaN,NaN,NaN,426.8012000000001,446.71241719632036,406.88998280367986,440.0796332603625,447.59999999999997,447.59999999999997,447.59999999999997,941639,879777.8333333334,75.7556511550075,68.22192437023558,NaN,NaN,NaN,NaN,4.55272411517655,26.058197197956208,172166606,1.6047108744662486,6.85523459423257,5.2505237197663215
2024-06-18T13:30:00-04:00,447.77,447.9,445.15,446.36,435.6598504887591,NaN,NaN,NaN,NaN,NaN,427.4534000000001,447.74458374464604,407.16221625535417,440.0796332603625,447.2107290324422,447.74770604048103,446.67375202440337,494854,880626.2,72.12636083542696,69.50702587961379,NaN,NaN,NaN,NaN,4.423958106949653,26.26816875975382,171671752,1.2492920385365656,6.812138767937029,5.562846729400463
2024-06-20T09:30:00-04:00,446.34,446.66,441.26,444.62,435.6598504887591,NaN,NaN,NaN,NaN,NaN,428.0798000000001,448.5178161424502,407.64178385754997,440.0796332603625,444.18,444.18,444.18,1201552,895214.9,67.80908891713923,70.32459076576245,NaN,NaN,NaN,NaN,4.493675385024681,25.370615867070146,170470200,0.7992742979448844,6.561939601831568,5.762665303886684
2024-06-20T13:30:00-04:00,444.67,446.04,443.78,445.81,435.6598504887591,NaN,NaN,NaN,NaN,NaN,428.6676000000001,449.4185805300614,407.91661946993884,440.0796332603625,444.5857592130602,445.08903990061935,444.0824785255011,781014,906485.4666666667,69.16832501107847,71.04831566381412,NaN,NaN,NaN,NaN,4.3341271432372075,24.53717389529245,171251214,0.4987185173614481,6.386063450588495,5.887344933227046
2024-06-21T09:30:00-04:00,447.27,450.37,446.51,448.56,435.6598504887591,NaN,NaN,NaN,NaN,NaN,429.1872000000001,450.5931606801256,407.78123931987454,440.12007502675556,448.48,448.48,448.48,1129171,883104.5333333333,72.10012478311717,71.95987862790446,NaN,NaN,NaN,NaN,4.350260918720265,24.581541471161568,172380385,0.4060171035890061,6.3948663127133045,5.988849209124298
2024-06-21T13:30:00-04:00,448.54,450.57,448.09,449.81,436.22732286456,NaN,NaN,NaN,NaN,NaN,429.7202000000001,451.8153717766355,407.62502822336467,441.13006002140446,448.8290537757172,449.3093721858545,448.34873536557996,596329,866769.9333333333,73.34104077235901,72.59895894360555,NaN,NaN,NaN,NaN,4.21667085309739,24.657808199038175,172976714,0.3518024505827597,6.428602272352748,6.076799821769988
2024-06-24T09:30:00-04:00,449.99,452.74,446.41,448.67,436.22732286456,NaN,NaN,NaN,NaN,NaN,430.25520000000006,452.85855948126095,407.65184051873916,442.0230480171236,449.2733333333333,449.27334096272784,449.2733257039388,961773,824200.5,70.27132758621413,72.57169412143028,NaN,NaN,NaN,NaN,4.3676229350190034,25.1067177925668,172014941,0.1712265298370026,6.290832984066242,6.119606454229239
2024-06-24T13:30:00-04:00,448.69,448.96,447.32,447.67,436.22732286456,NaN,NaN,NaN,NaN,NaN,430.7904000000001,453.7477845060604,407.8330154939398,442.0230480171236,448.8014689842251,449.42279743717336,448.18014053127683,554708,789509.4333333333,67.59851967184366,72.28347956889709,NaN,NaN,NaN,NaN,4.172792725374788,25.5235624151291,171460233,-0.07053988431278846,6.031431598838253,6.101971483151042
2024-06-25T09:30:00-04:00,448.055,450.3,446.77,449.54,436.22732286456,NaN,NaN,NaN,NaN,NaN,431.3996000000001,454.6957397523097,408.10346024769046,442.0230480171236,448.86999999999995,448.86999999999995,448.86999999999995,802718,775345.5666666667,69.90381873602958,72.1532220677206,NaN,NaN,NaN,NaN,4.126878959276591,26.149930126728403,172262951,-0.154668049519894,5.908636421251174,6.063304470771068
2024-06-25T13:30:00-04:00,449.52,451.42,449.34,450.83,437.8044319804935,NaN,NaN,NaN,NaN,NaN,432.0096,455.70816703177394,408.311032968226,442.95612058476723,449.4559627116922,450.24927589190025,448.6626495314842,437939,770758.7333333333,71.41472520397842,72.1296873040634,NaN,NaN,NaN,NaN,3.980673319328266,26.927928325379575,172700890,-0.17224320205795784,5.84800046819862,6.020243670256578
2024-06-26T09:30:00-04:00,448.745,453.62,448.19,451.91,438.16059416319837,NaN,NaN,NaN,NaN,NaN,432.5538,456.79931748755405,408.308282512446,444.13389646781377,451.24,451.24,451.24,754182,772933.3333333334,72.65255701815748,72.11105643121981,NaN,NaN,NaN,NaN,4.084196653661961,28.0160117097209,173455072,-0.16019202936661436,5.8200036335483105,5.980195662914925
2024-06-26T13:30:00-04:00,451.83,452.59,450.87,452.11,439.330339883053,NaN,NaN,NaN,NaN,NaN,433.0872,457.8511690001293,408.3232309998707,444.141117174251,451.4396969039494,451.7282581118518,451.15113569604705,361196,769220.2666666667,72.88670610808472,72.12115650761174,NaN,NaN,NaN,NaN,3.915325464114676,29.02637485232356,173816268,-0.18599782648593788,5.7476983798075025,5.93369620629344
2024-06-27T09:30:00-04:00,452.165,456.17,451.7,454.02,441.48941534291424,NaN,NaN,NaN,NaN,NaN,433.56160000000006,458.9936079773356,408.1295920226645,447.17589373940086,453.9633333333333,453.96333872812994,453.9633279385367,873891,762175.2333333333,75.08099823291911,71.97411343098149,NaN,NaN,NaN,NaN,3.954945073820773,30.514199955676354,174690159,-0.12462672454587942,5.777912800611091,5.90253952515697
2024-06-27T13:30:00-04:00,453.97,454.55,451.88,452.83,441.48941534291424,NaN,NaN,NaN,NaN,NaN,434.0372,459.99785454951876,408.0765454504812,447.17589373940086,453.674704601126,454.08668110965493,453.26272809259706,428935,759901.5666666667,71.21398440115637,71.52308774517942,NaN,NaN,NaN,NaN,3.863163282833576,31.895751837361093,174261224,-0.20938271406741027,5.640811132572708,5.850193846640118
2024-06-28T09:30:00-04:00,453.03,455.39,451.61,453.52,441.48941534291424,NaN,NaN,NaN,NaN,NaN,434.49600000000004,461.00116508153087,407.9908349184692,447.17589373940086,453.50666666666666,453.50666666666666,453.50666666666666,953050,764468.6333333333,72.11093085888241,71.26275058117048,NaN,NaN,NaN,NaN,3.8572230483454613,33.30376006187979,175214274,-0.2608308510051591,5.524155282883669,5.784986133888828
2024-06-28T13:30:00-04:00,453.53,454.12,446.41,447.68,441.48941534291424,NaN,NaN,NaN,NaN,NaN,434.839,461.5728788057306,408.1051211942694,447.17589373940086,451.3723431159107,453.42234407946364,449.3223421523578,1033066,783573.8,56.16073027838442,70.12234839852458,NaN,NaN,NaN,NaN,4.13242140203507,32.565378248425375,174181208,-0.704840133330622,4.90393596722555,5.608776100556172
2024-07-01T09:30:00-04:00,448.66,454.77,445.66,453.21,441.48941534291424,NaN,NaN,NaN,NaN,NaN,435.30120000000005,462.4866483545744,408.1157516454257,447.17589373940086,451.21333333333337,451.21333333333337,451.21333333333337,1096396,797970.5333333333,64.22919233197736,69.86664149958445,NaN,NaN,NaN,NaN,4.487962730461133,31.62934974813657,175277604,-0.6444101252967487,4.803263443935236,5.447673569231985
2024-07-01T13:30:00-04:00,453.24,457.33,452.6,456.68,441.5628962344249,NaN,NaN,NaN,NaN,NaN,435.8918000000001,463.62088673287053,408.1627132671297,447.17589373940086,452.82743339254677,454.9185989976938,450.73626778739975,653208,801162.5333333333,68.18591745268742,69.79646953112794,NaN,NaN,NaN,NaN,4.505251106856764,31.30583464276942,175930812,-0.4009708299936765,4.946460031739889,5.3474308617335655
2024-07-02T09:30:00-04:00,453.12,457.94,453.11,457.74,442.07344640558733,NaN,NaN,NaN,NaN,NaN,436.4412000000001,464.78470059959113,408.09769940040906,447.17589373940086,456.2633333333333,456.26333872812995,456.2633279385367,748823,802135,69.30294757296744,69.59667115897439,NaN,NaN,NaN,NaN,4.528447456366994,31.12915589174781,176679635,-0.20847302520449595,5.086839580227945,5.295312605432441
2024-07-02T13:30:00-04:00,457.76,459.59,457.37,459.43,445.3371533871516,NaN,NaN,NaN,NaN,NaN,437.0268000000001,466.02843400636266,408.02516599363753,448.2677537667372,457.1795378255609,458.39675625655116,455.9623193945706,424255,797436.6,71.04830734814199,69.43290448581602,NaN,NaN,NaN,NaN,4.363558352340777,31.294174178145123,177103890,-0.01731513238395177,5.273668689952501,5.290983822336453
2024-07-03T09:30:00-04:00,458.19,461.01,457.85,460.76,446.45364641500834,NaN,NaN,NaN,NaN,NaN,437.6608,467.31666858345864,408.00493141654135,450.3722030133898,459.8733333333333,459.8733333333333,459.8733333333333,863898,804839.1,72.37929102238083,69.58347330268508,NaN,NaN,NaN,NaN,4.277589898602148,31.71650712834032,177967788,0.14004722267276648,5.466042850677411,5.3259956280046445
2024-07-05T09:30:00-04:00,459.63,468.05,458.95,467.85,449.8725715779625,NaN,NaN,NaN,NaN,NaN,438.41200000000003,469.16550490593323,407.65849509406684,454.9897624107119,464.95,464.95,464.95,926820,812258.3333333334,78.14685051398054,70.33692550569486,NaN,NaN,NaN,NaN,4.622047762987711,33.14955787825657,178894608,0.6352485423470657,6.120056305938476,5.4848077635914105
2024-07-05T13:30:00-04:00,467.825,468.35,466.74,467.4,454.31745468805514,NaN,NaN,NaN,NaN,NaN,439.1568000000001,470.86383150783956,407.4497684921606,457.0968099285695,465.8424170148207,467.0574398689659,464.62739416067546,499991,786180.1,77.04717403254074,70.84716516973138,NaN,NaN,NaN,NaN,4.4069014942028755,34.51654370244815,178394617,0.8336084634458372,6.526818342898707,5.69320987945287
2024-07-08T09:30:00-04:00,466.62,467.7,464.47,465.55,454.31745468805514,NaN,NaN,NaN,NaN,NaN,439.88000000000005,472.3043831706827,407.4556168293174,457.0968099285695,465.90666666666664,465.90667206146327,465.90666127187,689641,769098.6666666666,72.5285486038647,70.92672398400897,NaN,NaN,NaN,NaN,4.32283710175981,34.92569042750453,177704976,0.7442709001981678,6.6235485047005795,5.879277604502412
2024-07-08T13:30:00-04:00,465.56,466.52,464.76,466.22,454.31745468805514,NaN,NaN,NaN,NaN,NaN,440.81340000000006,473.52875752149237,408.09804247850775,457.14595835428446,465.88082391791556,465.9158565777555,465.8457912580756,375279,749622.2666666667,73.14287186042435,70.96174647274232,NaN,NaN,NaN,NaN,4.139777308776966,35.30561238648545,178080255,0.6384175189658503,6.677299503209724,6.038881984243874
2024-07-09T09:30:00-04:00,466.985,467.32,459.31,459.72,454.31745468805514,NaN,NaN,NaN,NaN,NaN,441.7150000000001,473.97699156901245,409.4530084309877,457.14595835428446,462.1166666666667,462.1166666666667,462.1166666666667,1176313,770849.7,59.29051136650937,69.99058970548694,NaN,NaN,NaN,NaN,4.416221786721468,33.850673377836124,176903942,0.068733619907003,6.124799009127628,6.056065389220625
2024-07-09T13:30:00-04:00,459.71,460.45,458,459.53,454.31745468805514,NaN,NaN,NaN,NaN,NaN,442.7730000000001,473.8096235921226,411.7363764078776,457.14595835428446,461.1073982671862,462.4480086253247,459.76678790904776,666701,765476.1666666666,58.939128634372764,68.83759901987649,NaN,NaN,NaN,NaN,4.275777373384219,32.13327517468732,176237241,-0.35927368962215134,5.606973277192935,5.966246966815087
2024-07-10T09:30:00-04:00,461.22,465.08,458.85,462.99,454.31745468805514,NaN,NaN,NaN,NaN,NaN,443.7268000000001,474.25465572291506,413.1989442770851,457.14595835428446,462.3066666666667,462.3066666666667,462.3066666666667,950348,780048.4,63.214546035177314,68.2662105651637,NaN,NaN,NaN,NaN,4.415364703856772,31.473974322986496,177187589,-0.4422906768050172,5.4133836208088155,5.855674297613833
2024-07-10T13:30:00-04:00,463.02,466.46,462.68,466.16,454.31745468805514,NaN,NaN,NaN,NaN,NaN,444.83100000000013,474.5191682156194,415.14283178438086,457.14595835428446,463.23176623373575,464.5464153307861,461.9171171366854,470587,760392.7333333333,66.64161770836455,67.8755453401267,NaN,NaN,NaN,NaN,4.369981510724144,31.10699634110524,177658176,-0.32222157845565214,5.452897324544267,5.775118902999919
2024-07-11T09:30:00-04:00,462.84,464.82,451.55,455.39,NaN,NaN,NaN,472.1850761978876,472.1850761978876,472.1850761978876,445.6660000000001,474.12100926021645,417.21099073978377,457.14595835428446,457.2533333333333,457.2533409627278,457.25332570393874,1476995,777509.0666666667,49.70029956615993,67.41408600353925,NaN,NaN,NaN,NaN,5.101411402815278,29.520755069415074,176181181,-0.9700401021284604,4.562568775339344,5.532608877467804
2024-07-11T13:30:00-04:00,455.34,455.9,452.48,454.72,NaN,NaN,NaN,468.5261704675286,NaN,NaN,446.4892000000002,473.5275300785859,419.4508699214145,457.14595835428446,456.42590053007154,457.73122717434546,455.1205738857976,593480,765903.7666666667,48.868018189428525,66.31685927907147,NaN,NaN,NaN,NaN,4.981310588328469,28.047816745702768,175587701,-1.4184266711790396,3.759575538494005,5.1780022096730445
2024-07-12T09:30:00-04:00,454.57,454.95,450.62,454.79,NaN,NaN,NaN,467.05998090082267,NaN,NaN,447.2638000000002,472.9563794391812,421.57122056081914,457.14595835428446,453.4533333333333,453.4533333333333,453.4533333333333,982843,782170.0666666667,48.96417813394297,64.94387789916115,NaN,NaN,NaN,NaN,4.934788403447863,27.013801116421547,176570544,-1.667850037311216,3.0931896630340248,4.761039700345241
2024-07-12T13:30:00-04:00,454.78,456.37,452.1,453.93,NaN,NaN,NaN,467.05998090082267,NaN,NaN,447.8850000000002,472.6744239545503,423.0955760454501,457.14595835428446,453.7084387633596,454.03766955161313,453.37920797510606,590096,761788.2,47.77542618272243,63.406197799857935,NaN,NaN,NaN,NaN,4.887303517487299,25.72543777297592,175980448,-1.8350409971506938,2.467238453906873,4.302279451057567
2024-07-15T09:30:00-04:00,453.13,457.25,451.45,452.33,NaN,NaN,NaN,467.05998090082267,NaN,NaN,448.4514000000002,472.3095578534137,424.5932421465867,457.14595835428446,453.6766666666667,453.6766666666667,453.6766666666667,709877,759416.9666666667,45.55929247584202,61.585553880407936,NaN,NaN,NaN,NaN,4.952496123381065,24.324447203559657,175270571,-1.9849684930495486,1.8210688347456312,3.80603732779518
2024-07-15T13:30:00-04:00,452.22,454.37,451.43,454.05,NaN,NaN,NaN,467.0019429115814,NaN,NaN,449.07080000000025,471.8455224228585,426.296077577142,455.81576668342757,453.5252173117061,453.71661525458467,453.33381936882756,444471,736593.6333333333,48.33383122989221,59.86802103808733,NaN,NaN,NaN,NaN,4.808746400282417,23.027840091538263,175715042,-1.8998173485326664,1.4312656421293468,3.331082990662013
2024-07-16T09:30:00-04:00,454.27,454.31,447.1,447.38,NaN,NaN,NaN,465.1491273246914,NaN,NaN,449.52980000000025,471.1977588295318,427.8618411704687,455.40383254191494,449.59666666666664,449.59666666666664,449.59666666666664,1159120,755353.3333333334,39.851845412863135,57.132663530864654,NaN,NaN,NaN,NaN,4.980264514547957,22.697701526524124,174555922,-2.2028873615337843,0.5774737887447827,2.780361150278567
2024-07-16T13:30:00-04:00,447.35,450.13,446.68,449.5,NaN,NaN,NaN,462.6630306281145,NaN,NaN,450.00440000000026,470.5819917579854,429.4268082420151,455.40383254191494,449.30095787198496,449.6972013733274,448.9047143706425,645554,744812.7,43.260082004350416,54.71929981456535,NaN,NaN,NaN,NaN,4.870959906365959,22.46945761465601,175201476,-2.1674213532401163,0.0710844587284214,2.2385058119685377
2024-07-17T09:30:00-04:00,442.3,444.35,439.2,441.93,NaN,NaN,NaN,456.789483781382,NaN,NaN,450.3642000000002,469.69776918518846,431.03063081481196,455.40383254191494,441.82666666666665,441.82666666666665,441.82666666666665,1496078,776191.7,35.520299620389665,52.07585345860285,NaN,NaN,NaN,NaN,5.258748484482678,23.43570526557051,173705398,-2.5350798827958902,-0.9303440415263253,1.604735841269565
2024-07-17T13:30:00-04:00,441.88,444.84,441.35,443.5,NaN,NaN,NaN,456.789483781382,NaN,NaN,450.7198000000002,468.84336322135897,432.5962367786414,448.67006603353195,442.28974298549207,442.94959960404975,441.6298863669344,736818,773995.0333333333,37.997927473766225,49.56550028812727,NaN,NaN,NaN,NaN,5.132409307019627,24.19451282361926,174442216,-2.5470643880690935,-1.579094643816802,0.9679697442522914
2024-07-18T09:30:00-04:00,444.39,444.6,434.39,437.4,NaN,NaN,NaN,455.0221019578295,NaN,NaN,450.90900000000016,468.25835676037633,433.559643239624,443.7658670473347,438.79666666666657,438.7966742960611,438.79665903727204,1357363,804642.5,32.73486542900501,47.66866843544839,NaN,NaN,NaN,NaN,5.495094356518227,25.742052443156364,173084853,-2.8191672644258725,-2.5559893362800494,0.2631779281458232
2024-07-18T13:30:00-04:00,437.42,441.01,436.66,440.02,NaN,NaN,NaN,454.24950641429183,NaN,NaN,451.1456000000001,467.54589422171745,434.7453057782828,443.7658670473347,438.93912352243404,439.14268517994617,438.7355618649219,664769,801662.0666666667,36.78487212120935,46.08622154165099,NaN,NaN,NaN,NaN,5.413301902481209,27.17905351844082,173749622,-2.677127733095734,-3.0832317382238443,-0.4061040051281103
2024-07-19T09:30:00-04:00,432.8,441.05,432,435.99,NaN,NaN,NaN,452.47293794091485,NaN,NaN,451.21220000000017,467.33640207758026,435.0879979224201,443.7658670473347,436.34666666666664,436.34666666666664,436.34666666666664,1239290,830931.8666666667,33.448805067585724,43.96009718682303,NaN,NaN,NaN,NaN,5.67306605230398,28.985246529301627,172510332,-2.7012434595971997,-3.78265832962461,-1.0814148700274102
2024-07-19T13:30:00-04:00,435.9,438.36,435.83,437.11,NaN,NaN,NaN,452.47293794091485,NaN,NaN,451.1588000000001,467.450903431996,434.8666965680042,443.7658670473347,436.61412052252604,436.9746067770924,436.2536342679597,682171,824541.2,35.207489771934576,41.714802334220884,NaN,NaN,NaN,NaN,5.448561334282269,30.662425753672373,173192503,-2.493420247601846,-4.198190179529718,-1.7047699319278717
2024-07-22T09:30:00-04:00,441.62,444.58,438.93,442.31,NaN,NaN,NaN,452.47293794091485,NaN,NaN,451.1834000000001,467.41816940885656,434.9486305911437,442.1126936378678,441.94,441.94,441.94,795904,836773.5,42.76938331074087,41.21973688740524,NaN,NaN,NaN,NaN,5.592949810404962,30.489662192099683,173988407,-1.885057561057669,-4.061091883249958,-2.176034322192289
2024-07-22T13:30:00-04:00,442.3,444.58,442.27,442.92,NaN,NaN,NaN,452.47293794091485,NaN,NaN,451.21780000000007,467.37491127148127,435.06068872851887,440.8991549102942,442.35653209689485,442.96885140884245,441.74421278494725,368300,817281.8333333334,43.60093421057406,40.843516603201344,NaN,NaN,NaN,NaN,5.358453395376037,30.32923888492504,174356707,-1.3461625183391601,-3.858737470116239,-2.512574951777079
2024-07-23T09:30:00-04:00,443.99,448.35,443.23,444.56,NaN,NaN,NaN,452.47293794091485,NaN,NaN,451.28460000000007,467.3028402079308,435.26635979206935,437.6763239282354,445.38000000000005,445.38000000000005,445.38000000000005,701206,806219.8333333334,45.87778550388416,40.623059986768574,NaN,NaN,NaN,NaN,5.363563867134892,29.2600612679886,175057913,-0.8102578471676711,-3.5253972607366677,-2.7151394135689966
2024-07-23T13:30:00-04:00,444.5,445.34,443.1,444.82,NaN,NaN,NaN,452.47293794091485,NaN,NaN,451.32960000000014,467.26207197890886,435.3971280210914,434.8670471243998,445.04906002330625,445.50532870451724,444.59279134209527,368895,781969.8,46.248269447446845,40.51397736282031,NaN,NaN,NaN,NaN,5.14045216233954,28.2897229916827,175426808,-0.39054212588833526,-3.2033170709294154,-2.81277494504108
2024-07-24T09:30:00-04:00,440.225,441.49,428.94,429.96,NaN,NaN,NaN,451.8035475224163,NaN,NaN,451.07880000000006,467.92777321023084,434.2298267897693,434.8670471243998,433.46333333333337,433.46333333333337,433.46333333333337,1341684,804919,32.53869201691137,39.5839344728967,NaN,NaN,NaN,NaN,5.90756272217243,29.217368934094257,174085124,-1.0296865315238541,-4.099883109445898,-3.0701965779220437
2024-07-24T13:30:00-04:00,429.93,430.54,427.6,428.86,NaN,NaN,NaN,445.30543172594287,NaN,NaN,450.6976000000001,468.64202556782163,432.7531744321785,434.8670471243998,431.6129160556217,433.81177599080314,429.4140561204403,950155,811630.0666666667,31.78751258771213,38.40205456988384,NaN,NaN,NaN,NaN,5.695593956302971,30.20464236373645,173134969,-1.4185210272800335,-4.843347862022085,-3.424826834742052
2024-07-25T09:30:00-04:00,428.8,429.84,417.51,425.01,NaN,NaN,NaN,440.85382119294536,NaN,NaN,450.2286000000001,469.55501301843157,430.9021869815686,434.8670471243998,424.11999999999995,424.11999999999995,424.11999999999995,2192820,870582.2333333333,29.242926461415976,37.64427464478047,NaN,NaN,NaN,NaN,6.169480102281328,31.917774969981274,170942149,-1.8023482531866852,-5.677762151225409,-3.8754138980387234
2024-07-25T13:30:00-04:00,425.05,425.41,417.96,418.49,NaN,NaN,NaN,439.09887477508425,NaN,NaN,449.6430000000001,470.90898344772364,428.37701655227653,434.8670471243998,422.9857385930167,424.62383687609486,421.3476403099386,1051355,876830.8,25.51754275696058,36.37695041282405,NaN,NaN,NaN,NaN,6.260945809261237,33.50854096149432,169890794,-2.3292014080787506,-6.786915658137161,-4.457714250058411
2024-07-26T09:30:00-04:00,418.185,428.93,417.27,428.62,NaN,NaN,NaN,439.09887477508425,NaN,NaN,449.2882000000001,471.3389050916492,427.2374949083509,434.8670471243998,424.94,424.94000762939453,424.93999237060547,1451590,894323.1333333333,38.60436508639563,36.597240803253044,NaN,NaN,NaN,NaN,6.646592537171151,34.17748453109323,171342384,-1.8502091077010432,-6.770475634684715,-4.920266526983672
2024-07-26T13:30:00-04:00,428.58,428.74,423.5,425.28,NaN,NaN,NaN,439.09887477508425,NaN,NaN,448.9014000000001,471.9231997593386,425.87960024066155,434.8670471243998,425.2301286656066,425.650772406204,424.80948492500926,690552,900675.1666666666,36.33734628070933,36.478627860891834,NaN,NaN,NaN,NaN,6.546121641658927,34.79864641714934,170651832,-1.621288861116576,-6.9468776033793915,-5.325588742262815
2024-07-29T09:30:00-04:00,431.5,432.02,424.71,428.26,NaN,NaN,NaN,439.09887477508425,NaN,NaN,448.5504000000001,472.27446607980505,424.8263339201951,434.8670471243998,428.33,428.33,428.33,903377,907799.7,39.73766143005239,36.97882757525237,NaN,NaN,NaN,NaN,6.600684381540432,34.62558994467363,171555209,-1.1540864301525353,-6.768196779953485,-5.614110349800949
2024-07-29T13:30:00-04:00,428.29,429.06,426.16,426.84,NaN,NaN,NaN,439.09887477508425,NaN,NaN,448.11600000000004,472.60648402949585,423.62551597050424,434.8670471243998,428.0162802887027,428.4723280136378,427.5602325637676,427496,909540.2666666667,38.677553242194975,37.1140190838942,NaN,NaN,NaN,NaN,6.336349782858972,34.46489464880332,171127713,-0.8401921901346814,-6.6643505874693005,-5.824158397334619
2024-07-30T09:30:00-04:00,427.79,429.01,417.39,418.38,NaN,NaN,NaN,439.09887477508425,NaN,NaN,447.48740000000004,473.3468675304632,421.62793246953686,433.4336376995198,421.5933333333333,421.5933333333333,421.5933333333333,1454982,918829.2333333333,33.024858300950385,37.08373717199167,NaN,NaN,NaN,NaN,6.713753369797617,35.212020314796185,169672731,-1.0862047941977675,-7.181914390081829,-6.0957095958840615
2024-07-30T13:30:00-04:00,418.41,425.21,417.95,422.29,NaN,NaN,NaN,439.09887477508425,NaN,NaN,446.95980000000003,473.76053595703854,420.1590640429615,424.0249101596159,421.67549150302824,421.7831887319601,421.5677942740964,846740,924830.5333333333,37.566426370396634,37.252232643310386,NaN,NaN,NaN,NaN,6.752770986240644,35.90577986178955,170519471,-0.8783595918439335,-7.193659085688978,-6.315299493845044
2024-07-31T09:30:00-04:00,420.55,421.7,412.21,417.02,NaN,NaN,NaN,436.23278340332257,NaN,NaN,446.3468000000001,474.4261046751306,418.26749532486957,415.09792812769274,416.97666666666663,416.97666666666663,416.97666666666663,2210671,966841.3,34.20022783188601,36.640150109106465,NaN,NaN,NaN,NaN,6.990430201509172,37.035697971427325,168308800,-0.9807848927326077,-7.541280609760804,-6.560495717028196
2024-07-31T13:30:00-04:00,416.96,421.21,415.56,418.21,NaN,NaN,NaN,436.23278340332257,NaN,NaN,445.72020000000003,474.8645901950112,416.57580980498886,413.04535788888234,417.49549614837525,418.15218158999835,416.83881070675216,1379935,997152.9,35.60344063128265,36.068900567728505,NaN,NaN,NaN,NaN,6.894685187115658,38.0849076446624,169688735,-0.8578149151677561,-7.632764360987892,-6.774949445820136
2024-08-01T09:30:00-04:00,420.75,427.45,416.66,418.035,NaN,NaN,NaN,436.23278340332257,NaN,NaN,445.06430000000006,475.17913820376367,414.94946179623645,413.04535788888234,420.715,420.715,420.715,1833643,1009041.1666666666,35.48360041113442,35.32645877538924,NaN,NaN,NaN,NaN,7.172921959464537,37.599390664397916,167855092,-0.6851738105239331,-7.631416708975053,-6.9462428984511195
2024-08-01T13:30:00-04:00,418.11,418.29,413.09,417.02,NaN,NaN,NaN,435.272254141451,NaN,NaN,444.3665000000001,475.41686735690735,413.3161326430928,413.04535788888234,419.352897736251,421.44702666292096,417.25876880958106,775760,1015117.1666666666,34.75294118709958,34.50536389965015,NaN,NaN,NaN,NaN,7.03199896235993,37.52465972646894,167079332,-0.542495125594245,-7.624361805443925,-7.08186667984968
2024-08-02T09:30:00-04:00,412.4,415,404.33,405.65,NaN,NaN,NaN,430.0876062259305,NaN,NaN,443.43730000000005,476.2365699436898,410.6380300563103,413.04535788888234,408.32666666666665,408.32666666666665,408.32666666666665,1645155,1037194.2333333333,27.837798010643127,34.16958575634528,NaN,NaN,NaN,NaN,7.436141893619935,38.21843703903093,165434177,-1.085671210007412,-8.438955692358945,-7.353284482351533
2024-08-02T13:30:00-04:00,405.65,409.02,404.65,408.49,NaN,NaN,NaN,426.92521503384273,NaN,NaN,442.52670000000006,476.6033923048429,408.45000769515724,413.04535788888234,407.99327010942386,408.4429805711961,407.54355964765165,904197,1047664.2666666667,31.5040079455419,34.14933542476169,NaN,NaN,NaN,NaN,7.2171317583613686,38.86265882926706,166338374,-1.1209301215835525,-8.754447134330974,-7.633517012747421
2024-08-05T09:30:00-04:00,389.1,401.03,385.6,397.28,NaN,NaN,NaN,415.613387077759,NaN,NaN,441.4157000000001,477.6313339726195,405.2000660273807,412.4302863111059,394.6366666666666,394.6366666666666,394.6366666666666,2407371,1104247.4,25.908687946079226,33.91117553080907,NaN,NaN,NaN,NaN,8.336622347049842,40.58435186911403,163931003,-1.7300714089590983,-9.796106273946293,-8.066034864987195
2024-08-05T13:30:00-04:00,397.27,398.5,393.17,395.62,NaN,NaN,NaN,415.613387077759,NaN,NaN,440.25770000000006,478.4972979691054,402.01810203089474,409.89622904888466,394.99813860017065,395.52406294801807,394.4722142523232,1137223,1127339.1333333333,25.195076254568562,33.88814220920963,NaN,NaN,NaN,NaN,8.121863607974852,42.18306683468621,162793780,-2.053576986536944,-10.633006098158376,-8.579429111621431
2024-08-06T09:30:00-04:00,400.01,405.7,398.44,403.75,NaN,NaN,NaN,415.613387077759,NaN,NaN,439.37910000000005,478.89361417844816,399.86458582155194,406.88183941842317,402.62999999999994,402.62999999999994,402.62999999999994,1463321,1137479.1666666667,34.6837386637211,33.608097464732886,NaN,NaN,NaN,NaN,8.261730493119504,42.32231058952697,164257101,-1.5516374918293927,-10.518975976408171,-8.967338484578779
2024-08-06T13:30:00-04:00,403.9,404.8,399.23,399.42,NaN,NaN,NaN,415.613387077759,NaN,NaN,438.30330000000004,479.1591725085978,397.44742749140227,406.88183941842317,402.1292008109536,402.82947430901424,401.42892731289294,748396,1140907.2333333334,32.331493362120824,33.321965113405135,NaN,NaN,NaN,NaN,8.069464029325253,42.4516083618791,163508705,-1.350269110530311,-10.655174872741668,-9.304905762211357
2024-08-07T09:30:00-04:00,408.68,410.08,400.1,401.2,NaN,NaN,NaN,415.613387077759,NaN,NaN,437.1937000000001,478.99553741462444,395.39186258537575,406.88183941842317,403.79333333333335,403.79333333333335,403.79333333333335,1079039,1127005.9333333333,34.30397331476483,32.93384453374173,NaN,NaN,NaN,NaN,8.254502312944876,41.65031098435622,164587744,-0.954845481018598,-10.498462613484605,-9.543617132466007
2024-08-07T13:30:00-04:00,401.16,402.09,397.475,398.27,NaN,NaN,NaN,415.613387077759,NaN,NaN,436.00430000000006,478.77306477101894,393.2355352289812,406.88183941842317,401.92006536828416,404.1446264470891,399.69550428947923,765153,1127950.4333333333,32.61849848037305,32.501054907897306,NaN,NaN,NaN,NaN,7.9945378620202385,41.13084326585635,163822591,-0.7569254520521582,-10.489773947531205,-9.732848495479047
2024-08-08T09:30:00-04:00,402.55,405.86,399.99,403.82,NaN,NaN,NaN,415.613387077759,NaN,NaN,434.8921000000001,478.05672144347795,391.7274785565222,399.23547153473856,403.22333333333336,403.22333333333336,403.22333333333336,905600,1112891.6666666667,38.75676852661353,32.91047706687325,NaN,NaN,NaN,NaN,7.965642300447366,40.01450978966813,164728191,-0.15027317320342526,-9.920689961983328,-9.770416788779903
2024-08-08T13:30:00-04:00,403.82,405.56,400.27,403.01,NaN,NaN,NaN,415.613387077759,NaN,NaN,433.7371000000001,477.16098799219463,390.3132120078056,393.4113772277908,403.0918391870858,403.23000335267346,402.9536750214981,820273,1118075.1333333333,38.20968270863785,32.95642394817619,NaN,NaN,NaN,NaN,7.774524993272556,38.97791441892193,163907918,0.2752250075878955,-9.426385529295032,-9.701610536882928
2024-08-09T09:30:00-04:00,403.79,407.59,402.25,407.59,NaN,NaN,NaN,415.613387077759,NaN,NaN,432.5319000000001,475.4436989783547,389.62010102164555,389.686427605812,405.80999999999995,405.80999999999995,405.80999999999995,842725,1104856.3,43.10050053119134,33.59215771241229,NaN,NaN,NaN,NaN,7.600630350895943,37.660251336694415,164750643,0.9082239060280735,-8.566330654347837,-9.47455456037591
2024-08-09T13:30:00-04:00,407.59,408.02,405.72,406.04,NaN,NaN,NaN,415.613387077759,NaN,NaN,431.3047000000001,473.6636579857538,388.9457420142464,392.54714208464964,406.09089312611644,406.46656851855585,405.71521773367704,471132,1097821.6666666667,41.89201024085674,34.04134125595329,NaN,NaN,NaN,NaN,7.222013897260515,36.35960611426503,164279511,1.2448250808974102,-7.918523209254147,-9.163348290151557
2024-08-12T09:30:00-04:00,407.06,408.78,404.25,406.75,NaN,NaN,NaN,415.613387077759,NaN,NaN,430.1287000000001,471.8799255537334,388.3774744462668,394.13671366771973,406.5933333333333,406.5933333333333,406.5933333333333,868738,1100249.4666666666,42.684771130887306,34.5557105930785,NaN,NaN,NaN,NaN,7.029727190313333,35.3355039474081,165148249,1.5193954270832108,-7.2641040062975435,-8.783499433380754
2024-08-12T13:30:00-04:00,406.8,407.22,405.12,406.95,NaN,NaN,NaN,415.613387077759,NaN,NaN,428.9433000000001,469.886159675881,388.00044032411915,394.4553709341758,406.537364325307,406.6148825475003,406.4598461031137,452873,1103068.5666666667,42.921003293823844,35.139143600701665,NaN,NaN,NaN,NaN,6.677603819576668,34.38455193532667,165601122,1.70468260226661,-6.652646180547492,-8.357328782814102
2024-08-13T09:30:00-04:00,409.59,414.95,409.57,414.31,NaN,NaN,NaN,415.613387077759,NaN,NaN,428.0351000000001,468.21435716036706,387.85584283963317,400.7382967473406,412.9433333333334,412.9433333333334,412.9433333333334,911739,1110086.3333333333,50.935382934840774,36.7889710952872,NaN,NaN,NaN,NaN,6.7720606896069055,32.081371294664976,166512861,2.277344912134568,-5.510647642645893,-7.787992554780461
2024-08-13T13:30:00-04:00,414.34,414.85,412.51,413.97,NaN,NaN,NaN,415.613387077759,NaN,NaN,427.12390000000005,466.46247431528343,387.78532568471667,402.3106373978725,413.2705886617176,413.6775490083583,412.86362831507694,589576,1117442.3666666667,50.582056728269144,38.15168886548201,NaN,NaN,NaN,NaN,6.455484926063557,29.942703556907695,165923285,2.5662000060461434,-4.580242547222781,-7.146442553268924
2024-08-14T09:30:00-04:00,415,417.56,412.44,416.43,395.6160513126224,395.6160513126224,395.6160513126224,NaN,NaN,NaN,426.1927000000001,464.27541897907133,388.1099810209289,404.96850991829797,415.4766666666667,415.4766666666667,415.4766666666667,781091,1098755.9333333333,53.116137935210936,40.09507815041999,NaN,NaN,NaN,NaN,6.3600931456304455,28.1043876318087,166704376,2.8348685437092724,-3.6028568736323336,-6.437725417341606
2024-08-14T13:30:00-04:00,416.41,417.72,415.12,416.53,397.562594434776,NaN,NaN,NaN,NaN,NaN,425.2001000000001,461.61480969208776,388.7853903079124,406.3468079346384,415.8762803587242,416.3578717990324,415.394688918416,537805,1085010.9333333333,53.22114898215457,42.0969404881047,NaN,NaN,NaN,NaN,6.091515063799702,26.424305062845672,167242181,2.919729564840699,-2.788063461290733,-5.707793026131432
2024-08-15T09:30:00-04:00,419.72,420.93,417.65,419.11,400.6897492331952,NaN,NaN,NaN,NaN,NaN,424.4745000000001,459.88604954247154,389.06295045752864,409.63144634771066,419.23,419.23,419.23,996914,1045147.4,55.96175140210466,43.61679854084639,NaN,NaN,NaN,NaN,5.9706925592425835,25.39827217038202,168239095,3.0365481925884676,-1.9121077853958468,-4.9486559779843144
2024-08-15T13:30:00-04:00,419.19,421.11,419.11,421.09,402.0824879044136,NaN,NaN,NaN,NaN,NaN,423.8019000000001,458.15159350021895,389.45220649978125,411.07115707816854,419.6694014919966,420.25003688750144,419.0887660964918,570918,1029132.8333333334,57.99561259299598,45.44994991448033,NaN,NaN,NaN,NaN,5.687071662153827,24.47511028391054,168810013,3.122061897689422,-1.0460786058725375,-4.168140503561959
2024-08-16T09:30:00-04:00,420.965,421.34,417.31,419.52,402.0824879044136,NaN,NaN,NaN,NaN,NaN,423.0965000000001,456.30127184079225,389.89172815920796,411.29392566253483,419.3900000000001,419.3900000000001,419.3900000000001,983145,1013518,55.79518472798993,46.98503644399641,NaN,NaN,NaN,NaN,5.568709400571409,23.230091409879908,167826868,2.949802996880625,-0.48088675746117815,-3.4306897543418033
2024-08-16T13:30:00-04:00,419.53,419.68,418.31,418.54,402.0824879044136,NaN,NaN,NaN,NaN,NaN,422.3887000000001,454.4223933124957,390.3550066875045,411.29392566253483,419.2312829524596,419.47942448087696,418.98314142404223,402222,1003907,54.40752784092536,48.54139568403586,NaN,NaN,NaN,NaN,5.268801586244881,22.074002455422896,167424646,2.655936540736358,-0.11076907842135597,-2.766705619157714
2024-08-19T09:30:00-04:00,418.99,419.87,416.46,418.57,402.0824879044136,NaN,NaN,NaN,NaN,NaN,421.71350000000007,452.5968613617273,390.83013863827284,411.29392566253483,418.29999999999995,418.29999999999995,418.29999999999995,546027,991995.3333333334,54.44487885900609,49.66197499349247,NaN,NaN,NaN,NaN,5.136030044370249,20.584493419530585,167970673,2.359656213898764,0.182864648215741,-2.176791565683023
2024-08-19T13:30:00-04:00,418.61,421.68,418.46,421.55,403.57229368783834,NaN,NaN,NaN,NaN,NaN,421.06350000000003,450.53284354543837,391.5941564545617,413.12400993921784,419.32367158582747,420.45017347530904,418.1971696963459,450891,992775.1666666666,58.11552151654195,51.08382062262848,NaN,NaN,NaN,NaN,4.999170755486661,19.583914925717874,168421564,2.2602783984291968,0.6485564323534732,-1.6117219660757236
2024-08-20T09:30:00-04:00,421.7,423.99,421.66,423.75,406.74446215657304,NaN,NaN,NaN,NaN,NaN,420.59090000000003,449.0991713393723,392.0826286606278,415.92520795137426,423.1333333333334,423.1333333333334,423.1333333333334,715272,968118.1666666666,60.6371578324622,52.33643900129068,NaN,NaN,NaN,NaN,4.816372844380472,19.117581236356543,169136836,2.23459540229542,1.1815222867935518,-1.0530731155018684
2024-08-20T13:30:00-04:00,423.75,425.85,423.42,424.87,408.95403205854694,NaN,NaN,NaN,NaN,NaN,420.0983,447.4178330567595,392.7787669432405,418.18316636109944,423.8872072371058,424.6763807954272,423.0980336787845,652715,961650.6666666666,61.89490237626196,53.76521701096248,NaN,NaN,NaN,NaN,4.645917641210438,19.036831493030334,169789551,2.182433064454774,1.674968215066599,-0.5074648493881749
2024-08-21T09:30:00-04:00,424.115,426.4,421.72,424,408.95403205854694,NaN,NaN,NaN,NaN,NaN,419.7397,446.3654492221214,393.11395077787864,418.18316636109944,424.0399999999999,424.04000934406173,424.0399906559381,804167,914767.2,60.28354927036717,55.0222725923539,NaN,NaN,NaN,NaN,4.64835209540969,18.516195571575913,168985384,1.9844370667543134,1.9730814840547168,-0.011355582699596523
2024-08-21T13:30:00-04:00,423.99,424.58,422.74,424,408.95403205854694,NaN,NaN,NaN,NaN,NaN,419.3497,445.12973075326374,393.5696692467362,418.18316636109944,423.951373318699,424.0769881787014,423.82575845869655,400307,882112.9333333333,60.28354927036717,56.26245444782128,NaN,NaN,NaN,NaN,4.447755517166139,18.032747930225383,168985384,1.7564130677294112,2.1841607519621675,0.42774768423275633
2024-08-22T09:30:00-04:00,424.3,426.75,416.38,416.44,408.95403205854694,NaN,NaN,NaN,NaN,NaN,418.93049999999994,444.1994396888616,393.66156031113826,418.18316636109944,419.8566666666666,419.8566666666666,419.8566666666666,979446,853639.7,47.75441011703706,56.03524210369244,NaN,NaN,NaN,NaN,4.870772980225701,17.395168510480463,168005938,1.035056734905322,1.7215686028644086,0.6865118679590868
2024-08-22T13:30:00-04:00,416.44,416.67,414.61,415.63,408.95403205854694,NaN,NaN,NaN,NaN,NaN,418.44269999999995,442.9958590806433,393.8895409193566,418.18316636109944,418.2627858542923,420.30868931833544,416.21688239024917,594459,847596.3333333334,46.636023810942305,55.75338260959767,NaN,NaN,NaN,NaN,4.670003481638152,17.147029196361782,167411479,0.47071407074286953,1.2749044563876737,0.8041903856448042
2024-08-23T09:30:00-04:00,416.97,419.27,412.09,414.5,408.95403205854694,NaN,NaN,NaN,NaN,NaN,418.01289999999995,442.069701124827,393.95609887517287,418.18316636109944,415.28666666666663,415.28666666666663,415.28666666666663,1053143,827862.6,45.050911474342975,55.17729500524996,NaN,NaN,NaN,NaN,4.8492889472354275,16.28748301380529,166358336,0.012873802220153996,0.8202826384199966,0.8074088361998426
2024-08-23T13:30:00-04:00,414.55,417.15,414.06,416.64,408.95403205854694,NaN,NaN,NaN,NaN,NaN,417.60349999999994,441.03497662865755,394.17202337134233,418.18316636109944,415.5358839094292,415.8571390576327,415.21462876122564,633787,818848.9333333333,48.613054456095405,54.848145396245734,NaN,NaN,NaN,NaN,4.723625451004324,15.48933298714569,166992123,-0.14555766590429065,0.6254617538194793,0.77101941972377
2024-08-26T09:30:00-04:00,416.48,417.26,412.15,413.49,408.95403205854694,NaN,NaN,NaN,NaN,NaN,417.0270999999999,439.39283111614156,394.66136888385824,418.18316636109944,414.3,414.3,414.3,556768,757162.1666666666,44.08299964064243,53.99966312756986,NaN,NaN,NaN,NaN,4.751223633075445,15.16705114232692,166435355,-0.44528394532836635,0.2144144880633121,0.6596984333916784
2024-08-26T13:30:00-04:00,413.46,413.76,411.36,413.63,408.95403205854694,NaN,NaN,NaN,NaN,NaN,416.44129999999996,437.5633530072106,395.3192469927893,418.18316636109944,413.71307292641455,414.39676320383455,413.02938264899456,410321,732932.1,44.33129228435651,53.02364024838132,NaN,NaN,NaN,NaN,4.583279087855769,15.038141164021281,166845676,-0.6068839221548925,-0.09890646930193725,0.5079774528529553
2024-08-27T09:30:00-04:00,412.84,414.34,410.23,412.65,408.95403205854694,NaN,NaN,NaN,NaN,NaN,415.8031,435.3583790713751,396.24782092862483,418.18316636109944,412.4066666666665,412.40667206146315,412.4066612718699,719618,708142,42.89542696767556,52.102228979787434,NaN,NaN,NaN,NaN,4.5494734387232105,15.163699038091316,166126058,-0.7435302429051147,-0.4214353507784381,0.3220948921266766
2024-08-27T13:30:00-04:00,412.71,414.21,412.71,413.9,408.95403205854694,NaN,NaN,NaN,NaN,NaN,415.1847,432.89939925342236,397.4700007465777,417.9265330888795,412.79130710900733,413.3513251988453,412.23128901916937,339475,694511.3,45.32784453293367,51.45368017207375,NaN,NaN,NaN,NaN,4.335939621671552,15.280288492584917,166465533,-0.7133648233905476,-0.569611137111508,0.14375368627903964
2024-08-28T09:30:00-04:00,414.91,415,407.71,409.94,NaN,NaN,NaN,426.14402447550026,426.14402447550026,426.14402447550026,414.78430000000003,432.04422699981825,397.5243730001818,416.8812264711036,410.8833333333334,410.8833333333334,410.8833333333334,608765,678835.5,39.57644105323638,50.39164890023306,NaN,NaN,NaN,NaN,4.5469439344093,16.392986337842448,165856768,-0.9110904836541284,-0.9951094182886209,-0.08401893463449248
2024-08-28T13:30:00-04:00,410,411.8,407.31,410.77,NaN,NaN,NaN,424.28406881752295,NaN,NaN,414.4225,431.2397716276716,397.60522837232844,415.4059811768829,410.50753355198583,410.9611446069103,410.05392249706136,417826,667257.9333333333,41.25880192163947,49.18759750059717,NaN,NaN,NaN,NaN,4.542876510522922,17.497084528851776,166274594,-0.9335255827080065,-1.2509259130195005,-0.3174003303114941
2024-08-29T09:30:00-04:00,414.93,422.05,414.58,418.18,NaN,NaN,NaN,424.28406881752295,NaN,NaN,414.28589999999997,430.8662461592091,397.70555384079086,407.69450703549757,418.27,418.27,418.27,1079386,673050.8,53.662929605273604,48.689438341512265,NaN,NaN,NaN,NaN,5.024099616914144,16.644062067803166,167353980,-0.42286794741749434,-0.8459852645833621,-0.42311731716586776
2024-08-29T13:30:00-04:00,418.14,418.25,411.93,413.16,NaN,NaN,NaN,424.28406881752295,NaN,NaN,414.1793,430.71864339806694,397.6399566019331,407.69450703549757,416.8918900884033,418.727587948514,415.05619222829256,608334,665986.1666666666,46.499201192921944,47.58974539984512,NaN,NaN,NaN,NaN,5.116663929991705,15.610368949253925,166745646,-0.3971373906900627,-0.9195390555284462,-0.5224016648383835
2024-08-30T09:30:00-04:00,414.98,417.36,412.14,413.6,NaN,NaN,NaN,424.28406881752295,NaN,NaN,413.8789,429.89554949854346,397.8622505014565,407.69450703549757,414.3666666666666,414.3666666666666,414.3666666666666,765859,663423.9666666667,47.16496529474655,46.65270368730079,NaN,NaN,NaN,NaN,5.124045077849442,14.650511053458201,167511505,-0.3273489696182653,-0.9315878768612151,-0.6042389072429498
2024-08-30T13:30:00-04:00,413.61,417.44,412.18,417.09,NaN,NaN,NaN,424.28406881752295,NaN,NaN,413.7151,429.42661889408424,398.00358110591577,407.69450703549757,414.8995203516782,415.49723897390516,414.3018017294512,608655,668008.0666666667,52.24150908755959,46.07827224567168,NaN,NaN,NaN,NaN,5.133756143717339,13.740557193887476,168120160,-0.03821438790898379,-0.6520068921291795,-0.6137925042201957
2024-09-03T09:30:00-04:00,417.9,419.85,410.84,411.69,NaN,NaN,NaN,424.28406881752295,NaN,NaN,413.38370000000003,428.54339245198844,398.2240075480116,407.69450703549757,414.1266666666668,414.1266666666668,414.1266666666668,798968,665682.4,45.03178967173978,45.88379935672187,NaN,NaN,NaN,NaN,5.41063070488039,13.180076343043806,167321192,-0.1940067277179116,-0.8563009138675852,-0.6622941861496736
2024-09-03T13:30:00-04:00,411.7,411.765,407.04,409.55,NaN,NaN,NaN,424.28406881752295,NaN,NaN,413.03790000000004,427.7357904730941,398.340009526906,407.69450703549757,412.0588514093144,414.3807421021741,409.7369607164547,633679,671709.2666666667,42.52699548019677,45.59029733309719,NaN,NaN,NaN,NaN,5.361657083103217,12.688111948324106,166687513,-0.412015985758574,-1.1773141683478912,-0.7652981825893171
2024-09-04T09:30:00-04:00,405.64,411.25,404.35,408.18,NaN,NaN,NaN,424.17208537508833,NaN,NaN,412.83389999999997,427.51267423898724,398.1551257610127,407.69450703549757,407.9266666666667,407.9266666666667,407.9266666666667,768588,666937.5666666667,40.95639390486681,45.29783179242032,NaN,NaN,NaN,NaN,5.471538720024414,12.771149191788417,165918925,-0.6075145283417572,-1.5246913430165137,-0.9171768146747564
2024-09-04T13:30:00-04:00,408.15,410.9,408.04,408.76,NaN,NaN,NaN,424.17208537508833,NaN,NaN,412.5633,427.032156984539,398.0944430154611,407.69450703549757,408.3415069906276,408.9497549079473,407.73325907330786,357515,659202.2,41.934113896479225,44.82076460959059,NaN,NaN,NaN,NaN,5.285000240022668,12.848255203576706,166276440,-0.6528263409908881,-1.7332097409133667,-1.0803833999224786
2024-09-05T09:30:00-04:00,408.21,413.1,406.13,406.29,NaN,NaN,NaN,424.17208537508833,NaN,NaN,412.3487,426.86500046668476,397.83239953331525,407.69450703549757,408.50666666666666,408.50666666666666,408.50666666666666,892145,662904,38.97424183196404,44.45585333754213,NaN,NaN,NaN,NaN,5.405357365735336,12.341932798292522,165384295,-0.7947846521841284,-2.073864215152639,-1.2790795629685108
2024-09-05T13:30:00-04:00,406.27,409.44,406.25,408.33,NaN,NaN,NaN,423.78207387853996,NaN,NaN,412.1511000000001,426.6117502329196,397.6904497670806,407.69450703549757,408.33244204672485,408.5706816147756,408.0942024786741,477119,660881.1333333333,42.5791404563619,44.33069963554252,NaN,NaN,NaN,NaN,5.247117553897097,11.871776279100068,165861414,-0.7002482882548815,-2.1543899232871127,-1.4541416350322312
2024-09-06T09:30:00-04:00,409.12,410.61,401.46,402.45,NaN,NaN,NaN,422.4953887022426,NaN,NaN,411.83940000000007,426.4503911559357,397.22840884406446,404.07267008173983,404.84,404.84,404.84,856888,656213.6,35.9814700347239,43.83684556890312,NaN,NaN,NaN,NaN,5.525894871475878,12.459372461936404,165004526,-0.9662772859744435,-2.6619882425002857,-1.6957109565258421
2024-09-06T13:30:00-04:00,402.45,402.67,400.79,401.75,NaN,NaN,NaN,417.6985528521407,NaN,NaN,411.5340000000001,426.3361814608096,396.7318185391906,404.07267008173983,403.47862611104773,405.0185800399725,401.93867218212296,669674,659505.4666666667,35.28060380672177,43.119185517030836,NaN,NaN,NaN,NaN,5.2654738092276006,13.132869504541638,164334852,-1.1115781474430957,-3.0851836408297117,-1.973605493386616
2024-09-09T09:30:00-04:00,407.38,408.66,402.15,405.19,NaN,NaN,NaN,417.6985528521407,NaN,NaN,411.5248000000001,426.34216237792543,396.70743762207474,404.07267008173983,405.33333333333326,405.3333409627278,405.3333257039387,736256,651275.8333333334,41.32880526800421,43.244354389514264,NaN,NaN,NaN,NaN,5.382939965711345,12.21341405705683,165071108,-0.9068534010935863,-3.107172244753599,-2.2003188436600127
2024-09-09T13:30:00-04:00,405.17,405.91,402.84,405.77,NaN,NaN,NaN,417.6985528521407,NaN,NaN,411.4704000000001,426.35176443202334,396.58903556797685,404.07267008173983,405.164734961629,405.39872168299786,404.93074824026013,382255,650610.2666666667,42.3077618127524,43.31928009602233,NaN,NaN,NaN,NaN,5.217729968160539,11.35963399867808,165453363,-0.6739230105615559,-3.0427226068619575,-2.3687995963004016
2024-09-10T09:30:00-04:00,408.115,416.3,407.65,411.6,NaN,NaN,NaN,417.6985528521407,NaN,NaN,411.75680000000006,426.0752794946571,397.43832050534303,400.9145045891717,411.85,411.85000762939455,411.8499923706055,952632,664163.7666666667,51.13391176540358,43.13863596460305,NaN,NaN,NaN,NaN,5.597177827577645,12.413476038715178,166405995,-0.09894572275660796,-2.4924817497461618,-2.393536026989554
2024-09-10T13:30:00-04:00,411.57,414.72,411.57,414.23,NaN,NaN,NaN,417.6985528521407,NaN,NaN,412.1290000000001,425.69816931867405,398.5598306813261,400.9145045891717,412.474396362773,413.27723247504065,411.67156025050537,576225,668341.5666666667,54.51454701174475,43.71116066594753,NaN,NaN,NaN,NaN,5.422379411322102,13.392043647321053,166982220,0.45628766727807246,-1.8231764428919632,-2.2794641101700357
2024-09-11T09:30:00-04:00,414.935,417.28,409.59,417.05,NaN,NaN,NaN,417.6985528521407,NaN,NaN,412.3950000000001,425.8173701334299,398.9726298665703,402.32828293706984,414.6399999999999,414.6400093440617,414.63999065593805,811485,671548.6666666666,57.87938018335716,44.476476015134004,NaN,NaN,NaN,NaN,5.58435231051338,14.66969062245796,167793705,0.9811250971420322,-1.0530577387424955,-2.0341828358845278
2024-09-11T13:30:00-04:00,417.08,423.99,417.01,422.75,403.7332838170193,403.7332838170193,403.7332838170193,NaN,NaN,NaN,412.8616000000001,426.06762853846743,399.6555714615328,408.5386263496559,417.7333630106136,421.03157992051933,414.4351461007078,713812,673585.2333333333,63.721271821341155,45.29645906754697,NaN,NaN,NaN,NaN,5.684041431190997,16.665117267799815,168507517,1.6409567719497022,0.017013129052600107,-1.6239436428971021
2024-09-12T09:30:00-04:00,423.445,424.16,419.76,423.97,405.3554072798821,NaN,NaN,NaN,NaN,NaN,413.3170000000001,426.4532827313803,400.18071726861996,409.5989010797247,422.63000000000005,422.63000000000005,422.63000000000005,858957,675411.5666666667,64.84513598779819,46.711698090122574,NaN,NaN,NaN,NaN,5.5923241861059285,18.53636667850566,169366474,2.0611675511835745,0.9525157960823663,-1.1086517551012083
2024-09-12T13:30:00-04:00,424,427.36,424,427.09,409.36788876716014,NaN,NaN,NaN,NaN,NaN,413.89340000000004,426.8662810122956,400.9205189877045,414.0161208637798,424.19812619953404,425.94763597221544,422.44861642685265,690082,685070.7333333333,67.6087003943733,48.50324844113519,NaN,NaN,NaN,NaN,5.43501531566979,20.613521048763637,170056556,2.4257161953601907,1.9234934890990303,-0.5022227062611605
2024-09-13T09:30:00-04:00,425.74,431.52,425.46,431.26,412.09298473228927,NaN,NaN,NaN,NaN,NaN,414.4422,427.9736799131259,400.9107200868741,417.8148966910238,429.41333333333336,429.41333333333336,429.41333333333336,894787,682248.7666666667,70.90119768778746,50.642162997058094,NaN,NaN,NaN,NaN,5.479657078836233,22.932674929654915,170951343,2.7977464984492793,2.9949604168004385,0.1972139183511593
2024-09-13T13:30:00-04:00,431.29,431.83,429.71,430.7,414.82921269900334,NaN,NaN,NaN,NaN,NaN,414.99600000000004,428.8727373686779,401.11926263132216,419.80591735281905,429.8755536863544,430.51009773466524,429.2410096380436,474782,678259.5333333333,69.87401099898757,52.637869932951546,NaN,NaN,NaN,NaN,5.239681573205074,25.11400117301319,170476561,2.8467295371085646,3.755625839736865,0.9088963026283006
2024-09-16T09:30:00-04:00,430.3,433.51,428.25,429.89,414.946521212685,NaN,NaN,NaN,NaN,NaN,415.44199999999995,429.7642473096709,401.119752690329,421.26073388225524,430.55,430.55,430.55,1232147,684226.3333333334,68.33195087638424,54.73484915041013,NaN,NaN,NaN,NaN,5.24113288940471,27.293126448383497,169244414,2.668222348657951,4.244174238450739,1.5759518897927882
2024-09-16T13:30:00-04:00,429.94,431.7,429.87,431.46,415.3262247939266,NaN,NaN,NaN,NaN,NaN,415.9504,430.6998807827013,401.2009192172987,421.26073388225524,430.6718107363713,430.874776455802,430.4688450169406,443801,677893.4666666667,69.72654225834319,56.67394927912307,NaN,NaN,NaN,NaN,4.997480540161516,29.316599918370212,169688215,2.5022909562882107,4.703815585153052,2.201524628864841
2024-09-17T09:30:00-04:00,440.1,441.85,432.25,434.9,420.8770782123845,NaN,NaN,NaN,NaN,NaN,416.5134,431.9482471245853,401.0785528754147,428.0834696846434,436.3333333333333,436.3333333333333,436.3333333333333,1458732,707958.9333333333,72.57622420076788,59.28786029098336,NaN,NaN,NaN,NaN,5.382660501578554,31.970981548396953,171146947,2.46657603113321,5.284744667781354,2.8181686366481435
2024-09-17T13:30:00-04:00,434.91,435.65,433.14,435.07,420.8770782123845,NaN,NaN,NaN,NaN,NaN,417.0758,433.1132696707188,401.0383303292812,428.0834696846434,435.9591864234589,436.667037016514,435.25133583040383,407546,707866.4333333333,72.71292357680373,61.961597417417785,NaN,NaN,NaN,NaN,5.177470465751513,34.435764490564644,171554493,2.3000449139131733,5.69322477903961,3.393179865126437
2024-09-18T09:30:00-04:00,435.57,435.73,430.44,432.56,420.8770782123845,NaN,NaN,NaN,NaN,NaN,417.4408,434.0310500716314,400.85054992836865,428.0834696846434,432.91,432.91,432.91,626905,704776,67.37300443699232,63.82189735805979,NaN,NaN,NaN,NaN,5.185508289626407,35.890033135449926,170927588,1.8839769715404748,5.748151079552031,3.864174108011556
2024-09-18T13:30:00-04:00,432.62,436.04,430.44,430.78,420.8770782123845,NaN,NaN,NaN,NaN,NaN,417.77700000000004,434.7491919621208,400.8048080378793,428.0834696846434,432.6269468706694,432.8689736447254,432.3849200966135,857454,722041.9666666667,63.79500151970897,65.35670019427097,NaN,NaN,NaN,NaN,5.215114840367379,37.26820082734581,170070134,1.3756080805319684,5.583684208676516,4.208076128144548
2024-09-19T09:30:00-04:00,441.25,441.49,436.89,438.34,422.61878085437615,NaN,NaN,NaN,NaN,NaN,418.21520000000004,436.13080849759285,400.2995915024072,428.0834696846434,438.9066666666667,438.9066666666667,438.9066666666667,1056553,736968.2333333333,70.87072598858407,66.76647263878387,NaN,NaN,NaN,NaN,5.607606637483998,38.996258581469675,171126687,1.428957971376093,5.994273592364664,4.565315620988571
2024-09-19T13:30:00-04:00,438.37,439.88,437.68,438.61,422.66201808826816,NaN,NaN,NaN,NaN,NaN,418.6568000000001,437.45141686332477,399.8621831366754,428.0834696846434,438.84204800238615,438.92963329409895,438.75446271067335,575102,742210.7666666667,71.08804935573853,67.95029423478343,NaN,NaN,NaN,NaN,5.364206163377998,40.600883638870414,171701789,1.3630979694536336,6.269188082805613,4.906090113351979
2024-09-20T09:30:00-04:00,437.24,439.2,434.25,436.92,422.66201808826816,NaN,NaN,NaN,NaN,NaN,419.0130000000001,438.491121983369,399.5348780166312,428.0834696846434,436.79,436.79,436.79,749776,731223.7666666667,67.68418987292003,68.65063778403791,NaN,NaN,NaN,NaN,5.334620008850997,41.02126466950056,170952013,1.097782609272417,6.278318374942501,5.180535765670084
2024-09-20T13:30:00-04:00,436.94,437.91,435.16,435.16,422.66201808826816,NaN,NaN,NaN,NaN,NaN,419.2944000000001,439.28423307981564,399.3045669201846,428.0834696846434,436.4616315728104,436.8171738637733,436.1060892818475,639546,732264.1666666666,64.2346962432486,68.6873109570313,NaN,NaN,NaN,NaN,5.15000429393307,41.41161848365713,170312467,0.7143914591281737,6.073525089580301,5.359133630452127
2024-09-23T09:30:00-04:00,434.28,436.46,430.41,432.99,422.66201808826816,NaN,NaN,NaN,NaN,NaN,419.56380000000007,439.9182738629913,399.2093261370088,428.0834696846434,433.28666666666663,433.28667429606116,433.2866590372721,623898,727532.1333333333,60.163404139662354,68.35290153930731,NaN,NaN,NaN,NaN,5.2142897015092755,40.417568040633284,169688569,0.24929720415059986,5.670755135640377,5.421457931489777
2024-09-23T13:30:00-04:00,432.99,434.44,432.98,433.4,422.66201808826816,NaN,NaN,NaN,NaN,NaN,419.86100000000005,440.57772454803427,399.1442754519658,428.0834696846434,433.37768176048695,433.5220461698944,433.2333173510795,247982,715509.7,60.67061500654712,67.85732401160544,NaN,NaN,NaN,NaN,4.946126151401468,39.49452120068257,169936551,-0.07854459081294785,5.323277192973592,5.40182178378654
2024-09-24T09:30:00-04:00,433.05,433.37,426.1,428.98,422.66201808826816,NaN,NaN,NaN,NaN,NaN,420.06920000000014,440.93851827920406,399.1998817207962,426.3246953462639,429.48333333333335,429.48333333333335,429.48333333333335,953431,720658.4666666667,52.85731462174435,66.56847522117378,NaN,NaN,NaN,NaN,5.114259997729931,37.008794862019116,168983120,-0.6112334914657778,4.637779919454317,5.249013410920095
2024-09-24T13:30:00-04:00,429,429.49,427.56,429.21,422.66201808826816,NaN,NaN,NaN,NaN,NaN,420.2224000000001,441.2448518303365,399.19994816966374,426.3246953462639,429.2743186702387,429.6043089347635,428.9443284057139,382508,712286.1,53.19509756703973,65.37712426174895,NaN,NaN,NaN,NaN,4.886812855034937,34.70062040468877,169365628,-0.9462468954988221,4.066204791546568,5.01245168704539
2024-09-25T09:30:00-04:00,429.92,433.12,428.57,432.17,422.66201808826816,NaN,NaN,NaN,NaN,NaN,420.39080000000007,441.65706768943886,399.1245323105613,426.3246953462639,431.2866666666667,431.2866666666667,431.2866666666667,699733,709990.9333333333,57.42319536217592,64.5979274393055,NaN,NaN,NaN,NaN,4.862754793961014,33.228791604472654,170065361,-0.9634202613354024,3.8081763603761374,4.77159662171154
2024-09-25T13:30:00-04:00,432.16,432.55,430.95,432.12,422.66201808826816,NaN,NaN,NaN,NaN,NaN,420.5358000000001,442.02000148478425,399.05159851521597,426.3246953462639,431.46999585700814,431.74192145891834,431.19807025509795,318050,708675.4333333333,57.32898668152323,63.71238775524692,NaN,NaN,NaN,NaN,4.629700880106658,31.862093432843402,169747311,-0.9703727310361172,3.558630707916393,4.52900343895251
2024-09-26T09:30:00-04:00,435.085,435.33,429.14,429.68,422.66201808826816,NaN,NaN,NaN,NaN,NaN,420.64940000000007,442.2653327941,399.03346720590014,426.3246953462639,431.3833333333334,431.3833333333334,431.3833333333334,826192,706477,52.77842989931122,62.298259590857164,NaN,NaN,NaN,NaN,4.741150817241897,31.08728751789315,168921119,-1.1208670218843704,3.1279196615970477,4.248786683481418
2024-09-26T13:30:00-04:00,429.65,431.6,429.55,431.33,422.66201808826816,NaN,NaN,NaN,NaN,NaN,420.79600000000005,442.5994511029565,398.9925488970436,425.88075627701113,431.1877830925962,431.4535205645531,430.92204562063927,447396,705486.2333333333,55.35892881458507,61.058688536412966,NaN,NaN,NaN,NaN,4.548925758867476,30.367824882582195,169368515,-1.089872458269217,2.886446110644897,3.976318568914114
2024-09-27T09:30:00-04:00,431.66,431.85,427.46,428.8,422.66201808826816,NaN,NaN,NaN,NaN,NaN,421.04320000000007,442.92362940709734,399.1627705929028,425.87960502160894,429.3699999999999,429.3700053947965,429.36999460520326,652837,698684.5333333333,50.77696885165061,59.87325742317427,NaN,NaN,NaN,NaN,4.5375739189483735,29.13249853143765,168715678,-1.2110227779075138,2.4625400965297217,3.6735628744372355
2024-09-27T13:30:00-04:00,428.79,430.14,427.54,428.09,422.66201808826816,NaN,NaN,NaN,NaN,NaN,421.29240000000004,443.20434105868117,399.3804589413189,424.5947313110277,429.07589662457315,429.45392286365393,428.69787038549237,395149,689533.7,49.53782129454482,58.85488740709112,NaN,NaN,NaN,NaN,4.39917578188063,27.985409776803426,168320529,-1.3022753488622794,2.0457186883593863,3.3479940372216657
2024-09-30T09:30:00-04:00,428.13,429.52,425.57,427.48,422.66201808826816,NaN,NaN,NaN,NaN,NaN,421.55200000000013,443.4434496550357,399.6605503449646,424.5947313110277,427.5233333333333,427.5233333333333,427.5233333333333,539789,682984.8,48.44398511295099,57.252977344545904,NaN,NaN,NaN,NaN,4.367091797460584,26.379627264876447,167780740,-1.3606550642756687,1.6471752068770797,3.0078302711527485
2024-09-30T13:30:00-04:00,427.49,430.42,425.35,430.23,422.66201808826816,NaN,NaN,NaN,NaN,NaN,421.8238000000001,443.8018450049365,399.8457549950637,424.5947313110277,428.1070534923302,428.6785930719963,427.53551391266404,563042,689011.0333333333,53.43576469201154,55.992099868565404,NaN,NaN,NaN,NaN,4.417299526213399,25.103742094697605,168343782,-1.177841790987776,1.5355280324180285,2.7133698234058046
2024-10-01T09:30:00-04:00,428.43,428.46,418.81,420.07,NaN,NaN,NaN,438.56164453707885,438.56164453707885,438.56164453707885,421.95540000000017,443.8107214425846,400.1000785574157,424.5947313110277,422.44666666666666,422.44666666666666,422.44666666666666,1065449,692771.6,38.575332626065496,53.91289577950437,NaN,NaN,NaN,NaN,4.917492417198157,24.250024239259503,167278333,-1.6746382991284965,0.6200719494951841,2.2947102486236806
2024-10-01T13:30:00-04:00,420.03,423.74,419.98,420.63,NaN,NaN,NaN,436.6208879672117,NaN,NaN,422.09540000000015,443.8249243242645,400.3658756757358,424.5947313110277,422.1294339444777,422.59369537916564,421.6651725097897,497466,690146.3,39.57282752508841,52.15133372820721,NaN,NaN,NaN,NaN,4.834814387398288,23.457286230638406,167775799,-1.8834159626117017,-0.05955970464094662,1.8238562579707551
2024-10-02T09:30:00-04:00,422.59,422.89,416.71,418.2,NaN,NaN,NaN,434.7326657868838,NaN,NaN,422.20640000000014,443.79805644777423,400.61474355222606,424.5947313110277,419.26666666666665,419.26666666666665,419.26666666666665,1027305,697340.3,36.78156309398297,50.4812022249444,NaN,NaN,NaN,NaN,4.930899074012696,23.36493859729082,166748494,-2.087246652867357,-0.7852020581134411,1.3020445947539159
2024-10-02T13:30:00-04:00,418.2,418.97,417.04,417.13,NaN,NaN,NaN,432.5220900692982,NaN,NaN,422.27100000000013,443.7820394913572,400.7599605086431,424.5947313110277,418.7418230828989,419.4765313556249,418.00711481017294,524239,691021.2,35.59112238300057,48.689809894691074,NaN,NaN,NaN,NaN,4.716549140154647,23.279187223468064,166224255,-2.185742254424946,-1.4301332232772666,0.7556090311476794
2024-10-03T09:30:00-04:00,417.63,419.55,414.29,415.51,NaN,NaN,NaN,431.4944950661483,NaN,NaN,422.3824000000001,443.69361265810477,401.0711873418954,421.9867850488222,416.44999999999993,416.45000539479656,416.4499946052033,855808,690916.2333333333,33.80709559557168,47.32907996425017,NaN,NaN,NaN,NaN,4.755367058715028,23.710567884272898,165368447,-2.243170527248044,-2.0483541279123756,0.1948163993356684
2024-10-03T13:30:00-04:00,415.5,417.07,414.99,416.53,NaN,NaN,NaN,430.22565438132335,NaN,NaN,422.4976000000001,443.6178964221369,401.3773035778633,421.96442803905774,416.36649617761316,416.48558191705547,416.24741043817085,420794,681939.9666666667,35.982927486368,46.09963924420219,NaN,NaN,NaN,NaN,4.564269411663953,24.11113564073453,165789241,-2.098256837212708,-2.4280046471802166,-0.32974780996750863
2024-10-04T09:30:00-04:00,418.24,419.7,415,418.15,NaN,NaN,NaN,430.22565438132335,NaN,NaN,422.49700000000007,443.61778871630963,401.3762112836905,420.93154243124616,417.6166666666666,417.6166666666666,417.6166666666666,748722,677071.1333333333,39.39056701690455,44.81159436239709,NaN,NaN,NaN,NaN,4.573964453687956,23.628533401760674,166537963,-1.7910427899067534,-2.5685512973509503,-0.777508507444197
2024-10-04T13:30:00-04:00,418.06,418.32,416,416.01,NaN,NaN,NaN,430.22565438132335,NaN,NaN,422.5540000000001,443.5888959588353,401.5191040411649,420.4115871559976,417.2426113038985,417.66009075291987,416.82513185487716,601066,681280.6,36.6176804123805,43.33221534317261,NaN,NaN,NaN,NaN,4.412966992710244,23.18040275128495,165936897,-1.6340789580964832,-2.820107205064801,-1.1860282469683177
2024-10-07T09:30:00-04:00,415.98,417.1,413.08,413.36,NaN,NaN,NaN,428.87067385663374,NaN,NaN,422.54920000000016,443.59237460457956,401.50602539542075,420.4115871559976,414.5133333333333,414.5133333333333,414.5133333333333,1024919,674373,33.47515196012128,41.953409776087604,NaN,NaN,NaN,NaN,4.384897921802372,23.392653091103213,164911978,-1.6083399660237223,-3.1964532044979705,-1.5881132384742482
2024-10-07T13:30:00-04:00,413.35,413.67,409,409.57,NaN,NaN,NaN,425.12609777224134,NaN,NaN,422.3988000000001,443.7017870731555,401.0958129268447,414.74326972479804,412.91606582157846,414.7775466273162,411.0545850158407,754619,684733.6,29.566982297619106,40.11112788201861,NaN,NaN,NaN,NaN,4.405262355959346,24.31798698173335,164157359,-1.7352858463827956,-3.757220546452743,-2.0219347000699472
2024-10-08T09:30:00-04:00,410.9,414.83,408.17,412.92,NaN,NaN,NaN,425.12609777224134,NaN,NaN,422.42340000000013,443.6796550266733,401.16714497332697,410.88661577983845,411.97333333333336,411.97333333333336,411.97333333333336,898041,666043.9,36.61150500057666,39.09930903551333,NaN,NaN,NaN,NaN,4.56631504481939,24.78223563616227,165055400,-1.4916637468538294,-3.886514383637234,-2.3948506367834046
2024-10-08T13:30:00-04:00,412.93,415.66,412.64,414.68,NaN,NaN,NaN,425.12609777224134,NaN,NaN,422.52600000000007,443.58128760190965,401.4707123980905,409.51729262387073,412.84488070422685,413.9812990513914,411.70846235706233,528204,670065.8333333334,40.00644733318184,38.4184966097017,NaN,NaN,NaN,NaN,4.455863970189436,24.93015492763133,165583604,-1.126618171707979,-3.803123351418378,-2.676505179710399
2024-10-09T09:30:00-04:00,416,420.36,414.31,418.49,NaN,NaN,NaN,425.12609777224134,NaN,NaN,422.7322000000001,443.4202059125804,402.0441940874198,408.86325905873747,417.72,417.72,417.72,845051,677337.3666666667,46.66570079551484,38.29147630131339,NaN,NaN,NaN,NaN,4.56973082946162,23.654195048076495,166428655,-0.571209005136533,-3.3905164361310653,-2.8193074309945323
2024-10-09T13:30:00-04:00,418.46,418.54,416.6,417.46,NaN,NaN,NaN,425.12609777224134,NaN,NaN,422.9062000000001,443.26494215758163,402.5474578424186,408.86325905873747,417.65298923465303,417.74253382406636,417.5634446452397,473253,664530.6666666666,45.20485955315018,37.70355450568045,NaN,NaN,NaN,NaN,4.381892913071504,22.469375159918435,165955402,-0.23317468570797528,-3.1107757881295015,-2.8776011024215262
2024-10-10T09:30:00-04:00,415.225,417.335,413.13,416.15,NaN,NaN,NaN,425.12609777224134,NaN,NaN,423.10340000000014,443.00030131047555,403.2064986895247,408.86325905873747,415.5383333333333,415.5383333333333,415.5383333333333,693862,652440.9666666667,43.346301910973004,38.04433802603098,NaN,NaN,NaN,NaN,4.378186276423539,22.15129255407331,165261540,-0.0664445204115478,-2.960656752935961,-2.894212232524413
2024-10-10T13:30:00-04:00,416.16,416.26,414.7,415.76,NaN,NaN,NaN,425.12609777224134,NaN,NaN,423.2520000000001,442.8134960572746,403.6905039427256,408.86325905873747,415.55238570677716,415.56954274358316,415.53522866997116,465466,648786.4333333333,42.78236093336736,38.273590412336624,NaN,NaN,NaN,NaN,4.1768872566790005,21.855930134359987,164796074,0.04303894022910093,-2.840413557238037,-2.883452497467138
2024-10-11T09:30:00-04:00,416.08,417.14,413.25,414.68,NaN,NaN,NaN,425.12609777224134,NaN,NaN,423.49660000000006,442.3028034913772,404.69039650862294,408.7560885826937,415.02333333333326,415.0233409627278,415.0233257039387,832261,651535.9333333333,41.18442826910301,38.58808078198805,NaN,NaN,NaN,NaN,4.156395309773357,21.897976613887064,163963813,0.06676968904002223,-2.79999038616711,-2.8667600752071323
2024-10-11T13:30:00-04:00,414.69,416.5,414.42,416.31,NaN,NaN,NaN,425.12609777224134,NaN,NaN,423.78780000000006,441.66607476685436,405.90952523314576,408.7560885826937,415.27291823804575,415.61556748545024,414.93026899064125,441567,644936.6333333333,44.55062076851423,39.22804495238188,NaN,NaN,NaN,NaN,4.008081359075259,21.937019773447922,164405380,0.20830198163466207,-2.6063825981638047,-2.8146845797984668
2024-10-14T09:30:00-04:00,417.64,424.03,417.52,420.44,NaN,NaN,NaN,425.12609777224134,NaN,NaN,424.09280000000007,441.1950506308094,406.9905493691907,413.4473106454216,420.66333333333336,420.66333333333336,420.66333333333336,872072,653209.1,52.04040434329256,40.53042414864766,NaN,NaN,NaN,NaN,4.273218404855596,20.913757519059516,165277452,0.5753200402218455,-2.09553452952116,-2.6708545697430055
2024-10-14T13:30:00-04:00,420.46,421.3,419,419.13,NaN,NaN,NaN,425.12609777224134,NaN,NaN,424.36000000000007,440.70973223019257,408.01026776980757,413.4473106454216,420.3059857600709,420.7269837502398,419.88498776990195,628310,665886.7,49.74515791002331,41.51344060748018,NaN,NaN,NaN,NaN,4.132274233080198,19.963585425698852,164649142,0.7159491535331926,-1.7759181278265146,-2.491867281359707
2024-10-15T09:30:00-04:00,422.2,422.48,415.28,416.92,NaN,NaN,NaN,425.12609777224134,NaN,NaN,424.4664000000001,440.5496627336281,408.38313726637205,413.4473106454216,418.2266666666667,418.2266666666667,418.2266666666667,816346,661317.2,46.05479423641368,41.98945683744512,NaN,NaN,NaN,NaN,4.351397502145901,18.941687882869253,163832796,0.6482423609515116,-1.6815643301703176,-2.329806691121829
2024-10-15T13:30:00-04:00,416.91,418.92,416.36,418.69,NaN,NaN,NaN,425.12609777224134,NaN,NaN,424.5556,440.45925198811847,408.6519480118816,413.4473106454216,418.13719526927764,418.25195487194225,418.02243566661303,496209,665107.2333333333,49.298944975010976,42.89526144906158,NaN,NaN,NaN,NaN,4.223440537706908,17.992783021670338,164329005,0.7060207871683568,-1.447280707161383,-2.1533014943297397
2024-10-16T09:30:00-04:00,415.03,416.03,410.48,414.68,NaN,NaN,NaN,425.12609777224134,NaN,NaN,424.50820000000004,440.5148434657375,408.5015565342626,413.4473106454216,413.72999999999996,413.7300053947966,413.72999460520333,844012,669916.5333333333,42.99108091074458,43.57497065982039,NaN,NaN,NaN,NaN,4.508194785013556,18.354007701099693,163484993,0.46894681584543685,-1.5671179745229438,-2.0360647903683806
2024-10-16T13:30:00-04:00,414.69,416.36,414.27,416.09,NaN,NaN,NaN,425.12609777224134,NaN,NaN,424.37500000000017,440.54792960470206,408.2020703952983,413.4473106454216,414.2627494374952,415.0983407450843,413.4271581299061,343089,670751.1666666666,45.625584099200935,44.722013645647664,NaN,NaN,NaN,NaN,4.335466586084019,18.592574986723324,163828082,0.4043157965479356,-1.5306700446834611,-1.9349858412313967
2024-10-17T09:30:00-04:00,422.36,422.5,415.59,417.63,NaN,NaN,NaN,425.12609777224134,NaN,NaN,424.24820000000017,440.53088463855767,407.96551536144267,413.4473106454216,418.57333333333327,418.57333333333327,418.57333333333327,654427,665025.6666666666,48.42875654999449,45.56610304203464,NaN,NaN,NaN,NaN,4.519361829935162,17.2871559499198,164482509,0.45853152244542494,-1.3618214381746157,-1.8203529606200406
2024-10-17T13:30:00-04:00,417.61,418.12,415.59,416.79,NaN,NaN,NaN,425.12609777224134,NaN,NaN,424.0422000000001,440.436100958559,407.6482990414412,413.4473106454216,417.96103557793714,418.7919925883462,417.1300785675281,355328,661956.7333333333,47.00529658376911,46.066020845648026,NaN,NaN,NaN,NaN,4.377264556368368,16.07498113003081,164127181,0.4314648818711806,-1.2810218582810649,-1.7124867401522454
2024-10-18T09:30:00-04:00,417.52,419.65,416.27,417.37,NaN,NaN,NaN,425.12609777224134,NaN,NaN,423.7644000000001,440.13037160449335,407.3984283955068,413.4473106454216,417.7633333333333,417.7633333333333,417.7633333333333,634780,661354.8333333334,48.13878737787513,46.17124131581661,NaN,NaN,NaN,NaN,4.306031373770627,15.303080743750547,164761961,0.444508593596892,-1.1568509981561306,-1.6013595917530226
2024-10-18T13:30:00-04:00,417.43,418.22,416.9,418.13,NaN,NaN,NaN,425.12609777224134,NaN,NaN,423.51300000000015,439.8312024745067,407.1947975254936,413.4473106454216,417.75873838063677,417.7650749728753,417.75240178839823,333790,659309.5333333333,49.65822996535992,46.48933920240302,NaN,NaN,NaN,NaN,4.0927434185013,14.586316099347446,165095751,0.49248297864270296,-0.9857558684496439,-1.4782388470923469
2024-10-21T09:30:00-04:00,416.12,418.1,413.78,416.36,NaN,NaN,NaN,425.12609777224134,NaN,NaN,423.24240000000015,439.57735567667225,406.90744432332804,411.6838485163373,416.08,416.08,416.08,657062,663218.6333333333,46.258987760456584,46.69738819165185,NaN,NaN,NaN,NaN,4.111118888608352,13.9586058247552,164438689,0.39725517868189764,-0.9816698737399747,-1.3789250524218724
2024-10-21T13:30:00-04:00,416.43,418.96,416.31,418.8,NaN,NaN,NaN,425.12609777224134,NaN,NaN,422.98920000000015,439.1987901687523,406.779609831248,411.1870788130699,416.77474460731924,417.70611471858564,415.84337449605283,365605,656637.4,51.21651325304091,47.2998276430571,NaN,NaN,NaN,NaN,4.006753253707753,13.147037467716233,164804294,0.48502996184036706,-0.7726376001214135,-1.2576675619617805
2024-10-22T09:30:00-04:00,418.46,429.4,418.04,427.37,410.1308324760911,410.1308324760911,410.1308324760911,NaN,NaN,NaN,422.83860000000016,438.7397330463883,406.937466953612,416.6254093080057,424.9366666666666,424.93667429606114,424.9366590372721,1575530,673640.1,63.83534434122845,48.91775021963749,NaN,NaN,NaN,NaN,4.531985164157197,14.099915285498236,166379824,1.0730027173824843,0.08358583476632475,-0.9894168826161595
2024-10-22T13:30:00-04:00,427.4,430.55,427.17,427.42,415.4276128180869,NaN,NaN,NaN,NaN,NaN,422.68560000000014,438.2568222564243,407.114377743576,418.6403274464046,426.0188582561276,427.6173599723576,424.4203565398976,722119,681128.5333333333,63.89402557350541,50.29942199142257,NaN,NaN,NaN,NaN,4.44970050957454,15.155563684476272,167101943,1.397495282179606,0.7574522201083482,-0.6400430620712578
2024-10-23T09:30:00-04:00,430.99,431.08,424.61,425.12,415.4276128180869,NaN,NaN,NaN,NaN,NaN,422.53680000000014,437.86808171546517,407.2055182845351,418.6403274464046,426.93666666666667,426.93666666666667,426.93666666666667,1111657,683940.2666666667,59.14023087902238,50.80655245826042,NaN,NaN,NaN,NaN,4.594007616033499,15.469765140052566,165990286,1.3866764470283335,1.0933024967141591,-0.2933739503141744
2024-10-23T13:30:00-04:00,425.08,425.55,422.53,424.67,415.4276128180869,NaN,NaN,NaN,NaN,NaN,422.4146000000001,437.57759717599333,407.2516028240069,418.6403274464046,426.1527513836957,427.3740604720974,424.931442295294,457992,681732.0333333333,58.22742771579619,51.41242887295848,NaN,NaN,NaN,NaN,4.481578500602538,15.253089087775612,165532294,1.2811602256106749,1.3080763316991693,0.026916106088494318
2024-10-24T09:30:00-04:00,425.36,425.95,422.4,424.62,415.4276128180869,NaN,NaN,NaN,NaN,NaN,422.1402000000001,436.62173775810066,407.65866224189955,418.6403274464046,424.32333333333327,424.32333333333327,424.32333333333327,563631,671992.8,58.12008747777073,52.27423553305541,NaN,NaN,NaN,NaN,4.415037179130929,15.128071952091021,164968663,1.1444278939792625,1.4574509735625725,0.31302307958330994
2024-10-24T13:30:00-04:00,424.6,425.25,423.59,424.81,415.4276128180869,NaN,NaN,NaN,NaN,NaN,421.86420000000015,435.5857200848508,408.14267991514953,418.6403274464046,424.3948924378052,424.5002459297449,424.2895389458655,260032,666634.0666666667,58.43366502748025,52.92671553680322,NaN,NaN,NaN,NaN,4.218248809193007,15.011984611812473,165228695,1.008005500638018,1.5730299553808322,0.5650244547428144
2024-10-25T09:30:00-04:00,426.87,432.52,426.31,428.42,415.9710652425244,NaN,NaN,NaN,NaN,NaN,421.69420000000014,434.8649488564281,408.5234511435722,420.8642624976378,429.0833333333333,429.0833333333333,429.0833333333333,980973,674375.7666666667,63.95586454622647,54.42420008219478,NaN,NaN,NaN,NaN,4.467659608536362,16.166386771809442,166209668,1.094887819720666,1.9336342293936468,0.8387464096729809
2024-10-25T13:30:00-04:00,428.38,429.32,426.98,428.15,415.9710652425244,NaN,NaN,NaN,NaN,NaN,421.55400000000014,434.2904817747703,408.81751822523,420.8642624976378,428.82532965270013,429.2427473524479,428.40791195295236,374772,666832.6333333333,63.2787386553823,55.68513969335059,NaN,NaN,NaN,NaN,4.315683922212335,17.238331634663773,165834896,1.067070685260158,2.1725847662481783,1.1055140809880204
2024-10-28T09:30:00-04:00,431.54,431.92,427.01,427.57,416.2413321734572,NaN,NaN,NaN,NaN,NaN,421.4456000000001,433.87957677974555,409.0116232202547,421.06932799848823,428.8333333333333,428.8333333333333,428.8333333333333,596509,652552.3,61.76591999352304,56.63779422503121,NaN,NaN,NaN,NaN,4.358135070625742,18.61773906373357,165238387,0.9466048298491463,2.2887701182994533,1.342165288450307
2024-10-28T13:30:00-04:00,427.64,428.09,426.3,426.71,416.2413321734572,NaN,NaN,NaN,NaN,NaN,421.3118000000002,433.36653629072623,409.2570637092741,421.06932799848823,428.1507296736736,429.02407887712354,427.27738047022365,364400,639545,59.49468349292346,57.5298932899708,NaN,NaN,NaN,NaN,4.174696851295328,19.67958527156151,164873987,0.7543571204967945,2.2851116890713,1.5307545685745056
2024-10-29T09:30:00-04:00,428,432.23,425.83,431.19,416.2413321734572,NaN,NaN,NaN,NaN,NaN,421.3560000000001,433.53840764378,409.17359235622024,421.3695699190325,429.75,429.75,429.75,712425,633357.8,66.4215700646235,58.83580633902426,NaN,NaN,NaN,NaN,4.333647076202808,21.252776431060976,165586412,0.8662628706560347,2.613583156894549,1.7473202862385144
2024-10-29T13:30:00-04:00,431.21,433.17,430.75,432.04,419.073373615551,NaN,NaN,NaN,NaN,NaN,421.4126000000001,433.7655447889609,409.05965521103934,423.27165593522597,430.5798900769047,431.66038530237364,429.49939485143574,420276,629760.2,67.55526415732783,60.114165924164816,NaN,NaN,NaN,NaN,4.19695799933118,22.83574012909709,166006688,0.9293073244993519,2.9089544418627042,1.9796471173633523
2024-10-30T09:30:00-04:00,437.435,438.52,432.59,437.4,422.3704929966622,NaN,NaN,NaN,NaN,NaN,421.5172000000002,434.313351946544,408.72104805345634,427.3613247481808,436.1699999999999,436.1699999999999,436.1699999999999,1398258,648200.4333333333,73.60671480926675,62.06757499907984,NaN,NaN,NaN,NaN,4.360032427950379,24.921584167607104,167404946,1.2441211544115083,3.5347985603777374,2.290677405966229
2024-10-30T13:30:00-04:00,437.39,437.45,432.17,433.5,422.3704929966622,NaN,NaN,NaN,NaN,NaN,421.5448000000002,434.4378953552309,408.65170464476944,427.3613247481808,435.4247698341415,436.3099603208983,434.5395793473847,991048,665460.2666666667,64.22082154431851,62.996454162742516,NaN,NaN,NaN,NaN,4.425744397382492,26.72030255544734,166413898,1.1064489197688028,3.6737385556772324,2.5672896359084296
2024-10-31T09:30:00-04:00,415.01,416.16,406.29,408.88,NaN,NaN,NaN,427.63588344725605,427.63588344725605,427.63588344725605,421.1288000000002,434.2846708658548,407.97292913414555,427.3613247481808,410.4433333333333,410.4433333333333,410.4433333333333,3885463,771846.9666666667,34.399810948338796,60.8939160632504,NaN,NaN,NaN,NaN,6.053191226140884,26.140469856369748,162528435,-0.6324396231942551,1.7767401069156108,2.409179730109866
2024-10-31T13:30:00-04:00,408.85,411.22,406.3,406.32,NaN,NaN,NaN,425.0958432905626,NaN,NaN,420.6286000000002,434.0931840692959,407.16401593070447,427.3613247481808,409.7195280992404,410.8523150978383,408.5867411006425,1586316,809208.6333333333,32.699515403888356,58.66573676542061,NaN,NaN,NaN,NaN,5.972248995702251,25.602053778654838,160942119,-1.874524995050237,0.06602348629706967,1.9405484813473066
2024-11-01T09:30:00-04:00,409.25,415.48,407.49,414.5,NaN,NaN,NaN,425.0958432905626,NaN,NaN,420.3426000000002,433.707886265516,406.97731373448437,427.3613247481808,412.49,412.49,412.49,1461817,830193.8333333334,42.48240401418993,57.47589198936115,NaN,NaN,NaN,NaN,6.199945496009235,24.421319888824538,162403936,-2.050437465248831,-0.622498350213732,1.4279391150350988
2024-11-01T13:30:00-04:00,414.55,414.55,409.85,410.01,NaN,NaN,NaN,425.0958432905626,NaN,NaN,419.9810000000001,433.466069224864,406.49593077513623,427.3613247481808,412.2027727601103,412.6615453588561,411.7440001613645,572993,834574.7,39.120886876712966,56.11113907228378,NaN,NaN,NaN,NaN,6.0928065320085745,23.32492413398212,161830943,-2.3527682323463157,-1.513021175397796,0.8397470569485198
2024-11-04T09:30:00-05:00,410,410.42,405.57,407.58,NaN,NaN,NaN,424.6142078055879,NaN,NaN,419.5830000000002,433.3313620842252,405.8346379157752,427.3613247481808,407.8566666666666,407.8566666666666,407.8566666666666,792689,831928.6,37.39624526557604,54.630864628555585,NaN,NaN,NaN,NaN,6.004034636865106,22.86292517970548,161038254,-2.5816600382395407,-2.387327990850906,0.19433204738863463
2024-11-04T13:30:00-05:00,407.53,408.85,406.94,408.7,NaN,NaN,NaN,424.01924381442484,NaN,NaN,419.15240000000017,432.888566894706,405.41623310529434,427.3613247481808,407.96498553475175,408.11156250789054,407.81840856161296,432892,825414.6666666666,38.736805219810265,53.223946070864876,NaN,NaN,NaN,NaN,5.711603591374744,22.43392615073432,161471146,-2.5200860073122895,-2.9557754617517276,-0.43568945443943785
2024-11-05T09:30:00-05:00,408.24,414.9,408.23,411.78,NaN,NaN,NaN,424.01924381442484,NaN,NaN,418.98660000000024,432.87375758385224,405.09944241614824,427.3613247481808,411.6366666666666,411.6366666666666,411.6366666666666,936171,829408.8333333334,42.39022374205674,51.68354315628132,NaN,NaN,NaN,NaN,5.780060477705116,21.008184262369774,162407317,-2.148855022717603,-3.1217582328364415,-0.9729032101188385
2024-11-05T13:30:00-05:00,411.82,412.36,410.75,411.48,NaN,NaN,NaN,424.01924381442484,NaN,NaN,418.80360000000024,432.8396625589509,404.76753744104957,427.3613247481808,411.6001084783889,411.6507349430907,411.5494820136871,488168,829140.8,42.126704403131775,50.172683566834856,NaN,NaN,NaN,NaN,5.482199015011894,19.684281080316982,161919149,-1.8138036286970345,-3.240157745990132,-1.4263541172930974
2024-11-06T09:30:00-05:00,412.1,420.36,410.6,416.94,NaN,NaN,NaN,424.01924381442484,NaN,NaN,418.7784000000002,432.8232284346611,404.73357156533933,425.88305979854465,415.9666666666667,415.9666666666667,415.9666666666667,2084493,870490.1666666666,48.41233334376774,49.2188559489952,NaN,NaN,NaN,NaN,5.787756228225329,19.263831746085245,164003642,-1.1472690798996186,-2.8604404671676207,-1.713171387268002
2024-11-06T13:30:00-05:00,417,420.45,416.98,420.17,NaN,NaN,NaN,424.01924381442484,NaN,NaN,418.8392000000002,432.88127838744055,404.7971216125598,406.325211533959,416.86318007545935,418.31058824053207,415.41577191038664,799709,885710.8333333334,51.75085868715029,48.66572560572568,NaN,NaN,NaN,NaN,5.625059354780662,18.885236985721967,164803351,-0.4476066860397192,-2.2726797448176512,-1.825073058777932
2024-11-07T09:30:00-05:00,421.12,426.42,419.88,424.82,406.8645891990859,406.8645891990859,406.8645891990859,NaN,NaN,NaN,419.0254000000002,433.1327099972573,404.91809000274316,411.8501692271672,423.70666666666665,423.70666666666665,423.70666666666665,1120269,901238.9,56.15041972316033,47.93207200990689,NaN,NaN,NaN,NaN,5.690412258010617,19.274939978095514,165923620,0.32778340928906613,-1.4153437971665994,-1.7431272064556655
2024-11-07T13:30:00-05:00,424.81,426.85,423.82,425.6,409.37665332640023,NaN,NaN,NaN,NaN,NaN,419.2068000000002,433.413996734007,404.9996032659934,413.6791353817338,424.3065651305887,425.12506835560197,423.4880619055754,601779,909453.9333333333,56.86100485532704,47.16819634547826,NaN,NaN,NaN,NaN,5.500382811009861,19.68690034350522,166525399,0.8622694870727723,-0.6652903476147003,-1.5275598346874726
2024-11-08T09:30:00-05:00,425.235,426.5,421.86,422.52,409.37665332640023,NaN,NaN,NaN,NaN,NaN,419.2942000000003,433.5280582766146,405.06034172338593,413.6791353817338,423.6266666666667,423.6266666666667,423.6266666666667,900498,918311.2,53.195242825019335,45.71023406088916,NaN,NaN,NaN,NaN,5.438926895937727,19.680725919311122,165624901,0.9694414814353589,-0.31575798289327395,-1.2851994643286329
2024-11-08T13:30:00-05:00,422.49,424.07,421.8,422.91,409.37665332640023,NaN,NaN,NaN,NaN,NaN,419.4322000000003,433.66981176035205,405.19458823964857,413.6791353817338,423.40409570162694,423.7300739847681,423.07811741848576,419800,921178.2,53.603127156043605,44.95182731886952,NaN,NaN,NaN,NaN,5.212574974799317,19.662753200819854,166044701,1.0224008939345866,-0.007198346910399778,-1.0295992408449863
2024-11-11T09:30:00-05:00,422.515,424.82,416,418.81,409.37665332640023,NaN,NaN,NaN,NaN,NaN,419.54120000000023,433.6742572148743,405.4081427851262,413.6791353817338,419.8766666666666,419.8766666666666,419.8766666666666,1125014,936776.6,48.789450792294204,45.979658736294915,NaN,NaN,NaN,NaN,5.470248190885079,18.538877971150683,164919687,0.7497331214904751,-0.09243283898189247,-0.8421659604723676
2024-11-11T13:30:00-05:00,418.8,419.95,417.12,418.11,409.37665332640023,NaN,NaN,NaN,NaN,NaN,419.7120000000003,433.562505261494,405.86149473850656,413.6791353817338,419.45910049838426,420.1262049215651,418.79199607520343,440779,939282.4,47.996950783257766,47.07233269196415,NaN,NaN,NaN,NaN,5.281659034393287,17.49527954360074,164478908,0.5025334967052542,-0.21399908959079994,-0.7165325862960541
2024-11-12T09:30:00-05:00,417.83,421.78,417.13,421.77,409.37665332640023,NaN,NaN,NaN,NaN,NaN,419.88900000000024,433.61341284714666,406.1645871528538,413.6791353817338,420.22666666666663,420.22666666666663,420.22666666666663,972781,919190.7666666667,52.35468995648279,47.7774959735565,NaN,NaN,NaN,NaN,5.236540531936622,16.83735705511218,165451689,0.5613550650358204,-0.014838755001278514,-0.576193820037099
2024-11-12T13:30:00-05:00,421.74,424.44,421.68,422.91,409.37665332640023,NaN,NaN,NaN,NaN,NaN,420.05360000000024,433.7214658231231,406.3857341768774,413.6791353817338,421.1872887389919,422.51051837468395,419.8640591032999,512684,912209.6,53.65732270600314,48.8158128185058,NaN,NaN,NaN,NaN,5.059644779655434,16.660570965874953,165964373,0.6468013102215262,0.2323078177398088,-0.4144934924817174
2024-11-13T09:30:00-05:00,421.66,428.9,418.22,428.4,409.37665332640023,NaN,NaN,NaN,NaN,NaN,420.25180000000023,434.10931879085604,406.3942812091444,414.6949626124074,425.17333333333335,425.17333333333335,425.17333333333335,1122218,912561.6333333333,59.41235615886251,50.388392168026265,NaN,NaN,NaN,NaN,5.4610987239657565,17.150151263156985,167086591,1.0205888002748504,0.8612425078618458,-0.15934629241300474
2024-11-13T13:30:00-05:00,428.39,429.31,423.71,425.34,410.4980487777887,NaN,NaN,NaN,NaN,NaN,420.40940000000023,434.3154823584191,406.50331764158136,415.1459700899259,425.543764097407,426.00577654929356,425.08175164552046,721413,921342.3333333334,55.29086933186953,51.570825318887636,NaN,NaN,NaN,NaN,5.4710202436824895,17.66195947508448,166365178,1.0075412846691276,1.1000803134234047,0.09253902875427716
2024-11-14T09:30:00-05:00,424.94,428.18,420,426.54,410.4980487777887,NaN,NaN,NaN,NaN,NaN,420.61720000000025,434.57290652597095,406.66149347402956,415.1459700899259,424.9066666666667,424.9066666666667,424.9066666666667,1529205,953528.1333333333,56.56342621568108,52.58319692414652,NaN,NaN,NaN,NaN,5.66451879770517,17.315135899209256,167894383,1.0222839115546865,1.3703939181976352,0.3481100066429488
2024-11-14T13:30:00-05:00,426.57,427.73,425.84,426.75,410.87311882439013,NaN,NaN,NaN,NaN,NaN,420.8370000000002,434.82592433317035,406.8480756668301,415.1459700899259,425.4566953101289,426.3076880397516,424.6057025805062,638829,966154.7,56.79518481789122,53.63094552520077,NaN,NaN,NaN,NaN,5.394910312154804,16.99308543589655,168533212,0.9881625495061306,1.583313193525612,0.5951506440194814
2024-11-15T09:30:00-05:00,420.05,422.8,413.65,415.04,410.87311882439013,NaN,NaN,NaN,NaN,NaN,420.8442000000003,434.82080622035534,406.86759377964523,415.1459700899259,417.16333333333336,417.16333333333336,417.16333333333336,1192835,973216.7666666667,43.01337853354191,53.24530589589892,NaN,NaN,NaN,NaN,5.945273861286606,16.965854510133173,167340377,0.1622441089862734,0.7979557802523232,0.6357116712660498
2024-11-15T13:30:00-05:00,415.06,415.82,413.84,415,410.87311882439013,NaN,NaN,NaN,NaN,NaN,420.81800000000015,434.8333641408059,406.8026358591944,415.1459700899259,416.32481985889365,417.42295957221467,415.22668014557263,695481,983907.0666666667,42.97501677931082,52.61846004533896,NaN,NaN,NaN,NaN,5.66204001405185,16.940568650495756,166644896,-0.3722790416341455,0.17036286922336785,0.5426419108575133
2024-11-18T09:30:00-05:00,414.46,418.41,412.17,415.62,410.87311882439013,NaN,NaN,NaN,NaN,NaN,420.7216000000002,434.81214171275775,406.63105828724264,415.1459700899259,415.40000000000003,415.40000000000003,415.40000000000003,760517,989374,43.81150282552658,51.737108838365124,NaN,NaN,NaN,NaN,5.703322870191004,16.414149935102767,167405413,-0.6531725256374911,-0.27382374618935046,0.3793487794481406
2024-11-18T13:30:00-05:00,415.67,416.77,414.85,415.82,410.87311882439013,NaN,NaN,NaN,NaN,NaN,420.65540000000016,434.80620334677803,406.5045966532223,415.1459700899259,415.5429568267954,415.739558371756,415.34635528183475,402110,990631,44.096379218241644,50.8253498642876,NaN,NaN,NaN,NaN,5.433085522320215,15.925332556523566,167807523,-0.785685654136697,-0.6027582882227307,0.18292736591396633
2024-11-19T09:30:00-05:00,413.59,416.68,411.55,416.51,410.87311882439013,NaN,NaN,NaN,NaN,NaN,420.6472000000002,434.80712431614717,406.4872756838533,415.1459700899259,414.91333333333336,414.91333333333336,414.91333333333336,770037,992551.4,45.12996858346242,50.24925884703354,NaN,NaN,NaN,NaN,5.411436556440199,16.00054303556649,168577560,-0.7851889014433917,-0.7985587608902733,-0.013369859446881599
2024-11-19T13:30:00-05:00,416.52,417.93,415.49,417.63,410.87311882439013,NaN,NaN,NaN,NaN,NaN,420.6260000000002,434.80074825170215,406.45125174829826,415.1459700899259,415.63523489068524,416.6338628245996,414.6366069567709,402402,991955.6,46.84780924955991,49.76673613942756,NaN,NaN,NaN,NaN,5.199191088123042,15.800203467747679,168979962,-0.6721189728698285,-0.8535185755341672,-0.18139960266433872
2024-11-20T09:30:00-05:00,417.28,417.28,410.58,414.37,NaN,NaN,NaN,429.8351801003483,429.8351801003483,429.8351801003483,420.61980000000017,434.80521306551145,406.4343869344889,415.1459700899259,414.07666666666665,414.07666666666665,414.07666666666665,686762,968239.0666666667,42.66117743751892,49.32900232837218,NaN,NaN,NaN,NaN,5.331391724685682,16.3602176890358,168293200,-0.7724071434808962,-1.146908532015459,-0.37450138853456283
2024-11-20T13:30:00-05:00,414.32,416.28,413.05,415.42,NaN,NaN,NaN,429.8351801003483,NaN,NaN,420.60640000000024,434.81015767741854,406.4026423225819,414.4480208575526,414.42653582465584,414.8406392718656,414.0124323774461,490230,951545.1333333333,44.38512029693351,49.07101443649187,NaN,NaN,NaN,NaN,5.181292315779559,16.880230894517627,168783430,-0.7243521624298341,-1.2799415915718555,-0.5555894291420214
2024-11-21T09:30:00-05:00,419.6,419.75,410.3,415.45,NaN,NaN,NaN,429.8351801003483,NaN,NaN,420.56280000000015,434.81613254503094,406.30946745496937,414.4480208575526,415.1666666666667,415.1666666666667,415.1666666666667,943003,853463.1333333333,44.43652231329404,48.505431033406964,NaN,NaN,NaN,NaN,5.48620000750959,16.570318904384877,169726433,-0.6492807613096229,-1.36719038077905,-0.7179096194694271
2024-11-21T13:30:00-05:00,415.43,415.98,412.36,412.83,NaN,NaN,NaN,429.8351801003483,NaN,NaN,420.48360000000025,434.86335563627,406.1038443637305,406.4125608596823,414.60536283567785,415.30898669733455,413.90173897402116,600106,820589.4666666667,40.88271706334769,47.59295920178871,NaN,NaN,NaN,NaN,5.352900006973191,16.282543484975893,169126327,-0.7288483253072147,-1.6289700261034454,-0.9001217007962308
2024-11-22T09:30:00-05:00,411,415.63,411,414.62,NaN,NaN,NaN,429.17938717085514,NaN,NaN,420.42860000000013,434.8764460733502,405.98075392665004,406.4125608596823,413.75,413.75,413.75,836224,799736.3666666667,44.16800280086113,46.50407681907433,NaN,NaN,NaN,NaN,5.3012642921893915,16.260232713347836,169962551,-0.6180724434020046,-1.6727122550487366,-1.054639811646732
2024-11-22T13:30:00-05:00,414.61,417.4,413.92,416.95,NaN,NaN,NaN,429.17938717085514,NaN,NaN,420.4050000000002,434.8716304300276,405.9383695699728,406.4125608596823,414.7982368179055,415.96188355443905,413.6345900813719,678577,803255.8333333334,48.2030657281689,45.99780513309571,NaN,NaN,NaN,NaN,5.171173985604432,15.808058626654505,170641128,-0.35792978136491205,-1.502052038352872,-1.1441222569879599
2024-11-25T09:30:00-05:00,418.125,421.09,414.81,416.65,NaN,NaN,NaN,429.17938717085514,NaN,NaN,420.41080000000017,434.87117003119766,405.95042996880267,408.34567714720043,417.51666666666665,417.51666666666665,417.51666666666665,890347,806511.1,47.72480869902221,45.36647531047722,NaN,NaN,NaN,NaN,5.250375843775543,14.791722379542602,169750781,-0.18482868493286686,-1.3751581131540433,-1.1903294282211765
2024-11-25T13:30:00-05:00,416.66,419.36,415.94,418.875,NaN,NaN,NaN,429.17938717085514,NaN,NaN,420.4123000000002,434.87201690037494,405.95258309962543,408.34567714720043,417.69748660492826,417.9529240398319,417.44204917002463,446152,806953.1,51.563251941001205,44.992765819270794,NaN,NaN,NaN,NaN,5.119634712077291,13.847981578652977,170196933,0.08620306204180705,-1.0825756006689176,-1.1687786627107246
2024-11-26T09:30:00-05:00,419.47,427.25,418.88,426.11,NaN,NaN,NaN,429.17938717085514,NaN,NaN,420.38710000000015,434.80255033493694,405.97164966506335,413.5381333742083,424.0799999999999,424.08000539479656,424.0799946052033,1411626,822801.6,61.470373558194666,46.31112260674599,NaN,NaN,NaN,NaN,5.3521608040717705,14.420637463360544,171608559,0.7239379330205249,-0.26385624643506844,-0.9877941794555933
2024-11-26T13:30:00-05:00,426.12,429.06,426.11,427.67,NaN,NaN,NaN,429.17938717085514,NaN,NaN,420.39210000000014,434.81747432302,405.9667256769803,416.6155066993666,425.2884517274982,426.9646101904334,423.61229326456305,733750,830987.6666666666,63.217347039002895,47.75700333958114,NaN,NaN,NaN,NaN,5.180577889495214,15.222809637921886,172342309,1.1942688590091186,0.5050418943058048,-0.6892269647033137
2024-11-27T09:30:00-05:00,425.33,427.21,423,423.75,NaN,NaN,NaN,429.17938717085514,NaN,NaN,420.36470000000014,434.7592204032326,405.9701795967677,416.6155066993666,424.65333333333336,424.65333333333336,424.65333333333336,730989,785870.8666666667,56.308414318167436,48.64963987476977,NaN,NaN,NaN,NaN,5.144108040245556,15.22920683538658,171611320,1.1825759330797079,0.7889929516463212,-0.39358298143338666
2024-11-27T13:30:00-05:00,423.75,424.89,422.05,422.79,NaN,NaN,NaN,429.17938717085514,NaN,NaN,420.3271000000002,434.6862183698359,405.9679816301645,416.6155066993666,424.1186183438594,424.80274407440544,423.43449261331335,446564,774099.3666666667,54.730886489972285,49.40924753703625,NaN,NaN,NaN,NaN,4.979528894513729,15.018079149214088,171164756,1.0555777127590802,0.9258891595154637,-0.12968855324361656
2024-11-29T09:30:00-05:00,420.05,424.89,417.82,423.46,NaN,NaN,NaN,429.17938717085514,NaN,NaN,420.3039000000002,434.63892749068856,405.9688725093119,416.6155066993666,422.0566666666667,422.0566666666667,422.0566666666667,1242983,778189.8333333334,55.66445045656107,50.16171052797187,NaN,NaN,NaN,NaN,5.12884825919132,13.968425341970757,172407739,0.9645827412065433,1.0760398732645626,0.11145713205801927
2024-12-02T09:30:00-05:00,421.7,432.77,421.35,430.75,411.9568192395428,411.9568192395428,411.9568192395428,NaN,NaN,NaN,420.4227000000002,435.0015149325961,405.8438850674043,417.0304155440606,428.28999999999996,428.28999999999996,428.28999999999996,1151508,796514.1333333333,64.29292105183274,51.40778994241993,NaN,NaN,NaN,NaN,5.5782162406776505,14.264189568078425,173559247,1.3211984705446085,1.76295522023878,0.4417567496941714
2024-12-02T13:30:00-05:00,430.74,431.94,430.04,430.99,415.115594174756,NaN,NaN,NaN,NaN,NaN,420.4741000000002,435.18287828913583,405.76532171086455,418.3983324352485,429.0456478408431,430.25777222017126,427.833523461515,447519,781414.8333333334,64.53761211056167,52.97039241906584,NaN,NaN,NaN,NaN,5.315486509200674,14.538827778035547,174006766,1.4867477212492588,2.300191401255745,0.8134436800064861
2024-12-03T09:30:00-05:00,429.91,432.44,428.57,429.97,415.115594174756,NaN,NaN,NaN,NaN,NaN,420.51050000000015,435.30384556478543,405.71715443521487,419.6716659481988,430.32666666666665,430.32666666666665,430.32666666666665,643218,788862.1,62.57498346530565,54.26966835966385,NaN,NaN,NaN,NaN,5.212237472829197,14.471326077428431,173363548,1.440062984235078,2.613522410300334,1.1734594260652558
2024-12-03T13:30:00-05:00,429.98,431.55,427.8,431.12,415.115594174756,NaN,NaN,NaN,NaN,NaN,420.5815000000002,435.542813612074,405.62018638792637,419.6716659481988,430.2526924533792,430.3369743138178,430.16841059294063,495508,767878.5666666667,63.907653731337824,55.66046346095269,NaN,NaN,NaN,NaN,5.107791939055683,14.237359274477404,173859056,1.3980035220799163,2.920963828665151,1.5229603065852348
2024-12-04T09:30:00-05:00,432.83,439.67,432.63,437.22,420.2085102979353,NaN,NaN,NaN,NaN,NaN,420.7917000000001,436.37395472899027,405.20944527100994,425.72326620684726,436.50666666666666,436.5066720614633,436.50666127187003,1472084,802255.4,70.00833063274217,57.74086443019514,NaN,NaN,NaN,NaN,5.353663943408849,15.246754109625662,175331140,1.6737590221896752,3.615159084322329,1.9414000621326537
2024-12-04T13:30:00-05:00,437.17,438.62,436.1,437.29,421.79948710257463,NaN,NaN,NaN,NaN,NaN,420.9137000000002,436.9097203562929,404.91767964370746,426.2026129654778,436.75772282256924,437.13896738452723,436.37647826061124,638362,791108.1,70.07084936889711,59.591067756483426,NaN,NaN,NaN,NaN,5.151259376022502,16.184049313691904,175969502,1.7456238763692715,4.123429907594243,2.3778060312249716
2024-12-05T09:30:00-05:00,438.26,444.67,436.19,443.37,424.42041950700303,NaN,NaN,NaN,NaN,NaN,421.14030000000014,438.05498431981505,404.22561568018523,430.49609037238224,441.41,441.41,441.41,1234100,815155.3,74.9543578286571,61.501874335089724,NaN,NaN,NaN,NaN,5.389026563449467,17.786963477620233,177203602,2.065492278917366,4.959671379871679,2.894179100954313
2024-12-05T13:30:00-05:00,443.36,444.43,441.99,442.64,427.5954004385029,NaN,NaN,NaN,NaN,NaN,421.24510000000015,438.6201209772245,403.8700790227758,431.8708722979058,441.8746034897422,442.60409318525313,441.14511379423124,500584,794434.1666666666,73.40564472119765,63.33621976524511,NaN,NaN,NaN,NaN,5.178381808917362,19.27538377269654,176703018,2.0847305054286194,5.500092232740087,3.415361727311468
2024-12-06T09:30:00-05:00,442.3,446.09,441.82,443.32,428.46788223675276,NaN,NaN,NaN,NaN,NaN,421.44150000000013,439.5717662142401,403.3112337857602,433.9076978383246,443.74333333333334,443.74333333333334,443.74333333333334,923189,801160.0333333333,73.94568296429352,64.93496483833742,NaN,NaN,NaN,NaN,5.113497393994693,20.848522806434758,177626207,1.9997624456143819,5.915064784329445,3.915302338715063
2024-12-06T13:30:00-05:00,443.31,444.77,442.94,443.79,428.82229668053674,NaN,NaN,NaN,NaN,NaN,422.1397000000002,440.9569727471055,403.32242725289484,434.1091582706597,443.772925352126,443.8152053014176,443.73064540283434,452242,765261.2666666667,74.33363060798202,65.85376891332224,NaN,NaN,NaN,NaN,4.878961865852213,22.309294766334535,178078449,1.835974497915437,6.21027046110936,4.374295963193923
2024-12-09T09:30:00-05:00,442.6,448.33,440.44,446.17,428.95969228596687,NaN,NaN,NaN,NaN,NaN,422.93670000000014,442.37183083153724,403.50156916846305,435.8563266165278,444.98,444.98,444.98,881041,773335,76.26122441487368,66.78547444017015,NaN,NaN,NaN,NaN,5.09403601829134,24.075725916364394,178959490,1.7490769869820095,6.560642196921435,4.811565209939426
2024-12-09T13:30:00-05:00,446.11,447.2,444.89,445.8,431.0058426366047,NaN,NaN,NaN,NaN,NaN,423.5627000000001,443.86740420466793,403.2579957953323,436.0660612932222,445.3313536130308,445.8025736870384,444.8601335390232,489821,749901.2,75.3142512006514,68.14303421749044,NaN,NaN,NaN,NaN,4.8951763026991015,25.715983412820698,178469669,1.5354431475585484,6.730869144387611,5.195425996829063
2024-12-10T09:30:00-05:00,444.44,449.6,443.8,446.02,431.5535316076682,NaN,NaN,NaN,NaN,NaN,424.28290000000015,445.16012760231735,403.40567239768296,437.7928490345778,446.47333333333336,446.47333333333336,446.47333333333336,851425,755099.3333333334,75.50898722794827,69.627184270203,NaN,NaN,NaN,NaN,4.9598065667920235,27.507756044677244,179321094,1.28772530773493,6.805082631497726,5.517357323762796
2024-12-10T13:30:00-05:00,446.05,446.07,441.6,443.49,431.5535316076682,NaN,NaN,NaN,NaN,NaN,425.0011000000002,446.00084888323505,404.0013511167653,437.7928490345778,445.4110791880343,446.7513612022045,444.0707971738641,534824,747576.2333333333,68.78853378211159,70.56461879345662,NaN,NaN,NaN,NaN,4.924820383449734,28.465802770408043,178786270,0.8531964933202625,6.583852940413124,5.730656447092861
2024-12-11T09:30:00-05:00,444.11,450.35,444.05,449.16,431.88189553508613,NaN,NaN,NaN,NaN,NaN,425.81030000000015,447.3464176083129,404.2741823916874,437.7928490345778,447.8533333333334,447.8533333333334,447.8533333333334,916961,764737.9333333333,74.30745587917359,71.27994270969523,NaN,NaN,NaN,NaN,5.063047498917611,29.864774257009003,179703231,0.845717133550961,6.787802864031562,5.942085730480601
2024-12-11T13:30:00-05:00,449.18,449.93,447.86,448.93,433.99090028349127,NaN,NaN,NaN,NaN,NaN,426.55330000000015,448.6578213121458,404.4487786878545,438.67533870570384,448.1473067352649,448.61978067355903,447.6748327969708,354986,750902.9,73.73786879263008,71.93710390127156,NaN,NaN,NaN,NaN,4.849258391852067,31.16381920885275,179348245,0.7278444020861894,6.851891233088338,6.124046831002149
2024-12-12T09:30:00-05:00,449.83,456.17,449.22,453.87,437.4810866342417,NaN,NaN,NaN,NaN,NaN,427.40110000000016,450.36312563275237,404.43907436724794,443.54627096456306,453.0866666666668,453.0866666666668,453.0866666666668,1299709,780813.1333333333,77.69293665070576,73.0169577002287,NaN,NaN,NaN,NaN,5.020025649576921,32.999015513928356,180647954,0.8752367445938019,7.218092761744401,6.342856017150599
2024-12-12T13:30:00-05:00,453.85,454.03,449.14,449.5,437.4810866342417,NaN,NaN,NaN,NaN,NaN,428.0523000000002,451.62924884498574,404.4753511550146,443.54627096456306,452.43437169108256,453.438057844489,451.43068553767614,548957,776219.6333333333,67.94484397229479,73.30532843172564,NaN,NaN,NaN,NaN,5.010738103178568,34.67696784507533,180098997,0.585028254554671,7.074141335343938,6.489113080789267
2024-12-13T09:30:00-05:00,447.8,451.42,445.6,447.4,437.4810866342417,NaN,NaN,NaN,NaN,NaN,428.5969000000002,452.67307884048876,404.5207211595116,443.54627096456306,448.14000000000004,448.14000000000004,448.14000000000004,880055,789213.8,63.80203252588913,72.86202142409327,NaN,NaN,NaN,NaN,5.068542524380098,35.11593625658417,179218942,0.1792859481417386,6.713220515966441,6.533934567824702
2024-12-13T13:30:00-05:00,447.4,448.25,446.935,447.21,437.4810866342417,NaN,NaN,NaN,NaN,NaN,429.04470000000015,453.650286553449,404.4391134465513,443.54627096456306,447.94419204316654,448.250508244005,447.63787584232807,359609,769767.3333333334,63.42522491399717,72.387333963029,NaN,NaN,NaN,NaN,4.800432344067234,35.52354978155667,178859333,-0.15611792500267363,6.338787161571361,6.494905086574034
2024-12-16T09:30:00-05:00,446.99,449.6,445.27,449.13,437.4810866342417,NaN,NaN,NaN,NaN,NaN,429.5153000000002,454.73182826301036,404.29877173699003,443.54627096456306,448,448,448,983553,782548.9,65.63397589183668,71.72159239611325,NaN,NaN,NaN,NaN,4.76683003377672,35.381150734493524,179842886,-0.29484151061165953,6.1263531983094595,6.421194708921119
2024-12-16T13:30:00-05:00,449.09,452.18,448.58,451.65,437.4810866342417,NaN,NaN,NaN,NaN,NaN,430.0979000000002,455.9783262785443,404.21747372145614,443.54627096456306,448.9996681385247,450.34245130337,447.65688497367944,545127,772845.6666666666,68.33672033394083,71.35952636845205,NaN,NaN,NaN,NaN,4.683485031364098,35.62658183379915,180388013,-0.2640549810027988,6.09112598266762,6.355180963670419
2024-12-17T09:30:00-05:00,451.09,455.23,449.57,453.73,437.7697630167234,NaN,NaN,NaN,NaN,NaN,430.7143000000002,457.33800162165653,404.0905983783439,443.9354115757344,452.8433333333333,452.8433333333333,452.8433333333333,1041703,784949.8666666667,70.40558877242293,71.10666249760415,NaN,NaN,NaN,NaN,4.753236100552379,36.256342752389266,181429716,-0.15611461325161002,6.160037697105906,6.316152310357516
2024-12-17T13:30:00-05:00,453.73,455.3,453.15,454.52,439.9665919705087,NaN,NaN,NaN,NaN,NaN,431.42850000000027,458.64579378536456,404.211206214636,445.1893292605875,453.31521959329854,454.0049405676613,452.62549861893575,487609,771525.2666666667,71.17592581859668,70.88111215550519,NaN,NaN,NaN,NaN,4.56729066479864,36.850119450753745,181917325,-0.08744309645405224,6.206848439789951,6.294291536244003
2024-12-18T09:30:00-05:00,451.31,452.65,446.16,451.57,439.9665919705087,NaN,NaN,NaN,NaN,NaN,432.0977000000002,459.6159407293594,404.579459270641,445.1893292605875,450.1266666666666,450.1266666666666,450.1266666666666,851745,785045.0333333333,64.4314445041076,70.03612787616476,NaN,NaN,NaN,NaN,4.8381984744558775,35.377009452408586,181065580,-0.28546317122829823,5.937462572208631,6.222925743436929
2024-12-18T13:30:00-05:00,451.56,451.96,437.03,437.43,NaN,NaN,NaN,458.8877033194633,458.8877033194633,458.8877033194633,432.4109000000002,459.80803413404897,405.0137658659514,445.1893292605875,445.59882014967906,449.5562191398848,441.64142115947334,1114996,775157.3666666667,43.26773902026684,67.74709129185158,NaN,NaN,NaN,NaN,5.559041440566172,33.48556037131655,179950584,-1.3537288592018832,4.530764669434575,5.884493528636458
2024-12-19T09:30:00-05:00,441.96,443.125,438.34,440.17,NaN,NaN,NaN,456.8922968408263,NaN,NaN,432.75610000000023,460.10059175169846,405.411608248302,445.1893292605875,440.545,440.545,440.545,876978,779931.6333333333,46.90702935073326,65.70409430062193,NaN,NaN,NaN,NaN,5.568752766240016,31.729214796016812,180827562,-1.8311197983372294,3.595593780714921,5.426713579052151
2024-12-19T13:30:00-05:00,440.17,440.72,436.42,437.08,NaN,NaN,NaN,454.58162425715244,NaN,NaN,432.92970000000014,460.2715785316449,405.5878214683554,445.1893292605875,439.6255208635432,440.82017732040435,438.4308644066821,519501,772882.0333333333,43.51674869594897,63.89896679446746,NaN,NaN,NaN,NaN,5.478127568651445,30.424207487039123,180308061,-2.2810197578054634,2.5754388817953213,4.856458639600785
2024-12-20T09:30:00-05:00,432.67,443.75,428.67,439.54,NaN,NaN,NaN,453.55018679091825,NaN,NaN,433.2137000000002,460.5293200595759,405.89807994042445,445.1893292605875,437.32,437.32,437.32,1325966,802195.4333333333,46.812601314754836,61.9350486112947,NaN,NaN,NaN,NaN,6.163975599462055,30.317509020917576,181634027,-2.330717464888423,1.9430618084902562,4.273779273378679
2024-12-20T13:30:00-05:00,439.54,440.28,434.78,437.04,NaN,NaN,NaN,453.55018679091825,NaN,NaN,433.42370000000017,460.692269512153,406.1551304878473,445.1893292605875,437.3353922134993,437.3573326563162,437.3134517706824,652595,782515.8333333334,44.00254224762028,59.81109671522257,NaN,NaN,NaN,NaN,6.116548770929051,30.218431873804718,180981432,-2.4381943534328796,1.2260363315875793,3.664230685020459
2024-12-23T09:30:00-05:00,436.74,437.58,432.86,435.31,NaN,NaN,NaN,452.37917846032013,NaN,NaN,433.5949000000002,460.8011352036941,406.38866479630633,445.1893292605875,435.25,435.25,435.25,763421,769579.6,42.118393236530444,57.27005789992433,NaN,NaN,NaN,NaN,6.016795287291259,30.374445892654027,180218011,-2.5215552581869725,0.5122866122867435,3.033841870473716
2024-12-23T13:30:00-05:00,435.32,436.43,433.64,435.27,NaN,NaN,NaN,451.79467034848733,NaN,NaN,433.9995000000002,460.68669095369376,407.3123090463066,445.1893292605875,435.2001482081198,435.2659348111148,435.1343616051248,438380,769274.9666666667,42.07353470532532,55.422107237997935,NaN,NaN,NaN,NaN,5.786309909627599,30.519316053014094,179779631,-2.4718318287874643,-0.05594791551061462,2.4158839132768497
2024-12-24T09:30:00-05:00,434.61,439.56,434.24,439.24,NaN,NaN,NaN,451.79467034848733,NaN,NaN,434.48430000000013,460.64886733903813,408.31973266096213,445.1893292605875,437.68,437.68,437.68,586482,767383.7666666667,47.993829453423146,54.29294987567895,NaN,NaN,NaN,NaN,5.753002058939913,29.854129299741476,180366113,-2.079757664698905,-0.18381316759678157,1.8959444971021235
2024-12-26T09:30:00-05:00,439.25,440.96,436.63,439.16,NaN,NaN,NaN,451.79467034848733,NaN,NaN,434.9551000000002,460.58668211970246,409.3235178802979,440.38146340847,438.9166666666667,438.9166666666667,438.9166666666667,499200,767506.8333333334,47.88761742715697,53.183120769476076,NaN,NaN,NaN,NaN,5.651359054729918,28.897618235703177,179866913,-1.7473792181483663,-0.28827952558333436,1.459099692565032
2024-12-26T13:30:00-05:00,439.17,439.97,438.09,438.22,NaN,NaN,NaN,451.79467034848733,NaN,NaN,435.4031000000001,460.45775600560944,410.3484439943908,434.680170726776,438.8725246392242,438.94300205214324,438.80204722630515,195830,724965.0333333333,46.583131143106264,51.82234614456676,NaN,NaN,NaN,NaN,5.381976265106355,28.009429390524758,179671083,-1.520741278436582,-0.4418269054806956,1.0789143729558863
2024-12-27T09:30:00-05:00,434.96,435.2,426.38,428.32,NaN,NaN,NaN,447.73220813573255,NaN,NaN,435.63930000000005,460.1947538145725,411.0838461854276,427.78913990912,429.96666666666664,429.96666666666664,429.96666666666664,850060,732021.6333333333,35.587777963514725,49.48313597525061,NaN,NaN,NaN,NaN,5.8432636747416185,28.82667509886075,178821023,-1.9406003659968238,-1.3468360845401435,0.5937642814566804
2024-12-27T13:30:00-05:00,428.21,430.98,428.21,430.67,NaN,NaN,NaN,446.14483503865387,NaN,NaN,435.90010000000007,459.9568447914187,411.84335520858144,427.78913990912,429.96140864885996,429.96792479275234,429.9548925049676,553493,709334.7333333333,39.2531783241693,47.25796380037535,NaN,NaN,NaN,NaN,5.623744840831506,29.585546113744165,179374516,-1.9574721558246395,-1.853075913324119,0.10439624250052049
2024-12-30T09:30:00-05:00,426.235,427.55,421.92,426.2,NaN,NaN,NaN,441.72575162780595,NaN,NaN,436.1367000000001,459.56631353585556,412.7070864641446,427.78913990912,425.22333333333336,425.22333333333336,425.22333333333336,630669,713670.9,35.155221995437486,44.685056384435406,NaN,NaN,NaN,NaN,5.847048780772113,30.923129930744313,178743847,-2.1516498597304747,-2.585166082162573,-0.4335162224320982
2024-12-30T13:30:00-05:00,426.07,427.42,424.79,424.87,NaN,NaN,NaN,441.72575162780595,NaN,NaN,436.3257000000001,459.23038196765714,413.42101803234306,427.78913990912,425.38536804943,425.6087535175486,425.16198258131135,331824,693958.7333333333,34.01727807476935,42.512615925196954,NaN,NaN,NaN,NaN,5.617259582145533,32.165172046530174,178412023,-2.2414888498400205,-3.235377284732124,-0.9938884348921033
2024-12-31T09:30:00-05:00,426.26,426.7,421.74,421.93,NaN,NaN,NaN,440.7199410493025,NaN,NaN,436.4553000000001,458.95580171972705,413.9547982802731,427.78913990912,423.4566666666667,423.4566666666667,423.4566666666667,440939,693581.9666666667,31.58354854682392,41.6780308913796,NaN,NaN,NaN,NaN,5.570312469135137,33.59923634364969,177971084,-2.358858479456543,-3.9424615342127822,-1.5836030547562392
2024-12-31T13:30:00-05:00,421.9,423.4,420.64,421.31,NaN,NaN,NaN,438.1463073652433,NaN,NaN,436.6249,458.5305053547843,414.71929464521577,427.78913990912,422.54289471553085,423.3760008829726,421.7097885480891,530461,681895.9666666667,31.07858156389345,40.54742747803391,NaN,NaN,NaN,NaN,5.3695758641969125,35.02872491931582,177440623,-2.333897774950571,-4.500975273444453,-2.167077498493882
2025-01-02T09:30:00-05:00,425.5,426.09,414.82,416.26,NaN,NaN,NaN,437.38511157591404,NaN,NaN,436.65770000000003,458.4359534846031,414.879446515397,427.78913990912,419.0566666666667,419.0566666666667,419.0566666666667,945141,697073.3,27.25606336450231,39.38594995435915,NaN,NaN,NaN,NaN,5.791034731039988,36.82160715054872,176495482,-2.498428481373412,-5.290113100210647,-2.791684618837235
2025-01-02T13:30:00-05:00,416.22,418.94,414.98,418.61,NaN,NaN,NaN,433.6605610497362,NaN,NaN,436.69090000000006,458.35363294760975,415.02816705239036,427.78913990912,418.50471285829775,419.2456821898879,417.76374352670763,524447,686174.0333333333,31.47953737983528,38.29073110186489,NaN,NaN,NaN,NaN,5.660246535965702,38.48642636526499,177019929,-2.295158625463082,-5.660632900666087,-3.365474275203005
2025-01-03T09:30:00-05:00,421.42,423.77,419.54,422.69,NaN,NaN,NaN,433.6605610497362,NaN,NaN,436.81170000000003,458.0900136183221,415.533386381678,427.78913990912,422,422,422,731838,692741.1666666666,38.18939082837598,37.875506000490304,NaN,NaN,NaN,NaN,5.624514640539578,38.66994770426837,177751767,-1.756378555122803,-5.560947469106509,-3.804568913983706
2025-01-03T13:30:00-05:00,422.7,424.02,421.6,423.36,NaN,NaN,NaN,433.6605610497362,NaN,NaN,436.9014000000001,457.9126419470992,415.890158052901,419.53531192729594,422.3961749813531,422.88256905923794,421.9097809034683,485526,678360,39.241591228641,37.67002014278391,NaN,NaN,NaN,NaN,5.395620737643891,38.77390607642933,178237293,-1.2491660154821567,-5.366026433336401,-4.1168604178542445
2025-01-06T09:30:00-05:00,428.06,434.29,426.81,428.01,413.5782629712992,413.5782629712992,413.5782629712992,NaN,NaN,NaN,436.9394000000001,457.87918812116976,415.9996118788304,418.9039751643624,429.7033333333334,429.7033333333334,429.7033333333334,1080063,702529.2333333333,46.09949107360559,37.95758845480393,NaN,NaN,NaN,NaN,5.790933542097899,36.60959187205739,179317356,-0.5314869079524183,-4.781219052794768,-4.2497321448423495
2025-01-06T13:30:00-05:00,428.005,428.31,425.48,428.075,413.5782629712992,NaN,NaN,NaN,NaN,NaN,436.94750000000005,457.87324799139685,416.02175200860324,418.9039751643624,429.01500989328895,430.10519884457136,427.92482094200653,430557,673557.5,46.19092037422964,37.82880923486154,NaN,NaN,NaN,NaN,5.579438289090905,34.79953414209586,179747913,-0.010905980241948221,-4.263364620144785,-4.252458639902836
2025-01-07T09:30:00-05:00,429.42,430.59,422.75,424.17,413.5782629712992,NaN,NaN,NaN,NaN,NaN,436.95590000000004,457.8607771046234,416.05102289537666,418.9039751643624,425.83666666666664,425.83666666666664,425.83666666666664,662137,677330.1666666666,41.62300236030265,37.38133673008623,NaN,NaN,NaN,NaN,5.7409069827272665,33.51958656972277,179085776,0.10551664591316356,-4.120562832511382,-4.226079478424546
2025-01-07T13:30:00-05:00,424.19,424.6,420.82,422.47,413.5782629712992,NaN,NaN,NaN,NaN,NaN,436.94950000000006,457.8719092541818,416.0270907458183,418.9039751643624,424.7599705738566,426.2743453605813,423.2455957871319,334709,659151.9666666667,39.778729565691954,36.8953080459852,NaN,NaN,NaN,NaN,5.60084219824675,32.60379454002392,178751067,0.1029950669965789,-4.097335644678822,-4.2003307116754005
2025-01-08T09:30:00-05:00,423.96,426.94,421.52,424.29,413.5782629712992,NaN,NaN,NaN,NaN,NaN,436.9661000000001,457.84694799904827,416.0852520009519,418.9039751643624,424.25,424.25,424.25,633496,668281.5333333333,42.705648629796535,37.403727379291055,NaN,NaN,NaN,NaN,5.587924898371983,31.26557595976359,179384563,0.25045718005348583,-3.887259236608543,-4.137716416662029
2025-01-08T13:30:00-05:00,424.21,425.33,422.79,424.51,413.5782629712992,NaN,NaN,NaN,NaN,NaN,436.84130000000005,457.9426903627113,415.7399096372888,418.9039751643624,424.2345673920589,424.25403888191454,424.2150959022033,397946,648761.3,43.06586999274877,37.6760624984753,NaN,NaN,NaN,NaN,5.370215977059695,30.02294442095043,179782509,0.38151685325250195,-3.660820350096401,-4.042337203348903
2025-01-10T09:30:00-05:00,424.7,424.71,415.03,422.17,413.5782629712992,NaN,NaN,NaN,NaN,NaN,436.66490000000005,458.1037655007583,415.2260344992418,418.9039751643624,420.6366666666667,420.6366666666667,420.6366666666667,1008943,664221.8333333334,40.172746062985425,38.03445707472872,NaN,NaN,NaN,NaN,5.678057692984003,29.96867662326651,178773566,0.3311826568270213,-3.6283588823151263,-3.9595415391421476
2025-01-10T13:30:00-05:00,422.22,423.26,418.81,418.95,413.5782629712992,NaN,NaN,NaN,NaN,NaN,436.44450000000006,458.3750797688878,414.5139202311123,418.9039751643624,420.5458680252739,420.6825886784582,420.40914737208954,444997,644331.6333333333,36.53549327566962,38.21432958907874,NaN,NaN,NaN,NaN,5.590339286342288,29.918285096845725,178328569,0.11287852242826091,-3.8184433861068214,-3.9313219085350823
2025-01-13T09:30:00-05:00,415.22,418.5,412.29,415.09,NaN,NaN,NaN,432.1935021789492,432.1935021789492,432.1935021789492,436.1239,458.81205420345975,413.43574579654023,418.9039751643624,415.2933333333333,415.2933333333333,415.2933333333333,736560,652630,32.7119617773986,38.294930534119786,NaN,NaN,NaN,NaN,5.666743623032121,30.620951246422486,177592009,-0.2403626293469756,-4.231775195218802,-3.9914125658718262
2025-01-13T13:30:00-05:00,415.15,417.63,414.02,417.23,NaN,NaN,NaN,432.1935021789492,NaN,NaN,435.7241,459.0173441441689,412.43085585583117,418.9039751643624,415.66926533452624,416.1536279380736,415.1849027309789,443696,639028.3666666667,36.66905959538862,38.6942503935123,NaN,NaN,NaN,NaN,5.519833364244113,31.273426956743762,178035705,-0.27620838661127856,-4.336673049135925,-4.060464662524646
2025-01-14T09:30:00-05:00,418.17,419.74,413.93,416.21,NaN,NaN,NaN,432.1935021789492,NaN,NaN,435.30250000000007,459.2217826188368,411.3832173811633,415.69094410519193,416.6266666666667,416.6266666666667,416.6266666666667,655446,623710.0333333333,35.59459032344286,39.28985946200805,NaN,NaN,NaN,NaN,5.540559552512391,31.352859980362624,177380259,-0.3122720486181878,-4.450804723297381,-4.138532674679193
2025-01-14T13:30:00-05:00,416.16,417.84,410.72,415.67,NaN,NaN,NaN,431.06604983839674,NaN,NaN,434.74850000000004,459.17251394119654,410.32448605880353,415.69094410519193,415.6663701598934,416.6078525230454,414.7248877967414,681904,617207.5666666667,35.0097179458746,39.54201521672514,NaN,NaN,NaN,NaN,5.653376727332931,31.81071087869703,176698355,-0.31523756254405644,-4.532579627859263,-4.217342065315207
2025-01-15T09:30:00-05:00,419.13,427.405,418.27,425.69,NaN,NaN,NaN,431.06604983839674,NaN,NaN,434.40950000000004,458.85648805578404,409.96251194421603,413.1826042273228,423.78833333333336,423.78833333333336,423.78833333333336,1057124,635128.3333333334,51.07439395671731,40.46237258303524,NaN,NaN,NaN,NaN,6.0877783896662905,30.23518047535168,177755479,0.37733067875550397,-3.7456787168708274,-4.123009395626331
2025-01-15T13:30:00-05:00,425.69,428.15,425.29,426.18,NaN,NaN,NaN,431.06604983839674,NaN,NaN,434.0667000000001,458.48495936547204,409.64844063452813,413.1826042273228,424.7144788947832,426.01474743203573,423.4142103575307,536313,608806.5666666667,51.70311173581073,41.35248119069022,NaN,NaN,NaN,NaN,5.857222790404409,28.640733688086844,178291792,0.8604980823532329,-3.04738679268479,-3.907884875038023
2025-01-16T09:30:00-05:00,428.87,429.4,425,426.31,NaN,NaN,NaN,431.06604983839674,NaN,NaN,433.7171000000001,458.06894626182867,409.3652537381715,414.8975108679956,426.90333333333336,426.90333333333336,426.90333333333336,620763,607745.5,51.87978832741291,41.76535956596217,NaN,NaN,NaN,NaN,5.753135448232664,26.933499760306713,178912555,1.1621530557900437,-2.4551935553004682,-3.617346611090512
2025-01-16T13:30:00-05:00,426.27,428.08,424.38,424.59,NaN,NaN,NaN,431.06604983839674,NaN,NaN,433.2855000000001,457.5037914549975,409.06720854500276,414.8975108679956,426.4153948924362,427.01305782070006,425.81773196417237,413755,596089.9666666667,49.30962152838336,41.98812393411601,NaN,NaN,NaN,NaN,5.606482916216044,25.45344191762321,178498800,1.2135148423571542,-2.100453058144069,-3.3139679005012233
2025-01-17T09:30:00-05:00,434,434.48,428.2,432,413.99289061849083,413.99289061849083,413.99289061849083,NaN,NaN,NaN,433.0095000000001,456.9641262963845,409.0548737036157,418.7734069555172,431.56,431.56000539479663,431.55999460520337,815968,608676.2333333333,58.783160485605706,43.213849514494804,NaN,NaN,NaN,NaN,5.912448422200616,24.30453803875365,179314768,1.6851946635166866,-1.2074745711053652,-2.8926692346220517
2025-01-17T13:30:00-05:00,431.92,431.99,428.39,428.8,413.99289061849083,NaN,NaN,NaN,NaN,NaN,432.6651000000001,456.3552966635887,408.9749033364115,418.7734069555172,430.89587870981455,431.77707029546406,430.01468712416505,463476,604576.0333333333,54.08248964695662,44.23554666315657,NaN,NaN,NaN,NaN,5.747987820614859,23.23769872266048,178851292,1.7146491375827084,-0.749357812643666,-2.4640069502263744
2025-01-21T09:30:00-05:00,430.2,430.88,425.65,429.41,413.99289061849083,NaN,NaN,NaN,NaN,NaN,432.38350000000014,455.88629985447255,408.8807001455277,418.7734069555172,428.64666666666676,428.64666666666676,428.64666666666676,777159,613841.3333333334,54.82410416352851,45.1011506298517,NaN,NaN,NaN,NaN,5.710988690570942,21.716663529992083,179628451,1.7046185461403391,-0.3332337675509507,-2.03785231369129
2025-01-21T13:30:00-05:00,429.39,429.52,427.42,428.66,413.99289061849083,NaN,NaN,NaN,NaN,NaN,431.97350000000006,455.0017930544111,408.945206945589,418.7734069555172,428.59634522344646,428.65265551737605,428.5400349295169,620641,628001.7,53.67622035883548,45.85903279885789,NaN,NaN,NaN,NaN,5.453060926958729,20.304273708228575,179007810,1.5796881075007498,-0.06324217931535259,-1.6429302868161024
2025-01-22T09:30:00-05:00,437.455,445.96,436,444.3,422.8678978996257,NaN,NaN,NaN,NaN,NaN,431.8809000000001,454.6717218096594,409.0900781903408,427.43881948897985,442.08666666666664,442.08666666666664,442.08666666666664,1734194,657472.8333333334,68.49160275732201,47.881808277024795,NaN,NaN,NaN,NaN,6.299270860747389,21.240095517160665,180742004,2.4316608118856315,1.3966457280409372,-1.0350150838446945
2025-01-22T13:30:00-05:00,444.29,447.27,443.64,446.15,427.6711752678245,NaN,NaN,NaN,NaN,NaN,431.7265000000001,454.01849715143817,409.43450284856203,430.6380555911839,443.1754902777079,444.82904044138263,441.5219401140332,751931,664087.4333333333,69.72502652482578,50.25248922339309,NaN,NaN,NaN,NaN,6.108608656408289,22.236535572176958,181493935,2.965687832667058,2.672094706989128,-0.29359312567793006
2025-01-23T09:30:00-05:00,442.13,444.47,441.525,443.11,427.6711752678245,NaN,NaN,NaN,NaN,NaN,431.5987000000002,453.55234997532943,409.6450500246709,430.6380555911839,443.03499999999997,443.0350076293945,443.03499237060544,692309,666142.1,65.20779788261237,52.5736203737655,NaN,NaN,NaN,NaN,6.002636609521983,22.731929729284047,180801626,2.9536103011941464,3.398419750814753,0.44480944962060653
2025-01-23T13:30:00-05:00,443.2,446.7,443.12,446.7,427.6711752678245,NaN,NaN,NaN,NaN,NaN,431.5847000000001,453.49888302468827,409.67051697531195,432.4105555783577,443.9701845569738,445.1688898339626,442.77147927998493,421376,669127.1666666666,67.85621253093588,54.80127415487602,NaN,NaN,NaN,NaN,5.830305423127554,23.43536150374289,181223002,3.0162573761092517,4.215131169757171,1.1988737936479195
2025-01-24T09:30:00-05:00,445.15,446.66,441.4,443.98,427.6711752678245,NaN,NaN,NaN,NaN,NaN,431.52010000000007,453.26807006526536,409.7721299347348,432.5784444626862,444.0133333333333,444.0133333333333,444.0133333333333,842688,682518.8,63.8881069215539,56.82223962616967,NaN,NaN,NaN,NaN,5.7924264643327295,23.72461319431777,180380314,2.7128922040899854,4.589989048760401,1.8770968446704157
2025-01-24T13:30:00-05:00,443.98,444.29,441.71,443.97,427.6711752678245,NaN,NaN,NaN,NaN,NaN,431.4169000000001,452.87669765887154,409.9571023411287,432.5784444626862,443.77657821921815,444.10415728556626,443.44899915287004,440183,679509.5333333333,63.87331826017752,58.88392536290559,NaN,NaN,NaN,NaN,5.562967431166109,23.993204049851585,179940131,2.362783188983294,4.830575830899534,2.4677926419162395
2025-01-27T09:30:00-05:00,424,433.96,423.5,429.44,NaN,NaN,NaN,447.55823765210687,447.55823765210687,447.55823765210687,430.9727000000001,451.6438403855633,410.3015596144369,432.5784444626862,428.96666666666664,428.96667429606117,428.9666590372721,1683641,704126.2,46.88951692047886,58.585005574602846,NaN,NaN,NaN,NaN,6.627755471797102,23.23554111386698,178256490,1.0697115922457052,3.804932132223371,2.7352205399776657
2025-01-27T13:30:00-05:00,429.42,435.2,429.32,434.61,NaN,NaN,NaN,447.55823765210687,NaN,NaN,430.5903000000001,450.2457813128457,410.9348186871546,432.5784444626862,430.2973642273586,432.2089223329577,428.3858061217596,815893,713841.0666666667,51.80049107233714,58.591961241497586,NaN,NaN,NaN,NaN,6.574344366668738,22.345963953431884,179072383,0.5081641554721461,3.3704257343178483,2.862261578845702
2025-01-28T09:30:00-05:00,434.39,446.61,431.33,446.17,NaN,NaN,NaN,447.55823765210687,NaN,NaN,430.42330000000015,449.39259388352775,411.45400611647256,432.5784444626862,441.37000000000006,441.37000000000006,441.37000000000006,1207893,729709.5666666667,60.578111493581,59.21327003908102,NaN,NaN,NaN,NaN,7.196176911906687,21.446898559013654,180280276,0.8411957976283491,3.9137563258811383,3.0725605282527892
2025-01-28T13:30:00-05:00,446.17,448.38,445.08,447.05,427.18480570096153,427.18480570096153,427.18480570096153,NaN,NaN,NaN,430.33290000000017,448.9378068892979,411.7279931107024,432.5784444626862,443.59378696777674,446.27920567116234,440.90836826439113,828306,741135.5666666667,61.15800103560508,60.059582861025426,NaN,NaN,NaN,NaN,6.917878561056211,20.805713833826125,181108582,1.0339843016386032,4.3650409053010435,3.3310566036624403
2025-01-29T09:30:00-05:00,446.69,446.795,440.4,443,427.18480570096153,NaN,NaN,NaN,NaN,NaN,430.44430000000017,449.2830857368617,411.6055142631386,432.5784444626862,443.3983333333333,443.3983333333333,443.3983333333333,784243,731274.9,57.00218433581576,59.93237027889757,NaN,NaN,NaN,NaN,6.898744378123626,19.57720949935478,180324339,0.8117870896738557,4.34579046575476,3.5340033760809044
2025-01-29T13:30:00-05:00,443,445.5,441.5,441.74,427.18480570096153,NaN,NaN,NaN,NaN,NaN,430.47570000000013,449.3843274499133,411.56707255008695,432.5784444626862,443.1533976194984,443.3958853869157,442.91090985208103,800157,743594.9,55.733311341616435,60.05028611423042,NaN,NaN,NaN,NaN,6.6916912082576525,18.436455474488533,179524182,0.5173338706262931,4.180670714363771,3.663336843737478
2025-01-30T09:30:00-05:00,418.69,422.87,413.18,415.71,NaN,NaN,NaN,440.26571322345933,440.26571322345933,440.26571322345933,430.04830000000015,449.3033834441052,410.7932165558951,432.5784444626862,417.25333333333333,417.25333333333333,417.25333333333333,4116203,858730.4333333333,37.273844552239936,58.79669614199552,NaN,NaN,NaN,NaN,8.253713264810678,19.49740684400681,175407979,-1.388914930826532,1.9271931802043127,3.316108111030845
2025-01-30T13:30:00-05:00,415.76,417.02,414.07,414.86,NaN,NaN,NaN,437.1770444405748,NaN,NaN,429.5547000000001,449.0747164354373,410.03468356456284,432.5784444626862,416.62666520466973,417.5327194703322,415.72061093900726,1969081,913209.5,36.84469495303558,57.59444432729553,NaN,NaN,NaN,NaN,7.874876603038485,20.48257597284521,173438898,-2.5953828725579355,0.07187952033342526,2.667262392891361
2025-01-31T09:30:00-05:00,418.73,420.69,415.23,417.54,NaN,NaN,NaN,437.1770444405748,NaN,NaN,429.1647000000001,448.84942772582434,409.47997227417585,431.73475557014893,417.81999999999994,417.82000539479657,417.8199946052033,1864826,954253.8333333334,39.22077059802992,55.50367060163181,NaN,NaN,NaN,NaN,7.728813988535735,20.913689657005442,175303724,-3.0688049294898074,-1.1687437689708986,1.9000611605189088
2025-01-31T13:30:00-05:00,417.46,417.93,414.9,415.04,NaN,NaN,NaN,437.1770444405748,NaN,NaN,428.75930000000005,448.753561777813,408.7650382221871,428.353451881533,417.1783972773176,418.06375917295355,416.2930353816816,979330,973633.3,37.79238765847763,53.22276782546408,NaN,NaN,NaN,NaN,7.393184417926042,21.339704476500263,174324394,-3.381531532156651,-2.326853254676905,1.0546782774797459
2025-02-03T09:30:00-05:00,411.51,414.72,408.66,413.07,NaN,NaN,NaN,432.4930422205263,NaN,NaN,428.31530000000004,448.69379733518133,407.93680266481874,428.353451881533,412.1500000000001,412.1500000000001,412.1500000000001,1320411,984015.5666666667,36.6594009959908,51.183596619276834,NaN,NaN,NaN,NaN,7.320814102359896,22.208769922022718,173003983,-3.535613135811804,-3.3648381422850093,0.17077499352679482
2025-02-03T13:30:00-05:00,413.08,415.41,410.76,411.005,NaN,NaN,NaN,432.4930422205263,NaN,NaN,427.75060000000013,448.44918455449624,407.052015445504,428.353451881533,412.2386658227869,412.35513876244187,412.12219288313196,765194,994688.8,35.45937659787796,48.8695369097727,NaN,NaN,NaN,NaN,7.130041666477049,22.913913722944653,172238789,-3.580186215824611,-4.304457776253969,-0.7242715604293579
2025-02-04T09:30:00-05:00,412.65,413.9,409.74,411.765,NaN,NaN,NaN,431.94737937862,NaN,NaN,427.2027000000001,448.11345859072964,406.2919414092706,428.353451881533,411.8016666666667,411.8016666666667,411.8016666666667,948811,1001763.8333333334,36.28601898954509,46.8979592003435,NaN,NaN,NaN,NaN,6.9178958331572575,23.64979476699119,173187600,-3.3653400113752125,-4.930946574648374,-1.5656065632731613
2025-02-04T13:30:00-05:00,411.76,413.03,411.3,412.29,NaN,NaN,NaN,431.61340758868266,NaN,NaN,426.6841000000001,447.7616866445782,405.606513355422,428.0230092041811,411.963254656595,412.16157877863145,411.7649305345585,629864,1007969.4333333333,36.88737431318126,44.97039177555805,NaN,NaN,NaN,NaN,6.547331845074594,24.33311287932012,173817464,-3.006484278638336,-5.323711911571081,-2.3172276329327453
2025-02-05T09:30:00-05:00,411.94,413.82,410.4,412.05,NaN,NaN,NaN,431.14075269828805,NaN,NaN,426.3587000000001,447.82401097468045,404.8933890253198,428.0230092041811,412.09,412.09,412.09,1033130,1020558.9,36.71676706648689,44.2437667859872,NaN,NaN,NaN,NaN,6.323950998997838,25.047858445867018,172784334,-2.618146100990336,-5.589910259170665,-2.971764158180329
2025-02-05T13:30:00-05:00,412.04,413.51,411.94,413.26,NaN,NaN,NaN,431.10480939382046,NaN,NaN,426.0105000000001,447.74788008591946,404.2731199140807,402.69168214264664,412.34257381882543,412.71891564748074,411.9662319901701,465336,1013339.9666666667,38.26699640376765,43.2770885953751,NaN,NaN,NaN,NaN,5.984383070497992,25.71155075766056,173249670,-2.133183329916408,-5.638243320575839,-3.505059990659431
2025-02-06T09:30:00-05:00,414.52,418.2,414,416.1,NaN,NaN,NaN,431.10480939382046,NaN,NaN,425.80850000000015,447.7220812910535,403.8949187089468,407.0753457141173,416.1,416.10000762939455,416.0999923706055,788439,1004383.8,41.866568730353585,41.94054982657314,NaN,NaN,NaN,NaN,5.909784279748135,25.44240259062091,174038109,-1.5041959371048632,-5.38530491204051,-3.881108974935647
2025-02-06T13:30:00-05:00,416.085,416.39,414.09,415.84,NaN,NaN,NaN,431.10480939382046,NaN,NaN,425.6279000000002,447.7175762393541,403.53822376064625,407.0753457141173,415.8140572476009,416.14110305324544,415.4870114419563,602711,1006597.0666666667,41.62726412514383,40.545497190111625,NaN,NaN,NaN,NaN,5.651942545480412,25.192479292655523,173435398,-1.0123156511189526,-5.146503538834338,-4.1341878877153855
2025-02-07T09:30:00-05:00,416.64,418.65,409.55,410.7,NaN,NaN,NaN,431.10480939382046,NaN,NaN,425.4033000000002,447.8640532028512,402.94254679714913,407.0753457141173,412.96666666666675,412.96666666666675,412.96666666666675,1343253,1030680.0666666667,37.111171821744605,39.124710581963676,NaN,NaN,NaN,NaN,5.898232363660379,25.48377266402807,172092145,-0.9412795481612068,-5.3107873229168945,-4.369507774755688
2025-02-07T13:30:00-05:00,410.7,411.13,408.1,409.75,NaN,NaN,NaN,427.3433956471535,NaN,NaN,425.1721000000001,448.031086774561,402.3131132254392,407.0753457141173,411.67249351852104,413.28634452543315,410.0586425116089,863805,1045681.7333333333,36.326737642864366,37.738526746338536,NaN,NaN,NaN,NaN,5.693358623398922,25.91227211784206,171228340,-0.8682028780298783,-5.454761372293035,-4.586558494263157
2025-02-10T09:30:00-05:00,413.685,415.47,411.74,412.82,NaN,NaN,NaN,427.3433956471535,NaN,NaN,425.10330000000016,448.08951870685394,402.1170812931464,407.0753457141173,413.3433333333333,413.3433333333333,413.3433333333333,717135,1042387.3,40.68969952006708,37.982516386897615,NaN,NaN,NaN,NaN,5.695261578870429,25.450056730721986,171945475,-0.5391522012028434,-5.260498745766711,-4.721346544563867
2025-02-10T13:30:00-05:00,412.83,413.06,410.92,412.2,NaN,NaN,NaN,427.3433956471535,NaN,NaN,424.97510000000017,448.1752527141377,401.77494728586265,407.0753457141173,412.85288860726337,413.47648145183973,412.229295762687,443587,1041724.3333333334,40.092220820037845,38.214482520254926,NaN,NaN,NaN,NaN,5.441314323236826,25.126122475352513,171501888,-0.301169698790674,-5.09780866805221,-4.796638969261536
2025-02-11T09:30:00-05:00,409.625,412.48,409.3,409.97,NaN,NaN,NaN,427.3433956471535,NaN,NaN,424.72070000000014,448.2915021933763,401.149897806624,407.0753457141173,410.5833333333333,410.5833333333333,410.5833333333333,590100,1035489.0333333333,37.934617926684496,38.12261447230168,NaN,NaN,NaN,NaN,5.2797918715770535,25.03695373333525,170911788,-0.23480241192438633,-5.090141984167019,-4.855339572242633
2025-02-11T13:30:00-05:00,409.98,411.9,409.88,411.54,NaN,NaN,NaN,427.241910533152,NaN,NaN,424.48430000000025,448.34031651657256,400.62828348342794,407.0753457141173,410.76932030930254,411.0198038992861,410.518836719319,325336,1025645.5333333333,40.36778438275498,38.30657138117863,NaN,NaN,NaN,NaN,5.0469495950358345,24.95415418717636,171237124,-0.036437015567772235,-4.9008858417023475,-4.864448826134575
2025-02-12T09:30:00-05:00,407.33,410.75,404.395,410.33,NaN,NaN,NaN,424.1554600543724,NaN,NaN,424.13070000000016,448.28939375689475,399.97200624310557,407.0753457141173,408.4916666666666,408.4916666666666,408.4916666666666,809761,994831.1,39.095683372813674,38.480591550951694,NaN,NaN,NaN,NaN,5.196810338247563,25.574562611739044,170427363,0.056933538644555526,-4.7932819028288804,-4.850215441473436
2025-02-12T13:30:00-05:00,410.33,410.42,408.04,409.04,NaN,NaN,NaN,424.1554600543724,NaN,NaN,423.75000000000017,448.24564230632245,399.2543576936779,407.0753457141173,408.7106825013076,409.0267010966126,408.39466390600256,388940,982731.4,37.73056893098167,38.64281957474481,NaN,NaN,NaN,NaN,4.995609599801308,26.150656148832958,170038423,0.07436554499317793,-4.7572585102319636,-4.8316240552251415
2025-02-13T09:30:00-05:00,407.33,410.42,406.36,408.08,NaN,NaN,NaN,424.1554600543724,NaN,NaN,423.4282000000001,448.31297588887713,398.5434241111231,406.3402765712938,408.28666666666663,408.28666666666663,408.28666666666663,976561,992206.4666666667,36.703466994633835,38.67263728939401,NaN,NaN,NaN,NaN,4.928780342672644,26.89212228891397,169061862,0.06417726107735611,-4.751402478878447,-4.815579739955803
2025-02-13T13:30:00-05:00,408.08,411,407.65,410.48,NaN,NaN,NaN,424.1554600543724,NaN,NaN,423.1884000000002,448.33519052601497,398.0416094739854,406.06022125703504,408.8178892917374,409.50630006470783,408.129478518767,581510,997544.2666666667,41.02569541431561,38.96823165376075,NaN,NaN,NaN,NaN,4.816010318196028,27.425167570437814,169643372,0.2514922784635427,-4.501214391876374,-4.752706670339917
2025-02-14T09:30:00-05:00,407.7,408.7,405.89,407.8,NaN,NaN,NaN,422.91097446526186,NaN,NaN,422.85860000000014,448.36885574468573,397.34834425531454,403.3405416045025,407.4633333333333,407.4633333333333,407.4633333333333,1486384,1019000.8,37.91242004978346,39.05363543828194,NaN,NaN,NaN,NaN,4.799866724039171,28.152306203463066,168156988,0.22801224212824867,-4.467691367679606,-4.695703609807855
2025-02-14T13:30:00-05:00,407.8,408.95,406.68,408.35,NaN,NaN,NaN,422.91097446526186,NaN,NaN,422.53540000000015,448.36129985575155,396.70950014424875,403.3405416045025,407.60799097164096,407.8440899254914,407.3718920177905,557989,1022927.6666666666,38.93655100458057,39.10146076691143,NaN,NaN,NaN,NaN,4.619161958036372,28.75361925841462,168714977,0.279252180311941,-4.346638384417929,-4.62589056472987
2025-02-18T09:30:00-05:00,408,410.59,407.62,408.06,NaN,NaN,NaN,422.91097446526186,NaN,NaN,422.2532000000002,448.39532789807134,396.1110721019291,402.7229173015052,408.75666666666666,408.75666666666666,408.75666666666666,833496,994589.5,38.57524148350658,38.866365963565215,NaN,NaN,NaN,NaN,4.501364675319486,28.820046440946506,167881481,0.3203957589153772,-4.225395866085648,-4.5457916250010255
2025-02-18T13:30:00-05:00,408.06,410.5,406.51,409.64,NaN,NaN,NaN,422.91097446526186,NaN,NaN,422.0670000000002,448.43225562173376,395.7017443782666,402.7229173015052,408.80130076619866,408.8618106810465,408.7407908513508,453507,982509.9666666667,41.74688835896468,38.87491055169528,NaN,NaN,NaN,NaN,4.464838627082381,29.05979997606866,168334988,0.4716631051510003,-3.9562127435622756,-4.427875848713276
2025-02-19T09:30:00-05:00,407.88,411.99,407.7,411.55,NaN,NaN,NaN,422.91097446526186,NaN,NaN,421.9962000000003,448.45486501241135,395.5375349875892,402.7229173015052,410.41333333333336,410.41333333333336,410.41333333333336,1141885,980309.7,45.41605355974412,39.46811639012382,NaN,NaN,NaN,NaN,4.4523501537193555,28.822137204284893,169476873,0.7040090246750577,-3.5478645678694534,-4.251873592544511
2025-02-19T13:30:00-05:00,411.565,415.48,411.565,414.79,NaN,NaN,NaN,422.91097446526186,NaN,NaN,421.9474000000002,448.4500119648454,395.444788035155,406.0156218887519,412.0637971184251,413.82585762490396,410.30173661194624,1001827,986093.7333333333,51.048655824679706,40.519681974539196,NaN,NaN,NaN,NaN,4.415039428453688,27.617942283121145,170478700,1.0582663800523036,-2.9290406174791315,-3.987306997531435
2025-02-20T09:30:00-05:00,415.25,419.3,412.59,417.53,NaN,NaN,NaN,422.91097446526186,NaN,NaN,421.9738000000002,448.45612063545815,395.4914793645423,408.3734975110015,416.47333333333336,416.47333333333336,416.47333333333336,1448367,1008231.2,55.25388548647554,41.5599809721398,NaN,NaN,NaN,NaN,4.578965183564141,25.70503049342313,171927067,1.436043870599668,-2.19225215928185,-3.628296029881518
2025-02-20T13:30:00-05:00,417.53,417.95,414.94,416.11,NaN,NaN,NaN,422.91097446526186,NaN,NaN,421.98260000000016,448.4568270323289,395.50837296767145,408.3734975110015,416.42999856983903,416.494720785431,416.36527635424704,649299,1003202.6,52.725916732667976,42.46238782304196,NaN,NaN,NaN,NaN,4.466896241880987,23.928755260132117,171277768,1.5400050899643527,-1.703289667426077,-3.2432947573904296
2025-02-21T09:30:00-05:00,417.25,418.05,412.3,412.49,NaN,NaN,NaN,422.91097446526186,NaN,NaN,421.71860000000015,448.30271337922125,395.13448662077906,408.3734975110015,414.28000000000003,414.28000000000003,414.28000000000003,971283,898371.9333333333,46.84220823021576,43.09864427329418,NaN,NaN,NaN,NaN,4.55854651031806,22.764374721294573,170306485,1.322984912837705,-1.5895636163432982,-2.912548529181003
2025-02-21T13:30:00-05:00,412.51,412.53,407.88,408.15,NaN,NaN,NaN,422.91097446526186,NaN,NaN,421.3580000000001,448.1783501095627,394.53764989043754,408.3734975110015,412.0923610458126,414.46457461715505,409.72014747447014,826018,860269.8333333334,40.943251859633165,43.139749093071195,NaN,NaN,NaN,NaN,4.565078902438197,22.550517064833013,169480467,0.8671923029496789,-1.8285581504939046,-2.6957504534435834
2025-02-24T09:30:00-05:00,409,409.38,399.32,404.62,NaN,NaN,NaN,419.7080059894582,NaN,NaN,420.92420000000016,448.1092973409919,393.73910265900844,408.3734975110015,404.4400000000001,404.4400000000001,404.4400000000001,1358277,843384.8666666667,36.87557635694841,42.98117002050939,NaN,NaN,NaN,NaN,4.957573266549754,23.585031297765727,168122190,0.33535096078836935,-2.2765617524581216,-2.611912713246491
2025-02-24T13:30:00-05:00,404.59,405.38,403.03,404.08,NaN,NaN,NaN,419.18536935357366,NaN,NaN,420.5140000000002,448.0817271460532,392.94627285394716,408.3734975110015,404.36076371204945,404.4858382909515,404.2356891331474,545128,828911.4666666667,36.28175476038298,42.87768329403805,NaN,NaN,NaN,NaN,4.771318033224773,24.545651656917535,167577062,-0.026225769330146864,-2.6446949249091745,-2.6184691555790276
2025-02-25T09:30:00-05:00,401.16,401.96,396.7,398.26,NaN,NaN,NaN,414.6358071102294,NaN,NaN,419.8392000000002,447.8966971342652,391.78170286573516,408.3734975110015,398.97333333333336,398.97333333333336,398.97333333333336,1327577,829150.3333333334,30.568260391164188,42.43945425093308,NaN,NaN,NaN,NaN,4.957652459423003,26.13833672523352,166249485,-0.599026980647972,-3.3672528813889926,-2.7682259007410206
2025-02-25T13:30:00-05:00,398.24,399.3,397.01,397.96,NaN,NaN,NaN,413.0773613324917,NaN,NaN,419.2224000000002,447.8156448833478,390.62915511665267,408.3734975110015,398.65134396735533,399.07648722343276,398.2262007112779,761504,829027.3333333334,30.30335718264338,41.673572948670774,NaN,NaN,NaN,NaN,4.767105855178505,27.617258574384074,165487981,-0.9205536107437595,-3.91891791417072,-2.9983643034269605
2025-02-26T09:30:00-05:00,398.1,403.63,394.245,400.2,NaN,NaN,NaN,413.0773613324917,NaN,NaN,418.6382000000002,447.5666229614903,389.70977703851014,408.3734975110015,399.35833333333335,399.35833333333335,399.35833333333335,835546,825251.8333333334,34.843658074145566,41.45437566469665,NaN,NaN,NaN,NaN,5.096955436951468,27.836796452063616,166323527,-0.903536250095391,-4.127784616046199,-3.224248365950808
2025-02-26T13:30:00-05:00,400.12,400.68,398.24,399.73,NaN,NaN,NaN,413.0773613324917,NaN,NaN,418.0596000000002,447.3184657907142,388.80073420928625,408.3734975110015,399.4191283603963,399.50832670588557,399.32993001490706,388144,817194.5,34.338200359883075,41.12592204721825,NaN,NaN,NaN,NaN,4.90717290574065,28.040653052766046,165935383,-0.8461046799659515,-4.281879215908248,-3.435774535942296
2025-02-27T09:30:00-05:00,401,405.7,396.63,398.33,NaN,NaN,NaN,413.0773613324917,NaN,NaN,417.14020000000016,445.92832122802207,388.35207877197826,407.7037980088012,400.21999999999997,400.21999999999997,400.21999999999997,817124,809994.3,32.811338004843265,40.71421465588516,NaN,NaN,NaN,NaN,5.204517698187745,27.027178943702246,165118259,-0.8237749077298337,-4.465493170604589,-3.641718262874755
2025-02-27T13:30:00-05:00,398.4,398.56,392.17,392.58,NaN,NaN,NaN,411.2218508354293,NaN,NaN,416.0688000000002,444.44299824839334,387.694601751607,406.97803840704097,397.37543825358983,400.2667212279125,394.48415527926716,790929,820847.4,27.418778429802884,39.6907782323736,NaN,NaN,NaN,NaN,5.289195005460049,26.761418932486652,164327330,-1.100346113896915,-5.017150905245899,-3.9168047913489836
2025-02-28T09:30:00-05:00,392.67,392.77,386.57,391.23,NaN,NaN,NaN,405.6515394338188,NaN,NaN,415.03120000000024,443.16743695946496,386.8949630405355,401.34743072563276,390.19,390.19,390.19,1215140,835070.7666666667,26.3248533514209,38.32712107463623,NaN,NaN,NaN,NaN,5.354252505070044,27.22253814428756,163112190,-1.2664587108448213,-5.499878179905011,-4.233419469060189
2025-02-28T13:30:00-05:00,391.16,397.67,389.63,396.94,NaN,NaN,NaN,405.6515394338188,NaN,NaN,414.0360000000003,441.12172369346825,386.9502763065323,395.4039445805062,391.9607635916844,394.1818389472668,389.739688236102,772362,840725.8,37.654836589603384,37.37041970070221,NaN,NaN,NaN,NaN,5.546091611850756,26.617813594277084,163884552,-0.901190872520071,-5.359908059710278,-4.458717187190207
2025-03-03T09:30:00-05:00,398.5,398.55,392.14,393.21,NaN,NaN,NaN,405.6515394338188,NaN,NaN,413.0206000000003,439.3355883252666,386.705611674734,393.024155664405,394.63333333333344,394.63333333333344,394.63333333333344,704310,819427.7,33.97884676745436,35.85077407791498,NaN,NaN,NaN,NaN,5.607799353861418,25.881859700235132,163180242,-0.822396765725701,-5.486713144347334,-4.664316378621633
2025-03-03T13:30:00-05:00,393.25,395.08,386.17,388.54,NaN,NaN,NaN,405.6515394338188,NaN,NaN,411.91200000000026,437.58060705217315,386.2433929478274,391.03937292811224,391.9032002897312,394.2242128516384,389.582187727824,974488,823117.1333333333,30.026532682698388,34.22938950291715,NaN,NaN,NaN,NaN,5.8436708285856005,25.979187313854187,162205754,-0.9854035566211463,-5.896070824398066,-4.91066726777692
2025-03-04T09:30:00-05:00,383.4,387.53,381,385.48,NaN,NaN,NaN,401.47092868754066,NaN,NaN,411.0328000000003,437.24537340740784,384.82022659259275,391.03937292811224,384.67,384.67,384.67,1333422,843660.0333333333,27.74892844873196,32.86558380423973,NaN,NaN,NaN,NaN,5.9648371979723445,26.63383732084435,160872332,-1.1864290076133974,-6.393703527293667,-5.207274519680269
2025-03-04T13:30:00-05:00,385.41,392.56,385.17,388.66,NaN,NaN,NaN,401.47092868754066,NaN,NaN,410.1138000000002,436.1770573988553,384.0505426011451,391.03937292811224,386.2720294836808,388.28313445427847,384.2609245130831,846134,857078.2666666667,33.402481845630774,32.32695737466814,NaN,NaN,NaN,NaN,6.066634540974319,26.25569725753703,161718466,-0.999819397970156,-6.457048767142965,-5.457229369172809
2025-03-05T09:30:00-05:00,389.425,397.18,388.83,395.49,NaN,NaN,NaN,401.47092868754066,NaN,NaN,409.1002000000002,433.3548557147047,384.8455442852957,391.03937292811224,393.8333333333333,393.8333333333333,393.8333333333333,954690,869231.2666666667,43.608754375662414,32.807898661719136,NaN,NaN,NaN,NaN,6.241874930904723,25.109227600108813,162673156,-0.34481676256982574,-5.88825032238509,-5.543433559815265
2025-03-05T13:30:00-05:00,395.535,401.67,394.3,401.15,379.98809583252125,379.98809583252125,379.98809583252125,NaN,NaN,NaN,408.18220000000025,429.97116272516814,386.39323727483236,391.03937292811224,396.6101506180757,399.2076971071814,394.01260412897,1091014,894753.8666666667,50.39342501249721,33.81587510829873,NaN,NaN,NaN,NaN,6.322455292982958,23.354865998743808,163764170,0.4955484670904937,-4.9239979759521475,-5.419546443042641
2025-03-06T09:30:00-05:00,394,402.13,393.29,397.22,379.98809583252125,NaN,NaN,NaN,NaN,NaN,407.26660000000027,426.8634582624519,387.66974173754863,383.6364983424898,397.5466666666667,397.5466666666667,397.5466666666667,920670,898450.8333333334,46.233946804458206,34.9348527092483,NaN,NaN,NaN,NaN,6.502279914912745,21.87347513797963,162843500,0.794901194579194,-4.425919949818649,-5.220821144397843
2025-03-06T13:30:00-05:00,397.21,397.89,394.25,396.98,379.98809583252125,NaN,NaN,NaN,NaN,NaN,406.3714000000002,423.52433642962586,389.2184635703746,383.19929349215596,397.0692182660544,397.6456288386212,396.49280769348763,631674,906541.9666666667,45.984327487183066,36.054922016715416,NaN,NaN,NaN,NaN,6.297831349561834,20.497897910127172,162211826,0.9731406411014953,-4.004395343020974,-4.977535984122469
2025-03-07T09:30:00-05:00,392.14,394.78,385.56,390.1,379.98809583252125,NaN,NaN,NaN,NaN,NaN,405.8592000000002,423.3913919176887,388.32700808231175,383.19929349215596,390.1466666666667,390.1466666666667,390.1466666666667,1153395,912436.4333333333,39.414744310935575,36.38142817648613,NaN,NaN,NaN,NaN,6.663700538878848,20.415523198631874,161058431,0.6401577510383394,-4.177338795324545,-4.817496546362884
2025-03-07T13:30:00-05:00,390.08,394.27,389.89,393.33,379.98809583252125,NaN,NaN,NaN,NaN,NaN,405.42860000000024,423.1123044806432,387.74489551935727,383.19929349215596,390.9087612949867,392.0088222724057,389.8087003175676,553557,911504.6666666666,43.49610633829679,37.0355643178014,NaN,NaN,NaN,NaN,6.500579071816072,20.339032395100528,161611988,0.6479436499425173,-4.007566983934737,-4.655510633877254
2025-03-10T09:30:00-04:00,385.85,386.36,378.9,380.5,NaN,NaN,NaN,402.28127037927896,402.28127037927896,402.28127037927896,404.6878000000002,423.35590629493163,386.0196937050688,383.19929349215596,381.92,381.92,381.92,1502002,912025.2666666667,33.76584309464208,37.10374325278703,NaN,NaN,NaN,NaN,7.066966280972068,21.427444255687153,160109986,-0.1574798012587184,-4.852360385450652,-4.694880584191933
2025-03-10T13:30:00-04:00,380.51,380.8,377.25,380.22,NaN,NaN,NaN,398.26712172567534,NaN,NaN,403.9914000000002,423.6351958694038,384.34760413059666,383.19929349215596,380.8874752429761,382.11701286724195,379.65793761871026,1059224,928733.1,33.58924318172511,37.544490735067185,NaN,NaN,NaN,NaN,6.815754403759778,22.583130182000488,159050762,-0.6291148811780669,-5.4812741856645175,-4.852159304486451
2025-03-11T09:30:00-04:00,378.83,385.99,376.91,377.19,NaN,NaN,NaN,398.26712172567534,NaN,NaN,403.27380000000016,424.1230312145782,382.42456878542214,383.19929349215596,380.0300000000001,380.0300000000001,380.0300000000001,1427126,948520.7666666667,31.659555683625214,37.92554090165321,NaN,NaN,NaN,NaN,6.97748623206265,22.70820351942456,157623636,-1.0408786817313835,-6.1532576566506805,-5.112378974919297
2025-03-11T13:30:00-04:00,377.16,385.38,377.06,380.36,NaN,NaN,NaN,398.26712172567534,NaN,NaN,402.6609000000001,424.3498261781011,380.97197382189904,383.19929349215596,380.34643438739624,380.7773810295476,379.9154877452449,769454,959052.3333333334,35.81413882175289,37.79406248966388,NaN,NaN,NaN,NaN,7.073380072629603,22.824343047032627,158393090,-0.9954890967117977,-6.356740345809044,-5.361251249097246
2025-03-12T09:30:00-04:00,382.845,385.21,378.98,384.12,NaN,NaN,NaN,398.26712172567534,NaN,NaN,402.1080000000001,424.2452345156096,379.97076548439065,383.19929349215596,382.77,382.77,382.77,966142,953194.2333333333,40.43925892623349,38.25552050100525,NaN,NaN,NaN,NaN,7.013138638870343,22.932186894097264,159359232,-0.626022680526857,-6.143779599755817,-5.51775691922896
2025-03-12T13:30:00-04:00,384.1,385,380.66,383.3,NaN,NaN,NaN,398.26712172567534,NaN,NaN,401.52820000000014,424.08297552623674,378.97342447376354,382.93343479372476,382.8672300833251,382.97499291999185,382.7594672466584,786510,946017,39.76626806164516,38.95121588521573,NaN,NaN,NaN,NaN,6.8222001646653165,23.03232760922871,158572722,-0.36365729299434246,-5.972328535471888,-5.608671242477546
2025-03-13T09:30:00-04:00,383.155,385.31,378.04,378.72,NaN,NaN,NaN,398.26712172567534,NaN,NaN,400.8616000000002,424.0930643050919,377.63013569490846,380.7127478349798,380.6900000000001,380.6900000000001,380.6900000000001,968491,930021.1333333333,36.14780441730934,39.55113559725697,NaN,NaN,NaN,NaN,6.854185867189221,23.457529909325146,157604231,-0.42129994990551367,-6.135296179859438,-5.713996229953924
2025-03-13T13:30:00-04:00,378.66,380.5,377.42,378.83,NaN,NaN,NaN,398.0832402467108,NaN,NaN,400.1730000000002,423.92879802908845,376.4172019709119,376.5185586143871,380.08325671799344,380.92457751083697,379.2419359251499,503712,925168.2333333333,36.29773014856867,39.75793904746682,NaN,NaN,NaN,NaN,6.58460116238999,23.930594077036588,158107943,-0.37623065505181064,-6.184284548768687,-5.808053893716877
2025-03-14T09:30:00-04:00,379.92,388.27,379.53,387.67,NaN,NaN,NaN,398.0832402467108,NaN,NaN,399.60440000000017,423.1682954877778,376.0405045122225,376.5185586143871,385.1566666666667,385.1566720614633,385.15666127187006,930789,923818.4333333333,47.056389536103566,40.00419870178405,NaN,NaN,NaN,NaN,6.788558222219275,22.769031445835616,159038732,0.2888396052919706,-5.447004387101913,-5.7358439923938835
2025-03-14T13:30:00-04:00,387.74,391.19,386.78,388.32,NaN,NaN,NaN,398.0832402467108,NaN,NaN,399.05400000000014,422.3594681995206,375.74853180047967,375.2378757552783,386.6177050888897,388.38825452479153,384.84715565298785,633809,917411.4666666667,47.755093142694065,39.81574642536954,NaN,NaN,NaN,NaN,6.618661206346472,21.189137743801716,159672541,0.7843253868130899,-4.755437258877521,-5.539762645690611
2025-03-17T09:30:00-04:00,386.68,390.29,385.55,388.36,NaN,NaN,NaN,398.0832402467108,NaN,NaN,398.60720000000015,421.8589722472706,375.3554277527297,375.2378757552783,388.06666666666666,388.06666666666666,388.06666666666666,650550,893820.5666666667,47.800746743683085,39.92766070674274,NaN,NaN,NaN,NaN,6.484471120178867,19.925903325677698,160323091,1.1068283078486925,-4.156227260879746,-5.263055568728438
2025-03-17T13:30:00-04:00,388.37,392.71,388.31,388.78,NaN,NaN,NaN,398.0832402467108,NaN,NaN,398.1878000000002,421.37689822823233,374.9987017717681,378.4046404833781,388.96415121143775,389.89679582514367,388.03150659773183,602424,895730.4333333333,48.31148584739423,40.09388630390068,NaN,NaN,NaN,NaN,6.3355803258803745,18.67643668457046,160925515,1.3257308137841548,-3.6058920514982447,-4.9316228652823995
2025-03-18T09:30:00-04:00,387.2,387.3,381.1,382.35,NaN,NaN,NaN,398.0832402467108,NaN,NaN,397.57840000000016,420.79881286796797,374.35798713203235,378.4046404833781,383.5833333333333,383.5833333333333,383.5833333333333,786462,877693.2666666667,41.600587643254,40.25001797049486,NaN,NaN,NaN,NaN,6.431610302603201,18.305895013978578,160139053,1.0280507496846383,-3.6465594281766016,-4.67461017786124
2025-03-18T13:30:00-04:00,382.39,384.2,381.76,383.52,NaN,NaN,NaN,398.0832402467108,NaN,NaN,397.00480000000016,420.1689813979875,373.8406186020128,378.4046404833781,383.41707286375896,383.6238119628101,383.2103337647078,508640,869264.4666666667,43.14810238187566,40.2251605450362,NaN,NaN,NaN,NaN,6.146495280988687,17.96182060557183,160647693,0.9048627288101896,-3.5435317668485027,-4.448394495658692
2025-03-19T09:30:00-04:00,385.425,387.95,384,385.13,NaN,NaN,NaN,398.0832402467108,NaN,NaN,396.50800000000015,419.6039999999763,373.412000000024,378.4046404833781,385.6933333333333,385.6933333333333,385.6933333333333,527732,859004,45.296268994907386,41.04876239505516,NaN,NaN,NaN,NaN,6.023888475203782,16.947410794060495,161175425,0.9235180666552782,-3.293996912339594,-4.217514978994872
2025-03-19T13:30:00-04:00,385.11,389.69,384.66,387.93,NaN,NaN,NaN,398.0832402467108,NaN,NaN,396.03580000000017,418.84682824159745,373.2247717584029,378.4046404833781,386.72494132953653,387.5757676742818,385.8741149847913,775820,871926.5333333333,48.911709401332075,42.14322426788423,NaN,NaN,NaN,NaN,5.952896441260653,15.772738472086994,161951245,1.1039382656075318,-2.8375921469854575,-3.9415304125929893
2025-03-20T09:30:00-04:00,385.49,391.78,383.28,385.65,NaN,NaN,NaN,398.0832402467108,NaN,NaN,395.5422000000002,418.1619192873569,372.9224807126435,378.4046404833781,386.90333333333336,386.90333333333336,386.90333333333336,662277,866764.9666666667,46.23222896280762,43.184129502111546,NaN,NaN,NaN,NaN,6.134832409742034,15.040542858064262,161288968,1.049581789831501,-2.629553175303613,-3.679134965135114
2025-03-20T13:30:00-04:00,385.68,388,384.6,386.85,NaN,NaN,NaN,398.0832402467108,NaN,NaN,395.0984000000002,417.51118576524726,372.68561423475313,378.4046404833781,386.7098234315895,386.9191749939287,386.50047186925025,565840,859262,47.85146783405624,44.04393871727607,NaN,NaN,NaN,NaN,5.939487237617601,14.36064693075744,161854808,1.0706145598737247,-2.340866765292958,-3.4114813251666827
2025-03-21T09:30:00-04:00,383.45,386.2,382.8,384.72,NaN,NaN,NaN,398.0832402467108,NaN,NaN,394.63120000000026,416.91561164219434,372.3467883578062,378.4046404833781,384.5733333333333,384.5733333333333,384.5733333333333,706678,842313.2666666667,45.246757740671605,44.38733148973593,NaN,NaN,NaN,NaN,5.804523863502058,13.367699090337878,161148130,0.9228443084439331,-2.2579259396117664,-3.1807702480556994
2025-03-21T13:30:00-04:00,384.72,391.75,384.44,391.15,NaN,NaN,NaN,398.0832402467108,NaN,NaN,394.2446000000003,416.08199699137435,372.4072030086262,378.4046404833781,387.1109741040155,389.3651410050731,384.8568072029579,895591,846420.9,53.47917846286594,45.36682508982313,NaN,NaN,NaN,NaN,5.912057873251911,13.422713474717204,162043721,1.2211938076002342,-1.6542779885554069,-2.875471796155641
2025-03-24T09:30:00-04:00,395.21,395.36,389.88,392.535,NaN,NaN,NaN,398.0832402467108,NaN,NaN,393.93930000000023,415.4342525246934,372.44434747530704,381.56390534905586,392.5916666666667,392.5916666666667,392.5916666666667,942449,854358.8666666667,55.04701135072423,46.71676844220991,NaN,NaN,NaN,NaN,5.881196596591061,14.012313965901138,162986170,1.4587790882334084,-1.0519979358638807,-2.510777024097289
2025-03-24T13:30:00-04:00,392.54,394.31,391.65,392.84,NaN,NaN,NaN,398.0832402467108,NaN,NaN,393.6291000000003,414.727235054042,372.53096494595854,381.94312427924467,392.71720088962394,392.8819188861573,392.5524828930906,547394,840122.4,55.403452945570514,48.08146292771004,NaN,NaN,NaN,NaN,5.651111125405987,14.559800136286219,163533564,1.573575991347055,-0.5438070349134705,-2.1173830262605255
2025-03-25T09:30:00-04:00,393.68,396.34,392.65,394.6,NaN,NaN,NaN,398.0832402467108,NaN,NaN,393.3599000000002,414.05426565732347,372.66553434267695,384.6014994233957,394.5300000000001,394.5300000000001,394.5300000000001,777715,821598.8333333334,57.49775440747213,48.827274704236366,NaN,NaN,NaN,NaN,5.51103175930556,15.371192409435647,164311279,1.694661877752366,0.0009443209299320188,-1.693717556822434
2025-03-25T13:30:00-04:00,394.61,395.73,393.37,395.125,NaN,NaN,NaN,398.0832402467108,NaN,NaN,393.0696000000002,413.24298809816156,372.89621190183885,385.15919953871656,394.6094922670397,394.71199515775766,394.5069893763217,467733,808985.4666666667,58.129407156714485,49.56829713380926,NaN,NaN,NaN,NaN,5.285958062212306,16.124628091645828,164779012,1.730664762767628,0.4696133966371008,-1.2610513661305272
2025-03-26T09:30:00-04:00,394.99,395.29,391.45,391.72,NaN,NaN,NaN,398.0832402467108,NaN,NaN,392.67300000000023,412.1450343056102,373.2009656943903,385.15919953871656,392.82,392.82,392.82,680391,799842.1666666666,52.66285597948134,49.91559065065199,NaN,NaN,NaN,NaN,5.182675343482858,16.319848777687042,164098621,1.4567039862435283,0.5598286166738831,-0.8968753695696451
2025-03-26T13:30:00-04:00,391.69,391.7,388.575,389.81,NaN,NaN,NaN,398.0832402467108,NaN,NaN,392.1734000000002,410.6039324328671,373.74286756713326,385.15919953871656,391.61453030595317,392.9973218228648,390.2317387890415,517080,780711.0333333333,49.831944478023324,50.024194838554074,NaN,NaN,NaN,NaN,5.037127104662657,15.79703115756044,163581541,1.094912752626558,0.47176557121355245,-0.6231471814130056
2025-03-27T09:30:00-04:00,390.22,391.79,387.4,389.83,NaN,NaN,NaN,398.0832402467108,NaN,NaN,391.61940000000016,408.57403389634726,374.66476610365305,385.15919953871656,389.67333333333335,389.67333333333335,389.67333333333335,602979,770121.3333333334,49.86233703807251,50.61431979532682,NaN,NaN,NaN,NaN,4.9909037400438985,15.037371246583318,164184520,0.8177093478871503,0.3989895034459323,-0.418719844441218
2025-03-27T13:30:00-04:00,389.76,392.23,389.6,390.61,NaN,NaN,NaN,398.0832402467108,NaN,NaN,391.10940000000016,406.5534138098589,375.6653861901414,385.15919953871656,390.0969711692277,390.64785964882714,389.54608268962824,356586,760951.7333333333,51.10639709516612,51.18276941770471,NaN,NaN,NaN,NaN,4.822267758612191,14.426831256332262,164541106,0.6546931155749387,0.3996465500274553,-0.25504656554748334
2025-03-28T09:30:00-04:00,388.425,389.12,377.6,377.64,NaN,NaN,NaN,398.0832402467108,NaN,NaN,390.4124000000001,405.05882963180306,375.76597036819715,385.15919953871656,381.4533333333334,381.4533333333334,381.4533333333334,1078058,758440.5,35.384113240337484,50.47475829237829,NaN,NaN,NaN,NaN,5.407105775854177,15.14946034403195,163463048,-0.30719228449776587,-0.6390369211696907,-0.3318446366719248
2025-03-28T13:30:00-04:00,377.68,380,376.93,378.85,NaN,NaN,NaN,394.81128229594054,NaN,NaN,389.82640000000015,403.92142210566493,375.73137789433537,385.15919953871656,380.2178804696322,381.63458488897425,378.8011760502901,819853,767317.0333333333,37.32138192407205,49.646877758288284,NaN,NaN,NaN,NaN,5.240169649007449,15.913289308145313,164282901,-0.8137351538535251,-1.3490135789888313,-0.5352784251353062
2025-03-31T09:30:00-04:00,372.28,373,367.24,371.22,NaN,NaN,NaN,387.3064512824887,NaN,NaN,389.1584000000002,403.54841576646453,374.76838423353587,385.15919953871656,370.4866666666667,370.4866666666667,370.4866666666667,1213047,757685.2,31.008167964048212,48.55944482980548,NaN,NaN,NaN,NaN,5.695157531221204,17.74282007717011,163069854,-1.5706178133035196,-2.498550691764706,-0.9279328784611862
2025-03-31T13:30:00-04:00,371.22,377.23,370.11,375.1,NaN,NaN,NaN,387.3064512824887,NaN,NaN,388.5788000000001,402.8521165816298,374.30548341837044,385.15919953871656,372.09286990490796,373.90913393014984,370.2766058796661,948682,754000.4666666667,36.857501986097084,47.77416155495125,NaN,NaN,NaN,NaN,5.796931993276833,18.52746956817841,164018536,-1.7066104973580127,-3.061196000158702,-1.3545855028006895
2025-04-01T09:30:00-04:00,374.61,382.36,373.23,380.82,NaN,NaN,NaN,387.3064512824887,NaN,NaN,388.23000000000013,402.39187798278635,374.0681220172139,385.15919953871656,378.80333333333334,378.80333333333334,378.80333333333334,1059371,741741.9666666667,44.34842283069982,47.709994775667546,NaN,NaN,NaN,NaN,6.035008279471344,18.284775205265216,165077907,-1.3249982002971357,-3.010833253172109,-1.6858350528749733
2025-04-01T13:30:00-04:00,380.78,382.82,378.27,382.07,NaN,NaN,NaN,387.3064512824887,NaN,NaN,387.91220000000015,401.8985010349209,373.9258989650794,384.9133596309733,379.5763585423239,380.6448802999357,378.507836784712,554458,734575.4333333333,45.8600001489364,47.165767753244005,NaN,NaN,NaN,NaN,5.928936259509106,17.976376689701386,165632365,-0.9212108942912702,-2.837348670739061,-1.916137776447791
2025-04-02T09:30:00-04:00,377.965,385.07,376.66,383.99,NaN,NaN,NaN,387.3064512824887,NaN,NaN,387.5880000000001,401.16546972007575,374.0105302799244,382.8397601310583,381.9066666666667,381.9066666666667,381.9066666666667,677431,724951.7333333333,48.18787789807867,46.67582964948361,NaN,NaN,NaN,NaN,6.106155098115596,17.278876546185536,166309796,-0.4798344593599664,-2.5159308506477487,-2.0360963912877823
2025-04-02T13:30:00-04:00,383.96,384.04,380.26,381.99,NaN,NaN,NaN,387.3064512824887,NaN,NaN,387.2332000000001,400.44519860124774,374.0212013987525,382.8397601310583,381.9915666512338,382.0860282292062,381.89710507326146,547230,716975.7333333333,45.97052492692039,46.002049076722884,NaN,NaN,NaN,NaN,5.940001162535912,16.63119784149225,165762566,-0.28710717107157047,-2.3949803551272453,-2.107873184055675
2025-04-03T09:30:00-04:00,375.06,377.49,369.3,375.77,NaN,NaN,NaN,387.3064512824887,NaN,NaN,386.7820000000001,399.9882053595838,373.5757946404164,382.8397601310583,374.18666666666667,374.18666666666667,374.18666666666667,1361789,730085.6666666666,39.831875166375035,44.74020055950166,NaN,NaN,NaN,NaN,6.42214393664049,17.485160698303766,164400777,-0.5289875996751578,-2.7691076836496222,-2.2401200839744644
2025-04-03T13:30:00-04:00,375.77,377.06,372.61,373.18,NaN,NaN,NaN,387.3064512824887,NaN,NaN,386.39400000000006,400.0290097909615,372.75899020903864,375.10280810484664,374.2277654222805,374.27555424930114,374.1799765952599,1007197,746868.5,37.58146754221376,43.27249058703733,NaN,NaN,NaN,NaN,6.281276512594739,18.27812620820017,163393580,-0.7977281643191612,-3.237280289373416,-2.439552125054255
2025-04-04T09:30:00-04:00,364.26,374.5,362.85,364.54,NaN,NaN,NaN,387.3064512824887,NaN,NaN,385.86020000000013,400.7299866776689,370.9904133223314,368.29035235826956,367.2966666666667,367.2966666666667,367.2966666666667,2254111,790979.2333333333,31.24060260618947,41.7423296318022,NaN,NaN,NaN,NaN,6.664756761695114,19.965783365382922,161139469,-1.4534949996412316,-4.256420874605794,-2.8029258749645627
2025-04-04T13:30:00-04:00,364.5,366.59,359.48,359.89,NaN,NaN,NaN,382.260401751297,NaN,NaN,385.11920000000015,401.3379970404538,368.9004029595465,368.29035235826956,365.08278396719777,367.7008826145337,362.4646853198618,1611805,823579.1,28.457697370659986,40.215597695561954,NaN,NaN,NaN,NaN,6.69655985014546,21.80200625337046,159527664,-2.059520734620033,-5.377326793239604,-3.317806058619571
2025-04-07T09:30:00-04:00,350.02,370.89,344.8,359.11,NaN,NaN,NaN,379.7542471262381,NaN,NaN,384.4372000000001,402.0460124710231,366.82838752897703,368.29035235826956,358.2666666666667,358.266670481364,358.26666285196944,3014172,902366.5,28.00701336345074,38.65450314737468,NaN,NaN,NaN,NaN,8.081805575135068,24.412260653492286,156513492,-2.3509324177845397,-6.256471580850246,-3.905539163065706
2025-04-07T13:30:00-04:00,359.1,361.62,354.81,357.77,NaN,NaN,NaN,379.7542471262381,NaN,NaN,383.82180000000005,402.90320285827136,364.74039714172875,368.29035235826956,358.20260468355065,358.2959238077792,358.1092855593221,1420455,929634.2,27.209767810537627,36.94760105561551,NaN,NaN,NaN,NaN,7.990962319768277,26.836068310748267,155093037,-2.46025346760545,-6.980855997572519,-4.520602529967069
2025-04-08T09:30:00-04:00,368.255,373.63,358.14,358.465,NaN,NaN,NaN,379.7542471262381,NaN,NaN,383.2815000000001,403.6321671389318,362.93083286106844,368.29035235826956,363.4116666666666,363.4116742960611,363.41165903727205,1567169,955657.7666666667,28.349000012325234,36.445092967900344,NaN,NaN,NaN,NaN,8.55303643978483,27.03708102932393,156660206,-2.314236484872648,-7.413398136057879,-5.099161651185231
2025-04-08T13:30:00-04:00,358.33,362.64,350.22,355.5,NaN,NaN,NaN,379.7542471262381,NaN,NaN,382.61830000000003,404.33974089234533,360.89685910765473,368.29035235826956,360.2871707453661,363.8955371343649,356.6788043563673,1175045,977871.2666666667,26.447287514378857,35.66837193863655,NaN,NaN,NaN,NaN,8.829248122657338,27.79670163174745,155485161,-2.244131058073023,-7.90432547377651,-5.6601944157034865
2025-04-09T09:30:00-04:00,353.535,384.74,353.12,379.13,343.8095982487029,343.8095982487029,343.8095982487029,NaN,NaN,NaN,382.2911000000001,403.71799340897593,360.86420659102424,368.29035235826956,372.33,372.33,372.33,2006737,1027171.4333333333,53.32197002790619,37.262214943197826,NaN,NaN,NaN,NaN,10.45715897103896,25.992482285367196,157491898,-0.5229349683444866,-6.313863126134095,-5.790928157789608
2025-04-09T13:30:00-04:00,379.06,393.24,378.21,389.78,358.00205613293383,NaN,NaN,NaN,NaN,NaN,382.06370000000004,402.9188902230508,361.20850977694926,359.6792255092925,380.22934608268025,387.5838926378364,372.8747995275241,2315053,1078479.2,60.35309075818722,38.94047128406141,NaN,NaN,NaN,NaN,10.783790473107606,24.654800289110703,159806951,1.315743417019485,-4.146248886515252,-5.461992303534737
2025-04-10T09:30:00-04:00,382.48,383.87,367.79,374.06,358.00205613293383,NaN,NaN,NaN,NaN,NaN,381.6005,402.1146025882149,361.08639741178513,359.6792255092925,375.24,375.24,375.24,1605098,1109906.5666666667,48.693774250768236,39.25085352835201,NaN,NaN,NaN,NaN,11.584234010742774,23.233438690045986,158201853,1.4458002297779515,-3.654742016312298,-5.100542246090249
2025-04-10T13:30:00-04:00,374,383.53,373.22,381.3,358.00205613293383,NaN,NaN,NaN,NaN,NaN,381.2869,401.32486216085573,361.2489378391443,354.770380407434,377.0770822721484,379.1204953150532,375.0336692292436,1297318,1134289.1666666667,53.17994881047616,39.77370700417628,NaN,NaN,NaN,NaN,11.493217295689716,21.913602919485893,159499171,1.9600666393689208,-2.650458946879098,-4.610525586248019
2025-04-11T09:30:00-04:00,380.635,388.1,378.99,385.5,358.00205613293383,NaN,NaN,NaN,NaN,NaN,381.1949000000001,401.11203910077603,361.2777608992241,354.30364336122113,384.1966666666667,384.1966666666667,384.1966666666667,933717,1141857.1333333333,55.605077610398524,40.3035069836277,NaN,NaN,NaN,NaN,11.322987488854737,20.412167969840624,160432888,2.4897163995444904,-1.4983800868174058,-3.988096486361896
2025-04-11T13:30:00-04:00,385.48,390.02,384.88,388.17,358.6584593085731,NaN,NaN,NaN,NaN,NaN,381.09170000000006,400.80872661254386,361.37467338745626,358.9290283207562,385.8453787548042,387.5892965696594,384.101460939949,834551,1139822.4666666666,57.12544722788756,41.1002871479825,NaN,NaN,NaN,NaN,10.881345525365111,19.186589971756327,161267439,2.8979274372748582,-0.36568718976832315,-3.2636146270431814
2025-04-14T09:30:00-04:00,393.105,394.66,384.22,386.32,360.5335293400017,NaN,NaN,NaN,NaN,NaN,381.20810000000006,400.9784248218048,361.4377751781953,364.567222656605,388.40000000000003,388.40000000000003,388.40000000000003,914229,1138881.8,55.7020305224349,42.23386967341535,NaN,NaN,NaN,NaN,10.849820844981888,18.451919406298096,160353210,2.9135631360251857,0.3783392929883007,-2.535223843036885
2025-04-14T13:30:00-04:00,386.3,390.265,385.53,388.05,360.5335293400017,NaN,NaN,NaN,NaN,NaN,381.3647000000001,401.22507435799133,361.50432564200884,364.567222656605,388.26301636921437,388.47063723713677,388.05539550129197,397970,1133901,56.78641136605954,43.60565137511862,NaN,NaN,NaN,NaN,10.413047927483182,17.769725309801167,160751180,2.9041472053127193,1.0949601636040143,-1.809187041708705
2025-04-15T09:30:00-04:00,388.555,391.85,384.55,384.79,360.5335293400017,NaN,NaN,NaN,NaN,NaN,381.51670000000007,401.3632719568817,361.67012804311844,367.04662250022716,387.06333333333333,387.06333333333333,387.06333333333333,888572,1137596.2333333334,54.098945260810424,45.23839013616298,NaN,NaN,NaN,NaN,10.190687361234383,17.283331876456092,159862608,2.554453715851066,1.3838801031051275,-1.1705736127459385
2025-04-15T13:30:00-04:00,384.8,386.36,384.18,385.63,360.5335293400017,NaN,NaN,NaN,NaN,NaN,381.62210000000005,401.49893285535677,361.7452671446433,367.04662250022716,386.4982261822864,387.2895962225211,385.70685614205166,453101,1137108.5,54.69392392275751,47.112406318455655,NaN,NaN,NaN,NaN,9.6184954068605,16.78690098330046,160315709,2.2656426603170856,1.6614797126504186,-0.6041629476666671
2025-04-16T09:30:00-04:00,380.67,381.6,375.9,377.47,360.5335293400017,NaN,NaN,NaN,NaN,NaN,381.4891000000001,401.38627976898636,361.5919202310139,367.04662250022716,378.3233333333333,378.3233333333333,378.3233333333333,903069,1144531.1,48.16282536511125,48.552107175717126,NaN,NaN,NaN,NaN,9.62646002065618,15.794228392129314,159412640,1.450608655374698,1.2090978715517053,-0.24151078382299263
2025-04-16T13:30:00-04:00,377.53,377.53,368.245,371.62,360.5335293400017,NaN,NaN,NaN,NaN,NaN,381.2555000000001,401.3355664590441,361.1754335409561,367.04662250022716,375.0683619324545,377.97935293833666,372.1573709265723,1129103,1164931.8666666667,44.09736110908725,49.75836383989924,NaN,NaN,NaN,NaN,9.602070019180738,15.611895170961084,158283537,0.4925863025599401,0.37422209437693255,-0.11836420818300758
2025-04-17T09:30:00-04:00,373.6,374.32,368.58,370.33,360.5335293400017,NaN,NaN,NaN,NaN,NaN,381.0877000000001,401.3887212757774,360.7866787242228,367.04662250022716,371.07666666666665,371.07666666666665,371.07666666666665,688505,1167782.7333333334,43.2307788796725,50.82134804470976,NaN,NaN,NaN,NaN,9.326207874953543,15.442585751304868,157595032,-0.2149514185801556,-0.38705348140820206,-0.17210206282804646
2025-04-17T13:30:00-04:00,370.43,371.92,366.9,367.63,360.5335293400017,NaN,NaN,NaN,NaN,NaN,380.8637000000001,401.5037523070918,360.2236476929084,367.04662250022716,370.0969032439072,371.21687153403184,368.9769349537826,526912,1173460.2666666666,41.397089686903065,51.88919105703292,NaN,NaN,NaN,NaN,9.01862159817115,15.449071051306246,157068120,-0.8178929170071676,-1.194468209087006,-0.37657529207983836
2025-04-21T09:30:00-04:00,362.815,364.35,357.76,358.53,NaN,NaN,NaN,387.3486930543665,387.3486930543665,387.3486930543665,380.2809000000001,401.7483313964102,358.81346860358997,367.04662250022716,360.2133333333333,360.2133333333333,360.2133333333333,812255,1164600.1666666667,35.87408061629509,50.64291324191783,NaN,NaN,NaN,NaN,9.079434341158924,16.26372514728471,156255865,-1.7302372447745795,-2.539371848048063,-0.8091346032734833
2025-04-21T13:30:00-04:00,358.49,359.73,355.7,359.07,NaN,NaN,NaN,383.3630706428044,NaN,NaN,379.6959000000001,401.83870295625377,357.55309704374645,367.04662250022716,359.28239431814546,360.3015480852855,358.2632405510054,677728,1159862.6666666667,36.41619324272324,48.933134847956126,NaN,NaN,NaN,NaN,8.718760459647575,17.184800186474348,156933593,-2.1695368347304407,-3.521055646686534,-1.3515188119560935
2025-04-22T09:30:00-04:00,363.25,367.77,359.98,363.57,NaN,NaN,NaN,383.3630706428044,NaN,NaN,379.2001000000001,401.6526876896084,356.74751231039176,367.04662250022716,363.7733333333333,363.7733333333333,363.7733333333333,732864,1143856.5666666667,40.89999951028413,48.37643665220726,NaN,NaN,NaN,NaN,8.717420426815604,16.96124585103219,157666457,-2.031649574995359,-3.8910807807002925,-1.8594312057049334
2025-04-22T13:30:00-04:00,363.68,367.36,362.785,366.68,NaN,NaN,NaN,383.3630706428044,NaN,NaN,378.7581000000001,401.30883195174783,356.2073680482524,367.04662250022716,364.578753363207,365.4893818990186,363.6681248273954,573305,1131344,43.84716523957183,47.709809254285524,NaN,NaN,NaN,NaN,8.421533253471631,16.753659682407328,158239762,-1.6232970702093579,-3.8885525434666306,-2.2652554732572727
2025-04-23T09:30:00-04:00,375.82,380.35,373.5,377,NaN,NaN,NaN,383.3630706428044,NaN,NaN,378.65110000000016,401.18340678735206,356.11879321264826,365.42729800018174,376.95,376.95,376.95,1051030,1131065.9666666666,52.340372282199255,47.476616016557,NaN,NaN,NaN,NaN,8.796423735366515,16.017313702108947,159290792,-0.6030035241717746,-3.0190098784719908,-2.416006354300216
2025-04-23T13:30:00-04:00,377.05,378,373.05,374.17,NaN,NaN,NaN,383.3630706428044,NaN,NaN,378.4641000000001,400.9868640124314,355.9413359875688,359.98883840014537,376.32909457121326,377.2121058790929,375.4460832633336,519677,1129906.6,50.10242331371988,46.974971451259314,NaN,NaN,NaN,NaN,8.521679182840334,15.282920976991802,158771115,-0.09047057457980179,-2.5290945725249685,-2.4386239979451667
2025-04-24T09:30:00-04:00,375.695,385.16,375.15,385.01,354.4607009948812,354.4607009948812,354.4607009948812,NaN,NaN,NaN,378.46170000000006,400.9816476562384,355.9417523437617,364.45220629906134,381.7733333333333,381.7733333333333,381.7733333333333,790868,1133687.8333333333,57.58367023034726,47.10937428753876,NaN,NaN,NaN,NaN,8.697987812637454,15.290730920764165,159561983,0.9495337111066382,-1.2517068590618692,-2.2012405701685074
2025-04-24T13:30:00-04:00,385.08,388.46,384.57,387.25,361.4581691314776,NaN,NaN,NaN,NaN,NaN,378.44810000000007,400.94596975603764,355.9502302439625,369.94876503924905,384.21559637020846,386.70840661888747,381.72278612152945,759120,1140750.8333333333,58.95321764537927,47.26414616463303,NaN,NaN,NaN,NaN,8.354560111734777,15.590397680557826,160321103,1.7146319800274221,-0.05795059513422984,-1.772582575161652
2025-04-25T09:30:00-04:00,387.01,390.9,384.6,390.56,362.9730250800468,NaN,NaN,NaN,NaN,NaN,378.54630000000003,401.21129572556475,355.8813042744353,372.9410120313993,388.68666666666667,388.68666666666667,388.68666666666667,640825,1116718.7,60.95920107363119,47.754164436977376,NaN,NaN,NaN,NaN,8.207805818039432,16.082014476061257,160961928,2.3316936751003046,1.1420345187137286,-1.189659156386576
2025-04-25T13:30:00-04:00,390.53,392.15,389.02,391.81,366.50743303095373,NaN,NaN,NaN,NaN,NaN,378.6455000000001,401.4976467919239,355.79335320807627,376.2178096251194,389.92052916027995,391.0710476660346,388.7700106545253,737031,1107713.1666666667,61.720029137326186,48.256029095160855,NaN,NaN,NaN,NaN,7.845105402465187,16.6495840221938,161698959,2.686842730925429,2.1688942572702103,-0.5179484736552187
2025-04-28T09:30:00-04:00,392.06,392.06,386.65,387.19,366.50743303095373,NaN,NaN,NaN,NaN,NaN,378.6949000000001,401.6099510791413,355.77984892085885,376.6092477000955,388.6333333333334,388.6333333333334,388.6333333333334,632991,1053675.8333333333,57.27713695405352,48.90705135151388,NaN,NaN,NaN,NaN,7.671169302289103,16.828076135049624,161065968,2.478478973512888,2.5801502432358916,0.10167126972300344
2025-04-28T13:30:00-04:00,387.15,392.73,386.93,391.13,366.50743303095373,NaN,NaN,NaN,NaN,NaN,378.69450000000006,401.6086820931892,355.7803179068109,377.4693981600764,389.2313443816203,390.0169274738787,388.44576128936194,366802,1012175.7333333333,59.92646785503405,50.03770183336722,NaN,NaN,NaN,NaN,7.537514352125597,17.062171777299557,161432770,2.468469321642484,3.1872579217761086,0.7187886001336244
2025-04-29T09:30:00-04:00,391.2,394.91,390.38,392.63,369.65888639177894,NaN,NaN,NaN,NaN,NaN,378.69640000000004,401.6151875804949,355.7776124195052,380.43651852806113,392.64000000000004,392.64000000000004,392.64000000000004,545309,929880.3,60.92006293490319,51.301222123026555,NaN,NaN,NaN,NaN,7.322691898402342,17.50679684035001,161978079,2.421967662240374,3.746248177934092,1.3242805156937179
2025-04-29T13:30:00-04:00,392.62,395.1,392.55,394.01,371.53598246487996,NaN,NaN,NaN,NaN,NaN,378.7198,401.698612585507,355.740987414493,382.2462148224489,393.2640914172191,393.8874242895651,392.6407585448731,546637,900753.0333333333,61.857060534142036,52.76264861211506,NaN,NaN,NaN,NaN,6.981785334230747,17.940067122838666,162524716,2.3418529394372376,4.251596689990265,1.9097437505530275
2025-04-30T09:30:00-04:00,390.33,391.035,384.44,390.07,371.53598246487996,NaN,NaN,NaN,NaN,NaN,378.6292000000001,401.39155263411334,355.8668473658868,382.2462148224489,388.51500000000004,388.51500000000004,388.51500000000004,881293,877890.5,57.61003765688188,54.31521697215697,NaN,NaN,NaN,NaN,7.166657810357123,17.052349890305532,161643423,1.9000224177731235,4.284771772769432,2.384749354996308
2025-04-30T13:30:00-04:00,390,396.66,389.41,392.71,371.53598246487996,NaN,NaN,NaN,NaN,NaN,378.58090000000004,401.2129119909787,355.9488880090214,382.2462148224489,390.8777737771019,393.0780170344486,388.6775305197552,1016303,872599.1,59.6110522203036,55.971992613412716,NaN,NaN,NaN,NaN,7.172610823903042,16.892313881109697,162659726,1.6702266195135005,4.4725326293881835,2.802306009874683
2025-05-01T09:30:00-04:00,431.43,437,427.64,429.1,404.76202841916347,NaN,NaN,NaN,NaN,NaN,379.32849999999996,405.7923588456044,352.86464115439554,402.3114619890938,431.24666666666667,431.24666666666667,431.24666666666667,3718562,929659.9333333333,76.25197776911477,58.49713391761485,NaN,NaN,NaN,NaN,9.823852907909968,19.371549183380353,166378288,3.735415723081156,7.471575663726128,3.736159940644972
2025-05-01T13:30:00-04:00,429.11,431.89,424.94,425.26,404.76202841916347,NaN,NaN,NaN,NaN,NaN,380.0375000000001,409.3344685974455,350.74053140255467,402.3114619890938,430.13263398167743,431.8890768178847,428.37619114547016,1495901,902354.8666666667,72.84140661591022,60.56815115878188,NaN,NaN,NaN,NaN,9.618577700202113,21.346789983942443,164882387,4.554897893081507,9.429782306996856,4.874884413915349
2025-05-02T09:30:00-04:00,431.75,439.44,429.99,436.5,406.7670754810974,NaN,NaN,NaN,NaN,NaN,380.97090000000003,414.1702538304574,347.77154616954266,407.36933567302003,435.31,435.31,435.31,2152021,920585.6333333333,76.1973937320053,62.27222411948231,NaN,NaN,NaN,NaN,9.944393578759104,23.49627535415161,167034408,5.502625317705012,11.753166061046613,6.250540743341602
2025-05-02T13:30:00-04:00,436.48,437.32,434.6,434.95,408.91152659559293,NaN,NaN,NaN,NaN,NaN,381.85769999999997,418.2543745299636,345.4610254700363,410.30346853841604,435.394017450636,435.5328213982645,435.2552135030075,788464,903623.8333333334,74.82428273719279,64.03807122115894,NaN,NaN,NaN,NaN,9.428365465990595,25.492226055060126,166245944,5.652283429365128,13.315895030048011,7.663611600682883
2025-05-05T09:30:00-04:00,432.87,439.5,432.11,438.87,408.9782753867023,NaN,NaN,NaN,NaN,NaN,383.0823,422.79789397566753,343.3667060243324,414.19177483073287,436.82666666666665,436.82666666666665,436.82666666666665,857299,901076.5666666667,76.00209975164381,65.35367332982298,NaN,NaN,NaN,NaN,9.282767932705552,27.011465952882542,167103243,5.630081755127913,14.701213794592775,9.071132039464862
2025-05-05T13:30:00-04:00,438.86,439.02,435,436.06,410.8544901418522,NaN,NaN,NaN,NaN,NaN,384.2265,426.5961775654475,341.8568224345525,416.7634198645863,436.78212117540204,436.84501074540026,436.7192316054038,430113,887595.3,73.35287945250494,66.38222060176052,NaN,NaN,NaN,NaN,8.906855937512296,28.422188715146213,166673130,5.059000572356281,15.394882754910213,10.335882182553933
2025-05-06T09:30:00-04:00,432.2,437.72,431.17,435.94,410.8544901418522,NaN,NaN,NaN,NaN,NaN,385.5209,430.11795208598454,340.9238479140154,416.7634198645863,434.9433333333334,434.9433333333334,434.9433333333334,847447,885369.2333333333,73.23547796138622,67.25909752231446,NaN,NaN,NaN,NaN,8.738509084832847,29.184652785620813,165825683,4.3339683965007545,15.753342678179877,11.419374281679122
2025-05-06T13:30:00-04:00,435.94,436.24,433.23,433.35,410.8544901418522,NaN,NaN,NaN,NaN,NaN,386.68589999999995,433.13792220313144,340.23387779686846,417.87078871333523,434.72735970541316,435.0405014029881,434.4142180078382,403118,885540.8333333334,70.6087320762304,67.89400487509333,NaN,NaN,NaN,NaN,8.329329864487644,29.892655136775797,165422565,3.3829424851469216,15.648052388112774,12.265109902965852
2025-05-07T09:30:00-04:00,434.06,436.18,431.12,435.66,410.8544901418522,NaN,NaN,NaN,NaN,NaN,387.78270000000003,436.17797643107224,339.38742356892783,418.9546309706682,434.32,434.32,434.32,832002,883655.1666666666,71.58755045880012,68.91617726828953,NaN,NaN,NaN,NaN,8.095806302738527,30.229251970024073,166254567,2.6451185708618894,15.571508116543214,12.926389545681324
2025-05-07T13:30:00-04:00,435.63,438.12,432.18,433.12,410.8544901418522,NaN,NaN,NaN,NaN,NaN,388.80370000000005,438.80129877473985,338.80610122526025,421.36970477653455,434.38090782151914,434.4559373926861,434.3058782503522,548284,886827.9333333333,68.87154859474764,69.5551116068405,NaN,NaN,NaN,NaN,7.941820138257204,30.686531058953985,165706283,1.7640590569224575,15.131463366834396,13.367404309911938
2025-05-08T09:30:00-04:00,437.93,443.66,435.63,443.51,414.9798638247412,NaN,NaN,NaN,NaN,NaN,389.99410000000006,442.2593875124558,337.7288124875443,424.98976382122765,440.9333333333334,440.9333333333334,440.9333333333334,1228379,897671.6,73.32910339946781,70.44147164002369,NaN,NaN,NaN,NaN,8.127404414095976,31.504915450964933,166934662,1.6605505853960452,15.443092541656995,13.78254195626095
2025-05-08T13:30:00-04:00,443.52,443.57,437.67,438.46,416.27146092361664,NaN,NaN,NaN,NaN,NaN,391.12350000000004,445.06187529069473,337.18512470930534,425.6838110569821,440.5831166289408,441.0722371197175,440.0939961381641,629759,881026.8,68.2159850572669,70.8956805345326,NaN,NaN,NaN,NaN,7.9683040988034035,32.2648438149751,166304903,1.0606926686805824,15.108407792111677,14.047715123431095
2025-05-09T09:30:00-04:00,439.82,440.5,435.88,436.77,416.27146092361664,NaN,NaN,NaN,NaN,NaN,392.34350000000006,447.58139070013306,337.10560929986707,425.6838110569821,437.7166666666667,437.7166666666667,437.7166666666667,557402,876656.7,66.5437521521097,71.53380299847746,NaN,NaN,NaN,NaN,7.729139520317446,32.64995771385163,165747501,0.39318789609905735,14.539199993554917,14.14601209745586
2025-05-09T13:30:00-04:00,436.795,439.675,436.405,438.66,416.27146092361664,NaN,NaN,NaN,NaN,NaN,393.6531,450.10310120070835,337.20309879929164,425.6838110569821,437.9581154538011,438.22206685159153,437.69416405601066,466413,874640.0666666667,67.50317772107596,72.09752624853262,NaN,NaN,NaN,NaN,7.410629554580488,33.0075634770941,166213914,-0.054153830305534,14.07831980957394,14.132473639879475
2025-05-12T09:30:00-04:00,445.97,447.155,439.81,446.32,420.14750372028675,NaN,NaN,NaN,NaN,NaN,395.2887,452.9948545005382,337.5825454994618,430.9633712611748,444.4283333333332,444.42834096272776,444.4283257039387,1274728,890055.8333333334,71.11819247280326,71.73082729879607,NaN,NaN,NaN,NaN,7.488084586396163,33.9305421330843,167488642,0.028300115623247635,14.167848784408534,14.139548668785286
2025-05-12T13:30:00-04:00,446.36,449.37,445.85,449.2,424.85568536936466,NaN,NaN,NaN,NaN,NaN,397.07490000000007,455.80740420303687,338.3423957969633,434.6566970089399,445.6826967344091,447.43835936763764,443.92703410118054,650702,889154.9666666667,72.36301720475836,71.69665662657094,NaN,NaN,NaN,NaN,7.20464997308215,34.944396377570314,168139344,0.13338441829203695,14.306279191650333,14.172894773358296
2025-05-13T09:30:00-04:00,447.65,450.65,445.37,448.54,425.5699723980299,NaN,NaN,NaN,NaN,NaN,398.86350000000004,458.30503868297814,339.42196131702195,436.2393576071519,448.18666666666667,448.18666666666667,448.18666666666667,1183405,904173,71.6013917787256,71.36837077276525,NaN,NaN,NaN,NaN,7.067174975004852,35.97714651986044,166955939,0.020925757368456033,14.199051970068865,14.178126212700409
2025-05-13T13:30:00-04:00,448.5,450.15,447.35,448.87,426.9481554708467,NaN,NaN,NaN,NaN,NaN,400.68550000000005,460.56016683832013,340.81083316167997,437.22148608572155,448.39843401432626,448.6863938903247,448.1104741383278,640011,906396.5333333333,71.76142942822739,71.14959553641059,NaN,NaN,NaN,NaN,6.762376762504502,36.93612879484413,167595950,-0.1588575566469821,13.979554266891682,14.138411823538664
2025-05-14T09:30:00-04:00,448.045,453.89,447.87,450.76,429.24823931308094,NaN,NaN,NaN,NaN,NaN,402.5314000000001,462.7753800823267,342.28741991767345,440.53718886857723,450.84,450.84,450.84,1149784,909688.3333333334,72.70998215148566,70.91444427925641,NaN,NaN,NaN,NaN,6.709349850897036,38.10515991698342,168745734,-0.27149649646580976,13.799041202956403,14.070537699422212
2025-05-14T13:30:00-04:00,450.8,453.31,450.45,452.97,430.84150116248634,NaN,NaN,NaN,NaN,NaN,404.48080000000004,464.8190505334697,344.1425494665304,441.1977510948618,451.30468045775075,451.9651148964916,450.64424601900987,569201,911339.1333333333,73.81748604747767,70.94763046461162,NaN,NaN,NaN,NaN,6.434396290118677,39.190688816112754,169314935,-0.31510547613337003,13.6766558542555,13.99176133038887
2025-05-15T09:30:00-04:00,450.765,456.18,450.475,456.01,432.467342018737,NaN,NaN,NaN,NaN,NaN,406.01840000000004,467.59968980266586,344.4371101973342,443.63770087588944,454.22166666666664,454.22166666666664,454.22166666666664,1041431,919691.2333333333,75.30227390128859,71.09525874603322,NaN,NaN,NaN,NaN,6.3822965551102,40.41278848799706,170356366,-0.2594749092480715,13.667417693828781,13.926892603076853
2025-05-15T13:30:00-04:00,456.04,456.05,451.1,453.05,432.98803101788536,NaN,NaN,NaN,NaN,NaN,407.28380000000004,470.06686432661525,344.50073567338484,443.63770087588944,453.891324620649,454.2941957917176,453.48845344958045,700206,917727.4333333333,71.0758051580506,71.12862110902037,NaN,NaN,NaN,NaN,6.279989658316613,41.547595326175355,169656160,-0.5268737505156444,13.268300414932298,13.795174165447943
2025-05-16T09:30:00-04:00,452.52,452.68,448.73,450.56,432.98803101788536,NaN,NaN,NaN,NaN,NaN,408.81380000000007,472.0108747285013,345.61672527149886,443.63770087588944,450.6566666666667,450.6566666666667,450.6566666666667,853322,924810.6666666666,67.63670870518789,70.8464181266195,NaN,NaN,NaN,NaN,6.139990397008283,41.954759160715255,168802838,-0.9515285237316427,12.60576351078339,13.557292034515033
2025-05-16T13:30:00-04:00,450.61,454.36,450.595,454.26,432.98803101788536,NaN,NaN,NaN,NaN,NaN,410.27299999999997,474.2262722227734,346.31972777722655,443.63770087588944,451.65251025920196,452.8413154641055,450.46370505429843,598789,920202.6,69.96251327889642,70.92434417548728,NaN,NaN,NaN,NaN,5.972848225793407,42.49237760567867,169401627,-1.0552870986071667,12.238183161256075,13.293470259863241
2025-05-19T09:30:00-04:00,450.875,459.56,450.78,458.78,435.036018055657,NaN,NaN,NaN,NaN,NaN,411.7386,476.7044933299623,346.77270667003773,445.8630742787643,456.3733333333333,456.3733333333333,456.3733333333333,1032270,933511.9,72.55712043622071,70.86920253525534,NaN,NaN,NaN,NaN,6.173359066808166,43.43788458398823,170433897,-0.897739260116543,12.171296184717562,13.069035444834105
2025-05-19T13:30:00-04:00,458.74,459.5,457.18,458.735,438.8048354167635,NaN,NaN,NaN,NaN,NaN,413.1499,479.0654129082677,347.2343870917323,447.3824594230114,456.98670514389397,457.9410811378353,456.03232914995266,426385,935498,72.48998608463316,71.17448832292436,NaN,NaN,NaN,NaN,5.898119133464725,44.31585534956139,170007512,-0.8739500480635609,11.976597884754653,12.850547932818214
2025-05-20T09:30:00-04:00,455.62,457.57,454.37,457.365,438.8048354167635,NaN,NaN,NaN,NaN,NaN,414.5708,481.17102175218326,347.9705782478168,447.3824594230114,456.435,456.435,456.435,627283,938230.4666666667,70.35568019442049,71.44676889737512,NaN,NaN,NaN,NaN,5.788610623931531,44.330935015632825,169380229,-1.0178117171489909,11.578283286381975,12.596095003530966
2025-05-20T13:30:00-04:00,457.37,458.62,455.02,458.33,438.8048354167635,NaN,NaN,NaN,NaN,NaN,415.9763999999999,483.24160550894237,348.7111944910574,447.3824594230114,456.79928492095587,457.2362093245968,456.3623605173149,436047,934544.1333333333,71.00329785518277,71.69677747838276,NaN,NaN,NaN,NaN,5.632281293650708,44.45641130456636,169816276,-1.1078782003813359,11.211247253054296,12.319125453435632
2025-05-21T09:30:00-04:00,454.56,457.79,452.38,452.5,438.8048354167635,NaN,NaN,NaN,NaN,NaN,417.3306,484.75598829372666,349.90521170627335,447.3824594230114,454.22333333333336,454.22333333333336,454.22333333333336,967320,937411.7,62.167130364981425,71.05741589925262,NaN,NaN,NaN,NaN,5.654975486961371,43.83430667825475,168848956,-1.590621416549732,10.330848682748467,11.9214700992982
2025-05-21T13:30:00-04:00,452.36,454.9,451.83,452.37,438.8048354167635,NaN,NaN,NaN,NaN,NaN,418.6653999999999,486.17008682514,351.16071317485984,447.3824594230114,453.7887099025083,454.361688397812,453.2157314072046,556570,922087.2666666667,61.98190101964122,70.31590760031568,NaN,NaN,NaN,NaN,5.470334380749844,43.1050596731646,168292386,-1.926794572704349,9.512976883417764,11.439771456122113
2025-05-22T09:30:00-04:00,454.95,460.25,453.9,455.74,438.8048354167635,NaN,NaN,NaN,NaN,NaN,420.23079999999993,487.47124938457887,352.990350615421,447.3917723037324,456.62999999999994,456.62999999999994,456.62999999999994,1080190,834141.5333333333,64.90141035722911,69.83733749878022,NaN,NaN,NaN,NaN,5.642453353553427,43.095053639627366,169372576,-1.9257243244874154,9.032616050512843,10.958340375000258
2025-05-22T13:30:00-04:00,455.745,457.56,454.19,454.89,438.8048354167635,NaN,NaN,NaN,NaN,NaN,421.8961999999999,488.358548937126,355.4338510628738,447.3917723037324,456.28550900545105,456.79001324933245,455.78100476156965,503647,801066.4,63.575294224237766,69.2526135556381,NaN,NaN,NaN,NaN,5.48013525687104,43.085762322771366,168868929,-1.9782539741218876,8.4855229073479,10.463776881469787
2025-05-23T09:30:00-04:00,449.54,452.99,448.92,452.94,438.8048354167635,NaN,NaN,NaN,NaN,NaN,423.5483999999999,488.89896487713287,358.19783512286693,447.3917723037324,451.61666666666673,451.61666666666673,451.61666666666673,771923,755063.1333333333,60.52017630405467,68.38191313796446,NaN,NaN,NaN,NaN,5.515125595665963,41.6628616618163,168097006,-2.127315899524845,7.804632007063731,9.931947906588576
2025-05-23T13:30:00-04:00,452.92,453.66,449.97,450.25,438.8048354167635,NaN,NaN,NaN,NaN,NaN,425.20079999999984,488.9711948979499,361.4304051020498,447.3917723037324,451.49649075154093,451.6527425632322,451.34023893984966,456624,744001.8,56.48749183686371,67.1440564086349,NaN,NaN,NaN,NaN,5.384759481689822,40.44372663272792,167640382,-2.3714448007740536,6.967641905621008,9.339086706395062
2025-05-27T09:30:00-04:00,456.37,460.25,456.22,459.08,439.7948011020365,NaN,NaN,NaN,NaN,NaN,427.21179999999987,488.748058832012,365.6755411679877,447.3917723037324,458.5166666666667,458.5166666666667,458.5166666666667,855018,743925.7666666667,64.7829463122873,66.39267586656338,NaN,NaN,NaN,NaN,5.714419518711978,40.1985316778472,168495400,-1.9217777107485823,6.936864567959333,8.858642278707915
2025-05-27T13:30:00-04:00,459.02,460.97,458.67,460.69,441.90435559739853,NaN,NaN,NaN,NaN,NaN,429.2441999999999,488.3067714766995,370.18162852330033,448.20731994848705,459.2808946639069,460.07690063783366,458.48488868998015,788113,755859.1,66.05371971117532,66.03395547750085,NaN,NaN,NaN,NaN,5.470532410232551,40.056360728340515,169283513,-1.5172084389778746,6.962131729985572,8.479340168963446
2025-05-28T09:30:00-04:00,461.25,462.53,457.7,457.89,442.35506670660766,NaN,NaN,NaN,NaN,NaN,431.13059999999984,487.6527357926291,374.6084642073706,449.9048559587896,459.3733333333332,459.37334096272775,459.3733257039387,662322,749688.2666666667,61.87226002264213,65.6222091430333,NaN,NaN,NaN,NaN,5.424780095215939,40.11176492378846,168621191,-1.4400916682483853,6.679225583652965,8.11931725190135
2025-05-28T13:30:00-04:00,457.88,458.87,456.93,457.41,442.35506670660766,NaN,NaN,NaN,NaN,NaN,432.9451999999999,486.8387887081219,379.05161129187786,449.9048559587896,458.76789493144486,459.5580501014315,457.9777397614582,388852,749212.7333333333,61.157519530019435,64.99328101811352,NaN,NaN,NaN,NaN,5.175867231271943,39.941165503106184,168232339,-1.4209191296438801,6.3431683398465,7.76408746949038
2025-05-29T09:30:00-04:00,461.56,461.74,455.33,458.51,442.35506670660766,NaN,NaN,NaN,NaN,NaN,434.57539999999995,486.4963416648047,382.6544583351952,449.9048559587896,458.5266666666667,458.5266666666667,458.5266666666667,630703,742502.7666666667,62.23420094458023,64.25592962585348,NaN,NaN,NaN,NaN,5.2640195718953775,40.14480589098845,168863042,-1.3349994983729996,6.095338096524131,7.43033759489713
2025-05-29T13:30:00-04:00,458.5,459.98,457.27,458.56,442.35506670660766,NaN,NaN,NaN,NaN,NaN,436.2631999999999,485.6444252079683,386.88197479203154,449.9048559587896,458.55642796815414,458.5937905791977,458.5190653571106,400179,737565.9333333333,62.28537526142846,63.52702885276744,NaN,NaN,NaN,NaN,5.081589602474281,40.33390053687912,169263221,-1.2757139446807217,5.8356951640462285,7.11140910872695
2025-05-30T09:30:00-04:00,459.76,460.25,455.55,457.08,442.35506670660766,NaN,NaN,NaN,NaN,NaN,437.7045999999999,485.18839470261514,390.2208052973847,449.9048559587896,457.6266666666666,457.6266666666666,457.6266666666666,745690,721476.3,59.706380189620866,62.766364566710315,NaN,NaN,NaN,NaN,5.0543332022975465,39.96339114074336,168517531,-1.330963377026868,5.447704887443365,6.778668264470233
2025-05-30T13:30:00-04:00,457.02,461.68,456.63,459.63,442.4637907084795,NaN,NaN,NaN,NaN,NaN,439.15219999999994,484.7716377063123,393.5327622936876,450.2325208005762,458.5203828581756,459.3622098467601,457.6785558695911,840450,728499.3333333334,62.58124181491513,62.16478913526263,NaN,NaN,NaN,NaN,5.054023687847723,39.83125782877639,169357981,-1.1948861332239566,5.285060597940287,6.479946731164244
2025-06-02T09:30:00-04:00,457.1,462.05,456.96,460.97,442.8783911308214,NaN,NaN,NaN,NaN,NaN,440.56039999999985,484.4054242029859,396.7153757970138,450.34701664046094,459.99333333333334,459.99333333333334,459.99333333333334,599531,729903.6333333333,64.0334495619967,62.298097649335155,NaN,NaN,NaN,NaN,5.056593424430031,39.76420008272218,169957512,-1.0205184154226883,5.204298711885883,6.2248171273085715
2025-06-02T13:30:00-04:00,460.96,462.11,460.24,461.97,445.04914607942044,NaN,NaN,NaN,NaN,NaN,441.9635999999999,483.9284879917516,399.99871200824816,451.81261331236874,460.58359254329497,461.29457945509745,459.8726056314925,413213,728130.3,65.12132517154956,62.522342231614324,NaN,NaN,NaN,NaN,4.828979608399315,39.71150515636187,170370725,-0.8506636520248119,5.161487562277557,6.012151214302369
2025-06-03T09:30:00-04:00,461.45,464.1,460.86,463.04,446.6453212576286,NaN,NaN,NaN,NaN,NaN,443.4805999999999,482.8172503220599,404.14394967793993,454.242090649895,462.66666666666674,462.66666666666674,462.66666666666674,711947,709370.9333333333,66.29603318908258,62.62195814817528,NaN,NaN,NaN,NaN,4.715481064942223,39.97896626423249,171082672,-0.6861355173837111,5.15448181757273,5.840617334956441
2025-06-03T13:30:00-04:00,463.01,463.64,461.77,463.17,447.3350793822818,NaN,NaN,NaN,NaN,NaN,444.92139999999995,481.6751129030511,408.1676870969488,454.818672519916,462.7390546309802,462.832622729572,462.6454865323884,426113,701884.6333333333,66.44390508085368,62.82685892364784,NaN,NaN,NaN,NaN,4.51223241744635,40.22732300725521,171508785,-0.591995609494683,5.100622823088088,5.692618432582771
2025-06-04T09:30:00-04:00,464,465.7,463.04,464.74,449.33598486490536,NaN,NaN,NaN,NaN,NaN,446.3635999999999,480.351635544293,412.3755644557068,457.3129380159328,464.49333333333334,464.49333333333334,464.49333333333334,802464,689186.6,68.25531450430586,63.379368795094365,NaN,NaN,NaN,NaN,4.379930101914466,40.781935383537125,172311249,-0.4536619343778465,5.125541014610462,5.579202948988309
2025-06-04T13:30:00-04:00,464.69,465.1,463.28,463.8,449.591167371046,NaN,NaN,NaN,NaN,NaN,447.75939999999997,478.6210885241211,416.89771147587885,457.48035041274625,464.363241582107,464.56185988053033,464.1646232836836,344260,679328.2333333333,65.95950688297589,64.05594129838809,NaN,NaN,NaN,NaN,4.197077951777723,41.29693259008461,171966989,-0.45402849084078856,5.011667335437323,5.465695826278112
2025-06-05T09:30:00-04:00,464.95,468.7,464.13,467.32,451.8115688541803,NaN,NaN,NaN,NaN,NaN,449.30439999999993,475.8987553138638,422.7100446861361,460.15428033019697,466.71666666666664,466.71666666666664,466.71666666666664,780764,667027.5666666667,70.02536663611224,64.43039989294701,NaN,NaN,NaN,NaN,4.247286669507884,42.29466440676838,172747753,-0.2556488464945499,5.146134768159925,5.401783614654475
2025-06-05T13:30:00-04:00,467.29,469.63,466.45,467.67,453.6667248153539,NaN,NaN,NaN,NaN,NaN,450.80359999999996,472.460443356317,429.1467566436829,461.2034242641576,467.2503948206809,467.8467236246035,466.65406601675835,625444,668902.3333333334,70.40389736441263,64.74112686817824,NaN,NaN,NaN,NaN,4.171051907400178,43.34079425292893,173373197,-0.14481764146669196,5.22076156282111,5.365579204287802
2025-06-06T09:30:00-04:00,470.085,473.34,468.77,470.56,456.56187368738324,NaN,NaN,NaN,NaN,NaN,451.6327999999999,473.0759830808807,430.18961691911915,463.76373941132607,470.88999999999993,470.88999999999993,470.88999999999993,1012897,667951.2,73.39186678558667,65.56395592267428,NaN,NaN,NaN,NaN,4.278119628300162,44.73846038590469,174386094,0.06775687777942174,5.450275301512079,5.382518423732657
2025-06-06T13:30:00-04:00,470.57,471.84,470.07,470.12,456.87928851977495,NaN,NaN,NaN,NaN,NaN,452.5299999999999,473.22517789245103,431.8348221075488,463.76373941132607,470.82725589019094,470.9244597316196,470.7300520487623,422031,658678.7,72.19678128583631,66.35247461951835,NaN,NaN,NaN,NaN,4.09896822627872,46.0362932236679,173964063,0.12029137557735048,5.532882643204346,5.412591267626995
2025-06-09T09:30:00-04:00,469.73,472.53,468.63,472.39,456.87928851977495,NaN,NaN,NaN,NaN,NaN,453.2477999999999,474.1577530520741,432.33784694792575,463.76373941132607,471.1833333333334,471.1833333333334,471.1833333333334,588411,649848.3333333334,74.50347484216806,67.2288513264889,NaN,NaN,NaN,NaN,4.084756210115953,46.558104923608134,174552474,0.2424336438067014,5.715633322385372,5.473199678578671
2025-06-09T13:30:00-04:00,472.35,473.44,471.65,472.74,458.9680810686379,NaN,NaN,NaN,NaN,NaN,454.0036,474.9452358520481,433.0619641479519,465.51555457859894,471.849150678674,472.5608997041734,471.1374016531746,514917,647052.6,74.849940909615,68.12632030135936,NaN,NaN,NaN,NaN,3.9208450522505287,47.17071662556848,175067391,0.2787193446413845,5.821598859380401,5.542879514739017
2025-06-10T09:30:00-04:00,471.185,472.8,466.96,469.48,458.9680810686379,NaN,NaN,NaN,NaN,NaN,454.6157999999999,475.541678845107,433.68992115489283,465.51555457859894,469.74666666666667,469.74666666666667,469.74666666666667,700150,635981.9333333333,65.8713076117112,68.5666722600801,NaN,NaN,NaN,NaN,4.05792754851835,45.79158243974274,174367241,0.028272631806791182,5.578220304497506,5.549947672690715
2025-06-10T13:30:00-04:00,469.48,471.02,467.92,470.94,458.9680810686379,NaN,NaN,NaN,NaN,NaN,455.31339999999994,476.04305908450874,434.58374091549115,465.51555457859894,469.82708797869594,469.9304754013122,469.7237005560797,423641,635890.4666666667,67.7378262772377,68.93499972167457,NaN,NaN,NaN,NaN,3.9895041521956083,44.51095783861882,174790882,-0.08760863828286602,5.440436874837133,5.528045513119999
2025-06-11T09:30:00-04:00,470.42,475.47,469.67,474.62,458.9680810686379,NaN,NaN,NaN,NaN,NaN,456.087,476.7538389455166,435.4201610544834,465.51555457859894,473.2533333333334,473.2533333333334,473.2533333333334,814691,642137.4,71.90817430491117,69.49748006045418,NaN,NaN,NaN,NaN,4.1188252841816375,44.15700520072767,175605573,0.02880268332027658,5.564048867270344,5.5352461839500675
2025-06-11T13:30:00-04:00,474.63,474.78,470.93,472.71,459.2255856384032,NaN,NaN,NaN,NaN,NaN,456.8742,477.0084428077123,436.73995719228765,465.51555457859894,473.0990763036396,473.3114586053071,472.8866940019721,429780,641928.5,67.06276611738153,69.6361544137279,NaN,NaN,NaN,NaN,4.099623478168661,43.82833489411445,175175793,-0.07209836058015284,5.4451232332248765,5.517221593805029
2025-06-12T09:30:00-04:00,474.93,479.99,473.63,479.29,462.80737720029396,NaN,NaN,NaN,NaN,NaN,457.7468,477.90953977017426,437.58406022982575,468.3676857243153,477.6366666666667,477.6366666666667,477.6366666666667,1031457,644066.4,73.65008314534077,70.16144369631776,NaN,NaN,NaN,NaN,4.326793229728045,44.301967894954025,176207250,0.23805910687404186,5.814795477397581,5.576736370523539
2025-06-12T13:30:00-04:00,479.35,480.415,477.99,479.03,465.5056782366442,NaN,NaN,NaN,NaN,NaN,458.6650000000001,478.4357697371511,438.8942302628491,469.90464857945227,478.21454849704344,478.9478226733526,477.48127432073426,640614,646867.8666666667,73.02857559470789,70.63177730445021,NaN,NaN,NaN,NaN,4.190950856176043,44.796972067195576,175566636,0.3525457133918577,6.017418512263362,5.664872798871504
2025-06-13T09:30:00-04:00,476.23,479.22,474.96,475.59,465.5056782366442,NaN,NaN,NaN,NaN,NaN,459.3066000000001,479.1504721463139,439.4627278536863,469.90464857945227,476.59,476.59,476.59,961190,642901.2,65.19021306238518,70.41284148717016,NaN,NaN,NaN,NaN,4.195882937877758,44.10118594106265,174605446,0.13464434402184988,5.8331782288988165,5.698533884876967
2025-06-13T13:30:00-04:00,475.54,476.04,472.76,474.96,465.5056782366442,NaN,NaN,NaN,NaN,NaN,460.0366,479.43978318626085,440.6334168137392,469.90464857945227,475.8110896879102,476.7876733851035,474.83450599071693,611456,646494.8333333334,63.83881246627651,70.26136331454877,NaN,NaN,NaN,NaN,4.130462728029348,42.710545181346035,173993990,-0.10114786573032042,5.572099052714066,5.673246918444386
2025-06-16T09:30:00-04:00,475.21,480.73,475.04,480.13,465.5056782366442,NaN,NaN,NaN,NaN,NaN,460.90380000000005,479.9423970659544,441.86520293404567,469.90464857945227,478.6333333333334,478.6333333333334,478.6333333333334,839883,648760.1666666666,69.43792525741495,70.21940321607039,NaN,NaN,NaN,NaN,4.247572533170112,42.22955367383663,174833873,0.0345798962210937,5.716471788720753,5.681891892499659
2025-06-16T13:30:00-04:00,480.15,480.3,477.77,479.04,465.6549712564066,NaN,NaN,NaN,NaN,NaN,461.71139999999997,480.32833090066106,443.0944690993389,470.2818000581436,478.7601161516135,478.9473642589603,478.57286804426667,385039,646374,67.07968428777112,69.98195942488171,NaN,NaN,NaN,NaN,4.124888780800821,41.782918702577895,174448834,-0.003523284739454624,5.677487786575341,5.681011071314796
2025-06-17T09:30:00-04:00,475.49,478.73,474.08,476.61,465.6549712564066,NaN,NaN,NaN,NaN,NaN,462.3172,480.86249559322033,443.7719044067797,470.2818000581436,476.47333333333336,476.47333333333336,476.47333333333336,591533,637591.1666666666,62.022538858002434,69.16986457291141,NaN,NaN,NaN,NaN,4.184539582172193,40.19527880752566,173857301,-0.23409054058083445,5.388397895588753,5.622488436169587
2025-06-17T13:30:00-04:00,476.59,478.7,475.3,478.04,465.6549712564066,NaN,NaN,NaN,NaN,NaN,462.894,481.5650694926631,444.2229305073369,470.2818000581436,476.8227010347687,477.25055225708394,476.3948498124535,394420,624468.0666666667,63.75429003393196,68.56682948348967,NaN,NaN,NaN,NaN,4.128501040588463,38.721041762120024,174251721,-0.3263341113334244,5.214570797002807,5.540904908336231
2025-06-18T09:30:00-04:00,478.53,479.81,475.19,478.47,465.6549712564066,NaN,NaN,NaN,NaN,NaN,463.4925999999999,482.20359957137765,444.7816004286222,470.2818000581436,477.8233333333334,477.8233333333334,477.8233333333334,565308,621234.2666666667,64.28172287393186,67.83670434290137,NaN,NaN,NaN,NaN,4.163608109117859,37.584400954143085,174817029,-0.39011739801066003,5.053258160822907,5.443375558833567
2025-06-18T13:30:00-04:00,478.47,481,477.81,480.33,466.24973460623085,NaN,NaN,NaN,NaN,NaN,464.1218,482.93913623656124,445.3044637634388,471.0957853038156,478.87553003083775,479.8144303812476,477.9366296804279,709970,631938.2,66.54921624449047,67.24379543824963,NaN,NaN,NaN,NaN,4.094064672752297,36.7748225781052,175526999,-0.3405702889903761,5.017662697595597,5.358232986585973
2025-06-20T09:30:00-04:00,481.85,483.46,478.79,478.8,467.9308830332204,NaN,NaN,NaN,NaN,NaN,464.68260000000004,483.5449197131137,445.8202802868864,473.2016282430525,480.35,480.35,480.35,812170,637987.1,63.00597726030051,67.03912898457743,NaN,NaN,NaN,NaN,4.135202910412844,36.49880825704558,174714829,-0.43815287661196756,4.810541890821014,5.248694767432982
2025-06-20T13:30:00-04:00,478.78,479.18,476.87,477.24,467.9308830332204,NaN,NaN,NaN,NaN,NaN,465.16799999999995,484.0488081394881,446.2871918605118,473.2016282430525,479.23765640139595,480.51826322121286,477.95704958157904,612764,645073.2666666667,59.5259572626557,66.45256691210729,NaN,NaN,NaN,NaN,4.004831273954784,35.57271375572916,174102065,-0.6237539581016236,4.469002319805952,5.092756277907576
2025-06-23T09:30:00-04:00,478.21,486.38,472.51,485.905,467.9308830332204,NaN,NaN,NaN,NaN,NaN,465.7659,485.32982891931164,446.20197108068834,473.2016282430525,481.59833333333336,481.59833333333336,481.59833333333336,1515002,670717,69.5773402257093,66.28607876359287,NaN,NaN,NaN,NaN,4.709486182958015,35.92390480247877,175617067,-0.20083653698473558,4.841710606676656,5.042547143661392
2025-06-23T13:30:00-04:00,485.945,487.75,485.16,485.9,472.53394935862644,NaN,NaN,NaN,NaN,NaN,466.4228999999999,486.4357895554888,446.41001044451104,474.9155136604429,483.38516760020946,485.6555678702383,481.1147673301806,938376,673981.2,69.5666043824965,66.46492435395822,NaN,NaN,NaN,NaN,4.558094312746727,36.43476328286076,174678691,0.028477064344373915,5.07814347409186,5.049666409747486
2025-06-24T09:30:00-04:00,488.95,491.49,486.81,490.49,475.09945166050704,NaN,NaN,NaN,NaN,NaN,467.22149999999993,487.81694117031736,446.6260588296825,478.42741092835433,489.59666666666664,489.59666666666664,489.59666666666664,963505,686113.6666666666,73.59459568392053,66.46096096385678,NaN,NaN,NaN,NaN,4.631801861836249,37.36981638814779,175642196,0.4175998045075646,5.5716661653819415,5.154066360874377
2025-06-24T13:30:00-04:00,490.45,491.85,489.51,490.11,476.9490220395749,NaN,NaN,NaN,NaN,NaN,467.9384999999999,489.1655223300431,446.71147766995676,480.22992874268346,489.95943840707014,490.39815557383764,489.52072124030263,658797,694299.8,72.73628440606527,66.44008302181088,NaN,NaN,NaN,NaN,4.468101728847947,38.279932748090175,174983399,0.5683637762402594,5.864521081174701,5.296157304934441
2025-06-25T09:30:00-04:00,491.57,494.56,490.11,490.6,478.62133921959423,NaN,NaN,NaN,NaN,NaN,468.57489999999996,490.559887922672,446.58991207732794,483.03894299414674,491.75666666666666,491.75666666666666,491.75666666666666,765021,696068.9333333333,73.170798442414,67.01012483467008,NaN,NaN,NaN,NaN,4.46680874821595,39.43155028182179,175748420,0.6160517446806111,6.066221985785205,5.450170241104594
2025-06-25T13:30:00-04:00,490.61,492.43,489.44,492.42,478.62133921959423,NaN,NaN,NaN,NaN,NaN,469.24859999999995,492.0359960811678,446.4612039188321,483.03894299414674,491.6173305787974,491.77889143397925,491.45576972361556,569021,700832.5333333333,74.77865395766734,67.79154208405514,NaN,NaN,NaN,NaN,4.361322409057669,40.25399071814179,176317441,0.6801071754020711,6.300304210357183,5.620197034955112
2025-06-26T09:30:00-04:00,493.13,496.95,492.84,495.955,481.39278015669635,NaN,NaN,NaN,NaN,NaN,470.02039999999994,493.7405110317845,446.3002889682154,486.1155235162539,495.2483333333333,495.2483333333333,495.2483333333333,899722,704074.4666666667,77.58809980178124,68.37369740865272,NaN,NaN,NaN,NaN,4.373370808410691,41.50788467435759,177217163,0.8589607144888536,6.693897928066178,5.834937213577325
2025-06-26T13:30:00-04:00,495.97,498.04,495.56,497.43,483.5733356041193,NaN,NaN,NaN,NaN,NaN,470.8024,495.48776467140067,446.1170353285993,488.13241881300314,496.1421351272376,497.02287298841674,495.2613972660585,926611,723486.1666666666,78.65643292311003,69.20060802546264,NaN,NaN,NaN,NaN,4.238130036381357,42.77787078682135,178143774,0.966969553147119,7.043649155011224,6.076679601864105
2025-06-27T09:30:00-04:00,497.53,499.29,496.2,497.5,484.69818398575023,NaN,NaN,NaN,NaN,NaN,471.70239999999995,496.92837766113576,446.47642233886415,489.8189350504025,497.66333333333336,497.66333333333336,497.66333333333336,855543,725978.8,78.70830444185782,70.39244842430946,NaN,NaN,NaN,NaN,4.156120748068406,44.077829069721496,178999317,0.9330445673948322,7.242985311107645,6.309940743712813
2025-06-27T13:30:00-04:00,497.43,498.04,493.44,495.89,484.69818398575023,NaN,NaN,NaN,NaN,NaN,472.5728,498.0722789876172,447.07332101238273,489.8189350504025,496.7899733085427,497.7244981683595,495.8554484487259,747217,730037.9,74.23932366354522,71.14137939785326,NaN,NaN,NaN,NaN,4.187826408920665,44.25215919540621,178252100,0.7025963415103673,7.188186170600773,6.485589829090405
2025-06-30T09:30:00-04:00,497.14,499.3,495.35,497.66,484.69818398575023,NaN,NaN,NaN,NaN,NaN,473.41119999999995,499.3937658132522,447.42863418674773,489.8189350504025,497.4366666666667,497.4366666666667,497.4366666666667,745797,721134.5666666667,75.86196283274373,71.96853939491125,NaN,NaN,NaN,NaN,4.170838808283474,44.57559364239945,178997897,0.5751539773181511,7.204532300738094,6.629378323419943
2025-06-30T13:30:00-04:00,497.67,500.79,496.95,497.26,485.91331864125027,NaN,NaN,NaN,NaN,NaN,474.2586,500.53177666670604,447.98542333329397,490.96881474580607,497.86300953052114,498.31080322968324,497.41521583135903,676056,729602.0666666667,74.71657371979768,72.55192207171892,NaN,NaN,NaN,NaN,4.147207464834657,45.062897508129794,178321841,0.3791592082586579,7.103327333743266,6.724168125484608
2025-07-01T09:30:00-04:00,496.47,498.05,490.98,493.26,485.91331864125027,NaN,NaN,NaN,NaN,NaN,475.065,501.14572713709964,448.98427286290035,490.96881474580607,494.09666666666664,494.09666666666664,494.09666666666664,875038,739156.3,64.26693559334255,72.64199052407906,NaN,NaN,NaN,NaN,4.3559783602036095,43.5615591688282,177446803,-0.0801362807059931,6.623997774602117,6.70413405530811
2025-07-01T13:30:00-04:00,493.26,493.31,491.205,492.1,485.91331864125027,NaN,NaN,NaN,NaN,NaN,475.902,501.4236498682969,450.3803501317031,490.96881474580607,493.3898811966968,494.30500786195165,492.474754531442,521963,739391.1666666666,61.57733451753195,72.78851747085594,NaN,NaN,NaN,NaN,4.195194191617639,42.16745928233386,176924840,-0.49896171940747003,6.080431906048773,6.579393625456243
2025-07-02T09:30:00-04:00,489.875,493.5,488.66,490.27,485.91331864125027,NaN,NaN,NaN,NaN,NaN,476.52579999999995,501.8965486180473,451.1550513819526,490.96881474580607,490.81000000000006,490.81000000000006,490.81000000000006,877587,745305.7333333333,57.48973474465335,71.92511707935195,NaN,NaN,NaN,NaN,4.241251749359234,40.14638157487465,176047253,-0.9120863931359464,5.43928563403631,6.351372027172256
2025-07-02T13:30:00-04:00,490.24,492.22,489.7,491.02,485.91331864125027,NaN,NaN,NaN,NaN,NaN,477.1323999999999,502.4098162635403,451.85498373645953,490.96881474580607,490.87191753728996,490.9537234043197,490.7901116702602,502746,747942.5666666667,58.69976129415766,71.14891400161346,NaN,NaN,NaN,NaN,4.118305195833577,38.26966656080539,176549999,-1.1332528577328471,4.934805955006198,6.068058812739045
2025-07-03T09:30:00-04:00,493.585,500.1,493.4,498.56,485.91331864125027,NaN,NaN,NaN,NaN,NaN,477.94579999999985,503.31134871160066,452.58025128839904,490.96881474580607,497.3533333333333,497.3533333333333,497.3533333333333,1057915,756050.0333333333,68.42909127120997,70.77994940070556,NaN,NaN,NaN,NaN,4.472711967559753,37.92644195354916,177607914,-0.7866048743419629,5.0848027198115915,5.871407594153554
2025-07-07T09:30:00-04:00,497.37,498.76,495.97,496.46,485.91331864125027,NaN,NaN,NaN,NaN,NaN,478.7267999999999,503.9191746209114,453.5344253790884,490.96881474580607,497.06333333333333,497.06333333333333,497.06333333333333,524217,759197.9333333333,63.91310201554767,70.14972208709716,NaN,NaN,NaN,NaN,4.352518255591196,37.60773338966837,177083697,-0.7156431030240258,4.976853715373522,5.692496818397548
2025-07-07T13:30:00-04:00,496.43,498,495.21,497.85,485.91331864125027,NaN,NaN,NaN,NaN,NaN,479.5135999999999,504.58824345031564,454.4389565496841,490.96881474580607,497.0458616775656,497.0671183564568,497.0246049986744,354151,736621.0666666667,65.53445461221902,69.60426895636895,NaN,NaN,NaN,NaN,4.240909808763255,37.07524027290406,177437848,-0.5968412997000465,4.94644519377249,5.543286493472537
2025-07-08T09:30:00-04:00,497.07,498.2,494.11,495.92,485.91331864125027,NaN,NaN,NaN,NaN,NaN,480.26079999999996,505.01789678941253,455.5037032105874,490.96881474580607,496.07666666666665,496.07666666666665,496.07666666666665,434862,729762.6666666666,61.40886359958009,68.64928393079128,NaN,NaN,NaN,NaN,4.230130536708734,36.23460940023862,177002986,-0.6647963997950805,4.712290993728686,5.377087393523767
2025-07-08T13:30:00-04:00,495.95,496.9,495.58,496.64,485.91331864125027,NaN,NaN,NaN,NaN,NaN,481.0519999999999,505.3189352824088,456.785064717591,490.96881474580607,496.19187246494226,496.3364592699904,496.0472856598941,276085,706925.8333333334,62.36081882166521,67.56162100364014,NaN,NaN,NaN,NaN,4.022264069800967,35.45402358990643,177279071,-0.675612775646778,4.532571423965294,5.208184199612072
2025-07-09T09:30:00-04:00,500.47,506.77,499.73,501.51,489.85510795969043,NaN,NaN,NaN,NaN,NaN,481.8895999999999,506.03184652679323,457.7473534732066,494.55150697225196,502.6700000000001,502.6700000000001,502.6700000000001,1252854,728305.7666666667,68.09385224035266,66.80715095487176,NaN,NaN,NaN,NaN,4.45853092195804,36.21919508104721,178531925,-0.38366553078705756,4.72860228612825,5.112267816915308
2025-07-09T13:30:00-04:00,501.47,503.9,501.25,503.44,489.85510795969043,NaN,NaN,NaN,NaN,NaN,482.7389999999999,506.8658595552874,458.61214044471245,494.55150697225196,502.7147541197127,502.79629878164536,502.6332094577801,377377,712888.9,70.04136098966575,66.18808356542947,NaN,NaN,NaN,NaN,4.329350141818179,36.92971146567795,178909302,-0.10400575123860722,4.982260627867049,5.086266379105656
2025-07-10T09:30:00-04:00,503.29,504.46,497.79,500.92,489.85510795969043,NaN,NaN,NaN,NaN,NaN,483.518,507.42644578805493,459.609554211945,494.55150697225196,501.0566666666667,501.0566666666667,501.0566666666667,804608,726874.5333333333,64.50497722154391,65.49277310528652,NaN,NaN,NaN,NaN,4.496539417402592,36.52491142929838,178104694,-0.13045929850272042,4.923192255977256,5.053651554479976
2025-07-10T13:30:00-04:00,500.95,502.19,500.26,501.59,489.85510795969043,NaN,NaN,NaN,NaN,NaN,484.28899999999993,507.9916562224676,460.58634377753225,494.55150697225196,501.15708010092374,501.295054874615,501.01910532723247,426156,721361.9666666667,65.29053560488282,64.7376711604393,NaN,NaN,NaN,NaN,4.313215173302408,36.149025681231635,178530850,-0.14351631924345654,4.874256155425655,5.017772474669112
2025-07-11T09:30:00-04:00,498.1,505.03,497.78,504.57,489.85510795969043,NaN,NaN,NaN,NaN,NaN,485.11699999999996,508.70297295004804,461.5310270499519,494.55150697225196,502.46,502.46,502.46,760553,733566.4,68.61733749521153,64.30201143011172,NaN,NaN,NaN,NaN,4.5229855180665215,36.23439652893326,179291403,0.0002537200504919568,5.018089624732227,5.017835904681735
2025-07-11T13:30:00-04:00,504.56,504.63,502.56,503.1,490.4230975694966,NaN,NaN,NaN,NaN,NaN,485.8841999999999,509.2636146513673,462.50478534863254,494.55150697225196,502.8037041655913,503.26766589596735,502.3397424352152,417383,728635.5666666667,65.29280845476217,64.37528806307027,NaN,NaN,NaN,NaN,4.347772266776055,36.31366945894191,178874020,-0.04920592296728277,4.9563285009726314,5.005534423939914
2025-07-14T09:30:00-04:00,501.515,503.96,501.02,502.72,490.4230975694966,NaN,NaN,NaN,NaN,NaN,486.66259999999994,509.6371943372342,463.6880056627657,494.55150697225196,502.56666666666666,502.56666666666666,502.56666666666666,540738,722994.5,64.42386011687628,64.57861132016629,NaN,NaN,NaN,NaN,4.24721710486348,35.87018640636332,178333282,-0.14751202734881375,4.821144389753897,4.968656417102711
2025-07-14T13:30:00-04:00,502.73,503.48,502.16,503.09,490.4230975694966,NaN,NaN,NaN,NaN,NaN,487.37799999999993,510.1253660013752,464.63063399862466,494.72777869098724,502.6875785798834,502.8515706510145,502.52358650875226,293954,705720.6333333333,64.9134940853368,65.10887984450083,NaN,NaN,NaN,NaN,4.038130168801802,35.45838071468319,178627236,-0.22308132135296166,4.689804765411509,4.912886086764471
2025-07-15T09:30:00-04:00,502.93,507.74,502.67,506.84,492.52038613740683,NaN,NaN,NaN,NaN,NaN,488.1614,510.8377518265218,465.4850481734782,498.2032229527898,505.75,505.75,505.75,610540,705646.5,69.49582295889255,65.8800271062676,NaN,NaN,NaN,NaN,4.1118351567445295,35.798113862394075,179237776,-0.06422600467392137,4.832603580922068,4.89682958559599
2025-07-15T13:30:00-04:00,506.85,508.31,505.62,505.63,494.49014131297923,NaN,NaN,NaN,NaN,NaN,488.8628,511.48748785730083,466.23811214269915,499.33557836223184,506.04581856840554,506.42034716841135,505.6712899683997,380886,667842.6333333333,66.47886993236116,65.74072558206412,NaN,NaN,NaN,NaN,4.010275502691349,36.200767274754305,178856890,-0.08315457025374418,4.79288637277881,4.876040943032554
2025-07-16T09:30:00-04:00,505.08,505.74,501.89,505.48,494.49014131297923,NaN,NaN,NaN,NaN,NaN,489.57,512.0168945736456,467.12310542635447,499.33557836223184,504.37000000000006,504.37000000000006,504.37000000000006,842073,664632.5333333333,66.09580331773222,65.89663281793445,NaN,NaN,NaN,NaN,3.9988272524991113,35.30393332603302,178014817,-0.14468611256885744,4.695183302321482,4.839869414890339
2025-07-16T13:30:00-04:00,505.43,506.7,504.95,505.48,494.49014131297923,NaN,NaN,NaN,NaN,NaN,490.2318,512.5644938599024,467.8991061400976,499.33557836223184,504.79930401895683,505.424576315428,504.17403172248567,396955,645747.5333333333,66.09580331773222,65.93672915404254,NaN,NaN,NaN,NaN,3.83819673446346,34.65489541991266,178014817,-0.219792371730394,4.565128950227347,4.784921321957741
2025-07-17T09:30:00-04:00,505.81,513.38,505.71,512.79,496.9116870491642,NaN,NaN,NaN,NaN,NaN,491.03280000000007,513.6693977266932,468.39620227330687,502.9030961214627,510.6266666666666,510.6266666666666,510.6266666666666,1125477,661303.5333333333,74.4249809738154,66.86645182363077,NaN,NaN,NaN,NaN,4.128325539144639,35.114503898326085,179140294,0.16753826756882795,4.9943441564187765,4.8268058888499485
2025-07-17T13:30:00-04:00,512.78,513,510.91,511.78,499.61092854692953,NaN,NaN,NaN,NaN,NaN,491.87880000000007,514.3916084041086,469.3659915958915,503.57347689717017,511.14389474876106,511.76787774158987,510.51991175593224,773313,661579.9333333333,71.80037531283648,67.54070585871443,NaN,NaN,NaN,NaN,3.982730857777163,35.541283199709966,178366981,0.2930660672219787,5.193138472877422,4.900072405655443
2025-07-18T09:30:00-04:00,513.8,514.43,508.32,510.9,499.61092854692953,NaN,NaN,NaN,NaN,NaN,492.67800000000005,514.9970832249015,470.35891677509863,503.8337815177361,511.2166666666667,511.2166666666667,511.2166666666667,935828,673806.8333333334,69.5006284129687,67.64118987104415,NaN,NaN,NaN,NaN,4.13467865365022,35.100059849248275,177431153,0.255548883713999,5.219508510297942,4.963959626583943
2025-07-18T13:30:00-04:00,510.93,511.96,507.43,509.96,499.61092854692953,NaN,NaN,NaN,NaN,NaN,493.38480000000004,515.6097702775967,471.1598297224034,503.8337815177361,510.6035925346118,511.3127326462377,509.89445242298586,699452,667131.1666666666,67.03085039073906,67.42615339969224,NaN,NaN,NaN,NaN,4.162915892675203,34.414654364207955,176731701,0.11339346879328804,5.105701462575553,4.992307993782265
2025-07-21T09:30:00-04:00,507.17,512.07,505.55,510.95,499.61092854692953,NaN,NaN,NaN,NaN,NaN,494.1496000000001,516.1063014681198,472.19289853188036,503.8337815177361,509.52333333333337,509.52333333333337,509.52333333333337,748439,661192.1,68.30819531142672,67.69781183468386,NaN,NaN,NaN,NaN,4.331279043198405,33.20842090875353,177480140,0.0360145038689641,5.03732612361847,5.001311619749506
2025-07-21T13:30:00-04:00,510.94,511.05,509.54,510.15,499.61092854692953,NaN,NaN,NaN,NaN,NaN,494.7668000000001,516.7529184168544,472.78068158314585,503.8337815177361,509.7782461898051,510.12379850383684,509.43269387577334,407298,646250.6,66.08021492796772,67.75421750061851,NaN,NaN,NaN,NaN,4.129759111541376,32.08834698583157,177072842,-0.11102320649496722,4.862532611630797,4.973555818125765
2025-07-22T09:30:00-04:00,510.925,511.2,506.35,507.58,499.61092854692953,NaN,NaN,NaN,NaN,NaN,495.3378000000001,517.1416468312377,473.53395316876237,503.8337815177361,508.37666666666655,508.3766720614632,508.3766612718699,535909,639207,59.379752808910965,67.09439002302561,NaN,NaN,NaN,NaN,4.181204889288418,30.11500051771943,176536933,-0.40671792985272415,4.465158405809859,4.871876335662583
2025-07-22T13:30:00-04:00,507.59,508.22,505.27,505.53,499.61092854692953,NaN,NaN,NaN,NaN,NaN,495.93660000000006,517.1753833399249,474.6978166600752,503.8337815177361,507.360505131348,508.37883614879024,506.3421741139058,533628,632134.7,54.621955114617336,66.33218621301526,NaN,NaN,NaN,NaN,4.093261682910677,27.991944427687287,176003305,-0.7459750053613723,3.939407578960868,4.68538258432224
2025-07-23T09:30:00-04:00,506.54,506.83,500.72,504.21,499.61092854692953,NaN,NaN,NaN,NaN,NaN,496.52160000000003,517.0152948781916,476.02790512180843,503.8337815177361,503.92,503.92,503.92,861490,638315.8333333334,51.746834129652285,65.42668435678499,NaN,NaN,NaN,NaN,4.237314419845626,27.04152856436337,175141815,-1.0464645802419676,3.3773018590197807,4.423766439261748
2025-07-23T13:30:00-04:00,504.15,506.11,504.11,506.04,499.61092854692953,NaN,NaN,NaN,NaN,NaN,497.0398,517.1562270147656,476.92337298523444,503.8337815177361,504.3982773187978,505.0973243733958,503.6992302641998,403271,622590.2666666667,55.26261140943053,64.73733559422024,NaN,NaN,NaN,NaN,4.07750624699951,26.158999548419736,175545086,-1.103492531247384,3.0444007752025186,4.147893306449903
2025-07-24T09:30:00-04:00,508.66,513.21,507.3,512.65,499.61092854692953,NaN,NaN,NaN,NaN,NaN,497.71200000000005,517.622752572426,477.8012474275741,503.8337815177361,511.0533333333333,511.0533387281299,511.05332793853665,755902,630388.2333333333,65.14205305647363,64.42635202976176,NaN,NaN,NaN,NaN,4.298398657928118,24.992262147725025,176300988,-0.6973704378767032,3.2761802591040237,3.973550696980727
2025-07-24T13:30:00-04:00,512.69,513.67,510.3,510.96,499.61092854692953,NaN,NaN,NaN,NaN,NaN,498.399,517.7113639153923,479.0866360846077,503.8337815177361,511.30851036866534,511.6008100974038,511.0162106399269,576092,620338.4,61.408193159694164,64.06416083171412,NaN,NaN,NaN,NaN,4.232084468076105,24.003500383938245,175724896,-0.5503416220130388,3.285623669464428,3.835965291477467
2025-07-25T09:30:00-04:00,512.41,515.43,510.39,515.37,500.0542560981489,NaN,NaN,NaN,NaN,NaN,499.1456,518.135592905737,480.1556070942631,504.23820913241514,513.73,513.73,513.73,754025,628714.3666666667,66.76205658782959,64.11175035100678,NaN,NaN,NaN,NaN,4.289792720356381,23.44764607740646,176478921,-0.18287285733404346,3.6073742198099126,3.790247077143956
2025-07-25T13:30:00-04:00,515.36,518.28,513.11,513.66,502.7186080936876,NaN,NaN,NaN,NaN,NaN,499.8494,518.3235300893971,481.3752699106029,506.74156730593216,514.4829362634315,515.1168644734965,513.8490080533664,1063707,628907.4333333333,63.106221809179246,63.898208814681574,NaN,NaN,NaN,NaN,4.352664668902351,23.473274464914873,175415214,-0.086647221557834,3.6819380501966634,3.7685852717544974
2025-07-28T09:30:00-04:00,514.14,515.01,511.11,511.15,502.7186080936876,NaN,NaN,NaN,NaN,NaN,500.4658,518.3406262492226,482.59097375077744,506.74156730593216,512.4233333333333,512.4233333333333,512.4233333333333,541112,629470.6,58.078891007101454,62.7306309599163,NaN,NaN,NaN,NaN,4.320331478266467,22.930754181382994,174874102,-0.21633247546715895,3.498169677420549,3.714502152887708
2025-07-28T13:30:00-04:00,511.18,512.47,510.12,512.395,502.7186080936876,NaN,NaN,NaN,NaN,NaN,501.1377,518.2121115225068,484.06328847749313,506.74156730593216,512.1077160710279,512.4829238692087,511.7325082728471,382882,630428.3,59.79000754365682,61.87274754783203,NaN,NaN,NaN,NaN,4.179593515533149,22.153754573009962,175256984,-0.2406875899990757,3.4136426653888634,3.654330255387939
2025-07-29T09:30:00-04:00,515.6,517.62,512.17,512.83,502.7186080936876,NaN,NaN,NaN,NaN,NaN,501.8495,517.810630191806,485.8883698081939,506.79932246063726,514.2066666666666,514.2066666666666,514.2066666666666,600147,635937.8,60.39823491111208,61.2225765834137,NaN,NaN,NaN,NaN,4.270336835852214,22.412678979935315,175857131,-0.24889081039304362,3.343216742396635,3.5921075527896784
2025-07-29T13:30:00-04:00,512.83,512.91,511.57,512.59,502.7186080936876,NaN,NaN,NaN,NaN,NaN,502.38319999999993,517.9558951758565,486.81050482414327,506.79932246063726,513.4801848965975,514.3836313601244,512.5767384330707,388063,639670.4,59.860241325887294,60.710390221638576,NaN,NaN,NaN,NaN,4.061027061862768,22.480562532404463,175469068,-0.2890499606618908,3.2307951019623147,3.5198450626242055
2025-07-30T09:30:00-04:00,515.45,515.95,510.72,512.89,502.7186080936876,NaN,NaN,NaN,NaN,NaN,502.92299999999994,518.0372004750528,487.808799524947,506.79932246063726,513.1866666666666,513.1866666666666,513.1866666666666,652095,619645.1,60.33584559784943,60.14093667066877,NaN,NaN,NaN,NaN,4.144525128872572,23.062830697263493,176121163,-0.3120129178794335,3.1298289152749135,3.441841833154347
2025-07-30T13:30:00-04:00,512.91,514.03,509.435,513.99,502.7186080936876,NaN,NaN,NaN,NaN,NaN,503.39300000000003,518.3925791940869,488.39342080591314,506.79932246063726,512.8158665197766,513.166131211324,512.4656018282292,730799,631425.8333333334,62.108674804522636,59.85725523327984,NaN,NaN,NaN,NaN,4.176701905381671,23.21729189143346,176851962,-0.2712286066685503,3.102806074818659,3.3740346814872093
2025-07-31T09:30:00-04:00,555.35,555.45,533.67,534.51,526.8564707043577,NaN,NaN,NaN,NaN,NaN,504.28100000000006,521.1682605238221,487.393739476178,526.4332104798771,541.2099999999999,541.2099999999999,541.2099999999999,3321254,715314.0333333333,80.03535008200048,61.33265503850051,NaN,NaN,NaN,NaN,6.8397946264258405,26.50995144511138,180173216,1.0473304926144071,4.683197797255218,3.635867304640811
2025-07-31T13:30:00-04:00,534.47,535.5,531.92,533.48,526.8564707043577,NaN,NaN,NaN,NaN,NaN,505.1386,523.4544566318879,486.8227433681122,526.4332104798771,539.12169511135,542.507160032426,535.7362301902741,1263727,743233.0666666667,78.03954001044245,63.005339673916595,NaN,NaN,NaN,NaN,6.606952153109711,29.25144153390214,178909489,1.7199952943332164,5.785861422557332,4.0658661282241155
2025-08-01T09:30:00-04:00,535,535.79,520.88,523.25,NaN,NaN,NaN,546.964868635079,546.964868635079,546.964868635079,505.75520000000006,524.3898618922791,487.12053810772096,526.4332104798771,526.64,526.64,526.64,1573603,770334.7333333333,61.60742367346395,63.70966749847458,NaN,NaN,NaN,NaN,7.200026999316158,30.021636490876784,177335886,1.3615211386411827,5.767767551525594,4.406246412884411
2025-08-01T13:30:00-04:00,523.28,526.26,522.33,524.12,NaN,NaN,NaN,542.6139655153028,NaN,NaN,506.3185000000001,525.4307775461094,487.20622245389075,526.4332104798771,525.9625810089265,527.0438613390783,524.8813006787747,617637,777009.8666666667,62.33379545298287,64.21475207301403,NaN,NaN,NaN,NaN,6.966453642222143,30.73681752235324,177953523,1.080813754810733,5.757263606397828,4.676449851587095
2025-08-04T09:30:00-04:00,528.3,537.53,528,537.31,NaN,NaN,NaN,542.6139655153028,NaN,NaN,507.1161000000001,527.9308039652149,486.3013960347853,526.4332104798771,534.28,534.28,534.28,1214116,799455.8,71.22307115076958,64.64911050832089,NaN,NaN,NaN,NaN,7.426706953491987,32.0495885444343,179167639,1.6473344469580402,6.735617910284645,5.088283463326605
2025-08-04T13:30:00-04:00,537.32,538.25,534.09,535.47,NaN,NaN,NaN,542.6139655153028,NaN,NaN,507.87550000000005,529.9631229821083,485.78787701789173,526.4332104798771,534.9507180278009,535.7639175891915,534.1375184664104,825935,817188.5,68.78435152407226,65.17597896291933,NaN,NaN,NaN,NaN,7.193370742528272,33.30607015861219,178341704,1.7522492371738272,7.278595009793889,5.526345772620062
2025-08-05T09:30:00-04:00,537.22,537.5,530.67,531.6,NaN,NaN,NaN,542.6139655153028,NaN,NaN,508.5897000000001,531.3791435570398,485.80025644296035,526.4332104798771,533.2566666666667,533.2566666666667,533.2566666666667,805146,823675.3666666667,63.833629512469294,64.96680560039358,NaN,NaN,NaN,NaN,7.16741568949054,33.937233084762525,177536558,1.4287949961798398,7.312339517844862,5.883544521665022
2025-08-05T13:30:00-04:00,531.59,532.57,527.21,527.75,NaN,NaN,NaN,542.6139655153028,NaN,NaN,509.1915,532.3803504458449,486.0026495541552,526.4332104798771,531.2991723509189,533.3375032396783,529.2608414621594,742551,835730.8666666667,59.26377227030475,64.69234491904541,NaN,NaN,NaN,NaN,7.038314568812646,33.99773006035844,176794007,0.8518231915709471,6.948323511128706,6.096500319557759
2025-08-06T09:30:00-04:00,530.495,531.7,524.6,525.85,NaN,NaN,NaN,542.6139655153028,NaN,NaN,509.7633,533.1561740953287,486.3704259046713,526.4332104798771,527.3833333333333,527.3833333333333,527.3833333333333,1151696,846051.6333333333,57.09155856903847,64.62182117346948,NaN,NaN,NaN,NaN,7.042720671040315,33.66538343967031,175642311,0.2687002720226843,6.432375659586114,6.16367538756343
2025-08-06T13:30:00-04:00,525.84,526.74,524,524.83,NaN,NaN,NaN,542.6139655153028,NaN,NaN,510.3947,533.6756711489853,487.1137288510147,526.4332104798771,526.5081565330953,527.582223577939,525.4340894882516,764657,858308.3666666667,55.90685533058294,64.34445315824992,NaN,NaN,NaN,NaN,6.735383480251722,33.265384674137735,174877654,-0.23216265830786842,5.8734720646785945,6.105634722986463
2025-08-07T09:30:00-04:00,526.71,528.05,520.6,520.96,NaN,NaN,NaN,542.6139655153028,NaN,NaN,510.9719,533.837274249289,488.106525750711,515.8770275280369,523.2033333333334,523.2033333333334,523.2033333333334,839821,848786.5,51.53713701436916,63.711517594196856,NaN,NaN,NaN,NaN,6.786427517376594,32.373190449927776,174037833,-0.836561754813383,5.059932529469734,5.896494284283117
2025-08-07T13:30:00-04:00,521.05,521.25,517.55,520.91,NaN,NaN,NaN,537.7774114643978,NaN,NaN,511.5847,533.8319249424499,489.3374750575502,515.8770275280369,521.9964289504902,523.5858207442212,520.4070371567592,484251,839151.1,51.4811508973589,63.11301113501626,NaN,NaN,NaN,NaN,6.565968408992554,31.095005234452838,173553582,-1.2284815458457228,4.360892351975963,5.589373897821686
2025-08-08T09:30:00-04:00,522.59,524.5,519.41,521.92,NaN,NaN,NaN,537.7774114643978,NaN,NaN,512.2027,533.8388790720979,490.5665209279022,515.8770275280369,521.9433333333333,521.9433333333333,521.9433333333333,732777,832382.7333333333,52.60126650490759,62.56054119980612,NaN,NaN,NaN,NaN,6.460542094064516,30.25292557011489,174286359,-1.3962316599670759,3.844084322862841,5.240315982829917
2025-08-08T13:30:00-04:00,521.92,523.25,520.14,522.12,NaN,NaN,NaN,537.7774114643978,NaN,NaN,512.6739000000001,534.1265104043177,491.2212895956825,515.8770275280369,521.8924797141281,521.9457553697033,521.8392040585528,667664,831323.1333333333,52.83347576627046,61.89802698278811,NaN,NaN,NaN,NaN,6.2212176587741945,29.470994453229654,174954023,-1.4631928386233346,3.4113249345507484,4.874517773174083
2025-08-11T09:30:00-04:00,522.41,527.58,519.74,525.64,NaN,NaN,NaN,537.7774114643978,NaN,NaN,513.2575,534.500627665198,492.0143723348022,515.8770275280369,524.32,524.32,524.32,787506,832625.3666666667,56.84104531759444,60.241290928187674,NaN,NaN,NaN,NaN,6.3368449688617545,29.207296733013617,175741529,-1.248261693175703,3.3141906567044543,4.562452349880157
2025-08-11T13:30:00-04:00,525.59,526.08,520.2,521.97,NaN,NaN,NaN,537.7774114643978,NaN,NaN,513.7399,534.654511207473,492.8252887925271,515.8770275280369,523.649456870776,524.4260678575749,522.8728458839771,587084,838618.2333333333,51.890603085911934,58.37350971929264,NaN,NaN,NaN,NaN,6.304213185371629,28.96243456424158,175154445,-1.3239169078956676,2.9075562150105725,4.23147312290624
2025-08-12T09:30:00-04:00,523.76,529.08,522.65,528.19,NaN,NaN,NaN,537.7774114643978,NaN,NaN,514.3853,535.0506168773157,493.7199831226843,513.6785601067253,526.64,526.64,526.64,1037307,855331.5,58.48920587722589,58.1507798767042,NaN,NaN,NaN,NaN,6.361769386416514,29.056101138957807,176191752,-0.9435658826147368,3.052015769637819,3.995581652252556
2025-08-12T13:30:00-04:00,528.2,530.95,527.65,529.38,NaN,NaN,NaN,537.7774114643978,NaN,NaN,515.0401,535.4884715234201,494.59172847658004,516.9788480853802,527.509650151228,528.7666977586986,526.2526025437575,496470,854092.9,59.630037829105945,57.95765433214156,NaN,NaN,NaN,NaN,6.143071573101054,29.33762585985266,176688222,-0.6161898811484225,3.225344300817028,3.8415341819654505
2025-08-13T09:30:00-04:00,532.18,532.66,524.49,525.21,NaN,NaN,NaN,537.7774114643978,NaN,NaN,515.5141000000001,535.7839360812249,495.2442639187754,517.3980784683041,527.4533333333334,527.4533333333334,527.4533333333334,847878,853639.1666666666,54.02674622716924,56.72934540902725,NaN,NaN,NaN,NaN,6.287852175022404,28.96854810518728,175840344,-0.6798374459533822,2.991737374523723,3.671574820477105
2025-08-13T13:30:00-04:00,525.19,525.25,519.38,520.68,NaN,NaN,NaN,537.7774114643978,NaN,NaN,515.8589000000002,535.8804613067377,495.8373386932626,517.3980784683041,524.392789954661,527.2260146950148,521.5595652143072,989392,873176.5333333333,48.675716953635174,55.29301436828175,NaN,NaN,NaN,NaN,6.258005591092233,27.706921790550933,174850952,-1.0066593681103089,2.413250610339219,3.4199099784495277
2025-08-14T09:30:00-04:00,522.8,525.94,520.1,524.06,NaN,NaN,NaN,537.7774114643978,NaN,NaN,516.3217000000001,536.0075620954161,496.63583790458404,517.3980784683041,523.3666666666667,523.3666666666667,523.3666666666667,1001798,881373.0666666667,52.45925155686341,54.480558800024184,NaN,NaN,NaN,NaN,6.228148048871361,26.629442186554353,175852750,-0.9742092325899105,2.2021484377121396,3.17635767030205
2025-08-14T13:30:00-04:00,524.06,524.06,520.15,522.44,NaN,NaN,NaN,537.7774114643978,NaN,NaN,516.7387000000001,536.0381937560435,497.43920624395673,517.3980784683041,522.9160628051584,523.4774455629464,522.3546800473704,645434,883684.4666666667,50.536330220829704,53.85717008220454,NaN,NaN,NaN,NaN,6.062566045380548,25.62892541141467,175207316,-1.03514332048396,1.8824285196971005,2.9175718401810604
2025-08-15T09:30:00-04:00,522.77,525.25,520.86,524.85,NaN,NaN,NaN,537.7774114643978,NaN,NaN,517.1443,536.25528343989,498.0333165601101,517.3980784683041,523.6533333333333,523.6533333333333,523.6533333333333,719618,882537.5666666667,53.279982897927454,53.58491467712518,NaN,NaN,NaN,NaN,5.943097042139079,24.879817816281705,175926934,-0.891870078684422,1.802734241825533,2.694604320509955
2025-08-15T13:30:00-04:00,524.87,526.1,519.08,520.08,NaN,NaN,NaN,537.7774114643978,NaN,NaN,517.4839000000001,536.1835912584073,498.78420874159286,517.3980784683041,522.6160512647399,523.5620332098658,521.670069319614,865227,875921.5666666667,47.64669903136208,52.994903512895114,NaN,NaN,NaN,NaN,6.020018681986286,23.81920413935761,175061707,-1.0842923327640297,1.339238904554918,2.4235312373189477
2025-08-18T09:30:00-04:00,521.575,522.82,515.77,516.36,NaN,NaN,NaN,537.1988891026135,NaN,NaN,517.7567,535.9787747018515,499.5346252981485,517.3980784683041,518.3166666666667,518.3166666666667,518.3166666666667,839461,885866.5333333333,43.760795524639015,52.43945054934296,NaN,NaN,NaN,NaN,6.093588776130128,22.192833698025314,174222246,-1.4075550590719392,0.6640874134790238,2.071642472550963
2025-08-18T13:30:00-04:00,516.34,517.31,514.03,517.11,NaN,NaN,NaN,533.2073486888582,NaN,NaN,518.0371,535.7727702822295,500.3014297177705,517.3980784683041,517.1489044355486,518.2289428016865,516.0688660694108,981366,905816,44.739334906105185,51.95789226425341,NaN,NaN,NaN,NaN,5.892618149263688,20.85142738924153,175203612,-1.5074070323282516,0.1873836821406485,1.6947907144689
2025-08-19T09:30:00-04:00,515.145,515.145,508.6,511.3,NaN,NaN,NaN,529.7731510211829,NaN,NaN,518.1263000000001,535.6797398691341,500.5728601308661,517.3980784683041,511.6816666666667,511.6816666666667,511.6816666666667,994983,918977.2,39.06828990086525,50.991251078250386,NaN,NaN,NaN,NaN,6.079573995744853,20.497547648305787,174208629,-1.877203257421825,-0.6517133573083811,1.2254899001134438
2025-08-19T13:30:00-04:00,511.27,511.92,508.56,509.91,NaN,NaN,NaN,527.7851668838564,NaN,NaN,518.2119000000001,535.5613077005294,500.8624922994709,517.3980784683041,511.11960004345855,511.865402399857,510.3737976870601,565124,924879.2333333333,37.83272780338241,49.91976908090124,NaN,NaN,NaN,NaN,5.8853187103345075,20.175098460552512,173643505,-2.1104573806822593,-1.4125818257393803,0.697875554942879
2025-08-20T09:30:00-04:00,509.99,511,504.44,505.92,NaN,NaN,NaN,525.3622047527721,NaN,NaN,518.2207000000001,535.5446949214811,500.8967050785191,511.88455755249396,507.12,507.12000762939454,507.1199923706055,1141203,941182.8333333334,34.46341548165407,48.32136694976264,NaN,NaN,NaN,NaN,5.9335102310249,20.487970896318757,172502302,-2.407017759851951,-2.3108966448720594,0.09612111497989129
2025-08-20T13:30:00-04:00,505.93,507.61,504.78,505.51,NaN,NaN,NaN,523.4211954458278,NaN,NaN,518.2213,535.5435318203968,500.8990681796033,511.88455755249396,506.6917473369292,507.24898851273065,506.1345061611278,674026,939290.4,34.12708329467277,47.052544107531276,NaN,NaN,NaN,NaN,5.711830928808838,20.778495300958834,171828276,-2.4937577718291752,-3.021076099806578,-0.5273183279774026
2025-08-21T09:30:00-04:00,503.7,507.6,502.77,504.45,NaN,NaN,NaN,522.286822925563,NaN,NaN,518.0545000000001,535.7395332484724,500.3694667515278,511.88455755249396,504.93999999999994,504.9400076293945,504.9399923706054,601888,848644.8666666667,33.22432199220185,45.24790954431527,NaN,NaN,NaN,NaN,5.648843005322496,21.34238070327789,171226388,-2.480237090871249,-3.627614691566464,-1.147377600695215
2025-08-21T13:30:00-04:00,504.48,506.45,504.05,504.11,NaN,NaN,NaN,521.9017400653102,NaN,NaN,517.9011,535.9308713008162,499.87132869918395,511.88455755249396,504.91041539485724,504.944993907546,504.87583688216847,440590,821206.9666666667,32.92348084093541,43.34029833087452,NaN,NaN,NaN,NaN,5.416782790656602,21.86598857685987,170785798,-2.352982046412586,-4.088605158710948,-1.7356231122983616
2025-08-22T09:30:00-04:00,504.5,510.72,502.44,507.87,NaN,NaN,NaN,521.9017400653102,NaN,NaN,517.8405,535.9839993592653,499.69700064073464,511.88455755249396,507.01000000000005,507.01000000000005,507.01000000000005,1025941,802951.5666666667,39.45281211016056,42.29930303680248,NaN,NaN,NaN,NaN,5.621298305609704,21.262810096120305,171811739,-1.8940960823264001,-4.103243215206362,-2.209147132879962
2025-08-22T13:30:00-04:00,507.9,508.57,505.75,507.1,NaN,NaN,NaN,521.9017400653102,NaN,NaN,517.7833,536.043474326651,499.5231256733491,507.92264604199516,507.0586307050398,507.1215357625,506.99572564757955,613158,802802.2666666667,38.623650720813174,41.58129830588662,NaN,NaN,NaN,NaN,5.421205569494725,20.702715792576427,171198581,-1.5361828320728597,-4.129375672971037,-2.593192840898177
2025-08-25T09:30:00-04:00,506.67,508.19,504.59,505.85,NaN,NaN,NaN,521.9017400653102,NaN,NaN,517.6813000000001,536.1488153509952,499.21378464900505,503.75211683359606,506.21,506.2100076293945,506.20999237060545,574828,781492.6666666666,37.254826677910955,40.49526795739002,NaN,NaN,NaN,NaN,5.29111945738796,20.40525704795566,170623753,-1.2874509339054208,-4.202506508279953,-2.915055574374532
2025-08-25T13:30:00-04:00,505.79,505.91,504.15,504.17,NaN,NaN,NaN,520.8953859864489,NaN,NaN,517.5617,536.2982601549452,498.8251398450548,500.04369346687685,505.48664292654195,506.2199083983322,504.75337745475167,559398,772608.1,35.437068751714534,39.41674928102464,NaN,NaN,NaN,NaN,5.0388966390031085,20.21544220785826,170064355,-1.144697963481771,-4.345928028726746,-3.201230065244975
2025-08-26T09:30:00-04:00,504.14,504.93,500.21,500.37,NaN,NaN,NaN,518.3578684416103,NaN,NaN,517.4175,536.5655842122537,498.26941578774625,498.15895477350153,501.83666666666664,501.83666666666664,501.83666666666664,632517,766853.8,31.672657967507376,37.87336892885178,NaN,NaN,NaN,NaN,5.016118307645746,20.75958721088929,169431838,-1.208538327498692,-4.71190297461834,-3.503364647119648
2025-08-26T13:30:00-04:00,500.4,503.4,498.51,502.05,NaN,NaN,NaN,516.6920562397189,NaN,NaN,517.3479,536.6926032636745,498.00319673632544,497.49721270018097,501.5114811231981,501.7610144739388,501.2619477724574,1074181,777908.1333333333,34.962055723551586,36.96732297829389,NaN,NaN,NaN,NaN,5.00710985709962,21.542730739091652,170506019,-1.0460454727607313,-4.810921488070562,-3.764876015309831
2025-08-27T09:30:00-04:00,501.75,505.63,499.88,505.39,NaN,NaN,NaN,516.6920562397189,NaN,NaN,517.3715,536.6548159233541,498.08818407664575,497.49721270018097,503.6333333333334,503.6333333333334,503.6333333333334,743731,764309.3,41.03929582863535,36.77293014286506,NaN,NaN,NaN,NaN,5.060173438735362,21.604154825742413,171249750,-0.6418880140993624,-4.567236032934034,-3.925348018834671
2025-08-27T13:30:00-04:00,505.4,507.34,504.97,506.6,NaN,NaN,NaN,516.6920562397189,NaN,NaN,517.3827,536.6403103616105,498.1250896383894,497.49721270018097,504.53714733857385,505.8005964423751,503.2736982347726,380591,751507.1,43.11313547857504,36.65677304089862,NaN,NaN,NaN,NaN,4.8680181931114035,21.178499285835436,171630341,-0.24191509664864075,-4.227741889645472,-3.985826792996831
2025-08-28T09:30:00-04:00,507.09,510.24,505.5,508.6,NaN,NaN,NaN,516.6920562397189,NaN,NaN,517.3016999999999,536.6719943302397,497.93140566976,499.5891723814888,508.11333333333334,508.11334267739517,508.1133239892715,569974,742512.2,46.46495039966653,37.18510593367014,NaN,NaN,NaN,NaN,4.858874036460589,20.026637687539363,172200315,0.18543511803819612,-3.754032895449086,-3.939468013487282
2025-08-28T13:30:00-04:00,508.65,510.9,508.01,509.57,NaN,NaN,NaN,516.6920562397189,NaN,NaN,517.2738999999999,536.6844685944511,497.86333140554876,500.934337905191,508.64086487697205,509.3114646091189,507.9702651448252,352716,738127.7,48.0632893945428,37.91586033303874,NaN,NaN,NaN,NaN,4.718240176713404,18.79229628881903,172553031,0.5413876499537396,-3.262733451045108,-3.8041211009988474
2025-08-29T09:30:00-04:00,508.97,509.6,504.49,508.095,NaN,NaN,NaN,516.6920562397189,NaN,NaN,517.1283999999999,536.7022519908584,497.5545480091415,500.934337905191,507.395,507.3950053947966,507.39499460520335,542851,731796.8333333334,45.82292597804178,38.72725393992358,NaN,NaN,NaN,NaN,4.746223021233876,18.42406064992304,172010180,0.6766617576046587,-2.958293903993024,-3.6349556615976826
2025-08-29T13:30:00-04:00,508.08,509.01,505.28,506.79,NaN,NaN,NaN,516.6920562397189,NaN,NaN,516.991,536.7558269407983,497.22617305920164,500.934337905191,507.2336682954857,507.4164138169741,507.0509227739973,423084,723644.1666666666,43.8743435210702,39.42348681323768,NaN,NaN,NaN,NaN,4.6736356625743145,18.082127556662474,171587096,0.6758343657539481,-2.7901627044052475,-3.4659970701591956
2025-09-02T09:30:00-04:00,500.635,505.4,496.82,501.88,NaN,NaN,NaN,516.6817598567558,NaN,NaN,516.8055999999999,536.956254941222,496.65494505877786,500.934337905191,501.3666666666666,501.3666666666666,501.3666666666666,689473,720376.4,37.42578616712345,39.72359139716065,NaN,NaN,NaN,NaN,5.051947400961865,19.23212037679981,170897623,0.3581415226983311,-3.018320166786282,-3.376461689484613
2025-09-02T13:30:00-04:00,501.99,506.79,501.4,504.93,NaN,NaN,NaN,516.6817598567558,NaN,NaN,516.6562999999999,537.044675394819,496.2679246051808,500.934337905191,502.5029850463478,503.96082973454577,501.04514035814987,418885,714769.7666666667,43.027492065461196,40.44530648462678,NaN,NaN,NaN,NaN,5.076094015178877,19.91283083643778,171316508,0.36566986434065596,-2.919374359058793,-3.285044223399449
2025-09-03T09:30:00-04:00,503.87,507.78,503.04,504.08,NaN,NaN,NaN,516.6817598567558,NaN,NaN,516.4812999999999,537.1463712856286,495.81622871437133,500.934337905191,504.96666666666664,504.96666666666664,504.96666666666664,651290,701902.5333333333,41.901694620005486,40.62022666390141,NaN,NaN,NaN,NaN,5.052087299808954,20.268533319203065,170665218,0.3269235713843126,-2.876389759169058,-3.2033133305533705
2025-09-03T13:30:00-04:00,504.04,505.62,502.32,505.4,NaN,NaN,NaN,516.6817598567558,NaN,NaN,516.3374999999999,537.207926373225,495.46707362677483,500.934337905191,504.75110463489165,505.00727892514516,504.49493034463814,461156,700725.4,44.33736049324748,41.02834879050386,NaN,NaN,NaN,NaN,4.926938206965458,20.72219260666505,171126374,0.39894358418749754,-2.7046338503189986,-3.103577434506496
2025-09-04T09:30:00-04:00,504.15,508.04,503.16,506.79,NaN,NaN,NaN,516.6817598567558,NaN,NaN,516.2154999999999,537.2358882219155,495.1951117780843,500.934337905191,505.99666666666667,505.9966720614633,505.99666127187004,584679,691952.1,46.863585582053396,41.71468871222833,NaN,NaN,NaN,NaN,4.923585477896496,20.448498239546932,171711053,0.540172326803058,-2.4283620260026737,-2.9685343528057317
2025-09-04T13:30:00-04:00,506.77,508.15,506.31,507.77,NaN,NaN,NaN,516.6817598567558,NaN,NaN,516.0910999999999,537.2359506535345,494.9462493464653,500.934337905191,506.55262706834947,507.2430366565461,505.8622174801528,379133,671610.1333333333,48.63362573344976,42.657299925209415,NaN,NaN,NaN,NaN,4.703329372332459,20.16306658330562,172090186,0.6899799122481216,-2.1060594624955797,-2.7960393747437013
2025-09-05T09:30:00-04:00,509.05,511.97,493.99,494.56,NaN,NaN,NaN,516.6817598567558,NaN,NaN,515.2920999999999,536.6110515774135,493.97314842258623,500.934337905191,500.17333333333335,500.17333333333335,500.17333333333335,1666738,693774.8,32.78165717980285,42.73651415465908,NaN,NaN,NaN,NaN,5.6516629885944285,21.755658968926085,170423448,-0.06983386435659744,-2.8833317051894483,-2.813497840832851
2025-09-05T13:30:00-04:00,494.56,495.61,492.38,495.06,NaN,NaN,NaN,510.2688471855954,NaN,NaN,514.5236999999998,535.934421502094,493.11297849790566,499.07247032415285,497.97143907051685,500.7952708488855,495.1476072921482,1013404,706040.4666666667,33.66301878662753,42.643725802021656,NaN,NaN,NaN,NaN,5.478687060837685,23.406991459746557,171436852,-0.48485065825465323,-3.419561163651167,-2.934710505396514
2025-09-08T09:30:00-04:00,498.105,501.195,495.05,498.31,NaN,NaN,NaN,510.2688471855954,NaN,NaN,514.0248999999999,535.7588055385866,492.29099446141316,498.72297625932225,498.185,498.185,498.185,960929,714084.1666666666,39.239799469765536,42.51519034781667,NaN,NaN,NaN,NaN,5.52628084220642,23.537799301534307,172397781,-0.48539586887693176,-3.5414553414926786,-3.056059472615747
2025-09-08T13:30:00-04:00,498.33,498.64,497.02,498.36,NaN,NaN,NaN,510.2688471855954,NaN,NaN,513.5096999999998,535.4819363368016,491.5374636631981,497.5745216485238,498.1151497776199,498.2021990136066,498.02810054163314,618724,705867.4,39.32431059951117,42.24455999931211,NaN,NaN,NaN,NaN,5.247260782048819,23.65926372605151,173016505,-0.4292399487549998,-3.592609408559497,-3.163369459804497
2025-09-09T09:30:00-04:00,501.44,502.25,498.26,499.11,NaN,NaN,NaN,510.2688471855954,NaN,NaN,512.7456999999998,533.9993150346253,491.49208496537443,497.5745216485238,499.8733333333333,499.8733333333333,499.8733333333333,587307,697462.2666666667,40.6576340235285,41.82975168673082,NaN,NaN,NaN,NaN,5.157456440473903,22.946967456424545,173603812,-0.29483795515013966,-3.5319169037421716,-3.237078948592032
2025-09-09T13:30:00-04:00,499.13,499.44,497.71,498.43,NaN,NaN,NaN,510.2688471855954,NaN,NaN,512.0048999999998,532.6108372502213,491.3989627497784,497.5745216485238,499.2749674263146,499.9441143927438,498.6058204598854,469630,680404.4,39.80359941745088,41.23977383122426,NaN,NaN,NaN,NaN,4.912638123297198,22.377457664644695,173134182,-0.20902567707796305,-3.498361044939486,-3.289335367861523
2025-09-10T09:30:00-04:00,502.84,503.19,496.72,499.72,NaN,NaN,NaN,510.2688471855954,NaN,NaN,511.36729999999983,531.4753725292124,491.25922747078715,497.5745216485238,499.8766666666668,499.8766666666668,499.8766666666668,1466395,696118.1333333333,42.28057017776604,40.98674841691884,NaN,NaN,NaN,NaN,5.023878257347396,21.038377801689247,174600577,-0.03196970325673387,-3.3292974969324405,-3.2973277936757066
2025-09-10T13:30:00-04:00,499.715,501.88,499.08,500.2,NaN,NaN,NaN,510.2688471855954,NaN,NaN,510.81629999999984,530.6058284238936,491.02677157610606,497.5745216485238,500.01670141422505,500.24431510159036,499.78908772685975,555042,695782.0666666667,43.216850813982425,40.93978465212685,NaN,NaN,NaN,NaN,4.865029810394011,19.794946500373477,175155619,0.14137504238532372,-3.120608990694052,-3.2619840330793757
2025-09-11T09:30:00-04:00,502.17,503.18,497.88,500.08,NaN,NaN,NaN,510.2688471855954,NaN,NaN,510.30089999999984,529.8381302735071,490.7636697264926,497.5745216485238,500.37999999999994,500.38000539479657,500.3799946052033,722137,681813.2,43.028932428521934,41.34000938508389,NaN,NaN,NaN,NaN,4.8960991096515825,18.404130712606907,174433482,0.26469382348849724,-2.9311167537187544,-3.1958105772072516
2025-09-11T13:30:00-04:00,500.2,502.26,499.68,501.03,NaN,NaN,NaN,510.2688471855954,NaN,NaN,509.8248999999998,529.0806900372917,490.5691099627079,494.51961731881903,500.59465119388983,500.88596218452795,500.3033402032517,392078,672414.9333333333,45.065452748444486,41.485578005296986,NaN,NaN,NaN,NaN,4.730663458962183,17.112658909680807,174825560,0.4178743344217515,-2.673467659180062,-3.0913419936018136
2025-09-12T09:30:00-04:00,506.52,512.54,503.85,512.01,492.52416263589015,492.52416263589015,492.52416263589015,NaN,NaN,NaN,509.6458999999998,528.6490582312055,490.64274176879417,498.43289204272105,509.4666666666667,509.4666666666667,509.4666666666667,1415780,699544.6666666666,61.981335474997124,42.91983806636781,NaN,NaN,NaN,NaN,5.214901783322026,17.758936864368202,176241340,1.22088037154849,-1.565241529166201,-2.786121900714691
2025-09-12T13:30:00-04:00,512.05,512.5,509.87,509.89,495.86783706153153,NaN,NaN,NaN,NaN,NaN,509.4254999999997,528.154624085247,490.6963759147525,499.89931363417685,509.8667194263279,510.4622799524261,509.2711589002297,638820,706152.3333333334,58.25162302262679,43.91371396132348,NaN,NaN,NaN,NaN,5.030265941656167,18.359052108006498,175602520,1.5502955265731893,-0.8482524924982044,-2.3985480190713937
2025-09-15T09:30:00-04:00,508.79,514.25,507.02,511.97,495.86783706153153,NaN,NaN,NaN,NaN,NaN,509.2264999999997,527.6289629058338,490.8240370941657,500.5544509073415,511.08,511.08,511.08,724793,696114.0666666667,60.74734182414689,44.90541083575873,NaN,NaN,NaN,NaN,5.187389802966442,18.223035240470313,176327313,1.8301053558538758,-0.11091632425404896,-1.9410216801079248
2025-09-15T13:30:00-04:00,511.96,515.47,511.4,515.39,497.98256434738715,NaN,NaN,NaN,NaN,NaN,509.0918999999997,527.2114442426405,490.97235575735897,502.4785607258732,512.031569213804,513.4299852704733,510.63315315713476,335600,686862.1333333333,64.50463555975179,46.03905439478029,NaN,NaN,NaN,NaN,5.107576245611701,18.30112510612501,176662913,2.1454999235757684,0.7408532243617856,-1.4046466992139828
2025-09-16T09:30:00-04:00,516.545,517.19,510.56,513.54,498.2208568770514,NaN,NaN,NaN,NaN,NaN,508.84989999999976,526.3929700266788,491.3068299733207,503.48184858069857,513.7633333333333,513.7633333333333,513.7633333333333,723285,691810.7,61.09771988166408,48.06163030205609,NaN,NaN,NaN,NaN,5.216320799496583,18.658518024711025,175939628,2.125455694921958,1.2521729194384648,-0.8732827754834932
2025-09-16T13:30:00-04:00,513.56,513.89,508.62,509.15,498.2208568770514,NaN,NaN,NaN,NaN,NaN,508.5934999999998,525.732128445727,491.4548715542726,503.48184858069857,512.0740229783423,513.6768070448946,510.47123891179,803486,699946.9666666667,53.83185555556924,49.50226149983764,NaN,NaN,NaN,NaN,5.220155028103969,18.49150840367821,175136142,1.7292744692557145,1.2883103110861498,-0.4409641581695646
2025-09-17T09:30:00-04:00,510.61,510.83,505.92,508.49,498.2208568770514,NaN,NaN,NaN,NaN,NaN,508.1994999999998,524.3979774902095,492.00102250979006,503.48184858069857,508.41333333333336,508.41333333333336,508.41333333333336,566933,697760.8333333334,52.81494395179058,50.47191467712514,NaN,NaN,NaN,NaN,5.198001097525112,17.686258842815096,174569209,1.3522048550826304,1.2492919106837235,-0.10291294439890691
2025-09-17T13:30:00-04:00,508.5,511.3,506.52,509.99,498.2208568770514,NaN,NaN,NaN,NaN,NaN,507.81169999999986,522.850200671296,492.7731993287038,503.48184858069857,508.82441490529675,509.2524006774962,508.3964291330973,523033,679389.2333333333,54.90015909310206,51.58447528381021,NaN,NaN,NaN,NaN,5.16814387627332,17.034340974926575,175092242,1.1416448464515365,1.3241431136655137,0.18249826721397722
2025-09-18T09:30:00-04:00,511.33,513.06,507.66,509.18,498.2208568770514,NaN,NaN,NaN,NaN,NaN,507.4910999999998,521.6924758897118,493.28972411028775,503.48184858069857,509.9666666666667,509.9666720614633,509.96666127187007,839225,682572.3666666667,53.52460303852306,52.503544499166956,NaN,NaN,NaN,NaN,5.184705027968078,16.78881515357355,174253017,0.8964668933784727,1.3030818839370681,0.4066149905585954
2025-09-18T13:30:00-04:00,509.18,509.66,507.87,508.35,498.2208568770514,NaN,NaN,NaN,NaN,NaN,507.24449999999985,520.9404512630791,493.5485487369205,503.48184858069857,509.43507443845874,510.09062252115376,508.7795263557637,551857,688281.2333333333,52.08450845613164,53.380752287644164,NaN,NaN,NaN,NaN,4.9422260973989305,16.560826890888602,173701160,0.639124134164728,1.2055201582645054,0.5663960240997774
2025-09-19T09:30:00-04:00,510.73,514.85,510.34,511.71,498.2208568770514,NaN,NaN,NaN,NaN,NaN,506.9974999999998,519.893600844862,494.1013991551376,503.48184858069857,512.3000000000001,512.3000000000001,512.3000000000001,928070,700217.7666666667,57.114776293819794,54.44033843879087,NaN,NaN,NaN,NaN,5.053495661870436,17.32757753949225,174629230,0.6535863610229257,1.3833789753784345,0.7297926143555088
2025-09-19T13:30:00-04:00,511.65,519.3,510.36,517.99,498.9833242623655,NaN,NaN,NaN,NaN,NaN,506.90849999999983,519.4331506139144,494.3838493860852,504.9258444434709,514.3822296328863,516.1501783332463,512.6142809325262,1287356,731372.4333333333,64.59599861292017,55.96742042442926,NaN,NaN,NaN,NaN,5.331103114593972,18.702719830003172,175916586,1.0225104764076673,2.007930709865093,0.9854202334574256