time,open,high,low,close,Long Stop,Long Stop Start,Buy Label,Short Stop,Short Stop Start,Sell Label,Basis,Upper,Lower,ATR Trailing Stoploss,VWAP,Upper Band #1,Lower Band #1,Volume,Volume MA,RSI,RSI-based MA,Regular Bullish,Regular Bullish Label,Regular Bearish,Regular Bearish Label,ATR,ADX,OnBalanceVolume,Histogram,MACD,Signal
2025-08-12T14:50:00-04:00,529.17,529.48,529.15,529.45,528.8064007896812,NaN,NaN,NaN,NaN,NaN,527.9950000000009,530.8337384515897,525.1562615484121,529.554853519611,526.806985598812,528.7002592565011,524.913711941123,16911,14216.5,55.53356844631543,63.780801476100585,NaN,NaN,NaN,NaN,0.5202711093633399,23.94877293182435,13018949,-0.1403447026845086,0.4912927344422542,0.6316374371267628
2025-08-12T14:55:00-04:00,529.45,529.82,529.41,529.72,528.8064007896812,NaN,NaN,NaN,NaN,NaN,528.0694000000009,530.89002804296,525.2487719570418,529.554853519611,526.8234830743613,528.7235660848178,524.9234000639049,7506,13953.866666666667,58.24864180043405,63.48921417674485,NaN,NaN,NaN,NaN,0.5123946015516786,23.455515693583745,13026455,-0.12884232899078252,0.4705845258882846,0.5994268548790671
2025-08-12T15:00:00-04:00,529.68,529.91,529.66,529.66,528.8064007896812,NaN,NaN,NaN,NaN,NaN,528.1548000000009,530.9034061624773,525.4061938375246,529.554853519611,526.8401389862552,528.7475131534579,524.9327648190524,7421,13786.533333333333,57.409747782506166,63.03158907367101,NaN,NaN,NaN,NaN,0.493652130012273,23.1489436898864,13019034,-0.1241726562544363,0.44421103456102173,0.568383690815458
2025-08-12T15:05:00-04:00,529.67,529.69,529.29,529.31,528.8064007896812,NaN,NaN,NaN,NaN,NaN,528.2394000000008,530.8617299862245,525.6170700137772,529.554853519611,526.8555075897318,528.7675885778699,524.9434266015937,7766,13831.833333333334,52.64660961154683,62.18833183787107,NaN,NaN,NaN,NaN,0.48696269215425997,21.998995499841214,13011268,-0.1422544879739398,0.3905655808480333,0.5328200688219731
2025-08-12T15:10:00-04:00,529.25,529.53,528.87,528.88,528.8064007896812,NaN,NaN,NaN,NaN,NaN,528.3094000000009,530.8065484851115,525.8122515148902,529.1588828156888,526.8702489026167,528.7846002887412,524.9558975164922,8678,13913.866666666667,47.43911084229332,60.75868498169225,NaN,NaN,NaN,NaN,0.49932249985752486,20.769285917991137,13002590,-0.17842982877103564,0.3097827828581785,0.48821261162921414
2025-08-12T15:15:00-04:00,528.91,529.15,528.91,528.99,528.8064007896812,NaN,NaN,NaN,NaN,NaN,528.3682000000009,530.7869986762988,525.949401323703,528.8976281734687,526.8815535068373,528.7971674120636,524.9659396016111,6975,13626.2,48.83340434310348,59.12674134155441,NaN,NaN,NaN,NaN,0.4829423212962718,19.627412734844636,13009565,-0.18918124325306734,0.25173605756288,0.4409173008159473
2025-08-12T15:20:00-04:00,529,529.4,528.87,529.38,528.8064007896812,NaN,NaN,NaN,NaN,NaN,528.4320000000009,530.785006586549,526.0789934134528,528.8976281734687,526.8973292276626,528.8160201020055,524.9786383533196,9008,12546.833333333334,53.53921696029673,57.64252756003236,NaN,NaN,NaN,NaN,0.48630358406082186,18.414431501578203,13018573,-0.165133698161384,0.2345001781142173,0.3996338762756013
2025-08-12T15:25:00-04:00,529.4,529.88,529.365,529.75,528.8064007896812,NaN,NaN,NaN,NaN,NaN,528.4920000000009,530.8232829078325,526.1607170921692,528.8976281734687,526.9265384653442,528.8559194094031,524.9971575212852,14222,12644.3,57.52995002976533,56.51047871425742,NaN,NaN,NaN,NaN,0.4883533280564765,18.17714583975066,13032795,-0.12143543160225378,0.24783958677278406,0.36927501837503784
2025-08-12T15:30:00-04:00,529.75,529.77,529.52,529.74,528.8064007896812,NaN,NaN,NaN,NaN,NaN,528.5528000000008,530.8523200883628,526.2532799116389,528.8976281734687,526.9443083716411,528.8800282992619,525.0085884440203,8764,12584.766666666666,57.386480819762724,55.42698269803922,NaN,NaN,NaN,NaN,0.47132809033815676,17.956809153767942,13024031,-0.091685145204283,0.2546685868696841,0.3463537320739671
2025-08-12T15:35:00-04:00,529.72,530.13,529.7,529.91,528.8064007896812,NaN,NaN,NaN,NaN,NaN,528.623000000001,530.8690356177716,526.3769643822303,529.0863510399247,526.9803387006283,528.9315477835029,525.0291296177537,16662,12809.533333333333,59.247097296329265,55.015005262527744,NaN,NaN,NaN,NaN,0.4683760838854277,18.359163764495364,13040693,-0.060540593247926267,0.2706779905140593,0.33121858376198554
2025-08-12T15:40:00-04:00,529.89,529.9,529.43,529.56,528.8064007896812,NaN,NaN,NaN,NaN,NaN,528.6844000000009,530.8606027838307,526.5081972161711,529.0863510399247,527.0095018525229,528.9695363506934,525.0494673543525,15280,13040.466666666667,54.01772505135703,54.88911833279224,NaN,NaN,NaN,NaN,0.4692063636078984,18.072573504643604,13025413,-0.0632019924555986,0.2522160931924873,0.3154180856480859
2025-08-12T15:45:00-04:00,529.51,529.9,529.38,529.88,528.8064007896812,NaN,NaN,NaN,NaN,NaN,528.7440000000009,530.8843924865129,526.603607513489,529.0863510399247,527.0282933708829,528.9944272055657,525.0621595362002,9692,12932.033333333333,57.69433550771836,54.89536996623248,NaN,NaN,NaN,NaN,0.4728344804930472,17.686426078794906,13035105,-0.04401090709537436,0.26040445177886795,0.3044153588742423
2025-08-12T15:50:00-04:00,529.88,530.66,528.56,529.54,NaN,NaN,NaN,530.6282918397234,530.6282918397234,530.6282918397234,528.793000000001,530.8914537154508,526.6945462845513,529.0863510399247,527.1144559821812,529.1015401135346,525.1273718508278,48723,13991.8,52.858356144408916,54.663170049215424,NaN,NaN,NaN,NaN,0.5890605890292598,17.17667466847894,12986382,-0.0541484845272559,0.23672975321517242,0.2908782377424283
2025-08-12T15:55:00-04:00,529.49,529.69,529.07,529.38,NaN,NaN,NaN,531.142048542852,NaN,NaN,528.8492000000009,530.8549670443525,526.8434329556493,529.0863510399247,527.2430745788556,529.2428717624293,525.2432773952819,87075,16549,50.70446753973409,54.50633658396946,NaN,NaN,NaN,NaN,0.5912705469557417,16.70333407318554,12899307,-0.07052667620958653,0.2027198924804452,0.2732465686900317
2025-08-13T09:30:00-04:00,532.18,532.66,529.95,531.5,529.1757718454596,529.1757718454596,529.1757718454596,NaN,NaN,NaN,528.942000000001,530.9997269001781,526.884273099824,529.5265931087625,531.37,531.37,531.37,57743,18102.033333333333,68.82884351972348,55.45599908921289,NaN,NaN,NaN,NaN,0.7833226507446154,18.420428882937596,12957050,0.05570722593386862,0.3428806011073675,0.2871733751734989
2025-08-13T09:35:00-04:00,531.43,531.46,529.58,531.46,529.1757718454596,NaN,NaN,NaN,NaN,NaN,529.031400000001,531.1301310823667,526.9326689176353,529.5265931087625,531.1771789608391,531.4346681280998,530.9196897935784,32381,18693.033333333333,68.3184533041163,56.175271339475906,NaN,NaN,NaN,NaN,0.8645138899771398,19.42576217754475,12924669,0.1267371140073434,0.44559476768267814,0.31885765367533475
2025-08-13T09:40:00-04:00,531.41,531.42,529.93,530.22,529.1757718454596,NaN,NaN,NaN,NaN,NaN,529.1054000000009,531.1032036330416,527.1075963669603,529.5265931087625,531.0329958772992,531.3867826265508,530.6792091280475,25496,19264.366666666665,54.76171317393847,55.9861260102925,NaN,NaN,NaN,NaN,0.9120486121216361,20.359285951108536,12899173,0.08257263533694392,0.4220734478465147,0.33950081250957076
2025-08-13T09:45:00-04:00,530.31,530.31,528.88,529.09,NaN,NaN,NaN,532.0795869589781,532.0795869589781,532.0795869589781,529.147400000001,531.0516554860028,527.2431445139991,529.5265931087625,530.6909538234627,531.4196187298994,529.962288917026,31280,19896.066666666666,45.83561343492714,55.499626283391095,NaN,NaN,NaN,NaN,0.9490451398272299,19.69596928408281,12867893,-0.024646522491310108,0.3086926593954331,0.3333391818867432
2025-08-13T09:50:00-04:00,529.06,530.67,529.06,530.58,NaN,NaN,NaN,532.0795869589781,NaN,NaN,529.209000000001,531.0952884180793,527.3227115819226,529.5265931087625,530.6078421001364,531.313381895195,529.9023023050778,24200,20321.733333333334,56.01614601561093,56.112271652913776,NaN,NaN,NaN,NaN,0.9962562012681431,19.437870860333888,12892093,0.0014919273935897204,0.3352040911287304,0.3337121637351407
2025-08-13T09:55:00-04:00,530.58,530.66,529.88,530.265,NaN,NaN,NaN,532.0795869589781,NaN,NaN,529.260100000001,531.1194251346,527.400774865402,529.5265931087625,530.5650194249798,531.2341269340324,529.8959119159273,24696,20902.133333333335,53.717452623447265,56.461132244366915,NaN,NaN,NaN,NaN,0.980809329748988,19.198208038281315,12867397,-0.00534816210307365,0.3270269611062986,0.33237512320937224
2025-08-13T10:00:00-04:00,530.21,530.57,529.62,530.55,NaN,NaN,NaN,532.0795869589781,NaN,NaN,529.3099000000009,531.1713666143994,527.4484333856024,529.5265931087625,530.5326125378083,531.1740150024684,529.8912100731482,22190,21198.466666666667,55.4968681922463,56.60096447522046,NaN,NaN,NaN,NaN,0.9786086633383493,18.602039089231916,12889587,0.005802795444334763,0.3396286175147907,0.3338258220704559
2025-08-13T10:05:00-04:00,530.57,531.8,530.48,531.72,NaN,NaN,NaN,532.0795869589781,NaN,NaN,529.385900000001,531.3229324612968,527.4488675387053,529.5265931087625,530.6067065616493,531.2602871130402,529.9531260102583,22228,20941.4,61.962332195249665,56.91756320132647,NaN,NaN,NaN,NaN,1.002993758814177,19.237351748703897,12911815,0.08411104784783796,0.43896463188025336,0.3548535840324154
2025-08-13T10:10:00-04:00,531.7,531.8,530.75,531.15,NaN,NaN,NaN,532.0795869589781,NaN,NaN,529.458900000001,531.3811937226892,527.5366062773128,529.5265931087625,530.6476735391045,531.2982373848013,529.9971096934078,16803,20830.066666666666,57.57390885002007,56.93095091777344,NaN,NaN,NaN,NaN,1.006351347470304,19.82728493249931,12895012,0.0891727024902112,0.4663194621451794,0.3771467596549682
2025-08-13T10:15:00-04:00,531.17,531.4,530.73,530.73,NaN,NaN,NaN,532.0795869589781,NaN,NaN,529.5189000000009,531.4085934027715,527.6292065972303,529.5265931087625,530.6661293640378,531.3009355989967,530.0313231290789,16516,20794.866666666665,54.51039927416377,56.59261534476161,NaN,NaN,NaN,NaN,0.9823262512224222,20.343128030020626,12878496,0.057428875323837614,0.4489328538097652,0.3915039784859276
2025-08-13T10:20:00-04:00,530.735,531.31,530.735,530.92,NaN,NaN,NaN,532.0795869589781,NaN,NaN,529.5819000000009,531.4440008449003,527.7197991551016,528.8011107876468,530.6843568615955,531.3054225930317,530.0632911301592,16402,20691.233333333334,55.659822446006054,56.70990801580797,NaN,NaN,NaN,NaN,0.9535886618493868,20.822125192004705,12894898,0.04307803198000887,0.4453515184609387,0.4022734864809298
2025-08-13T10:25:00-04:00,530.89,531,529.6,529.72,NaN,NaN,NaN,532.0795869589781,NaN,NaN,529.609100000001,531.438455830908,527.7797441690941,528.8011107876468,530.6370321653167,531.2528433534349,530.0212209771985,25871,21099.733333333334,47.496904066280514,55.981520055705275,NaN,NaN,NaN,NaN,0.9854751860030004,19.5644490799203,12869027,-0.04842366739559939,0.3417439022364306,0.39016756963203
2025-08-13T10:30:00-04:00,529.76,530.21,529.53,530.13,NaN,NaN,NaN,532.0795869589781,NaN,NaN,529.638300000001,531.4533169244864,527.8232830755155,528.8011107876468,530.6072575867223,531.2253180032632,529.9891971701815,14453,20847.166666666668,50.18503701114636,55.79056868904366,NaN,NaN,NaN,NaN,0.9636555298599335,18.30587601604777,12883480,-0.08062855231111399,0.2893818792431375,0.3700104315542515
2025-08-13T10:35:00-04:00,530.125,530.37,529.855,529.93,NaN,NaN,NaN,532.0795869589781,NaN,NaN,529.6717000000009,531.4450173536451,527.8983826463567,528.8011107876468,530.5866041369056,531.2021093144987,529.9710989593126,12751,20788.2,48.87058660565948,55.65957719375262,NaN,NaN,NaN,NaN,0.9316087062985087,17.343136942200648,12870729,-0.11272411555869644,0.22910528710588096,0.3418294026645774
2025-08-13T10:40:00-04:00,529.92,530.53,529.67,530.48,NaN,NaN,NaN,532.0795869589781,NaN,NaN,529.7079000000009,531.4718184664682,527.9439815335336,528.8011107876468,530.5650294525248,531.167888136718,529.9621707683315,21871,21226.833333333332,52.55113994688681,54.49688408140714,NaN,NaN,NaN,NaN,0.926493798705759,16.184707789123735,12892600,-0.09494848671733214,0.2231437942679122,0.31809228098524434
2025-08-13T10:45:00-04:00,530.51,530.56,529.87,530.43,NaN,NaN,NaN,532.0795869589781,NaN,NaN,529.742900000001,531.4932417826988,527.9925582173032,528.8011107876468,530.5567481986906,531.1524519502718,529.9610444471093,11188,21358.4,52.183378249368076,53.3443787203537,NaN,NaN,NaN,NaN,0.9096013845124863,15.152317766381524,12881412,-0.0849205801603179,0.21194155578484697,0.29686213594516486
2025-08-13T10:50:00-04:00,530.42,530.61,529.9,530.13,NaN,NaN,NaN,532.0795869589781,NaN,NaN,529.772500000001,531.4977898296821,528.0472101703198,528.8011107876468,530.5465652245712,531.1362548184436,529.9568756306987,11492,21177.766666666666,49.925787525276164,52.998955459734965,NaN,NaN,NaN,NaN,0.895344142761597,14.270060535878978,12869920,-0.096035340039273,0.1768179608960736,0.2728533009353466
2025-08-13T10:55:00-04:00,530.18,530.71,530.16,530.35,NaN,NaN,NaN,532.0795869589781,NaN,NaN,529.8071000000009,531.5077635047963,528.1064364952055,528.8011107876468,530.5404544168438,531.1178297358268,529.9630790978607,17702,21517.633333333335,51.5801201625799,53.40927736885301,NaN,NaN,NaN,NaN,0.8728195611357715,13.609837332895463,12887622,-0.08641519040864493,0.16483431292454043,0.25124950333318535
2025-08-13T11:00:00-04:00,530.34,530.34,529.42,529.49,NaN,NaN,NaN,532.0795869589781,NaN,NaN,529.823100000001,531.4962537754984,528.1499462245035,528.8011107876468,530.5157728520488,531.1004553750246,529.9310903290731,13062,21705.666666666668,45.28220596539282,52.64256736526601,NaN,NaN,NaN,NaN,0.8769038781975066,13.436573117452639,12874560,-0.1330292245636208,0.08496297262865937,0.21799219719228016
2025-08-13T11:05:00-04:00,529.48,529.55,527.25,527.59,NaN,NaN,NaN,531.1277137475346,NaN,NaN,529.8111000000009,531.5386546754105,528.0835453245913,528.8011107876468,530.2861650485088,531.1828399233798,529.3894901736378,44547,22931.7,35.088737830741366,51.31194488007274,NaN,NaN,NaN,NaN,0.9785536011833956,15.354644147090557,12830013,-0.2785133408404186,-0.13014947885824313,0.1483638619821755
2025-08-13T11:10:00-04:00,527.63,527.77,526.91,527.43,NaN,NaN,NaN,530.060999486283,NaN,NaN,529.7899000000009,531.6055524878545,527.9742475121473,528.7685037970535,530.1524043921418,531.2197948836065,529.085013900677,22252,23384.166666666668,34.386738901036196,49.80407850212915,NaN,NaN,NaN,NaN,0.9700854868131541,17.359188508746524,12807761,-0.36666326809902283,-0.309965223141603,0.056698044957419785
2025-08-13T11:15:00-04:00,527.38,527.52,526.91,527.365,NaN,NaN,NaN,529.8954995096337,NaN,NaN,529.780400000001,531.6411727846742,527.9196272153279,528.7685037970535,530.0535982810187,531.2265713158616,528.8806252461758,17189,23724.633333333335,34.08837038058364,47.81308122965301,NaN,NaN,NaN,NaN,0.9443650948979297,19.220551130284207,12790572,-0.40735789376201825,-0.45249932224510303,-0.04514142848308479
2025-08-13T11:20:00-04:00,527.45,527.54,526.86,527.25,NaN,NaN,NaN,529.8513858955596,NaN,NaN,529.763600000001,531.6987961544565,527.8284038455455,528.7685037970535,529.9422499875678,531.2171431904071,528.6673567847286,20521,24108.4,33.53397925700794,46.09594340158072,NaN,NaN,NaN,NaN,0.9254818738337883,20.98475722992699,12770051,-0.4184376083760468,-0.5681884389531433,-0.14975083057709648
2025-08-13T11:25:00-04:00,527.26,527.51,526.99,527.28,NaN,NaN,NaN,529.8513858955596,NaN,NaN,529.7310000000009,531.7745028741573,527.6874971258445,528.7685037970535,529.8455837317312,531.1934393986762,528.4977280647861,19547,24285.9,33.83627918679508,44.61922053819724,NaN,NaN,NaN,NaN,0.8965188828456593,22.62294860816672,12789598,-0.4001671883279368,-0.6499598159870175,-0.24979262765908067
2025-08-13T11:30:00-04:00,527.39,528.22,527.39,528.07,NaN,NaN,NaN,529.8513858955596,NaN,NaN,529.710400000001,531.7991956713477,527.6216043286543,528.7685037970535,529.806272581705,531.1683785899153,528.4441665734947,11146,24365.3,41.39523514901336,43.60032144555491,NaN,NaN,NaN,NaN,0.8996246769281161,22.83547631530947,12800744,-0.3150449516204353,-0.6435988171846247,-0.3285538655641895
2025-08-13T11:35:00-04:00,528.13,528.3,527.11,527.28,NaN,NaN,NaN,529.8513858955596,NaN,NaN,529.672400000001,531.8649631020495,527.4798368979524,528.7685037970535,529.7686192118817,531.1496415870914,528.3875968366721,9451,24124.933333333334,36.8601664511747,42.84055447304735,NaN,NaN,NaN,NaN,0.9203657714332465,23.30540954660041,12791293,-0.2925973973319167,-0.6943006122290853,-0.40170321489716865
2025-08-13T11:40:00-04:00,527.32,527.99,527.29,527.99,NaN,NaN,NaN,529.8513858955596,NaN,NaN,529.6408000000009,531.8833292498972,527.3982707501046,528.7685037970535,529.7517296175743,531.1391402192897,528.3643190158588,4766,23774.466666666667,42.91335216874222,42.32114841287562,NaN,NaN,NaN,NaN,0.9053396449023029,23.74177611851342,12796059,-0.21421647328047533,-0.6694738064977628,-0.45525733321728745
2025-08-13T11:45:00-04:00,528,528.14,527.66,528.13,NaN,NaN,NaN,529.8513858955596,NaN,NaN,529.5992000000009,531.8748751606544,527.3235248393474,528.3218030376428,529.730430925619,531.1229697588166,528.3378920924214,6895,23681.233333333334,44.05233429177436,41.976987533312396,NaN,NaN,NaN,NaN,0.8749582416949968,23.861489075997607,12802954,-0.14077427993010094,-0.6312251831299136,-0.49045090319981266
2025-08-13T11:50:00-04:00,528.13,528.2,527.37,527.79,NaN,NaN,NaN,529.8513858955596,NaN,NaN,529.5414000000009,531.8508891549532,527.2319108450486,526.7854424301142,529.6891460188825,531.0950339508577,528.2832580869074,12470,22472.8,41.867612566772344,41.21387843473279,NaN,NaN,NaN,NaN,0.8717469387167858,24.29450730708201,12790484,-0.10458917400979018,-0.6211873707120503,-0.5165981967022601
2025-08-13T11:55:00-04:00,527.77,527.97,527.6,527.97,NaN,NaN,NaN,529.8513858955596,NaN,NaN,529.4884000000009,531.8179874649609,527.1588125350409,526.1871644392447,529.6698032431207,531.0808437898528,528.2587626963885,6229,19777.933333333334,43.46611858670608,40.59121703025693,NaN,NaN,NaN,NaN,0.8359078716655871,24.69659566451753,12796713,-0.0602294066773551,-0.591884955048954,-0.5316555483715989
2025-08-13T12:00:00-04:00,527.93,528.33,527.89,528.3,NaN,NaN,NaN,529.8513858955596,NaN,NaN,529.443000000001,531.774979415898,527.111020584104,526.6737852411167,529.6546415898274,531.0664921864915,528.2427909931633,6073,18055.6,46.37731044565406,40.3377543817125,NaN,NaN,NaN,NaN,0.807628737975192,24.32734354714482,12802786,-0.0033614076722561226,-0.5358573079619191,-0.532495900289663
2025-08-13T12:05:00-04:00,528.3,528.34,528.1,528.3,NaN,NaN,NaN,529.8513858955596,NaN,NaN,529.4072000000009,531.7532666309237,527.0611333690781,526.8950281928933,529.636960549162,531.048651821235,528.2252692770891,7623,17230.333333333332,46.37731044565406,39.96612511621779,NaN,NaN,NaN,NaN,0.7670838281198218,23.964077947906812,12802786,0.03731322641099466,-0.4858543672759197,-0.5231675936869143
2025-08-13T12:10:00-04:00,528.31,528.61,528.15,528.23,NaN,NaN,NaN,529.8513858955596,NaN,NaN,529.3842000000009,531.7533174383858,527.0150825616159,527.2240225543146,529.611753439574,531.0212729973543,528.2022338817937,11938,16778.4,45.7971423123587,40.002906283858216,NaN,NaN,NaN,NaN,0.7451492689684086,23.0737377743893,12790848,0.06115366069068995,-0.44672551782355185,-0.5078791785142418
2025-08-13T12:15:00-04:00,528.24,528.33,527.63,527.63,NaN,NaN,NaN,529.8513858955596,NaN,NaN,529.3452000000009,531.7638243686849,526.9265756313168,527.2240225543146,529.5809078467347,530.9967732588293,528.1650424346401,11116,16106.266666666666,41.05619721173385,40.42915338250054,NaN,NaN,NaN,NaN,0.7419243211849541,22.997261291103772,12779732,0.03923024632048089,-0.4588413706136407,-0.4980716169341216
2025-08-13T12:20:00-04:00,527.64,527.64,526.66,526.67,NaN,NaN,NaN,529.4967085478181,NaN,NaN,529.2894000000009,531.8209549681568,526.757845031845,527.2240225543146,529.5133008382667,530.970338177995,528.0562634985383,16882,15862.333333333334,34.84140184280646,40.4616293069127,NaN,NaN,NaN,NaN,0.7589297268146016,23.998830235055475,12762850,-0.03329157282359274,-0.5396860829636125,-0.5063945101400198
2025-08-13T12:25:00-04:00,526.65,526.95,526.3,526.34,NaN,NaN,NaN,528.9536763410991,NaN,NaN,529.232200000001,531.8950857723793,526.5693142276226,527.2240225543146,529.4496035961085,530.9541303240526,527.9450768681645,14115,15509.633333333333,32.99259323095488,40.38335951051065,NaN,NaN,NaN,NaN,0.7511490320421366,25.250285318759747,12748735,-0.09344477179592414,-0.6232004748849249,-0.5297557030890008
2025-08-13T12:30:00-04:00,526.32,526.36,525.64,525.98,NaN,NaN,NaN,528.3210092346856,NaN,NaN,529.1628000000009,531.9759911838702,526.3496088161315,527.2240225543146,529.3663502814185,530.9442890540308,527.7884115088061,16317,15313.866666666667,31.05651752945387,40.206397958542496,NaN,NaN,NaN,NaN,0.7489241011819859,26.928769486754454,12732418,-0.14439377955367916,-0.7102479275310998,-0.5658541479774206
2025-08-13T12:35:00-04:00,525.98,526.22,525.8,525.93,NaN,NaN,NaN,528.2827815421998,NaN,NaN,529.0870000000009,532.0369667789283,526.1370332210735,527.2240225543146,529.2987452481019,530.9310050903196,527.6664854058843,13813,15033.366666666667,30.786298737528412,39.9885422121663,NaN,NaN,NaN,NaN,0.725429522526135,28.487361928463827,12718605,-0.16679036898216126,-0.7743421092051221,-0.6075517402229609
2025-08-13T12:40:00-04:00,525.94,526.26,525.86,526.16,NaN,NaN,NaN,528.2827815421998,NaN,NaN,529.0170000000008,532.0734397584795,525.9605602415222,527.2240225543146,529.2624968925267,530.9205138632989,527.6044799217544,7906,14736.8,33.64632669216529,39.43504875096288,NaN,NaN,NaN,NaN,0.7021845566314094,29.84309479361795,12726511,-0.15186769466958927,-0.7973863585599474,-0.6455186638903582
2025-08-13T12:45:00-04:00,526.2,526.23,525.43,525.5,NaN,NaN,NaN,528.0620178927894,NaN,NaN,528.9408000000008,532.1503596952264,525.7312403047752,527.2240225543146,529.1783870530803,530.9030999005635,527.4536742055972,17003,14753.033333333333,29.836331632551932,38.933346263918395,NaN,NaN,NaN,NaN,0.7091713740148851,31.442279926301175,12709508,-0.17078788368626097,-0.8590035184981843,-0.6882156348119234
2025-08-13T12:50:00-04:00,525.45,525.54,524.95,525.34,NaN,NaN,NaN,527.456017079481,NaN,NaN,528.8700000000008,532.234251476547,525.5057485234546,527.2240225543146,529.0841158357806,530.8901323908881,527.2780992806731,17731,14797.333333333334,28.9796094462813,37.93807892659976,NaN,NaN,NaN,NaN,0.700659133013816,33.26265090933908,12691777,-0.17763020417754816,-0.9102533900338585,-0.7326231858563104
2025-08-13T12:55:00-04:00,525.33,525.34,525.05,525.17,NaN,NaN,NaN,527.3450617576863,NaN,NaN,528.7936000000008,532.3133852430857,525.2738147569158,527.2240225543146,529.0258728820689,530.8796690321221,527.1720767320157,11133,14306.066666666668,28.057757519268137,36.795609157135026,NaN,NaN,NaN,NaN,0.6713263377985489,34.952995393588566,12680644,-0.17677698638976957,-0.9535944188435224,-0.7768174324537528
2025-08-13T13:00:00-04:00,525.18,525.7,525.12,525.15,NaN,NaN,NaN,527.3450617576863,NaN,NaN,528.7090000000009,532.3688928942289,525.0491071057728,526.8712180434517,528.9391027257738,530.8547655859254,527.0234398656221,17878,14420.233333333334,27.945131029788598,35.80114619020762,NaN,NaN,NaN,NaN,0.6648030279557984,35.63964788523795,12662766,-0.16116952129932638,-0.9782793340779108,-0.8171098127785844
2025-08-13T13:05:00-04:00,525.15,525.15,524.53,524.7,NaN,NaN,NaN,526.9590851965695,NaN,NaN,528.6080000000007,532.422850455482,524.7931495445195,525.9829744347613,528.8557421517753,530.8393297020702,526.8721546014804,15654,14517,25.467996605369507,34.515566048683574,NaN,NaN,NaN,NaN,0.6616028116732416,36.7605504524831,12647112,-0.1642068064483836,-1.022368320839064,-0.8581615143906803
2025-08-13T13:10:00-04:00,524.78,525.11,524.51,524.74,NaN,NaN,NaN,526.9145813239982,NaN,NaN,528.5080000000008,532.4586308353245,524.5573691646772,525.299379547809,528.766801086043,530.8168290888935,526.7167730831924,17397,14367.866666666667,26.095113841912763,33.06683771984491,NaN,NaN,NaN,NaN,0.6572026108394403,37.816809510399416,12664509,-0.1471261245340144,-1.0420691700581983,-0.8949430455241839
2025-08-13T13:15:00-04:00,524.78,524.9,524.49,524.86,NaN,NaN,NaN,526.7598276274528,NaN,NaN,528.4070000000007,532.4658254455727,524.3481745544287,524.8164823284782,528.6982257536671,530.7962291230949,526.6002223842393,13824,14455.733333333334,28.05096961494702,31.757813374794416,NaN,NaN,NaN,NaN,0.6395452814937637,38.81407639938265,12678333,-0.11289054488089723,-1.0360562266253055,-0.9231656817444083
2025-08-13T13:20:00-04:00,524.88,524.95,524.65,524.79,NaN,NaN,NaN,526.7598276274528,NaN,NaN,528.3116000000008,532.480283456116,524.1429165438856,524.8164823284782,528.613973012346,530.7652947755,526.462651249192,17872,14668.4,27.592244850303473,30.457463556076185,NaN,NaN,NaN,NaN,0.6152920471013569,39.60308603566195,12660461,-0.08156534906585144,-1.0251223680767225,-0.9435570190108711
2025-08-13T13:25:00-04:00,524.77,525.41,524.76,525.21,NaN,NaN,NaN,526.7598276274528,NaN,NaN,528.2182000000008,532.4509096565761,523.9854903434256,524.8164823284782,528.5306234466123,530.7218071704176,526.3394397228069,20265,14753.833333333334,34.51216200998253,29.9900324702368,NaN,NaN,NaN,NaN,0.6177711865941156,39.144479561258265,12680726,-0.022249884783932083,-0.9713693749907861,-0.949119490206854
2025-08-13T13:30:00-04:00,525.19,525.25,524.4,524.43,NaN,NaN,NaN,526.7598276274528,NaN,NaN,528.1160000000008,532.4613786943457,523.7706213056558,524.6751858627825,528.4539455934854,530.6886046464385,526.2192865405323,17288,14894.7,28.974121965485338,29.57094105042815,NaN,NaN,NaN,NaN,0.6343589589802517,39.1278940326053,12663438,-0.025030561733535905,-0.9804076923737739,-0.955377130640238
2025-08-13T13:35:00-04:00,524.42,524.47,523.85,523.96,NaN,NaN,NaN,526.1857625068928,NaN,NaN,528.0076000000008,532.4897072005432,523.5254927994584,524.3091351617446,528.3480121242607,530.6551967093569,526.0408275391644,21541,14127.833333333334,26.24160847130463,29.08872785331027,NaN,NaN,NaN,NaN,0.6333333190530912,39.65199556162556,12641897,-0.04674560382739412,-1.0138091354244807,-0.9670635315970866
2025-08-13T13:40:00-04:00,523.98,524,523.65,523.78,NaN,NaN,NaN,525.8064096656703,NaN,NaN,527.8532000000009,532.3751450501734,523.3312549498285,524.3091351617446,528.2630941424973,530.6298724275354,525.8963158574592,16909,13949.733333333334,25.259115394238236,28.67462770079487,NaN,NaN,NaN,NaN,0.6130952248350149,40.31526165252749,12624988,-0.06057633559121689,-1.0427839510861077,-0.9822076154948908
2025-08-13T13:45:00-04:00,523.815,523.98,523.7,523.92,NaN,NaN,NaN,525.7695274081399,NaN,NaN,527.7024000000008,532.2360419087943,523.1687580912073,524.3091351617446,528.2132982883428,530.6121807520084,525.8144158246772,10352,13721.833333333334,27.53173690853353,28.442158998723805,NaN,NaN,NaN,NaN,0.589302708775369,40.93115159407928,12635340,-0.04818058642766421,-1.042433348529471,-0.9942527621018068
2025-08-13T13:50:00-04:00,523.9,524,523.83,523.96,NaN,NaN,NaN,525.7695274081399,NaN,NaN,527.5772000000009,532.1711730775119,522.9832269224898,524.0974654098004,528.1588944784959,530.5902754027949,525.7275135541969,11758,13429.733333333334,28.20345809422342,28.05338267029939,NaN,NaN,NaN,NaN,0.5593525152914112,41.44637191795586,12647098,-0.026268345843642793,-1.0270881944063603,-1.0008198485627176
2025-08-13T13:55:00-04:00,523.98,524.02,523.83,523.87,NaN,NaN,NaN,525.7311396425406,NaN,NaN,527.4728000000009,532.1608030542398,522.7847969457621,524.0974654098004,528.1205757035319,530.5741063785774,525.6670450284864,8418,13058.766666666666,27.583925072712134,27.89249648745369,NaN,NaN,NaN,NaN,0.5329701927705919,41.86442503418796,12638680,-0.0077764540847249375,-1.0105404161686238,-1.0027639620838988
2025-08-13T14:00:00-04:00,523.86,523.98,523.66,523.97,NaN,NaN,NaN,525.5876787496978,NaN,NaN,527.3406000000009,532.0434351615293,522.6377648384725,524.0974654098004,528.0649185241375,530.5497658993177,525.5800711489574,12394,13100.366666666667,29.4386152300373,27.925282614864834,NaN,NaN,NaN,NaN,0.5177580361441246,42.43943611425861,12651074,0.019745334008696824,-0.9780822945730279,-0.9978276285817247
2025-08-13T14:05:00-04:00,523.97,523.99,523.85,523.95,NaN,NaN,NaN,525.5876787496978,NaN,NaN,527.2143000000009,531.9353566652824,522.4932433347194,524.0974654098004,528.0288037319951,530.5325140815977,525.5250933823926,8340,13063.333333333334,29.277112707799446,28.012379414045636,NaN,NaN,NaN,NaN,0.49077531927668616,42.93981517826694,12642734,0.04378102530864125,-0.9431013469459231,-0.9868823722545643
2025-08-13T14:10:00-04:00,523.94,524.59,523.75,524.57,NaN,NaN,NaN,525.5876787496978,NaN,NaN,527.0947000000009,531.7744856400344,522.4149143599674,524.0974654098004,527.9586885074646,530.4898708421118,525.4275061728173,18316,13515,40.22494835904579,28.889509223278292,NaN,NaN,NaN,NaN,0.5157199393283537,41.60680548682612,12661050,0.10511522705086929,-0.8554883384409777,-0.960603565491847
2025-08-13T14:15:00-04:00,524.56,524.56,524.18,524.18,NaN,NaN,NaN,525.5876787496978,NaN,NaN,526.9439000000009,531.5021449644969,522.3856550355049,523.7749723278404,527.9258914053753,530.4691269159339,525.3826558948167,8819,13579.133333333333,36.407153313050024,29.67087755954119,NaN,NaN,NaN,NaN,0.5067399436620499,40.369010773345366,12652231,0.12191675301991933,-0.8082076242169478,-0.9301243772368671
2025-08-13T14:20:00-04:00,524.16,524.31,523.81,524.3,NaN,NaN,NaN,525.5876787496978,NaN,NaN,526.806900000001,531.2618338441998,522.3519661558021,523.523913309382,527.8688618386037,530.4346501114579,525.3030735657495,15019,13664.1,38.34615680321196,30.545952056776848,NaN,NaN,NaN,NaN,0.5062585191147606,39.80103516537941,12667250,0.1421944324067016,-0.7523813367284902,-0.8945757691351918
2025-08-13T14:25:00-04:00,524.24,524.35,523.81,523.86,NaN,NaN,NaN,525.5876787496978,NaN,NaN,526.6695000000009,531.0552041620148,522.283795837987,523.523913309382,527.8251933889576,530.4089085331979,525.2414782447173,11402,13836.533333333333,34.22541705139402,30.98698401652306,NaN,NaN,NaN,NaN,0.5086686248922833,39.156721994938934,12655848,0.12752592633845916,-0.7351683612121178,-0.862694287550577
2025-08-13T14:30:00-04:00,523.88,523.95,523.47,523.56,NaN,NaN,NaN,525.4015068906367,NaN,NaN,526.5223000000009,530.8206611803326,522.2239388196691,523.523913309382,527.7506363080364,530.3700020146499,525.1312706014229,18380,14246.766666666666,31.722352810060883,31.2819917279343,NaN,NaN,NaN,NaN,0.5066208659714072,39.06097815523632,12637468,0.10036659112623347,-0.7372360486427851,-0.8376026397690186
2025-08-13T14:35:00-04:00,523.56,523.76,523.17,523.58,NaN,NaN,NaN,525.160074759244,NaN,NaN,526.3995000000009,530.6761969727152,522.1228030272866,523.523913309382,527.6496529165582,530.3173594110564,524.9819464220601,25008,14826.266666666666,32.07898524364319,31.108193387481492,NaN,NaN,NaN,NaN,0.5125765184020232,39.3632839695908,12662476,0.0869948800830812,-0.7288590396651671,-0.8158539197482483
2025-08-13T14:40:00-04:00,523.56,523.61,523.35,523.57,NaN,NaN,NaN,525.1334804520058,NaN,NaN,526.2683000000009,530.4811895590254,522.0554104409763,523.523913309382,527.6218113989032,530.3019743496716,524.9416484481349,7122,14665.733333333334,31.98901521718632,31.323542905460133,NaN,NaN,NaN,NaN,0.49453533851616377,39.6439965114914,12655354,0.08085314310352376,-0.7147874908688436,-0.7956406339723674
2025-08-13T14:45:00-04:00,523.57,523.61,522.8,522.83,NaN,NaN,NaN,524.8937767950963,NaN,NaN,526.1263000000008,530.3144847185703,521.9381152814314,523.523913309382,527.5441214602558,530.2657418060762,524.8225011144355,18429,14909.5,26.145319622613755,31.31666513055364,NaN,NaN,NaN,NaN,0.5170685286221562,40.543553247990175,12636925,0.03279379854543463,-0.7546483857905741,-0.7874421843360088
2025-08-13T14:50:00-04:00,522.89,522.95,522.43,522.46,NaN,NaN,NaN,524.3729233044103,NaN,NaN,525.9659000000008,530.0886348637691,521.8431651362325,523.523913309382,527.4546355602502,530.230606827042,524.6786642934583,19914,15010.566666666668,23.803849611169852,31.212717574620182,NaN,NaN,NaN,NaN,0.5172779194348662,41.728729453793896,12617011,-0.015481548195730999,-0.8067941195806725,-0.7913125713849415
2025-08-13T14:55:00-04:00,522.45,523.07,522.37,522.67,NaN,NaN,NaN,524.3729233044103,NaN,NaN,525.8107000000009,529.8325622597843,521.7888377402176,523.523913309382,527.3976215078628,530.2049667345273,524.5902762811984,13327,14984.3,27.75828898823042,31.228899866027103,NaN,NaN,NaN,NaN,0.5303294966180933,42.44111543388111,12630338,-0.024312076879000055,-0.8217026674836916,-0.7973905906046915
2025-08-13T15:00:00-04:00,522.63,523.07,522.56,522.93,NaN,NaN,NaN,524.3729233044103,NaN,NaN,525.6667000000009,529.573591147241,521.7598088527608,523.5121306475055,527.3512737844213,530.1813401046742,524.5212074641685,11444,14821.866666666667,32.433709768092044,31.531060699874864,NaN,NaN,NaN,NaN,0.5288773897168083,43.10261670110495,12641782,-0.004710151539416674,-0.8032782800289624,-0.7985681284895457
2025-08-13T15:05:00-04:00,522.92,522.96,522.18,522.33,NaN,NaN,NaN,524.2934290685708,NaN,NaN,525.5063000000009,529.2874251283941,521.7251748716077,523.2217045180043,527.2473675631126,530.1339577624393,524.3607773637858,24507,15178.333333333334,27.93985161179937,31.55648402409538,NaN,NaN,NaN,NaN,0.5468147190227567,44.10562847837829,12617275,-0.02318733565847697,-0.827552298062642,-0.804364962404165
2025-08-13T15:10:00-04:00,522.32,522.32,521.75,521.87,NaN,NaN,NaN,523.7591822927269,NaN,NaN,525.3539000000009,529.0945188200485,521.6132811799532,523.2093636144035,527.0530495857564,530.0548486785525,524.0512504929603,43918,16378.733333333334,25.07172562048946,31.244563337699105,NaN,NaN,NaN,NaN,0.5491850962354199,45.40660568748738,12573357,-0.05557584178496877,-0.8738347646353759,-0.8182589228504071
2025-08-13T15:15:00-04:00,521.83,522.04,521.57,522.04,NaN,NaN,NaN,523.5149012794211,NaN,NaN,525.2429000000009,529.0404634763337,521.4453365236681,522.7974908915229,526.8704203134483,529.9693336166939,523.7715070102028,43596,17265.166666666668,28.01279464343412,31.154254904530152,NaN,NaN,NaN,NaN,0.5435290179328838,46.75359615062203,12616953,-0.05465403923754819,-0.8865764718973423,-0.8319224326597942
2025-08-13T15:20:00-04:00,521.995,522.2,521.65,521.67,NaN,NaN,NaN,523.5149012794211,NaN,NaN,525.1277000000009,529.0015844635109,521.253815536491,522.5429927132183,526.735914274876,529.8989850222733,523.5728435274787,33904,17804.266666666666,25.652696838609344,30.11337979592755,NaN,NaN,NaN,NaN,0.5439912309376826,47.451866878044896,12583049,-0.06723927380470562,-0.9159715249156761,-0.8487322511109705
2025-08-13T15:25:00-04:00,521.67,522.43,521.64,522.43,NaN,NaN,NaN,523.5149012794211,NaN,NaN,525.0290000000009,528.9212718297428,521.1367281702591,522.5063941705746,526.6411582350905,529.8382694073807,523.4440470628003,26852,18328.233333333334,37.33197774230828,30.17943868373171,NaN,NaN,NaN,NaN,0.5615632858707027,47.34059361881251,12609901,-0.015363506748317768,-0.8679366345463677,-0.85257312779805
2025-08-13T15:30:00-04:00,522.42,522.52,521.81,521.89,NaN,NaN,NaN,523.5149012794211,NaN,NaN,524.921800000001,528.8584802049754,520.9851197950265,522.3221153364597,526.5205160376884,529.759045658762,523.2819864166147,35126,18903.166666666668,33.32607910495575,29.820861705284837,NaN,NaN,NaN,NaN,0.5721659083085122,46.947197354658904,12574775,-0.008732192544587014,-0.8634883684787837,-0.8547561759341967
2025-08-13T15:35:00-04:00,521.93,522,520.76,520.92,NaN,NaN,NaN,523.2244675087215,NaN,NaN,524.794600000001,528.8280842700227,520.7611157299792,521.7092030522673,526.0225809603345,529.4707150234487,522.5744468972202,138083,22984.133333333335,27.597451467942975,29.347435592181196,NaN,NaN,NaN,NaN,0.6198683434293334,47.658439093815964,12436692,-0.058228542314829435,-0.9275418538277336,-0.8693133115129041
2025-08-13T15:40:00-04:00,520.93,520.94,519.65,519.92,NaN,NaN,NaN,522.2315371674161,NaN,NaN,524.631600000001,528.7795389769273,520.4836610230747,521.7092030522673,525.7982107075043,529.3614422716196,522.234979143389,58524,24355.033333333333,23.174692238103944,28.736888408469984,NaN,NaN,NaN,NaN,0.6677348903272436,49.02007148412833,12378168,-0.1420917593348181,-1.0469280106814267,-0.9048362513466086
2025-08-13T15:45:00-04:00,519.9,520,519.38,519.795,NaN,NaN,NaN,521.6230582052608,NaN,NaN,524.481900000001,528.7744576939793,520.1893423060227,521.7092030522673,525.6521942866581,529.2931867049397,522.0112018683765,37607,25147.8,22.68529286805402,28.06591038164219,NaN,NaN,NaN,NaN,0.6643252553038694,50.4182973530349,12340561,-0.18693490283433234,-1.138504879889524,-0.9515699770551918
2025-08-13T15:50:00-04:00,519.83,520.98,519.58,519.9,NaN,NaN,NaN,521.6230582052608,NaN,NaN,524.320100000001,528.680868046599,519.9593319534031,521.4813624418138,525.4050840826228,529.141237985852,521.6689301793937,73599,27005.366666666665,24.134589268129915,27.504879956709594,NaN,NaN,NaN,NaN,0.7168734513535914,49.54417216187882,12414160,-0.1898661433790222,-1.1889026562789695,-0.9990365128999473
2025-08-13T15:55:00-04:00,519.89,520.82,519.71,520.68,NaN,NaN,NaN,521.6230582052608,NaN,NaN,524.171100000001,528.5100276504714,519.8321723495307,520.9493760449335,524.8619797661748,528.7174518422122,521.0065076901375,199496,32979.73333333333,34.02797417109326,28.06792671017241,NaN,NaN,NaN,NaN,0.7449539191140502,48.732484484376734,12613656,-0.12286448822340024,-1.1526171231791977,-1.0297526349557975
2025-08-14T09:30:00-04:00,522.8,523.02,520.88,521.34,519.6312178776371,519.6312178776371,519.6312178776371,NaN,NaN,NaN,524.042100000001,528.3261663342167,519.7580336657853,520.9493760449335,521.7466666666668,521.7466666666668,521.7466666666668,61615,34457.3,41.03493789040254,29.298718730117606,NaN,NaN,NaN,NaN,0.8588857820344774,45.67868560269412,12675271,-0.02292067298294631,-1.0584034761844805,-1.0354828032015342
2025-08-14T09:35:00-04:00,521.4,521.43,520.1,520.45,519.6312178776371,NaN,NaN,NaN,NaN,NaN,523.891700000001,528.141491340301,519.6419086597011,520.9493760449335,521.2374319480019,521.7796942421439,520.6951696538599,54338,35550.53333333333,35.551436514788506,29.85537212487176,NaN,NaN,NaN,NaN,0.8925367976034381,42.81207424761902,12620933,-0.0064337080084082565,-1.0435249382120446,-1.0370912302036364
2025-08-14T09:40:00-04:00,520.43,522.48,520.18,522.4,519.6312178776371,NaN,NaN,NaN,NaN,NaN,523.7737000000011,527.8514929368275,519.6959070631747,520.9493760449335,521.3486277080156,521.8574039474614,520.8398514685697,38142,36258.3,51.001120840195966,31.18161577287918,NaN,NaN,NaN,NaN,0.9930698834889117,40.38463090453405,12659075,0.13813667506395322,-0.8644203863736948,-1.002557061437648
2025-08-14T09:45:00-04:00,522.39,523.43,522.32,522.54,520.2422660372649,NaN,NaN,NaN,NaN,NaN,523.6585000000011,527.5389743261227,519.7780256738796,520.9493760449335,521.6879046975384,522.4373330424987,520.9384763525782,48614,37533.7,51.89277165810623,32.892538633329664,NaN,NaN,NaN,NaN,1.0014220346682678,38.89348985944959,12707689,0.23958383190529753,-0.7030772715560261,-0.9426611034613236
2025-08-14T09:50:00-04:00,522.5,524.33,522.44,522.8,520.6142084901165,NaN,NaN,NaN,NaN,NaN,523.5499000000011,527.2102248429132,519.889575157089,520.594840590407,521.9541921008057,522.8436618261215,521.0647223754899,43679,38597.73333333333,53.58213784232272,34.9289966491749,NaN,NaN,NaN,NaN,1.0648918893348192,38.12266843443315,12751368,0.31579621802821223,-0.5479158309260583,-0.8637120489542706
2025-08-14T09:55:00-04:00,522.85,523.455,522.7,523.19,520.6142084901165,NaN,NaN,NaN,NaN,NaN,523.4611000000011,526.9316937756563,519.990506224346,520.594840590407,522.086293766575,523.0011792375337,521.1714082956162,31640,39371.8,56.073929661818134,36.933363436202335,NaN,NaN,NaN,NaN,1.0427567543823317,37.40690568263218,12783008,0.3797732923642465,-0.3889954334989625,-0.768768725863209
2025-08-14T10:00:00-04:00,523.26,523.46,522.53,522.53,520.6142084901165,NaN,NaN,NaN,NaN,NaN,523.3783000000012,526.7343677041772,520.0222322958252,520.594840590407,522.1516777909897,523.0513497330663,521.252005848913,26410,39839,51.07686607845071,38.74937552476242,NaN,NaN,NaN,NaN,1.0347027004978842,36.5331583107217,12756598,0.3648535991938031,-0.3127017268709551,-0.6775553260647582
2025-08-14T10:05:00-04:00,522.52,522.93,521.86,522.72,520.6142084901165,NaN,NaN,NaN,NaN,NaN,523.3059000000012,526.557846917628,520.0539530823744,520.594840590407,522.1737193294662,523.048900191147,521.2985384677853,20358,40239.6,52.39217148321026,39.82510364911257,NaN,NaN,NaN,NaN,1.0372239361766022,34.93125062740914,12776956,0.3546784946946069,-0.2342072076964996,-0.5888857023911065
2025-08-14T10:10:00-04:00,522.76,522.9,522.03,522.56,520.6142084901165,NaN,NaN,NaN,NaN,NaN,523.2375000000012,526.4043421172047,520.0706578827977,520.594840590407,522.1881771063099,523.0461466721534,521.3302075404664,15222,40136.46666666667,51.14516703754457,41.09789564429748,NaN,NaN,NaN,NaN,1.0252793693068454,33.443764921476046,12761734,0.3248660358781734,-0.18280315754338972,-0.5076691934215631
2025-08-14T10:15:00-04:00,522.54,523.49,522.49,523.18,520.6142084901165,NaN,NaN,NaN,NaN,NaN,523.1825000000011,526.254484536986,520.1105154630163,520.6829589646645,522.2383600264112,523.0952799468146,521.3814401060079,20937,40540.4,55.55923965711448,43.09516622923831,NaN,NaN,NaN,NaN,1.0234737000706422,32.57067037211483,12782671,0.3333454245367989,-0.09098741275056454,-0.42433283728736343
2025-08-14T10:20:00-04:00,523.25,523.71,523.05,523.32,520.6419988606849,NaN,NaN,NaN,NaN,NaN,523.1257000000012,526.0780644821383,520.1733355178641,521.1343671717316,522.3252418157994,523.2012177825517,521.449265849047,30307,41050,56.514662920289304,45.47659270653726,NaN,NaN,NaN,NaN,0.997511292922745,31.94106723499331,12812978,0.3339886575076071,-0.006847015402854595,-0.3408356729104617
2025-08-14T10:25:00-04:00,523.34,523.91,523.07,523.42,520.7619080033811,NaN,NaN,NaN,NaN,NaN,523.0841000000012,525.9590745660361,520.2091254339663,521.4294937373853,522.3927283621377,523.2840430081072,521.5014137161683,24587,41489.5,57.22210419860627,47.9435078015767,NaN,NaN,NaN,NaN,0.9862604862854002,31.522812458292993,12837565,0.32637268630744803,0.06713018497384837,-0.25924250133359966
2025-08-14T10:30:00-04:00,523.46,523.97,523.43,523.84,521.0209121850456,NaN,NaN,NaN,NaN,NaN,523.0541000000011,525.8648761838515,520.2433238161507,521.7105949899083,522.4185654775804,523.3205609439673,521.5165700111935,8090,41146.5,60.154111484407416,50.5163308170251,NaN,NaN,NaN,NaN,0.955099022979305,31.186034032933385,12845655,0.33365703078654624,0.15782878714958315,-0.1758282436369631
2025-08-14T10:35:00-04:00,523.83,524.18,523.57,523.99,521.2345070857253,NaN,NaN,NaN,NaN,NaN,523.0305000000011,525.789149125138,520.2718508748642,522.0674759919266,522.4806171000074,523.4126706137926,521.5485635862223,18361,40924.933333333334,61.177534986902515,52.45558516101147,NaN,NaN,NaN,NaN,0.9304490927664905,31.05906343851824,12864016,0.33190750599616686,0.2390561388582455,-0.09285136713792136
2025-08-14T10:40:00-04:00,524.025,525,523.74,525,521.6777113091015,NaN,NaN,NaN,NaN,NaN,523.027500000001,525.777234713728,520.2777652862741,522.6799807935413,522.6158557375153,523.654311444653,521.5774000303776,30454,41702.666666666664,67.27283462318287,54.32972064192428,NaN,NaN,NaN,NaN,0.9539884432831691,31.596593579755783,12894470,0.37871414648228374,0.38054131596493335,0.0018271694826495904
2025-08-14T10:45:00-04:00,524.98,525.94,524.92,525.77,522.7209971586877,NaN,NaN,NaN,NaN,NaN,523.0489000000011,525.8661918122795,520.2316081877228,523.5739846348331,522.8760793534241,524.1709208774316,521.5812378294165,46123,42625.8,71.00978570625135,56.86245986988592,NaN,NaN,NaN,NaN,0.9587035544772353,32.702348182770855,12940593,0.437321763773823,0.5484793741999283,0.11115761042610534
2025-08-14T10:50:00-04:00,525.765,525.94,525.27,525.47,522.927770015111,NaN,NaN,NaN,NaN,NaN,523.0635000000011,525.9229462742982,520.2040537257041,523.7121877078664,523.0037966576235,524.3906284538442,521.6169648614028,25925,42826.166666666664,67.76326228304501,58.059755687232276,NaN,NaN,NaN,NaN,0.9380818720145808,33.72912031414199,12914668,0.4309720515154931,0.6498726748204717,0.21890062330497861
2025-08-14T10:55:00-04:00,525.465,525.59,524.05,524.24,522.927770015111,NaN,NaN,NaN,NaN,NaN,523.0511000000012,525.8845355746386,520.2176644253638,523.7121877078664,523.0659280363877,524.4611484049572,521.6707076678183,21688,43104.86666666667,56.38158735884864,58.38038538014245,NaN,NaN,NaN,NaN,0.9810760240135449,32.87260615363136,12892980,0.32390850610437116,0.6237862559354426,0.2998777498310714
2025-08-14T11:00:00-04:00,524.22,524.39,523.87,524.09,522.927770015111,NaN,NaN,NaN,NaN,NaN,523.0371000000011,525.8428113813852,520.2313886186171,523.7121877078664,523.0913258067737,524.4789959175845,521.703655695963,14032,43191.13333333333,55.16471759021806,58.4934267907064,NaN,NaN,NaN,NaN,0.9481420222982904,31.84557760901071,12878948,0.22751675310669056,0.5842736912144346,0.35675693810774406
2025-08-14T11:05:00-04:00,524.08,524.16,523.68,523.89,522.927770015111,NaN,NaN,NaN,NaN,NaN,523.0107000000012,525.7583724759849,520.2630275240175,523.7121877078664,523.1190916988127,524.4910536575625,521.7471297400629,20380,43053.566666666666,53.50651759554867,58.3100402145443,NaN,NaN,NaN,NaN,0.9147033064198424,30.643083974623732,12858568,0.1391574479254979,0.5307037480146164,0.3915463000891185
2025-08-14T11:10:00-04:00,523.96,524.55,523.92,524.49,522.927770015111,NaN,NaN,NaN,NaN,NaN,523.0119000000012,525.7621020935111,520.2616979064913,523.7121877078664,523.1394318246884,524.5085234270939,521.7703402222828,10353,41934.73333333333,57.62200998245575,58.7775504934018,NaN,NaN,NaN,NaN,0.8965102131041371,29.896917615960145,12868921,0.11120162928734728,0.5305483366983026,0.4193467074109553
2025-08-14T11:15:00-04:00,524.49,524.79,524.05,524.1,522.927770015111,NaN,NaN,NaN,NaN,NaN,523.0147000000012,525.7690394190682,520.2603605809342,523.7121877078664,523.1620356857106,524.5274452101737,521.7966261612476,12001,40881.566666666666,54.259937621902324,58.91096236045123,NaN,NaN,NaN,NaN,0.885330912168128,29.425604306041542,12856920,0.05913809782583451,0.49326932969324844,0.4341312318674139
2025-08-14T11:20:00-04:00,524.08,524.1,523.4,523.61,522.927770015111,NaN,NaN,NaN,NaN,NaN,523.0113000000011,525.7622698717923,520.26033012821,523.7121877078664,523.1755153456105,524.5264524970763,521.8245781941447,15917,40282,50.289722420674174,58.84985917353192,NaN,NaN,NaN,NaN,0.8720929898704078,28.09121062610041,12841003,-0.011822978708325826,0.41935250848200667,0.4311754871903325
2025-08-14T11:25:00-04:00,523.59,523.62,523.1,523.1,522.927770015111,NaN,NaN,NaN,NaN,NaN,522.9949000000012,525.7337555922901,520.2560444077122,523.7121877078664,523.1783076603515,524.509922898548,521.846692422155,18782,40013,46.477840182096095,58.20118778245917,NaN,NaN,NaN,NaN,0.8469434905939489,26.471079710406247,12822221,-0.09215817981467067,0.31597776242199416,0.40813594223666483
2025-08-14T11:30:00-04:00,523.1,523.18,522.25,522.35,NaN,NaN,NaN,525.261369515566,525.261369515566,525.261369515566,522.9627000000011,525.6932568728525,520.2321431271496,523.7121877078664,523.15433390373,524.4635237905107,521.8451440169493,28117,39779.36666666667,41.496486951060824,57.12846092751429,NaN,NaN,NaN,NaN,0.8528760984086633,25.158769018340493,12794104,-0.18926378878888633,0.1715562062505569,0.36081999503944323
2025-08-14T11:35:00-04:00,522.33,522.41,521.83,521.99,NaN,NaN,NaN,524.6297163557676,NaN,NaN,522.9251000000011,525.6564223822406,520.1937776177615,523.7121877078664,523.1253825986885,524.4285687670725,521.8221964303044,18940,35807.933333333334,39.31817215534918,55.84960863871021,NaN,NaN,NaN,NaN,0.833384948522325,24.3592533212176,12775164,-0.26647006868848366,0.02773240917883868,0.29420247786732234
2025-08-14T11:40:00-04:00,521.95,522.23,521.8,522.17,NaN,NaN,NaN,524.4692747032327,NaN,NaN,522.889100000001,525.6118204696567,520.1663795303454,523.0377501662931,523.1000626298538,524.3976926967656,521.802432562942,17274,34432.933333333334,40.98625334728402,54.48047591462997,NaN,NaN,NaN,NaN,0.804571737913592,23.64687584816501,12792438,-0.29208767621894893,-0.0709071174063638,0.2211805588125851
2025-08-14T11:45:00-04:00,522.17,522.98,522.17,522.83,NaN,NaN,NaN,524.4692747032327,NaN,NaN,522.866700000001,525.5725156692888,520.1608843307131,522.8238784681135,523.0893207835487,524.3728133535506,521.8058282135469,18072,33781.76666666667,46.764738924571155,53.450990481606304,NaN,NaN,NaN,NaN,0.8049594709197683,22.035432107758183,12810510,-0.25272938049951754,-0.09473116681181182,0.15799821368770572
2025-08-14T11:50:00-04:00,522.84,523.36,522.7,523.27,NaN,NaN,NaN,524.4692747032327,NaN,NaN,522.840700000001,525.5052164731777,520.1761835268243,522.8238784681135,523.0897052650462,524.361213154914,521.8181973751783,14026,31796,50.26135703138728,52.235884939335186,NaN,NaN,NaN,NaN,0.7946052229969255,20.814594688318227,12824536,-0.18817253897339076,-0.07721746002903274,0.11095507894435802
2025-08-14T11:55:00-04:00,523.23,523.69,523.15,523.39,NaN,NaN,NaN,524.4692747032327,NaN,NaN,522.8249000000011,525.4667345813971,520.1830654186051,522.8238784681135,523.0998913021622,524.35227928148,521.8475033228443,24779,25972.1,51.20272121551114,50.82109461856803,NaN,NaN,NaN,NaN,0.7764191356400078,20.039749723718074,12849315,-0.13119868256244493,-0.05304327425869815,0.07815540830374679
2025-08-14T12:00:00-04:00,523.45,523.56,522.83,523.33,NaN,NaN,NaN,524.4692747032327,NaN,NaN,522.8055000000011,525.4178018576715,520.1931981423306,522.8238784681135,523.1024962674848,524.3433314792683,521.8616610557012,14761,24410.3,50.68617645875189,49.601302773975654,NaN,NaN,NaN,NaN,0.7731034830942861,18.909466897827848,12834554,-0.09315250916364715,-0.038285228150812145,0.054867281012835
2025-08-14T12:05:00-04:00,523.34,523.605,522.97,523.15,NaN,NaN,NaN,524.4692747032327,NaN,NaN,522.7913000000011,525.3881926114445,520.1944073885577,522.1771027744909,523.1038949405473,524.3385572020048,521.8692326790898,8060,22867.7,49.08631889967769,49.08021216974917,NaN,NaN,NaN,NaN,0.7632389485875508,17.913679524595366,12826494,-0.0764100903114489,-0.04064533187647612,0.035764758434972774
2025-08-14T12:10:00-04:00,523.13,523.35,522.56,522.64,NaN,NaN,NaN,524.4692747032327,NaN,NaN,522.7729000000011,525.3607671441283,520.1850328558738,522.0441465837729,523.1015323087717,524.3306783066489,521.8723863108944,7533,21847.4,44.77409812522139,48.33802506510654,NaN,NaN,NaN,NaN,0.7651504522598741,16.815942273134173,12818961,-0.09478379235641285,-0.08271498201054328,0.012068810345869561
2025-08-14T12:15:00-04:00,522.61,523.31,522.53,522.8,NaN,NaN,NaN,524.4692747032327,NaN,NaN,522.757300000001,525.3349013725366,520.1796986274654,522.0441465837729,523.1002208051201,524.325840872002,521.8746007382382,4821,20387.633333333335,46.36599610674051,47.827987815905956,NaN,NaN,NaN,NaN,0.7662111342413097,15.835658866335706,12823782,-0.09123055265169158,-0.10196938046874493,-0.010738827817053341
2025-08-14T12:20:00-04:00,522.74,524.22,522.72,524.2,NaN,NaN,NaN,524.4692747032327,NaN,NaN,522.769900000001,525.3693356994461,520.170464300556,522.0538227525707,523.1098109019377,524.3281853742469,521.8914364296286,12940,19363,57.822373013897156,47.84229946100892,NaN,NaN,NaN,NaN,0.8186246246526447,15.623972949888811,12836722,0.005221638666923906,-0.004211779483398459,-0.009433418150322365
2025-08-14T12:25:00-04:00,524.2,524.5,524.1,524.35,521.8973013236991,521.8973013236991,521.8973013236991,NaN,NaN,NaN,522.8003000000011,525.4371196061071,520.1634803938952,522.5670582020566,523.1335440601448,524.3514618456123,521.9156262746773,16595,18861.5,58.83689874893853,48.16922525579722,NaN,NaN,NaN,NaN,0.7887228657488828,15.731157829935691,12853317,0.07506092891395573,0.0843927429921223,0.009331814078166568
2025-08-14T12:30:00-04:00,524.33,524.92,524.33,524.81,522.2510603544401,NaN,NaN,NaN,NaN,NaN,522.847300000001,525.5413357895551,520.153264210447,523.0786465616453,523.172986388131,524.3999163191752,521.9460564570868,21989,18714.133333333335,61.866198725124555,48.99611642040082,NaN,NaN,NaN,NaN,0.7745283753382425,16.263302944787565,12875306,0.14417107409140012,0.18954565669241674,0.04537458260101661
2025-08-14T12:35:00-04:00,524.86,525.05,524.24,524.28,522.2685121565111,NaN,NaN,NaN,NaN,NaN,522.879500000001,525.6026189830222,520.1563810169798,523.1719172493163,523.2087484910527,524.4385867076829,521.9789102744224,23555,18820.7,56.689645796503086,49.72553110714417,NaN,NaN,NaN,NaN,0.7770620628140784,16.887925699685372,12851751,0.14569325503558478,0.22749115139549758,0.0817978963599128
2025-08-14T12:40:00-04:00,524.29,524.3,523.81,524,522.2685121565111,NaN,NaN,NaN,NaN,NaN,522.900900000001,525.6420280079029,520.1597719920991,523.1719172493163,523.2292981417421,524.4505890822865,522.0080072011978,22638,19067.9,54.11356082277667,50.626750669409596,NaN,NaN,NaN,NaN,0.7565576297559307,16.770605420070716,12829113,0.1203951657100586,0.23229185349748604,0.11189668778742745
2025-08-14T12:45:00-04:00,523.98,524.15,523.87,523.95,522.2685121565111,NaN,NaN,NaN,NaN,NaN,522.933300000001,525.6849464953648,520.1816535046373,523.1719172493163,523.2386368901869,524.4552951558276,522.0219786245461,11336,18747.866666666665,53.64476851932305,51.65007898112202,NaN,NaN,NaN,NaN,0.7225177990590765,16.661665160428534,12817777,0.09401647596194582,0.22941728273985973,0.1354008067779139
2025-08-14T12:50:00-04:00,523.98,524.17,523.91,524,522.2685121565111,NaN,NaN,NaN,NaN,NaN,522.9759000000009,525.7263324670772,520.2254675329247,523.1719172493163,523.2464994705318,524.4596038230604,522.0333951180032,9306,18047.833333333332,54.073242865548345,52.584863946712325,NaN,NaN,NaN,NaN,0.689480813411999,16.585902443331555,12827083,0.07451078512435358,0.2285392881833559,0.15402850305900231
2025-08-14T12:55:00-04:00,523.99,524.26,523.87,523.91,522.2685121565111,NaN,NaN,NaN,NaN,NaN,523.013300000001,525.7626661879841,520.2639338120179,523.1719172493163,523.2560381564481,524.464566264091,522.0475100488052,11748,17619.866666666665,53.121426887053836,53.03891308688965,NaN,NaN,NaN,NaN,0.6680893267397124,16.63566654610332,12815335,0.05123117931139551,0.2180674771982467,0.1668362978868512
2025-08-14T13:00:00-04:00,523.92,524.06,523.84,524,522.2685121565111,NaN,NaN,NaN,NaN,NaN,523.059900000001,525.7955640794859,520.3242359205161,523.1719172493163,523.2616050706899,524.4670193728762,522.0561907685037,7457,17598.766666666666,53.99354248266067,53.30549776198061,NaN,NaN,NaN,NaN,0.6360829462582983,16.622383543838755,12822792,0.03817692537572409,0.21455745460650633,0.17638052923078223
2025-08-14T13:05:00-04:00,524,524.01,523.95,523.99,522.2685121565111,NaN,NaN,NaN,NaN,NaN,523.091100000001,525.832893054834,520.349306945168,523.1719172493163,523.2662275643902,524.4691540768388,522.0633010519416,6136,17191.266666666666,53.87361520852137,53.49627590433848,NaN,NaN,NaN,NaN,0.5949341643827016,16.610049327450234,12816656,0.025747270144144047,0.20856461691096229,0.18281734676681824
2025-08-14T13:10:00-04:00,523.99,524.01,523.97,524,522.2685121565111,NaN,NaN,NaN,NaN,NaN,523.133300000001,525.8647798984472,520.4018201015548,523.2385490203238,523.2691544011393,524.4705398403431,522.0677689619355,3872,16305.2,53.983686142169844,53.73181231029692,NaN,NaN,NaN,NaN,0.5552960097839347,16.598596126518032,12820528,0.015578354385507726,0.2022902897487029,0.18671193536319516
2025-08-14T13:15:00-04:00,523.99,524.19,523.92,524.04,522.2685121565111,NaN,NaN,NaN,NaN,NaN,523.195700000001,525.8638979003839,520.5275020996181,523.4378392162591,523.2804672706651,524.4767622658075,522.0841722755227,14141,15239.133333333333,54.45189350053787,54.11506763892978,NaN,NaN,NaN,NaN,0.5349177233708032,16.889514017063846,12834669,0.009238521391930404,0.19826008710310816,0.18902156571117776
2025-08-14T13:20:00-04:00,524.04,524.055,523.96,523.98,522.2685121565111,NaN,NaN,NaN,NaN,NaN,523.276900000001,525.7836308502895,520.7701691497125,523.4378392162591,523.2850035479477,524.478868764889,522.0911383310064,6207,14581.866666666667,53.571381664625,54.74344503460147,NaN,NaN,NaN,NaN,0.5034950288443111,17.15965205828496,12828462,-0.0007717950254047257,0.18805682192942186,0.18882861695482658
2025-08-14T13:25:00-04:00,524,524.19,523.99,524.06,522.3515762802836,NaN,NaN,NaN,NaN,NaN,523.3622000000009,525.671694454629,521.0527055453729,523.5656170984058,523.3005098982029,524.4877758961339,522.1132439002719,19540,14510.266666666666,54.624950091832574,55.3333703192509,NaN,NaN,NaN,NaN,0.48253109821257717,17.64905335009405,12848002,-0.0036217100042938433,0.1843014794494593,0.18792318945375314
2025-08-14T13:30:00-04:00,524.06,524.06,523.93,523.99,522.3515762802836,NaN,NaN,NaN,NaN,NaN,523.444000000001,525.5367455640362,521.3512544359658,523.5656170984058,523.3049584387942,524.489699730578,522.1202171470104,6474,14258.333333333334,53.4813554039077,55.023297632823095,NaN,NaN,NaN,NaN,0.45735030548310707,17.928526911018064,12841528,-0.011398621792180152,0.17367491221352793,0.18507353400570808
2025-08-14T13:35:00-04:00,523.995,524,523.345,523.35,522.3515762802836,NaN,NaN,NaN,NaN,NaN,523.497400000001,525.435881095031,521.5589189049709,523.5656170984058,523.3082549906092,524.4858222654034,522.1306877158149,12946,14010.533333333333,44.3411728508708,53.98788864010397,NaN,NaN,NaN,NaN,0.4714681408057403,16.69649295651613,12828582,-0.05820608977273731,0.11231592178978644,0.17052201156252375
2025-08-14T13:40:00-04:00,523.4,523.4,522.9,523,522.3515762802836,NaN,NaN,NaN,NaN,NaN,523.530600000001,525.3747102342246,521.6864897657773,523.5656170984058,523.306228886081,524.478232180515,522.1342255916471,10033,13999.866666666667,40.286254529791165,52.446464054723016,NaN,NaN,NaN,NaN,0.4735061307481874,16.34245251430226,12818549,-0.10838364345045076,0.03504245724946031,0.14342610069991107
2025-08-14T13:45:00-04:00,523.01,523.11,522.64,522.7,522.3515762802836,NaN,NaN,NaN,NaN,NaN,523.575600000001,525.2153031912808,521.9358968087213,523.5656170984058,523.2998746776134,524.4655649338681,522.1341844213587,13561,14051.866666666667,37.15026406767617,51.050793931235376,NaN,NaN,NaN,NaN,0.47325569283760455,16.467794822422448,12804988,-0.15460519983753235,-0.049830399097004374,0.10477480074052797
2025-08-14T13:50:00-04:00,522.68,522.92,522.25,522.485,NaN,NaN,NaN,524.269716043388,524.269716043388,524.269716043388,523.5773000000011,525.212293833477,521.9423061665251,523.5656170984058,523.2919911064854,524.4540378702534,522.1299443427174,11126,13892.166666666666,35.04482066561101,49.688741062866406,NaN,NaN,NaN,NaN,0.4873088576349156,17.19393675768682,12793862,-0.19014732545156146,-0.13290935607392385,0.05723796937763761
2025-08-14T13:55:00-04:00,522.495,522.7,522.46,522.5,NaN,NaN,NaN,524.2208653141431,NaN,NaN,523.576500000001,525.2135610848442,521.9394389151579,523.5656170984058,523.2870458991617,524.4467616511051,522.1273301472183,7117,13503.333333333334,35.32023565798275,48.379845858484956,NaN,NaN,NaN,NaN,0.46964393923242226,17.868211411860884,12800979,-0.20202116690106717,-0.19528848924869635,0.0067326776523708165
2025-08-14T14:00:00-04:00,522.5,522.82,521.94,521.96,NaN,NaN,NaN,524.0662805271367,NaN,NaN,523.5597000000012,525.244825999781,521.8745740002213,523.5656170984058,523.2682396626445,524.4258756806533,522.1106036446357,19443,13214.2,30.333823911335784,46.6841730760412,NaN,NaN,NaN,NaN,0.49895508643010605,19.221705717513522,12781536,-0.23339609629254432,-0.2850124427133096,-0.05161634642076528
2025-08-14T14:05:00-04:00,521.96,521.99,521.72,521.77,NaN,NaN,NaN,523.5014495940849,NaN,NaN,523.531300000001,525.2867860397087,521.7758139602934,523.5656170984058,523.2456938032326,524.4080858024396,522.0833018040256,17199,13156.166666666666,28.79352871541596,44.94646606378135,NaN,NaN,NaN,NaN,0.4826011516850972,20.74695624393604,12764337,-0.25248106491303,-0.3672176775620528,-0.11473661264902278
2025-08-14T14:10:00-04:00,521.81,522.4,521.69,521.71,NaN,NaN,NaN,523.5014495940849,NaN,NaN,523.514900000001,525.3220574240704,521.7077425759317,523.5656170984058,523.2261469534533,524.3907502847212,522.0615436221854,16627,13134.6,28.304743173732305,43.111551827429324,NaN,NaN,NaN,NaN,0.4988439265647276,21.092436817574193,12747710,-0.2539907069119316,-0.4322249962889373,-0.1782342893770057
2025-08-14T14:15:00-04:00,521.75,521.76,520.95,521.12,NaN,NaN,NaN,523.0580460144452,NaN,NaN,523.482900000001,525.3986286748953,521.5671713251066,523.4954936787246,523.184160103112,524.3704059824219,521.9979142238022,24572,13351.266666666666,23.99181683528397,40.97713765791237,NaN,NaN,NaN,NaN,0.5210693603815288,22.325880686340152,12723138,-0.27764980237231784,-0.525296542342403,-0.24764673997008516
2025-08-14T14:20:00-04:00,521.15,521.52,521.02,521.34,NaN,NaN,NaN,522.9638166501521,NaN,NaN,523.4585000000011,525.4501970139479,521.4668029860543,523.2208949429797,523.1608880213453,524.3581021910924,521.9636738515982,14217,13357.633333333333,28.374459735191692,39.14790720027107,NaN,NaN,NaN,NaN,0.5195644060685625,23.47122142162283,12737355,-0.26162636952245294,-0.5746797018731513,-0.3130533323506984
2025-08-14T14:25:00-04:00,521.35,521.35,520.84,520.9,NaN,NaN,NaN,522.7813704387817,NaN,NaN,523.4129000000011,525.5285579013682,521.2972420986339,522.5267159543838,523.1379329609179,524.3488289066826,521.9270370151531,12579,12950.966666666667,25.23989041932313,37.061335551612885,NaN,NaN,NaN,NaN,0.5188812342065217,24.738155296855577,12724776,-0.26309403023561206,-0.6419208701452135,-0.3788268399096014
2025-08-14T14:30:00-04:00,520.89,521.68,520.8,521.68,NaN,NaN,NaN,522.7813704387817,NaN,NaN,523.380100000001,525.5506413969104,521.2095586030916,522.1763727635071,523.1054384286125,524.3281048728686,521.8827719843564,22076,13194.8,38.260714853470205,35.96771649367325,NaN,NaN,NaN,NaN,0.5446754317631983,25.071498418672522,12746852,-0.19699063796452243,-0.6250651373652545,-0.42807449940073206
2025-08-14T14:35:00-04:00,521.69,521.72,520.99,521.01,NaN,NaN,NaN,522.7813704387817,NaN,NaN,523.331900000001,525.6015298278385,521.0622701721636,521.8380982108056,523.0877739920288,524.3179761323175,521.8575718517401,11374,13305.266666666666,32.951728195620845,34.41962921537242,NaN,NaN,NaN,NaN,0.5579129009229712,25.281264719359093,12735478,-0.18408689882981327,-0.6581831229379986,-0.47409622410818536
2025-08-14T14:40:00-04:00,521,521.24,520.92,521.005,NaN,NaN,NaN,522.7813704387817,NaN,NaN,523.2752000000011,525.6312271296189,520.9191728703832,521.7144785686445,523.0685926404549,524.308649189919,521.8285360909907,11442,13435.566666666668,32.91502257291958,32.95060544173041,NaN,NaN,NaN,NaN,0.5409191222856197,25.57856432755955,12724036,-0.1623457892422112,-0.6770284606609493,-0.5146826714187381
2025-08-14T14:45:00-04:00,521.02,521.1,520.89,520.99,NaN,NaN,NaN,522.6603964436543,NaN,NaN,523.215200000001,525.6469400839211,520.7834599160809,521.5915828549156,523.0420632151904,524.2960304842626,521.7880959461182,15702,13798.266666666666,32.796992044328235,32.12602109840594,NaN,NaN,NaN,NaN,0.5172820421223637,25.900577536678664,12708334,-0.13647344969842967,-0.6852744835417752,-0.5488010338433456
2025-08-14T14:50:00-04:00,521,521.1,520.52,520.52,NaN,NaN,NaN,522.4787875143973,NaN,NaN,523.1256000000011,525.6170924353389,520.6341075646633,521.150813027146,523.0117454607839,524.2851837496996,521.7383071718682,16202,13907,29.256861967667405,31.338207343968538,NaN,NaN,NaN,NaN,0.5217618962564835,26.73900455027884,12692132,-0.13809399248366494,-0.7214185244479268,-0.5833245319642618
2025-08-14T14:55:00-04:00,520.53,520.98,520.15,520.94,NaN,NaN,NaN,522.271115354652,NaN,NaN,523.0290000000011,525.4770457501955,520.5809542498067,521.150813027146,522.9662116437671,524.2675517818597,521.6648715056746,24895,14183.666666666666,35.91395729574661,31.249899717402137,NaN,NaN,NaN,NaN,0.5437789036667376,27.98170979382048,12717027,-0.09974912481633591,-0.7080109379846817,-0.6082618131683458
2025-08-14T15:00:00-04:00,520.95,521.25,520.53,520.925,NaN,NaN,NaN,522.271115354652,NaN,NaN,522.9381000000011,525.3541595098594,520.5220404901428,520.3556504217169,522.9251797203817,524.2453530026468,521.6050064381167,25740,14308.7,35.784441912184334,31.30272980644309,NaN,NaN,NaN,NaN,0.5563661248334012,28.35636648425363,12691287,-0.06589814878910394,-0.6906344991547257,-0.6247363503656218
2025-08-14T15:05:00-04:00,520.91,521.23,520.72,521.19,NaN,NaN,NaN,522.271115354652,NaN,NaN,522.8771000000011,525.3125326833995,520.4416673166027,520.156973015919,522.8993815070602,524.2285613350521,521.5702016790683,18034,14124.666666666666,39.90748410741237,31.630390409973774,NaN,NaN,NaN,NaN,0.5530542587738719,28.70426198251299,12709321,-0.018619240000249393,-0.6480104003659335,-0.6293911603656841
2025-08-14T15:10:00-04:00,521.19,521.2,520.88,521.15,NaN,NaN,NaN,522.271115354652,NaN,NaN,522.8183000000012,525.2756242429483,520.360975757054,520.156973015919,522.8842044100652,524.2181614375106,521.5502473826198,11026,13737.6,39.49527135716833,32.28477951324752,NaN,NaN,NaN,NaN,0.5364075260043132,29.027307802325247,12698295,0.015175647927752833,-0.610421600455993,-0.6255972483837459
2025-08-14T15:15:00-04:00,521.19,522.005,521.06,521.99,NaN,NaN,NaN,522.271115354652,NaN,NaN,522.780300000001,525.2289056513282,520.3316943486739,520.4652351881139,522.8648833713386,524.1966372411431,521.5331295015341,21684,14082.533333333333,50.952678474229906,33.86757592459137,NaN,NaN,NaN,NaN,0.5655927027182944,27.234815869192403,12719979,0.09487238472864123,-0.5070067674729444,-0.6018791522015856
2025-08-14T15:20:00-04:00,521.98,522,521.36,521.64,NaN,NaN,NaN,522.271115354652,NaN,NaN,522.723300000001,525.1425665078019,520.3040334922001,520.4652351881139,522.8501247360232,524.1802334751175,521.5200159969289,16784,14331.8,46.96225139984497,35.20025508359942,NaN,NaN,NaN,NaN,0.5709075096669867,25.570359074140477,12703195,0.12300242320223642,-0.4481261231987901,-0.5711285464010265
2025-08-14T15:25:00-04:00,521.65,521.755,521.28,521.44,NaN,NaN,NaN,522.271115354652,NaN,NaN,522.6701000000011,525.0829103853434,520.2572896146587,520.4652351881139,522.8356468650699,524.1659821459929,521.5053115841469,14679,14429.5,44.802986341035655,36.686767191153116,NaN,NaN,NaN,NaN,0.5640569732622035,24.194396417065573,12688516,0.12662913324719438,-0.4128421298420335,-0.5394712630892279
2025-08-14T15:30:00-04:00,521.46,521.62,521.3,521.43,NaN,NaN,NaN,522.271115354652,NaN,NaN,522.626500000001,525.0485662658205,520.2044337341815,520.4652351881139,522.8032656804371,524.1345259980923,521.4720053627819,32957,15279.5,44.692338024548754,37.852329926107195,NaN,NaN,NaN,NaN,0.5466243323149068,22.916716806924583,12655559,0.126544256324168,-0.38129094268401786,-0.5078351990081859
2025-08-14T15:35:00-04:00,521.45,522.07,521.45,521.91,NaN,NaN,NaN,522.271115354652,NaN,NaN,522.602700000001,525.0290703006166,520.1763296993855,520.6754723330514,522.7824093317182,524.1072948311562,521.4575238322802,30248,16083.233333333334,50.95371543388598,39.68903171286168,NaN,NaN,NaN,NaN,0.5532940228638492,21.88368061768589,12685807,0.15511971329674584,-0.31393555738725354,-0.4690552706839994
2025-08-14T15:40:00-04:00,521.95,522.13,521.76,522.06,NaN,NaN,NaN,522.271115354652,NaN,NaN,522.596900000001,525.0270422912818,520.1667577087203,520.8293778664411,522.7756600055341,524.0969635611785,521.4543564498896,12271,16363.2,52.75377310091614,40.72425015910782,NaN,NaN,NaN,NaN,0.5402015926592888,21.0522581147722,12698078,0.17874756137511316,-0.2456208189651079,-0.42436838034022106
2025-08-14T15:45:00-04:00,522.055,522.25,521.4,521.41,NaN,NaN,NaN,522.271115354652,NaN,NaN,522.585300000001,525.0323973899368,520.1382026100652,520.8293778664411,522.7607443748426,524.0790581912386,521.4424305584466,20175,16564.333333333332,45.03971782023663,41.587677989437516,NaN,NaN,NaN,NaN,0.5623300503264841,19.699928523145978,12677903,0.1465742003067434,-0.24115062995679182,-0.3877248302635352
2025-08-14T15:50:00-04:00,521.41,522.92,521.41,522.33,520.3197066919699,520.3197066919699,520.3197066919699,NaN,NaN,NaN,522.5885000000011,525.0338345365293,520.1431654634729,520.9926018345222,522.7398861872568,524.036711938747,521.4430604357667,59097,18327.333333333332,55.057009899034526,43.16924851273144,NaN,NaN,NaN,NaN,0.6300207610174489,19.480038711270435,12737000,0.18097196308789198,-0.1615098764036702,-0.3424818394915622
2025-08-14T15:55:00-04:00,522.32,523.26,522.13,522.44,520.7794927514259,NaN,NaN,NaN,NaN,NaN,522.5807000000011,525.0253913988049,520.1360086011973,521.1530814676179,522.7308061584525,523.9819202187525,521.4796920981526,115154,21514.466666666667,56.08758175592669,44.83286206355991,NaN,NaN,NaN,NaN,0.6657335638019165,19.81872098799777,12852154,0.20318724963323714,-0.08849777745001575,-0.2916850270832529
2025-08-15T09:30:00-04:00,522.77,523.07,520.86,520.86,520.7794927514259,NaN,NaN,NaN,NaN,NaN,522.532500000001,525.0156586730756,520.0493413269265,521.1530814676179,521.5966666666667,521.5966666666667,521.5966666666667,62901,23395.366666666665,41.402110671688604,45.700379828132846,NaN,NaN,NaN,NaN,0.7760383092446393,19.053554605297162,12789253,0.10828727736366567,-0.15632593037867082,-0.2646132077423365
2025-08-15T09:35:00-04:00,520.92,522.73,520.92,522.04,520.7794927514259,NaN,NaN,NaN,NaN,NaN,522.5055000000011,524.9801193637692,520.0308806362331,521.1530814676179,521.7147491885986,521.8613141046841,521.5681842725131,40829,24324.8,51.59545922570239,46.82048710884398,NaN,NaN,NaN,NaN,0.8541784300128797,18.34304296421802,12830082,0.1208464866570868,-0.11355509942097797,-0.23440158607806477
2025-08-15T09:40:00-04:00,521.99,523.17,521.99,522.96,520.7794927514259,NaN,NaN,NaN,NaN,NaN,522.498100000001,524.965013771428,520.0311862285741,521.1530814676179,521.943766370824,522.3810750524985,521.5064576891496,31139,25028.333333333332,57.764319096741,48.390478336312306,NaN,NaN,NaN,NaN,0.8774513992976705,17.140754414786574,12861221,0.1832326284391232,-0.00536080052916077,-0.18859342896828396
2025-08-15T09:45:00-04:00,523,523,521.39,521.73,520.7794927514259,NaN,NaN,NaN,NaN,NaN,522.4697000000011,524.9386345141849,520.0007654858174,521.1530814676179,521.9598846111903,522.3605084533616,521.559260769019,27134,25480.766666666666,48.80830977865431,49.02625159854387,NaN,NaN,NaN,NaN,0.9297762993478378,16.71510650945893,12834087,0.13595334012417903,-0.018651753813060168,-0.1546050939372392
2025-08-15T09:50:00-04:00,521.65,522.5,521.52,522.4,520.7794927514259,NaN,NaN,NaN,NaN,NaN,522.4649000000012,524.9334246514802,519.9963753485222,521.1530814676179,521.9755812376621,522.3617070429772,521.5894554323471,15466,25625.433333333334,53.07610260835665,49.99631097362875,NaN,NaN,NaN,NaN,0.9333637065372793,16.319862025940402,12849553,0.14336003930658645,0.02459495519599386,-0.11876508411059258
2025-08-15T09:55:00-04:00,522.42,522.67,522,522.27,520.7794927514259,NaN,NaN,NaN,NaN,NaN,522.4543000000011,524.9215292222788,519.9870707777235,521.1530814676179,521.995587503026,522.3784957490312,521.6126792570207,11174,25760.666666666668,52.16732902424036,50.08307172720093,NaN,NaN,NaN,NaN,0.9145520132131849,15.639430121712858,12838379,0.13327370701609922,0.04782704965953144,-0.08544665735656778
2025-08-15T10:00:00-04:00,522.22,523.2,521.13,523.18,520.7794927514259,NaN,NaN,NaN,NaN,NaN,522.4339000000011,524.8595729283784,520.0082270716239,521.1530814676179,522.0646794989223,522.4608800939686,521.6684789038759,29713,26103,57.63549322784434,50.8454461434866,NaN,NaN,NaN,NaN,0.9970840122693895,16.19697933781795,12868092,0.17881843633386812,0.13807638806076739,-0.040742048273100746
2025-08-15T10:05:00-04:00,523.2,523.84,523.03,523.83,520.8150935213329,NaN,NaN,NaN,NaN,NaN,522.4235000000011,524.8205125146591,520.0264874853432,521.1530814676179,522.190101993276,522.7527022022648,521.6275017842872,19895,26192.866666666665,61.05979330121385,52.00664664064218,NaN,NaN,NaN,NaN,0.9837208685358659,15.621483970329056,12887987,0.23984395136480843,0.2590628909329098,0.019218939568101362
2025-08-15T10:10:00-04:00,523.84,524.43,523.71,524.28,521.4709983612722,NaN,NaN,NaN,NaN,NaN,522.4129000000012,524.7719922736426,520.0538077263598,521.6286708727025,522.4377224925616,523.2730922161835,521.6023527689398,34657,26793.866666666665,63.273081615427,53.3338426114192,NaN,NaN,NaN,NaN,0.9648836636404408,14.77080161902212,12922644,0.29406327898612167,0.38679803830075343,0.09273475931463178
2025-08-15T10:15:00-04:00,524.31,524.5,523.345,523.345,521.4709983612722,NaN,NaN,NaN,NaN,NaN,522.3942000000011,524.7081873456466,520.0802126543556,521.6814366981621,522.5421173019145,523.4170328054234,521.6672017984055,23984,26774.266666666666,56.13389554573073,53.70385547655097,NaN,NaN,NaN,NaN,0.9784634019518359,13.95471423214195,12898660,0.252116659366532,0.40788058352279677,0.15576392415626478
2025-08-15T10:20:00-04:00,523.37,524,523.37,523.59,521.4709983612722,NaN,NaN,NaN,NaN,NaN,522.3860000000011,524.6799869213929,520.0920130786093,521.6814366981621,522.5900813230846,523.4751995494944,521.7049630966749,13393,26746.8,57.48748109584959,54.04197747618907,NaN,NaN,NaN,NaN,0.9553588732409884,13.196918801467502,12912053,0.2268242166145995,0.43929419492451416,0.21246997830991465
2025-08-15T10:25:00-04:00,523.73,524.01,523.09,523.09,521.4709983612722,NaN,NaN,NaN,NaN,NaN,522.3688000000011,524.6282588368942,520.109341163108,521.6814366981621,522.6399174828177,523.5189749404371,521.7608600251983,20434,27008.633333333335,53.83640176129498,54.67031204340752,NaN,NaN,NaN,NaN,0.9528332394380578,12.887366702259289,12891619,0.165235023105331,0.4190137571915784,0.2537787340862474
2025-08-15T10:30:00-04:00,523.14,523.29,522.69,522.77,521.4709983612722,NaN,NaN,NaN,NaN,NaN,522.3442000000011,524.5584144059429,520.1299855940593,521.6814366981621,522.6467264100954,523.5159605891943,521.7774922309966,8342,26550.833333333332,51.578617981201795,54.42185547784804,NaN,NaN,NaN,NaN,0.9276308651924757,13.125486236711447,12883277,0.09523491214733254,0.3728223742704131,0.27758746212308055
2025-08-15T10:35:00-04:00,522.72,522.76,522.4,522.59,521.4709983612722,NaN,NaN,NaN,NaN,NaN,522.3178000000011,524.4877430028938,520.1478569971083,521.6814366981621,522.644048442255,523.4948201772165,521.7932767072934,14955,26670.2,50.30074424487142,54.00850994134409,NaN,NaN,NaN,NaN,0.8878000891072991,13.701442745724988,12868322,0.03234993587081986,0.3180248819616054,0.28567494609078553
2025-08-15T10:40:00-04:00,522.64,522.72,521.79,521.86,521.4709983612722,NaN,NaN,NaN,NaN,NaN,522.2750000000011,524.3943649982416,520.1556350017606,521.6814366981621,522.6276434347745,523.4698323752359,521.7854544943132,11516,26672.666666666668,45.389325019893015,54.293310966215834,NaN,NaN,NaN,NaN,0.8908143684567823,14.902869504245775,12856806,-0.05795232460875971,0.2132345403298359,0.2711868649385956
2025-08-15T10:45:00-04:00,521.9,522.07,521.65,521.99,521.4709983612722,NaN,NaN,NaN,NaN,NaN,522.235000000001,524.2981306298379,520.1718693701641,521.6814366981621,522.5921574917461,523.4282053976381,521.7561095858541,18831,26776.966666666667,46.39315013617349,53.92171745982092,NaN,NaN,NaN,NaN,0.8571847707098745,16.159600405023113,12875637,-0.10569013800057694,0.13907419243787444,0.2447643304384514
2025-08-15T10:50:00-04:00,522.02,522.06,521.6,521.675,521.4709983612722,NaN,NaN,NaN,NaN,NaN,522.1885000000011,524.1944234770021,520.1825765230001,521.6814366981621,522.5646422146419,523.3994950919671,521.7297893373168,13450,26685.233333333334,44.2697144166069,52.957817125525615,NaN,NaN,NaN,NaN,0.828814429944878,17.37872794876352,12862187,-0.15240485670256707,0.05425825956024255,0.20666311626280962
2025-08-15T10:55:00-04:00,521.7,521.78,521.33,521.68,NaN,NaN,NaN,523.9233198197416,523.9233198197416,523.9233198197416,522.1413000000011,524.0806966163336,520.2019033836687,521.6814366981621,522.5158670349134,523.3565176755376,521.6752163942892,21109,26559.033333333333,44.31328375839517,52.63674383836425,NaN,NaN,NaN,NaN,0.8017562563773818,18.793080845082592,12883296,-0.17526044280839964,-0.012412437247689923,0.16284800556070972
2025-08-15T11:00:00-04:00,521.79,522.24,521.75,522.1,NaN,NaN,NaN,523.9233198197416,NaN,NaN,522.1037000000011,523.9705891867213,520.236810813281,521.6814366981621,522.5058540645304,523.340656046374,521.6710520826867,8815,25994.866666666665,47.99142699483576,52.27355272311275,NaN,NaN,NaN,NaN,0.7844879523504301,19.146532091344152,12892111,-0.1550796747554203,-0.031001587883565662,0.12407808687185465
2025-08-15T11:05:00-04:00,522.105,522.51,522.05,522.485,NaN,NaN,NaN,523.9233198197416,NaN,NaN,522.0722000000011,523.8573522724627,520.2870477275395,521.4841194868237,522.5021195787798,523.3273145617612,521.6769245957984,10387,25739.966666666667,51.17500405860618,52.202672368424594,NaN,NaN,NaN,NaN,0.7613102414682592,18.95934366715986,12902498,-0.11086262316234194,-0.014500192081072782,0.09636243108126916
2025-08-15T11:10:00-04:00,522.44,522.86,522.43,522.65,NaN,NaN,NaN,523.9233198197416,NaN,NaN,522.0454000000011,523.7531374960763,520.3376625039259,521.4841194868237,522.5046135588075,523.3228752217714,521.6863518958436,7692,25628.833333333332,52.51650506922636,51.83703035709475,NaN,NaN,NaN,NaN,0.7376452242205309,18.158987800885466,12910190,-0.06768523331283641,0.011755889440223655,0.07944112275306006
2025-08-15T11:15:00-04:00,522.71,523.47,522.59,523.14,NaN,NaN,NaN,523.9233198197416,NaN,NaN,522.0412000000011,523.7370744751554,520.3453255248469,521.9048282690576,522.5219632904073,523.3333414645912,521.7105851162233,14200,25379.366666666665,56.35190699150233,51.500752763543915,NaN,NaN,NaN,NaN,0.7478134224904928,17.260856323303912,12924390,-0.006527904346836366,0.0712812423195146,0.07780914666635097
2025-08-15T11:20:00-04:00,523.16,523.3,522.66,522.78,NaN,NaN,NaN,523.9233198197416,NaN,NaN,522.0368000000012,523.7238195716405,520.3497804283619,521.9048282690576,522.5314940006815,523.3351990872727,521.7277889140903,11482,25202.633333333335,52.96686853825292,50.76459468660291,NaN,NaN,NaN,NaN,0.7401124637411709,16.426877094121036,12912908,0.008462798055293333,0.08838764423546763,0.0799248461801743
2025-08-15T11:25:00-04:00,522.77,523.01,522.69,522.92,NaN,NaN,NaN,523.9233198197416,NaN,NaN,522.0412000000011,523.7362440216883,520.346155978314,521.9048282690576,522.5401662735743,523.335429750418,521.7449027967306,12273,25122.433333333334,54.12106188044429,50.620820853368166,NaN,NaN,NaN,NaN,0.710104430616797,15.652467809879795,12925181,0.025620859412858507,0.11195092044624744,0.08633006103338893
2025-08-15T11:30:00-04:00,522.96,523.19,522.8,522.94,NaN,NaN,NaN,523.9233198197416,NaN,NaN,522.0503000000011,523.7596020901319,520.3409979098703,521.9048282690576,522.5537277088678,523.3401948331175,521.767260584618,15512,24540.933333333334,54.29362108449946,50.39268799541459,NaN,NaN,NaN,NaN,0.6872398284298901,15.227638111129375,12940693,0.03552141066688062,0.1307318243669897,0.09521041370010909
2025-08-15T11:35:00-04:00,523,523,522.26,522.29,NaN,NaN,NaN,523.9233198197416,NaN,NaN,522.0461000000012,523.7519901357406,520.3402098642617,521.9048282690576,522.5529388900977,523.3310096792451,521.7748681009504,10858,23894.6,47.977757248390326,49.97421338734997,NaN,NaN,NaN,NaN,0.69100841211347,14.414922778012173,12929835,-0.002484703305259836,0.09210453456853429,0.09458923787379413
2025-08-15T11:40:00-04:00,522.39,522.41,521.99,522.2,NaN,NaN,NaN,523.9233198197416,NaN,NaN,522.0509000000011,523.7571446353263,520.3446553646759,521.9048282690576,522.5451183692064,523.3162724792875,521.7739642591254,11560,23870.9,47.15972754354864,49.65857835608903,NaN,NaN,NaN,NaN,0.6716506683910763,14.088670727450872,12918275,-0.032781888758986785,0.05361187692506064,0.08639376568404743
2025-08-15T11:45:00-04:00,522.22,523.2,522.22,523.2,NaN,NaN,NaN,523.9233198197416,NaN,NaN,522.0795000000012,523.8136629091429,520.3453370908595,521.9048282690576,522.5489596132195,523.3164000827505,521.7815191436885,6178,23404.333333333332,56.11343491257215,50.07377054663908,NaN,NaN,NaN,NaN,0.6951041920774281,13.667840686387525,12924453,0.012976931477922102,0.10261493003145006,0.08963799855352796
2025-08-15T11:50:00-04:00,523.24,524.88,523.24,524.69,521.7800346377315,521.7800346377315,521.7800346377315,NaN,NaN,NaN,522.1391000000012,524.0172285245787,520.2609714754237,522.7717328174111,522.6186032156605,523.4433098597802,521.7938965715408,22262,22176.5,65.49526386146815,51.50990903532302,NaN,NaN,NaN,NaN,0.7654538926433225,15.069602981496304,12946715,0.13524850788113527,0.25869863340494703,0.12345012552381177
2025-08-15T11:55:00-04:00,524.7,524.87,523.89,523.89,522.0700330632893,NaN,NaN,NaN,NaN,NaN,522.1945000000011,524.1121175311004,520.2768824689018,522.7717328174111,522.670977413139,523.5305148775715,521.8114399487065,18641,18959.4,58.29016998802979,52.35969616759848,NaN,NaN,NaN,NaN,0.7807786145973722,16.37123939838303,12928074,0.15261641062200376,0.31422063880131645,0.1616042281793127
2025-08-15T12:00:00-04:00,523.88,524.11,523.49,524.05,522.0700330632893,NaN,NaN,NaN,NaN,NaN,522.2487000000012,524.2191119454923,520.2782880545102,522.7717328174111,522.6862383318318,523.550977299314,521.8214993643495,7251,17104.4,59.25558166757782,53.430115256953535,NaN,NaN,NaN,NaN,0.7692944278404173,16.911662275160523,12935325,0.1642393824663157,0.36690345626220733,0.20266407379589163
2025-08-15T12:05:00-04:00,524,524.83,524,524.49,522.1163731010548,NaN,NaN,NaN,NaN,NaN,522.3205000000012,524.349848909189,520.2911510908134,522.7739672025145,522.7217410172893,523.6126049588191,521.8308770757595,11902,16140.166666666666,61.86934224225877,54.68411943437236,NaN,NaN,NaN,NaN,0.7736305401375334,18.06414801487065,12947227,0.18914685862652827,0.43909764707905197,0.2499507884525237
2025-08-15T12:10:00-04:00,524.5,524.62,524.15,524.3,522.1267652328252,NaN,NaN,NaN,NaN,NaN,522.3729000000011,524.4676382547045,520.2781617452977,522.7739672025145,522.7453785956149,523.6510557841258,521.8397014071039,8625,15389.7,60.07711787279394,55.54738306851224,NaN,NaN,NaN,NaN,0.7519426444134257,19.134313344601477,12938602,0.18043888151390713,0.4754993903449076,0.2950605088310005
2025-08-15T12:15:00-04:00,524.29,524.29,523.71,523.96,522.1267652328252,NaN,NaN,NaN,NaN,NaN,522.4319000000011,524.5359236585483,520.3278763414538,522.7739672025145,522.7700290891107,523.6832391861509,521.8568189920705,12087,14888.133333333333,56.90065249928314,55.95635795713202,NaN,NaN,NaN,NaN,0.7403753126696037,19.384512568072765,12926515,0.1411339697962371,0.47147797107629685,0.33034400128005975
2025-08-15T12:20:00-04:00,523.95,524.01,523.71,523.85,522.1267652328252,NaN,NaN,NaN,NaN,NaN,522.4888000000011,524.5892671469899,520.3883328530123,522.7739672025145,522.7768417860298,523.6912162810885,521.862467290971,3840,14500.6,55.87139741503256,56.19599312468961,NaN,NaN,NaN,NaN,0.7089199331932001,19.61684041843896,12922675,0.09906831046220721,0.45417938935781876,0.35511107889561155
2025-08-15T12:25:00-04:00,523.89,524.41,523.84,523.89,522.1267652328252,NaN,NaN,NaN,NaN,NaN,522.5468000000011,524.6386563611491,520.4549436388531,522.8537289661499,522.7929753447813,523.7125864195388,521.8733642700239,7882,14390.866666666667,56.18179075121539,56.183841964669114,NaN,NaN,NaN,NaN,0.6989970808222526,20.25366686806298,12930557,0.06682427223309395,0.43864141918697896,0.371817146953885
2025-08-15T12:30:00-04:00,523.91,524.75,523.86,524.75,522.1273903517737,NaN,NaN,NaN,NaN,NaN,522.6314000000011,524.730668481061,520.5321315189412,523.0599831729199,522.8533317411523,523.8080636472005,521.898599835104,23402,14180.5,62.318597119835026,56.85182257763926,NaN,NaN,NaN,NaN,0.712640146477805,21.177875239917153,12953959,0.0946046998975949,0.49007302182587864,0.39546832192828374
2025-08-15T12:35:00-04:00,524.78,524.79,524.19,524.31,522.329554426693,NaN,NaN,NaN,NaN,NaN,522.698800000001,524.7929122787169,520.6046877212851,523.137986538336,522.8697109096341,523.8328308533963,521.9065909658719,6758,13742.6,57.85421166739679,57.11847613385016,NaN,NaN,NaN,NaN,0.7045944217293839,22.07516921387684,12947201,0.0753724177833025,0.48968384415741184,0.41431142637410934
2025-08-15T12:40:00-04:00,524.35,524.47,524.11,524.41,522.329554426693,NaN,NaN,NaN,NaN,NaN,522.768500000001,524.8537867898103,520.6832132101918,523.137986538336,522.8845139819829,523.8538408109713,521.9151871529945,6662,12809.433333333332,58.580453666307996,57.4246784611222,NaN,NaN,NaN,NaN,0.6799805344630003,22.742703846917973,12953863,0.06197141745075474,0.49177569818755273,0.429804280736798
2025-08-15T12:45:00-04:00,524.42,524.73,524.36,524.67,522.4791807896108,NaN,NaN,NaN,NaN,NaN,522.8381000000011,524.9402340479414,520.7359659520607,523.343711384535,522.904365509881,523.8851981325927,521.9235328871694,7755,12268.466666666667,60.48690724296388,58.318189175020315,NaN,NaN,NaN,NaN,0.6578390677156435,23.642871148151297,12961618,0.06299743496464749,0.5085510744426074,0.4455536394779599
2025-08-15T12:50:00-04:00,524.71,524.98,524.71,524.88,522.8308089355376,NaN,NaN,NaN,NaN,NaN,522.9127000000011,525.0345578735469,520.7908421264553,523.715969107628,522.9250083351686,523.9208674536236,521.9291492167137,7106,12058.9,62.00795953847953,59.37877717465823,NaN,NaN,NaN,NaN,0.6329934200216732,24.737087731528923,12968724,0.06967777514514983,0.5326508584093972,0.46297308326424735
2025-08-15T12:55:00-04:00,524.9,525.13,524.765,524.91,522.9750903475585,NaN,NaN,NaN,NaN,NaN,522.971100000001,525.1481772048786,520.7940227951234,523.9362752861024,522.9586362676491,523.9792264381817,521.9380460971165,11435,11758.933333333332,62.231634799116875,59.81579145226857,NaN,NaN,NaN,NaN,0.6138510328772686,25.905241816693742,12980159,0.06790595152872181,0.5478555226751496,0.4799495711464278
2025-08-15T13:00:00-04:00,524.94,525.09,524.71,525.03,522.9750903475585,NaN,NaN,NaN,NaN,NaN,523.038900000001,525.256704580145,520.8210954198571,523.945020228882,522.9770081643047,524.0104913625559,521.9435249660536,6386,11693.733333333334,63.165794890736855,59.649400811502055,NaN,NaN,NaN,NaN,0.5971473876717491,26.85301617294134,12986545,0.06651817565563622,0.563097290715973,0.4965791150603368
2025-08-15T13:05:00-04:00,525.03,525.03,524.61,524.69,522.9750903475585,NaN,NaN,NaN,NaN,NaN,523.103900000001,525.320954161716,520.8868458382859,523.945020228882,522.9938933602525,524.0370466212056,521.9507400992994,6534,11413.033333333333,58.733189568121354,59.68104506722288,NaN,NaN,NaN,NaN,0.5844940028380499,27.475455931743276,12980011,0.03593612923873912,0.5414992766087607,0.5055631473700216
2025-08-15T13:10:00-04:00,524.78,525.25,524.56,525.07,522.9935400271168,NaN,NaN,NaN,NaN,NaN,523.176700000001,525.408116239957,520.945283760045,524.0042129464845,523.0157920021887,524.0734422924236,521.9581417119539,7844,11290.633333333333,61.94723956180536,59.873306345382,NaN,NaN,NaN,NaN,0.5920301454924788,28.31968192764095,12987855,0.034525653280710555,0.5487202139709098,0.5141945606901992
2025-08-15T13:15:00-04:00,525.08,525.16,524.7,524.71,523.0426972986115,NaN,NaN,NaN,NaN,NaN,523.232700000001,525.4746618274321,520.99073817257,524.0042129464845,523.0308856225581,524.0971923361798,521.9645789089365,5822,10857,57.38718310130016,59.553152121027814,NaN,NaN,NaN,NaN,0.5825994208144392,29.10360606668879,12982033,0.004169529846661191,0.5194064729985257,0.5152369431518645
2025-08-15T13:20:00-04:00,524.7,524.82,524.6,524.78,523.0426972986115,NaN,NaN,NaN,NaN,NaN,523.287100000001,525.5445473096748,521.0296526903272,524.0042129464845,523.0371036955551,524.1064046057166,521.9678027853935,2603,10495.433333333332,58.034065570570355,59.40721981372612,NaN,NaN,NaN,NaN,0.5566994621848383,29.537086178887133,12984636,-0.015305754263763016,0.4961047503221607,0.5114105045859237
2025-08-15T13:25:00-04:00,524.75,525.05,524.62,524.85,523.0426972986115,NaN,NaN,NaN,NaN,NaN,523.3559000000009,525.589880025965,521.1219199740368,524.0042129464845,523.0544958482603,524.13311905438,521.9758726421406,6942,10023.2,58.70909731780965,59.536394443620885,NaN,NaN,NaN,NaN,0.5476495006002035,30.255851093002455,12991578,-0.02690532759862585,0.47777884508764146,0.5046841726862673
2025-08-15T13:30:00-04:00,524.87,525.16,524.74,525.14,523.1679573330617,NaN,NaN,NaN,NaN,NaN,523.4121000000009,525.6811254199572,521.1430745800446,524.0795656228801,523.0850644163136,524.1824324521878,521.9876963804394,11408,10109.633333333333,61.47391691391575,59.93657440782682,NaN,NaN,NaN,NaN,0.5385316791287574,31.06987793455852,13002986,-0.01885928047163299,0.48111007209672607,0.49996935256835906
2025-08-15T13:35:00-04:00,525.15,525.21,525.01,525.1,523.3816865451953,NaN,NaN,NaN,NaN,NaN,523.465300000001,525.7651864398293,521.1654135601726,524.245652498304,523.1003350484441,524.2074747118696,521.9931953850186,5564,9948.866666666667,60.868503936708066,60.271339635362004,NaN,NaN,NaN,NaN,0.5143508449052779,31.893950527106075,12997422,-0.019938371068782934,0.47504638873238036,0.4949847598011633
2025-08-15T13:40:00-04:00,525.12,525.3,524.97,525.23,523.4402462476864,NaN,NaN,NaN,NaN,NaN,523.5527000000011,525.7809389538866,521.3244610461156,524.3635219986433,523.1319174588662,524.2594305077262,522.0044044100061,11433,10073.566666666668,62.172384613352676,60.26089588489898,NaN,NaN,NaN,NaN,0.5011829274120386,32.7851856733861,13008855,-0.015785907066157567,0.47525237596846637,0.49103828303462393
2025-08-15T13:45:00-04:00,525.26,525.38,525.13,525.33,523.6031896000643,NaN,NaN,NaN,NaN,NaN,523.6185000000011,525.8584493288582,521.3785506711439,524.5058175989146,523.1470784152353,524.2849053777484,522.0092514527223,5317,9777.466666666667,63.188484551602244,60.64191537662794,NaN,NaN,NaN,NaN,0.4832412897397501,33.72634910786249,13014172,-0.010450635656238993,0.4779749884643252,0.4884256241205642
2025-08-15T13:50:00-04:00,525.33,525.42,525.17,525.42,523.6841809818795,NaN,NaN,NaN,NaN,NaN,523.6677000000011,525.9551948820999,521.3802051179023,524.5956540791317,523.1670568884763,524.3186570373845,522.0154567395681,6937,9625.966666666667,64.12254772223872,61.03777923776581,NaN,NaN,NaN,NaN,0.4665811976154823,34.658800207873206,13021109,-0.005268044747252287,0.4818405681864988,0.4871086129337511
2025-08-15T13:55:00-04:00,525.44,525.91,525.4,525.85,524.0478545736123,NaN,NaN,NaN,NaN,NaN,523.750100000001,526.0492507031651,521.4509492968369,524.9955232633054,523.2455718312445,524.4619912330934,522.0291524293957,24124,10021,68.26571019873343,61.59340802032078,NaN,NaN,NaN,NaN,0.4696825406429472,36.15817752704181,13045233,0.02125718164006818,0.5136800899838363,0.4924229083437681
2025-08-15T14:00:00-04:00,525.83,526.1,525.46,525.89,524.1586339111753,NaN,NaN,NaN,NaN,NaN,523.8199000000011,526.1623598087195,521.4774401912827,525.0484186106443,523.3351731215025,524.6198735752567,522.0504726677483,28323,10448.033333333333,68.62863777279318,62.066313608486034,NaN,NaN,NaN,NaN,0.48184807345416425,37.75657353767577,13073556,0.03483172396581824,0.535962563301041,0.5011308393352227
2025-08-15T14:05:00-04:00,525.78,525.78,524.77,524.77,524.1586339111753,NaN,NaN,NaN,NaN,NaN,523.869900000001,526.1844535110793,521.5553464889229,525.0484186106443,523.3606207687491,524.6533616915478,522.0678798459503,11845,10480.933333333332,51.03059017427319,61.26623899242578,NaN,NaN,NaN,NaN,0.5274303539217243,36.94375266594631,13061711,-0.03453045009444311,0.4579677767171688,0.4924982268116119
2025-08-15T14:10:00-04:00,524.77,524.87,524.45,524.52,524.1586339111753,NaN,NaN,NaN,NaN,NaN,523.896700000001,526.2097106864492,521.5836893135529,525.0484186106443,523.380302746347,524.6722744429096,522.0883310497843,13162,10534.333333333334,48.06767707707119,60.18780200573537,NaN,NaN,NaN,NaN,0.5197567572130268,35.358592094554766,13048549,-0.09663960205265837,0.371698724245789,0.46833832629844735
2025-08-15T14:15:00-04:00,524.55,524.58,524.06,524.06,NaN,NaN,NaN,525.9949052731597,525.9949052731597,525.9949052731597,523.901300000001,526.214676587576,521.587923412426,525.0484186106443,523.4073624711426,524.687437294925,522.1272876473603,27445,11243.233333333334,43.10804810905221,59.07172047294472,NaN,NaN,NaN,NaN,0.5197741316978174,33.003635148631325,13021104,-0.16412828409596353,0.26317797117849295,0.4273062552744565
2025-08-15T14:20:00-04:00,524.04,524.19,523.77,523.98,NaN,NaN,NaN,525.6360459425616,NaN,NaN,523.895300000001,526.2062715783145,521.5843284216876,525.0484186106443,523.4174288211339,524.6884323305914,522.1464253116764,15481,11017.2,42.2907910131275,57.66768843375344,NaN,NaN,NaN,NaN,0.5126474080051213,31.056404009927235,13005623,-0.2068260893353433,0.16877364360527736,0.37559973294062066
2025-08-15T14:25:00-04:00,523.94,524.04,523.9,523.99,NaN,NaN,NaN,525.5698620360815,NaN,NaN,523.908200000001,526.2139352484841,521.6024647515179,525.0484186106443,523.4216088181715,524.6887692092096,522.1544484271335,6632,10616.9,42.43769487567104,56.599867846208504,NaN,NaN,NaN,NaN,0.4860297360047546,29.248260809702014,13012255,-0.22553217552996846,0.0936845135281601,0.31921668905812856
2025-08-15T14:30:00-04:00,524,524.02,523.81,523.83,NaN,NaN,NaN,525.4707773980778,NaN,NaN,523.913000000001,526.2170642343132,521.6089357656889,525.0484186106443,523.4277251827909,524.6876397301343,522.1678106354476,11825,10769.366666666667,40.65448986728631,55.35846958168821,NaN,NaN,NaN,NaN,0.46631332629013184,27.756374955217083,13000430,-0.23855508247602714,0.02102283596309462,0.25957791843912176
2025-08-15T14:35:00-04:00,523.79,523.8,523.33,523.38,NaN,NaN,NaN,525.1182420618017,NaN,NaN,523.9188000000009,526.215997909642,521.6216020903598,525.0484186106443,523.42874457155,524.680167261362,522.1773218817381,12288,10782.233333333334,36.06454788564021,53.741001765104684,NaN,NaN,NaN,NaN,0.46871951726940814,27.272026791792666,12988142,-0.26529660768843644,-0.07204284117142379,0.19325376651701265
2025-08-15T14:40:00-04:00,523.4,523.47,522.9,522.9,NaN,NaN,NaN,524.7453674226286,NaN,NaN,523.921400000001,526.2136801216633,521.6291198783387,525.0484186106443,523.4228996640082,524.6642629362626,522.1815363917539,16002,11028.133333333333,31.924239862044004,51.63031054711384,NaN,NaN,NaN,NaN,0.47595383746445397,27.48397194024618,12972140,-0.3005447273982744,-0.18242714273083038,0.11811758466744404
2025-08-15T14:45:00-04:00,522.93,523.55,522.89,523.5,NaN,NaN,NaN,524.7453674226286,NaN,NaN,523.9396000000011,526.2035830731686,521.6756169268335,525.0484186106443,523.4215749528985,524.6554691618799,522.1876807439171,11350,11003.566666666668,41.036572724588275,50.21374403196243,NaN,NaN,NaN,NaN,0.48909999193127646,27.4672952328251,12983490,-0.26966877190810623,-0.21896838021768872,0.050700391690417485
2025-08-15T14:50:00-04:00,523.51,523.71,522.94,523.05,NaN,NaN,NaN,524.7453674226286,NaN,NaN,523.963400000001,526.1635558481049,521.7632441518971,524.3787348885154,523.4181079946909,524.640848698128,522.1953672912538,17614,11462.7,37.032798701758665,48.41805932399142,NaN,NaN,NaN,NaN,0.5091642782218982,27.023711754213014,12965876,-0.265360013054696,-0.28099962462795247,-0.01563961157325651
2025-08-15T14:55:00-04:00,523.08,523.5,522.75,523.16,NaN,NaN,NaN,524.7453674226286,NaN,NaN,523.986800000001,526.1265633130525,521.8470366869495,523.5389879108124,523.4137582301211,524.6275098308954,522.2000066293467,15013,11700.4,38.6095533606122,46.662421381777854,NaN,NaN,NaN,NaN,0.526366829777477,26.93134320013678,12980889,-0.24158622973567934,-0.3176223987428557,-0.07603616900717636
2025-08-15T15:00:00-04:00,523.11,523.14,522.59,522.66,NaN,NaN,NaN,524.5097275490074,NaN,NaN,524.006500000001,526.0778070742663,521.9351929257357,523.2551903286499,523.4011469101403,524.6056007400333,522.1966930802472,20266,11595.866666666667,34.39365557720289,44.53892908570386,NaN,NaN,NaN,NaN,0.5294834847933669,27.105495232430847,12960623,-0.24523655823091284,-0.3825818667958174,-0.13734530856490457
2025-08-15T15:05:00-04:00,522.64,522.82,522.42,522.8,NaN,NaN,NaN,524.2445126604161,NaN,NaN,524.028900000001,526.0218247743001,522.035975225702,523.0462974482687,523.3891577351319,524.5871114030429,522.191204067221,16765,11929.433333333332,36.48494755121317,42.268874610880985,NaN,NaN,NaN,NaN,0.5202346644509901,27.53503246065448,12977388,-0.22448218390074892,-0.4179480384408407,-0.1934658545400918
2025-08-15T15:10:00-04:00,522.84,523.4,522.82,523.38,NaN,NaN,NaN,524.2445126604161,NaN,NaN,524.0545000000011,525.9793794755734,522.1296205244288,523.0462974482687,523.3877082441528,524.5811771972369,522.1942392910687,7787,11966.933333333332,44.39321357263664,40.53777288229838,NaN,NaN,NaN,NaN,0.5259321884187782,26.38194748949078,12985175,-0.16092798084968224,-0.3946258306021946,-0.23369784975251234
2025-08-15T15:15:00-04:00,523.37,523.39,522.8,523.16,NaN,NaN,NaN,524.2445126604161,NaN,NaN,524.068000000001,525.9578084548734,522.1781915451286,523.0462974482687,523.3837873855,524.5690345016541,522.1985402693459,14916,12205.633333333333,42.24461475029857,39.91020320915733,NaN,NaN,NaN,NaN,0.530508460674582,25.349356111164344,12970259,-0.12456663430247433,-0.38940614263060525,-0.2648395083281309
2025-08-15T15:20:00-04:00,523.17,523.32,523.1,523.13,NaN,NaN,NaN,524.2445126604161,NaN,NaN,524.077600000001,525.9432197244108,522.2119802755911,522.7710379586149,523.3821377435745,524.5626366870247,522.2016388001243,8556,12253.966666666667,41.94647664039962,39.47297460653793,NaN,NaN,NaN,NaN,0.5083292849121138,24.390521259861227,12961703,-0.09474609658672584,-0.3832721290615382,-0.28852603247481234
2025-08-15T15:25:00-04:00,523.11,523.24,522.99,523.13,NaN,NaN,NaN,524.2445126604161,NaN,NaN,524.077400000001,525.9434238358479,522.2113761641542,522.3618303668919,523.3782089929794,524.5502611053523,522.2061568806064,15819,12400.1,41.94647664039961,39.390005215919885,NaN,NaN,NaN,NaN,0.48987719313267714,23.73298486310102,12961703,-0.06845797755940514,-0.3740985044240688,-0.30564052686466364
2025-08-15T15:30:00-04:00,523.14,523.36,523.03,523.09,NaN,NaN,NaN,524.2445126604161,NaN,NaN,524.0836000000011,525.9343371925588,522.2328628074433,522.3517714348109,523.3751533984753,524.5392528273672,522.2110539695833,14990,12686.9,41.49364596347259,39.33306628380168,NaN,NaN,NaN,NaN,0.4784573936232031,22.779616540676678,12946713,-0.04815865374437228,-0.365838844045129,-0.3176801903007567
2025-08-15T15:35:00-04:00,523.08,523.17,522.78,522.8,NaN,NaN,NaN,524.2445126604161,NaN,NaN,524.081200000001,525.9382671059886,522.2241328940133,522.3517714348109,523.3701595877051,524.5288796439436,522.2114395314666,11788,12862.033333333333,38.26812254838798,39.03523968899575,NaN,NaN,NaN,NaN,0.4721390083644019,22.441554619748075,12934925,-0.04852176748470849,-0.37833239965664234,-0.32981063217193385
2025-08-15T15:40:00-04:00,522.81,523.38,522.81,523.24,NaN,NaN,NaN,524.2445126604161,NaN,NaN,524.0872000000011,525.931373700058,522.2430262999442,522.3039168198445,523.3662047034591,524.5151624093036,522.2172469976146,19205,13240.733333333334,45.225369516852744,39.3617310925362,NaN,NaN,NaN,NaN,0.4798433649098047,21.522377064004523,12954130,-0.015119176254524358,-0.3487096024900893,-0.33359042623556495
2025-08-15T15:45:00-04:00,523.26,523.4,523.06,523.14,NaN,NaN,NaN,524.2445126604161,NaN,NaN,524.1042000000011,525.8967404975955,522.3116595024068,522.3324854117603,523.3635872434053,524.5036497219617,522.2235247648489,17624,13634.133333333333,44.01135281988899,39.92936001641112,NaN,NaN,NaN,NaN,0.46985455313053526,20.61165405762732,12936506,0.0032690068727829757,-0.32950416764458623,-0.3327731745173692
2025-08-15T15:50:00-04:00,523.17,523.22,520.17,520.26,NaN,NaN,NaN,523.5438294452025,NaN,NaN,524.0654000000011,526.0900805564479,522.0407194435543,522.3324854117603,523.0758003521805,524.3644240412714,521.7871766630897,173232,19321.766666666666,24.01621831849043,39.36450133472873,NaN,NaN,NaN,NaN,0.654150656478359,23.23343833643072,12763274,-0.16613804520700465,-0.540445731026125,-0.3743076858191204
2025-08-15T15:55:00-04:00,520.19,520.53,519.08,520.08,NaN,NaN,NaN,521.7675190158752,NaN,NaN,524.0030000000011,526.3039815287784,521.7020184712237,522.3324854117603,522.4890253242429,524.184664797063,520.7933858514228,292516,28840.9,23.30361536829419,38.09786152356486,NaN,NaN,NaN,NaN,0.7109970381584713,26.20979615130429,12470758,-0.2716845603953162,-0.7139133863132656,-0.44222882591794943
2025-08-18T09:30:00-04:00,521.575,522.48,519.95,522.32,518.9966863939374,518.9966863939374,518.9966863939374,NaN,NaN,NaN,523.955600000001,526.2953372835833,521.6158627164187,522.3324854117603,521.5833333333334,521.5833333333334,521.5833333333334,40145,29798.8,45.12483529975045,38.67586413770714,NaN,NaN,NaN,NaN,0.8409258211471499,25.969191355572224,12510903,-0.17661363500282173,-0.6629958696714766,-0.4863822346686549
2025-08-18T09:35:00-04:00,522.33,522.82,521.17,521.52,519.6525188305766,NaN,NaN,NaN,NaN,NaN,523.908200000001,526.3453317232221,521.4710682767799,522.3324854117603,521.6907902424565,521.8159917983734,521.5655886865396,29572,30599.066666666666,40.67394321938482,38.823320556190886,NaN,NaN,NaN,NaN,0.8987168339223599,25.344738102646552,12481331,-0.15438651927253078,-0.6793653837593183,-0.5249788644867875
2025-08-18T09:40:00-04:00,521.56,521.97,520.06,520.89,519.6525188305766,NaN,NaN,NaN,NaN,NaN,523.845000000001,526.4239121730167,521.2660878269854,522.3324854117603,521.5173072252251,521.8432754759175,521.1913389745326,22234,30959.1,37.53420191596582,39.047645294673956,NaN,NaN,NaN,NaN,0.9709513457850544,25.583426067709418,12459097,-0.16778079339893237,-0.734704856235453,-0.5669240628365206
2025-08-18T09:45:00-04:00,520.9,521,520.4,520.56,519.6525188305766,NaN,NaN,NaN,NaN,NaN,523.7664000000011,526.4969845813264,521.0358154186758,522.3324854117603,521.390564222014,521.8196408430136,520.9614876010143,15808,31308.8,35.96798548336622,39.01071943268489,NaN,NaN,NaN,NaN,0.9444548210861236,25.805064892410652,12443289,-0.18327200909178565,-0.7960140742012527,-0.612742065109467
2025-08-18T09:50:00-04:00,520.53,520.71,518.34,518.91,NaN,NaN,NaN,522.2009474182975,522.2009474182975,522.2009474182975,523.6586000000011,526.7038586353149,520.6133413646874,522.3324854117603,520.8162676117731,521.8124321963946,519.8201030271516,41360,32456.233333333334,29.369108383555513,37.93756906203623,NaN,NaN,NaN,NaN,1.0462794767228294,27.180281197139088,12401929,-0.2830870742677959,-0.9666009079442119,-0.683513833676416
2025-08-18T09:55:00-04:00,519.1,519.41,518.42,519.16,NaN,NaN,NaN,521.6043134447384,NaN,NaN,523.562600000001,526.8563001922231,520.2688998077789,522.3324854117603,520.5482192843515,521.671629805298,519.4248087634049,25762,32510.833333333332,31.422061811439207,37.16452956640342,NaN,NaN,NaN,NaN,1.0422595140997708,28.45726776581549,12427691,-0.3086234500639182,-1.0692931462563138,-0.7606696961923956
2025-08-18T10:00:00-04:00,519.23,520.2,518.92,520.09,NaN,NaN,NaN,521.6043134447384,NaN,NaN,523.4874000000011,526.9201756926185,520.0546243073837,522.3324854117603,520.4787627473434,521.5767528529319,519.3807726417548,16368,32112.333333333332,38.57459763905638,36.92368106630747,NaN,NaN,NaN,NaN,1.0592409773783646,28.683106350575304,12444059,-0.24216529669110876,-1.0633763170562816,-0.8212110203651728
2025-08-18T10:05:00-04:00,520.14,520.215,519.71,519.85,NaN,NaN,NaN,521.6043134447384,NaN,NaN,523.406600000001,526.9847729634266,519.8284270365755,520.8409883294082,520.4535497557877,521.5324464392116,519.3746530723637,9123,32021.6,37.48797055699968,36.605216346064616,NaN,NaN,NaN,NaN,1.0196523361370526,28.875037150578457,12434936,-0.19564532385262212,-1.0657676751809504,-0.8701223513283283
2025-08-18T10:10:00-04:00,519.85,520,518.76,518.83,NaN,NaN,NaN,521.6043134447384,NaN,NaN,523.2882000000011,527.0668890631598,519.5095109368424,519.300946024657,520.3849303900892,521.4721316342241,519.2977291459542,11571,31968.566666666666,33.20664954601068,36.013288030531626,NaN,NaN,NaN,NaN,1.0353914549844068,29.6132434899452,12423365,-0.21339273266291214,-1.1368632671569685,-0.9234705344940564
2025-08-18T10:15:00-04:00,518.83,518.83,518.28,518.28,NaN,NaN,NaN,521.2386470273811,NaN,NaN,523.1676000000011,527.1854791614261,519.1497208385762,519.300946024657,520.220030013774,521.3906082916363,519.0494517359117,19895,31716.9,31.141405972813857,35.504236846562044,NaN,NaN,NaN,NaN,1.0007206367712398,30.552823483643714,12403470,-0.24001067553146083,-1.2234838789083824,-0.9834732033769216
2025-08-18T10:20:00-04:00,518.34,518.95,518.34,518.92,NaN,NaN,NaN,521.2386470273811,NaN,NaN,523.0578000000011,527.2309298369447,518.8846701630574,519.300946024657,520.1595990563436,521.3429923604658,518.9762057522214,9846,31529.066666666666,36.12006787350936,34.8538581577518,NaN,NaN,NaN,NaN,0.9770977341447279,31.26711444763896,12413316,-0.19430308792613782,-1.226352063284594,-1.032048975358456
2025-08-18T10:25:00-04:00,518.93,519.71,517.9,517.9,NaN,NaN,NaN,521.2386470273811,NaN,NaN,522.9224000000011,527.3112468822611,518.533553117741,518.1997568197256,519.9678267881794,521.2003526679042,518.7353009084546,31648,32362.933333333334,32.13253436666842,34.0053711253789,NaN,NaN,NaN,NaN,1.0365907531343945,30.96988965886792,12381668,-0.21115379216494778,-1.2959912155646407,-1.084837423399693
2025-08-18T10:30:00-04:00,517.86,518.11,517.695,517.97,NaN,NaN,NaN,520.6120140045621,NaN,NaN,522.7842000000011,527.3494059576743,518.2189940423278,517.6838054557804,519.7997941163304,521.1071546340598,518.492433598601,24498,32785.36666666667,32.68178545750904,34.62434020673737,NaN,NaN,NaN,NaN,0.9921914136247924,30.83468375064639,12406166,-0.1962889642499117,-1.3301986287120826,-1.133909664462171
2025-08-18T10:35:00-04:00,517.92,518.25,517.92,518.1,NaN,NaN,NaN,520.6120140045621,NaN,NaN,522.648000000001,527.355517392012,517.9404826079901,517.1686667146877,519.620302292222,520.9635966413563,518.2770079430878,34933,33540.2,33.754041932472305,35.37079924703581,NaN,NaN,NaN,NaN,0.9448920269373101,30.5293596404984,12441099,-0.15804825197129357,-1.3314699794262879,-1.1734217274549943
2025-08-18T10:40:00-04:00,518.08,518.25,517.95,518,NaN,NaN,NaN,520.6120140045621,NaN,NaN,522.5074000000011,527.340209219908,517.6745907800941,517.1686667146877,519.5411423265303,520.8936290574422,518.1886555956185,17865,33602.3,33.31445963646169,34.527200985372325,NaN,NaN,NaN,NaN,0.898828310727499,30.245844395360983,12423234,-0.12147846830911169,-1.325269812841384,-1.2037913445322723
2025-08-18T10:45:00-04:00,518,518.16,517.69,518,NaN,NaN,NaN,520.425717430151,NaN,NaN,522.373600000001,527.3262425427613,517.4209574572408,517.1686667146877,519.3936849393999,520.762107884349,518.0252619944508,35813,34417.73333333333,33.31445963646169,34.00152358659211,NaN,NaN,NaN,NaN,0.8681977171041001,30.1940079983895,12423234,-0.08121439843719536,-1.3053093425787665,-1.2240949441415712
2025-08-18T10:50:00-04:00,518,518.33,517.97,518.25,NaN,NaN,NaN,520.425717430151,NaN,NaN,522.237200000001,527.2604388591918,517.2139611408103,517.1686667146877,519.3525985825709,520.7153369757369,517.9898601894048,13579,34283.23333333333,35.74083970082137,33.873426285510355,NaN,NaN,NaN,NaN,0.8318978801680939,29.890560596244725,12436813,-0.024606010618593688,-1.2548524574148132,-1.2302464467962195
2025-08-18T10:55:00-04:00,518.24,518.5,518.1,518.16,NaN,NaN,NaN,520.425717430151,NaN,NaN,522.106200000001,527.2057088230741,517.0066911769278,517.0292776068117,519.3204298973417,520.6758038298476,517.9650559648358,12059,34184.76666666667,35.24368037265451,33.821690206173805,NaN,NaN,NaN,NaN,0.801048031584657,29.349139587496747,12424754,0.017637250194039833,-1.2081998840536698,-1.2258371342477097
2025-08-18T11:00:00-04:00,518.17,518.22,517.09,517.44,NaN,NaN,NaN,520.0808625207202,NaN,NaN,521.9594000000011,527.1640831369616,516.7547168630406,517.0292776068117,519.2432966821033,520.6157054468315,517.8708879173751,19148,34147.5,31.472038993286176,33.97189953544028,NaN,NaN,NaN,NaN,0.8245446007571812,29.71140868291976,12405606,0.008416939096580922,-1.2153159603769836,-1.2237328994735646
2025-08-18T11:05:00-04:00,517.41,517.74,517.13,517.7,NaN,NaN,NaN,519.8337778606874,NaN,NaN,521.8164000000011,527.0880111537265,516.5447888462757,517.0292776068117,519.2067838644514,520.5869971473066,517.8265705815961,9353,33900.433333333334,34.210044186290986,34.17104113364398,NaN,NaN,NaN,NaN,0.8092199864173836,30.047801414383983,12414959,0.02994572871910206,-1.1863007385746869,-1.216246467293789
2025-08-18T11:10:00-04:00,517.685,517.725,516.86,516.96,NaN,NaN,NaN,519.700197048838,NaN,NaN,521.652800000001,527.0087208952929,516.2968791047091,517.0292776068117,519.0913073406932,520.511476638023,517.6711380433634,26642,34528.933333333334,30.477623310855847,33.59268582448679,NaN,NaN,NaN,NaN,0.8132042731018568,30.576111074340506,12388317,0.005732968046325171,-1.2090802572358825,-1.2148132252822077
2025-08-18T11:15:00-04:00,516.95,517,516.6,516.94,NaN,NaN,NaN,519.1528017284363,NaN,NaN,521.4896000000011,526.9122870973642,516.066912902638,517.0292776068117,519.0237293165188,520.4739987492734,517.5734598837643,14503,34515.166666666664,30.381146244479794,33.08505551644966,NaN,NaN,NaN,NaN,0.7836896821660082,31.270556672532123,12373814,0.000055214088644950365,-1.2147442076714015,-1.2147994217600464
2025-08-18T11:20:00-04:00,517,517.03,516.59,516.91,NaN,NaN,NaN,519.1158561953255,NaN,NaN,521.3232000000011,526.787022017242,515.8593779827602,517.0292776068117,518.9675595241707,520.4401136145111,517.4950054338303,12738,34654.566666666666,30.226582375533695,32.8721935757013,NaN,NaN,NaN,NaN,0.7591404191541463,31.858902697764197,12361076,0.005654178019436351,-1.207731699235751,-1.2133858772551873
2025-08-18T11:25:00-04:00,516.92,517.04,516.63,516.71,NaN,NaN,NaN,519.0919536409926,NaN,NaN,521.150800000001,526.6419417242955,515.6596582757065,517.0292776068117,518.9181416790029,520.4094944955267,517.4267888624792,11500,34510.6,29.161443426059662,32.730767679504574,NaN,NaN,NaN,NaN,0.7342018177859907,32.38509834261439,12349576,0.00716577345084124,-1.2044286604416357,-1.211594433892477
2025-08-18T11:30:00-04:00,516.7,516.79,516.2,516.37,NaN,NaN,NaN,518.7298193845838,NaN,NaN,520.969800000001,526.4826932364499,515.4569067635521,517.0292776068117,518.8333985746222,520.3661604410444,517.3006367081999,18015,34611.433333333334,27.394150028170387,32.10748783340893,NaN,NaN,NaN,NaN,0.7239016879441283,33.24498488673356,12331561,-0.0029145600196289756,-1.2152376339170132,-1.2123230738973843
2025-08-18T11:35:00-04:00,516.35,516.48,515.8,516.34,NaN,NaN,NaN,518.3659639580119,NaN,NaN,520.779600000001,526.2620067120638,515.2971932879382,517.0292776068117,518.7152416471951,520.3090058859761,517.121477408414,24680,35041.166666666664,27.237297804999287,31.757828079003996,NaN,NaN,NaN,NaN,0.7207658530909808,34.356737849121366,12306881,0.00005805644009670985,-1.2122505033472635,-1.2123085597873602
2025-08-18T11:40:00-04:00,516.39,516.64,516.25,516.44,NaN,NaN,NaN,518.3659639580119,NaN,NaN,520.590600000001,526.0064263040996,515.1747736959024,517.0292776068117,518.6540327788706,520.2686426062912,517.03942295145,15191,34907.36666666667,28.702741405657235,31.47361064672887,NaN,NaN,NaN,NaN,0.6971397207273383,35.03961158948831,12322072,0.019352343545290696,-1.1881181303557469,-1.2074704739010376
2025-08-18T11:45:00-04:00,516.43,516.76,516.38,516.5,NaN,NaN,NaN,518.3659639580119,NaN,NaN,520.425200000001,525.8254773851204,515.0249226148817,516.4784220854494,518.5974714215856,520.2262718051684,516.9686710380029,15551,34838.26666666667,29.618653501835254,31.178225758826223,NaN,NaN,NaN,NaN,0.6744868835325281,35.407787620452744,12337623,0.04526848473734413,-1.1508848679793573,-1.1961533527167014
2025-08-18T11:50:00-04:00,516.5,516.76,516.35,516.68,NaN,NaN,NaN,518.3659639580119,NaN,NaN,520.268400000001,525.639189677185,514.897610322817,516.0417376683595,518.5645399419902,520.1998166109158,516.9292632730646,9696,29387.066666666666,32.42333566180261,31.114574046350576,NaN,NaN,NaN,NaN,0.6555949632802023,35.77921113689698,12347319,0.08153145246315785,-1.0942390371377542,-1.175770489600912
2025-08-18T11:55:00-04:00,516.66,517.01,516.66,516.85,NaN,NaN,NaN,518.3659639580119,NaN,NaN,520.124200000001,525.4671341598635,514.7812658401385,515.9338901346877,518.5308490226364,520.1675694527504,516.8941285925224,11738,20027.8,35.05559644253793,31.238940961070305,NaN,NaN,NaN,NaN,0.6337667516173323,35.537141628083084,12359057,0.12155464260874083,-1.023827186339986,-1.1453818289487268
2025-08-18T12:00:00-04:00,516.98,517.16,516.89,516.89,NaN,NaN,NaN,518.3659639580119,NaN,NaN,519.982400000001,525.2846584769679,514.6801415230341,516.0688403258235,518.4983929358061,520.1330402826461,516.8637455889661,12843,19117.733333333334,35.69034843421558,31.235334442027035,NaN,NaN,NaN,NaN,0.6106405550732333,34.9682544912687,12371900,0.1532632416419557,-0.953802776896282,-1.1070660185382377
2025-08-18T12:05:00-04:00,516.91,517.02,516.67,516.89,NaN,NaN,NaN,518.3659639580119,NaN,NaN,519.840400000001,525.085727001886,514.5950729981159,516.0688403258235,518.4613213613767,520.0956331551798,516.8270095675736,14207,18605.566666666666,35.69034843421558,31.267239303567113,NaN,NaN,NaN,NaN,0.592023372568004,34.721183893164174,12371900,0.17519617440664526,-0.8880708005299311,-1.0632669749365764
2025-08-18T12:10:00-04:00,516.905,517.15,516.64,516.74,NaN,NaN,NaN,518.3659639580119,NaN,NaN,519.698600000001,524.8878843588051,514.5093156411968,516.0688403258235,518.4259577892573,520.0595318156669,516.7923837628476,14030,18332.1,34.23510824708099,31.46460139312389,NaN,NaN,NaN,NaN,0.5861645602417173,34.177725175681815,12357870,0.17988019126976984,-0.8384167358493642,-1.018296927119134
2025-08-18T12:15:00-04:00,516.73,516.79,516.61,516.76,NaN,NaN,NaN,518.3659639580119,NaN,NaN,519.5662000000009,524.7106306037676,514.4217693962341,516.0688403258235,518.3988493701826,520.0333738868509,516.7643248535143,10365,18150.666666666668,34.61790315863679,31.493734176862876,NaN,NaN,NaN,NaN,0.557152805938734,33.71598360866246,12368235,0.18394639741595376,-0.7883639303491918,-0.9723103277651456
2025-08-18T12:20:00-04:00,516.78,517.37,516.7,517.27,NaN,NaN,NaN,518.3659639580119,NaN,NaN,519.453600000001,524.5474311865253,514.3597688134766,516.2632609974573,518.3646579301858,519.9905101323611,516.7388057280104,17823,17366.1,43.62855264378969,32.43308627207243,NaN,NaN,NaN,NaN,0.56521331980025,31.951378420938916,12386058,0.21826361875089517,-0.6994808043265266,-0.9177444230774218
2025-08-18T12:25:00-04:00,517.29,517.29,517.01,517.19,NaN,NaN,NaN,518.3659639580119,NaN,NaN,519.3274000000009,524.3257450217947,514.3290549782072,516.2646087979658,518.3295041035179,519.9441366458323,516.7148715612036,20200,17180.7,42.63594494704785,33.308429036541575,NaN,NaN,NaN,NaN,0.544840939814516,30.312816460909904,12365858,0.2315927363078678,-0.6282535026925871,-0.8598462390004549
2025-08-18T12:30:00-04:00,517.25,517.83,517.25,517.55,NaN,NaN,NaN,518.3659639580119,NaN,NaN,519.2174000000009,524.1244525732805,514.3103474267214,516.6896870383728,518.3088778240308,519.9071360386565,516.7106196094051,18599,17255.066666666666,48.33260844529156,34.601716612952856,NaN,NaN,NaN,NaN,0.5516380155420496,28.567036364260467,12384457,0.2586201080437325,-0.5365711039457892,-0.7951912119895217
2025-08-18T12:35:00-04:00,517.56,517.585,516.8,516.84,NaN,NaN,NaN,518.3659639580119,NaN,NaN,519.091000000001,523.9101173462115,514.2718826537906,516.6896870383728,518.2933634338447,519.8874816536021,516.6992452140872,9027,17251.866666666665,39.9139008106861,35.36974928328332,NaN,NaN,NaN,NaN,0.5683067287176233,26.932559489757224,12375430,0.22394211280790421,-0.5152635709796414,-0.7392056837875456
2025-08-18T12:40:00-04:00,516.85,517.03,516.77,516.95,NaN,NaN,NaN,518.3659639580119,NaN,NaN,518.9768000000009,523.7222625735311,514.2313374264708,516.6896870383728,518.273118532212,519.8641259284468,516.6821111359773,10715,17223.333333333332,41.610802643025146,36.38522447005865,NaN,NaN,NaN,NaN,0.5462848195235067,25.467214570407265,12386145,0.20422634175548615,-0.48392275659318784,-0.688149098348674
2025-08-18T12:45:00-04:00,516.91,516.91,515.81,516,NaN,NaN,NaN,518.239086818941,NaN,NaN,518.840800000001,523.529615355352,514.1519846446499,516.6896870383728,518.225588219394,519.8276191935765,516.6235572452115,17442,17141.566666666666,32.95480612987798,36.79361792183571,NaN,NaN,NaN,NaN,0.5886930467004062,25.519183433057176,12368703,0.12680993946164543,-0.5296366740216172,-0.6564466134832626
2025-08-18T12:50:00-04:00,515.999,516.13,515.77,515.98,NaN,NaN,NaN,517.7927646908075,NaN,NaN,518.692800000001,523.2648630613214,514.1207369386805,516.6896870383728,518.1826945068681,519.7992501086793,516.5661389050568,14398,17293.3,32.80011074280719,37.08628716020356,NaN,NaN,NaN,NaN,0.5723578290789496,25.616962604063303,12354305,0.07634759693293725,-0.561012117317091,-0.6373597142500282
2025-08-18T12:55:00-04:00,515.97,516.03,515.84,516,NaN,NaN,NaN,517.7199117503161,NaN,NaN,518.549600000001,522.9999212644497,514.0992787355523,516.6896870383728,518.1558411332923,519.7808896462177,516.5307926203668,9286,16547.9,33.13811479226956,37.33767725237744,NaN,NaN,NaN,NaN,0.5450465555733061,25.707757548568992,12363591,0.047803551194206984,-0.5776052752572696,-0.6254088264514766
2025-08-18T13:00:00-04:00,516,516.18,515.85,516,NaN,NaN,NaN,517.7199117503161,NaN,NaN,518.407000000001,522.7157877642094,514.0982122357925,516.6896870383728,518.123716727151,519.7574702625628,516.4899631917391,11699,16121.266666666666,33.13811479226956,37.38873290455365,NaN,NaN,NaN,NaN,0.5296860873180648,25.436316501428248,12363591,0.03310848806078204,-0.584023216375499,-0.6171317044362811
2025-08-18T13:05:00-04:00,515.99,516.08,515.9,515.97,NaN,NaN,NaN,517.6838348799369,NaN,NaN,518.263800000001,522.4079773896458,514.1196226103561,516.6896870383728,518.091280259141,519.7335577295431,516.4490027887388,12025,15357.666666666666,32.85066753388659,37.231237982507125,NaN,NaN,NaN,NaN,0.5047085096524933,25.18426410051184,12351566,0.02587404756080125,-0.5847891449852796,-0.6106631925460808
2025-08-18T13:10:00-04:00,515.95,516.11,515.95,515.995,NaN,NaN,NaN,517.6686605672124,NaN,NaN,518.121900000001,522.0769074028543,514.1668925971477,516.6896870383728,518.0649130642332,519.7131642454563,516.4166618830102,10223,15102.933333333332,33.36935745775209,37.06545291275973,NaN,NaN,NaN,NaN,0.4800864732487415,24.871652309066626,12361789,0.027146021438406165,-0.5767306657480731,-0.6038766871864792
2025-08-18T13:15:00-04:00,516,516.25,515.99,516.22,NaN,NaN,NaN,517.6686605672124,NaN,NaN,517.990300000001,521.7468166892679,514.233783310734,516.6896870383728,518.0418852671612,519.6933979386436,516.3903725956789,9800,14235.833333333334,38.01036608896288,37.231168459527396,NaN,NaN,NaN,NaN,0.4643660108738307,24.20707370042907,12371589,0.04638463356832956,-0.5458958952260673,-0.5922805287943969
2025-08-18T13:20:00-04:00,516.21,516.32,516.09,516.09,NaN,NaN,NaN,517.6686605672124,NaN,NaN,517.8473000000009,521.3277834200378,514.366816579964,516.2802496306982,518.0136084297551,519.6684773934832,516.358739466027,12455,14198.366666666667,36.431445473499316,37.38804968998585,NaN,NaN,NaN,NaN,0.44762558152570125,23.401563392897515,12359134,0.053114876027217095,-0.5258869337603755,-0.5790018097875926
2025-08-18T13:25:00-04:00,516.085,516.47,516.08,516.36,NaN,NaN,NaN,517.6686605672124,NaN,NaN,517.711700000001,520.8702069949139,514.553193005088,515.8561997045584,517.9861245906598,519.6416704645318,516.3305787167877,13490,14246.066666666668,41.83551838468714,37.90359363470373,NaN,NaN,NaN,NaN,0.4435094685595788,22.249996353919663,12372624,0.0770583102533644,-0.48267892197088713,-0.5597372322242515
2025-08-18T13:30:00-04:00,516.34,517,516.29,516.29,NaN,NaN,NaN,517.6686605672124,NaN,NaN,517.632300000001,520.7295795864401,514.5350204135619,515.9906651552161,517.9447589689039,519.59454944599,516.2949684918178,24487,14424.033333333333,40.86555525295748,37.70623667821572,NaN,NaN,NaN,NaN,0.4625445065196115,21.366295953291377,12348137,0.08866184804308053,-0.44890992217040093,-0.5375717702134815
2025-08-18T13:35:00-04:00,516.3,516.38,515.86,515.93,NaN,NaN,NaN,517.6686605672124,NaN,NaN,517.549300000001,520.6018582773229,514.4967417226792,515.9906651552161,517.9209682717827,519.5738039581933,516.2681325853722,11025,14479.766666666666,36.215162295292856,37.2476093459475,NaN,NaN,NaN,NaN,0.46664847033963797,20.096822640755256,12337112,0.07321350039190355,-0.44605489472360205,-0.5192683951155056
2025-08-18T13:40:00-04:00,515.89,516,515.36,515.4,NaN,NaN,NaN,517.2631278686342,NaN,NaN,517.410900000001,520.2020085175234,514.6197914824786,515.9906651552161,517.8834004228114,519.5489882993165,516.2178125463063,14312,14068.766666666666,30.679834840715912,35.98669694562067,NaN,NaN,NaN,NaN,0.4790307224582343,19.834562402119502,12322800,0.03060351171349296,-0.48101400547363937,-0.5116175171871323
2025-08-18T13:45:00-04:00,515.4,515.65,515.24,515.4,NaN,NaN,NaN,517.012076601878,NaN,NaN,517.288500000001,519.8775308990838,514.6994691009182,515.9906651552161,517.837956350958,519.5208777464012,516.1550349555149,16783,14144.766666666666,30.679834840715912,35.32712080490852,NaN,NaN,NaN,NaN,0.4740999565683581,19.789565298839392,12322800,0.006956428893601374,-0.5029219810701306,-0.509878409963732
2025-08-18T13:50:00-04:00,515.39,515.52,515.25,515.39,NaN,NaN,NaN,516.9176640290655,NaN,NaN,517.1785000000009,519.6085948534903,514.7484051465115,515.9906651552161,517.8019799473807,519.4983146751056,516.1056452196558,13496,14170.033333333333,30.57756460160161,34.53903237337827,NaN,NaN,NaN,NaN,0.4595213882420455,19.747782274365004,12309304,-0.004219484497071546,-0.5151527655850714,-0.5109332810879998
2025-08-18T13:55:00-04:00,515.39,515.58,515.34,515.52,NaN,NaN,NaN,516.9176640290655,NaN,NaN,517.077700000001,519.3514644637298,514.8039355362721,515.9906651552161,517.7771217982854,519.4811898245083,516.0730537720625,9951,14118.4,33.67295164720184,34.59032848175854,NaN,NaN,NaN,NaN,0.44384128908190007,19.54788653299612,12319255,0.0019512393441795117,-0.5084942319077754,-0.5104454712519549
2025-08-18T14:00:00-04:00,515.5,515.56,515.29,515.55,NaN,NaN,NaN,516.8895554479708,NaN,NaN,517.010500000001,519.2621804827447,514.7588195172573,515.9906651552161,517.7591717362675,519.4686857845564,516.0496576879785,7278,13760.5,34.399864649094795,34.70459661792194,NaN,NaN,NaN,NaN,0.43142405414747736,19.46131343712004,12326533,0.01228480615081895,-0.4950894635634313,-0.5073742697142503
2025-08-18T14:05:00-04:00,515.56,515.6,515.38,515.46,NaN,NaN,NaN,516.8895554479708,NaN,NaN,516.9365000000009,519.1435018116508,514.729498188351,515.9906651552161,517.7254348325248,519.4444268611919,516.0064428038577,14075,13407,33.22349706705661,34.7106953518353,NaN,NaN,NaN,NaN,0.4163223359940881,19.261063999329846,12312458,0.016999740416976827,-0.4861245941930292,-0.503124334610006
2025-08-18T14:10:00-04:00,515.5,515.98,515.49,515.82,NaN,NaN,NaN,516.8895554479708,NaN,NaN,516.851100000001,518.8872348570679,514.814965142934,515.9906651552161,517.695527387859,519.4182229025963,515.9728318731217,14718,13391.233333333334,41.797310728814104,35.329209347302765,NaN,NaN,NaN,NaN,0.4237278834230805,18.01940398393509,12327176,0.04662506288315099,-0.4448430060060673,-0.4914680688892183
2025-08-18T14:15:00-04:00,515.84,516,515.75,515.89,NaN,NaN,NaN,516.8895554479708,NaN,NaN,516.7719000000011,518.6360833482332,514.907716651769,515.9906651552161,517.6712900802565,519.3950874383327,515.9474927221804,13065,13308.366666666667,43.321192575279944,36.07710399311658,NaN,NaN,NaN,NaN,0.4113187488928604,16.81454970876926,12340241,0.07169733526475225,-0.40184639980827797,-0.4735437350730302
2025-08-18T14:20:00-04:00,515.87,516.2,515.78,516.08,NaN,NaN,NaN,516.8895554479708,NaN,NaN,516.716900000001,518.4952462981033,514.9385537018987,515.3125321241729,517.6491217945872,519.3718233347029,515.9264202544716,13317,13429.066666666668,47.350606307808455,37.07576462526346,NaN,NaN,NaN,NaN,0.41193883825766126,16.04647445050888,12353558,0.10009622104054822,-0.34842345877234493,-0.44851967981289315
2025-08-18T14:25:00-04:00,516.1,516.21,516.03,516.09,NaN,NaN,NaN,516.8895554479708,NaN,NaN,516.673100000001,518.4024986111294,514.9437013888726,515.3978569118348,517.6348032457688,519.3558276084651,515.9137788830725,9315,13348.3,47.56190613289801,37.75801748554454,NaN,NaN,NaN,NaN,0.39537177838211857,15.358927000857772,12362873,0.11737612810303799,-0.3017995196840957,-0.4191756477871337
2025-08-18T14:30:00-04:00,516.07,516.23,516.04,516.19,NaN,NaN,NaN,516.8895554479708,NaN,NaN,516.618500000001,518.2289909178418,515.0080090821601,515.4852855294678,517.6168080331228,519.3350287112727,515.8985873549728,12312,13330.6,49.73441322726607,38.70822946795645,NaN,NaN,NaN,NaN,0.38070236564054255,14.775107762984957,12375185,0.13225709924135343,-0.2538542737354419,-0.3861113729767953
2025-08-18T14:35:00-04:00,516.205,516.35,516.15,516.17,NaN,NaN,NaN,516.8895554479708,NaN,NaN,516.583900000001,518.1566698993856,515.0111301006164,515.6542284235742,517.5877138481213,519.2995367077641,515.8758909884785,21614,13577.5,49.29453972452394,39.24101670651623,NaN,NaN,NaN,NaN,0.3677950538090785,14.565466320915421,12353571,0.13689481838076423,-0.21499285000084,-0.35188766838160424
2025-08-18T14:40:00-04:00,516.18,516.18,515.63,515.71,NaN,NaN,NaN,516.8895554479708,NaN,NaN,516.538700000001,518.0790984018895,514.9983015981124,515.6542284235742,517.5609456621303,519.2731146697508,515.8487766545097,16102,13646.566666666668,40.43617780326508,39.21034688868105,NaN,NaN,NaN,NaN,0.38080969282271254,14.194385160382122,12337469,0.10647736564937726,-0.21879096131988263,-0.3252683269692599
2025-08-18T14:45:00-04:00,515.72,515.76,515.59,515.72,NaN,NaN,NaN,516.8895554479708,NaN,NaN,516.491100000001,517.9818626089842,515.0003373910178,515.6542284235742,517.5453186529278,519.2588035083644,515.8318337974912,8855,13596.233333333334,40.685718126091025,39.529672305166635,NaN,NaN,NaN,NaN,0.3657518576210873,13.949940226671757,12346324,0.08543416199541543,-0.21847562447499058,-0.303909786470406
2025-08-18T14:50:00-04:00,515.71,515.78,515.65,515.71,NaN,NaN,NaN,516.8895554479708,NaN,NaN,516.445300000001,517.8877457134406,515.0028542865614,515.6542284235742,517.5159574832425,519.2311548012124,515.8007601652725,17268,13577.733333333334,40.502979720243744,40.23132551084719,NaN,NaN,NaN,NaN,0.3489124392195807,13.657600642270436,12329056,0.06989860054846408,-0.2165365357848259,-0.28643513633329
2025-08-18T14:55:00-04:00,515.73,515.8,515.56,515.6,NaN,NaN,NaN,516.8860347246698,NaN,NaN,516.397300000001,517.7884250253876,515.0061749746144,515.6542284235742,517.4750537614399,519.1931375888545,515.7569699340253,24192,13710.8,38.45682423656978,40.78682475340819,NaN,NaN,NaN,NaN,0.3411329792753256,13.633959481620275,12304864,0.052088442907047394,-0.22132458269948074,-0.27341302560652814
2025-08-18T15:00:00-04:00,515.6,516,515.52,515.88,NaN,NaN,NaN,516.8860347246698,NaN,NaN,516.349900000001,517.6433643235628,515.0564356764392,515.6542284235742,517.4465036788587,519.1636257910059,515.7293815667115,19102,13727.566666666668,45.942903212770915,41.88434893992028,NaN,NaN,NaN,NaN,0.3510520521842322,12.929293745698706,12323966,0.05855641912161075,-0.2002175017045147,-0.25877392082612544
2025-08-18T15:05:00-04:00,515.88,516.01,515.7,515.95,NaN,NaN,NaN,516.8860347246698,NaN,NaN,516.3057000000009,517.495621021141,515.1157789788608,515.6542284235742,517.4225944026718,519.1372478236133,515.7079409817304,17446,14008.2,47.65708584850428,42.88321566858474,NaN,NaN,NaN,NaN,0.3481197627424974,12.241452440931129,12341412,0.06636722596495814,-0.17581488836992776,-0.2421821143348859
2025-08-18T15:10:00-04:00,516,516,515.43,515.49,NaN,NaN,NaN,516.8860347246698,NaN,NaN,516.2667000000009,517.4329445868931,515.1004554131088,515.6542284235742,517.3801641284838,519.0959414050594,515.6643868519081,27752,14576.1,38.9223807702381,43.20625253438069,NaN,NaN,NaN,NaN,0.3639683511180368,12.405222051449357,12313660,0.04063561147392375,-0.19138759999248123,-0.23202321146640498
2025-08-18T15:15:00-04:00,515.48,515.51,515.22,515.3,NaN,NaN,NaN,516.575443870332,NaN,NaN,516.2187000000009,517.3417864778055,515.0956135221963,515.6542284235742,517.3297808068268,519.0534846628169,515.6060769508366,29572,14980.433333333332,35.98835944817412,43.40374270446051,NaN,NaN,NaN,NaN,0.3586848974667459,13.098679707669083,12284088,0.012367303318745693,-0.21656408231797286,-0.22893138563671855
2025-08-18T15:20:00-04:00,515.315,515.34,514.44,514.44,NaN,NaN,NaN,516.1681509671353,NaN,NaN,516.168300000001,517.3767297399907,514.9598702600113,515.6542284235742,517.1973606062288,518.9706734979801,515.4240477144775,64422,16647.9,26.317940275722364,42.298073386382534,NaN,NaN,NaN,NaN,0.39735026193340534,15.199345019932329,12219666,-0.05879510620010944,-0.30242526838685535,-0.2436301621867459
2025-08-18T15:25:00-04:00,514.46,514.73,514.25,514.3,NaN,NaN,NaN,515.7755077413563,NaN,NaN,516.1155000000009,517.4119385818814,514.8190614181204,515.3483827388593,517.1058109838038,518.9185458548353,515.2930761127724,43053,17773.466666666667,25.133923628099467,40.99898274729821,NaN,NaN,NaN,NaN,0.4032538146524491,17.4139118885761,12176613,-0.10702953247098423,-0.3774170777754762,-0.27038754530449194
2025-08-18T15:30:00-04:00,514.31,514.38,514.13,514.2,NaN,NaN,NaN,515.5161664803856,NaN,NaN,516.0613000000009,517.4440636229074,514.6785363770944,515.2455996558695,516.9815452486034,518.8483022036386,515.1147882935683,58988,19349.766666666666,24.293211166899795,39.35202595151902,NaN,NaN,NaN,NaN,0.3923071136058455,19.631247986530884,12117625,-0.13556796619506795,-0.43984750304832687,-0.3042795368532589
2025-08-18T15:35:00-04:00,514.2,514.415,514.04,514.095,NaN,NaN,NaN,515.4824770949134,NaN,NaN,516.0090000000009,517.4843765609173,514.5336234390845,515.2455996558695,516.7015193792661,518.6614187938582,514.741619964674,151452,23997.333333333332,23.40784561473714,37.62673591450753,NaN,NaN,NaN,NaN,0.391070891205428,21.810681952379873,11966173,-0.1502754030139265,-0.492123790620667,-0.3418483876067405
2025-08-18T15:40:00-04:00,514.1,515.125,514.03,515.125,NaN,NaN,NaN,515.4824770949134,NaN,NaN,515.9841000000009,517.4761947545538,514.492005245448,515.2455996558695,516.5999693591075,518.5562777839361,514.6436609342788,83527,26440.8,44.69914440996105,37.2670738561286,NaN,NaN,NaN,NaN,0.44135154183361364,21.501471003209826,12049700,-0.08276729430829566,-0.44530750549211007,-0.3625402111838144
2025-08-18T15:45:00-04:00,515.15,516.32,515.15,515.71,514.2860332668247,514.2860332668247,514.2860332668247,NaN,NaN,NaN,515.9715000000009,517.4619995794949,514.4810004205069,515.2455996558695,516.581497468302,518.5210804604371,514.6419144761669,34508,27264.4,52.7354544027038,37.51285347599859,NaN,NaN,NaN,NaN,0.4951835745597877,21.090034667404005,12084208,0.00452282194899134,-0.35688668374757526,-0.3614095056965666
2025-08-18T15:50:00-04:00,515.7,516.18,515.32,516.18,514.2860332668247,NaN,NaN,NaN,NaN,NaN,515.966300000001,517.4520318858081,514.4805681141938,515.2455996558695,516.5617810134622,518.4768209066884,514.646741120236,48121,28453.266666666666,58.014450566320505,38.768444387645395,NaN,NaN,NaN,NaN,0.5212418906626528,20.707986641298604,12132329,0.09228668539901375,-0.24605114894779945,-0.3383378343468132
2025-08-18T15:55:00-04:00,516.17,517.31,516.02,517.11,515.056912542706,NaN,NaN,NaN,NaN,NaN,515.978500000001,517.4913321110962,514.4656678889057,515.2385777223427,516.5812961994741,518.4217837472365,514.7408086517116,141258,32712.2,66.08611617244415,40.58275853381348,NaN,NaN,NaN,NaN,0.5761531841867464,21.77791730492723,12273587,0.20489254299891124,-0.08222215559817414,-0.2871146985970854
2025-08-19T09:30:00-04:00,515.145,515.145,512.07,512.18,NaN,NaN,NaN,515.8297653001443,515.8297653001443,515.8297653001443,515.8885000000009,517.7245776117317,514.0524223882702,515.2385777223427,513.1316666666667,513.1316666666667,513.1316666666667,74646,34384.166666666664,31.50680491961458,39.940174619482825,NaN,NaN,NaN,NaN,0.894999385316262,22.240246280742017,12198941,-0.04727260538764533,-0.34620545533164204,-0.2989328499439967
2025-08-19T09:35:00-04:00,512.19,514.13,511.74,513.75,NaN,NaN,NaN,515.3821623319559,NaN,NaN,515.8265000000009,517.736395545933,513.9166044540689,515.2385777223427,513.1623929954421,513.1992761557991,513.1255098350852,51805,35743.5,41.92785318129914,40.18810525839206,NaN,NaN,NaN,NaN,1.0017851435079566,22.8779899767947,12250746,-0.09992768113150846,-0.4238424513583823,-0.3239147702268738
2025-08-19T09:40:00-04:00,513.74,515.1,512.93,512.93,NaN,NaN,NaN,515.3821623319559,NaN,NaN,515.747300000001,517.7974962920815,513.6971037079205,515.2385777223427,513.2712420653971,513.4777584862513,513.0647256445429,36023,36467.2,38.6226025292816,39.665226638142826,NaN,NaN,NaN,NaN,1.0852290618288218,22.401530605224597,12214723,-0.1770699035420228,-0.5452521496544023,-0.3681822461123795
2025-08-19T09:45:00-04:00,513,513.31,512.4,512.69,NaN,NaN,NaN,515.3821623319559,NaN,NaN,515.6633000000011,517.8583823300611,513.468217669941,515.2385777223427,513.2060962953534,513.4575094434844,512.9546831472225,26064,36776.566666666666,37.68619239058815,38.95301996257739,NaN,NaN,NaN,NaN,1.072712700269618,22.33553702405307,12188659,-0.22809844917619831,-0.6533053075826274,-0.4252068584064291
2025-08-19T09:50:00-04:00,512.71,513.6,512.43,513.6,NaN,NaN,NaN,515.3821623319559,NaN,NaN,515.6005000000009,517.8478195136549,513.3531804863469,515.2385777223427,513.2065913771331,513.4415252437159,512.9716575105504,27384,37239.5,43.29958765257614,39.265677597030106,NaN,NaN,NaN,NaN,1.0796617931075077,21.964171678605567,12216043,-0.18617425153445077,-0.6579246728244925,-0.47175042129004174
2025-08-19T09:55:00-04:00,513.65,513.86,513.31,513.5,NaN,NaN,NaN,515.3821623319559,NaN,NaN,515.535300000001,517.8328755996282,513.2377244003738,515.2385777223427,513.2328231767575,513.4768582867221,512.988788066793,17490,37490.8,42.84285399214379,39.75528435017079,NaN,NaN,NaN,NaN,1.0418288078855478,21.340267672149963,12198553,-0.15221832259557955,-0.6620233245345162,-0.5098050019389366
2025-08-19T10:00:00-04:00,513.56,514.1,513.22,513.85,NaN,NaN,NaN,515.3821623319559,NaN,NaN,515.4669000000009,517.7574509285687,513.1763490714332,515.2385777223427,513.2719666816477,513.541166925101,513.0027664381943,20242,37922.933333333334,45.028450390255934,41.09174935835176,NaN,NaN,NaN,NaN,1.0302696073222941,20.50137328870911,12218795,-0.09597189094740166,-0.6297698656231887,-0.533797974675787
2025-08-19T10:05:00-04:00,513.83,514.05,513.68,513.84,NaN,NaN,NaN,515.3821623319559,NaN,NaN,515.399900000001,517.6808835501473,513.1189164498547,515.2385777223427,513.3155833068832,513.6166864087437,513.0144802050228,20447,38135.333333333336,44.97553373374385,42.50900722304065,NaN,NaN,NaN,NaN,0.9831074925135591,19.722399932656888,12198348,-0.05145835455137304,-0.5981209178650033,-0.5466625633136303
2025-08-19T10:10:00-04:00,513.91,513.98,512.66,512.69,NaN,NaN,NaN,515.3821623319559,NaN,NaN,515.3027000000011,517.6227743168473,512.9826256831549,515.2385777223427,513.3020298725153,513.5974763521642,513.0065833928663,19346,38289.6,39.26136210160069,43.57816086123357,NaN,NaN,NaN,NaN,1.0071712430483084,19.881009806837042,12179002,-0.08926709548164924,-0.6582464326656918,-0.5689793371840426
2025-08-19T10:15:00-04:00,512.72,513,512.545,512.97,NaN,NaN,NaN,515.339630818031,NaN,NaN,515.2253000000011,517.5927960688238,512.8578039311784,511.3063078262052,513.2720347769823,513.5796889781591,512.9643805758055,20295,38530.6,41.21955162976923,44.850425576593004,NaN,NaN,NaN,NaN,0.9677304399734322,20.119240472241035,12199297,-0.08522913129026255,-0.6755157512968708,-0.5902866200066083
2025-08-19T10:20:00-04:00,512.98,513.01,512.25,512.35,NaN,NaN,NaN,515.1840794172114,NaN,NaN,515.133300000001,517.5816877217885,512.6849122782135,511.3063078262052,513.2288668588811,513.5737953962087,512.8839383215536,19566,38738.9,38.27686272654148,44.391691170634466,NaN,NaN,NaN,NaN,0.9528925514039007,20.576952004859674,12179731,-0.11241578279488096,-0.7308063485002094,-0.6183905657053285
2025-08-19T10:25:00-04:00,512.41,512.47,510.97,511.23,NaN,NaN,NaN,514.3625303527928,NaN,NaN,515.0379000000011,517.7056639243472,512.370136075655,511.3063078262052,513.0355280153257,513.660940787683,512.4101152429683,43575,39880.9,33.609097962681005,43.02552285348998,NaN,NaN,NaN,NaN,0.9919716548750507,21.882076422671247,12136156,-0.18940086290122982,-0.8551416443318658,-0.665740781430636
2025-08-19T10:30:00-04:00,511.2,511.75,511.2,511.61,NaN,NaN,NaN,514.0724153367566,NaN,NaN,514.9505000000009,517.7710398413218,512.1299601586801,511.3063078262052,512.9636633564517,513.6538387192277,512.2734879936756,18761,40095.86666666667,36.44113555195274,41.484571781035136,NaN,NaN,NaN,NaN,0.960402250955405,23.09397766778199,12154917,-0.19740476958347075,-0.9124967434099744,-0.7150919738265037
2025-08-19T10:35:00-04:00,511.62,511.75,511.21,511.69,NaN,NaN,NaN,514.0329873669041,NaN,NaN,514.864300000001,517.8118542464994,511.91674575350254,511.3063078262052,512.9133996172878,513.6399909307955,512.1868083037801,14586,39861.6,37.0499397908582,39.41055918235043,NaN,NaN,NaN,NaN,0.9303735187443062,24.219314538241967,12169503,-0.1804484088812155,-0.9406524849280231,-0.7602040760468076
2025-08-19T10:40:00-04:00,511.71,511.86,511.13,511.3,NaN,NaN,NaN,514.0314879411358,NaN,NaN,514.770300000001,517.8631765956679,511.67742340433415,511.3063078262052,512.8366693904628,513.6167726349703,512.0565661459553,22377,40070.76666666667,35.27599494368246,39.67978704121242,NaN,NaN,NaN,NaN,0.9160611245482856,25.08890660436925,12147126,-0.17831934015963236,-0.983103251246348,-0.8047839110867157
2025-08-19T10:45:00-04:00,511.39,511.5,510.39,510.52,NaN,NaN,NaN,513.5175566710841,NaN,NaN,514.6613000000011,517.9549944660353,511.367605533967,511.3063078262052,512.706346341203,513.6105381864943,511.80215449591174,29626,40763.13333333333,31.978216160221436,38.96909868256402,NaN,NaN,NaN,NaN,0.9299139013662662,26.412295647357247,12117500,-0.21007780314211022,-1.0673811650143534,-0.8573033618722432
2025-08-19T10:50:00-04:00,510.49,511,510.33,510.65,NaN,NaN,NaN,513.2119859133076,NaN,NaN,514.554400000001,518.0109379436691,511.0978620563329,511.3063078262052,512.5836055948388,513.5859178718077,511.58129331786984,29494,41170.666666666664,33.10074361386526,38.574680188605704,NaN,NaN,NaN,NaN,0.9113486226972484,27.680697766241103,12146994,-0.20285859949632157,-1.1108766112426451,-0.9080180117463236
2025-08-19T10:55:00-04:00,510.62,510.72,509.68,509.86,NaN,NaN,NaN,512.7730320081573,NaN,NaN,514.427200000001,518.0910761764181,510.7633238235838,511.1250462609642,512.4272024193045,513.5707797674414,511.28362507116765,32859,41459.566666666666,29.87436010990986,38.016692168557256,NaN,NaN,NaN,NaN,0.9205380067903036,29.26833681044515,12114135,-0.2298372870450277,-1.1953146205526082,-0.9654773335075805
2025-08-19T11:00:00-04:00,509.85,509.94,509.01,509.79,NaN,NaN,NaN,512.0578941896047,NaN,NaN,514.301200000001,518.1560128665704,510.44638713343153,510.6208296070171,512.206322132447,513.5428915522572,510.8697527126368,44119,42293.46666666667,29.599056605623986,37.038082808060665,NaN,NaN,NaN,NaN,0.9212138634481396,31.1089629339659,12070016,-0.2303637192726442,-1.2534319825983857,-1.0230682633257415
2025-08-19T11:05:00-04:00,509.77,509.84,509.13,509.39,NaN,NaN,NaN,512.0473080900772,NaN,NaN,514.1618000000011,518.2080761936729,510.11552380632924,510.6208296070171,512.1050163298511,513.5154457780241,510.6945868816781,21727,42436.166666666664,28.01057639701378,35.978634408408524,NaN,NaN,NaN,NaN,0.9061271589161282,32.81811576294945,12048289,-0.23481757742879283,-1.3165902351117325,-1.0817726576829396
2025-08-19T11:10:00-04:00,509.4,509.4,508.6,509.25,NaN,NaN,NaN,511.55493044961906,NaN,NaN,514.0210000000011,518.2472011305398,509.7947988694624,509.8086636856137,511.93412306562306,513.4716487368661,510.39659739438,35394,42690.9,27.45520769651168,34.72340278742679,NaN,NaN,NaN,NaN,0.8985466475649729,34.680990850841944,12012895,-0.22437180211561025,-1.3622374103274524,-1.1378656082118421
2025-08-19T11:15:00-04:00,509.27,509.73,509.17,509.72,NaN,NaN,NaN,511.55493044961906,NaN,NaN,513.8968000000011,518.2542555689945,509.53934443100775,509.7403958070342,511.88475707692095,513.4439209185143,510.3255932353276,13176,42144.36666666667,32.30757776034574,33.81854878932693,NaN,NaN,NaN,NaN,0.874364744167475,35.79282296986407,12026071,-0.16569464634893416,-1.34498391614801,-1.1792892697990758
2025-08-19T11:20:00-04:00,509.72,509.73,509.21,509.39,NaN,NaN,NaN,511.55493044961906,NaN,NaN,513.7766000000012,518.2903299161145,509.26287008388783,509.7403958070342,511.8239890734147,513.4099119059981,510.23806624083124,16311,40540.666666666664,30.752238370973757,33.21075423713929,NaN,NaN,NaN,NaN,0.8490529767269439,36.82523850895604,12009760,-0.13053942861430023,-1.342463555566951,-1.2119241269526508
2025-08-19T11:25:00-04:00,509.34,509.78,509.34,509.58,NaN,NaN,NaN,511.55493044961906,NaN,NaN,513.660200000001,518.2989114413241,509.021488558678,509.7403958070342,511.7594060974127,513.3671390659438,510.1516731288816,19301,39748.933333333334,32.759374649227865,32.60645588138633,NaN,NaN,NaN,NaN,0.8198349069607335,37.68220326619631,12029061,-0.07848748959902574,-1.310033488951433,-1.2315459993524072
2025-08-19T11:30:00-04:00,509.55,509.8,509.55,509.63,NaN,NaN,NaN,511.55493044961906,NaN,NaN,513.5450000000011,518.2910071634816,508.79899283652065,509.24931664562735,511.7257834593068,513.3422196415416,510.10934727707195,10980,38148.666666666664,33.30721130192384,32.25148077962793,NaN,NaN,NaN,NaN,0.7791324136063953,38.43473574333771,12040041,-0.02732924575312734,-1.2657075565438163,-1.238378310790689
2025-08-19T11:35:00-04:00,509.63,509.97,509.21,509.28,NaN,NaN,NaN,511.55493044961906,NaN,NaN,513.4202000000012,518.2787442094655,508.5616557905368,508.86445331650185,511.6507928021529,513.290197333248,510.01138827105785,23757,33892.166666666664,31.379892675696652,32.09225183055762,NaN,NaN,NaN,NaN,0.7777658126345133,39.38976089542164,12016284,-0.004877729050876134,-1.244475472104284,-1.239597743053408
2025-08-19T11:40:00-04:00,509.23,510,509.23,509.9,NaN,NaN,NaN,511.55493044961906,NaN,NaN,513.3072000000011,518.2248047661182,508.3895952338841,508.4915626532015,511.6141882011709,513.2593807461677,509.9689956561741,13636,31562.466666666667,38.20170925432157,32.21800709501254,NaN,NaN,NaN,NaN,0.7772111117320468,40.205655076291,12029920,0.0603182728488143,-1.16419990199239,-1.2245181748412044
2025-08-19T11:45:00-04:00,509.93,509.99,509.59,509.85,NaN,NaN,NaN,511.55493044961906,NaN,NaN,513.1950000000011,518.1667095647107,508.2232904352914,508.48095780153784,511.58994311816434,513.23719558779,509.9426906485387,9848,30740.466666666667,37.874699401579626,32.276918495778354,NaN,NaN,NaN,NaN,0.7502674608940458,40.96327110138399,12020072,0.10599269551836121,-1.0920273054432528,-1.198020000961614
2025-08-19T11:50:00-04:00,509.79,509.93,509.67,509.8,NaN,NaN,NaN,511.55493044961906,NaN,NaN,513.074600000001,518.0776733910374,508.07152660896475,508.5927662412303,511.56548813167404,513.2145919708452,509.9163842925029,10151,29474.8,37.528738758528846,32.43782876826737,NaN,NaN,NaN,NaN,0.7152483565444705,41.66677169611319,12009921,0.136795463019332,-1.027025672187449,-1.1638211352067809
2025-08-19T11:55:00-04:00,509.78,509.98,509.7,509.78,NaN,NaN,NaN,511.55493044961906,NaN,NaN,512.9524000000011,517.9728825421319,507.9319174578704,508.7702129929842,511.53814073570635,513.1885715162374,509.8877099551753,11826,25160.4,37.38164960859503,32.82378830029406,NaN,NaN,NaN,NaN,0.6841591882198675,42.17533906553835,11998095,0.15826497858434396,-0.9659899119763509,-1.1242548905606948
2025-08-19T12:00:00-04:00,509.8,510.26,509.8,510.17,NaN,NaN,NaN,511.55493044961906,NaN,NaN,512.834200000001,517.8328147517193,507.83558524828277,509.05217039438736,511.5112046160415,513.1581286036377,509.8642806284453,14173,23144.633333333335,42.14362536728234,33.46970842553814,NaN,NaN,NaN,NaN,0.6695763890613069,41.8512508119118,12012268,0.19856364943376748,-0.8760503287684855,-1.074613978202253
2025-08-19T12:05:00-04:00,510.17,510.25,509.85,509.99,NaN,NaN,NaN,511.55493044961906,NaN,NaN,512.7122000000011,517.6846996365882,507.739700363414,509.0837363155099,511.48501571443296,513.1289461202331,509.84108530863284,13841,21879.166666666668,40.60866607210508,34.23644456569494,NaN,NaN,NaN,NaN,0.6503209326997833,41.55031171925856,11998427,0.21172291201933313,-0.8099603381780867,-1.0216832501974198
2025-08-19T12:10:00-04:00,509.97,510,509.88,509.99,NaN,NaN,NaN,511.55493044961906,NaN,NaN,512.588200000001,517.516634947939,507.6597650520631,509.0837363155099,511.4689162390246,513.1115926114675,509.8262398665818,8334,20956.2,40.60866607210508,35.02284524187216,NaN,NaN,NaN,NaN,0.6124408660783704,41.270868276080556,11998427,0.2181865091370414,-0.7489501137761181,-0.9671366229131595
2025-08-19T12:15:00-04:00,509.98,510.95,509.93,510.76,NaN,NaN,NaN,511.55493044961906,NaN,NaN,512.480000000001,517.3259966979091,507.63400330209305,509.64559124192635,511.45345692982113,513.0866048199971,509.82030903964517,13488,20537,49.698101944920865,36.57195420957981,NaN,NaN,NaN,NaN,0.641552232787057,38.642039388084264,12011915,0.2687568703652007,-0.6311905349566587,-0.8999474053218594
2025-08-19T12:20:00-04:00,510.85,510.95,510.32,510.51,NaN,NaN,NaN,511.55493044961906,NaN,NaN,512.3760000000011,517.1630930632175,507.5889069367847,509.64559124192635,511.43632467154936,513.0575861133448,509.81506322975395,16353,20169.3,47.17375930058981,37.98042218129967,NaN,NaN,NaN,NaN,0.6407270733022669,36.20098399208771,11995562,0.278614946583166,-0.5516787220929018,-0.8302936686760678
2025-08-19T12:25:00-04:00,510.5,510.66,510.28,510.44,NaN,NaN,NaN,511.55493044961906,NaN,NaN,512.2704000000011,516.9902427257515,507.5505572742508,509.64559124192635,511.42422895665425,513.0390315075334,509.80942640577507,10299,19929.6,46.462135631846905,38.99146202926404,NaN,NaN,NaN,NaN,0.6221037109235372,34.01366155194397,11985263,0.273290734305605,-0.4886802507940615,-0.7619709850996665
2025-08-19T12:30:00-04:00,510.46,510.59,510.11,510.16,NaN,NaN,NaN,511.55493044961906,NaN,NaN,512.1594000000011,516.8110090286808,507.50779097132147,509.64559124192635,511.40227905148635,513.0090646622579,509.79549344071484,16356,19800.066666666666,43.62714660914178,39.91109833199033,NaN,NaN,NaN,NaN,0.6119534458575675,32.32348093300493,11968907,0.24470506746812437,-0.45608965076451113,-0.7007947182326355
2025-08-19T12:35:00-04:00,510.16,510.26,509.81,509.89,NaN,NaN,NaN,511.55493044961906,NaN,NaN,512.0452000000012,516.6332601386212,507.45713986138117,509.64559124192635,511.36571774031984,512.9674356523632,509.7639998282765,22473,19867.6,41.027481035988124,40.50167735961606,NaN,NaN,NaN,NaN,0.6003853425820261,31.315241935916227,11946434,0.20311852374359718,-0.446896563553139,-0.6500150872967362
2025-08-19T12:40:00-04:00,509.95,510.22,509.7,510.15,NaN,NaN,NaN,511.55493044961906,NaN,NaN,511.93060000000116,516.414867003171,507.4463329968313,509.64559124192635,511.3463063694177,512.9444562106988,509.7481565281365,12767,19648.3,44.4596119909439,41.29827740883178,NaN,NaN,NaN,NaN,0.5946435323975985,30.57444257008564,11959201,0.188923731216732,-0.4138604232758212,-0.6027841544925532
2025-08-19T12:45:00-04:00,510.09,510.26,509.86,510.07,NaN,NaN,NaN,511.55493044961906,NaN,NaN,511.8130000000012,516.1762364129638,507.4497635870385,509.64559124192635,511.32701400455545,512.9207693066938,509.73325870241706,13479,19421.1,43.61843844224233,42.17245924929933,NaN,NaN,NaN,NaN,0.5807404229406254,29.774858487948592,11945722,0.17051307105739366,-0.38964281567081116,-0.5601558867282048
2025-08-19T12:50:00-04:00,510.04,510.49,510.04,510.15,NaN,NaN,NaN,511.55493044961906,NaN,NaN,511.7062000000012,515.9643482166948,507.4480517833076,509.64559124192635,511.3127350301709,512.9010052015049,509.724464858837,11785,19161.733333333334,44.74429165986752,42.63978656398119,NaN,NaN,NaN,NaN,0.5714018213020086,28.400267455885864,11957507,0.16024729639936575,-0.3598467662289977,-0.5200940626283634
2025-08-19T12:55:00-04:00,510.14,510.5,510.05,510.4,NaN,NaN,NaN,511.55493044961906,NaN,NaN,511.60820000000115,515.7550869089494,507.4613130910529,509.64559124192635,511.30091528972537,512.8834137913018,509.71841678814894,10906,18072.766666666666,48.22373746240882,43.379003568326134,NaN,NaN,NaN,NaN,0.5627302626375786,27.096552764344995,11968413,0.16610849389759624,-0.3124584452563681,-0.47856693915396437
2025-08-19T13:00:00-04:00,510.43,510.89,510.19,510.78,NaN,NaN,NaN,511.55493044961906,NaN,NaN,511.5350000000011,515.6079085425176,507.4620914574845,509.64559124192635,511.2903063924486,512.8626914692636,509.7179213156336,14546,17932.266666666666,53.06196310396211,44.48851959299993,NaN,NaN,NaN,NaN,0.5725352438777508,25.434220368867987,11982959,0.18968821289246318,-0.24145667303838536,-0.43114488593084854
2025-08-19T13:05:00-04:00,510.78,510.92,510.25,510.26,NaN,NaN,NaN,511.55493044961906,NaN,NaN,511.4542000000011,515.4642999283935,507.44410007160866,509.60269254170805,511.28080942999685,512.8464318193793,509.7151870406144,11026,17813.6,46.63934246671657,45.14978336858004,NaN,NaN,NaN,NaN,0.5794970121721983,23.962063553571472,11971933,0.1652692348201527,-0.22455834240565764,-0.38982757722581035
2025-08-19T13:10:00-04:00,510.25,510.69,509.81,510.67,NaN,NaN,NaN,511.55493044961906,NaN,NaN,511.3836000000012,515.3214938730284,507.4457061269739,509.60269254170805,511.25869026173814,512.8109545809122,509.7064259425641,24053,17869.466666666667,51.61244934206233,45.826127938207186,NaN,NaN,NaN,NaN,0.6009615113027552,22.962221835164883,11995986,0.17101943183017287,-0.17605328743809423,-0.3470727192682671
2025-08-19T13:15:00-04:00,510.64,510.95,510.42,510.95,NaN,NaN,NaN,511.55493044961906,NaN,NaN,511.3207000000012,515.1830940808046,507.45830591919776,509.60269254170805,511.2554522163215,512.8030343830445,509.70787004959845,6506,17098.8,54.71634391456446,46.833819212668566,NaN,NaN,NaN,NaN,0.595892831923985,21.38673068917742,12002492,0.18669156430367917,-0.11370826388866817,-0.30039982819234734
2025-08-19T13:20:00-04:00,510.93,511,510.56,510.65,NaN,NaN,NaN,511.55493044961906,NaN,NaN,511.2312000000012,514.9412159346555,507.521184065347,509.60269254170805,511.24920056590474,512.7884710277301,509.7099301040794,11895,16512.166666666668,50.945592952006905,47.57217113266155,NaN,NaN,NaN,NaN,0.5847576296437003,19.915344964708755,11990597,0.170321261771477,-0.08749825097800112,-0.2578195127494781
2025-08-19T13:25:00-04:00,510.7,511.32,510.68,511.3,NaN,NaN,NaN,511.55493044961906,NaN,NaN,511.14300000000117,514.6256294657074,507.66037053429494,509.8550790920669,511.24801728773264,512.781228903163,509.7148056723023,7891,15679.9,57.74088279498978,48.146655479095045,NaN,NaN,NaN,NaN,0.590846370383437,19.283484317606177,11998488,0.1949641240709526,-0.014114357660787391,-0.20907848173173998
2025-08-19T13:30:00-04:00,511.27,511.45,511.06,511.18,NaN,NaN,NaN,511.55493044961906,NaN,NaN,511.0430000000012,514.2146096852177,507.87139031478466,510.0830632736535,511.2478688391417,512.7747520169571,509.72098566132627,8266,14484.8,56.19325431894586,48.790905123263336,NaN,NaN,NaN,NaN,0.5765002010703333,18.972276456195793,11990222,0.1944374601522123,0.033968343458525396,-0.1604691166936869
2025-08-19T13:35:00-04:00,511.16,511.64,511.02,511.29,509.49149237537455,509.49149237537455,509.49149237537455,NaN,NaN,NaN,510.9266000000012,513.5846281705458,508.2685718294566,510.2364506189228,511.2487037691658,512.7663122375649,509.7310953007667,12325,14171.4,57.322474536588764,49.56664361645919,NaN,NaN,NaN,NaN,0.5796073295653097,19.071635290096786,12002547,0.19239753378326174,0.08002780053539027,-0.11236973324787147
2025-08-19T13:40:00-04:00,511.31,511.74,511.26,511.65,509.6796063583121,NaN,NaN,NaN,NaN,NaN,510.91600000000113,513.5581294433659,508.27387055663627,510.37716049513824,511.25213418250974,512.7614170845417,509.7428512804778,11696,13381.466666666667,60.876869996151406,50.7987667155313,NaN,NaN,NaN,NaN,0.572492520310646,19.362738519006257,12014243,0.20503196319527675,0.14392022074622446,-0.061111742449052285
2025-08-19T13:45:00-04:00,511.67,511.76,511.5,511.5,509.8568969783888,NaN,NaN,NaN,NaN,NaN,510.8710000000012,513.3924099221373,508.3495900778651,510.5397283961106,511.2547410684564,512.7584195846099,509.75106255230287,8068,13211.2,58.683772292093906,52.05993037668171,NaN,NaN,NaN,NaN,0.550171626002742,19.67407012618858,12006175,0.19318735898924216,0.18037245628750043,-0.012814902701741737
2025-08-19T13:50:00-04:00,511.52,511.92,511.5,511.85,509.96021984300756,NaN,NaN,NaN,NaN,NaN,510.84940000000114,513.3178324085249,508.3809675914775,510.73378271688847,511.2586860957256,512.7570993455844,509.7602728458668,8202,12940.9,62.113441910833636,53.320918228102414,NaN,NaN,NaN,NaN,0.5408736527168331,20.292721443796914,12014377,0.1980892033137993,0.2347966014405074,0.03670739812670809
2025-08-19T13:55:00-04:00,511.835,511.9,511.25,511.25,509.96021984300756,NaN,NaN,NaN,NaN,NaN,510.82060000000115,513.2354818926405,508.40571810736185,510.73378271688847,511.26049112452466,512.7525126846072,509.76846956444217,9136,12602.066666666668,53.85949303424939,54.052422127531486,NaN,NaN,NaN,NaN,0.5486683918084863,20.02037666049774,12005241,0.15215216837480075,0.22689760859520902,0.07474544022040827
2025-08-19T14:00:00-04:00,511.23,511.24,510.14,510.53,509.96021984300756,NaN,NaN,NaN,NaN,NaN,510.75920000000116,513.0407182303684,508.477681769634,510.73378271688847,511.2551871333133,512.7419559716826,509.768418294944,9027,12536.966666666667,45.965851224627436,54.13967638215719,NaN,NaN,NaN,NaN,0.5887635066793097,19.96227511279521,11996214,0.06875349887799545,0.16068731381790258,0.09193381493990713
2025-08-19T14:05:00-04:00,510.56,510.76,510.21,510.65,509.96021984300756,NaN,NaN,NaN,NaN,NaN,510.7022000000012,512.8451709833239,508.55922901667844,510.73378271688847,511.2494073870958,512.7315402711099,509.7672745030817,8650,12033.4,47.35082067314458,54.077325182924035,NaN,NaN,NaN,NaN,0.5859946847736455,19.908323675642865,12004864,0.01969663313308241,0.11655460635626014,0.09685797322317773
2025-08-19T14:10:00-04:00,510.63,510.94,510.53,510.72,509.96021984300756,NaN,NaN,NaN,NaN,NaN,510.63960000000117,512.5848463482831,508.69435365171915,510.73378271688847,511.2447973818868,512.7211422311735,509.7684525326001,9585,11898.366666666667,48.18513126788291,53.72898005177552,NaN,NaN,NaN,NaN,0.573423635861244,19.394330710666598,12014449,-0.008499589168477803,0.08623348676258047,0.09473307593105827
2025-08-19T14:15:00-04:00,510.7,510.7,510.31,510.4,509.96021984300756,NaN,NaN,NaN,NaN,NaN,510.5708000000011,512.2884255225625,508.85317447743967,510.73378271688847,511.2370012191602,512.7079336711114,509.76606876720905,10977,11936,44.698055344739885,53.59031668592004,NaN,NaN,NaN,NaN,0.5617505190140141,19.334236069669867,12003472,-0.04701218833829282,0.03596784050819224,0.08298002884648506
2025-08-19T14:20:00-04:00,510.46,510.73,510.38,510.7,509.96021984300756,NaN,NaN,NaN,NaN,NaN,510.5310000000011,512.1390907921623,508.92290920783995,510.73378271688847,511.234034208083,512.7021564079314,509.76591200823464,5132,11768.7,48.46352398806149,53.36539344634855,NaN,NaN,NaN,NaN,0.5466254819415861,19.196034333548802,12008604,-0.05029789672645946,0.02010765793841074,0.0704055546648702
2025-08-19T14:25:00-04:00,510.69,510.75,510.51,510.68,509.96021984300756,NaN,NaN,NaN,NaN,NaN,510.48520000000116,511.93552542396515,509.03487457603717,510.73378271688847,511.22954422252207,512.6929387749674,509.76614967007674,8443,11655.933333333332,48.227764495558844,52.90192348784815,NaN,NaN,NaN,NaN,0.524723661802902,19.009527561654238,12000161,-0.05163884350871273,0.005857000278979285,0.057495843787692014
2025-08-19T14:30:00-04:00,510.68,510.86,510.1,510.12,509.96021984300756,NaN,NaN,NaN,NaN,NaN,510.44060000000115,511.79262017571705,509.08857982428526,510.73378271688847,511.22090006842484,512.679555766599,509.76224437025064,11090,11553.166666666666,42.05828565944293,52.26711582409359,NaN,NaN,NaN,NaN,0.5415291145312654,19.62770489978848,11989071,-0.08603439983820671,-0.050047156010066374,0.035987243828140336
2025-08-19T14:35:00-04:00,510.11,510.17,509.79,509.8,NaN,NaN,NaN,511.67112231857385,511.67112231857385,511.67112231857385,510.4120000000011,511.7564939552334,509.06750604476883,510.73378271688847,511.2097905137122,512.6671289448763,509.7524520825482,9609,11412.1,38.988981864505845,50.92769432905902,NaN,NaN,NaN,NaN,0.5299913206361747,20.705981153435513,11979462,-0.12383254404250721,-0.11880343622499367,0.005029107817513534
2025-08-19T14:40:00-04:00,509.81,510.12,509.46,509.46,NaN,NaN,NaN,511.494253122275,NaN,NaN,510.3690000000011,511.69487932920913,509.0431206707931,510.62602617351075,511.1954827192646,512.6534452542376,509.7375201842916,10623,11488.4,35.98419467088121,49.484190068482974,NaN,NaN,NaN,NaN,0.5392776548764497,22.17640732013095,11968839,-0.1627760370897306,-0.19844093854464973,-0.03566490145491912
2025-08-19T14:45:00-04:00,509.5,509.74,509.34,509.64,NaN,NaN,NaN,511.22133252580795,NaN,NaN,510.32800000000117,511.61413529439636,509.041864705606,509.6658209388086,511.18074473242336,512.6402077132959,509.7212817515508,10414,11385.933333333332,38.67859541987575,48.15248441728919,NaN,NaN,NaN,NaN,0.5293292509567058,23.700781513615624,11979253,-0.1668397456460889,-0.24421458351253023,-0.07737483786644134
2025-08-19T14:50:00-04:00,509.62,509.83,509.56,509.7,NaN,NaN,NaN,511.22133252580795,NaN,NaN,510.29600000000113,511.5632868640248,509.02871313597745,509.62537300522877,511.1714039976789,512.6309933151485,509.7118146802093,7260,11082.833333333334,39.59131587046233,46.632087694025685,NaN,NaN,NaN,NaN,0.5108057330312256,24.81169769049049,11986513,-0.15610631282938994,-0.27250772890317876,-0.11640141607378882
2025-08-19T14:55:00-04:00,509.68,509.81,509.56,509.69,NaN,NaN,NaN,511.22133252580795,NaN,NaN,510.2794000000012,511.55622361955227,509.00257638045014,509.62537300522877,511.15856951262697,512.6183216520166,509.6988173732374,10058,11074.8,39.4858285220626,45.260805996166305,NaN,NaN,NaN,NaN,0.4921767521004238,25.843262711874292,11976455,-0.14077242135597007,-0.2923669427687514,-0.15159452141278135
2025-08-19T15:00:00-04:00,509.69,509.73,509.14,509.15,NaN,NaN,NaN,511.0438665027712,NaN,NaN,510.2494000000012,511.56002372765187,508.9387762723505,509.62537300522877,511.1288678950986,512.5948850297991,509.6628507603981,19319,11173.566666666668,34.18847864341288,43.2661657627791,NaN,NaN,NaN,NaN,0.4991641269503958,27.402216044180506,11957136,-0.1568613924510894,-0.3476712619766431,-0.1908098695255537
2025-08-19T15:05:00-04:00,509.15,509.25,508.84,508.95,NaN,NaN,NaN,510.6366452980997,NaN,NaN,510.2312000000012,511.587427943808,508.8749720561944,509.62537300522877,511.0920097308301,512.5713263372664,509.6126931243938,20974,11123.6,32.451960744364214,41.73705631350159,NaN,NaN,NaN,NaN,0.492795260739655,29.209772046108444,11936162,-0.1697466700503681,-0.4029932070885138,-0.23324653703814574
2025-08-19T15:10:00-04:00,508.94,509.24,508.92,509,NaN,NaN,NaN,510.6366452980997,NaN,NaN,510.2154000000012,511.6096924210364,508.82110757896595,509.62537300522877,511.072155847172,512.5578029530607,509.5865087412833,11839,11092.666666666666,33.36321219897289,40.83686781166913,NaN,NaN,NaN,NaN,0.4804527421153934,30.888216905041528,11948001,-0.16360716413692777,-0.43775549220930543,-0.27414832807237766
2025-08-19T15:15:00-04:00,508.99,509.25,508.69,509.02,NaN,NaN,NaN,510.53825532326863,NaN,NaN,510.2080000000012,511.6235027358862,508.79249726411626,509.58029840418305,511.0298444091998,512.5294501616831,509.5302386567165,25175,11482.533333333333,33.748218399355096,39.8652533635413,NaN,NaN,NaN,NaN,0.4861346891071512,32.71319615106451,11973176,-0.14740677162722654,-0.4584067926064108,-0.3110000209791843
2025-08-19T15:20:00-04:00,509.01,509.01,508.65,508.73,NaN,NaN,NaN,510.3774255358473,NaN,NaN,510.1976000000013,511.64830774280045,508.7468922572021,508.9562387233464,511.006509160889,512.5154445350981,509.4975737866798,13103,11526.466666666667,30.955399535923448,38.634558239829914,NaN,NaN,NaN,NaN,0.47783935417092643,34.45311383141201,11960073,-0.14519716758959073,-0.49249648046617267,-0.34729931287658194
2025-08-19T15:25:00-04:00,508.715,509.03,508.67,509,NaN,NaN,NaN,510.37617892058154,NaN,NaN,510.18320000000114,511.6665121841688,508.69988781583345,508.8189909786771,510.97637413764966,512.4952175031666,509.4575307721327,18199,11769.566666666668,36.24537956348747,38.03079568402617,NaN,NaN,NaN,NaN,0.4694222574444286,35.98149557488693,11978272,-0.11580372436130026,-0.49205396832820725,-0.376250243966907
2025-08-19T15:30:00-04:00,508.99,509.21,508.95,509.2,NaN,NaN,NaN,510.37617892058154,NaN,NaN,510.1794000000012,511.67176676307525,508.6870332369271,508.7828833810827,510.9525566474508,512.4760179929525,509.42909530194913,16534,11835.833333333334,39.91755024042049,37.420368987766096,NaN,NaN,NaN,NaN,0.45446352476982593,36.62039118493623,11994806,-0.0751161265859202,-0.4701454021993072,-0.395029275613387
2025-08-19T15:35:00-04:00,509.18,509.21,508.56,508.84,NaN,NaN,NaN,510.37617892058154,NaN,NaN,510.1646000000012,511.6946520760478,508.6345479239546,508.7828833810827,510.91402324049886,512.4491953984866,509.3788510825111,24294,12278.1,35.90829947451191,36.54040720054846,NaN,NaN,NaN,NaN,0.46843041585769385,37.76661706619833,11970512,-0.06504916954397283,-0.47634073754335304,-0.4112915679993802
2025-08-19T15:40:00-04:00,508.84,509.15,508.76,509.09,NaN,NaN,NaN,510.37617892058154,NaN,NaN,510.1538000000012,511.70625297366803,508.60134702633434,508.7828833810827,510.8771964873911,512.420096193485,509.3342967812971,25758,12334.933333333332,40.38614146144269,36.42096832926273,NaN,NaN,NaN,NaN,0.4628282432964291,38.83096967022742,11996270,-0.03562532827205944,-0.45582322833945454,-0.4201979000673951
2025-08-19T15:45:00-04:00,509.06,509.12,508.56,508.73,NaN,NaN,NaN,510.34577062125885,NaN,NaN,510.1428000000012,511.7273253659385,508.55827463406393,508.61330670486615,510.84097898841435,512.3942866539545,509.2876713228742,23795,12911.233333333334,36.43819708255547,36.238769416266265,NaN,NaN,NaN,NaN,0.46976908306097004,40.080138107467185,11972475,-0.03445899094942717,-0.4632716387541791,-0.4288126478047519
2025-08-19T15:50:00-04:00,508.77,509.56,508.74,509.32,NaN,NaN,NaN,510.34577062125885,NaN,NaN,510.1312000000012,511.7310831942981,508.53131680570425,508.24879515284044,510.7699387916664,512.3252336003154,509.21464398301737,61918,14578.666666666666,45.79104537361886,36.939258752176094,NaN,NaN,NaN,NaN,0.4954998628423282,39.51452306844279,12034393,0.009640268644344807,-0.4167623119993209,-0.4264025806436657
2025-08-19T15:55:00-04:00,509.33,510.12,509.2,509.91,NaN,NaN,NaN,510.34577062125885,NaN,NaN,510.1324000000012,511.7315275606328,508.5332724393696,508.60087239568276,510.6806730147356,512.1947012719636,509.1666447575076,135655,18837.466666666667,53.20620690789495,37.9769452870346,NaN,NaN,NaN,NaN,0.5258213012107344,37.339232800420675,12170048,0.07831532398806595,-0.3285084256585833,-0.40682374964664925
2025-08-20T09:30:00-04:00,509.99,510.91,506.38,508.31,508.08574687772494,508.08574687772494,508.08574687772494,NaN,NaN,NaN,510.1026000000012,511.7790572631815,508.42614273682085,508.60087239568276,508.5333333333333,508.53333872812993,508.5333279385367,86304,21438.733333333334,38.01837483798937,37.86459235614368,NaN,NaN,NaN,NaN,0.8118340654099698,38.480330271188286,12083744,0.018854771888653477,-0.3832552847858324,-0.40211005667448585
2025-08-20T09:35:00-04:00,508.4,509.57,507.65,509.54,NaN,NaN,NaN,510.9243160738382,510.9243160738382,510.9243160738382,510.09780000000114,511.7792911939826,508.4163088060197,508.60087239568276,508.6119146579023,508.7675094979532,508.45631981785135,22013,21761.666666666668,49.86609600740989,38.606040033668485,NaN,NaN,NaN,NaN,0.8909887750235445,39.539920779758205,12105757,0.06275933860302835,-0.32366088342070043,-0.3864202220237288
2025-08-20T09:40:00-04:00,509.65,511,509.64,510,507.91178920224536,507.91178920224536,507.91178920224536,NaN,NaN,NaN,510.0944000000012,511.7759809689701,508.4128190310323,508.60087239568276,508.9801758327172,509.6677560281637,508.29259563727067,32347,22450.033333333333,53.44978996097141,39.98184798492266,NaN,NaN,NaN,NaN,0.9316324339504326,38.08709795063077,12138104,0.11986696697149335,-0.2365865133093621,-0.35645348028085544
2025-08-20T09:45:00-04:00,510.05,510.91,509.86,510.27,507.9430715112342,NaN,NaN,NaN,NaN,NaN,510.10000000000116,511.7820178344758,508.4179821655265,508.60087239568276,509.27216157595814,510.1001036172139,508.44421953470237,38224,23455.233333333334,55.46221015406506,41.62543722847272,NaN,NaN,NaN,NaN,0.9400872600968311,36.73804818072672,12176328,0.16985778516433941,-0.14413124882543116,-0.31398903398977057
2025-08-20T09:50:00-04:00,510.12,510.29,507.62,507.68,NaN,NaN,NaN,511.6500226483674,511.6500226483674,511.6500226483674,510.0538000000012,511.8671367682688,508.24046323173366,508.60087239568276,509.12644729571275,509.9250784906367,508.3278161007888,43703,24638.6,38.33972772452916,41.980902623155316,NaN,NaN,NaN,NaN,1.0636524558042013,37.14676071805514,12132625,0.029861664549412248,-0.27666195330300525,-0.3065236178524175
2025-08-20T09:55:00-04:00,507.73,507.9,506.27,506.67,NaN,NaN,NaN,509.8797943461688,NaN,NaN,509.9720000000011,512.006093408735,507.9379065912673,508.60087239568276,508.79909655144326,509.8707411108872,507.7274519919993,39335,25645.233333333334,33.939444955739745,41.99456166289707,NaN,NaN,NaN,NaN,1.1041058518181865,38.17329442790435,12093290,-0.12111191261828014,-0.4579135086252677,-0.33680159600698756
2025-08-20T10:00:00-04:00,506.52,508.26,506.48,507.24,NaN,NaN,NaN,509.8797943461688,NaN,NaN,509.9066000000011,512.0732512768598,507.7399487231424,508.60087239568276,508.6415115449216,509.7517878325127,507.53123525733054,31392,26390.733333333334,38.246971736584435,42.51538824865857,NaN,NaN,NaN,NaN,1.1523840052597427,38.65838155886795,12124682,-0.16994371511827183,-0.5492312399048274,-0.37928752478655553
2025-08-20T10:05:00-04:00,507.34,507.89,506.68,507.79,NaN,NaN,NaN,509.8797943461688,NaN,NaN,509.8536000000011,512.0938634120964,507.6133365879058,508.60087239568276,508.5658015938883,509.678631610336,507.45297157744056,19962,26767.8,42.165688332438506,42.93826744644078,NaN,NaN,NaN,NaN,1.1564994334554741,39.10881960904843,12144644,-0.15308420546729712,-0.5706427816206769,-0.4175585761533798
2025-08-20T10:10:00-04:00,507.82,508.03,506.15,507.17,NaN,NaN,NaN,509.8797943461688,NaN,NaN,509.7938000000011,512.1545418824281,507.43305811757415,508.60087239568276,508.44763015191273,509.58547305512593,507.30978724869954,27815,27375.466666666667,39.149712500001655,42.883421893553724,NaN,NaN,NaN,NaN,1.2081780453515114,39.79743933273942,12116829,-0.17025221416380626,-0.6303738438581377,-0.4601216296943314
2025-08-20T10:15:00-04:00,507.12,508.1,506.98,507.89,NaN,NaN,NaN,509.8797943461688,NaN,NaN,509.75380000000115,512.1737004598331,507.3338995401692,507.4296979165462,508.4057856122113,509.52718647122776,507.2843847531948,19053,27644.666666666668,44.146010695652336,43.4718298379209,NaN,NaN,NaN,NaN,1.2018796135406897,40.333945328103646,12135882,-0.1219443280031754,-0.6125520396983006,-0.49060771169512524
2025-08-20T10:20:00-04:00,507.82,508.24,507.19,507.19,NaN,NaN,NaN,509.8797943461688,NaN,NaN,509.69460000000106,512.2155496932265,507.1736503067756,507.4046853332717,508.31510734204863,509.40877846657344,507.22143621752383,42133,28878.033333333333,40.6513062798031,43.4907701820895,NaN,NaN,NaN,NaN,1.1910310697163555,40.61707599433127,12093749,-0.12547294547317278,-0.6474488935365912,-0.5219759480634184
2025-08-20T10:25:00-04:00,507.14,507.74,507.04,507.43,NaN,NaN,NaN,509.8797943461688,NaN,NaN,509.64180000000107,512.2385354574149,507.0450645425873,507.4046853332717,508.26051408967476,509.3427776014174,507.1782505779321,25621,29450.633333333335,42.33675652590013,43.91209585661412,NaN,NaN,NaN,NaN,1.1559574218794724,40.97165068690534,12119370,-0.10103212100848036,-0.6482660993240188,-0.5472339783155384
2025-08-20T10:30:00-04:00,507.42,507.9,507.13,507.38,NaN,NaN,NaN,509.8797943461688,NaN,NaN,509.5864000000011,512.2546121646371,506.918187835365,507.4046853332717,508.2289927143893,509.300680167266,507.15730526151253,17771,29673.333333333332,42.06871169848955,43.64621487981917,NaN,NaN,NaN,NaN,1.128389034602366,41.03278583584226,12101599,-0.07861867046886517,-0.6455073164016198,-0.5668886459327547
2025-08-20T10:35:00-04:00,507.39,508.16,506.9,507.79,NaN,NaN,NaN,509.8797943461688,NaN,NaN,509.5342000000011,512.2385789371632,506.829821062839,506.1507482666173,508.20690351362884,509.2652607689666,507.1485462582911,16679,29909,45.13614215929005,43.06978168349024,NaN,NaN,NaN,NaN,1.1377898178450576,40.65218869575899,12118278,-0.029115575533474436,-0.6032831153495977,-0.5741675398161232
2025-08-20T10:40:00-04:00,507.76,507.76,507.34,507.59,NaN,NaN,NaN,509.8797943461688,NaN,NaN,509.470400000001,512.2045571563995,506.7362428436026,505.1542658783253,508.17971536446356,509.2235343031185,507.1358964258086,20394,30234.7,43.91461961429548,43.49094202465496,NaN,NaN,NaN,NaN,1.088661973713271,40.298777065681655,12097884,-0.004090664983601888,-0.5792808710456256,-0.5751902060620238
2025-08-20T10:45:00-04:00,507.69,508.11,507.23,507.3,NaN,NaN,NaN,509.8797943461688,NaN,NaN,509.41120000000103,512.2020010025716,506.6203989974304,505.56633016212817,508.1519960041095,509.1808928626115,507.1230991456075,22106,30624.433333333334,42.134034326691086,42.93865190460362,NaN,NaN,NaN,NaN,1.0737575470194656,39.35852122386921,12075778,-0.0014543196386467283,-0.5770081056103322,-0.5755537859716855
2025-08-20T10:50:00-04:00,507.33,507.5,506.75,507,NaN,NaN,NaN,509.8797943461688,NaN,NaN,509.3378000000011,512.1847922085994,506.49080779140274,505.56633016212817,508.11081742955906,509.1404518970681,507.08118296205004,20233,31056.866666666665,40.31304580802147,42.000313036535765,NaN,NaN,NaN,NaN,1.0506320079466467,38.92941440701939,12055545,-0.013623756754446825,-0.592583481914744,-0.5789597251602971
2025-08-20T10:55:00-04:00,507.05,507.26,506.75,506.81,NaN,NaN,NaN,509.85860900739266,NaN,NaN,509.255000000001,512.1500281511616,506.3599718488405,505.56633016212817,508.08628436595114,509.11878371339697,507.0537850185053,11238,31096.2,39.15874252819247,40.83577963468773,NaN,NaN,NaN,NaN,1.012015435950457,38.530958077087405,12044307,-0.02738423516093902,-0.613190019111471,-0.585805783950532
2025-08-20T11:00:00-04:00,506.75,506.9,506.03,506.35,NaN,NaN,NaN,509.30753587069296,NaN,NaN,509.169000000001,512.1474297870175,506.19057021298454,505.56633016212817,508.02442634035026,509.0851594255926,506.9636932551079,20764,31144.366666666665,36.43840618057579,40.69997095297678,NaN,NaN,NaN,NaN,1.0018714762397103,38.77615846978258,12023543,-0.05858895542825293,-0.6590419782358481,-0.6004530228075952
2025-08-20T11:05:00-04:00,506.39,506.48,505.5,506.25,NaN,NaN,NaN,508.8369660583888,NaN,NaN,509.06800000000095,512.092663947663,506.0433360523388,505.56633016212817,507.8597285214108,509.01024176975307,506.7092152730685,51457,32160.466666666667,35.85526507434908,40.83681524716315,NaN,NaN,NaN,NaN,1.000309227936875,39.38904915820837,11972086,-0.07598369048795672,-0.6954326359175411,-0.6194489454295844
2025-08-20T11:10:00-04:00,506.28,506.37,505.64,506.195,NaN,NaN,NaN,508.82210396482566,NaN,NaN,508.968300000001,512.036250201044,505.900349798958,505.56633016212817,507.7794536773544,508.96339823992577,506.59550911478306,28549,32717.466666666667,35.51858507825979,40.641930485854246,NaN,NaN,NaN,NaN,0.9810014259413853,39.958161940318035,11943537,-0.08076575653574114,-0.7204061410992608,-0.6396403845635197
2025-08-20T11:15:00-04:00,506.16,506.23,505.73,506.13,NaN,NaN,NaN,508.73723560278813,NaN,NaN,508.86510000000106,511.9607372455237,505.7694627544784,505.56633016212817,507.7190901139282,508.9254560550645,506.5127241727919,22768,32637.233333333334,35.09911986243313,40.13717559513958,NaN,NaN,NaN,NaN,0.9466441812312864,40.48662380941987,11920769,-0.0778458573324663,-0.7369477062291026,-0.6591018488966363
2025-08-20T11:20:00-04:00,506.15,506.28,506.04,506.16,NaN,NaN,NaN,508.73723560278813,NaN,NaN,508.755300000001,511.837457951196,505.673142048806,505.56633016212817,507.6682778715256,508.8866897598082,506.44986598324306,22230,32941.46666666667,35.47786026698084,39.87490043563809,NaN,NaN,NaN,NaN,0.8961695968576197,40.86334468587888,11942999,-0.06401147694467968,-0.7391161950774858,-0.6751047181328061
2025-08-20T11:25:00-04:00,506.24,506.25,505.5,505.85,NaN,NaN,NaN,508.52078698518505,NaN,NaN,508.642300000001,511.72794625905743,505.55665374094457,505.56633016212817,507.5903461139244,508.837198605028,506.3434936228208,30839,33362.8,33.31440352166966,39.10121420892504,NaN,NaN,NaN,NaN,0.8857289113677896,41.64657695644463,11912160,-0.06561344287313886,-0.7571215217242298,-0.6915080788510909
2025-08-20T11:30:00-04:00,505.84,507,505.82,506.7,NaN,NaN,NaN,508.52078698518505,NaN,NaN,508.53930000000105,511.5321969303912,505.5464030696109,505.56633016212817,507.55285003787066,508.79384851570506,506.31185156003625,25552,33663.4,43.48996314859482,39.30397541383873,NaN,NaN,NaN,NaN,0.9067482748415194,40.819306030273445,11937712,-0.0026285975827667896,-0.6947938258295494,-0.6921652282467826
2025-08-20T11:35:00-04:00,506.67,506.8,506.05,506.1,NaN,NaN,NaN,508.52078698518505,NaN,NaN,508.43630000000104,511.4033152065506,505.4692847934515,505.09006412970257,507.51838423096956,508.7587699655801,506.27799849635903,21180,33559.6,38.969638297851134,39.06346696897809,NaN,NaN,NaN,NaN,0.8955519694956966,40.051125884543055,11916532,0.005006618627479087,-0.6859069549624337,-0.6909135735899128
2025-08-20T11:40:00-04:00,506.08,506.53,505.11,505.15,NaN,NaN,NaN,508.52078698518505,NaN,NaN,508.32870000000105,511.3733942762522,505.2840057237499,505.077051303762,507.44750223453434,508.717541001405,506.1774634676637,29093,33670.76666666667,33.10282000481497,38.423046133715616,NaN,NaN,NaN,NaN,0.9330125431031439,40.19918304997807,11887439,-0.044798084452302156,-0.7469111791552905,-0.7021130947029883
2025-08-20T11:45:00-04:00,505.15,505.93,504.86,505.67,NaN,NaN,NaN,508.15543071966465,NaN,NaN,508.229100000001,511.28931286125373,505.16888713874823,505.0233026375787,507.3535334543617,508.6616336876931,506.0454332210303,39702,34201,38.55565785245229,37.95301154037007,NaN,NaN,NaN,NaN,0.9427973614529188,40.53122421196089,11927141,-0.03408010160493902,-0.7447132217091621,-0.7106331201042231
2025-08-20T11:50:00-04:00,505.675,505.68,504.44,504.49,NaN,NaN,NaN,507.86404750513447,NaN,NaN,508.104500000001,511.25488172226056,504.95411827774143,505.0233026375787,507.2344133498815,508.6166951563601,505.8521315434029,41738,33528.333333333336,32.15128688517575,37.11277348829009,NaN,NaN,NaN,NaN,0.9640261213491395,41.14866414182728,11885403,-0.094401879154006,-0.8286354690467306,-0.7342335898927246
2025-08-20T11:55:00-04:00,504.48,505.09,504.465,504.82,NaN,NaN,NaN,507.5393180730829,NaN,NaN,507.99290000000104,511.20484276970217,504.7809572302999,505.0233026375787,507.17661461816147,508.5920085951192,505.76122064120375,21089,29709.466666666667,35.383843218549,36.630616980565655,NaN,NaN,NaN,NaN,0.939809969824201,41.722001219560354,11906492,-0.09950800165169083,-0.8586185919573381,-0.7591105903056473
2025-08-20T12:00:00-04:00,504.82,505.66,504.76,505.3,NaN,NaN,NaN,507.5393180730829,NaN,NaN,507.8849000000011,511.08861439983906,504.68118560016313,505.0233026375787,507.13784574375495,508.5650152531677,505.7106762343422,18207,27439.566666666666,39.8712808034577,36.59906233738253,NaN,NaN,NaN,NaN,0.9369664005510462,41.08306511267131,11924699,-0.05993890145262415,-0.8340342171214274,-0.7740953156688033
2025-08-20T12:05:00-04:00,505.25,505.65,504.99,505.48,NaN,NaN,NaN,507.5393180730829,NaN,NaN,507.78090000000105,510.95236634157294,504.60943365842917,505.0233026375787,507.10822543464883,508.541407041964,505.67504382733364,15528,27223.4,41.5116537217424,36.7671274226361,NaN,NaN,NaN,NaN,0.9171830862259692,40.48976729913148,11940227,-0.01345120105186104,-0.7909093169836297,-0.7774581159317686
2025-08-20T12:10:00-04:00,505.43,505.85,505.28,505.51,NaN,NaN,NaN,507.5393180730829,NaN,NaN,507.6887000000011,510.8508263788094,504.5265736211928,505.0233026375787,507.08792950277433,508.5227097854691,505.65314922007957,12181,26551.2,41.79665187029047,37.14985925761572,NaN,NaN,NaN,NaN,0.8923842943526893,39.5327598910435,11952408,0.02539399028291045,-0.7457156280781305,-0.771109618361041
2025-08-20T12:15:00-04:00,505.49,505.75,505.21,505.67,NaN,NaN,NaN,507.5393180730829,NaN,NaN,507.6061000000011,510.75906006247476,504.45313993752745,505.0233026375787,507.06518614965296,508.5014642537557,505.6289080455502,14006,25743.933333333334,43.38124022468461,37.68742891121111,NaN,NaN,NaN,NaN,0.867213987613213,38.72682327890023,11966414,0.06565109413245651,-0.6890457506954704,-0.7546968448279269
2025-08-20T12:20:00-04:00,505.69,506.09,505.63,506,NaN,NaN,NaN,507.5393180730829,NaN,NaN,507.53690000000114,510.675914424231,504.3978855757713,504.843642110063,507.04773080944113,508.4801172618328,505.6153443570495,14551,24772.2,46.6097989384025,38.479658472649874,NaN,NaN,NaN,NaN,0.8381272742122677,37.27577149693439,11980965,0.11538218421308755,-0.6104691145615675,-0.725851298774655
2025-08-20T12:25:00-04:00,506,506.29,505.89,506.085,NaN,NaN,NaN,507.5393180730829,NaN,NaN,507.465800000001,510.5719212847901,504.35967871521194,504.6975975546062,507.03619558367706,508.46377954230564,505.60861162504847,11753,23852.8,47.4411488778054,39.361231973747884,NaN,NaN,NaN,NaN,0.8068324689113939,35.5364187583643,11992718,0.15254609243046224,-0.5351686832365772,-0.6877147756670394
2025-08-20T12:30:00-04:00,506.08,506.41,505.35,505.35,NaN,NaN,NaN,507.5393180730829,NaN,NaN,507.3788000000011,510.47339371090254,504.28420628909964,504.6975975546062,507.0113771283506,508.4370388147483,505.5857154419529,18547,23424.633333333335,41.4332283001918,39.78661540469153,NaN,NaN,NaN,NaN,0.8249158639891517,34.659850285914395,11974171,0.12720677331150776,-0.5287063090276547,-0.6559130823391625
2025-08-20T12:35:00-04:00,505.4,505.8,504.79,505.74,NaN,NaN,NaN,507.5393180730829,NaN,NaN,507.299800000001,510.3557888474844,504.24381115251765,504.6975975546062,506.98643179744175,508.4142518151838,505.55861177969973,16102,23295.966666666667,45.38543300773031,40.648831796553004,NaN,NaN,NaN,NaN,0.8381361594184974,34.48765892792867,11990273,0.13552491299350988,-0.4865069410972751,-0.622031854090785
2025-08-20T12:40:00-04:00,505.78,505.92,505.31,505.36,NaN,NaN,NaN,507.5393180730829,NaN,NaN,507.224000000001,510.28067335445985,504.1673266455422,504.6975975546062,506.96880072818124,508.3968617040998,505.54073975226265,12403,22782.233333333334,42.38422520431031,40.56985051481839,NaN,NaN,NaN,NaN,0.8218407194600343,34.07924114868944,11977870,0.11505435534123154,-0.4782139099142455,-0.593268265255477
2025-08-20T12:45:00-04:00,505.36,505.5,505.09,505.21,NaN,NaN,NaN,507.5393180730829,NaN,NaN,507.149200000001,510.21629005998636,504.0821099400156,504.6975975546062,506.9533816780925,508.3840779583813,505.52268539780374,9366,22459.333333333332,41.22535101134373,40.73097285149644,NaN,NaN,NaN,NaN,0.7924235252128907,33.9512288235392,11968504,0.09202853091684537,-0.47823260160942027,-0.5702611325262656
2025-08-20T12:50:00-04:00,505.21,506.055,505.15,506.05,NaN,NaN,NaN,507.5393180730829,NaN,NaN,507.090200000001,510.12594370391747,504.05445629608454,504.6975975546062,506.9370511248792,508.36478844460856,505.5093138051498,14244,21529.7,49.54506513043253,41.90541893189769,NaN,NaN,NaN,NaN,0.8004647019834007,32.714690457470844,11982748,0.13157790209017706,-0.4057887549135444,-0.5373666570037214
2025-08-20T12:55:00-04:00,505.96,505.96,504.96,505.12,NaN,NaN,NaN,507.5393180730829,NaN,NaN,507.012200000001,510.04601090974217,503.9783890902598,504.6975975546062,506.9132630932155,508.3433716239185,505.48315456251254,15916,21206.2,42.39061272184447,42.179344279711415,NaN,NaN,NaN,NaN,0.8211457946988744,31.815283602328115,11966832,0.09501779258049958,-0.418594416278097,-0.5136122088585966
2025-08-20T13:00:00-04:00,505.08,505.755,505.05,505.755,NaN,NaN,NaN,507.5393180730829,NaN,NaN,506.9527000000009,509.96604114167883,503.939358858323,504.6975975546062,506.89487947719726,508.3243898250752,505.46536912931936,14228,21088.1,47.92052282490644,43.30571827540647,NaN,NaN,NaN,NaN,0.8128496665060965,30.980120093981288,11981060,0.11232835552272624,-0.3732017644551888,-0.48553011997791506
2025-08-20T13:05:00-04:00,505.71,505.82,505.09,505.795,NaN,NaN,NaN,507.5393180730829,NaN,NaN,506.8886000000009,509.8610898917,503.91611010830184,504.6975975546062,506.880745363536,508.30912783596153,505.45236289111045,11613,20919.233333333334,48.25745582084074,44.225262032713026,NaN,NaN,NaN,NaN,0.8069318331842338,30.06467882156338,11992673,0.12426903498031167,-0.33019382625252547,-0.45446286123283713
2025-08-20T13:10:00-04:00,505.78,506.27,505.71,506,NaN,NaN,NaN,507.5393180730829,NaN,NaN,506.82460000000094,509.73236122746533,503.91683877253655,504.6975975546062,506.86889003551846,508.2913525297615,505.4464275412754,14758,20731.366666666665,50.04133844654171,44.95169472150474,NaN,NaN,NaN,NaN,0.7892938450996458,28.299616140193507,12007431,0.1424647056155519,-0.27638197921339724,-0.41884668482894916
2025-08-20T13:15:00-04:00,506.04,506.27,505.61,505.92,NaN,NaN,NaN,507.5393180730829,NaN,NaN,506.7662000000009,509.6266108509664,503.90578914903534,504.606078043685,506.85780329506343,508.2754318678284,505.4401747222985,13248,20436.1,49.326643242387384,45.50990825869366,NaN,NaN,NaN,NaN,0.7800585704496689,26.831588568467584,11994183,0.14511429635025463,-0.2374538143911309,-0.3825681107413855
2025-08-20T13:20:00-04:00,505.93,506.5,505.86,505.9,NaN,NaN,NaN,507.5393180730829,NaN,NaN,506.7024000000009,509.4941179220099,503.91068207799196,504.7526935173873,506.8466469783764,508.25699257667947,505.4363013800733,16411,20308.7,49.137699955204894,46.03426883618755,NaN,NaN,NaN,NaN,0.7700543868461202,25.01476785315405,11977772,0.14137932445042667,-0.2058439551783522,-0.34722327962877886
2025-08-20T13:25:00-04:00,505.9,506.12,505.81,505.92,NaN,NaN,NaN,507.5393180730829,NaN,NaN,506.6462000000009,509.38501986197485,503.9073801380269,504.7526935173873,506.8412594107563,508.24906796630427,505.4334508552084,6857,20162.666666666668,49.34665014021788,46.46036954443993,NaN,NaN,NaN,NaN,0.7371933592142546,23.42359070726215,11984629,0.1360689002537473,-0.1771371543115947,-0.313206054565342
2025-08-20T13:30:00-04:00,505.93,506.5,505.85,506.32,NaN,NaN,NaN,507.5393180730829,NaN,NaN,506.586200000001,509.21741839381735,503.9549816061846,504.9327238511279,506.8328568530932,508.23289123625557,505.4328224699308,15732,19994.933333333334,53.464285022554854,46.949975693307955,NaN,NaN,NaN,NaN,0.7309652621275206,22.290496663657734,12000361,0.15398997799356973,-0.12071858207337982,-0.27470856006694955
2025-08-20T13:35:00-04:00,506.31,506.81,506.26,506.49,NaN,NaN,NaN,507.5393180730829,NaN,NaN,506.51780000000093,508.9716795072218,504.0639204927801,505.2811790809023,506.82846136496056,508.2191136232494,505.4378091066717,16486,18829.233333333334,55.13358595433448,47.49943548448861,NaN,NaN,NaN,NaN,0.7180391719755557,21.772757676930187,12016847,0.17050362158299343,-0.06157903308820778,-0.2320826546712012
2025-08-20T13:40:00-04:00,506.44,506.5,506.3,506.45,NaN,NaN,NaN,507.5393180730829,NaN,NaN,506.480600000001,508.8804746958651,504.08072530413693,505.2811790809023,506.8252855193464,508.2110332137964,505.4395378248964,9120,18181.6,54.63695873885937,48.44255908725057,NaN,NaN,NaN,NaN,0.6810363739773008,21.29200004639746,12007727,0.17147911858436254,-0.01773375644074804,-0.18921287502511058
2025-08-20T13:45:00-04:00,506.48,507.61,506.48,507.61,504.7750038087077,504.7750038087077,504.7750038087077,NaN,NaN,NaN,506.442000000001,508.7017982201867,504.1822017798153,505.9715546117775,506.83306019582307,508.20667607682907,505.45944431481706,22969,18188.3,64.59656836538869,49.81478304136903,NaN,NaN,NaN,NaN,0.7152480615503525,22.372148051584546,12030696,0.23885483014690084,0.10935566265851548,-0.12949916748838536
2025-08-20T13:50:00-04:00,507.58,507.58,507.23,507.28,505.1863672719482,NaN,NaN,NaN,NaN,NaN,506.38760000000104,508.4218765189652,504.3533234810369,506.07924368942196,506.8419672431535,508.20570157198586,505.4782329143211,20595,18133.8,60.52540533826554,51.11058162236583,NaN,NaN,NaN,NaN,0.6913017714396127,23.375142627829693,12010101,0.24868424611562037,0.1813561401561401,-0.06732810595948027
2025-08-20T13:55:00-04:00,507.3,507.33,506.43,506.7,505.1863672719482,NaN,NaN,NaN,NaN,NaN,506.31620000000106,508.0249580974175,504.60744190258464,506.07924368942196,506.84168848333366,508.1967446622906,505.4866323043767,15759,17631.133333333335,54.07477035568055,52.028397289818464,NaN,NaN,NaN,NaN,0.706208787765353,22.613617539748983,11994342,0.20540826698071807,0.18943222776641733,-0.015976039214300755
2025-08-20T14:00:00-04:00,506.71,506.71,505.38,505.95,505.1863672719482,NaN,NaN,NaN,NaN,NaN,506.28160000000105,507.9480326435587,504.6151673564434,506.07924368942196,506.8307170968103,508.1800966976076,505.481337496013,16669,17335.033333333333,47.086367927865055,51.85277606106364,NaN,NaN,NaN,NaN,0.7507653029249696,21.67752967961621,11977673,0.11979828351454055,0.13377181517887493,0.01397353166433438
2025-08-20T14:05:00-04:00,505.99,506.1,505.73,505.965,505.1863672719482,NaN,NaN,NaN,NaN,NaN,506.267500000001,507.9324783769449,504.6025216230571,506.07924368942196,506.8187347668256,508.1630512934142,505.47441824023707,17000,17195.7,47.233246444045385,52.198678469792284,NaN,NaN,NaN,NaN,0.7235677812874721,20.80830523806435,11994673,0.06068945137619683,0.08983534588458042,0.02914589450838359
2025-08-20T14:10:00-04:00,505.98,505.98,504.9,505.22,NaN,NaN,NaN,507.74935024752506,507.74935024752506,507.74935024752506,506.2271000000011,507.89375663991785,504.5604433600843,506.07924368942196,506.7888731067369,508.13516123327935,505.44258498019445,26782,17118.666666666668,41.127084431551076,51.7134328702669,NaN,NaN,NaN,NaN,0.749027225481227,20.990613341381128,11967891,-0.027350137906360338,-0.005041777874566833,0.022308360031793505
2025-08-20T14:15:00-04:00,505.19,505.63,504.95,505.18,NaN,NaN,NaN,507.5871070544557,NaN,NaN,506.17490000000106,507.8055887978241,504.544211202178,506.07924368942196,506.7671959320587,508.1161663118783,505.4182255522391,18648,16416.866666666665,40.82194200897085,51.18232474084762,NaN,NaN,NaN,NaN,0.7440967093754256,21.15989943731814,11949243,-0.08385399504823568,-0.08250913377850111,0.0013448612697345777
2025-08-20T14:20:00-04:00,505.19,505.83,504.87,505.78,NaN,NaN,NaN,507.5871070544557,NaN,NaN,506.147100000001,507.75623403908304,504.53796596091894,506.07924368942196,506.74648094515015,508.09410423348646,505.39885765681385,21836,15753.466666666667,47.15553452674508,50.97619588943358,NaN,NaN,NaN,NaN,0.7595183729914652,20.955609887890816,11971079,-0.07659541561343304,-0.09439940824705673,-0.017803992633623682
2025-08-20T14:25:00-04:00,505.72,505.81,505.37,505.4,NaN,NaN,NaN,507.5871070544557,NaN,NaN,506.097300000001,507.6403582735803,504.55424172642165,506.07924368942196,506.73284273772896,508.0790350415831,505.3866504338748,15183,15556.6,43.94748911989925,50.59197059497014,NaN,NaN,NaN,NaN,0.7366956320635032,20.765912449136874,11955896,-0.092119017039744,-0.13295276393330369,-0.04083374689355969
2025-08-20T14:30:00-04:00,505.4,505.45,505.11,505.2,NaN,NaN,NaN,507.5008028203714,NaN,NaN,506.057500000001,507.58837719804274,504.5266228019593,506.07924368942196,506.713804735196,508.0616618311446,505.3659476392474,17702,15539.766666666666,42.315785330016645,50.10469097888527,NaN,NaN,NaN,NaN,0.7083602297732512,20.929690468806932,11938194,-0.10941113786652312,-0.1775976692267136,-0.06818653136019048
2025-08-20T14:35:00-04:00,505.18,505.71,504.87,505.265,NaN,NaN,NaN,507.5008028203714,NaN,NaN,506.014200000001,507.5094021387585,504.51899786124346,506.07924368942196,506.69430360836753,508.04320274512327,505.3454044716118,18991,15655.2,43.05577387103599,49.655342673943714,NaN,NaN,NaN,NaN,0.7177630705037314,20.562927521660317,11957185,-0.10974419981749284,-0.20536678113205653,-0.09562258131456369
2025-08-20T14:40:00-04:00,505.31,505.415,505.1,505.2,NaN,NaN,NaN,507.43329347889215,NaN,NaN,505.970600000001,507.4306775854701,504.5105224145319,505.6793949515376,506.6816768428774,508.0314819946816,505.33187169107316,12201,15655.866666666667,42.46906135093814,48.86996955454252,NaN,NaN,NaN,NaN,0.6889942797534648,20.222361927881323,11944984,-0.107476359624793,-0.22996803084555495,-0.12249167122076195
2025-08-20T14:45:00-04:00,505.24,505.57,505.15,505.36,NaN,NaN,NaN,507.43329347889215,NaN,NaN,505.922000000001,507.2958224033126,504.54817759668936,504.72451596123005,506.6638476797787,508.0131594996348,505.3145358599226,19238,15830.266666666666,44.474804698990496,48.108628036303664,NaN,NaN,NaN,NaN,0.6697804026282185,19.58180634566803,11964222,-0.08909327356386343,-0.23385826317559122,-0.1447649896117278
2025-08-20T14:50:00-04:00,505.34,505.61,505.01,505.3,NaN,NaN,NaN,507.428977116098,NaN,NaN,505.8762000000009,507.17518815858745,504.57721184141434,504.3266127689841,506.645275729073,507.99456773417296,505.295983723973,19786,16004.766666666666,43.857311950655,47.33865326571764,NaN,NaN,NaN,NaN,0.6647960881547759,19.21989398148139,11944436,-0.07540995979250215,-0.2390274393523555,-0.16361747955985334
2025-08-20T14:55:00-04:00,505.29,505.44,504.83,504.86,NaN,NaN,NaN,507.240841792639,NaN,NaN,505.8274000000009,507.0916313696629,504.56316863033896,504.1586891405888,506.6220583497596,507.9751498066592,505.26896689285996,21264,16321.8,39.523596625414086,45.54772671286231,NaN,NaN,NaN,NaN,0.6608820818580072,19.179411424522936,11923172,-0.08946851185954202,-0.27545311938428085,-0.18598460752473883
2025-08-20T15:00:00-04:00,504.885,505.06,504.78,504.99,NaN,NaN,NaN,506.96830352933716,NaN,NaN,505.78720000000095,507.0273276691793,504.54707233082263,504.1586891405888,506.60527203978273,507.9619027078431,505.2486413717224,14819,16197.533333333333,41.36706364966923,44.179273735105426,NaN,NaN,NaN,NaN,0.6336762188681516,19.224760253451866,11937991,-0.08359817024261712,-0.29048232032801025,-0.20688415008539313
2025-08-20T15:05:00-04:00,504.99,505.9,504.89,505.9,NaN,NaN,NaN,506.96830352933716,NaN,NaN,505.769000000001,506.97478604893706,504.5632139510649,504.3447288399814,506.58925310866067,507.9415051512924,505.23700106602894,23140,16432.133333333335,52.32282690028052,44.054134916862566,NaN,NaN,NaN,NaN,0.6605564889489973,18.192791869095622,11961131,-0.01557620224129469,-0.22635440288701147,-0.21077820064571678
2025-08-20T15:10:00-04:00,505.87,506.77,505.68,506.63,NaN,NaN,NaN,506.96830352933716,NaN,NaN,505.774600000001,506.9936551077888,504.55554489221316,504.9807830719852,506.58586747433804,507.9283821092033,505.2433528394728,22561,16770.733333333334,58.949369280247865,44.90149215631849,NaN,NaN,NaN,NaN,0.6912310254526386,18.50156600777235,11983692,0.0763836989655235,-0.1152985769388124,-0.1916822759043359
2025-08-20T15:15:00-04:00,506.61,506.76,506.35,506.66,NaN,NaN,NaN,506.96830352933716,NaN,NaN,505.78280000000103,507.0199178746055,504.5456821253966,505.12362645758816,506.5859398336024,507.9166491623538,505.25523050485106,27226,17366.066666666666,59.20033600745541,45.75628426799063,NaN,NaN,NaN,NaN,0.6711430950631622,18.78828485082931,12010918,0.13368028439982277,-0.024581920404557422,-0.1582622048043802
2025-08-20T15:20:00-04:00,506.69,507.47,506.54,507.23,504.8690797730302,504.8690797730302,504.8690797730302,NaN,NaN,NaN,505.803500000001,507.10069119479533,504.5063088052067,505.69590116607054,506.59244336891015,507.9155641089465,505.2693226288738,20741,17582.633333333335,63.73664453388904,47.37125284672906,NaN,NaN,NaN,NaN,0.6896328739872225,19.884080451413478,12031659,0.20040384741396902,0.09224260446308108,-0.10816124295088794
2025-08-20T15:25:00-04:00,507.21,507.21,506.63,507.01,504.8690797730302,NaN,NaN,NaN,NaN,NaN,505.821100000001,507.1587805133543,504.48341948664773,505.69590116607054,506.59580091291247,507.91314624168757,505.27845558413736,14936,17549.966666666667,60.921200124512644,48.80691414069632,NaN,NaN,NaN,NaN,0.6832305258452797,20.901604937670207,12016723,0.21866558259386235,0.16517073529144,-0.053494847302422356
2025-08-20T15:30:00-04:00,506.965,507.41,506.75,506.77,504.9657421072445,NaN,NaN,NaN,NaN,NaN,505.83330000000103,507.194049218533,504.47255078146907,505.7045767462851,506.5994392214346,507.9110006519404,505.28787779092875,15341,17587.066666666666,57.915630495361334,49.57549242416891,NaN,NaN,NaN,NaN,0.6815712025706187,22.066084698597184,12001382,0.2038203362439999,0.2012805730025775,-0.0025397632414223756
2025-08-20T15:35:00-04:00,506.75,506.88,506.2,506.21,504.9657421072445,NaN,NaN,NaN,NaN,NaN,505.84050000000104,507.20533002444773,504.47566997555435,505.7045767462851,506.59770704122917,507.9026585027627,505.29275557969567,16587,17752.866666666665,51.527694927431476,50.116935696135506,NaN,NaN,NaN,NaN,0.681458973815575,21.957078116355706,11984795,0.14811628740789598,0.1826055960184476,0.034489308610551626
2025-08-20T15:40:00-04:00,506.22,506.59,506.14,506.56,504.9657421072445,NaN,NaN,NaN,NaN,NaN,505.837700000001,507.1960242749147,504.4793757250873,505.7045767462851,506.59609037494783,507.89484023168285,505.2973405182128,15793,17787.366666666665,54.87752194828711,51.01420259744054,NaN,NaN,NaN,NaN,0.6649261899716045,21.734730076797966,12000588,0.12745931812068634,0.19381345626140956,0.06635413814072322
2025-08-20T15:45:00-04:00,506.57,506.96,506.53,506.94,504.9657421072445,NaN,NaN,NaN,NaN,NaN,505.854500000001,507.2457645312482,504.4632354687538,505.7045767462851,506.59891386212206,507.8892948209545,505.30853290328963,21914,18076.233333333334,58.2509793929934,52.09957442043749,NaN,NaN,NaN,NaN,0.648145747830776,22.023573646915825,12022502,0.13147607613025308,0.23069923330353959,0.0992231571732865
2025-08-20T15:50:00-04:00,506.96,507.05,505.94,506.59,504.9657421072445,NaN,NaN,NaN,NaN,NaN,505.883300000001,507.27465561083073,504.49194438917124,505.7045767462851,506.5973476781712,507.8737088478909,505.32098650845154,36788,18755.466666666667,54.229489850485876,52.93960502754805,NaN,NaN,NaN,NaN,0.6811353372714359,21.14221030510418,11985714,0.10386072814832067,0.22904906735868735,0.12518833921036668
2025-08-20T15:55:00-04:00,506.55,506.55,505.2,505.51,504.9657421072445,NaN,NaN,NaN,NaN,NaN,505.88010000000105,507.2741365689303,504.4860634310718,505.7045767462851,506.54238021575605,507.79392836077125,505.29083207074086,118219,22467.533333333333,44.10995176218413,52.91354410349045,NaN,NaN,NaN,NaN,0.7317685274663324,20.094832160902023,11867495,0.011043016924885296,0.1389921103664733,0.127949093441588
2025-08-21T09:30:00-04:00,503.7,504.82,502.77,504.25,NaN,NaN,NaN,506.26223712480186,506.26223712480186,506.26223712480186,505.875300000001,507.2899496512232,504.4606503487788,505.7045767462851,503.94666666666666,503.94666666666666,503.94666666666666,34898,23106.4,35.73237327094239,52.33319134065383,NaN,NaN,NaN,NaN,0.8752136326473092,21.41082376321211,11832597,-0.12928896335883033,-0.033662110756949915,0.09562685260188042
2025-08-21T09:35:00-04:00,504.23,505.43,503.45,505.1,NaN,NaN,NaN,506.26223712480186,NaN,NaN,505.88090000000096,507.2809366979817,504.4808633020202,505.7045767462851,504.2410094141673,504.59218862787606,503.88983020045856,24516,23374.066666666666,43.524800581415185,52.61899162322534,NaN,NaN,NaN,NaN,0.9541269446010742,21.794126593395248,11857113,-0.1570955863359007,-0.10074263031799546,0.05635295601790524
2025-08-21T09:40:00-04:00,505.07,505.07,504.23,504.49,NaN,NaN,NaN,506.26223712480186,NaN,NaN,505.86470000000094,507.30928493545815,504.4201150645437,505.7045767462851,504.30962281750345,504.65491932694493,503.96432630806197,14202,23543.466666666667,39.79563608706758,52.50674679732523,NaN,NaN,NaN,NaN,0.9481178771295692,22.150050649993876,11842911,-0.20573156276217475,-0.2008114974348132,0.004920065327361556
2025-08-21T09:45:00-04:00,504.62,504.68,502.92,504.65,NaN,NaN,NaN,506.26223712480186,NaN,NaN,505.8481000000009,507.32861462532605,504.36758537467574,505.7045767462851,504.2449755800941,504.55419624146833,503.93575491871985,29442,23759.233333333334,41.218266123669,51.71356388471012,NaN,NaN,NaN,NaN,1.0061094573345992,23.39227496052862,11872353,-0.21526489116102426,-0.26416104862391876,-0.04889615746289451
2025-08-21T09:50:00-04:00,504.66,504.67,503.5,504.3,NaN,NaN,NaN,506.26223712480186,NaN,NaN,505.82390000000095,507.3640834811476,504.2837165188543,505.47422329409795,504.2278383760971,504.50762688776683,503.9480498644274,24815,23899.9,39.04476646509081,50.29180654077033,NaN,NaN,NaN,NaN,1.0178159246678433,24.54576896316803,11847538,-0.23184606080920728,-0.33870373347440363,-0.10685767266519634
2025-08-21T09:55:00-04:00,504.31,504.37,503.17,503.2,NaN,NaN,NaN,506.26223712480186,NaN,NaN,505.7745000000009,507.48075232478243,504.06824767521937,505.47422329409795,504.1568994941863,504.4895168567517,503.82428213162086,15724,23898.733333333334,33.131582834081655,48.4297527426722,NaN,NaN,NaN,NaN,1.0308290729058538,25.82614422352328,11831814,-0.29931029229403794,-0.48099553803274375,-0.18168524573870581
2025-08-21T10:00:00-04:00,503.2,505.11,502.94,504.9,NaN,NaN,NaN,506.26223712480186,NaN,NaN,505.75250000000096,507.4748452021795,504.03015479782243,505.47422329409795,504.17881674557964,504.4926296135873,503.86500387757195,22831,24104.133333333335,46.59316973369432,47.20521882837259,NaN,NaN,NaN,NaN,1.1121984248411512,25.948908913417128,11854645,-0.2157588072857492,-0.4513837548458923,-0.23562494756014313
2025-08-21T10:05:00-04:00,504.93,505.88,504.76,505.75,NaN,NaN,NaN,506.26223712480186,NaN,NaN,505.74580000000094,507.46552365097574,504.02607634902614,505.3063786352784,504.3124836974271,504.80448104766083,503.8204863471934,19330,24181.8,51.81629123692136,46.554868193544635,NaN,NaN,NaN,NaN,1.1127556802096408,25.105728046461955,11873975,-0.09568676002628301,-0.3552333975929969,-0.25954663756671387
2025-08-21T10:10:00-04:00,505.79,506.75,505.67,506.485,503.197124626399,503.197124626399,503.197124626399,NaN,NaN,NaN,505.7685000000009,507.49666926131516,504.0403307386867,504.4601029082227,504.53065867211143,505.3064818186508,503.75483552557205,22884,24051.866666666665,55.838208272432716,46.40648089190688,NaN,NaN,NaN,NaN,1.1104159887660938,23.398610497985757,11896859,0.03386035114687008,-0.21722119863312628,-0.25108154977999636
2025-08-21T10:15:00-04:00,506.56,507.3,506.14,507.25,503.6858916888354,NaN,NaN,NaN,NaN,NaN,505.7987000000009,507.57590095534493,504.0214990446569,504.0403406507103,504.83379782311334,505.90623460839333,503.76136103783335,30660,24452.266666666666,59.6165010396903,46.98425275706823,NaN,NaN,NaN,NaN,1.1139577038542317,22.159031116622906,11927519,0.16439253050948505,-0.04559088664314004,-0.20998341715262508
2025-08-21T10:20:00-04:00,507.17,507.54,506.71,506.91,504.1156238847974,NaN,NaN,NaN,NaN,NaN,505.8297000000009,507.62914481317176,504.03025518683006,504.5172725205682,504.9710302802204,506.13926356180883,503.802796998632,15771,24250.1,57.27125823861911,47.15523392066336,NaN,NaN,NaN,NaN,1.0936750107217894,21.226574491855747,11911748,0.21780621664421207,0.06227435365264,-0.15553186299157207
2025-08-21T10:25:00-04:00,506.98,507.6,506.46,507.47,504.1156238847974,NaN,NaN,NaN,NaN,NaN,505.8749000000009,507.72269705481233,504.0271029451894,504.61181801645455,505.0629466433728,506.28858113034033,503.8373121564053,11092,24113.733333333334,60.05828914671959,47.284327474500955,NaN,NaN,NaN,NaN,1.096983938527379,20.086019287814256,11922840,0.27702296457861647,0.1907468427316985,-0.08627612184691795
2025-08-21T10:30:00-04:00,507.47,507.55,506.54,506.79,504.1156238847974,NaN,NaN,NaN,NaN,NaN,505.88970000000086,507.7546444055422,504.0247555944595,504.65445441316365,505.1169168865901,506.3654821647108,503.8683516084694,7794,23783.466666666667,55.3381791965171,47.363519570646034,NaN,NaN,NaN,NaN,1.090770800061137,19.02693231263287,11915046,0.25700742494107925,0.23498315932943115,-0.022024265611648122
2025-08-21T10:35:00-04:00,506.78,507.23,506.28,506.35,504.1156238847974,NaN,NaN,NaN,NaN,NaN,505.9143000000009,507.7704120752264,504.0581879247754,504.65445441316365,505.17787424251446,506.4362866570863,503.9194618279426,11580,23536.433333333334,52.46490861300258,47.96030220284735,NaN,NaN,NaN,NaN,1.080715742913916,17.736876103870127,11903466,0.20311033750739385,0.2318636562725942,0.02875331876520034
2025-08-21T10:40:00-04:00,506.29,506.59,506.08,506.54,504.1156238847974,NaN,NaN,NaN,NaN,NaN,505.93000000000086,507.79372100803477,504.06627899196695,504.65445441316365,505.2163472911027,506.47314954594634,503.95954503625904,9255,23438.233333333334,53.585610017029815,49.23553339899645,NaN,NaN,NaN,NaN,1.0399503327057784,16.636628327056503,11912721,0.1705445253547258,0.24193397545860762,0.0713894501038818
2025-08-21T10:45:00-04:00,506.54,506.88,506.16,506.41,504.1156238847974,NaN,NaN,NaN,NaN,NaN,505.9423000000009,507.8104072869521,504.0741927130497,504.65445441316365,505.2548082436745,506.5113323664021,503.99828412094695,9229,23104.6,52.670615666882505,49.88880590510126,NaN,NaN,NaN,NaN,1.0170967375125064,15.636525741515026,11903492,0.13224553908562295,0.23669637396091048,0.10445083487528753
2025-08-21T10:50:00-04:00,506.47,507.21,506.46,507.18,504.1156238847974,NaN,NaN,NaN,NaN,NaN,505.9659000000009,507.8658691459795,504.06593085402227,504.92958452763185,505.302232183298,506.5722035287784,504.03226083781755,8750,22736.733333333334,57.31933635767719,51.14049878157338,NaN,NaN,NaN,NaN,1.0015898276901811,15.098421222997516,11912242,0.14949528959852462,0.2913199468734433,0.1418246572749187
2025-08-21T10:55:00-04:00,507.25,507.25,506.63,506.73,504.1156238847974,NaN,NaN,NaN,NaN,NaN,505.9821000000009,507.89400281015696,504.07019718984486,505.1156676221055,505.33418846303624,506.6105235688793,504.0578533571932,6508,22244.866666666665,53.98230350192936,52.0522157371634,NaN,NaN,NaN,NaN,0.9743334114265971,14.646521929011215,11905734,0.12245937188045414,0.2948988721254864,0.17243950024503224
2025-08-21T11:00:00-04:00,506.74,507.45,506.61,506.68,504.1989363230779,NaN,NaN,NaN,NaN,NaN,505.997700000001,507.9193724057951,504.07602759420683,505.32253409768435,505.4145002759702,506.7054520086204,504.12354854332006,17108,22321.166666666668,53.60884875507594,53.09250732930519,NaN,NaN,NaN,NaN,0.9647381677532669,14.472619300275369,11888626,0.09433127860021498,0.29035359849530096,0.19602231989508598
2025-08-21T11:05:00-04:00,506.67,506.67,506.17,506.37,504.1989363230779,NaN,NaN,NaN,NaN,NaN,506.00670000000093,507.931045716177,504.0823542838249,505.32253409768435,505.4384622167818,506.72270972390794,504.1542147096556,8354,21828.3,51.24190357688284,54.386101668076705,NaN,NaN,NaN,NaN,0.9322568700566044,13.653796521633035,11880272,0.05018555930803903,0.25875426903013476,0.20856870972209574
2025-08-21T11:10:00-04:00,506.43,506.46,505.56,505.68,504.1989363230779,NaN,NaN,NaN,NaN,NaN,505.993900000001,507.91825369800983,504.0695463019922,505.32253409768435,505.4542271842213,506.71913176842037,504.1893226000222,12192,21482.666666666668,46.33780433777688,54.36786128265403,NaN,NaN,NaN,NaN,0.9299528079097025,13.266236633524425,11868080,-0.02605060139475901,0.17600545797864697,0.20205605937340598
2025-08-21T11:15:00-04:00,505.62,506.17,505.47,506.03,504.1989363230779,NaN,NaN,NaN,NaN,NaN,505.98470000000106,507.9038700380337,504.0655299619684,505.32253409768435,505.46450761710156,506.7161514212227,504.2128638129804,8624,20862.6,49.00389339501688,54.16697572251799,NaN,NaN,NaN,NaN,0.9135276073447229,13.018044278676525,11876704,-0.05197425859967203,0.13708823612381593,0.18906249472348796
2025-08-21T11:20:00-04:00,506.03,506.91,505.76,506.88,504.1989363230779,NaN,NaN,NaN,NaN,NaN,505.99330000000094,507.9245489314837,504.0620510685182,505.32253409768435,505.4832669434034,506.73149224205275,504.23504164475406,6636,20392.433333333334,54.8682927946282,54.09769604553196,NaN,NaN,NaN,NaN,0.930418492534388,12.416809185381585,11883340,-0.012976760622360362,0.17284154394553752,0.18581830456789789
2025-08-21T11:25:00-04:00,506.85,506.96,506.54,506.67,504.1989363230779,NaN,NaN,NaN,NaN,NaN,505.97450000000106,507.8601948307846,504.0888051692175,505.32253409768435,505.49948431165103,506.74749788953886,504.2514707337632,4932,20058.966666666667,53.23935551652925,53.642185651020455,NaN,NaN,NaN,NaN,0.8939600287819288,11.922903487053961,11878408,-0.0029494005772637555,0.18213155384631818,0.18508095442358194
2025-08-21T11:30:00-04:00,506.7,507.11,506.43,506.95,504.1989363230779,NaN,NaN,NaN,NaN,NaN,505.967900000001,507.8375128890803,504.0982871109217,505.32253409768435,505.51742949594933,506.7664631579808,504.26839583391785,5156,19719.466666666667,55.15121942110302,53.49075430691216,NaN,NaN,NaN,NaN,0.8786771695832201,11.664217972160547,11883564,0.01967176502499879,0.20967066070483042,0.18999889567983164
2025-08-21T11:35:00-04:00,506.91,507.1,506.56,506.62,504.2059512411253,NaN,NaN,NaN,NaN,NaN,505.966300000001,507.83353946910375,504.09906053089827,505.3253753428027,505.54297136093214,506.7916112934971,504.2943314283672,8023,19434,52.43039684513537,52.945904856799004,NaN,NaN,NaN,NaN,0.8544859431844201,11.424009994045235,11875541,0.010027034226860188,0.20253268846340688,0.1925056542365467
2025-08-21T11:40:00-04:00,506.65,507.03,506.56,506.88,504.2261352756196,NaN,NaN,NaN,NaN,NaN,505.984900000001,507.86956600617555,504.10023399382646,505.37530027424214,505.5564353933961,506.8053405267805,504.3075302600117,4148,19045.833333333332,54.34161279621861,52.87472154249196,NaN,NaN,NaN,NaN,0.827022661528388,11.200959728652446,11879689,0.018293825398070618,0.21537293598413498,0.19707911058606437
2025-08-21T11:45:00-04:00,506.88,506.94,506.41,506.43,504.2261352756196,NaN,NaN,NaN,NaN,NaN,505.994200000001,507.8829661143735,504.1054338856285,505.37530027424214,505.5778467665249,506.8225550548965,504.3331384781533,8317,18592.6,50.55567077169146,52.73834741096975,NaN,NaN,NaN,NaN,0.8058067571335013,10.717853322353003,11871372,-0.007998383956741184,0.18708113064013787,0.19507951459687906
2025-08-21T11:50:00-04:00,506.55,506.55,505.92,506.045,504.2261352756196,NaN,NaN,NaN,NaN,NaN,506.010700000001,507.8864942410912,504.1349057589108,505.37530027424214,505.5872877481809,506.8242937923421,504.3502817040198,6507,17583.233333333334,47.50619899506387,52.30410376654361,NaN,NaN,NaN,NaN,0.7932491316239652,10.46719722157374,11864865,-0.050406846178869424,0.1320709568732923,0.1824778030521617
2025-08-21T11:55:00-04:00,506.04,506.52,505.98,506.52,504.2261352756196,NaN,NaN,NaN,NaN,NaN,506.03750000000105,507.90331804972817,504.1716819502739,505.37530027424214,505.6014708681539,506.83103413456456,504.37190760174326,7860,13904.6,51.401119265544615,52.21342545216233,NaN,NaN,NaN,NaN,0.7751599079365364,10.234445127992995,11872725,-0.04569546352626869,0.12535847364432584,0.17105393717059453
2025-08-21T12:00:00-04:00,506.57,506.76,506.12,506.19,504.2261352756196,NaN,NaN,NaN,NaN,NaN,506.04570000000103,507.9105227890709,504.18087721093116,505.37530027424214,505.6153503997351,506.8377781179396,504.39292268153065,7810,13001.666666666666,48.697755373229086,51.59759823898747,NaN,NaN,NaN,NaN,0.7655056287982115,9.562136420922092,11864915,-0.06296632360176518,0.09234603266838803,0.15531235627015322
2025-08-21T12:05:00-04:00,506.27,506.46,505.98,506.39,504.2261352756196,NaN,NaN,NaN,NaN,NaN,506.06550000000107,507.9234895033928,504.20751049660936,505.37530027424214,505.6255790881261,506.841258427217,504.40989974903516,6676,12407,50.40035009661211,51.34174442432196,NaN,NaN,NaN,NaN,0.7451123695983365,9.19339540083172,11871591,-0.05914298571688756,0.08138362412404376,0.14052660984093132
2025-08-21T12:10:00-04:00,506.39,506.89,506.34,506.6,504.26214532626665,NaN,NaN,NaN,NaN,NaN,506.09350000000103,507.940637513788,504.2463624862141,505.43033119509096,505.63798309968917,506.85095938184145,504.4250068175369,5508,12117.2,52.194372736351966,51.240710422984534,NaN,NaN,NaN,NaN,0.7311757717698847,9.017377909619192,11877099,-0.041525663436583454,0.088619530545202,0.13014519398178545
2025-08-21T12:15:00-04:00,506.65,506.72,506.32,506.32,504.26214532626665,NaN,NaN,NaN,NaN,NaN,506.114600000001,507.9474467898475,504.28175321015453,505.43033119509096,505.64699038494166,506.8562548901652,504.43772587971813,4883,11298.566666666668,49.617417444028945,51.124675699209256,NaN,NaN,NaN,NaN,0.7075203595006097,8.813443660538043,11872216,-0.04736207800025019,0.07094259648147272,0.11830467448172291
2025-08-21T12:20:00-04:00,506.36,506.37,505.86,506.07,504.26214532626665,NaN,NaN,NaN,NaN,NaN,506.1320000000011,507.9462094682717,504.31779053173045,505.43033119509096,505.6567191664674,506.85472943305825,504.4587088998765,9701,10794.766666666666,47.36866816965313,51.19830883005756,NaN,NaN,NaN,NaN,0.6934117623934226,8.62533805407117,11862515,-0.06557040827699637,0.03634166413547746,0.10191207241247383
2025-08-21T12:25:00-04:00,506.07,506.07,505.33,505.45,504.26214532626665,NaN,NaN,NaN,NaN,NaN,506.1338000000011,507.94511836923954,504.32248163076264,505.43033119509096,505.6555955516251,506.83670057717285,504.4744905260773,13038,10705.233333333334,42.25406712976026,50.71617838253923,NaN,NaN,NaN,NaN,0.6967394936510359,9.29550458156056,11849477,-0.1140417922664817,-0.0406401679206283,0.0734016243458534
2025-08-21T12:30:00-04:00,505.48,505.705,504.98,505.05,504.26214532626665,NaN,NaN,NaN,NaN,NaN,506.1288000000011,507.95064692955884,504.30695307044334,505.43033119509096,505.6435520511781,506.8092668261899,504.4778372761663,14044,10412.333333333334,39.30539971296857,49.60454316242068,NaN,NaN,NaN,NaN,0.698758101247388,10.399680307046031,11835433,-0.1646407116337099,-0.13239926519628398,0.03224144643742592
2025-08-21T12:35:00-04:00,505.05,505.245,504.78,505.11,504.26214532626665,NaN,NaN,NaN,NaN,NaN,506.1338000000011,507.94301923349525,504.3245807665069,505.43033119509096,505.62702008334713,506.78070132040625,504.473338846288,13600,10221.333333333334,39.98197312814518,48.65758727753611,NaN,NaN,NaN,NaN,0.682061094015434,11.68401215587764,11849033,-0.1841892751531427,-0.1979951475040025,-0.013805872350859769
2025-08-21T12:40:00-04:00,505.1,505.29,505.02,505.08,504.26214532626665,NaN,NaN,NaN,NaN,NaN,506.135600000001,507.9404375425867,504.33076245741523,505.43033119509096,505.61773777375635,506.7625741988766,504.47290134863607,9371,9770.9,39.74342017395349,47.557030188454,NaN,NaN,NaN,NaN,0.6526281587286201,12.770757941065805,11839662,-0.1885750942982766,-0.24952474022370552,-0.06094964592542892
2025-08-21T12:45:00-04:00,505.13,505.21,504.87,505.04,504.26214532626665,NaN,NaN,NaN,NaN,NaN,506.11840000000103,507.9481108391516,504.2886891608505,505.43033119509096,505.6062351990967,506.74248735906855,504.4699830391249,10193,9088.666666666666,39.40581868689217,46.62670317715091,NaN,NaN,NaN,NaN,0.6302975759622883,13.987629476250035,11829469,-0.18343566298738428,-0.29024422465965927,-0.10680856167227498
2025-08-21T12:50:00-04:00,504.99,505.54,504.92,505.48,504.26214532626665,NaN,NaN,NaN,NaN,NaN,506.095400000001,507.92771857355126,504.26308142645075,505.43033119509096,505.60053340572955,506.7263992271113,504.4746675843478,10164,8901.766666666666,44.94578421086706,45.95557256391152,NaN,NaN,NaN,NaN,0.6295620348221252,14.318854905069411,11839633,-0.14154484109357593,-0.2837396130392449,-0.14219477194566896
2025-08-21T12:55:00-04:00,505.57,505.62,504.46,504.63,504.26214532626665,NaN,NaN,NaN,NaN,NaN,506.054800000001,507.9248502225535,504.18474977744853,505.43033119509096,505.5746985130211,506.687329756694,504.46206726934815,20092,9201.766666666666,37.762989691752246,45.041809629630144,NaN,NaN,NaN,NaN,0.667450460906261,15.29200855286987,11819541,-0.16081712268053192,-0.34321617529633386,-0.18239905261580194
2025-08-21T13:00:00-04:00,504.66,505.06,504.66,505,504.26214532626665,NaN,NaN,NaN,NaN,NaN,506.0102000000011,507.8723632138005,504.14803678620166,505.35226495607276,505.5642660487998,506.67127823417627,504.4572538634234,8602,9228.7,42.100558121492696,44.65569242437506,NaN,NaN,NaN,NaN,0.6504897136986714,16.19565122582744,11828143,-0.13919088314617462,-0.3563876565485202,-0.2171967734023456
2025-08-21T13:05:00-04:00,504.99,505.15,504.86,504.9,504.26214532626665,NaN,NaN,NaN,NaN,NaN,505.96800000000104,507.83325172430335,504.10274827569873,505.02081196485824,505.55025530915395,506.6478496314424,504.4526609868655,13300,9286.033333333333,41.263516955559886,43.93157797366187,NaN,NaN,NaN,NaN,0.624740448434478,16.8033055057574,11814843,-0.12274098393723176,-0.3706230033238853,-0.24788201938665355
2025-08-21T13:10:00-04:00,504.9,504.9,504.41,504.59,504.26214532626665,NaN,NaN,NaN,NaN,NaN,505.924400000001,507.8143773953955,504.0344226046065,504.62064957188653,505.538516109707,506.6339227345406,504.44310948487345,7316,9221.4,38.69512336876988,43.217104259057635,NaN,NaN,NaN,NaN,0.6151161306891547,18.012974362477593,11807527,-0.12351980333194013,-0.4022817735515787,-0.27876197021963856
2025-08-21T13:15:00-04:00,504.58,505,504.52,504.68,504.26214532626665,NaN,NaN,NaN,NaN,NaN,505.89380000000097,507.81359848820875,503.9740015117932,504.2651568517158,505.5248489886799,506.6158879989275,504.43380997843224,9867,9242.666666666666,39.86539135299848,42.46460720594238,NaN,NaN,NaN,NaN,0.6054649784970735,18.86955537938179,11817394,-0.10924783062774468,-0.4153217585043194,-0.3060739278765747
2025-08-21T13:20:00-04:00,504.73,504.77,504.15,504.17,NaN,NaN,NaN,506.45975500399635,506.45975500399635,506.45975500399635,505.846000000001,507.8154415439111,503.87655845609095,504.2651568517158,505.5088457912582,506.60076945564913,504.41692212686723,8121,9221.7,35.70587932895694,41.28685767684273,NaN,NaN,NaN,NaN,0.6065031943187115,20.165428809451495,11809273,-0.12433207379677391,-0.4614890201225421,-0.3371569463257682
2025-08-21T13:25:00-04:00,504.17,504.58,503.94,504.45,NaN,NaN,NaN,506.25612977654197,NaN,NaN,505.796200000001,507.778354947255,503.814045052747,504.2651568517158,505.4842959958218,506.5779633986133,504.3906285930303,12464,9420.233333333334,39.4417530302524,40.560024504430125,NaN,NaN,NaN,NaN,0.6088958232959454,21.62815054686904,11821737,-0.10632615103631482,-0.4700646351211617,-0.3637384840848469
2025-08-21T13:30:00-04:00,504.48,505.05,504.42,505,NaN,NaN,NaN,506.25612977654197,NaN,NaN,505.7644000000011,507.7456113856253,503.7831886143769,504.2651568517158,505.47269062017955,506.5601844373539,504.3851968030052,10757,9208.533333333333,46.0705709308508,40.467303273087104,NaN,NaN,NaN,NaN,0.6104032644890918,21.760649102129673,11832494,-0.05105074552223077,-0.4275519159876353,-0.37650117046540454
2025-08-21T13:35:00-04:00,505,505.825,504.95,505.71,NaN,NaN,NaN,506.25612977654197,NaN,NaN,505.76840000000107,507.7483479171743,503.7884520828278,504.2651568517158,505.4731216204533,506.5500638061359,504.3961794347707,12069,9332.366666666667,53.19336739559265,41.2486818635037,NaN,NaN,NaN,NaN,0.6293030313112995,20.312946429818304,11844563,0.03501400284298051,-0.33273366691167894,-0.36774766975465945
2025-08-21T13:40:00-04:00,505.77,505.93,505.7,505.74,NaN,NaN,NaN,506.25612977654197,NaN,NaN,505.7982000000011,507.73010658021536,503.8662934197868,504.54850427862476,505.4782020119924,506.54721736244903,504.4091866615357,10179,9265.266666666666,53.472993308140545,42.26065283458741,NaN,NaN,NaN,NaN,0.6007813862176364,18.938988221809286,11854742,0.09238944310297592,-0.25226086587593954,-0.34465030897891547
2025-08-21T13:45:00-04:00,505.75,506,505.65,505.76,NaN,NaN,NaN,506.25612977654197,NaN,NaN,505.8114000000012,507.73303580170125,503.8897641983011,504.71980342289976,505.4833418902654,506.5446488867041,504.4220348938267,10198,9317.733333333334,53.671698775340005,43.23849038081561,NaN,NaN,NaN,NaN,0.5828684300592355,17.789349912675682,11864940,0.12792651459251553,-0.18474216573827107,-0.3126686803307866
2025-08-21T13:50:00-04:00,505.8,505.87,504.95,504.96,NaN,NaN,NaN,506.25612977654197,NaN,NaN,505.8208000000011,507.7209666859776,503.9206333140246,504.71980342289976,505.47997520983324,506.5336042063353,504.42634621333116,9873,9425.633333333333,45.33193684852231,43.637670143284815,NaN,NaN,NaN,NaN,0.6069492564835769,17.500401653096993,11855067,0.09529075287247141,-0.19355523924019735,-0.28884599211266876
2025-08-21T13:55:00-04:00,504.94,505.41,504.85,505.3,NaN,NaN,NaN,506.25612977654197,NaN,NaN,505.83380000000113,507.71049769393375,503.9571023060685,504.71980342289976,505.4761171312883,506.5233269801668,504.42890728240974,8730,9552.233333333334,48.96169873546417,44.32023300389711,NaN,NaN,NaN,NaN,0.6035957381633216,17.381275939378874,11863797,0.09417135043226998,-0.1711318040723313,-0.2653031545046013
2025-08-21T14:00:00-04:00,505.29,505.7,505.19,505.38,NaN,NaN,NaN,506.25612977654197,NaN,NaN,505.85540000000117,507.6852632064035,504.02553679359886,504.71980342289976,505.4754357198027,506.5158812047231,504.4349902348823,8680,9669.7,49.806180826339045,44.66740419071653,NaN,NaN,NaN,NaN,0.5969103282945122,16.68897683995378,11872477,0.09605724419186065,-0.14523159926477547,-0.24128884345663612
2025-08-21T14:05:00-04:00,505.37,505.38,504.96,505.12,NaN,NaN,NaN,506.25612977654197,NaN,NaN,505.89380000000114,507.57358398443193,504.21401601557034,504.71980342289976,505.4696617040119,506.50162482750767,504.43769858051616,12273,9811.366666666667,47.079738477959076,45.33288624687417,NaN,NaN,NaN,NaN,0.5842738762734767,16.419633197356056,11860204,0.07781099813215,-0.14402509579144862,-0.22183609392359863
2025-08-21T14:10:00-04:00,505.06,505.385,504.86,505.3,NaN,NaN,NaN,506.25612977654197,NaN,NaN,505.9018000000011,507.56631645662975,504.2372835433725,504.71980342289976,505.4634864624976,506.48517789777765,504.44179502721755,15002,10173.166666666666,49.154872997028114,45.83676588084098,NaN,NaN,NaN,NaN,0.5800400279682266,16.330244549847666,11875206,0.07580524030247437,-0.12707954354550566,-0.20288478384798003
2025-08-21T14:15:00-04:00,505.25,505.71,505.13,505.7,NaN,NaN,NaN,506.25612977654197,NaN,NaN,505.9008000000012,507.5657400692131,504.2358599307893,504.71980342289976,505.4644513186228,506.47622960759605,504.4526730296496,13810,10356.266666666666,53.516929169926954,46.712009610438635,NaN,NaN,NaN,NaN,0.5800371688276379,15.565006580239451,11889016,0.0979509615680759,-0.08044608188788516,-0.17839704345596105
2025-08-21T14:20:00-04:00,505.72,505.9,505.66,505.82,NaN,NaN,NaN,506.25612977654197,NaN,NaN,505.8875000000012,507.54416441811907,504.2308355818833,504.71980342289976,505.4669213947677,506.475292894088,504.45854989544745,5399,10319.333333333334,54.770558320901415,47.860254964162316,NaN,NaN,NaN,NaN,0.5557487996256604,14.480071928100486,11894415,0.11598125081204819,-0.033420479940900805,-0.149401730752949
2025-08-21T14:25:00-04:00,505.84,505.86,505.21,505.21,NaN,NaN,NaN,506.25612977654197,NaN,NaN,505.8467000000012,507.46722042080216,504.2261795792002,504.71980342289976,505.4662142391177,506.4657034438158,504.46672503441954,12854,10485.8,47.72446187406081,48.4216171442382,NaN,NaN,NaN,NaN,0.56248102822383,14.272103198821027,11881561,0.08363565012016924,-0.04485716810273743,-0.12849281822290667
2025-08-21T14:30:00-04:00,505.23,505.23,504.88,504.96,NaN,NaN,NaN,506.25612977654197,NaN,NaN,505.80770000000115,507.4178095721609,504.1975904278414,504.71980342289976,505.45783782817426,506.44966649982223,504.4660091565263,14106,10695.666666666666,45.160257246580485,49.09692985263988,NaN,NaN,NaN,NaN,0.5473038119221295,14.593758536452492,11867455,0.04419476380643121,-0.07324936346486766,-0.11744412727129887
2025-08-21T14:35:00-04:00,505,505.76,504.99,505.63,NaN,NaN,NaN,506.25612977654197,NaN,NaN,505.7709000000012,507.3098940721965,504.2319059278058,504.6872186787941,505.4578593262427,506.4447449203098,504.47097373217565,7490,10722.8,52.52262953578778,50.03127817446383,NaN,NaN,NaN,NaN,0.5653535396419782,13.844321506815257,11874945,0.06098576826287902,-0.0412119169427001,-0.10219768520557912
2025-08-21T14:40:00-04:00,505.63,505.67,505.2,505.25,NaN,NaN,NaN,506.25612977654197,NaN,NaN,505.7401000000012,507.2577725451416,504.22242745486074,504.6872186787941,505.4569801171618,506.4387571340837,504.47520310023987,7918,10803.133333333333,48.542154614560914,50.207819866157415,NaN,NaN,NaN,NaN,0.558542572524696,13.148415693580684,11867027,0.04499407435128926,-0.045955092266467545,-0.0909491666177568
2025-08-21T14:45:00-04:00,505.21,505.37,504.93,505.29,NaN,NaN,NaN,506.25612977654197,NaN,NaN,505.7189000000012,507.23150740248474,504.2062925975177,504.6872186787941,505.45397245984617,506.43045762328893,504.4774872964034,8898,10936.966666666667,48.980469247045555,49.90689856983261,NaN,NaN,NaN,NaN,0.5500752459157889,12.968185432110607,11875925,0.0359939994355121,-0.04595666732336667,-0.08195066675887877
2025-08-21T14:50:00-04:00,505.33,505.63,505.27,505.42,NaN,NaN,NaN,506.25612977654197,NaN,NaN,505.69650000000127,507.1928906554736,504.2001093445289,504.6872186787941,505.45381738911203,506.42486986823013,504.48276490999393,8643,10901.7,50.45746960414427,49.69150401954717,NaN,NaN,NaN,NaN,0.5364984426360907,12.280127989891119,11884568,0.03750948679317541,-0.03506380826740951,-0.07257329506058492
2025-08-21T14:55:00-04:00,505.41,505.87,505.22,505.75,NaN,NaN,NaN,506.25612977654197,NaN,NaN,505.6833000000013,507.16586211801814,504.2007378819844,504.6872186787941,505.4576481115487,506.41728077199866,504.4980154510987,19162,11105.833333333334,54.090755378275006,49.721436634042526,NaN,NaN,NaN,NaN,0.5446056967335112,11.618518994991822,11903730,0.05821452156783865,0.00019485689921339144,-0.05801966466862526
2025-08-21T15:00:00-04:00,505.7,506,505.62,505.77,NaN,NaN,NaN,506.25612977654197,NaN,NaN,505.6551000000012,507.0750302638177,504.2351697361847,504.7773284181336,505.4613287516305,506.41638433905916,504.50627316420184,8758,10929.633333333333,54.30945521028327,50.36268794559688,NaN,NaN,NaN,NaN,0.5328481469668315,11.244000301347349,11912488,0.06994564230999846,0.02941238821887282,-0.04053325409112564
2025-08-21T15:05:00-04:00,505.76,506.12,505.66,505.97,NaN,NaN,NaN,506.25612977654197,NaN,NaN,505.6399000000012,507.0294243625275,504.2503756374749,504.91186273450694,505.4667576409719,506.41738824796107,504.5161270339827,9734,10800.766666666666,56.5390805704083,50.90392950523575,NaN,NaN,NaN,NaN,0.5276447078977706,11.11873444734782,11922222,0.08676488207600724,0.06792284850388342,-0.01884203357212383
2025-08-21T15:10:00-04:00,506,506.09,505.89,506,NaN,NaN,NaN,506.25612977654197,NaN,NaN,505.6263000000012,506.9878679322751,504.2647320677273,505.0234901876055,505.47201095901914,506.4193343383451,504.5246875796932,8227,10762.633333333333,56.87899560155258,51.40913056060815,NaN,NaN,NaN,NaN,0.5042415144765006,11.002416154348257,11930449,0.09484480636587862,0.09971397438522445,0.004869168019345827
2025-08-21T15:15:00-04:00,505.96,506.05,505.84,505.89,NaN,NaN,NaN,506.25612977654197,NaN,NaN,505.61670000000123,506.96385048678343,504.26954951321903,505.0917921500844,505.47747330301405,506.4203907930386,504.5345558129895,10028,10757.133333333333,55.17499449584605,51.98736313331436,NaN,NaN,NaN,NaN,0.4832242634424674,10.77065522814372,11920421,0.08787289060802084,0.11471028127937188,0.02683739067135104
2025-08-21T15:20:00-04:00,505.915,506.45,505.82,506.33,504.50725224272423,504.50725224272423,504.50725224272423,NaN,NaN,NaN,505.62970000000126,506.9915082222033,504.2678917777992,505.3684337200675,505.4895973908839,506.4291649929661,504.5500297888017,14245,10893.166666666666,60.298524414943586,52.783338234594034,NaN,NaN,NaN,NaN,0.49370824462514795,11.345900292919866,11934666,0.10673168746252114,0.16025199999950246,0.05352031253698132
2025-08-21T15:25:00-04:00,506.33,506.34,505.99,506.15,504.56351350441855,NaN,NaN,NaN,NaN,NaN,505.63210000000123,506.99714078845585,504.2670592115466,505.3684337200675,505.4969749147702,506.4339722608168,504.5599775687236,9446,10538.3,57.40768814553049,53.06124958999429,NaN,NaN,NaN,NaN,0.48344337000906357,11.880056424497717,11925220,0.10098185059233103,0.17974762577739511,0.07876577518506409
2025-08-21T15:30:00-04:00,506.17,506.18,505.99,506.09,504.56351350441855,NaN,NaN,NaN,NaN,NaN,505.6163000000012,506.9408871938232,504.29171280617925,505.3684337200675,505.503300171877,506.4372362482868,504.5693640954672,9307,10561.8,56.436418790006215,53.18023962350178,NaN,NaN,NaN,NaN,0.46248312929413027,12.376058546677148,11915913,0.08753717639595868,0.18818724568001244,0.10065006928405376
2025-08-21T15:35:00-04:00,506.08,506.09,505.49,505.52,504.56351350441855,NaN,NaN,NaN,NaN,NaN,505.59330000000125,506.8833908627255,504.303209137277,505.3684337200675,505.50534504120515,506.43462807939557,504.5760620030147,9115,10422.3,48.109100670501796,53.20771382324756,NaN,NaN,NaN,NaN,0.47230576291597565,11.49771515373739,11906798,0.037227795795959806,0.14718481402900352,0.10995701823304371
2025-08-21T15:40:00-04:00,505.52,505.56,504.69,504.7,504.56351350441855,NaN,NaN,NaN,NaN,NaN,505.54830000000123,506.802422176763,504.29417782323947,505.3684337200675,505.49475198614437,506.4174980504506,504.5720059218381,18161,10783.8,39.157774380123286,52.77896504707205,NaN,NaN,NaN,NaN,0.5007124941362634,12.19860861577585,11888637,-0.049589633357843346,0.047969976535739534,0.09755960989358288
2025-08-21T15:45:00-04:00,504.7,504.86,504.37,504.795,NaN,NaN,NaN,506.22171088530143,506.22171088530143,506.22171088530143,505.51180000000124,506.74509113923506,504.27850886076743,505.3684337200675,505.47919114140916,506.3999579135343,504.558424369284,17317,11032.133333333333,40.53813671362195,51.922929845488774,NaN,NaN,NaN,NaN,0.49994731598367376,13.32328948837795,11905954,-0.0962322997729897,-0.022730764822654237,0.07350153495033546
2025-08-21T15:50:00-04:00,504.77,504.95,504.15,504.25,NaN,NaN,NaN,506.192769481424,NaN,NaN,505.4592000000013,506.6788529972706,504.239547002732,505.3684337200675,505.43811096997024,506.3625366386628,504.5136853012777,37927,12025.666666666666,35.554562528929935,50.99524469651514,NaN,NaN,NaN,NaN,0.5213796505562692,14.67001736867178,11868027,-0.15587308953751955,-0.12133982697156398,0.03453326256595557
2025-08-21T15:55:00-04:00,504.27,504.55,504.05,504.11,NaN,NaN,NaN,505.9362799595412,NaN,NaN,505.4128000000013,506.6574576372292,504.16814236277344,505.3684337200675,505.33175468611,506.27800161726077,504.38550775495924,92284,14686.333333333334,34.38515900500502,49.95272253636938,NaN,NaN,NaN,NaN,0.5198525326593929,16.055978234342025,11775743,-0.19433296230367691,-0.20838294031364057,-0.01404997800996366
2025-08-22T09:30:00-04:00,504.5,504.74,502.44,503.96,NaN,NaN,NaN,505.4655399613803,NaN,NaN,505.37110000000126,506.6668982690799,504.0753017309226,505.3684337200675,503.71333333333337,503.71333333333337,503.71333333333337,39502,15644.5,33.1279387197349,48.71489890176871,NaN,NaN,NaN,NaN,0.6470059231837227,18.880268759667366,11736241,-0.21769616906307263,-0.28617018933880445,-0.06847402027573182
2025-08-22T09:35:00-04:00,503.99,505.79,503.5,505.79,502.54243912777343,502.54243912777343,502.54243912777343,NaN,NaN,NaN,505.35650000000123,506.6161352623898,504.0968647376127,505.3684337200675,504.2853962402541,504.9365900017083,503.6342024787999,30485,16258.366666666667,54.82777102680828,48.76754287666394,NaN,NaN,NaN,NaN,0.7643626429563154,19.429826339720396,11766726,-0.10351719217252195,-0.19787051049138427,-0.09435331831886232
2025-08-22T09:40:00-04:00,505.8,506.47,505.66,506.34,503.94755553105654,NaN,NaN,NaN,NaN,NaN,505.3595000000013,506.6277464247929,504.09125357520963,505.299746976054,504.74679269251055,505.73168149336396,503.76190389165714,22904,16682.533333333333,59.12121616167867,49.111240087477896,NaN,NaN,NaN,NaN,0.7676224541737217,18.899400863078725,11789630,0.009434437088222253,-0.08256027195858451,-0.09199470904680676
2025-08-22T09:45:00-04:00,506.35,506.35,504.47,504.78,503.94755553105654,NaN,NaN,NaN,NaN,NaN,505.3273000000013,506.5707680671252,504.0838319328774,505.25279758084326,504.84570091648925,505.73640534868457,503.95499648429393,25932,17207,45.81893841239639,48.3455156476199,NaN,NaN,NaN,NaN,0.8470779931613127,19.527356306961103,11763698,-0.01898109606311918,-0.11572107912570573,-0.09673998306258655
2025-08-22T09:50:00-04:00,504.85,504.915,503.74,504.25,NaN,NaN,NaN,506.6617624190167,506.6617624190167,506.6617624190167,505.2803000000012,506.5053067895083,504.0552932104941,505.0482380646746,504.75599271415354,505.59461745829293,503.91736797001414,23462,17659.966666666667,42.33390506166813,47.306580609056724,NaN,NaN,NaN,NaN,0.8705009936497913,20.654644067309466,11740236,-0.0687377831854212,-0.18266221204436306,-0.11392442885894186
2025-08-22T09:55:00-04:00,504.35,504.68,503.48,503.89,NaN,NaN,NaN,506.47179594542513,NaN,NaN,505.23170000000124,506.4804395381391,503.9829604618634,504.2915904517397,504.67483887988624,505.49916056809496,503.8505171916775,17544,17953.766666666666,40.10266419367267,46.22998558747291,NaN,NaN,NaN,NaN,0.8940366369605197,21.8808948550905,11722692,-0.11825669425082469,-0.2617452966724727,-0.14348860242164801
2025-08-22T10:00:00-04:00,503.9,507,503.9,506.06,502.74283114300334,502.74283114300334,502.74283114300334,NaN,NaN,NaN,505.23150000000123,506.47970550958416,503.9832944904183,503.70837244738084,504.98048947228034,505.80079746253796,504.1601814820227,72605,20084.6,55.37166781115207,45.87806725863066,NaN,NaN,NaN,NaN,1.0523197343204835,20.343783651024037,11795297,-0.0033024883602651156,-0.14761671287197942,-0.1443142245117143
2025-08-22T10:05:00-04:00,506.2,508.71,506.19,508.32,504.5045206365032,NaN,NaN,NaN,NaN,NaN,505.2889000000012,506.8068345026695,503.7709654973329,504.16624588355774,505.60269886704435,506.963223989113,504.24217374497573,67666,21931.033333333333,65.29448649299297,46.441409997735114,NaN,NaN,NaN,NaN,1.1664397532975903,20.137016270488623,11862963,0.21446530822148352,0.12376741076514008,-0.09069789745634343
2025-08-22T10:10:00-04:00,508.42,508.65,507.84,508.43,505.32295151666216,NaN,NaN,NaN,NaN,NaN,505.35650000000123,507.1088130411455,503.604186958857,504.6099967068462,505.92684193855854,507.4762085428656,504.37747533425147,40875,22793.466666666667,65.69430195783164,47.1026873668655,NaN,NaN,NaN,NaN,1.1409797709191911,19.94501798856288,11903838,0.34756213684988135,0.34375477360600826,-0.0038073632438730964
2025-08-22T10:15:00-04:00,508.51,509.4,507.9,508.37,505.65622644772293,NaN,NaN,NaN,NaN,NaN,505.42170000000124,507.36469522236825,503.4787047776342,505.41799736547694,506.1379001136503,507.78665139554045,504.48914883176013,29753,23324.9,65.25272842143353,48.32723220621777,NaN,NaN,NaN,NaN,1.1666240729963917,20.254937983018113,11874085,0.4089705201621149,0.5074057869587705,0.09843526679665562
2025-08-22T10:20:00-04:00,508.35,508.4,507.03,507.8,505.65622644772293,NaN,NaN,NaN,NaN,NaN,505.4761000000012,507.5270893110874,503.425110688915,505.41799736547694,506.24886235082806,507.89091141798133,504.6068132836748,27526,24062.466666666667,61.054181257689265,49.89126126890106,NaN,NaN,NaN,NaN,1.1811509249252212,19.710589777597107,11846559,0.3887477107716454,0.5843699052612124,0.19562219448956697
2025-08-22T10:25:00-04:00,507.8,508.61,507.7,508.2,505.65622644772293,NaN,NaN,NaN,NaN,NaN,505.5393000000012,507.72308937498497,503.3555106250175,505.41799736547694,506.3207602556852,507.9725388657084,504.668981645662,15484,24150.133333333335,62.860150379336446,51.485690816452085,NaN,NaN,NaN,NaN,1.1617830017162787,19.35356273262974,11862043,0.37943726357378216,0.6699187739567947,0.2904815103830125
2025-08-22T10:30:00-04:00,508.31,508.95,508.26,508.38,505.65622644772293,NaN,NaN,NaN,NaN,NaN,505.59730000000127,507.92125456800295,503.2733454319996,505.7338146511242,506.43881995412147,508.12091834374496,504.756721564498,23358,24458.533333333333,63.676423108873415,53.494395143590914,NaN,NaN,NaN,NaN,1.132369930165116,19.264636575543683,11885401,0.36254984230163634,0.743668813260058,0.3811189709584216
2025-08-22T10:35:00-04:00,508.39,508.86,508.17,508.275,505.65622644772293,NaN,NaN,NaN,NaN,NaN,505.6702000000012,508.09471228794035,503.2456877120621,505.94205172089937,506.5097819134892,508.20255723579436,504.817006591184,16111,24745.9,62.8092215796207,55.52468532749204,NaN,NaN,NaN,NaN,1.1007720780104646,19.087366762670186,11869290,0.32278422838340104,0.7845992564376729,0.4618150280542719
2025-08-22T10:40:00-04:00,508.33,509.86,508.19,509.765,505.9787704188758,NaN,NaN,NaN,NaN,NaN,505.7655000000013,508.43896011640385,503.0920398835987,506.6906413767195,506.76356551083865,508.5632042867982,504.96392673487907,45858,26010.566666666666,69.2161022565468,58.10241129440716,NaN,NaN,NaN,NaN,1.1414312152954325,19.62659266335536,11915148,0.37181706897017897,0.9265863642669956,0.5547692952968166
2025-08-22T10:45:00-04:00,509.72,510.6,509.475,510.38,506.9763263089269,NaN,NaN,NaN,NaN,NaN,505.8751000000013,508.83193985937567,502.9182601406269,507.5020131013756,506.9634574420279,508.88307185902664,505.04384302502916,31290,26756.966666666667,71.40570014260342,59.28654908839253,NaN,NaN,NaN,NaN,1.1402575570600444,20.57915012722984,11946438,0.41724877585083253,1.0763302651103572,0.6590814892595247
2025-08-22T10:50:00-04:00,510.42,510.72,509.4,509.84,506.9763263089269,NaN,NaN,NaN,NaN,NaN,505.98010000000124,509.1144768047475,502.845723195255,507.5816104811005,507.0688892498107,509.03460481312123,505.10317368650016,19164,27107.666666666668,66.90575168741923,59.84258734023115,NaN,NaN,NaN,NaN,1.1530963029843306,21.534703024645978,11927274,0.3833813606726233,1.1383081901003038,0.7549268294276805
2025-08-22T10:55:00-04:00,509.9,510.21,509.64,509.86,506.9763263089269,NaN,NaN,NaN,NaN,NaN,506.0837000000012,509.3777029195951,502.78969708040734,507.5816104811005,507.1441405553411,509.136396732667,505.1518843780152,14987,26968.5,66.98872870599811,61.354715218345554,NaN,NaN,NaN,NaN,1.111446567056878,22.422002143675243,11942261,0.33645026600093575,1.1754896619288502,0.8390393959279144
2025-08-22T11:00:00-04:00,509.89,510.72,509.695,510.48,507.1670971494151,NaN,NaN,NaN,NaN,NaN,506.2099000000012,509.67976540868443,502.74003459131796,507.9709307079043,507.2791595662125,509.3302151710828,505.22810396134224,25245,27518.066666666666,69.53850942749938,63.29790124447635,NaN,NaN,NaN,NaN,1.1052718122671035,23.5673573290089,11967506,0.32131507571847184,1.2406832405760042,0.9193681648575324
2025-08-22T11:05:00-04:00,510.48,510.625,510.12,510.17,507.4014336426235,NaN,NaN,NaN,NaN,NaN,506.32430000000124,509.9290785000328,502.7195214999697,508.17324456632343,507.3809160284288,509.46967197862705,505.2921600782306,20523,27877.7,66.76184374276362,65.20212835512571,NaN,NaN,NaN,NaN,1.0623952542480244,24.630901429675863,11946983,0.2668195845990782,1.25289264560638,0.9860730610073019
2025-08-22T11:10:00-04:00,510.19,510.57,509.8,509.88,507.4014336426235,NaN,NaN,NaN,NaN,NaN,506.42190000000124,510.1404297570717,502.7033702429308,508.22359565305874,507.4418759990263,509.545565168492,505.33818682956064,14084,28072.933333333334,64.18006308437859,65.83129944607046,NaN,NaN,NaN,NaN,1.0415098789445927,25.151268396516418,11932899,0.19117878061582716,1.2250465367770857,1.0338677561612586
2025-08-22T11:15:00-04:00,509.83,509.83,509.23,509.27,507.4014336426235,NaN,NaN,NaN,NaN,NaN,506.4931000000012,510.2898848970373,502.6963151029651,508.22359565305874,507.48415001123607,509.5853060693718,505.3829939531003,13472,28187.733333333334,59.010686092876675,65.38245656034786,NaN,NaN,NaN,NaN,1.013544887591406,24.851523845654505,11919427,0.08539233258348866,1.1406081718906194,1.0552158393071307
2025-08-22T11:20:00-04:00,509.23,509.265,508.55,508.87,507.4014336426235,NaN,NaN,NaN,NaN,NaN,506.55570000000125,510.40362152131297,502.70777847868953,508.22359565305874,507.53528097227576,509.6147954858453,505.4557664587062,23985,28512.4,55.834848760204906,64.67820990337452,NaN,NaN,NaN,NaN,0.9925773956205891,23.739846907518185,11895442,-0.02053623770837576,1.029545542171661,1.0500817798800368
2025-08-22T11:25:00-04:00,508.85,508.85,508.16,508.255,507.4014336426235,NaN,NaN,NaN,NaN,NaN,506.6056000000013,510.4755998131964,502.73560018680615,508.22359565305874,507.5493448329703,509.6152673707684,505.4834222951722,10670,28553.2,51.266482512984155,63.67919233848528,NaN,NaN,NaN,NaN,0.9723932959334027,22.268659431061792,11884772,-0.13467492826671768,0.8817381195466396,1.0164130478133573
2025-08-22T11:30:00-04:00,508.27,509,508,508.6,507.4014336426235,NaN,NaN,NaN,NaN,NaN,506.67840000000126,510.5587697960693,502.7980302039332,508.22359565305874,507.58023717548014,509.62069894060846,505.5397754103518,21797,28969.533333333333,53.561884836572915,63.144028308405545,NaN,NaN,NaN,NaN,0.9743652033667312,20.723976759230684,11906569,-0.18640431571895877,0.7834076531646588,0.9698119688836175
2025-08-22T11:35:00-04:00,508.61,509.45,508.19,508.27,507.4014336426235,NaN,NaN,NaN,NaN,NaN,506.73780000000124,510.6228756278671,502.8527243721354,508.22359565305874,507.6162843676137,509.63078204342816,505.6017866917992,24527,29483.266666666666,51.08337760194725,62.30283025287775,NaN,NaN,NaN,NaN,0.9947676888405353,19.775027563456803,11882042,-0.23895709102007368,0.6711156051085254,0.9100726961285991
2025-08-22T11:40:00-04:00,508.3,508.7,508.1,508.4,507.4014336426235,NaN,NaN,NaN,NaN,NaN,506.79820000000126,510.690855010929,502.9055449890735,508.22359565305874,507.6338330796861,509.62902133655274,505.63864482281946,16464,29426.7,52.02518424807078,61.470598905677555,NaN,NaN,NaN,NaN,0.9665699967804946,18.782450206520725,11898506,-0.2593702896499773,0.5858598340661274,0.8452301237161047
2025-08-22T11:45:00-04:00,508.37,508.47,507.78,507.85,507.4014336426235,NaN,NaN,NaN,NaN,NaN,506.8528000000013,510.7263039220293,502.97929607797334,508.22359565305874,507.64067245481766,509.61938707216325,505.6619578374721,12807,29276.366666666665,47.829479103178485,60.4006173002174,NaN,NaN,NaN,NaN,0.9468149970104632,17.46250676399287,11885699,-0.3013737847066962,0.46851289283273445,0.7698866775394306
2025-08-22T11:50:00-04:00,507.85,508.01,507.43,507.85,507.4014336426235,NaN,NaN,NaN,NaN,NaN,506.9038000000013,510.76129740558457,503.046302594418,508.22359565305874,507.6426645669775,509.6053066860099,505.6800224479451,12350,28423.8,47.829479103178485,58.87300136069109,NaN,NaN,NaN,NaN,0.920613925795429,16.61197456339304,11885699,-0.31892115975510804,0.3712352278455455,0.6901563876006536
2025-08-22T11:55:00-04:00,507.88,508.36,507.12,507.38,NaN,NaN,NaN,510.4681763663131,510.4681763663131,510.4681763663131,506.9374000000013,510.78161395790653,503.093186042096,508.22359565305874,507.64219065583416,509.5842078741767,505.7001734374916,16240,25889,44.28953058636224,56.93613210667387,NaN,NaN,NaN,NaN,0.9434272168100418,15.474785202427817,11869459,-0.3494874663405325,0.253297054674988,0.6027845210155205
2025-08-22T12:00:00-04:00,507.54,507.83,506.9,507.05,NaN,NaN,NaN,510.1572433420332,NaN,NaN,506.9620000000013,510.79301657447917,503.1309834255234,507.62787652244697,507.63474326846404,509.5584717921294,505.71101474479866,15435,25086.766666666666,41.942307438635225,55.15302894604643,NaN,NaN,NaN,NaN,0.9424681298950394,14.59707294413378,11854024,-0.3768804251307858,0.1316839896020383,0.5085644147328241
2025-08-22T12:05:00-04:00,507.05,507.7,506.98,507.389,NaN,NaN,NaN,510.10350500830447,NaN,NaN,507.0055800000012,510.805332245729,503.2058277542734,507.1433012179576,507.6306317614828,509.54039810528707,505.7208654176785,11873,24466.366666666665,45.15773777450171,53.59367245093954,NaN,NaN,NaN,NaN,0.9265775491882488,13.782054418575033,11865897,-0.3572954030185146,0.061945160959680834,0.4192405639781954
2025-08-22T12:10:00-04:00,507.4,507.52,506.86,506.99,NaN,NaN,NaN,509.9178911442906,NaN,NaN,507.0461800000012,510.8007493900752,503.29161060992715,507.1064902235943,507.62079972507775,509.51326146898407,505.7283379811714,15890,24232.566666666666,42.195605566518864,51.640607889440936,NaN,NaN,NaN,NaN,0.9075362956748002,13.189730693712267,11850007,-0.3555752592136424,-0.02522851003885762,0.3303467491747848
2025-08-22T12:15:00-04:00,506.99,507.4,506.53,507.16,NaN,NaN,NaN,509.68753245591375,NaN,NaN,507.07678000000124,510.8095587237855,503.34400127621694,507.1064902235943,507.60951295349815,509.48555458096473,505.7334713260316,15968,23900.433333333334,43.88455022112647,50.006515495038286,NaN,NaN,NaN,NaN,0.9048551316980291,13.083949289682565,11865975,-0.3280199691588151,-0.07967821227373406,0.24834175688508103
2025-08-22T12:20:00-04:00,507.19,507.21,506.6,506.79,NaN,NaN,NaN,509.58696279882673,NaN,NaN,507.1075800000012,510.80480218009166,503.4103578199107,507.1064902235943,507.59753347984474,509.4607377164124,505.7343292432771,13700,23575.033333333333,41.07177201047747,48.35592327547391,NaN,NaN,NaN,NaN,0.8837940508624526,12.985723700226409,11852275,-0.3194301183823188,-0.15094589109281742,0.16848422728950135
2025-08-22T12:25:00-04:00,506.74,506.94,506.4,506.91,NaN,NaN,NaN,509.3036917625164,NaN,NaN,507.1399800000012,510.80113938917617,503.4788206108262,506.52519217887544,507.58359985265565,509.4345651194775,505.7326345858338,14200,23463.566666666666,42.3620885912212,47.166737739641384,NaN,NaN,NaN,NaN,0.8592373329437074,13.17331712327377,11866475,-0.29117903057106465,-0.19548956092432945,0.09568946964673519
2025-08-22T12:30:00-04:00,506.95,507.11,506.75,506.9,NaN,NaN,NaN,509.3036917625164,NaN,NaN,507.16958000000113,510.7984261208955,503.54073387910677,506.3851537431004,507.57661284658786,509.4190534155914,505.7341722775843,9191,21349.766666666666,42.279007705208365,46.198463378570196,NaN,NaN,NaN,NaN,0.8235775234477293,13.026324173202664,11857284,-0.2597182693798851,-0.22895836707812123,0.03075990230176391
2025-08-22T12:35:00-04:00,506.9,507.03,506.74,506.79,NaN,NaN,NaN,509.3036917625164,NaN,NaN,507.19038000000114,510.7983023241611,503.58245767584117,506.1736983955842,507.57029679834335,509.4059090522139,505.7346845444728,7690,19350.566666666666,41.31905139833293,45.487932584666545,NaN,NaN,NaN,NaN,0.7854648432014603,12.905435159638232,11849594,-0.23368478809419188,-0.26134608281597593,-0.02766129472178406
2025-08-22T12:40:00-04:00,506.79,507.16,506.79,506.95,NaN,NaN,NaN,509.3036917625164,NaN,NaN,507.2139800000012,510.7997992805667,503.6281607194357,506.1736983955842,507.56152140797013,509.3851738062977,505.73786900964257,12991,18421.1,43.33443573554301,44.757400506021554,NaN,NaN,NaN,NaN,0.7557887829727848,12.528645165539023,11862585,-0.19465435468423276,-0.270979238077075,-0.07632488339284225
2025-08-22T12:45:00-04:00,506.92,506.97,506.66,506.77,NaN,NaN,NaN,509.1706720325882,NaN,NaN,507.22998000000115,510.8005606912985,503.6593993087038,505.8046317195326,507.55320887504115,509.3686060049915,505.7378117450908,9862,17758.066666666666,41.60332059568087,44.08025357700252,NaN,NaN,NaN,NaN,0.7239467270461575,12.406952817506749,11852723,-0.17077807233880604,-0.2897974738163498,-0.11901940147754377
2025-08-22T12:50:00-04:00,506.82,506.89,506.59,506.77,NaN,NaN,NaN,509.02950512201596,NaN,NaN,507.2453800000011,510.801219745708,503.6895402542942,505.8046317195326,507.5451157623198,509.35312423701527,505.7371072876244,9196,17147.066666666666,41.60332059568086,43.33583474468896,NaN,NaN,NaN,NaN,0.6936648179714328,12.41918476587755,11852723,-0.1457753352112836,-0.30123857049164826,-0.15546323528036465
2025-08-22T12:55:00-04:00,506.77,506.79,506.05,506.27,NaN,NaN,NaN,508.70634579828794,NaN,NaN,507.2529800000011,510.79880996676354,503.7071500332387,505.8046317195326,507.5253125597412,509.32439168488605,505.7262334345964,15644,17152.4,36.85968524363909,42.55227804043614,NaN,NaN,NaN,NaN,0.6969744738306167,13.307275522499001,11837079,-0.15295382327726692,-0.3466555143769483,-0.19370169109968138
2025-08-22T13:00:00-04:00,506.265,506.87,506.22,506.56,NaN,NaN,NaN,508.70634579828794,NaN,NaN,507.2575800000011,510.7992027706117,503.7159572293905,505.8046317195326,507.507598772196,509.29501679278036,505.7201807516116,17172,16946.2,41.05751137576193,42.06856605990639,NaN,NaN,NaN,NaN,0.6936191542712854,13.936540318940748,11854251,-0.12916200451570176,-0.3551541967443086,-0.22599219222860684
2025-08-22T13:05:00-04:00,506.55,506.9,506.37,506.63,NaN,NaN,NaN,508.70634579828794,NaN,NaN,507.2671800000011,510.7993313366998,503.73502866330233,505.8046317195326,507.49457828597514,509.2717940085207,505.71736256342956,14294,16885.633333333335,42.058869428780596,41.90923312007913,NaN,NaN,NaN,NaN,0.6819320718233345,14.444355507468412,11868545,-0.10095130358763182,-0.35218132171314664,-0.2512300181255148
2025-08-22T13:10:00-04:00,506.63,506.96,506.25,506.84,NaN,NaN,NaN,508.70634579828794,NaN,NaN,507.2821800000011,510.80055056961044,503.7638094303918,505.8046317195326,507.48091893777286,509.2461976716214,505.7156402039243,16437,15904.933333333332,45.07359667611119,42.1328966370417,NaN,NaN,NaN,NaN,0.683936923835952,15.121208557244453,11884982,-0.06228522310843526,-0.3290865470110589,-0.2668013239026236
2025-08-22T13:15:00-04:00,506.84,507.39,506.77,507.28,NaN,NaN,NaN,508.70634579828794,NaN,NaN,507.3173800000011,510.79955653447666,503.8352034655255,505.9344223499881,507.47257568454256,509.21646347384404,505.7286878952411,24991,15694.966666666667,50.84458853901208,42.53910026307816,NaN,NaN,NaN,NaN,0.6793700007048128,14.659378669888817,11909973,-0.004272829811841405,-0.2721423611674254,-0.267869531355584
2025-08-22T13:20:00-04:00,507.27,507.67,507.26,507.51,NaN,NaN,NaN,508.70634579828794,NaN,NaN,507.3735800000011,510.7747318062887,503.9724281937135,506.3005378799905,507.4726799646535,509.20427755497093,505.74108237433603,14263,15531.6,53.58960174682445,43.352957133099984,NaN,NaN,NaN,NaN,0.6601292863687566,13.613427427021024,11924236,0.04943238128252958,-0.20607905475242205,-0.25551143603495163
2025-08-22T13:25:00-04:00,507.53,507.92,507.53,507.87,NaN,NaN,NaN,508.70634579828794,NaN,NaN,507.4350800000011,510.75780376962064,504.1123562303816,506.6194303039924,507.47574938422395,509.19875030087195,505.75274846757594,10474,15381.166666666666,57.582409884187506,44.331375680461484,NaN,NaN,NaN,NaN,0.64226290877099,13.147292641621972,11934710,0.10580624800753718,-0.12325362602553014,-0.22905987403306732
2025-08-22T13:30:00-04:00,507.9,507.99,507.54,507.55,NaN,NaN,NaN,508.70634579828794,NaN,NaN,507.5010800000011,510.69678759134064,504.3053724086615,506.7245442431939,507.4779763372084,509.192277078234,505.76367559618285,10609,14893.3,53.20098863120375,45.197748296227644,NaN,NaN,NaN,NaN,0.6285298438587755,12.85360683357338,11924101,0.11726039989663212,-0.08248437416227716,-0.19974477405890928
2025-08-22T13:35:00-04:00,507.59,507.61,507.37,507.48,NaN,NaN,NaN,508.70634579828794,NaN,NaN,507.56848000000116,510.6138794209359,504.5230805790664,506.7245442431939,507.478055318528,509.1845483397478,505.7715622973082,9507,14526.1,52.26415631558505,45.90503884796792,NaN,NaN,NaN,NaN,0.6007777121545779,12.176006816998566,11914594,0.11564645498061377,-0.05518670533314207,-0.17083316031375584
2025-08-22T13:40:00-04:00,507.43,507.97,507.4,507.89,NaN,NaN,NaN,508.70634579828794,NaN,NaN,507.64708000000115,510.51349336324216,504.78066663676015,506.7791083156441,507.48075799288614,509.17907009319885,505.78244589257343,10372,14402.366666666667,57.03630815306822,46.959131737100776,NaN,NaN,NaN,NaN,0.5985793041435402,12.27840722522637,11924966,0.13629518278644975,-0.00046418183069363295,-0.1367593646171434
2025-08-22T13:45:00-04:00,507.88,507.93,507.71,507.755,NaN,NaN,NaN,508.70634579828794,NaN,NaN,507.6863800000012,510.50332509299704,504.8694349070053,506.86728665251525,507.4833717682004,509.17492388182984,505.791819654571,8767,14245.533333333333,55.08364680057236,47.94231712297501,NaN,NaN,NaN,NaN,0.5715379252761464,12.373493318580762,11916199,0.1347240110507714,0.031645649196320846,-0.10307836185445055
2025-08-22T13:50:00-04:00,507.76,508.13,507.76,508.02,NaN,NaN,NaN,508.70634579828794,NaN,NaN,507.71998000000116,510.5118519299032,504.92810807009914,507.0923293220122,507.4907876211079,509.1704594623923,505.8111157798236,16484,13995.5,58.114962842490954,48.99806905918558,NaN,NaN,NaN,NaN,0.5574995020421359,12.856264319664662,11932683,0.14452820242618725,0.07758189117828351,-0.06694631124790373
2025-08-22T13:55:00-04:00,508.06,508.13,507.86,508.09,NaN,NaN,NaN,508.70634579828794,NaN,NaN,507.7861800000012,510.4501044930584,505.122255506944,507.1648634576098,507.49451770158754,509.168926347891,505.8201090552841,7582,13892.566666666668,58.90393881667382,50.23382750354222,NaN,NaN,NaN,NaN,0.5369638233248393,13.304551677813997,11940265,0.14817444565676405,0.11827174582305133,-0.02990269983371272
2025-08-22T14:00:00-04:00,508.11,508.39,507.99,508.14,NaN,NaN,NaN,508.70634579828794,NaN,NaN,507.8639800000011,510.33013731719626,505.39782268280595,507.4178907660878,507.5009870918327,509.16870232814813,505.8332718555173,10481,13515.366666666667,59.49090630653619,51.511512197174746,NaN,NaN,NaN,NaN,0.5271806930873492,14.22860591185883,11950746,0.1461557913835805,0.1527920393957629,0.006636248012182405
2025-08-22T14:05:00-04:00,508.14,508.38,508.09,508.22,NaN,NaN,NaN,508.70634579828794,NaN,NaN,507.95058000000114,510.14116721101385,505.7599927889884,507.4573126128702,507.50942567856225,509.169293290707,505.8495580664175,12879,13127.1,60.46390506355264,53.19752789859714,NaN,NaN,NaN,NaN,0.5102392150096828,15.086656272043317,11963625,0.14227372159670273,0.18447840000806082,0.04220467841135809
2025-08-22T14:10:00-04:00,508.23,508.42,508.21,508.28,NaN,NaN,NaN,508.70634579828794,NaN,NaN,507.9949800000011,510.1194857950466,505.87047420495554,507.5768500902962,507.51650809715574,509.1706406306708,505.8623755636407,10015,12912.133333333333,61.21631543155677,54.63744247401105,NaN,NaN,NaN,NaN,0.4887935567947081,15.96477842343655,11973640,0.13582657971235862,0.21198790305180637,0.07616132333944775
2025-08-22T14:15:00-04:00,508.28,508.57,508.24,508.41,NaN,NaN,NaN,508.70634579828794,NaN,NaN,507.9967800000011,510.1225363833148,505.87102361668735,507.73048007223696,507.5248351837831,509.17344122123063,505.8762291463356,10601,12838.6,62.865304050119555,56.12361637553527,NaN,NaN,NaN,NaN,0.4774511598807992,17.084686115727816,11984241,0.1322673303791595,0.24149548631339712,0.10922815593423763
2025-08-22T14:20:00-04:00,508.45,508.52,507.72,507.72,NaN,NaN,NaN,508.70634579828794,NaN,NaN,507.9825800000011,510.1060554176047,505.85910458239755,507.73048007223696,507.5297517332616,509.17024378348424,505.889259683039,12194,12833.4,50.57426510723026,56.51652126347234,NaN,NaN,NaN,NaN,0.5004903627464532,16.43424016378346,11972047,0.078072789549306,0.2068191428708701,0.12874635332156412
2025-08-22T14:25:00-04:00,507.71,507.98,507.69,507.89,NaN,NaN,NaN,508.70634579828794,NaN,NaN,507.97298000000114,510.0937009511911,505.85225904881116,507.73048007223696,507.53267991646277,509.16601990734245,505.8993399255831,10460,12640.733333333334,53.01180029718717,56.67132210334199,NaN,NaN,NaN,NaN,0.48545533683599373,15.74506321976678,11982507,0.049687243563809186,0.1908554077763256,0.1411681642125164
2025-08-22T14:30:00-04:00,507.92,508.01,507.83,508,NaN,NaN,NaN,508.70634579828794,NaN,NaN,507.9769800000011,510.0971351813467,505.8568248186555,507.73048007223696,507.5367503824837,509.1625539731815,505.91094679178593,11478,12508.833333333334,54.57293676001867,56.741560318570144,NaN,NaN,NaN,NaN,0.4636370984905661,15.183382271993096,11993985,0.03502398566109799,0.1849481462888889,0.1499241606277909
2025-08-22T14:35:00-04:00,507.95,508.25,507.92,508.21,NaN,NaN,NaN,508.70634579828794,NaN,NaN,507.9771800000011,510.0974211808921,505.8569388191101,507.73048007223696,507.54346630160745,509.1611999106442,505.9257326925707,13443,12561.166666666666,57.47750818695514,56.73406734019641,NaN,NaN,NaN,NaN,0.4540915914555245,15.266929216050931,12007428,0.03603220392669729,0.1949644155361625,0.15893221160946522
2025-08-22T14:40:00-04:00,508.2,508.2,507.83,507.99,NaN,NaN,NaN,508.70634579828794,NaN,NaN,507.96938000000114,510.0865033636346,505.85225663636766,507.73048007223696,507.54730400718466,509.1588691029626,505.9357389114067,9865,12360.333333333334,53.6102488900728,56.763300215829915,NaN,NaN,NaN,NaN,0.44879933492298674,15.046901771739888,11997563,0.019286427257284022,0.18304024568107025,0.16375381842378622
2025-08-22T14:45:00-04:00,508,508.22,507.96,508.06,NaN,NaN,NaN,508.70634579828794,NaN,NaN,507.9650800000012,510.0805756980931,505.84958430190926,507.73048007223696,507.5514456909176,509.15741534125857,505.94547604057664,9330,12139.066666666668,54.65566323897722,56.93412213892936,NaN,NaN,NaN,NaN,0.43531366814277683,14.895886297217745,12006893,0.010753796636856189,0.17719606421985645,0.16644226758300026
2025-08-22T14:50:00-04:00,508.05,508.22,507.99,508.13,NaN,NaN,NaN,508.70634579828794,NaN,NaN,507.93238000000116,509.98519363420775,505.8795663657946,507.73048007223696,507.5551339686313,509.15646704770506,505.95380088955756,7929,11946.7,55.73004874641693,56.84081789559713,NaN,NaN,NaN,NaN,0.4206484061325798,14.755657642304328,12014822,0.007791791363724265,0.1761820067876556,0.16839021542393134
2025-08-22T14:55:00-04:00,508.14,508.21,508,508,NaN,NaN,NaN,508.70634579828794,NaN,NaN,507.8847800000011,509.815085437249,505.9544745627532,507.73048007223696,507.5610420649683,509.1541050231032,505.9679791068334,14022,11940.766666666666,53.208606814901856,56.70688646804923,NaN,NaN,NaN,NaN,0.40560209140882264,14.625445319884726,12000800,-0.004304672483980948,0.16300937481895517,0.16731404730293611
2025-08-22T15:00:00-04:00,507.96,508.04,507.5,507.58,NaN,NaN,NaN,508.70634579828794,NaN,NaN,507.83958000000115,509.6887710039089,505.9903889960934,507.73048007223696,507.5620081840254,509.14982191983887,505.9741944482119,8161,11906.433333333332,45.97187632309838,55.839523145235475,NaN,NaN,NaN,NaN,0.4152019420224796,14.348414414949115,11992639,-0.03998963266678726,0.11732700646945204,0.1573166391362393
2025-08-22T15:05:00-04:00,507.6,507.71,507.41,507.44,NaN,NaN,NaN,508.70634579828794,NaN,NaN,507.7911800000012,509.550822720761,506.0315372792414,507.4726997683561,507.56154882717436,509.14066342141865,505.9824342329301,13600,12103.433333333332,43.831875248949025,54.76294717611227,NaN,NaN,NaN,NaN,0.40697323187801354,14.34017499209216,11979039,-0.07062865045700059,0.06903082606498856,0.13965947652198915
2025-08-22T15:10:00-04:00,507.47,507.73,507.35,507.64,NaN,NaN,NaN,508.70634579828794,NaN,NaN,507.7343800000012,509.317694793943,506.15106520605934,507.4726997683561,507.56167379234444,509.1323939182778,505.9909536664111,13330,12114.733333333334,47.5855725747662,53.91256619527155,NaN,NaN,NaN,NaN,0.4050465724581551,14.499627540843269,11992369,-0.07463983869154533,0.04635967815755748,0.12099951684910282
2025-08-22T15:15:00-04:00,507.6,507.6,506.98,507,NaN,NaN,NaN,508.70634579828794,NaN,NaN,507.6709800000011,509.1060315785573,506.23592842144495,507.4726997683561,507.55348209480803,509.1075874865077,505.99937670310834,28592,12739.066666666668,38.67785616693652,52.35641984551326,NaN,NaN,NaN,NaN,0.4232575315682846,15.561606554523419,11963777,-0.11518766442827041,-0.022985063686235208,0.0922026007420352
2025-08-22T15:20:00-04:00,506.99,507.49,506.91,507.39,NaN,NaN,NaN,508.6798967303885,NaN,NaN,507.6211800000011,508.9116788589566,506.33068114104566,507.4726997683561,507.5485052793701,509.08968503147656,506.0073255272636,22437,13180.433333333332,45.38685320786138,51.22574397239216,NaN,NaN,NaN,NaN,0.43445342217054883,16.70059949416452,11986214,-0.11051563297236917,-0.04594194047342626,0.06457369249894292
2025-08-22T15:25:00-04:00,507.4,507.57,507.04,507.12,NaN,NaN,NaN,508.6798967303885,NaN,NaN,507.57818000000117,508.78673170550775,506.3696282944946,507.4726997683561,507.5432039872676,509.07145898996276,506.0149489845724,23125,13429.8,41.96390734204127,49.73278706467228,NaN,NaN,NaN,NaN,0.44127817772979344,17.4205277300608,11963089,-0.11961335732850392,-0.08494300416168699,0.034670353166816936
2025-08-22T15:30:00-04:00,507.12,507.15,506.4,506.68,NaN,NaN,NaN,508.2946786324407,NaN,NaN,507.5343800000012,508.7107973309938,506.3579626690086,507.4726997683561,507.52659042007485,509.04318715483083,506.0099936853189,28236,13798.6,37.05893574742294,48.767406396114616,NaN,NaN,NaN,NaN,0.4633297364633796,19.325872366757498,11934853,-0.14744115993145218,-0.1496310967474983,-0.002189936816046116
2025-08-22T15:35:00-04:00,506.67,506.77,506.14,506.14,NaN,NaN,NaN,507.99151142187526,NaN,NaN,507.4920800000011,508.7130635252593,506.27109647474293,507.4726997683561,507.5096693342497,509.02182350043284,505.9975151680665,19836,13983.333333333334,32.099971365557906,47.273704329569675,NaN,NaN,NaN,NaN,0.4752347552874236,21.469532572542956,11915017,-0.1915955514758753,-0.24168437616089022,-0.05008882468501494
2025-08-22T15:40:00-04:00,506.15,506.41,505.75,506.38,NaN,NaN,NaN,507.6366699936082,NaN,NaN,507.4476800000012,508.66573342444616,506.2296265755562,507.4726997683561,507.4849029001778,508.9936565545475,505.97614924580813,26178,14308.033333333333,36.187014972455344,45.96042420188657,NaN,NaN,NaN,NaN,0.48843227276689516,23.936085670205596,11941195,-0.19345402370845843,-0.291906354320588,-0.09845233061212955
2025-08-22T15:45:00-04:00,506.38,506.94,506.3,506.91,NaN,NaN,NaN,507.6366699936082,NaN,NaN,507.4204800000012,508.62452566055475,506.21643433944763,507.18015981468494,507.47567194897596,508.97766794678546,505.97367595116646,17093,14044.766666666666,44.17789860923743,45.01045208919245,NaN,NaN,NaN,NaN,0.49925853899783024,24.427627456267032,11958288,-0.14975676558015333,-0.2856482875873212,-0.13589152200716786
2025-08-22T15:50:00-04:00,506.99,507.84,506.71,507.27,505.6192325058239,505.6192325058239,505.6192325058239,NaN,NaN,NaN,507.3978800000012,508.56951889349335,506.226241106509,506.8721278517479,507.46838619405383,508.94357429297264,505.993198095135,53136,15340.533333333333,48.86214339144631,44.67130169643342,NaN,NaN,NaN,NaN,0.5443115004979849,22.75426814316891,12011424,-0.09030441758777905,-0.24877204399189168,-0.15846762640411263
2025-08-22T15:55:00-04:00,507.3,507.72,506.8,507.1,505.6192325058239,NaN,NaN,NaN,NaN,NaN,507.3828800000012,508.5501774328446,506.2155825671578,506.86970228139836,507.44229310371117,508.8442081838211,506.04037802360125,163416,20438.6,46.86233481293604,44.114635380287616,NaN,NaN,NaN,NaN,0.5711463933195586,21.200434495292082,11848008,-0.05771121460651746,-0.23060664466225944,-0.17289543005574198
2025-08-25T09:30:00-04:00,506.67,508.14,505.18,506.6,NaN,NaN,NaN,508.6920526134951,508.6920526134951,508.6920526134951,507.35788000000116,508.5375661009688,506.17819389903354,506.58176182511875,506.64000000000004,506.64000000000004,506.64000000000004,44078,21554.233333333334,41.484499108198364,43.09709612041486,NaN,NaN,NaN,NaN,0.7417787937967315,22.037470807392896,11803930,-0.06458968645602331,-0.25363253812577113,-0.18904285166974782
2025-08-25T09:35:00-04:00,506.43,506.46,505.2,505.26,NaN,NaN,NaN,507.9605956765181,NaN,NaN,507.3154800000011,508.6332497647862,505.997710235216,506.421327568076,506.17968875883093,506.6781110722061,505.6812664454558,37595,22490.5,31.16300776011856,41.52241047364463,NaN,NaN,NaN,NaN,0.7887945942398246,22.814718811486507,11766335,-0.1493072831818544,-0.3756769556470658,-0.22636967246521142
2025-08-25T09:40:00-04:00,505.19,506.41,504.59,506.18,NaN,NaN,NaN,507.78193223667637,NaN,NaN,507.29808000000116,508.65189421499196,505.9442657850104,506.421327568076,506.0704403439006,506.54591139306456,505.59496929473664,25955,23009.933333333334,41.85870321641037,41.22861239459548,NaN,NaN,NaN,NaN,0.8624521232226978,24.127814150792386,11792290,-0.13380367724810127,-0.393624269025338,-0.2598205917772367
2025-08-25T09:45:00-04:00,506.16,506.7,505.3,506.605,NaN,NaN,NaN,507.78193223667637,NaN,NaN,507.28240000000113,508.6497320571663,505.91506794283595,506.1165230175071,506.0889175833825,506.53200220749846,505.64583295926656,17638,23305.633333333335,46.03048375594864,41.385655859381174,NaN,NaN,NaN,NaN,0.9008484001353606,24.747702630463618,11809928,-0.08758086567975576,-0.36929667387693144,-0.2817158081971757
2025-08-25T09:50:00-04:00,506.53,506.91,506.23,506.41,NaN,NaN,NaN,507.78193223667637,NaN,NaN,507.2708000000011,508.65756077055505,505.8840392294471,506.1165230175071,506.12614419575283,506.5663440544853,505.6859443370204,11941,23154.2,44.4543910118428,41.16200003345807,NaN,NaN,NaN,NaN,0.8850735144114068,24.903122399711535,11797987,-0.06389426436986795,-0.3615836386595106,-0.29768937428964265
2025-08-25T09:55:00-04:00,506.39,506.89,506.2,506.77,NaN,NaN,NaN,507.78193223667637,NaN,NaN,507.26300000000117,508.65653650629514,505.8694634937072,506.1165230175071,506.17276567003273,506.6158611560786,505.72967018398685,14303,23378.233333333334,47.99466368313473,41.827486284615084,NaN,NaN,NaN,NaN,0.871139691953449,25.082770670196027,11812290,-0.020010182460137804,-0.3227021023648149,-0.3026919199046771
2025-08-25T10:00:00-04:00,506.84,507.09,506.06,506.9,NaN,NaN,NaN,507.78193223667637,NaN,NaN,507.26520000000113,508.656087426964,505.87431257303825,506.1165230175071,506.23011561461277,506.67763352704225,505.7825977021833,19172,23667.933333333334,49.25250858440518,42.10360452579679,NaN,NaN,NaN,NaN,0.8824868568139149,24.827810177335948,11831462,0.019600357486003583,-0.2781914730471726,-0.2977918305331762
2025-08-25T10:05:00-04:00,506.97,507.29,506.5,507.09,NaN,NaN,NaN,507.78193223667637,NaN,NaN,507.26880000000114,508.656920396294,505.88067960370824,506.1165230175071,506.2706909977554,506.7366392975211,505.80474269798975,10047,23573.533333333333,51.11357716078693,42.75715236999291,NaN,NaN,NaN,NaN,0.8758806527557796,24.178480543998155,11841509,0.058240260813947176,-0.22499150451574224,-0.2832317653296894
2025-08-25T10:10:00-04:00,507.06,507.51,506.91,507.31,NaN,NaN,NaN,507.78193223667637,NaN,NaN,507.2770000000011,508.6611473890132,505.89285261098905,505.88121841400573,506.3395514287135,506.85333347071736,505.8257693867096,13770,23698.7,53.251392739599886,43.913756440862684,NaN,NaN,NaN,NaN,0.85617489184465,23.13483105812564,11855279,0.09602800891144714,-0.1631967541903805,-0.2592247631018276
2025-08-25T10:15:00-04:00,507.37,508,507.01,507.03,505.1278703386062,505.1278703386062,505.1278703386062,NaN,NaN,NaN,507.28180000000117,508.6608137905273,505.90278620947504,505.6079347491517,506.40010263795,506.9527478093492,505.8474574665508,12442,23760.066666666666,50.24010307629042,45.209480134486434,NaN,NaN,NaN,NaN,0.8657338281414614,21.686221193396022,11842837,0.09917304725736428,-0.13525845403012227,-0.23443150128748655
2025-08-25T10:20:00-04:00,507.09,507.5,506.81,507.5,505.1278703386062,NaN,NaN,NaN,NaN,NaN,507.29280000000114,508.66982455846954,505.91577544153273,505.6079347491517,506.42647934511655,506.99075343685854,505.86220525337455,6471,23569.3,54.854939501329966,46.54290331512034,NaN,NaN,NaN,NaN,0.8531814118456426,20.282059317974024,11849308,0.1280770505926381,-0.07433518804668893,-0.20241223863932703
2025-08-25T10:25:00-04:00,507.46,507.46,506.87,507.21,505.1278703386062,NaN,NaN,NaN,NaN,NaN,507.3016000000012,508.6707492812518,505.9324507187506,505.6079347491517,506.4472018756238,507.017144185523,505.8772595657246,6035,23421.8,51.67069804768431,47.078103275009404,NaN,NaN,NaN,NaN,0.8372398824280963,18.978194719367885,11843273,0.12281774052570518,-0.04889006298219556,-0.17170780350790074
2025-08-25T10:30:00-04:00,507.15,507.475,506.93,507.35,505.1278703386062,NaN,NaN,NaN,NaN,NaN,507.3132000000012,508.67393915005124,505.95246084995114,505.6079347491517,506.4731011950177,507.05149611688233,505.8947062731531,7300,23282.533333333333,53.08650095123213,47.37984310070839,NaN,NaN,NaN,NaN,0.8163656051118048,17.73749723989559,11850573,0.12358289816338658,-0.017229180803667532,-0.1408120789670541
2025-08-25T10:35:00-04:00,507.345,507.53,507.07,507.07,505.1278703386062,NaN,NaN,NaN,NaN,NaN,507.32920000000115,508.6589584120745,505.9994415879278,505.72397007325253,506.50170571475036,507.08687857601376,505.91653285348696,8988,23134.033333333333,49.93571958893714,47.599370584708474,NaN,NaN,NaN,NaN,0.7909109190323887,16.471603525904673,11841585,0.10099887539065153,-0.014563484728739695,-0.11556236011939122
2025-08-25T10:40:00-04:00,507.04,507.18,506.75,506.96,505.1278703386062,NaN,NaN,NaN,NaN,NaN,507.3372000000011,508.65309233403656,506.0213076659656,505.72397007325253,506.52658570258956,507.1052375964269,505.9479338087522,13429,23252.833333333332,48.7125288615626,48.11565842423449,NaN,NaN,NaN,NaN,0.7651315676729329,15.94407974997086,11828156,0.07558273645959754,-0.021083939544894292,-0.09666667600449183
2025-08-25T10:45:00-04:00,507.05,508.05,506.89,507.97,505.18999107353466,NaN,NaN,NaN,NaN,NaN,507.3640000000011,508.67576369615296,506.05223630384927,506.1421408468816,506.57600389355247,507.18620701518824,505.9658007719167,11609,23328.8,58.712798061200004,50.08350058859745,NaN,NaN,NaN,NaN,0.7933364556962966,15.795464166914602,11839765,0.12102735311920261,0.05461751539451143,-0.06640983772469118
2025-08-25T10:50:00-04:00,507.95,508.1,507.55,507.68,505.57362784291945,NaN,NaN,NaN,NaN,NaN,507.38080000000116,508.6867928921953,506.07480710780703,506.2987126775053,506.6227324480743,507.26443185912933,505.9810330370193,10560,23416.5,55.37416345077208,51.04889060533758,NaN,NaN,NaN,NaN,0.7759552802894191,15.736547123926131,11829205,0.12526502790111604,0.09017144715170389,-0.03509358074941217
2025-08-25T10:55:00-04:00,507.65,507.86,507.36,507.36,505.57362784291945,NaN,NaN,NaN,NaN,NaN,507.38240000000116,508.6880909873401,506.0767090126622,506.2987126775053,506.6646160848599,507.31944757348134,506.0097845962385,13183,23388.533333333333,51.86920882001726,51.46594239562819,NaN,NaN,NaN,NaN,0.7562441888401749,15.271456773021521,11816022,0.1012528096590538,0.09147243132440508,-0.009780378334648721
2025-08-25T11:00:00-04:00,507.35,508.14,507.28,508.14,505.57362784291945,NaN,NaN,NaN,NaN,NaN,507.3950000000011,508.71742504311277,506.07257495688947,506.3571761136034,506.7185672872706,507.40454435018324,506.032590224358,13527,23567.4,58.726814641491785,52.4854012263174,NaN,NaN,NaN,NaN,0.7636553182087348,15.316028673469667,11829549,0.13076152048433487,0.15367152227076986,0.022910001786434996
2025-08-25T11:05:00-04:00,508.11,508.19,507.59,507.64,505.6760051139441,NaN,NaN,NaN,NaN,NaN,507.3904000000012,508.7077744168355,506.0730255831669,506.46374089088266,506.7417211507833,507.4382905344504,506.0451517671162,6480,23330.066666666666,53.46782715123337,52.87634147403874,NaN,NaN,NaN,NaN,0.7519656526223982,15.441124826362639,11823069,0.11028457575199048,0.1607657214764231,0.050481145724432616
2025-08-25T11:10:00-04:00,507.7,507.93,507.52,507.67,505.6760051139441,NaN,NaN,NaN,NaN,NaN,507.39280000000116,508.71176498603035,506.073835013972,506.46374089088266,506.76622634082014,507.4704510880082,506.0620015936321,7935,23150.233333333334,53.73552768633784,53.196557124176785,NaN,NaN,NaN,NaN,0.727539534577943,15.385230769566588,11831004,0.09312302674550238,0.1668849291563106,0.07376190241080821
2025-08-25T11:15:00-04:00,507.631,507.79,507.48,507.6,505.6760051139441,NaN,NaN,NaN,NaN,NaN,507.3952000000011,508.71522720976924,506.075172790233,506.46374089088266,506.79980701047657,507.50984706391756,506.0897669570356,12741,22621.866666666665,52.96978025862999,53.32914305973701,NaN,NaN,NaN,NaN,0.6977152821080901,15.230924517319396,11818263,0.07234512771055983,0.164193312049008,0.09184818433844817
2025-08-25T11:20:00-04:00,507.62,507.73,507.49,507.655,505.6760051139441,NaN,NaN,NaN,NaN,NaN,507.39050000000117,508.70510906528176,506.0758909347206,506.47095533613196,506.84640550742455,507.56192529340234,506.13088572144676,19463,22522.733333333334,53.53011169701664,53.34905155669535,NaN,NaN,NaN,NaN,0.6650213333860843,15.087640140232722,11837726,0.05820210113666707,0.164600810759282,0.10639870962261494
2025-08-25T11:25:00-04:00,507.67,507.72,507.39,507.39,505.6760051139441,NaN,NaN,NaN,NaN,NaN,507.3832000000012,508.6936789332277,506.07272106677465,506.54776426890555,506.8795878087337,507.5913203186633,506.16785529880406,18434,22366.366666666665,50.41349997732471,53.36143704962637,NaN,NaN,NaN,NaN,0.641091238144224,14.671647733811117,11819292,0.02840477812252007,0.14190468227576503,0.11349990415324496
2025-08-25T11:30:00-04:00,507.38,507.43,507.01,507.21,505.6760051139441,NaN,NaN,NaN,NaN,NaN,507.3670000000012,508.66556227972205,506.0684377202804,506.54776426890555,506.88987846545444,507.59305781641547,506.1866991144934,11434,21806.3,48.3541524628491,52.897095118306304,NaN,NaN,NaN,NaN,0.6252990068482092,13.939415913833372,11807858,-0.004282568526662978,0.10814669349491624,0.11242926202157921
2025-08-25T11:35:00-04:00,507.28,507.45,507.16,507.21,505.6760051139441,NaN,NaN,NaN,NaN,NaN,507.3494000000012,508.632045139682,506.0667548603204,506.54776426890555,506.9030742527289,507.5975749543431,506.20857355111474,13348,21590.033333333333,48.35415246284911,52.660199005103784,NaN,NaN,NaN,NaN,0.6013490777876201,13.206913929225431,11807858,-0.025570860949438418,0.0804656858347812,0.10603654678421962
2025-08-25T11:40:00-04:00,507.23,507.23,506.95,507.23,505.6760051139441,NaN,NaN,NaN,NaN,NaN,507.3312000000012,508.5941292277254,506.06827077227706,506.54776426890555,506.9067277559103,507.5963852095895,506.2170703022311,6163,20922.866666666665,48.624588746388994,52.34149099047214,NaN,NaN,NaN,NaN,0.5783955722313637,13.034587782494198,11814021,-0.03726384511253003,0.059456740393557084,0.09672058550608711
2025-08-25T11:45:00-04:00,507.21,507.64,507.05,507.06,505.6760051139441,NaN,NaN,NaN,NaN,NaN,507.3080000000012,508.54716261820755,506.0688373817948,506.55253224454367,506.9148438156876,507.598292562585,506.2313950687902,9542,20671.166666666668,46.40048188376432,52.08897401153122,NaN,NaN,NaN,NaN,0.5792244599291216,12.395802625695326,11804479,-0.05437013468353735,0.028757917151665424,0.08312805183520278
2025-08-25T11:50:00-04:00,507.06,507.4,506.72,506.72,505.6760051139441,NaN,NaN,NaN,NaN,NaN,507.2768000000012,508.49487513494904,506.0587248650533,506.55253224454367,506.91583873809435,507.58854163712937,506.24313583905933,13025,19334.133333333335,42.239174387412845,51.62659154909195,NaN,NaN,NaN,NaN,0.5864227127913236,11.993696550427346,11791454,-0.0846977215591207,-0.022744100113698096,0.0619536214454226
2025-08-25T11:55:00-04:00,506.72,507.285,506.69,507.2,505.6760051139441,NaN,NaN,NaN,NaN,NaN,507.2526000000011,508.42695299406046,506.07824700594176,506.55253224454367,506.917720404027,507.5861649044912,506.2492759035628,5575,14072.766666666666,49.169851974655444,50.9449525429102,NaN,NaN,NaN,NaN,0.5870353761633739,11.687634003729604,11797029,-0.0691988116575974,-0.024544893126574152,0.044653918531023254
2025-08-25T12:00:00-04:00,507.16,507.38,507.09,507.18,505.6760051139441,NaN,NaN,NaN,NaN,NaN,507.24180000000115,508.408668902024,506.0749310979783,506.55253224454367,506.92506731820777,507.58686743076595,506.2632672056496,10637,12958.066666666668,48.90653271848068,50.4829789191751,NaN,NaN,NaN,NaN,0.5658185635802772,11.147043374160726,11786392,-0.0575403336702928,-0.027271498556842744,0.030268835113450056
2025-08-25T12:05:00-04:00,507.14,507.84,507.09,507.48,505.6760051139441,NaN,NaN,NaN,NaN,NaN,507.23360000000116,508.3878270809452,506.0793729190571,506.55253224454367,506.93809758778116,507.5972162317574,506.27897894380493,10603,12058.333333333334,52.97463476524646,50.5619379152629,NaN,NaN,NaN,NaN,0.5789743804674002,11.15765208004826,11796995,-0.02834732220483443,-0.005165317642592981,0.023182004562241447
2025-08-25T12:10:00-04:00,507.48,507.55,507.17,507.27,505.6760051139441,NaN,NaN,NaN,NaN,NaN,507.2190000000012,508.35235960501484,506.08564039498754,506.55253224454367,506.9425244023079,507.5992171709541,506.28583163366176,5066,11362.033333333333,49.97504163096962,49.93681127165418,NaN,NaN,NaN,NaN,0.5647619247197284,11.167503021229543,11791929,-0.02217675002141059,-0.004538932964521791,0.0176378170568888
2025-08-25T12:15:00-04:00,507.28,507.42,507.16,507.16,505.6760051139441,NaN,NaN,NaN,NaN,NaN,507.1980000000012,508.2954752818513,506.10052471815106,506.55253224454367,506.9478970578143,507.5999957111042,506.2957984045244,8065,11042.933333333332,48.42818298792003,49.57683668856037,NaN,NaN,NaN,NaN,0.5429932158111758,11.147086993878244,11783864,-0.02432735667053574,-0.012771378781280873,0.011555977889254864
2025-08-25T12:20:00-04:00,507.21,507.305,507.06,507.18,505.6760051139441,NaN,NaN,NaN,NaN,NaN,507.18180000000126,508.255693399713,506.10790660028954,506.55253224454367,506.95012547330003,507.5995060097868,506.30074493681326,4394,10791.366666666667,48.73885900321028,49.21993178262268,NaN,NaN,NaN,NaN,0.5217079861103778,10.823152808925283,11788258,-0.023229035386517775,-0.017480316343892355,0.00574871904262542
2025-08-25T12:25:00-04:00,507.18,507.36,507.13,507.23,505.6760051139441,NaN,NaN,NaN,NaN,NaN,507.1652000000012,508.20953320082737,506.1208667991751,506.55253224454367,506.9526347479675,507.59975590447306,506.305513591462,4025,10448.766666666666,49.5569865365902,48.97616080247699,NaN,NaN,NaN,NaN,0.5008717013882092,10.671104705033606,11792283,-0.01818445124795032,-0.01698184501731248,0.0012026062306378397
2025-08-25T12:30:00-04:00,507.23,507.23,506.9,507.12,505.6760051139441,NaN,NaN,NaN,NaN,NaN,507.1450000000012,508.1523211973141,506.13767880268824,506.55253224454367,506.9549713478246,507.59651567313716,506.31342702251203,8464,10091.833333333334,47.75136833028508,48.56339341913902,NaN,NaN,NaN,NaN,0.48866657986048295,9.996376871688904,11783819,-0.021100251608302402,-0.025172708279740164,-0.004072456671437762
2025-08-25T12:35:00-04:00,507.2,507.4,506.94,507.21,505.6760051139441,NaN,NaN,NaN,NaN,NaN,507.1292000000012,508.1067241349071,506.15167586509534,506.53909320736506,506.9579876219499,507.59581405940224,506.3201611844975,6337,9968.166666666666,49.37656945819208,48.48932695348668,NaN,NaN,NaN,NaN,0.48661896701330415,9.68450891099425,11790156,-0.016040991176180058,-0.024123695641662835,-0.008082704465482777
2025-08-25T12:40:00-04:00,507.25,507.26,506.91,506.91,505.6760051139441,NaN,NaN,NaN,NaN,NaN,507.1158000000012,508.08658392772696,506.1450160722754,506.53909320736506,506.9593755930866,507.59079801116945,506.3279531750037,9896,9839.033333333333,44.41699108558265,48.208101140824795,NaN,NaN,NaN,NaN,0.4768604693694943,9.299045115098306,11780260,-0.03110066015911775,-0.04695852966437997,-0.015857869505262218
2025-08-25T12:45:00-04:00,506.925,507.18,506.925,506.99,505.6760051139441,NaN,NaN,NaN,NaN,NaN,507.1068000000011,508.07373072891676,506.13986927108544,506.53909320736506,506.961294316407,507.5843892507031,506.33819938211093,13351,9869.333333333334,45.97535604178605,48.038187110748865,NaN,NaN,NaN,NaN,0.4620847215573862,8.941114447480643,11793611,-0.03365943465170658,-0.05793216281989544,-0.024272728168188863
2025-08-25T12:50:00-04:00,507,507.04,506.72,506.86,505.6760051139441,NaN,NaN,NaN,NaN,NaN,507.0912000000011,508.04833647645984,506.13406352354235,506.53909320736506,506.96059520968646,507.58125819762967,506.33993222174325,4030,9787.966666666667,43.82510987246965,47.695367191183195,NaN,NaN,NaN,NaN,0.4519358128747153,8.677684798995484,11789581,-0.04157374821478173,-0.07623991343666603,-0.0346661652218843
2025-08-25T12:55:00-04:00,506.885,506.95,506.8,506.85,505.6760051139441,NaN,NaN,NaN,NaN,NaN,507.08820000000117,508.04739916305255,506.1290008369498,506.44514788975147,506.95960615439265,507.5770671845931,506.3421451241922,5396,9766.666666666666,43.65596920233997,47.49933057108145,NaN,NaN,NaN,NaN,0.4303689690979483,8.433071553973551,11784185,-0.044677053878656246,-0.09051248257020461,-0.045835428691548365
2025-08-25T13:00:00-04:00,506.845,506.87,506.21,506.39,505.6760051139441,NaN,NaN,NaN,NaN,NaN,507.0682000000012,508.04296922101275,506.0934307789896,506.44514788975147,506.94787006594606,507.5619576613793,506.3337824705128,13135,9961.166666666666,36.649007195041946,47.10003291448353,NaN,NaN,NaN,NaN,0.4467711855909538,9.789125003018563,11771050,-0.07321835326005012,-0.13735837026661102,-0.0641400170065609
2025-08-25T13:05:00-04:00,506.38,506.42,505.93,506.17,505.6760051139441,NaN,NaN,NaN,NaN,NaN,507.0492000000011,508.0557075431749,506.04269245682735,506.44514788975147,506.9224758863057,507.5419624570372,506.30298931557417,17816,10255.433333333332,33.85065283161099,46.00580440426607,NaN,NaN,NaN,NaN,0.44985895804874343,11.601976449597327,11753234,-0.10072439345806626,-0.19004550882914373,-0.08932111537107747
2025-08-25T13:10:00-04:00,506.18,506.39,505.94,506.26,505.6760051139441,NaN,NaN,NaN,NaN,NaN,507.0408000000012,508.0663230052974,506.01527699470495,506.44514788975147,506.91164978626836,507.53276161938425,506.29053795315247,8228,10082.066666666668,36.003442595004046,45.08415510973202,NaN,NaN,NaN,NaN,0.4498690324738324,13.28533850713475,11761462,-0.10612659412687478,-0.22197935802967095,-0.11585276390279617
2025-08-25T13:15:00-04:00,506.26,506.26,505.9,506.045,505.6760051139441,NaN,NaN,NaN,NaN,NaN,507.03890000000115,508.0714198082929,506.0063801917094,506.44514788975147,506.8987085261882,507.52369329200997,506.27372376036647,8597,9981.666666666666,33.22192693245084,43.67324740738947,NaN,NaN,NaN,NaN,0.44344981586855964,14.928970283274298,11752865,-0.11661384760464932,-0.2616200734086078,-0.1450062258039585
2025-08-25T13:20:00-04:00,506.15,506.2,505.87,505.92,505.6760051139441,NaN,NaN,NaN,NaN,NaN,507.0297000000012,508.09327023005847,505.9661297699439,506.44514788975147,506.8876692632115,507.51668571879117,506.2586528076318,6941,9861.033333333333,31.689064652322358,42.36710619462895,NaN,NaN,NaN,NaN,0.43534625759223283,16.51821160310242,11745924,-0.12372917822181834,-0.29966769858123143,-0.1759385203594131
2025-08-25T13:25:00-04:00,505.94,505.95,505.75,505.85,505.6760051139441,NaN,NaN,NaN,NaN,NaN,507.00850000000116,508.12186112488877,505.89513887511356,506.32111831180123,506.87383434696994,507.50987768787155,506.23779100606833,7664,9677.066666666668,30.831156403693484,41.11017572432706,NaN,NaN,NaN,NaN,0.41853581062135825,18.246543655203023,11738260,-0.12456608019146792,-0.331646120598748,-0.20708004040728006
2025-08-25T13:30:00-04:00,505.79,505.91,505.1,505.23,NaN,NaN,NaN,506.971834141731,506.971834141731,506.971834141731,506.9677000000011,508.18445339923755,505.7509466007647,506.293894649441,506.82825530396883,507.5038415417037,506.15266906623395,18517,9843.4,24.503558023576588,39.37908279721036,NaN,NaN,NaN,NaN,0.44649753843411855,20.89825441016786,11719743,-0.15623971673985335,-0.40237968633209675,-0.2461399695922434
2025-08-25T13:35:00-04:00,505.3,505.3,504.79,505.15,NaN,NaN,NaN,506.5147053171069,NaN,NaN,506.92870000000113,508.2467770973618,505.61062290264044,506.1798925756422,506.7725036194642,507.5047751592804,506.040232079648,19545,10278.9,23.824121379872665,37.54102100030197,NaN,NaN,NaN,NaN,0.45103342854596656,23.719706136550915,11700198,-0.1707631963693237,-0.45959396505389805,-0.28883076868457436
2025-08-25T13:40:00-04:00,505.18,505.44,504.87,505.02,NaN,NaN,NaN,506.5147053171069,NaN,NaN,506.8971000000011,508.31700857256766,505.47719142743455,506.1798925756422,506.74566640340163,507.50161765994204,505.9897151468612,10056,10349.6,22.72157638335669,35.753178718378514,NaN,NaN,NaN,NaN,0.45953104079268275,25.744461931321048,11690142,-0.17657762441919134,-0.5095527992085636,-0.3329751747893722
2025-08-25T13:45:00-04:00,505,505.27,504.88,505.22,NaN,NaN,NaN,506.5147053171069,NaN,NaN,506.89630000000113,508.31993732547573,505.47266267452653,505.92391406051377,506.72230603103895,507.49728104602525,505.94733101605266,9101,10228.266666666666,28.224894243128688,34.242344774445414,NaN,NaN,NaN,NaN,0.4545645378789187,27.62459231217903,11699243,-0.15516630055119218,-0.5269330504783625,-0.3717667499271703
2025-08-25T13:50:00-04:00,505.2,505.4,505.1,505.31,NaN,NaN,NaN,506.5147053171069,NaN,NaN,506.87890000000107,508.3573428141268,505.4004571858753,505.41813124841104,506.70160144918503,507.4900586868775,505.9131442114926,9141,9884.2,30.619323819294678,33.256797112567696,NaN,NaN,NaN,NaN,0.44352421374470696,28.794970644524163,11708384,-0.12447910744328244,-0.5273656342312734,-0.4028865267879909
2025-08-25T13:55:00-04:00,505.3,505.34,505.16,505.22,NaN,NaN,NaN,506.5147053171069,NaN,NaN,506.85120000000114,508.39938546510007,505.3030145349022,505.3635049987288,506.6862990839112,507.48460230815186,505.8879958596705,6784,9495.866666666667,29.55743357040464,32.08408836461188,NaN,NaN,NaN,NaN,0.4247010556200815,29.881750524558935,11701600,-0.10079011899192997,-0.5288741755279034,-0.4280840565359734
2025-08-25T14:00:00-04:00,505.21,505.3,505.01,505.04,NaN,NaN,NaN,506.5147053171069,NaN,NaN,506.82380000000114,508.4488348409783,505.198765159024,505.25880399898307,506.66326381528637,507.4778568094071,505.8486708211656,9651,9436.433333333332,27.50305862166971,30.918227560983315,NaN,NaN,NaN,NaN,0.41507955164722,31.15566854406576,11691949,-0.08824315423507223,-0.5383879993298137,-0.4501448450947415
2025-08-25T14:05:00-04:00,505.04,505.21,504.82,504.93,NaN,NaN,NaN,506.38138050594335,NaN,NaN,506.7870000000011,508.49638819307194,505.0776118069303,505.23404319918643,506.6301013822871,507.4697066758877,505.79049608868644,13270,9433.833333333334,26.300034938106563,29.678517970680925,NaN,NaN,NaN,NaN,0.41328815510098904,32.64791486935552,11678679,-0.0786691662329525,-0.5484813028859321,-0.4698121366529796
2025-08-25T14:10:00-04:00,504.945,505.32,504.79,505.29,NaN,NaN,NaN,506.38138050594335,NaN,NaN,506.7548000000011,508.51437944821475,504.9952205517875,505.07723455934917,506.59916328614975,507.45690219459783,505.74142437770166,14160,9700.4,36.14437959971005,29.642473142442928,NaN,NaN,NaN,NaN,0.42162471545091645,33.50025955847938,11692839,-0.04128686179866187,-0.521420713901307,-0.4801338521026451
2025-08-25T14:15:00-04:00,505.34,505.56,505.29,505.49,NaN,NaN,NaN,506.38138050594335,NaN,NaN,506.7228000000011,508.514729863216,504.93087013678615,504.8067876474794,506.585925622367,507.4475210446849,505.72433020004905,7960,9647.666666666666,40.86980607349456,30.1438412311489,NaN,NaN,NaN,NaN,0.41079437863299256,33.22342048526731,11700799,0.0014487893676618513,-0.4783228653930678,-0.47977165476072964
2025-08-25T14:20:00-04:00,505.53,505.67,505.42,505.58,NaN,NaN,NaN,506.38138050594335,NaN,NaN,506.6882000000012,508.50013792229737,504.876262077705,504.7979636253946,506.5638934938594,507.4291376709256,505.69864931679314,15159,9718.8,42.91694031224417,30.63766249666605,NaN,NaN,NaN,NaN,0.3993090658734931,32.5165659389686,11715958,0.0382762959985975,-0.43192628476248274,-0.47020258076108024
2025-08-25T14:25:00-04:00,505.61,505.64,505.34,505.48,NaN,NaN,NaN,506.38138050594335,NaN,NaN,506.6572000000011,508.4975012347332,504.81689876526906,504.7979636253946,506.5512211566998,507.41916752657187,505.6832747868277,8430,9813.966666666667,41.209760437142606,31.20822203271546,NaN,NaN,NaN,NaN,0.3922155611682444,32.06093769390627,11707528,0.05725753779590664,-0.39863065851619695,-0.4558881963121036
2025-08-25T14:30:00-04:00,505.51,505.58,505.27,505.41,NaN,NaN,NaN,506.38138050594335,NaN,NaN,506.6154000000011,508.4721001250935,504.7586998749087,504.7979636253946,506.5263809209249,507.4006071141211,505.6521547277287,16089,9995.7,40.009980505092905,31.802573165056206,NaN,NaN,NaN,NaN,0.3863430210847985,31.813993208640806,11691439,0.06584208687899129,-0.3735855877133645,-0.43942767459235577
2025-08-25T14:35:00-04:00,505.41,505.52,505.295,505.42,NaN,NaN,NaN,506.38138050594335,NaN,NaN,506.5796000000011,508.4579618806402,504.701238119362,504.7979636253946,506.5172398744365,507.3936588610084,505.64082088786455,6058,9844.2,40.27748202674752,32.477310709560065,NaN,NaN,NaN,NaN,0.374818519578739,31.584687615180012,11697497,0.07241551980891092,-0.3489082748312171,-0.42132379464012804
2025-08-25T14:40:00-04:00,505.41,505.54,505.15,505.22,NaN,NaN,NaN,506.38138050594335,NaN,NaN,506.53700000000106,508.4399934300216,504.6340065699805,504.7979636253946,506.49571166633655,507.37897710910124,505.61244622357185,13338,10119.933333333332,36.748113697996025,33.35192182916145,NaN,NaN,NaN,NaN,0.3759029110374036,31.750414238768176,11684159,0.06381707486004656,-0.3415524510650698,-0.4053695259251164
2025-08-25T14:45:00-04:00,505.2,505.26,505.09,505.2,NaN,NaN,NaN,506.38138050594335,NaN,NaN,506.49960000000107,508.43249093191605,504.5667090680861,504.7979636253946,506.47270622307343,507.36497557511467,505.5804368710322,13419,10298.4,36.404575270371986,34.25052567848283,NaN,NaN,NaN,NaN,0.3611955602490187,32.05550836036793,11670740,0.057501662942075316,-0.33349244724752225,-0.39099411018959757
2025-08-25T14:50:00-04:00,505.19,505.25,504.93,504.99,NaN,NaN,NaN,506.29956942048574,NaN,NaN,506.46020000000107,508.43382910264665,504.4865708973555,504.7979636253946,506.4498315629385,507.352689178741,505.54697394713605,12569,10570.9,32.92417527344121,34.9792827420603,NaN,NaN,NaN,NaN,0.3582530202312312,32.723729116074466,11658171,0.04069186217999643,-0.34012928246460206,-0.3808211446445985
2025-08-25T14:55:00-04:00,504.99,505.16,504.67,504.72,NaN,NaN,NaN,506.1364071741,NaN,NaN,506.39520000000107,508.37969384848503,504.4107061515171,504.7979636253946,506.4148766345468,507.33793766475753,505.491815604336,17380,11016.066666666668,29.075357047663147,35.04003008524133,NaN,NaN,NaN,NaN,0.36766351878614384,33.88184363310233,11640791,0.014263774519314765,-0.362991426495455,-0.3772552010147698
2025-08-25T15:00:00-04:00,504.71,504.75,504.55,504.58,NaN,NaN,NaN,505.84316139345907,NaN,NaN,506.3332000000011,508.3467488656704,504.3196511343318,504.7979636253946,506.38401796506076,507.3282466075346,505.43978932258693,13968,11199.533333333333,27.293700947724815,34.80248559441491,NaN,NaN,NaN,NaN,0.3556875531585613,35.17614990503036,11626823,-0.008543678737833682,-0.3879347994370619,-0.3793911206992282
2025-08-25T15:05:00-04:00,504.61,505,504.5,504.94,NaN,NaN,NaN,505.84316139345907,NaN,NaN,506.28480000000104,508.31357890235864,504.25602109764344,504.7979636253946,506.3551128024403,507.31413609617715,505.3960895087035,15175,11494.133333333333,37.841430424005694,35.394199655386416,NaN,NaN,NaN,NaN,0.36599558507580693,35.08946706130928,11641998,0.004042120573936159,-0.374338469981808,-0.37838059055574413
2025-08-25T15:10:00-04:00,504.93,505.24,504.81,504.99,NaN,NaN,NaN,505.84316139345907,NaN,NaN,506.221800000001,508.2114851597283,504.2321148402737,504.79237090031563,506.3277266202491,507.29568838259974,505.3597648578985,17181,11736.966666666667,39.16156190293192,36.22694988976229,NaN,NaN,NaN,NaN,0.37056732899896405,33.963232984643135,11659179,0.018359267923853895,-0.35543150565092674,-0.37379077357478063
2025-08-25T15:15:00-04:00,504.99,505.02,504.78,505,NaN,NaN,NaN,505.84316139345907,NaN,NaN,506.169000000001,508.1454149348604,504.1925850651416,504.7468967202525,506.295201460059,507.27468600039583,505.31571691972215,20104,11962.066666666668,39.438591913499316,37.165418245147485,NaN,NaN,NaN,NaN,0.36124109121332443,33.00099439753449,11679283,0.030416511122199008,-0.3357701346720319,-0.3661866457942309
2025-08-25T15:20:00-04:00,505.01,505.37,504.93,505.2,NaN,NaN,NaN,505.84316139345907,NaN,NaN,506.119600000001,508.0667341388433,504.17246586115874,504.741017376202,506.2739722247204,507.2562399164307,505.29170453301015,16524,12378.533333333333,44.84771599743282,37.78708513069911,NaN,NaN,NaN,NaN,0.3668667275552297,30.7812950183883,11695807,0.052481260311732225,-0.3005850704045656,-0.35306633071629784
2025-08-25T15:25:00-04:00,505.215,505.3,505.12,505.24,NaN,NaN,NaN,505.84316139345907,NaN,NaN,506.0724000000011,507.98786050710527,504.1569394928969,504.7218139009616,506.25558669891115,507.2389781532908,505.2721952445315,15595,12718.5,45.888675474966796,38.14557580223285,NaN,NaN,NaN,NaN,0.3535191041584281,28.720145594895406,11711402,0.06933140814723715,-0.2664020705322514,-0.33573347867948855
2025-08-25T15:30:00-04:00,505.265,505.48,505.1,505.12,NaN,NaN,NaN,505.84316139345907,NaN,NaN,506.021700000001,507.9007695662595,504.14263043374245,504.6420772600847,506.24044291389555,507.2243047325419,505.2565810952492,13443,12728.766666666666,43.25128018731542,38.1694572218808,NaN,NaN,NaN,NaN,0.35541059671854003,27.143991360437063,11697959,0.07166098577020125,-0.24615724646673698,-0.3178182322369382
2025-08-25T15:35:00-04:00,505.11,505.39,505.11,505.36,NaN,NaN,NaN,505.84316139345907,NaN,NaN,505.98110000000105,507.82759862026455,504.13460137973755,504.6420772600847,506.22028278535265,507.2033115017408,505.2372540689645,19595,12788.066666666668,49.50236538493147,38.761786146722855,NaN,NaN,NaN,NaN,0.35002412552435663,25.68041957129717,11717554,0.08757826007802705,-0.20834540713940441,-0.29592366721743146
2025-08-25T15:40:00-04:00,505.37,505.4,504.99,505.07,NaN,NaN,NaN,505.84316139345907,NaN,NaN,505.93830000000094,507.76800555967,504.1085944403319,504.6420772600847,506.2068860820796,507.19092169088515,505.2228504732741,11788,12906.733333333334,43.29623468098136,38.99651858785774,NaN,NaN,NaN,NaN,0.3543081165583289,23.85589911650803,11705766,0.07715465921587122,-0.19948034319759245,-0.27663500241346367
2025-08-25T15:45:00-04:00,505.1,505.115,504.65,505.03,NaN,NaN,NaN,505.84316139345907,NaN,NaN,505.89470000000097,507.7049048599549,504.084495140047,504.6420772600847,506.1719779363088,507.16450797014585,505.17944790247174,26423,13500.933333333332,42.504684522370624,39.15560448040225,NaN,NaN,NaN,NaN,0.36221467966130766,23.266104821618462,11679343,0.06654609536540745,-0.19345238320670433,-0.2599984785721118
2025-08-25T15:50:00-04:00,505.13,505.3,504.77,504.81,NaN,NaN,NaN,505.84316139345907,NaN,NaN,505.846300000001,507.64044470848296,504.05215529151906,504.6420772600847,506.13021163806815,507.1302331043138,505.1301901718225,34451,14417.933333333332,38.35170007663948,39.27014636459108,NaN,NaN,NaN,NaN,0.3741993453997878,22.0222222623837,11644892,0.04473886724461851,-0.20407489451633865,-0.24881376176095715
2025-08-25T15:55:00-04:00,504.79,505.21,504.15,504.17,NaN,NaN,NaN,505.84316139345907,NaN,NaN,505.788500000001,507.60853983332095,503.9684601666811,504.6420772600847,505.93804768626353,507.0131536805657,504.86294169196134,134524,18646.6,29.363490919363997,38.7672117680905,NaN,NaN,NaN,NaN,0.4231851064426602,22.43619716120373,11510368,-0.009849683485446903,-0.2611258661177658,-0.2512761826323189
2025-08-26T09:30:00-04:00,504.14,504.7,502.6,503.695,NaN,NaN,NaN,505.1522635664669,NaN,NaN,505.728000000001,507.619853058551,503.836146941451,504.6420772600847,503.66499999999996,503.66499999999996,503.66499999999996,48295,19639.2,24.73087449928306,38.181975998507774,NaN,NaN,NaN,NaN,0.5429575988396106,24.809773401148185,11462073,-0.07157094616366494,-0.34073986533690004,-0.2691689191732351
2025-08-26T09:35:00-04:00,503.7,504.93,503.25,504.65,NaN,NaN,NaN,505.1522635664669,NaN,NaN,505.677000000001,507.54470661372346,503.8092933862785,504.6420772600847,503.916544738243,504.21752110974893,503.615568366737,33734,20112.166666666668,43.89584408244308,39.24058221527777,NaN,NaN,NaN,NaN,0.6241749132082103,26.368101726139347,11495807,-0.043104940005381454,-0.3230500941799619,-0.27994515417458044
2025-08-26T09:40:00-04:00,504.65,504.92,503.83,504.06,NaN,NaN,NaN,505.1522635664669,NaN,NaN,505.614600000001,507.48575134474686,503.7434486552552,504.6420772600847,503.9897794304786,504.293653385671,503.68590547528623,21438,20491.566666666666,37.53692523194094,39.97224109272178,NaN,NaN,NaN,NaN,0.6574481336933404,27.815120885059713,11474369,-0.058103581759590295,-0.3525746313740683,-0.294471049614478
2025-08-26T09:45:00-04:00,504.05,504.05,502.12,502.34,NaN,NaN,NaN,505.00674332166136,NaN,NaN,505.51180000000096,507.5213768298612,503.5022231701407,504.6420772600847,503.7846855011084,504.30463617450073,503.2647348277161,22384,20934.333333333332,25.802110681427394,39.112289682537615,NaN,NaN,NaN,NaN,0.749058981286673,30.430824201027658,11451985,-0.1715402994883174,-0.5088964239748748,-0.3373561244865574
2025-08-26T09:50:00-04:00,502.29,503.05,502.29,502.64,NaN,NaN,NaN,504.6080277161313,NaN,NaN,505.41920000000096,507.52076547247583,503.3176345275261,504.5796618080678,503.6002775139006,504.2322711205603,502.9682839072409,24682,21452.366666666665,29.917443489099753,38.45199551012104,NaN,NaN,NaN,NaN,0.7498404826233386,32.85969156585504,11476667,-0.2114269000335443,-0.6016397495284878,-0.39021284949494345
2025-08-26T09:55:00-04:00,502.61,503.16,502.5,502.955,NaN,NaN,NaN,504.6080277161313,NaN,NaN,505.335100000001,507.4872240566214,503.18297594338054,504.5467294464542,503.5140166600292,504.15240399514914,502.87562932490926,20215,21900.066666666666,34.05343440900418,38.0673414026571,NaN,NaN,NaN,NaN,0.7434233052931019,34.829797991404945,11496882,-0.2016836408909628,-0.642317400608647,-0.44063375971768415
2025-08-26T10:00:00-04:00,502.94,504.25,502.81,504.15,NaN,NaN,NaN,504.6080277161313,NaN,NaN,505.274500000001,507.3856638957972,503.1633361042048,504.3029068457307,503.5354245892267,504.14588466964466,502.9249645088087,18164,22183.833333333332,46.86476602591152,38.21141640469129,NaN,NaN,NaN,NaN,0.7931787834864517,34.30029344347837,11515046,-0.1047248829569073,-0.5715398634138182,-0.46681498045691094
2025-08-26T10:05:00-04:00,504.15,504.22,503.45,503.58,NaN,NaN,NaN,504.6080277161313,NaN,NaN,505.201500000001,507.2894379768137,503.11356202318825,504.3029068457307,503.54729531191396,504.14265353387066,502.95193708995726,11063,22110.266666666666,42.612408199530826,37.977397313588725,NaN,NaN,NaN,NaN,0.7915231560945649,33.808610648975105,11503983,-0.07058336577918467,-0.5550441876808918,-0.48446082190170714
2025-08-26T10:10:00-04:00,503.59,504.06,503,503.48,NaN,NaN,NaN,504.6080277161313,NaN,NaN,505.12870000000095,507.1977382391554,503.0596617608465,503.8823254765845,503.54545165063473,504.1244757129398,502.9664275883297,11479,22020.9,41.894205333587614,37.88046339546531,NaN,NaN,NaN,NaN,0.8107000735163818,33.817164902581254,11492504,-0.047449057119614835,-0.5437721433012257,-0.49632308618161086
2025-08-26T10:15:00-04:00,503.46,503.87,503.35,503.53,NaN,NaN,NaN,504.6080277161313,NaN,NaN,505.05510000000095,507.0841820474,503.0260179526019,502.58786038126766,503.5476269227111,504.1098497084552,502.985404136967,12882,22184.966666666667,42.41679590450827,37.37435128972079,NaN,NaN,NaN,NaN,0.7899357825509247,33.82510813807267,11505386,-0.022745796629914605,-0.5247553319690041,-0.5020095353390895
2025-08-26T10:20:00-04:00,503.55,504.43,503.47,504.38,NaN,NaN,NaN,504.6080277161313,NaN,NaN,505.004500000001,506.97125900787074,503.0377409921312,502.4002883050141,503.5721663920805,504.1331204028512,503.01121238130975,10563,22031.766666666666,50.55772826446559,37.89302940282681,NaN,NaN,NaN,NaN,0.8020832266544285,32.73584176268764,11515949,0.05275184006186884,-0.4360697352617535,-0.48882157532362236
2025-08-26T10:25:00-04:00,504.4,504.7,504.29,504.4,502.41355930434776,502.41355930434776,502.41355930434776,NaN,NaN,NaN,504.95270000000096,506.84247904398325,503.0629209560187,502.60590172208316,503.60193234190336,504.1762140836394,503.0276506001673,8117,22021.333333333332,50.734218000614895,38.480853222701406,NaN,NaN,NaN,NaN,0.7740772818933956,31.248566189341364,11524066,0.10303980375445798,-0.3600218206305499,-0.46306162438500786
2025-08-26T10:30:00-04:00,504.38,504.44,503.6,503.69,502.41355930434776,NaN,NaN,NaN,NaN,NaN,504.889300000001,506.73096121612264,503.0476387838794,502.60590172208316,503.6095241134068,504.1786931122125,503.0403551146011,6140,21689.7,44.641971848028625,38.9301583492292,NaN,NaN,NaN,NaN,0.778786047472437,30.710051703981968,11517926,0.08806891150750468,-0.35297548500062703,-0.4410443965081317
2025-08-26T10:35:00-04:00,503.725,503.98,503.53,503.58,502.41355930434776,NaN,NaN,NaN,NaN,NaN,504.823900000001,506.6139282553626,503.0338717446394,502.60590172208316,503.611760949476,504.173746543514,503.04977535543793,6564,21706.566666666666,43.76512515931388,39.95884650922562,NaN,NaN,NaN,NaN,0.7553013297958376,30.288575690803697,11511362,0.0710697029683266,-0.3522072677977235,-0.4232769707660501
2025-08-26T10:40:00-04:00,503.51,503.81,503.28,503.51,502.41355930434776,NaN,NaN,NaN,NaN,NaN,504.76630000000097,506.5362783148416,502.99632168516035,502.60590172208316,503.6092626343699,504.16239624821367,503.0561290205261,8414,21542.433333333334,43.183836885630775,41.2769152511076,NaN,NaN,NaN,NaN,0.7392083776675656,30.17940224173422,11502948,0.05608103599743963,-0.3531756757692506,-0.4092567117666902
2025-08-26T10:45:00-04:00,503.59,503.63,502.98,503.15,502.41355930434776,NaN,NaN,NaN,NaN,NaN,504.7059000000009,506.4862355737846,502.9255644262172,502.60590172208316,503.58860800648586,504.13186397935414,503.0453520336176,16272,21637.533333333333,40.22482509460366,41.01469960911907,NaN,NaN,NaN,NaN,0.7328363506913094,30.401580688878262,11486676,0.02450332568889957,-0.37862755465556575,-0.4031308803444653
2025-08-26T10:50:00-04:00,503.2,503.2,502.82,503.19,502.41355930434776,NaN,NaN,NaN,NaN,NaN,504.6445000000009,506.4179522816614,502.8710477183404,502.60590172208316,503.5707448001497,504.1128761944361,503.0286134058633,10003,21552,40.71094363042235,41.2414152090106,NaN,NaN,NaN,NaN,0.7076337542133583,30.775777631213195,11496679,0.009654497644898563,-0.39106275828834214,-0.4007172559332407
2025-08-26T10:55:00-04:00,503.26,503.45,502.72,502.78,502.41355930434776,NaN,NaN,NaN,NaN,NaN,504.5792000000009,506.38177411365416,502.7766258863477,502.60590172208316,503.5551847791958,504.09834142498414,503.0120281334075,7902,21236.066666666666,37.357381889199395,42.06679172385145,NaN,NaN,NaN,NaN,0.7092313431981155,30.58098460883179,11488777,-0.022670544256451097,-0.4290554362538046,-0.4063848919973535
2025-08-26T11:00:00-04:00,502.77,503,502.53,503,502.41355930434776,NaN,NaN,NaN,NaN,NaN,504.520800000001,506.3349999435055,502.7066000564964,502.60590172208316,503.5262505761913,504.0765117325151,502.97598941986746,12639,21191.766666666666,40.20375956408606,42.80152858635047,NaN,NaN,NaN,NaN,0.6921433901125378,30.62522060983176,11501416,-0.023998007360644558,-0.4363824011981592,-0.41238439383751463
2025-08-26T11:05:00-04:00,503.01,503.08,502.8,502.86,502.41355930434776,NaN,NaN,NaN,NaN,NaN,504.4610000000009,506.293030566136,502.62896943386585,502.60590172208316,503.51220845208513,504.0638060109992,502.96061089317107,7291,20928.966666666667,38.989638833869336,43.15411461669799,NaN,NaN,NaN,NaN,0.6627045765330689,30.48378940472804,11494125,-0.028746863449565507,-0.4483179731494715,-0.419571109699906
2025-08-26T11:10:00-04:00,502.9,503.05,502.75,503.05,502.41355930434776,NaN,NaN,NaN,NaN,NaN,504.41740000000095,506.277694857063,502.5571051429389,502.60590172208316,503.5004078581449,504.0521040421455,502.9487116741443,6823,20583.7,41.56863950077162,42.77581986490228,NaN,NaN,NaN,NaN,0.6367971067807077,30.418404859604138,11500948,-0.01426589051812599,-0.43740347284756353,-0.42313758232943754
2025-08-26T11:15:00-04:00,503.08,503.18,502.78,503.01,502.41355930434776,NaN,NaN,NaN,NaN,NaN,504.37460000000095,506.2637520201147,502.4854479798872,502.3447213776666,503.4897446385542,504.04050668144157,502.93898259566686,6936,20144.766666666666,41.17403470550672,42.67307890104342,NaN,NaN,NaN,NaN,0.6198830277249453,30.034129185652837,11494012,-0.0031366976579712547,-0.4270584544019016,-0.42392175674393034
2025-08-26T11:20:00-04:00,503.06,503.26,503,503.2,502.41355930434776,NaN,NaN,NaN,NaN,NaN,504.33820000000094,506.24624796456897,502.4301520354329,502.16885855982673,503.48245828790334,504.0294198182208,502.9354967575859,7350,19838.966666666667,43.89830876125343,42.81622914587668,NaN,NaN,NaN,NaN,0.5941770971731629,29.475053278572823,11501362,0.019993465554893453,-0.39892992480031353,-0.418923390355207
2025-08-26T11:25:00-04:00,503.18,503.32,502.7,502.7,502.41355930434776,NaN,NaN,NaN,NaN,NaN,504.287800000001,506.232787566748,502.34281243325404,502.16885855982673,503.4674838815843,504.01500967432827,502.91995808884036,9061,19621.166666666668,38.805305796541354,42.5582655667362,NaN,NaN,NaN,NaN,0.5960215902322231,29.421490492319474,11492301,0.005353325924593644,-0.4122317329494649,-0.41758505887405856
2025-08-26T11:30:00-04:00,502.68,502.68,502.15,502.25,NaN,NaN,NaN,504.2136708284323,504.2136708284323,504.2136708284323,504.226600000001,506.23074913489825,502.2224508651037,502.16885855982673,503.4295296699235,504.00407630385945,502.8549830359876,12364,19585.2,34.882791256778305,41.43862720904425,NaN,NaN,NaN,NaN,0.5927343337870651,30.094407604902564,11479937,-0.02901436560615156,-0.453853015881748,-0.4248386502755964
2025-08-26T11:35:00-04:00,502.23,502.59,502.12,502.47,NaN,NaN,NaN,504.13600397259455,NaN,NaN,504.171600000001,506.2142496897152,502.12895031028677,502.16885855982673,503.4004665046634,503.9921721596747,502.8087608496522,10411,19279.066666666666,38.17316562149128,40.54140918196399,NaN,NaN,NaN,NaN,0.5839675956594155,30.755382079859434,11490348,-0.031121328935847625,-0.46374031144540595,-0.4326189825095583
2025-08-26T11:40:00-04:00,502.45,502.58,502.23,502.5,NaN,NaN,NaN,504.13600397259455,NaN,NaN,504.12080000000105,506.20053686665653,502.0410631333456,502.16885855982673,503.3896500434649,503.9867214284069,502.79257865852287,4213,19026.566666666666,38.62857190996428,40.11188061495939,NaN,NaN,NaN,NaN,0.5672556245408834,31.369144092319384,11494561,-0.02495186664550142,-0.46380881581643507,-0.43885694917093365
2025-08-26T11:45:00-04:00,502.53,502.58,502.23,502.31,NaN,NaN,NaN,504.12105940478136,NaN,NaN,504.06840000000096,506.19543026659886,501.94136973340306,502.16885855982673,503.3715836327022,503.97837179100486,502.76479547439953,6794,18372.266666666666,36.780751982177954,39.61299681659254,NaN,NaN,NaN,NaN,0.5517373656451036,31.939065961032203,11487767,-0.027901330213859155,-0.4737336119382576,-0.4458322817243984
2025-08-26T11:50:00-04:00,502.35,502.52,502.13,502.32,NaN,NaN,NaN,504.0162385227458,NaN,NaN,504.009000000001,506.1619774720268,501.85602252797514,502.16885855982673,503.3564594916123,503.9716868865614,502.7412320966633,5595,17410.4,36.95169661922666,39.167843940420816,NaN,NaN,NaN,NaN,0.5401846966704523,32.612460535532094,11493362,-0.02358461855455496,-0.4753130549175921,-0.45172843636303717
2025-08-26T11:55:00-04:00,502.35,502.44,502.2,502.32,NaN,NaN,NaN,503.9670913171665,NaN,NaN,503.945600000001,506.1070769383354,501.78412306166655,502.16885855982673,503.33995247810856,503.96390193026866,502.71600302594845,6276,13135.466666666667,36.95169661922666,38.93404904932246,NaN,NaN,NaN,NaN,0.5187429326225635,33.237755497567704,11493362,-0.015524320711770845,-0.4711338372527507,-0.45560951654097986
2025-08-26T12:00:00-04:00,502.36,502.77,502.36,502.67,NaN,NaN,NaN,503.9670913171665,NaN,NaN,503.887400000001,506.02630274556753,501.7484972544344,502.16885855982673,503.3301343222416,503.9556867519229,502.70458189256027,5299,11702.266666666666,43.18743599853019,39.11094136133016,NaN,NaN,NaN,NaN,0.5138327231495224,32.677540238658445,11498661,0.016831415696894836,-0.43457024691986135,-0.4514016626167562
2025-08-26T12:05:00-04:00,502.67,502.68,502.43,502.52,NaN,NaN,NaN,503.9670913171665,NaN,NaN,503.828200000001,505.9513012775799,501.7050987224221,502.16885855982673,503.31878496146845,503.9468551109082,502.6907148120287,5845,10772.633333333333,41.30207582339216,39.3927052137725,NaN,NaN,NaN,NaN,0.49498752863884227,32.15734035538556,11492816,0.030771727040049768,-0.41293700381669396,-0.4437087308567437
2025-08-26T12:10:00-04:00,502.54,502.77,502.435,502.75,NaN,NaN,NaN,503.9670913171665,NaN,NaN,503.775000000001,505.870011215944,501.679988784058,502.1370868478614,503.3037119419486,503.9325104891421,502.67491339475515,9367,10370.266666666666,45.24892744377424,39.75307434803595,NaN,NaN,NaN,NaN,0.4835598480217806,31.36526199279356,11502183,0.056619409822703415,-0.37293446857836443,-0.42955387840106785
2025-08-26T12:15:00-04:00,502.75,502.77,502.5,502.6,NaN,NaN,NaN,503.9670913171665,NaN,NaN,503.718600000001,505.7850743295808,501.6521256704212,501.9068243746389,503.285054617952,503.9150476756741,502.65506156022997,11689,10013.766666666666,43.208391440523876,40.054413819939846,NaN,NaN,NaN,NaN,0.46830557316308064,30.629760656100984,11490494,0.06419566475806426,-0.3493092974534875,-0.41350496221155175
2025-08-26T12:20:00-04:00,502.61,502.61,502.2,502.22,NaN,NaN,NaN,503.9235429859041,NaN,NaN,503.658600000001,505.7214243150682,501.5957756849338,501.9068243746389,503.2688464571196,503.9052905948739,502.63240231936527,7465,9439.866666666667,38.47481365140687,39.83342625927093,NaN,NaN,NaN,NaN,0.46414088936571957,30.610311768770952,11483029,0.04509820530883307,-0.3571322055755104,-0.40223041088434347
2025-08-26T12:25:00-04:00,502.2,502.32,502.09,502.29,NaN,NaN,NaN,503.68588194109026,NaN,NaN,503.600400000001,505.650148119868,501.550651880134,501.9068243746389,503.2519373980846,503.89666250904645,502.6072122871227,7200,9006.033333333333,39.78350142605748,39.73410245359598,NaN,NaN,NaN,NaN,0.44741654012531235,30.813155981067435,11490229,0.03889845960599181,-0.3536073363768537,-0.3925057959828455
2025-08-26T12:30:00-04:00,502.26,502.26,501.71,501.88,NaN,NaN,NaN,503.4776600346771,NaN,NaN,503.53820000000104,505.6041852455355,501.47221475446656,501.9068243746389,503.1702400999044,503.86972364809156,502.4707565517172,29521,9384.6,35.0772115846798,39.10402408384072,NaN,NaN,NaN,NaN,0.45688678725922155,31.675492875278348,11460708,0.01038661583328615,-0.37952252619123783,-0.389909142024524
2025-08-26T12:35:00-04:00,501.9,501.9,501.3,501.3,NaN,NaN,NaN,503.1066300331009,NaN,NaN,503.46980000000104,505.60020180124707,501.339398198755,501.9068243746389,503.12207939217785,503.8659137901787,502.378244994177,13968,9481.433333333332,29.720893619674797,38.45513749977882,NaN,NaN,NaN,NaN,0.46710915959784616,33.05326404952382,11446740,-0.041488056835803644,-0.4417692130692785,-0.4002811562334749
2025-08-26T12:40:00-04:00,501.29,501.5,501.21,501.24,NaN,NaN,NaN,502.8326923043236,NaN,NaN,503.403000000001,505.59843161927677,501.2075683807252,501.9068243746389,503.07874564554703,503.86383606568455,502.2936552254095,11913,9495.9,29.223746283770794,38.050920001706864,NaN,NaN,NaN,NaN,0.45445850534085863,34.445948203580286,11434827,-0.07200699712487962,-0.4902899026395744,-0.41828290551469477
2025-08-26T12:45:00-04:00,501.27,501.28,500.79,500.96,NaN,NaN,NaN,502.512342654127,NaN,NaN,503.32340000000096,505.57796110028875,501.06883889971317,501.9068243746389,502.9741943472023,503.863337629286,502.0850510651186,26419,9947.133333333333,26.957561485235843,37.24980542054576,NaN,NaN,NaN,NaN,0.4569971835307939,36.21318060959423,11408408,-0.10141649233526595,-0.5450535209337772,-0.4436370285985113
2025-08-26T12:50:00-04:00,500.96,500.96,500.37,500.45,NaN,NaN,NaN,502.1556452607576,NaN,NaN,503.232600000001,505.57532852776586,500.88987147223617,501.9068243746389,502.88091442643594,503.86731552912056,501.8945133237513,21316,10305.566666666668,23.398437491766273,36.161938676388765,NaN,NaN,NaN,NaN,0.46649738470716395,38.235794158992285,11387092,-0.1430358285056667,-0.6224318142305947,-0.479395985724928
2025-08-26T12:55:00-04:00,500.43,500.89,500.42,500.85,NaN,NaN,NaN,502.14197956708676,NaN,NaN,503.1496000000011,505.5297401963866,500.7694598036156,501.9068243746389,502.8213874867882,503.85641083018345,501.7863641433929,15412,10548.733333333334,31.083704121861203,35.75500668636614,NaN,NaN,NaN,NaN,0.466747571513793,40.113935312004756,11402504,-0.13172622041069504,-0.6440537612382968,-0.5123275408276018
2025-08-26T13:00:00-04:00,500.82,501.09,500.75,501.03,NaN,NaN,NaN,502.14197956708676,NaN,NaN,503.06620000000106,505.44534485363255,500.6870551463696,501.9068243746389,502.7655350644036,503.83334405935966,501.6977260694475,17275,10919.9,34.27908133341032,35.56410559452211,NaN,NaN,NaN,NaN,0.4576941735485202,41.0655932164139,11419779,-0.10157429913691407,-0.6392954147487444,-0.5377211156118303
2025-08-26T13:05:00-04:00,501.02,501.05,500.7,500.76,NaN,NaN,NaN,502.14197956708676,NaN,NaN,502.97660000000104,505.358966419101,500.59423358090106,501.71445949971115,502.71679699365444,503.8136284920633,501.6199654952456,14951,11199.466666666667,31.890513080242258,35.20259248459465,NaN,NaN,NaN,NaN,0.4500017325807704,42.00856994837473,11404828,-0.08967943487958818,-0.6498204092113156,-0.5601409743317274
2025-08-26T13:10:00-04:00,500.75,500.75,500.21,500.45,NaN,NaN,NaN,501.9360891971066,NaN,NaN,502.883200000001,505.2881821277747,500.47821787222733,501.4885675997689,502.6644053182048,503.8001671654707,501.52864347093885,14127,11389.9,29.360865893918856,34.21498033426527,NaN,NaN,NaN,NaN,0.45714446596785907,43.4014874197254,11390701,-0.09219959768232933,-0.675390471434639,-0.5831908737523097
2025-08-26T13:15:00-04:00,500.46,500.71,500.24,500.45,NaN,NaN,NaN,501.92899423360177,NaN,NaN,502.785000000001,505.17837418613345,500.39162581386853,501.3048540798151,502.62995094072915,503.78937610476805,501.47052577669024,9649,11169.133333333333,29.36086589391884,33.362036767874315,NaN,NaN,NaN,NaN,0.45806271839872414,44.694910785979594,11390701,-0.08362909176561717,-0.6877272384593311,-0.604098146693714
2025-08-26T13:20:00-04:00,500.45,500.55,500.31,500.46,NaN,NaN,NaN,501.8506308593471,NaN,NaN,502.692800000001,505.08214899815636,500.30345100184564,500.83588326385205,502.6051155026182,503.78103789065653,501.4291931145799,7060,11071.033333333333,29.56987469837594,32.242104428917294,NaN,NaN,NaN,NaN,0.44248680994167305,45.89594676892991,11397761,-0.06772766538503106,-0.6887577284250028,-0.6210300630399718
2025-08-26T13:25:00-04:00,500.47,500.62,500.33,500.37,NaN,NaN,NaN,501.8506308593471,NaN,NaN,502.59960000000103,504.9805400149547,500.21865998504734,500.50370661108167,502.5709640768548,503.76836018781046,501.37356796589916,9977,11140.2,28.745515463166228,31.209041859106037,NaN,NaN,NaN,NaN,0.4315948949458407,46.69419016798453,11387784,-0.05429234046038889,-0.6888954886154579,-0.634603148155069
2025-08-26T13:30:00-04:00,500.4,500.56,499.6,499.81,NaN,NaN,NaN,501.5430748119258,NaN,NaN,502.49960000000095,504.9204583922015,500.0787416078004,500.2379652888653,502.35576560785904,503.7060697120885,501.0054615036296,57536,12636.766666666666,24.220848860138673,30.190901516872596,NaN,NaN,NaN,NaN,0.4693381167354221,48.158543849966065,11330248,-0.0729775808536004,-0.7258251242220695,-0.6528475433684691
2025-08-26T13:35:00-04:00,499.77,499.94,499.77,499.92,NaN,NaN,NaN,501.27475322956553,NaN,NaN,502.4146000000009,504.89266040185197,499.93653959814986,500.01074258231927,502.29609105660467,503.68310582095523,500.9090762922541,17020,12961.066666666668,26.66276288504345,29.25370590680016,NaN,NaN,NaN,NaN,0.44795682268289305,49.518300840377485,11347268,-0.06789169270555018,-0.7377121592504068,-0.6698204665448566
2025-08-26T13:40:00-04:00,499.91,500.08,499.72,499.79,NaN,NaN,NaN,501.27475322956553,NaN,NaN,502.33650000000097,504.89312140236245,499.7798785976395,500.01074258231927,502.2397715877116,503.658613581982,500.8209295934411,16757,13292.2,25.612337520780244,28.577643473664484,NaN,NaN,NaN,NaN,0.4416741924912548,50.18573184757747,11330511,-0.06333463278730778,-0.7489887575289913,-0.6856541247416835
2025-08-26T13:45:00-04:00,499.78,499.84,499.39,499.49,NaN,NaN,NaN,501.0168412690876,NaN,NaN,502.2333000000009,504.82438750054956,499.6422124994522,500.01074258231927,502.1678953763276,503.63259147321384,500.7031992794413,20052,13729.4,23.328288058040656,28.121028790690616,NaN,NaN,NaN,NaN,0.4422688930275929,51.13548871935125,11310459,-0.07005257117912556,-0.7732198387155904,-0.7031672675364649
2025-08-26T13:50:00-04:00,499.51,499.56,498.64,498.79,NaN,NaN,NaN,500.5635757568564,NaN,NaN,502.127900000001,504.8391462733826,499.41665372661936,500.01074258231927,502.03074081243216,503.6019463297908,500.4595352950735,33627,14605.3,19.057695486876298,27.39488230519815,NaN,NaN,NaN,NaN,0.47639254352562316,52.57980084267062,11276832,-0.10885269619447491,-0.8392331377795585,-0.7303804415850836
2025-08-26T13:55:00-04:00,498.79,499.21,498.79,498.9,NaN,NaN,NaN,500.45432231336287,NaN,NaN,502.0591000000009,504.91599880031833,499.2022011996835,499.66212016171795,501.96401728322365,503.581089410251,500.3469451561963,17308,14880.2,21.489954538360124,27.00433895184989,NaN,NaN,NaN,NaN,0.47236450470236147,53.920947814324315,11294140,-0.1137869425771667,-0.872614119806542,-0.7588271772293753
2025-08-26T14:00:00-04:00,498.88,499.49,498.82,499.28,NaN,NaN,NaN,500.45432231336287,NaN,NaN,501.9919000000009,504.94734980594154,499.03645019406025,499.66212016171795,501.8958166421238,503.5494677355949,500.24216554865274,20083,15137.5,29.384218237645825,27.431894719412714,NaN,NaN,NaN,NaN,0.48648132579505105,54.12123498899558,11314223,-0.07974593828552301,-0.8585096000862791,-0.7787636618007561
2025-08-26T14:05:00-04:00,499.31,499.75,499.27,499.68,NaN,NaN,NaN,500.45432231336287,NaN,NaN,501.92640000000085,504.9381948395677,498.914605160434,499.66212016171795,501.8580754605898,503.5244283645981,500.1917225565815,13422,15237.866666666667,36.609751923146796,27.82661241950454,NaN,NaN,NaN,NaN,0.48601837395254865,53.426574932372716,11327645,-0.02160237724171732,-0.8057666333529028,-0.7841642561111855
2025-08-26T14:10:00-04:00,499.69,499.8,499.01,499.71,NaN,NaN,NaN,500.45432231336287,NaN,NaN,501.8376000000008,504.8437285660665,498.8314714339351,499.66212016171795,501.8189631515486,503.49854176104975,500.1393845420474,14011,15564.466666666667,37.12934349841425,28.030202574147676,NaN,NaN,NaN,NaN,0.5077313472416538,53.09172846025542,11341656,0.025036918457547075,-0.7528681080392516,-0.7779050264967987
2025-08-26T14:15:00-04:00,499.7,499.85,499.62,499.64,NaN,NaN,NaN,500.45432231336287,NaN,NaN,501.75880000000086,504.7845974544697,498.73300254553203,499.31369612937436,501.8028664476886,503.4861122695131,500.11962062586406,6458,15553.266666666666,36.3800289608635,28.350882279906337,NaN,NaN,NaN,NaN,0.4878933938672513,52.6116909870079,11335198,0.05558182398176725,-0.7084277465195896,-0.7640095705013569
2025-08-26T14:20:00-04:00,499.6,499.6,498.87,498.88,NaN,NaN,NaN,500.45432231336287,NaN,NaN,501.6668000000009,504.75671764218606,498.5768823578157,499.0343655227996,501.74540098761054,503.455303095463,500.03549887975805,18555,15985.266666666666,29.43451992452198,28.356143282092273,NaN,NaN,NaN,NaN,0.5080438657338748,52.949438138388004,11316643,0.03027699286968677,-0.7261633294142484,-0.7564403222839352
2025-08-26T14:25:00-04:00,498.91,498.99,498.72,498.81,NaN,NaN,NaN,500.34118200339,NaN,NaN,501.57240000000087,504.7167805360818,498.42801946391995,499.0343655227996,501.6883837887755,503.42872700051055,499.9480405770405,17362,16354.8,28.887479004108414,28.322329932820104,NaN,NaN,NaN,NaN,0.4910407324671682,53.39163357515283,11299281,0.015258330527421426,-0.7373674091246585,-0.7526257396520799
2025-08-26T14:30:00-04:00,498.82,499,498.51,498.64,NaN,NaN,NaN,500.24044645778133,NaN,NaN,501.45760000000087,504.6027106428626,498.31248935713916,498.7784924182397,501.6346131863725,503.40404554439664,499.8651808283484,16303,16721.6,27.548433515481037,28.177941276899038,NaN,NaN,NaN,NaN,0.49096639443379964,53.976807670434354,11282978,0.0010575993874949452,-0.7513037404177112,-0.7523613398052061
2025-08-26T14:35:00-04:00,498.645,498.92,498.63,498.845,NaN,NaN,NaN,500.23247161879124,NaN,NaN,501.3465000000009,504.4603055487732,498.2326944512286,498.57886335648703,501.5978379016418,503.3848041094097,499.81087169387393,11836,16921.3,31.66217023681608,28.386273760731168,NaN,NaN,NaN,NaN,0.476611651974244,54.52018361605292,11294814,0.012043170919845192,-0.7373073761553997,-0.7493505470752448
2025-08-26T14:40:00-04:00,498.855,499.22,498.75,499.12,NaN,NaN,NaN,500.23247161879124,NaN,NaN,501.2551000000009,504.3566470261761,498.15355297382564,498.57886335648703,501.5518241630205,503.35517275956767,499.74847556647336,16656,17164.266666666666,36.8427177719926,29.287835825863592,NaN,NaN,NaN,NaN,0.4761393911189428,53.98412644355262,11311470,0.04267893485951468,-0.6960018785008515,-0.7386808133603662
2025-08-26T14:45:00-04:00,499.11,499.4,499.11,499.33,NaN,NaN,NaN,500.23247161879124,NaN,NaN,501.1701000000009,504.24495966436575,498.09524033563605,498.57886335648703,501.5187523933616,503.3294881984045,499.7080165883187,13731,17232.333333333332,40.5490517476978,30.279713601767472,NaN,NaN,NaN,NaN,0.46284372032473003,52.908261846759686,11325201,0.07977965926998398,-0.6389562392728863,-0.7187358985428702
2025-08-26T14:50:00-04:00,499.33,499.4,498.7,498.74,NaN,NaN,NaN,500.23247161879124,NaN,NaN,501.07470000000086,504.1492369790876,498.0001630209141,498.57886335648703,501.474743148746,503.3006462523535,499.64884004513846,16420,17530.833333333332,34.43488648303432,30.909895670499907,NaN,NaN,NaN,NaN,0.4797834545872485,52.428292876183136,11308781,0.0677516493414112,-0.6340463368661062,-0.7017979862075174
2025-08-26T14:55:00-04:00,498.73,499.15,498.7,499.01,NaN,NaN,NaN,500.23247161879124,NaN,NaN,500.9919000000009,504.0614021673764,497.9223978326254,498.57886335648703,501.4248595538614,503.26639489434467,499.5833242133781,19369,17936.466666666667,38.97007887520725,32.02716644315466,NaN,NaN,NaN,NaN,0.47765606497387286,51.98260740350491,11328150,0.0802899998362655,-0.6014354864121856,-0.6817254862484511
2025-08-26T15:00:00-04:00,499.01,499.24,498.98,499.01,NaN,NaN,NaN,500.23247161879124,NaN,NaN,500.90830000000096,503.9614279755738,497.8551720244281,498.57886335648703,501.3894318474478,503.23930314013364,499.5395605547619,14997,17452.333333333332,38.97007887520725,33.449479542321164,NaN,NaN,NaN,NaN,0.4621092031900242,51.261779546819106,11328150,0.09015502168207212,-0.569031709145861,-0.6591867308279331
2025-08-26T15:05:00-04:00,499,499.16,498.77,498.96,NaN,NaN,NaN,500.23247161879124,NaN,NaN,500.831900000001,503.88503798494895,497.778762015053,498.3340863557229,501.3562945750665,503.2149445484275,499.4976446017055,13765,17445.566666666666,38.39961858886679,34.65731268878592,NaN,NaN,NaN,NaN,0.4569585458193113,50.87796445290278,11314385,0.0944309474535372,-0.5411480465110117,-0.6355789939645489
2025-08-26T15:10:00-04:00,498.95,499.46,498.94,499.44,NaN,NaN,NaN,500.23247161879124,NaN,NaN,500.760700000001,503.77405561043435,497.7473443895677,498.3529614170433,501.3253960115047,503.18721498356643,499.463577039443,15224,17555.933333333334,46.496734181107904,35.87963525617607,NaN,NaN,NaN,NaN,0.4614615068322164,49.52427981776821,11329609,0.12858771958249682,-0.47484434448642787,-0.6034320640689247
2025-08-26T15:15:00-04:00,499.45,499.75,499.22,499.36,NaN,NaN,NaN,500.23247161879124,NaN,NaN,500.690700000001,503.66813245683505,497.713267543167,498.59936913363464,501.29198504301826,503.1538655549141,499.4301045311224,18489,17291.6,45.425028387818664,36.50929786079549,NaN,NaN,NaN,NaN,0.4663571134870561,47.413508353430664,11311120,0.14365170372232017,-0.4238674344160245,-0.5675191381383446
2025-08-26T15:20:00-04:00,499.36,500.16,499.36,499.64,NaN,NaN,NaN,500.23247161879124,NaN,NaN,500.622500000001,503.5361768858279,497.70882311417415,498.83949530690774,501.26781003184396,503.12541756427106,499.41020249941687,16267,17123.3,49.78736217372499,37.41344205188911,NaN,NaN,NaN,NaN,0.49018874823798153,44.41466934008999,11327387,0.16860596698244912,-0.35676167941028325,-0.5253676463927324
2025-08-26T15:25:00-04:00,499.64,499.93,499.475,499.84,NaN,NaN,NaN,500.23247161879124,NaN,NaN,500.5591000000011,503.39924203072076,497.7189579692814,498.83949530690774,501.24874293670604,503.10239154105346,499.3950943323586,13442,17057.633333333335,52.69593842195214,38.578864156252585,NaN,NaN,NaN,NaN,0.4876752662209817,41.630033113416516,11340829,0.19296142166394503,-0.2841658693128011,-0.4771272909767461
2025-08-26T15:30:00-04:00,499.83,500.1,499.68,499.71,NaN,NaN,NaN,500.23247161879124,NaN,NaN,500.4893000000011,503.2364163125356,497.7421836874666,498.86287699642094,501.2193529697852,503.0647980276744,499.37390791189597,22660,17237.133333333335,50.6425049556207,40.093720229902495,NaN,NaN,NaN,NaN,0.48284131863376983,38.683433172697086,11318169,0.19416517437744574,-0.23442082300493894,-0.4285859973823847
2025-08-26T15:35:00-04:00,499.7,499.71,498.86,498.97,NaN,NaN,NaN,500.23247161879124,NaN,NaN,500.4147000000011,503.11989382564303,497.7095061743592,498.86287699642094,501.17052104395276,503.0202021966502,499.32083989125533,26835,17633.266666666666,40.87771047793068,40.95016533517552,NaN,NaN,NaN,NaN,0.5090669387313552,37.4884679092384,11291334,0.14142346947730855,-0.25180666053574896,-0.3932301300130575
2025-08-26T15:40:00-04:00,498.95,499.18,498.67,498.685,NaN,NaN,NaN,500.23247161879124,NaN,NaN,500.34340000000105,503.0392526952848,497.6475473047173,498.86287699642094,501.11459240855544,502.9763048010836,499.2528800160273,27617,18082.933333333334,37.85066293707069,41.68603886528906,NaN,NaN,NaN,NaN,0.5091335859648292,36.67205818868387,11263717,0.08634930850756062,-0.28529349437860674,-0.37164280288616736
2025-08-26T15:45:00-04:00,498.68,499.24,498.55,499.11,NaN,NaN,NaN,500.23247161879124,NaN,NaN,500.2762000000011,502.92373965682935,497.62866034317284,498.86287699642094,501.0585587552308,502.9274545246848,499.18966298577686,30759,18786.6,44.456048934006915,42.59988734365984,NaN,NaN,NaN,NaN,0.5220526155387698,36.096373530634814,11294476,0.07781402155418071,-0.27437527594344147,-0.3521892974976222
2025-08-26T15:50:00-04:00,499.19,503.4,498.87,501.03,499.0539535471116,499.0539535471116,499.0539535471116,NaN,NaN,NaN,500.24680000000114,502.82669205864823,497.66690794135405,499.97147441773404,501.066092719184,502.75666824064916,499.3755171977188,261983,27284.033333333333,63.387619660684344,44.495951764280676,NaN,NaN,NaN,NaN,0.808334571571713,36.64824415276177,11556459,0.19412588658453134,-0.10953193926695803,-0.30365782585148937
2025-08-26T15:55:00-04:00,501.07,502.6,501.07,502.05,499.63445565860656,NaN,NaN,NaN,NaN,NaN,500.2416000000012,502.8058374605627,497.6773625394397,499.97147441773404,501.19692286118186,502.77997824128863,499.6138674810751,265637,35806.03333333333,69.36201208531942,46.55402035982515,NaN,NaN,NaN,NaN,0.8627392450308798,37.16069544473681,11822096,0.3247139180267948,0.10223457168200412,-0.22247934634479066
2025-08-27T09:30:00-04:00,501.75,503.57,501.48,501.48,500.1394804013971,NaN,NaN,NaN,NaN,NaN,500.2248000000011,502.74497773870127,497.7046222613009,499.97147441773404,502.1766666666667,502.1766720614633,502.17666127187005,50165,35560.333333333336,63.15954926526785,48.60578198712755,NaN,NaN,NaN,NaN,0.9504007275286723,38.16691424287066,11771931,0.3551941594339778,0.2215133529476816,-0.1336808064862962
2025-08-27T09:35:00-04:00,501.47,502.77,501.45,501.63,500.1394804013971,NaN,NaN,NaN,NaN,NaN,500.21100000000115,502.69239315598884,497.72960684401346,499.97147441773404,502.0943755978229,502.2033747825721,501.98537641307365,28593,35946.1,64.07009066113386,50.398639971836594,NaN,NaN,NaN,NaN,0.9768006755623382,39.053908803479125,11800524,0.3664701114474836,0.32440683282305827,-0.04206327862442531
2025-08-27T09:40:00-04:00,501.65,501.78,500.64,500.82,500.1394804013971,NaN,NaN,NaN,NaN,NaN,500.1740000000012,502.5610006272069,497.78699937279544,499.97147441773404,501.8081677209229,502.2739315715943,501.3424038702515,30956,36419.4,56.01845151442338,51.61638087463775,NaN,NaN,NaN,NaN,0.9884577701650273,38.661699350198866,11769568,0.3030178661025728,0.3367090540037907,0.0336911879012179
2025-08-27T09:45:00-04:00,500.8,501.38,500.13,500.24,NaN,NaN,NaN,503.312634955171,503.312634955171,503.312634955171,500.12840000000114,502.41957999174343,497.83722000825884,499.97147441773404,501.5655679326375,502.2076410775099,500.92349478776515,27098,36654.26666666667,51.06944775380623,52.52136867213342,NaN,NaN,NaN,NaN,1.0071393580103825,37.61833198093241,11742470,0.2100411295970115,0.29624259989748225,0.08620147030047078
2025-08-27T09:50:00-04:00,500.21,500.99,500.04,500.71,NaN,NaN,NaN,503.0859242753905,NaN,NaN,500.0876000000012,502.2601756497895,497.9150243502129,499.97147441773404,501.4162950282822,502.1052464302088,500.7273436263556,24420,36347.36666666667,54.57185194843199,53.09816279837086,NaN,NaN,NaN,NaN,1.0030579752953543,36.53120641182884,11766890,0.16996282896802395,0.2986550065105007,0.12869217754247675
2025-08-27T09:55:00-04:00,500.69,500.79,499.88,500.25,NaN,NaN,NaN,502.91315499014553,NaN,NaN,500.04060000000123,502.09203524243935,497.9891647575631,499.97147441773404,501.2396481694905,501.9905808696745,500.48871546930656,30527,36788,50.74350519138681,53.47805399862573,NaN,NaN,NaN,NaN,0.9964109770599736,35.303864526343524,11736363,0.10540340686114788,0.2604464361189116,0.15504302925776373
2025-08-27T10:00:00-04:00,500.27,500.72,500.17,500.5,NaN,NaN,NaN,502.91315499014553,NaN,NaN,500.0062000000012,501.965933204859,498.0464667951433,499.97147441773404,501.1680547718235,501.9179542837483,500.4181552598987,19481,36767.933333333334,52.68616857288533,53.685111598565754,NaN,NaN,NaN,NaN,0.9645244786985477,34.16418991839288,11755844,0.07395430930162489,0.24748591588479485,0.17353160658316996
2025-08-27T10:05:00-04:00,500.53,501.22,500.48,501.22,NaN,NaN,NaN,502.91315499014553,NaN,NaN,499.9848000000012,501.8661101376538,498.1034898623486,499.97147441773404,501.1575200980348,501.88818132253084,500.4268588735388,12082,36723.26666666667,57.842978678128105,54.05275733114975,NaN,NaN,NaN,NaN,0.9484870159343665,33.583117137192716,11767926,0.0947324805400726,0.29194720725826073,0.19721472671818813
2025-08-27T10:10:00-04:00,501.23,501.74,500.78,501.71,NaN,NaN,NaN,502.91315499014553,NaN,NaN,499.98140000000114,501.8495659868297,498.1132340131726,499.7027436273498,501.17672548419307,501.88222983272016,500.471221135666,18386,36869.1,60.96140486311335,54.78982161025637,NaN,NaN,NaN,NaN,0.9493093719390572,33.492121564845995,11786312,0.13226248881646713,0.36254283773877205,0.23028034892230492
2025-08-27T10:15:00-04:00,501.7,503.24,501.43,503.24,499.6656459145615,499.6656459145615,499.6656459145615,NaN,NaN,NaN,500.0202000000011,502.0682243735193,497.97217562648297,500.3182223464693,501.2887952993004,502.0701941879278,500.5073964106729,20097,37323.73333333333,68.73761076062394,56.779814487591594,NaN,NaN,NaN,NaN,1.0107872739434103,34.41668593278157,11806409,0.2443937563664249,0.5357725443803361,0.29137878801391115
2025-08-27T10:20:00-04:00,503.29,503.61,503.08,503.59,500.7247074638996,NaN,NaN,NaN,NaN,NaN,500.06720000000115,502.32241897707746,497.81198102292484,501.0075778771755,501.4386598991503,502.36909751666434,500.5082222816363,19736,37363.1,70.19996196148128,59.09047870362093,NaN,NaN,NaN,NaN,0.9764453258045974,35.47617590360405,11826145,0.32154367551801555,0.6933083824114306,0.371764706893415
2025-08-27T10:25:00-04:00,503.62,504.13,503.48,504.13,501.2151753064496,NaN,NaN,NaN,NaN,NaN,500.13060000000115,502.64588816527777,497.61531183472454,501.72306230174036,501.71519466178694,502.8885811516562,500.5418081719177,35419,37965,72.34903057213879,61.08283453491607,NaN,NaN,NaN,NaN,0.9531278025328388,36.72695245848897,11861564,0.3841161299959485,0.8519098693883507,0.46779373939240215
2025-08-27T10:30:00-04:00,504.14,505.09,503.85,504.94,501.82880370161104,NaN,NaN,NaN,NaN,NaN,500.2204000000011,503.07288722249723,497.367912777505,502.5444498413923,502.0121637834479,503.43090467095936,500.5934228959364,36002,38621.63333333333,75.23414314460389,61.92901478376746,NaN,NaN,NaN,NaN,0.9736186737804898,38.317272606093425,11897566,0.4506268514408842,1.0310773036935075,0.5804504522526233
2025-08-27T10:35:00-04:00,505.01,505.01,503.95,504.615,501.82880370161104,NaN,NaN,NaN,NaN,NaN,500.2957000000011,503.3984877843463,497.1929122156559,502.5444498413923,502.1843926734823,503.69369302733264,500.675092319632,25972,39092.833333333336,71.98851585152333,62.116622195639174,NaN,NaN,NaN,NaN,0.979788768510455,39.79399845744042,11871594,0.4426592822220048,1.1337745550301292,0.6911152728081245
2025-08-27T10:40:00-04:00,504.59,504.68,504.14,504.48,501.82880370161104,NaN,NaN,NaN,NaN,NaN,500.3647000000011,503.67616215963295,497.05323784036926,502.5444498413923,502.27403894263335,503.8170088453415,500.7310690399252,15732,39062.03333333333,70.62556346533773,62.64990892421559,NaN,NaN,NaN,NaN,0.948375285045424,41.16524389083408,11855862,0.3995442825239095,1.1905456259630114,0.7910013434391019
2025-08-27T10:45:00-04:00,504.43,504.595,504.04,504.13,501.82880370161104,NaN,NaN,NaN,NaN,NaN,500.4321000000011,503.9061910112614,496.95800898874086,502.5444498413923,502.34813618795357,503.9079432331897,500.78832914271743,15336,39115.53333333333,67.07965714540711,62.86487795880653,NaN,NaN,NaN,NaN,0.9202770503993227,42.25292415417944,11840526,0.3220282738885236,1.1935366857997565,0.8715084119112328
2025-08-27T10:50:00-04:00,504.18,504.24,503.79,503.82,501.82880370161104,NaN,NaN,NaN,NaN,NaN,500.49950000000115,504.100797126661,496.8982028733413,502.5444498413923,502.3996674771223,503.95999440531165,500.83934054893297,13628,39022.46666666667,64.0140333622605,63.43599094793775,NaN,NaN,NaN,NaN,0.8866858325136561,42.792057461017585,11826898,0.22883263554818123,1.1575492063464594,0.9287165707982782
2025-08-27T10:55:00-04:00,503.82,504.27,503.78,503.94,501.82880370161104,NaN,NaN,NaN,NaN,NaN,500.5693000000012,504.29711706023755,496.84148293976483,502.5444498413923,502.45995972751905,504.02052254290356,500.89939691213453,16621,38930.86666666667,64.68680742646892,64.40865949598508,NaN,NaN,NaN,NaN,0.8583511301912526,43.31210685191657,11843519,0.15761481801108157,1.1257350933121302,0.9681202753010486
2025-08-27T11:00:00-04:00,503.95,504.33,503.79,503.87,501.82880370161104,NaN,NaN,NaN,NaN,NaN,500.6375000000012,504.4778943800833,496.7971056199191,502.62635689922195,502.49113384679634,504.0509048422216,500.9313628513711,9116,38734.833333333336,63.93590695780202,65.07752056808295,NaN,NaN,NaN,NaN,0.8356117637490177,43.83614298612593,11834403,0.09142103627167297,1.0823965706406398,0.9909755343689668
2025-08-27T11:05:00-04:00,503.91,504.08,503.475,503.58,501.82880370161104,NaN,NaN,NaN,NaN,NaN,500.7017000000012,504.62841394863335,496.77498605136907,502.62635689922195,502.55009553620783,504.09406624195327,501.0061248304624,22810,39036.333333333336,60.78767424875595,65.79496121503789,NaN,NaN,NaN,NaN,0.8191394949097993,43.66398793030374,11811593,0.017597957183241975,1.0129729808480192,0.9953750236647773
2025-08-27T11:10:00-04:00,503.62,504.32,503.57,504.17,501.82880370161104,NaN,NaN,NaN,NaN,NaN,500.7889000000012,504.8246632678993,496.7531367321031,502.62635689922195,502.6049356951207,504.14523106293973,501.0646403273016,18299,39138.833333333336,64.60613779953813,66.64638758837023,NaN,NaN,NaN,NaN,0.8142009595590993,43.70423909617608,11829892,-0.0010176550314435762,0.9941029548754727,0.9951206099069163
2025-08-27T11:15:00-04:00,504.19,504.49,504.02,504.41,501.90223996171454,NaN,NaN,NaN,NaN,NaN,500.8787000000012,505.0312557473348,496.72614425266755,502.88913473240166,502.6682475739177,504.21355447164274,501.1229406761927,18953,39154.3,66.05422811620838,67.23290540537597,NaN,NaN,NaN,NaN,0.7896151767334513,43.88184550460248,11848845,-0.0063882982974151625,0.9871352370351474,0.9935235353325625
2025-08-27T11:20:00-04:00,504.44,504.57,504.37,504.49,502.19691087254574,NaN,NaN,NaN,NaN,NaN,500.9727000000012,505.23378822186953,496.7116117781329,503.1893077859213,502.7012754975532,504.25143623844167,501.1511147566647,9477,38927.96666666667,66.545571082122,67.63177442101944,NaN,NaN,NaN,NaN,0.7474998069667754,44.114129380844574,11858322,-0.013371979616220164,0.9768085608122874,0.9901805404285076
2025-08-27T11:25:00-04:00,504.47,504.53,504.2,504.5,502.19691087254574,NaN,NaN,NaN,NaN,NaN,501.0729000000012,505.4244730896577,496.7213269103447,503.260446228737,502.72954400927404,504.2822023713278,501.1768856472203,8729,38770.86666666667,66.61062927342496,67.47984717193381,NaN,NaN,NaN,NaN,0.7176783921834332,43.92455032012052,11867051,-0.025437344842916154,0.9583838593748624,0.9838212042177785
2025-08-27T11:30:00-04:00,504.52,504.73,503.78,503.82,502.19691087254574,NaN,NaN,NaN,NaN,NaN,501.17350000000124,505.54185220586083,496.80514779414165,503.260446228737,502.7731410635254,504.3200398136021,501.22624231344867,17207,38589.1,58.30708860049983,66.630356217578,NaN,NaN,NaN,NaN,0.7342727927417627,42.80828252806367,11849844,-0.08403153589208823,0.8787817843526682,0.9628133202447564
2025-08-27T11:35:00-04:00,503.79,504.11,503.74,504.08,502.19691087254574,NaN,NaN,NaN,NaN,NaN,501.27710000000116,505.67049098590525,496.88370901409706,503.260446228737,502.7928502610818,504.3346158827793,501.2510846393843,9071,37996.96666666667,60.34268737342394,65.77276027481264,NaN,NaN,NaN,NaN,0.7082533075459229,41.6851145326659,11858915,-0.10853736037982509,0.827141619769975,0.9356789801498001
2025-08-27T11:40:00-04:00,504.11,504.43,503.8,504.41,502.19691087254574,NaN,NaN,NaN,NaN,NaN,501.37970000000115,505.8210860038377,496.9383139961646,503.260446228737,502.82462263451606,504.3634520171363,501.2857932518958,12673,37498.833333333336,62.82365941992634,64.88629715162138,NaN,NaN,NaN,NaN,0.7026637855783566,41.034423255587406,11871588,-0.10567800622819545,0.8035814723645558,0.9092594785927512
2025-08-27T11:45:00-04:00,504.38,504.73,504.11,504.6,502.2560921795493,NaN,NaN,NaN,NaN,NaN,501.47810000000123,505.9820635383207,496.9741364616818,503.2863907752907,502.8526919506765,504.39331536341604,501.31206853793697,9773,36799.3,64.21189028070941,64.33082389656325,NaN,NaN,NaN,NaN,0.6967592294656172,40.77052966278596,11881361,-0.09451019170839425,0.7911217389572585,0.8856319306656527
2025-08-27T11:50:00-04:00,504.57,504.75,504.26,504.6,502.3726334441152,NaN,NaN,NaN,NaN,NaN,501.5759000000012,506.13408327350663,497.01771672649573,503.35011262023255,502.8822773150878,504.42525054105056,501.339304089125,10307,28410.1,64.21189028070941,63.8727043833755,NaN,NaN,NaN,NaN,0.6819907130752166,40.548077664150945,11881361,-0.09063017876349,0.7723442072112903,0.8629743859747803
2025-08-27T11:55:00-04:00,504.58,504.85,504.55,504.62,502.6236501057464,NaN,NaN,NaN,NaN,NaN,501.67550000000125,506.2775496514506,497.0734503485519,503.58009009618604,502.91870874641876,504.46669559263296,501.37072190020456,12181,19961.566666666666,64.37429709959392,63.67946438010313,NaN,NaN,NaN,NaN,0.6547056621412733,40.45934787484839,11893542,-0.09003849756118121,0.7504262640233037,0.8404647615844849
2025-08-27T12:00:00-04:00,504.64,504.66,504.4,504.56,502.6236501057464,NaN,NaN,NaN,NaN,NaN,501.78910000000127,506.3899350062211,497.18826499378144,503.58009009618604,502.92609042874443,504.4744012957758,501.37777956171306,2739,18380.7,63.44412596870257,63.638756709134704,NaN,NaN,NaN,NaN,0.6265124005597572,39.9690683957116,11890803,-0.09643909305245857,0.7199158952689118,0.8163549883213703
2025-08-27T12:05:00-04:00,504.52,504.705,504.31,504.52,502.6236501057464,NaN,NaN,NaN,NaN,NaN,501.90330000000125,506.48610901135663,497.3204909886459,503.59075766155905,502.9383326955505,504.4868863338915,501.3897790572095,4681,17583.633333333335,62.79271800627389,63.5034646076922,NaN,NaN,NaN,NaN,0.6099758005197733,39.2675765441225,11886122,-0.10539062484315753,0.6846167072674234,0.7900073321105809
2025-08-27T12:10:00-04:00,504.49,504.6,504.29,504.48,502.6236501057464,NaN,NaN,NaN,NaN,NaN,502.02010000000126,506.5617725943756,497.4784274056269,503.59075766155905,502.94466981106245,504.49308557861065,501.39625404351426,2541,16636.466666666667,62.105997730203356,63.37275680572087,NaN,NaN,NaN,NaN,0.5885489576255039,38.55913672532464,11883581,-0.11523157344600254,0.6459678653030778,0.7611994387490804
2025-08-27T12:15:00-04:00,504.52,504.55,504.07,504.23,502.6236501057464,NaN,NaN,NaN,NaN,NaN,502.12780000000123,506.61829937476006,497.6373006252424,503.59075766155905,502.9562251788091,504.50290890851977,501.40954144909847,5301,15909.9,57.84783368002984,63.16276819366901,NaN,NaN,NaN,NaN,0.5807954606522548,37.2750983696294,11878280,-0.13825318582552715,0.5883829564671714,0.7266361422926986
2025-08-27T12:20:00-04:00,504.23,504.24,503.9,503.93,502.6236501057464,NaN,NaN,NaN,NaN,NaN,502.22400000000124,506.65837165724264,497.78962834275984,503.59075766155905,502.96246488031534,504.5067647127741,501.4181650478566,3612,15216.3,53.1394501515486,62.34371907595547,NaN,NaN,NaN,NaN,0.5635957848913817,35.62292701762458,11874668,-0.1712051281607223,0.5126297320917956,0.6838348602525179
2025-08-27T12:25:00-04:00,503.91,504.07,503.45,504.07,502.6236501057464,NaN,NaN,NaN,NaN,NaN,502.31880000000126,506.70403685044954,497.933563149553,503.59075766155905,502.9942147011157,504.5201259968249,501.4683034054065,22566,14950.933333333332,54.980953401161095,61.55277088202352,NaN,NaN,NaN,NaN,0.5676246573991405,33.145078982579086,11897234,-0.18018383046380726,0.4586050721727588,0.6387889026365661
2025-08-27T12:30:00-04:00,504.06,504.57,504,504.455,502.6236501057464,NaN,NaN,NaN,NaN,NaN,502.4331000000012,506.7364112314669,498.12978876853555,503.59075766155905,503.0136673921676,504.53702686130845,501.4903079230267,9379,14614.2,59.67412357068388,61.06195320263508,NaN,NaN,NaN,NaN,0.5677943247277728,31.6949314572272,11906613,-0.15761988890989453,0.4417640414991979,0.5993839304090924
2025-08-27T12:35:00-04:00,504.48,504.7,504.15,504.7,502.6236501057464,NaN,NaN,NaN,NaN,NaN,502.54690000000124,506.7825089945461,498.3112910054564,503.59075766155905,503.03499617107065,504.5579192671492,501.5120730749921,9352,14523.2,62.3630242775426,60.75855284578635,NaN,NaN,NaN,NaN,0.5665233015329327,30.57752450714763,11915965,-0.1250436936948084,0.4430793132905819,0.5681230069853903
2025-08-27T12:40:00-04:00,504.67,504.91,504.54,504.81,502.9068699974022,NaN,NaN,NaN,NaN,NaN,502.66290000000123,506.8216878468059,498.50411215319656,503.7412989251454,503.0520932955351,504.5769882205405,501.5271983705297,6623,14131.1,63.5385605768405,61.132229415524954,NaN,NaN,NaN,NaN,0.5524859228520093,29.900803923516182,11922588,-0.0962300945810074,0.4478353887591311,0.5440654833401385
2025-08-27T12:45:00-04:00,504.7,505.17,504.59,505.125,503.06542136115667,NaN,NaN,NaN,NaN,NaN,502.78620000000126,506.86329973322006,498.70910026678246,503.9450391401163,503.09416833666836,504.62800158976796,501.56033508356876,14997,13961.1,66.74202348371773,61.58932485197452,NaN,NaN,NaN,NaN,0.5544512140768687,29.691034654740413,11937585,-0.05798332535413597,0.47158632664746847,0.5295696520016044
2025-08-27T12:50:00-04:00,505.15,505.57,505.15,505.35,503.567220390195,NaN,NaN,NaN,NaN,NaN,502.9044000000012,506.9289420304385,498.8798579695639,504.36753131209304,503.1403833714001,504.6918387039376,501.5889280388626,14193,13776.333333333334,68.84743206800584,62.01959432683733,NaN,NaN,NaN,NaN,0.5466332702142347,30.06793384168491,11951778,-0.021440420710217234,0.502769126113833,0.5242095468240502
2025-08-27T12:55:00-04:00,505.34,505.34,504.87,505.01,503.567220390195,NaN,NaN,NaN,NaN,NaN,503.0174000000012,506.9538355646649,499.0809644353375,504.36753131209304,503.1600195713348,504.7156968528204,501.60434228984917,7131,12833.4,62.417209598682405,61.89140284954969,NaN,NaN,NaN,NaN,0.5418737509132192,29.68228000883732,11944647,-0.023889217824475617,0.4943480245434557,0.5182372423679313
2025-08-27T13:00:00-04:00,505.1,505.28,504.91,505.28,503.567220390195,NaN,NaN,NaN,NaN,NaN,503.13020000000125,506.9956407038027,499.2647592961998,504.36753131209304,503.1804305224201,504.74111261431267,501.6197484305276,7250,11875,65.19707357923568,61.96177308515871,NaN,NaN,NaN,NaN,0.5295970544194141,29.32417287833599,11951897,-0.011665664926283847,0.5036551612100766,0.5153208261363604
2025-08-27T13:05:00-04:00,505.28,505.28,505,505.16,503.567220390195,NaN,NaN,NaN,NaN,NaN,503.23660000000126,507.02604874021233,499.4471512597902,504.36753131209304,503.1950181055721,504.7590282275221,501.6310079836221,5301,11185.966666666667,62.96784045005422,61.86131189590587,NaN,NaN,NaN,NaN,0.511768693389454,28.99164482858475,11946596,-0.01574884661117737,0.4956347678723887,0.5113836144835661
2025-08-27T13:10:00-04:00,505.14,505.41,505.11,505.33,503.59136572256637,NaN,NaN,NaN,NaN,NaN,503.34900000000124,507.0456227823303,499.65237721767215,504.41418882543337,503.20443625449894,504.7711765543069,501.63769595469097,3237,10769.466666666667,64.80384987481887,61.95843503205703,NaN,NaN,NaN,NaN,0.4966423581473509,28.910872186375062,11949833,-0.011295709173500756,0.4972639780166901,0.5085596871901908
2025-08-27T13:15:00-04:00,505.35,505.63,505.32,505.41,503.8399400079043,NaN,NaN,NaN,NaN,NaN,503.4778000000013,506.9997921400493,499.9558078599533,504.67835106034664,503.243542849724,504.82417804820795,501.66290765124006,12702,10681.666666666666,65.66650969764746,62.163705867155144,NaN,NaN,NaN,NaN,0.48331076113682603,29.205267444223672,11962535,-0.007443457646233664,0.49925536513239877,0.5066988227786324
2025-08-27T13:20:00-04:00,505.43,505.43,505.05,505.17,503.8399400079043,NaN,NaN,NaN,NaN,NaN,503.6075000000013,506.88294638097557,500.3320536190271,504.67835106034664,503.2612272869525,504.84571335453063,501.6767412193743,6606,10447.6,60.84816532265892,62.07386069518769,NaN,NaN,NaN,NaN,0.47593142105562386,28.65621709574004,11955929,-0.024574458433120228,0.47598074973723214,0.5005552081703524
2025-08-27T13:25:00-04:00,505.21,505.45,505.2,505.39,503.8399400079043,NaN,NaN,NaN,NaN,NaN,503.7331000000013,506.78292484000747,500.6832751599951,504.67835106034664,503.2799385373654,504.86951120606403,501.6903658686668,6673,10116,63.49258913499847,62.477057513399735,NaN,NaN,NaN,NaN,0.46193631955164877,28.184822961827972,11962602,-0.024547184370713626,0.4698712277069603,0.49441841207767395
2025-08-27T13:30:00-04:00,505.4,505.59,505.31,505.59,503.906079020774,NaN,NaN,NaN,NaN,NaN,503.82430000000124,506.81753704957,500.8310629504325,504.7291557428975,503.32124553838275,504.9242170096115,501.718274067154,14122,10282.866666666667,65.75693894207436,63.37830671272301,NaN,NaN,NaN,NaN,0.4489408681551005,28.020734602962122,11976724,-0.0149872710729676,0.4756843232364645,0.4906715943094321
2025-08-27T13:35:00-04:00,505.62,506.22,505.62,506.01,504.36034815619337,NaN,NaN,NaN,NaN,NaN,503.9035000000012,506.9142655164716,500.89273448353083,505.216324594318,503.3810049040468,505.0133732202331,501.74863658786046,17629,10110.166666666666,69.96935384757293,64.44890674460957,NaN,NaN,NaN,NaN,0.4618736632868828,28.886710733535136,11994353,0.014120414429738049,0.5083221123466046,0.4942016979168666
2025-08-27T13:40:00-04:00,506.04,506.3,505.94,505.94,504.58215051273004,NaN,NaN,NaN,NaN,NaN,503.99270000000126,506.9751152686759,501.01028473132664,505.3170596754544,503.41942438339277,505.0710485668548,501.7678001999307,11283,9876.3,68.45782959580299,65.07631431783237,NaN,NaN,NaN,NaN,0.45459697305210645,29.800419997175347,11983070,0.022651553323621898,0.522516139571394,0.4998645862477721
2025-08-27T13:45:00-04:00,505.98,506.29,505.98,506.22,504.6193254894241,NaN,NaN,NaN,NaN,NaN,504.0845000000013,507.05289569373247,501.11610430627013,505.3286477403635,503.44605270776304,505.1115095437632,501.7805958717629,7710,9501.533333333333,71.14317681993941,65.70346807086071,NaN,NaN,NaN,NaN,0.4471257606912434,30.648864313412684,11990780,0.0401230499034303,0.5500183986270599,0.5098953487236296
2025-08-27T13:50:00-04:00,506.2,506.26,506.11,506.16,504.71776523990485,NaN,NaN,NaN,NaN,NaN,504.19130000000126,507.06494006701865,501.3176599329839,505.4159181922908,503.4698070427615,505.1472803113099,501.7923337742131,6972,9418.033333333333,69.77238858309761,66.14874149987907,NaN,NaN,NaN,NaN,0.4259024920704387,31.436705464204493,11983808,0.04049285051148821,0.5605114118629899,0.5200185613515017
2025-08-27T13:55:00-04:00,506.11,506.56,506.05,506.35,504.8349122744546,NaN,NaN,NaN,NaN,NaN,504.3135000000013,507.0193922732851,501.60760772671745,505.62973455383263,503.5194892572319,505.22360259493036,501.81537591953344,14218,9601,71.63614602070018,66.49832168109211,NaN,NaN,NaN,NaN,0.43190945692254956,32.614785933000476,11998026,0.04598637839757547,0.5775015343484711,0.5315151559508956
2025-08-27T14:00:00-04:00,506.33,506.4,506.05,506.08,504.8349122744546,NaN,NaN,NaN,NaN,NaN,504.42090000000127,506.967768421153,501.87403157884955,505.62973455383263,503.5376978556983,505.2500512650353,501.82534444636127,5628,9215.033333333333,65.45949510949518,66.25632618405562,NaN,NaN,NaN,NaN,0.4260587814280793,33.70871779688245,11992398,0.024942441854503228,0.5626932082690246,0.5377507664145214
2025-08-27T14:05:00-04:00,506.08,506.1,505.69,505.96,504.8349122744546,NaN,NaN,NaN,NaN,NaN,504.53510000000125,506.8224928291608,502.2477071708417,505.62973455383263,503.56120108830186,505.281243755605,501.84115842099874,8195,9185.833333333334,62.86512006390149,66.28831978871413,NaN,NaN,NaN,NaN,0.4249117256117897,33.352907885596494,11984203,-0.0021157046472831675,0.5351061356054174,0.5372218402527006
2025-08-27T14:10:00-04:00,505.93,506.73,505.92,506.73,504.8390953769464,NaN,NaN,NaN,NaN,NaN,504.65970000000124,506.72195838220284,502.59744161779963,505.62973455383263,503.607034919132,505.35132003714307,501.8627498011209,13326,9207.6,70.84890951350997,66.692022355448,NaN,NaN,NaN,NaN,0.4524180309252334,34.02314721632821,11997529,0.025277534231143317,0.5688187580416297,0.5435412238104864
2025-08-27T14:15:00-04:00,506.73,506.84,506.405,506.405,505.1448183143578,NaN,NaN,NaN,NaN,NaN,504.7634000000013,506.636114007711,502.8906859922916,505.69666327324984,503.62908696106143,505.3852602355231,501.87291368659976,6363,9093.933333333332,64.54160060400977,66.80443379501627,NaN,NaN,NaN,NaN,0.4511738858591455,34.791295578260765,11991166,0.015425893226000298,0.5628235903429868,0.5473976971169865
2025-08-27T14:20:00-04:00,506.41,506.705,506.41,506.57,505.1448183143578,NaN,NaN,NaN,NaN,NaN,504.8606000000013,506.5881736032329,503.13302639676965,505.69666327324984,503.6425724963857,505.40590105555566,501.87924393721573,3923,8881.133333333333,66.18739229013985,66.90325825325348,NaN,NaN,NaN,NaN,0.4403757511549216,35.50457620005528,11995089,0.013981818903316401,0.564874970746132,0.5508931518428156
2025-08-27T14:25:00-04:00,506.61,506.83,506.49,506.7,505.22818672857807,NaN,NaN,NaN,NaN,NaN,504.92980000000125,506.6693171269219,503.1902828730806,505.8082644948799,503.65889379077913,505.4314012716133,501.88638630994495,4619,8629.066666666668,67.46855185845993,67.03197555045436,NaN,NaN,NaN,NaN,0.43320605464385403,36.343877394999396,11999708,0.015617659630628333,0.5704152263811011,0.5547975667504728
2025-08-27T14:30:00-04:00,506.71,506.77,506.5,506.5,505.2314509681882,NaN,NaN,NaN,NaN,NaN,504.98800000000125,506.73900199741024,503.23699800259226,505.81761159590394,503.68110427938245,505.46508406411806,501.89712449464685,6549,8756.066666666668,63.48330339718002,67.22019969863445,NaN,NaN,NaN,NaN,0.42154847931214884,37.123228504590365,11993159,-0.001997246895808602,0.552301008130712,0.5542982550265206
2025-08-27T14:35:00-04:00,506.51,506.63,506.37,506.5,505.2314509681882,NaN,NaN,NaN,NaN,NaN,505.03540000000123,506.81894124005174,503.2518587599507,505.81761159590394,503.7071722828195,505.50326695486893,501.91107761077006,8067,8868.933333333332,63.48330339718002,67.21953643164741,NaN,NaN,NaN,NaN,0.41000930221842324,37.306948723185876,11993159,-0.017986661451445674,0.5318149282122135,0.5498015896636592
2025-08-27T14:40:00-04:00,506.46,506.46,506.25,506.36,505.2314509681882,NaN,NaN,NaN,NaN,NaN,505.06380000000127,506.88518140833685,503.2424185916657,505.81761159590394,503.7198495353073,505.52094591574973,501.9187531548648,4194,8924.033333333333,60.57835196953532,66.84963736218035,NaN,NaN,NaN,NaN,0.3985800663456787,36.99305824074023,11988965,-0.04101253529319171,0.49853592054716955,0.5395484558403613
2025-08-27T14:45:00-04:00,506.36,506.56,506.33,506.47,505.2314509681882,NaN,NaN,NaN,NaN,NaN,505.10090000000133,506.95939475501507,503.2424052449876,505.81761159590394,503.73453336102085,505.5418641553738,501.9272025666679,4734,8905.133333333333,62.04783718505262,66.28381474342889,NaN,NaN,NaN,NaN,0.38653863303527436,36.90167728872034,11993699,-0.051193779323057464,0.4755562316865394,0.5267500110095968
2025-08-27T14:50:00-04:00,506.5,506.5,506.21,506.36,505.2314509681882,NaN,NaN,NaN,NaN,NaN,505.1385000000013,507.02113990044165,503.2558600995609,505.81761159590394,503.74613653343573,505.55784311133635,501.9344299555351,3917,8915.3,59.65315148540654,65.65490916411487,NaN,NaN,NaN,NaN,0.37964301638989906,36.320521084489386,11989782,-0.06671374565426069,0.443357828941771,0.5100715745960317
2025-08-27T14:55:00-04:00,506.36,506.45,506.24,506.3,505.2314509681882,NaN,NaN,NaN,NaN,NaN,505.18190000000135,507.0695862965758,503.2942137034269,505.81761159590394,503.7650553113927,505.5835090026791,501.9466016201063,6529,8380.733333333334,58.330751924519625,64.73973595729917,NaN,NaN,NaN,NaN,0.3675256580763334,35.78087603770349,11983253,-0.08142340010311289,0.4082923244671406,0.4897157245702535
2025-08-27T15:00:00-04:00,506.28,506.28,505.99,506.09,505.2314509681882,NaN,NaN,NaN,NaN,NaN,505.22730000000126,507.09081947528733,503.3637805247152,505.81761159590394,503.78602864736735,505.6098363637048,501.9622209310299,8013,8335.2,53.832664350016024,63.601184226364765,NaN,NaN,NaN,NaN,0.3634166824994526,34.26726807071577,11975240,-0.10424113154317105,0.35941431014128966,0.4636554416844607
2025-08-27T15:05:00-04:00,506.05,506.25,505.96,506.07,505.2314509681882,NaN,NaN,NaN,NaN,NaN,505.2699000000013,507.1110099789405,503.4287900210621,505.81761159590394,503.80473986434095,505.63288710800157,501.9765926206803,7356,8268.666666666666,53.41023874444954,62.299333706632574,NaN,NaN,NaN,NaN,0.35817263374949315,32.74696526798273,11967884,-0.1185817626252586,0.3154282384028875,0.4340100010281461
2025-08-27T15:10:00-04:00,506.05,506.05,504.97,505.61,NaN,NaN,NaN,506.83763299938016,506.83763299938016,506.83763299938016,505.3047000000013,507.1039547442301,503.50544525577243,505.81761159590394,503.8326125960968,505.6591461068154,502.0060790853782,14779,8540.533333333333,44.718542839636925,60.81783711592841,NaN,NaN,NaN,NaN,0.4111603027673841,32.16519046071857,11953105,-0.15466685210973652,0.24067643589097543,0.39534328800071195
2025-08-27T15:15:00-04:00,505.63,506.15,505.62,506.14,NaN,NaN,NaN,506.83763299938016,NaN,NaN,505.35590000000127,507.1008019326476,503.61099806735496,505.81761159590394,503.8641706709189,505.6954057543546,502.03293558748317,13815,8501.133333333333,54.00577017224345,60.185026409381415,NaN,NaN,NaN,NaN,0.4203631382839969,31.314148977311447,11966920,-0.1389573026207772,0.2216466597247404,0.3606039623455176
2025-08-27T15:20:00-04:00,506.12,506.26,505.92,505.96,NaN,NaN,NaN,506.83763299938016,NaN,NaN,505.39170000000126,507.11107268638443,503.6723273136181,505.7741771371028,503.8897583578729,505.7253227253156,502.0541939904302,11100,8398.033333333333,50.87947123890588,58.758637961195404,NaN,NaN,NaN,NaN,0.41462291412085245,30.18266735553197,11955820,-0.13660122690484638,0.18985242871445962,0.326453655619306
2025-08-27T15:25:00-04:00,505.88,506.06,505.77,505.95,NaN,NaN,NaN,506.83763299938016,NaN,NaN,505.42250000000126,507.1255223118075,503.719477688195,505.7741771371028,503.9123782854469,505.75016049933026,502.0745960715635,10632,8514.733333333334,50.70386353285873,57.77022817039891,NaN,NaN,NaN,NaN,0.4057212773979359,29.464826025489906,11945188,-0.13157801455561374,0.1619811374247888,0.29355915198040256
2025-08-27T15:30:00-04:00,506,506.35,505.99,506.21,NaN,NaN,NaN,506.83763299938016,NaN,NaN,505.45690000000127,507.1526592855105,503.76114071449206,505.7741771371028,503.94320738115357,505.78729371801063,502.0991210442965,13176,8712.266666666666,55.04804169482688,56.97456027073368,NaN,NaN,NaN,NaN,0.4053126147266572,27.91480579019044,11958364,-0.10761575558604969,0.15903945749784043,0.2666552130838901
2025-08-27T15:35:00-04:00,506.25,506.62,506.06,506.41,NaN,NaN,NaN,506.83763299938016,NaN,NaN,505.49510000000123,507.18896597891893,503.80123402108353,505.72634170968223,503.98162083237855,505.83585040949106,502.12739125526605,15654,9057.366666666667,58.10636976683536,56.30583297847478,NaN,NaN,NaN,NaN,0.4163617136747533,26.086529602670982,11974018,-0.07662279206975592,0.1708767229966952,0.24749951506645113
2025-08-27T15:40:00-04:00,506.43,506.69,506.4,506.65,NaN,NaN,NaN,506.83763299938016,NaN,NaN,505.5517000000013,507.2065699146643,503.89683008533825,505.7260733677458,504.02356901369393,505.89169621778086,502.155441809607,16183,9488.9,61.49209188794396,56.16360358495792,NaN,NaN,NaN,NaN,0.40733587698370094,24.566482509586955,11990201,-0.0401204761168969,0.19734891992033,0.2374693960372269
2025-08-27T15:45:00-04:00,506.63,506.94,506.52,506.93,505.4340474528982,505.4340474528982,505.4340474528982,NaN,NaN,NaN,505.60870000000125,507.2531765837404,503.9642234162621,505.9083184187041,504.0788064705365,505.9683861793275,502.1892267617455,20373,9744.6,65.04173476737276,56.27492011140026,NaN,NaN,NaN,NaN,0.40824045719915203,23.761454216591222,12010574,0.0005656327231463865,0.23817643694115986,0.23761080421801348
2025-08-27T15:50:00-04:00,506.93,507.34,506.355,506.57,505.47613620503915,NaN,NaN,NaN,NaN,NaN,505.65190000000126,507.28156731400037,504.02223268600216,506.0221547349633,504.17391245166095,506.0946155215027,502.2532093818192,37687,10780.633333333333,57.67986510885486,56.06788533563737,NaN,NaN,NaN,NaN,0.44943756739920954,23.83889972257638,11972887,0.0008966348006379521,0.23873159771881092,0.23783496291817297
2025-08-27T15:55:00-04:00,506.58,507.13,506.56,506.6,505.47613620503915,NaN,NaN,NaN,NaN,NaN,505.6919000000013,507.3144928491817,504.06930715082086,506.0221547349633,504.32095358061724,506.2802248145034,502.3616823467311,63845,12686.366666666667,58.10542164875538,55.78628422590186,NaN,NaN,NaN,NaN,0.45804916972783694,23.910813406705454,12036732,0.0008033313686937882,0.2388391271290402,0.23803579576034642
2025-08-28T09:30:00-04:00,507.09,510.02,506.62,509.38,506.52991439343447,NaN,NaN,NaN,NaN,NaN,505.78750000000133,507.68197538755106,503.8930246124516,507.2385790303765,508.6733333333334,508.6733333333334,508.6733333333334,42304,13625.766666666666,79.08933043118432,57.17458272202884,NaN,NaN,NaN,NaN,0.6696170861758457,26.809035497202583,12079036,0.17594571712754153,0.4579679421697733,0.2820222250422318
2025-08-28T09:35:00-04:00,509.35,510.24,508.15,508.41,507.20128192100566,NaN,NaN,NaN,NaN,NaN,505.86330000000123,507.8651017970158,503.86149820298664,507.2385790303765,508.78108694950055,508.90916933873217,508.6530045602689,29941,14036.166666666666,66.56180536295452,57.76251511048848,NaN,NaN,NaN,NaN,0.771073008591859,29.605384595553986,12049095,0.2120239295254533,0.5470521369490484,0.3350282074235951
2025-08-28T09:40:00-04:00,508.54,508.9,507.6,507.67,507.20128192100566,NaN,NaN,NaN,NaN,NaN,505.92550000000125,507.95453449809867,503.89646550190383,507.2385790303765,508.597163246548,508.93130412401837,508.26302236907765,24584,14479.533333333333,58.89724840254239,58.12427111424036,NaN,NaN,NaN,NaN,0.8088535079781515,31.01196786566232,12024511,0.1732429499258124,0.5515818948308606,0.3783389449050482
2025-08-28T09:45:00-04:00,507.76,507.81,506.38,506.6,NaN,NaN,NaN,509.27580510916636,509.27580510916636,509.27580510916636,505.9671000000012,507.96420299047304,503.9699970095294,507.2385790303765,508.17843201398233,508.95712651135733,507.39973751660733,32477,15305.1,49.942227337233284,57.87655601372491,NaN,NaN,NaN,NaN,0.8532211145511411,30.25537262913714,11992034,0.06811995729255327,0.4634888915207398,0.39536893422818653
2025-08-28T09:50:00-04:00,506.61,506.63,505.5,505.88,NaN,NaN,NaN,508.30076851329517,NaN,NaN,505.99510000000123,507.9467592823578,504.04344071764467,507.2385790303765,507.81010751652036,508.8913865347815,506.72882849825925,26360,15951.366666666667,44.985679592148095,57.89563721033285,NaN,NaN,NaN,NaN,0.872991034940345,28.429258264551997,11965674,-0.05089327969611668,0.33175233460804066,0.38264561430415733
2025-08-28T09:55:00-04:00,505.8,506.69,505.57,506.69,NaN,NaN,NaN,508.30076851329517,NaN,NaN,506.0443000000012,507.9386801187621,504.14991988124035,507.2385790303765,507.69673459816914,508.80888154087796,506.5845876554603,12788,15903.7,50.890589956804995,57.67312433780153,NaN,NaN,NaN,NaN,0.8906345324446063,26.79825717466989,11978462,-0.07461676048490445,0.2893746636980268,0.36399142418293123
2025-08-28T10:00:00-04:00,506.78,507.05,506.27,506.44,NaN,NaN,NaN,508.30076851329517,NaN,NaN,506.0945000000013,507.89269381437265,504.29630618562993,507.2385790303765,507.582175497811,508.6881909810941,506.4761600145279,19385,16362.266666666666,49.137554233051354,57.54870169452621,NaN,NaN,NaN,NaN,0.8827320658414223,25.67375524013332,11959077,-0.10484750104901958,0.23293204787165678,0.33777954892067635
2025-08-28T10:05:00-04:00,506.41,507.22,506.11,506.89,NaN,NaN,NaN,508.30076851329517,NaN,NaN,506.1509000000013,507.86656743687473,504.43523256312784,507.2385790303765,507.5126211279827,508.59704763487116,506.42819462109424,16910,16652.766666666666,52.32127590852807,57.66423114993116,NaN,NaN,NaN,NaN,0.898965489709893,24.811097960807444,11975987,-0.09266078726366023,0.22195356484110107,0.3146143521047613
2025-08-28T10:10:00-04:00,506.89,507.18,506.46,507.18,NaN,NaN,NaN,508.30076851329517,NaN,NaN,506.2054000000013,507.8746127946895,504.5361872053131,507.2385790303765,507.48228982906335,508.54536950925797,506.41921014886873,11452,16590.3,54.30629371831196,57.61124915160867,NaN,NaN,NaN,NaN,0.8861822404449026,24.010059058576275,11987439,-0.06452611606229597,0.2339567070268913,0.2984828230891873
2025-08-28T10:15:00-04:00,507.15,507.18,506.28,506.31,NaN,NaN,NaN,508.30076851329517,NaN,NaN,506.23760000000135,507.8505789068039,504.6246210931988,507.2385790303765,507.4472315216795,508.5035402126715,506.3909228306875,8842,16672.933333333334,47.86773580811876,56.87991815455748,NaN,NaN,NaN,NaN,0.8871692232702691,22.99119892110233,11978597,-0.10175186202820852,0.17129299555392663,0.27304485758213515
2025-08-28T10:20:00-04:00,506.33,506.91,506.28,506.37,NaN,NaN,NaN,508.30076851329517,NaN,NaN,506.26880000000136,507.82962229409264,504.7079777059101,506.9698632243012,507.4113049340634,508.46229360255984,506.360316265567,9071,16844.533333333333,48.32278071690472,55.93925307091182,NaN,NaN,NaN,NaN,0.8687999930366822,22.045114507733672,11987668,-0.11841047569041585,0.12503176296911533,0.24344223865953118
2025-08-28T10:25:00-04:00,506.37,506.71,505.94,506.02,NaN,NaN,NaN,508.30076851329517,NaN,NaN,506.28670000000136,507.81482775440236,504.75857224560036,505.63389057944096,507.35332684614116,508.4098229230066,506.29683076927574,12012,17090.966666666667,45.810796028455165,54.56561458956056,NaN,NaN,NaN,NaN,0.8617428506769179,20.62475046409214,11975656,-0.1472000979602214,0.059442116209254436,0.20664221416947584
2025-08-28T10:30:00-04:00,506.04,506.58,505.85,506.17,NaN,NaN,NaN,508.30076851329517,NaN,NaN,506.30310000000134,507.8080902172441,504.79810978275856,504.60021904964555,507.30918062274185,508.36862651635676,506.24973472912694,9796,17199.2,47.080460664333295,53.80851427209473,NaN,NaN,NaN,NaN,0.8523326470571353,19.164830720400474,11985452,-0.1498396711289604,0.019342625258275348,0.16918229638723575
2025-08-28T10:35:00-04:00,506.17,506.385,505.85,506.2,NaN,NaN,NaN,508.30076851329517,NaN,NaN,506.3269000000014,507.7862873898846,504.8675126101182,504.60021904964555,507.27676082830334,508.3387683815985,506.21475327500815,7331,17174.666666666668,47.34617857392617,53.039996909606934,NaN,NaN,NaN,NaN,0.8296660294101947,17.80919095840106,11992783,-0.143267134082761,-0.009901621216215517,0.1333655128665455
2025-08-28T10:40:00-04:00,506.22,506.8,506.17,506.69,NaN,NaN,NaN,508.30076851329517,NaN,NaN,506.35510000000136,507.786706773432,504.9234932265707,504.8659133781879,507.2398893439225,508.2866414033888,506.19313728445627,14138,17506.133333333335,51.619220392994336,51.07784619259337,NaN,NaN,NaN,NaN,0.815404170166609,17.218152741907,12006921,-0.10158250794003035,0.006387377941507566,0.10796988588153791
2025-08-28T10:45:00-04:00,506.68,506.7,506.35,506.45,NaN,NaN,NaN,508.30076851329517,NaN,NaN,506.3809000000014,507.7713297010868,504.990470298916,504.97773070255033,507.2146889146575,508.2521769594829,506.17720086983206,9781,17674.366666666665,49.50029867931723,49.85916714376213,NaN,NaN,NaN,NaN,0.782161015154706,16.669331540876804,11997140,-0.08643084907200224,-0.0000686754584648952,0.08636217361353735
2025-08-28T10:50:00-04:00,506.51,507.71,506.51,507.62,NaN,NaN,NaN,508.30076851329517,NaN,NaN,506.42670000000135,507.826479423307,505.0269205766957,505.70218456204026,507.21747765691833,508.2326599022749,506.20229541156175,12809,17970.766666666666,58.4538199999452,49.82749368643376,NaN,NaN,NaN,NaN,0.8162923712150835,17.510810455806006,12009949,0.0014760843135489532,0.08820727900547354,0.08673119469192458
2025-08-28T10:55:00-04:00,507.65,507.65,507,507,NaN,NaN,NaN,508.30076851329517,NaN,NaN,506.45850000000144,507.83651922825715,505.0804807717457,505.7187476496322,507.217458344045,508.2204800183756,506.21443666971436,7318,17997.066666666666,53.08288280402706,50.051826219776174,NaN,NaN,NaN,NaN,0.8044143446997187,18.292183733954552,12002631,0.01613940502707907,0.10690545097577342,0.09076604594869435
2025-08-28T11:00:00-04:00,507,507.68,506.99,507.24,NaN,NaN,NaN,508.30076851329517,NaN,NaN,506.49990000000145,507.8445642530373,505.1552357469656,505.7899981197058,507.21950429215684,508.2105921107161,506.2284164735976,7500,17979.966666666667,54.813688453465005,50.753826852727386,NaN,NaN,NaN,NaN,0.7962418915068815,19.05429288119623,12010131,0.03897277869498603,0.13948201931742688,0.10050924062244085
2025-08-28T11:05:00-04:00,507.24,507.44,506.97,507.31,NaN,NaN,NaN,508.30076851329517,NaN,NaN,506.5383000000014,507.8635073172266,505.2130926827762,505.7899981197058,507.21971258042987,508.20575370119775,506.233671459662,3232,17842.5,55.331285654707415,51.071019402577555,NaN,NaN,NaN,NaN,0.7729388992563878,19.71491266744498,12013363,0.054792190401396795,0.16899947862418685,0.11420728822279005
2025-08-28T11:10:00-04:00,507.39,508.12,507.39,507.79,NaN,NaN,NaN,508.30076851329517,NaN,NaN,506.5823000000014,507.9246221795703,505.2399778204325,506.3173987966117,507.2341755058893,508.21104237051077,506.25730864126785,8638,17637.8,58.81506982718244,51.76227051644406,NaN,NaN,NaN,NaN,0.7755861207380745,21.135261579153102,12022001,0.09142646661145759,0.22849037148711204,0.13706390487565445
2025-08-28T11:15:00-04:00,507.81,508.6,507.81,508.11,505.9656809264955,505.9656809264955,505.9656809264955,NaN,NaN,NaN,506.62430000000137,508.02261328169294,505.2259867183098,506.75291903728936,507.27410903756424,508.248584286673,506.2996337884555,14507,17660.866666666665,60.998896225501156,52.382100539084995,NaN,NaN,NaN,NaN,0.7780442549710694,22.91563528618056,12036508,0.12876746172525372,0.2980232320322216,0.16925577030696787
2025-08-28T11:20:00-04:00,508.08,508.7,508.04,508.05,506.14246815710936,NaN,NaN,NaN,NaN,NaN,506.6665000000014,508.1063975636088,505.226602436394,506.8923352298315,507.31220962979876,508.2865123919482,506.33790686764934,13667,17746.433333333334,60.35270291501122,52.81398691027779,NaN,NaN,NaN,NaN,0.7696125224731336,24.65913449770785,12022841,0.14004973854666242,0.3443179434902959,0.20426820494363346
2025-08-28T11:25:00-04:00,508.08,508.08,507.11,507.22,506.14246815710936,NaN,NaN,NaN,NaN,NaN,506.6865000000014,508.1288123773409,505.24418762266185,506.8923352298315,507.3158589589,508.27912114692845,506.3525967708715,8401,17672.066666666666,52.126317519509115,53.11817131823425,NaN,NaN,NaN,NaN,0.7839259137250505,24.277632851723048,12014440,0.08494867716670815,0.31045405140201865,0.2255053742353105
2025-08-28T11:30:00-04:00,507.2,507.77,507.15,507.6,506.14246815710936,NaN,NaN,NaN,NaN,NaN,506.71530000000143,508.1718471614516,505.2587528385513,506.8923352298315,507.3184446257905,508.27541220484244,506.36147704673857,4990,17399.2,55.14106846287634,53.605191871517945,NaN,NaN,NaN,NaN,0.7722169198875471,23.923381323308593,12019430,0.06815407214957137,0.3106979644222747,0.24254389227270334
2025-08-28T11:35:00-04:00,507.61,508.01,507.42,507.48,506.14246815710936,NaN,NaN,NaN,NaN,NaN,506.7379000000014,508.2060935682279,505.26970643177486,506.8923352298315,507.3271566706023,508.2723612425349,506.3819520986697,10365,17222.9,53.984930963367525,54.189058652583114,NaN,NaN,NaN,NaN,0.7592014256098635,23.90467300999607,12009065,0.044185443982624306,0.29777569725098374,0.25359025326835943
2025-08-28T11:40:00-04:00,507.62,507.81,507.4,507.46,506.14246815710936,NaN,NaN,NaN,NaN,NaN,506.7655000000014,508.2350689823039,505.2959310176989,506.8923352298315,507.3295614963619,508.2700914456922,506.38903154703166,4009,16817.1,53.7825316730705,54.667778010350055,NaN,NaN,NaN,NaN,0.7342584666377322,23.844832613553663,12005056,0.023257811001233142,0.28266251701990086,0.2594047060186677
2025-08-28T11:45:00-04:00,507.45,507.69,507.33,507.52,506.14246815710936,NaN,NaN,NaN,NaN,NaN,506.79670000000135,508.2627744980379,505.3306255019648,506.8923352298315,507.3311150344245,508.26781222211656,506.39441784673244,3262,16246.733333333334,54.335652019298834,55.167026113590964,NaN,NaN,NaN,NaN,0.7075257190207523,23.63279853965428,12008318,0.010385679840035578,0.2723868058187122,0.26200112597867664
2025-08-28T11:50:00-04:00,507.56,507.79,507.53,507.79,506.14246815710936,NaN,NaN,NaN,NaN,NaN,506.8179000000014,508.3099296088911,505.32587039111166,506.8923352298315,507.33432249381684,508.2676094330637,506.40103555457,3354,15102.3,56.83889623525399,55.53986010232379,NaN,NaN,NaN,NaN,0.6762738819478443,23.58655113993177,12011672,0.016615397880907323,0.2827703733298108,0.2661549754489035
2025-08-28T11:55:00-04:00,507.85,508.14,507.82,508.07,506.14246815710936,NaN,NaN,NaN,NaN,NaN,506.8512000000013,508.37877920708985,505.3236207929128,506.90819258119114,507.3437693089766,508.27389847151477,506.41364014643847,5519,13158.1,59.32885043535442,56.241899513469306,NaN,NaN,NaN,NaN,0.652968604665853,24.045819688708296,12017191,0.03509151960892798,0.3100193749600635,0.2749278553511355
2025-08-28T12:00:00-04:00,508.08,508.33,507.92,508.26,506.14246815710936,NaN,NaN,NaN,NaN,NaN,506.8850000000013,508.4602396623887,505.3097603376139,507.1395540649529,507.35658836786683,508.28510583436014,506.42807090137353,6221,11955.333333333334,60.97410077135124,56.42191956856974,NaN,NaN,NaN,NaN,0.6356137043325756,24.725562524666852,12023412,0.05445133066948682,0.342992018687994,0.2885406880185072
2025-08-28T12:05:00-04:00,508.29,508.97,508.03,508.745,506.4792782042891,NaN,NaN,NaN,NaN,NaN,506.92590000000126,508.5838260400501,505.2679739599524,507.54764325196237,507.39673200288837,508.3355937198719,506.45787028590485,13584,11410.1,64.87961018542302,57.26454295295515,NaN,NaN,NaN,NaN,0.6573555825945384,26.093554789723267,12036996,0.09205225302656012,0.40360600430170734,0.31155375127514723
2025-08-28T12:10:00-04:00,508.76,509.01,508.58,508.98,506.8074928313668,NaN,NaN,NaN,NaN,NaN,506.97550000000126,508.7253322760351,505.22566772396743,507.65711460156984,507.4952117610802,508.47300426523884,506.5174192569216,29986,11590.166666666666,66.62257418337381,58.10803479080579,NaN,NaN,NaN,NaN,0.6411158981235004,27.405292727495716,12066982,0.12295102641346156,0.46524253429197415,0.3422915078785126
2025-08-28T12:15:00-04:00,508.95,509,508.77,508.77,506.9564704299411,NaN,NaN,NaN,NaN,NaN,507.0209000000012,508.8356172657651,505.20618273423725,507.80269168125585,507.5471785407082,508.5405791781161,506.55377790330033,17777,11100.166666666666,63.58571427003354,58.69763683475766,NaN,NaN,NaN,NaN,0.611750476828966,28.623335098284418,12049205,0.11935016725071917,0.49147921694191155,0.37212904969119237
2025-08-28T12:20:00-04:00,508.83,509,508.77,508.94,507.0127672285801,NaN,NaN,NaN,NaN,NaN,507.07250000000124,508.9545842154835,505.19041578451896,507.9271533450047,507.57924461166016,508.58222484850137,506.57626437481895,11196,10594.7,64.9774766506954,59.13780875072287,NaN,NaN,NaN,NaN,0.5844825856268984,29.75437444258821,12060401,0.1182930588398366,0.5199953732409881,0.4017023144011515
2025-08-28T12:25:00-04:00,508.96,509.2,508.84,508.95,507.1837778090992,NaN,NaN,NaN,NaN,NaN,507.12210000000124,509.06770025553885,505.1764997444636,508.16172267600376,507.67754878202186,508.70996146430747,506.64513609973625,35287,11344.666666666666,65.06206805878314,59.428035310243004,NaN,NaN,NaN,NaN,0.568448115224978,31.04531161047937,12095688,0.1084052994691071,0.5372089387375354,0.4288036392684283
2025-08-28T12:30:00-04:00,508.94,509.03,508.24,508.24,507.1837778090992,NaN,NaN,NaN,NaN,NaN,507.1597000000012,509.1175604736995,505.2018395263029,508.16172267600376,507.6931928930487,508.7219578519777,506.6644279341197,9825,11026,54.919490205597896,59.039948688142054,NaN,NaN,NaN,NaN,0.5842732498517627,30.513593633933635,12085863,0.047305196285477136,0.4879351346252747,0.4406299383397976
2025-08-28T12:35:00-04:00,508.27,508.37,507.79,507.91,507.1837778090992,NaN,NaN,NaN,NaN,NaN,507.1919000000011,509.14509726464684,505.2387027353554,508.16172267600376,507.69533687158656,508.7210987525345,506.66957499063864,3390,10575.333333333334,50.944313191141894,58.9555198075444,NaN,NaN,NaN,NaN,0.5839680177194928,28.987843697105,12082473,-0.0185479493405305,0.41744500166413445,0.43599295100466495
2025-08-28T12:40:00-04:00,507.901,508.04,507.7,507.79,507.1837778090992,NaN,NaN,NaN,NaN,NaN,507.2259000000011,509.16028330088454,505.29151669911766,508.16172267600376,507.6964684432413,508.71838265956706,506.6745542269156,4022,10327.666666666666,49.540081778310046,58.555449330075376,NaN,NaN,NaN,NaN,0.5665417307395313,27.379600211413756,12078451,-0.07048409524673005,0.3478878319462524,0.41837192719298244
2025-08-28T12:45:00-04:00,507.83,508.02,507.71,507.86,507.1837778090992,NaN,NaN,NaN,NaN,NaN,507.2617000000011,509.17533278468835,505.34806721531385,508.16172267600376,507.6977445975645,508.7158473856681,506.6796418094609,4054,10168.066666666668,50.39896707937343,58.29930905264723,NaN,NaN,NaN,NaN,0.5482173214009934,25.88623126041475,12082505,-0.09868875312094189,0.29501098579180507,0.39369973891274695
2025-08-28T12:50:00-04:00,507.86,508,507.68,507.76,507.1837778090992,NaN,NaN,NaN,NaN,NaN,507.3047000000011,509.1637883881356,505.44561161186664,508.16172267600376,507.6984399163937,508.71351526108924,506.6833645716981,3208,9972.633333333333,49.11287913922999,57.9657624430872,NaN,NaN,NaN,NaN,0.5319160841580649,24.428006317393134,12079297,-0.12116451049819488,0.24224410079000336,0.36340861128819824
2025-08-28T12:55:00-04:00,507.81,507.96,507.65,507.81,507.1837778090992,NaN,NaN,NaN,NaN,NaN,507.33810000000113,509.172126050711,505.5040739492913,508.16172267600376,507.69971580299756,508.70885765286357,506.69057395313155,6362,9784.3,49.80261814082395,57.64197430891041,NaN,NaN,NaN,NaN,0.5160649352896318,22.99840264748878,12085659,-0.1290224796889488,0.20213051167701224,0.33115299136596105
2025-08-28T13:00:00-04:00,507.8,507.98,507.53,507.91,507.1837778090992,NaN,NaN,NaN,NaN,NaN,507.37710000000106,509.17482087791865,505.5793791220835,508.16172267600376,507.70066200833094,508.70537986670087,506.695944149961,4817,9618.333333333334,51.22650493220334,57.241089215835366,NaN,NaN,NaN,NaN,0.5113460113403756,21.3621205537154,12090476,-0.12382142318769512,0.17637621238134216,0.3001976355690373
2025-08-28T13:05:00-04:00,507.89,508.05,507.79,507.96,507.1837778090992,NaN,NaN,NaN,NaN,NaN,507.41730000000115,509.1750226273104,505.6595773726919,508.16172267600376,507.70229484911476,508.7036694293904,506.7009202688391,3848,9502.233333333334,51.96025769890725,56.714761163232005,NaN,NaN,NaN,NaN,0.4933927248160624,20.02362776482216,12094324,-0.11361653947516503,0.15817696122508096,0.271793500700246
2025-08-28T13:10:00-04:00,507.94,507.96,507.7,507.75,507.1837778090992,NaN,NaN,NaN,NaN,NaN,507.44810000000115,509.17380088795943,505.72239911204286,508.16172267600376,507.7028676092793,508.70142870659106,506.7043065119675,3126,9135.166666666666,48.649850928358966,55.834457603018265,NaN,NaN,NaN,NaN,0.47672181590062873,18.654567869573988,12091198,-0.11714394819067991,0.1253635654618961,0.242507513652576
2025-08-28T13:15:00-04:00,507.81,507.86,507.52,507.55,507.1837778090992,NaN,NaN,NaN,NaN,NaN,507.4709000000012,509.1710713897126,505.77072861028984,507.804378140803,507.7024032517604,508.69707620807156,506.70773029544927,4335,8953.633333333333,45.665862631781266,54.462047063472426,NaN,NaN,NaN,NaN,0.466955971907729,17.865322797215715,12086863,-0.1281884077758091,0.08227200393281464,0.21046041170862373
2025-08-28T13:20:00-04:00,507.59,507.98,507.56,507.885,507.1837778090992,NaN,NaN,NaN,NaN,NaN,507.4956000000012,509.18318719903317,505.80801280096927,507.1066331066741,507.7032553615284,508.6939648167011,506.71254590635573,4507,8676.9,51.078566537889,53.35176080308065,NaN,NaN,NaN,NaN,0.46431625962860595,16.774346149224304,12091370,-0.10893082294139714,0.07429688303187731,0.18322770597327445
2025-08-28T13:25:00-04:00,507.82,508.62,507.82,508.6,507.1837778090992,NaN,NaN,NaN,NaN,NaN,507.5290000000012,509.2364753276222,505.8215246723802,507.4862369204937,507.71418933729143,508.69995870915267,506.7284199654302,9686,8755.833333333334,60.193293417188286,53.10944502787742,NaN,NaN,NaN,NaN,0.48829366965513493,16.938063786245,12101056,-0.047191030501034986,0.12423891784698071,0.1714299483480157
2025-08-28T13:30:00-04:00,508.65,509.03,508.63,508.65,507.23999221747846,NaN,NaN,NaN,NaN,NaN,507.5706000000012,509.2839320035313,505.85726799647114,507.90798953639495,507.7287978866299,508.7154621507215,506.74213362253823,7997,8772.4,60.74409868461071,52.8070608874428,NaN,NaN,NaN,NaN,0.48412983610833604,17.825018249797164,12109053,-0.00439190382471305,0.1659400685671244,0.17033197239183745
2025-08-28T13:35:00-04:00,508.67,508.84,508.28,508.415,507.23999221747846,NaN,NaN,NaN,NaN,NaN,507.6069000000012,509.3133324054605,505.90046759454185,507.90798953639495,507.733131232923,508.71877390017045,506.7474885656755,3217,8771.9,56.76824967895032,52.21464528888332,NaN,NaN,NaN,NaN,0.48954913352916934,17.68175050232747,12105836,0.006113955399017212,0.17797441664060898,0.17186046124159177
2025-08-28T13:40:00-04:00,508.36,508.39,508.01,508.195,507.23999221747846,NaN,NaN,NaN,NaN,NaN,507.58320000000117,509.22204808158017,505.94435191842217,507.90798953639495,507.739169535345,508.7198091845583,506.7585298861317,7643,8738.733333333334,53.25411452971409,52.095689883463045,NaN,NaN,NaN,NaN,0.4835099097056594,16.887047429267536,12098193,-0.0032283842764730952,0.1678249808960004,0.1710533651724735
2025-08-28T13:45:00-04:00,508.24,508.44,508.03,508.1,507.23999221747846,NaN,NaN,NaN,NaN,NaN,507.5770000000012,509.20560308067684,505.94839691932555,507.90798953639495,507.7426400392767,508.72029225204113,506.76498782651225,4568,8407.433333333332,51.76397751150581,52.15423733491762,NaN,NaN,NaN,NaN,0.4782592018695427,16.25390130036623,12093625,-0.016536883497227872,0.15038226080093864,0.1669191442981665
2025-08-28T13:50:00-04:00,508.13,508.65,508.12,508.65,507.23999221747846,NaN,NaN,NaN,NaN,NaN,507.5966000000011,509.2525667130291,505.9406332869731,507.90798953639495,507.74614486322236,508.7227552939706,506.76953443247413,2860,8047.2,58.92920400864566,52.82488892279873,NaN,NaN,NaN,NaN,0.48338354459314353,16.101588462063827,12096485,0.009566442901720373,0.17887719792531698,0.1693107550235966
2025-08-28T13:55:00-04:00,508.67,508.71,508.21,508.35,507.23999221747846,NaN,NaN,NaN,NaN,NaN,507.6316000000012,509.27576475888776,505.9874352411146,507.90798953639495,507.74912659293113,508.72461554651164,506.7736376393506,2637,7855.066666666667,54.199870594218055,53.09638203100191,NaN,NaN,NaN,NaN,0.48457043426506186,16.082799329715332,12093848,0.004737140458171224,0.17523218059631063,0.1704950401381394
2025-08-28T14:00:00-04:00,508.34,508.5,508.28,508.5,507.23999221747846,NaN,NaN,NaN,NaN,NaN,507.68400000000116,509.26740645270206,506.10059354730026,507.90798953639495,507.75211809896194,508.7264872080195,506.7777489899044,2656,7777.266666666666,56.097089139639664,53.595254173888314,NaN,NaN,NaN,NaN,0.4656725461032737,16.065352278248874,12096504,0.00948017735148271,0.18234526182749278,0.17286508447601007
2025-08-28T14:05:00-04:00,508.55,508.79,508.53,508.65,507.23999221747846,NaN,NaN,NaN,NaN,NaN,507.7232000000012,509.30327564197586,506.14312435802657,507.90798953639495,507.762065677914,508.7356433609537,506.7884879948743,6689,7654.733333333334,57.97197288262516,54.178779512588406,NaN,NaN,NaN,NaN,0.45312450709589847,16.65499182643834,12103193,0.01995272602077161,0.19780599200197457,0.17785326598120296
2025-08-28T14:10:00-04:00,508.64,508.65,508.32,508.32,507.23999221747846,NaN,NaN,NaN,NaN,NaN,507.76080000000115,509.3060344270591,506.2155655729432,507.90798953639495,507.76852016360147,508.7395832785474,506.79745704865553,5935,7718.933333333333,52.64538944471676,54.28012840633937,NaN,NaN,NaN,NaN,0.4443298994461903,16.55546735163586,12097258,0.002789478434791548,0.1813401140246924,0.17855063558990086
2025-08-28T14:15:00-04:00,508.39,508.76,508.22,508.68,507.23999221747846,NaN,NaN,NaN,NaN,NaN,507.7966000000012,509.34241815048256,506.25078184951985,507.90798953639495,507.77849804019297,508.7473665716638,506.80962950872214,7909,7873.833333333333,57.25907330528411,54.65861523536629,NaN,NaN,NaN,NaN,0.4511634780571741,16.70201871429468,12105167,0.013232205198334623,0.19509089208781916,0.18185868688948453
2025-08-28T14:20:00-04:00,508.7,509.09,508.7,509.06,507.4305176936053,NaN,NaN,NaN,NaN,NaN,507.83420000000115,509.4093753662884,506.2590246337139,508.05507300158615,507.79380163589144,508.7654691156545,506.82213415612836,8234,8036.5,61.52072739586433,55.57796355447381,NaN,NaN,NaN,NaN,0.4482232296245165,17.49577924365088,12113401,0.041676591278882874,0.23395442598808813,0.19227783470920526
2025-08-28T14:25:00-04:00,509.03,509.38,509.02,509.14,507.75299416207775,NaN,NaN,NaN,NaN,NaN,507.8908000000012,509.4460869299297,506.3355130700727,508.37205840126893,507.8072779927533,508.78372986348495,506.8308261220217,6188,8058.8,62.37136351042671,56.771213617234196,NaN,NaN,NaN,NaN,0.4419215703656234,18.731467066077183,12119589,0.06067267842168772,0.2681186827363149,0.20744600431462717
2025-08-28T14:30:00-04:00,509.17,509.71,509.17,509.56,507.98103988198335,NaN,NaN,NaN,NaN,NaN,507.9546000000012,509.5168123269053,506.3923876730971,508.6186467210151,507.82995324838504,508.8188660357615,506.84104046100856,8747,8143,66.55190329140828,57.87645195677128,NaN,NaN,NaN,NaN,0.4510700296252213,20.37236485721002,12128336,0.09431066894778062,0.32533434049935295,0.23102367155157233
2025-08-28T14:35:00-04:00,509.66,509.69,509.27,509.43,508.03008352371137,NaN,NaN,NaN,NaN,NaN,508.02280000000115,509.5382644946284,506.50733550537393,508.6186467210151,507.8380738282565,508.8311924221263,506.84495523438665,3224,7797.666666666667,64.17527974988184,58.160879551963674,NaN,NaN,NaN,NaN,0.44885074179484946,21.89605566326194,12125112,0.10004789361481398,0.3560835385700898,0.2560356449552758
2025-08-28T14:40:00-04:00,509.4,509.5,509.285,509.41,508.03008352371137,NaN,NaN,NaN,NaN,NaN,508.0876000000012,509.5570056466322,506.6181943533702,508.6186467210151,507.8524532652928,508.8521651108869,506.8527414196987,6032,6999.2,63.79781444225967,58.37900210608145,NaN,NaN,NaN,NaN,0.43214711738092987,23.31091141173872,12119080,0.09478861760447888,0.3745214169608744,0.2797327993563955
2025-08-28T14:45:00-04:00,509.39,509.41,509.14,509.22,508.03008352371137,NaN,NaN,NaN,NaN,NaN,508.1480000000012,509.54875122499817,506.74724877500427,508.6186467210151,507.86754553336954,508.8723575112173,506.8627335555218,7111,6643.666666666667,60.17667107416111,58.62246077716794,NaN,NaN,NaN,NaN,0.42056518042515195,24.068507048627392,12111969,0.07184760266395634,0.3695423026863409,0.2976947000223846
2025-08-28T14:50:00-04:00,509.2,509.27,508.96,509.18,508.03008352371137,NaN,NaN,NaN,NaN,NaN,508.1978000000012,509.5643008724264,506.8312991275761,508.6186467210151,507.87630643531185,508.8831427094682,506.8694701611555,4599,6423.766666666666,59.41212080105294,59.06231836797786,NaN,NaN,NaN,NaN,0.4126676675376412,24.117372373887207,12107370,0.04843551657843814,0.3582390957454322,0.3098035791669941
2025-08-28T14:55:00-04:00,509.18,509.63,509.09,509.58,508.03008352371137,NaN,NaN,NaN,NaN,NaN,508.26040000000125,509.5870888686628,506.9337111313397,508.6509293575422,507.8906583008389,508.90382936709443,506.8774872345833,6198,5454.133333333333,64.29713311291616,59.9575437680786,NaN,NaN,NaN,NaN,0.42176283414209687,24.85321299738545,12113568,0.05392485020467025,0.3772096419228319,0.32328479171816166
2025-08-28T15:00:00-04:00,509.57,509.91,509.57,509.62,508.3794516341627,NaN,NaN,NaN,NaN,NaN,508.3004000000012,509.66743158494455,506.9333684150579,508.9567434860338,507.9140996079723,508.9412705821288,506.8869286338157,8826,5420.833333333333,64.75397314635167,60.37359870648617,NaN,NaN,NaN,NaN,0.4159226317033779,25.99157010656718,12122394,0.05414400923745338,0.3909648032649784,0.336820794027525
2025-08-28T15:05:00-04:00,509.61,509.62,509.42,509.57,508.3794516341627,NaN,NaN,NaN,NaN,NaN,508.3518000000012,509.71263615262114,506.9909638473813,508.9567434860338,507.92904910805424,508.963163377078,506.8949348390305,6335,5519,63.657481784257705,61.04914236291757,NaN,NaN,NaN,NaN,0.4004995865817072,26.51489483787009,12116059,0.04518144136381391,0.3932975957322924,0.3481161543684785
2025-08-28T15:10:00-04:00,509.535,509.76,509.535,509.61,508.3794516341627,NaN,NaN,NaN,NaN,NaN,508.3992000000012,509.7669154069345,507.0314845930679,508.9574158310616,507.94011206525784,508.97992352371455,506.9003006068011,4488,5534.533333333334,64.18004460222332,61.62649632453069,NaN,NaN,NaN,NaN,0.38796390182586854,27.242052253199073,12120547,0.036574389662204665,0.3938341414462343,0.35725975178402963
2025-08-28T15:15:00-04:00,509.61,509.96,509.6,509.84,508.49344774455113,NaN,NaN,NaN,NaN,NaN,508.4498000000013,509.83960856015455,507.05999143984803,509.1379326648493,507.96165474825193,509.01440702647164,506.9089024700322,8110,5669.733333333334,67.10863053810701,62.279114728493674,NaN,NaN,NaN,NaN,0.38596648026687486,28.24410844492372,12128657,0.04068336017546559,0.40811395200336165,0.36743059182789606
2025-08-28T15:20:00-04:00,509.84,510,509.52,509.52,508.49344774455113,NaN,NaN,NaN,NaN,NaN,508.48440000000124,509.8927957377959,507.0760042622066,509.1379326648493,507.99276196232546,509.0608018967723,506.9247220278786,12909,5993.1,59.784916411867016,62.78908094043298,NaN,NaN,NaN,NaN,0.39268316024781363,28.869885958853263,12115748,0.01735464733168446,0.3891239009925016,0.37176925366081714
2025-08-28T15:25:00-04:00,509.54,509.71,509.51,509.71,508.49344774455113,NaN,NaN,NaN,NaN,NaN,508.5164000000013,509.96154226084155,507.071257739161,509.1379326648493,508.01069591267094,509.0866117054521,506.93478011988975,7833,6042.133333333333,62.40813897830468,63.15687134564873,NaN,NaN,NaN,NaN,0.37892007737296896,29.411346959208856,12123581,0.010558909587426613,0.3849678906451004,0.3744089810576738
2025-08-28T15:30:00-04:00,509.7,509.75,509.57,509.73,508.49344774455113,NaN,NaN,NaN,NaN,NaN,508.5500000000013,510.0279526358392,507.07204736416344,509.1379326648493,508.02709247182474,509.1103300976689,506.9438548459806,7137,6119.466666666666,62.684070619830756,63.23996729021777,NaN,NaN,NaN,NaN,0.36471150041775735,29.991937054565053,12130718,0.0036088954007107987,0.37892010030856227,0.37531120490785147
2025-08-28T15:35:00-04:00,509.72,510,509.71,509.87,508.64214172020377,NaN,NaN,NaN,NaN,NaN,508.60300000000126,510.0764272951403,507.1295727048622,509.25940121952226,508.0560695918854,509.1547623076455,506.95737687612524,11695,6381.033333333334,64.64063805611752,63.40205832919569,NaN,NaN,NaN,NaN,0.3593749646736333,30.99252776661345,12142413,0.004576409212229071,0.3810317164231378,0.37645530721090875
2025-08-28T15:40:00-04:00,509.91,510.36,509.85,510.31,508.87772618746726,NaN,NaN,NaN,NaN,NaN,508.65720000000124,510.1776817111851,507.1367182888174,509.51252097561786,508.1053953326047,509.23721066085255,506.97358000435685,17645,6865,69.96989576906901,63.64620064902859,NaN,NaN,NaN,NaN,0.37013389576837313,32.4745703904479,12160058,0.029590626095292172,0.41344358983002394,0.38385296373473177
2025-08-28T15:45:00-04:00,510.31,510.5,510.16,510.18,509.1121477244006,NaN,NaN,NaN,NaN,NaN,508.71120000000127,510.2522549094762,507.1701450905263,509.65201678049425,508.14740547047256,509.307512962096,506.98729797884914,14920,7217.833333333333,66.7680081672913,63.83139553598642,NaN,NaN,NaN,NaN,0.367981474642059,34.03938865836317,12145138,0.031922052619990204,0.4237555295097195,0.3918334768897293
2025-08-28T15:50:00-04:00,510.19,510.9,510,510.87,509.16477737329143,NaN,NaN,NaN,NaN,NaN,508.7794000000013,510.3930413956194,507.16575860438326,509.7716134243954,508.31835340915717,509.59897505247926,507.0377317658351,58119,9004.9,73.65819260453361,64.53570826186312,NaN,NaN,NaN,NaN,0.4059827978819103,35.962020410657495,12203257,0.07217185587121572,0.48204829672874894,0.4098764408575332
2025-08-28T15:55:00-04:00,510.84,510.84,509.1,509.57,NaN,NaN,NaN,511.4381670527673,511.4381670527673,511.4381670527673,508.82040000000126,510.4079236546074,507.23287634539514,509.7716134243954,508.47016169750054,509.7676455232303,507.17267787177076,92255,11757.2,51.84708346173093,63.940737718118115,NaN,NaN,NaN,NaN,0.503412598033201,34.77169818121744,12111002,0.006916556601945734,0.4185221366099654,0.41160558000801967
2025-08-29T09:30:00-04:00,508.97,509.6,507.37,508.23,NaN,NaN,NaN,510.1905230958233,NaN,NaN,508.82920000000126,510.3985531896686,507.25984681033395,509.7716134243954,508.40000000000003,508.40000539479666,508.3999946052034,41307,12867.533333333333,39.02084095002655,62.484217728759084,NaN,NaN,NaN,NaN,0.6267402696022594,33.88237840682382,12069695,-0.12361497712094371,0.25708685860684,0.3807018357277837
2025-08-29T09:35:00-04:00,508.07,508.2,506.99,507.2,NaN,NaN,NaN,509.3920902278314,NaN,NaN,508.8118000000013,510.43287712147685,507.1907228785258,509.7716134243954,508.1027464881838,508.5387141541377,507.6667788222299,19203,13400.4,32.38829443671894,60.205014966173565,NaN,NaN,NaN,NaN,0.6705445360592416,33.479558225419,12050492,-0.2681524919766102,0.045511220757020965,0.31366371273363114
2025-08-29T09:40:00-04:00,507.19,507.56,506,506.22,NaN,NaN,NaN,508.70813158111173,NaN,NaN,508.7710000000012,510.54138639683276,507.00061360316965,509.7716134243954,507.68754078262714,508.45702475988867,506.9180568053656,22961,13911,27.584142804956045,57.55002708464531,NaN,NaN,NaN,NaN,0.7340770691978673,34.008615577170346,12027531,-0.4100897321379441,-0.198948452438799,0.2111412796991451
2025-08-29T09:45:00-04:00,506.2,506.21,505.37,506.09,NaN,NaN,NaN,507.7463983274248,NaN,NaN,508.71790000000124,510.64090711234496,506.7948928876575,509.7716134243954,507.31726372797095,508.31657360651366,506.31795384942825,21655,14480.566666666668,27.011764011887948,54.93247581519032,NaN,NaN,NaN,NaN,0.7423572785408784,34.95481012766252,12005876,-0.48777689412993075,-0.39857983796326835,0.0891970561666624
2025-08-29T09:50:00-04:00,505.94,506.23,505.58,505.59,NaN,NaN,NaN,507.7463983274248,NaN,NaN,508.6501000000013,510.761207281468,506.53899271853464,509.7716134243954,507.1188023305167,508.1816898537996,506.0559148072338,15820,14912.566666666668,24.87390369498324,52.12489432181603,NaN,NaN,NaN,NaN,0.7357603300736753,35.79481800784585,11990056,-0.5436216558564023,-0.5903300136538405,-0.04670835779743818
2025-08-29T09:55:00-04:00,505.605,505.74,504.7,504.85,NaN,NaN,NaN,507.2290116991619,NaN,NaN,508.5717000000013,510.9352351560892,506.2081648439133,509.7716134243954,506.80934826807845,508.0287087115451,505.5899878246118,21853,15553.1,22.087640700801657,48.90910933343707,NaN,NaN,NaN,NaN,0.7574917350684142,37.13864948266351,11968203,-0.5969257651644202,-0.7928655642529634,-0.19593979908854323
2025-08-29T10:00:00-04:00,504.79,505.73,504.66,505.09,NaN,NaN,NaN,507.2290116991619,NaN,NaN,508.4947000000013,511.04842465897786,505.9409753410247,509.7716134243954,506.5950097687984,507.860394199111,505.32962533848576,21329,16175.533333333333,25.021108850140706,46.42598022188519,NaN,NaN,NaN,NaN,0.7798137539920983,38.40983494149263,11989532,-0.5819413281606036,-0.9233664592892978,-0.34142513112869416
2025-08-29T10:05:00-04:00,505.06,505.16,504.49,504.815,NaN,NaN,NaN,506.8861656184513,NaN,NaN,508.4120000000013,511.16168798121566,505.6623120187869,509.7716134243954,506.38599207415615,507.7048711120879,505.0671130362244,21930,16683.566666666666,23.910234369487654,43.67612989268398,NaN,NaN,NaN,NaN,0.7719699144212352,39.69290317229287,11967602,-0.5564801971104263,-1.037025377516727,-0.48054518040630073
2025-08-29T10:10:00-04:00,504.88,505.58,504.67,505.57,NaN,NaN,NaN,506.8861656184513,NaN,NaN,508.3586000000012,511.22097107207054,505.4962289279319,509.0522907395163,506.2660971827924,507.5587824196888,504.97341194589603,22470,17234.733333333334,32.739372184234924,41.537222861569994,NaN,NaN,NaN,NaN,0.7818292062482876,40.01050052572155,11990072,-0.458786667095724,-1.0540285142759558,-0.5952418471802318
2025-08-29T10:15:00-04:00,505.47,506,505.29,505.98,NaN,NaN,NaN,506.8861656184513,NaN,NaN,508.32000000000124,511.25661846247743,505.38338153752505,507.0548325916131,506.21732878296416,507.4556868335529,504.97897073237544,22076,17706.966666666667,37.013625423042754,39.56386481635036,NaN,NaN,NaN,NaN,0.7766985486591228,39.50539479956503,12012148,-0.34191195145815645,-1.0226317865029273,-0.6807198350447708
2025-08-29T10:20:00-04:00,505.98,506.38,505.5,505.5,NaN,NaN,NaN,506.8861656184513,NaN,NaN,508.2742000000012,511.31213637758515,505.23626362241725,505.5438660732904,506.1894884594088,507.3910979198702,504.98787899894734,16206,17972.7,34.268065158955494,37.01373405848511,NaN,NaN,NaN,NaN,0.7840772237548995,38.36803537897063,11995942,-0.2751600402922223,-1.0246698854100487,-0.7495098451178264
2025-08-29T10:25:00-04:00,505.48,506.13,505.19,506.12,NaN,NaN,NaN,506.8861656184513,NaN,NaN,508.23940000000124,511.33483769991176,505.1439623000907,504.6550928586324,506.1754729900167,507.35663458053244,504.994311399501,9552,18084.833333333332,40.41606274474463,35.13145224258892,NaN,NaN,NaN,NaN,0.7952145649152637,37.62977875970003,12005494,-0.1724968018242533,-0.965130847398143,-0.7926340455738897
2025-08-29T10:30:00-04:00,506.05,506.53,505.83,506.33,NaN,NaN,NaN,506.8861656184513,NaN,NaN,508.21080000000126,511.3495483865149,505.0720516134876,504.3717197403477,506.17735307594864,507.33801551643825,505.01669063545904,9155,18098.433333333334,42.38181654031235,32.897425380858834,NaN,NaN,NaN,NaN,0.7884135245641726,36.259625394614986,12014649,-0.07847890278617442,-0.8907326740566077,-0.8122537712704333
2025-08-29T10:35:00-04:00,506.35,506.91,506.27,506.87,504.45256460948207,504.45256460948207,504.45256460948207,NaN,NaN,NaN,508.1920000000012,511.35131891299767,505.03268108700473,504.8633757922782,506.19357761632386,507.3389538209154,505.04820141173235,8796,18284.166666666668,47.20518405296852,32.565861137375805,NaN,NaN,NaN,NaN,0.7778125585238777,34.38544637374021,12023445,0.026430389714413804,-0.7792157841274161,-0.8056461738418299
2025-08-29T10:40:00-04:00,506.85,506.99,506.23,506.23,504.46608439996015,NaN,NaN,NaN,NaN,NaN,508.1584000000012,511.3643902922694,504.95240970773307,504.97270063382257,506.20098742978394,507.33254847493816,505.0694263846297,7199,18323.066666666666,42.64834327029957,32.82496844596674,NaN,NaN,NaN,NaN,0.7765402329150286,32.5203955827457,12016246,0.05730159465935625,-0.7340191805176346,-0.7913207751769908
2025-08-29T10:45:00-04:00,506.22,506.585,505.83,505.9,504.46608439996015,NaN,NaN,NaN,NaN,NaN,508.11720000000116,511.3846859807106,504.84971401929175,504.97270063382257,506.1989941051382,507.3188278782178,505.07916033205856,5970,18285.033333333333,40.47855285642648,33.40284404737442,NaN,NaN,NaN,NaN,0.7750016448496692,31.30445741402727,12010276,0.05980171496340103,-0.7165686314727395,-0.7763703464361406
2025-08-29T10:50:00-04:00,505.91,506.59,505.65,506.56,504.46608439996015,NaN,NaN,NaN,NaN,NaN,508.0934000000012,511.388457170068,504.7983428299344,504.97270063382257,506.20059778351333,507.30713118392373,505.09406438310293,6978,18364.333333333332,46.35676506002722,34.743745637022364,NaN,NaN,NaN,NaN,0.7867872416461212,30.397230534666893,12017254,0.10743151559064645,-0.6420809519478325,-0.749512467538479
2025-08-29T10:55:00-04:00,506.52,506.88,506.26,506.84,504.46608439996015,NaN,NaN,NaN,NaN,NaN,508.0792000000012,511.389585692663,504.7688143073394,504.97270063382257,506.2103210261491,507.30707703813766,505.1135650141605,6367,18369.966666666667,48.67266235525931,36.290952661548886,NaN,NaN,NaN,NaN,0.7748738672428271,29.04692345797401,12023621,0.15635532227794235,-0.554068314691051,-0.7104236369689934
2025-08-29T11:00:00-04:00,506.8,507.1,506.65,506.74,504.7467023478103,NaN,NaN,NaN,NaN,NaN,508.0563000000012,511.3875182807597,504.7250817192427,505.3066341796137,506.23265013629333,507.3156406572081,505.14965961537854,11245,18450.6,47.877668123509046,37.93407869215787,NaN,NaN,NaN,NaN,0.7516685910111999,27.421226619636407,12012376,0.17891844244773814,-0.48677558390932063,-0.6656940263570588
2025-08-29T11:05:00-04:00,506.7,507.27,506.46,507.26,504.7467023478103,NaN,NaN,NaN,NaN,NaN,508.0295000000011,511.36434947104294,504.6946505289593,505.4303073436909,506.2532536482903,507.32868668498656,505.17782061159403,8649,18527.733333333334,52.24564090028931,40.088221563549844,NaN,NaN,NaN,NaN,0.7558351202246857,26.19023870879502,12021025,0.22293555920172126,-0.38702457735490725,-0.6099601365566285
2025-08-29T11:10:00-04:00,507.29,507.51,507.19,507.33,505.2617163954222,NaN,NaN,NaN,NaN,NaN,508.00310000000115,511.3387821722684,504.6674178277339,505.87824587495277,506.28578585969797,507.3611669294291,505.21040478996684,9866,18707,52.818838148635365,42.073773656299466,NaN,NaN,NaN,NaN,0.7247040402086362,24.625462300601217,12030891,0.2488661114340447,-0.29887749726407264,-0.5477436086981173
2025-08-29T11:15:00-04:00,507.34,507.65,507.27,507.58,505.4148201956302,NaN,NaN,NaN,NaN,NaN,507.98640000000114,511.32202710063666,504.6507728993656,506.1545966999622,506.3193600656493,507.39829781915853,505.24042231214,9401,18750.033333333333,54.90086323138003,44.28739000357749,NaN,NaN,NaN,NaN,0.7000823230508761,22.929891232545145,12040292,0.27302099630174226,-0.2064673633209395,-0.47948835962268177
2025-08-29T11:20:00-04:00,507.56,507.9,507.25,507.86,505.5341465503743,NaN,NaN,NaN,NaN,NaN,507.9797000000011,511.3149699492691,504.64443005073315,506.37867735996974,506.3604057391542,507.44782602989665,505.27298544841176,10656,18674.933333333334,57.179981601111436,46.033147819068674,NaN,NaN,NaN,NaN,0.6965050142615262,21.653335932992597,12050948,0.29608894812436404,-0.10937717446722672,-0.40546612259159076
2025-08-29T11:25:00-04:00,507.85,508.35,507.7,508.12,505.98827625263004,NaN,NaN,NaN,NaN,NaN,507.98010000000113,511.31543236041495,504.6447676395873,506.80794188797586,506.41471085087915,507.5254730974788,505.30394860427947,11597,18800.4,59.23982720412379,47.62073366057446,NaN,NaN,NaN,NaN,0.6931832275285625,21.163253106956954,12062545,0.3153151713374086,-0.011322158419829975,-0.3266373297572386
2025-08-29T11:30:00-04:00,508.12,508.17,507.48,507.63,505.98827625263004,NaN,NaN,NaN,NaN,NaN,507.9597000000011,511.2908682087024,504.62853179129974,506.80794188797586,506.4397962563619,507.5551008181242,505.3244916945996,6883,18791.933333333334,53.97053859093725,49.028053191430295,NaN,NaN,NaN,NaN,0.692955854133665,20.288240320723975,12055662,0.28254368817354586,0.026542280459693757,-0.2560014077138521
2025-08-29T11:35:00-04:00,507.64,508.01,507.4,507.99,505.98827625263004,NaN,NaN,NaN,NaN,NaN,507.9525000000012,511.2818183978541,504.62318160214824,506.80794188797586,506.4715495911684,507.59273138707596,505.35036779526087,8823,18696.2,56.996953914994414,50.21240256073385,NaN,NaN,NaN,NaN,0.6870304359812612,19.322768208335813,12064485,0.2725000253423095,0.08462362396403478,-0.18787640137827472
2025-08-29T11:40:00-04:00,507.99,508.2,507.76,507.83,505.98827625263004,NaN,NaN,NaN,NaN,NaN,507.93910000000113,511.26488753898667,504.6133124610156,506.80794188797586,506.52188376586275,507.6552599657039,505.3885075660216,13510,18558.366666666665,55.25799266806081,51.1321294270016,NaN,NaN,NaN,NaN,0.6693854048397424,18.745108092733158,12050975,0.24342195752251353,0.11640104552486719,-0.12702091199764634
2025-08-29T11:45:00-04:00,507.81,507.91,507.57,507.72,505.98827625263004,NaN,NaN,NaN,NaN,NaN,507.92050000000114,511.24057364294083,504.60042635706145,506.80794188797586,506.53217831947023,507.6661938819854,505.39816275695506,3355,18172.866666666665,54.03734686799026,51.620141056646005,NaN,NaN,NaN,NaN,0.6458578759226202,17.81909930255033,12047620,0.20657388908834887,0.13119644936278974,-0.07537743972555913
2025-08-29T11:50:00-04:00,507.67,507.73,507.415,507.435,505.98827625263004,NaN,NaN,NaN,NaN,NaN,507.9028000000011,511.2236018059846,504.5819981940176,506.80794188797586,506.5553989806664,507.686114553612,505.42468340772075,9439,16550.2,50.90009077253044,52.209551592519645,NaN,NaN,NaN,NaN,0.6222251704995757,16.647173067678565,12038181,0.1551484565880305,0.11855813100947898,-0.036590325578551505
2025-08-29T11:55:00-04:00,507.47,507.51,507.15,507.29,505.98827625263004,NaN,NaN,NaN,NaN,NaN,507.87500000000114,511.19258225136787,504.5574177486344,506.80794188797586,506.57389787418236,507.6969250236294,505.45087072473535,10068,13810.633333333333,49.33087523236253,52.84186033365793,NaN,NaN,NaN,NaN,0.6034948011781784,15.86912959601015,12028113,0.10586287906824653,0.09573827325675666,-0.01012460581148987
2025-08-29T12:00:00-04:00,507.28,507.95,507.265,507.8,505.98827625263004,NaN,NaN,NaN,NaN,NaN,507.8498000000011,511.1500914772325,504.5495085227697,506.80794188797586,506.5969806459083,507.71924517953227,505.4747161122843,8899,12730.366666666667,54.62907723977173,53.43273977506825,NaN,NaN,NaN,NaN,0.6093166010940231,15.172028335065063,12037012,0.10206143949385955,0.11745219355583458,0.015390754061975025
2025-08-29T12:05:00-04:00,507.79,507.79,507.44,507.72,505.98827625263004,NaN,NaN,NaN,NaN,NaN,507.82140000000106,511.10116769829966,504.54163230170246,506.80794188797586,506.6093051747893,507.7307162687021,505.4878940808765,5012,12257.333333333334,53.68085737749157,53.790467990941984,NaN,NaN,NaN,NaN,0.591508272444451,14.524720021330337,12032000,0.08908281383559752,0.12674427135647193,0.03766145752087441
2025-08-29T12:10:00-04:00,507.69,508.04,507.67,507.98,506.0471847555505,NaN,NaN,NaN,NaN,NaN,507.78980000000115,511.03218736650894,504.54741263349337,506.89293465256014,506.639814431462,507.7650279277825,505.5146009351415,10395,11838.466666666667,56.333631677755534,54.39446538767388,NaN,NaN,NaN,NaN,0.5756862529841335,14.385302438952637,12042395,0.0925274346804557,0.15332075087144403,0.060793316190988336
2025-08-29T12:15:00-04:00,507.96,508.015,507.66,507.69,506.0634490848436,NaN,NaN,NaN,NaN,NaN,507.7550000000012,510.9633964833645,504.5466035166379,506.91984772204813,506.64649430367655,507.77182491595113,505.52116369140197,2566,11202.166666666666,52.70767209914697,54.42746761616371,NaN,NaN,NaN,NaN,0.5599229491995498,14.23206998938177,12039829,0.07077465170592066,0.14926163082338917,0.0784869791174685
2025-08-29T12:20:00-04:00,507.7,507.97,507.63,507.91,506.0634490848436,NaN,NaN,NaN,NaN,NaN,507.72500000000116,510.89880024490697,504.55119975509535,506.9238781776385,506.65051096904875,507.77605952827116,505.52496240982634,1494,10724.633333333333,55.070314291396016,54.588287340646616,NaN,NaN,NaN,NaN,0.5442141671138699,14.013928409749562,12041323,0.06675463980001498,0.16193027886748723,0.09517563906747226
2025-08-29T12:25:00-04:00,507.92,507.98,507.38,507.45,506.0634490848436,NaN,NaN,NaN,NaN,NaN,507.6896000000012,510.83527057308646,504.5439294269159,506.9238781776385,506.6803408775938,507.8004885919865,505.56019316320106,14307,10473.1,49.50169915061177,54.20263276344889,NaN,NaN,NaN,NaN,0.5481988694628809,13.189840051772524,12027016,0.030511762202779222,0.1333153418209463,0.10280357961816707
2025-08-29T12:30:00-04:00,507.4,507.96,507.34,507.9,506.0634490848436,NaN,NaN,NaN,NaN,NaN,507.6640000000012,510.7814444652937,504.54655553470866,506.9238781776385,506.7014508088859,507.8200926532714,505.58280896450043,9349,10073.766666666666,54.36333994062827,54.00144407341437,NaN,NaN,NaN,NaN,0.553327521644104,12.327216294376523,12036365,0.033976659779149126,0.14527440434210348,0.11129774456295435
2025-08-29T12:35:00-04:00,507.89,508.44,507.83,508.37,506.38341243754473,NaN,NaN,NaN,NaN,NaN,507.6398000000012,510.71588644779473,504.5637135522076,507.1593856269509,506.72201026221353,507.846734073421,505.5972864510061,6429,9557.066666666668,58.822342914088544,53.971623766983285,NaN,NaN,NaN,NaN,0.5573755558123833,12.56259398266842,12042794,0.06334689950638756,0.1904813689459388,0.12713446943955126
2025-08-29T12:40:00-04:00,508.37,508.42,508.15,508.24,506.5762118722017,NaN,NaN,NaN,NaN,NaN,507.61220000000117,510.64112466634066,504.5832753336617,507.2605085015607,506.7380629226639,507.86787583802993,505.6082500072979,4954,8973.2,57.158788161182336,54.19935587914365,NaN,NaN,NaN,NaN,0.5368487303972158,12.781158978939464,12037840,0.06897949063706138,0.21335883273587797,0.1443793420988166
2025-08-29T12:45:00-04:00,508.26,508.45,508.06,508.1,506.5762118722017,NaN,NaN,NaN,NaN,NaN,507.58280000000116,510.56329067003645,504.60230932996586,507.32740680124857,506.77510471373336,507.9140130678167,505.63619635965,12390,8650.333333333334,55.34355992320605,54.081256308301626,NaN,NaN,NaN,NaN,0.5263595353688423,12.728750831736551,12025450,0.058643118917108744,0.2176832407452025,0.15904012182809377
2025-08-29T12:50:00-04:00,508.14,508.25,508,508.25,506.5762118722017,NaN,NaN,NaN,NaN,NaN,507.55560000000116,510.4859949485012,504.62520505150115,507.32740680124857,506.7927041632421,507.93502123982364,505.65038708666054,6278,8319.4,56.92208262426214,54.20011987660172,NaN,NaN,NaN,NaN,0.5066195685567821,12.506276939690036,12031728,0.05721302331510689,0.23055640097197738,0.1733433776568705
2025-08-29T12:55:00-04:00,508.25,508.81,508.22,508.67,506.86734439786443,NaN,NaN,NaN,NaN,NaN,507.5322000000012,510.4074211452576,504.65697885474475,507.6965403527991,506.82376372785376,507.9796942485058,505.66783320720174,8846,8295.866666666667,61.07141362680018,54.70255321651671,NaN,NaN,NaN,NaN,0.5125753136598673,13.456457563189641,12040574,0.07854054619278353,0.2715190603978499,0.19297851420506637
2025-08-29T13:00:00-04:00,508.63,508.64,507.9,507.9,506.86734439786443,NaN,NaN,NaN,NaN,NaN,507.4998000000012,510.32068848311343,504.67891151688895,507.6965403527991,506.8451931496083,508.0038219833703,505.6865643158463,8319,8268,51.31304372409137,54.73204985591393,NaN,NaN,NaN,NaN,0.5309627912555939,13.446332529836624,12032255,0.03689204971894908,0.23909357635375272,0.20220152663480365
2025-08-29T13:05:00-04:00,507.97,508.37,507.97,508.06,506.86734439786443,NaN,NaN,NaN,NaN,NaN,507.4668000000012,510.2213168422539,504.71228315774846,507.6965403527991,506.85688988988227,508.01670081232714,505.6970789674374,4706,8131.666666666667,52.993813627425965,54.99368831270417,NaN,NaN,NaN,NaN,0.5266083061659106,13.436930713151678,12036961,0.01722103027648686,0.22372781448041223,0.20650678420392538
2025-08-29T13:10:00-04:00,508.05,508.07,507.5,507.51,506.86734439786443,NaN,NaN,NaN,NaN,NaN,507.42240000000123,510.1000596038215,504.744740396181,507.6965403527991,506.8653998580315,508.02234471562946,505.7084550004335,5327,8069.266666666666,46.98875850026678,54.447951259882394,NaN,NaN,NaN,NaN,0.5297077128683451,12.69719810050249,12031634,-0.032993536515210614,0.1652648635599121,0.19825840007512271
2025-08-29T13:15:00-04:00,507.55,507.89,507.34,507.76,506.86734439786443,NaN,NaN,NaN,NaN,NaN,507.3802000000012,509.9672051863628,504.7931948136396,507.6965403527991,506.8770013300334,508.0294694282752,505.7245332317916,7725,8127.766666666666,49.77472658379897,54.16894191747578,NaN,NaN,NaN,NaN,0.5311571619491784,12.359024118516096,12039359,-0.04859054649390682,0.1375202169577392,0.186110763451646
2025-08-29T13:20:00-04:00,507.79,508.22,507.79,508.06,506.86734439786443,NaN,NaN,NaN,NaN,NaN,507.3352000000012,509.7917764458373,504.8786235541651,507.6965403527991,506.88904836442833,508.0413891765344,505.7367075523223,5643,8083.266666666666,52.96890507195049,53.92860430277541,NaN,NaN,NaN,NaN,0.5260745075242397,11.683464432145875,12045002,-0.03837069060467249,0.1381474001958054,0.1765180908004779
2025-08-29T13:25:00-04:00,508.12,508.32,508.04,508.095,506.86734439786443,NaN,NaN,NaN,NaN,NaN,507.29350000000113,509.6229988719943,504.96400112800796,507.6965403527991,506.9027549057354,508.05626802097544,505.7492417904953,5893,8067.466666666666,53.34172321500335,53.97389366819373,NaN,NaN,NaN,NaN,0.508497756986792,11.276673923940242,12050895,-0.029329291424625065,0.13985647651969657,0.16918576794432164
2025-08-29T13:30:00-04:00,508.08,508.21,507.65,507.88,506.86734439786443,NaN,NaN,NaN,NaN,NaN,507.23370000000114,509.33524020530837,505.1321597946939,507.6965403527991,506.92103071543954,508.07197143292916,505.7700899979499,9998,8025.9,50.68383613298756,53.66057379973598,NaN,NaN,NaN,NaN,0.5121764886305927,10.93531313500268,12040897,-0.03738805973116083,0.12245069328037061,0.15983875301153144
2025-08-29T13:35:00-04:00,507.84,508.31,507.65,508.19,506.86734439786443,NaN,NaN,NaN,NaN,NaN,507.2061000000011,509.2185415904229,505.19365840957926,507.6965403527991,506.9384088464306,508.0888832964148,505.7879343964464,8643,8025.7,54.22545209081308,53.99798472403607,NaN,NaN,NaN,NaN,0.5227353108712665,10.378675604680158,12049540,-0.022152939326648247,0.13214757885322115,0.1543005181798694
2025-08-29T13:40:00-04:00,508.22,508.25,507.81,507.87,506.86734439786443,NaN,NaN,NaN,NaN,NaN,507.1989000000012,509.1991762695197,505.19862373048267,507.6965403527991,506.94428879562236,508.0941435320305,505.7944340592142,3198,7803.433333333333,50.216493841994264,53.7017814312765,NaN,NaN,NaN,NaN,0.516825645809033,9.8617978979521,12046342,-0.03327094811748138,0.11271183303301768,0.14598278115049906
2025-08-29T13:45:00-04:00,507.94,508.22,507.93,508.14,506.86734439786443,NaN,NaN,NaN,NaN,NaN,507.2177000000011,509.2352591279363,505.20014087206596,507.36423228223924,506.95231782062376,508.10216212393016,505.80247351731737,3962,7622.133333333333,53.35032398072897,53.310922936036526,NaN,NaN,NaN,NaN,0.5049095282512466,9.381840027418905,12050304,-0.02259551047731495,0.11773839305385536,0.1403339035311703
2025-08-29T13:50:00-04:00,508.2,508.94,508.19,508.81,506.9327548984918,NaN,NaN,NaN,NaN,NaN,507.26950000000113,509.3147415491762,505.2242584508261,507.5953712526931,506.9776443707657,508.13723463075075,505.8180541107806,8629,7554.566666666667,60.067837176860785,53.518712151442124,NaN,NaN,NaN,NaN,0.5259874190904441,10.113720118067498,12058933,0.026758578361183227,0.17378212648264935,0.14702354812146612
2025-08-29T13:55:00-04:00,508.86,508.92,508.5,508.65,507.09467513037856,NaN,NaN,NaN,NaN,NaN,507.32070000000107,509.37342794954225,505.2679720504599,507.6342970021545,506.9953517236886,508.16186463685426,505.82883881052294,6032,7369.066666666667,57.92277864544272,53.702942060173314,NaN,NaN,NaN,NaN,0.5184168891554135,10.793323059384049,12052901,0.04473882436868823,0.2029470785823264,0.15820825421363818
2025-08-29T14:00:00-04:00,508.65,508.68,508.4,508.4,507.09467513037856,NaN,NaN,NaN,NaN,NaN,507.3769000000011,509.39050958345496,505.3632904165473,507.6342970021545,507.00820910447,508.17789609714765,505.8385221117923,5050,7307.966666666666,54.639494037182935,53.539900018239095,NaN,NaN,NaN,NaN,0.5013871113586004,11.13095400788772,12047851,0.03626644072134766,0.20354130511532276,0.1672748643939751
2025-08-29T14:05:00-04:00,508.42,508.88,508.3,508.81,507.09467513037856,NaN,NaN,NaN,NaN,NaN,507.4561000000012,509.3752188484159,505.5369811515865,507.65515008137885,507.0207802831218,508.19484366879857,505.846716897445,4503,7163.966666666666,58.76738790839717,53.375326752638884,NaN,NaN,NaN,NaN,0.5070023176901277,11.860042218320913,12052354,0.053695197195008065,0.23439386088773517,0.1806986636927271
2025-08-29T14:10:00-04:00,508.79,508.88,508.64,508.86,507.21207328910924,NaN,NaN,NaN,NaN,NaN,507.53150000000113,509.3672769457142,505.69572305428807,507.78012006510306,507.03933895695866,508.221093796758,505.8575841171593,6273,6922.733333333334,59.25435837680121,53.94256351354672,NaN,NaN,NaN,NaN,0.4879307235694049,12.537052699437451,12058627,0.06334790110387012,0.25988354007256476,0.19653563896869464
2025-08-29T14:15:00-04:00,508.85,508.9,508.71,508.74,507.3015245032406,NaN,NaN,NaN,NaN,NaN,507.61000000000115,509.3046728281094,505.9153271718929,507.92509605208244,507.06082364564713,508.2509277235114,505.8707195677829,7473,7060,57.49918747875845,54.264375931499046,NaN,NaN,NaN,NaN,0.4666499576001616,13.210227151326581,12051154,0.056627329693426376,0.2673198010854776,0.21069247139205122
2025-08-29T14:20:00-04:00,508.73,509,508.5,508.78,507.3015245032406,NaN,NaN,NaN,NaN,NaN,507.6742000000011,509.2965481237231,506.05185187627916,507.97007684166596,507.09073552481414,508.291296027027,505.8901750226013,10870,7107.7,57.946350853671454,55.047061099599375,NaN,NaN,NaN,NaN,0.4690321034858643,13.118945504838415,12062024,0.05007837104641291,0.27329043520006735,0.22321206415365444
2025-08-29T14:25:00-04:00,508.81,508.83,508.59,508.7,507.3015245032406,NaN,NaN,NaN,NaN,NaN,507.72860000000117,509.30172814303285,506.1554718569695,507.97007684166596,507.1072687306815,508.3126905410437,505.90184692031926,6383,6984.866666666667,56.66231258592828,55.539031528322894,NaN,NaN,NaN,NaN,0.45267266752258895,13.034183975956545,12055641,0.03620802479312221,0.2684720951450572,0.232264070351935
2025-08-29T14:30:00-04:00,508.71,509.01,508.64,508.72,507.3735474666145,NaN,NaN,NaN,NaN,NaN,507.7930000000012,509.2556824653206,506.3303175346818,508.06984917866623,507.1391549289867,508.35494566739686,505.9233641905766,12050,7089.9,56.91932792136006,55.821204588995,NaN,NaN,NaN,NaN,0.4467674769852615,13.430844898569061,12067691,0.024775122066531957,0.26323297293509995,0.238457850868568
2025-08-29T14:35:00-04:00,508.725,508.79,508.5,508.59,507.3735474666145,NaN,NaN,NaN,NaN,NaN,507.84240000000113,509.241178379375,506.44362162062725,508.06984917866623,507.16023425356343,508.380116175924,505.94035233120286,9141,7227.533333333334,54.65058062445035,55.9146944039555,NaN,NaN,NaN,NaN,0.43556980005774426,13.294932466084669,12058550,0.00584017628687189,0.24575807122715787,0.23991789494028598
2025-08-29T14:40:00-04:00,508.59,508.77,508.4,508.6,507.3735474666145,NaN,NaN,NaN,NaN,NaN,507.88780000000116,509.23363232034484,506.5419676796575,508.06984917866623,507.1749169337684,508.3970491945281,505.95278467300864,6693,7104.133333333333,54.79982836888859,56.20869384937701,NaN,NaN,NaN,NaN,0.43088624291076283,12.819913374494357,12065243,-0.007883141602049504,0.2300639679377241,0.2379471095397736
2025-08-29T14:45:00-04:00,508.57,508.57,508.04,508.05,507.3735474666145,NaN,NaN,NaN,NaN,NaN,507.91140000000115,509.22603613009477,506.59676386990753,508.06984917866623,507.1866606336992,508.40688957954285,505.96643168785556,7407,7265.5,45.86020176337107,55.61117596884544,NaN,NaN,NaN,NaN,0.4401086541314228,12.535042479166222,12057836,-0.05334043755818724,0.17127156259203957,0.2246120001502268
2025-08-29T14:50:00-04:00,508.04,508.22,507.66,508.12,507.3735474666145,NaN,NaN,NaN,NaN,NaN,507.94920000000116,509.17388993401784,506.7245100659845,508.06984917866623,507.19162623422113,508.4097733308691,505.9734791375732,4049,7350.666666666667,47.04426051458009,55.38458787403014,NaN,NaN,NaN,NaN,0.44867232169346416,13.192662816676584,12061885,-0.07661650439514162,0.12884136965629978,0.2054578740514414
2025-08-29T14:55:00-04:00,508.12,508.41,508.1,508.41,507.3735474666145,NaN,NaN,NaN,NaN,NaN,507.9994000000012,509.08145108686915,506.9173489131332,508.06984917866623,507.20718988055677,508.4238584074064,505.99052135370715,9388,7186.7,51.75208052872326,55.2704276274583,NaN,NaN,NaN,NaN,0.4387671558582169,13.187232103555349,12071273,-0.07055512610514358,0.11726396642001191,0.1878190925251555
2025-08-29T15:00:00-04:00,508.45,508.63,508.44,508.5,507.3735474666145,NaN,NaN,NaN,NaN,NaN,508.0382000000012,509.04771029443947,507.02868970556295,508.06984917866623,507.21403621698636,508.43122397414277,505.99684845982995,3517,6992.3,53.14427115885857,54.775887197601,NaN,NaN,NaN,NaN,0.42314093043977075,12.526330549405094,12074790,-0.05902607639559018,0.11403649703066776,0.17306257342625794
2025-08-29T15:05:00-04:00,508.5,508.75,508.46,508.72,507.3735474666145,NaN,NaN,NaN,NaN,NaN,508.07580000000127,509.0431621008918,507.10843789911075,508.06984917866623,507.2247493991137,508.44361722398025,506.00588157424716,5106,6948.2,56.45216482954304,54.67084335360817,NaN,NaN,NaN,NaN,0.4136308639797886,11.688425392480442,12079896,-0.036243539339154,0.12775814925231543,0.16400168859146944
2025-08-29T15:10:00-04:00,508.7,508.79,508.53,508.74,507.3735474666145,NaN,NaN,NaN,NaN,NaN,508.11580000000123,509.02240544573186,507.2091945542706,508.06984917866623,507.23256405651426,508.4528347755846,506.0122933374439,3661,6905.1,56.75108557213997,54.82167132039081,NaN,NaN,NaN,NaN,0.40265723083837857,11.024278462032907,12083557,-0.020282759074894213,0.13864823974785168,0.1589309988227459
2025-08-29T15:15:00-04:00,508.73,508.93,508.7,508.93,507.51567306277417,NaN,NaN,NaN,NaN,NaN,508.1492000000012,509.0502623920785,507.2481376079239,508.1439320975832,507.26538598320826,508.49462371544143,506.0361482509751,14156,6963.966666666666,59.588988229731775,54.880357057629,NaN,NaN,NaN,NaN,0.3903245714927814,10.80588014768952,12097713,0.0014608170757762218,0.16075702016746618,0.15929620309168996
2025-08-29T15:20:00-04:00,508.95,509,508.74,508.85,507.59427883264806,NaN,NaN,NaN,NaN,NaN,508.17960000000124,509.0705654056981,507.28863459430437,508.2411456780666,507.2834844561112,508.51738245278915,506.0495864594332,8008,7021.633333333333,57.867215063412694,54.781275392386966,NaN,NaN,NaN,NaN,0.3810156735290106,10.799268353994993,12089705,0.008455004736920957,0.16986495901284115,0.1614099542759202
2025-08-29T15:25:00-04:00,508.88,508.92,508.58,508.71,507.59427883264806,NaN,NaN,NaN,NaN,NaN,508.2022000000012,509.0884960196138,507.3159039803886,508.2411456780666,507.30437205630335,508.5415209757827,506.067223136824,10311,7070.466666666666,54.87882385060394,54.594106561804495,NaN,NaN,NaN,NaN,0.37808598256265497,10.251945388172325,12079394,0.0019895840663290143,0.16389693435883146,0.16190735029250244
2025-08-29T15:30:00-04:00,508.69,509,508.68,508.73,507.59427883264806,NaN,NaN,NaN,NaN,NaN,508.21960000000115,509.11247588981104,507.32672411019126,508.2411456780666,507.32934361427726,508.5710552054414,506.08763202311314,12153,7198.266666666666,55.23448391914717,54.40040178076705,NaN,NaN,NaN,NaN,0.3739369838081791,9.98960802161332,12091547,-0.0023668387692911963,0.15894880183088844,0.16131564060017964
2025-08-29T15:35:00-04:00,508.71,508.74,508.17,508.425,507.59427883264806,NaN,NaN,NaN,NaN,NaN,508.2257000000012,509.1199371242369,507.3314628757655,508.2411456780666,507.3433023823189,508.5834374022757,506.10316736236206,9243,7349.5,48.90378451914352,53.84622120456813,NaN,NaN,NaN,NaN,0.38794148496473724,10.299269947552107,12082304,-0.025908357972707907,0.12893019313429477,0.15483855110700268
2025-08-29T15:40:00-04:00,508.48,508.82,508.45,508.69,507.59427883264806,NaN,NaN,NaN,NaN,NaN,508.2469000000012,509.1338721271488,507.3599278728536,508.2411456780666,507.3619525066374,508.6029700830745,506.1209349302003,10669,7527.566666666667,53.8527861339669,53.62718250546862,NaN,NaN,NaN,NaN,0.3884456646101118,10.324922663414846,12092973,-0.02380551980064438,0.1250816513561972,0.14888717115684158
2025-08-29T15:45:00-04:00,508.68,508.92,508.19,508.25,507.59427883264806,NaN,NaN,NaN,NaN,NaN,508.2521000000012,509.1360300618806,507.36816993812175,508.2411456780666,507.3768737877921,508.6158775432467,506.13787003233745,10388,7616.333333333333,45.902906830364216,53.0023486630339,NaN,NaN,NaN,NaN,0.412842402852248,10.992763205787416,12082585,-0.05067672488757874,0.08554126504736814,0.13621798993494688
2025-08-29T15:50:00-04:00,508.29,508.38,506.35,506.63,NaN,NaN,NaN,508.89150675362515,508.89150675362515,508.89150675362515,508.2281000000011,509.2156583803247,507.2405416196775,508.2411456780666,507.365289596341,508.5772063796867,506.15337281299526,35883,8624.333333333334,28.954830615210057,51.15627739491401,NaN,NaN,NaN,NaN,0.5283536597913712,14.1073014262122,12046702,-0.16948900679353626,-0.07564326855697345,0.09384573823656281
2025-08-29T15:55:00-04:00,506.645,506.87,505.28,506.79,NaN,NaN,NaN,507.74893826482395,NaN,NaN,508.2095000000011,509.26717906032087,507.1518209396814,508.2411456780666,507.1798812635771,508.3505819999648,506.0091805271894,170247,14102.8,31.639406567593994,50.140506309501355,NaN,NaN,NaN,NaN,0.604185541234847,17.693402194313297,12216949,-0.2257180969834361,-0.18830188299273232,0.03741621399070377
2025-09-02T09:30:00-04:00,500.635,501.85,496.82,501.73,NaN,NaN,NaN,502.29239561642294,NaN,NaN,508.0954000000011,510.18760824840416,506.0031917515981,508.2411456780666,500.1333333333334,500.1333333333334,500.1333333333334,102370,17181.866666666665,13.834856236290477,47.76840600390924,NaN,NaN,NaN,NaN,1.273172288289503,22.669202744710816,12114579,-0.5723873811488439,-0.6780680124453511,-0.1056806312965072
2025-09-02T09:35:00-04:00,501.69,502.83,501.38,502.3,499.0843041843236,499.0843041843236,499.0843041843236,NaN,NaN,NaN,507.99560000000116,510.6361557283555,505.3550442716468,508.2411456780666,500.7250580304753,501.64972437533356,499.800391685617,41922,18291.166666666668,19.34120163849606,45.45334322603587,NaN,NaN,NaN,NaN,1.2858028391259662,26.292031095071533,12156501,-0.722327941499521,-1.0085905581709085,-0.28626261667138747
2025-09-02T09:40:00-04:00,502.32,502.93,500.72,501.16,499.0843041843236,NaN,NaN,NaN,NaN,NaN,507.86280000000113,511.12423597737774,504.6013640226245,508.2183332339626,500.88803429513234,501.78965835838653,499.98641023187815,32876,19280.433333333334,17.00115298214449,42.871691927699146,NaN,NaN,NaN,NaN,1.3518169220455385,29.753579106185867,12123625,-0.8485844907309279,-1.3469932300850473,-0.49840873935411945
2025-09-02T09:45:00-04:00,500.97,503.44,500.97,503.2,499.0843041843236,NaN,NaN,NaN,NaN,NaN,507.7724000000012,511.2855155623143,504.2592844376881,508.2183332339626,501.100280095928,502.10682689256,500.093733299296,26179,20021,32.694101816832784,41.17468742679127,NaN,NaN,NaN,NaN,1.4316871418994264,32.45690443932137,12149804,-0.7485035170429677,-1.4340381356578291,-0.6855346186148614
2025-09-02T09:50:00-04:00,503.09,504.35,502.99,503.29,500.2612252114032,NaN,NaN,NaN,NaN,NaN,507.67860000000115,511.40830403039195,503.94889596961036,507.89423326973605,501.3189081625495,502.50583400913337,500.1319823159657,19986,20399.566666666666,33.29333896376011,39.49913409762128,NaN,NaN,NaN,NaN,1.426566631763754,34.09413523062991,12169790,-0.6345434324147204,-1.478713909133262,-0.8441704767185415
2025-09-02T09:55:00-04:00,503.29,504.09,503.19,503.46,500.26344224724846,NaN,NaN,NaN,NaN,NaN,507.5940000000012,511.5062602155585,503.6817397844439,507.89423326973605,501.52754232798856,502.8340699490886,500.2210147068885,22702,20955.233333333334,34.47995680486322,37.705631852987814,NaN,NaN,NaN,NaN,1.3889547294949127,35.61442096541639,12192492,-0.5113064999356571,-1.483303601638113,-0.9719971017024558
2025-09-02T10:00:00-04:00,503.61,504.36,503.09,503.49,500.32874032691905,NaN,NaN,NaN,NaN,NaN,507.50560000000115,511.58162239373576,503.42957760626655,507.81438661578886,501.6817577493452,503.0550052906569,500.3085102080335,19310,21430.566666666666,34.700710075322036,36.050881496695624,NaN,NaN,NaN,NaN,1.3804579631024219,36.754434638663,12211802,-0.3964844045805538,-1.467602607428148,-1.0711182028475943
2025-09-02T10:05:00-04:00,503.49,503.53,502.43,502.98,500.32874032691905,NaN,NaN,NaN,NaN,NaN,507.41620000000114,511.6847156945126,503.1476843054897,506.4805092926311,501.7927120858062,503.1551998148528,500.43022435675965,24797,22107.033333333333,32.68461963075883,34.46558119527812,NaN,NaN,NaN,NaN,1.3604252514522466,38.02242256563903,12187005,-0.3265136003881528,-1.4792602033327853,-1.1527466029446325
2025-09-02T10:10:00-04:00,502.985,503.87,502.85,503.67,500.32874032691905,NaN,NaN,NaN,NaN,NaN,507.33160000000106,511.72427501128266,502.93892498871946,504.55540743410484,501.9127537182293,503.29446215497484,500.5310452814837,22462,22646.666666666668,37.9382472255983,33.230135717167485,NaN,NaN,NaN,NaN,1.3361091620627992,38.84122317606306,12209467,-0.21099731463634663,-1.4164932462400657,-1.205495931603719
2025-09-02T10:15:00-04:00,503.61,504.55,503.49,504.25,500.65214680386896,NaN,NaN,NaN,NaN,NaN,507.24920000000105,511.71483247868736,502.78356752131475,500.93301678956794,502.02307834906674,503.45186917791204,500.5942875202214,16632,22951.966666666667,42.033543437305184,32.73940421132189,NaN,NaN,NaN,NaN,1.3163870790583136,38.90311353697749,12226099,-0.07952859544592639,-1.304906675911127,-1.2253780804652006
2025-09-02T10:20:00-04:00,504.31,505.02,503.74,503.78,500.9906855855113,NaN,NaN,NaN,NaN,NaN,507.160000000001,511.72008113907077,502.5999188609312,501.48641343165434,502.1106273755579,503.57341683791117,500.6478379132046,13929,23053.933333333334,39.74480481205842,31.731691259756992,NaN,NaN,NaN,NaN,1.313788001982718,38.49727744047207,12212170,-0.01178029278043291,-1.2401034464407417,-1.2283231536603088
2025-09-02T10:25:00-04:00,503.81,505.34,503.57,505.34,500.9906855855113,NaN,NaN,NaN,NaN,NaN,507.104800000001,511.68480609551295,502.524793904489,501.62813074532346,502.17993338421974,503.68382411539307,500.6760426530464,9254,23149.633333333335,49.56166038418054,31.9930307993153,NaN,NaN,NaN,NaN,1.3463745732696655,37.80715870929575,12221424,0.14205451652237278,-1.050755008007343,-1.1928095245297157
2025-09-02T10:30:00-04:00,505.29,505.4,504.56,505.27,501.54686434547625,NaN,NaN,NaN,NaN,NaN,507.045200000001,511.6415733350227,502.44882666497926,502.0105045962588,502.24433256018705,503.7915255864685,500.6971395339056,8013,23015.066666666666,49.174513205774225,33.43729384149845,NaN,NaN,NaN,NaN,1.3102049608932589,37.10556399176158,12213411,0.23743584250838223,-0.8960147213942378,-1.13345056390262
2025-09-02T10:35:00-04:00,505.19,505.39,504.55,504.64,501.57837051159095,NaN,NaN,NaN,NaN,NaN,506.9646000000009,511.5854509341124,502.3437490658895,502.25840367700704,502.30590460400066,503.8853721210631,500.72643708693823,8689,23000,45.71350991818501,34.44258693796924,NaN,NaN,NaN,NaN,1.2766188922580244,36.46017290584795,12204722,0.2549005548140084,-0.8148248703851095,-1.069725425199118
2025-09-02T10:40:00-04:00,504.59,504.6,503.5,503.635,501.57837051159095,NaN,NaN,NaN,NaN,NaN,506.87930000000085,511.5846225219447,502.173977478057,502.25840367700704,502.3574465337396,503.93692411111806,500.7779689563612,12241,23184.933333333334,40.782397622901954,36.3674113227272,NaN,NaN,NaN,NaN,1.2668603999538788,36.467470457989165,12192481,0.19810052022507518,-0.8220997749177741,-1.0202002951428493
2025-09-02T10:45:00-04:00,503.67,503.68,503.1,503.21,501.57837051159095,NaN,NaN,NaN,NaN,NaN,506.78230000000093,511.5852158680059,501.97938413199597,502.25840367700704,502.3823067026773,503.94900356904907,500.8156098363055,10004,23271.5,38.87275039782609,37.76252194839363,NaN,NaN,NaN,NaN,1.217798942814315,36.68358366297365,12182477,0.13429306655767126,-0.8523339619457602,-0.9866270285034314
2025-09-02T10:50:00-04:00,503.23,503.34,502.7,502.7,501.57837051159095,NaN,NaN,NaN,NaN,NaN,506.68610000000086,511.61781705954013,501.7543829404616,502.25840367700704,502.4018339785762,503.94269973000297,500.8609682271494,14941,23634.566666666666,36.65467794119361,39.16634515975428,NaN,NaN,NaN,NaN,1.1765275897561485,37.08909409234601,12167536,0.06370780803839327,-0.9069922684554399,-0.9707000764938332
2025-09-02T10:55:00-04:00,502.69,503.22,502.66,502.88,501.57837051159095,NaN,NaN,NaN,NaN,NaN,506.58850000000086,511.62341618554234,501.5535838144594,502.25840367700704,502.4185172794632,503.9371317080218,500.89990285090454,13517,23772.2,37.99934191901704,39.54529088133887,NaN,NaN,NaN,NaN,1.1324899047735666,37.486546347401855,12181053,0.03646353368687216,-0.925120659385243,-0.9615841930721152
2025-09-02T11:00:00-04:00,502.92,503.25,502.18,502.29,501.57837051159095,NaN,NaN,NaN,NaN,NaN,506.4731000000008,511.6308180570287,501.31538194297286,502.25840367700704,502.42532499191594,503.91051437525493,500.94013560857695,19310,24298.633333333335,35.350483362007225,39.692229766927944,NaN,NaN,NaN,NaN,1.1280263401468829,38.10786403945133,12161743,-0.011409970470763975,-0.9758466561605701,-0.9644366856898061
2025-09-02T11:05:00-04:00,502.26,502.29,501.38,501.6,NaN,NaN,NaN,504.9983015655937,504.9983015655937,504.9983015655937,506.3432000000008,511.65581546091954,501.0305845390821,502.25840367700704,502.4039433728655,503.86992191509535,500.9379648306357,14506,24611.966666666667,32.497408391811334,39.55061916599567,NaN,NaN,NaN,NaN,1.112453030136393,39.06739514311025,12147237,-0.07605962877218975,-1.0595112216550433,-0.9834515928828536
2025-09-02T11:10:00-04:00,501.62,501.67,501.27,501.61,NaN,NaN,NaN,504.5440605853394,NaN,NaN,506.21780000000086,511.67346647033423,500.7621335296675,502.25840367700704,502.38464892551036,503.84036414649376,500.92893370452697,10084,24826.066666666666,32.58233174767925,39.3993064283069,NaN,NaN,NaN,NaN,1.061563527983796,40.008661793463965,12157321,-0.10298949361461274,-1.1121884599011196,-1.0091989662865068
2025-09-02T11:15:00-04:00,501.63,502,500.775,500.95,NaN,NaN,NaN,504.4888760132785,NaN,NaN,506.0730000000009,511.6934305880841,500.4525694119177,502.25840367700704,502.3532682417011,503.8009592821101,500.90557720129203,13091,24790.566666666666,29.907958106008977,39.20097346225334,NaN,NaN,NaN,NaN,1.073237561699241,41.107001304100585,12144230,-0.14738871552546984,-1.193434860693344,-1.0460461451678742
2025-09-02T11:20:00-04:00,500.96,501.15,500.52,501.09,NaN,NaN,NaN,503.8813134672204,NaN,NaN,505.9374000000009,511.70314166569534,500.1716583343064,502.25840367700704,502.3253189539474,503.7724602447225,500.87817766317227,9483,24839.733333333334,31.198017361042687,38.71952847192794,NaN,NaN,NaN,NaN,1.0415777358635805,42.23905331209773,12153713,-0.14901985167983045,-1.2323209597676623,-1.0833011080878319
2025-09-02T11:25:00-04:00,501.06,501.16,500.75,501.05,NaN,NaN,NaN,503.8813134672204,NaN,NaN,505.79560000000083,511.68509629049436,499.9061037095073,501.52472294160566,502.29732418602003,503.7420088645755,500.8526395074646,10387,24842.266666666666,31.022333427266744,37.933013471210906,NaN,NaN,NaN,NaN,0.996465040444755,43.27360427039366,12143326,-0.13490680648659947,-1.2519346161960812,-1.1170278097094817
2025-09-02T11:30:00-04:00,501.01,501.14,500.75,500.92,NaN,NaN,NaN,503.82721950215745,NaN,NaN,505.6378000000009,511.6178796512643,499.6577203487375,500.9297783532845,502.2641846794112,503.7065003150345,500.8218690437879,12399,24850.466666666667,30.422720288360637,37.26715029094678,NaN,NaN,NaN,NaN,0.9531461089844144,44.234258731668454,12130927,-0.11710155243264508,-1.263404750250288,-1.146303197817643
2025-09-02T11:35:00-04:00,500.92,501,500.43,500.48,NaN,NaN,NaN,503.54393679751394,NaN,NaN,505.4744000000009,511.5618394087484,499.3869605912534,500.92385814610213,502.2383976054233,503.68360264697037,500.79319256387623,8196,24815.566666666666,28.420454590780764,35.757064162846795,NaN,NaN,NaN,NaN,0.9257785297712414,45.2876835951802,12122731,-0.11743205189236638,-1.2930932626831009,-1.1756612107907345
2025-09-02T11:40:00-04:00,500.48,501.14,500.45,500.83,NaN,NaN,NaN,503.54393679751394,NaN,NaN,505.323000000001,511.48791167778825,499.15808832221376,500.92385814610213,502.21133237363136,503.65603036764685,500.7666343796159,9967,24792.166666666668,32.24071134315396,34.54750688694535,NaN,NaN,NaN,NaN,0.9089372062161526,45.993235509019,12132698,-0.07842875916239889,-1.2736971597437332,-1.1952684005813343
2025-09-02T11:45:00-04:00,500.8,500.955,500.56,500.75,NaN,NaN,NaN,503.4787833217017,NaN,NaN,505.16180000000094,511.37488675581375,498.9487132441881,500.8780865168817,502.1953619537304,503.64009977323644,500.7506241342244,5846,24640.766666666666,31.822643754839007,33.55530216099206,NaN,NaN,NaN,NaN,0.8722274057721403,46.64839085758361,12126852,-0.0440792649998738,-1.2503674818311765,-1.2062882168313027
2025-09-02T11:50:00-04:00,500.69,500.69,500.29,500.66,NaN,NaN,NaN,503.15031589798804,NaN,NaN,504.99780000000095,511.24456113158817,498.75103886841373,499.9374692135054,502.1594305191112,503.6084738838105,500.7103871544119,11877,23840.566666666666,31.330439262109266,32.8801622780783,NaN,NaN,NaN,NaN,0.8427825910741288,47.41995110688685,12114975,-0.014985049941146578,-1.225019529257736,-1.2100344793165894
2025-09-02T11:55:00-04:00,500.65,501.09,500.43,500.67,NaN,NaN,NaN,503.15031589798804,NaN,NaN,504.83640000000094,511.1050432467583,498.56775675324354,499.7218802966434,502.13671279283324,503.5852683995292,500.6881571861373,8801,18459.033333333333,31.45729576218973,32.35048694696142,NaN,NaN,NaN,NaN,0.8297266917116888,47.2907564787322,12123776,0.015706011499445838,-1.1904019649422821,-1.206107976441728
2025-09-02T12:00:00-04:00,500.71,501.11,500.66,500.72,NaN,NaN,NaN,503.15031589798804,NaN,NaN,504.6752000000009,510.94443981318693,498.4059601868149,499.7218802966434,502.12618918904406,503.5736197307201,500.678758647368,4496,15196.566666666668,32.13239199778121,32.027466522431965,NaN,NaN,NaN,NaN,0.8026033565894244,47.12884904686351,12128272,0.048305978536336,-1.1457255032713078,-1.1940314818076438
2025-09-02T12:05:00-04:00,500.68,501.25,500.66,500.93,NaN,NaN,NaN,503.15031589798804,NaN,NaN,504.5198000000009,510.76743730024987,498.2721626997519,499.81520577832276,502.10912299655945,503.55293084026835,500.66531515285055,8196,14072.366666666667,35.026882511303256,31.815147993309548,NaN,NaN,NaN,NaN,0.787417402547321,46.672900834972396,12136468,0.09049419359283961,-1.0809137398165944,-1.171407933409434
2025-09-02T12:10:00-04:00,500.94,501.2,500.87,501,NaN,NaN,NaN,503.15031589798804,NaN,NaN,504.3654000000009,510.5716387446462,498.15916125535557,499.88716462265825,502.1009013668312,503.54230899428944,500.6594937393729,4322,13120.566666666668,36.00661631067048,31.862014632499783,NaN,NaN,NaN,NaN,0.754744730936797,46.249520352502074,12140790,0.12733983330006748,-1.0122331417843498,-1.1395729750844172
2025-09-02T12:15:00-04:00,500.99,501.45,500.99,501.45,NaN,NaN,NaN,503.15031589798804,NaN,NaN,504.2226000000008,510.3616566829006,498.083543317101,500.1697316981266,502.092993693039,503.5294909598298,500.65649642624817,5668,12436.866666666667,42.05563278382499,32.54474494621505,NaN,NaN,NaN,NaN,0.7336915358698813,45.27751052737314,12146458,0.1828658199756641,-0.9109907001148372,-1.0938565200905013
2025-09-02T12:20:00-04:00,501.43,501.67,501.34,501.37,NaN,NaN,NaN,503.15031589798804,NaN,NaN,504.0780000000008,510.13790395928135,498.0180960407203,500.4807853585013,502.0829245103178,503.51014970629797,500.65569931433765,9318,12081.266666666666,41.308071553570116,33.16801207520725,NaN,NaN,NaN,NaN,0.7048564261648927,43.88467897603207,12137140,0.2129493722416813,-0.8276698047883997,-1.040619177030081
2025-09-02T12:25:00-04:00,501.35,501.4,500.9,501,NaN,NaN,NaN,503.15031589798804,NaN,NaN,503.93700000000086,509.9485468887633,497.9254531112384,500.4807853585013,502.0754145455018,503.49975079481106,500.65107829619257,4510,11474.866666666667,37.94828866339528,33.74232140073484,NaN,NaN,NaN,NaN,0.6902238242959718,43.122950613271776,12132630,0.20651659279943735,-0.7824734360307843,-0.9889900288302217
2025-09-02T12:30:00-04:00,500.98,501.2,500.91,501.08,NaN,NaN,NaN,503.15031589798804,NaN,NaN,503.7962000000009,509.7386400910249,497.85375990897694,500.4807853585013,502.0622787436132,503.4819705288706,500.6425869583558,7762,11089.933333333332,39.10162231280003,34.30686461157465,NaN,NaN,NaN,NaN,0.6616364082748284,42.415631419280075,12140392,0.20578055663834693,-0.731764333032288,-0.937544889670635
2025-09-02T12:35:00-04:00,501.03,501.25,500.81,500.83,NaN,NaN,NaN,503.15031589798804,NaN,NaN,503.6446000000009,509.4945196025026,497.7946803974992,500.4807853585013,502.05131601411983,503.4681243256582,500.63450770258146,6026,10464.233333333334,36.799752275946595,34.719537386480354,NaN,NaN,NaN,NaN,0.6458052362551977,41.88166216019359,12134366,0.1871248684598542,-0.7036388040958172,-0.8907636725556715
2025-09-02T12:40:00-04:00,500.85,501.53,500.83,501.24,NaN,NaN,NaN,503.15031589798804,NaN,NaN,503.4994000000009,509.2189981113801,497.7798018886217,500.4807853585013,502.041473018782,503.45300384981306,500.629942187751,7066,9951.033333333333,42.751923972215955,35.60019479247002,NaN,NaN,NaN,NaN,0.6496762908083971,40.6913557975016,12141432,0.19990861425260964,-0.6408779047399094,-0.840786518992519
2025-09-02T12:45:00-04:00,501.25,501.45,500.84,500.99,NaN,NaN,NaN,503.15031589798804,NaN,NaN,503.3448000000008,508.90731668185714,497.7822833181445,500.4807853585013,502.0328181398101,503.44078229591986,500.62485398370035,5630,9584.3,40.261963483121406,36.44601685620864,NaN,NaN,NaN,NaN,0.6468422700363696,39.58607131785904,12135802,0.1891525528080047,-0.6043458279825131,-0.7934983807905178
2025-09-02T12:50:00-04:00,500.98,501.51,500.98,501.32,NaN,NaN,NaN,503.15031589798804,NaN,NaN,503.1964000000009,508.56788323609607,497.8249167639057,500.4807853585013,502.0272184811194,503.4315158835562,500.6229210786826,4561,9272.033333333333,44.82969715764033,37.34523012867195,NaN,NaN,NaN,NaN,0.6384963936051984,38.402396588883775,12140363,0.200789174828089,-0.5425119122554065,-0.7433010870834955
2025-09-02T12:55:00-04:00,501.35,501.78,501.28,501.53,NaN,NaN,NaN,503.15031589798804,NaN,NaN,503.0484000000008,508.1823491384433,497.9144508615583,500.49104201361513,502.0210741853442,503.4177485212029,500.62439984948554,7774,9222.7,47.576730745211286,38.47052205655569,NaN,NaN,NaN,NaN,0.62860379406197,36.61303645331534,12148137,0.2177353272675424,-0.47113192799906756,-0.68886725526661
2025-09-02T13:00:00-04:00,501.59,501.77,501.35,501.36,NaN,NaN,NaN,503.15031589798804,NaN,NaN,502.8986000000009,507.777436352627,498.0197636473748,500.52883361089215,502.01137945167505,503.3969792060103,500.6257796973398,11773,9348.033333333333,45.59742349734476,39.4895923590725,NaN,NaN,NaN,NaN,0.6137035230575406,34.9514877560018,12136364,0.21237407009322895,-0.42339966765007375,-0.6357737377433027
2025-09-02T13:05:00-04:00,501.37,501.5,501.1,501.1,NaN,NaN,NaN,503.15031589798804,NaN,NaN,502.74640000000085,507.3580582869891,498.1347417130126,500.52883361089215,502.00641194993426,503.3889709065314,500.6238529933371,4118,9195.666666666666,42.673374056673296,40.29074080867848,NaN,NaN,NaN,NaN,0.5984389856962861,33.89009759602692,12132246,0.18708437349127638,-0.4019182708792073,-0.5890026443704837
2025-09-02T13:10:00-04:00,501.09,501.12,500.3,500.5,NaN,NaN,NaN,502.77507864215335,NaN,NaN,502.5818000000009,506.90597009793396,498.25762990206783,500.52883361089215,501.9780673464369,503.36000261353985,500.5961320793339,13663,9243.066666666668,36.80737673564667,40.62466828995458,NaN,NaN,NaN,NaN,0.6142647724322651,34.11119232994312,12118583,0.1285052359907033,-0.4283710993821046,-0.5568763353728079
2025-09-02T13:15:00-04:00,500.47,500.9,500.47,500.76,NaN,NaN,NaN,502.7148477947827,NaN,NaN,502.42850000000084,506.4457778091609,498.41122219084076,500.52883361089215,501.959644849214,503.3398701432728,500.5794195551552,9710,9233.266666666666,40.61676724173984,41.023945770700045,NaN,NaN,NaN,NaN,0.601103002972814,34.31649458286531,12128293,0.10672203850022177,-0.4234737872475307,-0.5301958257477525
2025-09-02T13:20:00-04:00,500.88,501.56,500.77,501.43,NaN,NaN,NaN,502.7148477947827,NaN,NaN,502.2833000000008,505.8884960329867,498.67810396701486,500.52883361089215,501.9490011003208,503.32148741433707,500.57651478630453,10226,9076.1,49.1273552162507,41.96114140681293,NaN,NaN,NaN,NaN,0.6153099313318996,32.86089911787075,12138519,0.1350657356115893,-0.36136365623326583,-0.49642939184485513
2025-09-02T13:25:00-04:00,501.47,502.21,501.47,501.88,NaN,NaN,NaN,502.7148477947827,NaN,NaN,502.15590000000077,505.33354169725567,498.97825830274587,500.66385459761716,501.9474910305891,503.3091544517818,500.5858276093964,10883,8988.3,53.905579018457516,42.8075661378581,NaN,NaN,NaN,NaN,0.6270735076653333,30.750452847802194,12149402,0.17899444752938426,-0.2726863324331248,-0.45168077996250905
2025-09-02T13:30:00-04:00,501.99,502.81,501.89,502.76,500.25681250681043,500.25681250681043,500.25681250681043,NaN,NaN,NaN,502.07850000000076,504.9941873968851,499.16281260311644,501.10808367809375,501.9580244194132,503.3083848351271,500.60766400369937,13738,8802.566666666668,61.51758808065387,44.2511030326498,NaN,NaN,NaN,NaN,0.6487111142606672,29.694296480041704,12163140,0.2574223600173075,-0.12990282994087465,-0.38732518995818216
2025-09-02T13:35:00-04:00,502.76,503.06,502.62,502.84,500.7819573928645,NaN,NaN,NaN,NaN,NaN,501.99950000000075,504.59696048985677,499.40203951014473,501.478466942475,501.97426168341707,503.317377515311,500.6311458515231,13189,8758.666666666666,62.12985375649185,45.9783576821567,NaN,NaN,NaN,NaN,0.6338031775277623,29.04643108937129,12176329,0.30172153360959364,-0.010173272946190082,-0.3118948065557837
2025-09-02T13:40:00-04:00,502.78,502.93,502.61,502.61,500.7819573928645,NaN,NaN,NaN,NaN,NaN,502.01710000000077,504.6189394178843,499.41526058211724,501.50477355398,501.98428339367,503.3210512300555,500.6475155572845,9803,8749.3,59.21298354124898,47.41488348418876,NaN,NaN,NaN,NaN,0.6113886648472073,28.4243099017497,12166526,0.3018360787744535,0.06540029191228314,-0.23643578686217034
2025-09-02T13:45:00-04:00,502.58,502.68,502.331,502.67,500.7819573928645,NaN,NaN,NaN,NaN,NaN,502.0245000000008,504.6316150715315,499.4173849284701,501.50477355398,501.99132350954227,503.32140440891243,500.6612426101721,8985,8612.433333333332,59.74393665859009,49.05375379723473,NaN,NaN,NaN,NaN,0.5926466173581204,27.272312233710373,12175511,0.2920697272210959,0.12865137216419953,-0.16341835505689636
2025-09-02T13:50:00-04:00,502.68,502.97,502.5,502.58,500.7957582095528,NaN,NaN,NaN,NaN,NaN,502.05290000000076,504.6526539030441,499.4531460969574,501.6832550745472,501.99730396922683,503.32317311548525,500.6714348229684,6409,8509.966666666667,58.51348059283881,50.17957927013636,NaN,NaN,NaN,NaN,0.5838861446896851,26.638535933905967,12169102,0.2663838537554671,0.1695614621374375,-0.09682239161802958
2025-09-02T13:55:00-04:00,502.54,502.76,502.15,502.27,500.7957582095528,NaN,NaN,NaN,NaN,NaN,502.0343000000008,504.61419147756214,499.4544085224395,501.6832550745472,502.00036359229006,503.32155624133225,500.67917094324787,5774,8356.2,54.36050280272737,51.18661779296536,NaN,NaN,NaN,NaN,0.5857514200689943,25.348565631401794,12163328,0.21741939957213074,0.17495185784713385,-0.04246754172499689
2025-09-02T14:00:00-04:00,502.25,503.025,502.18,502.77,500.7957582095528,NaN,NaN,NaN,NaN,NaN,502.0239000000008,504.58760145610586,499.4601985438958,501.6832550745472,502.0107347564991,503.32403303084664,500.6974364821516,11969,8341.866666666667,59.3694799597317,52.22517370740046,NaN,NaN,NaN,NaN,0.6042691757783497,24.56439563607894,12175297,0.20762794447546842,0.21706738886933863,0.009439444393870212
2025-09-02T14:05:00-04:00,502.75,502.83,502.18,502.3,500.7957582095528,NaN,NaN,NaN,NaN,NaN,502.00070000000085,504.53279795149035,499.46860204851134,501.6832550745472,502.0158466221855,503.32206396241475,500.70962928195627,9224,8376.133333333333,53.43298413982064,52.64347752130113,NaN,NaN,NaN,NaN,0.6075356632227518,23.836237783279152,12166073,0.160526290567537,0.21009730760329148,0.04957101703575447
2025-09-02T14:10:00-04:00,502.31,502.89,502.31,502.66,500.7957582095528,NaN,NaN,NaN,NaN,NaN,501.9841000000008,504.48764763408263,499.480552365919,501.6832550745472,502.01992693538733,503.322665941345,500.71718792942966,5226,8218.1,56.98123401396286,53.4566068439167,NaN,NaN,NaN,NaN,0.6062831158496963,23.26016766863539,12171299,0.14511126247435152,0.23096009512869387,0.08584883265434234
2025-09-02T14:15:00-04:00,502.69,502.77,501.8,501.81,500.7957582095528,NaN,NaN,NaN,NaN,NaN,501.9607000000009,504.44839773803204,499.4730022619697,501.6832550745472,502.0210250057664,503.31709056666506,500.7249594448677,8043,8291.333333333334,47.73305679263418,53.8180127536282,NaN,NaN,NaN,NaN,0.6322628932890016,21.64803998720685,12163256,0.07281476767515752,0.17686729224828923,0.10405252457313172
2025-09-02T14:20:00-04:00,501.88,501.9,501.6,501.8,500.7957582095528,NaN,NaN,NaN,NaN,NaN,501.9233000000009,504.36284389913396,499.4837561008678,501.6832550745472,502.0186151930819,503.30876194872735,500.7284684374365,7478,8144.7,47.635103922050504,54.59142183837133,NaN,NaN,NaN,NaN,0.6085298294826412,20.427473896439412,12155778,0.022096851265782758,0.13167358865536016,0.1095767373895774
2025-09-02T14:25:00-04:00,501.77,501.86,501.4,501.44,500.7957582095528,NaN,NaN,NaN,NaN,NaN,501.86710000000085,504.21749238339464,499.51670761660705,501.6832550745472,502.0162666880085,503.30346723303177,500.72906614298523,4123,7988.766666666666,44.1246267778868,54.8419832338104,NaN,NaN,NaN,NaN,0.5979205559481695,19.656559956776317,12151655,-0.03482385879972574,0.06604691388992023,0.10087077268964598
2025-09-02T14:30:00-04:00,501.42,501.84,501.42,501.73,500.7957582095528,NaN,NaN,NaN,NaN,NaN,501.8261000000009,504.1122297328916,499.5399702671102,501.6832550745472,502.01359590685996,503.2962815409611,500.7309102727588,6050,8040.566666666667,47.48220178523267,54.72447227445197,NaN,NaN,NaN,NaN,0.5852119448090116,18.94071129851773,12157705,-0.051087629982350724,0.03701123521170757,0.0880988651940583
2025-09-02T14:35:00-04:00,501.63,501.93,501.5,501.84,500.7957582095528,NaN,NaN,NaN,NaN,NaN,501.75610000000086,503.8101217028381,499.7020782971636,501.6832550745472,502.0116168542906,503.2895502856332,500.733683422948,6206,7974.233333333334,48.74043055454068,54.35553309845791,NaN,NaN,NaN,NaN,0.5741253773226541,18.06455648047691,12163911,-0.052386586213460706,0.022615632427232413,0.07500221864069312
2025-09-02T14:40:00-04:00,501.84,501.98,501.65,501.9,500.7957582095528,NaN,NaN,NaN,NaN,NaN,501.6887000000009,503.4816560049502,499.8957439950516,501.53498324771016,502.0107650346778,503.28551597530645,500.7360140940491,4099,7966.8,49.451811043722635,53.49369188153425,NaN,NaN,NaN,NaN,0.5566878503710389,17.129854899131924,12168010,-0.04730927648174835,0.015865623038507692,0.06317489952025604
2025-09-02T14:45:00-04:00,501.86,502.76,501.84,502.61,500.7957582095528,NaN,NaN,NaN,NaN,NaN,501.64810000000085,503.25408491771867,500.04211508228303,501.53498324771016,502.0166691682256,503.2826997429965,500.75063859345465,12365,8190.033333333334,57.04809525466418,53.130709131403705,NaN,NaN,NaN,NaN,0.58263871820168,17.131183223926744,12180375,0.0030877011529523157,0.06703452596144643,0.06394682480849412
2025-09-02T14:50:00-04:00,502.62,503.4,502.62,503.04,501.121147467029,NaN,NaN,NaN,NaN,NaN,501.6362000000009,503.1911245113362,500.08127548866554,501.86580124866055,502.02834128967703,503.2915759546356,500.76510662471844,9677,8202,60.88220678424849,53.24993936304653,NaN,NaN,NaN,NaN,0.5974502383301289,18.06157877450826,12190052,0.061372292432238046,0.14066219034879168,0.07928989791655364
2025-09-02T14:55:00-04:00,503.04,503.135,502.68,502.74,501.121147467029,NaN,NaN,NaN,NaN,NaN,501.62680000000086,503.14889035081416,500.10470964918755,501.86580124866055,502.03889674322824,503.29742067586074,500.78037281059574,10803,8411.766666666666,57.05556502060128,53.057912817475895,NaN,NaN,NaN,NaN,0.5872752213065472,18.92551750004824,12179249,0.07481853809418844,0.17281307053428918,0.09799453244010074
2025-09-02T15:00:00-04:00,502.86,503.39,502.86,503.36,501.25609717553675,NaN,NaN,NaN,NaN,NaN,501.6400000000009,503.20978979351156,500.07021020649023,501.90111279914277,502.04874718814,503.30646614206665,500.79102823421334,7189,8392.666666666666,62.32576379541901,53.33021876051735,NaN,NaN,NaN,NaN,0.5917555626417921,20.065209779624755,12186438,0.1179978270995975,0.2454918163145976,0.1274939892150001
2025-09-02T15:05:00-04:00,503.31,503.5,503.14,503.44,501.48695639483054,NaN,NaN,NaN,NaN,NaN,501.6512000000008,503.2636299166894,500.0387700833122,502.1288902393142,502.05709670485743,503.31513603954284,500.799057370172,5446,8373.333333333334,62.957453670866734,53.94428667967016,NaN,NaN,NaN,NaN,0.5752015938816649,21.26520799397574,12191884,0.1428192025898148,0.3060179924522686,0.16319878986245379
2025-09-02T15:10:00-04:00,503.43,503.55,503.19,503.49,501.571185649611,NaN,NaN,NaN,NaN,NaN,501.6752000000009,503.3590871208712,499.99131287913065,502.2731121914514,502.070464354954,503.32940500953794,500.8115237003701,8535,8422.3,63.3708353029485,54.23009777561422,NaN,NaN,NaN,NaN,0.559830051461547,22.44576001282291,12200419,0.1525929722554411,0.35394000518175517,0.20134703292631406
2025-09-02T15:15:00-04:00,503.48,503.89,503.38,503.79,501.84840448371955,NaN,NaN,NaN,NaN,NaN,501.7190000000009,503.50369605140105,499.93430394860076,502.6134897531611,502.087937762789,503.3511604219181,500.8247151036599,9441,8549.333333333334,65.83446008894668,55.11591748626608,NaN,NaN,NaN,NaN,0.5562707620714359,23.973685622083078,12209860,0.16802946265880242,0.4113838612498171,0.24335439859101465
2025-09-02T15:20:00-04:00,503.79,503.96,503.57,503.66,502.0064315526414,NaN,NaN,NaN,NaN,NaN,501.7600000000009,503.6251713047308,499.894828695271,502.74379180252885,502.098438112414,503.3643999500073,500.8324762748207,5620,8584.633333333333,63.83097636671827,55.60518479717718,NaN,NaN,NaN,NaN,0.5443942790663324,25.47706804667873,12204240,0.15838146180503387,0.441331225847307,0.2829497640422731
2025-09-02T15:25:00-04:00,503.65,503.89,503.53,503.85,502.0064315526414,NaN,NaN,NaN,NaN,NaN,501.8180000000009,503.7576824471869,499.8783175528149,502.74379180252885,502.11072557352816,503.37998051936387,500.84147062769244,6561,8544.2,65.48425017124049,56.87312718136335,NaN,NaN,NaN,NaN,0.5312232591330239,26.740367171304936,12210801,0.15357742097884158,0.4749215402658251,0.32134411928698353
2025-09-02T15:30:00-04:00,503.84,503.941,503.56,503.56,502.04935395602246,NaN,NaN,NaN,NaN,NaN,501.86740000000094,503.85560847892174,499.87919152108014,502.82812675361845,502.12210405136517,503.39378995805225,500.8504181446781,6438,8366.366666666667,60.90798372587748,57.821190024493845,NaN,NaN,NaN,NaN,0.5204930263378059,27.98360645894945,12204363,0.12107880357290823,0.4726926237531188,0.3516138201802106
2025-09-02T15:35:00-04:00,503.555,504.06,503.5,504.05,502.0798151398396,NaN,NaN,NaN,NaN,NaN,501.92740000000094,503.99288322572806,499.8619167742738,502.8897014028948,502.13812440165,503.41488122275985,500.8613675805401,8250,8504.1,65.31819054974237,59.335016008197826,NaN,NaN,NaN,NaN,0.5233149530279628,29.30412032178421,12212613,0.122427208018412,0.5046478302032256,0.38222062218481356
2025-09-02T15:40:00-04:00,504.05,504.22,503.88,503.95,502.38073263348326,NaN,NaN,NaN,NaN,NaN,501.9880000000009,504.1087583539434,499.8672416460584,503.11376112231585,502.15777657692337,503.4421386786333,500.87341447521345,9516,8365.866666666667,63.73782793006668,60.49613216140025,NaN,NaN,NaN,NaN,0.5102210278116821,30.747673853667333,12203097,0.10698812642150746,0.5159557802116979,0.4089676537901904
2025-09-02T15:45:00-04:00,503.91,504.38,503.74,504.34,502.38073263348326,NaN,NaN,NaN,NaN,NaN,502.0652000000009,504.2410685244587,499.88933147554314,503.17500889785265,502.19232166770746,503.4918497915019,500.892793543913,16024,8576.333333333334,67.08281597003,61.80630254822091,NaN,NaN,NaN,NaN,0.519490954396561,32.29615489854968,12219121,0.11286312365912898,0.5500465583641017,0.4371834347049727
2025-09-02T15:50:00-04:00,504.32,506.79,504.13,505.24,503.4930022548887,NaN,NaN,NaN,NaN,NaN,502.1534000000009,504.4745156274436,499.83228437255815,504.49600711828214,502.3477235484335,503.78955349164903,500.905893605218,47335,9813.3,73.22166451625542,63.50414922483039,NaN,NaN,NaN,NaN,0.6723844576539513,35.37673521165136,12266456,0.1640791661830156,0.6422823924337422,0.4782032262507266
2025-09-02T15:55:00-04:00,505.18,506,504.85,504.93,503.4930022548887,NaN,NaN,NaN,NaN,NaN,502.23700000000093,504.6492230402144,499.82477695978747,504.49600711828214,502.7034136332004,504.3569925857143,501.0498346806865,135369,13962.833333333334,68.48407218032344,64.32100471952035,NaN,NaN,NaN,NaN,0.7064998535358102,38.23727407381721,12131087,0.16343592508184246,0.6824981326030297,0.5190622075211873
2025-09-03T09:30:00-04:00,503.87,505.34,503.04,505.04,NaN,NaN,NaN,506.44557025949194,506.44557025949194,506.44557025949194,502.3246000000009,504.8181347111924,499.8310652888094,504.49600711828214,504.47333333333336,504.47333333333336,504.47333333333336,54965,15337.066666666668,69.24449753934594,64.91831120202731,NaN,NaN,NaN,NaN,0.8203212925689635,37.18070809405013,12186052,0.15675292471764846,0.7150033634182478,0.5582504387005993
2025-09-03T09:35:00-04:00,505.11,506.1,504.3,505.27,NaN,NaN,NaN,506.44557025949194,NaN,NaN,502.4166000000009,504.9970793655131,499.83612063448874,504.49600711828214,504.76497081290245,505.1305876754215,504.3993539503834,34972,16063.166666666666,70.82936244851452,65.90215387544967,NaN,NaN,NaN,NaN,0.8902983430997526,36.84570170672517,12221024,0.15393550221402652,0.7506698164681325,0.596734314254106
2025-09-03T09:40:00-04:00,505.39,506.45,505.2,506.45,503.36506924703315,503.36506924703315,503.36506924703315,NaN,NaN,NaN,502.5312000000009,505.3020356565723,499.76036434342956,504.49600711828214,505.04828342141326,505.6670675294033,504.4294993134232,25867,16598.633333333335,77.29405481253309,66.97131751952925,NaN,NaN,NaN,NaN,0.9159913185926275,36.80155207820581,12246891,0.21396457344720898,0.8641900310631172,0.6502254576159082
2025-09-03T09:45:00-04:00,506.41,507.78,505.07,505.93,503.70733882671345,NaN,NaN,NaN,NaN,NaN,502.6312000000009,505.52197329376145,499.7404267062403,504.49600711828214,505.29165692492074,506.0276314711248,504.5556823787167,29105,17269.3,69.938364542397,67.46995401035285,NaN,NaN,NaN,NaN,1.0441347958360099,37.601858838670076,12217786,0.2012600892748384,0.9018005692094562,0.7005404799346178
2025-09-03T09:50:00-04:00,505.93,506.81,505.37,505.53,503.70733882671345,NaN,NaN,NaN,NaN,NaN,502.72180000000094,505.6854320682135,499.75816793178836,504.49600711828214,505.37845403619315,506.0928453791736,504.6640626932127,23963,17854.433333333334,64.82767913873747,67.57401428433778,NaN,NaN,NaN,NaN,1.0724108818477232,38.34500083052976,12193823,0.15083301891480594,0.8890817535781252,0.7382487346633193
2025-09-03T09:55:00-04:00,505.6,505.71,504.32,504.57,503.70733882671345,NaN,NaN,NaN,NaN,NaN,502.78420000000085,505.76939839140243,499.79900160859927,504.49600711828214,505.3232108684705,506.01638284166756,504.6300388952734,20434,18343.1,54.52888817261722,66.76647343317138,NaN,NaN,NaN,NaN,1.095095818858599,37.50590355865555,12173389,0.04332396199698374,0.792403687159549,0.7490797251625653
2025-09-03T10:00:00-04:00,504.63,505.8,504.34,505.22,503.70733882671345,NaN,NaN,NaN,NaN,NaN,502.8612000000009,505.89473691845603,499.8276630815458,504.49600711828214,505.30046770155553,505.95683353010025,504.6441018730108,23857,18739.366666666665,59.24937558784879,66.43921623468071,NaN,NaN,NaN,NaN,1.1211604032258446,36.795823199484275,12197246,0.008320518854004422,0.7594803737300708,0.7511598548760664
2025-09-03T10:05:00-04:00,505.31,506.22,505.25,505.62,503.70733882671345,NaN,NaN,NaN,NaN,NaN,502.9536000000009,506.03579859123954,499.87140140876227,504.49600711828214,505.32254008685555,505.9668017174628,504.67827845624834,12576,18851.1,61.8725114680945,66.18123489874172,NaN,NaN,NaN,NaN,1.112506088709713,36.45778944263099,12209822,0.004623747987976268,0.7569395398610368,0.7523157918730605
2025-09-03T10:10:00-04:00,505.66,506.13,504.7,505.05,503.70733882671345,NaN,NaN,NaN,NaN,NaN,503.0330000000008,506.1225779640769,499.9434220359247,503.77298441251867,505.3201306448379,505.9372981465897,504.7029631430861,20297,19353.466666666667,56.309992121244626,65.85280692698223,NaN,NaN,NaN,NaN,1.135184225230448,35.38424913123942,12189525,-0.04117048872854079,0.7008526809623845,0.7420231696909253
2025-09-03T10:15:00-04:00,505,506.21,504.87,506.15,503.70733882671345,NaN,NaN,NaN,NaN,NaN,503.1394000000008,506.2841108859204,499.9946891140812,503.77298441251867,505.3345024376518,505.94592397206134,504.72308090324225,8649,19373.666666666668,63.188040658013456,65.7006533632873,NaN,NaN,NaN,NaN,1.1498139234282714,34.45730467268421,12198174,-0.00428065746937234,0.7366723478542099,0.7409530053235822
2025-09-03T10:20:00-04:00,506.27,506.77,506.055,506.09,503.70733882671345,NaN,NaN,NaN,NaN,NaN,503.2364000000008,506.43943545970694,500.03336454029466,503.77298441251867,505.3830325648132,506.015397691163,504.75066743846344,13406,19571.266666666666,62.60906067408164,65.62002713071693,NaN,NaN,NaN,NaN,1.118755786040536,34.07236971798572,12184768,0.008481386283955672,0.7515547381785268,0.7430733518945711
2025-09-03T10:25:00-04:00,506.14,506.37,504.7,504.75,503.70733882671345,NaN,NaN,NaN,NaN,NaN,503.31160000000085,506.4764680471341,500.1467319528676,503.77298441251867,505.37839834093086,505.9976555184242,504.7591411634375,11825,19828,51.30303536330418,64.49289994452225,NaN,NaN,NaN,NaN,1.1581303727519274,32.029612642233765,12172943,-0.07625434764186567,0.6477554173422391,0.7240097649841047
2025-09-03T10:30:00-04:00,504.8,505.78,504.69,505.53,503.70733882671345,NaN,NaN,NaN,NaN,NaN,503.3958000000008,506.56824660097305,500.22335339902855,503.77298441251867,505.37679595225956,505.98500119164834,504.7685907128708,10320,19970.333333333332,56.25498094053723,63.28099397482809,NaN,NaN,NaN,NaN,1.1532639175553594,30.121836746192177,12183263,-0.08219056620315657,0.621271557230159,0.7034621234333156
2025-09-03T10:35:00-04:00,505.6,506.29,505.6,506.03,503.70733882671345,NaN,NaN,NaN,NaN,NaN,503.48580000000084,506.69650731084806,500.2750926891536,503.60707864466826,505.4029569074193,506.0100917876101,504.7958220272285,13312,20207.2,59.12442604217029,62.612447822102865,NaN,NaN,NaN,NaN,1.12517363772998,28.849434601776014,12196575,-0.05610720569128813,0.6333281163192055,0.6894353220104936
2025-09-03T10:40:00-04:00,506.02,506.45,505.88,506.08,503.70733882671345,NaN,NaN,NaN,NaN,NaN,503.5802000000008,506.8128249142234,500.34757508577815,503.7891474128561,505.4254589145207,506.0364510985136,504.8144667305277,9604,20390.7,59.4111478741806,61.91006570316249,NaN,NaN,NaN,NaN,1.0855183778921238,27.82030031989931,12206179,-0.03991199524432232,0.6395453279550907,0.679457323199413
2025-09-03T10:45:00-04:00,506.15,506.49,505.97,506.23,503.70733882671345,NaN,NaN,NaN,NaN,NaN,503.68280000000084,506.919675134411,500.44592486559065,504.1013179302849,505.45310350144155,506.07113359184547,504.8350734110376,11143,20349.966666666667,60.310598619051596,61.15872542962942,NaN,NaN,NaN,NaN,1.045124208042685,26.904443013097623,12217322,-0.0242907314933275,0.6490939088327536,0.6733846403260811
2025-09-03T10:50:00-04:00,506.23,506.8,506.23,506.7,503.70733882671345,NaN,NaN,NaN,NaN,NaN,503.80680000000086,507.0214102463542,500.5921897536475,504.6040543442279,505.4879444910903,506.12673160232293,504.8491573798576,10378,20373.333333333332,63.071929885025895,60.142859363378896,NaN,NaN,NaN,NaN,1.0111867646110642,26.366763130871256,12227700,0.010628917041295982,0.6866707866277011,0.6760418695864051
2025-09-03T10:55:00-04:00,506.73,507.02,506.51,506.69,503.95068700670873,NaN,NaN,NaN,NaN,NaN,503.9254000000008,507.11911936087716,500.7316806391245,505.0082434753823,505.54221596534006,506.2170249963744,504.86740693430573,15164,20518.7,62.9715434283967,59.645229283807446,NaN,NaN,NaN,NaN,0.9753877099959876,26.085619993828125,12212536,0.02515716952385183,0.7074883314912199,0.6823311619673681
2025-09-03T11:00:00-04:00,506.69,506.93,506.01,506.33,503.95068700670873,NaN,NaN,NaN,NaN,NaN,504.02340000000083,507.20551152474997,500.8412884752517,505.0082434753823,505.5817020523322,506.2659485619286,504.8974555427358,16413,20826.166666666668,59.31166781264843,59.25122847480109,NaN,NaN,NaN,NaN,0.9714314449962753,25.082605406129083,12196123,0.003749374391760041,0.6870178799570681,0.683268505565308
2025-09-03T11:05:00-04:00,506.35,506.5,505.9,506.5,503.95068700670873,NaN,NaN,NaN,NaN,NaN,504.1158000000009,507.31186530531545,500.9197346946863,505.0082434753823,505.60953554637535,506.29456780386124,504.92450328888947,14764,21136.766666666666,60.479748364030414,59.67628991704488,NaN,NaN,NaN,NaN,0.944900627496543,23.99353301852408,12210887,-0.005245390952085871,0.6767117668752007,0.6819571578272866
2025-09-03T11:10:00-04:00,506.535,506.88,506.31,506.36,503.95068700670873,NaN,NaN,NaN,NaN,NaN,504.18780000000083,507.42043926783515,500.9551607321665,505.03058065939575,505.63573366977187,506.3276841011482,504.94378323839555,11331,21229.966666666667,58.97813630625906,59.65691568264561,NaN,NaN,NaN,NaN,0.9181220112467895,23.422133564949,12199556,-0.025759909718944596,0.6497572706786059,0.6755171803975505
2025-09-03T11:15:00-04:00,506.3,506.33,505.71,505.93,503.95068700670873,NaN,NaN,NaN,NaN,NaN,504.2496000000008,507.4949313168578,501.0042686831438,505.03058065939575,505.6459547542374,506.33042388488184,504.9614856235929,11656,21303.8,54.502171332549146,59.13046281582094,NaN,NaN,NaN,NaN,0.8989704390148784,22.029423619357782,12187900,-0.07086779224646456,0.5869324400894698,0.6578002323359343
2025-09-03T11:20:00-04:00,505.86,506.07,505.56,505.83,503.95068700670873,NaN,NaN,NaN,NaN,NaN,504.3140000000008,507.55442219408644,501.0735778059152,505.03058065939575,505.65033045380693,506.3266897002564,504.97397120735747,10419,21463.766666666666,53.48557501666999,58.928718736922754,NaN,NaN,NaN,NaN,0.8711868362281007,20.53390184650845,12177481,-0.10780433789372301,0.5230448099687806,0.6308491478625036
2025-09-03T11:25:00-04:00,505.8,505.9,505.2,505.215,503.95068700670873,NaN,NaN,NaN,NaN,NaN,504.36490000000083,507.58028457355147,501.1495154264502,505.03058065939575,505.64413244522734,506.31148759035756,504.9767773000971,12481,21661.1,47.60467096627293,57.815620901798425,NaN,NaN,NaN,NaN,0.8589592050689498,19.464317060912247,12165000,-0.17030336210543562,0.4179699452307091,0.5882733073361447
2025-09-03T11:30:00-04:00,505.2,505.34,504.94,505.24,503.95068700670873,NaN,NaN,NaN,NaN,NaN,504.41810000000083,507.60145853399666,501.234741466005,505.03058065939575,505.63001275088993,506.292171511837,504.96785398994285,13199,21886.466666666667,47.855665423253,56.76180695531067,NaN,NaN,NaN,NaN,0.8261764047068804,18.799553597503113,12178199,-0.2043166898755484,0.3328774449917091,0.5371941348672575
2025-09-03T11:35:00-04:00,505.25,505.61,505.09,505.61,503.95068700670873,NaN,NaN,NaN,NaN,NaN,504.48490000000083,507.62503151885994,501.3447684811417,505.03058065939575,505.6269328680929,506.28424247500874,504.9696232611771,7124,21848.933333333334,51.55455136267463,56.779772383837134,NaN,NaN,NaN,NaN,0.8043066615135345,17.77597945897401,12185323,-0.196209927047307,0.2919317260581238,0.4881416531054308
2025-09-03T11:40:00-04:00,505.57,505.9,505.12,505.12,503.95068700670873,NaN,NaN,NaN,NaN,NaN,504.5319000000008,507.6381175641733,501.4256824358283,505.03058065939575,505.62218474227615,506.27402682109584,504.97034266345645,8768,21824,46.81806482110948,56.10570694673515,NaN,NaN,NaN,NaN,0.8025704714054228,16.607587167880506,12176555,-0.21656406610734463,0.21743657047124998,0.4340006365785946
2025-09-03T11:45:00-04:00,505.09,505.55,504.9,505.48,503.95068700670873,NaN,NaN,NaN,NaN,NaN,504.5955000000008,507.646042410106,501.5449575898956,505.03058065939575,505.6176668186769,506.2658481240847,504.96948551326915,6696,21513.066666666666,50.42194145352124,55.48410090468879,NaN,NaN,NaN,NaN,0.7916725805907522,15.638889694598982,12183251,-0.1989513419303245,0.18531145916568903,0.3842628010960135
2025-09-03T11:50:00-04:00,505.48,505.86,505.37,505.59,503.95068700670873,NaN,NaN,NaN,NaN,NaN,504.6541000000008,507.6659935498896,501.64220645011204,505.03058065939575,505.61753047168764,506.26168329438167,504.9733776489936,5807,20128.8,51.503356307629105,54.91925864993511,NaN,NaN,NaN,NaN,0.7701245391199849,14.765140349777456,12189058,-0.1739659771242027,0.16680532969076012,0.3407713068149628
2025-09-03T11:55:00-04:00,505.55,505.58,504.85,505.33,503.95068700670873,NaN,NaN,NaN,NaN,NaN,504.72450000000083,507.62985935743774,501.8191406425639,505.03058065939575,505.6101257132381,506.2497650779596,504.97048634851666,9723,15940.6,48.79418640719602,54.09665777765971,NaN,NaN,NaN,NaN,0.7679727863256968,14.217734396793,12179335,-0.16888539007398284,0.12966456922248426,0.2985499592964671
2025-09-03T12:00:00-04:00,505.35,505.45,504.89,504.99,503.95068700670873,NaN,NaN,NaN,NaN,NaN,504.78830000000085,507.57150937691455,502.00509062308714,504.5254645275166,505.5998747879222,506.23687886832,504.9628707075244,10007,14442,45.42889168547137,52.83644076340581,NaN,NaN,NaN,NaN,0.7531175873024328,13.709428869021718,12169328,-0.18126755400941297,0.07196551678470087,0.25323307079411383
2025-09-03T12:05:00-04:00,505.01,505.65,504.95,505.48,503.95068700670873,NaN,NaN,NaN,NaN,NaN,504.86910000000074,507.48855161366237,502.2496483863391,504.37137162201327,505.59750665357916,506.2318020817813,504.963211225377,4868,13438.533333333333,50.70550524747749,51.96029517905445,NaN,NaN,NaN,NaN,0.7493234739236868,12.905706309806739,12174196,-0.15056413206802147,0.06502790570908701,0.21559203777710848
2025-09-03T12:10:00-04:00,505.48,505.6,504.73,504.78,503.95068700670873,NaN,NaN,NaN,NaN,NaN,504.93010000000083,507.3915958776798,502.4686041223219,504.33038676248106,505.58924531185994,506.22246666268774,504.95602396103214,7372,12822.033333333333,44.13942968926459,50.87656388452704,NaN,NaN,NaN,NaN,0.7579432257862809,12.499800563152696,12166824,-0.17006487754873229,0.0030109408411931327,0.17307581838992542
2025-09-03T12:15:00-04:00,504.77,504.8,504.35,504.52,503.95068700670873,NaN,NaN,NaN,NaN,NaN,504.98370000000085,507.28522715296924,502.68217284703246,504.33038676248106,505.55318111228735,506.2034913328784,504.9028708916963,18112,12455.6,41.965701487744546,49.554131964792326,NaN,NaN,NaN,NaN,0.7359472810872602,12.674982141139054,12148712,-0.1915429769153945,-0.06635290275431771,0.1251900741610768
2025-09-03T12:20:00-04:00,504.5,505.17,504.38,504.4,503.95068700670873,NaN,NaN,NaN,NaN,NaN,505.0337000000008,507.1676042237506,502.89979577625104,504.33038676248106,505.54389187784443,506.1972351146771,504.8905486410118,5389,11836.466666666667,40.96301983188738,48.26733793090864,NaN,NaN,NaN,NaN,0.7398081895810288,12.17798965897634,12143323,-0.20376348780641362,-0.12951428559694023,0.0742492022094734
2025-09-03T12:25:00-04:00,504.37,504.785,504.12,504.47,503.95068700670873,NaN,NaN,NaN,NaN,NaN,505.07090000000085,507.09660648317634,503.04519351682535,504.33038676248106,505.5279466643599,506.1894923608224,504.8664009678974,7811,11415.7,41.83603950536305,47.36261422896677,NaN,NaN,NaN,NaN,0.7344647474680996,12.102472155997795,12151134,-0.19695112788460936,-0.1719397076462883,0.025011420238321057
2025-09-03T12:30:00-04:00,504.51,504.62,504.17,504.38,503.95068700670873,NaN,NaN,NaN,NaN,NaN,505.0977000000008,507.0493241533712,503.1460758466305,504.33038676248106,505.5074645321967,506.1802598540879,504.8346692103055,9747,10945.366666666667,40.996623703385175,46.470546278017856,NaN,NaN,NaN,NaN,0.7141458369346632,12.032348760374857,12141387,-0.18832838318060638,-0.21039905873743692,-0.022070675556830545
2025-09-03T12:35:00-04:00,504.37,504.47,504.22,504.29,503.95068700670873,NaN,NaN,NaN,NaN,NaN,505.12870000000083,506.97599078275647,503.2814092172452,504.33038676248106,505.4953295366693,506.17517022969787,504.81548884364076,5623,10713.6,40.129511824054056,45.936606339287934,NaN,NaN,NaN,NaN,0.6809925628679014,11.967234178724988,12135764,-0.17859370441371047,-0.24531280607396866,-0.06671910166025817
2025-09-03T12:40:00-04:00,504.27,504.32,503.84,503.88,NaN,NaN,NaN,506.2488274841659,506.2488274841659,506.2488274841659,505.13910000000084,506.95197803120203,503.32622196879964,504.0560380223903,505.44963741225354,506.1662693673622,504.7330054571449,17406,10617.233333333334,36.356917321030345,45.11526718912917,NaN,NaN,NaN,NaN,0.6666359512344812,12.508052572228262,12118358,-0.1886869961081372,-0.30257784679542965,-0.11389085068729246
2025-09-03T12:45:00-04:00,503.85,504.18,503.73,503.99,NaN,NaN,NaN,506.0866080530675,NaN,NaN,505.1501000000008,506.92794193787205,503.37225806212956,504.0560380223903,505.41948493472387,506.15902901831686,504.6799408511309,11717,10719.5,38.03990840025068,44.14993554895604,NaN,NaN,NaN,NaN,0.6511619547177316,13.175065454734305,12130075,-0.17706372751037394,-0.3352205100752599,-0.15815678256488594
2025-09-03T12:50:00-04:00,504,504.11,503.53,503.54,NaN,NaN,NaN,505.93380768701894,NaN,NaN,505.1511000000009,506.9252581540903,503.3769418459115,504.0560380223903,505.39125791325534,506.155974956449,504.6265408700617,9772,10598.366666666667,34.070599532669306,43.23940231406745,NaN,NaN,NaN,NaN,0.6460789579521824,14.091244753387416,12120303,-0.1877725782742017,-0.3928725054076381,-0.20509992713343636
2025-09-03T12:55:00-04:00,503.56,503.85,503.56,503.61,NaN,NaN,NaN,505.7649982466999,NaN,NaN,505.1475000000009,506.93338269373595,503.3616173062658,503.88983041791226,505.35252746880064,506.15042721715497,504.5546277204463,13517,10654.766666666666,35.20325757837608,42.1523534658428,NaN,NaN,NaN,NaN,0.6220733180984552,14.941982673565304,12133820,-0.1783042362826301,-0.42798022248672396,-0.24967598620409387
2025-09-03T13:00:00-04:00,503.6,504.21,503.56,504.06,NaN,NaN,NaN,505.7649982466999,NaN,NaN,505.1555000000008,506.9180892874099,503.39291071259174,503.50049146746386,505.3127531080506,506.1332057833424,504.4923004327587,17414,10891.233333333334,42.09083009721853,41.480030165099194,NaN,NaN,NaN,NaN,0.6240680810914211,14.832797489000917,12151234,-0.13202846322967787,-0.41471156524119124,-0.28268310201151337
2025-09-03T13:05:00-04:00,504.05,504.25,503.94,504.07,NaN,NaN,NaN,505.7649982466999,NaN,NaN,505.15990000000085,506.9104890311833,503.4093109688184,503.50049146746386,505.3028927690019,506.1273450102008,504.478440527803,5002,10614.233333333334,42.237766417551605,41.01171445155317,NaN,NaN,NaN,NaN,0.6016346467277484,14.635712847926378,12156236,-0.09288721046181447,-0.39879211508878143,-0.30590490462696696
2025-09-03T13:10:00-04:00,504.1,504.75,504.1,504.26,NaN,NaN,NaN,505.7649982466999,NaN,NaN,505.17390000000086,506.88380910756626,503.46399089243545,503.4553607957491,505.2883535552734,506.1144771046761,504.46223000587065,9847,10622.333333333334,45.08866711451939,40.98741269648516,NaN,NaN,NaN,NaN,0.607232171961481,13.826266959318065,12166083,-0.04857069770901329,-0.36661827676323355,-0.31804757905422026
2025-09-03T13:15:00-04:00,504.33,504.56,504.33,504.53,NaN,NaN,NaN,505.7649982466999,NaN,NaN,505.1835000000008,506.8733334226406,503.49366657736095,503.4553607957491,505.28211826840663,506.1081339050532,504.4561026317601,4871,10413.266666666666,48.94497294468959,40.86166038914316,NaN,NaN,NaN,NaN,0.5852870168213761,13.074638634181774,12170954,0.0018825384631303566,-0.3156944059753073,-0.31757694443843765
2025-09-03T13:20:00-04:00,504.49,504.6,504.09,504.19,NaN,NaN,NaN,505.7649982466999,NaN,NaN,505.1883000000008,506.8654065667483,503.51119343325337,503.4553607957491,505.27517268483786,506.10241421184907,504.44793115782664,4504,10217.466666666667,44.68890070081294,40.900908318539486,NaN,NaN,NaN,NaN,0.5799093727627097,12.428376956567382,12166450,0.014604246361621276,-0.2993216364864111,-0.31392588284803236
2025-09-03T13:25:00-04:00,504.09,504.09,503.5,504.08,NaN,NaN,NaN,505.73701904401196,NaN,NaN,505.1831000000009,506.8722641589863,503.49393584101546,503.4553607957491,505.2537067512167,506.09215578750394,504.4152577149295,10093,10048.433333333332,43.37477595200646,41.00155649455819,NaN,NaN,NaN,NaN,0.5877729889939446,12.912442769243485,12156357,0.017654447016099195,-0.2918578240779084,-0.3095122710940076
2025-09-03T13:30:00-04:00,504.04,504.39,503.92,503.93,NaN,NaN,NaN,505.73701904401196,NaN,NaN,505.1569000000008,506.88197726098304,503.43182273901857,503.4553607957491,505.24577193418554,506.0868987855743,504.4046450827968,4433,9649.1,41.57922961029209,41.04557147872996,NaN,NaN,NaN,NaN,0.5793606326372321,12.683314236131874,12151924,0.011889893131160623,-0.2946499046800568,-0.30653979781121743
2025-09-03T13:35:00-04:00,503.92,504.06,503.69,503.8,NaN,NaN,NaN,505.73701904401196,NaN,NaN,505.1343000000008,506.89980956843726,503.3687904315643,503.4553607957491,505.22471275279065,506.07663419548334,504.37279131009797,10045,9491.8,40.03251898549659,40.91674858445378,NaN,NaN,NaN,NaN,0.5644063017345731,12.868759566529638,12141879,0.002151863116050756,-0.303849968916154,-0.30600183203220477
2025-09-03T13:40:00-04:00,503.79,504,503.385,503.48,NaN,NaN,NaN,505.5719748653827,NaN,NaN,505.10310000000084,506.92830014136365,503.277899858638,503.4553607957491,505.2062339725506,506.0703432545185,504.3421246905827,7764,9372.9,36.43922258191499,40.5912199329202,NaN,NaN,NaN,NaN,0.5680201373249614,13.531292357800401,12134115,-0.021696441790359955,-0.3331223842701547,-0.31142594247979477
2025-09-03T13:45:00-04:00,503.49,503.62,502.95,503.5,NaN,NaN,NaN,505.1704078260471,NaN,NaN,505.06770000000085,506.946451935727,503.1889480642747,503.4553607957491,505.1738367321138,506.06404857557203,504.28362488865554,12008,9384.633333333333,36.820919039390304,40.354891876872784,NaN,NaN,NaN,NaN,0.5753044132303223,14.761999884139238,12146123,-0.03139116980900575,-0.35066490474105194,-0.3192737349320462
2025-09-03T13:50:00-04:00,503.45,503.77,503.29,503.36,NaN,NaN,NaN,505.1704078260471,NaN,NaN,505.00590000000085,506.90191443982746,503.10988556017423,503.4553607957491,505.164835652004,506.0612215875802,504.2684497164278,3648,9158.933333333332,35.2262236440267,40.2741280428011,NaN,NaN,NaN,NaN,0.5684969551424394,15.536069361335247,12142475,-0.04184577575719611,-0.37158095462854135,-0.32973517887134524
2025-09-03T13:55:00-04:00,503.4,503.43,502.95,503.32,NaN,NaN,NaN,505.0358364696008,NaN,NaN,504.9537000000008,506.88839254302263,503.019007456979,503.4553607957491,505.1488155824671,506.05850208468144,504.2391290802527,5764,8935.033333333333,34.76297233217984,40.04006118079604,NaN,NaN,NaN,NaN,0.5621757440608378,16.721964605776744,12136711,-0.0457514693819806,-0.386924515598821,-0.3411730462168404
2025-09-03T14:00:00-04:00,503.26,503.27,502.85,503.04,NaN,NaN,NaN,504.88602572098256,NaN,NaN,504.9039000000008,506.9037812855038,502.90401871449785,503.39643090927945,505.1363942863355,506.0575340909367,504.21525448173423,4144,8633.2,31.62753162880388,39.86555633051994,NaN,NaN,NaN,NaN,0.5555917623422044,17.954448286496763,12132567,-0.06055965118517659,-0.4168726101983111,-0.35631295901313453
2025-09-03T14:05:00-04:00,503.05,503.36,502.92,503.29,NaN,NaN,NaN,504.88602572098256,NaN,NaN,504.8783000000008,506.92680150994727,502.8297984900544,503.39643090927945,505.124591852548,506.0552831843833,504.1939005207127,4265,8537.9,37.08397469805346,39.99989326763974,NaN,NaN,NaN,NaN,0.5473352078891897,18.854087919207117,12136832,-0.047463642484470436,-0.4156425121187226,-0.36817886963425217
2025-09-03T14:10:00-04:00,503.35,503.55,503.2,503.38,NaN,NaN,NaN,504.88602572098256,NaN,NaN,504.8415000000008,506.929846953067,502.7531530469346,503.1087157819388,505.1137793687598,506.0516550103879,504.17590372713175,4378,8391.566666666668,38.97215552842773,39.7771307984404,NaN,NaN,NaN,NaN,0.5332398358971063,19.176938757835433,12141210,-0.027666989154861377,-0.4027626060778289,-0.3750956169229675
2025-09-03T14:15:00-04:00,503.32,503.36,503.04,503.2,NaN,NaN,NaN,504.88602572098256,NaN,NaN,504.7931000000008,506.9188703442483,502.66732965575324,503.1087157819388,505.0989071596742,506.0481258399821,504.14968847936626,5543,8353.133333333333,36.60596943522626,39.37485958541716,NaN,NaN,NaN,NaN,0.5194369904758827,19.73659238968743,12135667,-0.021875985430877376,-0.40244059871156423,-0.38056461328068686
2025-09-03T14:20:00-04:00,503.17,503.36,503.07,503.19,NaN,NaN,NaN,504.88602572098256,NaN,NaN,504.7559000000008,506.92700081669796,502.58479918330363,502.84997262555106,505.0907662073099,506.0460033727372,504.13552904188265,3082,8262.3,36.473479209058226,38.75948902074138,NaN,NaN,NaN,NaN,0.503048634013321,20.256270762121428,12132585,-0.01426816288471533,-0.398399816886581,-0.38413165400186566
2025-09-03T14:25:00-04:00,503.18,503.47,503.09,503.26,NaN,NaN,NaN,504.88602572098256,NaN,NaN,504.6981000000007,506.8715423288361,502.5246576711653,502.7244781004408,505.081492740661,506.04304878227697,504.11993669904507,3674,8060.666666666667,38.16072760182556,37.989185781965375,NaN,NaN,NaN,NaN,0.4942594458695161,20.407912234142398,12136259,-0.0007824749928633246,-0.3851097477429448,-0.3843272727500815
2025-09-03T14:30:00-04:00,503.21,503.21,502.9,502.95,NaN,NaN,NaN,504.6983773589621,NaN,NaN,504.6353000000007,506.8256318553329,502.4449681446685,502.4578356670269,505.0583417969395,506.0388499513631,504.0778336425159,8178,7999.7,33.870381062040764,37.21643437919594,NaN,NaN,NaN,NaN,0.48466948545026595,20.90100165672218,12128081,-0.008568525850730757,-0.39503793006349497,-0.3864694042127642
2025-09-03T14:35:00-04:00,502.9,503.15,502.62,502.65,NaN,NaN,NaN,504.52595111537295,NaN,NaN,504.59330000000074,506.85267124803465,502.3339287519668,502.4578356670269,505.0413107584708,506.0373944995151,504.0452270174265,5550,8022.433333333333,30.31799287989999,36.283807016902614,NaN,NaN,NaN,NaN,0.48790737934667355,21.83447135785548,12122531,-0.028621426761330615,-0.42224618766442745,-0.39362476090309684
2025-09-03T14:40:00-04:00,502.69,503.22,502.56,503.13,NaN,NaN,NaN,504.52595111537295,NaN,NaN,504.54530000000074,506.8249161160623,502.2656838839392,502.4578356670269,505.01870361508804,506.0324437501384,504.0049634800377,8097,8046.6,40.98343635034449,36.24125035547778,NaN,NaN,NaN,NaN,0.5001997093933415,22.470948039325997,12130628,-0.0054687336360509375,-0.40046067794816054,-0.3949919443121096
2025-09-03T14:45:00-04:00,503.12,503.18,502.87,502.9,NaN,NaN,NaN,504.52595111537295,NaN,NaN,504.48270000000076,506.76769208672266,502.19770791327886,502.4578356670269,505.0042494892945,506.02874042353216,503.9797585550569,5306,7619.733333333334,37.98342004702321,36.09488614558683,NaN,NaN,NaN,NaN,0.48661401586524583,23.061962100691478,12125322,-0.0017473905925619038,-0.39717618255281195,-0.39542879196025005
2025-09-03T14:50:00-04:00,502.96,503.01,502.7,502.87,NaN,NaN,NaN,504.4468302291012,NaN,NaN,504.4185000000008,506.7007482328308,502.1362517671708,502.4578356670269,504.9712096094767,506.0215253730844,503.92089384586905,11693,7829.866666666667,37.59683536856879,36.17757277320496,NaN,NaN,NaN,NaN,0.47399872901772844,23.92481433788731,12113629,0.0023671951360660914,-0.39246979804016746,-0.39483699317623355
2025-09-03T14:55:00-04:00,502.9,503.07,502.82,503.07,NaN,NaN,NaN,504.4468302291012,NaN,NaN,504.35530000000074,506.6082166954076,502.1023833045939,502.4578356670269,504.95585029788487,506.0164494725169,503.8952511232528,5919,7766.8,41.84618263288343,36.53652017274018,NaN,NaN,NaN,NaN,0.4579988198021764,24.498589987857414,12119548,0.021185231739951238,-0.3683554535012945,-0.38954068524124574
2025-09-03T15:00:00-04:00,503.03,503.07,502.78,502.81,NaN,NaN,NaN,504.4468302291012,NaN,NaN,504.2775000000007,506.4689946946558,502.0860053053456,502.4578356670269,504.931830788842,506.0092985229123,503.8543630547717,8982,7741.3,38.20407072799031,36.74922353588044,NaN,NaN,NaN,NaN,0.4459989041020224,25.112230239902818,12110566,0.01882822314056687,-0.36600540631553713,-0.384833629456104
2025-09-03T15:05:00-04:00,502.82,503.21,502.66,502.68,NaN,NaN,NaN,504.4468302291012,NaN,NaN,504.1973000000008,506.3222632553096,502.07233674469194,502.4578356670269,504.9075711363682,506.0017942577726,503.81334801496376,9123,7857.966666666666,36.493776105176146,36.872852376808744,NaN,NaN,NaN,NaN,0.4534275538090176,25.121147542757267,12101443,0.011576047689260627,-0.37036356984452823,-0.38193961753378886
2025-09-03T15:10:00-04:00,502.72,502.75,502.46,502.56,NaN,NaN,NaN,504.1033675328949,NaN,NaN,504.12190000000084,506.20596227262604,502.03783772737563,502.4578356670269,504.88153515513346,505.9966744581993,503.7663958520676,8895,7574.266666666666,34.938909236848616,37.10937934881194,NaN,NaN,NaN,NaN,0.441754157108375,25.57382789281481,12092548,0.002247639995107631,-0.3791300675399043,-0.38137770753501193
2025-09-03T15:15:00-04:00,502.53,502.93,502.32,502.8,NaN,NaN,NaN,504.1033675328949,NaN,NaN,504.0479000000008,506.05009288684187,502.0457071131598,502.2202685336215,504.84835629803325,505.98703938771206,503.70967320835445,12134,7588.166666666667,40.4075607346662,37.346778351427126,NaN,NaN,NaN,NaN,0.4537717173149206,25.293338186290747,12104682,0.015076136848292843,-0.3625325364746459,-0.37760867332293874
2025-09-03T15:20:00-04:00,502.78,503.18,502.74,503.05,NaN,NaN,NaN,504.1033675328949,NaN,NaN,503.98170000000084,505.89042901066273,502.07297098933896,502.21098770758215,504.81757522228554,505.97142857352617,503.6637218710449,13540,7713.766666666666,45.54244324305782,37.81608461675785,NaN,NaN,NaN,NaN,0.45278802322099754,24.160278668697295,12118222,0.04172347629088302,-0.32545432795933493,-0.36717780425021795
2025-09-03T15:25:00-04:00,503.05,503.53,503,503.22,NaN,NaN,NaN,504.1033675328949,NaN,NaN,503.9275000000008,505.7644107208034,502.0905892791982,502.41036456502565,504.78559734748364,505.9489215301627,503.6222731648046,17023,7830.633333333333,48.77478123114563,38.68528545932352,NaN,NaN,NaN,NaN,0.45830316441949576,22.788804372792782,12135245,0.07043479163908134,-0.2791343147013663,-0.34956910634044763
2025-09-03T15:30:00-04:00,503.22,503.62,503.22,503.49,NaN,NaN,NaN,504.1033675328949,NaN,NaN,503.8807000000008,505.6388899886985,502.12251001130306,502.52429165202057,504.7612178158994,505.92778207117686,503.5946535606219,15437,7764.733333333334,53.49594398994734,39.9011758008156,NaN,NaN,NaN,NaN,0.45413865267524445,21.753816495823482,12150682,0.10515590374940964,-0.21812422665368558,-0.3232801304030952
2025-09-03T15:35:00-04:00,503.52,503.83,503.39,503.77,NaN,NaN,NaN,504.1033675328949,NaN,NaN,503.8518000000008,505.56832061918436,502.1352793808173,502.7334333216164,504.7410149702951,505.9061768278674,503.5758531127228,15933,8129.1,57.83591457454442,41.30654629886694,NaN,NaN,NaN,NaN,0.4531287489127268,21.324148084299217,12166615,0.14222220703306065,-0.14550237161176938,-0.28772457864483003
2025-09-03T15:40:00-04:00,503.76,504.22,503.61,504.095,502.41281718073486,502.41281718073486,502.41281718073486,NaN,NaN,NaN,503.8289000000008,505.50069818048695,502.1571018195146,503.03774665729316,504.72342898781653,505.8808383875062,503.5660195881269,20345,8479.033333333333,62.240746717252804,43.333000988524944,NaN,NaN,NaN,NaN,0.4643338382761044,21.765400912226873,12186960,0.1813629955363946,-0.061020834224336795,-0.2423838297607314
2025-09-03T15:45:00-04:00,504.16,504.56,503.8,504.38,502.6424618543378,NaN,NaN,NaN,NaN,NaN,503.8043000000008,505.40523723680013,502.2033627632015,503.23419732583454,504.7102953537651,505.8543159154011,503.5662747921291,25104,9153.466666666667,65.63148044374933,45.85539295737133,NaN,NaN,NaN,NaN,0.4854528498278106,22.775213191842987,12212064,0.2167861368699888,0.02859884132675461,-0.18818729554323418
2025-09-03T15:50:00-04:00,504.4,505.62,504.4,504.98,503.37325904277697,NaN,NaN,NaN,NaN,NaN,503.80150000000083,505.39368874387003,502.2093112561316,503.9393578606676,504.72692191724724,505.83967097563925,503.6141728588552,55485,10852.833333333334,71.44504881797359,48.031222419344836,NaN,NaN,NaN,NaN,0.5393490748401105,24.9952520334465,12267549,0.2676306540230632,0.1463510219855948,-0.12127963203746837
2025-09-03T15:55:00-04:00,504.96,505.55,504.57,505.4,503.37325904277697,NaN,NaN,NaN,NaN,NaN,503.79990000000083,505.38548568236564,502.214314317636,503.9393578606676,504.7853751567867,505.83359089968,503.7371594138934,145664,15371.866666666667,74.67446034663085,50.65201101217395,NaN,NaN,NaN,NaN,0.5708241409229611,27.056716672078334,12413213,0.3133784732884787,0.27044345957313,-0.04293501371534869
2025-09-04T09:30:00-04:00,504.15,506.8,503.96,506.73,503.3738372683154,NaN,NaN,NaN,NaN,NaN,503.82270000000085,505.53806725979615,502.10733274020555,503.9393578606676,505.83,505.83,505.83,30508,16241.033333333333,81.72340723533826,53.803909002657484,NaN,NaN,NaN,NaN,0.7329081308570375,29.883823414283185,12443721,0.4108934259203109,0.47068176868503997,0.05978834276472905
2025-09-04T09:35:00-04:00,506.69,506.89,504.85,505.12,503.6768446652102,NaN,NaN,NaN,NaN,NaN,503.8185000000009,505.5200572267427,502.11694277325904,503.9393578606676,505.72781300484655,505.83277531714475,505.62285069254835,28916,16870.066666666666,59.9651769858237,55.09812288501036,NaN,NaN,NaN,NaN,0.826271835795818,32.55909713674579,12414805,0.34718267904061456,0.49376669156549724,0.14658401252488268
2025-09-04T09:40:00-04:00,505.14,505.14,503.9,504.59,503.6768446652102,NaN,NaN,NaN,NaN,NaN,503.81050000000084,505.4936117003729,502.12738829962876,503.9393578606676,505.34195499328683,505.90372247953104,504.7801875070426,28711,17568.3,54.79339738126313,56.28307478881556,NaN,NaN,NaN,NaN,0.8558238475246888,32.73769676308446,12386094,0.2538903871660868,0.46394699648249116,0.21005660931640438
2025-09-04T09:45:00-04:00,504.61,504.93,503.87,504.48,503.6768446652102,NaN,NaN,NaN,NaN,NaN,503.7905000000008,505.41658271501547,502.16441728498614,503.9393578606676,505.15859669975384,505.78034259235267,504.536850807155,22079,17904,53.7571144683772,57.51617038618707,NaN,NaN,NaN,NaN,0.8704078584157825,32.84066761413852,12364015,0.17317224333112824,0.42652191348031465,0.2533496701491864
2025-09-04T09:50:00-04:00,504.48,504.56,503.59,504.32,NaN,NaN,NaN,506.40679297102633,506.40679297102633,506.40679297102633,503.7813000000008,505.3899973725051,502.1726026274965,503.9393578606676,505.020103915804,505.6929441940293,504.3472636375787,17678,18371.666666666668,52.210369002264514,58.749846083716776,NaN,NaN,NaN,NaN,0.8775215828146571,32.347058676833825,12346337,0.10098113260333258,0.3795760859033521,0.27859495330001954
2025-09-04T09:55:00-04:00,504.47,504.76,503.78,504.02,NaN,NaN,NaN,506.40679297102633,NaN,NaN,503.7713000000008,505.3676744034991,502.1749255965025,503.9393578606676,504.90939863847797,505.5968507327718,504.2219465441841,19590,18832.533333333333,49.343556394025974,59.388131487956755,NaN,NaN,NaN,NaN,0.8848414697564685,32.127613043485425,12326747,0.028754348983451083,0.31453788952933337,0.2857835405458823
2025-09-04T10:00:00-04:00,503.84,503.92,503.16,503.5,NaN,NaN,NaN,505.90946425665834,NaN,NaN,503.75330000000076,505.3411861534731,502.16541384652845,503.9393578606676,504.715086423926,505.5132736157574,503.9168992320946,24114,19498.2,44.75619962285546,59.33197122937088,NaN,NaN,NaN,NaN,0.8830670790595747,30.714180809359483,12302633,-0.053813969385240135,0.2185160788143321,0.27233004819957224
2025-09-04T10:05:00-04:00,503.55,504.42,503.37,504.42,NaN,NaN,NaN,505.90946425665834,NaN,NaN,503.7523000000008,505.3384414931005,502.16615850690107,503.9393578606676,504.65337812982546,505.4357830596128,503.8709732000381,18151,19961.066666666666,53.06922267316066,59.63871704665767,NaN,NaN,NaN,NaN,0.8949908591267487,30.041324466068424,12320784,-0.046515704880023434,0.21418541709954297,0.2607011219795664
2025-09-04T10:10:00-04:00,504.37,505.24,504.32,504.5,NaN,NaN,NaN,505.90946425665834,NaN,NaN,503.75470000000075,505.34499105391126,502.16440894609025,503.9123890308273,504.65728874522296,505.39237944827016,503.92219804217575,25258,20657.066666666666,53.72136564056374,59.65481859313026,NaN,NaN,NaN,NaN,0.896777226331982,30.27577345534647,12346042,-0.03677421322588642,0.2147333554472084,0.2515075686730948
2025-09-04T10:15:00-04:00,504.49,504.87,503.96,504.77,NaN,NaN,NaN,505.90946425665834,NaN,NaN,503.7643000000007,505.37308837528076,502.1555116247206,503.9123890308273,504.64860696603483,505.35819323699286,503.9390206950768,16193,21012.066666666666,55.94634250340588,59.519849159477516,NaN,NaN,NaN,NaN,0.8977217101654136,29.8516916073811,12362235,-0.013802847221532716,0.23425400964617893,0.24805685686771164
2025-09-04T10:20:00-04:00,504.75,505.12,504.51,505.01,NaN,NaN,NaN,505.90946425665834,NaN,NaN,503.7869000000007,505.43287313358434,502.14092686641703,503.5599112246618,504.6765994210745,505.3461474789543,504.0070513631947,31818,21969.933333333334,57.88462808648859,59.20869782870864,NaN,NaN,NaN,NaN,0.8771701594393136,29.717213998004166,12394053,0.01437348032218988,0.266023707270449,0.2516502269482591
2025-09-04T10:25:00-04:00,504.98,505.62,504.87,505.5,NaN,NaN,NaN,505.90946425665834,NaN,NaN,503.81710000000066,505.5308842210912,502.10331577891014,503.35847537226863,504.7282211281448,505.39451091535676,504.06193134093286,22562,22599.533333333333,61.5994871411329,58.920698307093176,NaN,NaN,NaN,NaN,0.8680865766222199,30.07425869889711,12416615,0.06025678315826177,0.3269712058960863,0.26671442273782453
2025-09-04T10:30:00-04:00,505.45,506.46,505.44,506.12,503.5195668917506,503.5195668917506,503.5195668917506,NaN,NaN,NaN,503.8687000000007,505.6975059592445,502.03989404075685,504.1407802978149,504.820223274395,505.54213015166306,504.09831639712695,22145,23065.1,65.7197588972775,58.51174902704345,NaN,NaN,NaN,NaN,0.8789375354349171,31.081522057012727,12438760,0.1229921554120289,0.4204546170028607,0.2974624615908318
2025-09-04T10:35:00-04:00,506.09,507.17,506.02,507.11,504.1182229421256,NaN,NaN,NaN,NaN,NaN,503.93870000000067,505.97832232694554,501.8990776730558,504.7396242382519,504.97899841020654,505.8521969203056,504.1057999001075,27331,23791.133333333335,71.05952962867052,58.25353969004629,NaN,NaN,NaN,NaN,0.8982991400467112,32.481499190818916,12466091,0.21633359803068464,0.5678794591291876,0.35154586109850294
2025-09-04T10:40:00-04:00,507.12,507.35,506.89,507.09,504.6930764447563,NaN,NaN,NaN,NaN,NaN,503.99930000000074,506.22160691762014,501.77699308238135,505.17569939060155,505.09258182215467,506.06776414303744,504.1173995012719,18864,24150.033333333333,70.81952961577564,57.474691288648955,NaN,NaN,NaN,NaN,0.8669920586148059,33.89010155399815,12447227,0.2590163114689272,0.6753162504346619,0.41629993896573475
2025-09-04T10:45:00-04:00,507.05,507.45,506.96,507.415,504.8215729699946,NaN,NaN,NaN,NaN,NaN,504.0662000000008,506.4856433731992,501.64675662680236,505.4655595124812,505.18144824872627,506.22944815757506,504.1334483398775,15023,24473.933333333334,72.4480008862663,58.366321567251994,NaN,NaN,NaN,NaN,0.8400640544280347,35.259933139747304,12462250,0.2891363599609471,0.7777203889169186,0.4885840289559715
2025-09-04T10:50:00-04:00,507.42,507.64,506.94,507.265,504.919456016813,NaN,NaN,NaN,NaN,NaN,504.1263000000007,506.7059975087257,501.5466024912757,505.702447609985,505.25990408549853,506.3625801967582,504.1572279742389,14317,24561.4,70.49265206427701,59.48769690175299,NaN,NaN,NaN,NaN,0.8300594791117456,36.65172853360168,12447933,0.27883104016692484,0.8371228291646275,0.5582917889977027
2025-09-04T10:55:00-04:00,507.26,507.55,506.95,507.49,504.919456016813,NaN,NaN,NaN,NaN,NaN,504.1855000000007,506.9301203738341,501.44087962616726,505.702447609985,505.33324456692714,506.481835110649,504.18465402320527,14077,24833.333333333332,71.7253890280589,60.77114508458739,NaN,NaN,NaN,NaN,0.813626659175194,37.94410997075216,12462010,0.2670242161824523,0.892072059225768,0.6250478430433157
2025-09-04T11:00:00-04:00,507.53,507.56,506.63,506.78,504.919456016813,NaN,NaN,NaN,NaN,NaN,504.2373000000007,507.0764408623734,501.398159137628,505.702447609985,505.3602622783606,506.5186137134649,504.2019108432563,6587,24753.5,62.8083954552104,61.528146974083526,NaN,NaN,NaN,NaN,0.8219390406626806,38.42291481644338,12455423,0.19461709381189662,0.8683192103081865,0.6737021164962899
2025-09-04T11:05:00-04:00,506.84,507.01,506.6,506.91,504.919456016813,NaN,NaN,NaN,NaN,NaN,504.29390000000075,507.22943967036474,501.35836032963675,505.702447609985,505.3797338434626,506.5427280535293,504.2167396333959,5386,24628.933333333334,63.69829753349363,62.553485626902635,NaN,NaN,NaN,NaN,0.7925148234724869,38.799896703902355,12460809,0.14118584532054446,0.8501844231469704,0.708998577826426
2025-09-04T11:10:00-04:00,506.96,507.1,506.16,506.52,504.919456016813,NaN,NaN,NaN,NaN,NaN,504.3457000000007,507.3444510794198,501.3469489205816,505.702447609985,505.3964858715408,506.5600730125711,504.2328987305105,5729,24523.4,59.127492417533865,63.58000654080824,NaN,NaN,NaN,NaN,0.8030494789387378,38.188267795236484,12455080,0.06894228500419364,0.795176434081668,0.7262341490774744
2025-09-04T11:15:00-04:00,506.51,507.29,506.32,507.29,504.919456016813,NaN,NaN,NaN,NaN,NaN,504.4155000000007,507.5207711630895,501.3102288369119,505.702447609985,505.4346355817183,506.6091507394669,504.2601204239697,10335,24463.433333333334,64.53800969233804,64.39920561360661,NaN,NaN,NaN,NaN,0.8149745161574014,37.82837393773556,12465415,0.06256601551494556,0.8044416684711564,0.7418756529562108
2025-09-04T11:20:00-04:00,507.29,508.04,507.29,507.9,505.30772716161556,NaN,NaN,NaN,NaN,NaN,504.5039000000007,507.74624130777204,501.2615586922294,506.0745542662719,505.510607833954,506.73686895547905,504.28434671242894,14474,24494.566666666666,68.13653305156853,65.42886042867839,NaN,NaN,NaN,NaN,0.8103334792890156,38.21393069591316,12479889,0.08745491562161711,0.8511942974832323,0.7637393818616152
2025-09-04T11:25:00-04:00,507.855,507.99,507.55,507.69,505.45987592699663,NaN,NaN,NaN,NaN,NaN,504.5877000000007,507.9367537224793,501.23864627752215,506.19764341301754,505.5890606116444,506.86180878966934,504.3163124336195,16018,24461.066666666666,65.66608082801852,66.123127451865,NaN,NaN,NaN,NaN,0.7838810879112286,38.571947685649505,12463871,0.07810568927990025,0.8613714934614904,0.7832658041815902
2025-09-04T11:30:00-04:00,507.7,507.74,506.84,506.94,505.45987592699663,NaN,NaN,NaN,NaN,NaN,504.65930000000066,508.05307960929724,501.26552039070407,506.19764341301754,505.621948883848,506.90151234947183,504.3423854182242,9664,24268.633333333335,57.62955498564281,66.10490794466173,NaN,NaN,NaN,NaN,0.7921752959175719,37.45176009981989,12454207,0.013147213350264475,0.7996998208694208,0.7865526075191563
2025-09-04T11:35:00-04:00,506.9,507.1,506.71,507.085,505.45987592699663,NaN,NaN,NaN,NaN,NaN,504.7346000000006,508.17295474558034,501.2962452544209,506.19764341301754,505.64048247825406,506.92080933312025,504.36015562338787,6514,23954.666666666668,58.68237473557041,65.89654277283584,NaN,NaN,NaN,NaN,0.7634484890663199,36.172516139813574,12460721,-0.026173988285678074,0.7538351221620587,0.7800091104477368
2025-09-04T11:40:00-04:00,507.04,507.4,507.02,507.255,505.45987592699663,NaN,NaN,NaN,NaN,NaN,504.81890000000067,508.293424018677,501.34437598132433,506.19764341301754,505.665111325457,506.95048121050434,504.3797414404097,7453,23524.933333333334,59.93920369250236,65.48364597249477,NaN,NaN,NaN,NaN,0.7360593112758682,35.348978303671416,12468174,-0.045709863296770625,0.7228717813267735,0.7685816446235442
2025-09-04T11:45:00-04:00,507.185,507.2,506.83,507.02,505.45987592699663,NaN,NaN,NaN,NaN,NaN,504.8935000000007,508.393591569698,501.3934084303034,506.19764341301754,505.68977054267697,506.97614214710825,504.4033989382457,8911,22985.166666666668,57.3425075635246,64.50385868212719,NaN,NaN,NaN,NaN,0.7138407890418784,34.215261065095284,12459263,-0.07756254785679684,0.6716284598025482,0.749191007659345
2025-09-04T11:50:00-04:00,507.04,507.22,506.8,507.22,505.45987592699663,NaN,NaN,NaN,NaN,NaN,504.9703000000007,508.5025516383016,501.43804836169977,506.19764341301754,505.70670038583387,506.99427583016603,504.4191249415017,6021,21336.366666666665,58.97158496228993,63.65757692116393,NaN,NaN,NaN,NaN,0.692852161253174,33.102799602064586,12465284,-0.08752793517063262,0.6397810886960542,0.7273090238666868
2025-09-04T11:55:00-04:00,507.14,507.24,506.7,506.86,505.45987592699663,NaN,NaN,NaN,NaN,NaN,505.04350000000073,508.5776659548208,501.50933404518065,506.19764341301754,505.7347909021143,507.0206962575459,504.4488855466827,11588,16867.166666666668,54.906868470190155,62.40463889144421,NaN,NaN,NaN,NaN,0.6819341497350916,31.8621233936763,12453696,-0.1187907843964855,0.57882054337108,0.6976113277675655
2025-09-04T12:00:00-04:00,506.89,506.95,506.48,506.64,505.45987592699663,NaN,NaN,NaN,NaN,NaN,505.11250000000075,508.6339134940505,501.591086505951,506.19764341301754,505.74629960274854,507.02867659720835,504.4639226082887,6171,16055.933333333332,52.524262184394445,61.12118247145259,NaN,NaN,NaN,NaN,0.666795996182583,30.256430679606254,12447525,-0.15255839877159283,0.5069133293030745,0.6594717280746674
2025-09-04T12:05:00-04:00,506.65,506.84,506.52,506.81,505.45987592699663,NaN,NaN,NaN,NaN,NaN,505.1835000000007,508.6957882848906,501.6712117151108,506.19764341301754,505.75454268174644,507.0346216892714,504.4744636742215,4358,15237.333333333334,54.17889668050811,59.867861589484676,NaN,NaN,NaN,NaN,0.6420248535981123,28.765430302255496,12451883,-0.1608891969338886,0.45836023190730657,0.6192494288411952
2025-09-04T12:10:00-04:00,506.78,506.94,506.65,506.85,505.45987592699663,NaN,NaN,NaN,NaN,NaN,505.26150000000075,508.7450224983075,501.777977501694,506.19764341301754,505.7624869327575,507.04102351661163,504.48395034890336,3905,14410.466666666667,54.5800155440126,59.28012016725626,NaN,NaN,NaN,NaN,0.6168802211982486,27.562909781795348,12455788,-0.16076957455328067,0.4182874606495943,0.579057035202875
2025-09-04T12:15:00-04:00,506.87,507,506.64,506.8,505.45987592699663,NaN,NaN,NaN,NaN,NaN,505.3445000000007,508.7724931441476,501.91650685585387,505.9207573401035,505.7697775011052,507.04685345292575,504.4927015492846,3636,13795.7,53.944321741902755,58.583407610714055,NaN,NaN,NaN,NaN,0.5985316339698032,26.558525528000548,12452152,-0.1607368264539183,0.37813600213547716,0.5388728285893954
2025-09-04T12:20:00-04:00,506.77,506.83,506,506.08,505.45987592699663,NaN,NaN,NaN,NaN,NaN,505.4035000000008,508.778136127919,502.0288638720826,505.9207573401035,505.77679519649024,507.04690032742616,504.5066900655543,6985,13439.266666666666,45.691589351286076,57.623700248839214,NaN,NaN,NaN,NaN,0.6150650886862447,25.07611227376198,12445167,-0.2031517291971494,0.2849331670929587,0.4880848962901081
2025-09-04T12:25:00-04:00,506.03,506.14,505.81,505.99,505.45987592699663,NaN,NaN,NaN,NaN,NaN,505.4653000000007,508.7666648141729,502.1639351858285,505.9207573401035,505.7782162356726,507.0439858383062,504.51244663303896,3740,12910.933333333332,44.76959161492644,56.211670386166965,NaN,NaN,NaN,NaN,0.5947032966372261,24.046608484415106,12441427,-0.22928038576247084,0.20148441408701956,0.4307647998494904
2025-09-04T12:30:00-04:00,506.04,506.48,505.97,506.19,505.45987592699663,NaN,NaN,NaN,NaN,NaN,505.5317000000007,508.75420561463335,502.309194385368,505.9207573401035,505.7806932721293,507.04327930748457,504.5181072367741,3062,12209.2,47.313855638465526,54.72433628523104,NaN,NaN,NaN,NaN,0.5886530611631378,22.3760001281033,12444489,-0.2248017325028221,0.1497626342209628,0.3745643667237849
2025-09-04T12:35:00-04:00,506.23,506.49,506.16,506.32,505.45987592699663,NaN,NaN,NaN,NaN,NaN,505.59670000000074,508.7482961727645,502.44510382723695,505.9207573401035,505.7853799808808,507.0435041792491,504.5272557825125,4686,11760.366666666667,48.95972355849518,53.53102505169365,NaN,NaN,NaN,NaN,0.5701778425086268,20.804190533249777,12449175,-0.20532865665762462,0.11790354590175411,0.32323220255937873
2025-09-04T12:40:00-04:00,506.34,506.46,506.19,506.3,505.45987592699663,NaN,NaN,NaN,NaN,NaN,505.6665000000007,508.7212315751643,502.6117684248371,505.9207573401035,505.79078363888584,507.0436279744008,504.5379393033709,5575,11104.266666666666,48.70762703219795,52.89374448359045,NaN,NaN,NaN,NaN,0.5487365680437236,19.344653052314364,12443600,-0.18658284206999032,0.09000364997189081,0.2765864920418811
2025-09-04T12:45:00-04:00,506.36,506.74,506.29,506.74,505.45987592699663,NaN,NaN,NaN,NaN,NaN,505.7477000000007,508.69450654885475,502.80089345114664,505.9207573401035,505.79368773009645,507.0451780456775,504.5421974145154,1999,10631.133333333333,54.28459145445592,52.579617106367984,NaN,NaN,NaN,NaN,0.5416839560405997,18.544791265952625,12445599,-0.13949416193086828,0.10221878962829578,0.24171295155916406
2025-09-04T12:50:00-04:00,506.74,507.09,506.64,507.03,505.45987592699663,NaN,NaN,NaN,NaN,NaN,505.8371000000007,508.66027699699754,503.01392300300387,506.0204814497313,505.80000907085656,507.05081581864374,504.5492023230694,3105,9674.033333333333,57.55989487100703,52.40966647626118,NaN,NaN,NaN,NaN,0.5351351020376989,18.47469697120923,12448704,-0.08636390334071287,0.13375807238327297,0.22012197572398584
2025-09-04T12:55:00-04:00,506.97,507.02,506.35,506.36,505.45987592699663,NaN,NaN,NaN,NaN,NaN,505.9083000000007,508.5979108336391,503.21868916636225,506.0204814497313,505.8089430443265,507.05528951877307,504.56259656987993,6438,9136.566666666668,48.85166658611668,51.803177835017756,NaN,NaN,NaN,NaN,0.5454825947492882,17.705799992885765,12442266,-0.09330019283078314,0.10349673468550691,0.19679692751629005
2025-09-04T13:00:00-04:00,506.44,506.94,506.44,506.94,505.45987592699663,NaN,NaN,NaN,NaN,NaN,505.98610000000076,508.5631830712234,503.4090169287781,506.0204814497313,505.8213834101428,507.0644377037011,504.5783291165845,7314,8642.2,55.174003565136424,51.53192202093536,NaN,NaN,NaN,NaN,0.5479481236957665,16.99182422729969,12449580,-0.05753668943416529,0.12487606572358345,0.18241275515774874
2025-09-04T13:05:00-04:00,506.9,507,506.53,506.54,505.45987592699663,NaN,NaN,NaN,NaN,NaN,506.05250000000075,508.5093599870711,503.5956400129304,506.0204814497313,505.8273082546397,507.068177132523,504.58643937675646,3894,7860.966666666666,50.53470259656175,51.219624458533325,NaN,NaN,NaN,NaN,0.5423804005746423,16.458807376250448,12445686,-0.05929473782064726,0.10829433288193968,0.16758907070258694
2025-09-04T13:10:00-04:00,506.5,506.5,506.17,506.17,505.45987592699663,NaN,NaN,NaN,NaN,NaN,506.1061000000007,508.4514061966938,503.7607938033076,506.0204814497313,505.8313983598573,507.0673913163001,504.59540540341453,5205,7405.666666666667,46.6289884115813,50.798533474760966,NaN,NaN,NaN,NaN,0.530067514819311,15.486494091409636,12440481,-0.08242873353395663,0.06455315378514115,0.14698188731909778
2025-09-04T13:15:00-04:00,506.27,506.49,506.23,506.49,505.45987592699663,NaN,NaN,NaN,NaN,NaN,506.1605000000007,508.41079442437103,503.91020557563036,506.0204814497313,505.83306732101727,507.0676411047625,504.598493537272,1686,6961.1,50.21292482797771,50.51524977100879,NaN,NaN,NaN,NaN,0.5150626923322169,14.583631755486026,12442167,-0.0735259768368886,0.05507441627298704,0.12860039310987564
2025-09-04T13:20:00-04:00,506.48,506.78,506.45,506.72,505.45987592699663,NaN,NaN,NaN,NaN,NaN,506.21300000000076,508.38935934440974,504.0366406555918,506.0204814497313,505.83734037577295,507.0700903981833,504.6045903533626,3038,6585.133333333333,52.67288154463205,50.37902591391018,NaN,NaN,NaN,NaN,0.5018439285942004,14.040069498455257,12445205,-0.05058591077076771,0.06536800464641601,0.11595391541718372
2025-09-04T13:25:00-04:00,506.72,506.84,506.57,506.79,505.45987592699663,NaN,NaN,NaN,NaN,NaN,506.26120000000077,508.37900316270185,504.1433968372997,506.0204814497313,505.84326637066397,507.0740775703467,504.61245517098126,3867,6244.8,53.427103188347346,50.34208173151337,NaN,NaN,NaN,NaN,0.4852836479803276,13.67375444933091,12449072,-0.03014561799757634,0.0782718929202133,0.10841751091778964
2025-09-04T13:30:00-04:00,506.77,506.81,506.6,506.74,505.45987592699663,NaN,NaN,NaN,NaN,NaN,506.29640000000074,508.3861741877994,504.2066258122021,506.0204814497313,505.8500872051423,507.078491208954,504.6216832013306,4602,6178.633333333333,52.78008621888237,50.84840293634168,NaN,NaN,NaN,NaN,0.46562053026744554,13.333604760858304,12444470,-0.01993306031573676,0.08350118552311869,0.10343424583885545
2025-09-04T13:35:00-04:00,506.74,507.03,506.74,506.85,505.45987592699663,NaN,NaN,NaN,NaN,NaN,506.32540000000074,508.40482957469413,504.24597042530735,506.1809510677291,505.8592014350821,507.08589565719274,504.6325072129715,5296,6175.633333333333,54.097133053713314,51.51465589625502,NaN,NaN,NaN,NaN,0.4530762066769111,13.547217748756015,12449766,-0.0064101503068289545,0.09542155795531926,0.10183170826214821
2025-09-04T13:40:00-04:00,506.83,507.14,506.74,506.93,505.45987592699663,NaN,NaN,NaN,NaN,NaN,506.32940000000076,508.41269319974634,504.2461068002552,506.2607608541833,505.8689790735453,507.0943617940556,504.643596353035,5445,6166.166666666667,55.078457625999,52.06927032393599,NaN,NaN,NaN,NaN,0.4492850490571301,13.996475239423829,12455211,0.006578811234958029,0.11005522230584575,0.10347641107088772
2025-09-04T13:45:00-04:00,506.97,507.4,506.9,507.33,505.61692475329056,NaN,NaN,NaN,NaN,NaN,506.37360000000075,508.4461298926453,504.3010701073562,506.4466086833466,505.8774074126213,507.10352201019464,504.651292815048,3795,5948.166666666667,59.715734243609134,52.83755680144412,NaN,NaN,NaN,NaN,0.4529075455530494,14.966425494631894,12459006,0.03895885937465554,0.15217498528920714,0.1132161259145516
2025-09-04T13:50:00-04:00,507.37,507.67,507.24,507.53,505.93297362814104,NaN,NaN,NaN,NaN,NaN,506.4324000000007,508.4656321451844,504.39916785481705,506.6922869466773,505.9003790277911,507.1324887154617,504.66826934012045,8781,5758.4,61.83704838840478,53.77537261260175,NaN,NaN,NaN,NaN,0.45127129229926066,16.371188557717694,12467787,0.06894312141258435,0.19939502768028206,0.1304519062676977
2025-09-04T13:55:00-04:00,507.52,507.59,507.24,507.3,505.93297362814104,NaN,NaN,NaN,NaN,NaN,506.4888000000007,508.45770280009816,504.51989719990326,506.6922869466773,505.9123237639555,507.14654516861435,504.67810235929664,4997,5391.033333333334,58.05119964794919,54.04441605499413,NaN,NaN,NaN,NaN,0.4440376285635968,17.675611402011658,12462790,0.06825519581229603,0.21577090103306773,0.1475157052207717
2025-09-04T14:00:00-04:00,507.29,507.525,507.26,507.47,505.93297362814104,NaN,NaN,NaN,NaN,NaN,506.55180000000064,508.4389743524166,504.66462564758467,506.6922869466773,505.9242623969931,507.1608156391757,504.6877091548104,4935,5233.4,60.00048320889871,54.218743793414966,NaN,NaN,NaN,NaN,0.4312492265233389,18.886861185998907,12467725,0.07375009754532383,0.23970332715242648,0.16595322960710265
2025-09-04T14:05:00-04:00,507.41,507.45,507.1,507.31,505.93297362814104,NaN,NaN,NaN,NaN,NaN,506.61760000000066,508.3718226074043,504.86337739259704,506.6922869466773,505.9387456248674,507.17661930254087,504.70087194719395,6689,5239.233333333334,57.301636340288105,54.82231306157007,NaN,NaN,NaN,NaN,0.42687428177167214,19.364679164895843,12461036,0.0616043033906028,0.24295860884535614,0.18135430545475334
2025-09-04T14:10:00-04:00,507.31,507.43,507.08,507.2,505.93297362814104,NaN,NaN,NaN,NaN,NaN,506.6916000000006,508.20981400226174,505.1733859977395,506.6922869466773,505.95357254107176,507.19205986398794,504.7150852181556,7271,5233.166666666667,55.45483451492248,54.84237241512621,NaN,NaN,NaN,NaN,0.42138326164512574,19.72786986504784,12453765,0.04208883993224535,0.23396535537006002,0.19187651543781467
2025-09-04T14:15:00-04:00,507.22,507.335,507.09,507.15,505.93297362814104,NaN,NaN,NaN,NaN,NaN,506.7462000000006,508.1235330158942,505.368866984107,506.6922869466773,505.9732324252172,507.21155745324404,504.73490739719034,10270,5278.466666666666,54.59353053430057,55.132288696393275,NaN,NaN,NaN,NaN,0.4087844572419028,20.06511837233184,12443495,0.022710374220000884,0.22026448321281578,0.1975541089928149
2025-09-04T14:20:00-04:00,507.2,507.45,507.025,507.395,505.93297362814104,NaN,NaN,NaN,NaN,NaN,506.80410000000063,508.0344165269735,505.5737834730278,506.6922869466773,505.9877437750428,507.2268753657079,504.74861218437775,7207,5318,58.033104459846214,55.946868414126484,NaN,NaN,NaN,NaN,0.40994271029605345,20.683001701050937,12450702,0.023208076524477483,0.22656420464841176,0.20335612812393428
2025-09-04T14:25:00-04:00,507.4,507.41,507.01,507.1,505.93297362814104,NaN,NaN,NaN,NaN,NaN,506.85070000000064,507.93743457493576,505.7639654250655,506.6922869466773,505.99609824559286,507.2348324665081,504.7573640246776,4641,5086.433333333333,52.84257674022311,56.13470069357258,NaN,NaN,NaN,NaN,0.40923251670348065,21.18439923275421,12446061,0.0016232511368639846,0.20538519204501426,0.20376194090815028
2025-09-04T14:30:00-04:00,507.11,507.41,506.93,507.41,505.93297362814104,NaN,NaN,NaN,NaN,NaN,506.8987000000007,507.86085759434445,505.93654240565695,506.6922869466773,506.01742935635417,507.2562395196967,504.77861919301165,11398,5260.666666666667,57.17705295518156,56.456427222897545,NaN,NaN,NaN,NaN,0.41428733693894765,21.25552578663285,12457459,0.0059350243074969,0.2111807212925214,0.2052456969850245
2025-09-04T14:35:00-04:00,507.41,507.96,507.41,507.93,506.28333863560425,NaN,NaN,NaN,NaN,NaN,506.9473000000006,507.8664718210635,506.0281281789377,506.9118095433471,506.0416641375451,507.28873826780546,504.7945900072848,9413,5429.166666666667,63.274892186314624,57.15984072275235,NaN,NaN,NaN,NaN,0.4239810985861624,22.669654643493402,12466872,0.03964043576032131,0.25479624168542614,0.21515580592510483
2025-09-04T14:40:00-04:00,507.89,508.15,507.55,507.55,506.4302323339859,NaN,NaN,NaN,NaN,NaN,506.9759000000006,507.8791777849064,506.0726222150948,507.01144763467767,506.06776601382796,507.32289204288935,504.8126399847666,10542,5650.4,56.89863003120295,57.454022423632395,NaN,NaN,NaN,NaN,0.4365538772585769,24.331227748514074,12456330,0.03247607086761006,0.2557508945096174,0.22327482364200735
2025-09-04T14:45:00-04:00,507.55,508,507.48,508,506.4302323339859,NaN,NaN,NaN,NaN,NaN,506.9937000000006,507.94085745083413,506.0465425491671,507.01144763467767,506.07901242461736,507.33794985507353,504.8200749941612,4440,5677.2,61.806948260554485,58.00472350983534,NaN,NaN,NaN,NaN,0.4425143145972487,25.542731891754265,12460770,0.05296553122087219,0.2894817376680976,0.2365162064472254
2025-09-04T14:50:00-04:00,508.01,508.11,507.67,507.69,506.4686827671235,NaN,NaN,NaN,NaN,NaN,507.0057000000007,507.97243472902005,506.0389652709813,507.01144763467767,506.0950187253627,507.3591562752958,504.8308811754296,6431,5658.733333333334,56.9920227520273,58.14140673312307,NaN,NaN,NaN,NaN,0.44233472069744506,26.88179149206068,12454339,0.04109163846478203,0.28788075452820294,0.2467891160634209
2025-09-04T14:55:00-04:00,507.74,507.98,507.5,507.53,506.4686827671235,NaN,NaN,NaN,NaN,NaN,507.00800000000066,507.9791560103358,506.0368439896655,507.01144763467767,506.1130270677173,507.3810216292396,504.845032506195,8106,5804.266666666666,54.626648838472384,57.77790063275616,NaN,NaN,NaN,NaN,0.44502509779048605,27.31804010519825,12446233,0.01903446545767684,0.27058219788551696,0.2515477324278401
2025-09-04T15:00:00-04:00,507.56,507.61,507.42,507.57,506.4686827671235,NaN,NaN,NaN,NaN,NaN,507.01410000000067,507.9954148101003,506.032785189901,507.01144763467767,506.12406958500657,507.3932707963668,504.85486837364635,5555,5887.366666666667,55.12805003558255,57.29868646469743,NaN,NaN,NaN,NaN,0.4268090193768797,27.36049679333628,12451788,0.004471032495414917,0.25713652304710877,0.25266549055169385
2025-09-04T15:05:00-04:00,507.525,507.57,507.23,507.3,506.4686827671235,NaN,NaN,NaN,NaN,NaN,507.01030000000065,507.9856674365918,506.0349325634095,507.01144763467767,506.1388261557044,507.40762889127086,504.87002342013795,8587,6017.4,51.02894055194324,56.79709652926844,NaN,NaN,NaN,NaN,0.42060837513567223,26.587183791703545,12443201,-0.0244256963346757,0.22213337013334922,0.24655906646802492
2025-09-04T15:10:00-04:00,507.28,507.42,507.12,507.4,506.4686827671235,NaN,NaN,NaN,NaN,NaN,507.0227000000006,508.00179797088197,506.04360202911926,507.01144763467767,506.15235812868764,507.4200421639846,504.8846740933907,8428,6112.5,52.439477363326255,56.257024683156125,NaN,NaN,NaN,NaN,0.41199349119741074,25.431714370289388,12451629,-0.03712323634254175,0.20015502103984772,0.23727825738238947
2025-09-04T15:15:00-04:00,507.39,507.44,507.01,507.1,506.4686827671235,NaN,NaN,NaN,NaN,NaN,507.0265000000007,508.0052936433144,506.04770635668694,507.01144763467767,506.15908741379366,507.42535201759654,504.8928228099908,4806,6206.066666666667,47.97504494345221,55.59083958338213,NaN,NaN,NaN,NaN,0.41327967039759617,23.936393708765493,12446823,-0.06444426676038437,0.156722923931909,0.22116719069229338
2025-09-04T15:20:00-04:00,507.09,507.32,506.95,506.95,506.4686827671235,NaN,NaN,NaN,NaN,NaN,507.0351000000007,508.0034418592444,506.066758140757,507.01144763467767,506.1718473061431,507.43381018652843,504.90988442575775,10422,6449.966666666666,45.87217729140298,54.90636406741645,NaN,NaN,NaN,NaN,0.4101882653691967,22.320218513697245,12436401,-0.08977927301037453,0.10894309942932523,0.19872237243969976
2025-09-04T15:25:00-04:00,506.98,507.01,506.55,506.6,506.4686827671235,NaN,NaN,NaN,NaN,NaN,507.0213000000006,507.9943730890072,506.04822691099406,507.01144763467767,506.1832157717976,507.43446469740945,504.9319668461858,15815,6762.533333333334,41.32095196801839,53.95832274125343,NaN,NaN,NaN,NaN,0.41374624641425267,21.932327958388438,12420586,-0.12510028253577388,0.04234701926998241,0.1674473018057563
2025-09-04T15:30:00-04:00,506.63,506.88,506.53,506.78,506.4686827671235,NaN,NaN,NaN,NaN,NaN,506.9989000000007,507.9411065359998,506.05669346400157,506.95332648619376,506.1917314924189,507.4350433184361,504.9484196664017,12064,6920.866666666667,44.377415988972174,52.982916421905294,NaN,NaN,NaN,NaN,0.40919294309895055,21.629017692853616,12432650,-0.13072024909617266,0.004046990435540465,0.13476723953171313
2025-09-04T15:35:00-04:00,506.8,506.84,506.54,506.81,506.4686827671235,NaN,NaN,NaN,NaN,NaN,506.9813000000006,507.90388291579205,506.05871708420915,506.95332648619376,506.20013623043286,507.43550684246577,504.96476561839995,12287,7200.633333333333,44.89262022267374,52.41506238493748,NaN,NaN,NaN,NaN,0.40139344716330794,21.34737244628557,12444937,-0.12670428108032283,-0.023613111818690413,0.10309116926163242
2025-09-04T15:40:00-04:00,506.81,506.93,506.57,506.73,506.4686827671235,NaN,NaN,NaN,NaN,NaN,506.9771000000006,507.9023050349825,506.0518949650187,506.814661188955,506.2083148064936,507.436133239085,504.9804963739022,12029,7428.1,43.72941760312617,51.45451700264781,NaN,NaN,NaN,NaN,0.3984367723659298,20.68555423960634,12432908,-0.12359037796427481,-0.051396803193711094,0.07219357477056372
2025-09-04T15:45:00-04:00,506.73,506.73,506.34,506.38,NaN,NaN,NaN,507.82191680246194,507.82191680246194,507.82191680246194,506.9630000000006,507.9025743700629,506.0234256299383,506.582728951164,506.2138198998263,507.4298976726318,504.99774212702084,16319,7915.866666666667,38.971760062873315,49.718578993830576,NaN,NaN,NaN,NaN,0.39783414576836645,20.798647131060395,12416589,-0.13815418935797488,-0.10049916192690489,0.03765502743107
2025-09-04T15:50:00-04:00,506.37,508.12,506.31,507.35,505.7397612340136,505.7397612340136,505.7397612340136,NaN,NaN,NaN,506.9649000000006,507.90720884356887,506.0225911564324,506.5781831609312,506.2499272889915,507.46000003143723,505.03985454654577,29143,8786.033333333333,53.93118500773742,49.506618635011606,NaN,NaN,NaN,NaN,0.4987031353563404,21.47702603068855,12445732,-0.07848039309078428,-0.06044546393241035,0.01803492915837393
2025-09-04T15:55:00-04:00,507.33,507.97,507.09,507.77,506.0018175415584,NaN,NaN,NaN,NaN,NaN,506.9799000000006,507.94874361821104,506.0110563817902,506.47654652874496,506.418444098365,507.636493911603,505.200394285127,119419,12637.766666666666,58.65672233299159,49.28160249732855,NaN,NaN,NaN,NaN,0.5259386256880341,22.10694929462898,12565151,-0.010324943978638524,0.005128749185075776,0.0154536931637143
2025-09-05T09:30:00-04:00,509.05,511.97,506.69,507.06,507.15128038057856,NaN,NaN,NaN,NaN,NaN,506.9767000000006,507.9434049376895,506.00999506231176,507.92077309777153,508.57333333333327,508.5733409627278,508.57332570393874,86440,15365.7,49.42675798825686,48.74122644277351,NaN,NaN,NaN,NaN,0.8655144381388908,25.625870766957053,12478711,-0.012516607922379155,-0.00019206673925964424,0.01232454118311951
2025-09-05T09:35:00-04:00,507.07,507.48,499.87,500.95,NaN,NaN,NaN,506.7924141821751,506.7924141821751,506.7924141821751,506.8585000000006,508.80355346879605,504.9134465312052,507.92077309777153,504.77986368200305,507.5433762620109,502.0163511019952,162879,20618.466666666667,20.10599281337946,46.27546529812402,NaN,NaN,NaN,NaN,1.3472634068432565,25.059015985692167,12315832,-0.4032724455680411,-0.4917660157769319,-0.08849357020889079
2025-09-05T09:40:00-04:00,501.09,503.65,500.1,502.95,NaN,NaN,NaN,505.33480444662166,NaN,NaN,506.7847000000006,509.0162325756984,504.55316742430284,507.92077309777153,503.8848394357795,506.42077655845713,501.34890231310186,135117,24940.866666666665,33.92360460145814,44.76086205282943,NaN,NaN,NaN,NaN,1.5046017349258778,24.53265083166049,12450949,-0.49860831981002796,-0.7117539699714257,-0.21314565016139778
2025-09-05T09:45:00-04:00,503.12,503.9,501.3,503.62,NaN,NaN,NaN,505.33480444662166,NaN,NaN,506.7209000000006,509.12186454715453,504.31993545284666,507.92077309777153,503.76563410396693,506.1568754421055,501.37439276582836,55505,26664.533333333333,37.804292239661585,43.81624431623788,NaN,NaN,NaN,NaN,1.5828444681454557,23.86216556869785,12506454,-0.4875240838220035,-0.8225507549389022,-0.33502667111689866
2025-09-05T09:50:00-04:00,503.62,503.7,501.75,502.77,NaN,NaN,NaN,505.33480444662166,NaN,NaN,506.6393000000007,509.2822967908306,503.9963032091707,507.92077309777153,503.66823829840916,505.9628947361341,501.3735818606842,46161,27910.533333333333,34.996195985017195,42.57029564635866,NaN,NaN,NaN,NaN,1.6090698632779223,23.239572110232537,12460293,-0.5062105214081452,-0.96778982287708,-0.46157930146893494
2025-09-05T09:55:00-04:00,502.68,502.77,501.16,502.54,NaN,NaN,NaN,505.33480444662166,NaN,NaN,506.55410000000063,509.4348413553461,503.67335864465514,507.92077309777153,503.51624374436415,505.7394474401214,501.2930400486069,54344,29555.433333333334,34.254740380118804,41.59027389183484,NaN,NaN,NaN,NaN,1.6091363016152105,23.000019633022443,12405949,-0.501856358759547,-1.0888997499183688,-0.5870433911588218
2025-09-05T10:00:00-04:00,502.47,502.47,500.95,501.18,NaN,NaN,NaN,505.33480444662166,NaN,NaN,506.4561000000007,509.70459952383777,503.2076004761636,507.92077309777153,503.3422857959525,505.53857947544225,501.1459921164627,51972,31123.333333333332,30.18264977477132,40.46959335493258,NaN,NaN,NaN,NaN,1.6077694229284119,22.897537863805034,12353977,-0.5542591746126224,-1.2798673594245997,-0.7256081848119773
2025-09-05T10:05:00-04:00,501.2,501.2,500.57,500.78,NaN,NaN,NaN,504.64532317019376,NaN,NaN,506.3519000000007,509.9670607925916,502.73673920740976,507.92077309777153,503.219460746632,505.42785671586944,501.0110647773946,30709,31924,29.087413976277247,39.595769212665346,NaN,NaN,NaN,NaN,1.5379287498620964,23.022261049050226,12323268,-0.576960896787555,-1.446809305796421,-0.8698484090088661
2025-09-05T10:10:00-04:00,500.76,501.69,500.25,501.25,NaN,NaN,NaN,504.64532317019376,NaN,NaN,506.2531000000007,510.1403349499481,502.3658650500533,507.92077309777153,503.1017629738867,505.304195055166,500.8993308926074,35979,32880.933333333334,32.200556099801915,38.72599350629604,NaN,NaN,NaN,NaN,1.5309338391576606,22.67791755468865,12359247,-0.5230201089493114,-1.5236235451955054,-1.000603436246194
2025-09-05T10:15:00-04:00,501.24,501.44,500.55,500.57,NaN,NaN,NaN,504.64532317019376,NaN,NaN,506.1381000000007,510.33823661161813,501.93796338838325,507.92077309777153,503.0089647213979,505.21136005826276,500.806569384533,28374,33484.4,30.13897759104148,37.67216188975088,NaN,NaN,NaN,NaN,1.4851528506463982,22.358170024210047,12330873,-0.49606719064427174,-1.6206874245515337,-1.124620233907262
2025-09-05T10:20:00-04:00,500.54,500.87,499.94,499.95,NaN,NaN,NaN,504.09708986468485,NaN,NaN,506.0111000000007,510.55400008213775,501.4681999178636,500.43561847821724,502.865437305959,505.0954176825352,500.6354569293828,37775,34503.333333333336,28.356374443872227,36.5740873783756,NaN,NaN,NaN,NaN,1.4454990756002275,22.466984563685223,12293098,-0.4824829653352394,-1.7277239405763112,-1.2452409752410718
2025-09-05T10:25:00-04:00,500,500,498.17,499.2,NaN,NaN,NaN,502.8588130526538,NaN,NaN,505.8603000000006,510.7812512938563,500.9393487061449,497.26626121622644,502.5611134995319,504.9306283381694,500.19159866089444,64202,36488.7,26.327782518858186,35.670946125231666,NaN,NaN,NaN,NaN,1.4729634273430674,23.537452993365545,12228896,-0.4851867053610952,-1.8517243569424409,-1.3665376515813457
2025-09-05T10:30:00-04:00,499.12,499.58,498.41,498.91,NaN,NaN,NaN,502.7568215502604,NaN,NaN,505.6979000000007,510.9766635253126,500.4191364746888,497.26626121622644,502.4256641365106,504.84879121895074,500.00253705407044,30914,37139.23333333333,25.566175098488188,33.64487398885672,NaN,NaN,NaN,NaN,1.4513231825328454,24.531459392354414,12197982,-0.46749572798783623,-1.9509073115661408,-1.4834115835783046
2025-09-05T10:35:00-04:00,498.85,499.24,498.06,498.99,NaN,NaN,NaN,502.4017387525212,NaN,NaN,505.5505000000006,511.1489855984874,499.95201440151385,497.26626121622644,502.2984738677024,504.77178451450766,499.82516322089714,29516,37809.333333333336,26.20040619077858,31.32656569298436,NaN,NaN,NaN,NaN,1.4319429552090714,25.629969344038688,12227498,-0.4132710741856822,-2.0000004263104074,-1.5867293521247252
2025-09-05T10:40:00-04:00,499.09,499.27,498.5,498.6,NaN,NaN,NaN,502.4017387525212,NaN,NaN,505.3837000000006,511.2948801898204,499.4725198101808,497.26626121622644,502.2330830527419,504.7287589487505,499.7374071567333,16141,37995.96666666667,25.078545723334884,29.587407674061364,NaN,NaN,NaN,NaN,1.3846613155512792,26.61390651393807,12211357,-0.36804273934722764,-2.04678277630876,-1.6787400369615322
2025-09-05T10:45:00-04:00,498.64,498.64,497.25,497.48,NaN,NaN,NaN,501.65319584682203,NaN,NaN,505.20250000000067,511.5033914445745,498.90160855542683,497.26626121622644,502.01402145693294,504.6306288701733,499.39741404369255,44913,39345.066666666666,22.145884184760163,29.733114200588552,NaN,NaN,NaN,NaN,1.3850426501547584,28.13138140873842,12166444,-0.37657211773266375,-2.149455184127362,-1.7728830663946982
2025-09-05T10:50:00-04:00,497.48,497.74,496.9,497.17,NaN,NaN,NaN,500.97418694469377,NaN,NaN,505.02250000000066,511.7051965363161,498.3398034636852,497.26626121622644,501.8447691455926,504.56076941032524,499.1287688808599,33702,40254.1,21.399949672141034,28.83856741992305,NaN,NaN,NaN,NaN,1.3461110322865635,29.69081430574908,12132742,-0.36579807347642346,-2.2301306582402276,-1.8643325847638041
2025-09-05T10:55:00-04:00,497.19,497.4,495.07,495.24,NaN,NaN,NaN,500.0408148108441,NaN,NaN,504.79750000000064,512.004401761268,497.5905982387333,497.26626121622644,501.5973446918625,504.50909715966714,498.6855922240578,41048,41352.166666666664,17.457471353588673,27.385223070917846,NaN,NaN,NaN,NaN,1.416388815694665,31.80080047344814,12091694,-0.44604069866278206,-2.4218834580922817,-1.9758427594294996
2025-09-05T11:00:00-04:00,495.32,495.48,494.55,494.93,NaN,NaN,NaN,498.77464141035114,NaN,NaN,504.56170000000066,512.2565522036762,496.8668477963251,497.26626121622644,501.1632913822559,504.4194557487654,497.9071270157464,69268,43475.933333333334,16.918329426124643,26.093946888139804,NaN,NaN,NaN,NaN,1.381646757430761,33.916266277391,12022426,-0.4747231256013018,-2.569246666431127,-2.094523540829825
2025-09-05T11:05:00-04:00,494.93,495.55,494.59,495.51,NaN,NaN,NaN,498.77464141035114,NaN,NaN,504.33610000000067,512.4085596720215,496.2636403279799,497.06600897298114,500.934118341847,504.3259151111706,497.5423215725234,42286,44599.23333333333,21.785325482392153,25.20327439544504,NaN,NaN,NaN,NaN,1.351529131899995,35.79166775381034,12064712,-0.41170532812201444,-2.609155200982343,-2.1974498728603287
2025-09-05T11:10:00-04:00,495.48,496.21,494.68,496.18,NaN,NaN,NaN,498.77464141035114,NaN,NaN,504.1249000000007,512.4822705168748,495.7675294831267,496.04180717838494,500.7716843236617,504.2319421289036,497.3114265184198,35073,45487.4,27.098153924901013,24.982953263311448,NaN,NaN,NaN,NaN,1.3642770510499933,36.701917454726896,12099785,-0.28783315411618826,-2.557241315505564,-2.269408161389376
2025-09-05T11:15:00-04:00,496.22,497.16,496.1,496.52,NaN,NaN,NaN,498.77464141035114,NaN,NaN,503.91830000000067,512.5036115515078,495.33298844849355,496.0120052753331,500.65512359362134,504.1354706506091,497.1747765366336,32494,46410.333333333336,29.707521169430848,25.027246634250993,NaN,NaN,NaN,NaN,1.3425429759749938,36.473249335609594,12132279,-0.15271601897807363,-2.460303185111968,-2.3075871661338945
2025-09-05T11:20:00-04:00,496.48,497.35,496.39,496.94,NaN,NaN,NaN,498.77464141035114,NaN,NaN,503.7185000000007,512.4773812639679,494.95961873603346,496.0120052753331,500.5830624812817,504.0682694616756,497.09785550088776,22749,46821.23333333333,32.90243041769082,25.077380514100206,NaN,NaN,NaN,NaN,1.3152184776910683,36.057460765230935,12155028,-0.012180339743864899,-2.322812590813726,-2.310632251069861
2025-09-05T11:25:00-04:00,496.89,497.51,496.55,497.11,NaN,NaN,NaN,498.77464141035114,NaN,NaN,503.51410000000067,512.4023636525035,494.62583634749785,496.0120052753331,500.5177726178404,504.00313514506854,497.0324100906123,22402,47040.8,34.20595895543504,25.367879182985458,NaN,NaN,NaN,NaN,1.2898457292845618,35.494226846706326,12177430,0.10845781092915496,-2.1750599874084173,-2.2835177983375723
2025-09-05T11:30:00-04:00,497.14,497.25,496.19,496.67,NaN,NaN,NaN,498.77464141035114,NaN,NaN,503.2969000000007,512.3118690823876,494.2819309176137,495.33860422026646,500.46678714564706,503.95638042045846,496.97719387083566,16392,47185.066666666666,32.4488392142121,25.66019809515259,NaN,NaN,NaN,NaN,1.2734281771928075,35.19682513443647,12161038,0.17112455275722782,-2.0696121073910376,-2.2407366601482654
2025-09-05T11:35:00-04:00,496.78,497.64,496.74,496.97,NaN,NaN,NaN,498.77464141035114,NaN,NaN,503.0903000000007,512.2017939299872,493.97880607001423,494.8806194272123,500.39891302466344,503.88507524488165,496.91275080444524,25360,47620.833333333336,34.904148256820505,26.272795647864182,NaN,NaN,NaN,NaN,1.2517547359647476,34.46290988315823,12186398,0.24100588820995794,-1.939479299885818,-2.180485188095776
2025-09-05T11:40:00-04:00,496.96,497.74,496.94,497.35,NaN,NaN,NaN,498.77464141035114,NaN,NaN,502.88790000000074,512.0507052667327,493.72509473326875,495.13249554176986,500.3442489227283,503.8227467638665,496.8657510815901,22801,47979.9,37.97923580987371,27.159442841534577,NaN,NaN,NaN,NaN,1.219486540538695,33.66278162248088,12209199,0.3163020080346226,-1.7851076780524977,-2.1014096860871203
2025-09-05T11:45:00-04:00,497.33,497.33,496.52,496.86,NaN,NaN,NaN,498.77464141035114,NaN,NaN,502.67890000000074,511.90520614904443,493.45259385095704,495.13249554176986,500.29683895602903,503.7744985883708,496.81917932368725,17806,48029.46666666667,35.641187382270445,27.83378435521257,NaN,NaN,NaN,NaN,1.1916660733573625,33.230735999073644,12191393,0.33480257900061794,-1.6829064623363479,-2.017709041336966
2025-09-05T11:50:00-04:00,496.86,496.9,496.26,496.72,NaN,NaN,NaN,498.77464141035114,NaN,NaN,502.4693000000007,511.7512420401184,493.187357959883,495.13249554176986,500.260078106507,503.7395245865926,496.78063162642144,13075,47493.86666666667,34.97862518225877,28.540932887992845,NaN,NaN,NaN,NaN,1.1522613538318356,33.01795462472425,12178318,0.33830806928891244,-1.5948239547258254,-1.9331320240147378
2025-09-05T11:55:00-04:00,496.74,496.9,496,496.32,NaN,NaN,NaN,498.77464141035114,NaN,NaN,502.2527000000007,511.5928916916227,492.9125083083787,495.13249554176986,500.21162266459197,503.6956838846932,496.72756144449073,16624,44067.36666666667,33.08612043976639,29.322378334779007,NaN,NaN,NaN,NaN,1.1342426857009886,33.008492865646694,12161694,0.31486750480270187,-1.5395476430113604,-1.8544151478140622
2025-09-05T12:00:00-04:00,496.32,496.65,495.78,496.07,NaN,NaN,NaN,498.77464141035114,NaN,NaN,502.0262000000007,511.40578283913476,492.64661716086664,495.13249554176986,500.1791499889948,503.6679219799095,496.6903779980801,10699,41542.666666666664,31.92357364421187,30.07406576135549,NaN,NaN,NaN,NaN,1.1153682081509184,33.15917088036939,12150995,0.2846214711778512,-1.4986383088417483,-1.7832597800195995
2025-09-05T12:05:00-04:00,496.11,496.69,495.8,496.69,NaN,NaN,NaN,498.77464141035114,NaN,NaN,501.81800000000067,511.19998870155933,492.436011298442,495.13249554176986,500.14829814860286,503.6394566752078,496.65713962199794,10950,36478.36666666667,37.763976410778994,31.52453040829766,NaN,NaN,NaN,NaN,1.0992704789972805,33.23663196987937,12161945,0.3065681060180916,-1.400049647496985,-1.7066177535150766
2025-09-05T12:10:00-04:00,496.69,497.17,496.66,496.84,NaN,NaN,NaN,498.77464141035114,NaN,NaN,501.6066000000007,510.9513179602241,492.2618820397773,495.13249554176986,500.12513381329904,503.6146148153056,496.6356528112925,9621,32295.166666666668,39.12470460366254,33.11070006383608,NaN,NaN,NaN,NaN,1.0571797304974742,32.568565350070514,12171566,0.3293845827285402,-1.2948870251044013,-1.6242716078329416
2025-09-05T12:15:00-04:00,496.83,497.03,496.1,496.52,NaN,NaN,NaN,498.77464141035114,NaN,NaN,501.3784000000007,510.65129069039534,492.105509309606,495.13249554176986,500.09425332202255,503.5843465430856,496.6041601009595,11791,30838.033333333333,37.25342306358375,34.21556417677834,NaN,NaN,NaN,NaN,1.0480954640333653,32.42878391331381,12159775,0.32080514597400045,-1.2232651753654409,-1.5440703213394413
2025-09-05T12:20:00-04:00,496.545,497.1,496.39,497.09,NaN,NaN,NaN,498.77464141035114,NaN,NaN,501.1692000000007,510.34719441249877,491.9912055875027,495.13249554176986,500.06402463736873,503.5516825549498,496.57636671978764,12879,29728.633333333335,42.52651290100867,35.317589817928884,NaN,NaN,NaN,NaN,1.0239457880309846,32.189284749904374,12172654,0.3490636481288969,-1.10774076117832,-1.456804409307217
2025-09-05T12:25:00-04:00,497.13,497.15,496.69,496.83,NaN,NaN,NaN,498.77464141035114,NaN,NaN,500.94580000000065,509.9906580661242,491.9009419338771,495.2783547654665,500.0484861875393,503.5346428114412,496.56232956363743,6779,28143.133333333335,40.84054300620243,36.11280566341257,NaN,NaN,NaN,NaN,0.9836639460287699,31.8842462569,12165875,0.34516585171377834,-1.025347094664994,-1.3705129463787724
2025-09-05T12:30:00-04:00,496.87,497.01,496.19,496.25,NaN,NaN,NaN,498.77464141035114,NaN,NaN,500.7170000000007,509.64590609179027,491.7880939082112,495.2783547654665,500.02144330874637,503.5081010098236,496.53478560766916,10584,26763.533333333333,37.28905203838133,36.42613577917618,NaN,NaN,NaN,NaN,0.9719736641695716,32.0542726088059,12155291,0.30010908403724423,-0.9953765913322172,-1.2954856753694615
2025-09-05T12:35:00-04:00,496.27,496.3,495.52,495.58,NaN,NaN,NaN,498.77464141035114,NaN,NaN,500.47800000000063,509.3037931086306,491.65220689137067,495.2783547654665,499.95202682781485,503.45132641201144,496.45272724361826,23328,26517.5,33.64888451330033,36.386344747595125,NaN,NaN,NaN,NaN,0.9582612595860329,32.74143742442846,12131963,0.2251890217183461,-1.0139993982215287,-1.2391884199398748
2025-09-05T12:40:00-04:00,495.5,496.01,495.35,495.48,NaN,NaN,NaN,498.6643624249792,NaN,NaN,500.2362000000007,508.93306370113885,491.5393362988625,495.2783547654665,499.8775249393,503.3921403062021,496.3629095723978,24786,26144.4,33.129057329038446,36.43493175579701,NaN,NaN,NaN,NaN,0.936956883901314,33.50400787924927,12107177,0.17134147537654743,-1.0250115757191907,-1.196353051095738
2025-09-05T12:45:00-04:00,495.46,495.53,494.17,494.24,NaN,NaN,NaN,497.8841641329347,NaN,NaN,499.97500000000065,508.59167615710277,491.3583238428985,495.2783547654665,499.6788941955759,503.2681859770574,496.0896024140944,56975,27097.766666666666,27.463414248363733,35.90345075519296,NaN,NaN,NaN,NaN,0.9671742493369314,34.95004109808258,12050202,0.06038189253149295,-1.120875685431372,-1.181257577962865
2025-09-05T12:50:00-04:00,494.23,494.84,494,494.56,NaN,NaN,NaN,497.4307930359831,NaN,NaN,499.7182000000007,508.19868648581644,491.237713514185,495.2783547654665,499.59443574498107,503.2148423157754,495.97402917418674,24713,26662.366666666665,30.75453954990698,35.38740102233819,NaN,NaN,NaN,NaN,0.9580903743842917,36.383794269419944,12074915,0.018860209343390943,-1.1576823162836263,-1.1765425256270172
2025-09-05T12:55:00-04:00,494.56,495.24,494.43,495.14,NaN,NaN,NaN,497.4307930359831,NaN,NaN,499.47900000000067,507.7860632594402,491.17193674056114,495.2783547654665,499.5191184796559,503.1578727338732,495.8803642254386,25067,25357.866666666665,36.38816452637246,35.44075653263119,NaN,NaN,NaN,NaN,0.9475124904996995,36.992632293361964,12099982,0.03958709802921323,-1.1270586530905007,-1.166645751119714
2025-09-05T13:00:00-04:00,495.12,495.12,494.33,494.41,NaN,NaN,NaN,497.4307930359831,NaN,NaN,499.22820000000064,507.3735060738339,491.0828939261674,495.2783547654665,499.4803471442251,503.13057862682393,495.8301156616263,12366,24739.6,32.77401719372983,35.283284533450555,NaN,NaN,NaN,NaN,0.9376901697497211,37.62591778861517,12087616,0.014552281250619359,-1.1484553995564397,-1.163007680807059
2025-09-05T13:05:00-04:00,494.47,494.97,493.99,494.97,NaN,NaN,NaN,497.4307930359831,NaN,NaN,498.99560000000065,506.9474995564869,491.0437004435144,495.2783547654665,499.40610256659085,503.07669968771205,495.73550544546964,24358,24567.666666666668,37.87183250602175,35.62512110961165,NaN,NaN,NaN,NaN,0.9407123004818851,38.4438903785751,12111974,0.04443889923434474,-1.107459056764128,-1.1518979559984728
2025-09-05T13:10:00-04:00,495,495.22,494.67,495.2,NaN,NaN,NaN,497.4307930359831,NaN,NaN,498.7640000000007,506.4661378847734,491.061862115228,495.2783547654665,499.3529253520314,503.03252324605035,495.6733274580124,19521,24680.333333333332,39.88802694613239,36.1940106311774,NaN,NaN,NaN,NaN,0.912804279018894,38.72466352823142,12131495,0.08602138832178063,-1.044371220596247,-1.1303926089180276
2025-09-05T13:15:00-04:00,495.12,495.25,494.515,494.78,NaN,NaN,NaN,497.4307930359831,NaN,NaN,498.5234000000007,505.9518659086456,491.09493409135587,495.1026838123732,499.2742503662602,502.9690002114575,495.5795005210629,28556,24135.1,37.49512546937935,36.174806992506,NaN,NaN,NaN,NaN,0.9001039733746883,39.10534817094985,12102939,0.09107725841484893,-1.0165460358994665,-1.1076232943143154
2025-09-05T13:20:00-04:00,494.8,495,494.68,494.93,NaN,NaN,NaN,497.4307930359831,NaN,NaN,498.2874000000006,505.40108125209593,491.1737187479053,494.38414704989856,499.2405873640258,502.94112293179194,495.5400517962597,12593,23431.466666666667,38.90479096697081,36.15909887559945,NaN,NaN,NaN,NaN,0.8586679752764957,39.4588410534741,12115532,0.10914239917680679,-0.971195295343307,-1.0803376945201137
2025-09-05T13:25:00-04:00,494.98,494.98,494.32,494.56,NaN,NaN,NaN,497.3942255838797,NaN,NaN,498.0510000000006,504.8519696364815,491.2500303635197,494.14731763991887,499.18749631515766,502.89951888188585,495.47547374842947,19151,22701.566666666666,36.705759014079916,36.11998001492061,NaN,NaN,NaN,NaN,0.8444774056138906,40.07797622747762,12096381,0.10098055144245799,-0.9541120052170413,-1.0550925566594993
2025-09-05T13:30:00-04:00,494.56,495,494.43,494.97,NaN,NaN,NaN,497.3942255838797,NaN,NaN,497.80340000000064,504.1160585331513,491.49074146684995,493.3598541119351,499.15145475797596,502.8693513081387,495.43355820781323,13805,20852.8,40.70530857691671,35.989893991771176,NaN,NaN,NaN,NaN,0.8248718766414694,40.60700754078884,12110186,0.1263556156396335,-0.8971480371099574,-1.0235036527495909
2025-09-05T13:35:00-04:00,494.94,495.3,494.76,494.77,NaN,NaN,NaN,497.3942255838797,NaN,NaN,497.54340000000064,503.23275231429915,491.85404768570214,493.6975179730203,499.10521093060953,502.8285582269622,495.3818636342569,18673,20065.7,39.39749361118914,35.88681903498451,NaN,NaN,NaN,NaN,0.8045238854527945,40.408633548449316,12091513,0.13220399878606037,-0.8582486542670154,-0.9904526530530757
2025-09-05T13:40:00-04:00,494.76,494.83,493.84,494,NaN,NaN,NaN,496.9978759515693,NaN,NaN,497.2822000000006,502.366984030459,492.19741596954225,493.6975179730203,499.0457682817674,502.7849087037971,495.30662785973766,20945,19594.766666666666,34.76624165383032,35.70661829323087,NaN,NaN,NaN,NaN,0.8177721793490241,41.01382222145387,12070568,0.0888294666046987,-0.8794158197972024,-0.9682452864019011
2025-09-05T13:45:00-04:00,493.96,494.21,493.81,493.89,NaN,NaN,NaN,496.60638159013433,NaN,NaN,497.1410000000006,502.20258275606807,492.0794172439331,493.6975179730203,498.9901259774217,502.7460860549013,495.2341658999421,19066,19147.166666666668,34.148665951831006,35.74231696741163,NaN,NaN,NaN,NaN,0.7879313093955208,41.598435120873575,12051502,0.05879392714901299,-0.8947528774656348,-0.9535468046146478
2025-09-05T13:50:00-04:00,493.92,493.93,493.35,493.51,NaN,NaN,NaN,496.19745515421914,NaN,NaN,496.9522000000006,501.83402472407624,492.0703752759249,493.6975179730203,498.9403370889141,502.7143353319278,495.1663388459003,16205,18929.033333333333,32.031818117009664,35.663942737981,NaN,NaN,NaN,NaN,0.7730790730101254,42.478475872357194,12035297,0.021328750040642164,-0.9268858670638451,-0.9482146171044873
2025-09-05T13:55:00-04:00,493.5,493.71,493.37,493.53,NaN,NaN,NaN,496.0275708290273,NaN,NaN,496.7504000000006,501.33837028723616,492.162429712765,493.6975179730203,498.88116928076073,502.6763412119993,495.0859973495222,19434,18830.1,32.26979205094605,36.00725543816546,NaN,NaN,NaN,NaN,0.7421448535094004,43.295656570163416,12054731,0.006649259471251834,-0.9399030427654225,-0.9465523022366743
2025-09-05T14:00:00-04:00,493.56,493.66,493.02,493.07,NaN,NaN,NaN,495.8017721549807,NaN,NaN,496.55640000000056,500.9248903750289,492.18790962497224,493.6975179730203,498.82656197679705,502.6433901319411,495.009733821653,17380,18863.033333333333,29.6945775585408,35.93154386735359,NaN,NaN,NaN,NaN,0.7348487925444463,44.30390790571529,12037351,-0.023626714695053286,-0.9760856956054909,-0.9524589809104376
2025-09-05T14:05:00-04:00,493.09,493.37,492.88,492.88,NaN,NaN,NaN,495.54169160248154,NaN,NaN,496.3632000000006,500.5046247592495,492.22177524075164,493.6975179730203,498.76264341818427,502.6061748536671,494.91911198270145,20030,18685.366666666665,28.67662909142868,35.38071990771475,NaN,NaN,NaN,NaN,0.7173595930769866,45.33631019783762,12017321,-0.04480652673858976,-1.0084671393336748,-0.9636606125950851
2025-09-05T14:10:00-04:00,492.88,493.73,492.84,493.73,NaN,NaN,NaN,495.54169160248154,NaN,NaN,496.21420000000063,500.18423393390947,492.2441660660918,493.6975179730203,498.70193292744017,502.56513172854847,494.8387341263319,20883,18621.433333333334,38.786505019006185,35.81018332380591,NaN,NaN,NaN,NaN,0.7296910507143478,45.38214826449307,12038204,0.007297733668002793,-0.9545384455100816,-0.9618361791780844
2025-09-05T14:15:00-04:00,493.74,494.3,493.59,494.3,NaN,NaN,NaN,495.54169160248154,NaN,NaN,496.0846000000006,499.8686976938323,492.3005023061689,493.6975179730203,498.6338719662248,502.5089719388272,494.75877199362236,27298,18937.833333333332,44.47079273289062,36.281537625725115,NaN,NaN,NaN,NaN,0.7282845470918969,44.166258942901436,12065502,0.08471806062903409,-0.8559386033917917,-0.9406566640208258
2025-09-05T14:20:00-04:00,494.34,494.73,494.19,494.21,NaN,NaN,NaN,495.54169160248154,NaN,NaN,495.94380000000064,499.46327698335705,492.4243230166442,493.6975179730203,498.58851068212215,502.4676152211014,494.70940614314287,20037,19169.9,43.77951564083515,36.55950110391817,NaN,NaN,NaN,NaN,0.7148356508710486,42.21850213704371,12045465,0.13163475846586525,-0.7761132159384942,-0.9077479744043595
2025-09-05T14:25:00-04:00,494.27,494.7,494.19,494.61,NaN,NaN,NaN,495.54169160248154,NaN,NaN,495.8246000000006,499.1048541603365,492.5443458396647,493.19131110718234,498.5529510687001,502.43376270416564,494.6721394332346,16499,19165.733333333334,47.672723493897735,37.286472391383775,NaN,NaN,NaN,NaN,0.7002045329516874,40.40987081731867,12061964,0.1879435547235182,-0.6728185309999617,-0.8607620857234799
2025-09-05T14:30:00-04:00,494.65,494.73,493.12,493.19,NaN,NaN,NaN,495.54169160248154,NaN,NaN,495.6894000000006,498.83276230118804,492.54603769881317,493.19131110718234,498.47402748886753,502.3721210964374,494.57593388129766,31230,19850.1,37.693577023356106,37.199957109697,NaN,NaN,NaN,NaN,0.7651899234551393,39.94668392065307,12030734,0.13061082664394286,-0.6974985524185513,-0.8281093790624942
2025-09-05T14:35:00-04:00,493.18,493.425,492.41,492.78,NaN,NaN,NaN,495.3975468976241,NaN,NaN,495.56100000000055,498.6441808245236,492.4778191754775,493.19131110718234,498.2902334254769,502.25161379621653,494.3288530547373,65404,21665.233333333334,35.39009235818918,37.10598091999053,NaN,NaN,NaN,NaN,0.7830335003511998,40.11936769870062,11965330,0.06921342101787598,-0.7415926027901492,-0.8108060238080251
2025-09-05T14:40:00-04:00,492.84,493.2,492.7,493.07,NaN,NaN,NaN,495.38549931136845,NaN,NaN,495.44420000000065,498.452617762916,492.4357822370853,493.19131110718234,498.2502203032137,502.2231970741108,494.2772435323167,15165,21850.033333333333,38.26388920398956,36.9315938219243,NaN,NaN,NaN,NaN,0.7628168217546856,40.279716921173346,11980495,0.053001520994301554,-0.7445541225651482,-0.7975556435594497
2025-09-05T14:45:00-04:00,493.05,493.05,492.53,492.7,NaN,NaN,NaN,495.1884311608517,NaN,NaN,495.3184000000006,498.24823101159564,492.3885689884056,493.19131110718234,498.1732307480621,502.17072489062343,494.1757366055008,28570,22409.333333333332,36.06008934226362,36.693207802715335,NaN,NaN,NaN,NaN,0.7469013344864953,40.56962053299657,11951925,0.023720415774677095,-0.7679051238411034,-0.7916255396157805
2025-09-05T14:50:00-04:00,492.79,493.75,492.79,493.7,NaN,NaN,NaN,495.1884311608517,NaN,NaN,495.2204000000006,498.0299407732613,492.41085922673994,493.19131110718234,498.1275294502538,502.13277296319984,494.12228593730777,19751,22638.4,45.23983681186854,37.44132174257521,NaN,NaN,NaN,NaN,0.7685512391660322,39.47938243216181,11971676,0.07515888565553808,-0.6976769325463579,-0.772835818201896
2025-09-05T14:55:00-04:00,493.7,493.87,493.08,493.19,NaN,NaN,NaN,495.1884311608517,NaN,NaN,495.13460000000055,497.92483500026765,492.34436499973344,493.19131110718234,498.0800517110361,502.0931172986798,494.06698612339244,20780,23105.1,41.9333053099654,37.99736741101338,NaN,NaN,NaN,NaN,0.7700832935113171,38.25431635735263,11950896,0.07795835715406674,-0.6753878717593125,-0.7533462289133792
2025-09-05T15:00:00-04:00,493.14,493.16,492.38,492.51,NaN,NaN,NaN,495.1884311608517,NaN,NaN,495.0414000000006,497.86457554476266,492.2182244552385,493.19131110718234,497.96062338278,502.0076666938,493.91358007176,47024,24319.766666666666,37.950471120086334,38.42012833980457,NaN,NaN,NaN,NaN,0.7729344868319374,37.83741934749755,11903872,0.03909840812431731,-0.7044732187579825,-0.7435716268822998
2025-09-05T15:05:00-04:00,492.5,493.16,492.45,493.04,NaN,NaN,NaN,495.1884311608517,NaN,NaN,494.99740000000054,497.8748761435631,492.119923856438,493.19131110718234,497.89335909669126,501.9552024084733,493.8315157849092,28529,24493.133333333335,42.53200415517673,39.153143490106764,NaN,NaN,NaN,NaN,0.7684391663439445,37.45030069548926,11932401,0.053294504164182244,-0.676953496677072,-0.7302480008412543
2025-09-05T15:10:00-04:00,493.07,493.31,492.895,493.21,NaN,NaN,NaN,495.1884311608517,NaN,NaN,494.96300000000053,497.88367731815833,492.04232268184273,493.19131110718234,497.8363552917427,501.9068085118545,493.7659020716309,26129,24537.9,43.96128713054984,40.172194173821694,NaN,NaN,NaN,NaN,0.7431935116050928,36.79504471076495,11958530,0.07690509064519557,-0.6341166375347598,-0.7110217281799553
2025-09-05T15:15:00-04:00,493.2,493.53,492.96,493.39,NaN,NaN,NaN,495.1884311608517,NaN,NaN,494.92060000000055,497.8696972443568,491.9715027556443,492.7180488857459,497.77915404152515,501.8554965981598,493.7028114848905,27793,23565.166666666668,45.50669660986818,41.37434185371023,NaN,NaN,NaN,NaN,0.7308225464904429,35.75531163736987,11986323,0.10564168576811228,-0.578969620969815,-0.6846113067379272
2025-09-05T15:20:00-04:00,493.49,494.95,493.49,494.93,NaN,NaN,NaN,495.1884311608517,NaN,NaN,494.8956000000006,497.8226795268095,491.96852047319175,492.8117795531182,497.7360698380886,501.8033028676587,493.6688368085185,29000,23708.066666666666,56.547548881968595,42.64298784392183,NaN,NaN,NaN,NaN,0.7900495074554115,33.76536604415788,12015323,0.2226359880201183,-0.4063163217127794,-0.6289523097328977
2025-09-05T15:25:00-04:00,494.98,495.13,494.45,494.46,NaN,NaN,NaN,495.1884311608517,NaN,NaN,494.8544000000006,497.7466466278535,491.9621533721477,493.07942364249453,497.6911603058289,501.7451115642079,493.63720904744986,33354,23984.3,53.01704417436077,43.25343437545541,NaN,NaN,NaN,NaN,0.782188828351454,32.131751848320924,11981969,0.26003453989193503,-0.303909134867979,-0.563943674759914
2025-09-05T15:30:00-04:00,494.495,494.53,493.38,493.46,NaN,NaN,NaN,495.1884311608517,NaN,NaN,494.78480000000053,497.6401955657093,491.92940443429177,493.07942364249453,497.61502126295915,501.66533005504436,493.5647124708739,45180,25078.1,46.381792980246686,43.43931132827053,NaN,NaN,NaN,NaN,0.8084610548977771,30.424625802424295,11936789,0.21116749042480643,-0.29998431172890605,-0.5111518021537125
2025-09-05T15:35:00-04:00,493.46,493.97,493.31,493.32,NaN,NaN,NaN,495.1884311608517,NaN,NaN,494.7090000000006,497.51425007734747,491.9037499226537,493.07942364249453,497.56829736457314,501.6186972495705,493.51789747957577,26806,25159.7,45.52281178612783,43.28574620628695,NaN,NaN,NaN,NaN,0.797856693833652,28.918132297337245,11909983,0.16519442222050335,-0.3046587743780833,-0.46985319659858665
2025-09-05T15:40:00-04:00,493.35,493.83,493.07,493.72,NaN,NaN,NaN,495.1884311608517,NaN,NaN,494.6500000000005,497.41154159786015,491.8884584021408,493.07942364249453,497.500821382339,501.55028989791396,493.451352866764,39893,25838.766666666666,48.45977861439123,44.05476060564661,NaN,NaN,NaN,NaN,0.7951526442741048,27.79413756945258,11949876,0.15753025656617425,-0.27294037589086884,-0.4304706324570431
2025-09-05T15:45:00-04:00,493.71,493.97,493.56,493.66,NaN,NaN,NaN,495.1884311608517,NaN,NaN,494.58380000000056,497.27757026426065,491.8900297357405,493.07942364249453,497.4460373164034,501.4912239710868,493.40085066172,35111,26057.266666666666,48.04139381355982,44.958424995315944,NaN,NaN,NaN,NaN,0.7676417411116706,26.540453365200133,11914765,0.14456396841541042,-0.2497656719377801,-0.3943296403531905
2025-09-05T15:50:00-04:00,493.66,494.48,493.5,494.15,NaN,NaN,NaN,495.1884311608517,NaN,NaN,494.5198000000005,497.097186241292,491.942413758709,493.07942364249453,497.32565270214513,501.3480585284752,493.3032468758151,88637,28592.066666666666,51.70827395514194,45.918738191826826,NaN,NaN,NaN,NaN,0.782810188175124,24.648159780972282,12003402,0.16372435142716213,-0.18967420106923782,-0.35339855249639995
2025-09-05T15:55:00-04:00,494.68,495.61,494.08,495.06,492.3682818517962,492.3682818517962,492.3682818517962,NaN,NaN,NaN,494.4838000000005,496.97838578457146,491.9892142154295,493.26610971133806,497.1685439011565,501.10279485170935,493.2342929506037,174793,33780.13333333333,57.68138590126107,47.463116517469494,NaN,NaN,NaN,NaN,0.8361808890197601,24.17590622732742,12178195,0.2284469484764478,-0.0678398669008402,-0.296286815377288
2025-09-08T09:30:00-04:00,498.105,498.41,495.05,497.65,493.8776502818222,NaN,NaN,NaN,NaN,NaN,494.5024000000005,497.0760186502016,491.92878134979935,494.85488776907044,497.0366666666667,497.0366666666667,497.0366666666667,87757,36245.2,69.31465922188357,49.18274668961343,NaN,NaN,NaN,NaN,1.0164536826612067,25.642450056158456,12265952,0.4250271915194292,0.2349971740219985,-0.1900300174974307
2025-09-08T09:35:00-04:00,497.6,499.43,496.98,497.35,495.14821163264844,NaN,NaN,NaN,NaN,NaN,494.5230000000005,497.16992803010436,491.8760719698966,495.36091021525635,497.46416862675926,497.9056080965602,497.02272915695835,82303,38366.2,67.0166110319308,50.97441138403953,NaN,NaN,NaN,NaN,1.1188498481854054,27.45134186107579,12183649,0.5085464200137007,0.44565300751969517,-0.06289341249400551
2025-09-08T09:40:00-04:00,497.44,499.55,497.44,498.4,495.2771565584371,NaN,NaN,NaN,NaN,NaN,494.5696000000005,497.3995426419219,491.73965735807906,495.36091021525635,497.64065344256056,498.19349987543916,497.08780700968197,36482,38884.1,70.68050766811578,53.3122711374702,NaN,NaN,NaN,NaN,1.1960748590293042,29.180550425570495,12220131,0.6018177449723563,0.6893787687214399,0.08756102374908356
2025-09-08T09:45:00-04:00,498.37,499.25,498.19,499.24,495.5038767148718,NaN,NaN,NaN,NaN,NaN,494.6206000000005,497.68384901969324,491.5573509803077,495.36091021525635,497.84548725550155,498.53126888374453,497.1597056272586,40375,39594.4,73.24137134258652,55.50579736514233,NaN,NaN,NaN,NaN,1.1863552262414971,30.786244092601294,12260506,0.6815386843097073,0.9394843791362177,0.2579456948265104
2025-09-08T09:50:00-04:00,499.28,500.21,498.7,500.01,496.179155046014,NaN,NaN,NaN,NaN,NaN,494.6840000000004,498.04510219968216,491.3228978003187,496.24362603021126,498.2558838988866,499.22065250036945,497.2911152974038,73212,41494.63333333333,75.36545078459062,57.74895191185953,NaN,NaN,NaN,NaN,1.2094727100813896,32.677695012391546,12333718,0.7425668000917028,1.186154194941139,0.4435873948494361
2025-09-08T09:55:00-04:00,500.02,500.02,498.71,498.795,496.179155046014,NaN,NaN,NaN,NaN,NaN,494.7295000000005,498.24675475288683,491.21224524711414,496.24362603021126,498.33225577609755,499.2902742929335,497.37423725926163,29011,41813.86666666667,66.40776175097434,59.24188513622425,NaN,NaN,NaN,NaN,1.2166532307898617,34.43404229505392,12304707,0.6603088989145317,1.2689735184926008,0.608664619578069
2025-09-08T10:00:00-04:00,498.76,499.44,498.5,498.76,496.179155046014,NaN,NaN,NaN,NaN,NaN,494.7629000000005,498.39889454849043,491.1269054515106,496.24362603021126,498.3601879644306,499.3023786104003,497.41799731846095,18066,41836.73333333333,66.16380065542546,59.92876026289974,NaN,NaN,NaN,NaN,1.1968922857334428,35.74386340365538,12286641,0.5663540590807734,1.3166071934290358,0.7502531343482624
2025-09-08T10:05:00-04:00,498.66,499.11,498.3,498.96,496.179155046014,NaN,NaN,NaN,NaN,NaN,494.80550000000045,498.5844703619919,491.026529638009,496.24362603021126,498.3837693146507,499.3049632900399,497.4625753392615,21316,41879.6,66.91183417726964,60.921245263107515,NaN,NaN,NaN,NaN,1.1692571224667685,36.64934329689769,12307957,0.4836993881963798,1.354877369593737,0.8711779813973572
2025-09-08T10:10:00-04:00,498.96,499.15,498.61,498.85,496.179155046014,NaN,NaN,NaN,NaN,NaN,494.8575000000005,498.7832499915842,490.9317500084168,496.2952132219745,498.41149630152813,499.3131173421398,497.5098752609165,23495,41966.666666666664,66.04698602419248,62.32590190910365,NaN,NaN,NaN,NaN,1.124310185147711,37.51260810585734,12284462,0.3915744141854207,1.360645999129133,0.9690715849437124
2025-09-08T10:15:00-04:00,498.89,499.12,498.35,498.5,496.179155046014,NaN,NaN,NaN,NaN,NaN,494.91590000000053,498.96775571762845,490.8640442823726,496.45117057757966,498.4285562626225,499.3004769630405,497.5566355622045,30814,42083.86666666667,63.245882086546956,63.59183550199072,NaN,NaN,NaN,NaN,1.099002314780016,37.879366293329355,12253648,0.2821342643983884,1.321739415441698,1.0396051510433095
2025-09-08T10:20:00-04:00,498.5,499.8,498.37,499.7,496.179155046014,NaN,NaN,NaN,NaN,NaN,495.0003000000005,499.26581211890857,490.7347878810924,496.9499364620637,498.46572959566595,499.3364075999628,497.5950515913691,19971,42081.666666666664,68.2220990983294,65.00342982227203,NaN,NaN,NaN,NaN,1.122645006581444,38.64338533695815,12273619,0.26585266923766104,1.3719209875903857,1.1060683183527247
2025-09-08T10:25:00-04:00,499.71,500.65,499.65,500.6,496.9740011996198,NaN,NaN,NaN,NaN,NaN,495.1275000000005,499.6653586355813,490.5896413644197,497.86994916965097,498.60373557729145,499.57076129575466,497.6367098588282,37653,42786.8,71.35461911831524,66.66866020118313,NaN,NaN,NaN,NaN,1.1138846489684837,39.801514027926515,12311272,0.28906332830299664,1.4673974787314705,1.178334150428474
2025-09-08T10:30:00-04:00,500.59,500.86,499.81,500.22,497.1601829632735,NaN,NaN,NaN,NaN,NaN,495.2407000000005,499.9935753440909,490.4878246559101,498.1109593357208,498.70579570853556,499.72615222292194,497.6854391941492,32106,42816,68.29354344273196,67.85332230743956,NaN,NaN,NaN,NaN,1.10932145975645,40.97841636320895,12279166,0.2534647826398404,1.4951651287282743,1.241700346088434
2025-09-08T10:35:00-04:00,500.33,500.76,500.03,500.4,497.26494737403374,NaN,NaN,NaN,NaN,NaN,495.34590000000054,500.31321464238687,490.3785853576142,498.1957674685766,498.76104126668724,499.80864418001886,497.7134383533556,17988,41235.46666666667,68.97254645346604,68.6598337754542,NaN,NaN,NaN,NaN,1.0822270697738479,42.07125424597121,12297154,0.21803209559154935,1.5142404655778705,1.2962083699863212
2025-09-08T10:40:00-04:00,500.37,500.84,500.12,500.39,497.39404067521406,NaN,NaN,NaN,NaN,NaN,495.46550000000053,500.621308471679,490.30969152832205,498.42861397486126,498.8080032639055,499.8776143055354,497.7383922222756,15746,41254.833333333336,68.88428799391674,68.62909297345657,NaN,NaN,NaN,NaN,1.0563537076471423,43.12886795492812,12281408,0.17193851014005435,1.5111315076613892,1.3391929975213348
2025-09-08T10:45:00-04:00,500.42,500.83,500.21,500.42,497.48976609906794,NaN,NaN,NaN,NaN,NaN,495.57450000000057,500.91106827900666,490.2379317209945,498.590891179889,498.84612738118875,499.93269490049886,497.75955986187864,13160,40741.166666666664,69.01239533797607,68.77164899531695,NaN,NaN,NaN,NaN,1.0251855856723469,44.11093782753096,12294568,0.12374000592933698,1.493868004933006,1.370127999003669
2025-09-08T10:50:00-04:00,500.47,500.69,499.97,500.41,497.48976609906794,NaN,NaN,NaN,NaN,NaN,495.67870000000056,501.1827780550849,490.1746219449162,498.590891179889,498.88492643172583,499.98374669865643,497.7861061647952,15276,40592,68.9105494672004,68.64522340953728,NaN,NaN,NaN,NaN,1.003386615267177,44.512457219067656,12279292,0.07391408959811252,1.4625206110013096,1.388606521403197
2025-09-08T10:55:00-04:00,500.41,500.65,500.11,500.2,497.48976609906794,NaN,NaN,NaN,NaN,NaN,495.7871000000006,501.427900683988,490.14629931601314,498.658970355129,498.91026106162303,500.01561430007956,497.8049078231665,10688,40255.6,66.68494442836153,68.17690720137836,NaN,NaN,NaN,NaN,0.9702875713195189,44.885296654066,12268604,0.012748101820426516,1.4045416486787303,1.3917935468583038
2025-09-08T11:00:00-04:00,500.165,500.75,499.72,500.36,497.48976609906794,NaN,NaN,NaN,NaN,NaN,495.8957000000005,501.67372734822453,490.11767265177645,498.658970355129,498.95860165789566,500.07318538097144,497.8440179348199,22204,39428.26666666667,67.5450055063702,67.61830396721976,NaN,NaN,NaN,NaN,0.9745527447966943,44.38598751276777,12290808,-0.02873572078510267,1.3558738958769254,1.384609616662028
2025-09-08T11:05:00-04:00,500.34,500.34,499.76,500.02,497.48976609906794,NaN,NaN,NaN,NaN,NaN,496.0049000000005,501.8833319301033,490.12646806989767,498.658970355129,498.9911813566491,500.1043030576463,497.87805965565195,19496,39127.166666666664,63.77712347229296,67.43040123302822,NaN,NaN,NaN,NaN,0.9477989773112178,43.92234331013369,12271312,-0.08755183042639691,1.275169828629032,1.362721659055429
2025-09-08T11:10:00-04:00,500.01,500.79,500,500.24,497.5342708317104,NaN,NaN,NaN,NaN,NaN,496.1103000000005,502.0986828899584,490.1219171100426,498.80599282182607,499.0224580944446,500.1412486272038,497.9036675616853,15323,38766.96666666667,65.13248002990557,67.35673547406252,NaN,NaN,NaN,NaN,0.9365276217889893,43.91621897148372,12286635,-0.11821080407373019,1.2149581539632663,1.3331689580369965
2025-09-08T11:15:00-04:00,500.17,500.5,499.69,499.75,497.5342708317104,NaN,NaN,NaN,NaN,NaN,496.2099000000005,502.27101623026016,490.1487837697409,498.80599282182607,499.04529097850957,500.16027410321675,497.9303078538024,16182,38379.933333333334,59.76834231352818,66.84648605522383,NaN,NaN,NaN,NaN,0.9274899345183474,43.229645915845076,12270453,-0.1746553512907698,1.1148497689235342,1.289505120214304
2025-09-08T11:20:00-04:00,499.72,500.25,499.39,500.1,497.5342708317104,NaN,NaN,NaN,NaN,NaN,496.33190000000053,502.4554228060853,490.20837719391574,498.80599282182607,499.06045646799134,500.1714929432923,497.94941999269037,12067,37815.5,62.16524227906685,66.56921864485773,NaN,NaN,NaN,NaN,0.922669224909895,41.972339497236526,12282520,-0.19029796755480932,1.0516326607707924,1.2419306283256017
2025-09-08T11:25:00-04:00,500.19,500.68,500.19,500.66,497.6552326420427,NaN,NaN,NaN,NaN,NaN,496.46730000000053,502.6677648887506,490.2668351112505,498.80599282182607,499.08367202900195,500.20069716287793,497.96664689512596,11242,37078.433333333334,65.68763151270684,66.74362931815485,NaN,NaN,NaN,NaN,0.8981928517020442,41.28657212840241,12293762,-0.16571127520644247,1.0347915343175487,1.2005028095239911
2025-09-08T11:30:00-04:00,500.635,500.78,500.35,500.42,497.85294934013166,NaN,NaN,NaN,NaN,NaN,496.6055000000005,502.844059528988,490.36694047101304,499.03779065981996,499.107063236923,500.22971641242816,497.98441006141786,11648,35960.7,62.98139014667958,66.36929296446557,NaN,NaN,NaN,NaN,0.8647505051518946,40.75705961000685,12282114,-0.16787494816954474,0.9906591243120602,1.158534072481605
2025-09-08T11:35:00-04:00,500.425,500.65,500.11,500.62,497.85294934013166,NaN,NaN,NaN,NaN,NaN,496.74730000000056,503.0219949596376,490.47260504036353,499.03779065981996,499.128967291399,500.25551071658504,498.002423866213,11743,35458.6,64.30128385941264,65.86548330311538,NaN,NaN,NaN,NaN,0.8415540404981853,39.74632111940955,12293857,-0.15822941551283853,0.9607473030905567,1.1189767186033952
2025-09-08T11:40:00-04:00,500.59,501.195,500.59,500.9,498.26860673346704,NaN,NaN,NaN,NaN,NaN,496.9039000000006,503.19448766384306,490.6133123361581,499.5614860222848,499.19138793944234,500.34489743464036,498.0378784442443,26576,35014.7,66.12242612751993,65.71040349488597,NaN,NaN,NaN,NaN,0.8246573233197447,39.422117614087014,12320433,-0.13622168636643694,0.9486996106453489,1.0849212970117859
2025-09-08T11:45:00-04:00,500.9,501.12,500.24,500.32,498.26860673346704,NaN,NaN,NaN,NaN,NaN,497.0527000000005,503.3073914261865,490.79800857381457,499.5614860222848,499.2191238703435,500.3770570876568,498.06119065303017,15553,34362.76666666667,59.36646542224574,65.0242548497988,NaN,NaN,NaN,NaN,0.8286103716540484,38.39702834959793,12304880,-0.16219196758890786,0.8821813375256511,1.044373305114559
2025-09-08T11:50:00-04:00,500.34,500.6,500.27,500.39,498.26860673346704,NaN,NaN,NaN,NaN,NaN,497.18590000000063,503.43553797001374,490.9362620299875,499.5614860222848,499.24281624023877,500.4013698486577,498.08426263181985,15446,31923.066666666666,59.89900055112981,64.38244860388545,NaN,NaN,NaN,NaN,0.7929953451073335,37.44515974685806,12320326,-0.17502138138288315,0.8255965783859551,1.0006179597688383
2025-09-08T11:55:00-04:00,500.4,500.78,500.39,500.41,498.26860673346704,NaN,NaN,NaN,NaN,NaN,497.30810000000065,503.5661792225811,491.0500207774202,499.5614860222848,499.26884509865266,500.4297815051952,498.10790869211013,16201,26636.666666666668,60.060060553354816,63.74299611926964,NaN,NaN,NaN,NaN,0.7642099633139515,36.79036321042366,12336527,-0.1817337890423627,0.773450723465885,0.9551845125082477
2025-09-08T12:00:00-04:00,500.4,500.4,499.95,500.22,498.26860673346704,NaN,NaN,NaN,NaN,NaN,497.4283000000006,503.6745979785197,491.1820020214815,499.5614860222848,499.2788640593713,500.4374161255711,498.1203119931715,8787,24004.333333333332,57.68957070496641,62.941497636252926,NaN,NaN,NaN,NaN,0.7424806802201004,35.25446707890358,12327740,-0.19724780159712707,0.7086247605118388,0.9058725621089658
2025-09-08T12:05:00-04:00,500.24,500.24,499.38,499.44,498.26860673346704,NaN,NaN,NaN,NaN,NaN,497.52490000000057,503.7431989600423,491.3066010399588,499.5614860222848,499.2884906216399,500.4349595731362,498.14202167014355,19532,21911.966666666667,49.118701015489606,61.68676596390493,NaN,NaN,NaN,NaN,0.750874917347237,32.808901210831145,12308208,-0.25466807342453257,0.5875374703283001,0.8422055437528326
2025-09-08T12:10:00-04:00,499.41,499.68,499.155,499.23,498.26860673346704,NaN,NaN,NaN,NaN,NaN,497.6457000000006,503.75619523659316,491.53520476340805,499.5614860222848,499.28918282361843,500.4296901578657,498.14867548937116,8702,20985.966666666667,47.09023463209288,60.22571090145656,NaN,NaN,NaN,NaN,0.7347409946795797,30.753512285309398,12299506,-0.2983878027436899,0.46922079032322017,0.7676085930669101
2025-09-08T12:15:00-04:00,499.22,499.22,498.93,499.17,498.26860673346704,NaN,NaN,NaN,NaN,NaN,497.7735000000006,503.7371144238705,491.8098855761307,499.5614860222848,499.2866585657553,500.41945220672727,498.15386492478336,11726,20031,46.49937449400642,58.99158597443609,NaN,NaN,NaN,NaN,0.7036880664881819,29.195125358742363,12287780,-0.32097570125522434,0.36638896649787966,0.687364667753104
2025-09-08T12:20:00-04:00,499.23,499.4,498.64,498.695,498.26860673346704,NaN,NaN,NaN,NaN,NaN,497.8860000000006,503.70082347080097,492.0711765292002,499.5614860222848,499.2819945623792,500.40848843032364,498.1555006944348,10678,17946.533333333333,42.0058168771784,57.33968146352701,NaN,NaN,NaN,NaN,0.7077103474533112,28.178752215835225,12277102,-0.3548872445779032,0.24375561203072493,0.5986428566086281
2025-09-08T12:25:00-04:00,498.685,498.83,498.5,498.8,498.26860673346704,NaN,NaN,NaN,NaN,NaN,498.0080000000006,503.63542392187713,492.3805760781241,499.5614860222848,499.2742011246376,500.3949577919122,498.15344445736304,11859,17374.8,43.30997492498359,56.164083792916685,NaN,NaN,NaN,NaN,0.6807310369209307,27.437110487098536,12288961,-0.3562954251246373,0.15327357520283158,0.5095690003274689
2025-09-08T12:30:00-04:00,498.76,498.88,498.03,498.135,NaN,NaN,NaN,500.73988945306473,500.73988945306473,500.73988945306473,498.09670000000057,503.58787568800824,492.6055243119929,499.37318881782784,499.2643108273791,500.38312133139715,498.1455003233611,9398,17085.866666666665,37.5505499924371,54.40589148672884,NaN,NaN,NaN,NaN,0.6928216771408658,27.379041095734586,12279563,-0.38558484022159567,0.02758795005047432,0.41317279027207
2025-09-08T12:35:00-04:00,498.12,498.58,497.79,498.58,NaN,NaN,NaN,500.4737581142891,NaN,NaN,498.2045000000006,503.5147878449605,492.89421215504075,499.3350408434098,499.25515087199113,500.37239484378955,498.1379069001927,8587,16661.566666666666,43.01188170874502,52.78619507216014,NaN,NaN,NaN,NaN,0.6997629859165156,27.617393109385457,12288150,-0.3590978407632851,-0.03569951068203636,0.32339833008124874
2025-09-08T12:40:00-04:00,498.56,498.66,498.4,498.57,NaN,NaN,NaN,500.4737581142891,NaN,NaN,498.32570000000067,503.3810832729259,493.27031672707545,499.3350408434098,499.25010290998,500.36497949383084,498.13522632612916,6345,16089.9,42.9210442679213,51.353313223677404,NaN,NaN,NaN,NaN,0.6683513440653394,27.655479901993406,12281805,-0.3272583379295967,-0.08567459233074715,0.24158374559884954
2025-09-08T12:45:00-04:00,498.51,498.62,498.25,498.52,NaN,NaN,NaN,500.4737581142891,NaN,NaN,498.43530000000055,503.2599017075535,493.6106982924476,499.0140326747278,499.24303973627775,500.3553789365295,498.130700536026,8105,15332.933333333332,42.43844067220496,49.791681567448286,NaN,NaN,NaN,NaN,0.6470405337749583,27.886470492374265,12273700,-0.2955398876293123,-0.12784111393779085,0.16769877369152147
2025-09-08T12:50:00-04:00,498.62,498.8,498.4,498.58,NaN,NaN,NaN,500.4737581142891,NaN,NaN,498.54270000000065,503.1305117699154,493.9548882300859,498.70122613978225,499.2391497542361,500.3492860715871,498.12901343688515,5438,14848.5,43.262870250448124,48.158856147657445,NaN,NaN,NaN,NaN,0.6293947813624637,27.662040289314188,12279138,-0.25786650608336736,-0.15463435891268773,0.10323214717067963
2025-09-08T12:55:00-04:00,498.63,498.75,498.5,498.68,NaN,NaN,NaN,500.4737581142891,NaN,NaN,498.6485000000006,502.9936956223454,494.30330437765576,498.1864809118258,499.2342539181449,500.3411274497384,498.12738038655135,7525,13844.233333333334,44.6848663761904,47.11017050151063,NaN,NaN,NaN,NaN,0.6022951541222878,27.453640815044118,12286663,-0.21529515343068528,-0.16588679461767697,0.04940835881300831
2025-09-08T13:00:00-04:00,498.685,498.72,498.14,498.14,NaN,NaN,NaN,500.4737581142891,NaN,NaN,498.7127000000006,502.9291848910508,494.4962151089504,497.9441477835685,499.2285858941527,500.3342690935143,498.12290269479104,5798,12967.3,39.00052732929971,45.617422414237055,NaN,NaN,NaN,NaN,0.6007026431135559,27.788000452236695,12280865,-0.21223811166849843,-0.2158892807726147,-0.0036511691041162947
2025-09-08T13:05:00-04:00,498.151,498.27,497.99,498.23,NaN,NaN,NaN,500.1234935743979,NaN,NaN,498.78810000000055,502.8288681889227,494.7473318110784,497.9441477835685,499.21859413461794,500.323859814543,498.11332845469286,8726,12658.566666666668,40.36220562932886,44.21043277680663,NaN,NaN,NaN,NaN,0.5777953114625857,28.303067603692984,12289591,-0.19341926784085273,-0.24542525390518222,-0.05200598606432948
2025-09-08T13:10:00-04:00,498.23,498.6,498.17,498.17,NaN,NaN,NaN,500.1234935743979,NaN,NaN,498.88230000000055,502.63087103928615,495.13372896071496,497.6304159012606,499.21245793630874,500.31647282876577,498.1084430438517,6349,12345.333333333334,39.72553961810136,42.92728769917341,NaN,NaN,NaN,NaN,0.5672385035009729,27.90477801139889,12283242,-0.17483955466204906,-0.2705554293918908,-0.09571587472984175
2025-09-08T13:15:00-04:00,498.22,498.53,498.14,498.47,NaN,NaN,NaN,500.1234935743979,NaN,NaN,498.9853000000005,502.3835074152,495.58709258480104,497.6304159012606,499.2043495797862,500.30601245853643,498.10268670103596,9213,12213.766666666666,44.44422150607927,42.593396305644106,NaN,NaN,NaN,NaN,0.5545786103937596,27.583626141367663,12292455,-0.13401084952168313,-0.26322943663194565,-0.12921858711026252
2025-09-08T13:20:00-04:00,498.46,498.54,498.15,498.47,NaN,NaN,NaN,500.1234935743979,NaN,NaN,499.0803000000006,502.1323625216956,496.0282374783056,497.6304159012606,499.1972733499278,500.29677055849754,498.09777614135805,8257,11979.8,44.444221506079266,42.40439536807171,NaN,NaN,NaN,NaN,0.5428229953656369,27.257588741861998,12292455,-0.10021707675581121,-0.25448993305502654,-0.15427285629921533
2025-09-08T13:25:00-04:00,498.489,498.55,498.29,498.31,NaN,NaN,NaN,500.1234935743979,NaN,NaN,499.17330000000055,501.81481214961315,496.53178785038796,497.6304159012606,499.1915101271789,500.28923143098996,498.09378882336784,6804,11850.333333333334,42.39148099480062,42.11097440384272,NaN,NaN,NaN,NaN,0.5226213528395194,26.925070184960436,12285651,-0.08258659994397699,-0.25750610622918657,-0.17491950628520958
2025-09-08T13:30:00-04:00,498.33,498.44,498.2,498.25,NaN,NaN,NaN,500.1097466816979,NaN,NaN,499.25530000000055,501.49141395877064,497.01918604123045,497.6304159012606,499.18543167224965,500.28188466238936,498.08897868210994,6572,11329.266666666666,41.6152566168284,42.083077242389145,NaN,NaN,NaN,NaN,0.502434113350983,26.792064225454183,12279079,-0.06944118467991753,-0.2617209871351065,-0.19227980245518897
2025-09-08T13:35:00-04:00,498.29,498.32,498.11,498.26,NaN,NaN,NaN,499.95203092343894,NaN,NaN,499.31930000000057,501.2311127619003,497.4074872381008,497.6304159012606,499.1796015663334,500.27523356624744,498.0839695664194,5940,10877.4,41.806513247650486,41.975687122579636,NaN,NaN,NaN,NaN,0.4815459623973399,26.8457554932671,12285019,-0.05517051652017285,-0.26124294810540505,-0.2060724315852322
2025-09-08T13:40:00-04:00,498.26,498.3,498.01,498.28,NaN,NaN,NaN,499.8526204269189,NaN,NaN,499.33190000000053,501.20750111871297,497.4562988812881,497.6304159012606,499.17091040515874,500.2655622703214,498.07625853999605,8684,10656.1,42.21422454909598,42.308806733769565,NaN,NaN,NaN,NaN,0.4678641079403885,27.092811338173107,12293703,-0.04017873224613172,-0.25629584689289686,-0.21611711464676514
2025-09-08T13:45:00-04:00,498.28,498.28,497.88,498,NaN,NaN,NaN,499.7550013166044,NaN,NaN,499.34490000000056,501.17380293796526,497.51599706203586,497.58325654602004,499.1568518849924,500.2517048621236,498.06199890786127,12512,10533.766666666666,38.181117706032396,41.96375216214723,NaN,NaN,NaN,NaN,0.4630166716589306,27.57433177744962,12281191,-0.04457458415357568,-0.2718353448387347,-0.22726076068515905
2025-09-08T13:50:00-04:00,497.94,498.01,497.5,497.895,NaN,NaN,NaN,499.42341034766787,NaN,NaN,499.33480000000054,501.1898546721152,497.4797453278859,497.58325654602004,499.141799196799,500.2397796486262,498.0438187449718,11172,10503.933333333332,36.76269962659874,41.523870402052765,NaN,NaN,NaN,NaN,0.4663726236832921,28.67129825167322,12270019,-0.04962210733598024,-0.28928839485513436,-0.23966628751915411
2025-09-08T13:55:00-04:00,497.86,498.13,497.84,497.9,NaN,NaN,NaN,499.42341034766787,NaN,NaN,499.30800000000056,501.20597997790225,497.4100200220989,497.58325654602004,499.1296681053442,500.22850870386804,498.03082750682034,10402,10475.933333333332,36.88294482331454,41.127049269989165,NaN,NaN,NaN,NaN,0.453774579134487,29.23383491042295,12280421,-0.047680444102595365,-0.29926684264739833,-0.25158639854480297
2025-09-08T14:00:00-04:00,497.86,498.09,497.7,497.78,NaN,NaN,NaN,499.42341034766787,NaN,NaN,499.26340000000056,501.1977551267723,497.32904487322884,497.58325654602004,499.11615006097963,500.21690182903507,498.0153982929242,10907,10451.233333333334,35.15519881155994,40.547929881497154,NaN,NaN,NaN,NaN,0.44921925205345126,29.997056835999597,12269514,-0.04932841402234023,-0.31324691607272825,-0.263918502050388
2025-09-08T14:05:00-04:00,497.76,498.13,497.69,498.05,NaN,NaN,NaN,499.42341034766787,NaN,NaN,499.24850000000055,501.20836657620583,497.28863342379526,497.58325654602004,499.10613838366476,500.2073651728229,498.0049115945066,8946,10358,41.7652350251912,40.33938478499721,NaN,NaN,NaN,NaN,0.44856073404963315,30.544968134743648,12278460,-0.02813858883077902,-0.2990917380888618,-0.2709531492580828
2025-09-08T14:10:00-04:00,498.04,498.28,497.865,497.93,NaN,NaN,NaN,499.42341034766787,NaN,NaN,499.2319000000005,501.22186471242577,497.24193528757525,497.58325654602004,499.09381986091023,500.19475091153333,497.9928888102871,11941,9870.166666666666,39.822304677541396,40.39808316701448,NaN,NaN,NaN,NaN,0.446163538760371,30.453807085385787,12266519,-0.018570037109265747,-0.294165695644665,-0.27559565853539925
2025-09-08T14:15:00-04:00,497.9,498.28,497.82,498.28,NaN,NaN,NaN,499.42341034766787,NaN,NaN,499.2183000000005,501.22473824641867,497.21186175358235,497.54660523681605,499.0830189717136,500.1824928532764,497.9835450901508,11836,9746.266666666666,47.49448353184769,40.907531588622966,NaN,NaN,NaN,NaN,0.447151857420343,30.46681666128998,12278355,0.013249553115387613,-0.25903371714116474,-0.27228327025655236
2025-09-08T14:20:00-04:00,498.28,498.28,498.05,498.15,NaN,NaN,NaN,499.42341034766787,NaN,NaN,499.2043000000005,501.23049348450843,497.1781065154926,497.5002841894528,499.06501835934347,500.1611748189925,497.96886189969445,21080,9934.066666666668,45.189939963297874,41.29784589899415,NaN,NaN,NaN,NaN,0.4316410104617443,30.478896981772447,12257275,0.02668495065646631,-0.23892708193596945,-0.26561203259243577
2025-09-08T14:25:00-04:00,498.14,498.45,498,498.44,NaN,NaN,NaN,499.42341034766787,NaN,NaN,499.2031000000006,501.2310308558982,497.17516914410294,497.4992273515623,499.0594876792332,500.1536215600288,497.9653537984376,7837,9655.266666666666,50.91204732321413,41.759833457360926,NaN,NaN,NaN,NaN,0.4329523668573332,29.761556904301518,12265112,0.054635785047531304,-0.1973173012830216,-0.2519530863305529
2025-09-08T14:30:00-04:00,498.46,498.48,498.25,498.31,NaN,NaN,NaN,499.42341034766787,NaN,NaN,499.17530000000056,501.2133062896018,497.1372937103993,497.59942386118576,499.0534259846133,500.1448621718745,497.9619897973521,9338,9673.633333333333,48.46922522772492,42.04733372319276,NaN,NaN,NaN,NaN,0.4184557692246678,28.969673513859917,12255774,0.06329144031082673,-0.1728387859420195,-0.23613022625284624
2025-09-08T14:35:00-04:00,498.29,498.39,498.13,498.19,NaN,NaN,NaN,499.42341034766787,NaN,NaN,499.12710000000055,501.1419102531921,497.112289746809,497.59942386118576,499.04621733759126,500.1355083900765,497.956926285106,9778,9348.5,46.26262273078737,42.32384384719181,NaN,NaN,NaN,NaN,0.40713749999433374,28.578546264721496,12245996,0.05989342999801531,-0.16126343875532712,-0.22115686875334242
2025-09-08T14:40:00-04:00,498.17,498.39,498,498.29,NaN,NaN,NaN,499.42341034766787,NaN,NaN,499.08850000000064,501.0919981896795,497.0850018103218,497.59942386118576,499.04095546350044,500.12871530811583,497.95319561888505,7159,9297.066666666668,48.37196502408133,42.80646587628131,NaN,NaN,NaN,NaN,0.40591339285188033,28.568696208992222,12253155,0.0630219217337204,-0.14237946658619194,-0.20540138831991234
2025-09-08T14:45:00-04:00,498.375,498.58,498.35,498.4,NaN,NaN,NaN,499.42341034766787,NaN,NaN,499.04850000000056,501.02534723647074,497.0716527635304,497.7449450169271,499.03630331295267,500.1210933178119,497.9515133080934,8748,9197.8,50.665971013617956,43.43928428813613,NaN,NaN,NaN,NaN,0.3976338647910292,27.712122033405894,12261903,0.07057163473824554,-0.1171868448971054,-0.18775847963535094
2025-09-08T14:50:00-04:00,498.38,498.44,497.98,498.07,NaN,NaN,NaN,499.42341034766787,NaN,NaN,499.00210000000055,500.9596342542115,497.0445657457896,497.7449450169271,499.02892280172654,500.1120704690137,497.9457751344394,9582,9161.266666666666,44.305714458847085,43.588676424546925,NaN,NaN,NaN,NaN,0.40208858873452563,27.88371792953312,12252321,0.052256096039208694,-0.12243835958634008,-0.17469445562554878
2025-09-08T14:55:00-04:00,498.07,498.33,498.06,498.15,NaN,NaN,NaN,499.42341034766787,NaN,NaN,498.9567000000006,500.88567548877234,497.0277245112288,497.7449450169271,499.02210342852743,500.103550206038,497.94065665101687,9178,9071.9,46.073073016733055,44.152387518168396,NaN,NaN,NaN,NaN,0.39265368953920105,28.043056975936974,12261499,0.04473498942127796,-0.11877571884895133,-0.1635107082702293
2025-09-08T15:00:00-04:00,498.12,498.24,497.9,498.08,NaN,NaN,NaN,499.42341034766787,NaN,NaN,498.9101000000005,500.8087263341286,497.0114736658724,497.7449450169271,499.0135312705809,500.0938182488448,497.93324429231706,10417,9105.866666666667,44.73537570128778,44.72186438064619,NaN,NaN,NaN,NaN,0.3888927117149747,28.56670235879796,12251082,0.034699282883280086,-0.12013660466612919,-0.15483588754940927
2025-09-08T15:05:00-04:00,498.08,498.18,497.85,497.85,NaN,NaN,NaN,499.36738031534594,NaN,NaN,498.86310000000054,500.7479722918133,496.9782277081878,497.7449450169271,499.00414270016245,500.0841533644346,497.9241320358903,10367,9165.2,40.5675988529471,44.98505395419137,NaN,NaN,NaN,NaN,0.38468608944961824,29.16697425261076,12240715,0.013323649255766346,-0.13818132597970134,-0.1515049752354677
2025-09-08T15:10:00-04:00,497.82,497.82,497.35,497.43,NaN,NaN,NaN,498.9440903010121,NaN,NaN,498.80450000000053,500.68174612036444,496.9272538796366,497.7449450169271,498.9868885841939,500.07216251114295,497.9016146572448,13809,9414,34.28592507982809,44.922962973353386,NaN,NaN,NaN,NaN,0.39292279734607405,30.67038312156013,12226906,-0.026194808361333977,-0.18424848568713514,-0.15805367732580117
2025-09-08T15:15:00-04:00,497.44,497.89,497.44,497.69,NaN,NaN,NaN,498.9440903010121,NaN,NaN,498.7579000000005,500.62780383620714,496.8879961637939,497.7449450169271,498.9687959914228,500.05738901619117,497.8802029666544,16440,9691.833333333334,40.434822610209736,44.82793351514043,NaN,NaN,NaN,NaN,0.3977140261070673,31.736922341723144,12243346,-0.031557499057835725,-0.19750055114809584,-0.1659430520902601
2025-09-08T15:20:00-04:00,497.67,497.86,497.54,497.66,NaN,NaN,NaN,498.9440903010121,NaN,NaN,498.7063000000005,500.5519953260474,496.8606046739536,497.7449450169271,498.95115777835974,500.04250357636147,497.859811980358,16649,10065.533333333333,39.970086376530546,44.8384893507825,NaN,NaN,NaN,NaN,0.3921630242422763,32.72728018901737,12226697,-0.03366609223130257,-0.20802566737938832,-0.17435957514808575
2025-09-08T15:25:00-04:00,497.68,497.68,497.3,497.35,NaN,NaN,NaN,498.82268175034494,NaN,NaN,498.65830000000045,500.5177070121149,496.798892987886,497.7449450169271,498.9338390761409,500.0307297608764,497.8369483914054,14062,10283.433333333332,35.437563832527275,43.97728080083105,NaN,NaN,NaN,NaN,0.3912942367963991,34.06971644171661,12212635,-0.05141675821598907,-0.23863052291807207,-0.187213764702083
2025-09-08T15:30:00-04:00,497.34,497.62,497.26,497.27,NaN,NaN,NaN,498.7611962162383,NaN,NaN,498.6017000000004,500.4543981505524,496.7490018494484,497.7449450169271,498.9030399080294,500.0103226996294,497.79575711642946,24812,10917.233333333334,34.35486876921608,43.20334714411093,NaN,NaN,NaN,NaN,0.38905893416808585,35.38260100313818,12187823,-0.06324580128836871,-0.2662710163125439,-0.2030252150241752
2025-09-08T15:35:00-04:00,497.3,497.39,497.125,497.37,NaN,NaN,NaN,498.5547782064093,NaN,NaN,498.5359000000005,500.32408644347197,496.747713556529,497.5419560135417,498.875725473191,499.9930550957509,497.7583958506311,21584,11345.833333333334,36.94806518301283,42.205919848382266,NaN,NaN,NaN,NaN,0.38019758172750734,36.82280264895345,12209407,-0.05911185839418737,-0.2769150380169094,-0.21780317962272205
2025-09-08T15:40:00-04:00,497.39,497.64,497.3,497.36,NaN,NaN,NaN,498.5547782064093,NaN,NaN,498.4747000000005,500.2094223514242,496.73997764857677,497.47656481083334,498.8423995118652,499.9678059007625,497.7169931229679,30053,12135.966666666667,36.79154670338612,41.371799953786635,NaN,NaN,NaN,NaN,0.37732632588982645,36.8834979537545,12179354,-0.05207454840568598,-0.2828963651298295,-0.23082181672414354
2025-09-08T15:45:00-04:00,497.39,498.35,497.36,498.34,NaN,NaN,NaN,498.5547782064093,NaN,NaN,498.42910000000046,500.05212518665473,496.8060748133462,497.3872518486667,498.81833947865744,499.935892003999,497.70078695331586,39038,13130.133333333333,56.31998324707073,42.09018284780687,NaN,NaN,NaN,NaN,0.4210887311834109,34.38265144692781,12218392,0.019711804020663554,-0.2061820616983141,-0.22589386571897765
2025-09-08T15:50:00-04:00,498.32,498.33,497.43,497.5,NaN,NaN,NaN,498.5547782064093,NaN,NaN,498.36110000000053,499.8431071377728,496.8790928622283,497.3328014789334,498.76670759370853,499.8805737427061,497.652841444711,68262,15130.3,43.82239270850221,41.76521339669408,NaN,NaN,NaN,NaN,0.45601096467030783,32.06043683344588,12150130,0.012125367297338957,-0.21073715659730397,-0.22286252389464292
2025-09-08T15:55:00-04:00,497.48,498.64,497.02,498.36,497.04966583804236,497.04966583804236,497.04966583804236,NaN,NaN,NaN,498.3219000000005,499.6942030119551,496.94959698804587,497.15692895417186,498.6841341020252,499.76202320693886,497.60624499711156,171619,20624.133333333335,54.865192896998046,42.065157816935525,NaN,NaN,NaN,NaN,0.539153038622429,30.943731435009035,12321749,0.06364968991573117,-0.14330041149997896,-0.20695010141571013
2025-09-09T09:30:00-04:00,501.44,502.09,500.11,501.44,499.0834685091845,NaN,NaN,NaN,NaN,NaN,498.3429000000005,499.86509984122415,496.82070015877684,498.674947624536,501.21333333333337,501.21333333333337,501.21333333333337,56957,22303.633333333335,74.32818226639904,44.209619803189184,NaN,NaN,NaN,NaN,0.7670706787208241,32.3286301085834,12378706,0.29105264434919864,0.15686570402078814,-0.13418694032841047
2025-09-09T09:35:00-04:00,501.38,501.62,500.66,501.44,499.08421994058517,NaN,NaN,NaN,NaN,NaN,498.3635000000005,500.019073917541,496.70792608246,498.674947624536,501.22108055140336,501.2331872923607,501.208973810446,23323,22883.066666666666,74.32818226639904,46.227841892451046,NaN,NaN,NaN,NaN,0.7808513445264781,33.61460744833102,12378706,0.41955030682321853,0.3902509432006127,-0.029299363622605823
2025-09-09T09:40:00-04:00,501.41,501.93,500.775,501.49,499.2326644887404,NaN,NaN,NaN,NaN,NaN,498.3889000000005,500.1901820868953,496.5876179131057,498.78286647970305,501.2595149762129,501.3333404113703,501.1856895410556,22227,23334.5,74.53492562075938,48.3563811724133,NaN,NaN,NaN,NaN,0.8075762484888747,35.00876593893877,12400933,0.48155463178708835,0.5726439261112546,0.09108929432416625
2025-09-09T09:45:00-04:00,501.52,501.96,500.67,500.96,499.2326644887404,NaN,NaN,NaN,NaN,NaN,498.41930000000053,500.3379922724317,496.5006077275694,498.7972931837624,501.2482033262403,501.31928226214023,501.17712439034034,22499,23667.4,68.25969316701583,50.334387909132495,NaN,NaN,NaN,NaN,0.8420350878825238,36.08290967364639,12378434,0.4605200463892152,0.6667393523106853,0.20621930592147006
2025-09-09T09:50:00-04:00,500.98,501.5,500.47,500.74,499.2326644887404,NaN,NaN,NaN,NaN,NaN,498.44950000000046,500.46345258053566,496.43554741946525,498.7972931837624,501.20823398848125,501.3372818736488,501.0791861033137,16387,23841.233333333334,65.78386293033235,52.58424061273995,NaN,NaN,NaN,NaN,0.8554611530337702,36.65486146063239,12362047,0.40727480587625725,0.7153128132667916,0.3080380073905344
2025-09-09T09:55:00-04:00,500.74,501.63,500.3,500.91,499.2326644887404,NaN,NaN,NaN,NaN,NaN,498.4843000000004,500.60419528910063,496.3644047109002,498.7972931837624,501.1830316228774,501.32796519109394,501.0380980546609,15076,23997.033333333333,66.78636183058077,54.46649341419502,NaN,NaN,NaN,NaN,0.8893567849599284,36.82506860332518,12377123,0.36059238147561373,0.7587784842350516,0.39818610275943783
2025-09-09T10:00:00-04:00,500.91,501.31,499.44,499.88,499.2326644887404,NaN,NaN,NaN,NaN,NaN,498.5080000000005,500.6629932706276,496.35300672937336,498.7972931837624,501.0361307327502,501.40921757649164,500.6630438890088,27823,24560.9,56.067739654871616,55.61632579121938,NaN,NaN,NaN,NaN,0.9594027288913625,35.390229589014005,12349300,0.2430675133385204,0.7020204944325883,0.4589529810940679
2025-09-09T10:05:00-04:00,500,500.86,499.74,500.84,499.2326644887404,NaN,NaN,NaN,NaN,NaN,498.5488000000005,500.79948305997294,496.298116940028,498.7972931837624,500.99053007925164,501.37919564816383,500.60186451033945,16461,24811.4,62.16293113724077,57.52528059869892,NaN,NaN,NaN,NaN,0.9708739625419798,34.057879075725054,12365761,0.21374397266871792,0.7261329469299653,0.5123889742612474
2025-09-09T10:10:00-04:00,500.85,501.82,500.64,501.53,499.2326644887404,NaN,NaN,NaN,NaN,NaN,498.6167000000005,501.01345581494377,496.2199441850572,498.7972931837624,501.0158553174424,501.4002343236502,500.6314763112346,16184,24952.833333333332,65.8322291976486,59.77366348644409,NaN,NaN,NaN,NaN,0.9858115366461246,33.84329605612931,12381945,0.2235225687881509,0.791792185246436,0.5682696164582851
2025-09-09T10:15:00-04:00,501.65,502.14,501.1,502.11,499.2326644887404,NaN,NaN,NaN,NaN,NaN,498.68730000000045,501.2758603791549,496.098739620846,499.04065618436425,501.1219616126628,501.5663672794732,500.6775559458524,34804,25718.433333333334,68.58964311362635,62.033776195773626,NaN,NaN,NaN,NaN,0.9896821411713989,33.930338402806335,12416749,0.2497676203775847,0.880479141930266,0.6307115215526813
2025-09-09T10:20:00-04:00,502.07,502.25,501.1,501.265,499.2326644887404,NaN,NaN,NaN,NaN,NaN,498.7412000000004,501.42811016539883,496.05428983460195,499.19552494749144,501.14160715524827,501.584294272954,500.6989200375425,12466,25431.3,60.880959757205126,63.7544485567607,NaN,NaN,NaN,NaN,1.0011334168020116,34.10888428103478,12404283,0.19344827640541273,0.8725218670594472,0.6790735906540345
2025-09-09T10:25:00-04:00,501.27,501.34,500.76,500.92,499.2326644887404,NaN,NaN,NaN,NaN,NaN,498.7892000000005,501.543492910462,496.034907089539,499.19552494749144,501.1372474923207,501.57337786824115,500.7011171164002,8821,25464.1,58.01412614221753,63.8754587635569,NaN,NaN,NaN,NaN,0.9710524584590097,33.63607105268566,12395462,0.11979944606403614,0.8288228982340797,0.7090234521700436
2025-09-09T10:30:00-04:00,500.97,501.11,499.55,499.55,499.2326644887404,NaN,NaN,NaN,NaN,NaN,498.80860000000047,501.5703798892307,496.0468201107702,499.19552494749144,501.0950808183147,501.57038999875806,500.6197716378714,11231,25527.2,48.28974326766445,64.1945552320685,NaN,NaN,NaN,NaN,1.013120139997652,31.369025046112515,12384231,-0.026536529803865783,0.6758527899152114,0.7023893197190771
2025-09-09T10:35:00-04:00,499.58,499.71,499.01,499.33,NaN,NaN,NaN,502.01052641431033,502.01052641431033,502.01052641431033,498.8216000000004,501.58695309802675,496.056246901974,499.19552494749144,501.0111243774263,501.60653337582,500.41571537903263,14367,25680.166666666668,46.92936474307402,63.627710363931065,NaN,NaN,NaN,NaN,0.9907544157121045,29.633262309367996,12369864,-0.13730943113049743,0.5307525308059553,0.6680619619364527
2025-09-09T10:40:00-04:00,499.3,499.38,498.8,499.1,NaN,NaN,NaN,501.6991388500235,NaN,NaN,498.8408000000004,501.60028137099636,496.08131862900444,499.19552494749144,500.9185221404585,501.6301474086088,500.20689687230816,15151,25946.566666666666,45.48665581919167,61.56760133198768,NaN,NaN,NaN,NaN,0.9614148145898103,28.257397087631723,12354713,-0.22031040844461303,0.3926739513806865,0.6129843598252995
2025-09-09T10:45:00-04:00,499.04,499.71,498.9,499.35,NaN,NaN,NaN,501.6991388500235,NaN,NaN,498.86320000000046,501.62066750419245,496.10573249580847,499.19552494749144,500.8772698281116,501.6239845021595,500.1305551540637,8312,25932.033333333333,47.38021956627347,59.64274685340729,NaN,NaN,NaN,NaN,0.9505994706905383,26.532547399185376,12363025,-0.2504188228182971,0.29996083130242823,0.5503796541207253
2025-09-09T10:50:00-04:00,499.32,499.97,499.05,499.91,NaN,NaN,NaN,501.6991388500235,NaN,NaN,498.89800000000037,501.66350248545365,496.1324975145471,499.19552494749144,500.83960510790706,501.604863475601,500.0743467402131,10141,25950.666666666668,51.44851362968253,57.99371742547323,NaN,NaN,NaN,NaN,0.9484137942126438,24.685353857055112,12373166,-0.2254426396717067,0.26857635453109197,0.49401899420279866
2025-09-09T10:55:00-04:00,500,500.1,499.57,499.73,NaN,NaN,NaN,501.6991388500235,NaN,NaN,498.9232000000004,501.69559734470363,496.1508026552972,499.19552494749144,500.8109173647331,501.5845201070549,500.03731462241126,9428,25959,50.10749395507952,56.69713176747778,NaN,NaN,NaN,NaN,0.9185270946260286,23.141320561699004,12363738,-0.21396103260398847,0.22656770344781307,0.44052873605180154
2025-09-09T11:00:00-04:00,499.73,500.01,499.12,499.35,NaN,NaN,NaN,501.6991388500235,NaN,NaN,498.9408000000005,501.7126386382718,496.16896136172915,499.19552494749144,500.7663938920892,501.5632120817793,499.9695757023991,11949,26010.066666666666,47.30426609276369,55.377160564794295,NaN,NaN,NaN,NaN,0.9164894450098827,21.876803402693675,12351789,-0.22381532149446332,0.16075958418372238,0.3845749056781857
2025-09-09T11:05:00-04:00,499.34,499.75,499.07,499.63,NaN,NaN,NaN,501.6991388500235,NaN,NaN,498.9672000000004,501.7396481306182,496.19475186938257,499.19552494749144,500.7349104142873,501.5465406924458,499.9232801361288,8895,25961,49.544154216449776,54.14557430664208,NaN,NaN,NaN,NaN,0.8995973417948916,20.768664476145354,12360684,-0.20389618000892268,0.12970468066703233,0.333600860675955
2025-09-09T11:10:00-04:00,499.6,499.88,499.39,499.82,NaN,NaN,NaN,501.6991388500235,NaN,NaN,498.99860000000047,501.77340740894977,496.22379259105116,498.6064199579931,500.70920193647663,501.52679777992364,499.8916060930296,9204,25807.5,51.064203890612845,53.788178894909315,NaN,NaN,NaN,NaN,0.8703403888095428,19.53718583983631,12369888,-0.17163869258778058,0.11905249494122927,0.29069118752900985
2025-09-09T11:15:00-04:00,499.8,500.25,499.6,499.75,NaN,NaN,NaN,501.6991388500235,NaN,NaN,499.0284000000004,501.80284224253535,496.2539577574654,498.40037146612457,500.68965814178176,501.50760764988524,499.8717086336783,8827,25553.733333333334,50.46104511140848,52.952329893064146,NaN,NaN,NaN,NaN,0.8546017896088596,18.448164958044135,12361061,-0.14954015305450236,0.1037659962108819,0.25330614926538425
2025-09-09T11:20:00-04:00,499.74,499.91,499.17,499.2,NaN,NaN,NaN,501.6991388500235,NaN,NaN,499.0468000000004,501.8133362887323,496.28026371126856,498.40037146612457,500.6736858827161,501.4986090099967,499.8487627554355,4874,25161.233333333334,45.875939032182536,51.52688059553086,NaN,NaN,NaN,NaN,0.8464159474939417,17.46727163115099,12356187,-0.16525913357910435,0.046732232291503806,0.21199136587060816
2025-09-09T11:25:00-04:00,499.29,499.79,499.24,499.51,NaN,NaN,NaN,501.6991388500235,NaN,NaN,499.0770000000004,501.8301029760916,496.3238970239092,498.40037146612457,500.65390818859606,501.4854473141851,499.82236906300705,6683,24915.266666666666,48.705059031592725,50.10655316109988,NaN,NaN,NaN,NaN,0.8281005226729482,16.556442113321637,12362870,-0.14859753821822774,0.026244443097823478,0.17484198131605122
2025-09-09T11:30:00-04:00,499.5,499.64,499.13,499.15,NaN,NaN,NaN,501.6991388500235,NaN,NaN,499.1021000000004,501.8344455778809,496.3697544221199,498.40037146612457,500.63319607395044,501.47480303387096,499.79158911402993,6122,24292.266666666666,45.71651537413089,49.02337856230887,NaN,NaN,NaN,NaN,0.8053790567677369,15.880696586276208,12356748,-0.15493300447925681,-0.018824274283019804,0.136108730196237
2025-09-09T11:35:00-04:00,499.14,499.355,499.08,499.2,NaN,NaN,NaN,501.53257158075604,NaN,NaN,499.1281000000004,501.8388511056814,496.41734889431945,498.40037146612457,500.61657895324635,501.467089444994,499.7660684614987,4710,23729.8,46.21018653289402,48.18024001878576,NaN,NaN,NaN,NaN,0.7674948384271867,15.333387939658245,12361458,-0.1488321020053001,-0.04993139731038809,0.098900704694912
2025-09-09T11:40:00-04:00,499.25,499.26,498.74,498.8,NaN,NaN,NaN,501.2807501452672,NaN,NaN,499.1485000000004,501.8335938525224,496.4634061474784,498.40037146612457,500.58164275599347,501.4568227764311,499.7064627355558,8540,23012.7,42.852638211460274,47.79187537191404,NaN,NaN,NaN,NaN,0.7498166356823864,15.35802506518402,12352918,-0.16363487418151357,-0.10564288803197996,0.0579919861495336
2025-09-09T11:45:00-04:00,498.81,499.23,498.81,499.04,NaN,NaN,NaN,501.255716047755,NaN,NaN,499.1683000000004,501.8352395263096,496.5013604736912,498.40037146612457,500.5681669634114,501.4513856156757,499.6849483111471,3597,21831.333333333332,45.415300667052826,47.68372793791252,NaN,NaN,NaN,NaN,0.7269725902765022,15.380902396029384,12356515,-0.1495474170575922,-0.12894228517245665,0.020605131885135554
2025-09-09T11:50:00-04:00,499.07,500,499.07,499.87,NaN,NaN,NaN,501.255716047755,NaN,NaN,499.2071000000004,501.8572442143792,496.55695578562165,498.4251979020926,500.55443643686624,501.4381309986908,499.6707418750417,6278,19765.2,53.22694545978552,48.23660576938351,NaN,NaN,NaN,NaN,0.7436174052567506,14.616007866656025,12362793,-0.08009734121969964,-0.07951654463948898,0.0005807965802106449
2025-09-09T11:55:00-04:00,499.92,500.1,499.43,499.43,NaN,NaN,NaN,501.255716047755,NaN,NaN,499.2301000000004,501.8675916032339,496.5926083967669,498.5051583216741,500.5402632240831,501.42412062311973,499.6564058250465,6733,14269,49.20667858489565,48.36706712785651,NaN,NaN,NaN,NaN,0.7383590191669838,14.06926283394184,12356060,-0.060453611266076505,-0.07498621750238499,-0.014532606236308483
2025-09-09T12:00:00-04:00,499.46,499.66,499.12,499.25,NaN,NaN,NaN,501.255716047755,NaN,NaN,499.25210000000044,501.87147556621653,496.63272443378435,498.5051583216741,500.5229086665376,501.411923884343,499.6338934487322,6298,12580.366666666667,47.6220201523579,48.09374616519047,NaN,NaN,NaN,NaN,0.724190517797915,13.13410658933394,12349762,-0.0563269121861877,-0.08494124646904311,-0.02861433428285541
2025-09-09T12:05:00-04:00,499.23,499.33,498.79,498.9,NaN,NaN,NaN,501.255716047755,NaN,NaN,499.2613000000004,501.87241992008336,496.65018007991745,498.5051583216741,500.48567867424794,501.3945270443569,499.576830304139,10934,12167.4,44.613466201808265,47.701315611385375,NaN,NaN,NaN,NaN,0.7110340522409185,12.820372501522934,12338828,-0.07286293825026845,-0.11969300709569097,-0.046830068845422526
2025-09-09T12:10:00-04:00,498.95,499.14,498.59,498.99,NaN,NaN,NaN,501.0372667598991,NaN,NaN,499.2749000000004,501.8731105297918,496.676689470209,498.5051583216741,500.4195835628443,501.3637373669521,499.47542975873654,19454,12074.966666666667,45.565782295379925,47.57713819728654,NaN,NaN,NaN,NaN,0.6995316199379966,12.846413475411422,12358282,-0.0732372728655954,-0.13837665992741677,-0.06513938706182137
2025-09-09T12:15:00-04:00,498.985,499.43,498.91,499.16,NaN,NaN,NaN,501.0372667598991,NaN,NaN,499.2943000000004,501.8742395413593,496.7143604586415,498.5051583216741,500.3915544853253,501.3432985312318,499.43981043941875,10635,11679.5,47.40532472789563,47.424364662389806,NaN,NaN,NaN,NaN,0.686707932799567,12.299370884910145,12368917,-0.05818981348112237,-0.13787665391322435,-0.07968684043210197
2025-09-09T12:20:00-04:00,499.16,499.18,498.51,498.68,NaN,NaN,NaN,500.98332570478414,NaN,NaN,499.30210000000045,501.87218644931863,496.73201355068227,498.5051583216741,500.3555146932326,501.3260062967996,499.38502308966554,10944,11498.066666666668,42.98797475198057,46.84749115248751,NaN,NaN,NaN,NaN,0.6855145090281705,12.434659987909711,12357973,-0.07561394019902631,-0.17420426568088487,-0.09859032548185856
2025-09-09T12:25:00-04:00,498.65,498.74,498.36,498.65,NaN,NaN,NaN,500.64294726365756,NaN,NaN,499.30710000000045,501.8711125500879,496.743087449913,498.5051583216741,500.33321013710037,501.3176033853249,499.34881688887583,6199,11202.166666666666,42.72003878139118,46.29456212891484,NaN,NaN,NaN,NaN,0.6636920440975865,12.786702905339018,12351774,-0.08358693830940031,-0.20307399836860895,-0.11948706005920864
2025-09-09T12:30:00-04:00,498.64,498.66,498.45,498.6,NaN,NaN,NaN,500.58144966076406,NaN,NaN,499.31770000000046,501.86549842942026,496.76990157058066,498.5051583216741,500.3049040926676,501.3061941718293,499.30361401350586,8036,10542.6,42.24741280454859,46.03538168408385,NaN,NaN,NaN,NaN,0.6312854695191901,13.113599900094803,12343738,-0.08630403610764431,-0.22736710519376402,-0.1410630690861197
2025-09-09T12:35:00-04:00,498.61,498.65,498.46,498.53,NaN,NaN,NaN,500.51524740345656,NaN,NaN,499.3253000000004,501.86136025897684,496.789239741024,498.5051583216741,500.2857061143866,501.29813922158115,499.273273007192,5526,10178.1,41.55428317576485,45.52461198009615,NaN,NaN,NaN,NaN,0.5997650788392478,13.417147109510887,12338212,-0.08666405157822168,-0.2493931335588968,-0.16272908198067512
2025-09-09T12:40:00-04:00,498.52,498.65,498.47,498.61,NaN,NaN,NaN,500.45569070329947,NaN,NaN,499.3359000000005,501.8554282806247,496.81637171937626,498.5051583216741,500.26118537265575,501.286670516332,499.2357002289795,7367,9884.2,42.71109180980592,45.30993886835864,NaN,NaN,NaN,NaN,0.5697818589221552,13.699012375397254,12345579,-0.07575764642760713,-0.25742614001518405,-0.18166849358757692
2025-09-09T12:45:00-04:00,498.58,498.85,498.39,498.51,NaN,NaN,NaN,500.45569070329947,NaN,NaN,499.3491000000005,501.8441476462239,496.85405235377704,498.1141266573393,500.2328918790407,501.2723908777388,499.1933928803426,8807,9017.633333333333,41.60262110031599,44.98082705174592,NaN,NaN,NaN,NaN,0.5619402975705753,13.439862704673434,12336772,-0.06967591136529117,-0.2687633827941909,-0.1990874714288997
2025-09-09T12:50:00-04:00,498.505,498.61,498.26,498.42,NaN,NaN,NaN,500.26987520693194,NaN,NaN,499.3689000000005,501.8180053788669,496.9197946211341,497.98571284855774,500.20660022314496,501.2608820166447,499.1523184296452,7729,8859.733333333334,40.581817404686184,44.81862556554778,NaN,NaN,NaN,NaN,0.5468017048869644,13.466964817276969,12329043,-0.0661400185122803,-0.28176249456925007,-0.21562247605696977
2025-09-09T12:55:00-04:00,498.44,499.32,498.44,498.84,NaN,NaN,NaN,500.26987520693194,NaN,NaN,499.3919000000005,501.79874099119996,496.985059008801,498.1010284729423,500.18269806810275,501.24248041410425,499.12291572210125,9626,8886.566666666668,47.10457334585087,44.93928789974763,NaN,NaN,NaN,NaN,0.572030154537894,13.118634310371796,12338669,-0.03168741255313551,-0.25523174174838914,-0.22354432919525363
2025-09-09T13:00:00-04:00,498.92,499.23,498.68,499.2,NaN,NaN,NaN,500.26987520693194,NaN,NaN,499.4227000000005,501.77898454074074,497.0664154592602,498.1010284729423,500.16717007868436,501.22805426606396,499.10628589130476,7412,8759.266666666666,51.97143773274521,44.849608776387605,NaN,NaN,NaN,NaN,0.5704565720709024,12.795184553959851,12346081,0.016580289883953686,-0.20281896684031153,-0.21939925672426522
2025-09-09T13:05:00-04:00,499.18,499.51,499.17,499.38,NaN,NaN,NaN,500.26987520693194,NaN,NaN,499.46330000000046,501.7440767179146,497.1825232820863,498.33985822268306,500.1524624233013,501.20929211087173,499.0956327357309,10068,8615.966666666667,54.23861246377391,45.20903262487892,NaN,NaN,NaN,NaN,0.5539953883515504,13.034231172973119,12356149,0.05945178510850663,-0.14508452533863192,-0.20453631044713855
2025-09-09T13:10:00-04:00,499.45,499.6,499.24,499.49,NaN,NaN,NaN,500.26987520693194,NaN,NaN,499.50770000000045,501.700704522791,497.3146954772099,498.4838865781465,500.142690838377,501.19546452081437,499.08991715593964,7784,8370.4,55.61741743111991,45.78013243050477,NaN,NaN,NaN,NaN,0.5401385748978692,13.422729241771867,12363933,0.0920909084613181,-0.08942267487049094,-0.18151358333180903
2025-09-09T13:15:00-04:00,499.47,499.53,498.82,498.87,NaN,NaN,NaN,500.26987520693194,NaN,NaN,499.53770000000054,501.6525571669998,497.42284283300125,498.4838865781465,500.1244261403675,501.17732686073776,499.0715254199973,9816,8420.533333333333,47.01829354464302,45.95190581213583,NaN,NaN,NaN,NaN,0.5522715338337342,12.746066318130975,12354117,0.06980879418378169,-0.09425259060208191,-0.1640613847858636
2025-09-09T13:20:00-04:00,498.95,499.37,498.85,499.37,NaN,NaN,NaN,500.26987520693194,NaN,NaN,499.5779000000005,501.6000316368765,497.5557683631245,498.4838865781465,500.1132366518198,501.16465726868637,499.06181603495327,7016,8316.366666666667,53.2903887006966,46.5036634125156,NaN,NaN,NaN,NaN,0.5499664242741804,12.117736460464434,12361133,0.08558785252364182,-0.05707656913131132,-0.14266442165495313
2025-09-09T13:25:00-04:00,499.34,499.36,499.09,499.11,NaN,NaN,NaN,500.26987520693194,NaN,NaN,499.5933000000005,501.58904307886564,497.5975569211354,498.4838865781465,500.10442385044496,501.15468992281575,499.05415777807417,5586,8188.3,49.97719661757428,46.687368547492646,NaN,NaN,NaN,NaN,0.5306831082545982,11.53428730691693,12355547,0.07569925565075875,-0.0480403520915047,-0.12373960774226345
2025-09-09T13:30:00-04:00,499.13,499.27,498.85,499.02,NaN,NaN,NaN,500.26987520693194,NaN,NaN,499.62370000000055,501.53551464503465,497.71188535496645,498.4838865781465,500.09528404391426,501.1455753065873,499.0449927812412,5119,7960.633333333333,48.845127815419744,47.10573662345258,NaN,NaN,NaN,NaN,0.5227771719506954,11.025674760878834,12350428,0.06091751527687653,-0.047592713646167795,-0.10851022892304432
2025-09-09T13:35:00-04:00,499.05,499.08,498.85,498.91,NaN,NaN,NaN,500.26987520693194,NaN,NaN,499.6347000000005,501.52349475775117,497.7459052422499,498.4838865781465,500.0861020289126,501.1371756728135,499.0350283850117,4774,7823.266666666666,47.43097025884315,47.44223172898486,NaN,NaN,NaN,NaN,0.5018645168113572,10.553391682414889,12345654,0.04242853399256845,-0.05547456143233376,-0.0979030954249022
2025-09-09T13:40:00-04:00,498.87,499.045,498.78,498.98,NaN,NaN,NaN,500.26987520693194,NaN,NaN,499.5855000000005,501.4107191640888,497.76028083591217,498.4838865781465,500.0725568733096,501.1247756697973,499.02033807682193,7111,7753.5,48.45370738434135,47.885538484684346,NaN,NaN,NaN,NaN,0.48494562275340625,10.29573150030907,12352765,0.03397562515311131,-0.05543356398351307,-0.08940918913662438
2025-09-09T13:45:00-04:00,498.96,498.96,498.71,498.76,NaN,NaN,NaN,500.26987520693194,NaN,NaN,499.53190000000046,501.292387306699,497.7714126933019,498.4838865781465,500.05749962257767,501.11236656674293,499.0026326784124,7294,7702.4,45.460236264987586,48.164535133914534,NaN,NaN,NaN,NaN,0.46959236398530857,10.240856735211667,12345471,0.013671687710751668,-0.0723195794981848,-0.08599126720893646
2025-09-09T13:50:00-04:00,498.76,498.76,498.5,498.75,NaN,NaN,NaN,500.19711120861973,NaN,NaN,499.4771000000005,501.15920592908265,497.7949940709184,498.4838865781465,500.0391761833308,501.0989579014666,498.97939446519507,8185,7812.766666666666,45.32317007489348,48.35111215284936,NaN,NaN,NaN,NaN,0.4546214808435001,10.721432738967673,12337286,0.0003746699440261708,-0.08552292977890374,-0.08589759972292992
2025-09-09T13:55:00-04:00,498.74,499,498.64,498.91,NaN,NaN,NaN,500.19711120861973,NaN,NaN,499.4361000000005,501.07089820064385,497.8013017993572,498.4838865781465,500.0297804264055,501.0906047477464,498.96895610506465,4936,7754.533333333334,48.0234617053232,48.8097436246356,NaN,NaN,NaN,NaN,0.44786280364039394,10.399647891678976,12342222,0.0030146542273796206,-0.08212928193870539,-0.08514393616608501
2025-09-09T14:00:00-04:00,498.92,499.1,498.7,498.9,NaN,NaN,NaN,500.19711120861973,NaN,NaN,499.39930000000044,500.9974639581673,497.80113604183356,498.28210926251717,500.0118355389836,501.0736384941441,498.95003258382303,10083,7886.566666666667,47.86435654371345,49.32992499170898,NaN,NaN,NaN,NaN,0.44444403195179677,9.80029496927955,12332139,0.00464937645040879,-0.07933221560307402,-0.08398159205348281
2025-09-09T14:05:00-04:00,498.92,499.4,498.92,499.29,NaN,NaN,NaN,500.19711120861973,NaN,NaN,499.36690000000044,500.9058306537954,497.82796934620546,498.4429636886582,500.00084044869084,501.0595481250244,498.9421327723573,8752,8021.3,54.232814717887265,49.83908508971157,NaN,NaN,NaN,NaN,0.44841231538381127,9.783533610386145,12340891,0.031084793706719113,-0.045125599920083914,-0.07621039362680303
2025-09-09T14:10:00-04:00,499.35,499.44,498.84,498.99,NaN,NaN,NaN,500.19711120861973,NaN,NaN,499.3491000000005,500.8844640470759,497.8137359529251,498.4429636886582,499.9781522755268,501.0331844488512,498.92312010220235,16440,8284.633333333333,49.249245700115516,49.64464280166659,NaN,NaN,NaN,NaN,0.4592400071421121,9.521005748278306,12324451,0.027573981318614382,-0.04174291697853505,-0.06931689829714943
2025-09-09T14:15:00-04:00,498.96,499.055,498.68,498.705,NaN,NaN,NaN,500.19711120861973,NaN,NaN,499.3064000000005,500.791464361241,497.82133563876,498.4429636886582,499.9556979219603,501.01271576517115,498.8986800787494,12973,8597.166666666666,45.01706860753252,48.98596109764935,NaN,NaN,NaN,NaN,0.4532228637748184,8.886990046343,12311478,0.006371913207218111,-0.0613520067881268,-0.06772391999534491
2025-09-09T14:20:00-04:00,498.74,498.99,498.51,498.76,NaN,NaN,NaN,500.19711120861973,NaN,NaN,499.25100000000043,500.6006192045124,497.9013807954885,498.4429636886582,499.9309289619076,500.99085263919295,498.8710052846223,14155,8859.733333333334,45.98180100285867,48.29770278134498,NaN,NaN,NaN,NaN,0.4551355163623327,8.77997870741163,12325633,-0.0031237609908542907,-0.07162862123391278,-0.06850486024305849
2025-09-09T14:25:00-04:00,498.8,498.8,498.53,498.6,NaN,NaN,NaN,500.15057301401873,NaN,NaN,499.18080000000043,500.2678848344396,498.09371516556126,498.4429636886582,499.9031485592424,500.96813575958174,498.8381613589031,15152,9140.366666666667,43.585909950430924,48.05253252461555,NaN,NaN,NaN,NaN,0.4419115509078831,8.680611035546786,12310481,-0.01849799337994218,-0.09162735196798621,-0.07312935858804404
2025-09-09T14:30:00-04:00,498.64,498.66,498.38,498.61,NaN,NaN,NaN,499.97622878610883,NaN,NaN,499.1277000000004,500.0491276083983,498.2062723916025,498.4429636886582,499.8768581831417,500.94786003446205,498.8058563318213,13915,9394.266666666666,43.783067283513894,47.37343813767392,NaN,NaN,NaN,NaN,0.43034644012875073,9.017988140088228,12324396,-0.025859685972332874,-0.10545396605346014,-0.07959428008112726
2025-09-09T14:35:00-04:00,498.66,498.69,498.42,498.47,NaN,NaN,NaN,499.97622878610883,NaN,NaN,499.07870000000037,499.86422099759847,498.29317900240227,498.4429636886582,499.86204992694763,500.93640527839636,498.7876945754989,7942,9294.533333333333,41.591558283210375,46.774463970933645,NaN,NaN,NaN,NaN,0.4188931229766958,9.219514229621046,12316454,-0.03732707187598201,-0.12625311992610477,-0.08892604805012276
2025-09-09T14:40:00-04:00,498.49,498.6,498.34,498.41,NaN,NaN,NaN,499.86745226172314,NaN,NaN,499.0559000000004,499.8514920797767,498.26030792022414,498.4429636886582,499.8397660887069,500.92004080565687,498.7594913717569,11611,9033.1,40.6524161267001,46.18927027888225,NaN,NaN,NaN,NaN,0.4075436141926495,9.646630298378389,12304843,-0.04557619843583614,-0.14589629609491794,-0.1003200976590818
2025-09-09T14:45:00-04:00,498.42,498.97,498.31,498.97,NaN,NaN,NaN,499.86745226172314,NaN,NaN,499.04870000000045,499.84074749684214,498.25665250315876,498.4429636886582,499.8217255331264,500.90200742705053,498.7414436392023,12385,9091.433333333332,51.63034872409247,46.489225883542915,NaN,NaN,NaN,NaN,0.4255762131788906,9.184659934808929,12317228,-0.011704920599479501,-0.11495124840843118,-0.10324632780895168
2025-09-09T14:50:00-04:00,498.97,499.18,498.74,499.18,NaN,NaN,NaN,499.86745226172314,NaN,NaN,499.0503000000005,499.8430784286888,498.2575215713122,498.4429636886582,499.7951580894763,500.8665695591633,498.72374661978927,26090,9596.3,54.99250798319543,46.95628306917535,NaN,NaN,NaN,NaN,0.42660648366611253,9.37013935168144,12343318,0.024481517896258048,-0.07264443043862912,-0.09712594833488716
2025-09-09T14:55:00-04:00,499.165,499.21,498.94,498.97,NaN,NaN,NaN,499.86745226172314,NaN,NaN,499.0427000000005,499.831114127971,498.25428587203,498.37437095092656,499.7813766860762,500.8477680375674,498.71498533458504,14392,9869.4,51.162646970206126,47.3635981195481,NaN,NaN,NaN,NaN,0.4154203062613889,9.627340969836633,12328926,0.03336288420526541,-0.0554223430783054,-0.08878522728357081
2025-09-09T15:00:00-04:00,498.98,498.99,498.54,498.84,NaN,NaN,NaN,499.86745226172314,NaN,NaN,499.0213000000004,499.77155011658306,498.27104988341773,498.2598641221425,499.7683957739681,500.83375994238037,498.70303160555585,10463,9950.3,48.892617396398464,47.618558642512745,NaN,NaN,NaN,NaN,0.41789028438557463,9.322152051317097,12318463,0.029693756700696086,-0.05166803140770071,-0.0813617881083968
2025-09-09T15:05:00-04:00,498.885,498.885,498.57,498.65,NaN,NaN,NaN,499.86745226172314,NaN,NaN,498.9997000000005,499.7289857034274,498.27041429657356,498.2598641221425,499.75463865167666,500.81993160865704,498.68934569469627,10440,10114.1,45.70108022133248,47.45267425079912,NaN,NaN,NaN,NaN,0.41054097835803344,9.038762341263244,12308023,0.014453826637021383,-0.06329450481212007,-0.07774833144914145
2025-09-09T15:10:00-04:00,498.59,498.66,498.28,498.33,NaN,NaN,NaN,499.8289906376237,NaN,NaN,498.9793000000004,499.72512574200607,498.23347425799477,498.2598641221425,499.73030643511726,500.8007778468148,498.6598350234197,15071,10370.9,40.86305116411556,46.95258100939926,NaN,NaN,NaN,NaN,0.40835947990389193,9.587027162752621,12292952,-0.01556879548119397,-0.0972093258006339,-0.08164053031943994
2025-09-09T15:15:00-04:00,498.33,498.85,498.19,498.44,NaN,NaN,NaN,499.8289906376237,NaN,NaN,498.9555000000005,499.69264652354525,498.2183534764557,498.2598641221425,499.7014996843356,500.77575586801476,498.62724350065645,19661,10732.7,43.09319858708375,46.1568941429133,NaN,NaN,NaN,NaN,0.42633380276790145,9.44524622746795,12312613,-0.025806007253669466,-0.11389803938652676,-0.0880920321328573
2025-09-09T15:20:00-04:00,498.45,498.62,498.26,498.28,NaN,NaN,NaN,499.8132538660993,NaN,NaN,498.9247000000004,499.6432441095115,498.20615589048936,498.2598641221425,499.681463899889,500.7596026933225,498.60332510645554,13064,10910.533333333333,40.68955756194873,45.54548784732996,NaN,NaN,NaN,NaN,0.4215956739987666,9.31359250184647,12299549,-0.040277407691387546,-0.13843879174709173,-0.09816138405570418
2025-09-09T15:25:00-04:00,498.28,498.39,498.07,498.15,NaN,NaN,NaN,499.58446959945843,NaN,NaN,498.8927000000005,499.6038489554945,498.1815510445065,498.2598641221425,499.65643465484516,500.7422848304893,498.570584479201,14767,11081.9,38.7960940781757,45.10113252380447,NaN,NaN,NaN,NaN,0.4143388401417113,9.739324000542569,12284782,-0.05463777055691396,-0.16645859725184664,-0.11182082669493268
2025-09-09T15:30:00-04:00,498.14,498.2,497.95,498.03,NaN,NaN,NaN,499.4019937085739,NaN,NaN,498.8693000000005,499.61463753219704,498.123962467804,498.2598641221425,499.617291736111,500.7177997832785,498.51678368894346,21920,11565.5,37.080773384210595,44.46534483675818,NaN,NaN,NaN,NaN,0.4026003515601605,10.458146632595575,12262862,-0.06741303610321417,-0.19608712182395038,-0.12867408572073621
2025-09-09T15:35:00-04:00,498,498.25,497.98,498.22,NaN,NaN,NaN,499.4019937085739,NaN,NaN,498.8435000000005,499.5876458169224,498.0993541830786,498.2598641221425,499.58975289996806,500.6979208643967,498.48158493553944,17100,11799.9,41.49171897011729,44.31575976673577,NaN,NaN,NaN,NaN,0.3931288978772906,10.925175765923955,12279962,-0.05858796909913855,-0.2019090470946594,-0.14332107799552085
2025-09-09T15:40:00-04:00,498.26,498.29,497.71,498.13,NaN,NaN,NaN,499.32333517661385,NaN,NaN,498.82310000000047,499.5881487285628,498.0580512714381,498.2598641221425,499.56120478440516,500.6786563927073,498.44375317610303,17136,12111.633333333333,40.059124183363544,44.04976383101076,NaN,NaN,NaN,NaN,0.4064768337432013,12.069647729100245,12262826,-0.054422268751865926,-0.21134891393535327,-0.15692664518348734
2025-09-09T15:45:00-04:00,498.13,498.46,498.13,498.32,NaN,NaN,NaN,499.32333517661385,NaN,NaN,498.80550000000045,499.5755292184372,498.0354707815637,498.00489129771404,499.53485459851765,500.6551183580333,498.414590839002,19861,12446.466666666667,44.42188614318001,44.25193010672287,NaN,NaN,NaN,NaN,0.401014202761543,12.4506543736841,12282687,-0.0354023568258541,-0.20117959121580498,-0.16577723438995087
2025-09-09T15:50:00-04:00,498.34,498.6,497.74,498.05,NaN,NaN,NaN,499.32333517661385,NaN,NaN,498.79050000000046,499.5890643350462,497.9919356649547,497.9394130381712,499.46910949311666,500.60237869273556,498.33584029349777,46548,13764.2,39.96978435344469,44.203170694347484,NaN,NaN,NaN,NaN,0.4337989025642909,13.728612592774578,12236139,-0.03734460429201253,-0.21245798975496655,-0.17511338546295402
2025-09-09T15:55:00-04:00,498.03,498.85,498.03,498.43,NaN,NaN,NaN,499.32333517661385,NaN,NaN,498.77830000000046,499.57987746798415,497.97672253201677,497.7628243444296,499.40826304374497,500.5341972379442,498.2823288495457,62290,15654.333333333334,47.886148725698206,43.93572783731933,NaN,NaN,NaN,NaN,0.4613846952382737,14.006755182937045,12298429,-0.01075711395042983,-0.18855977790099132,-0.1778026639505615
2025-09-10T09:30:00-04:00,502.84,503.19,499.97,500.06,499.57953905777003,499.57953905777003,499.57953905777003,NaN,NaN,NaN,498.7821000000005,499.6058380389649,497.95836196103613,499.7168595327724,501.0733333333334,501.0733333333334,501.0733333333334,143623,20271.133333333335,67.61462357802787,44.837307522664496,NaN,NaN,NaN,NaN,0.7684286455783964,17.174468068522568,12442052,0.11211510056941987,-0.037658788238786656,-0.14977388880820652
2025-09-10T09:35:00-04:00,500.04,500.44,497.56,498.435,NaN,NaN,NaN,501.3022581721287,501.3022581721287,501.3022581721287,498.7622000000005,499.57029444804664,497.9541055519544,499.7168595327724,500.226290554145,501.320935222117,499.13164588617303,85998,22978.6,48.075195534234346,44.61677527723794,NaN,NaN,NaN,NaN,0.9192551708942249,16.96413133325538,12356054,0.08091352161807866,-0.048631986785608206,-0.12954550840368687
2025-09-10T09:40:00-04:00,498.41,499.17,496.72,498.28,NaN,NaN,NaN,500.4767009824865,NaN,NaN,498.7428000000005,499.5496932005494,497.9359067994516,499.7168595327724,499.695286434607,501.0276137634253,498.3629591057887,74410,25221.9,46.68923461897519,44.45939079313628,NaN,NaN,NaN,NaN,1.0285940872589223,15.996227839914098,12281644,0.048404659680232526,-0.0690396838033962,-0.11744434348362873
2025-09-10T09:45:00-04:00,498.18,498.465,497.01,498.11,NaN,NaN,NaN,500.35253275600974,NaN,NaN,498.72700000000054,499.5517035813025,497.9022964186986,499.7168595327724,499.4855775872699,500.86855590601573,498.1025992685241,39262,26287.5,45.151764933431245,44.42015398685762,NaN,NaN,NaN,NaN,1.0590516524547124,15.097460310382907,12242382,0.0157129973859943,-0.09780309675113585,-0.11351609413713015
2025-09-10T09:50:00-04:00,498.12,499.4,497.75,498.83,NaN,NaN,NaN,500.35253275600974,NaN,NaN,498.7238000000005,499.5456334607231,497.9019665392779,499.7168595327724,499.37774256506356,500.69691035763515,498.05857477249197,51577,27733.9,52.31400558089797,45.238079302342086,NaN,NaN,NaN,NaN,1.1012622487079455,15.014347580728465,12293959,0.04138241802583406,-0.06178807160483757,-0.10317048963067163
2025-09-10T09:55:00-04:00,498.79,500.64,498.59,500.58,496.7379763524787,496.7379763524787,496.7379763524787,NaN,NaN,NaN,498.7522000000005,499.71791250229245,497.7864874977086,499.7168595327724,499.4492799326307,500.6952090117585,498.2033508535029,57958,29501.3,64.46126804347654,46.76436997779871,NaN,NaN,NaN,NaN,1.169029230943093,15.764771464923102,12351917,0.16792367619083357,0.10673410560787033,-0.06118957058296323
2025-09-10T10:00:00-04:00,500.52,501.64,500.43,501.25,498.12375015463874,NaN,NaN,NaN,NaN,NaN,498.80360000000053,499.99554637336894,497.6116536266321,499.7168595327724,499.6283018459095,500.91256183211215,498.34404185970686,54835,30993.033333333333,67.83909410608385,48.70362258809407,NaN,NaN,NaN,NaN,1.1719557144471564,17.01848209577072,12406752,0.28175013710326374,0.29099810079611643,0.009247963692852704
2025-09-10T10:05:00-04:00,501.26,501.82,500.47,500.47,498.18198878397334,NaN,NaN,NaN,NaN,NaN,498.8400000000005,500.1189448765258,497.56105512347517,499.7168595327724,499.7746417804605,501.0513872796607,498.49789628126035,64863,32863.4,60.61594294950025,50.26218322176011,NaN,NaN,NaN,NaN,1.1846731634152141,18.277370330934854,12341889,0.2884624601637065,0.3698260388974859,0.08136357873377935
2025-09-10T10:10:00-04:00,500.56,502.08,500.33,501.585,498.18198878397334,NaN,NaN,NaN,NaN,NaN,498.8997000000005,500.38954483656124,497.4098551634398,499.7168595327724,499.8544712157215,501.14459825947165,498.56434417197136,30940,33346.73333333333,66.16235072613881,52.33943874618355,NaN,NaN,NaN,NaN,1.225053651742699,19.586428639993187,12372829,0.34796285433562224,0.5163171466533072,0.16835429231768492
2025-09-10T10:15:00-04:00,501.51,502.61,501,501.57,498.6578968052319,NaN,NaN,NaN,NaN,NaN,498.96050000000054,500.6231355574756,497.29786444252545,499.7168595327724,500.0138008388921,501.3538344591221,498.67376721866214,56134,34785.433333333334,66.02763504186254,54.092004179879645,NaN,NaN,NaN,NaN,1.2525498194753644,21.081853428846124,12316695,0.3645236419784074,0.6240088447906942,0.25948520281228676
2025-09-10T10:20:00-04:00,501.57,502.35,501.32,502.18,498.69049240499413,NaN,NaN,NaN,NaN,NaN,499.0319000000005,500.9195841783324,497.14421582166864,498.5611633496511,500.1318794446389,501.5105968001535,498.7531620891243,42838,35741.53333333333,68.80901066346073,56.14556749988658,NaN,NaN,NaN,NaN,1.2366534037985546,22.470462161352422,12359533,0.39235778904395524,0.7499324391172308,0.3575746500732756
2025-09-10T10:25:00-04:00,502.18,502.45,501.48,501.48,498.83115184113075,NaN,NaN,NaN,NaN,NaN,499.09130000000056,501.0930250652501,497.089574934751,498.93393067972085,500.2189910038772,501.611761058313,498.8262209494414,38622,36523.86666666667,62.486719716302716,57.43591275510964,NaN,NaN,NaN,NaN,1.2176067320986557,23.816574975005388,12320911,0.34130334504334253,0.7842038313774538,0.4429004863341112
2025-09-10T10:30:00-04:00,501.49,502.07,501.44,501.93,498.83115184113075,NaN,NaN,NaN,NaN,NaN,499.1615000000005,501.30528100489823,497.01771899510277,498.9421445437767,500.28537253558,501.6855409376533,498.8852041335067,32195,37133.2,64.73024400937217,59.20451701624732,NaN,NaN,NaN,NaN,1.175634822663037,25.008846553504853,12353106,0.31609183283476294,0.8380152773775649,0.5219234445428019
2025-09-10T10:35:00-04:00,501.91,502.15,501.48,501.71,498.83115184113075,NaN,NaN,NaN,NaN,NaN,499.21890000000053,501.47587522291246,496.9619247770886,499.31271563502133,500.3402816332936,501.7429583874789,498.93760487910833,29491,37851.5,62.754258359385496,60.26652484722498,NaN,NaN,NaN,NaN,1.1395180496156745,26.167629450197232,12323615,0.2649215267590803,0.8530753529916524,0.5881538262325721
2025-09-10T10:40:00-04:00,501.69,502.78,500.99,502.7,498.83115184113075,NaN,NaN,NaN,NaN,NaN,499.2889000000005,501.7473045958758,496.83049540412526,499.6151725080171,500.44841438211716,501.8749805624838,499.0218482017505,50814,39158.26666666667,67.55416407854827,60.262206311547864,NaN,NaN,NaN,NaN,1.1859810460716953,27.636074141544142,12374429,0.27677874706398475,0.934127260062553,0.6573485129985682
2025-09-10T10:45:00-04:00,502.64,502.73,501.25,502.62,498.83115184113075,NaN,NaN,NaN,NaN,NaN,499.35370000000046,501.9831469451378,496.72425305486314,499.6151725080171,500.52026121570344,501.9598095032071,499.0807129281998,36509,39962.4,66.80495295146206,61.600046127064125,NaN,NaN,NaN,NaN,1.2069823999237184,28.99962992636627,12337920,0.2586030897406535,0.9806023751743851,0.7219992854337316
2025-09-10T10:50:00-04:00,502.64,502.91,501.3,501.42,498.8361377317034,NaN,NaN,NaN,NaN,NaN,499.3923000000005,502.0845319434046,496.70006805659636,499.6151725080171,500.5506936614471,501.9881071593145,499.1132801635797,20428,39773.666666666664,56.654955372858026,62.31188332377004,NaN,NaN,NaN,NaN,1.2357693713577393,30.380126858289604,12317492,0.15049101231690576,0.9101130508298638,0.7596220385129581
2025-09-10T10:55:00-04:00,501.39,501.42,499.66,499.73,498.8361377317034,NaN,NaN,NaN,NaN,NaN,499.4095000000005,502.0991522074477,496.7198477925533,499.6151725080171,500.5400685569403,501.9510316160398,499.1291054978408,35821,40487.96666666667,46.04467559787613,62.37566265694468,NaN,NaN,NaN,NaN,1.2732144162607573,29.24967183720584,12281671,-0.03993771185148465,0.7096998986986023,0.7496376105500869
2025-09-10T11:00:00-04:00,499.84,499.84,498.72,499.06,NaN,NaN,NaN,502.64026500065864,502.64026500065864,502.64026500065864,499.40330000000046,502.094716436947,496.7118835630539,499.6151725080171,500.4937570347733,501.9013362005147,499.08617786903187,34050,41274.2,42.63561844465018,61.68434929006984,NaN,NaN,NaN,NaN,1.2622705293849852,27.191672803547334,12247621,-0.2067932838536124,0.49114600573307143,0.6979392895866838
2025-09-10T11:05:00-04:00,499.11,499.96,498.53,499.02,NaN,NaN,NaN,502.64026500065864,NaN,NaN,499.40150000000045,502.0938188884733,496.7091811115276,499.6151725080171,500.45557535442987,501.86028801875716,499.0508626901026,29117,41896.76666666667,42.43362611309481,60.110946295042574,NaN,NaN,NaN,NaN,1.2742512058574869,25.405555083297156,12218504,-0.3094503640366145,0.31112633454091565,0.6205766985775302
2025-09-10T11:10:00-04:00,498.88,499.77,498.5,499.69,NaN,NaN,NaN,502.5560472423357,NaN,NaN,499.4149000000005,502.1061595484391,496.7236404515619,499.6151725080171,500.4313746602331,501.83068223460924,499.0320670858569,21982,42127.13333333333,46.965908331763195,58.62000445401967,NaN,NaN,NaN,NaN,1.2739475482962366,23.77791442889235,12240486,-0.3204717782173421,0.21998697580585258,0.5404587540231947
2025-09-10T11:15:00-04:00,499.65,500,499.48,499.69,NaN,NaN,NaN,502.5560472423357,NaN,NaN,499.43050000000045,502.1189131001687,496.7420868998322,499.6151725080171,500.4210069593378,501.8126331562194,499.0293807624561,15328,41982.7,46.965908331763195,57.64500198132417,NaN,NaN,NaN,NaN,1.220094151989361,22.15065324242697,12240486,-0.3155073862328347,0.14607452123215126,0.46158190746498595
2025-09-10T11:20:00-04:00,499.66,499.89,499.19,499.86,NaN,NaN,NaN,502.5560472423357,NaN,NaN,499.44810000000047,502.13600765413213,496.7601923458688,499.6151725080171,500.40605987077,501.7883013661986,499.02381837534136,20604,42234.03333333333,48.1667885036249,56.359604679716035,NaN,NaN,NaN,NaN,1.1829445697044059,20.82661171476057,12261090,-0.2892155342687803,0.10006248962901054,0.38927802389779087
2025-09-10T11:25:00-04:00,499.875,500.87,499.67,500.71,NaN,NaN,NaN,502.5560472423357,NaN,NaN,499.4871000000005,502.1904823919334,496.7837176080676,499.6151725080171,500.40634753825424,501.7697173573136,499.0429777191949,29756,42733.666666666664,53.799828265179094,55.48618990995293,NaN,NaN,NaN,NaN,1.184162814725519,20.135197683246876,12290846,-0.20687911379534646,0.13067913165360778,0.33755824544895424
2025-09-10T11:30:00-04:00,500.69,500.78,499.98,500.45,NaN,NaN,NaN,502.5560472423357,NaN,NaN,499.5211000000005,502.22930256940225,496.81289743059875,499.487510405131,500.4062991431836,501.7586798211559,499.0539184652113,17903,42599.76666666667,51.94040138030696,54.281289246870514,NaN,NaN,NaN,NaN,1.156722613673693,19.493170368269872,12272943,-0.16409734224960826,0.1324365676369439,0.29653390988655215
2025-09-10T11:35:00-04:00,500.39,500.7,500.14,500.29,NaN,NaN,NaN,502.5560472423357,NaN,NaN,499.5487000000005,502.2595550748638,496.83784492513723,499.487510405131,500.4058509843685,501.74797093338174,499.06373103535526,17123,42600.53333333333,50.77734825755596,53.44490557124575,NaN,NaN,NaN,NaN,1.114099569839858,18.8970021472198,12255820,-0.1415945720905854,0.11954069477332041,0.2611352668639058
2025-09-10T11:40:00-04:00,500.23,501.24,500.15,501.1,NaN,NaN,NaN,502.5560472423357,NaN,NaN,499.59270000000055,502.3312851888679,496.8541148111332,498.78328435973845,500.4130597308226,501.7448544977608,499.08126496388445,19575,42681.833333333336,56.13266564456584,52.830792830902446,NaN,NaN,NaN,NaN,1.1123781719941561,18.910101656012614,12275395,-0.07075606295248016,0.17269018817330561,0.24344625112578577
2025-09-10T11:45:00-04:00,501.15,501.46,500.41,501.46,NaN,NaN,NaN,502.5560472423357,NaN,NaN,499.6361000000005,502.42248280875737,496.84971719124366,498.9696274877908,500.4266361579766,501.74890830419946,499.1043640117537,22882,42782.53333333333,58.30395278060804,52.51291386098977,NaN,NaN,NaN,NaN,1.1079225882802846,19.140160256204506,12298277,-0.0018918020831934501,0.24108149852179395,0.2429733006049874
2025-09-10T11:50:00-04:00,501.41,501.55,500.97,501.275,NaN,NaN,NaN,502.5560472423357,NaN,NaN,499.6818000000005,502.49907865801816,496.8645213419829,499.26770199023264,500.4430240617377,501.75744302057694,499.1286051028984,23419,42011.566666666666,56.74944972434175,51.74114854997502,NaN,NaN,NaN,NaN,1.070213831974549,19.444653674825588,12274858,0.027348744890116322,0.2771592317176328,0.24981048682751647
2025-09-10T11:55:00-04:00,501.27,501.27,500.82,500.83,NaN,NaN,NaN,502.5560472423357,NaN,NaN,499.72430000000054,502.54546501411056,496.9031349858905,499.26770199023264,500.4481420223652,501.7572299791616,499.13905406556876,11675,40324.4,53.08318737307131,50.761022437232825,NaN,NaN,NaN,NaN,1.0262699868335086,19.476294675221947,12263183,0.013566151928043724,0.26676817673757114,0.2532020248095274
2025-09-10T12:00:00-04:00,500.81,500.84,500.35,500.4,NaN,NaN,NaN,502.5560472423357,NaN,NaN,499.7571000000005,502.5707816374788,496.9434183625222,499.26770199023264,500.448892931793,501.7519860829581,499.1457997806279,11200,35910.3,49.73927806783061,50.26704548687372,NaN,NaN,NaN,NaN,0.9879649877739689,18.754691832798898,12251983,-0.025533660398243313,0.22128494931172327,0.24681860970996658
2025-09-10T12:05:00-04:00,500.425,500.68,500.06,500.6,NaN,NaN,NaN,502.5560472423357,NaN,NaN,499.7971000000005,502.6006927587429,496.9935072412581,499.26770199023264,500.448865136971,501.74379823190117,499.1539320420408,15436,33558.23333333333,51.27665656844213,50.64075841334272,NaN,NaN,NaN,NaN,0.9616817743615428,17.654445607205858,12267419,-0.0381888139923755,0.1990825922194972,0.2372714062118727
2025-09-10T12:10:00-04:00,500.6,500.6,499.69,499.72,NaN,NaN,NaN,502.5560472423357,NaN,NaN,499.81930000000057,502.60244570886437,497.03615429113677,499.26770199023264,500.4384394239672,501.7199029114157,499.15697593651873,29625,32065.4,44.78543755429057,50.79431692117418,NaN,NaN,NaN,NaN,0.9579902190500057,16.67328469675221,12237794,-0.10244160063941612,0.10921940541260255,0.21166100605201868
2025-09-10T12:15:00-04:00,499.68,500.09,499.52,499.6,NaN,NaN,NaN,502.5560472423357,NaN,NaN,499.8419000000006,502.59908253960924,497.0847174603919,499.26770199023264,500.43072687030786,501.7072276599967,499.154226080619,14068,31225.6,43.96805184012792,50.903918758819394,NaN,NaN,NaN,NaN,0.9302766319750048,15.993026166299165,12223726,-0.1469316371920001,0.027996459562018572,0.17492809675401866
2025-09-10T12:20:00-04:00,499.59,499.74,499.1,499.46,NaN,NaN,NaN,502.23222421358145,NaN,NaN,499.86290000000054,502.59199002363204,497.13380997636904,499.26770199023264,500.4151459399531,501.6876619750592,499.142629904847,20314,30183.5,42.98242480696983,50.61938422133416,NaN,NaN,NaN,NaN,0.909542586833932,15.9060846652667,12203412,-0.17764398997507208,-0.04712689071482146,0.13051709926025062
2025-09-10T12:25:00-04:00,499.43,499.78,499.21,499.24,NaN,NaN,NaN,502.23222421358145,NaN,NaN,499.86830000000054,502.5913634287376,497.14523657126347,499.26770199023264,500.4075361667919,501.6782165696779,499.1368557639059,9920,28582.233333333334,41.41142933740071,50.222635721736836,NaN,NaN,NaN,NaN,0.885289544917222,15.75686783291013,12193492,-0.20281129172539472,-0.12299701539649277,0.07981427632890195
2025-09-10T12:30:00-04:00,499.22,499.59,499,499.59,NaN,NaN,NaN,502.01202660782934,NaN,NaN,499.8765000000006,502.5936862278336,497.1593137721676,499.26770199023264,500.3921397168818,501.6592211431073,499.1250582906563,20198,27427.666666666668,44.86405047927719,49.98672586285486,NaN,NaN,NaN,NaN,0.8641974345659901,15.89594224742168,12213690,-0.18634543503473974,-0.15311751746452273,0.03322791757021701
2025-09-10T12:35:00-04:00,499.59,499.78,499.11,499.32,NaN,NaN,NaN,502.01202660782934,NaN,NaN,499.8835000000006,502.5931016306287,497.17389836937247,499.26770199023264,500.3803312344264,501.64439575952207,499.1162667093308,16081,25801.6,42.77014465524169,49.1988913192879,NaN,NaN,NaN,NaN,0.850326189239845,15.671181300011902,12197609,-0.18379012124450023,-0.19650973398540827,-0.012719612740908048
2025-09-10T12:40:00-04:00,499.32,499.75,499.1,499.64,NaN,NaN,NaN,502.01202660782934,NaN,NaN,499.89950000000056,502.59366944470156,497.20533055529955,499.2166615921861,500.3712578093761,501.63196710203556,499.1105485167167,13970,25235.933333333334,45.987673479481614,48.77369646922896,NaN,NaN,NaN,NaN,0.8360171757227116,15.47730864866414,12211579,-0.1520163035079814,-0.20273999212588478,-0.0507236886179034
2025-09-10T12:45:00-04:00,499.6,499.76,499.16,499.19,NaN,NaN,NaN,502.01202660782934,NaN,NaN,499.9103000000005,502.5886303823562,497.23196961764484,498.9523292737489,500.36380578531674,501.6227595204597,499.1048520501738,10202,23704.866666666665,42.379381821106364,48.17384172376826,NaN,NaN,NaN,NaN,0.8191588060282298,15.27665526538365,12201377,-0.1523876548180768,-0.24120825714049943,-0.08882060232242261
2025-09-10T12:50:00-04:00,499.21,499.38,498.845,499.3,NaN,NaN,NaN,501.67947289169655,NaN,NaN,499.92970000000054,502.5758212438041,497.28357875619696,498.8598634189991,500.3555062616678,501.6139564523333,499.0970560710023,9637,22598.166666666668,43.54545014728592,47.274754902533985,NaN,NaN,NaN,NaN,0.7988617484547825,15.588192316427415,12211014,-0.13680229445380307,-0.25982347038967646,-0.12302117593587339
2025-09-10T12:55:00-04:00,499.37,499.61,499.35,499.49,NaN,NaN,NaN,501.67947289169655,NaN,NaN,499.9507000000005,502.5656806953445,497.3357193046565,498.6888907351993,500.3509919174956,501.6077403483247,499.0942434866665,7182,21550.166666666668,45.593508858924395,46.36686605098515,NaN,NaN,NaN,NaN,0.763943052136584,15.372849525246915,12218196,-0.10661537348206743,-0.25629039278845767,-0.14967501930639024
2025-09-10T13:00:00-04:00,499.51,500.28,499.49,500.16,NaN,NaN,NaN,501.67947289169655,NaN,NaN,499.98830000000055,502.5598120915072,497.4167879084939,498.759062949535,500.3453083271466,501.5933190072609,499.0972976470323,21393,21190.1,52.18139708570986,46.040576576797164,NaN,NaN,NaN,NaN,0.7658042626982539,14.633465542310779,12239589,-0.03798344884491717,-0.1971543303625367,-0.15917088151761954
2025-09-10T13:05:00-04:00,500.18,501.01,500.11,500.99,NaN,NaN,NaN,501.67947289169655,NaN,NaN,500.04510000000045,502.5768373396923,497.5133626603086,499.34325035962803,500.3487635354108,501.59123061261755,499.10629645820404,13730,20664.733333333334,58.831765701962865,46.45118931457513,NaN,NaN,NaN,NaN,0.7753896725055197,14.998254418865193,12253319,0.061444658561852494,-0.08236505831530394,-0.14380971687715643
2025-09-10T13:10:00-04:00,501.015,501.375,500.73,500.8,NaN,NaN,NaN,501.67947289169655,NaN,NaN,500.10050000000047,502.5739908524472,497.62700914755374,499.7191002877024,500.3538326580331,501.5924646275285,499.11520068853775,11736,19362.133333333335,56.8815595518807,46.961352277721566,NaN,NaN,NaN,NaN,0.7660761244694099,15.778526365740161,12241583,0.1097289691201571,-0.006648505476960054,-0.11637747459711716
2025-09-10T13:15:00-04:00,500.8,500.81,500.53,500.62,NaN,NaN,NaN,501.67947289169655,NaN,NaN,500.14850000000047,502.5666871303056,497.73031286969535,499.7191002877024,500.3555486694992,501.59083397741,499.12026336158846,8266,18420.7,55.020763239139235,47.228788468485654,NaN,NaN,NaN,NaN,0.7313564012930256,16.11204913740648,12233317,0.12381427740991885,0.038390372165281406,-0.08542390524463744
2025-09-10T13:20:00-04:00,500.68,500.79,500.1,500.15,NaN,NaN,NaN,501.67947289169655,NaN,NaN,500.1889000000005,502.5373363216961,497.8404636783049,499.7191002877024,500.3554553119594,501.5842318454065,499.1266787785123,15325,18250.6,50.38580740535709,47.62881488641898,NaN,NaN,NaN,NaN,0.7284023726292379,15.634952479183134,12217992,0.09693661819684282,0.03574686750141609,-0.06118975069542673
2025-09-10T13:25:00-04:00,500.15,500.22,499.51,499.72,NaN,NaN,NaN,501.67947289169655,NaN,NaN,500.2169000000005,502.50822790253375,497.9255720974673,499.7191002877024,500.3523762992462,501.578309680463,499.1264429180294,8380,17335.9,46.52432260989614,47.811405655688134,NaN,NaN,NaN,NaN,0.7270879174414377,14.774939897599214,12209612,0.048124904238210565,-0.001033620397663526,-0.04915852463587409
2025-09-10T13:30:00-04:00,499.715,500,499.59,499.99,NaN,NaN,NaN,501.67947289169655,NaN,NaN,500.2557000000005,502.4631066315499,498.0482933684511,499.7191002877024,500.34850925426616,501.57039227074875,499.12662623778357,11608,16587.833333333332,49.159073472505796,48.25259484608356,NaN,NaN,NaN,NaN,0.7044387804813369,13.976356786128436,12221220,0.03268681868250061,-0.008300001282748326,-0.04098681996524894
2025-09-10T13:35:00-04:00,499.96,500.5,499.96,500.28,NaN,NaN,NaN,501.67947289169655,NaN,NaN,500.29270000000054,502.4375918007044,498.14780819929666,499.7191002877024,500.3473807545209,501.562521945176,499.13223956386577,16561,16169.3,51.900297728508136,49.001799731162656,NaN,NaN,NaN,NaN,0.6926931533041001,13.496371930903702,12237781,0.04017782021490545,0.009235455303382878,-0.030942364911522573
2025-09-10T13:40:00-04:00,500.26,500.47,500.15,500.18,NaN,NaN,NaN,501.67947289169655,NaN,NaN,500.2951000000005,502.43921332648796,498.15098667351305,499.7191002877024,500.3468447191949,501.557961956965,499.1357274814248,9992,15769.633333333333,50.881523612154425,49.431619240653895,NaN,NaN,NaN,NaN,0.6660722137823821,13.050671708195024,12227789,0.036667176377009794,0.014891605559739673,-0.02177557081727012
2025-09-10T13:45:00-04:00,500.17,500.77,500.12,500.67,NaN,NaN,NaN,501.67947289169655,NaN,NaN,500.33980000000054,502.41914504995873,498.26045495004234,499.7191002877024,500.34836965706654,501.5542506141114,499.14248870002166,13368,15704.3,55.49181813475766,50.34031020347646,NaN,NaN,NaN,NaN,0.6649241985122103,13.086863026215415,12241157,0.06401379784978288,0.05824167649495848,-0.005772121354824401
2025-09-10T13:50:00-04:00,500.68,500.87,500.42,500.46,NaN,NaN,NaN,501.67947289169655,NaN,NaN,500.38340000000056,502.3778437211246,498.38895627887655,499.7191002877024,500.3501287651024,501.5516579175766,499.1485996126282,11450,15399.166666666666,53.18770940657739,50.8545984839833,NaN,NaN,NaN,NaN,0.6495724700470517,13.26746685797782,12229707,0.06444933526263491,0.07478954772346924,0.010340212460834327
2025-09-10T13:55:00-04:00,500.51,500.75,500.39,500.71,NaN,NaN,NaN,501.67947289169655,NaN,NaN,500.4354000000006,502.32274081622,498.54805918378116,499.7191002877024,500.3517313272129,501.54982013184645,499.1536425225794,9251,14715.666666666666,55.55371040597337,51.79562195433095,NaN,NaN,NaN,NaN,0.6288887221865489,13.372136270110389,12238958,0.07720392723450523,0.10684512150396586,0.029641194269460634
2025-09-10T14:00:00-04:00,500.74,500.89,500.62,500.74,NaN,NaN,NaN,501.67947289169655,NaN,NaN,500.4736000000006,502.3059362564007,498.6412637436005,499.7639292291356,500.3540507297785,501.54903009935674,499.1590713602003,9013,14419.333333333334,55.84213284786634,52.67395643294383,NaN,NaN,NaN,NaN,0.603253813458937,13.694330979224539,12247971,0.08279539775025892,0.1331354414572843,0.05034004370702537
2025-09-10T14:05:00-04:00,500.76,500.76,499.99,500.14,NaN,NaN,NaN,501.67947289169655,NaN,NaN,500.4648000000006,502.2992328378533,498.6303671621479,499.7639292291356,500.35359461115667,501.54382625252254,499.1633629697908,12400,14261.9,48.99429138039174,52.9168694701915,NaN,NaN,NaN,NaN,0.6151642553547259,12.717392928011565,12235571,0.043210212721759345,0.10435280960922455,0.061142596887465206
2025-09-10T14:10:00-04:00,500.16,500.82,500.1,500.62,NaN,NaN,NaN,501.67947289169655,NaN,NaN,500.4522000000006,502.2734942202286,498.63090577977255,499.7639292291356,500.35476100420397,501.54071720025934,499.1688048081486,11475,13991.9,53.8680922928925,53.03734769927598,NaN,NaN,NaN,NaN,0.6226525228293862,11.917334800524644,12247046,0.046208888133786846,0.11890370705469877,0.07269481892091192
2025-09-10T14:15:00-04:00,500.61,500.755,500.33,500.43,NaN,NaN,NaN,501.67947289169655,NaN,NaN,500.4514000000006,502.27269738281063,498.6301026171906,499.7639292291356,500.355794279687,501.53773042709264,499.1738581322814,10883,13591.933333333332,51.75976354779865,52.53220468826425,NaN,NaN,NaN,NaN,0.6085344854844309,11.174423682143932,12236163,0.03287795260222015,0.11379225967368711,0.08091430707146696
2025-09-10T14:20:00-04:00,500.38,501.23,500.36,501.21,NaN,NaN,NaN,501.67947289169655,NaN,NaN,500.44390000000067,502.24948388238334,498.638316117618,499.7639292291356,500.3718624503202,501.5411051858711,499.20261971476924,45285,14320.8,58.875684316590906,52.67464217145783,NaN,NaN,NaN,NaN,0.6272105936641148,11.352788793662718,12281448,0.07183896135592241,0.17071300876636997,0.09887404741044756
2025-09-10T14:25:00-04:00,501.23,501.33,500.58,501.1,NaN,NaN,NaN,501.67947289169655,NaN,NaN,500.43450000000064,502.2213321120306,498.64766788797067,499.7639292291356,500.3781295413959,501.5432383732278,499.213020709564,16316,14475.5,57.58559929553544,52.857844746914715,NaN,NaN,NaN,NaN,0.6359812655452494,11.686263694066271,12265132,0.08457169094322119,0.20458866108947404,0.12001697014625286
2025-09-10T14:30:00-04:00,501.09,501.2,500.75,501.2,NaN,NaN,NaN,501.67947289169655,NaN,NaN,500.4149000000006,502.1453247908149,498.6844752091863,499.7639292291356,500.3838915520554,501.5456466369982,499.2221364671126,14221,14576.2,58.47637752991009,53.43574261295421,NaN,NaN,NaN,NaN,0.6226968894348736,11.995918958726715,12279353,0.09340652596142712,0.23677512759803676,0.14336860163660964
2025-09-10T14:35:00-04:00,501.24,501.27,500.69,500.99,NaN,NaN,NaN,501.67947289169655,NaN,NaN,500.40510000000063,502.11673370978775,498.6934662902135,499.79519560307403,500.3868841964597,501.5465055744977,499.22726281842165,8320,14339,55.82489858579927,54.100069468375864,NaN,NaN,NaN,NaN,0.6196471116180957,12.413147280490211,12271033,0.0793387313775838,0.24254201585858937,0.16320328448100557
2025-09-10T14:40:00-04:00,501.07,501.25,500.92,500.96,NaN,NaN,NaN,501.67947289169655,NaN,NaN,500.38570000000055,502.0490676793515,498.7223323206496,499.90515648245923,500.39027929467585,501.5478561337205,499.2327024556312,8664,13640.3,55.43817267446525,54.54857655423011,NaN,NaN,NaN,NaN,0.5989580322168021,12.8005735792706,12262369,0.062959819764701,0.24190305918688182,0.17894323942218082
2025-09-10T14:45:00-04:00,501,501,500.57,500.7,NaN,NaN,NaN,501.67947289169655,NaN,NaN,500.36550000000057,501.98807850244077,498.74292149756036,499.90515648245923,500.39223307581955,501.5470276988613,499.2374384527778,8981,13470.733333333334,52.07141772262,54.56079941095238,NaN,NaN,NaN,NaN,0.5868896013441738,12.222620528064239,12253388,0.031169393540609214,0.21790498134794234,0.18673558780733313
2025-09-10T14:50:00-04:00,500.68,500.73,500.47,500.675,NaN,NaN,NaN,501.67947289169655,NaN,NaN,500.32500000000056,501.8075221740917,498.84247782590944,499.90515648245923,500.3940500322151,501.54451110437077,499.2435889600594,13250,13235.266666666666,51.74600779789719,54.62254828136258,NaN,NaN,NaN,NaN,0.5635403441053036,11.438065848986705,12240138,0.006311944847039536,0.19462551886613255,0.18831357401909302
2025-09-10T14:55:00-04:00,500.63,501.63,500.63,501.58,NaN,NaN,NaN,501.67947289169655,NaN,NaN,500.30420000000055,501.68288830295626,498.92551169704484,500.19984011901914,500.40217546578543,501.55045871969105,499.2538922118798,15712,13428.333333333334,61.19896963580688,55.03020196000896,NaN,NaN,NaN,NaN,0.5947160338120676,12.424683571869528,12255850,0.04643906184238461,0.24636240132207377,0.19992333947968915
2025-09-10T15:00:00-04:00,501.61,501.88,501.11,501.11,499.52991008169016,499.52991008169016,499.52991008169016,NaN,NaN,NaN,500.2980000000006,501.6592391400113,498.93676085998993,500.3508720952153,500.40802030742014,501.55526356558556,499.2607770492547,10445,13103.233333333334,55.15586245550148,55.1707843206464,NaN,NaN,NaN,NaN,0.6072363171112044,13.702829688911008,12245405,0.03733858410661789,0.2465965696129615,0.2092579855063436
2025-09-10T15:05:00-04:00,501.15,501.2,500.525,500.64,499.52991008169016,NaN,NaN,NaN,NaN,NaN,500.3162000000006,501.67089341046886,498.96150658953235,500.3508720952153,500.40997642136983,501.5545888393887,499.26536400335095,8911,12864.233333333334,49.85430429496704,54.76368388414594,NaN,NaN,NaN,NaN,0.6120765801746906,13.531345726998662,12236494,-0.00222483641488469,0.20647693998773775,0.20870177640262244
2025-09-10T15:10:00-04:00,500.63,500.63,499.5,499.69,NaN,NaN,NaN,502.09882159912115,502.09882159912115,502.09882159912115,500.32880000000057,501.64777165884436,499.0098283411568,500.3508720952153,500.4054721580364,501.54550628562106,499.2654380304517,16765,12957.4,41.22816796296982,53.719829249510475,NaN,NaN,NaN,NaN,0.6497853958764974,13.473965774766885,12219729,-0.08943526721027606,0.09690769238977737,0.18634295960005343
2025-09-10T15:15:00-04:00,499.73,500.005,499.47,500,NaN,NaN,NaN,501.75182970825205,NaN,NaN,500.34840000000054,501.61716386952554,499.07963613047554,500.3508720952153,500.39884783145567,501.53403384830546,499.2636618146059,20193,13290.433333333332,44.5969294565409,53.40573196923542,NaN,NaN,NaN,NaN,0.6415864390281739,13.462818660964453,12239922,-0.12132410860355022,0.03468782384561564,0.15601193244916586
2025-09-10T15:20:00-04:00,499.97,499.97,499.08,499.34,NaN,NaN,NaN,501.5732238124224,NaN,NaN,500.3414000000005,501.62834838947475,499.0544516105262,500.3508720952153,500.39279763766353,501.5267891476831,499.258806127644,11518,13353.133333333333,39.41670816577331,52.37349024586975,NaN,NaN,NaN,NaN,0.6614731219547341,13.98771177028724,12228404,-0.1784933954754973,-0.06710481189520578,0.11138858358029152
2025-09-10T15:25:00-04:00,499.34,499.44,499.11,499.4,NaN,NaN,NaN,501.2751227300395,NaN,NaN,500.33560000000057,501.63677429909114,499.03442570091,500.3508720952153,500.38148743296347,501.5148297506221,499.24814511530485,18917,13744.3,40.09791235612583,51.54050087503599,NaN,NaN,NaN,NaN,0.6377964703865376,14.4751125146584,12247321,-0.20215552682172847,-0.14130582494686905,0.060849701874859406
2025-09-10T15:30:00-04:00,499.4,500,499.38,499.75,NaN,NaN,NaN,501.2751227300395,NaN,NaN,500.33340000000055,501.63815045762755,499.02864954237356,500.3508720952153,500.36926719585216,501.49583079661704,499.2427035950873,33363,14143.3,44.049995278408595,50.48152308659439,NaN,NaN,NaN,NaN,0.6365252939303566,13.84174393349503,12280684,-0.18460773835639774,-0.16990997107063777,0.014697767285759965
2025-09-10T15:35:00-04:00,499.79,500.09,499.38,499.45,NaN,NaN,NaN,501.2751227300395,NaN,NaN,500.3082000000005,501.63142297319894,498.9849770268021,500.3508720952153,500.3638816867146,501.4880131749276,499.2397501985016,13639,14140.266666666666,41.52131960026743,49.33407453693239,NaN,NaN,NaN,NaN,0.6417734872210439,13.092817355794734,12267045,-0.183210977693062,-0.21431595483056753,-0.03110497713750554
2025-09-10T15:40:00-04:00,499.44,500.39,499.3,500.38,NaN,NaN,NaN,501.2751227300395,NaN,NaN,500.3068000000005,501.6295679451931,498.9840320548079,500.3508720952153,500.3576287257326,501.4723300749991,499.24292737646607,34546,14900.6,50.926019253236014,48.79476323145566,NaN,NaN,NaN,NaN,0.6737896667052532,12.442612802235232,12301591,-0.11309728748704839,-0.17247658649631603,-0.05937929900926764
2025-09-10T15:45:00-04:00,500.37,500.54,500.13,500.26,NaN,NaN,NaN,501.2751227300395,NaN,NaN,500.30620000000056,501.6290250967914,498.9833749032097,500.3508720952153,500.35683647656066,501.4622448445903,499.251428108531,31825,15685.9,49.81282358586786,48.36532930288913,NaN,NaN,NaN,NaN,0.6549475476548797,12.09165663898449,12269766,-0.07033940802288985,-0.14730355903787995,-0.0769641510149901
2025-09-10T15:50:00-04:00,500.29,500.6,500.1,500.19,NaN,NaN,NaN,501.2751227300395,NaN,NaN,500.28800000000047,501.5915382606957,498.98446173930523,499.6391976761722,500.3555128227409,501.4487304629009,499.26229518258083,43036,16609.6,49.13806057694888,47.91532129592368,NaN,NaN,NaN,NaN,0.6438798656795311,11.869015483612364,12226730,-0.04361785852719394,-0.13148647417398251,-0.08786861564678858
2025-09-10T15:55:00-04:00,500.19,500.47,500.09,500.2,NaN,NaN,NaN,501.2751227300395,NaN,NaN,500.2628000000005,501.5227224726677,499.0028775273333,498.994075416831,500.35222043279106,501.42783258934145,499.27660827624067,65134,18501.4,49.243836187292956,47.71335118625747,NaN,NaN,NaN,NaN,0.6250313038452827,11.640499468204373,12291864,-0.023143530732223222,-0.1167980290620676,-0.09365449832984438
2025-09-11T09:30:00-04:00,502.17,502.8,500.3,500.82,499.3269435027489,499.3269435027489,499.3269435027489,NaN,NaN,NaN,500.25370000000044,501.49061035941537,499.0167896405855,500.31926033346474,501.3066666666666,501.30667429606115,501.3066590372721,45958,19646.4,55.43237961356466,47.97666345880515,NaN,NaN,NaN,NaN,0.7661004964277642,14.119070445410076,12337822,0.031323385151020816,-0.05450026689106835,-0.08582365204208917
2025-09-11T09:35:00-04:00,500.77,501.16,499.05,499.28,NaN,NaN,NaN,502.51473574737605,502.51473574737605,502.51473574737605,500.2227000000005,501.47784175975477,498.9675582402462,500.31926033346474,500.5774985589297,501.3157750042751,499.83922211358424,44831,20588.733333333334,41.79957445976744,46.59099237480233,NaN,NaN,NaN,NaN,0.8620933181114963,14.409018021487299,12292991,-0.033676595207741425,-0.12791939605176594,-0.09424280084402452
2025-09-11T09:40:00-04:00,499.28,499.63,497.88,498.53,NaN,NaN,NaN,501.29383866794984,NaN,NaN,500.18530000000044,501.52563191312686,498.844968086874,500.31926033346474,499.91486274284915,500.9979028033064,498.83182268239193,48718,21879.6,37.02395473425054,45.29585610899869,NaN,NaN,NaN,NaN,0.9255152239606751,13.452780658616625,12244273,-0.11965599510636254,-0.2438127947269777,-0.12415679962061515
2025-09-11T09:45:00-04:00,498.6,499.6,498.55,499.37,NaN,NaN,NaN,501.29383866794984,NaN,NaN,500.1607000000004,501.51476352781,498.80663647219086,500.31926033346474,499.76434291035605,500.77619130820335,498.75249451250875,35530,22618.333333333332,44.65121667695962,44.92420699342674,NaN,NaN,NaN,NaN,0.9358355651063447,12.564845964522428,12279803,-0.11253490082989903,-0.26482542565798894,-0.1522905248280899
2025-09-11T09:50:00-04:00,499.36,500.09,499,499.63,NaN,NaN,NaN,501.29383866794984,NaN,NaN,500.1589000000004,501.51553891932997,498.80226108067086,500.31926033346474,499.7412214505823,500.69189744451074,498.7905454566539,24106,23040.2,46.79900642717326,45.32212402658413,NaN,NaN,NaN,NaN,0.9468473104558897,12.122148149658035,12303909,-0.08419127520157818,-0.25752961883006265,-0.17333834362848446
2025-09-11T09:55:00-04:00,499.68,500.45,499.38,500.28,NaN,NaN,NaN,501.29383866794984,NaN,NaN,500.1725000000004,501.5200581610273,498.82494183897353,500.31926033346474,499.7720789262243,500.6762661106965,498.86789174175215,23225,23506,51.83137695843684,45.838870276719554,NaN,NaN,NaN,NaN,0.9556439311376114,12.076933517749488,12327134,-0.01895081992646694,-0.19702686853656814,-0.1780760486101012
2025-09-11T10:00:00-04:00,500.26,500.93,499.85,500.88,NaN,NaN,NaN,501.29383866794984,NaN,NaN,500.2009000000004,501.54704960443377,498.854750395567,500.31926033346474,499.881445599542,500.76268808891064,499.0002031101734,36196,24412.1,55.97146589519607,47.02135297167832,NaN,NaN,NaN,NaN,0.9645265074849237,12.495383939401213,12363330,0.0628481504516625,-0.09951586054552308,-0.1623640109971856
2025-09-11T10:05:00-04:00,500.89,501.28,500.19,501.01,NaN,NaN,NaN,501.29383866794984,NaN,NaN,500.2363000000004,501.57256765177027,498.9000323482306,500.31926033346474,499.95184379671946,500.83520981042267,499.06847778301625,20807,24692.333333333332,56.837097033181145,48.21700902003942,NaN,NaN,NaN,NaN,0.9734888998074274,13.201038881818688,12384137,0.1206000944689592,-0.011613892910986578,-0.13221398737994577
2025-09-11T10:10:00-04:00,501.07,501.66,500.71,501.5,498.4929529964599,498.4929529964599,498.4929529964599,NaN,NaN,NaN,500.2745000000005,501.64348246778,498.905517532221,500.31926033346474,500.0405947654314,500.95681907918595,499.1243704516769,19845,24971.333333333332,60.027172277897684,49.358235948574354,NaN,NaN,NaN,NaN,0.9718111212497573,14.186127468601512,12403982,0.1829518628598214,0.09647584119483099,-0.08647602166499041
2025-09-11T10:15:00-04:00,501.48,501.5,500.9,501.01,498.5485005875299,NaN,NaN,NaN,NaN,NaN,500.30830000000043,501.66474182967943,498.95185817032143,500.31926033346474,500.11228082230997,501.03856251318905,499.1859991314309,20939,25306.533333333333,55.60166781398382,50.36397510669695,NaN,NaN,NaN,NaN,0.9452531840176334,15.100852584899846,12383043,0.18195983448001515,0.14097377143502854,-0.040986063044986615
2025-09-11T10:20:00-04:00,501.05,501.9,500.94,501.83,498.7581141971876,NaN,NaN,NaN,NaN,NaN,500.3521000000005,501.75985578739045,498.9443442126106,499.3906333515185,500.2166005077113,501.1839808903761,499.24922012504646,24923,24627.8,60.808877391185526,51.06989354512192,NaN,NaN,NaN,NaN,0.9463065280163724,16.303312578067093,12407966,0.22450356155625595,0.23964338890033332,0.01513982734407738
2025-09-11T10:25:00-04:00,501.87,502.44,501.69,502.33,499.42183627913363,NaN,NaN,NaN,NaN,NaN,500.4149000000005,501.88830760045084,498.94149239955016,500.0575066812148,500.33392824636815,501.3792028506824,499.2886536420539,22253,24825.7,63.61137278960899,52.055504202532,NaN,NaN,NaN,NaN,0.9322846331580601,17.855556686844917,12430219,0.27117110280021983,0.35410370584435213,0.08293260304413233
2025-09-11T10:30:00-04:00,502.26,503.18,501.87,503.09,499.8233437209912,NaN,NaN,NaN,NaN,NaN,500.49070000000046,502.10965028870476,498.87174971129616,500.61900534497187,500.4436757441276,501.58002660859864,499.3073248796565,17762,24943.733333333334,67.42446283822194,53.36167579262293,NaN,NaN,NaN,NaN,0.9592643022181988,19.813900625256988,12447981,0.33395152004354367,0.5003720030985619,0.16642048305501825
2025-09-11T10:35:00-04:00,503.1,503.12,502.43,502.88,500.102055370037,NaN,NaN,NaN,NaN,NaN,500.5585000000005,502.28453620968935,498.83246379031164,500.72620427597747,500.5126395699347,501.70095551248227,499.3243236273872,11560,25051.733333333334,65.38561876285269,54.51466026230577,NaN,NaN,NaN,NaN,0.9400311377740416,21.632362853782485,12436421,0.34087584562460227,0.5925152900857711,0.2516394444611688
2025-09-11T10:40:00-04:00,502.85,503.14,502.6,502.8,500.2449164895808,NaN,NaN,NaN,NaN,NaN,500.6113000000005,502.4435912533502,498.7790087466508,500.954963420782,500.60422480479326,501.85404877150023,499.3544008380863,16200,25302.933333333334,64.58440289332098,55.16837621085979,NaN,NaN,NaN,NaN,0.9114574850758931,23.33519454008241,12420221,0.319947041767256,0.6515732466702389,0.33162620490298284
2025-09-11T10:45:00-04:00,502.83,502.93,501.7,501.73,500.2449164895808,NaN,NaN,NaN,NaN,NaN,500.6261000000005,502.48218759413726,498.7700124058638,500.954963420782,500.6361022269014,501.89169450648694,499.3805099473159,8869,25299.2,54.89534980202204,56.103788735306544,NaN,NaN,NaN,NaN,0.9342105218561877,23.355464839094655,12411352,0.21874884725776178,0.605062263975185,0.38631341671742325
2025-09-11T10:50:00-04:00,501.81,501.93,500.57,500.69,500.2449164895808,NaN,NaN,NaN,NaN,NaN,500.6239000000005,502.4794185682114,498.76838143178963,500.954963420782,500.6496081722691,501.8874538253369,499.4117625192013,13767,25316.433333333334,47.444974512003434,56.84814729086032,NaN,NaN,NaN,NaN,0.9646240560093181,21.88355052004514,12397585,0.07396028738562943,0.47876377594946007,0.40480348856383064
2025-09-11T10:55:00-04:00,500.69,500.94,500.22,500.83,NaN,NaN,NaN,503.29117471731706,503.29117471731706,503.29117471731706,500.6281000000006,502.4845147049653,498.77168529503587,500.954963420782,500.6500600542583,501.8673604491066,499.43275965940995,14826,25286.9,48.459059403683504,57.120136057054886,NaN,NaN,NaN,NaN,0.9471509091515076,20.515373530302835,12412411,-0.015423540600592478,0.38552406281309004,0.4009476034136825
2025-09-11T11:00:00-04:00,500.83,501.57,500.81,501.11,NaN,NaN,NaN,503.29117471731706,NaN,NaN,500.64730000000054,502.50339612816225,498.79120387183883,500.954963420782,500.66082408436074,501.86753594512595,499.45411222359553,9646,25260.266666666666,50.515626197862794,57.38560889781843,NaN,NaN,NaN,NaN,0.9337829870692563,19.54234094619744,12422057,-0.05642548174260931,0.3304157512354209,0.3868412329780302
2025-09-11T11:05:00-04:00,501.18,501.96,501.09,501.65,NaN,NaN,NaN,503.29117471731706,NaN,NaN,500.6859000000006,502.54352610792495,498.8282738920762,500.954963420782,500.67679857103593,501.8787509451964,499.4748461968755,8257,25238.466666666667,54.302681183226206,57.562130628160524,NaN,NaN,NaN,NaN,0.9292270594214527,19.029678155994116,12430314,-0.04823200633721997,0.32655122505650525,0.3747832313937252
2025-09-11T11:10:00-04:00,501.68,501.96,501.64,501.84,NaN,NaN,NaN,503.29117471731706,NaN,NaN,500.7229000000006,502.59722984201176,498.84857015798946,500.954963420782,500.69726460628124,501.8978960696323,499.4966331429302,8586,24965.833333333332,55.59049761839443,57.534918608388985,NaN,NaN,NaN,NaN,0.8857108408913484,18.553634136519594,12438900,-0.03185956427077258,0.3349587760552595,0.36681834032603206
2025-09-11T11:15:00-04:00,501.87,502.62,501.8,502.58,NaN,NaN,NaN,503.29117471731706,NaN,NaN,500.7689000000006,502.70922501313163,498.82857498686957,500.954963420782,500.74056756239867,501.95396518236,499.52716994243735,12963,24724.833333333332,60.2849134727957,57.78119121121859,NaN,NaN,NaN,NaN,0.8810172093991088,18.758975825943644,12451863,0.02395335466983578,0.3967600336633268,0.372806678993491
2025-09-11T11:20:00-04:00,502.58,502.67,502.18,502.31,NaN,NaN,NaN,503.29117471731706,NaN,NaN,500.81150000000054,502.79136287327583,498.83163712672524,500.954963420782,500.7710965715606,501.99353234857165,499.5486607945495,9255,24649.4,57.880789674718905,57.627878168134394,NaN,NaN,NaN,NaN,0.8530874087277445,18.996608393894764,12442608,0.0370505599924687,0.4191198789840769,0.3820693189916082
2025-09-11T11:25:00-04:00,502.29,502.82,502.16,502.69,NaN,NaN,NaN,503.29117471731706,NaN,NaN,500.8519000000005,502.89983250793085,498.80396749207017,501.01355690034046,500.8106752963091,502.04774028311635,499.5736103095019,11312,24395.9,60.281530128599805,57.96215404774983,NaN,NaN,NaN,NaN,0.8392954509614748,19.363749043516336,12453920,0.0640848421757394,0.4621753717112824,0.398090529535543
2025-09-11T11:30:00-04:00,502.71,502.97,502.68,502.73,NaN,NaN,NaN,503.29117471731706,NaN,NaN,500.89730000000054,503.00814742151,498.7864525784911,501.3798455202724,500.8526204980269,502.1093454670993,499.59589552895454,11030,23651.466666666667,60.53651913575961,57.94269988664797,NaN,NaN,NaN,NaN,0.8000600616070852,19.854029215588557,12464950,0.0765933643688479,0.4938322349966029,0.417238870627755
2025-09-11T11:35:00-04:00,502.73,502.83,502.1,502.17,NaN,NaN,NaN,503.29117471731706,NaN,NaN,500.92650000000054,503.0663693878285,498.7866306121726,501.3798455202724,500.8758619582543,502.1367196417537,499.6150042747549,8128,23467.766666666666,55.19414075152225,57.34146902678464,NaN,NaN,NaN,NaN,0.7950557714922907,19.380963874219287,12456822,0.04087653414687864,0.4683345383113533,0.42745800416447466
2025-09-11T11:40:00-04:00,502.14,502.56,501.96,501.96,NaN,NaN,NaN,503.29117471731706,NaN,NaN,500.9509000000005,503.10944737197815,498.79235262802285,501.3798455202724,500.8887237706343,502.14975116870266,499.6276963725659,5357,22494.8,53.294736230339225,56.3322028405073,NaN,NaN,NaN,NaN,0.7811232163857001,18.73086232175299,12451465,-0.0009516609826363265,0.42626842793617925,0.4272200889188156
2025-09-11T11:45:00-04:00,501.95,501.97,500.88,501.04,NaN,NaN,NaN,503.29117471731706,NaN,NaN,500.96890000000053,503.1150736082716,498.8227263917295,501.3798455202724,500.8947171397482,502.14740886405843,499.64202541543796,7975,21699.8,45.85047586845936,54.936835490907775,NaN,NaN,NaN,NaN,0.8031858437867239,18.060868893339048,12443490,-0.08972601041554074,0.3150625758993897,0.4047885863149304
2025-09-11T11:50:00-04:00,500.99,501.85,500.93,501.84,NaN,NaN,NaN,503.29117471731706,NaN,NaN,500.99330000000054,503.1507629630199,498.8358370369812,501.3798455202724,500.9043659841084,502.15012080205787,499.6586111661589,8240,20539.933333333334,52.11417710797512,54.04610507766879,NaN,NaN,NaN,NaN,0.8115297120876733,17.43873213838324,12451730,-0.09330071628393855,0.28816269096000724,0.3814634072439458
2025-09-11T11:55:00-04:00,501.89,502.14,501.77,502.01,NaN,NaN,NaN,503.29117471731706,NaN,NaN,501.0249000000005,503.19468385028847,498.85511614971256,501.3798455202724,500.90997738152834,502.15485708117103,499.66509768188564,2908,18465.733333333334,53.34910053656472,53.93565870156469,NaN,NaN,NaN,NaN,0.7799918755099827,16.45078881059578,12454638,-0.08327902116886071,0.2773646307828699,0.3606436519517306
2025-09-11T12:00:00-04:00,501.97,502.8,501.8,502.76,NaN,NaN,NaN,503.29117471731706,NaN,NaN,501.0559000000005,503.2790110536629,498.83278894633816,501.3798455202724,500.93167989326184,502.1810625764215,499.6822972101022,7901,17197.166666666668,58.44116053080391,54.721100560050445,NaN,NaN,NaN,NaN,0.7957067415449839,15.862071679079365,12462539,-0.028056664392281883,0.3255728214613782,0.3536294858536601
2025-09-11T12:05:00-04:00,502.78,502.93,502.66,502.89,NaN,NaN,NaN,503.29117471731706,NaN,NaN,501.09170000000057,503.3733779870586,498.81002201294257,501.3798455202724,500.95122956922023,502.2088136123876,499.6936455260529,5857,15898.033333333333,59.2710185813671,55.49338335845641,NaN,NaN,NaN,NaN,0.7581562600060552,15.470275025433692,12468396,0.013098739485041533,0.370002910209962,0.3569041707249205
2025-09-11T12:10:00-04:00,502.88,502.91,502.39,502.455,NaN,NaN,NaN,503.29117471731706,NaN,NaN,501.1168000000005,503.43008403722354,498.8035159627775,501.3798455202724,500.9678474474224,502.22971308228205,499.70598181256275,5834,14468.566666666668,55.292364766504,55.834578970502214,NaN,NaN,NaN,NaN,0.7411450985770539,14.710834770615614,12462562,0.007192980796079995,0.36589539672002047,0.3587024159239405
2025-09-11T12:15:00-04:00,502.49,502.8,502.41,502.77,NaN,NaN,NaN,503.29117471731706,NaN,NaN,501.1524000000005,503.5111227384646,498.7936772615364,501.3798455202724,500.9787312387872,502.24378534035196,499.7136771372224,3713,13408,57.51629970840588,56.06412315087219,NaN,NaN,NaN,NaN,0.716063305821549,14.005640248284543,12466275,0.0199466403710426,0.38363571638774374,0.36368907601670114
2025-09-11T12:20:00-04:00,502.78,503.15,502.42,502.47,NaN,NaN,NaN,503.29117471731706,NaN,NaN,501.18260000000043,503.56919777864965,498.7960022213512,501.62311552012955,501.0290621126644,502.30816703943765,499.74995718589116,17599,13191.1,54.72429626709079,56.002251625779074,NaN,NaN,NaN,NaN,0.7170587839771498,13.827642571012738,12448676,0.004433768235478086,0.36923128631104873,0.36479751807557065
2025-09-11T12:25:00-04:00,502.49,502.64,501.95,502.31,NaN,NaN,NaN,503.29117471731706,NaN,NaN,501.21480000000054,503.6178713340784,498.81172866592266,501.62311552012955,501.0418932466696,502.3208516187465,499.7629348745927,6067,12619.166666666666,53.23991396589386,55.499037375286086,NaN,NaN,NaN,NaN,0.7151260136930676,12.928731330326931,12442609,-0.019058440491592,0.3409744674610806,0.3600329079526726
2025-09-11T12:30:00-04:00,502.38,502.56,502.09,502.37,NaN,NaN,NaN,503.29117471731706,NaN,NaN,501.24870000000044,503.6681220874163,498.8292779125846,501.62311552012955,501.0594875793391,502.33858640011897,499.7803887585592,8257,11687.866666666667,53.74658414556616,55.203736980346605,NaN,NaN,NaN,NaN,0.6976170127149933,12.094028035404394,12450866,-0.032237118327362535,0.3197365100434695,0.351973628370832
2025-09-11T12:35:00-04:00,502.4,502.49,502,502.32,NaN,NaN,NaN,503.29117471731706,NaN,NaN,501.2635000000004,503.69984172420897,498.8271582757919,501.62311552012955,501.07343312239715,502.3516866860837,499.7951795587106,7100,11230.966666666667,53.22897542225137,54.699983072750285,NaN,NaN,NaN,NaN,0.6827872260924944,11.286346129137822,12443766,-0.045207094844263995,0.295464759815502,0.340671854659766
2025-09-11T12:40:00-04:00,502.29,502.545,502.2,502.5,NaN,NaN,NaN,503.29117471731706,NaN,NaN,501.2913000000005,503.75160470405655,498.83099529594443,501.62311552012955,501.08579560751434,502.3645871554058,499.8070040596229,5732,10760.533333333333,54.91240507500248,54.298260639839064,NaN,NaN,NaN,NaN,0.6586595670858896,10.517732356961162,12449498,-0.042585255025180735,0.28744028587829007,0.3300255409034708
2025-09-11T12:45:00-04:00,502.57,502.7,502.18,502.27,NaN,NaN,NaN,503.29117471731706,NaN,NaN,501.3239000000005,503.792004770262,498.855795229739,501.62311552012955,501.09623464104095,502.37513549966883,499.8173337824131,5045,10230.733333333334,52.32100662733395,54.09303677382561,NaN,NaN,NaN,NaN,0.648755312294039,10.074113447909774,12444453,-0.05639638972097061,0.2595300537522576,0.3159264434732282
2025-09-11T12:50:00-04:00,502.22,502.24,500.83,501.2,NaN,NaN,NaN,503.29117471731706,NaN,NaN,501.35410000000047,503.7780535385258,498.93014646147515,501.62311552012955,501.1035210790337,502.36901837878065,499.8380237792868,14287,9876.2,42.316156851494604,53.30885253247957,NaN,NaN,NaN,NaN,0.7052727899873218,11.005140939685276,12430166,-0.1332616908073626,0.14934932996402495,0.28261102077138756
2025-09-11T12:55:00-04:00,501.26,501.46,501,501.12,NaN,NaN,NaN,503.29117471731706,NaN,NaN,501.3765000000005,503.7705010436214,498.9824989563796,501.62311552012955,501.10490724337785,502.3606495170445,499.8491649697112,10054,9469.566666666668,41.67451027885566,53.0105692760793,NaN,NaN,NaN,NaN,0.6877533049882258,11.869666467762528,12420112,-0.18213549819945749,0.05494164802206569,0.23707714622152318
2025-09-11T13:00:00-04:00,501.16,501.37,500.6,500.67,NaN,NaN,NaN,503.15850978666634,NaN,NaN,501.4031000000004,503.7347422446824,499.07145775531836,501.62311552012955,501.0993206798491,502.3398628681177,499.8587784915805,16593,9430.6,38.16858296798623,52.01445540893724,NaN,NaN,NaN,NaN,0.6936280689176371,13.127402880248102,12403519,-0.23410014585557526,-0.055548036097945896,0.17855210975762936
2025-09-11T13:05:00-04:00,500.75,501.02,500.25,500.98,NaN,NaN,NaN,502.8147138872724,NaN,NaN,501.4347000000005,503.698742763961,499.17065723604,501.62311552012955,501.09194693070896,502.3203528214999,499.863541039918,14405,9525.433333333332,41.8008904542832,51.18958326020284,NaN,NaN,NaN,NaN,0.6990832068520902,14.660032059687097,12417924,-0.23624301352457228,-0.116751657148086,0.11949135637648628
2025-09-11T13:10:00-04:00,501.01,501.37,500.87,500.92,NaN,NaN,NaN,502.8147138872724,NaN,NaN,501.4581000000005,503.67571934445573,499.2404806555453,501.38323849363604,501.0912485383398,502.3085057141911,499.87399136248854,12570,9404.433333333332,41.2952431759357,49.964874877712255,NaN,NaN,NaN,NaN,0.6848629777912266,15.387814875948793,12405354,-0.23012031203951486,-0.1681590336729073,0.06196127836660756
2025-09-11T13:15:00-04:00,500.97,501.2,500.65,500.82,NaN,NaN,NaN,502.8147138872724,NaN,NaN,501.48550000000046,503.63603690901465,499.33496309098626,501.38323849363604,501.08883217804515,502.2989581043371,499.8787062517532,8446,9390.333333333334,40.41770261783022,48.61820945174534,NaN,NaN,NaN,NaN,0.675229907948997,16.31418749522639,12396908,-0.2211660898814538,-0.21449633398520973,0.006669755896244092
2025-09-11T13:20:00-04:00,500.81,501.015,500.51,500.51,NaN,NaN,NaN,502.8147138872724,NaN,NaN,501.48810000000043,503.6335928471517,499.34260715284915,501.38323849363604,501.08292859985204,502.28531498503247,499.8805422146716,10264,9273.566666666668,37.740269999541525,47.3644883969623,NaN,NaN,NaN,NaN,0.6630706288097825,17.33302221994619,12386644,-0.22380414768852308,-0.2730854287144098,-0.04928128102588668
2025-09-11T13:25:00-04:00,500.54,500.74,500.08,500.08,NaN,NaN,NaN,502.50298475390434,NaN,NaN,501.4845000000004,503.6388094014232,499.33019059857764,501.38323849363604,501.0737770118413,502.2720738253523,499.87548019833025,8441,9060.733333333334,34.34195675639681,45.70917818610451,NaN,NaN,NaN,NaN,0.6628512981805141,18.740238092137695,12378203,-0.24071775538315948,-0.35017847525483603,-0.10946071987167655
2025-09-11T13:30:00-04:00,500.2,500.765,500.19,500.56,NaN,NaN,NaN,502.50298475390434,NaN,NaN,501.49190000000044,503.63085945659515,499.35294054340574,501.38323849363604,501.0660489028582,502.25799729820193,499.87410050751447,9947,9070.766666666666,40.755045378114794,44.71137455117765,NaN,NaN,NaN,NaN,0.6644333483104775,19.990273884415842,12388150,-0.20706964338936645,-0.3682977741083846,-0.16122813071901815
2025-09-11T13:35:00-04:00,500.62,500.69,500.15,500.28,NaN,NaN,NaN,502.48983734808223,NaN,NaN,501.49350000000044,503.62870795170613,499.35829204829474,500.4665907949088,501.0598689160126,502.24827489524836,499.8714629367768,6590,9015.2,38.398912866098144,43.651303044049385,NaN,NaN,NaN,NaN,0.6555452520025877,21.196001576097526,12381560,-0.1915237855679884,-0.40063286267900367,-0.20910907711101526
2025-09-11T13:40:00-04:00,500.275,500.41,500.17,500.32,NaN,NaN,NaN,502.2984811049877,NaN,NaN,501.48350000000045,503.63584592873303,499.33115407126786,499.8112726359271,501.05502603087746,502.2411812420566,499.8688708196983,4738,8886.933333333332,38.941972775251934,42.59383080331265,NaN,NaN,NaN,NaN,0.6258634482881178,22.315605861230516,12386298,-0.16728083564802948,-0.4182101216710521,-0.2509292860230226
2025-09-11T13:45:00-04:00,500.34,500.39,499.82,499.93,NaN,NaN,NaN,502.0999137820337,NaN,NaN,501.4965000000004,503.602812654138,499.39018734586284,499.72145158959466,501.03496134061953,502.2176691414025,499.85225353983657,15093,8957.933333333332,35.642692790165626,41.33766775816367,NaN,NaN,NaN,NaN,0.6218732019818232,23.76601500559615,12371205,-0.16591790096542858,-0.45832666222980833,-0.29240876126437976
2025-09-11T13:50:00-04:00,499.96,500.23,499.82,500.05,NaN,NaN,NaN,501.98514497375936,NaN,NaN,501.52690000000047,503.50078843575545,499.5530115642455,499.72145158959466,501.0266378052134,502.2079258853833,499.8453497250435,6356,8861.3,37.40011488496926,40.08678988744701,NaN,NaN,NaN,NaN,0.6067394018402662,25.112823496792807,12377561,-0.1460419948571966,-0.4749612548358755,-0.3289192599786789
2025-09-11T13:55:00-04:00,500.05,500.26,499.84,500.03,NaN,NaN,NaN,501.97832020222484,NaN,NaN,501.54010000000045,503.46431879133047,499.61588120867043,499.72145158959466,501.0135633243374,502.19236455099644,499.8347620976783,10307,8827.8,37.21769962049071,39.007982244101065,NaN,NaN,NaN,NaN,0.5934008731373913,26.272006376729646,12367254,-0.12420605844378985,-0.4841768330334162,-0.35997077458962634
2025-09-11T14:00:00-04:00,500.02,500.11,499.88,500.05,NaN,NaN,NaN,501.8670329203056,NaN,NaN,501.5485000000005,503.44272517054077,499.65427482946023,499.6061612716757,501.0057981699015,502.1832917843234,499.8283045554796,6065,8662.3,37.54574577494034,38.66723859577576,NaN,NaN,NaN,NaN,0.5674436679132933,27.348390479528135,12373319,-0.09945049159194957,-0.4842838890795633,-0.38483339748761375
2025-09-11T14:05:00-04:00,500.07,500.295,499.74,500.24,NaN,NaN,NaN,501.8670329203056,NaN,NaN,501.5477000000005,503.44409996754325,499.6513000324577,499.48742901734056,500.98915422407265,502.16226315531026,499.81604529283504,14488,8874.3,40.71495678514784,38.59869906051091,NaN,NaN,NaN,NaN,0.5665548344909157,27.73898035487595,12387807,-0.06308701402877914,-0.4636921650235877,-0.40060515099480853
2025-09-11T14:10:00-04:00,500.23,500.73,499.9,500.03,NaN,NaN,NaN,501.8670329203056,NaN,NaN,501.5307000000004,503.4655860527056,499.59581394729526,499.38066731563896,500.9806692149403,502.15005252203235,499.81128590784823,8876,8991.6,38.39583465962772,38.61493132419959,NaN,NaN,NaN,NaN,0.5853723463129962,26.84473817070901,12378931,-0.04673743395696717,-0.45902694344101747,-0.4122895094840503
2025-09-11T14:15:00-04:00,500.04,500.04,499.76,499.8,NaN,NaN,NaN,501.7433604315317,NaN,NaN,501.50650000000047,503.49631833265425,499.5166816673467,499.38066731563896,500.9717199802411,502.14063458815286,499.8028053723294,6516,8942.966666666667,35.97866095229881,38.199057788343566,NaN,NaN,NaN,NaN,0.5635600358620699,26.280246737725637,12372415,-0.04495907831322132,-0.4684883573755769,-0.4235292790623556
2025-09-11T14:20:00-04:00,499.84,500.06,499.68,499.98,NaN,NaN,NaN,501.68138950282577,NaN,NaN,501.47610000000054,503.5113132951077,499.4408867048934,499.38066731563896,500.9596224123389,502.12734649945344,499.79189832522434,9319,8978.933333333332,39.204371919058204,38.04970984142375,NaN,NaN,NaN,NaN,0.5504486047290646,25.9083934114238,12381734,-0.026139195191883957,-0.45620327305221053,-0.4300640778603266
2025-09-11T14:25:00-04:00,499.97,500.2,499.9,500.02,NaN,NaN,NaN,501.68138950282577,NaN,NaN,501.45630000000057,503.5281984619056,499.3844015380955,499.38066731563896,500.9520849975581,502.11796583522477,499.7862041598914,6780,9108,39.928707539592864,38.01478162154965,NaN,NaN,NaN,NaN,0.5325594186769894,25.15458240955306,12388514,-0.00649947858969091,-0.43818842609744024,-0.43168894750774933
2025-09-11T14:30:00-04:00,500,500.74,499.97,500.1,NaN,NaN,NaN,501.68138950282577,NaN,NaN,501.4217000000005,503.5250227134145,499.3183772865865,499.4890333324857,500.9428152154341,502.1034365559953,499.7821938748729,11397,9224.533333333333,41.43165947281738,38.27845229821221,NaN,NaN,NaN,NaN,0.5495194602000603,23.612602027331235,12399911,0.015192067537303011,-0.4126988630861206,-0.4278909306234236
2025-09-11T14:35:00-04:00,500.09,500.62,500.04,500.35,NaN,NaN,NaN,501.68138950282577,NaN,NaN,501.3821000000005,503.49007921164974,499.27412078835124,499.4890333324857,500.934921560112,502.09000695532484,499.77983616489917,11065,9398.133333333333,45.98013937121175,39.10975105641328,NaN,NaN,NaN,NaN,0.5516966416143405,22.180763100982396,12410976,0.04784693102231208,-0.36808226684553347,-0.41592919786784555
2025-09-11T14:40:00-04:00,500.31,500.51,500.1,500.24,NaN,NaN,NaN,501.68138950282577,NaN,NaN,501.3251000000005,503.39912457962373,499.2510754203772,499.4890333324857,500.9314774501505,502.0844745145716,499.77848038572944,4515,9354.166666666666,44.3481539778506,39.366401670680126,NaN,NaN,NaN,NaN,0.5415754529275996,20.85119838365847,12406461,0.06257815572052339,-0.3377065032171913,-0.4002846589377147
2025-09-11T14:45:00-04:00,500.29,500.57,500.23,500.43,NaN,NaN,NaN,501.68138950282577,NaN,NaN,501.2761000000005,503.3163581103643,499.2358418896367,499.4890333324857,500.92687021473193,502.07579943365505,499.7779409958088,7614,9484.2,47.79486450432066,40.0375410734103,NaN,NaN,NaN,NaN,0.527177206289912,19.769909820734057,12414075,0.08430562659500007,-0.29490262569396464,-0.3792082522889647
2025-09-11T14:50:00-04:00,500.44,501.2,500.44,500.86,NaN,NaN,NaN,501.68138950282577,NaN,NaN,501.23730000000046,503.23347154499754,499.2411284550034,499.88692405298616,500.92531187861607,502.06469314929575,499.7859306079364,14601,9384.266666666666,54.641585614905644,41.158941990528426,NaN,NaN,NaN,NaN,0.544521691554917,20.120016819210168,12428676,0.12440330884675432,-0.22370411623052178,-0.3481074250772761
2025-09-11T14:55:00-04:00,500.87,500.93,500.54,500.71,NaN,NaN,NaN,501.68138950282577,NaN,NaN,501.2169000000005,503.2133617593903,499.22043824061075,499.88692405298616,500.92377509660486,502.0588739415619,499.7886762516478,6833,9409.8,52.075842329847035,42.33273838621996,NaN,NaN,NaN,NaN,0.533484427872422,20.445116174937986,12421843,0.1366153116184271,-0.17733828555424225,-0.31395359717266935
2025-09-11T15:00:00-04:00,500.68,500.87,500.49,500.74,NaN,NaN,NaN,501.68138950282577,NaN,NaN,501.2179000000005,503.21335492481126,499.22244507518974,499.88692405298616,500.92182865182093,502.05217105579203,499.79148624784983,7750,9392.9,52.55567395493695,43.415278319789074,NaN,NaN,NaN,NaN,0.5225212544529629,20.5851784716919,12429593,0.1418847429202395,-0.13659766852236999,-0.2784824114426095
2025-09-11T15:05:00-04:00,500.8,500.845,500.61,500.72,NaN,NaN,NaN,501.68138950282577,NaN,NaN,501.2157000000005,503.2131023222382,499.21829767776273,499.88692405298616,500.9206071322211,502.0475426393527,499.79367162508953,5564,9341.7,52.18058288007577,44.48405569547372,NaN,NaN,NaN,NaN,0.501984021992038,20.715236318677675,12424029,0.1390122054082435,-0.10471715468230514,-0.24372936009054863
2025-09-11T15:10:00-04:00,500.68,500.68,500.42,500.53,NaN,NaN,NaN,501.68138950282577,NaN,NaN,501.2041000000005,503.2105393229958,499.19766067700516,499.88692405298616,500.91690908846584,502.0389236770595,499.7948944998722,8875,9446.466666666667,48.629771231682675,45.275771799526744,NaN,NaN,NaN,NaN,0.4875565918497503,20.18773921776895,12415154,0.12002118295847103,-0.09370288139245986,-0.2137240643509309
2025-09-11T15:15:00-04:00,500.55,500.66,500.42,500.54,NaN,NaN,NaN,501.68138950282577,NaN,NaN,501.18190000000044,503.19267188090254,499.17112811909834,499.88692405298616,500.91345798045427,502.030900824782,499.7960151361265,8367,9557.2,48.82714500312623,45.855213815096626,NaN,NaN,NaN,NaN,0.4698739781461974,19.697920481210854,12423521,0.1044129274044423,-0.08320790509537801,-0.1876208324998203
2025-09-11T15:20:00-04:00,500.56,500.69,500.46,500.66,NaN,NaN,NaN,501.68138950282577,NaN,NaN,501.1583000000005,503.16531729855336,499.15128270144766,499.88692405298616,500.9109443570037,502.0241967699423,499.7976919440651,7467,9329.866666666667,51.24782756886997,46.77321330861393,NaN,NaN,NaN,NaN,0.4527401225643275,19.326016094313037,12430988,0.09852509999095904,-0.06446445751112151,-0.16298955750208055
2025-09-11T15:25:00-04:00,500.68,500.83,500.58,500.8,NaN,NaN,NaN,501.68138950282577,NaN,NaN,501.12270000000046,503.0903434729864,499.15505652701455,500.02252273515677,500.90950054146793,502.01824449415017,499.8007565887857,7696,9251.266666666666,53.982781600317985,48.059221926329585,NaN,NaN,NaN,NaN,0.4382586852383041,19.36592137062296,12438684,0.10009029290611765,-0.0378766913694335,-0.13796698427555115
2025-09-11T15:30:00-04:00,500.8,500.95,500.48,500.75,NaN,NaN,NaN,501.68138950282577,NaN,NaN,501.0915000000005,503.03213520444126,499.15086479555976,500.0690181881254,500.9065498527491,502.0065518975786,499.80654780791957,15238,9206.1,52.84261834920548,49.03338238562582,NaN,NaN,NaN,NaN,0.44052592200699453,19.717825692281355,12423446,0.09389136242618919,-0.02060278124281467,-0.11449414366900386
2025-09-11T15:35:00-04:00,500.74,500.8,500.55,500.74,NaN,NaN,NaN,501.68138950282577,NaN,NaN,501.0525000000005,502.9407396555335,499.16426034446755,500.0690181881254,500.90408723953414,501.99785046913075,499.8103240099375,11210,9099.6,52.603320048528325,49.93871185054978,NaN,NaN,NaN,NaN,0.4269169275779235,20.04459399096415,12412236,0.08548969714271198,-0.007632022240613878,-0.09312171938332586
2025-09-11T15:40:00-04:00,500.73,500.79,500.42,500.52,NaN,NaN,NaN,501.68138950282577,NaN,NaN,501.00830000000053,502.8400200759536,499.1765799240475,500.0690181881254,500.900960064979,501.9899532522412,499.8119668777168,9213,8987.7,47.50632633709685,50.372616626569744,NaN,NaN,NaN,NaN,0.4228514327509293,19.77399139183395,12403023,0.06255127182145626,-0.014932629606505543,-0.0774839014279618
2025-09-11T15:45:00-04:00,500.52,500.74,500.45,500.6,NaN,NaN,NaN,501.68138950282577,NaN,NaN,500.9769000000005,502.781512855057,499.17228714494405,500.0690181881254,500.8953159833964,501.97494341443195,499.8156885523609,18230,9313.833333333334,49.42537336304917,50.61870476884384,NaN,NaN,NaN,NaN,0.41336204469729293,19.522717549784474,12421253,0.0507066892356713,-0.014100539883372676,-0.06480722911904398
2025-09-11T15:50:00-04:00,500.52,501.6,500.06,501.52,NaN,NaN,NaN,501.68138950282577,NaN,NaN,500.9681000000005,502.757679715079,499.178520284922,500.1707498498562,500.90099120008057,501.96227812068724,499.8397042794739,35079,10141,65.18703967828395,52.107196604589085,NaN,NaN,NaN,NaN,0.49383618436177346,21.2728147639692,12456332,0.09992769174952244,0.060102385567859073,-0.03982530618166337
2025-09-11T15:55:00-04:00,501.53,502.26,500.64,501.03,499.7294365013776,499.7294365013776,499.7294365013776,NaN,NaN,NaN,500.9679000000005,502.757449763694,499.178350236307,500.3065998798849,500.9363372045191,501.9572198904853,499.91545451855285,96289,13069.266666666666,55.30152109868738,52.64338636132957,NaN,NaN,NaN,NaN,0.5742764569073613,23.757926639886353,12360043,0.09463251227555941,0.0784653341627859,-0.016167178112773517
2025-09-12T09:30:00-04:00,506.52,506.69,503.85,505.095,502.85582575131497,NaN,NaN,NaN,NaN,NaN,501.0330000000005,503.1513314180372,498.91466858196384,502.2972799039079,505.21166666666664,505.21166666666664,505.21166666666664,91215,15778.2,81.01844798954464,54.527447959518064,NaN,NaN,NaN,NaN,0.9375424242711229,27.97542213502833,12451258,0.34591900019527755,0.41623157213132345,0.07031257193604588
2025-09-12T09:35:00-04:00,505.02,505.82,504.01,505.44,502.85582575131497,NaN,NaN,NaN,NaN,NaN,501.1016000000005,503.54001623946675,498.6631837605342,502.2972799039079,505.16534216118237,505.2244199768543,505.10626434551045,56084,17428,81.96674354158408,56.662512331785,NaN,NaN,NaN,NaN,0.9998608225374713,31.89166795194588,12507342,0.5066629247210448,0.7036412278373518,0.1969783031163071
2025-09-12T09:40:00-04:00,505.48,506.83,505.11,506.76,503.3001635461362,NaN,NaN,NaN,NaN,NaN,501.18160000000057,504.0559085701746,498.30729142982653,502.43465913850105,505.39202783957614,505.831870183562,504.9521854955903,39689,18593.033333333333,85.04519475501215,58.98319238893322,NaN,NaN,NaN,NaN,1.0512993352133642,35.698450007492404,12547031,0.6632974974014614,1.0261001748681338,0.36280267746667244
2025-09-12T09:45:00-04:00,506.68,507.86,506.4,507.31,504.3824288394936,NaN,NaN,NaN,NaN,NaN,501.2700000000005,504.58684850373834,497.95315149626265,503.61372731080087,505.88913590875615,506.77606467640277,505.0022071411095,71455,20471.766666666666,86.10923424362015,61.40666748632925,NaN,NaN,NaN,NaN,1.0804922398409835,39.37311417764588,12618486,0.7584939745228461,1.31092014562023,0.5524261710973839
2025-09-12T09:50:00-04:00,507.24,508.11,505.3,506.32,504.3824288394936,NaN,NaN,NaN,NaN,NaN,501.34730000000053,504.939714903181,497.75488509682003,503.61372731080087,506.0151001377942,506.8596456778021,505.1705545977863,57971,22192.266666666666,75.67233886817709,63.33827946036456,NaN,NaN,NaN,NaN,1.2040285084237705,41.022032017191975,12560515,0.7101839234914422,1.4401560754616867,0.7299721519702445
2025-09-12T09:55:00-04:00,506.25,508.08,506.19,507.89,504.3824288394936,NaN,NaN,NaN,NaN,NaN,501.4497000000005,505.46543525480223,497.4339647451988,503.61372731080087,506.20813724797983,507.12485519433255,505.2914193016271,51827,23576.266666666666,79.84452584631565,65.55380666344952,NaN,NaN,NaN,NaN,1.253026472107786,42.55317001105621,12612342,0.7362138200571167,1.6502394270416403,0.9140256069845236
2025-09-12T10:00:00-04:00,508.05,508.37,506.67,507.08,504.3824288394936,NaN,NaN,NaN,NaN,NaN,501.5419000000005,505.8482752224518,497.23552477754924,503.6907083831301,506.35111525514185,507.29101247572424,505.41121803455945,51506,25090.966666666667,72.89827143203951,67.1002669393902,NaN,NaN,NaN,NaN,1.2849531526715146,44.07890052218849,12560836,0.6539100052794766,1.7314131135838693,1.0775031083043927
2025-09-12T10:05:00-04:00,507.08,507.94,507.05,507.44,504.3824288394936,NaN,NaN,NaN,NaN,NaN,501.64450000000056,506.25303219544287,497.03596780455825,503.75156670650404,506.4444134175252,507.39650983157173,505.49231700347866,37938,25872.633333333335,73.98166728264225,68.52875877384193,NaN,NaN,NaN,NaN,1.2567422131949768,45.49565028252561,12598774,0.5811954944680384,1.8039974763894406,1.2228019819214022
2025-09-12T10:10:00-04:00,507.39,507.74,506.62,507.2,504.3824288394936,NaN,NaN,NaN,NaN,NaN,501.74110000000053,506.6019868693305,496.88021313067054,503.8292533652032,506.4832421263253,507.4247199660158,505.5417642866348,25264,26418.9,71.91762339225595,69.89125913405982,NaN,NaN,NaN,NaN,1.246974912252479,46.07943862881043,12573510,0.4786879280325176,1.8211618919620491,1.3424739639295316
2025-09-12T10:15:00-04:00,507.2,507.46,506.79,507.15,504.3824288394936,NaN,NaN,NaN,NaN,NaN,501.83770000000055,506.92735429438056,496.74804570562054,503.9964026921626,506.5149190380425,507.4437782450835,505.5860598310015,24738,27026.3,71.47025674612276,71.23889746960228,NaN,NaN,NaN,NaN,1.205762418520156,46.62152780750347,12548772,0.3739145970462263,1.8098672102373143,1.435952613191088
2025-09-12T10:20:00-04:00,507.17,507.7,506.61,506.77,504.3824288394936,NaN,NaN,NaN,NaN,NaN,501.92310000000055,507.1943923990557,496.6518076009454,504.38412215373006,506.5357680190862,507.4511170694929,505.62041896867953,21562,27434.4,68.00779302514792,72.70328794732022,NaN,NaN,NaN,NaN,1.1974936743401432,47.253578882028016,12527210,0.25130146381302687,1.7500794429573716,1.4987779791443447
2025-09-12T10:25:00-04:00,506.731,507.38,506.52,507.17,504.3824288394936,NaN,NaN,NaN,NaN,NaN,502.0211000000006,507.492925760759,496.5492742392422,504.38412215373006,506.55384245411415,507.456776219168,505.6509086890603,20375,27887.566666666666,69.67329878881655,74.14956833487504,NaN,NaN,NaN,NaN,1.1733869833158483,47.668794854811395,12547585,0.1731392821072788,1.7152020817784432,1.5420627996711644
2025-09-12T10:30:00-04:00,507.21,508.38,507.15,507.91,504.6142370731111,NaN,NaN,NaN,NaN,NaN,502.1553000000006,507.8639980683907,496.4466019316105,505.29883817838726,506.6290789683776,507.55411232348564,505.70404561326956,34918,28671.6,72.52316847473493,74.67357753462151,NaN,NaN,NaN,NaN,1.1774307702218605,48.57771327973376,12582503,0.14823887263436863,1.7273613904641252,1.5791225178297565
2025-09-12T10:35:00-04:00,507.99,508.4,507.9,508.2,505.07427175160603,NaN,NaN,NaN,NaN,NaN,502.2969000000006,508.24218010745096,496.3516198925503,505.68507054270975,506.72283136384914,507.6917871680176,505.7538755596807,37956,29567.966666666667,73.5713250901278,75.97856353401014,NaN,NaN,NaN,NaN,1.1290428580631562,49.43118966753968,12620459,0.12897141566128534,1.7403367874063633,1.611365371745078
2025-09-12T10:40:00-04:00,508.21,508.44,507.68,507.86,505.07427175160603,NaN,NaN,NaN,NaN,NaN,502.44070000000056,508.56668922920136,496.31471077079976,505.8880564341678,506.77227223742983,507.7534500340246,505.7910944408351,25205,30257.633333333335,70.19064285583215,75.20514888160208,NaN,NaN,NaN,NaN,1.1026826539157872,49.78588702989036,12595254,0.07374553596942124,1.7035472917068546,1.6298017557374334
2025-09-12T10:45:00-04:00,507.85,508.41,507.28,508.04,505.07427175160603,NaN,NaN,NaN,NaN,NaN,502.5819000000006,508.8894728736216,496.27432712637955,505.8880564341678,506.80637588772504,507.7920178260349,505.82073394941517,20015,30671,70.95166157637536,74.4183573126586,NaN,NaN,NaN,NaN,1.1046338929218062,49.34807637504542,12615269,0.0318937496092635,1.6696689427490128,1.6377751931397493
2025-09-12T10:50:00-04:00,508.1,508.74,507.81,508.68,505.23157970432226,NaN,NaN,NaN,NaN,NaN,502.73710000000057,509.2519384750653,496.22226152493585,506.18975611786743,506.861635049194,507.8733538234731,505.84991627491485,23830,30978.633333333335,73.5383916890809,73.59644280794923,NaN,NaN,NaN,NaN,1.092160043427392,49.17579451576319,12639099,0.029901958697390985,1.6751526415114881,1.6452506828140971
2025-09-12T10:55:00-04:00,508.69,509.29,508.55,509.07,505.9140078995804,NaN,NaN,NaN,NaN,NaN,502.9021000000006,509.6288115558933,496.17538844410785,506.87980489429395,506.9563028220076,508.03715782228926,505.87544782172597,32511,31834.566666666666,74.99939009887667,72.80288251189613,NaN,NaN,NaN,NaN,1.0670057546111502,49.37434810882716,12671610,0.03697548511999882,1.6914700392140958,1.654494554094097
2025-09-12T11:00:00-04:00,509,509.13,508.61,508.66,505.9297348132358,NaN,NaN,NaN,NaN,NaN,503.0651000000006,509.94527979097563,496.18492020902556,506.94184391543513,507.0258634018563,508.1428149955924,505.90891180812025,28389,32522.533333333333,70.58711223268776,72.4396520379326,NaN,NaN,NaN,NaN,1.0279339149960667,49.558719302386564,12643221,-0.0017782347840895607,1.652271760613985,1.6540499953980745
2025-09-12T11:05:00-04:00,508.62,509.6,508.53,509.31,506.1124741399069,NaN,NaN,NaN,NaN,NaN,503.2497000000006,510.2929664038852,496.20643359611597,507.3144751323481,507.13155876367205,508.31409511022474,505.94902241711935,39467,33652.63333333333,73.27177323069026,71.97016970824508,NaN,NaN,NaN,NaN,1.030938635353494,50.024063048069856,12682688,0.0004267257739067887,1.654583402615458,1.6541566768415512
2025-09-12T11:10:00-04:00,509.34,509.99,509.32,509.74,506.7439525880929,NaN,NaN,NaN,NaN,NaN,503.4333000000006,510.66267939493906,496.20392060506214,507.82158010587847,507.2232591723742,508.4777429240918,505.9687754206566,29519,34340.76666666667,74.90370212009412,72.11341475739184,NaN,NaN,NaN,NaN,1.005871589971102,50.67939126013411,12712207,0.01414734743377788,1.6718408611337736,1.6576935136999957
2025-09-12T11:15:00-04:00,509.77,510.4,509.77,510.09,507.2162729249978,NaN,NaN,NaN,NaN,NaN,503.62950000000063,511.0362143185022,496.2227856814991,508.33526408470277,507.3425949602387,508.6974412478863,505.9877486725912,35723,35252.63333333333,76.17862016900716,72.27033996356076,NaN,NaN,NaN,NaN,0.9811664764017352,51.50515455701182,12747930,0.029228846945352993,1.694229572381687,1.665000725436334
2025-09-12T11:20:00-04:00,510.14,510.56,509.87,510.51,507.3825787011343,NaN,NaN,NaN,NaN,NaN,503.8333000000006,511.423053516169,496.2435464838322,508.56321126776226,507.4230002901999,508.84367776360756,506.0023228167923,23845,35798.566666666666,77.64616247009515,72.67952132626355,NaN,NaN,NaN,NaN,0.9603688709444682,52.35386217169705,12771775,0.04877333921701443,1.725967399457602,1.6771940602405875
2025-09-12T11:25:00-04:00,510.57,511.3,510.55,510.81,508.1135978510827,NaN,NaN,NaN,NaN,NaN,504.05090000000064,511.80267700633726,496.299122993664,509.3075690142098,507.58902369752076,509.1603500025452,506.0176973924963,44355,37020.53333333333,78.65756565347753,73.19290053393175,NaN,NaN,NaN,NaN,0.9481996658770077,53.485618734134455,12816130,0.06232131034353783,1.7550956981700097,1.6927743878264718
2025-09-12T11:30:00-04:00,510.72,511.68,510.195,511.3,508.1135978510827,NaN,NaN,NaN,NaN,NaN,504.2759000000006,512.2012344885962,496.35056551140497,509.3435552113678,507.71423621231145,509.3871608702909,506.04131155433197,34648,37667.53333333333,80.23089197817968,74.06597903057688,NaN,NaN,NaN,NaN,0.9865425468857938,54.6904309494497,12850778,0.08338388440753564,1.7970042433358913,1.7136203589283556
2025-09-12T11:35:00-04:00,511.29,511.74,511.24,511.4,508.6668939097675,NaN,NaN,NaN,NaN,NaN,504.50330000000065,512.5793197149237,496.42728028507753,509.62084416909425,507.8716660679378,509.67332165316515,506.0700104827104,42118,38697.8,80.5460806281854,74.84260630481752,NaN,NaN,NaN,NaN,0.9517895078225228,55.833302862939824,12892896,0.0829733934457384,1.8173371007355286,1.7343637072897902
2025-09-12T11:40:00-04:00,511.37,511.78,510.66,510.87,508.6668939097675,NaN,NaN,NaN,NaN,NaN,504.71970000000067,512.8861568593583,496.5532431406431,509.62084416909425,507.9885314007014,509.8573794187628,506.11968338264,37599,39644,73.82771726583547,74.9357883613247,NaN,NaN,NaN,NaN,0.9638045429780532,55.602232026475775,12855297,0.028731278590155673,1.7702778055274848,1.7415465269373291
2025-09-12T11:45:00-04:00,510.84,511.14,510.15,510.46,508.6668939097675,NaN,NaN,NaN,NaN,NaN,504.92410000000064,513.1432585187233,496.704941481278,509.62084416909425,508.06081599371436,509.9522803163493,506.1693516710794,29794,40029.46666666667,69.03087822826618,74.61147072833458,NaN,NaN,NaN,NaN,0.96567564705105,54.39342028988593,12825503,-0.04881535867621256,1.6805273285920634,1.729342687268276
2025-09-12T11:50:00-04:00,510.54,511.03,510.38,510.68,508.6668939097675,NaN,NaN,NaN,NaN,NaN,505.13710000000066,513.3898173922166,496.88438260778474,509.62084416909425,508.1083036967462,510.01515914159734,506.20144825189504,19622,39514.23333333333,70.15155637557666,74.60867883688776,NaN,NaN,NaN,NaN,0.9431273865474019,53.270952248766775,12845125,-0.09658730795889947,1.6086085523196516,1.705195860278551
2025-09-12T11:55:00-04:00,510.76,511.37,510.63,511.23,508.6668939097675,NaN,NaN,NaN,NaN,NaN,505.36570000000063,513.6475727372383,497.08382726276295,509.62084416909425,508.1542831447424,510.0814947888442,506.2270715006406,17136,36875.8,72.80141673650085,74.74080420546817,NaN,NaN,NaN,NaN,0.9286182875083024,52.51721980943568,12862261,-0.10191280405189262,1.5778048552136852,1.6797176592655778
2025-09-12T12:00:00-04:00,511.22,511.325,510.7,510.93,508.6668939097675,NaN,NaN,NaN,NaN,NaN,505.5847000000007,513.8644358433537,497.3049641566476,509.62084416909425,508.20911463051715,510.15703839715167,506.26119086388263,21852,34563.7,69.19307882069836,74.4304247148694,NaN,NaN,NaN,NaN,0.9069312669719951,51.81732540148537,12840409,-0.13436724865459881,1.5117585984473294,1.6461258471019282
2025-09-12T12:05:00-04:00,510.92,511.59,510.84,511.31,508.6668939097675,NaN,NaN,NaN,NaN,NaN,505.8105000000007,514.086678888582,497.53432111141933,509.62084416909425,508.26361534305363,510.23564601760546,506.2915846685018,20611,33381.26666666667,71.14404545214991,74.15504295438892,NaN,NaN,NaN,NaN,0.8957218907597098,51.39738342755199,12861020,-0.13842201545821853,1.4730983277791552,1.6115203432373737
2025-09-12T12:10:00-04:00,511.3,511.62,511.04,511.38,508.6668939097675,NaN,NaN,NaN,NaN,NaN,506.0361000000007,514.2922684306716,497.77993156932985,509.75401857109046,508.324202135982,510.3231026670299,506.32530160493405,23027,32825.86666666667,71.50207096170998,74.22039714931908,NaN,NaN,NaN,NaN,0.8731703271340151,51.0337172710109,12884047,-0.14393184084492572,1.4316055421812166,1.5755373830261423
2025-09-12T12:15:00-04:00,511.49,512.23,511.44,511.79,509.164057543667,NaN,NaN,NaN,NaN,NaN,506.26490000000064,514.5121401417617,498.01765985823954,510.31221485687234,508.4125745883362,510.46091990265575,506.3642292740167,30390,31457.033333333333,73.57048828318158,74.24173393878274,NaN,NaN,NaN,NaN,0.8715153037673014,51.19344738623328,12914437,-0.128038779133258,1.4154889091095697,1.5435276882428277
2025-09-12T12:20:00-04:00,511.79,511.89,511.31,511.75,509.164057543667,NaN,NaN,NaN,NaN,NaN,506.49510000000066,514.6992424875394,498.2909575124619,510.31221485687234,508.47649587372365,510.553929555881,506.3990621915663,24214,30331.8,73.01370006012556,74.10673379164213,NaN,NaN,NaN,NaN,0.8506927820696358,51.02531130223304,12890223,-0.12799006542887414,1.383540106456735,1.5115301718856091
2025-09-12T12:25:00-04:00,511.7,512.07,511.56,511.91,509.23631069577925,NaN,NaN,NaN,NaN,NaN,506.7247000000007,514.8794498818594,498.569950118142,510.3556175083983,508.5037436965705,510.59465866476216,506.4128287283788,9996,28937.433333333334,73.86570453111958,73.94152553179302,NaN,NaN,NaN,NaN,0.8263575833503796,51.020185648086134,12900219,-0.12481958773990898,1.355505687210723,1.480325274950632
2025-09-12T12:30:00-04:00,511.91,512.05,511.7,511.88,509.36579657324376,NaN,NaN,NaN,NaN,NaN,506.94510000000076,515.0494342697223,498.8407657302792,510.5034940067186,508.5468515680936,510.65862592998695,506.4350772062002,16006,27754.1,73.39778899654358,73.6380702836822,NaN,NaN,NaN,NaN,0.7923320416824929,51.01542611209256,12884213,-0.1316995175799449,1.3157008779757007,1.4474003955556456
2025-09-12T12:35:00-04:00,511.94,512.2,511.82,512.05,509.5630330926418,NaN,NaN,NaN,NaN,NaN,507.17190000000073,515.1999236394475,499.1438763605539,510.77279520537496,508.5812104067003,510.7104786324883,506.4519421809123,12501,26906.2,74.38789620526691,73.3330938945243,NaN,NaN,NaN,NaN,0.7628797529908901,51.14554107769875,12896714,-0.1314544882555413,1.283082285236219,1.4145367734917602
2025-09-12T12:40:00-04:00,512.04,512.44,512,512.28,509.82425886115806,NaN,NaN,NaN,NaN,NaN,507.4027000000008,515.3408330825016,499.4645669175,511.07823616429994,508.6412851993205,510.8035834306246,506.47898696801644,21115,26767.9,75.70535961296096,73.00984158272296,NaN,NaN,NaN,NaN,0.7398169134915447,51.47543882894766,12917829,-0.12262784620393097,1.2612519657368466,1.3838798119407776
2025-09-12T12:45:00-04:00,512.27,512.4,511.75,511.85,509.82425886115806,NaN,NaN,NaN,NaN,NaN,507.62530000000083,515.4243610739534,499.8262389260483,511.07823616429994,508.6893392171502,510.872852464502,506.50582596979837,18666,26565.5,68.60064243745052,72.15659599767046,NaN,NaN,NaN,NaN,0.7334014196707184,51.05757813240888,12899163,-0.15072528716321298,1.1954732029867614,1.3461984901499744
2025-09-12T12:50:00-04:00,511.82,512.16,511.77,512.11,509.82425886115806,NaN,NaN,NaN,NaN,NaN,507.8569,515.4852903648555,500.2285096351445,511.07823616429994,508.7362974752654,510.93953599996127,506.53305895056957,18695,26469.933333333334,70.40894144750956,71.9123977249329,NaN,NaN,NaN,NaN,0.7088727468370947,50.66956462848001,12917858,-0.15611539227921956,1.15105424980095,1.3071696420801695
2025-09-12T12:55:00-04:00,512.13,512.54,512.09,512.32,510.0384364493976,NaN,NaN,NaN,NaN,NaN,508.0925,515.5276119022277,500.65738809777224,511.2537769161215,508.78286309015493,511.00899878496523,506.55672739534464,17438,26372.033333333333,71.82054487333993,72.11165962815245,NaN,NaN,NaN,NaN,0.6903818363487259,50.70904707469593,12935296,-0.14982548561897668,1.1198877850564486,1.2697132706754253
2025-09-12T13:00:00-04:00,512.29,512.3,511.7,511.84,510.0384364493976,NaN,NaN,NaN,NaN,NaN,508.3161,515.5122821237658,501.11991787623424,511.2537769161215,508.812183738052,511.0486224880462,506.5757449880578,12542,25626.166666666668,64.27328466790058,71.69178307760417,NaN,NaN,NaN,NaN,0.6853545623238213,49.64236115440471,12922754,-0.18023720660330644,1.0444167624212923,1.2246539690245988
2025-09-12T13:05:00-04:00,511.91,512.05,511.3,511.34,510.0384364493976,NaN,NaN,NaN,NaN,NaN,508.5269,515.4420621498192,501.61173785018076,511.2537769161215,508.85150476832126,511.09578718505605,506.6072223515865,19623,25015.066666666666,57.49549768138801,70.5985031450961,NaN,NaN,NaN,NaN,0.6899720935864014,47.66860073773081,12903131,-0.23292412032393317,0.9334988186196824,1.1664229389436156
2025-09-12T13:10:00-04:00,511.36,511.69,511.33,511.38,510.0384364493976,NaN,NaN,NaN,NaN,NaN,508.73950000000013,515.3312731300387,502.14772686996156,511.2537769161215,508.8722345258397,511.1196018719508,506.6248671797286,10970,24540.566666666666,57.878180718071945,69.79029613776565,NaN,NaN,NaN,NaN,0.6664026583302309,45.83582320796219,12914101,-0.2618183385837516,0.8391500157139262,1.1009683542976778
2025-09-12T13:15:00-04:00,511.38,511.56,511.28,511.44,510.0384364493976,NaN,NaN,NaN,NaN,NaN,508.95350000000013,515.177031553542,502.7299684464583,511.2537769161215,508.8865765859952,511.13573927138344,506.637413900607,7814,24133.866666666665,58.48201324622213,68.88586526591367,NaN,NaN,NaN,NaN,0.6388024684495023,44.007721277381684,12921915,-0.27241198337284267,0.7604533750816245,1.0328653584544671
2025-09-12T13:20:00-04:00,511.48,512.37,511.4,512.31,510.0384364493976,NaN,NaN,NaN,NaN,NaN,509.18930000000006,514.9963054277687,503.3822945722314,511.2537769161215,508.9192641348129,511.1792743162152,506.65925395341065,14640,23827.533333333333,66.07598984023042,68.49828804295085,NaN,NaN,NaN,NaN,0.6624594349888255,43.459447280753764,12936555,-0.21866665718082035,0.7595320369784417,0.9781986941592621
2025-09-12T13:25:00-04:00,512.33,512.4,512.01,512.01,510.074060191256,NaN,NaN,NaN,NaN,NaN,509.4175000000001,514.7323314176713,504.1026685823289,511.2537769161215,508.9406616976744,511.20829713089205,506.6730262644567,9406,23057.366666666665,61.87333993206338,67.66277744644239,NaN,NaN,NaN,NaN,0.642998046775337,42.98663554250702,12927149,-0.2015806103629768,0.726222931205541,0.9278035415685179
2025-09-12T13:30:00-04:00,512.05,512.14,511.5,511.58,510.074060191256,NaN,NaN,NaN,NaN,NaN,509.61870000000005,514.4632824627462,504.7741175372539,511.2537769161215,508.9673060220539,511.24043237769575,506.694179666412,13605,22564.566666666666,56.34184539629554,66.47193068474026,NaN,NaN,NaN,NaN,0.6427839005770977,41.301375156150385,12913544,-0.216204421765834,0.6575480143612253,0.8737524361270593
2025-09-12T13:35:00-04:00,511.6,512.2,511.6,511.98,510.074060191256,NaN,NaN,NaN,NaN,NaN,509.83770000000004,514.059421549125,505.6159784508751,511.2537769161215,509.0134644770471,511.2984105916602,506.728518362434,22648,22003.933333333334,59.93048035141197,65.47655752904686,NaN,NaN,NaN,NaN,0.6411564791073093,39.8280199542593,12936192,-0.19647531904147109,0.6281582873252205,0.8246336063666916
2025-09-12T13:40:00-04:00,512.07,512.21,511.8,512.13,510.074060191256,NaN,NaN,NaN,NaN,NaN,509.97839999999997,514.0237259151967,505.9330740848032,511.2537769161215,509.02589056903753,511.3143674537554,506.7374136843197,5973,21219.066666666666,61.217874317088146,64.60656362337146,NaN,NaN,NaN,NaN,0.6246453020282176,38.476025610113744,12942165,-0.1717553163937532,0.6099394608745001,0.7816947772682533
2025-09-12T13:45:00-04:00,512.14,512.22,511.66,511.76,510.074060191256,NaN,NaN,NaN,NaN,NaN,510.10479999999995,513.9657475314154,506.24385246858446,511.04288353589976,509.04589252099044,511.3387317441987,506.7530532977822,10290,20371.3,56.40392199482828,63.32199403691156,NaN,NaN,NaN,NaN,0.6200277804547737,36.86539483604649,12931875,-0.17799669782714045,0.5591989049843278,0.7371956028114682
2025-09-12T13:50:00-04:00,511.77,511.83,511.16,511.67,510.074060191256,NaN,NaN,NaN,NaN,NaN,510.203,513.9672151904731,506.43878480952685,511.04288353589976,509.068984859302,511.36377583419073,506.7741938844133,13648,20031.4,55.2655004273186,61.86200409507996,NaN,NaN,NaN,NaN,0.6235972247080012,34.23875512270049,12918227,-0.1850422551044063,0.5058927839309604,0.6909350390353667
2025-09-12T13:55:00-04:00,511.67,511.97,511.55,511.78,510.074060191256,NaN,NaN,NaN,NaN,NaN,510.29239999999993,513.9892560913618,506.5955439086381,511.04288353589976,509.08992098053733,511.38801530013507,506.7918266609396,11591,18939.266666666666,56.42316918516526,60.99218457705958,NaN,NaN,NaN,NaN,0.6090545658002879,32.082031964834336,12929818,-0.17903723297336005,0.46713849781866656,0.6461757307920266
2025-09-12T14:00:00-04:00,511.84,511.85,511.08,511.1,510.074060191256,NaN,NaN,NaN,NaN,NaN,510.388,513.9121974973243,506.8638025026756,511.04288353589976,509.1102448243724,511.4078501468912,506.8126395018536,13593,18237.433333333334,48.131010243016895,59.40090377673868,NaN,NaN,NaN,NaN,0.6205506682431273,30.431447639068015,12916225,-0.21517504603029014,0.37720692325416394,0.5923819692844541
2025-09-12T14:05:00-04:00,511.11,511.37,511.06,511.35,510.074060191256,NaN,NaN,NaN,NaN,NaN,510.4571999999999,513.9177850141879,506.99661498581196,511.04288353589976,509.1323496155512,511.42837671286657,506.8363225182359,15658,17355.433333333334,50.98315321041507,57.91251865795834,NaN,NaN,NaN,NaN,0.5983684776543327,28.935831333286067,12931883,-0.21599191305957177,0.32239207795998936,0.5383839910195611
2025-09-12T14:10:00-04:00,511.35,511.52,511.06,511.27,510.074060191256,NaN,NaN,NaN,NaN,NaN,510.5409999999998,513.8708606578513,507.2111393421484,511.04288353589976,509.1560298447073,511.4503878713157,506.8616718180989,16951,16667.166666666668,50.03501382434299,56.89549931198993,NaN,NaN,NaN,NaN,0.5884850149647359,27.202753589692964,12914932,-0.21519501367894522,0.26939022392087963,0.48458523759982486
2025-09-12T14:15:00-04:00,511.26,511.29,510.67,510.98,510.074060191256,NaN,NaN,NaN,NaN,NaN,510.61179999999985,513.8233483867604,507.4002516132394,510.8578850963045,509.1943456315458,511.4794968357969,506.90919442729466,33039,16775.333333333332,46.648332639184396,56.12070180897539,NaN,NaN,NaN,NaN,0.5907360853243979,26.340663270504212,12881893,-0.2263396479948665,0.20166067760624173,0.42800032560110823
2025-09-12T14:20:00-04:00,511.05,511.3,511.03,511.21,510.074060191256,NaN,NaN,NaN,NaN,NaN,510.69199999999984,513.7556109414638,507.62838905853584,510.8578850963045,509.21323080551537,511.4956405349648,506.9308210760659,15102,16624.666666666668,49.56411089906671,55.52683967904644,NaN,NaN,NaN,NaN,0.5713977935155119,25.515306616030113,12896995,-0.21068372511259986,0.1646456692103584,0.37532939432295825
2025-09-12T14:25:00-04:00,511.25,511.44,511.09,511.29,510.074060191256,NaN,NaN,NaN,NaN,NaN,510.7747999999998,513.6701818126154,507.87941818738415,510.8578850963045,509.2280563388414,511.50889545553804,506.94721722214473,11510,16437.133333333335,50.57590480350129,54.96211764742352,NaN,NaN,NaN,NaN,0.5555836654072627,24.391729669568182,12908505,-0.18814290028542274,0.14015076896617984,0.3282936692516026
2025-09-12T14:30:00-04:00,511.26,511.55,511,511.44,510.074060191256,NaN,NaN,NaN,NaN,NaN,510.86819999999983,513.5329076839079,508.20349231609174,510.8578850963045,509.25033160863984,511.5292396459977,506.971423571282,17131,16279.766666666666,52.50002293849017,53.99240572587065,NaN,NaN,NaN,NaN,0.5551848321638876,23.06962592892586,12925636,-0.1575723273919341,0.13132826001168496,0.28890058740361907
2025-09-12T14:35:00-04:00,511.46,511.86,511.33,511.78,510.074060191256,NaN,NaN,NaN,NaN,NaN,510.96039999999977,513.4178456984723,508.5029543015272,510.6309138614008,509.2774774485213,511.5577011209924,506.99725377605023,18444,16207.533333333333,56.62225397176256,53.617328157277726,NaN,NaN,NaN,NaN,0.5533859155807549,21.738178150428872,12944080,-0.11108692858599772,0.15004192667112193,0.26112885525711965
2025-09-12T14:40:00-04:00,511.78,511.93,511.55,511.81,510.074060191256,NaN,NaN,NaN,NaN,NaN,511.0383999999998,513.3466577327515,508.7301422672481,510.75673108912065,509.29580698108447,511.57754108535624,507.0140728768127,12145,15844.8,56.97703977939433,53.66269918464193,NaN,NaN,NaN,NaN,0.5410012073249864,20.65976082842209,12956225,-0.07659355284102393,0.16538691420583973,0.24198046704686366
2025-09-12T14:45:00-04:00,511.81,512.06,511.43,511.61,510.074060191256,NaN,NaN,NaN,NaN,NaN,511.10659999999984,513.2724868300717,508.940713169928,510.8063848712965,509.3249986925385,511.60807246565116,507.0419249194258,20245,15506.633333333333,53.81686518130524,53.22601238677716,NaN,NaN,NaN,NaN,0.5473582639446258,19.953275453245915,12935980,-0.06592823505866821,0.1595701732235284,0.2254984082821966
2025-09-12T14:50:00-04:00,511.62,512.3,511.61,512.05,510.1303884870733,NaN,NaN,NaN,NaN,NaN,511.1903999999998,513.1629474293064,509.21785257069314,510.95210789703725,509.35308220676546,511.6403052730181,507.0658591405128,17780,15292.166666666666,59.180795167012285,53.080506733200316,NaN,NaN,NaN,NaN,0.5575469593771484,19.81235058464648,12953760,-0.029763407335853143,0.18829414911238018,0.21805755644823333
2025-09-12T14:55:00-04:00,512.09,512.23,511.88,512.17,510.2655981012973,NaN,NaN,NaN,NaN,NaN,511.2729999999998,513.0468150977301,509.4991849022695,510.9766863176298,509.3737301927586,511.6646088001138,507.08285158540343,12794,15385.433333333332,60.527305582924605,53.37503413235005,NaN,NaN,NaN,NaN,0.5427221765644965,19.681491778089864,12966554,0.00013438358537021244,0.2182255359299461,0.21809115234457588
2025-09-12T15:00:00-04:00,512.13,512.5,512.08,512.26,510.5246618239655,NaN,NaN,NaN,NaN,NaN,511.3445999999998,512.977375355296,509.71182464470365,511.28734905410386,509.4037391163192,511.7016182146005,507.10586001803784,17715,15442.4,61.55170244210334,53.82404856197753,NaN,NaN,NaN,NaN,0.5339563068098867,20.11880571578383,12984269,0.022621989446322377,0.24636863915247886,0.2237466497061565
2025-09-12T15:05:00-04:00,512.25,512.35,512.1,512.19,510.5246618239655,NaN,NaN,NaN,NaN,NaN,511.4069999999998,512.9214807693464,509.89251923065325,511.28734905410386,509.42803439390536,511.73069770132724,507.1253710864835,14965,15524.533333333333,60.24218173075971,54.09683517237713,NaN,NaN,NaN,NaN,0.5136737134663234,20.52488294364251,12969304,0.02902381111168864,0.2600264135957673,0.23100260248407864
2025-09-12T15:10:00-04:00,512.18,512.39,511.9,511.9,510.5246618239655,NaN,NaN,NaN,NaN,NaN,511.4717999999998,512.772806933433,510.1707930665666,511.28734905410386,509.46178998137736,511.76877030588446,507.15480965687027,22455,15569.2,55.01971941728706,54.58888582768215,NaN,NaN,NaN,NaN,0.5119827339330152,20.221368924045596,12946849,0.010901743630111704,0.24462978202171826,0.23372803839160655
2025-09-12T15:15:00-04:00,511.885,512.1,511.695,511.78,510.5246618239655,NaN,NaN,NaN,NaN,NaN,511.5211999999998,512.668625919617,510.3737740803825,511.28734905410386,509.50243286669047,511.8106032538714,507.1942624795095,30243,15955.1,52.97327761176849,54.73103757063597,NaN,NaN,NaN,NaN,0.5043411100806591,19.298744407608588,12916606,-0.010817278169295064,0.22020644067998774,0.2310237188492828
2025-09-12T15:20:00-04:00,511.77,511.78,510.98,511.09,510.5246618239655,NaN,NaN,NaN,NaN,NaN,511.54819999999984,512.5848923559389,510.5115076440608,511.28734905410386,509.51975216818136,511.82331093577733,507.2161934005854,17513,15915.7,43.05646834488146,54.232570036388715,NaN,NaN,NaN,NaN,0.5254596022177516,19.12061525045196,12899093,-0.07000366784984355,0.14351913403697836,0.2135228018868219
2025-09-12T15:25:00-04:00,511.1,511.12,510.33,510.66,NaN,NaN,NaN,512.4725755506176,512.4725755506176,512.4725755506176,511.5595999999998,512.5430710777263,510.57612892227337,511.28734905410386,509.5354830988681,511.82769326359795,507.24327293413825,24257,16143,38.25074208829959,53.63274213989695,NaN,NaN,NaN,NaN,0.5443553449164851,20.026687831086104,12874836,-0.13281908439489373,0.04749894639320473,0.18031803078809847
2025-09-12T15:30:00-04:00,510.63,510.83,510.27,510.77,NaN,NaN,NaN,512.2945039346804,NaN,NaN,511.5647999999999,512.5285695993088,510.601030400691,511.28734905410386,509.5521471365105,511.8306536190286,507.27364065399235,28392,16671.333333333332,40.092821724349534,52.95622148456,NaN,NaN,NaN,NaN,0.5454728202795934,20.953812144626387,12903228,-0.1598519567184649,-0.019496915109982638,0.14035504160848225
2025-09-12T15:35:00-04:00,510.8,510.94,510.45,510.59,NaN,NaN,NaN,512.2945039346804,NaN,NaN,511.56039999999985,512.5397954057528,510.58100459424685,511.28734905410386,509.56583871168283,511.8335272865464,507.29815013681923,23193,16790.333333333332,38.09039497485985,52.064399353942754,NaN,NaN,NaN,NaN,0.5415104759739088,21.495522877548698,12880035,-0.18118270327318753,-0.08612333748300216,0.09505936579018537
2025-09-12T15:40:00-04:00,510.59,510.9,510.29,510.67,NaN,NaN,NaN,512.2945039346804,NaN,NaN,511.5477999999998,512.5560562376716,510.53954376232804,511.28734905410386,509.5798710798267,511.83565347652717,507.32408868312626,25318,17268.6,39.535803027488114,51.13838364601405,NaN,NaN,NaN,NaN,0.5464025848329122,22.253745978172297,12905353,-0.18081573025993453,-0.13096029703473278,0.04985543322520174
2025-09-12T15:45:00-04:00,510.62,510.76,510.42,510.7,NaN,NaN,NaN,512.2939125600184,NaN,NaN,511.5337999999998,512.5689571093185,510.49864289068114,511.28734905410386,509.5932389640854,511.837651280276,507.3488266478948,24603,17828.233333333334,40.10057230101256,49.95826352667475,NaN,NaN,NaN,NaN,0.531659543059131,22.95781028589421,12929956,-0.16964705187423113,-0.16220338161758718,0.007443670256643949
2025-09-12T15:50:00-04:00,510.72,511.09,510.4,510.88,NaN,NaN,NaN,512.2939125600184,NaN,NaN,511.5339999999999,512.568647766488,510.4993522335118,511.2689033946265,509.62543144775816,511.84790145483674,507.4029614406796,53257,19115.466666666667,43.50999107657093,48.99633147647308,NaN,NaN,NaN,NaN,0.5429695756977643,22.603596574143083,12983213,-0.14233424488130214,-0.17047413584498372,-0.028139890963681587
2025-09-12T15:55:00-04:00,510.87,510.93,509.87,509.89,NaN,NaN,NaN,512.1868914028266,NaN,NaN,511.5225999999999,512.6152650724806,510.4299349275191,511.2689033946265,509.64743025730877,511.8320255877226,507.4628349268949,74762,21294,32.539691649416014,47.47653336705242,NaN,NaN,NaN,NaN,0.5799003202907812,23.188073812295272,12908451,-0.18067665144728073,-0.2539857052727825,-0.07330905382550178
2025-09-15T09:30:00-04:00,508.79,511.44,507.02,509.28,NaN,NaN,NaN,511.5383963390618,NaN,NaN,511.4945999999998,512.7340851192594,510.2551148807402,511.0006227157012,509.24666666666667,509.24666666666667,509.24666666666667,58384,22786.633333333335,27.875913169290072,45.24047036721511,NaN,NaN,NaN,NaN,0.8541931545557266,26.07680771811573,12850067,-0.23349799072260186,-0.3651815422287541,-0.13168355150615224
2025-09-15T09:35:00-04:00,509.29,510.36,509,509.53,NaN,NaN,NaN,511.5383963390618,NaN,NaN,511.4605999999999,512.8151739406458,510.10602605935406,510.5004981725609,509.4008602943184,509.5888280640267,509.21289252461014,39288,23341.3,32.16693550956752,43.2147296476896,NaN,NaN,NaN,NaN,0.8903222149446043,28.759203487806158,12889355,-0.23721008259287069,-0.4281961547472406,-0.1909860721543699
2025-09-15T09:40:00-04:00,509.6,510.87,509.6,509.94,NaN,NaN,NaN,511.5383963390618,NaN,NaN,511.44079999999985,512.8535127948749,510.02808720512485,509.7088246729478,509.59897238494983,509.96276173684447,509.2351830330552,35987,24341.766666666666,38.616906362010326,41.57652992768296,NaN,NaN,NaN,NaN,0.9224420567342777,30.20214237147786,12925342,-0.19919537963233172,-0.43998029669478456,-0.24078491706245284
2025-09-15T09:45:00-04:00,510,511.5,510,510.675,NaN,NaN,NaN,511.5383963390618,NaN,NaN,511.42809999999986,512.8566165594788,509.99958344052095,509.7088246729478,509.8681905258005,510.44383796885563,509.2925430827454,41997,25398.666666666668,48.1373870026231,40.71190173281606,NaN,NaN,NaN,NaN,0.9679819098246866,30.408230604057223,12967339,-0.11582517629572309,-0.3855663874321067,-0.2697412111363836
2025-09-15T09:50:00-04:00,510.685,511.7,510.42,510.84,508.4381589866766,508.4381589866766,508.4381589866766,NaN,NaN,NaN,511.41729999999984,512.8552418767571,509.9793581232426,509.7088246729478,509.97467502665626,510.613097559519,509.3362524937935,18483,25559.833333333332,50.011773383880424,40.35419130185845,NaN,NaN,NaN,NaN,0.9902689162657784,30.265456744673813,12985822,-0.044509507197319276,-0.32537809513303273,-0.28086858793571345
2025-09-15T09:55:00-04:00,510.74,510.8,509.87,510.21,508.4381589866766,NaN,NaN,NaN,NaN,NaN,511.3856999999999,512.8585122897365,509.9128877102632,509.7088246729478,510.0093620086328,510.62015385677535,509.3985701604903,23714,25963.933333333334,43.541152760941074,39.68046809822793,NaN,NaN,NaN,NaN,0.9888211365325065,30.615006021017926,12962108,-0.03512146840678332,-0.3247704234441926,-0.2896489550374093
2025-09-15T10:00:00-04:00,510.28,511.95,510.28,511.92,508.4381589866766,NaN,NaN,NaN,NaN,NaN,511.3890999999998,512.866039660574,509.9121603394257,509.7088246729478,510.1277700526012,510.8274734224818,509.4280666827206,20545,26195.666666666668,59.034161758132726,40.821731913460155,NaN,NaN,NaN,NaN,1.042476769637328,29.24891869414313,12982653,0.08437277720207881,-0.18418298353481077,-0.2685557607368896
2025-09-15T10:05:00-04:00,511.93,512.14,511.18,511.75,508.90175999019647,NaN,NaN,NaN,NaN,NaN,511.3858999999998,512.8589997118264,509.91280028817323,509.7088246729478,510.23446917232707,511.0164221077513,509.45251623690285,17476,26256.266666666666,57.34928074471906,42.18591324606155,NaN,NaN,NaN,NaN,1.0365855718060888,27.73977168461124,12965177,0.146445863720011,-0.08549843108687583,-0.23194429480688683
2025-09-15T10:10:00-04:00,511.77,512.39,511.46,512.04,509.16531635427845,NaN,NaN,NaN,NaN,NaN,511.3890999999998,512.867165885182,509.91103411481765,509.30968834306674,510.362852187116,511.2412140395806,509.4844903346514,20525,26375.4,59.474147745919545,43.5702936761737,NaN,NaN,NaN,NaN,1.028972316677083,26.02131814684285,12985702,0.1982968519960025,0.01592677018811628,-0.18237008180788622
2025-09-15T10:15:00-04:00,512.07,512.09,510.7,511.3,509.16531635427845,NaN,NaN,NaN,NaN,NaN,511.3740999999998,512.8402073497367,509.9079926502629,509.30968834306674,510.40912325771853,511.2922936821133,509.52595283332374,13403,25720.866666666665,52.31226332152164,44.58614141522096,NaN,NaN,NaN,NaN,1.0547600083430086,25.240847439185586,12972299,0.17483856027459752,0.03617811853536068,-0.13866044173923683
2025-09-15T10:20:00-04:00,511.32,511.95,510.42,510.65,509.16531635427845,NaN,NaN,NaN,NaN,NaN,511.34149999999977,512.7980414518777,509.88495854812186,509.30968834306674,510.43505846930145,511.3073891557247,509.5627277828782,13149,25655.766666666666,46.96269860408187,45.11663395640624,NaN,NaN,NaN,NaN,1.0887057220327918,24.788447755359822,12959150,0.11075269054752243,-0.00021957855483378808,-0.11097226910235622
2025-09-15T10:25:00-04:00,510.655,511.39,510.53,510.66,509.16531635427845,NaN,NaN,NaN,NaN,NaN,511.31769999999983,512.7791091969251,509.8562908030746,509.30968834306674,510.45449379103394,511.3112541513535,509.59773343071436,14520,25756.1,47.05240687480599,45.61319356882005,NaN,NaN,NaN,NaN,1.0723695990304505,24.36836233466447,12973670,0.06642895953639927,-0.027936069681857134,-0.0943650292182564
2025-09-15T10:30:00-04:00,510.71,511.25,510.33,510.72,509.16531635427845,NaN,NaN,NaN,NaN,NaN,511.2898999999998,512.7428232467033,509.8369767532963,509.30968834306674,510.4675695337256,511.30852324210576,509.6266158253455,13879,25647.7,47.62482384015625,45.907110194790434,NaN,NaN,NaN,NaN,1.0614860562425623,24.18601890963031,12987549,0.03985475559217404,-0.04454658472803885,-0.08440134032021289
2025-09-15T10:35:00-04:00,510.72,511.95,510.56,511.43,509.16531635427845,NaN,NaN,NaN,NaN,NaN,511.2720999999998,512.6956168987733,509.8485831012263,509.30968834306674,510.51918273186254,511.35884595833636,509.6795195053887,21535,25750.733333333334,53.96685925274669,47.437622166456904,NaN,NaN,NaN,NaN,1.0849513379395213,22.980555041354236,13009084,0.0671893194623069,-0.00041469099232926965,-0.06760401045463617
2025-09-15T10:40:00-04:00,511.59,512.3,511.59,512.1,509.16531635427845,NaN,NaN,NaN,NaN,NaN,511.2772999999998,512.7109404154951,509.8436595845045,509.44587318100486,510.59465764678043,511.47490493512674,509.7144103584341,18997,25979.133333333335,59.01083898102369,49.66154543872359,NaN,NaN,NaN,NaN,1.0695976709438375,21.399325781283913,13028081,0.12417408700296637,0.08761359829907178,-0.036560488703894584
2025-09-15T10:45:00-04:00,512.1,512.28,511.5,512.07,509.16531635427845,NaN,NaN,NaN,NaN,NaN,511.2918999999997,512.7425645239899,509.84123547600944,509.6066985448039,510.642356082678,511.54232227807216,509.7423898872839,13565,25756.466666666667,58.700685234309226,51.556813276205155,NaN,NaN,NaN,NaN,1.0489121230192757,20.04728675200753,13014516,0.15180040957260113,0.15319002326185682,0.001389613689255699
2025-09-15T10:50:00-04:00,512.06,512.24,511.81,512.05,509.1980125623517,NaN,NaN,NaN,NaN,NaN,511.30529999999976,512.7712691814588,509.83933081854065,509.88635883584317,510.6837490256392,511.6011911812684,509.76630687001,11822,25557.866666666665,58.480013792106504,52.97560666406917,NaN,NaN,NaN,NaN,1.004704114232185,18.79182193910803,13002694,0.15986940292126503,0.201226367340837,0.041356964419571964
2025-09-15T10:55:00-04:00,512.06,512.5,511.98,512.47,509.4706029004267,NaN,NaN,NaN,NaN,NaN,511.32589999999976,512.8273788579672,509.8244211420323,510.3570870686745,510.7363225412215,511.6837849033353,509.7888601791077,13216,25571.933333333334,61.733339215937434,53.94674610787733,NaN,NaN,NaN,NaN,0.9700823917870277,17.65457431227348,13015910,0.18297264861014795,0.2700727751822569,0.08710012657210896
2025-09-15T11:00:00-04:00,512.47,513.17,512.47,513.15,510.0810300413163,NaN,NaN,NaN,NaN,NaN,511.3426999999997,512.9053966568375,509.78000334316187,511.1056696549396,510.8443871471563,511.8830614175855,509.80571287672706,21269,25690.4,66.3329368862024,55.11254350090034,NaN,NaN,NaN,NaN,0.9507907923736637,17.475298050147302,13037179,0.23046352300358547,0.3751795303265908,0.14471600732300532
2025-09-15T11:05:00-04:00,513.15,513.76,513.12,513.47,510.73825594852934,NaN,NaN,NaN,NaN,NaN,511.37189999999964,513.0347347968191,509.7090652031803,511.7885357239517,510.9585347278357,512.1056949586477,509.8113744970236,19781,25850.933333333334,68.2660159903731,56.878605160145476,NaN,NaN,NaN,NaN,0.9285914500612582,17.957465912839485,13056960,0.26725090853022365,0.4787796429857849,0.21152873445556125
2025-09-15T11:10:00-04:00,513.49,514.25,513.38,513.43,511.11742613268706,NaN,NaN,NaN,NaN,NaN,511.4088999999996,513.1681444860143,509.64965551398495,512.2378285791614,511.0762570972257,512.3278537286504,509.824660465801,20363,25781.2,67.7424158311475,57.50062330821796,NaN,NaN,NaN,NaN,0.9244063464854543,18.87799294131171,13036597,0.2718176212044408,0.5513007609611122,0.27948313975667144
2025-09-15T11:15:00-04:00,513.43,513.81,512.99,513.03,511.11742613268706,NaN,NaN,NaN,NaN,NaN,511.4298999999997,513.240237526851,509.61956247314833,512.2378285791614,511.11317732087923,512.3860036062124,509.84035103554606,8053,25041.533333333333,62.573820101376725,57.87380469083637,NaN,NaN,NaN,NaN,0.9169487503079173,19.081729208841928,13028544,0.232355759412263,0.5699278390220002,0.3375720796097372
2025-09-15T11:20:00-04:00,513.07,513.17,512.1,512.23,511.11742613268706,NaN,NaN,NaN,NaN,NaN,511.43189999999964,513.2455448278174,509.6182551721819,512.2378285791614,511.17738051806026,512.454095425144,509.9006656109765,23298,25234.366666666665,53.74217162572921,57.46437782510849,NaN,NaN,NaN,NaN,0.9278809824287758,17.99995770045448,13005246,0.14130964481910702,0.5142091356336209,0.3728994908145139
2025-09-15T11:25:00-04:00,512.29,513.09,512.23,512.48,511.11742613268706,NaN,NaN,NaN,NaN,NaN,511.44629999999967,513.2814422945911,509.61115770540823,512.2378285791614,511.23189025097133,512.5133427064344,509.95043779550826,20051,25094.166666666668,55.839736798690154,57.71634021633481,NaN,NaN,NaN,NaN,0.9230323408267214,16.99545558552328,13025297,0.08939078144081014,0.4846379676155266,0.39524718617471644
2025-09-15T11:30:00-04:00,512.49,513.37,512.49,513.31,511.11742613268706,NaN,NaN,NaN,NaN,NaN,511.4790999999997,513.3862735005348,509.57192649946455,512.2378285791614,511.2570972900137,512.5473679360875,509.96682664393984,7330,24392.1,62.00045551957501,58.79046571029861,NaN,NaN,NaN,NaN,0.920672887910526,16.410127501186423,13032627,0.10152829905484673,0.5221575599932748,0.4206292609384281
2025-09-15T11:35:00-04:00,513.27,513.8,513.07,513.8,511.11742613268706,NaN,NaN,NaN,NaN,NaN,511.51949999999977,513.5330702125493,509.5059297874502,512.2378285791614,511.2893742567597,512.5988063472613,509.97994216625807,7554,23870.8,65.0962654936077,60.07931275449873,NaN,NaN,NaN,NaN,0.9070533959169103,16.369952040081763,13040181,0.13124943733819094,0.5846910576111668,0.45344162027297585
2025-09-15T11:40:00-04:00,513.81,514,512.98,513.05,511.11742613268706,NaN,NaN,NaN,NaN,NaN,511.5584999999997,513.6131768605147,509.50382313948467,512.2378285791614,511.34553838929304,512.6796792717495,510.0113975068366,15130,23531.2,57.389405066166375,60.77678284207088,NaN,NaN,NaN,NaN,0.9151210104942725,16.556618685740883,13025051,0.09100057007446483,0.5671923328660569,0.47619176279159203
2025-09-15T11:45:00-04:00,513.04,513.5,512.93,513.17,511.11742613268706,NaN,NaN,NaN,NaN,NaN,511.5948999999997,513.6974398833715,509.49236011662794,512.2378285791614,511.3713659930841,512.7138903024318,510.02884168373646,7815,22971.6,58.24127504878829,61.08209825607385,NaN,NaN,NaN,NaN,0.8904695097446852,16.645540036273573,13032866,0.06431972982290518,0.5565914250702235,0.49227169524731834
2025-09-15T11:50:00-04:00,513.2,513.2,512.7,513.01,511.11742613268706,NaN,NaN,NaN,NaN,NaN,511.6296999999997,513.7668910633821,509.49250893661724,512.2378285791614,511.3957431290926,512.7423178656022,510.04916839258294,8689,21486,56.61603109719795,60.91104055008629,NaN,NaN,NaN,NaN,0.8625788304772077,16.33351442127658,13024177,0.02952617623628251,0.5291794155426714,0.49965323930638894
2025-09-15T11:55:00-04:00,513.01,513.26,512.54,513.14,511.11742613268706,NaN,NaN,NaN,NaN,NaN,511.67289999999974,513.8428844149292,509.50291558507024,512.2378285791614,511.41985102274407,512.7701408811415,510.0695611643466,8805,19287.433333333334,57.65009685878907,60.83599852326343,NaN,NaN,NaN,NaN,0.8523946283002662,15.771585409224459,13032982,0.009911493052318088,0.5120426056217866,0.5021311125694685
2025-09-15T12:00:00-04:00,513.1,513.38,512.56,512.85,511.11742613268706,NaN,NaN,NaN,NaN,NaN,511.70569999999964,513.8961867133617,509.51521328663756,511.8120765350558,511.4375808558084,512.7897409347729,510.0854207768439,6874,17570.433333333334,54.52778645985967,60.55369657096008,NaN,NaN,NaN,NaN,0.8500807262788223,15.424241019543276,13026108,-0.025987143223650644,0.4696471835399052,0.49563432676355584
2025-09-15T12:05:00-04:00,512.8,513.16,512.55,512.6,511.11742613268706,NaN,NaN,NaN,NaN,NaN,511.73189999999965,513.9331822539257,509.5306177460736,511.8120765350558,511.4497104440411,512.8016377001294,510.0977831879528,5379,16440.133333333335,51.917337875531835,59.85255361807396,NaN,NaN,NaN,NaN,0.8329321029731931,15.082782910493767,13020729,-0.06759844348295457,0.4111362724098626,0.4787347158928172
2025-09-15T12:10:00-04:00,512.555,512.75,512.25,512.31,511.11742613268706,NaN,NaN,NaN,NaN,NaN,511.74929999999966,513.9548276106347,509.5437723893647,511.8120765350558,511.46811192843273,512.8140142763809,510.12220958048454,11226,15614.766666666666,48.98761689521547,58.61360219014632,NaN,NaN,NaN,NaN,0.8091512384751078,14.19948277892448,13009503,-0.11300763376171186,0.33747517369067737,0.4504828074523892
2025-09-15T12:15:00-04:00,512.29,512.78,512.25,512.46,511.11742613268706,NaN,NaN,NaN,NaN,NaN,511.76289999999966,513.977385123286,509.54841487671337,511.8120765350558,511.48002087864865,512.8226253271165,510.1374164301808,7053,14449.966666666667,50.542243870221725,57.347618467278366,NaN,NaN,NaN,NaN,0.7892118642983125,13.432480530274118,13016556,-0.13007950380139216,0.287883427700649,0.41796293150204117
2025-09-15T12:20:00-04:00,512.61,512.75,512.46,512.55,511.11742613268706,NaN,NaN,NaN,NaN,NaN,511.7776999999996,514.0031107130061,509.5522892869931,511.8120765350558,511.48978407099503,512.8304528478347,510.1491152941553,5422,14014.6,51.49735076637702,56.187256676937615,NaN,NaN,NaN,NaN,0.7535538739912876,12.720264156527355,13021978,-0.13202773719055627,0.25292826001384583,0.3849559972044021
2025-09-15T12:25:00-04:00,512.51,512.73,512.18,512.37,511.11742613268706,NaN,NaN,NaN,NaN,NaN,511.7928999999996,514.0238962711117,509.5619037288875,511.8120765350558,511.500099414941,512.836946759751,510.1632520701311,6842,13452.2,49.44089862515158,55.24919085720724,NaN,NaN,NaN,NaN,0.7390143115633433,12.130038890927256,13015136,-0.1413244898184315,0.20830038493136271,0.3496248747497942
2025-09-15T12:30:00-04:00,512.4,512.97,512.23,512.79,511.11742613268706,NaN,NaN,NaN,NaN,NaN,511.8076999999996,514.0550799948996,509.5603200050996,511.4799065487588,511.5116786209884,512.8468587940573,510.17649844791947,6248,12975.633333333333,54.051586358047786,55.27129190951571,NaN,NaN,NaN,NaN,0.739084717880248,11.437586359252592,13021384,-0.11612709541577815,0.20446600548007154,0.3205931008958497
2025-09-15T12:35:00-04:00,512.76,513.11,512.6,512.8,511.11742613268706,NaN,NaN,NaN,NaN,NaN,511.82029999999963,514.082677873247,509.5579221267523,511.63986360185424,511.52747855935206,512.862444157332,510.19251296137213,7575,12645.6,54.1587772660189,55.151223371467765,NaN,NaN,NaN,NaN,0.722721523745944,11.071979783048542,13028959,-0.09653089199309839,0.19992948590447668,0.29646037789757507
2025-09-15T12:40:00-04:00,512.77,513.03,512.49,512.95,511.11742613268706,NaN,NaN,NaN,NaN,NaN,511.8340999999996,514.1153765640225,509.5528234359767,511.63986360185424,511.5405798726358,512.8750914806724,510.20606826459925,6488,12177.7,55.82354715175197,54.71001563090898,NaN,NaN,NaN,NaN,0.7096699863355169,10.485049777842795,13035447,-0.0723181855645641,0.20606264594186996,0.27838083150643406
2025-09-15T12:45:00-04:00,512.92,512.92,512.63,512.82,511.11742613268706,NaN,NaN,NaN,NaN,NaN,511.84669999999954,514.1426125509792,509.55078744902,511.63986360185424,511.5456118754768,512.8797821751804,510.2114415757733,2595,11817.433333333332,53.99344295728841,53.91695687831474,NaN,NaN,NaN,NaN,0.6818364158829836,9.940043344437457,13032852,-0.0641853326647111,0.1981491656755452,0.2623344983402563
2025-09-15T12:50:00-04:00,512.82,512.86,512.16,512.25,511.11742613268706,NaN,NaN,NaN,NaN,NaN,511.8536999999996,514.1523524838352,509.55504751616394,511.63986360185424,511.55561123385746,512.8854264290896,510.2257960386253,7425,11626.633333333333,46.755613669571304,53.15740034998652,NaN,NaN,NaN,NaN,0.683133814748488,10.04741126882897,13025427,-0.09449083874934919,0.14422094990356982,0.238711788652919
2025-09-15T12:55:00-04:00,512.28,512.34,511.79,511.91,511.11742613268706,NaN,NaN,NaN,NaN,NaN,511.85629999999964,514.1549072394507,509.55769276054855,511.63986360185424,511.5627820334489,512.8833633054829,510.2422007614149,10373,11488.4,43.04867148982762,52.07221438148933,NaN,NaN,NaN,NaN,0.6736242565521682,10.813996997639368,13015054,-0.13240667245115506,0.07320344808897516,0.20561012054013023
2025-09-15T13:00:00-04:00,511.88,512.185,511.83,512.06,511.11742613268706,NaN,NaN,NaN,NaN,NaN,511.8756999999998,514.1644621196956,509.586937880304,511.63986360185424,511.5670871362423,512.882253753389,510.2519205190956,6225,11233.266666666666,45.116070361007935,51.25078861461861,NaN,NaN,NaN,NaN,0.6508653810841534,11.525826602963308,13021279,-0.14153246455092677,0.028694539851471745,0.17022700440239852
2025-09-15T13:05:00-04:00,512.07,512.42,511.95,512.04,511.11742613268706,NaN,NaN,NaN,NaN,NaN,511.9032999999998,514.1658893221287,509.6407106778708,511.63986360185424,511.5943881636552,512.8834040484242,510.30537227888624,33648,11637.033333333333,44.88212349493705,50.33879051720061,NaN,NaN,NaN,NaN,0.637946425292426,11.565115486745956,12987631,-0.14266124896205912,-0.008099556800175378,0.13456169216188374
2025-09-15T13:10:00-04:00,512.06,512.44,511.81,512.25,511.11742613268706,NaN,NaN,NaN,NaN,NaN,511.9328999999998,514.1740319373579,509.6917680626417,511.63986360185424,511.59975367840735,512.8838975237632,510.31560983305155,6644,11225.266666666666,47.9349773246195,49.86787557896917,NaN,NaN,NaN,NaN,0.6373788234858279,11.879127144256776,12994275,-0.12371527461570135,-0.020082401107742953,0.1036328735079584
2025-09-15T13:15:00-04:00,512.29,512.62,512.21,512.28,511.11742613268706,NaN,NaN,NaN,NaN,NaN,511.96669999999983,514.1765575611636,509.7568424388361,511.63986360185424,511.605160998622,512.8864043703253,510.3239176269187,5010,10940.1,48.37488466794234,49.61484320699849,NaN,NaN,NaN,NaN,0.6211374789511236,11.693124262764266,12999285,-0.10438521702633052,-0.02684864777495477,0.07753656925137575
2025-09-15T13:20:00-04:00,512.28,512.35,511.79,511.84,511.11742613268706,NaN,NaN,NaN,NaN,NaN,511.9900999999998,514.1691020561495,509.81109794385014,511.63986360185424,511.6078836941048,512.8850366739429,510.3307307142668,5041,10714.066666666668,42.67918162780601,49.164240687897816,NaN,NaN,NaN,NaN,0.6167705161689006,12.34050100606565,12994244,-0.11558412403100862,-0.06694358578738502,0.0486405382436236
2025-09-15T13:25:00-04:00,511.89,512.17,511.81,511.97,511.11742613268706,NaN,NaN,NaN,NaN,NaN,512.0154999999999,514.1631389362639,509.8678610637359,511.6031127051867,511.61104458790294,512.8832726235152,510.3388165522907,6102,10476.933333333332,44.74904897110515,48.75044105224663,NaN,NaN,NaN,NaN,0.598429765013976,12.941636553416934,13000346,-0.10869142141347574,-0.08722373852322107,0.02146768289025466
2025-09-15T13:30:00-04:00,511.96,511.98,511.4,511.73,511.11742613268706,NaN,NaN,NaN,NaN,NaN,512.0324999999998,514.1572515150732,509.9077484849264,511.6031127051867,511.61205622708064,512.8773286644004,510.34678378976093,8033,10035.733333333334,41.751574061492654,48.05431414475489,NaN,NaN,NaN,NaN,0.5971133532272663,14.209173992271772,12992313,-0.11418538111537992,-0.12126404350397024,-0.007078662388590323
2025-09-15T13:35:00-04:00,511.66,511.86,511.56,511.7,511.11742613268706,NaN,NaN,NaN,NaN,NaN,512.0686999999999,514.1060873564398,510.03131264356,511.4564901641494,511.61236634676925,512.8755749651214,510.34915772841714,2410,9456.7,41.378460723937465,47.478425723239596,NaN,NaN,NaN,NaN,0.575890970853891,15.38617304263698,12989903,-0.11349309736116578,-0.14894503409004756,-0.03545193672888178
2025-09-15T13:40:00-04:00,511.72,511.93,511.66,511.86,511.11742613268706,NaN,NaN,NaN,NaN,NaN,512.1202999999998,513.996901620118,510.24369837988166,511.34917789698846,511.6133535506388,512.8735861199311,510.3531209813465,3570,8896.933333333332,44.24046623455405,46.77763142870433,NaN,NaN,NaN,NaN,0.5540416157928975,16.253073049147698,12993473,-0.09657565686287158,-0.15617150780747124,-0.05959585094459967
2025-09-15T13:45:00-04:00,511.88,512.2,511.77,512.2,511.11742613268706,NaN,NaN,NaN,NaN,NaN,512.1736999999999,513.8982182632823,510.4491817367176,511.34917789698846,511.6154651854086,512.8730632027031,510.3578671681141,3536,8746.366666666667,49.84420619478648,46.469447780759154,NaN,NaN,NaN,NaN,0.5451815003791236,16.22562558277718,12997009,-0.058668147692120226,-0.13293103555974994,-0.07426288786762972
2025-09-15T13:50:00-04:00,512.25,512.25,511.88,512.17,511.11742613268706,NaN,NaN,NaN,NaN,NaN,512.2183,513.8204405805699,510.6161594194302,511.34917789698846,511.61860706445185,512.8727242664652,510.3644898624385,4845,8131.266666666666,49.37271576977821,46.00867411061818,NaN,NaN,NaN,NaN,0.5326685360663294,16.051998952472786,12992164,-0.03307046342920576,-0.11560096715413692,-0.08253050372493116
2025-09-15T13:55:00-04:00,512.22,512.76,512.22,512.7,511.11742613268706,NaN,NaN,NaN,NaN,NaN,512.2588,513.8042171734992,510.7133828265007,511.63469805480196,511.6248299583819,512.8771209260334,510.3725389907304,4972,7628.633333333333,57.094391468632324,46.23017043285703,NaN,NaN,NaN,NaN,0.5367636406330224,15.25562359558811,12997136,0.019283054168697925,-0.05842668601405876,-0.07770974018275668
2025-09-15T14:00:00-04:00,512.68,512.94,512.4,512.88,511.11742613268706,NaN,NaN,NaN,NaN,NaN,512.2995999999999,513.8000957047932,510.7991042952067,511.7697584438416,511.63284337135224,512.8841769523021,510.38150979040233,5444,7565.766666666666,59.36136948910749,47.1305815628239,NaN,NaN,NaN,NaN,0.5369948091592406,14.915414980538646,13002580,0.06328201953448503,0.001392784235349609,-0.061889235299135426
2025-09-15T14:05:00-04:00,512.87,513.29,512.74,513.28,511.21461414627584,NaN,NaN,NaN,NaN,NaN,512.361,513.7624235618929,510.9595764381071,512.0788067550732,511.6439371272519,512.8970184681988,510.390855786305,5759,7505.933333333333,63.92314662742976,48.62161550122404,NaN,NaN,NaN,NaN,0.5379237513621488,15.300214724774651,13008339,0.1136336684633092,0.08015285028000108,-0.03348081818330813
2025-09-15T14:10:00-04:00,513.27,513.27,513,513.17,511.37826804871787,NaN,NaN,NaN,NaN,NaN,512.386,513.7996081493832,510.9723918506168,512.1610454040587,511.65291106515883,512.9075985900515,510.39822354026614,4586,7154.466666666666,61.866462202147225,49.81807206130542,NaN,NaN,NaN,NaN,0.5195006262648505,15.6575287729938,13003753,0.13252153707526407,0.13217110316077196,-0.0003504339144921112
2025-09-15T14:15:00-04:00,513.18,513.28,513,513.18,511.42493768286704,NaN,NaN,NaN,NaN,NaN,512.4146,513.8334345076923,510.9957654923075,512.2528363232469,511.6592845485444,512.9151014265328,510.403467670556,3276,7003.166666666667,61.98620316931488,51.0397920380467,NaN,NaN,NaN,NaN,0.502393438674502,16.009919549919847,13007029,0.1380544607247438,0.17221764199143763,0.034163181266693834
2025-09-15T14:20:00-04:00,513.14,513.22,512.96,513.06,511.42493768286704,NaN,NaN,NaN,NaN,NaN,512.435,513.8610168302253,511.00898316977464,512.2682690585975,511.6683105135786,512.9252108873623,510.41141013979495,4931,6877.9,59.56895321218074,51.87079031572965,NaN,NaN,NaN,NaN,0.4850796216263227,16.204934632663473,13002098,0.12631576826175728,0.19205789159389042,0.06574212333213315
2025-09-15T14:25:00-04:00,513.07,513.33,512.975,513.18,511.5075568556702,NaN,NaN,NaN,NaN,NaN,512.4725999999999,513.8758864853571,511.0693135146427,512.391115246878,511.6785071101266,512.9371313218114,510.41988289844176,5336,6762.266666666666,61.198474396293115,52.78676101061185,NaN,NaN,NaN,NaN,0.47578822008158667,16.63838037080156,13007434,0.1193952632118531,0.21498620234694954,0.09559093913509643
2025-09-15T14:30:00-04:00,513.2,513.55,513.2,513.39,511.7543724531397,NaN,NaN,NaN,NaN,NaN,512.5274,513.8535903936563,511.2012096063436,512.6138921975023,511.69155034487653,512.9540930787182,510.4290076110349,6037,6734.366666666667,63.93766117417145,54.305223835352244,NaN,NaN,NaN,NaN,0.46823191864718794,17.51625991952466,13013471,0.12132895278641342,0.2472521301181132,0.12592317733169978
2025-09-15T14:35:00-04:00,513.4,513.53,513.33,513.48,511.85576461436074,NaN,NaN,NaN,NaN,NaN,512.5838,513.824637717013,511.342962282987,512.681113758002,511.6988299646268,512.9637909593142,510.43386896993934,3280,6664.4,65.07557660753015,55.75711866652542,NaN,NaN,NaN,NaN,0.44907249588666964,18.331433786196108,13016751,0.12077625993082391,0.2768935022452297,0.15611724231440577
2025-09-15T14:40:00-04:00,513.44,513.53,512.59,512.62,511.85576461436074,NaN,NaN,NaN,NaN,NaN,512.6218,513.7425618122285,511.50103818777154,512.681113758002,511.7115242110162,512.975904501953,510.4471439200794,8353,6568.633333333333,49.124365094913955,56.28374659748409,NaN,NaN,NaN,NaN,0.48413874618047475,17.261631115298215,13008398,0.05779206965625233,0.2283573293847212,0.17056525972846887
2025-09-15T14:45:00-04:00,512.64,513.02,512.64,513.01,511.85576461436074,NaN,NaN,NaN,NaN,NaN,512.6534,513.7260312319545,511.5807687680456,512.681113758002,511.71731017402465,512.9812697187236,510.45335062932566,3943,6464.966666666666,54.56351708507348,57.22553633756523,NaN,NaN,NaN,NaN,0.47812883573901066,16.26824292089303,13012341,0.03861912158439007,0.21883916170895645,0.18022004012456638
2025-09-15T14:50:00-04:00,513.04,513.25,512.95,513.18,511.85576461436074,NaN,NaN,NaN,NaN,NaN,512.6750000000001,513.7456801574858,511.6043198425143,512.681113758002,511.7280725554934,512.993159944365,510.4629851666218,6180,6490.233333333334,56.73486022789464,58.11799305137527,NaN,NaN,NaN,NaN,0.46540534747193524,15.477805700337472,13018521,0.033783382150364194,0.2224492678125216,0.18866588566215742
2025-09-15T14:55:00-04:00,513.23,513.31,513.1,513.245,511.85576461436074,NaN,NaN,NaN,NaN,NaN,512.6985000000001,513.766609076564,511.63039092343615,512.681113758002,511.7391397668126,513.0059985443311,510.4722809892942,6055,6464,57.56978643126224,58.66982021112354,NaN,NaN,NaN,NaN,0.4471621083667915,14.89773318867226,13024576,0.03140957092186042,0.22792784931448296,0.19651827839262254
2025-09-15T15:00:00-04:00,513.26,513.42,513.21,513.22,511.85576461436074,NaN,NaN,NaN,NaN,NaN,512.7219000000001,513.7833987325953,511.6604012674049,512.681113758002,511.7472315631122,513.0156758522936,510.47878727393083,4295,6398.9,57.11326798923448,59.222716798227566,NaN,NaN,NaN,NaN,0.430221957769158,14.643297698122485,13020281,0.024888109195155605,0.22762841488656704,0.20274030569141144
2025-09-15T15:05:00-04:00,513.19,513.4,513.08,513.34,511.85576461436074,NaN,NaN,NaN,NaN,NaN,512.7393000000001,513.8121727974988,511.6664272025013,512.681113758002,511.7547703338864,513.0245935408271,510.4849471269457,4069,6282.033333333334,58.80201877543671,59.344690177285024,NaN,NaN,NaN,NaN,0.42234896078564216,13.994870258575295,13024350,0.025305682507810984,0.23437240882617516,0.20906672631836418
2025-09-15T15:10:00-04:00,513.35,513.66,513.29,513.29,512.0210421488595,NaN,NaN,NaN,NaN,NaN,512.7421,513.8199647222856,511.6642352777145,512.7978319719822,511.7648946762359,513.037410873681,510.4923784787908,5059,6234.4,57.781075361086664,59.23181202528354,NaN,NaN,NaN,NaN,0.41860974930095374,14.070125811327342,13019291,0.019143939050369874,0.23299665013132653,0.21385271108095666
2025-09-15T15:15:00-04:00,513.32,513.37,513.07,513.37,512.0210421488595,NaN,NaN,NaN,NaN,NaN,512.7401000000001,513.8129140375938,511.6672859624064,512.7978319719822,511.78505028108754,513.0608021082403,510.5092984539348,11249,6522.866666666667,59.00743869247897,58.88069002992991,NaN,NaN,NaN,NaN,0.41013762435088236,13.45106726986129,13030540,0.01743407946446801,0.2356453104115417,0.21821123094707368
2025-09-15T15:20:00-04:00,513.41,513.51,513.19,513.44,512.0210421488595,NaN,NaN,NaN,NaN,NaN,512.7403,513.8136320268677,511.6669679731324,512.7978319719822,511.7955602603962,513.0736331852543,510.51748733553814,5572,6461.1,60.09958822300286,58.75448474570531,NaN,NaN,NaN,NaN,0.4036992226115291,13.243344162264428,13036112,0.01792629567508147,0.2406191005409255,0.22269280486584403
2025-09-15T15:25:00-04:00,513.46,513.84,513.41,513.76,512.2228696788682,NaN,NaN,NaN,NaN,NaN,512.7549,513.8628972742731,511.646902725727,512.9595699696549,511.8115298859079,513.0957544881218,510.527305283694,7266,6357.533333333334,64.72622692951346,58.95020072857664,NaN,NaN,NaN,NaN,0.405577849567853,13.824923736726246,13043378,0.03568648584702,0.26730091217461904,0.23161442632759904
2025-09-15T15:30:00-04:00,513.75,514.21,513.62,514.18,512.4961483298287,NaN,NaN,NaN,NaN,NaN,512.7939000000001,513.9609497673587,511.6268502326416,513.210655975724,511.8778840553179,513.1971022870893,510.55866582354656,26625,7037.533333333334,69.69340127046128,59.67337558988239,NaN,NaN,NaN,NaN,0.4187508603130086,15.081841328301806,13070003,0.0696393187073315,0.31866357471176343,0.24902425600443193
2025-09-15T15:35:00-04:00,514.18,514.36,514.08,514.17,512.827459769382,NaN,NaN,NaN,NaN,NaN,512.8277,514.0528713511263,511.6025286488738,513.4205247805792,511.9174789782439,513.259571609924,510.57538634656373,15234,6423.733333333334,69.4426637934127,60.262246261105226,NaN,NaN,NaN,NaN,0.4088400845763632,16.50759061415983,13054769,0.08436120516270218,0.35447576245780965,0.27011455729510747
2025-09-15T15:40:00-04:00,514.19,514.37,514.13,514.17,512.8880297798646,NaN,NaN,NaN,NaN,NaN,512.8449,514.1198093926475,511.56999060735257,513.4984198244633,511.96052928132957,513.3261787204849,510.59487984217424,17022,6769.666666666667,69.4426637934127,60.65546073390817,NaN,NaN,NaN,NaN,0.39678007853519504,17.849021000986625,13054769,0.08670366174917055,0.37849413448157065,0.2917904727324001
2025-09-15T15:45:00-04:00,514.16,514.56,514.06,514.47,512.9417556989616,NaN,NaN,NaN,NaN,NaN,512.8583,514.1860704770232,511.53052952297674,513.6127358595706,512.0262285514636,513.4289224897761,510.62353461315115,25630,7457,72.84215219092376,61.210216132721996,NaN,NaN,NaN,NaN,0.4041529300683954,19.426159294409707,13080399,0.10011182004007074,0.41693024778248855,0.3168184277424178
2025-09-15T15:50:00-04:00,514.43,514.5,513.86,514.28,512.9417556989616,NaN,NaN,NaN,NaN,NaN,512.8829000000001,514.2682924930377,511.4975075069624,513.6127358595706,512.0884212656574,513.5180208219381,510.65882170937675,27435,8203.466666666667,67.70485255464382,62.53739380841699,NaN,NaN,NaN,NaN,0.42099914934922333,20.139111047160014,13052964,0.08825403760838613,0.42713597475290044,0.3388819371445143
2025-09-15T15:55:00-04:00,514.25,515.47,513.6,515.39,512.9500088083515,NaN,NaN,NaN,NaN,NaN,512.9273000000001,514.4789690496802,511.3756309503199,513.6727509501252,512.3346822876047,513.9067956375021,510.7625689377072,95598,11186.666666666666,77.63055732127174,64.18503953957399,NaN,NaN,NaN,NaN,0.5244992101099933,22.22300380506625,13148562,0.14394347172290578,0.5188112767981465,0.37486780507524076
2025-09-16T09:30:00-04:00,516.545,517.19,514.9,515.4,514.2197811352446,NaN,NaN,NaN,NaN,NaN,512.9751,514.6742556609433,511.2759443390566,514.6072007601002,515.83,515.83,515.83,66925,13149.733333333334,77.69706133790963,65.68233961886078,NaN,NaN,NaN,NaN,0.6506064093878565,25.425234891003868,13215487,0.16852335391442885,0.5855219974682768,0.41699864355384797
2025-09-16T09:35:00-04:00,515.33,516.39,513.74,514.18,NaN,NaN,NaN,517.1686180072667,517.1686180072667,517.1686180072667,512.9959000000001,514.727767997151,511.26403200284926,514.6072007601002,515.4311909555233,515.9446974628864,514.9176844481602,40367,14414.966666666667,55.872868346397226,65.56113118422756,NaN,NaN,NaN,NaN,0.7934202372887222,25.980206509157355,13175120,0.09343602830402203,0.5337936789338755,0.4403576506298535
2025-09-16T09:40:00-04:00,514.11,514.25,512.5,513.11,NaN,NaN,NaN,515.6216353705727,NaN,NaN,513.0011000000001,514.7327457950505,511.26945420494957,514.6072007601002,514.785138174319,515.8586103456171,513.7116660030208,46258,15837.9,44.15769698334049,64.63573325523514,NaN,NaN,NaN,NaN,0.8617473631966706,24.695629338278017,13128862,-0.03082488063356892,0.40182654983789234,0.43265143047146126
2025-09-16T09:45:00-04:00,513.06,513.37,511.8,513.05,NaN,NaN,NaN,514.9436064900921,NaN,NaN,513.0101,514.7379871374953,511.2822128625046,514.6072007601002,514.358290896036,515.6242279033228,513.0923538887492,40501,17070.066666666666,43.60556644731513,63.55027237465504,NaN,NaN,NaN,NaN,0.9123368372540508,23.156208182732392,13088361,-0.1148667801781203,0.2890679552488109,0.4039347354269312
2025-09-16T09:50:00-04:00,513.08,513.31,512.06,512.42,NaN,NaN,NaN,514.9436064900921,NaN,NaN,513.0123,514.7368929490832,511.28770705091677,514.6072007601002,514.1406538725588,515.459985175249,512.8213225698686,27353,17820.333333333332,38.20401691458168,62.151911057047535,NaN,NaN,NaN,NaN,0.9364556345930471,21.726745681154313,13061008,-0.20540883230890034,0.1471736950408058,0.35258252734970613
2025-09-16T09:55:00-04:00,512.47,513.06,511.07,511.3,NaN,NaN,NaN,514.6481311201045,NaN,NaN,512.9891,514.7729785720494,511.2052214279507,514.6072007601002,513.8113267684622,515.2788996735535,512.3437538633709,36433,18869.033333333333,30.88045608634617,60.14284087089519,NaN,NaN,NaN,NaN,1.0117088035506832,21.400521528236474,13024575,-0.32608117715728546,-0.05501894409690067,0.2710622330603848
2025-09-16T10:00:00-04:00,511.26,511.82,510.56,511.29,NaN,NaN,NaN,513.8275342510088,NaN,NaN,512.9639,514.8065104200829,511.12128957991706,514.6072007601002,513.4517091839291,515.0813882226593,511.82203014519894,41610,20074.566666666666,30.823640974939437,58.0517017817478,NaN,NaN,NaN,NaN,1.029443889011348,21.537332605108443,12982965,-0.38773195024201135,-0.2136027047421294,0.17412924549988196
2025-09-16T10:05:00-04:00,511.27,512.2,511.19,511.92,NaN,NaN,NaN,513.8275342510088,NaN,NaN,512.9549,514.8133536474945,511.09644635250544,514.6072007601002,513.3567021554807,514.9865981506606,511.7268061603007,17930,20480.266666666666,38.5003964217189,56.17842817404819,NaN,NaN,NaN,NaN,1.0280550397962551,21.168681904047304,13000895,-0.36743028579693193,-0.285158611746283,0.08227167405064896
2025-09-16T10:10:00-04:00,511.96,512.92,511.91,512.91,NaN,NaN,NaN,513.8275342510088,NaN,NaN,512.9573000000001,514.815205497965,511.0993945020352,514.6072007601002,513.2884808212957,514.8605992822598,511.7163623603316,30561,21346.1,48.2240110302837,54.64490029974979,NaN,NaN,NaN,NaN,1.0267653940965178,19.970153436430156,13031456,-0.2730148610687396,-0.2589969022852756,0.01401795878346404
2025-09-16T10:15:00-04:00,512.93,513.66,512.88,513.47,NaN,NaN,NaN,513.8275342510088,NaN,NaN,512.9707000000001,514.8335322628423,511.1078677371579,514.6072007601002,513.2915006065896,514.8136049111089,511.7693963020703,23263,22012.333333333332,52.772698210912594,53.454188472428356,NaN,NaN,NaN,NaN,1.0091392945181932,18.993270527446057,13054719,-0.16391511914342366,-0.19087594014581555,-0.02696082100239188
2025-09-16T10:20:00-04:00,513.51,514,513.12,513.89,510.903493149928,510.903493149928,510.903493149928,NaN,NaN,NaN,512.9895,514.870006580581,511.108993419419,512.9987606080801,513.3192032674598,514.7878594686101,511.85054706630945,29314,22825.1,55.90183220158443,52.486986215869194,NaN,NaN,NaN,NaN,0.9999150591954648,18.40876151335213,13084033,-0.0598915976533919,-0.10182531806913175,-0.04193372041573985
2025-09-16T10:25:00-04:00,513.79,513.83,513,513.37,510.903493149928,NaN,NaN,NaN,NaN,NaN,513.0005,514.8833449218653,511.11765507813476,511.15171888171244,513.3225748563644,514.7603523372084,511.8847973755205,17441,23228.6,51.36419039991348,50.952846087939896,NaN,NaN,NaN,NaN,0.9920639835386449,17.72361495853121,13066592,-0.02435493659940126,-0.07237739116499142,-0.048022454565590164
2025-09-16T10:30:00-04:00,513.34,513.55,512.17,512.6,510.903493149928,NaN,NaN,NaN,NaN,NaN,513.0075,514.8817147688304,511.1332852311697,511.15171888171244,513.3044145413435,514.721629388531,511.8871996941559,14292,23503.766666666666,45.477480561654765,49.36517665986924,NaN,NaN,NaN,NaN,1.01977369900017,16.746333980145465,13052300,-0.04950630947708411,-0.1099053414119453,-0.060399031934861194
2025-09-16T10:35:00-04:00,512.62,512.84,512.1,512.32,510.903493149928,NaN,NaN,NaN,NaN,NaN,513.0157,514.8741574355776,511.1572425644226,511.15171888171244,513.2704608773354,514.6705557680394,511.8703659866313,17257,23969.666666666668,43.52406939524387,46.92899895086725,NaN,NaN,NaN,NaN,0.9997898633573014,15.911639127292943,13035043,-0.07999379960962408,-0.1603912814468913,-0.08039748183726722
2025-09-16T10:40:00-04:00,512.33,512.92,511.89,512.74,510.903493149928,NaN,NaN,NaN,NaN,NaN,513.0293,514.8694456571766,511.18915434282343,511.15171888171244,513.2468185148472,514.6310314701651,511.86260555952924,14555,24176.4,47.188462227837285,44.7498133001478,NaN,NaN,NaN,NaN,1.0019477302603492,15.361488901957298,13049598,-0.06737297332612065,-0.16461369849491803,-0.09724072516879738
2025-09-16T10:45:00-04:00,512.71,513.41,512.7,513.25,510.903493149928,NaN,NaN,NaN,NaN,NaN,513.0535000000001,514.8726737134274,511.2343262865728,511.15171888171244,513.2447197845165,514.6175265661077,511.87191300292534,7809,24305.266666666666,51.31897449742854,44.4245351680786,NaN,NaN,NaN,NaN,0.981094320956033,14.272477045764791,13057407,-0.022497147650601207,-0.1253621597320489,-0.10286501208144769
2025-09-16T10:50:00-04:00,513.22,513.82,513.12,513.7,510.903493149928,NaN,NaN,NaN,NaN,NaN,513.0825000000001,514.8957338512946,511.26926614870564,511.4918585945277,513.2570055616208,514.6029162629052,511.91109486033633,20014,24766.4,54.68663597531756,45.1766022389341,NaN,NaN,NaN,NaN,0.9610161551734624,13.723787509200431,13077421,0.036465237546141324,-0.05728346514877103,-0.09374870269491235
2025-09-16T10:55:00-04:00,513.76,513.96,513.255,513.3,510.9669923055635,NaN,NaN,NaN,NaN,NaN,513.1029,514.9024600461668,511.3033399538332,511.74498687562215,513.2619797682776,514.5947777092055,511.9291818273497,10068,24900.166666666668,51.2901132136401,45.725498436528746,NaN,NaN,NaN,NaN,0.9427292869467895,13.369647797036674,13067353,0.04683777378848125,-0.03520148545931079,-0.08203925924779204
2025-09-16T11:00:00-04:00,513.32,513.64,513.04,513.31,510.9669923055635,NaN,NaN,NaN,NaN,NaN,513.1323,514.8960451176205,511.3685548823795,511.74498687562215,513.2632279423365,514.5837723726032,511.9426835120697,9383,25069.766666666666,51.37142800071479,46.666027799823965,NaN,NaN,NaN,NaN,0.918248623593449,12.752718906509022,13076736,0.05226987796282781,-0.016701911794257285,-0.0689717897570851
2025-09-16T11:05:00-04:00,513.26,513.43,513,513.3,510.9669923055635,NaN,NaN,NaN,NaN,NaN,513.1589,514.8915687968929,511.42623120310714,511.74498687562215,513.262952872661,514.5743384351292,511.9515673101928,7169,25173.1,51.27923909400241,48.12308372894227,NaN,NaN,NaN,NaN,0.8833737219081991,12.12468654556552,13069567,0.052925168250794144,-0.002815329443592418,-0.05574049769438656
2025-09-16T11:10:00-04:00,513.24,513.48,512.93,512.955,510.9669923055635,NaN,NaN,NaN,NaN,NaN,513.1834000000001,514.8685485867265,511.4982514132737,511.74498687562215,513.2607614384917,514.5620541917501,511.95946868523333,8169,25276.766666666666,48.0739264304853,49.355246975766974,NaN,NaN,NaN,NaN,0.8595613132004755,11.439721298251875,13061398,0.02905254819424906,-0.019424812451575235,-0.048477360645824294
2025-09-16T11:15:00-04:00,512.94,512.94,512.45,512.82,510.9669923055635,NaN,NaN,NaN,NaN,NaN,513.2058000000001,514.8405004127286,511.57109958727153,511.74498687562215,513.2540945460248,514.5484173711686,511.959771720881,6786,25128,46.84012234323823,49.950941684446924,NaN,NaN,NaN,NaN,0.8342355051147269,11.11475616699045,13054612,0.004393244077054603,-0.04298580554950604,-0.04737904962656064
2025-09-16T11:20:00-04:00,512.8,513.1,512.49,512.51,510.9669923055635,NaN,NaN,NaN,NaN,NaN,513.2188000000001,514.8204885587174,511.6171114412828,511.74498687562215,513.2427463374537,514.5261481246206,511.9593445502868,11154,25314.066666666666,44.044727581539405,49.65242143810804,NaN,NaN,NaN,NaN,0.8182186833208187,10.569109516349242,13043458,-0.030644561159439344,-0.08568475107585982,-0.05504018991642048
2025-09-16T11:25:00-04:00,512.53,513.02,512.46,512.57,510.9669923055635,NaN,NaN,NaN,NaN,NaN,513.2262000000001,514.81233563086,511.64006436914013,511.74498687562215,513.2329035360514,514.5070889958569,511.9587180762459,9754,25397,44.73222543046897,49.07810195379064,NaN,NaN,NaN,NaN,0.7997744916550421,10.106624397022879,13053212,-0.046668289418555164,-0.11337555168961444,-0.06670726227105928
2025-09-16T11:30:00-04:00,512.555,512.715,512.3,512.64,510.9669923055635,NaN,NaN,NaN,NaN,NaN,513.2356000000001,514.8020349840805,511.66916501591976,511.74498687562215,513.2239417439838,514.4920960347534,511.95578745321416,7390,24755.833333333332,45.57242182295482,48.34028692674566,NaN,NaN,NaN,NaN,0.7722905993939733,9.920385449825039,13060602,-0.04918982916914834,-0.1281945487324947,-0.07900471956334636
2025-09-16T11:35:00-04:00,512.63,512.83,512.53,512.69,510.9669923055635,NaN,NaN,NaN,NaN,NaN,513.2354000000001,514.8021110005308,511.6686889994695,511.74498687562215,513.2192206438976,514.4828269264063,511.95561436138894,4949,24413,46.201544429198336,47.971526500266016,NaN,NaN,NaN,NaN,0.738555556580123,9.54208063117727,13065551,-0.044280515168552415,-0.13435536352403687,-0.09007484835548446
2025-09-16T11:40:00-04:00,512.69,512.72,512.14,512.46,510.9669923055635,NaN,NaN,NaN,NaN,NaN,513.2270000000001,514.8057007313969,511.6482992686033,511.74498687562215,513.2098633613033,514.4687242196428,511.9510025029638,6888,24075.2,43.699280681454105,47.84451222310883,NaN,NaN,NaN,NaN,0.7272301596815457,9.797034883473769,13058663,-0.05273906196642923,-0.155998675813521,-0.10325961384709177
2025-09-16T11:45:00-04:00,512.45,512.83,512.45,512.56,510.9669923055635,NaN,NaN,NaN,NaN,NaN,513.2126000000002,514.8022015095456,511.6229984904548,511.70691328031853,513.2053847309603,514.4605677428742,511.9502017190464,4339,23365.5,45.091704364102,47.956486149455834,NaN,NaN,NaN,NaN,0.7024280054185779,9.82114041114125,13063002,-0.047952881883857434,-0.16320071620191356,-0.11524783431805613
2025-09-16T11:50:00-04:00,512.54,513.2,512.53,513.14,510.9669923055635,NaN,NaN,NaN,NaN,NaN,513.2120000000001,514.801688019527,511.6223119804732,511.8434760031717,513.2028143570899,514.4517480063323,511.9538807078475,6035,22652.166666666668,52.438906169261564,48.33151785955757,NaN,NaN,NaN,NaN,0.7001117193172561,9.15881885458568,13069037,-0.004374290104202622,-0.12071569694830941,-0.11634140684410679
2025-09-16T11:55:00-04:00,513.1,513.215,512.91,512.98,510.9669923055635,NaN,NaN,NaN,NaN,NaN,513.2080000000002,514.7989959141913,511.61700408580907,511.97728080253734,513.2014072247081,514.4451877981867,511.9576266512295,4938,19630.166666666668,50.434044222563344,48.268308554210066,NaN,NaN,NaN,NaN,0.6718894536517424,8.51661759271213,13064099,0.014019070668774461,-0.09881756850813872,-0.11283663917691318
2025-09-16T12:00:00-04:00,512.95,513.11,512.68,512.74,510.9669923055635,NaN,NaN,NaN,NaN,NaN,513.2016000000002,514.7974927780441,511.6057072219563,511.97728080253734,513.1974749570629,514.4349700400801,511.95997987404576,6539,17617.3,47.50042154010898,47.75500752312373,NaN,NaN,NaN,NaN,0.6546116355337653,8.339819613775745,13057560,0.010525240797364666,-0.09968008818020735,-0.11020532897757201
2025-09-16T12:05:00-04:00,512.72,513.3,512.6,513.24,510.9669923055635,NaN,NaN,NaN,NaN,NaN,513.2028000000001,514.7987162381562,511.606883761844,511.9858597136238,513.1962271212657,514.4286675723005,511.9637866702309,4968,16437.333333333332,53.560909731781535,47.917207274419546,NaN,NaN,NaN,NaN,0.6578536615670629,7.798924490727252,13062528,0.04069717826266772,-0.05933385614923736,-0.10003103441190508
2025-09-16T12:10:00-04:00,513.23,513.72,513.23,513.42,511.4066908666218,NaN,NaN,NaN,NaN,NaN,513.2034000000002,514.7996198341124,511.60718016588805,512.4236877708992,513.1997377848539,514.4242119230893,511.9752636466186,8204,15168.866666666667,55.55024660741976,48.21569431775561,NaN,NaN,NaN,NaN,0.6458641143122733,7.949046246431162,13070732,0.06987409413866832,-0.012688416738569686,-0.08256251087723801
2025-09-16T12:15:00-04:00,513.44,513.57,513.23,513.31,511.4066908666218,NaN,NaN,NaN,NaN,NaN,513.2000000000002,514.7945720426198,511.6054279573805,512.4236877708992,513.2018417795708,514.4188721179902,511.98481144115146,7615,14072.666666666666,54.027101902550285,48.41197023265189,NaN,NaN,NaN,NaN,0.6240166775756846,8.08844501958479,13063117,0.07823146791463345,0.015226824016053797,-0.06300464389857965
2025-09-16T12:20:00-04:00,513.36,513.59,513.3,513.38,511.47664395078544,NaN,NaN,NaN,NaN,NaN,513.2152000000001,514.8018366437366,511.6285633562636,512.4793601733754,513.2029169795518,514.4170873699965,511.9887465891071,3006,13261.1,54.87503596317462,48.89776377070113,NaN,NaN,NaN,NaN,0.6001583434631412,8.255295389630836,13066123,0.08441032284790675,0.04250825966130378,-0.041902063186602966
2025-09-16T12:25:00-04:00,513.32,513.38,513,513.3,511.47664395078544,NaN,NaN,NaN,NaN,NaN,513.2210000000001,514.8067137191999,511.6352862808003,512.4793601733754,513.2031161505524,514.4121865887797,511.99404571232515,5237,12221.233333333334,53.65699148503378,49.3846829951151,NaN,NaN,NaN,NaN,0.5844327475014879,7.73318769352584,13060886,0.0791347808168027,0.0570164128344004,-0.02211836798240229
2025-09-16T12:30:00-04:00,513.24,513.28,513.045,513.16,511.47664395078544,NaN,NaN,NaN,NaN,NaN,513.2206000000001,514.806364976056,511.63483502394416,512.4793601733754,513.2028012226099,514.4072750983587,511.99832734686106,4781,10993.6,51.50252575946815,49.91738286496716,NaN,NaN,NaN,NaN,0.560901836965667,7.248373404285487,13056105,0.06294697330591931,0.05656534864999685,-0.006381624655922461
2025-09-16T12:35:00-04:00,513.15,513.38,513.025,513.3,511.47664395078544,NaN,NaN,NaN,NaN,NaN,513.2217000000002,514.8076074496521,511.63579255034824,512.4793601733754,513.2030537948905,514.4027976913986,512.0033098983823,4975,10561.766666666666,53.512693673161074,50.54455916801658,NaN,NaN,NaN,NaN,0.5461945628966921,7.0254330486079235,13061080,0.05849363780073964,0.06673542259500209,0.00824178479426245
2025-09-16T12:40:00-04:00,513.33,513.34,512.82,513,511.47664395078544,NaN,NaN,NaN,NaN,NaN,513.2173000000001,514.8044221878316,511.63017781216865,512.4793601733754,513.2014879896444,514.3950390066748,512.0079369726141,6703,9766.5,48.84098716549265,50.778028121055,NaN,NaN,NaN,NaN,0.5443235226897842,6.721276185663308,13054377,0.03341560230780015,0.05001128767901264,0.01659568537121249
2025-09-16T12:45:00-04:00,512.98,513,512.64,512.89,511.47664395078544,NaN,NaN,NaN,NaN,NaN,513.2083000000001,514.7976389944903,511.61896100550996,512.4793601733754,513.1982776506426,514.3869468071799,512.0096084941052,5797,9184.3,47.21341495339461,50.850304587069026,NaN,NaN,NaN,NaN,0.5311575567833721,6.848057830927699,13048580,0.008774231697818179,0.027563474993485215,0.018789243295667037
2025-09-16T12:50:00-04:00,512.84,513,512.665,512.77,511.47664395078544,NaN,NaN,NaN,NaN,NaN,513.1979000000001,514.7917633439167,511.6040366560835,512.4793601733754,513.1940753123486,514.376946069288,512.0112045554091,7107,8444.066666666668,45.4346590642557,50.974260185840556,NaN,NaN,NaN,NaN,0.5171463027274196,6.965783644387491,13041473,-0.014959879344822662,0.00008939411463870783,0.01504927345946137
2025-09-16T12:55:00-04:00,512.75,513.81,512.74,513.4,511.47664395078544,NaN,NaN,NaN,NaN,NaN,513.1985000000002,514.7926445978135,511.60435540218685,512.4954713866314,513.1959151088407,514.3699709280793,512.0218592896022,9962,8194.766666666666,55.01648562765742,51.68317313323738,NaN,NaN,NaN,NaN,0.5566358525325994,7.683954267990092,13051435,0.011016188106708048,0.028819508592846432,0.017803320486138384
2025-09-16T13:00:00-04:00,513.38,513.83,513.38,513.8,511.8024105922139,NaN,NaN,NaN,NaN,NaN,513.2057000000002,514.80737663374,511.6040233662605,512.5533771093052,513.2015369561282,514.3697386129986,512.0333352992577,7966,7983.9,59.83866834595156,52.21172757442952,NaN,NaN,NaN,NaN,0.5490190059231312,8.387662893995007,13059401,0.05208475321394375,0.08290926200356807,0.03082450878962432
2025-09-16T13:05:00-04:00,513.76,513.9,513.63,513.68,512.0075282925678,NaN,NaN,NaN,NaN,NaN,513.2041000000003,514.8037170663098,511.6044829336907,512.7437016874441,513.2083834481314,514.37064502815,512.0461218681128,8706,7698.866666666667,57.83561918723456,52.740411500477464,NaN,NaN,NaN,NaN,0.5290890769286206,9.175928556569389,13050695,0.06715622454244988,0.11476978946768668,0.047613564925236794
2025-09-16T13:10:00-04:00,513.74,513.9,513.585,513.9,512.0219588247239,NaN,NaN,NaN,NaN,NaN,513.1985000000002,514.7863290206819,511.61067097931846,512.8174613499554,513.2139229157145,514.3720743019231,512.0557715295059,6487,7429.933333333333,60.449511309707596,53.665346484020226,NaN,NaN,NaN,NaN,0.5137970000051435,9.774826895848628,13057182,0.08668809278439558,0.15597368090573127,0.06928558812133569
2025-09-16T13:15:00-04:00,513.915,514.2,513.77,513.8,512.2840288781455,NaN,NaN,NaN,NaN,NaN,513.1911000000003,514.7641292934975,511.6180707065032,513.1189690799642,513.2287447448775,514.3792165604292,512.0782729293259,14659,7658.266666666666,58.66912778344033,54.030219201995855,NaN,NaN,NaN,NaN,0.5078115000047807,10.92400005632002,13042523,0.087372526471003,0.17850124621008945,0.09112871973908644
2025-09-16T13:20:00-04:00,513.81,514.12,513.74,514.03,512.2840288781455,NaN,NaN,NaN,NaN,NaN,513.1883000000003,514.7548345316311,511.6217654683694,513.1189690799642,513.2377951388646,514.3840258135542,512.091564464175,8752,7282.866666666667,61.479266994771834,54.45372065823529,NaN,NaN,NaN,NaN,0.49868210714729605,11.89462725512933,13051275,0.09706856356745205,0.2124644241984015,0.11539586063094945
2025-09-16T13:25:00-04:00,514.04,514.07,513.54,513.54,512.2840288781455,NaN,NaN,NaN,NaN,NaN,513.1697000000003,514.6965011130739,511.6428988869266,513.1189690799642,513.2463465461979,514.3840656628045,512.1086274295913,12916,7377.8,53.18306108615736,54.39343202849294,NaN,NaN,NaN,NaN,0.500919099493924,12.15980809949919,13038359,0.06573465997075062,0.1975641855943877,0.1318295256236371
2025-09-16T13:30:00-04:00,513.56,513.84,513.4,513.81,512.2840288781455,NaN,NaN,NaN,NaN,NaN,513.1603000000002,514.6652736339327,511.6553263660678,513.1189690799642,513.2522223654413,514.383386840862,512.1210578900206,9858,7393.633333333333,56.65403896201343,54.520503671267136,NaN,NaN,NaN,NaN,0.49656773524436193,11.983590031695332,13048217,0.05867816134759188,0.20517722730812693,0.14649906596053505
2025-09-16T13:35:00-04:00,513.82,513.89,513.32,513.32,512.2840288781455,NaN,NaN,NaN,NaN,NaN,513.1189000000003,514.4835996588308,511.75420034116974,513.1189690799642,513.256875766509,514.378309149312,512.1354423837059,13478,7603.933333333333,49.48386858777453,54.22242346432005,NaN,NaN,NaN,NaN,0.5018128970126172,11.580814235928028,13034739,0.018573019247973943,0.16971534002050248,0.15114232077252854
2025-09-16T13:40:00-04:00,513.27,513.28,513.06,513.08,512.2840288781455,NaN,NaN,NaN,NaN,NaN,513.0725000000003,514.2715166798312,511.8734833201695,513.1189690799642,513.2550509671094,514.3677896936829,512.1423122405358,11842,7726.366666666667,46.38718747786142,53.85704215849099,NaN,NaN,NaN,NaN,0.4845405472260092,11.033559021492854,13022897,-0.02423191021803736,0.12085243299998183,0.1450843432180192
2025-09-16T13:45:00-04:00,513.12,513.34,512.85,512.99,512.2840288781455,NaN,NaN,NaN,NaN,NaN,513.0487000000003,514.2053309865046,511.892069013496,513.1189690799642,513.2518098919674,514.3555466058189,512.1480731781159,12816,7927.366666666667,45.24376293656181,53.266404248733906,NaN,NaN,NaN,NaN,0.4849305081384378,11.056924291107428,13010081,-0.056857229969559664,0.07401280575606961,0.13087003572562927
2025-09-16T13:50:00-04:00,512.96,512.96,512.42,512.44,512.2840288781455,NaN,NaN,NaN,NaN,NaN,513.0353000000002,514.2042386805808,511.86636131941964,513.1189690799642,513.2389836650892,514.335398274727,512.1425690554514,15645,8077.066666666667,38.92861806177299,52.558377884182505,NaN,NaN,NaN,NaN,0.49100690041426726,12.002200712967612,12994436,-0.11061843061982649,-0.007403002549153825,0.10321542807067266
2025-09-16T13:55:00-04:00,512.45,512.76,512.285,512.33,512.2840288781455,NaN,NaN,NaN,NaN,NaN,513.0209000000002,514.2063816569856,511.83541834301485,513.1189690799642,513.2287644319644,514.3215871961218,512.135941667807,10438,8099.866666666667,37.79244555728166,51.885451498745866,NaN,NaN,NaN,NaN,0.4898635503846784,13.134135828812424,12983998,-0.1464770471140269,-0.07988088082186096,0.06659616629216594
2025-09-16T14:00:00-04:00,512.28,512.28,511.72,511.96,NaN,NaN,NaN,513.6173594143627,513.6173594143627,513.6173594143627,513.0117000000002,514.2225602062679,511.8008397937327,513.1189690799642,513.201169502832,514.2971820627696,512.1051569428945,18117,8457.433333333332,34.17894847847026,51.08147217118976,NaN,NaN,NaN,NaN,0.49844472535720236,15.086131821941379,12965881,-0.18549364453277345,-0.16527088937380086,0.02022275515897258
2025-09-16T14:05:00-04:00,511.94,512.45,511.89,512.2,NaN,NaN,NaN,513.6173594143627,NaN,NaN,513.0297000000003,514.1624849041524,511.8969150958482,513.0651752639714,513.1850173307506,514.2797667461294,512.0902679153718,13106,8729.333333333334,38.299946922093206,49.88743369222089,NaN,NaN,NaN,NaN,0.502841530688835,16.3608535680503,12978987,-0.1850927362399179,-0.2111431651409248,-0.0260504289010069
2025-09-16T14:10:00-04:00,512.18,512.31,511.62,511.71,NaN,NaN,NaN,513.6056518630866,NaN,NaN,513.0381000000002,514.1244349202557,511.95176507974475,512.9611402111772,513.1618808651634,514.2604648903639,512.063296839963,14955,8998.233333333334,33.665553347902545,48.01792547807453,NaN,NaN,NaN,NaN,0.5162099927824854,17.946881600278555,12964032,-0.2061717460869047,-0.2837651115096378,-0.07759336542273308
2025-09-16T14:15:00-04:00,511.69,511.69,511.42,511.56,NaN,NaN,NaN,513.1606222329464,NaN,NaN,513.0309000000002,514.151028010134,511.9107719898664,512.7329121689417,513.1333762056692,514.2426097627794,512.024142648559,15250,9361.933333333332,32.37411834417949,46.19924684642774,NaN,NaN,NaN,NaN,0.5000521361551623,19.69517107210185,12948782,-0.21744104314952548,-0.3493946693596399,-0.13195362621011444
2025-09-16T14:20:00-04:00,511.58,511.79,511.58,511.7,NaN,NaN,NaN,513.1606222329464,NaN,NaN,513.0067000000003,514.1869027109972,511.82649728900327,512.7193297351533,513.1149567493704,514.2289336055271,512.0009798932138,11101,9530.8,34.8847943542858,44.373195635326184,NaN,NaN,NaN,NaN,0.4807626978583663,20.985863332731007,12959883,-0.20296833248277557,-0.38566404181358394,-0.18269570933080836
2025-09-16T14:25:00-04:00,511.74,511.82,511.36,511.45,NaN,NaN,NaN,513.1456392659697,NaN,NaN,512.9663000000002,514.2165172768339,511.7160827231664,512.2417710304982,513.0914701724705,514.2134149173365,511.9695254276045,13197,9806.1,32.56012868642351,42.50826712839641,NaN,NaN,NaN,NaN,0.47927964801133865,22.50405311917205,12946686,-0.19754599648776416,-0.42962820494051357,-0.2320822084527494
2025-09-16T14:30:00-04:00,511.45,511.8,511.41,511.65,NaN,NaN,NaN,513.1431102084256,NaN,NaN,512.9215000000002,514.1963996036228,511.64660039637744,512.2417710304982,513.0700694121292,514.1976710488277,511.9424677754307,13033,10022.566666666668,36.22173545730129,40.704157732862804,NaN,NaN,NaN,NaN,0.4729025302962421,23.91380077801016,12959719,-0.16891231181163208,-0.4432225982172895,-0.2743102864056574
2025-09-16T14:35:00-04:00,511.65,511.88,511.35,511.39,NaN,NaN,NaN,513.1431102084256,NaN,NaN,512.8819000000002,514.2200493037292,511.5437506962712,511.7964168243985,513.0508158547841,514.1842064991467,511.91742521042147,11420,10237.633333333333,33.662942862408016,39.30986357402356,NaN,NaN,NaN,NaN,0.47698092098936573,24.923779141329646,12948299,-0.15620236855641623,-0.4695632471011777,-0.31336087854476147
2025-09-16T14:40:00-04:00,511.39,511.589,511.29,511.44,NaN,NaN,NaN,512.9507202518919,NaN,NaN,512.8587000000002,514.254572214416,511.4628277855844,511.59163345951873,513.0289832218849,514.1699766882441,511.8879897555257,12467,10379.733333333334,34.619466334647896,37.73596552921174,NaN,NaN,NaN,NaN,0.46426799806155233,25.964373323520213,12960766,-0.13399990157945058,-0.4808607555190747,-0.3468608539396241
2025-09-16T14:45:00-04:00,511.43,511.63,511.31,511.48,NaN,NaN,NaN,512.9507202518919,NaN,NaN,512.8419000000002,514.2827954017823,511.4010045982181,511.17824541409203,513.0021869712957,514.1512774117627,511.8530965308287,16125,10663.4,35.421699682417525,36.731524893114816,NaN,NaN,NaN,NaN,0.45396314105715524,26.76322113128398,12976891,-0.10734435839822837,-0.48104130193740957,-0.3736969435391812
2025-09-16T14:50:00-04:00,511.48,511.48,510.34,510.66,NaN,NaN,NaN,512.4840663865378,NaN,NaN,512.8003000000002,514.365318095408,511.23528190459245,511.17824541409203,512.9228608754931,514.1222547288259,511.72346702216043,35426,11744.066666666668,27.87159987224298,35.40898292128493,NaN,NaN,NaN,NaN,0.5029657738387902,28.850812757541895,12941465,-0.13393357231926084,-0.5411139089382573,-0.40718033661899644
2025-09-16T14:55:00-04:00,510.655,510.69,510.27,510.62,NaN,NaN,NaN,512.0397906416953,NaN,NaN,512.7477000000002,514.4217169769145,511.07368302308595,510.94759633127353,512.8556958953636,514.1025529801794,511.6088388105478,28018,12503.433333333332,27.56296847360626,34.146069031073814,NaN,NaN,NaN,NaN,0.4970396471360206,30.860860525726125,12913447,-0.14241867845820166,-0.5852036846917485,-0.4427850062335469
2025-09-16T15:00:00-04:00,510.59,510.7,510.24,510.31,NaN,NaN,NaN,512.0216183398,NaN,NaN,512.6799000000002,514.4650571245057,510.8947428754946,510.7470955658318,512.813859175121,514.0898984665682,511.5378198836738,17445,12925.566666666668,25.23111608103406,33.167676032449606,NaN,NaN,NaN,NaN,0.4943939580548748,32.75927797955985,12896002,-0.1560178455436264,-0.6378073131630799,-0.4817894676194535
2025-09-16T15:05:00-04:00,510.315,510.56,510.28,510.36,NaN,NaN,NaN,511.93927205162726,NaN,NaN,512.6211000000002,514.5112717274012,510.7309282725992,510.7470955658318,512.7496866245915,514.0671743330253,511.43219891615774,27776,13685.6,26.313929080993887,32.347781998429056,NaN,NaN,NaN,NaN,0.47908010390810013,34.52209418669116,12923778,-0.1487795609408038,-0.6677639187954583,-0.5189843578546545
2025-09-16T15:10:00-04:00,510.39,510.47,510.12,510.13,NaN,NaN,NaN,511.79294150382606,NaN,NaN,512.5575000000002,514.561258717729,510.5537412822716,510.7470955658318,512.6911846552507,514.0471755440705,511.33519376643096,24936,14293.366666666667,24.552478672237655,31.66017701226958,NaN,NaN,NaN,NaN,0.46986009648609456,36.34271356210338,12898842,-0.14639005530244265,-0.7019719269827078,-0.5555818716802652
2025-09-16T15:15:00-04:00,510.17,510.51,510,510.33,NaN,NaN,NaN,511.7543987081976,NaN,NaN,512.4981000000002,514.584669327564,510.41153067243647,510.7470955658318,512.6178433525818,514.0157859329867,511.21990077217686,33559,15218.766666666666,29.003006510249946,30.99610983999506,NaN,NaN,NaN,NaN,0.4727272324513728,38.16622095259228,12932401,-0.11938968422727692,-0.7048189769643614,-0.5854292927370844
2025-09-16T15:20:00-04:00,510.32,510.64,510.205,510.455,NaN,NaN,NaN,511.7543987081976,NaN,NaN,512.4481000000003,514.6070375995442,510.28916240045635,510.7470955658318,512.5644294357703,513.9857985038394,511.1430603677012,27653,15903.633333333333,31.714206814121155,30.856727944724962,NaN,NaN,NaN,NaN,0.47003243013341783,39.26403089678651,12960054,-0.08289331510169784,-0.6890459366142068,-0.6061526215125089
2025-09-16T15:25:00-04:00,510.47,510.67,510.25,510.37,NaN,NaN,NaN,511.7543987081976,NaN,NaN,512.3991000000002,514.6319955996876,510.1662044003129,510.6253411621323,512.5304601601991,513.965551927921,511.0953683924773,18290,16181.233333333334,30.85144531377894,30.74796558541064,NaN,NaN,NaN,NaN,0.4664586851238891,40.14483955073461,12941764,-0.05557101711212753,-0.6756163929026684,-0.6200453757905409
2025-09-16T15:30:00-04:00,510.39,510.53,510,510.32,NaN,NaN,NaN,511.75007855340135,NaN,NaN,512.3553000000002,514.662457913813,510.04814208618734,510.6253411621323,512.4675896829525,513.9301876873036,511.0049916786014,33079,17018.333333333332,30.328775354739832,30.42253565687164,NaN,NaN,NaN,NaN,0.4709973504721808,41.31489941307214,12908685,-0.03307085336541482,-0.6613839424973094,-0.6283130891318945
2025-09-16T15:35:00-04:00,510.36,510.38,509.6,509.72,NaN,NaN,NaN,511.51393861915585,NaN,NaN,512.2983000000003,514.7194316442635,509.87716835573707,510.1062729297059,512.3900521732282,513.8959289352318,510.88417541122465,36816,17955.333333333332,24.881343756078564,29.87405101898986,NaN,NaN,NaN,NaN,0.4930689682955945,42.86501508767223,12871869,-0.04979694564053616,-0.6905592711825648,-0.6407623255420286
2025-09-16T15:40:00-04:00,509.74,510.1,509.26,509.28,NaN,NaN,NaN,511.24921413646695,NaN,NaN,512.2311000000002,514.7929909342868,509.6692090657136,509.5573479127078,512.2786188756609,513.8544439510391,510.7027938002826,49727,19396.666666666668,21.790417945794886,28.84324262531083,NaN,NaN,NaN,NaN,0.5178497562744828,44.62203513081312,12822142,-0.0799081623329122,-0.7406475284581688,-0.6607393661252566
2025-09-16T15:45:00-04:00,509.3,509.6,509.09,509.56,NaN,NaN,NaN,510.9124316757185,NaN,NaN,512.1685000000002,514.8333724170311,509.5036275829694,509.5573479127078,512.1805688731998,513.814322350894,510.54681539550563,45013,20408.466666666667,27.92635992758059,28.43348670139459,NaN,NaN,NaN,NaN,0.5172890593977375,46.39487028420769,12867155,-0.07069959114714885,-0.7491138550591927,-0.6784142639120438
2025-09-16T15:50:00-04:00,509.57,510.24,508.91,508.96,NaN,NaN,NaN,510.9124316757185,NaN,NaN,512.0985000000002,514.9089634847526,509.28803651524777,509.5573479127078,512.0517661439023,513.7524270209606,510.3511052668441,63104,22220.2,23.64536090229575,27.649622027655145,NaN,NaN,NaN,NaN,0.5753398408693265,45.64746039092316,12804051,-0.09332727267846119,-0.7950733547601203,-0.7017460820816591
2025-09-16T15:55:00-04:00,508.97,509.95,508.62,509.15,NaN,NaN,NaN,510.9124316757185,NaN,NaN,512.0303000000002,514.9558005791948,509.10479942080565,509.5573479127078,511.7758954853085,513.5947026941409,509.95708827647616,149796,26782.866666666665,27.43871012158864,27.079408487595938,NaN,NaN,NaN,NaN,0.6292441379500878,45.3562203450338,12953847,-0.0840944540372871,-0.806864149628268,-0.7227696955909809
2025-09-17T09:30:00-04:00,510.61,510.83,508.93,509.02,NaN,NaN,NaN,510.9124316757185,NaN,NaN,511.94790000000023,514.9740910645174,508.921708935483,509.5573479127078,509.5933333333333,509.5933333333333,509.5933333333333,51559,28172.9,26.469737585377842,26.97927546710557,NaN,NaN,NaN,NaN,0.7200124138107942,42.82698676999775,12902288,-0.07560607488847126,-0.8172772892015701,-0.7416712143130988
2025-09-17T09:35:00-04:00,509.005,509.69,507.56,507.65,NaN,NaN,NaN,510.7870516431827,NaN,NaN,511.8413000000003,515.0824286982638,508.60017130173674,509.5573479127078,508.9708008745105,509.61701702852065,508.3245847205003,47849,29318.6,18.896382173655667,26.36023358853767,NaN,NaN,NaN,NaN,0.8207258128243086,42.231003924785284,12854439,-0.14699085244833598,-0.9254097798735188,-0.7784189274251828
2025-09-17T09:40:00-04:00,507.7,508.05,506.8,507.24,NaN,NaN,NaN,509.6592311139471,NaN,NaN,511.73130000000026,515.2077434755572,508.2548565244433,509.5573479127078,508.56790703342705,509.4613526254718,507.6744614413823,33249,30032.166666666668,17.30102305034211,25.793798372059676,NaN,NaN,NaN,NaN,0.8513882547654293,42.332704990634916,12821190,-0.20309649008470054,-1.0322895400310586,-0.829193049946358
2025-09-17T09:45:00-04:00,507.28,507.98,506.4,507.6,NaN,NaN,NaN,509.5381296996768,NaN,NaN,511.61850000000027,515.2541678889351,507.98283211106553,509.37487833016627,508.34616529420265,509.2851582198752,507.4071723685301,28853,30566.733333333334,23.415039678444515,25.586734843306147,NaN,NaN,NaN,NaN,0.9034319508536158,42.723005263060294,12850043,-0.1970818094653597,-1.0755453117780576,-0.8784635023126979
2025-09-17T09:50:00-04:00,507.67,507.91,506.36,506.53,NaN,NaN,NaN,509.5381296996768,NaN,NaN,511.4807000000003,515.3477298729971,507.6136701270035,509.06590266413303,508.1777719666603,509.17083463012426,507.18470930319637,21855,30773.733333333334,18.93436691299084,25.18544114621709,NaN,NaN,NaN,NaN,0.9496153829355013,43.114715027743685,12828188,-0.243256686280654,-1.1825343601635154,-0.9392776738828614
2025-09-17T09:55:00-04:00,506.54,506.73,505.94,506.5,NaN,NaN,NaN,508.7839983420609,NaN,NaN,511.34450000000027,515.4183926101041,507.27060738989644,508.62872213130646,507.97637466689895,509.06933850314584,506.88341083065205,23279,31201.766666666666,18.825594393747465,24.458483137895485,NaN,NaN,NaN,NaN,0.9382142841543956,43.780221955213605,12804909,-0.2527976017090805,-1.2552746760192122,-1.0024770743101317
2025-09-17T10:00:00-04:00,506.5,506.8,505.92,506.24,NaN,NaN,NaN,508.7839983420609,NaN,NaN,511.2017000000002,515.4758135266912,506.92758647330913,508.4293821640361,507.72111541836034,508.8907845152054,506.5514463215153,37647,31852.766666666666,17.867582352842874,23.469438533518463,NaN,NaN,NaN,NaN,0.9340561210005098,44.24108031873221,12767262,-0.2529787951136915,-1.318700568202246,-1.0657217730885544
2025-09-17T10:05:00-04:00,506.17,506.76,506.04,506.37,NaN,NaN,NaN,508.7839983420609,NaN,NaN,511.06310000000025,515.5023120425517,506.62388795744874,508.4293821640361,507.6169397270025,508.7954433946821,506.4384360593229,20742,32107.3,20.058122915392687,22.698486933633735,NaN,NaN,NaN,NaN,0.9187663980718999,44.669020227713766,12788004,-0.2218185188887336,-1.3429949216994714,-1.1211764028107378
2025-09-17T10:10:00-04:00,506.39,507.46,506.08,507.46,NaN,NaN,NaN,508.7839983420609,NaN,NaN,510.94910000000027,515.4592493055774,506.4389506944232,508.1892045849831,507.56791642787755,508.71087289899657,506.4249599567585,22878,32371.4,35.57369363175421,23.073123953420474,NaN,NaN,NaN,NaN,0.9517116553524781,43.52800733092822,12810882,-0.11087696331598673,-1.2597726069557211,-1.1488956436397344
2025-09-17T10:15:00-04:00,507.4,507.63,506.95,507.39,NaN,NaN,NaN,508.7839983420609,NaN,NaN,510.83090000000016,515.3978244310674,506.26397556893284,508.1892045849831,507.5574720757385,508.67685150462256,506.4380926468544,12843,32291.166666666668,35.10251255283609,23.80320743890315,NaN,NaN,NaN,NaN,0.9323036799701587,42.13628508971328,12798039,-0.029521566134632193,-1.1857976013080247,-1.1562760351733925
2025-09-17T10:20:00-04:00,507.38,508.21,507.28,508.15,NaN,NaN,NaN,508.7839983420609,NaN,NaN,510.73390000000023,515.3184110054098,506.1493889945907,506.5123636679865,507.57694398448706,508.66472321951727,506.48916474945685,19324,32565.266666666666,43.80523229079348,25.375694177831626,NaN,NaN,NaN,NaN,0.9321391314008621,39.80538142412385,12817363,0.08206096238200278,-1.053699832195889,-1.1357607945778918
2025-09-17T10:25:00-04:00,508.16,508.39,507.9,508.205,NaN,NaN,NaN,508.7839983420609,NaN,NaN,510.64020000000016,515.236105551582,506.0442944484184,506.0867864504855,507.597999381459,508.6717010292688,506.5242977336492,11886,32521.566666666666,44.38645354328587,26.551415150382002,NaN,NaN,NaN,NaN,0.9005577648722297,37.34609639094387,12829249,0.16156144417254903,-0.9338089893622055,-1.0953704335347545
2025-09-17T10:30:00-04:00,508.12,508.64,507.74,507.79,NaN,NaN,NaN,508.7839983420609,NaN,NaN,510.5406000000002,515.1633345325976,505.9178654674029,506.3474291603884,507.61536617318006,508.6721768078816,506.5585555384785,13064,32522.6,40.945185223988496,27.78711688764577,NaN,NaN,NaN,NaN,0.9005179245242116,34.69633062819783,12816185,0.18642344077784445,-0.8623411325624488,-1.0487645733402933
2025-09-17T10:35:00-04:00,507.79,507.83,507.16,507.58,NaN,NaN,NaN,508.7839983420609,NaN,NaN,510.42420000000027,515.0461690001927,505.8022309998079,506.3474291603884,507.61310438641374,508.65694548342384,506.56926328940364,8693,32431.7,39.28538805816837,28.633308168830034,NaN,NaN,NaN,NaN,0.8840523584867651,33.042810353167,12807492,0.1883935107993242,-0.813272684841138,-1.0016661956404622
2025-09-17T10:40:00-04:00,507.62,507.91,507.3,507.43,NaN,NaN,NaN,508.7839983420609,NaN,NaN,510.29680000000025,514.8906231396896,505.70297686031086,506.3474291603884,507.6119778946256,508.64696722233293,506.5769885669183,6101,32219.5,38.09742098555026,29.463856983128064,NaN,NaN,NaN,NaN,0.8644771900234257,31.370524994600853,12801391,0.17931176331237142,-0.777526491499998,-0.9568382548123694
2025-09-17T10:45:00-04:00,507.43,507.96,507.23,507.79,NaN,NaN,NaN,508.7839983420609,NaN,NaN,510.17900000000026,514.7215481834147,505.6364518165858,506.3474291603884,507.61282806498366,508.63863444353393,506.5870216864334,6485,31898.166666666668,42.58483268312592,31.15588916237594,NaN,NaN,NaN,NaN,0.854871676450321,29.920514143906402,12807876,0.19591735169785918,-0.7119415651900454,-0.9078589168879045
2025-09-17T10:50:00-04:00,507.75,507.75,507.07,507.26,NaN,NaN,NaN,508.7839983420609,NaN,NaN,510.0462000000002,514.533758159957,505.5586418400435,506.3474291603884,507.6079238287471,508.62433074071583,506.5915169167784,7246,30958.833333333332,38.19496580736023,32.64831364502009,NaN,NaN,NaN,NaN,0.8452379852753001,28.813754380613148,12800630,0.170508516107021,-0.6947232717541283,-0.8652317878611493
2025-09-17T10:55:00-04:00,507.33,507.8,507.2,507.26,NaN,NaN,NaN,508.7839983420609,NaN,NaN,509.9154000000002,514.3384640238455,505.49233597615495,506.3474291603884,507.6044026573081,508.6115646170232,506.59724069759307,7133,30262.666666666668,38.19496580736023,33.70402265422835,NaN,NaN,NaN,NaN,0.8277209863270661,27.68356344544611,12800630,0.15353256509506608,-0.6733160814923167,-0.8268486465873828
2025-09-17T11:00:00-04:00,507.29,507.35,506.99,506.99,NaN,NaN,NaN,508.7839983420609,NaN,NaN,509.7746000000002,514.1121614530524,505.437038546948,506.3474291603884,507.5965500866013,508.59759185163875,506.5955083215639,6144,29885.966666666667,36.00224542059936,34.92315683334325,NaN,NaN,NaN,NaN,0.7943123444465624,26.96766329317332,12794486,0.1251513891654582,-0.67040941013056,-0.7955607992960182
2025-09-17T11:05:00-04:00,507.03,507.55,506.96,507.55,NaN,NaN,NaN,508.7839983420609,NaN,NaN,509.65480000000025,513.8996415563909,505.4099584436097,506.3474291603884,507.5931270304896,508.58751227113703,506.59874178984217,5522,29144.166666666668,43.275915085265126,36.6696083113088,NaN,NaN,NaN,NaN,0.7797186055575246,25.864398769215462,12800008,0.1437928429904718,-0.6158197455579284,-0.7596125885484002
2025-09-17T11:10:00-04:00,507.54,507.81,507.3,507.79,NaN,NaN,NaN,508.7839983420609,NaN,NaN,509.53440000000023,513.6402054701796,505.4285945298208,506.3474291603884,507.59394225647065,508.5782110696366,506.6096734433047,8120,28583.633333333335,46.10313900935086,38.686433786773655,NaN,NaN,NaN,NaN,0.7604529908748436,24.29767881742679,12808128,0.1701805689558059,-0.5468868773536428,-0.7170674463094487
2025-09-17T11:15:00-04:00,507.74,507.85,507.41,507.51,NaN,NaN,NaN,508.7839983420609,NaN,NaN,509.41820000000024,513.4163274415713,505.4200725584291,506.3806421810283,507.5938749885459,508.5697103648041,506.6180396122877,6952,27696.733333333334,43.38622410090549,40.352726728596,NaN,NaN,NaN,NaN,0.7375634915266404,22.76007510958272,12801176,0.16646715890388364,-0.5089834976795942,-0.6754506565834778
2025-09-17T11:20:00-04:00,507.51,507.78,507.31,507.32,NaN,NaN,NaN,508.7839983420609,NaN,NaN,509.30300000000017,513.2031835853235,505.40281641467686,506.3806421810283,507.5928482977913,508.56469623234614,506.6210003632365,3405,26888.466666666667,41.59493278431366,40.782815239493104,NaN,NaN,NaN,NaN,0.7184518135604497,21.534750821420896,12797771,0.1494457804589039,-0.488643431009848,-0.6380892114687519
2025-09-17T11:25:00-04:00,507.37,507.44,506.98,507.07,NaN,NaN,NaN,508.7839983420609,NaN,NaN,509.1846000000002,512.9881172352698,505.3810827647306,506.3806421810283,507.585067099417,508.5497740074777,506.6203601913563,7580,26531.466666666667,39.295962352608804,41.082347368048296,NaN,NaN,NaN,NaN,0.6999909697347019,21.029883834259046,12790191,0.12080583703541314,-0.4870819151744854,-0.6078877522098985
2025-09-17T11:30:00-04:00,507.11,507.48,507.11,507.32,NaN,NaN,NaN,508.7839983420609,NaN,NaN,509.08220000000017,512.8044477939093,505.35995220609107,506.3806421810283,507.5815141210405,508.5406340984464,506.62239414363466,5344,25606.966666666667,42.70620463467579,41.00384539261132,NaN,NaN,NaN,NaN,0.6792773290393679,20.462102263188676,12795535,0.11801844630169345,-0.4603646943327817,-0.5783831406344752
2025-09-17T11:35:00-04:00,507.36,507.42,506.99,507.02,NaN,NaN,NaN,508.7839983420609,NaN,NaN,508.9760000000002,512.6237900157458,505.3282099842546,506.3806421810283,507.57627391683485,508.530830678138,506.6217171555317,5129,24550.733333333334,39.81561144504187,40.677356671308175,NaN,NaN,NaN,NaN,0.6614718055365564,20.168551790152755,12790406,0.09621235136338835,-0.4581177014302398,-0.5543300527936281
2025-09-17T11:40:00-04:00,507.01,507.1,506.82,507.1,NaN,NaN,NaN,508.7839983420609,NaN,NaN,508.8788000000002,512.4617862181061,505.2958137818943,506.3806421810283,507.5669541255366,508.5164233795377,506.6174848715355,7134,23130.966666666667,40.96316375068553,40.67864085178654,NaN,NaN,NaN,NaN,0.6342238194268044,20.220424810903808,12797540,0.08766023745290341,-0.4447547559774989,-0.5324149934304023
2025-09-17T11:45:00-04:00,507.08,507.42,506.92,507.295,NaN,NaN,NaN,508.7839983420609,NaN,NaN,508.7807000000002,512.2617257165105,505.29967428348994,506.3806421810283,507.56201408677913,508.5057767380596,506.6182514354987,6148,21835.466666666667,43.777204491673494,40.99948488275118,NaN,NaN,NaN,NaN,0.6246364037534613,19.41226479419008,12803688,0.0950030139473329,-0.4136612259962362,-0.5086642399435691
2025-09-17T11:50:00-04:00,507.295,508.04,507.14,507.91,NaN,NaN,NaN,508.7839983420609,NaN,NaN,508.7047000000002,512.0912353444295,505.31816465557085,506.66123509112276,507.5654224981096,508.49740405324707,506.6334409429722,11483,20114.766666666666,51.611107263558814,41.96474818832322,NaN,NaN,NaN,NaN,0.6443052320567879,18.723149280144497,12815171,0.13851036705262815,-0.33552628112778393,-0.4740366481804121
2025-09-17T11:55:00-04:00,507.915,508.33,507.66,508.28,NaN,NaN,NaN,508.7839983420609,NaN,NaN,508.63910000000016,511.92750672047674,505.35069327952357,506.8919880728982,507.58411252383564,508.50449175621793,506.66373329145335,16760,15680.233333333334,55.61779848063212,42.89567431671652,NaN,NaN,NaN,NaN,0.6461405726241573,18.59561943972374,12831931,0.18645322803150444,-0.24097011314103156,-0.427423341172536
2025-09-17T12:00:00-04:00,508.29,508.46,507.96,508.25,NaN,NaN,NaN,508.7839983420609,NaN,NaN,508.57010000000014,511.7414022497403,505.39879775026,507.05959045831855,507.58822768795335,508.50706285471426,506.66939252119244,3048,14063.2,55.2185626592584,44.111645520423544,NaN,NaN,NaN,NaN,0.6357019602938603,18.69646945019352,12828883,0.20871090527171632,-0.16653470958289063,-0.37524561485460695
2025-09-17T12:05:00-04:00,508.29,508.44,507.62,507.7,NaN,NaN,NaN,508.7839983420609,NaN,NaN,508.49510000000015,511.5662102160674,505.4239897839329,507.05959045831855,507.59334224776853,508.50598335972904,506.680701135808,7413,12715.333333333334,48.364217212323986,44.83802062077809,NaN,NaN,NaN,NaN,0.6488661059871556,17.981952247010373,12821470,0.18004194317311512,-0.15019318588821307,-0.3302351290613282
2025-09-17T12:10:00-04:00,507.73,507.81,507.5,507.61,NaN,NaN,NaN,508.7839983420609,NaN,NaN,508.4143000000002,511.35912665685686,505.46947334314353,507.05959045831855,507.59370682237875,508.5027846243066,506.68462902045087,3787,11733.266666666666,47.328903801467966,45.647067647982986,NaN,NaN,NaN,NaN,0.6246613841309303,17.049881998156508,12817683,0.14990179786516883,-0.14285788172986713,-0.29275967959503596
2025-09-17T12:15:00-04:00,507.58,507.93,507.51,507.79,NaN,NaN,NaN,508.7839983420609,NaN,NaN,508.3423000000002,511.1661386708858,505.5184613291146,507.05959045831855,507.5950645241974,508.5001196871409,506.69000936125394,4438,10919.433333333332,49.65035096400828,46.10238449646465,NaN,NaN,NaN,NaN,0.6100427138358651,16.428290472251426,12822121,0.13730865235590917,-0.12112386415014953,-0.2584325165060587
2025-09-17T12:20:00-04:00,507.8,508.315,507.76,508.28,NaN,NaN,NaN,508.7839983420609,NaN,NaN,508.2791000000002,510.9606552873295,505.5975447126709,507.05959045831855,507.59971634446504,508.50207736029466,506.6973553286354,4387,10337.166666666666,55.4115993492991,46.76727452074666,NaN,NaN,NaN,NaN,0.6061110914190181,16.573848639538756,12826508,0.1558443014653764,-0.0636271396743382,-0.2194714411397146
2025-09-17T12:25:00-04:00,508.3,508.69,508.21,508.63,NaN,NaN,NaN,508.7839983420609,NaN,NaN,508.2221000000002,510.7455762449824,505.698623755018,507.3874178013818,507.6134977860534,508.51587403528777,506.71112153681906,7586,9814.066666666668,59.018732592655546,47.88388227015738,NaN,NaN,NaN,NaN,0.5971031563176609,17.31344466330676,12834094,0.18362953300029197,0.010065475110650368,-0.1735640578896416
2025-09-17T12:30:00-04:00,508.64,508.77,508.37,508.46,NaN,NaN,NaN,508.7839983420609,NaN,NaN,508.1781000000002,510.6048771959732,505.7513228040272,507.52793424110547,507.6309152231644,508.5334571604211,506.72837328590765,9671,8881.533333333333,56.62268039647076,48.95729281388289,NaN,NaN,NaN,NaN,0.5830243594378263,18.12176680265786,12824423,0.18215196182006202,0.05412589438543591,-0.1280260674346261
2025-09-17T12:35:00-04:00,508.47,508.665,508.35,508.51,NaN,NaN,NaN,508.7839983420609,NaN,NaN,508.13590000000016,510.462680341778,505.8091196582223,507.52793424110547,507.6429336976742,508.5450561719884,506.74081122336,7093,8426.566666666668,57.173394019529184,50.23425221866292,NaN,NaN,NaN,NaN,0.5638797623351243,18.815101962463235,12831516,0.17603521440877973,0.09201795057634854,-0.08401726383243117
2025-09-17T12:40:00-04:00,508.47,508.5,508.08,508.27,NaN,NaN,NaN,508.7839983420609,NaN,NaN,508.0951000000002,510.3379887531072,505.85221124689315,507.52793424110547,507.6506312492447,508.5500272163756,506.75123528211384,6300,7873.966666666666,53.65230189556894,51.016116308726716,NaN,NaN,NaN,NaN,0.5543169221683302,18.700482833631707,12825216,0.14842302884944333,0.10151152222937299,-0.04691150662007034
2025-09-17T12:45:00-04:00,508.22,508.29,507.95,508.21,NaN,NaN,NaN,508.7839983420609,NaN,NaN,508.0521000000002,510.2000823925234,505.904117607477,507.52793424110547,507.6544528234489,508.5514569581375,506.75744868876023,4042,7580.6,52.77720827170443,51.94194465348833,NaN,NaN,NaN,NaN,0.5390085705848803,18.248346303353618,12821174,0.11993428887022356,0.10300635446770912,-0.016927934402514448
2025-09-17T12:50:00-04:00,508.28,508.56,508.03,508.21,NaN,NaN,NaN,508.7839983420609,NaN,NaN,508.0137000000002,510.0787693060487,505.9486306939517,507.52793424110547,507.6615333275942,508.5557342826121,506.76733237257633,6180,7142.466666666666,52.77720827170443,52.78580497641825,NaN,NaN,NaN,NaN,0.5383651012573909,18.357716457165832,12821174,0.09594527371194564,0.1030036577374176,0.007058384025471962
2025-09-17T12:55:00-04:00,508.23,508.4,508.06,508.11,NaN,NaN,NaN,508.7839983420609,NaN,NaN,507.96930000000015,509.92586536794926,506.01273463205104,507.52793424110547,507.6654735192539,508.55749391382625,506.77345312468157,4014,6880.066666666667,51.16415006069908,53.313443945634354,NaN,NaN,NaN,NaN,0.5241961654532897,18.459274457134317,12817160,0.069433697643579,0.09385050607994572,0.024416808436366715
2025-09-17T13:00:00-04:00,508.1,508.59,508.1,508.5,NaN,NaN,NaN,508.7839983420609,NaN,NaN,507.9302000000001,509.76057368839065,506.0998263116096,507.52793424110547,507.6740252268526,508.56429150568573,506.7837589480195,6371,6656.966666666666,56.71988279146226,53.678356483341744,NaN,NaN,NaN,NaN,0.5217535822066227,18.92344452624664,12823531,0.07384321172142203,0.11672082308814424,0.04287761136672222
2025-09-17T13:05:00-04:00,508.5,508.65,508.34,508.42,NaN,NaN,NaN,508.7839983420609,NaN,NaN,507.8912000000002,509.5903663364298,506.1920336635706,507.6126690509603,507.6793043980933,508.56896256179465,506.7896462343919,3637,6488.433333333333,55.32939063030212,53.65775592260389,NaN,NaN,NaN,NaN,0.5066283263347212,19.469597348863715,12819894,0.0672397064367695,0.1269272444126841,0.0596875379759146
2025-09-17T13:10:00-04:00,508.43,508.58,508.3,508.54,NaN,NaN,NaN,508.7839983420609,NaN,NaN,507.8556000000001,509.4188807038892,506.292319296111,507.6126690509603,507.6846716934792,508.57370177384587,506.7956416131125,3732,6409.466666666666,57.03101711421389,53.78721695510071,NaN,NaN,NaN,NaN,0.49044058873938207,19.83943382835667,12823626,0.06668990050345952,0.143049913605239,0.07636001310177948
2025-09-17T13:15:00-04:00,508.5,508.84,508.4,508.75,506.9952665072024,506.9952665072024,506.9952665072024,NaN,NaN,NaN,507.8362000000002,509.32893515362673,506.34346484637365,507.84410819261456,507.69268329312354,508.58244770873006,506.802918877517,4557,6345.2,59.90914699374967,54.61185479663112,NaN,NaN,NaN,NaN,0.48683768954371176,20.700075827257415,12828183,0.07555484774982016,0.17080357278905467,0.09524872503923451
2025-09-17T13:20:00-04:00,508.75,508.89,508.43,508.43,507.046390756875,NaN,NaN,NaN,NaN,NaN,507.8192000000002,509.26438007142156,506.37401992857883,507.8632865540917,507.7005318203078,508.59026942808686,506.8107942125287,4949,6268.633333333333,53.9761689887621,55.08665945286641,NaN,NaN,NaN,NaN,0.48492071171915946,21.594177571068833,12823234,0.055860498107329556,0.16507434767339646,0.1092138495660669
2025-09-17T13:25:00-04:00,508.44,508.56,508.39,508.49,507.046390756875,NaN,NaN,NaN,NaN,NaN,507.7978000000001,509.1690332547912,506.426566745209,507.8632865540917,507.70784758810424,508.5965837449782,506.8191114312303,5321,6208.233333333334,54.87846578588985,55.46009622585795,NaN,NaN,NaN,NaN,0.46242637516779206,22.267090112581386,12828555,0.043421539688137695,0.16349077417623903,0.12006923448810133
2025-09-17T13:30:00-04:00,508.5,508.93,508.49,508.92,507.15762050368164,NaN,NaN,NaN,NaN,NaN,507.79700000000014,509.16556421071385,506.4284357892864,507.9849033946187,507.7175754498443,508.60809248205067,506.8270584176379,5191,6176.466666666666,60.808538244200015,55.845591861208014,NaN,NaN,NaN,NaN,0.46082449122723534,23.588730267989323,12833746,0.05969575982247585,0.19468893426619616,0.1349931744437203
2025-09-17T13:35:00-04:00,508.89,509.8,508.87,509.74,507.7263650262416,NaN,NaN,NaN,NaN,NaN,507.80880000000013,509.2328724135485,506.3847275864518,508.57892271569494,507.76172712160223,508.68284808826394,506.84060615494053,14787,6485.3,69.13820163571233,56.56841107856922,NaN,NaN,NaN,NaN,0.49433702756814757,25.93146143888302,12848533,0.11786655267318424,0.2823263652852006,0.16445981261201637
2025-09-17T13:40:00-04:00,509.77,509.97,509.42,509.42,508.08448479777604,NaN,NaN,NaN,NaN,NaN,507.81680000000017,509.2721497994109,506.36145020058945,508.718138172556,507.78997287154004,508.7316045375591,506.84834120552097,9142,6519.366666666667,63.469041332547455,57.05743685971755,NaN,NaN,NaN,NaN,0.49831295417042354,28.270613530677707,12839391,0.1262271180794694,0.3222437102113531,0.19601659213188372
2025-09-17T13:45:00-04:00,509.45,509.52,509.07,509.39,508.08448479777604,NaN,NaN,NaN,NaN,NaN,507.8516000000002,509.37112945308763,506.33207054691275,508.718138172556,507.81334851138365,508.7665312130402,506.8601658097271,9207,6594.533333333334,62.94792101060328,57.4699030733657,NaN,NaN,NaN,NaN,0.49486202887253533,29.259548129061034,12830184,0.12114874862620545,0.34745252791464054,0.2263037792884351
2025-09-17T13:50:00-04:00,509.37,509.53,509.1,509.185,508.08448479777604,NaN,NaN,NaN,NaN,NaN,507.8905000000002,509.4446007041871,506.3363992958133,508.718138172556,507.82751421391146,508.78677915168237,506.86824927614055,5937,6678.933333333333,59.36121218420775,57.87768237969704,NaN,NaN,NaN,NaN,0.4902290268102078,30.19108180133751,12824247,0.09646911800466085,0.34689017679426115,0.2504210587896003
2025-09-17T13:55:00-04:00,509.2,509.69,509.13,509.53,508.08448479777604,NaN,NaN,NaN,NaN,NaN,507.9291000000002,509.54698589173523,506.3112141082651,508.718138172556,507.8539206819795,508.82724471258626,506.88059665137274,10112,6763.333333333333,63.16507175854256,58.619672628756916,NaN,NaN,NaN,NaN,0.49521266775233597,31.27154862677229,12834359,0.09567738610679566,0.3700177914230949,0.2743404053162992
2025-09-17T14:00:00-04:00,509.69,510.43,508.48,508.66,508.08448479777604,NaN,NaN,NaN,NaN,NaN,507.9717000000002,509.55171089822466,506.3916891017758,508.718138172556,507.91080521559843,508.90064942105283,506.920961010144,27629,7506.166666666667,50.36300219891665,58.447229337843496,NaN,NaN,NaN,NaN,0.5991260486271683,33.0818061463067,12806730,0.032143100582842254,0.31451928104485205,0.2823761804620098
2025-09-17T14:05:00-04:00,508.61,508.76,507.95,508,NaN,NaN,NaN,510.1670847739843,510.1670847739843,510.1670847739843,508.0017000000002,509.52473198872013,506.47866801128026,508.718138172556,507.919342967716,508.89751968795656,506.9411662474754,17460,7917.2,43.20846716185534,57.87896627364038,NaN,NaN,NaN,NaN,0.6141884737252278,33.22512001566829,12789270,-0.054057981022527346,0.21480370418385064,0.268861685206378
2025-09-17T14:10:00-04:00,508.01,508.22,507.1,507.1,NaN,NaN,NaN,509.54244455698506,NaN,NaN,508.0189000000002,509.48013275304953,506.55766724695087,508.718138172556,507.9062798207345,508.8729549560587,506.93960468541025,20107,8349.633333333333,35.75029092698691,56.38113828332071,NaN,NaN,NaN,NaN,0.6503178684591404,31.506983277167084,12769163,-0.1651403983872483,0.062436187222317585,0.2275765856095659
2025-09-17T14:15:00-04:00,507.05,507.59,506.67,507.47,NaN,NaN,NaN,509.0523334407584,NaN,NaN,508.0409000000002,509.4336881241259,506.64811187587446,508.718138172556,507.8953901242174,508.857789142591,506.93299110584377,11465,8526.866666666667,40.31167919083314,55.30844460907293,NaN,NaN,NaN,NaN,0.6695808778549132,29.339315716717707,12780628,-0.20457000968028516,-0.028135926490790553,0.1764340831894946
2025-09-17T14:20:00-04:00,507.39,508.18,506.91,508.03,NaN,NaN,NaN,509.0523334407584,NaN,NaN,508.05230000000023,509.4351784611952,506.66942153880524,508.718138172556,507.89289514237527,508.84915436611425,506.9366359186363,9351,8455.8,46.502271502276784,54.55639135107742,NaN,NaN,NaN,NaN,0.7124679580081323,28.04723099021575,12789979,-0.18443045233714467,-0.05410398223193624,0.13032647010520843
2025-09-17T14:25:00-04:00,508.09,508.91,507.9,508.9,NaN,NaN,NaN,509.0523334407584,NaN,NaN,508.0825000000002,509.47214060049356,506.69285939950686,508.718138172556,507.8997969017849,508.8535979508746,506.9459958526952,7284,8139.933333333333,54.41274056397944,54.16379089180812,NaN,NaN,NaN,NaN,0.7337202467218406,27.73807367720381,12797263,-0.10780601292357672,-0.004431046049262477,0.10337496687431424
2025-09-17T14:30:00-04:00,508.9,509.1,507.58,507.92,506.3504151913751,506.3504151913751,506.3504151913751,NaN,NaN,NaN,508.07790000000017,509.46813895741076,506.6876610425896,508.46543739547894,507.9049091315502,508.85135136216195,506.95846690093845,12380,8451,46.136985708023865,53.60384922889824,NaN,NaN,NaN,NaN,0.7898830862417119,26.901342523048488,12784883,-0.11761168980457466,-0.04363964538140408,0.07397204442317058
2025-09-17T14:35:00-04:00,507.94,508.36,506.96,506.96,506.3504151913751,NaN,NaN,NaN,NaN,NaN,508.05300000000017,509.4774184774166,506.6285815225837,508.46543739547894,507.8963049481474,508.83634645187925,506.9562634444156,13319,8647.866666666667,39.75787648512909,52.523807135986765,NaN,NaN,NaN,NaN,0.8334628657958777,25.172383392267182,12771564,-0.17953164525634846,-0.150442512147265,0.029089133109083468
2025-09-17T14:40:00-04:00,506.93,507.72,506.6,507.16,506.3504151913751,NaN,NaN,NaN,NaN,NaN,508.0404000000002,509.4849052296757,506.5958947703247,508.46543739547894,507.87700509231183,508.8120737307289,506.94193645389475,19927,9185.866666666667,41.57041429184135,51.14965542510401,NaN,NaN,NaN,NaN,0.8539298039533153,23.673388137194358,12791491,-0.19643219554872202,-0.21645111132681905,-0.020018915778097036
2025-09-17T14:45:00-04:00,507.23,508.3,506.52,508.3,506.3504151913751,NaN,NaN,NaN,NaN,NaN,508.05480000000017,509.49500826229996,506.6145917377004,508.46543739547894,507.8738073004326,508.80034572763134,506.94726887323384,14545,9522.766666666666,50.67948270628386,49.8311755015734,NaN,NaN,NaN,NaN,0.9200776750995091,22.458585526558654,12806036,-0.12379318738841094,-0.1747604000136107,-0.05096721262519977
2025-09-17T14:50:00-04:00,508.26,508.44,506.8,507.32,506.3504151913751,NaN,NaN,NaN,NaN,NaN,508.05260000000015,509.4969493201922,506.6082506798081,506.78334991638314,507.8666547519987,508.7851307021258,506.94817880187156,15986,9909.4,44.28759467899417,48.46107216917674,NaN,NaN,NaN,NaN,0.9715006983066861,21.506312608382324,12790050,-0.1338516730761138,-0.21828180397034203,-0.08443013089422823
2025-09-17T14:55:00-04:00,507.4,508.77,507.26,508.72,506.3504151913751,NaN,NaN,NaN,NaN,NaN,508.07120000000015,509.52546209424617,506.6169379057541,506.5062441257506,507.87348033218353,508.78515325199197,506.9618074123751,14335,10134.366666666667,53.34112380031321,47.77487236844173,NaN,NaN,NaN,NaN,1.0099649341419221,21.029204705523178,12804385,-0.04302494842610677,-0.13821131642686169,-0.09518636800075492
2025-09-17T15:00:00-04:00,508.72,510.05,508.67,509.87,506.6419708109637,NaN,NaN,NaN,NaN,NaN,508.1234000000002,509.64333084005307,506.6034691599473,506.6134344160806,507.91765720734656,508.8558524596306,506.9794619550625,22059,10547.3,59.205503233687956,47.763750300547464,NaN,NaN,NaN,NaN,1.0363960102746417,21.84926390370625,12826444,0.09041703120826816,0.017834921009580285,-0.07258211019868788
2025-09-17T15:05:00-04:00,509.97,510.91,509.73,510.54,507.56460850137444,NaN,NaN,NaN,NaN,NaN,508.18900000000025,509.83233076352,506.5456692364805,507.5707475328645,508.0049537743855,509.03338459295463,506.9765229558164,30233,11318.633333333333,62.18735780445352,47.693913589541104,NaN,NaN,NaN,NaN,1.0466534381121677,23.24034288239355,12856677,0.21273562066115215,0.1933374156277523,-0.01939820503339984
2025-09-17T15:10:00-04:00,510.56,511.1,509.2,509.5,507.56460850137444,NaN,NaN,NaN,NaN,NaN,508.2392000000002,509.8863021336192,506.5920978663812,507.5707475328645,508.04755909446897,509.1033270458407,506.99179114309726,19371,11754.333333333334,55.41617353219157,48.054854399060744,NaN,NaN,NaN,NaN,1.107606763961301,23.726865401430413,12837306,0.21205706942347646,0.24567313174594574,0.033616062322469276
2025-09-17T15:15:00-04:00,509.53,510.72,509.51,510.34,507.56460850137444,NaN,NaN,NaN,NaN,NaN,508.29500000000013,510.0315367830944,506.55846321690586,507.5707475328645,508.0809972612101,509.16163147539294,507.00036304702724,13901,12082.966666666667,59.27336896722356,49.20234738515847,NaN,NaN,NaN,NaN,1.1156348522497814,24.178636311964645,12851207,0.2538157510499076,0.35088575113485376,0.09707000008494618
2025-09-17T15:20:00-04:00,510.23,511,510.11,510.88,507.6422858124745,NaN,NaN,NaN,NaN,NaN,508.35680000000013,510.23148905130563,506.48211094869464,507.7493027368266,508.1294104792668,509.2557108371578,507.00311012137587,17017,12444.2,61.574858164906,51.04695933072412,NaN,NaN,NaN,NaN,1.0995180770890818,24.830941438791573,12868224,0.30026041241240586,0.47239551560045356,0.17213510318804767
2025-09-17T15:25:00-04:00,510.91,511.21,510.51,510.84,507.98422736645296,NaN,NaN,NaN,NaN,NaN,508.42340000000013,510.4064919693813,506.44030803061895,508.25944218946125,508.17358880801,509.34250494375937,507.0046726722606,14964,12809.2,61.298526024318136,52.54601981883019,NaN,NaN,NaN,NaN,1.070981071582718,25.609423429536065,12853260,0.3095088499655558,0.5590211656449924,0.2495123156794366
2025-09-17T15:30:00-04:00,510.83,511.3,510.14,510.35,507.98422736645296,NaN,NaN,NaN,NaN,NaN,508.4840000000001,510.513164359853,506.45483564014717,508.359553751569,508.2126191552731,509.4115378604385,507.0137004501077,15105,13100.333333333334,57.872274032140425,53.358162856677595,NaN,NaN,NaN,NaN,1.0773395664696683,25.708059675401707,12838155,0.26553521467254976,0.5814313340201238,0.31589611934757406
2025-09-17T15:35:00-04:00,510.435,510.84,510.1,510.13,507.98422736645296,NaN,NaN,NaN,NaN,NaN,508.54520000000014,510.5846410604889,506.5057589395114,508.359553751569,508.2381431807764,509.45237856426803,507.0239077972847,11298,13355.7,56.34937996329814,53.49649424234321,NaN,NaN,NaN,NaN,1.053243883150403,25.732159329269745,12826857,0.20713374659178208,0.5748133025873017,0.3676795559955196
2025-09-17T15:40:00-04:00,510.05,510.28,509.76,509.76,507.98422736645296,NaN,NaN,NaN,NaN,NaN,508.59400000000016,510.630605999929,506.5573940000713,508.359553751569,508.26112830227237,509.4829353325685,507.03932127197623,13045,13666.133333333333,53.785892186444975,54.042844705087575,NaN,NaN,NaN,NaN,1.0151550343539444,25.180432800922446,12813812,0.13270594461389684,0.5335619867628907,0.40085604214899384
2025-09-17T15:45:00-04:00,509.75,509.865,509.28,509.64,507.98422736645296,NaN,NaN,NaN,NaN,NaN,508.64640000000014,510.65291742061936,506.6398825793809,508.359553751569,508.277515888016,509.5006522315234,507.0543795445086,11967,13913.133333333333,52.94463597992208,54.9847560975728,NaN,NaN,NaN,NaN,0.9844296747572366,23.923149525652203,12801845,0.06778672765975163,0.4855894517236834,0.41780272406393176
2025-09-17T15:50:00-04:00,509.59,509.93,509.04,509.46,507.98422736645296,NaN,NaN,NaN,NaN,NaN,508.6936000000002,510.663079159318,506.72412084068236,508.359553751569,508.31895800645896,509.5405705301255,507.09734548279243,34868,14910.433333333332,51.63990410075101,55.70400536963776,NaN,NaN,NaN,NaN,0.9776846979888616,22.40660102847612,12766977,0.008246920719944262,0.4281113749638621,0.41986445424391783
2025-09-17T15:55:00-04:00,509.42,510.2,509.13,509.99,507.98422736645296,NaN,NaN,NaN,NaN,NaN,508.7475000000002,510.7084163671604,506.78658363283995,508.359553751569,508.42709351790177,509.66279390419527,507.19139313160827,81041,17434.433333333334,55.144987358902966,56.022969987681996,NaN,NaN,NaN,NaN,0.9842786481325139,21.3609618126754,12848018,0.0004917437353837428,0.4204791339131475,0.41998739017776376
2025-09-18T09:30:00-04:00,511.33,511.33,507.73,509.16,NaN,NaN,NaN,512.2451728661345,512.2451728661345,512.2451728661345,508.77250000000015,510.72190837155074,506.82309162844956,508.359553751569,509.40666666666664,509.40667206146327,509.40666127187,74554,19746.533333333333,49.138507161694314,56.369463736446285,NaN,NaN,NaN,NaN,1.1711158875516177,21.016825848121726,12773464,-0.061192434811344065,0.3434968466635837,0.4046892814749278
2025-09-18T09:35:00-04:00,509.17,510.55,508.5,508.8,NaN,NaN,NaN,512.2451728661345,NaN,NaN,508.78290000000015,510.7272292825748,506.8385707174255,508.359553751569,509.35919147836177,509.41920297494084,509.2991799817827,46659,20808.933333333334,46.75951454841143,55.89934878988187,NaN,NaN,NaN,NaN,1.2338933241550742,20.697271023893315,12726805,-0.12331090825996227,0.2505506461499749,0.3738615544099372
2025-09-18T09:40:00-04:00,508.8,509.23,508.16,508.17,NaN,NaN,NaN,511.9734614659975,NaN,NaN,508.7813000000001,510.7275115093905,506.8350884906097,508.359553751569,509.1398601894338,509.51217035127326,508.7675500275944,42890,21933.866666666665,42.84981966645549,54.73108567793669,NaN,NaN,NaN,NaN,1.222186658143997,20.75667365759207,12683915,-0.19939495504296112,0.12461786060623581,0.32401281564919693
2025-09-18T09:45:00-04:00,508.17,509.37,507.66,509.37,NaN,NaN,NaN,511.8776223084521,NaN,NaN,508.8147000000001,510.7427730378664,506.88662696213373,508.359553751569,509.08678570632765,509.4503637341307,508.7232076785246,30370,22639.3,51.21679652806114,53.947474158194375,NaN,NaN,NaN,NaN,1.2570304682765674,21.29631050133644,12714285,-0.16300311495618808,0.12025892195396182,0.2832620369101499
2025-09-18T09:50:00-04:00,509.39,510.94,509.39,510.2,NaN,NaN,NaN,511.8776223084521,NaN,NaN,508.8665000000001,510.80148139509583,506.93151860490434,508.1176430012552,509.21833878165563,509.7105828406712,508.7260947226401,26696,23331.266666666666,56.01358990455733,53.990146756220504,NaN,NaN,NaN,NaN,1.2793854348282407,19.825824217811846,12740981,-0.08126230693290332,0.18168415324402076,0.2629464601769241
2025-09-18T09:55:00-04:00,510.22,510.51,509.22,510.01,NaN,NaN,NaN,511.8776223084521,NaN,NaN,508.9109000000001,510.8469182745476,506.9748817254526,507.87360257331414,509.28201859442464,509.7922193076581,508.77181788119117,22309,23737.833333333332,54.68792924998636,53.66261534784642,NaN,NaN,NaN,NaN,1.2801436180547923,18.54386473272571,12718672,-0.04029143644820904,0.2125821646166628,0.25287360106487183
2025-09-18T10:00:00-04:00,510.02,510.18,509.2,509.42,NaN,NaN,NaN,511.8776223084521,NaN,NaN,508.93370000000016,510.86630943779653,507.0010905622038,507.87360257331414,509.31168299637403,509.80622698401686,508.8171390087312,25051,23651.9,50.677103130496754,52.884204273960044,NaN,NaN,NaN,NaN,1.258704788193737,17.37621777878783,12693621,-0.052457366893016,0.18730189244860185,0.23975925934161785
2025-09-18T10:05:00-04:00,509.39,510.45,509.26,510.37,NaN,NaN,NaN,511.8776223084521,NaN,NaN,508.9685000000001,510.94024871605757,506.9967512839427,507.87360257331414,509.35724371378916,509.86664359243343,508.8478438351449,18276,23679.1,56.24198835954387,52.52302301219046,NaN,NaN,NaN,NaN,1.2537973033227556,16.307024188738342,12711897,0.0011081066770145254,0.241144392687886,0.24003628601087149
2025-09-18T10:10:00-04:00,510.38,511.43,510.38,511.18,NaN,NaN,NaN,511.8776223084521,NaN,NaN,509.02290000000016,511.0836106442028,506.96218935579753,508.2090188149652,509.49791394134115,510.1672814097539,508.8285464729284,26919,23906.166666666668,60.34970224272074,52.69998217008905,NaN,NaN,NaN,NaN,1.2399546387997018,16.357999696589538,12738816,0.08412776168357139,0.3451959881153357,0.2610682264317643
2025-09-18T10:15:00-04:00,511.18,512,511.05,511.37,508.13404024901973,508.13404024901973,508.13404024901973,NaN,NaN,NaN,509.0801000000002,511.2372059220511,506.9229940779493,508.94821505197217,509.6459406473882,510.4735765552333,508.8183047395431,25413,24371.1,61.268169945778425,53.05132431169478,NaN,NaN,NaN,NaN,1.2192435931711507,16.913574338068308,12764229,0.14149800374023835,0.4379407311070622,0.29644272736682387
2025-09-18T10:20:00-04:00,511.41,511.89,510.99,511.13,508.13404024901973,NaN,NaN,NaN,NaN,NaN,509.13730000000015,511.3562377727102,506.9183622272901,508.99857204157775,509.7165382460006,510.59446560159006,508.83861089041113,14778,24552,59.39653614694622,53.452084594587724,NaN,NaN,NaN,NaN,1.1964404793732097,17.344104567881153,12749451,0.1520201497689297,0.486467914577986,0.3344477648090563
2025-09-18T10:25:00-04:00,511.11,511.85,511.1,511.67,508.16588171449945,NaN,NaN,NaN,NaN,NaN,509.2065000000002,511.51926998406816,506.8937300159322,509.16185763326223,509.7882581217228,510.7188901541807,508.85762608926484,14490,24792.2,62.1948962881113,54.112817473744094,NaN,NaN,NaN,NaN,1.1645518737036948,17.743882638421656,12763941,0.1820585216298239,0.5620209168463361,0.37996239521651226
2025-09-18T10:30:00-04:00,511.73,512.91,511.73,512.39,508.99220527293124,NaN,NaN,NaN,NaN,NaN,509.29010000000017,511.7502386056683,506.82996139433203,510.13948610660975,509.9972561212688,511.13108099015466,508.8634312523829,32819,25473.5,65.59922985603592,55.10991217055016,NaN,NaN,NaN,NaN,1.1699410255819989,19.021928248513067,12796760,0.23382685595098318,0.6722459651552413,0.4384191092042581
2025-09-18T10:35:00-04:00,512.3,512.91,512.19,512.45,509.2752868514344,NaN,NaN,NaN,NaN,NaN,509.37690000000015,511.9671763480712,506.7866236519291,510.33358888528784,510.1062471842415,511.3279914473079,508.8845029211751,18142,25634.266666666666,65.8750066296106,55.87634211845785,NaN,NaN,NaN,NaN,1.1378023808975641,20.208684886455092,12814902,0.25384873131195296,0.7557300233441993,0.5018812920322463
2025-09-18T10:40:00-04:00,512.5,513.06,512.025,512.1,509.2755010854601,NaN,NaN,NaN,NaN,NaN,509.44890000000015,512.1359990229618,506.7618009770385,510.48137110823023,510.18052829772216,511.44887700888273,508.9121795865616,14067,25438.933333333334,62.716562182367525,56.84620319136308,NaN,NaN,NaN,NaN,1.130459353690593,21.0308428977828,12800835,0.22617914666456485,0.7846052253629523,0.5584260786983875
2025-09-18T10:45:00-04:00,512.04,512.04,511.08,511.7,509.2755010854601,NaN,NaN,NaN,NaN,NaN,509.5145000000001,512.2574897920592,506.771510207941,510.48137110823023,510.22043926828604,511.49284402977577,508.9480345067963,12479,25370.066666666666,59.22185184556212,57.73637014115956,NaN,NaN,NaN,NaN,1.1225693998555533,20.37162157741056,12788356,0.16636157295262266,0.7663780448891657,0.6000164719365431
2025-09-18T10:50:00-04:00,511.65,512.23,510.53,510.53,509.2755010854601,NaN,NaN,NaN,NaN,NaN,509.5543000000001,512.2973246151519,506.8112753848484,510.48137110823023,510.2537413876297,511.51292859607395,508.99455417918546,17617,25424.433333333334,50.37905737083762,58.27417283432971,NaN,NaN,NaN,NaN,1.163814442723017,19.068149664447663,12770739,0.0400112257470584,0.650030504120366,0.6100192783733076
2025-09-18T10:55:00-04:00,510.58,511.36,510.57,511.16,509.2755010854601,NaN,NaN,NaN,NaN,NaN,509.60250000000013,512.3718683393884,506.83313166061185,510.48137110823023,510.2723536407841,511.52200853100527,509.02269875056294,11387,25326.166666666668,54.33315951702025,58.49677019068394,NaN,NaN,NaN,NaN,1.1399705539570901,17.85778288812497,12782126,-0.006636479750869562,0.6017236786847207,0.6083601584355902
2025-09-18T11:00:00-04:00,511.23,511.53,510.645,510.68,509.2755010854601,NaN,NaN,NaN,NaN,NaN,509.64750000000015,512.4123148218806,506.8826851781197,510.48137110823023,510.2845465395357,511.5262155182522,509.04287756081925,8680,24880.2,50.99868629290277,58.13856278985147,NaN,NaN,NaN,NaN,1.121758371531583,16.94429974529315,12773446,-0.07170524467711847,0.5187286025891922,0.5904338472663107
2025-09-18T11:05:00-04:00,510.69,511.09,510,511.01,509.2755010854601,NaN,NaN,NaN,NaN,NaN,509.6979000000002,512.468345516353,506.92745448364735,510.48137110823023,510.2984947288414,511.52143405404274,509.07555540364,16800,24432.433333333334,53.128438523287436,58.02717059508727,NaN,NaN,NaN,NaN,1.1194899164221825,16.193824331890674,12790246,-0.09305322214996692,0.47411731957885195,0.5671705417288189
2025-09-18T11:10:00-04:00,511.03,511.11,510.46,510.79,509.2755010854601,NaN,NaN,NaN,NaN,NaN,509.7353000000001,512.5132088608996,506.9573911391007,510.48137110823023,510.3244821915544,511.51946147873934,509.1295029043695,28136,24724.6,51.52076777808001,58.087432355628934,NaN,NaN,NaN,NaN,1.085954922392029,15.469252277568005,12762110,-0.12076638878814216,0.41621255574364113,0.5369789445317833
2025-09-18T11:15:00-04:00,510.8,511.21,510.57,511.14,509.2755010854601,NaN,NaN,NaN,NaN,NaN,509.7633000000002,512.5689183701991,506.95768162980124,510.48137110823023,510.33783349331765,511.524036272461,509.1516307141743,11104,24631.366666666665,53.91025341428992,57.920879859539355,NaN,NaN,NaN,NaN,1.054100999364026,14.65067395889122,12773214,-0.11436504328727426,0.39402264042269053,0.5083876837099648
2025-09-18T11:20:00-04:00,511.145,511.46,510.49,510.78,509.2755010854601,NaN,NaN,NaN,NaN,NaN,509.7905000000002,512.6086201179758,506.9723798820246,510.48137110823023,510.34564669251165,511.5255925167246,509.1657008682987,7471,24313.166666666668,51.119299137272556,57.261565352007345,NaN,NaN,NaN,NaN,1.0480937851237362,13.683754752501667,12765743,-0.13196683183770885,0.34342914391282875,0.4753959757505376
2025-09-18T11:25:00-04:00,510.87,510.98,510.35,510.49,509.2755010854601,NaN,NaN,NaN,NaN,NaN,509.81250000000017,512.6349416733156,506.9900583266848,510.48137110823023,510.3497236326321,511.5208655633563,509.1785817019079,8681,24103.733333333334,48.92211355654836,56.37970418134806,NaN,NaN,NaN,NaN,1.0182299433291833,12.83513546629223,12757062,-0.15892258938093323,0.2767427390243711,0.4356653284053043
2025-09-18T11:30:00-04:00,510.55,510.77,510.32,510.46,509.2755010854601,NaN,NaN,NaN,NaN,NaN,509.8380000000002,512.6603422894949,507.01565771050554,509.4670968865842,510.3526069891104,511.51379488741526,509.1914190908056,9768,23925.833333333332,48.68897162439552,55.61487814402302,NaN,NaN,NaN,NaN,0.9776420902342408,12.093516645184476,12747294,-0.17337335879918592,0.2189486299063219,0.39232198870550783
2025-09-18T11:35:00-04:00,510.42,510.45,509.85,510.22,509.2755010854601,NaN,NaN,NaN,NaN,NaN,509.8518000000002,512.674730930639,507.0288690693613,509.3216775092674,510.3486529998565,511.49726594950295,509.20004005021,12755,23974.4,46.76877439196256,54.51301229429811,NaN,NaN,NaN,NaN,0.9513819409317918,12.104256083313038,12734539,-0.19223526715802863,0.152027904757972,0.34426317191600064
2025-09-18T11:40:00-04:00,510.17,510.22,509.84,510.05,509.2755010854601,NaN,NaN,NaN,NaN,NaN,509.8796000000002,512.682341400676,507.0768585993244,509.15232550898935,510.34384646837833,511.48422472366155,509.2034682130951,9049,23841.2,45.40286815125757,53.07041502967109,NaN,NaN,NaN,NaN,0.9105689451509533,12.128611996961473,12725490,-0.2079678400166382,0.08430337189520287,0.2922712119118411
2025-09-18T11:45:00-04:00,510.1,510.1,509.44,509.6,509.2755010854601,NaN,NaN,NaN,NaN,NaN,509.9116000000002,512.6638510349084,507.15934896509197,509.15232550898935,510.3342175620192,511.4684930733162,509.1999420507222,9109,23745.933333333334,41.91334934536677,51.358868080796526,NaN,NaN,NaN,NaN,0.8926711633544585,12.713798507734067,12716381,-0.2383092236369085,-0.00561531763429457,0.23269390600261394
2025-09-18T11:50:00-04:00,509.61,509.63,508.29,508.55,NaN,NaN,NaN,511.84477940342816,511.84477940342816,511.84477940342816,509.9406000000002,512.6028228605246,507.27837713947577,509.15232550898935,510.28658400797127,511.4336318742913,509.13953614165126,19417,23230.9,35.128982881033124,49.38832670212978,NaN,NaN,NaN,NaN,0.9246232231148526,14.497000207140154,12696964,-0.3139640247216372,-0.15976112489943262,0.15420289982220461
2025-09-18T11:55:00-04:00,508.6,508.84,508.16,508.16,NaN,NaN,NaN,511.3463803396359,NaN,NaN,509.9544000000002,512.5720330069577,507.3367669930427,509.15232550898935,510.22641663312527,511.4031685192516,509.04966474699893,20142,21200.933333333334,32.992810778307245,47.51482376875443,NaN,NaN,NaN,NaN,0.9071501357495023,16.2678345870435,12676822,-0.3712192026794431,-0.30982110352709924,0.061398099152343844
2025-09-18T12:00:00-04:00,508.13,508.81,507.89,508.68,NaN,NaN,NaN,511.1924539605616,NaN,NaN,509.9674000000001,512.552934559711,507.3818654402892,509.15232550898935,510.14027967260574,511.3493925436369,508.9311668015746,32605,19802.633333333335,38.373769808766966,46.65730322860652,NaN,NaN,NaN,NaN,0.9080679831959675,18.149074987996087,12709427,-0.3550202845561004,-0.38237725654278165,-0.02735697198668126
2025-09-18T12:05:00-04:00,508.73,509.1,508.45,508.78,NaN,NaN,NaN,511.1924539605616,NaN,NaN,509.96500000000015,512.5547127252704,507.3752872747298,509.15232550898935,510.11240554059617,511.32455327924924,508.9002578019431,13953,18712.433333333334,39.38191215450619,45.58935698842696,NaN,NaN,NaN,NaN,0.8896345558248294,19.290559591008176,12723380,-0.3196251918685642,-0.4268884618223865,-0.10726326995382231
2025-09-18T12:10:00-04:00,508.76,508.85,508.22,508.8,NaN,NaN,NaN,511.1924539605616,NaN,NaN,509.98260000000016,512.5280643897248,507.43713561027545,508.81886040719155,510.0852778393063,511.3027316581904,508.8678240204222,12666,17704.966666666667,39.59474842085772,44.77478999756659,NaN,NaN,NaN,NaN,0.8710892304087698,20.577806022677997,12736046,-0.27843070074181653,-0.455301645881093,-0.17687094513927645
2025-09-18T12:15:00-04:00,508.815,509.29,508.815,508.91,NaN,NaN,NaN,511.1924539605616,NaN,NaN,510.0216000000001,512.4370613968107,507.6061386031895,508.8160883257532,510.0718556749845,511.2876259864298,508.85608536353914,8747,16984.2,40.82537498762138,43.89599974501902,NaN,NaN,NaN,NaN,0.8438685710938584,20.88530424737802,12744793,-0.22938255269060176,-0.46359913600252867,-0.2342165833119269
2025-09-18T12:20:00-04:00,508.92,509.18,508.75,508.97,NaN,NaN,NaN,511.1924539605616,NaN,NaN,510.05780000000016,512.3518315253322,507.76376847466815,508.5818706606026,510.05909411799405,511.2735779651395,508.8446102708486,8224,16368.466666666667,41.52515879459062,43.18202767476977,NaN,NaN,NaN,NaN,0.8143065303014404,21.247008140690728,12753017,-0.18065114355277373,-0.4600305127528941,-0.27937936920012035
2025-09-18T12:25:00-04:00,508.96,509,508.77,508.92,NaN,NaN,NaN,511.1924539605616,NaN,NaN,510.0702000000001,512.3325757069812,507.807824293019,508.5354965284821,510.0502554063093,511.2643196815105,508.83619113110814,5457,15806.733333333334,41.089086696270215,42.266230052054084,NaN,NaN,NaN,NaN,0.7725703495656245,21.58287604162396,12747560,-0.14128104374326073,-0.4559806738791963,-0.31469963013593555
2025-09-18T12:30:00-04:00,508.95,509.36,508.84,509.15,NaN,NaN,NaN,511.1924539605616,NaN,NaN,510.1068000000001,512.2458743417993,507.9677256582009,508.42239722278566,510.04300531685703,511.255119851188,508.83089078252607,5617,15158.933333333332,44.002219774036206,41.75786724039433,NaN,NaN,NaN,NaN,0.7545296103109399,21.142960315544812,12753177,-0.09165132300425821,-0.4292637838912583,-0.3376124608870001
2025-09-18T12:35:00-04:00,509.13,509.2,508.83,508.91,NaN,NaN,NaN,511.1924539605616,NaN,NaN,510.11060000000015,512.2404616291883,507.98073837081205,507.97997921155576,510.03248190922847,511.2431645774133,508.8217992410436,7232,14790.8,41.685782138707644,41.24098642483428,NaN,NaN,NaN,NaN,0.7270632095744445,20.749531400030182,12745945,-0.06797815268886437,-0.42258515174808053,-0.35460699905921617
2025-09-18T12:40:00-04:00,508.88,509.255,508.74,509.23,NaN,NaN,NaN,511.1924539605616,NaN,NaN,510.0978000000001,512.2409427016078,507.9546572983925,507.97997921155576,510.0223205009267,511.2305519081716,508.8140890936818,7836,14154.7,45.78401647046861,41.03348962812522,NaN,NaN,NaN,NaN,0.7119158374619833,20.526410928619704,12753781,-0.025922204324625442,-0.38700975446499797,-0.3610875501403725
2025-09-18T12:45:00-04:00,509.25,509.63,509.18,509.18,NaN,NaN,NaN,511.1924539605616,NaN,NaN,510.0706000000001,512.2250945020762,507.91610549792404,508.37402935631656,510.00631764915505,511.2050263797726,508.8076089185375,17471,13889.966666666667,45.2489161360652,40.92492832413256,NaN,NaN,NaN,NaN,0.6932075633575552,19.514737893278486,12736310,0.0018976172142549652,-0.35871552862255385,-0.3606131458368088
2025-09-18T12:50:00-04:00,509.21,509.63,509.18,509.42,NaN,NaN,NaN,511.1924539605616,NaN,NaN,510.0690000000002,512.2253051730302,507.91269482697015,508.40022348505323,509.9999485686663,511.1938132794386,508.806083857894,8160,13669.366666666667,48.36826516686435,41.1367423966759,NaN,NaN,NaN,NaN,0.6758355945463004,18.5753272176045,12744470,0.037838946697150266,-0.313314462465371,-0.35115340916252125
2025-09-18T12:55:00-04:00,509.4,509.6,509.14,509.54,NaN,NaN,NaN,511.1924539605616,NaN,NaN,510.05300000000017,512.2128935157451,507.8931064842552,508.40022348505323,509.9822272565451,511.1616758064233,508.8027787066669,24370,13998.7,49.905073415330044,41.707579830244704,NaN,NaN,NaN,NaN,0.6604187663644243,17.78131505702121,12768840,0.06924221386616447,-0.2646006418298157,-0.33384285569598016
2025-09-18T13:00:00-04:00,509.53,509.86,509.43,509.56,NaN,NaN,NaN,511.1924539605616,NaN,NaN,510.0266000000001,512.177665261591,507.87553473840916,508.6739430304341,509.9778411158735,511.15086800757973,508.8048142241673,9574,13223.866666666667,50.17127837557165,42.78202950842603,NaN,NaN,NaN,NaN,0.6439602830526802,16.55977413525606,12778414,0.08961531694384606,-0.22182370951617258,-0.31143902646001864
2025-09-18T13:05:00-04:00,509.54,510.1,509.53,509.93,NaN,NaN,NaN,511.1924539605616,NaN,NaN,510.0084000000001,512.1469915364186,507.86980846358165,508.86615442434726,509.9759277010114,511.14000701332515,508.8118483886977,12454,13034.266666666666,54.94166869254185,44.3498050737285,NaN,NaN,NaN,NaN,0.638677405691778,15.92222539305124,12790868,0.12413886603219204,-0.1562654439197786,-0.28040430995197063
2025-09-18T13:10:00-04:00,509.91,509.91,509.47,509.5,NaN,NaN,NaN,511.1924539605616,NaN,NaN,509.9914000000001,512.1323717792527,507.8504282207476,508.86615442434726,509.97211174928964,511.13038353274715,508.81383996583213,8952,12863.766666666666,49.06299154742533,45.11332091220409,NaN,NaN,NaN,NaN,0.6259147338566496,15.18796516874517,12781916,0.11438479040908334,-0.13742332194061646,-0.2518081123496998
2025-09-18T13:15:00-04:00,509.48,509.7,509.35,509.52,NaN,NaN,NaN,511.1924539605616,NaN,NaN,509.9792000000001,512.1238224468589,507.83457755314134,508.86615442434726,509.9690199144275,511.1238916289278,508.8141481999272,5684,12637.266666666666,49.33453293809177,45.824222396745924,NaN,NaN,NaN,NaN,0.6062065385811722,14.216959778910915,12787600,0.105846924821941,-0.11949945632227355,-0.22534638114421454
2025-09-18T13:20:00-04:00,509.55,509.62,509.24,509.36,NaN,NaN,NaN,511.1924539605616,NaN,NaN,509.9712000000002,512.122008740737,507.8203912592634,508.86615442434726,509.96475022313336,511.1162644995989,508.8132359466678,6312,12260.433333333332,47.16819345001248,46.36518275597126,NaN,NaN,NaN,NaN,0.5900489286825168,13.352148878237927,12781288,0.08679049910619596,-0.11685825726146959,-0.20364875636766555
2025-09-18T13:25:00-04:00,509.34,509.36,509.135,509.18,NaN,NaN,NaN,511.1924539605616,NaN,NaN,509.9620000000001,512.1223110886143,507.8016889113859,508.86615442434726,509.95780160862716,511.10611422041245,508.8094889968419,7883,12143.633333333333,44.785593987134604,46.64805554165077,NaN,NaN,NaN,NaN,0.5639740052051958,12.80166791360626,12773405,0.060666046625688974,-0.12781619808555433,-0.1884822447112433
2025-09-18T13:30:00-04:00,509.18,509.24,508.95,509.01,NaN,NaN,NaN,511.0457927190743,NaN,NaN,509.9530000000002,512.125317656115,507.78068234388536,508.86615442434726,509.9489350336241,511.0949387804249,508.80293128682325,8434,12135.433333333332,42.59711163774819,46.72462360187631,NaN,NaN,NaN,NaN,0.5444044334048261,12.722783637527538,12764971,0.03198088531359353,-0.1485061380692514,-0.18048702338284492
2025-09-18T13:35:00-04:00,508.96,509.235,508.75,509.21,NaN,NaN,NaN,510.9207566863891,NaN,NaN,509.93740000000014,512.1196110253677,507.7551889746325,508.86615442434726,509.94004480084783,511.0836772130137,508.796412388682,8612,11862.5,45.94380512752108,47.07138920410852,NaN,NaN,NaN,NaN,0.5401612595901967,13.087801151925085,12773583,0.02673408957679696,-0.1470694114118487,-0.17380350098864566
2025-09-18T13:40:00-04:00,509.2,509.2,508.98,509.055,NaN,NaN,NaN,510.9207566863891,NaN,NaN,509.93530000000015,512.1206991944696,507.74990080553073,508.86615442434726,509.93307328850307,511.0746829627891,508.79146361421704,6984,11157.433333333332,43.81193373713558,47.057797344329906,NaN,NaN,NaN,NaN,0.5180068839051798,13.426745986722807,12766599,0.013736849955334696,-0.15663243854447728,-0.17036928849981198
2025-09-18T13:45:00-04:00,509.03,509.14,508.81,508.9,NaN,NaN,NaN,510.8068826419372,NaN,NaN,509.93730000000016,512.1187189967098,507.7558810032905,508.86615442434726,509.92490144259585,511.0652548411896,508.7845480440021,7236,11028.5,41.726800509054286,47.0607272279261,NaN,NaN,NaN,NaN,0.5045778207690944,14.11773052783532,12759363,-0.0034681900238649477,-0.17470452602964315,-0.1712363360057782
2025-09-18T13:50:00-04:00,508.9,508.99,508.59,508.78,NaN,NaN,NaN,510.59316070366725,NaN,NaN,509.9495000000001,512.0978186447799,507.80118135522036,508.86615442434726,509.91814241362925,511.0584632118378,508.7778216154207,5200,10952.8,40.13425862499109,46.65717309610626,NaN,NaN,NaN,NaN,0.49710797642844723,15.209860285400554,12754163,-0.020167158182776784,-0.1964452837342492,-0.1762781255514724
2025-09-18T13:55:00-04:00,508.79,508.8,508.38,508.38,NaN,NaN,NaN,510.36847158077336,NaN,NaN,509.92970000000014,512.1169141274759,507.74248587252436,508.6929235394778,509.9027093429254,511.0460892299315,508.75932945591927,9774,10989.233333333334,35.29819795483226,45.946407511732495,NaN,NaN,NaN,NaN,0.4916002638264164,16.616046192824694,12744389,-0.05349652366033186,-0.24314878012688723,-0.18965225646655537
2025-09-18T14:00:00-04:00,508.38,508.59,508.22,508.51,NaN,NaN,NaN,510.15308650891996,NaN,NaN,509.8959000000002,512.1173262893552,507.67447371064526,508.55133883158226,509.8889766577131,511.03568591505143,508.74226740037477,8392,10943.366666666667,37.91650571346535,45.19985326506113,NaN,NaN,NaN,NaN,0.48291453069595436,18.20067878055572,12752781,-0.061557028358404764,-0.26659854191456134,-0.20504151355615657
2025-09-18T14:05:00-04:00,508.5,508.625,508.21,508.41,NaN,NaN,NaN,510.1427189403327,NaN,NaN,509.8639000000002,512.1235966962516,507.60420330374876,508.5110710652658,509.86923879686555,511.02077578594515,508.71770180778594,12132,10922.6,36.68665125900968,44.25568025389539,NaN,NaN,NaN,NaN,0.47806349278910193,19.534002793290586,12740649,-0.06789471744216136,-0.28990991035885827,-0.2220151929166969
2025-09-18T14:10:00-04:00,508.4,508.53,508.22,508.41,NaN,NaN,NaN,510.06407262486306,NaN,NaN,509.84370000000024,512.1367196769835,507.55068032301693,508.36035685221265,509.8502762604421,511.00649024413957,508.69406227674466,11738,11012.233333333334,36.68665125900968,43.29249260271239,NaN,NaN,NaN,NaN,0.4660589575898765,20.772089376544393,12740649,-0.06628383476457014,-0.3048699863724096,-0.23858615160783944
2025-09-18T14:15:00-04:00,508.43,508.56,507.9,508,NaN,NaN,NaN,509.9322965964602,NaN,NaN,509.79630000000026,512.1412373635064,507.451362636494,508.2952854817701,509.81011004004364,510.98132085789496,508.6388992221923,22249,11450.233333333334,31.784428500190046,41.63840401754441,NaN,NaN,NaN,NaN,0.4799118891906014,22.502152002303454,12718400,-0.0857895543261587,-0.34582309451553783,-0.26003354018937913
2025-09-18T14:20:00-04:00,508,508.21,507.89,508.11,NaN,NaN,NaN,509.7185558420756,NaN,NaN,509.73490000000027,512.0924347206079,507.3773652793926,508.28638270833284,509.78003270748115,510.96301957835925,508.59704583660306,16533,11354.1,34.32020105455881,40.58534755376822,NaN,NaN,NaN,NaN,0.46848961139127226,24.125584303262652,12734933,-0.08412751209067743,-0.3651929303027259,-0.2810654182120485
2025-09-18T14:25:00-04:00,508.13,508.37,508.05,508.18,NaN,NaN,NaN,509.7185558420756,NaN,NaN,509.6711000000003,512.0208278903477,507.3213721096528,508.28638270833284,509.7633629855138,510.95111470533834,508.5756112656893,10199,11022.666666666666,35.95183783135532,39.629440760429915,NaN,NaN,NaN,NaN,0.45788321057760945,24.91548017069793,12745132,-0.07164601678423665,-0.37062293919234435,-0.2989769224081077
2025-09-18T14:30:00-04:00,508.19,508.26,507.87,508.15,NaN,NaN,NaN,509.68015108751104,NaN,NaN,509.6115000000002,511.9613597828672,507.2616402171332,508.2441061666663,509.7482315852885,510.94113261057606,508.555330560001,8839,10230.466666666667,35.54429851119295,38.799162550514225,NaN,NaN,NaN,NaN,0.45303440982206494,26.006951136676896,12736293,-0.059255869126247585,-0.3730467588159172,-0.3137908896896696
2025-09-18T14:35:00-04:00,508.15,508.71,508.15,508.69,NaN,NaN,NaN,509.68015108751104,NaN,NaN,509.5519000000002,511.8402556452399,507.26354435476054,508.073284933333,509.73615603455255,510.92938114129294,508.54293092781217,9660,10087.366666666667,47.15611903546049,38.96848576825179,NaN,NaN,NaN,NaN,0.460674809120489,25.29492352400865,12745953,-0.011061363930526258,-0.32761759460282747,-0.3165562306723012
2025-09-18T14:40:00-04:00,508.64,508.69,508.16,508.27,NaN,NaN,NaN,509.68015108751104,NaN,NaN,509.46950000000027,511.6366384355216,507.30236156447893,507.85662794666644,509.7255505652945,510.9201413602939,508.5309597702951,7727,9922.733333333334,40.97337919806506,38.852504879702984,NaN,NaN,NaN,NaN,0.46562660846902354,24.633755026530995,12738226,-0.004191562854967301,-0.32179568424101035,-0.31760412138604305
2025-09-18T14:45:00-04:00,508.25,508.93,508.23,508.58,NaN,NaN,NaN,509.68015108751104,NaN,NaN,509.39210000000026,511.3983782356127,507.3858217643878,507.6910450181943,509.7099711759307,510.90380688884943,508.516135463012,13690,10087.5,46.54438178700244,38.89540321252309,NaN,NaN,NaN,NaN,0.4823675650069496,23.221496442331173,12751916,0.023013035952979044,-0.28883782644481926,-0.3118508623977983
2025-09-18T14:50:00-04:00,508.64,508.78,508.5,508.65,NaN,NaN,NaN,509.68015108751104,NaN,NaN,509.3231000000003,511.18416086907666,507.4620391309239,507.6910450181943,509.701957541775,510.89486126879245,508.5090538147576,7620,10067.366666666667,47.743728875104004,39.17624572237798,NaN,NaN,NaN,NaN,0.46791273893502267,21.91011347128848,12759536,0.04616829132590472,-0.2541404982404174,-0.3003087895663221
2025-09-18T14:55:00-04:00,508.6,508.9,508.58,508.82,NaN,NaN,NaN,509.68015108751104,NaN,NaN,509.26550000000026,511.00289834199884,507.5281016580017,507.83506881164436,509.6905808277323,510.8806316888917,508.50052996657286,12489,10301.766666666666,50.6401450748884,39.81291319136613,NaN,NaN,NaN,NaN,0.45734754329680627,20.39402204633392,12772025,0.07184819944059717,-0.21049854026557568,-0.28234673970617286
2025-09-18T15:00:00-04:00,508.84,509.03,508.76,509,NaN,NaN,NaN,509.68015108751104,NaN,NaN,509.23490000000027,510.9356439427674,507.53415605723313,508.0430550493155,509.68224246566376,510.868398980479,508.4960859508485,11381,10493.9,53.57433964087847,40.77291897821523,NaN,NaN,NaN,NaN,0.4439655759184617,19.39857075354377,12783406,0.09823874782402031,-0.15954830492614747,-0.2577870527501678
2025-09-18T15:05:00-04:00,509.02,509.37,508.97,509.17,NaN,NaN,NaN,509.68015108751104,NaN,NaN,509.19510000000025,510.80446321530866,507.58573678469185,508.3804440394524,509.67218108097654,510.84877977556397,508.4955823863891,20799,10946.133333333333,56.22125147726974,42.267422801246475,NaN,NaN,NaN,NaN,0.44082517763856993,19.41422498606247,12804205,0.12282919298980383,-0.10425056151291301,-0.22707975450271684
2025-09-18T15:10:00-04:00,509.18,509.48,509,509.26,NaN,NaN,NaN,509.68015108751104,NaN,NaN,509.1667000000002,510.7193643033608,507.61403569663963,508.44835523156195,509.6661962513389,510.83556532609674,508.496827176581,15106,11188.466666666667,57.59950952792833,43.67335164513669,NaN,NaN,NaN,NaN,0.44362337923581624,19.697046347646268,12819311,0.13961693088113436,-0.052558590901298885,-0.19217552178243325
2025-09-18T15:15:00-04:00,509.27,509.66,509.07,509.52,NaN,NaN,NaN,509.68015108751104,NaN,NaN,509.1369000000002,510.6016114252089,507.6721885747915,508.53968418524954,509.66257229837464,510.8238026344906,508.50134196225866,15828,11133.7,61.381957583703326,45.43730209690052,NaN,NaN,NaN,NaN,0.4540788521475459,20.37606905522729,12835139,0.16116482967769502,0.009280515314685545,-0.15188431436300948
2025-09-18T15:20:00-04:00,509.6,509.65,509.22,509.23,NaN,NaN,NaN,509.68015108751104,NaN,NaN,509.10570000000024,510.49262466955656,507.7187753304439,508.53968418524954,509.65895518945314,510.81352428538094,508.50438609352534,13487,11311.266666666666,55.44117261776084,46.776910765382745,NaN,NaN,NaN,NaN,0.4523589341370033,21.006590140838235,12821652,0.14909968630198037,0.034490293514465975,-0.11460939278751439
2025-09-18T15:25:00-04:00,509.24,509.24,508.66,508.79,NaN,NaN,NaN,509.68015108751104,NaN,NaN,509.0587000000003,510.320297098437,507.79710290156356,508.53968418524954,509.6436410945741,510.7915474314687,508.4957347576795,22620,11252.933333333332,47.870861873558965,47.92594172062338,NaN,NaN,NaN,NaN,0.4614761531272162,19.60436203980914,12799032,0.10668653612053743,0.018748777363157387,-0.08793775875738004
2025-09-18T15:30:00-04:00,508.79,508.89,508.42,508.78,NaN,NaN,NaN,509.68015108751104,NaN,NaN,509.01870000000025,510.1824917506174,507.85490824938313,508.53968418524954,509.6277231814886,510.772432793225,508.4830135697522,19250,11575.466666666667,47.71140782966615,48.8824564902739,NaN,NaN,NaN,NaN,0.46208499933241287,18.760537062979694,12779782,0.07467364587404526,0.005404298585176548,-0.06926934728886872
2025-09-18T15:35:00-04:00,508.77,508.92,508.6,508.77,NaN,NaN,NaN,509.68015108751104,NaN,NaN,508.98430000000025,510.0712443586959,507.8973556413046,508.53968418524954,509.61733603334,510.75903848629025,508.47563358038974,13929,11624.633333333333,47.54087181240372,49.71024463177736,NaN,NaN,NaN,NaN,0.4519360708086686,17.884398002861328,12765853,0.05068740932993212,-0.005910085626453565,-0.056597494956385684
2025-09-18T15:40:00-04:00,508.77,508.86,508.37,508.39,NaN,NaN,NaN,509.68015108751104,NaN,NaN,508.94290000000024,509.95711514427717,507.9286848557233,508.53968418524954,509.6024352328448,510.74317487531647,508.46169559037315,16257,11868.133333333333,41.47432575598677,50.13381800640549,NaN,NaN,NaN,NaN,0.45465492289376436,17.67407578233992,12749596,0.009261459507962769,-0.04502067057143222,-0.05428213007939499
2025-09-18T15:45:00-04:00,508.41,508.46,508.09,508.32,NaN,NaN,NaN,509.68015108751104,NaN,NaN,508.9049000000003,509.86584638698747,507.9439536130131,508.53968418524954,509.58249561871327,510.7258628195513,508.4391284178752,18133,12283.1,40.45033598702071,49.65483350294551,NaN,NaN,NaN,NaN,0.4486081426870672,18.12204085805358,12731463,-0.021161380946527676,-0.08073385626255458,-0.059572475316026906
2025-09-18T15:50:00-04:00,508.28,508.83,508.07,508.51,NaN,NaN,NaN,509.68015108751104,NaN,NaN,508.8741000000002,509.78360467787195,507.9645953221285,508.53968418524954,509.5319942495504,510.6728609330915,508.3911275660093,56756,13964.566666666668,44.458746602020476,49.90378831751375,NaN,NaN,NaN,NaN,0.4708504182094189,17.37876928502283,12788219,-0.026452046386888237,-0.0926375332996372,-0.06618548691274896
2025-09-18T15:55:00-04:00,508.5,508.73,508.09,508.35,NaN,NaN,NaN,509.68015108751104,NaN,NaN,508.8491000000003,509.7460496969092,507.9521503030914,508.53968418524954,509.4164034962235,510.55151411247834,508.28129287996865,140803,18395.233333333334,41.90093991604666,49.57211389815977,NaN,NaN,NaN,NaN,0.4829325311944635,16.68858853863713,12647416,-0.03798889876646444,-0.11367161037082951,-0.07568271160436507