time,open,high,low,close,Long Stop,Long Stop Start,Buy Label,Short Stop,Short Stop Start,Sell Label,Basis,Upper,Lower,ATR Trailing Stoploss,VWAP,Upper Band #1,Lower Band #1,Volume,Volume MA,RSI,RSI-based MA,Regular Bullish,Regular Bullish Label,Regular Bearish,Regular Bearish Label,ATR,ADX,OnBalanceVolume,Histogram,MACD,Signal
2025-08-28T09:45:00-04:00,507.76,507.81,506.38,506.6,NaN,NaN,NaN,509.27580510916636,509.27580510916636,509.27580510916636,505.9671000000012,507.96420299047304,503.9699970095294,507.2385790303765,508.17843201398233,508.95712651135733,507.39973751660733,32477,15305.1,49.942227337233284,57.87655601372491,NaN,NaN,NaN,NaN,0.8532211145511411,30.25537262913714,11992034,0.06811995729255327,0.4634888915207398,0.39536893422818653
2025-08-28T09:50:00-04:00,506.61,506.63,505.5,505.88,NaN,NaN,NaN,508.30076851329517,NaN,NaN,505.99510000000123,507.9467592823578,504.04344071764467,507.2385790303765,507.81010751652036,508.8913865347815,506.72882849825925,26360,15951.366666666667,44.985679592148095,57.89563721033285,NaN,NaN,NaN,NaN,0.872991034940345,28.429258264551997,11965674,-0.05089327969611668,0.33175233460804066,0.38264561430415733
2025-08-28T09:55:00-04:00,505.8,506.69,505.57,506.69,NaN,NaN,NaN,508.30076851329517,NaN,NaN,506.0443000000012,507.9386801187621,504.14991988124035,507.2385790303765,507.69673459816914,508.80888154087796,506.5845876554603,12788,15903.7,50.890589956804995,57.67312433780153,NaN,NaN,NaN,NaN,0.8906345324446063,26.79825717466989,11978462,-0.07461676048490445,0.2893746636980268,0.36399142418293123
2025-08-28T10:00:00-04:00,506.78,507.05,506.27,506.44,NaN,NaN,NaN,508.30076851329517,NaN,NaN,506.0945000000013,507.89269381437265,504.29630618562993,507.2385790303765,507.582175497811,508.6881909810941,506.4761600145279,19385,16362.266666666666,49.137554233051354,57.54870169452621,NaN,NaN,NaN,NaN,0.8827320658414223,25.67375524013332,11959077,-0.10484750104901958,0.23293204787165678,0.33777954892067635
2025-08-28T10:05:00-04:00,506.41,507.22,506.11,506.89,NaN,NaN,NaN,508.30076851329517,NaN,NaN,506.1509000000013,507.86656743687473,504.43523256312784,507.2385790303765,507.5126211279827,508.59704763487116,506.42819462109424,16910,16652.766666666666,52.32127590852807,57.66423114993116,NaN,NaN,NaN,NaN,0.898965489709893,24.811097960807444,11975987,-0.09266078726366023,0.22195356484110107,0.3146143521047613
2025-08-28T10:10:00-04:00,506.89,507.18,506.46,507.18,NaN,NaN,NaN,508.30076851329517,NaN,NaN,506.2054000000013,507.8746127946895,504.5361872053131,507.2385790303765,507.48228982906335,508.54536950925797,506.41921014886873,11452,16590.3,54.30629371831196,57.61124915160867,NaN,NaN,NaN,NaN,0.8861822404449026,24.010059058576275,11987439,-0.06452611606229597,0.2339567070268913,0.2984828230891873
2025-08-28T10:15:00-04:00,507.15,507.18,506.28,506.31,NaN,NaN,NaN,508.30076851329517,NaN,NaN,506.23760000000135,507.8505789068039,504.6246210931988,507.2385790303765,507.4472315216795,508.5035402126715,506.3909228306875,8842,16672.933333333334,47.86773580811876,56.87991815455748,NaN,NaN,NaN,NaN,0.8871692232702691,22.99119892110233,11978597,-0.10175186202820852,0.17129299555392663,0.27304485758213515
2025-08-28T10:20:00-04:00,506.33,506.91,506.28,506.37,NaN,NaN,NaN,508.30076851329517,NaN,NaN,506.26880000000136,507.82962229409264,504.7079777059101,506.9698632243012,507.4113049340634,508.46229360255984,506.360316265567,9071,16844.533333333333,48.32278071690472,55.93925307091182,NaN,NaN,NaN,NaN,0.8687999930366822,22.045114507733672,11987668,-0.11841047569041585,0.12503176296911533,0.24344223865953118
2025-08-28T10:25:00-04:00,506.37,506.71,505.94,506.02,NaN,NaN,NaN,508.30076851329517,NaN,NaN,506.28670000000136,507.81482775440236,504.75857224560036,505.63389057944096,507.35332684614116,508.4098229230066,506.29683076927574,12012,17090.966666666667,45.810796028455165,54.56561458956056,NaN,NaN,NaN,NaN,0.8617428506769179,20.62475046409214,11975656,-0.1472000979602214,0.059442116209254436,0.20664221416947584
2025-08-28T10:30:00-04:00,506.04,506.58,505.85,506.17,NaN,NaN,NaN,508.30076851329517,NaN,NaN,506.30310000000134,507.8080902172441,504.79810978275856,504.60021904964555,507.30918062274185,508.36862651635676,506.24973472912694,9796,17199.2,47.080460664333295,53.80851427209473,NaN,NaN,NaN,NaN,0.8523326470571353,19.164830720400474,11985452,-0.1498396711289604,0.019342625258275348,0.16918229638723575
2025-08-28T10:35:00-04:00,506.17,506.385,505.85,506.2,NaN,NaN,NaN,508.30076851329517,NaN,NaN,506.3269000000014,507.7862873898846,504.8675126101182,504.60021904964555,507.27676082830334,508.3387683815985,506.21475327500815,7331,17174.666666666668,47.34617857392617,53.039996909606934,NaN,NaN,NaN,NaN,0.8296660294101947,17.80919095840106,11992783,-0.143267134082761,-0.009901621216215517,0.1333655128665455
2025-08-28T10:40:00-04:00,506.22,506.8,506.17,506.69,NaN,NaN,NaN,508.30076851329517,NaN,NaN,506.35510000000136,507.786706773432,504.9234932265707,504.8659133781879,507.2398893439225,508.2866414033888,506.19313728445627,14138,17506.133333333335,51.619220392994336,51.07784619259337,NaN,NaN,NaN,NaN,0.815404170166609,17.218152741907,12006921,-0.10158250794003035,0.006387377941507566,0.10796988588153791
2025-08-28T10:45:00-04:00,506.68,506.7,506.35,506.45,NaN,NaN,NaN,508.30076851329517,NaN,NaN,506.3809000000014,507.7713297010868,504.990470298916,504.97773070255033,507.2146889146575,508.2521769594829,506.17720086983206,9781,17674.366666666665,49.50029867931723,49.85916714376213,NaN,NaN,NaN,NaN,0.782161015154706,16.669331540876804,11997140,-0.08643084907200224,-0.0000686754584648952,0.08636217361353735
2025-08-28T10:50:00-04:00,506.51,507.71,506.51,507.62,NaN,NaN,NaN,508.30076851329517,NaN,NaN,506.42670000000135,507.826479423307,505.0269205766957,505.70218456204026,507.21747765691833,508.2326599022749,506.20229541156175,12809,17970.766666666666,58.4538199999452,49.82749368643376,NaN,NaN,NaN,NaN,0.8162923712150835,17.510810455806006,12009949,0.0014760843135489532,0.08820727900547354,0.08673119469192458
2025-08-28T10:55:00-04:00,507.65,507.65,507,507,NaN,NaN,NaN,508.30076851329517,NaN,NaN,506.45850000000144,507.83651922825715,505.0804807717457,505.7187476496322,507.217458344045,508.2204800183756,506.21443666971436,7318,17997.066666666666,53.08288280402706,50.051826219776174,NaN,NaN,NaN,NaN,0.8044143446997187,18.292183733954552,12002631,0.01613940502707907,0.10690545097577342,0.09076604594869435
2025-08-28T11:00:00-04:00,507,507.68,506.99,507.24,NaN,NaN,NaN,508.30076851329517,NaN,NaN,506.49990000000145,507.8445642530373,505.1552357469656,505.7899981197058,507.21950429215684,508.2105921107161,506.2284164735976,7500,17979.966666666667,54.813688453465005,50.753826852727386,NaN,NaN,NaN,NaN,0.7962418915068815,19.05429288119623,12010131,0.03897277869498603,0.13948201931742688,0.10050924062244085
2025-08-28T11:05:00-04:00,507.24,507.44,506.97,507.31,NaN,NaN,NaN,508.30076851329517,NaN,NaN,506.5383000000014,507.8635073172266,505.2130926827762,505.7899981197058,507.21971258042987,508.20575370119775,506.233671459662,3232,17842.5,55.331285654707415,51.071019402577555,NaN,NaN,NaN,NaN,0.7729388992563878,19.71491266744498,12013363,0.054792190401396795,0.16899947862418685,0.11420728822279005
2025-08-28T11:10:00-04:00,507.39,508.12,507.39,507.79,NaN,NaN,NaN,508.30076851329517,NaN,NaN,506.5823000000014,507.9246221795703,505.2399778204325,506.3173987966117,507.2341755058893,508.21104237051077,506.25730864126785,8638,17637.8,58.81506982718244,51.76227051644406,NaN,NaN,NaN,NaN,0.7755861207380745,21.135261579153102,12022001,0.09142646661145759,0.22849037148711204,0.13706390487565445
2025-08-28T11:15:00-04:00,507.81,508.6,507.81,508.11,505.9656809264955,505.9656809264955,505.9656809264955,NaN,NaN,NaN,506.62430000000137,508.02261328169294,505.2259867183098,506.75291903728936,507.27410903756424,508.248584286673,506.2996337884555,14507,17660.866666666665,60.998896225501156,52.382100539084995,NaN,NaN,NaN,NaN,0.7780442549710694,22.91563528618056,12036508,0.12876746172525372,0.2980232320322216,0.16925577030696787
2025-08-28T11:20:00-04:00,508.08,508.7,508.04,508.05,506.14246815710936,NaN,NaN,NaN,NaN,NaN,506.6665000000014,508.1063975636088,505.226602436394,506.8923352298315,507.31220962979876,508.2865123919482,506.33790686764934,13667,17746.433333333334,60.35270291501122,52.81398691027779,NaN,NaN,NaN,NaN,0.7696125224731336,24.65913449770785,12022841,0.14004973854666242,0.3443179434902959,0.20426820494363346
2025-08-28T11:25:00-04:00,508.08,508.08,507.11,507.22,506.14246815710936,NaN,NaN,NaN,NaN,NaN,506.6865000000014,508.1288123773409,505.24418762266185,506.8923352298315,507.3158589589,508.27912114692845,506.3525967708715,8401,17672.066666666666,52.126317519509115,53.11817131823425,NaN,NaN,NaN,NaN,0.7839259137250505,24.277632851723048,12014440,0.08494867716670815,0.31045405140201865,0.2255053742353105
2025-08-28T11:30:00-04:00,507.2,507.77,507.15,507.6,506.14246815710936,NaN,NaN,NaN,NaN,NaN,506.71530000000143,508.1718471614516,505.2587528385513,506.8923352298315,507.3184446257905,508.27541220484244,506.36147704673857,4990,17399.2,55.14106846287634,53.605191871517945,NaN,NaN,NaN,NaN,0.7722169198875471,23.923381323308593,12019430,0.06815407214957137,0.3106979644222747,0.24254389227270334
2025-08-28T11:35:00-04:00,507.61,508.01,507.42,507.48,506.14246815710936,NaN,NaN,NaN,NaN,NaN,506.7379000000014,508.2060935682279,505.26970643177486,506.8923352298315,507.3271566706023,508.2723612425349,506.3819520986697,10365,17222.9,53.984930963367525,54.189058652583114,NaN,NaN,NaN,NaN,0.7592014256098635,23.90467300999607,12009065,0.044185443982624306,0.29777569725098374,0.25359025326835943
2025-08-28T11:40:00-04:00,507.62,507.81,507.4,507.46,506.14246815710936,NaN,NaN,NaN,NaN,NaN,506.7655000000014,508.2350689823039,505.2959310176989,506.8923352298315,507.3295614963619,508.2700914456922,506.38903154703166,4009,16817.1,53.7825316730705,54.667778010350055,NaN,NaN,NaN,NaN,0.7342584666377322,23.844832613553663,12005056,0.023257811001233142,0.28266251701990086,0.2594047060186677
2025-08-28T11:45:00-04:00,507.45,507.69,507.33,507.52,506.14246815710936,NaN,NaN,NaN,NaN,NaN,506.79670000000135,508.2627744980379,505.3306255019648,506.8923352298315,507.3311150344245,508.26781222211656,506.39441784673244,3262,16246.733333333334,54.335652019298834,55.167026113590964,NaN,NaN,NaN,NaN,0.7075257190207523,23.63279853965428,12008318,0.010385679840035578,0.2723868058187122,0.26200112597867664
2025-08-28T11:50:00-04:00,507.56,507.79,507.53,507.79,506.14246815710936,NaN,NaN,NaN,NaN,NaN,506.8179000000014,508.3099296088911,505.32587039111166,506.8923352298315,507.33432249381684,508.2676094330637,506.40103555457,3354,15102.3,56.83889623525399,55.53986010232379,NaN,NaN,NaN,NaN,0.6762738819478443,23.58655113993177,12011672,0.016615397880907323,0.2827703733298108,0.2661549754489035
2025-08-28T11:55:00-04:00,507.85,508.14,507.82,508.07,506.14246815710936,NaN,NaN,NaN,NaN,NaN,506.8512000000013,508.37877920708985,505.3236207929128,506.90819258119114,507.3437693089766,508.27389847151477,506.41364014643847,5519,13158.1,59.32885043535442,56.241899513469306,NaN,NaN,NaN,NaN,0.652968604665853,24.045819688708296,12017191,0.03509151960892798,0.3100193749600635,0.2749278553511355
2025-08-28T12:00:00-04:00,508.08,508.33,507.92,508.26,506.14246815710936,NaN,NaN,NaN,NaN,NaN,506.8850000000013,508.4602396623887,505.3097603376139,507.1395540649529,507.35658836786683,508.28510583436014,506.42807090137353,6221,11955.333333333334,60.97410077135124,56.42191956856974,NaN,NaN,NaN,NaN,0.6356137043325756,24.725562524666852,12023412,0.05445133066948682,0.342992018687994,0.2885406880185072
2025-08-28T12:05:00-04:00,508.29,508.97,508.03,508.745,506.4792782042891,NaN,NaN,NaN,NaN,NaN,506.92590000000126,508.5838260400501,505.2679739599524,507.54764325196237,507.39673200288837,508.3355937198719,506.45787028590485,13584,11410.1,64.87961018542302,57.26454295295515,NaN,NaN,NaN,NaN,0.6573555825945384,26.093554789723267,12036996,0.09205225302656012,0.40360600430170734,0.31155375127514723
2025-08-28T12:10:00-04:00,508.76,509.01,508.58,508.98,506.8074928313668,NaN,NaN,NaN,NaN,NaN,506.97550000000126,508.7253322760351,505.22566772396743,507.65711460156984,507.4952117610802,508.47300426523884,506.5174192569216,29986,11590.166666666666,66.62257418337381,58.10803479080579,NaN,NaN,NaN,NaN,0.6411158981235004,27.405292727495716,12066982,0.12295102641346156,0.46524253429197415,0.3422915078785126
2025-08-28T12:15:00-04:00,508.95,509,508.77,508.77,506.9564704299411,NaN,NaN,NaN,NaN,NaN,507.0209000000012,508.8356172657651,505.20618273423725,507.80269168125585,507.5471785407082,508.5405791781161,506.55377790330033,17777,11100.166666666666,63.58571427003354,58.69763683475766,NaN,NaN,NaN,NaN,0.611750476828966,28.623335098284418,12049205,0.11935016725071917,0.49147921694191155,0.37212904969119237
2025-08-28T12:20:00-04:00,508.83,509,508.77,508.94,507.0127672285801,NaN,NaN,NaN,NaN,NaN,507.07250000000124,508.9545842154835,505.19041578451896,507.9271533450047,507.57924461166016,508.58222484850137,506.57626437481895,11196,10594.7,64.9774766506954,59.13780875072287,NaN,NaN,NaN,NaN,0.5844825856268984,29.75437444258821,12060401,0.1182930588398366,0.5199953732409881,0.4017023144011515
2025-08-28T12:25:00-04:00,508.96,509.2,508.84,508.95,507.1837778090992,NaN,NaN,NaN,NaN,NaN,507.12210000000124,509.06770025553885,505.1764997444636,508.16172267600376,507.67754878202186,508.70996146430747,506.64513609973625,35287,11344.666666666666,65.06206805878314,59.428035310243004,NaN,NaN,NaN,NaN,0.568448115224978,31.04531161047937,12095688,0.1084052994691071,0.5372089387375354,0.4288036392684283
2025-08-28T12:30:00-04:00,508.94,509.03,508.24,508.24,507.1837778090992,NaN,NaN,NaN,NaN,NaN,507.1597000000012,509.1175604736995,505.2018395263029,508.16172267600376,507.6931928930487,508.7219578519777,506.6644279341197,9825,11026,54.919490205597896,59.039948688142054,NaN,NaN,NaN,NaN,0.5842732498517627,30.513593633933635,12085863,0.047305196285477136,0.4879351346252747,0.4406299383397976
2025-08-28T12:35:00-04:00,508.27,508.37,507.79,507.91,507.1837778090992,NaN,NaN,NaN,NaN,NaN,507.1919000000011,509.14509726464684,505.2387027353554,508.16172267600376,507.69533687158656,508.7210987525345,506.66957499063864,3390,10575.333333333334,50.944313191141894,58.9555198075444,NaN,NaN,NaN,NaN,0.5839680177194928,28.987843697105,12082473,-0.0185479493405305,0.41744500166413445,0.43599295100466495
2025-08-28T12:40:00-04:00,507.901,508.04,507.7,507.79,507.1837778090992,NaN,NaN,NaN,NaN,NaN,507.2259000000011,509.16028330088454,505.29151669911766,508.16172267600376,507.6964684432413,508.71838265956706,506.6745542269156,4022,10327.666666666666,49.540081778310046,58.555449330075376,NaN,NaN,NaN,NaN,0.5665417307395313,27.379600211413756,12078451,-0.07048409524673005,0.3478878319462524,0.41837192719298244
2025-08-28T12:45:00-04:00,507.83,508.02,507.71,507.86,507.1837778090992,NaN,NaN,NaN,NaN,NaN,507.2617000000011,509.17533278468835,505.34806721531385,508.16172267600376,507.6977445975645,508.7158473856681,506.6796418094609,4054,10168.066666666668,50.39896707937343,58.29930905264723,NaN,NaN,NaN,NaN,0.5482173214009934,25.88623126041475,12082505,-0.09868875312094189,0.29501098579180507,0.39369973891274695
2025-08-28T12:50:00-04:00,507.86,508,507.68,507.76,507.1837778090992,NaN,NaN,NaN,NaN,NaN,507.3047000000011,509.1637883881356,505.44561161186664,508.16172267600376,507.6984399163937,508.71351526108924,506.6833645716981,3208,9972.633333333333,49.11287913922999,57.9657624430872,NaN,NaN,NaN,NaN,0.5319160841580649,24.428006317393134,12079297,-0.12116451049819488,0.24224410079000336,0.36340861128819824
2025-08-28T12:55:00-04:00,507.81,507.96,507.65,507.81,507.1837778090992,NaN,NaN,NaN,NaN,NaN,507.33810000000113,509.172126050711,505.5040739492913,508.16172267600376,507.69971580299756,508.70885765286357,506.69057395313155,6362,9784.3,49.80261814082395,57.64197430891041,NaN,NaN,NaN,NaN,0.5160649352896318,22.99840264748878,12085659,-0.1290224796889488,0.20213051167701224,0.33115299136596105
2025-08-28T13:00:00-04:00,507.8,507.98,507.53,507.91,507.1837778090992,NaN,NaN,NaN,NaN,NaN,507.37710000000106,509.17482087791865,505.5793791220835,508.16172267600376,507.70066200833094,508.70537986670087,506.695944149961,4817,9618.333333333334,51.22650493220334,57.241089215835366,NaN,NaN,NaN,NaN,0.5113460113403756,21.3621205537154,12090476,-0.12382142318769512,0.17637621238134216,0.3001976355690373
2025-08-28T13:05:00-04:00,507.89,508.05,507.79,507.96,507.1837778090992,NaN,NaN,NaN,NaN,NaN,507.41730000000115,509.1750226273104,505.6595773726919,508.16172267600376,507.70229484911476,508.7036694293904,506.7009202688391,3848,9502.233333333334,51.96025769890725,56.714761163232005,NaN,NaN,NaN,NaN,0.4933927248160624,20.02362776482216,12094324,-0.11361653947516503,0.15817696122508096,0.271793500700246
2025-08-28T13:10:00-04:00,507.94,507.96,507.7,507.75,507.1837778090992,NaN,NaN,NaN,NaN,NaN,507.44810000000115,509.17380088795943,505.72239911204286,508.16172267600376,507.7028676092793,508.70142870659106,506.7043065119675,3126,9135.166666666666,48.649850928358966,55.834457603018265,NaN,NaN,NaN,NaN,0.47672181590062873,18.654567869573988,12091198,-0.11714394819067991,0.1253635654618961,0.242507513652576
2025-08-28T13:15:00-04:00,507.81,507.86,507.52,507.55,507.1837778090992,NaN,NaN,NaN,NaN,NaN,507.4709000000012,509.1710713897126,505.77072861028984,507.804378140803,507.7024032517604,508.69707620807156,506.70773029544927,4335,8953.633333333333,45.665862631781266,54.462047063472426,NaN,NaN,NaN,NaN,0.466955971907729,17.865322797215715,12086863,-0.1281884077758091,0.08227200393281464,0.21046041170862373
2025-08-28T13:20:00-04:00,507.59,507.98,507.56,507.885,507.1837778090992,NaN,NaN,NaN,NaN,NaN,507.4956000000012,509.18318719903317,505.80801280096927,507.1066331066741,507.7032553615284,508.6939648167011,506.71254590635573,4507,8676.9,51.078566537889,53.35176080308065,NaN,NaN,NaN,NaN,0.46431625962860595,16.774346149224304,12091370,-0.10893082294139714,0.07429688303187731,0.18322770597327445
2025-08-28T13:25:00-04:00,507.82,508.62,507.82,508.6,507.1837778090992,NaN,NaN,NaN,NaN,NaN,507.5290000000012,509.2364753276222,505.8215246723802,507.4862369204937,507.71418933729143,508.69995870915267,506.7284199654302,9686,8755.833333333334,60.193293417188286,53.10944502787742,NaN,NaN,NaN,NaN,0.48829366965513493,16.938063786245,12101056,-0.047191030501034986,0.12423891784698071,0.1714299483480157
2025-08-28T13:30:00-04:00,508.65,509.03,508.63,508.65,507.23999221747846,NaN,NaN,NaN,NaN,NaN,507.5706000000012,509.2839320035313,505.85726799647114,507.90798953639495,507.7287978866299,508.7154621507215,506.74213362253823,7997,8772.4,60.74409868461071,52.8070608874428,NaN,NaN,NaN,NaN,0.48412983610833604,17.825018249797164,12109053,-0.00439190382471305,0.1659400685671244,0.17033197239183745
2025-08-28T13:35:00-04:00,508.67,508.84,508.28,508.415,507.23999221747846,NaN,NaN,NaN,NaN,NaN,507.6069000000012,509.3133324054605,505.90046759454185,507.90798953639495,507.733131232923,508.71877390017045,506.7474885656755,3217,8771.9,56.76824967895032,52.21464528888332,NaN,NaN,NaN,NaN,0.48954913352916934,17.68175050232747,12105836,0.006113955399017212,0.17797441664060898,0.17186046124159177
2025-08-28T13:40:00-04:00,508.36,508.39,508.01,508.195,507.23999221747846,NaN,NaN,NaN,NaN,NaN,507.58320000000117,509.22204808158017,505.94435191842217,507.90798953639495,507.739169535345,508.7198091845583,506.7585298861317,7643,8738.733333333334,53.25411452971409,52.095689883463045,NaN,NaN,NaN,NaN,0.4835099097056594,16.887047429267536,12098193,-0.0032283842764730952,0.1678249808960004,0.1710533651724735
2025-08-28T13:45:00-04:00,508.24,508.44,508.03,508.1,507.23999221747846,NaN,NaN,NaN,NaN,NaN,507.5770000000012,509.20560308067684,505.94839691932555,507.90798953639495,507.7426400392767,508.72029225204113,506.76498782651225,4568,8407.433333333332,51.76397751150581,52.15423733491762,NaN,NaN,NaN,NaN,0.4782592018695427,16.25390130036623,12093625,-0.016536883497227872,0.15038226080093864,0.1669191442981665
2025-08-28T13:50:00-04:00,508.13,508.65,508.12,508.65,507.23999221747846,NaN,NaN,NaN,NaN,NaN,507.5966000000011,509.2525667130291,505.9406332869731,507.90798953639495,507.74614486322236,508.7227552939706,506.76953443247413,2860,8047.2,58.92920400864566,52.82488892279873,NaN,NaN,NaN,NaN,0.48338354459314353,16.101588462063827,12096485,0.009566442901720373,0.17887719792531698,0.1693107550235966
2025-08-28T13:55:00-04:00,508.67,508.71,508.21,508.35,507.23999221747846,NaN,NaN,NaN,NaN,NaN,507.6316000000012,509.27576475888776,505.9874352411146,507.90798953639495,507.74912659293113,508.72461554651164,506.7736376393506,2637,7855.066666666667,54.199870594218055,53.09638203100191,NaN,NaN,NaN,NaN,0.48457043426506186,16.082799329715332,12093848,0.004737140458171224,0.17523218059631063,0.1704950401381394
2025-08-28T14:00:00-04:00,508.34,508.5,508.28,508.5,507.23999221747846,NaN,NaN,NaN,NaN,NaN,507.68400000000116,509.26740645270206,506.10059354730026,507.90798953639495,507.75211809896194,508.7264872080195,506.7777489899044,2656,7777.266666666666,56.097089139639664,53.595254173888314,NaN,NaN,NaN,NaN,0.4656725461032737,16.065352278248874,12096504,0.00948017735148271,0.18234526182749278,0.17286508447601007
2025-08-28T14:05:00-04:00,508.55,508.79,508.53,508.65,507.23999221747846,NaN,NaN,NaN,NaN,NaN,507.7232000000012,509.30327564197586,506.14312435802657,507.90798953639495,507.762065677914,508.7356433609537,506.7884879948743,6689,7654.733333333334,57.97197288262516,54.178779512588406,NaN,NaN,NaN,NaN,0.45312450709589847,16.65499182643834,12103193,0.01995272602077161,0.19780599200197457,0.17785326598120296
2025-08-28T14:10:00-04:00,508.64,508.65,508.32,508.32,507.23999221747846,NaN,NaN,NaN,NaN,NaN,507.76080000000115,509.3060344270591,506.2155655729432,507.90798953639495,507.76852016360147,508.7395832785474,506.79745704865553,5935,7718.933333333333,52.64538944471676,54.28012840633937,NaN,NaN,NaN,NaN,0.4443298994461903,16.55546735163586,12097258,0.002789478434791548,0.1813401140246924,0.17855063558990086
2025-08-28T14:15:00-04:00,508.39,508.76,508.22,508.68,507.23999221747846,NaN,NaN,NaN,NaN,NaN,507.7966000000012,509.34241815048256,506.25078184951985,507.90798953639495,507.77849804019297,508.7473665716638,506.80962950872214,7909,7873.833333333333,57.25907330528411,54.65861523536629,NaN,NaN,NaN,NaN,0.4511634780571741,16.70201871429468,12105167,0.013232205198334623,0.19509089208781916,0.18185868688948453
2025-08-28T14:20:00-04:00,508.7,509.09,508.7,509.06,507.4305176936053,NaN,NaN,NaN,NaN,NaN,507.83420000000115,509.4093753662884,506.2590246337139,508.05507300158615,507.79380163589144,508.7654691156545,506.82213415612836,8234,8036.5,61.52072739586433,55.57796355447381,NaN,NaN,NaN,NaN,0.4482232296245165,17.49577924365088,12113401,0.041676591278882874,0.23395442598808813,0.19227783470920526
2025-08-28T14:25:00-04:00,509.03,509.38,509.02,509.14,507.75299416207775,NaN,NaN,NaN,NaN,NaN,507.8908000000012,509.4460869299297,506.3355130700727,508.37205840126893,507.8072779927533,508.78372986348495,506.8308261220217,6188,8058.8,62.37136351042671,56.771213617234196,NaN,NaN,NaN,NaN,0.4419215703656234,18.731467066077183,12119589,0.06067267842168772,0.2681186827363149,0.20744600431462717
2025-08-28T14:30:00-04:00,509.17,509.71,509.17,509.56,507.98103988198335,NaN,NaN,NaN,NaN,NaN,507.9546000000012,509.5168123269053,506.3923876730971,508.6186467210151,507.82995324838504,508.8188660357615,506.84104046100856,8747,8143,66.55190329140828,57.87645195677128,NaN,NaN,NaN,NaN,0.4510700296252213,20.37236485721002,12128336,0.09431066894778062,0.32533434049935295,0.23102367155157233
2025-08-28T14:35:00-04:00,509.66,509.69,509.27,509.43,508.03008352371137,NaN,NaN,NaN,NaN,NaN,508.02280000000115,509.5382644946284,506.50733550537393,508.6186467210151,507.8380738282565,508.8311924221263,506.84495523438665,3224,7797.666666666667,64.17527974988184,58.160879551963674,NaN,NaN,NaN,NaN,0.44885074179484946,21.89605566326194,12125112,0.10004789361481398,0.3560835385700898,0.2560356449552758
2025-08-28T14:40:00-04:00,509.4,509.5,509.285,509.41,508.03008352371137,NaN,NaN,NaN,NaN,NaN,508.0876000000012,509.5570056466322,506.6181943533702,508.6186467210151,507.8524532652928,508.8521651108869,506.8527414196987,6032,6999.2,63.79781444225967,58.37900210608145,NaN,NaN,NaN,NaN,0.43214711738092987,23.31091141173872,12119080,0.09478861760447888,0.3745214169608744,0.2797327993563955
2025-08-28T14:45:00-04:00,509.39,509.41,509.14,509.22,508.03008352371137,NaN,NaN,NaN,NaN,NaN,508.1480000000012,509.54875122499817,506.74724877500427,508.6186467210151,507.86754553336954,508.8723575112173,506.8627335555218,7111,6643.666666666667,60.17667107416111,58.62246077716794,NaN,NaN,NaN,NaN,0.42056518042515195,24.068507048627392,12111969,0.07184760266395634,0.3695423026863409,0.2976947000223846
2025-08-28T14:50:00-04:00,509.2,509.27,508.96,509.18,508.03008352371137,NaN,NaN,NaN,NaN,NaN,508.1978000000012,509.5643008724264,506.8312991275761,508.6186467210151,507.87630643531185,508.8831427094682,506.8694701611555,4599,6423.766666666666,59.41212080105294,59.06231836797786,NaN,NaN,NaN,NaN,0.4126676675376412,24.117372373887207,12107370,0.04843551657843814,0.3582390957454322,0.3098035791669941
2025-08-28T14:55:00-04:00,509.18,509.63,509.09,509.58,508.03008352371137,NaN,NaN,NaN,NaN,NaN,508.26040000000125,509.5870888686628,506.9337111313397,508.6509293575422,507.8906583008389,508.90382936709443,506.8774872345833,6198,5454.133333333333,64.29713311291616,59.9575437680786,NaN,NaN,NaN,NaN,0.42176283414209687,24.85321299738545,12113568,0.05392485020467025,0.3772096419228319,0.32328479171816166
2025-08-28T15:00:00-04:00,509.57,509.91,509.57,509.62,508.3794516341627,NaN,NaN,NaN,NaN,NaN,508.3004000000012,509.66743158494455,506.9333684150579,508.9567434860338,507.9140996079723,508.9412705821288,506.8869286338157,8826,5420.833333333333,64.75397314635167,60.37359870648617,NaN,NaN,NaN,NaN,0.4159226317033779,25.99157010656718,12122394,0.05414400923745338,0.3909648032649784,0.336820794027525
2025-08-28T15:05:00-04:00,509.61,509.62,509.42,509.57,508.3794516341627,NaN,NaN,NaN,NaN,NaN,508.3518000000012,509.71263615262114,506.9909638473813,508.9567434860338,507.92904910805424,508.963163377078,506.8949348390305,6335,5519,63.657481784257705,61.04914236291757,NaN,NaN,NaN,NaN,0.4004995865817072,26.51489483787009,12116059,0.04518144136381391,0.3932975957322924,0.3481161543684785
2025-08-28T15:10:00-04:00,509.535,509.76,509.535,509.61,508.3794516341627,NaN,NaN,NaN,NaN,NaN,508.3992000000012,509.7669154069345,507.0314845930679,508.9574158310616,507.94011206525784,508.97992352371455,506.9003006068011,4488,5534.533333333334,64.18004460222332,61.62649632453069,NaN,NaN,NaN,NaN,0.38796390182586854,27.242052253199073,12120547,0.036574389662204665,0.3938341414462343,0.35725975178402963
2025-08-28T15:15:00-04:00,509.61,509.96,509.6,509.84,508.49344774455113,NaN,NaN,NaN,NaN,NaN,508.4498000000013,509.83960856015455,507.05999143984803,509.1379326648493,507.96165474825193,509.01440702647164,506.9089024700322,8110,5669.733333333334,67.10863053810701,62.279114728493674,NaN,NaN,NaN,NaN,0.38596648026687486,28.24410844492372,12128657,0.04068336017546559,0.40811395200336165,0.36743059182789606
2025-08-28T15:20:00-04:00,509.84,510,509.52,509.52,508.49344774455113,NaN,NaN,NaN,NaN,NaN,508.48440000000124,509.8927957377959,507.0760042622066,509.1379326648493,507.99276196232546,509.0608018967723,506.9247220278786,12909,5993.1,59.784916411867016,62.78908094043298,NaN,NaN,NaN,NaN,0.39268316024781363,28.869885958853263,12115748,0.01735464733168446,0.3891239009925016,0.37176925366081714
2025-08-28T15:25:00-04:00,509.54,509.71,509.51,509.71,508.49344774455113,NaN,NaN,NaN,NaN,NaN,508.5164000000013,509.96154226084155,507.071257739161,509.1379326648493,508.01069591267094,509.0866117054521,506.93478011988975,7833,6042.133333333333,62.40813897830468,63.15687134564873,NaN,NaN,NaN,NaN,0.37892007737296896,29.411346959208856,12123581,0.010558909587426613,0.3849678906451004,0.3744089810576738
2025-08-28T15:30:00-04:00,509.7,509.75,509.57,509.73,508.49344774455113,NaN,NaN,NaN,NaN,NaN,508.5500000000013,510.0279526358392,507.07204736416344,509.1379326648493,508.02709247182474,509.1103300976689,506.9438548459806,7137,6119.466666666666,62.684070619830756,63.23996729021777,NaN,NaN,NaN,NaN,0.36471150041775735,29.991937054565053,12130718,0.0036088954007107987,0.37892010030856227,0.37531120490785147
2025-08-28T15:35:00-04:00,509.72,510,509.71,509.87,508.64214172020377,NaN,NaN,NaN,NaN,NaN,508.60300000000126,510.0764272951403,507.1295727048622,509.25940121952226,508.0560695918854,509.1547623076455,506.95737687612524,11695,6381.033333333334,64.64063805611752,63.40205832919569,NaN,NaN,NaN,NaN,0.3593749646736333,30.99252776661345,12142413,0.004576409212229071,0.3810317164231378,0.37645530721090875
2025-08-28T15:40:00-04:00,509.91,510.36,509.85,510.31,508.87772618746726,NaN,NaN,NaN,NaN,NaN,508.65720000000124,510.1776817111851,507.1367182888174,509.51252097561786,508.1053953326047,509.23721066085255,506.97358000435685,17645,6865,69.96989576906901,63.64620064902859,NaN,NaN,NaN,NaN,0.37013389576837313,32.4745703904479,12160058,0.029590626095292172,0.41344358983002394,0.38385296373473177
2025-08-28T15:45:00-04:00,510.31,510.5,510.16,510.18,509.1121477244006,NaN,NaN,NaN,NaN,NaN,508.71120000000127,510.2522549094762,507.1701450905263,509.65201678049425,508.14740547047256,509.307512962096,506.98729797884914,14920,7217.833333333333,66.7680081672913,63.83139553598642,NaN,NaN,NaN,NaN,0.367981474642059,34.03938865836317,12145138,0.031922052619990204,0.4237555295097195,0.3918334768897293
2025-08-28T15:50:00-04:00,510.19,510.9,510,510.87,509.16477737329143,NaN,NaN,NaN,NaN,NaN,508.7794000000013,510.3930413956194,507.16575860438326,509.7716134243954,508.31835340915717,509.59897505247926,507.0377317658351,58119,9004.9,73.65819260453361,64.53570826186312,NaN,NaN,NaN,NaN,0.4059827978819103,35.962020410657495,12203257,0.07217185587121572,0.48204829672874894,0.4098764408575332
2025-08-28T15:55:00-04:00,510.84,510.84,509.1,509.57,NaN,NaN,NaN,511.4381670527673,511.4381670527673,511.4381670527673,508.82040000000126,510.4079236546074,507.23287634539514,509.7716134243954,508.47016169750054,509.7676455232303,507.17267787177076,92255,11757.2,51.84708346173093,63.940737718118115,NaN,NaN,NaN,NaN,0.503412598033201,34.77169818121744,12111002,0.006916556601945734,0.4185221366099654,0.41160558000801967
2025-08-29T09:30:00-04:00,508.97,509.6,507.37,508.23,NaN,NaN,NaN,510.1905230958233,NaN,NaN,508.82920000000126,510.3985531896686,507.25984681033395,509.7716134243954,508.40000000000003,508.40000539479666,508.3999946052034,41307,12867.533333333333,39.02084095002655,62.484217728759084,NaN,NaN,NaN,NaN,0.6267402696022594,33.88237840682382,12069695,-0.12361497712094371,0.25708685860684,0.3807018357277837
2025-08-29T09:35:00-04:00,508.07,508.2,506.99,507.2,NaN,NaN,NaN,509.3920902278314,NaN,NaN,508.8118000000013,510.43287712147685,507.1907228785258,509.7716134243954,508.1027464881838,508.5387141541377,507.6667788222299,19203,13400.4,32.38829443671894,60.205014966173565,NaN,NaN,NaN,NaN,0.6705445360592416,33.479558225419,12050492,-0.2681524919766102,0.045511220757020965,0.31366371273363114
2025-08-29T09:40:00-04:00,507.19,507.56,506,506.22,NaN,NaN,NaN,508.70813158111173,NaN,NaN,508.7710000000012,510.54138639683276,507.00061360316965,509.7716134243954,507.68754078262714,508.45702475988867,506.9180568053656,22961,13911,27.584142804956045,57.55002708464531,NaN,NaN,NaN,NaN,0.7340770691978673,34.008615577170346,12027531,-0.4100897321379441,-0.198948452438799,0.2111412796991451
2025-08-29T09:45:00-04:00,506.2,506.21,505.37,506.09,NaN,NaN,NaN,507.7463983274248,NaN,NaN,508.71790000000124,510.64090711234496,506.7948928876575,509.7716134243954,507.31726372797095,508.31657360651366,506.31795384942825,21655,14480.566666666668,27.011764011887948,54.93247581519032,NaN,NaN,NaN,NaN,0.7423572785408784,34.95481012766252,12005876,-0.48777689412993075,-0.39857983796326835,0.0891970561666624
2025-08-29T09:50:00-04:00,505.94,506.23,505.58,505.59,NaN,NaN,NaN,507.7463983274248,NaN,NaN,508.6501000000013,510.761207281468,506.53899271853464,509.7716134243954,507.1188023305167,508.1816898537996,506.0559148072338,15820,14912.566666666668,24.87390369498324,52.12489432181603,NaN,NaN,NaN,NaN,0.7357603300736753,35.79481800784585,11990056,-0.5436216558564023,-0.5903300136538405,-0.04670835779743818
2025-08-29T09:55:00-04:00,505.605,505.74,504.7,504.85,NaN,NaN,NaN,507.2290116991619,NaN,NaN,508.5717000000013,510.9352351560892,506.2081648439133,509.7716134243954,506.80934826807845,508.0287087115451,505.5899878246118,21853,15553.1,22.087640700801657,48.90910933343707,NaN,NaN,NaN,NaN,0.7574917350684142,37.13864948266351,11968203,-0.5969257651644202,-0.7928655642529634,-0.19593979908854323
2025-08-29T10:00:00-04:00,504.79,505.73,504.66,505.09,NaN,NaN,NaN,507.2290116991619,NaN,NaN,508.4947000000013,511.04842465897786,505.9409753410247,509.7716134243954,506.5950097687984,507.860394199111,505.32962533848576,21329,16175.533333333333,25.021108850140706,46.42598022188519,NaN,NaN,NaN,NaN,0.7798137539920983,38.40983494149263,11989532,-0.5819413281606036,-0.9233664592892978,-0.34142513112869416
2025-08-29T10:05:00-04:00,505.06,505.16,504.49,504.815,NaN,NaN,NaN,506.8861656184513,NaN,NaN,508.4120000000013,511.16168798121566,505.6623120187869,509.7716134243954,506.38599207415615,507.7048711120879,505.0671130362244,21930,16683.566666666666,23.910234369487654,43.67612989268398,NaN,NaN,NaN,NaN,0.7719699144212352,39.69290317229287,11967602,-0.5564801971104263,-1.037025377516727,-0.48054518040630073
2025-08-29T10:10:00-04:00,504.88,505.58,504.67,505.57,NaN,NaN,NaN,506.8861656184513,NaN,NaN,508.3586000000012,511.22097107207054,505.4962289279319,509.0522907395163,506.2660971827924,507.5587824196888,504.97341194589603,22470,17234.733333333334,32.739372184234924,41.537222861569994,NaN,NaN,NaN,NaN,0.7818292062482876,40.01050052572155,11990072,-0.458786667095724,-1.0540285142759558,-0.5952418471802318
2025-08-29T10:15:00-04:00,505.47,506,505.29,505.98,NaN,NaN,NaN,506.8861656184513,NaN,NaN,508.32000000000124,511.25661846247743,505.38338153752505,507.0548325916131,506.21732878296416,507.4556868335529,504.97897073237544,22076,17706.966666666667,37.013625423042754,39.56386481635036,NaN,NaN,NaN,NaN,0.7766985486591228,39.50539479956503,12012148,-0.34191195145815645,-1.0226317865029273,-0.6807198350447708
2025-08-29T10:20:00-04:00,505.98,506.38,505.5,505.5,NaN,NaN,NaN,506.8861656184513,NaN,NaN,508.2742000000012,511.31213637758515,505.23626362241725,505.5438660732904,506.1894884594088,507.3910979198702,504.98787899894734,16206,17972.7,34.268065158955494,37.01373405848511,NaN,NaN,NaN,NaN,0.7840772237548995,38.36803537897063,11995942,-0.2751600402922223,-1.0246698854100487,-0.7495098451178264
2025-08-29T10:25:00-04:00,505.48,506.13,505.19,506.12,NaN,NaN,NaN,506.8861656184513,NaN,NaN,508.23940000000124,511.33483769991176,505.1439623000907,504.6550928586324,506.1754729900167,507.35663458053244,504.994311399501,9552,18084.833333333332,40.41606274474463,35.13145224258892,NaN,NaN,NaN,NaN,0.7952145649152637,37.62977875970003,12005494,-0.1724968018242533,-0.965130847398143,-0.7926340455738897
2025-08-29T10:30:00-04:00,506.05,506.53,505.83,506.33,NaN,NaN,NaN,506.8861656184513,NaN,NaN,508.21080000000126,511.3495483865149,505.0720516134876,504.3717197403477,506.17735307594864,507.33801551643825,505.01669063545904,9155,18098.433333333334,42.38181654031235,32.897425380858834,NaN,NaN,NaN,NaN,0.7884135245641726,36.259625394614986,12014649,-0.07847890278617442,-0.8907326740566077,-0.8122537712704333
2025-08-29T10:35:00-04:00,506.35,506.91,506.27,506.87,504.45256460948207,504.45256460948207,504.45256460948207,NaN,NaN,NaN,508.1920000000012,511.35131891299767,505.03268108700473,504.8633757922782,506.19357761632386,507.3389538209154,505.04820141173235,8796,18284.166666666668,47.20518405296852,32.565861137375805,NaN,NaN,NaN,NaN,0.7778125585238777,34.38544637374021,12023445,0.026430389714413804,-0.7792157841274161,-0.8056461738418299
2025-08-29T10:40:00-04:00,506.85,506.99,506.23,506.23,504.46608439996015,NaN,NaN,NaN,NaN,NaN,508.1584000000012,511.3643902922694,504.95240970773307,504.97270063382257,506.20098742978394,507.33254847493816,505.0694263846297,7199,18323.066666666666,42.64834327029957,32.82496844596674,NaN,NaN,NaN,NaN,0.7765402329150286,32.5203955827457,12016246,0.05730159465935625,-0.7340191805176346,-0.7913207751769908
2025-08-29T10:45:00-04:00,506.22,506.585,505.83,505.9,504.46608439996015,NaN,NaN,NaN,NaN,NaN,508.11720000000116,511.3846859807106,504.84971401929175,504.97270063382257,506.1989941051382,507.3188278782178,505.07916033205856,5970,18285.033333333333,40.47855285642648,33.40284404737442,NaN,NaN,NaN,NaN,0.7750016448496692,31.30445741402727,12010276,0.05980171496340103,-0.7165686314727395,-0.7763703464361406
2025-08-29T10:50:00-04:00,505.91,506.59,505.65,506.56,504.46608439996015,NaN,NaN,NaN,NaN,NaN,508.0934000000012,511.388457170068,504.7983428299344,504.97270063382257,506.20059778351333,507.30713118392373,505.09406438310293,6978,18364.333333333332,46.35676506002722,34.743745637022364,NaN,NaN,NaN,NaN,0.7867872416461212,30.397230534666893,12017254,0.10743151559064645,-0.6420809519478325,-0.749512467538479
2025-08-29T10:55:00-04:00,506.52,506.88,506.26,506.84,504.46608439996015,NaN,NaN,NaN,NaN,NaN,508.0792000000012,511.389585692663,504.7688143073394,504.97270063382257,506.2103210261491,507.30707703813766,505.1135650141605,6367,18369.966666666667,48.67266235525931,36.290952661548886,NaN,NaN,NaN,NaN,0.7748738672428271,29.04692345797401,12023621,0.15635532227794235,-0.554068314691051,-0.7104236369689934
2025-08-29T11:00:00-04:00,506.8,507.1,506.65,506.74,504.7467023478103,NaN,NaN,NaN,NaN,NaN,508.0563000000012,511.3875182807597,504.7250817192427,505.3066341796137,506.23265013629333,507.3156406572081,505.14965961537854,11245,18450.6,47.877668123509046,37.93407869215787,NaN,NaN,NaN,NaN,0.7516685910111999,27.421226619636407,12012376,0.17891844244773814,-0.48677558390932063,-0.6656940263570588
2025-08-29T11:05:00-04:00,506.7,507.27,506.46,507.26,504.7467023478103,NaN,NaN,NaN,NaN,NaN,508.0295000000011,511.36434947104294,504.6946505289593,505.4303073436909,506.2532536482903,507.32868668498656,505.17782061159403,8649,18527.733333333334,52.24564090028931,40.088221563549844,NaN,NaN,NaN,NaN,0.7558351202246857,26.19023870879502,12021025,0.22293555920172126,-0.38702457735490725,-0.6099601365566285
2025-08-29T11:10:00-04:00,507.29,507.51,507.19,507.33,505.2617163954222,NaN,NaN,NaN,NaN,NaN,508.00310000000115,511.3387821722684,504.6674178277339,505.87824587495277,506.28578585969797,507.3611669294291,505.21040478996684,9866,18707,52.818838148635365,42.073773656299466,NaN,NaN,NaN,NaN,0.7247040402086362,24.625462300601217,12030891,0.2488661114340447,-0.29887749726407264,-0.5477436086981173
2025-08-29T11:15:00-04:00,507.34,507.65,507.27,507.58,505.4148201956302,NaN,NaN,NaN,NaN,NaN,507.98640000000114,511.32202710063666,504.6507728993656,506.1545966999622,506.3193600656493,507.39829781915853,505.24042231214,9401,18750.033333333333,54.90086323138003,44.28739000357749,NaN,NaN,NaN,NaN,0.7000823230508761,22.929891232545145,12040292,0.27302099630174226,-0.2064673633209395,-0.47948835962268177
2025-08-29T11:20:00-04:00,507.56,507.9,507.25,507.86,505.5341465503743,NaN,NaN,NaN,NaN,NaN,507.9797000000011,511.3149699492691,504.64443005073315,506.37867735996974,506.3604057391542,507.44782602989665,505.27298544841176,10656,18674.933333333334,57.179981601111436,46.033147819068674,NaN,NaN,NaN,NaN,0.6965050142615262,21.653335932992597,12050948,0.29608894812436404,-0.10937717446722672,-0.40546612259159076
2025-08-29T11:25:00-04:00,507.85,508.35,507.7,508.12,505.98827625263004,NaN,NaN,NaN,NaN,NaN,507.98010000000113,511.31543236041495,504.6447676395873,506.80794188797586,506.41471085087915,507.5254730974788,505.30394860427947,11597,18800.4,59.23982720412379,47.62073366057446,NaN,NaN,NaN,NaN,0.6931832275285625,21.163253106956954,12062545,0.3153151713374086,-0.011322158419829975,-0.3266373297572386
2025-08-29T11:30:00-04:00,508.12,508.17,507.48,507.63,505.98827625263004,NaN,NaN,NaN,NaN,NaN,507.9597000000011,511.2908682087024,504.62853179129974,506.80794188797586,506.4397962563619,507.5551008181242,505.3244916945996,6883,18791.933333333334,53.97053859093725,49.028053191430295,NaN,NaN,NaN,NaN,0.692955854133665,20.288240320723975,12055662,0.28254368817354586,0.026542280459693757,-0.2560014077138521
2025-08-29T11:35:00-04:00,507.64,508.01,507.4,507.99,505.98827625263004,NaN,NaN,NaN,NaN,NaN,507.9525000000012,511.2818183978541,504.62318160214824,506.80794188797586,506.4715495911684,507.59273138707596,505.35036779526087,8823,18696.2,56.996953914994414,50.21240256073385,NaN,NaN,NaN,NaN,0.6870304359812612,19.322768208335813,12064485,0.2725000253423095,0.08462362396403478,-0.18787640137827472
2025-08-29T11:40:00-04:00,507.99,508.2,507.76,507.83,505.98827625263004,NaN,NaN,NaN,NaN,NaN,507.93910000000113,511.26488753898667,504.6133124610156,506.80794188797586,506.52188376586275,507.6552599657039,505.3885075660216,13510,18558.366666666665,55.25799266806081,51.1321294270016,NaN,NaN,NaN,NaN,0.6693854048397424,18.745108092733158,12050975,0.24342195752251353,0.11640104552486719,-0.12702091199764634
2025-08-29T11:45:00-04:00,507.81,507.91,507.57,507.72,505.98827625263004,NaN,NaN,NaN,NaN,NaN,507.92050000000114,511.24057364294083,504.60042635706145,506.80794188797586,506.53217831947023,507.6661938819854,505.39816275695506,3355,18172.866666666665,54.03734686799026,51.620141056646005,NaN,NaN,NaN,NaN,0.6458578759226202,17.81909930255033,12047620,0.20657388908834887,0.13119644936278974,-0.07537743972555913
2025-08-29T11:50:00-04:00,507.67,507.73,507.415,507.435,505.98827625263004,NaN,NaN,NaN,NaN,NaN,507.9028000000011,511.2236018059846,504.5819981940176,506.80794188797586,506.5553989806664,507.686114553612,505.42468340772075,9439,16550.2,50.90009077253044,52.209551592519645,NaN,NaN,NaN,NaN,0.6222251704995757,16.647173067678565,12038181,0.1551484565880305,0.11855813100947898,-0.036590325578551505
2025-08-29T11:55:00-04:00,507.47,507.51,507.15,507.29,505.98827625263004,NaN,NaN,NaN,NaN,NaN,507.87500000000114,511.19258225136787,504.5574177486344,506.80794188797586,506.57389787418236,507.6969250236294,505.45087072473535,10068,13810.633333333333,49.33087523236253,52.84186033365793,NaN,NaN,NaN,NaN,0.6034948011781784,15.86912959601015,12028113,0.10586287906824653,0.09573827325675666,-0.01012460581148987
2025-08-29T12:00:00-04:00,507.28,507.95,507.265,507.8,505.98827625263004,NaN,NaN,NaN,NaN,NaN,507.8498000000011,511.1500914772325,504.5495085227697,506.80794188797586,506.5969806459083,507.71924517953227,505.4747161122843,8899,12730.366666666667,54.62907723977173,53.43273977506825,NaN,NaN,NaN,NaN,0.6093166010940231,15.172028335065063,12037012,0.10206143949385955,0.11745219355583458,0.015390754061975025
2025-08-29T12:05:00-04:00,507.79,507.79,507.44,507.72,505.98827625263004,NaN,NaN,NaN,NaN,NaN,507.82140000000106,511.10116769829966,504.54163230170246,506.80794188797586,506.6093051747893,507.7307162687021,505.4878940808765,5012,12257.333333333334,53.68085737749157,53.790467990941984,NaN,NaN,NaN,NaN,0.591508272444451,14.524720021330337,12032000,0.08908281383559752,0.12674427135647193,0.03766145752087441
2025-08-29T12:10:00-04:00,507.69,508.04,507.67,507.98,506.0471847555505,NaN,NaN,NaN,NaN,NaN,507.78980000000115,511.03218736650894,504.54741263349337,506.89293465256014,506.639814431462,507.7650279277825,505.5146009351415,10395,11838.466666666667,56.333631677755534,54.39446538767388,NaN,NaN,NaN,NaN,0.5756862529841335,14.385302438952637,12042395,0.0925274346804557,0.15332075087144403,0.060793316190988336
2025-08-29T12:15:00-04:00,507.96,508.015,507.66,507.69,506.0634490848436,NaN,NaN,NaN,NaN,NaN,507.7550000000012,510.9633964833645,504.5466035166379,506.91984772204813,506.64649430367655,507.77182491595113,505.52116369140197,2566,11202.166666666666,52.70767209914697,54.42746761616371,NaN,NaN,NaN,NaN,0.5599229491995498,14.23206998938177,12039829,0.07077465170592066,0.14926163082338917,0.0784869791174685
2025-08-29T12:20:00-04:00,507.7,507.97,507.63,507.91,506.0634490848436,NaN,NaN,NaN,NaN,NaN,507.72500000000116,510.89880024490697,504.55119975509535,506.9238781776385,506.65051096904875,507.77605952827116,505.52496240982634,1494,10724.633333333333,55.070314291396016,54.588287340646616,NaN,NaN,NaN,NaN,0.5442141671138699,14.013928409749562,12041323,0.06675463980001498,0.16193027886748723,0.09517563906747226
2025-08-29T12:25:00-04:00,507.92,507.98,507.38,507.45,506.0634490848436,NaN,NaN,NaN,NaN,NaN,507.6896000000012,510.83527057308646,504.5439294269159,506.9238781776385,506.6803408775938,507.8004885919865,505.56019316320106,14307,10473.1,49.50169915061177,54.20263276344889,NaN,NaN,NaN,NaN,0.5481988694628809,13.189840051772524,12027016,0.030511762202779222,0.1333153418209463,0.10280357961816707
2025-08-29T12:30:00-04:00,507.4,507.96,507.34,507.9,506.0634490848436,NaN,NaN,NaN,NaN,NaN,507.6640000000012,510.7814444652937,504.54655553470866,506.9238781776385,506.7014508088859,507.8200926532714,505.58280896450043,9349,10073.766666666666,54.36333994062827,54.00144407341437,NaN,NaN,NaN,NaN,0.553327521644104,12.327216294376523,12036365,0.033976659779149126,0.14527440434210348,0.11129774456295435
2025-08-29T12:35:00-04:00,507.89,508.44,507.83,508.37,506.38341243754473,NaN,NaN,NaN,NaN,NaN,507.6398000000012,510.71588644779473,504.5637135522076,507.1593856269509,506.72201026221353,507.846734073421,505.5972864510061,6429,9557.066666666668,58.822342914088544,53.971623766983285,NaN,NaN,NaN,NaN,0.5573755558123833,12.56259398266842,12042794,0.06334689950638756,0.1904813689459388,0.12713446943955126
2025-08-29T12:40:00-04:00,508.37,508.42,508.15,508.24,506.5762118722017,NaN,NaN,NaN,NaN,NaN,507.61220000000117,510.64112466634066,504.5832753336617,507.2605085015607,506.7380629226639,507.86787583802993,505.6082500072979,4954,8973.2,57.158788161182336,54.19935587914365,NaN,NaN,NaN,NaN,0.5368487303972158,12.781158978939464,12037840,0.06897949063706138,0.21335883273587797,0.1443793420988166
2025-08-29T12:45:00-04:00,508.26,508.45,508.06,508.1,506.5762118722017,NaN,NaN,NaN,NaN,NaN,507.58280000000116,510.56329067003645,504.60230932996586,507.32740680124857,506.77510471373336,507.9140130678167,505.63619635965,12390,8650.333333333334,55.34355992320605,54.081256308301626,NaN,NaN,NaN,NaN,0.5263595353688423,12.728750831736551,12025450,0.058643118917108744,0.2176832407452025,0.15904012182809377
2025-08-29T12:50:00-04:00,508.14,508.25,508,508.25,506.5762118722017,NaN,NaN,NaN,NaN,NaN,507.55560000000116,510.4859949485012,504.62520505150115,507.32740680124857,506.7927041632421,507.93502123982364,505.65038708666054,6278,8319.4,56.92208262426214,54.20011987660172,NaN,NaN,NaN,NaN,0.5066195685567821,12.506276939690036,12031728,0.05721302331510689,0.23055640097197738,0.1733433776568705
2025-08-29T12:55:00-04:00,508.25,508.81,508.22,508.67,506.86734439786443,NaN,NaN,NaN,NaN,NaN,507.5322000000012,510.4074211452576,504.65697885474475,507.6965403527991,506.82376372785376,507.9796942485058,505.66783320720174,8846,8295.866666666667,61.07141362680018,54.70255321651671,NaN,NaN,NaN,NaN,0.5125753136598673,13.456457563189641,12040574,0.07854054619278353,0.2715190603978499,0.19297851420506637
2025-08-29T13:00:00-04:00,508.63,508.64,507.9,507.9,506.86734439786443,NaN,NaN,NaN,NaN,NaN,507.4998000000012,510.32068848311343,504.67891151688895,507.6965403527991,506.8451931496083,508.0038219833703,505.6865643158463,8319,8268,51.31304372409137,54.73204985591393,NaN,NaN,NaN,NaN,0.5309627912555939,13.446332529836624,12032255,0.03689204971894908,0.23909357635375272,0.20220152663480365
2025-08-29T13:05:00-04:00,507.97,508.37,507.97,508.06,506.86734439786443,NaN,NaN,NaN,NaN,NaN,507.4668000000012,510.2213168422539,504.71228315774846,507.6965403527991,506.85688988988227,508.01670081232714,505.6970789674374,4706,8131.666666666667,52.993813627425965,54.99368831270417,NaN,NaN,NaN,NaN,0.5266083061659106,13.436930713151678,12036961,0.01722103027648686,0.22372781448041223,0.20650678420392538
2025-08-29T13:10:00-04:00,508.05,508.07,507.5,507.51,506.86734439786443,NaN,NaN,NaN,NaN,NaN,507.42240000000123,510.1000596038215,504.744740396181,507.6965403527991,506.8653998580315,508.02234471562946,505.7084550004335,5327,8069.266666666666,46.98875850026678,54.447951259882394,NaN,NaN,NaN,NaN,0.5297077128683451,12.69719810050249,12031634,-0.032993536515210614,0.1652648635599121,0.19825840007512271
2025-08-29T13:15:00-04:00,507.55,507.89,507.34,507.76,506.86734439786443,NaN,NaN,NaN,NaN,NaN,507.3802000000012,509.9672051863628,504.7931948136396,507.6965403527991,506.8770013300334,508.0294694282752,505.7245332317916,7725,8127.766666666666,49.77472658379897,54.16894191747578,NaN,NaN,NaN,NaN,0.5311571619491784,12.359024118516096,12039359,-0.04859054649390682,0.1375202169577392,0.186110763451646
2025-08-29T13:20:00-04:00,507.79,508.22,507.79,508.06,506.86734439786443,NaN,NaN,NaN,NaN,NaN,507.3352000000012,509.7917764458373,504.8786235541651,507.6965403527991,506.88904836442833,508.0413891765344,505.7367075523223,5643,8083.266666666666,52.96890507195049,53.92860430277541,NaN,NaN,NaN,NaN,0.5260745075242397,11.683464432145875,12045002,-0.03837069060467249,0.1381474001958054,0.1765180908004779
2025-08-29T13:25:00-04:00,508.12,508.32,508.04,508.095,506.86734439786443,NaN,NaN,NaN,NaN,NaN,507.29350000000113,509.6229988719943,504.96400112800796,507.6965403527991,506.9027549057354,508.05626802097544,505.7492417904953,5893,8067.466666666666,53.34172321500335,53.97389366819373,NaN,NaN,NaN,NaN,0.508497756986792,11.276673923940242,12050895,-0.029329291424625065,0.13985647651969657,0.16918576794432164
2025-08-29T13:30:00-04:00,508.08,508.21,507.65,507.88,506.86734439786443,NaN,NaN,NaN,NaN,NaN,507.23370000000114,509.33524020530837,505.1321597946939,507.6965403527991,506.92103071543954,508.07197143292916,505.7700899979499,9998,8025.9,50.68383613298756,53.66057379973598,NaN,NaN,NaN,NaN,0.5121764886305927,10.93531313500268,12040897,-0.03738805973116083,0.12245069328037061,0.15983875301153144
2025-08-29T13:35:00-04:00,507.84,508.31,507.65,508.19,506.86734439786443,NaN,NaN,NaN,NaN,NaN,507.2061000000011,509.2185415904229,505.19365840957926,507.6965403527991,506.9384088464306,508.0888832964148,505.7879343964464,8643,8025.7,54.22545209081308,53.99798472403607,NaN,NaN,NaN,NaN,0.5227353108712665,10.378675604680158,12049540,-0.022152939326648247,0.13214757885322115,0.1543005181798694
2025-08-29T13:40:00-04:00,508.22,508.25,507.81,507.87,506.86734439786443,NaN,NaN,NaN,NaN,NaN,507.1989000000012,509.1991762695197,505.19862373048267,507.6965403527991,506.94428879562236,508.0941435320305,505.7944340592142,3198,7803.433333333333,50.216493841994264,53.7017814312765,NaN,NaN,NaN,NaN,0.516825645809033,9.8617978979521,12046342,-0.03327094811748138,0.11271183303301768,0.14598278115049906
2025-08-29T13:45:00-04:00,507.94,508.22,507.93,508.14,506.86734439786443,NaN,NaN,NaN,NaN,NaN,507.2177000000011,509.2352591279363,505.20014087206596,507.36423228223924,506.95231782062376,508.10216212393016,505.80247351731737,3962,7622.133333333333,53.35032398072897,53.310922936036526,NaN,NaN,NaN,NaN,0.5049095282512466,9.381840027418905,12050304,-0.02259551047731495,0.11773839305385536,0.1403339035311703
2025-08-29T13:50:00-04:00,508.2,508.94,508.19,508.81,506.9327548984918,NaN,NaN,NaN,NaN,NaN,507.26950000000113,509.3147415491762,505.2242584508261,507.5953712526931,506.9776443707657,508.13723463075075,505.8180541107806,8629,7554.566666666667,60.067837176860785,53.518712151442124,NaN,NaN,NaN,NaN,0.5259874190904441,10.113720118067498,12058933,0.026758578361183227,0.17378212648264935,0.14702354812146612
2025-08-29T13:55:00-04:00,508.86,508.92,508.5,508.65,507.09467513037856,NaN,NaN,NaN,NaN,NaN,507.32070000000107,509.37342794954225,505.2679720504599,507.6342970021545,506.9953517236886,508.16186463685426,505.82883881052294,6032,7369.066666666667,57.92277864544272,53.702942060173314,NaN,NaN,NaN,NaN,0.5184168891554135,10.793323059384049,12052901,0.04473882436868823,0.2029470785823264,0.15820825421363818
2025-08-29T14:00:00-04:00,508.65,508.68,508.4,508.4,507.09467513037856,NaN,NaN,NaN,NaN,NaN,507.3769000000011,509.39050958345496,505.3632904165473,507.6342970021545,507.00820910447,508.17789609714765,505.8385221117923,5050,7307.966666666666,54.639494037182935,53.539900018239095,NaN,NaN,NaN,NaN,0.5013871113586004,11.13095400788772,12047851,0.03626644072134766,0.20354130511532276,0.1672748643939751
2025-08-29T14:05:00-04:00,508.42,508.88,508.3,508.81,507.09467513037856,NaN,NaN,NaN,NaN,NaN,507.4561000000012,509.3752188484159,505.5369811515865,507.65515008137885,507.0207802831218,508.19484366879857,505.846716897445,4503,7163.966666666666,58.76738790839717,53.375326752638884,NaN,NaN,NaN,NaN,0.5070023176901277,11.860042218320913,12052354,0.053695197195008065,0.23439386088773517,0.1806986636927271
2025-08-29T14:10:00-04:00,508.79,508.88,508.64,508.86,507.21207328910924,NaN,NaN,NaN,NaN,NaN,507.53150000000113,509.3672769457142,505.69572305428807,507.78012006510306,507.03933895695866,508.221093796758,505.8575841171593,6273,6922.733333333334,59.25435837680121,53.94256351354672,NaN,NaN,NaN,NaN,0.4879307235694049,12.537052699437451,12058627,0.06334790110387012,0.25988354007256476,0.19653563896869464
2025-08-29T14:15:00-04:00,508.85,508.9,508.71,508.74,507.3015245032406,NaN,NaN,NaN,NaN,NaN,507.61000000000115,509.3046728281094,505.9153271718929,507.92509605208244,507.06082364564713,508.2509277235114,505.8707195677829,7473,7060,57.49918747875845,54.264375931499046,NaN,NaN,NaN,NaN,0.4666499576001616,13.210227151326581,12051154,0.056627329693426376,0.2673198010854776,0.21069247139205122
2025-08-29T14:20:00-04:00,508.73,509,508.5,508.78,507.3015245032406,NaN,NaN,NaN,NaN,NaN,507.6742000000011,509.2965481237231,506.05185187627916,507.97007684166596,507.09073552481414,508.291296027027,505.8901750226013,10870,7107.7,57.946350853671454,55.047061099599375,NaN,NaN,NaN,NaN,0.4690321034858643,13.118945504838415,12062024,0.05007837104641291,0.27329043520006735,0.22321206415365444
2025-08-29T14:25:00-04:00,508.81,508.83,508.59,508.7,507.3015245032406,NaN,NaN,NaN,NaN,NaN,507.72860000000117,509.30172814303285,506.1554718569695,507.97007684166596,507.1072687306815,508.3126905410437,505.90184692031926,6383,6984.866666666667,56.66231258592828,55.539031528322894,NaN,NaN,NaN,NaN,0.45267266752258895,13.034183975956545,12055641,0.03620802479312221,0.2684720951450572,0.232264070351935
2025-08-29T14:30:00-04:00,508.71,509.01,508.64,508.72,507.3735474666145,NaN,NaN,NaN,NaN,NaN,507.7930000000012,509.2556824653206,506.3303175346818,508.06984917866623,507.1391549289867,508.35494566739686,505.9233641905766,12050,7089.9,56.91932792136006,55.821204588995,NaN,NaN,NaN,NaN,0.4467674769852615,13.430844898569061,12067691,0.024775122066531957,0.26323297293509995,0.238457850868568
2025-08-29T14:35:00-04:00,508.725,508.79,508.5,508.59,507.3735474666145,NaN,NaN,NaN,NaN,NaN,507.84240000000113,509.241178379375,506.44362162062725,508.06984917866623,507.16023425356343,508.380116175924,505.94035233120286,9141,7227.533333333334,54.65058062445035,55.9146944039555,NaN,NaN,NaN,NaN,0.43556980005774426,13.294932466084669,12058550,0.00584017628687189,0.24575807122715787,0.23991789494028598
2025-08-29T14:40:00-04:00,508.59,508.77,508.4,508.6,507.3735474666145,NaN,NaN,NaN,NaN,NaN,507.88780000000116,509.23363232034484,506.5419676796575,508.06984917866623,507.1749169337684,508.3970491945281,505.95278467300864,6693,7104.133333333333,54.79982836888859,56.20869384937701,NaN,NaN,NaN,NaN,0.43088624291076283,12.819913374494357,12065243,-0.007883141602049504,0.2300639679377241,0.2379471095397736
2025-08-29T14:45:00-04:00,508.57,508.57,508.04,508.05,507.3735474666145,NaN,NaN,NaN,NaN,NaN,507.91140000000115,509.22603613009477,506.59676386990753,508.06984917866623,507.1866606336992,508.40688957954285,505.96643168785556,7407,7265.5,45.86020176337107,55.61117596884544,NaN,NaN,NaN,NaN,0.4401086541314228,12.535042479166222,12057836,-0.05334043755818724,0.17127156259203957,0.2246120001502268
2025-08-29T14:50:00-04:00,508.04,508.22,507.66,508.12,507.3735474666145,NaN,NaN,NaN,NaN,NaN,507.94920000000116,509.17388993401784,506.7245100659845,508.06984917866623,507.19162623422113,508.4097733308691,505.9734791375732,4049,7350.666666666667,47.04426051458009,55.38458787403014,NaN,NaN,NaN,NaN,0.44867232169346416,13.192662816676584,12061885,-0.07661650439514162,0.12884136965629978,0.2054578740514414
2025-08-29T14:55:00-04:00,508.12,508.41,508.1,508.41,507.3735474666145,NaN,NaN,NaN,NaN,NaN,507.9994000000012,509.08145108686915,506.9173489131332,508.06984917866623,507.20718988055677,508.4238584074064,505.99052135370715,9388,7186.7,51.75208052872326,55.2704276274583,NaN,NaN,NaN,NaN,0.4387671558582169,13.187232103555349,12071273,-0.07055512610514358,0.11726396642001191,0.1878190925251555
2025-08-29T15:00:00-04:00,508.45,508.63,508.44,508.5,507.3735474666145,NaN,NaN,NaN,NaN,NaN,508.0382000000012,509.04771029443947,507.02868970556295,508.06984917866623,507.21403621698636,508.43122397414277,505.99684845982995,3517,6992.3,53.14427115885857,54.775887197601,NaN,NaN,NaN,NaN,0.42314093043977075,12.526330549405094,12074790,-0.05902607639559018,0.11403649703066776,0.17306257342625794
2025-08-29T15:05:00-04:00,508.5,508.75,508.46,508.72,507.3735474666145,NaN,NaN,NaN,NaN,NaN,508.07580000000127,509.0431621008918,507.10843789911075,508.06984917866623,507.2247493991137,508.44361722398025,506.00588157424716,5106,6948.2,56.45216482954304,54.67084335360817,NaN,NaN,NaN,NaN,0.4136308639797886,11.688425392480442,12079896,-0.036243539339154,0.12775814925231543,0.16400168859146944
2025-08-29T15:10:00-04:00,508.7,508.79,508.53,508.74,507.3735474666145,NaN,NaN,NaN,NaN,NaN,508.11580000000123,509.02240544573186,507.2091945542706,508.06984917866623,507.23256405651426,508.4528347755846,506.0122933374439,3661,6905.1,56.75108557213997,54.82167132039081,NaN,NaN,NaN,NaN,0.40265723083837857,11.024278462032907,12083557,-0.020282759074894213,0.13864823974785168,0.1589309988227459
2025-08-29T15:15:00-04:00,508.73,508.93,508.7,508.93,507.51567306277417,NaN,NaN,NaN,NaN,NaN,508.1492000000012,509.0502623920785,507.2481376079239,508.1439320975832,507.26538598320826,508.49462371544143,506.0361482509751,14156,6963.966666666666,59.588988229731775,54.880357057629,NaN,NaN,NaN,NaN,0.3903245714927814,10.80588014768952,12097713,0.0014608170757762218,0.16075702016746618,0.15929620309168996
2025-08-29T15:20:00-04:00,508.95,509,508.74,508.85,507.59427883264806,NaN,NaN,NaN,NaN,NaN,508.17960000000124,509.0705654056981,507.28863459430437,508.2411456780666,507.2834844561112,508.51738245278915,506.0495864594332,8008,7021.633333333333,57.867215063412694,54.781275392386966,NaN,NaN,NaN,NaN,0.3810156735290106,10.799268353994993,12089705,0.008455004736920957,0.16986495901284115,0.1614099542759202
2025-08-29T15:25:00-04:00,508.88,508.92,508.58,508.71,507.59427883264806,NaN,NaN,NaN,NaN,NaN,508.2022000000012,509.0884960196138,507.3159039803886,508.2411456780666,507.30437205630335,508.5415209757827,506.067223136824,10311,7070.466666666666,54.87882385060394,54.594106561804495,NaN,NaN,NaN,NaN,0.37808598256265497,10.251945388172325,12079394,0.0019895840663290143,0.16389693435883146,0.16190735029250244
2025-08-29T15:30:00-04:00,508.69,509,508.68,508.73,507.59427883264806,NaN,NaN,NaN,NaN,NaN,508.21960000000115,509.11247588981104,507.32672411019126,508.2411456780666,507.32934361427726,508.5710552054414,506.08763202311314,12153,7198.266666666666,55.23448391914717,54.40040178076705,NaN,NaN,NaN,NaN,0.3739369838081791,9.98960802161332,12091547,-0.0023668387692911963,0.15894880183088844,0.16131564060017964
2025-08-29T15:35:00-04:00,508.71,508.74,508.17,508.425,507.59427883264806,NaN,NaN,NaN,NaN,NaN,508.2257000000012,509.1199371242369,507.3314628757655,508.2411456780666,507.3433023823189,508.5834374022757,506.10316736236206,9243,7349.5,48.90378451914352,53.84622120456813,NaN,NaN,NaN,NaN,0.38794148496473724,10.299269947552107,12082304,-0.025908357972707907,0.12893019313429477,0.15483855110700268
2025-08-29T15:40:00-04:00,508.48,508.82,508.45,508.69,507.59427883264806,NaN,NaN,NaN,NaN,NaN,508.2469000000012,509.1338721271488,507.3599278728536,508.2411456780666,507.3619525066374,508.6029700830745,506.1209349302003,10669,7527.566666666667,53.8527861339669,53.62718250546862,NaN,NaN,NaN,NaN,0.3884456646101118,10.324922663414846,12092973,-0.02380551980064438,0.1250816513561972,0.14888717115684158
2025-08-29T15:45:00-04:00,508.68,508.92,508.19,508.25,507.59427883264806,NaN,NaN,NaN,NaN,NaN,508.2521000000012,509.1360300618806,507.36816993812175,508.2411456780666,507.3768737877921,508.6158775432467,506.13787003233745,10388,7616.333333333333,45.902906830364216,53.0023486630339,NaN,NaN,NaN,NaN,0.412842402852248,10.992763205787416,12082585,-0.05067672488757874,0.08554126504736814,0.13621798993494688
2025-08-29T15:50:00-04:00,508.29,508.38,506.35,506.63,NaN,NaN,NaN,508.89150675362515,508.89150675362515,508.89150675362515,508.2281000000011,509.2156583803247,507.2405416196775,508.2411456780666,507.365289596341,508.5772063796867,506.15337281299526,35883,8624.333333333334,28.954830615210057,51.15627739491401,NaN,NaN,NaN,NaN,0.5283536597913712,14.1073014262122,12046702,-0.16948900679353626,-0.07564326855697345,0.09384573823656281
2025-08-29T15:55:00-04:00,506.645,506.87,505.28,506.79,NaN,NaN,NaN,507.74893826482395,NaN,NaN,508.2095000000011,509.26717906032087,507.1518209396814,508.2411456780666,507.1798812635771,508.3505819999648,506.0091805271894,170247,14102.8,31.639406567593994,50.140506309501355,NaN,NaN,NaN,NaN,0.604185541234847,17.693402194313297,12216949,-0.2257180969834361,-0.18830188299273232,0.03741621399070377
2025-09-02T09:30:00-04:00,500.635,501.85,496.82,501.73,NaN,NaN,NaN,502.29239561642294,NaN,NaN,508.0954000000011,510.18760824840416,506.0031917515981,508.2411456780666,500.1333333333334,500.1333333333334,500.1333333333334,102370,17181.866666666665,13.834856236290477,47.76840600390924,NaN,NaN,NaN,NaN,1.273172288289503,22.669202744710816,12114579,-0.5723873811488439,-0.6780680124453511,-0.1056806312965072
2025-09-02T09:35:00-04:00,501.69,502.83,501.38,502.3,499.0843041843236,499.0843041843236,499.0843041843236,NaN,NaN,NaN,507.99560000000116,510.6361557283555,505.3550442716468,508.2411456780666,500.7250580304753,501.64972437533356,499.800391685617,41922,18291.166666666668,19.34120163849606,45.45334322603587,NaN,NaN,NaN,NaN,1.2858028391259662,26.292031095071533,12156501,-0.722327941499521,-1.0085905581709085,-0.28626261667138747
2025-09-02T09:40:00-04:00,502.32,502.93,500.72,501.16,499.0843041843236,NaN,NaN,NaN,NaN,NaN,507.86280000000113,511.12423597737774,504.6013640226245,508.2183332339626,500.88803429513234,501.78965835838653,499.98641023187815,32876,19280.433333333334,17.00115298214449,42.871691927699146,NaN,NaN,NaN,NaN,1.3518169220455385,29.753579106185867,12123625,-0.8485844907309279,-1.3469932300850473,-0.49840873935411945
2025-09-02T09:45:00-04:00,500.97,503.44,500.97,503.2,499.0843041843236,NaN,NaN,NaN,NaN,NaN,507.7724000000012,511.2855155623143,504.2592844376881,508.2183332339626,501.100280095928,502.10682689256,500.093733299296,26179,20021,32.694101816832784,41.17468742679127,NaN,NaN,NaN,NaN,1.4316871418994264,32.45690443932137,12149804,-0.7485035170429677,-1.4340381356578291,-0.6855346186148614
2025-09-02T09:50:00-04:00,503.09,504.35,502.99,503.29,500.2612252114032,NaN,NaN,NaN,NaN,NaN,507.67860000000115,511.40830403039195,503.94889596961036,507.89423326973605,501.3189081625495,502.50583400913337,500.1319823159657,19986,20399.566666666666,33.29333896376011,39.49913409762128,NaN,NaN,NaN,NaN,1.426566631763754,34.09413523062991,12169790,-0.6345434324147204,-1.478713909133262,-0.8441704767185415
2025-09-02T09:55:00-04:00,503.29,504.09,503.19,503.46,500.26344224724846,NaN,NaN,NaN,NaN,NaN,507.5940000000012,511.5062602155585,503.6817397844439,507.89423326973605,501.52754232798856,502.8340699490886,500.2210147068885,22702,20955.233333333334,34.47995680486322,37.705631852987814,NaN,NaN,NaN,NaN,1.3889547294949127,35.61442096541639,12192492,-0.5113064999356571,-1.483303601638113,-0.9719971017024558
2025-09-02T10:00:00-04:00,503.61,504.36,503.09,503.49,500.32874032691905,NaN,NaN,NaN,NaN,NaN,507.50560000000115,511.58162239373576,503.42957760626655,507.81438661578886,501.6817577493452,503.0550052906569,500.3085102080335,19310,21430.566666666666,34.700710075322036,36.050881496695624,NaN,NaN,NaN,NaN,1.3804579631024219,36.754434638663,12211802,-0.3964844045805538,-1.467602607428148,-1.0711182028475943
2025-09-02T10:05:00-04:00,503.49,503.53,502.43,502.98,500.32874032691905,NaN,NaN,NaN,NaN,NaN,507.41620000000114,511.6847156945126,503.1476843054897,506.4805092926311,501.7927120858062,503.1551998148528,500.43022435675965,24797,22107.033333333333,32.68461963075883,34.46558119527812,NaN,NaN,NaN,NaN,1.3604252514522466,38.02242256563903,12187005,-0.3265136003881528,-1.4792602033327853,-1.1527466029446325
2025-09-02T10:10:00-04:00,502.985,503.87,502.85,503.67,500.32874032691905,NaN,NaN,NaN,NaN,NaN,507.33160000000106,511.72427501128266,502.93892498871946,504.55540743410484,501.9127537182293,503.29446215497484,500.5310452814837,22462,22646.666666666668,37.9382472255983,33.230135717167485,NaN,NaN,NaN,NaN,1.3361091620627992,38.84122317606306,12209467,-0.21099731463634663,-1.4164932462400657,-1.205495931603719
2025-09-02T10:15:00-04:00,503.61,504.55,503.49,504.25,500.65214680386896,NaN,NaN,NaN,NaN,NaN,507.24920000000105,511.71483247868736,502.78356752131475,500.93301678956794,502.02307834906674,503.45186917791204,500.5942875202214,16632,22951.966666666667,42.033543437305184,32.73940421132189,NaN,NaN,NaN,NaN,1.3163870790583136,38.90311353697749,12226099,-0.07952859544592639,-1.304906675911127,-1.2253780804652006
2025-09-02T10:20:00-04:00,504.31,505.02,503.74,503.78,500.9906855855113,NaN,NaN,NaN,NaN,NaN,507.160000000001,511.72008113907077,502.5999188609312,501.48641343165434,502.1106273755579,503.57341683791117,500.6478379132046,13929,23053.933333333334,39.74480481205842,31.731691259756992,NaN,NaN,NaN,NaN,1.313788001982718,38.49727744047207,12212170,-0.01178029278043291,-1.2401034464407417,-1.2283231536603088
2025-09-02T10:25:00-04:00,503.81,505.34,503.57,505.34,500.9906855855113,NaN,NaN,NaN,NaN,NaN,507.104800000001,511.68480609551295,502.524793904489,501.62813074532346,502.17993338421974,503.68382411539307,500.6760426530464,9254,23149.633333333335,49.56166038418054,31.9930307993153,NaN,NaN,NaN,NaN,1.3463745732696655,37.80715870929575,12221424,0.14205451652237278,-1.050755008007343,-1.1928095245297157
2025-09-02T10:30:00-04:00,505.29,505.4,504.56,505.27,501.54686434547625,NaN,NaN,NaN,NaN,NaN,507.045200000001,511.6415733350227,502.44882666497926,502.0105045962588,502.24433256018705,503.7915255864685,500.6971395339056,8013,23015.066666666666,49.174513205774225,33.43729384149845,NaN,NaN,NaN,NaN,1.3102049608932589,37.10556399176158,12213411,0.23743584250838223,-0.8960147213942378,-1.13345056390262
2025-09-02T10:35:00-04:00,505.19,505.39,504.55,504.64,501.57837051159095,NaN,NaN,NaN,NaN,NaN,506.9646000000009,511.5854509341124,502.3437490658895,502.25840367700704,502.30590460400066,503.8853721210631,500.72643708693823,8689,23000,45.71350991818501,34.44258693796924,NaN,NaN,NaN,NaN,1.2766188922580244,36.46017290584795,12204722,0.2549005548140084,-0.8148248703851095,-1.069725425199118
2025-09-02T10:40:00-04:00,504.59,504.6,503.5,503.635,501.57837051159095,NaN,NaN,NaN,NaN,NaN,506.87930000000085,511.5846225219447,502.173977478057,502.25840367700704,502.3574465337396,503.93692411111806,500.7779689563612,12241,23184.933333333334,40.782397622901954,36.3674113227272,NaN,NaN,NaN,NaN,1.2668603999538788,36.467470457989165,12192481,0.19810052022507518,-0.8220997749177741,-1.0202002951428493
2025-09-02T10:45:00-04:00,503.67,503.68,503.1,503.21,501.57837051159095,NaN,NaN,NaN,NaN,NaN,506.78230000000093,511.5852158680059,501.97938413199597,502.25840367700704,502.3823067026773,503.94900356904907,500.8156098363055,10004,23271.5,38.87275039782609,37.76252194839363,NaN,NaN,NaN,NaN,1.217798942814315,36.68358366297365,12182477,0.13429306655767126,-0.8523339619457602,-0.9866270285034314
2025-09-02T10:50:00-04:00,503.23,503.34,502.7,502.7,501.57837051159095,NaN,NaN,NaN,NaN,NaN,506.68610000000086,511.61781705954013,501.7543829404616,502.25840367700704,502.4018339785762,503.94269973000297,500.8609682271494,14941,23634.566666666666,36.65467794119361,39.16634515975428,NaN,NaN,NaN,NaN,1.1765275897561485,37.08909409234601,12167536,0.06370780803839327,-0.9069922684554399,-0.9707000764938332
2025-09-02T10:55:00-04:00,502.69,503.22,502.66,502.88,501.57837051159095,NaN,NaN,NaN,NaN,NaN,506.58850000000086,511.62341618554234,501.5535838144594,502.25840367700704,502.4185172794632,503.9371317080218,500.89990285090454,13517,23772.2,37.99934191901704,39.54529088133887,NaN,NaN,NaN,NaN,1.1324899047735666,37.486546347401855,12181053,0.03646353368687216,-0.925120659385243,-0.9615841930721152
2025-09-02T11:00:00-04:00,502.92,503.25,502.18,502.29,501.57837051159095,NaN,NaN,NaN,NaN,NaN,506.4731000000008,511.6308180570287,501.31538194297286,502.25840367700704,502.42532499191594,503.91051437525493,500.94013560857695,19310,24298.633333333335,35.350483362007225,39.692229766927944,NaN,NaN,NaN,NaN,1.1280263401468829,38.10786403945133,12161743,-0.011409970470763975,-0.9758466561605701,-0.9644366856898061
2025-09-02T11:05:00-04:00,502.26,502.29,501.38,501.6,NaN,NaN,NaN,504.9983015655937,504.9983015655937,504.9983015655937,506.3432000000008,511.65581546091954,501.0305845390821,502.25840367700704,502.4039433728655,503.86992191509535,500.9379648306357,14506,24611.966666666667,32.497408391811334,39.55061916599567,NaN,NaN,NaN,NaN,1.112453030136393,39.06739514311025,12147237,-0.07605962877218975,-1.0595112216550433,-0.9834515928828536
2025-09-02T11:10:00-04:00,501.62,501.67,501.27,501.61,NaN,NaN,NaN,504.5440605853394,NaN,NaN,506.21780000000086,511.67346647033423,500.7621335296675,502.25840367700704,502.38464892551036,503.84036414649376,500.92893370452697,10084,24826.066666666666,32.58233174767925,39.3993064283069,NaN,NaN,NaN,NaN,1.061563527983796,40.008661793463965,12157321,-0.10298949361461274,-1.1121884599011196,-1.0091989662865068
2025-09-02T11:15:00-04:00,501.63,502,500.775,500.95,NaN,NaN,NaN,504.4888760132785,NaN,NaN,506.0730000000009,511.6934305880841,500.4525694119177,502.25840367700704,502.3532682417011,503.8009592821101,500.90557720129203,13091,24790.566666666666,29.907958106008977,39.20097346225334,NaN,NaN,NaN,NaN,1.073237561699241,41.107001304100585,12144230,-0.14738871552546984,-1.193434860693344,-1.0460461451678742
2025-09-02T11:20:00-04:00,500.96,501.15,500.52,501.09,NaN,NaN,NaN,503.8813134672204,NaN,NaN,505.9374000000009,511.70314166569534,500.1716583343064,502.25840367700704,502.3253189539474,503.7724602447225,500.87817766317227,9483,24839.733333333334,31.198017361042687,38.71952847192794,NaN,NaN,NaN,NaN,1.0415777358635805,42.23905331209773,12153713,-0.14901985167983045,-1.2323209597676623,-1.0833011080878319
2025-09-02T11:25:00-04:00,501.06,501.16,500.75,501.05,NaN,NaN,NaN,503.8813134672204,NaN,NaN,505.79560000000083,511.68509629049436,499.9061037095073,501.52472294160566,502.29732418602003,503.7420088645755,500.8526395074646,10387,24842.266666666666,31.022333427266744,37.933013471210906,NaN,NaN,NaN,NaN,0.996465040444755,43.27360427039366,12143326,-0.13490680648659947,-1.2519346161960812,-1.1170278097094817
2025-09-02T11:30:00-04:00,501.01,501.14,500.75,500.92,NaN,NaN,NaN,503.82721950215745,NaN,NaN,505.6378000000009,511.6178796512643,499.6577203487375,500.9297783532845,502.2641846794112,503.7065003150345,500.8218690437879,12399,24850.466666666667,30.422720288360637,37.26715029094678,NaN,NaN,NaN,NaN,0.9531461089844144,44.234258731668454,12130927,-0.11710155243264508,-1.263404750250288,-1.146303197817643
2025-09-02T11:35:00-04:00,500.92,501,500.43,500.48,NaN,NaN,NaN,503.54393679751394,NaN,NaN,505.4744000000009,511.5618394087484,499.3869605912534,500.92385814610213,502.2383976054233,503.68360264697037,500.79319256387623,8196,24815.566666666666,28.420454590780764,35.757064162846795,NaN,NaN,NaN,NaN,0.9257785297712414,45.2876835951802,12122731,-0.11743205189236638,-1.2930932626831009,-1.1756612107907345
2025-09-02T11:40:00-04:00,500.48,501.14,500.45,500.83,NaN,NaN,NaN,503.54393679751394,NaN,NaN,505.323000000001,511.48791167778825,499.15808832221376,500.92385814610213,502.21133237363136,503.65603036764685,500.7666343796159,9967,24792.166666666668,32.24071134315396,34.54750688694535,NaN,NaN,NaN,NaN,0.9089372062161526,45.993235509019,12132698,-0.07842875916239889,-1.2736971597437332,-1.1952684005813343
2025-09-02T11:45:00-04:00,500.8,500.955,500.56,500.75,NaN,NaN,NaN,503.4787833217017,NaN,NaN,505.16180000000094,511.37488675581375,498.9487132441881,500.8780865168817,502.1953619537304,503.64009977323644,500.7506241342244,5846,24640.766666666666,31.822643754839007,33.55530216099206,NaN,NaN,NaN,NaN,0.8722274057721403,46.64839085758361,12126852,-0.0440792649998738,-1.2503674818311765,-1.2062882168313027
2025-09-02T11:50:00-04:00,500.69,500.69,500.29,500.66,NaN,NaN,NaN,503.15031589798804,NaN,NaN,504.99780000000095,511.24456113158817,498.75103886841373,499.9374692135054,502.1594305191112,503.6084738838105,500.7103871544119,11877,23840.566666666666,31.330439262109266,32.8801622780783,NaN,NaN,NaN,NaN,0.8427825910741288,47.41995110688685,12114975,-0.014985049941146578,-1.225019529257736,-1.2100344793165894
2025-09-02T11:55:00-04:00,500.65,501.09,500.43,500.67,NaN,NaN,NaN,503.15031589798804,NaN,NaN,504.83640000000094,511.1050432467583,498.56775675324354,499.7218802966434,502.13671279283324,503.5852683995292,500.6881571861373,8801,18459.033333333333,31.45729576218973,32.35048694696142,NaN,NaN,NaN,NaN,0.8297266917116888,47.2907564787322,12123776,0.015706011499445838,-1.1904019649422821,-1.206107976441728
2025-09-02T12:00:00-04:00,500.71,501.11,500.66,500.72,NaN,NaN,NaN,503.15031589798804,NaN,NaN,504.6752000000009,510.94443981318693,498.4059601868149,499.7218802966434,502.12618918904406,503.5736197307201,500.678758647368,4496,15196.566666666668,32.13239199778121,32.027466522431965,NaN,NaN,NaN,NaN,0.8026033565894244,47.12884904686351,12128272,0.048305978536336,-1.1457255032713078,-1.1940314818076438
2025-09-02T12:05:00-04:00,500.68,501.25,500.66,500.93,NaN,NaN,NaN,503.15031589798804,NaN,NaN,504.5198000000009,510.76743730024987,498.2721626997519,499.81520577832276,502.10912299655945,503.55293084026835,500.66531515285055,8196,14072.366666666667,35.026882511303256,31.815147993309548,NaN,NaN,NaN,NaN,0.787417402547321,46.672900834972396,12136468,0.09049419359283961,-1.0809137398165944,-1.171407933409434
2025-09-02T12:10:00-04:00,500.94,501.2,500.87,501,NaN,NaN,NaN,503.15031589798804,NaN,NaN,504.3654000000009,510.5716387446462,498.15916125535557,499.88716462265825,502.1009013668312,503.54230899428944,500.6594937393729,4322,13120.566666666668,36.00661631067048,31.862014632499783,NaN,NaN,NaN,NaN,0.754744730936797,46.249520352502074,12140790,0.12733983330006748,-1.0122331417843498,-1.1395729750844172
2025-09-02T12:15:00-04:00,500.99,501.45,500.99,501.45,NaN,NaN,NaN,503.15031589798804,NaN,NaN,504.2226000000008,510.3616566829006,498.083543317101,500.1697316981266,502.092993693039,503.5294909598298,500.65649642624817,5668,12436.866666666667,42.05563278382499,32.54474494621505,NaN,NaN,NaN,NaN,0.7336915358698813,45.27751052737314,12146458,0.1828658199756641,-0.9109907001148372,-1.0938565200905013
2025-09-02T12:20:00-04:00,501.43,501.67,501.34,501.37,NaN,NaN,NaN,503.15031589798804,NaN,NaN,504.0780000000008,510.13790395928135,498.0180960407203,500.4807853585013,502.0829245103178,503.51014970629797,500.65569931433765,9318,12081.266666666666,41.308071553570116,33.16801207520725,NaN,NaN,NaN,NaN,0.7048564261648927,43.88467897603207,12137140,0.2129493722416813,-0.8276698047883997,-1.040619177030081
2025-09-02T12:25:00-04:00,501.35,501.4,500.9,501,NaN,NaN,NaN,503.15031589798804,NaN,NaN,503.93700000000086,509.9485468887633,497.9254531112384,500.4807853585013,502.0754145455018,503.49975079481106,500.65107829619257,4510,11474.866666666667,37.94828866339528,33.74232140073484,NaN,NaN,NaN,NaN,0.6902238242959718,43.122950613271776,12132630,0.20651659279943735,-0.7824734360307843,-0.9889900288302217
2025-09-02T12:30:00-04:00,500.98,501.2,500.91,501.08,NaN,NaN,NaN,503.15031589798804,NaN,NaN,503.7962000000009,509.7386400910249,497.85375990897694,500.4807853585013,502.0622787436132,503.4819705288706,500.6425869583558,7762,11089.933333333332,39.10162231280003,34.30686461157465,NaN,NaN,NaN,NaN,0.6616364082748284,42.415631419280075,12140392,0.20578055663834693,-0.731764333032288,-0.937544889670635
2025-09-02T12:35:00-04:00,501.03,501.25,500.81,500.83,NaN,NaN,NaN,503.15031589798804,NaN,NaN,503.6446000000009,509.4945196025026,497.7946803974992,500.4807853585013,502.05131601411983,503.4681243256582,500.63450770258146,6026,10464.233333333334,36.799752275946595,34.719537386480354,NaN,NaN,NaN,NaN,0.6458052362551977,41.88166216019359,12134366,0.1871248684598542,-0.7036388040958172,-0.8907636725556715
2025-09-02T12:40:00-04:00,500.85,501.53,500.83,501.24,NaN,NaN,NaN,503.15031589798804,NaN,NaN,503.4994000000009,509.2189981113801,497.7798018886217,500.4807853585013,502.041473018782,503.45300384981306,500.629942187751,7066,9951.033333333333,42.751923972215955,35.60019479247002,NaN,NaN,NaN,NaN,0.6496762908083971,40.6913557975016,12141432,0.19990861425260964,-0.6408779047399094,-0.840786518992519
2025-09-02T12:45:00-04:00,501.25,501.45,500.84,500.99,NaN,NaN,NaN,503.15031589798804,NaN,NaN,503.3448000000008,508.90731668185714,497.7822833181445,500.4807853585013,502.0328181398101,503.44078229591986,500.62485398370035,5630,9584.3,40.261963483121406,36.44601685620864,NaN,NaN,NaN,NaN,0.6468422700363696,39.58607131785904,12135802,0.1891525528080047,-0.6043458279825131,-0.7934983807905178
2025-09-02T12:50:00-04:00,500.98,501.51,500.98,501.32,NaN,NaN,NaN,503.15031589798804,NaN,NaN,503.1964000000009,508.56788323609607,497.8249167639057,500.4807853585013,502.0272184811194,503.4315158835562,500.6229210786826,4561,9272.033333333333,44.82969715764033,37.34523012867195,NaN,NaN,NaN,NaN,0.6384963936051984,38.402396588883775,12140363,0.200789174828089,-0.5425119122554065,-0.7433010870834955
2025-09-02T12:55:00-04:00,501.35,501.78,501.28,501.53,NaN,NaN,NaN,503.15031589798804,NaN,NaN,503.0484000000008,508.1823491384433,497.9144508615583,500.49104201361513,502.0210741853442,503.4177485212029,500.62439984948554,7774,9222.7,47.576730745211286,38.47052205655569,NaN,NaN,NaN,NaN,0.62860379406197,36.61303645331534,12148137,0.2177353272675424,-0.47113192799906756,-0.68886725526661
2025-09-02T13:00:00-04:00,501.59,501.77,501.35,501.36,NaN,NaN,NaN,503.15031589798804,NaN,NaN,502.8986000000009,507.777436352627,498.0197636473748,500.52883361089215,502.01137945167505,503.3969792060103,500.6257796973398,11773,9348.033333333333,45.59742349734476,39.4895923590725,NaN,NaN,NaN,NaN,0.6137035230575406,34.9514877560018,12136364,0.21237407009322895,-0.42339966765007375,-0.6357737377433027
2025-09-02T13:05:00-04:00,501.37,501.5,501.1,501.1,NaN,NaN,NaN,503.15031589798804,NaN,NaN,502.74640000000085,507.3580582869891,498.1347417130126,500.52883361089215,502.00641194993426,503.3889709065314,500.6238529933371,4118,9195.666666666666,42.673374056673296,40.29074080867848,NaN,NaN,NaN,NaN,0.5984389856962861,33.89009759602692,12132246,0.18708437349127638,-0.4019182708792073,-0.5890026443704837
2025-09-02T13:10:00-04:00,501.09,501.12,500.3,500.5,NaN,NaN,NaN,502.77507864215335,NaN,NaN,502.5818000000009,506.90597009793396,498.25762990206783,500.52883361089215,501.9780673464369,503.36000261353985,500.5961320793339,13663,9243.066666666668,36.80737673564667,40.62466828995458,NaN,NaN,NaN,NaN,0.6142647724322651,34.11119232994312,12118583,0.1285052359907033,-0.4283710993821046,-0.5568763353728079
2025-09-02T13:15:00-04:00,500.47,500.9,500.47,500.76,NaN,NaN,NaN,502.7148477947827,NaN,NaN,502.42850000000084,506.4457778091609,498.41122219084076,500.52883361089215,501.959644849214,503.3398701432728,500.5794195551552,9710,9233.266666666666,40.61676724173984,41.023945770700045,NaN,NaN,NaN,NaN,0.601103002972814,34.31649458286531,12128293,0.10672203850022177,-0.4234737872475307,-0.5301958257477525
2025-09-02T13:20:00-04:00,500.88,501.56,500.77,501.43,NaN,NaN,NaN,502.7148477947827,NaN,NaN,502.2833000000008,505.8884960329867,498.67810396701486,500.52883361089215,501.9490011003208,503.32148741433707,500.57651478630453,10226,9076.1,49.1273552162507,41.96114140681293,NaN,NaN,NaN,NaN,0.6153099313318996,32.86089911787075,12138519,0.1350657356115893,-0.36136365623326583,-0.49642939184485513
2025-09-02T13:25:00-04:00,501.47,502.21,501.47,501.88,NaN,NaN,NaN,502.7148477947827,NaN,NaN,502.15590000000077,505.33354169725567,498.97825830274587,500.66385459761716,501.9474910305891,503.3091544517818,500.5858276093964,10883,8988.3,53.905579018457516,42.8075661378581,NaN,NaN,NaN,NaN,0.6270735076653333,30.750452847802194,12149402,0.17899444752938426,-0.2726863324331248,-0.45168077996250905
2025-09-02T13:30:00-04:00,501.99,502.81,501.89,502.76,500.25681250681043,500.25681250681043,500.25681250681043,NaN,NaN,NaN,502.07850000000076,504.9941873968851,499.16281260311644,501.10808367809375,501.9580244194132,503.3083848351271,500.60766400369937,13738,8802.566666666668,61.51758808065387,44.2511030326498,NaN,NaN,NaN,NaN,0.6487111142606672,29.694296480041704,12163140,0.2574223600173075,-0.12990282994087465,-0.38732518995818216
2025-09-02T13:35:00-04:00,502.76,503.06,502.62,502.84,500.7819573928645,NaN,NaN,NaN,NaN,NaN,501.99950000000075,504.59696048985677,499.40203951014473,501.478466942475,501.97426168341707,503.317377515311,500.6311458515231,13189,8758.666666666666,62.12985375649185,45.9783576821567,NaN,NaN,NaN,NaN,0.6338031775277623,29.04643108937129,12176329,0.30172153360959364,-0.010173272946190082,-0.3118948065557837
2025-09-02T13:40:00-04:00,502.78,502.93,502.61,502.61,500.7819573928645,NaN,NaN,NaN,NaN,NaN,502.01710000000077,504.6189394178843,499.41526058211724,501.50477355398,501.98428339367,503.3210512300555,500.6475155572845,9803,8749.3,59.21298354124898,47.41488348418876,NaN,NaN,NaN,NaN,0.6113886648472073,28.4243099017497,12166526,0.3018360787744535,0.06540029191228314,-0.23643578686217034
2025-09-02T13:45:00-04:00,502.58,502.68,502.331,502.67,500.7819573928645,NaN,NaN,NaN,NaN,NaN,502.0245000000008,504.6316150715315,499.4173849284701,501.50477355398,501.99132350954227,503.32140440891243,500.6612426101721,8985,8612.433333333332,59.74393665859009,49.05375379723473,NaN,NaN,NaN,NaN,0.5926466173581204,27.272312233710373,12175511,0.2920697272210959,0.12865137216419953,-0.16341835505689636
2025-09-02T13:50:00-04:00,502.68,502.97,502.5,502.58,500.7957582095528,NaN,NaN,NaN,NaN,NaN,502.05290000000076,504.6526539030441,499.4531460969574,501.6832550745472,501.99730396922683,503.32317311548525,500.6714348229684,6409,8509.966666666667,58.51348059283881,50.17957927013636,NaN,NaN,NaN,NaN,0.5838861446896851,26.638535933905967,12169102,0.2663838537554671,0.1695614621374375,-0.09682239161802958
2025-09-02T13:55:00-04:00,502.54,502.76,502.15,502.27,500.7957582095528,NaN,NaN,NaN,NaN,NaN,502.0343000000008,504.61419147756214,499.4544085224395,501.6832550745472,502.00036359229006,503.32155624133225,500.67917094324787,5774,8356.2,54.36050280272737,51.18661779296536,NaN,NaN,NaN,NaN,0.5857514200689943,25.348565631401794,12163328,0.21741939957213074,0.17495185784713385,-0.04246754172499689
2025-09-02T14:00:00-04:00,502.25,503.025,502.18,502.77,500.7957582095528,NaN,NaN,NaN,NaN,NaN,502.0239000000008,504.58760145610586,499.4601985438958,501.6832550745472,502.0107347564991,503.32403303084664,500.6974364821516,11969,8341.866666666667,59.3694799597317,52.22517370740046,NaN,NaN,NaN,NaN,0.6042691757783497,24.56439563607894,12175297,0.20762794447546842,0.21706738886933863,0.009439444393870212
2025-09-02T14:05:00-04:00,502.75,502.83,502.18,502.3,500.7957582095528,NaN,NaN,NaN,NaN,NaN,502.00070000000085,504.53279795149035,499.46860204851134,501.6832550745472,502.0158466221855,503.32206396241475,500.70962928195627,9224,8376.133333333333,53.43298413982064,52.64347752130113,NaN,NaN,NaN,NaN,0.6075356632227518,23.836237783279152,12166073,0.160526290567537,0.21009730760329148,0.04957101703575447
2025-09-02T14:10:00-04:00,502.31,502.89,502.31,502.66,500.7957582095528,NaN,NaN,NaN,NaN,NaN,501.9841000000008,504.48764763408263,499.480552365919,501.6832550745472,502.01992693538733,503.322665941345,500.71718792942966,5226,8218.1,56.98123401396286,53.4566068439167,NaN,NaN,NaN,NaN,0.6062831158496963,23.26016766863539,12171299,0.14511126247435152,0.23096009512869387,0.08584883265434234
2025-09-02T14:15:00-04:00,502.69,502.77,501.8,501.81,500.7957582095528,NaN,NaN,NaN,NaN,NaN,501.9607000000009,504.44839773803204,499.4730022619697,501.6832550745472,502.0210250057664,503.31709056666506,500.7249594448677,8043,8291.333333333334,47.73305679263418,53.8180127536282,NaN,NaN,NaN,NaN,0.6322628932890016,21.64803998720685,12163256,0.07281476767515752,0.17686729224828923,0.10405252457313172
2025-09-02T14:20:00-04:00,501.88,501.9,501.6,501.8,500.7957582095528,NaN,NaN,NaN,NaN,NaN,501.9233000000009,504.36284389913396,499.4837561008678,501.6832550745472,502.0186151930819,503.30876194872735,500.7284684374365,7478,8144.7,47.635103922050504,54.59142183837133,NaN,NaN,NaN,NaN,0.6085298294826412,20.427473896439412,12155778,0.022096851265782758,0.13167358865536016,0.1095767373895774
2025-09-02T14:25:00-04:00,501.77,501.86,501.4,501.44,500.7957582095528,NaN,NaN,NaN,NaN,NaN,501.86710000000085,504.21749238339464,499.51670761660705,501.6832550745472,502.0162666880085,503.30346723303177,500.72906614298523,4123,7988.766666666666,44.1246267778868,54.8419832338104,NaN,NaN,NaN,NaN,0.5979205559481695,19.656559956776317,12151655,-0.03482385879972574,0.06604691388992023,0.10087077268964598
2025-09-02T14:30:00-04:00,501.42,501.84,501.42,501.73,500.7957582095528,NaN,NaN,NaN,NaN,NaN,501.8261000000009,504.1122297328916,499.5399702671102,501.6832550745472,502.01359590685996,503.2962815409611,500.7309102727588,6050,8040.566666666667,47.48220178523267,54.72447227445197,NaN,NaN,NaN,NaN,0.5852119448090116,18.94071129851773,12157705,-0.051087629982350724,0.03701123521170757,0.0880988651940583
2025-09-02T14:35:00-04:00,501.63,501.93,501.5,501.84,500.7957582095528,NaN,NaN,NaN,NaN,NaN,501.75610000000086,503.8101217028381,499.7020782971636,501.6832550745472,502.0116168542906,503.2895502856332,500.733683422948,6206,7974.233333333334,48.74043055454068,54.35553309845791,NaN,NaN,NaN,NaN,0.5741253773226541,18.06455648047691,12163911,-0.052386586213460706,0.022615632427232413,0.07500221864069312
2025-09-02T14:40:00-04:00,501.84,501.98,501.65,501.9,500.7957582095528,NaN,NaN,NaN,NaN,NaN,501.6887000000009,503.4816560049502,499.8957439950516,501.53498324771016,502.0107650346778,503.28551597530645,500.7360140940491,4099,7966.8,49.451811043722635,53.49369188153425,NaN,NaN,NaN,NaN,0.5566878503710389,17.129854899131924,12168010,-0.04730927648174835,0.015865623038507692,0.06317489952025604
2025-09-02T14:45:00-04:00,501.86,502.76,501.84,502.61,500.7957582095528,NaN,NaN,NaN,NaN,NaN,501.64810000000085,503.25408491771867,500.04211508228303,501.53498324771016,502.0166691682256,503.2826997429965,500.75063859345465,12365,8190.033333333334,57.04809525466418,53.130709131403705,NaN,NaN,NaN,NaN,0.58263871820168,17.131183223926744,12180375,0.0030877011529523157,0.06703452596144643,0.06394682480849412
2025-09-02T14:50:00-04:00,502.62,503.4,502.62,503.04,501.121147467029,NaN,NaN,NaN,NaN,NaN,501.6362000000009,503.1911245113362,500.08127548866554,501.86580124866055,502.02834128967703,503.2915759546356,500.76510662471844,9677,8202,60.88220678424849,53.24993936304653,NaN,NaN,NaN,NaN,0.5974502383301289,18.06157877450826,12190052,0.061372292432238046,0.14066219034879168,0.07928989791655364
2025-09-02T14:55:00-04:00,503.04,503.135,502.68,502.74,501.121147467029,NaN,NaN,NaN,NaN,NaN,501.62680000000086,503.14889035081416,500.10470964918755,501.86580124866055,502.03889674322824,503.29742067586074,500.78037281059574,10803,8411.766666666666,57.05556502060128,53.057912817475895,NaN,NaN,NaN,NaN,0.5872752213065472,18.92551750004824,12179249,0.07481853809418844,0.17281307053428918,0.09799453244010074
2025-09-02T15:00:00-04:00,502.86,503.39,502.86,503.36,501.25609717553675,NaN,NaN,NaN,NaN,NaN,501.6400000000009,503.20978979351156,500.07021020649023,501.90111279914277,502.04874718814,503.30646614206665,500.79102823421334,7189,8392.666666666666,62.32576379541901,53.33021876051735,NaN,NaN,NaN,NaN,0.5917555626417921,20.065209779624755,12186438,0.1179978270995975,0.2454918163145976,0.1274939892150001
2025-09-02T15:05:00-04:00,503.31,503.5,503.14,503.44,501.48695639483054,NaN,NaN,NaN,NaN,NaN,501.6512000000008,503.2636299166894,500.0387700833122,502.1288902393142,502.05709670485743,503.31513603954284,500.799057370172,5446,8373.333333333334,62.957453670866734,53.94428667967016,NaN,NaN,NaN,NaN,0.5752015938816649,21.26520799397574,12191884,0.1428192025898148,0.3060179924522686,0.16319878986245379
2025-09-02T15:10:00-04:00,503.43,503.55,503.19,503.49,501.571185649611,NaN,NaN,NaN,NaN,NaN,501.6752000000009,503.3590871208712,499.99131287913065,502.2731121914514,502.070464354954,503.32940500953794,500.8115237003701,8535,8422.3,63.3708353029485,54.23009777561422,NaN,NaN,NaN,NaN,0.559830051461547,22.44576001282291,12200419,0.1525929722554411,0.35394000518175517,0.20134703292631406
2025-09-02T15:15:00-04:00,503.48,503.89,503.38,503.79,501.84840448371955,NaN,NaN,NaN,NaN,NaN,501.7190000000009,503.50369605140105,499.93430394860076,502.6134897531611,502.087937762789,503.3511604219181,500.8247151036599,9441,8549.333333333334,65.83446008894668,55.11591748626608,NaN,NaN,NaN,NaN,0.5562707620714359,23.973685622083078,12209860,0.16802946265880242,0.4113838612498171,0.24335439859101465
2025-09-02T15:20:00-04:00,503.79,503.96,503.57,503.66,502.0064315526414,NaN,NaN,NaN,NaN,NaN,501.7600000000009,503.6251713047308,499.894828695271,502.74379180252885,502.098438112414,503.3643999500073,500.8324762748207,5620,8584.633333333333,63.83097636671827,55.60518479717718,NaN,NaN,NaN,NaN,0.5443942790663324,25.47706804667873,12204240,0.15838146180503387,0.441331225847307,0.2829497640422731
2025-09-02T15:25:00-04:00,503.65,503.89,503.53,503.85,502.0064315526414,NaN,NaN,NaN,NaN,NaN,501.8180000000009,503.7576824471869,499.8783175528149,502.74379180252885,502.11072557352816,503.37998051936387,500.84147062769244,6561,8544.2,65.48425017124049,56.87312718136335,NaN,NaN,NaN,NaN,0.5312232591330239,26.740367171304936,12210801,0.15357742097884158,0.4749215402658251,0.32134411928698353
2025-09-02T15:30:00-04:00,503.84,503.941,503.56,503.56,502.04935395602246,NaN,NaN,NaN,NaN,NaN,501.86740000000094,503.85560847892174,499.87919152108014,502.82812675361845,502.12210405136517,503.39378995805225,500.8504181446781,6438,8366.366666666667,60.90798372587748,57.821190024493845,NaN,NaN,NaN,NaN,0.5204930263378059,27.98360645894945,12204363,0.12107880357290823,0.4726926237531188,0.3516138201802106
2025-09-02T15:35:00-04:00,503.555,504.06,503.5,504.05,502.0798151398396,NaN,NaN,NaN,NaN,NaN,501.92740000000094,503.99288322572806,499.8619167742738,502.8897014028948,502.13812440165,503.41488122275985,500.8613675805401,8250,8504.1,65.31819054974237,59.335016008197826,NaN,NaN,NaN,NaN,0.5233149530279628,29.30412032178421,12212613,0.122427208018412,0.5046478302032256,0.38222062218481356
2025-09-02T15:40:00-04:00,504.05,504.22,503.88,503.95,502.38073263348326,NaN,NaN,NaN,NaN,NaN,501.9880000000009,504.1087583539434,499.8672416460584,503.11376112231585,502.15777657692337,503.4421386786333,500.87341447521345,9516,8365.866666666667,63.73782793006668,60.49613216140025,NaN,NaN,NaN,NaN,0.5102210278116821,30.747673853667333,12203097,0.10698812642150746,0.5159557802116979,0.4089676537901904
2025-09-02T15:45:00-04:00,503.91,504.38,503.74,504.34,502.38073263348326,NaN,NaN,NaN,NaN,NaN,502.0652000000009,504.2410685244587,499.88933147554314,503.17500889785265,502.19232166770746,503.4918497915019,500.892793543913,16024,8576.333333333334,67.08281597003,61.80630254822091,NaN,NaN,NaN,NaN,0.519490954396561,32.29615489854968,12219121,0.11286312365912898,0.5500465583641017,0.4371834347049727
2025-09-02T15:50:00-04:00,504.32,506.79,504.13,505.24,503.4930022548887,NaN,NaN,NaN,NaN,NaN,502.1534000000009,504.4745156274436,499.83228437255815,504.49600711828214,502.3477235484335,503.78955349164903,500.905893605218,47335,9813.3,73.22166451625542,63.50414922483039,NaN,NaN,NaN,NaN,0.6723844576539513,35.37673521165136,12266456,0.1640791661830156,0.6422823924337422,0.4782032262507266
2025-09-02T15:55:00-04:00,505.18,506,504.85,504.93,503.4930022548887,NaN,NaN,NaN,NaN,NaN,502.23700000000093,504.6492230402144,499.82477695978747,504.49600711828214,502.7034136332004,504.3569925857143,501.0498346806865,135369,13962.833333333334,68.48407218032344,64.32100471952035,NaN,NaN,NaN,NaN,0.7064998535358102,38.23727407381721,12131087,0.16343592508184246,0.6824981326030297,0.5190622075211873
2025-09-03T09:30:00-04:00,503.87,505.34,503.04,505.04,NaN,NaN,NaN,506.44557025949194,506.44557025949194,506.44557025949194,502.3246000000009,504.8181347111924,499.8310652888094,504.49600711828214,504.47333333333336,504.47333333333336,504.47333333333336,54965,15337.066666666668,69.24449753934594,64.91831120202731,NaN,NaN,NaN,NaN,0.8203212925689635,37.18070809405013,12186052,0.15675292471764846,0.7150033634182478,0.5582504387005993
2025-09-03T09:35:00-04:00,505.11,506.1,504.3,505.27,NaN,NaN,NaN,506.44557025949194,NaN,NaN,502.4166000000009,504.9970793655131,499.83612063448874,504.49600711828214,504.76497081290245,505.1305876754215,504.3993539503834,34972,16063.166666666666,70.82936244851452,65.90215387544967,NaN,NaN,NaN,NaN,0.8902983430997526,36.84570170672517,12221024,0.15393550221402652,0.7506698164681325,0.596734314254106
2025-09-03T09:40:00-04:00,505.39,506.45,505.2,506.45,503.36506924703315,503.36506924703315,503.36506924703315,NaN,NaN,NaN,502.5312000000009,505.3020356565723,499.76036434342956,504.49600711828214,505.04828342141326,505.6670675294033,504.4294993134232,25867,16598.633333333335,77.29405481253309,66.97131751952925,NaN,NaN,NaN,NaN,0.9159913185926275,36.80155207820581,12246891,0.21396457344720898,0.8641900310631172,0.6502254576159082
2025-09-03T09:45:00-04:00,506.41,507.78,505.07,505.93,503.70733882671345,NaN,NaN,NaN,NaN,NaN,502.6312000000009,505.52197329376145,499.7404267062403,504.49600711828214,505.29165692492074,506.0276314711248,504.5556823787167,29105,17269.3,69.938364542397,67.46995401035285,NaN,NaN,NaN,NaN,1.0441347958360099,37.601858838670076,12217786,0.2012600892748384,0.9018005692094562,0.7005404799346178
2025-09-03T09:50:00-04:00,505.93,506.81,505.37,505.53,503.70733882671345,NaN,NaN,NaN,NaN,NaN,502.72180000000094,505.6854320682135,499.75816793178836,504.49600711828214,505.37845403619315,506.0928453791736,504.6640626932127,23963,17854.433333333334,64.82767913873747,67.57401428433778,NaN,NaN,NaN,NaN,1.0724108818477232,38.34500083052976,12193823,0.15083301891480594,0.8890817535781252,0.7382487346633193
2025-09-03T09:55:00-04:00,505.6,505.71,504.32,504.57,503.70733882671345,NaN,NaN,NaN,NaN,NaN,502.78420000000085,505.76939839140243,499.79900160859927,504.49600711828214,505.3232108684705,506.01638284166756,504.6300388952734,20434,18343.1,54.52888817261722,66.76647343317138,NaN,NaN,NaN,NaN,1.095095818858599,37.50590355865555,12173389,0.04332396199698374,0.792403687159549,0.7490797251625653
2025-09-03T10:00:00-04:00,504.63,505.8,504.34,505.22,503.70733882671345,NaN,NaN,NaN,NaN,NaN,502.8612000000009,505.89473691845603,499.8276630815458,504.49600711828214,505.30046770155553,505.95683353010025,504.6441018730108,23857,18739.366666666665,59.24937558784879,66.43921623468071,NaN,NaN,NaN,NaN,1.1211604032258446,36.795823199484275,12197246,0.008320518854004422,0.7594803737300708,0.7511598548760664
2025-09-03T10:05:00-04:00,505.31,506.22,505.25,505.62,503.70733882671345,NaN,NaN,NaN,NaN,NaN,502.9536000000009,506.03579859123954,499.87140140876227,504.49600711828214,505.32254008685555,505.9668017174628,504.67827845624834,12576,18851.1,61.8725114680945,66.18123489874172,NaN,NaN,NaN,NaN,1.112506088709713,36.45778944263099,12209822,0.004623747987976268,0.7569395398610368,0.7523157918730605
2025-09-03T10:10:00-04:00,505.66,506.13,504.7,505.05,503.70733882671345,NaN,NaN,NaN,NaN,NaN,503.0330000000008,506.1225779640769,499.9434220359247,503.77298441251867,505.3201306448379,505.9372981465897,504.7029631430861,20297,19353.466666666667,56.309992121244626,65.85280692698223,NaN,NaN,NaN,NaN,1.135184225230448,35.38424913123942,12189525,-0.04117048872854079,0.7008526809623845,0.7420231696909253
2025-09-03T10:15:00-04:00,505,506.21,504.87,506.15,503.70733882671345,NaN,NaN,NaN,NaN,NaN,503.1394000000008,506.2841108859204,499.9946891140812,503.77298441251867,505.3345024376518,505.94592397206134,504.72308090324225,8649,19373.666666666668,63.188040658013456,65.7006533632873,NaN,NaN,NaN,NaN,1.1498139234282714,34.45730467268421,12198174,-0.00428065746937234,0.7366723478542099,0.7409530053235822
2025-09-03T10:20:00-04:00,506.27,506.77,506.055,506.09,503.70733882671345,NaN,NaN,NaN,NaN,NaN,503.2364000000008,506.43943545970694,500.03336454029466,503.77298441251867,505.3830325648132,506.015397691163,504.75066743846344,13406,19571.266666666666,62.60906067408164,65.62002713071693,NaN,NaN,NaN,NaN,1.118755786040536,34.07236971798572,12184768,0.008481386283955672,0.7515547381785268,0.7430733518945711
2025-09-03T10:25:00-04:00,506.14,506.37,504.7,504.75,503.70733882671345,NaN,NaN,NaN,NaN,NaN,503.31160000000085,506.4764680471341,500.1467319528676,503.77298441251867,505.37839834093086,505.9976555184242,504.7591411634375,11825,19828,51.30303536330418,64.49289994452225,NaN,NaN,NaN,NaN,1.1581303727519274,32.029612642233765,12172943,-0.07625434764186567,0.6477554173422391,0.7240097649841047
2025-09-03T10:30:00-04:00,504.8,505.78,504.69,505.53,503.70733882671345,NaN,NaN,NaN,NaN,NaN,503.3958000000008,506.56824660097305,500.22335339902855,503.77298441251867,505.37679595225956,505.98500119164834,504.7685907128708,10320,19970.333333333332,56.25498094053723,63.28099397482809,NaN,NaN,NaN,NaN,1.1532639175553594,30.121836746192177,12183263,-0.08219056620315657,0.621271557230159,0.7034621234333156
2025-09-03T10:35:00-04:00,505.6,506.29,505.6,506.03,503.70733882671345,NaN,NaN,NaN,NaN,NaN,503.48580000000084,506.69650731084806,500.2750926891536,503.60707864466826,505.4029569074193,506.0100917876101,504.7958220272285,13312,20207.2,59.12442604217029,62.612447822102865,NaN,NaN,NaN,NaN,1.12517363772998,28.849434601776014,12196575,-0.05610720569128813,0.6333281163192055,0.6894353220104936
2025-09-03T10:40:00-04:00,506.02,506.45,505.88,506.08,503.70733882671345,NaN,NaN,NaN,NaN,NaN,503.5802000000008,506.8128249142234,500.34757508577815,503.7891474128561,505.4254589145207,506.0364510985136,504.8144667305277,9604,20390.7,59.4111478741806,61.91006570316249,NaN,NaN,NaN,NaN,1.0855183778921238,27.82030031989931,12206179,-0.03991199524432232,0.6395453279550907,0.679457323199413
2025-09-03T10:45:00-04:00,506.15,506.49,505.97,506.23,503.70733882671345,NaN,NaN,NaN,NaN,NaN,503.68280000000084,506.919675134411,500.44592486559065,504.1013179302849,505.45310350144155,506.07113359184547,504.8350734110376,11143,20349.966666666667,60.310598619051596,61.15872542962942,NaN,NaN,NaN,NaN,1.045124208042685,26.904443013097623,12217322,-0.0242907314933275,0.6490939088327536,0.6733846403260811
2025-09-03T10:50:00-04:00,506.23,506.8,506.23,506.7,503.70733882671345,NaN,NaN,NaN,NaN,NaN,503.80680000000086,507.0214102463542,500.5921897536475,504.6040543442279,505.4879444910903,506.12673160232293,504.8491573798576,10378,20373.333333333332,63.071929885025895,60.142859363378896,NaN,NaN,NaN,NaN,1.0111867646110642,26.366763130871256,12227700,0.010628917041295982,0.6866707866277011,0.6760418695864051
2025-09-03T10:55:00-04:00,506.73,507.02,506.51,506.69,503.95068700670873,NaN,NaN,NaN,NaN,NaN,503.9254000000008,507.11911936087716,500.7316806391245,505.0082434753823,505.54221596534006,506.2170249963744,504.86740693430573,15164,20518.7,62.9715434283967,59.645229283807446,NaN,NaN,NaN,NaN,0.9753877099959876,26.085619993828125,12212536,0.02515716952385183,0.7074883314912199,0.6823311619673681
2025-09-03T11:00:00-04:00,506.69,506.93,506.01,506.33,503.95068700670873,NaN,NaN,NaN,NaN,NaN,504.02340000000083,507.20551152474997,500.8412884752517,505.0082434753823,505.5817020523322,506.2659485619286,504.8974555427358,16413,20826.166666666668,59.31166781264843,59.25122847480109,NaN,NaN,NaN,NaN,0.9714314449962753,25.082605406129083,12196123,0.003749374391760041,0.6870178799570681,0.683268505565308
2025-09-03T11:05:00-04:00,506.35,506.5,505.9,506.5,503.95068700670873,NaN,NaN,NaN,NaN,NaN,504.1158000000009,507.31186530531545,500.9197346946863,505.0082434753823,505.60953554637535,506.29456780386124,504.92450328888947,14764,21136.766666666666,60.479748364030414,59.67628991704488,NaN,NaN,NaN,NaN,0.944900627496543,23.99353301852408,12210887,-0.005245390952085871,0.6767117668752007,0.6819571578272866
2025-09-03T11:10:00-04:00,506.535,506.88,506.31,506.36,503.95068700670873,NaN,NaN,NaN,NaN,NaN,504.18780000000083,507.42043926783515,500.9551607321665,505.03058065939575,505.63573366977187,506.3276841011482,504.94378323839555,11331,21229.966666666667,58.97813630625906,59.65691568264561,NaN,NaN,NaN,NaN,0.9181220112467895,23.422133564949,12199556,-0.025759909718944596,0.6497572706786059,0.6755171803975505
2025-09-03T11:15:00-04:00,506.3,506.33,505.71,505.93,503.95068700670873,NaN,NaN,NaN,NaN,NaN,504.2496000000008,507.4949313168578,501.0042686831438,505.03058065939575,505.6459547542374,506.33042388488184,504.9614856235929,11656,21303.8,54.502171332549146,59.13046281582094,NaN,NaN,NaN,NaN,0.8989704390148784,22.029423619357782,12187900,-0.07086779224646456,0.5869324400894698,0.6578002323359343
2025-09-03T11:20:00-04:00,505.86,506.07,505.56,505.83,503.95068700670873,NaN,NaN,NaN,NaN,NaN,504.3140000000008,507.55442219408644,501.0735778059152,505.03058065939575,505.65033045380693,506.3266897002564,504.97397120735747,10419,21463.766666666666,53.48557501666999,58.928718736922754,NaN,NaN,NaN,NaN,0.8711868362281007,20.53390184650845,12177481,-0.10780433789372301,0.5230448099687806,0.6308491478625036
2025-09-03T11:25:00-04:00,505.8,505.9,505.2,505.215,503.95068700670873,NaN,NaN,NaN,NaN,NaN,504.36490000000083,507.58028457355147,501.1495154264502,505.03058065939575,505.64413244522734,506.31148759035756,504.9767773000971,12481,21661.1,47.60467096627293,57.815620901798425,NaN,NaN,NaN,NaN,0.8589592050689498,19.464317060912247,12165000,-0.17030336210543562,0.4179699452307091,0.5882733073361447
2025-09-03T11:30:00-04:00,505.2,505.34,504.94,505.24,503.95068700670873,NaN,NaN,NaN,NaN,NaN,504.41810000000083,507.60145853399666,501.234741466005,505.03058065939575,505.63001275088993,506.292171511837,504.96785398994285,13199,21886.466666666667,47.855665423253,56.76180695531067,NaN,NaN,NaN,NaN,0.8261764047068804,18.799553597503113,12178199,-0.2043166898755484,0.3328774449917091,0.5371941348672575
2025-09-03T11:35:00-04:00,505.25,505.61,505.09,505.61,503.95068700670873,NaN,NaN,NaN,NaN,NaN,504.48490000000083,507.62503151885994,501.3447684811417,505.03058065939575,505.6269328680929,506.28424247500874,504.9696232611771,7124,21848.933333333334,51.55455136267463,56.779772383837134,NaN,NaN,NaN,NaN,0.8043066615135345,17.77597945897401,12185323,-0.196209927047307,0.2919317260581238,0.4881416531054308
2025-09-03T11:40:00-04:00,505.57,505.9,505.12,505.12,503.95068700670873,NaN,NaN,NaN,NaN,NaN,504.5319000000008,507.6381175641733,501.4256824358283,505.03058065939575,505.62218474227615,506.27402682109584,504.97034266345645,8768,21824,46.81806482110948,56.10570694673515,NaN,NaN,NaN,NaN,0.8025704714054228,16.607587167880506,12176555,-0.21656406610734463,0.21743657047124998,0.4340006365785946
2025-09-03T11:45:00-04:00,505.09,505.55,504.9,505.48,503.95068700670873,NaN,NaN,NaN,NaN,NaN,504.5955000000008,507.646042410106,501.5449575898956,505.03058065939575,505.6176668186769,506.2658481240847,504.96948551326915,6696,21513.066666666666,50.42194145352124,55.48410090468879,NaN,NaN,NaN,NaN,0.7916725805907522,15.638889694598982,12183251,-0.1989513419303245,0.18531145916568903,0.3842628010960135
2025-09-03T11:50:00-04:00,505.48,505.86,505.37,505.59,503.95068700670873,NaN,NaN,NaN,NaN,NaN,504.6541000000008,507.6659935498896,501.64220645011204,505.03058065939575,505.61753047168764,506.26168329438167,504.9733776489936,5807,20128.8,51.503356307629105,54.91925864993511,NaN,NaN,NaN,NaN,0.7701245391199849,14.765140349777456,12189058,-0.1739659771242027,0.16680532969076012,0.3407713068149628
2025-09-03T11:55:00-04:00,505.55,505.58,504.85,505.33,503.95068700670873,NaN,NaN,NaN,NaN,NaN,504.72450000000083,507.62985935743774,501.8191406425639,505.03058065939575,505.6101257132381,506.2497650779596,504.97048634851666,9723,15940.6,48.79418640719602,54.09665777765971,NaN,NaN,NaN,NaN,0.7679727863256968,14.217734396793,12179335,-0.16888539007398284,0.12966456922248426,0.2985499592964671
2025-09-03T12:00:00-04:00,505.35,505.45,504.89,504.99,503.95068700670873,NaN,NaN,NaN,NaN,NaN,504.78830000000085,507.57150937691455,502.00509062308714,504.5254645275166,505.5998747879222,506.23687886832,504.9628707075244,10007,14442,45.42889168547137,52.83644076340581,NaN,NaN,NaN,NaN,0.7531175873024328,13.709428869021718,12169328,-0.18126755400941297,0.07196551678470087,0.25323307079411383
2025-09-03T12:05:00-04:00,505.01,505.65,504.95,505.48,503.95068700670873,NaN,NaN,NaN,NaN,NaN,504.86910000000074,507.48855161366237,502.2496483863391,504.37137162201327,505.59750665357916,506.2318020817813,504.963211225377,4868,13438.533333333333,50.70550524747749,51.96029517905445,NaN,NaN,NaN,NaN,0.7493234739236868,12.905706309806739,12174196,-0.15056413206802147,0.06502790570908701,0.21559203777710848
2025-09-03T12:10:00-04:00,505.48,505.6,504.73,504.78,503.95068700670873,NaN,NaN,NaN,NaN,NaN,504.93010000000083,507.3915958776798,502.4686041223219,504.33038676248106,505.58924531185994,506.22246666268774,504.95602396103214,7372,12822.033333333333,44.13942968926459,50.87656388452704,NaN,NaN,NaN,NaN,0.7579432257862809,12.499800563152696,12166824,-0.17006487754873229,0.0030109408411931327,0.17307581838992542
2025-09-03T12:15:00-04:00,504.77,504.8,504.35,504.52,503.95068700670873,NaN,NaN,NaN,NaN,NaN,504.98370000000085,507.28522715296924,502.68217284703246,504.33038676248106,505.55318111228735,506.2034913328784,504.9028708916963,18112,12455.6,41.965701487744546,49.554131964792326,NaN,NaN,NaN,NaN,0.7359472810872602,12.674982141139054,12148712,-0.1915429769153945,-0.06635290275431771,0.1251900741610768
2025-09-03T12:20:00-04:00,504.5,505.17,504.38,504.4,503.95068700670873,NaN,NaN,NaN,NaN,NaN,505.0337000000008,507.1676042237506,502.89979577625104,504.33038676248106,505.54389187784443,506.1972351146771,504.8905486410118,5389,11836.466666666667,40.96301983188738,48.26733793090864,NaN,NaN,NaN,NaN,0.7398081895810288,12.17798965897634,12143323,-0.20376348780641362,-0.12951428559694023,0.0742492022094734
2025-09-03T12:25:00-04:00,504.37,504.785,504.12,504.47,503.95068700670873,NaN,NaN,NaN,NaN,NaN,505.07090000000085,507.09660648317634,503.04519351682535,504.33038676248106,505.5279466643599,506.1894923608224,504.8664009678974,7811,11415.7,41.83603950536305,47.36261422896677,NaN,NaN,NaN,NaN,0.7344647474680996,12.102472155997795,12151134,-0.19695112788460936,-0.1719397076462883,0.025011420238321057
2025-09-03T12:30:00-04:00,504.51,504.62,504.17,504.38,503.95068700670873,NaN,NaN,NaN,NaN,NaN,505.0977000000008,507.0493241533712,503.1460758466305,504.33038676248106,505.5074645321967,506.1802598540879,504.8346692103055,9747,10945.366666666667,40.996623703385175,46.470546278017856,NaN,NaN,NaN,NaN,0.7141458369346632,12.032348760374857,12141387,-0.18832838318060638,-0.21039905873743692,-0.022070675556830545
2025-09-03T12:35:00-04:00,504.37,504.47,504.22,504.29,503.95068700670873,NaN,NaN,NaN,NaN,NaN,505.12870000000083,506.97599078275647,503.2814092172452,504.33038676248106,505.4953295366693,506.17517022969787,504.81548884364076,5623,10713.6,40.129511824054056,45.936606339287934,NaN,NaN,NaN,NaN,0.6809925628679014,11.967234178724988,12135764,-0.17859370441371047,-0.24531280607396866,-0.06671910166025817
2025-09-03T12:40:00-04:00,504.27,504.32,503.84,503.88,NaN,NaN,NaN,506.2488274841659,506.2488274841659,506.2488274841659,505.13910000000084,506.95197803120203,503.32622196879964,504.0560380223903,505.44963741225354,506.1662693673622,504.7330054571449,17406,10617.233333333334,36.356917321030345,45.11526718912917,NaN,NaN,NaN,NaN,0.6666359512344812,12.508052572228262,12118358,-0.1886869961081372,-0.30257784679542965,-0.11389085068729246
2025-09-03T12:45:00-04:00,503.85,504.18,503.73,503.99,NaN,NaN,NaN,506.0866080530675,NaN,NaN,505.1501000000008,506.92794193787205,503.37225806212956,504.0560380223903,505.41948493472387,506.15902901831686,504.6799408511309,11717,10719.5,38.03990840025068,44.14993554895604,NaN,NaN,NaN,NaN,0.6511619547177316,13.175065454734305,12130075,-0.17706372751037394,-0.3352205100752599,-0.15815678256488594
2025-09-03T12:50:00-04:00,504,504.11,503.53,503.54,NaN,NaN,NaN,505.93380768701894,NaN,NaN,505.1511000000009,506.9252581540903,503.3769418459115,504.0560380223903,505.39125791325534,506.155974956449,504.6265408700617,9772,10598.366666666667,34.070599532669306,43.23940231406745,NaN,NaN,NaN,NaN,0.6460789579521824,14.091244753387416,12120303,-0.1877725782742017,-0.3928725054076381,-0.20509992713343636
2025-09-03T12:55:00-04:00,503.56,503.85,503.56,503.61,NaN,NaN,NaN,505.7649982466999,NaN,NaN,505.1475000000009,506.93338269373595,503.3616173062658,503.88983041791226,505.35252746880064,506.15042721715497,504.5546277204463,13517,10654.766666666666,35.20325757837608,42.1523534658428,NaN,NaN,NaN,NaN,0.6220733180984552,14.941982673565304,12133820,-0.1783042362826301,-0.42798022248672396,-0.24967598620409387
2025-09-03T13:00:00-04:00,503.6,504.21,503.56,504.06,NaN,NaN,NaN,505.7649982466999,NaN,NaN,505.1555000000008,506.9180892874099,503.39291071259174,503.50049146746386,505.3127531080506,506.1332057833424,504.4923004327587,17414,10891.233333333334,42.09083009721853,41.480030165099194,NaN,NaN,NaN,NaN,0.6240680810914211,14.832797489000917,12151234,-0.13202846322967787,-0.41471156524119124,-0.28268310201151337
2025-09-03T13:05:00-04:00,504.05,504.25,503.94,504.07,NaN,NaN,NaN,505.7649982466999,NaN,NaN,505.15990000000085,506.9104890311833,503.4093109688184,503.50049146746386,505.3028927690019,506.1273450102008,504.478440527803,5002,10614.233333333334,42.237766417551605,41.01171445155317,NaN,NaN,NaN,NaN,0.6016346467277484,14.635712847926378,12156236,-0.09288721046181447,-0.39879211508878143,-0.30590490462696696
2025-09-03T13:10:00-04:00,504.1,504.75,504.1,504.26,NaN,NaN,NaN,505.7649982466999,NaN,NaN,505.17390000000086,506.88380910756626,503.46399089243545,503.4553607957491,505.2883535552734,506.1144771046761,504.46223000587065,9847,10622.333333333334,45.08866711451939,40.98741269648516,NaN,NaN,NaN,NaN,0.607232171961481,13.826266959318065,12166083,-0.04857069770901329,-0.36661827676323355,-0.31804757905422026
2025-09-03T13:15:00-04:00,504.33,504.56,504.33,504.53,NaN,NaN,NaN,505.7649982466999,NaN,NaN,505.1835000000008,506.8733334226406,503.49366657736095,503.4553607957491,505.28211826840663,506.1081339050532,504.4561026317601,4871,10413.266666666666,48.94497294468959,40.86166038914316,NaN,NaN,NaN,NaN,0.5852870168213761,13.074638634181774,12170954,0.0018825384631303566,-0.3156944059753073,-0.31757694443843765
2025-09-03T13:20:00-04:00,504.49,504.6,504.09,504.19,NaN,NaN,NaN,505.7649982466999,NaN,NaN,505.1883000000008,506.8654065667483,503.51119343325337,503.4553607957491,505.27517268483786,506.10241421184907,504.44793115782664,4504,10217.466666666667,44.68890070081294,40.900908318539486,NaN,NaN,NaN,NaN,0.5799093727627097,12.428376956567382,12166450,0.014604246361621276,-0.2993216364864111,-0.31392588284803236
2025-09-03T13:25:00-04:00,504.09,504.09,503.5,504.08,NaN,NaN,NaN,505.73701904401196,NaN,NaN,505.1831000000009,506.8722641589863,503.49393584101546,503.4553607957491,505.2537067512167,506.09215578750394,504.4152577149295,10093,10048.433333333332,43.37477595200646,41.00155649455819,NaN,NaN,NaN,NaN,0.5877729889939446,12.912442769243485,12156357,0.017654447016099195,-0.2918578240779084,-0.3095122710940076
2025-09-03T13:30:00-04:00,504.04,504.39,503.92,503.93,NaN,NaN,NaN,505.73701904401196,NaN,NaN,505.1569000000008,506.88197726098304,503.43182273901857,503.4553607957491,505.24577193418554,506.0868987855743,504.4046450827968,4433,9649.1,41.57922961029209,41.04557147872996,NaN,NaN,NaN,NaN,0.5793606326372321,12.683314236131874,12151924,0.011889893131160623,-0.2946499046800568,-0.30653979781121743
2025-09-03T13:35:00-04:00,503.92,504.06,503.69,503.8,NaN,NaN,NaN,505.73701904401196,NaN,NaN,505.1343000000008,506.89980956843726,503.3687904315643,503.4553607957491,505.22471275279065,506.07663419548334,504.37279131009797,10045,9491.8,40.03251898549659,40.91674858445378,NaN,NaN,NaN,NaN,0.5644063017345731,12.868759566529638,12141879,0.002151863116050756,-0.303849968916154,-0.30600183203220477
2025-09-03T13:40:00-04:00,503.79,504,503.385,503.48,NaN,NaN,NaN,505.5719748653827,NaN,NaN,505.10310000000084,506.92830014136365,503.277899858638,503.4553607957491,505.2062339725506,506.0703432545185,504.3421246905827,7764,9372.9,36.43922258191499,40.5912199329202,NaN,NaN,NaN,NaN,0.5680201373249614,13.531292357800401,12134115,-0.021696441790359955,-0.3331223842701547,-0.31142594247979477
2025-09-03T13:45:00-04:00,503.49,503.62,502.95,503.5,NaN,NaN,NaN,505.1704078260471,NaN,NaN,505.06770000000085,506.946451935727,503.1889480642747,503.4553607957491,505.1738367321138,506.06404857557203,504.28362488865554,12008,9384.633333333333,36.820919039390304,40.354891876872784,NaN,NaN,NaN,NaN,0.5753044132303223,14.761999884139238,12146123,-0.03139116980900575,-0.35066490474105194,-0.3192737349320462
2025-09-03T13:50:00-04:00,503.45,503.77,503.29,503.36,NaN,NaN,NaN,505.1704078260471,NaN,NaN,505.00590000000085,506.90191443982746,503.10988556017423,503.4553607957491,505.164835652004,506.0612215875802,504.2684497164278,3648,9158.933333333332,35.2262236440267,40.2741280428011,NaN,NaN,NaN,NaN,0.5684969551424394,15.536069361335247,12142475,-0.04184577575719611,-0.37158095462854135,-0.32973517887134524
2025-09-03T13:55:00-04:00,503.4,503.43,502.95,503.32,NaN,NaN,NaN,505.0358364696008,NaN,NaN,504.9537000000008,506.88839254302263,503.019007456979,503.4553607957491,505.1488155824671,506.05850208468144,504.2391290802527,5764,8935.033333333333,34.76297233217984,40.04006118079604,NaN,NaN,NaN,NaN,0.5621757440608378,16.721964605776744,12136711,-0.0457514693819806,-0.386924515598821,-0.3411730462168404
2025-09-03T14:00:00-04:00,503.26,503.27,502.85,503.04,NaN,NaN,NaN,504.88602572098256,NaN,NaN,504.9039000000008,506.9037812855038,502.90401871449785,503.39643090927945,505.1363942863355,506.0575340909367,504.21525448173423,4144,8633.2,31.62753162880388,39.86555633051994,NaN,NaN,NaN,NaN,0.5555917623422044,17.954448286496763,12132567,-0.06055965118517659,-0.4168726101983111,-0.35631295901313453
2025-09-03T14:05:00-04:00,503.05,503.36,502.92,503.29,NaN,NaN,NaN,504.88602572098256,NaN,NaN,504.8783000000008,506.92680150994727,502.8297984900544,503.39643090927945,505.124591852548,506.0552831843833,504.1939005207127,4265,8537.9,37.08397469805346,39.99989326763974,NaN,NaN,NaN,NaN,0.5473352078891897,18.854087919207117,12136832,-0.047463642484470436,-0.4156425121187226,-0.36817886963425217
2025-09-03T14:10:00-04:00,503.35,503.55,503.2,503.38,NaN,NaN,NaN,504.88602572098256,NaN,NaN,504.8415000000008,506.929846953067,502.7531530469346,503.1087157819388,505.1137793687598,506.0516550103879,504.17590372713175,4378,8391.566666666668,38.97215552842773,39.7771307984404,NaN,NaN,NaN,NaN,0.5332398358971063,19.176938757835433,12141210,-0.027666989154861377,-0.4027626060778289,-0.3750956169229675
2025-09-03T14:15:00-04:00,503.32,503.36,503.04,503.2,NaN,NaN,NaN,504.88602572098256,NaN,NaN,504.7931000000008,506.9188703442483,502.66732965575324,503.1087157819388,505.0989071596742,506.0481258399821,504.14968847936626,5543,8353.133333333333,36.60596943522626,39.37485958541716,NaN,NaN,NaN,NaN,0.5194369904758827,19.73659238968743,12135667,-0.021875985430877376,-0.40244059871156423,-0.38056461328068686
2025-09-03T14:20:00-04:00,503.17,503.36,503.07,503.19,NaN,NaN,NaN,504.88602572098256,NaN,NaN,504.7559000000008,506.92700081669796,502.58479918330363,502.84997262555106,505.0907662073099,506.0460033727372,504.13552904188265,3082,8262.3,36.473479209058226,38.75948902074138,NaN,NaN,NaN,NaN,0.503048634013321,20.256270762121428,12132585,-0.01426816288471533,-0.398399816886581,-0.38413165400186566
2025-09-03T14:25:00-04:00,503.18,503.47,503.09,503.26,NaN,NaN,NaN,504.88602572098256,NaN,NaN,504.6981000000007,506.8715423288361,502.5246576711653,502.7244781004408,505.081492740661,506.04304878227697,504.11993669904507,3674,8060.666666666667,38.16072760182556,37.989185781965375,NaN,NaN,NaN,NaN,0.4942594458695161,20.407912234142398,12136259,-0.0007824749928633246,-0.3851097477429448,-0.3843272727500815
2025-09-03T14:30:00-04:00,503.21,503.21,502.9,502.95,NaN,NaN,NaN,504.6983773589621,NaN,NaN,504.6353000000007,506.8256318553329,502.4449681446685,502.4578356670269,505.0583417969395,506.0388499513631,504.0778336425159,8178,7999.7,33.870381062040764,37.21643437919594,NaN,NaN,NaN,NaN,0.48466948545026595,20.90100165672218,12128081,-0.008568525850730757,-0.39503793006349497,-0.3864694042127642
2025-09-03T14:35:00-04:00,502.9,503.15,502.62,502.65,NaN,NaN,NaN,504.52595111537295,NaN,NaN,504.59330000000074,506.85267124803465,502.3339287519668,502.4578356670269,505.0413107584708,506.0373944995151,504.0452270174265,5550,8022.433333333333,30.31799287989999,36.283807016902614,NaN,NaN,NaN,NaN,0.48790737934667355,21.83447135785548,12122531,-0.028621426761330615,-0.42224618766442745,-0.39362476090309684
2025-09-03T14:40:00-04:00,502.69,503.22,502.56,503.13,NaN,NaN,NaN,504.52595111537295,NaN,NaN,504.54530000000074,506.8249161160623,502.2656838839392,502.4578356670269,505.01870361508804,506.0324437501384,504.0049634800377,8097,8046.6,40.98343635034449,36.24125035547778,NaN,NaN,NaN,NaN,0.5001997093933415,22.470948039325997,12130628,-0.0054687336360509375,-0.40046067794816054,-0.3949919443121096
2025-09-03T14:45:00-04:00,503.12,503.18,502.87,502.9,NaN,NaN,NaN,504.52595111537295,NaN,NaN,504.48270000000076,506.76769208672266,502.19770791327886,502.4578356670269,505.0042494892945,506.02874042353216,503.9797585550569,5306,7619.733333333334,37.98342004702321,36.09488614558683,NaN,NaN,NaN,NaN,0.48661401586524583,23.061962100691478,12125322,-0.0017473905925619038,-0.39717618255281195,-0.39542879196025005
2025-09-03T14:50:00-04:00,502.96,503.01,502.7,502.87,NaN,NaN,NaN,504.4468302291012,NaN,NaN,504.4185000000008,506.7007482328308,502.1362517671708,502.4578356670269,504.9712096094767,506.0215253730844,503.92089384586905,11693,7829.866666666667,37.59683536856879,36.17757277320496,NaN,NaN,NaN,NaN,0.47399872901772844,23.92481433788731,12113629,0.0023671951360660914,-0.39246979804016746,-0.39483699317623355
2025-09-03T14:55:00-04:00,502.9,503.07,502.82,503.07,NaN,NaN,NaN,504.4468302291012,NaN,NaN,504.35530000000074,506.6082166954076,502.1023833045939,502.4578356670269,504.95585029788487,506.0164494725169,503.8952511232528,5919,7766.8,41.84618263288343,36.53652017274018,NaN,NaN,NaN,NaN,0.4579988198021764,24.498589987857414,12119548,0.021185231739951238,-0.3683554535012945,-0.38954068524124574
2025-09-03T15:00:00-04:00,503.03,503.07,502.78,502.81,NaN,NaN,NaN,504.4468302291012,NaN,NaN,504.2775000000007,506.4689946946558,502.0860053053456,502.4578356670269,504.931830788842,506.0092985229123,503.8543630547717,8982,7741.3,38.20407072799031,36.74922353588044,NaN,NaN,NaN,NaN,0.4459989041020224,25.112230239902818,12110566,0.01882822314056687,-0.36600540631553713,-0.384833629456104
2025-09-03T15:05:00-04:00,502.82,503.21,502.66,502.68,NaN,NaN,NaN,504.4468302291012,NaN,NaN,504.1973000000008,506.3222632553096,502.07233674469194,502.4578356670269,504.9075711363682,506.0017942577726,503.81334801496376,9123,7857.966666666666,36.493776105176146,36.872852376808744,NaN,NaN,NaN,NaN,0.4534275538090176,25.121147542757267,12101443,0.011576047689260627,-0.37036356984452823,-0.38193961753378886
2025-09-03T15:10:00-04:00,502.72,502.75,502.46,502.56,NaN,NaN,NaN,504.1033675328949,NaN,NaN,504.12190000000084,506.20596227262604,502.03783772737563,502.4578356670269,504.88153515513346,505.9966744581993,503.7663958520676,8895,7574.266666666666,34.938909236848616,37.10937934881194,NaN,NaN,NaN,NaN,0.441754157108375,25.57382789281481,12092548,0.002247639995107631,-0.3791300675399043,-0.38137770753501193
2025-09-03T15:15:00-04:00,502.53,502.93,502.32,502.8,NaN,NaN,NaN,504.1033675328949,NaN,NaN,504.0479000000008,506.05009288684187,502.0457071131598,502.2202685336215,504.84835629803325,505.98703938771206,503.70967320835445,12134,7588.166666666667,40.4075607346662,37.346778351427126,NaN,NaN,NaN,NaN,0.4537717173149206,25.293338186290747,12104682,0.015076136848292843,-0.3625325364746459,-0.37760867332293874
2025-09-03T15:20:00-04:00,502.78,503.18,502.74,503.05,NaN,NaN,NaN,504.1033675328949,NaN,NaN,503.98170000000084,505.89042901066273,502.07297098933896,502.21098770758215,504.81757522228554,505.97142857352617,503.6637218710449,13540,7713.766666666666,45.54244324305782,37.81608461675785,NaN,NaN,NaN,NaN,0.45278802322099754,24.160278668697295,12118222,0.04172347629088302,-0.32545432795933493,-0.36717780425021795
2025-09-03T15:25:00-04:00,503.05,503.53,503,503.22,NaN,NaN,NaN,504.1033675328949,NaN,NaN,503.9275000000008,505.7644107208034,502.0905892791982,502.41036456502565,504.78559734748364,505.9489215301627,503.6222731648046,17023,7830.633333333333,48.77478123114563,38.68528545932352,NaN,NaN,NaN,NaN,0.45830316441949576,22.788804372792782,12135245,0.07043479163908134,-0.2791343147013663,-0.34956910634044763
2025-09-03T15:30:00-04:00,503.22,503.62,503.22,503.49,NaN,NaN,NaN,504.1033675328949,NaN,NaN,503.8807000000008,505.6388899886985,502.12251001130306,502.52429165202057,504.7612178158994,505.92778207117686,503.5946535606219,15437,7764.733333333334,53.49594398994734,39.9011758008156,NaN,NaN,NaN,NaN,0.45413865267524445,21.753816495823482,12150682,0.10515590374940964,-0.21812422665368558,-0.3232801304030952
2025-09-03T15:35:00-04:00,503.52,503.83,503.39,503.77,NaN,NaN,NaN,504.1033675328949,NaN,NaN,503.8518000000008,505.56832061918436,502.1352793808173,502.7334333216164,504.7410149702951,505.9061768278674,503.5758531127228,15933,8129.1,57.83591457454442,41.30654629886694,NaN,NaN,NaN,NaN,0.4531287489127268,21.324148084299217,12166615,0.14222220703306065,-0.14550237161176938,-0.28772457864483003
2025-09-03T15:40:00-04:00,503.76,504.22,503.61,504.095,502.41281718073486,502.41281718073486,502.41281718073486,NaN,NaN,NaN,503.8289000000008,505.50069818048695,502.1571018195146,503.03774665729316,504.72342898781653,505.8808383875062,503.5660195881269,20345,8479.033333333333,62.240746717252804,43.333000988524944,NaN,NaN,NaN,NaN,0.4643338382761044,21.765400912226873,12186960,0.1813629955363946,-0.061020834224336795,-0.2423838297607314
2025-09-03T15:45:00-04:00,504.16,504.56,503.8,504.38,502.6424618543378,NaN,NaN,NaN,NaN,NaN,503.8043000000008,505.40523723680013,502.2033627632015,503.23419732583454,504.7102953537651,505.8543159154011,503.5662747921291,25104,9153.466666666667,65.63148044374933,45.85539295737133,NaN,NaN,NaN,NaN,0.4854528498278106,22.775213191842987,12212064,0.2167861368699888,0.02859884132675461,-0.18818729554323418
2025-09-03T15:50:00-04:00,504.4,505.62,504.4,504.98,503.37325904277697,NaN,NaN,NaN,NaN,NaN,503.80150000000083,505.39368874387003,502.2093112561316,503.9393578606676,504.72692191724724,505.83967097563925,503.6141728588552,55485,10852.833333333334,71.44504881797359,48.031222419344836,NaN,NaN,NaN,NaN,0.5393490748401105,24.9952520334465,12267549,0.2676306540230632,0.1463510219855948,-0.12127963203746837
2025-09-03T15:55:00-04:00,504.96,505.55,504.57,505.4,503.37325904277697,NaN,NaN,NaN,NaN,NaN,503.79990000000083,505.38548568236564,502.214314317636,503.9393578606676,504.7853751567867,505.83359089968,503.7371594138934,145664,15371.866666666667,74.67446034663085,50.65201101217395,NaN,NaN,NaN,NaN,0.5708241409229611,27.056716672078334,12413213,0.3133784732884787,0.27044345957313,-0.04293501371534869
2025-09-04T09:30:00-04:00,504.15,506.8,503.96,506.73,503.3738372683154,NaN,NaN,NaN,NaN,NaN,503.82270000000085,505.53806725979615,502.10733274020555,503.9393578606676,505.83,505.83,505.83,30508,16241.033333333333,81.72340723533826,53.803909002657484,NaN,NaN,NaN,NaN,0.7329081308570375,29.883823414283185,12443721,0.4108934259203109,0.47068176868503997,0.05978834276472905
2025-09-04T09:35:00-04:00,506.69,506.89,504.85,505.12,503.6768446652102,NaN,NaN,NaN,NaN,NaN,503.8185000000009,505.5200572267427,502.11694277325904,503.9393578606676,505.72781300484655,505.83277531714475,505.62285069254835,28916,16870.066666666666,59.9651769858237,55.09812288501036,NaN,NaN,NaN,NaN,0.826271835795818,32.55909713674579,12414805,0.34718267904061456,0.49376669156549724,0.14658401252488268
2025-09-04T09:40:00-04:00,505.14,505.14,503.9,504.59,503.6768446652102,NaN,NaN,NaN,NaN,NaN,503.81050000000084,505.4936117003729,502.12738829962876,503.9393578606676,505.34195499328683,505.90372247953104,504.7801875070426,28711,17568.3,54.79339738126313,56.28307478881556,NaN,NaN,NaN,NaN,0.8558238475246888,32.73769676308446,12386094,0.2538903871660868,0.46394699648249116,0.21005660931640438
2025-09-04T09:45:00-04:00,504.61,504.93,503.87,504.48,503.6768446652102,NaN,NaN,NaN,NaN,NaN,503.7905000000008,505.41658271501547,502.16441728498614,503.9393578606676,505.15859669975384,505.78034259235267,504.536850807155,22079,17904,53.7571144683772,57.51617038618707,NaN,NaN,NaN,NaN,0.8704078584157825,32.84066761413852,12364015,0.17317224333112824,0.42652191348031465,0.2533496701491864
2025-09-04T09:50:00-04:00,504.48,504.56,503.59,504.32,NaN,NaN,NaN,506.40679297102633,506.40679297102633,506.40679297102633,503.7813000000008,505.3899973725051,502.1726026274965,503.9393578606676,505.020103915804,505.6929441940293,504.3472636375787,17678,18371.666666666668,52.210369002264514,58.749846083716776,NaN,NaN,NaN,NaN,0.8775215828146571,32.347058676833825,12346337,0.10098113260333258,0.3795760859033521,0.27859495330001954
2025-09-04T09:55:00-04:00,504.47,504.76,503.78,504.02,NaN,NaN,NaN,506.40679297102633,NaN,NaN,503.7713000000008,505.3676744034991,502.1749255965025,503.9393578606676,504.90939863847797,505.5968507327718,504.2219465441841,19590,18832.533333333333,49.343556394025974,59.388131487956755,NaN,NaN,NaN,NaN,0.8848414697564685,32.127613043485425,12326747,0.028754348983451083,0.31453788952933337,0.2857835405458823
2025-09-04T10:00:00-04:00,503.84,503.92,503.16,503.5,NaN,NaN,NaN,505.90946425665834,NaN,NaN,503.75330000000076,505.3411861534731,502.16541384652845,503.9393578606676,504.715086423926,505.5132736157574,503.9168992320946,24114,19498.2,44.75619962285546,59.33197122937088,NaN,NaN,NaN,NaN,0.8830670790595747,30.714180809359483,12302633,-0.053813969385240135,0.2185160788143321,0.27233004819957224
2025-09-04T10:05:00-04:00,503.55,504.42,503.37,504.42,NaN,NaN,NaN,505.90946425665834,NaN,NaN,503.7523000000008,505.3384414931005,502.16615850690107,503.9393578606676,504.65337812982546,505.4357830596128,503.8709732000381,18151,19961.066666666666,53.06922267316066,59.63871704665767,NaN,NaN,NaN,NaN,0.8949908591267487,30.041324466068424,12320784,-0.046515704880023434,0.21418541709954297,0.2607011219795664
2025-09-04T10:10:00-04:00,504.37,505.24,504.32,504.5,NaN,NaN,NaN,505.90946425665834,NaN,NaN,503.75470000000075,505.34499105391126,502.16440894609025,503.9123890308273,504.65728874522296,505.39237944827016,503.92219804217575,25258,20657.066666666666,53.72136564056374,59.65481859313026,NaN,NaN,NaN,NaN,0.896777226331982,30.27577345534647,12346042,-0.03677421322588642,0.2147333554472084,0.2515075686730948
2025-09-04T10:15:00-04:00,504.49,504.87,503.96,504.77,NaN,NaN,NaN,505.90946425665834,NaN,NaN,503.7643000000007,505.37308837528076,502.1555116247206,503.9123890308273,504.64860696603483,505.35819323699286,503.9390206950768,16193,21012.066666666666,55.94634250340588,59.519849159477516,NaN,NaN,NaN,NaN,0.8977217101654136,29.8516916073811,12362235,-0.013802847221532716,0.23425400964617893,0.24805685686771164
2025-09-04T10:20:00-04:00,504.75,505.12,504.51,505.01,NaN,NaN,NaN,505.90946425665834,NaN,NaN,503.7869000000007,505.43287313358434,502.14092686641703,503.5599112246618,504.6765994210745,505.3461474789543,504.0070513631947,31818,21969.933333333334,57.88462808648859,59.20869782870864,NaN,NaN,NaN,NaN,0.8771701594393136,29.717213998004166,12394053,0.01437348032218988,0.266023707270449,0.2516502269482591
2025-09-04T10:25:00-04:00,504.98,505.62,504.87,505.5,NaN,NaN,NaN,505.90946425665834,NaN,NaN,503.81710000000066,505.5308842210912,502.10331577891014,503.35847537226863,504.7282211281448,505.39451091535676,504.06193134093286,22562,22599.533333333333,61.5994871411329,58.920698307093176,NaN,NaN,NaN,NaN,0.8680865766222199,30.07425869889711,12416615,0.06025678315826177,0.3269712058960863,0.26671442273782453
2025-09-04T10:30:00-04:00,505.45,506.46,505.44,506.12,503.5195668917506,503.5195668917506,503.5195668917506,NaN,NaN,NaN,503.8687000000007,505.6975059592445,502.03989404075685,504.1407802978149,504.820223274395,505.54213015166306,504.09831639712695,22145,23065.1,65.7197588972775,58.51174902704345,NaN,NaN,NaN,NaN,0.8789375354349171,31.081522057012727,12438760,0.1229921554120289,0.4204546170028607,0.2974624615908318
2025-09-04T10:35:00-04:00,506.09,507.17,506.02,507.11,504.1182229421256,NaN,NaN,NaN,NaN,NaN,503.93870000000067,505.97832232694554,501.8990776730558,504.7396242382519,504.97899841020654,505.8521969203056,504.1057999001075,27331,23791.133333333335,71.05952962867052,58.25353969004629,NaN,NaN,NaN,NaN,0.8982991400467112,32.481499190818916,12466091,0.21633359803068464,0.5678794591291876,0.35154586109850294
2025-09-04T10:40:00-04:00,507.12,507.35,506.89,507.09,504.6930764447563,NaN,NaN,NaN,NaN,NaN,503.99930000000074,506.22160691762014,501.77699308238135,505.17569939060155,505.09258182215467,506.06776414303744,504.1173995012719,18864,24150.033333333333,70.81952961577564,57.474691288648955,NaN,NaN,NaN,NaN,0.8669920586148059,33.89010155399815,12447227,0.2590163114689272,0.6753162504346619,0.41629993896573475
2025-09-04T10:45:00-04:00,507.05,507.45,506.96,507.415,504.8215729699946,NaN,NaN,NaN,NaN,NaN,504.0662000000008,506.4856433731992,501.64675662680236,505.4655595124812,505.18144824872627,506.22944815757506,504.1334483398775,15023,24473.933333333334,72.4480008862663,58.366321567251994,NaN,NaN,NaN,NaN,0.8400640544280347,35.259933139747304,12462250,0.2891363599609471,0.7777203889169186,0.4885840289559715
2025-09-04T10:50:00-04:00,507.42,507.64,506.94,507.265,504.919456016813,NaN,NaN,NaN,NaN,NaN,504.1263000000007,506.7059975087257,501.5466024912757,505.702447609985,505.25990408549853,506.3625801967582,504.1572279742389,14317,24561.4,70.49265206427701,59.48769690175299,NaN,NaN,NaN,NaN,0.8300594791117456,36.65172853360168,12447933,0.27883104016692484,0.8371228291646275,0.5582917889977027
2025-09-04T10:55:00-04:00,507.26,507.55,506.95,507.49,504.919456016813,NaN,NaN,NaN,NaN,NaN,504.1855000000007,506.9301203738341,501.44087962616726,505.702447609985,505.33324456692714,506.481835110649,504.18465402320527,14077,24833.333333333332,71.7253890280589,60.77114508458739,NaN,NaN,NaN,NaN,0.813626659175194,37.94410997075216,12462010,0.2670242161824523,0.892072059225768,0.6250478430433157
2025-09-04T11:00:00-04:00,507.53,507.56,506.63,506.78,504.919456016813,NaN,NaN,NaN,NaN,NaN,504.2373000000007,507.0764408623734,501.398159137628,505.702447609985,505.3602622783606,506.5186137134649,504.2019108432563,6587,24753.5,62.8083954552104,61.528146974083526,NaN,NaN,NaN,NaN,0.8219390406626806,38.42291481644338,12455423,0.19461709381189662,0.8683192103081865,0.6737021164962899
2025-09-04T11:05:00-04:00,506.84,507.01,506.6,506.91,504.919456016813,NaN,NaN,NaN,NaN,NaN,504.29390000000075,507.22943967036474,501.35836032963675,505.702447609985,505.3797338434626,506.5427280535293,504.2167396333959,5386,24628.933333333334,63.69829753349363,62.553485626902635,NaN,NaN,NaN,NaN,0.7925148234724869,38.799896703902355,12460809,0.14118584532054446,0.8501844231469704,0.708998577826426
2025-09-04T11:10:00-04:00,506.96,507.1,506.16,506.52,504.919456016813,NaN,NaN,NaN,NaN,NaN,504.3457000000007,507.3444510794198,501.3469489205816,505.702447609985,505.3964858715408,506.5600730125711,504.2328987305105,5729,24523.4,59.127492417533865,63.58000654080824,NaN,NaN,NaN,NaN,0.8030494789387378,38.188267795236484,12455080,0.06894228500419364,0.795176434081668,0.7262341490774744
2025-09-04T11:15:00-04:00,506.51,507.29,506.32,507.29,504.919456016813,NaN,NaN,NaN,NaN,NaN,504.4155000000007,507.5207711630895,501.3102288369119,505.702447609985,505.4346355817183,506.6091507394669,504.2601204239697,10335,24463.433333333334,64.53800969233804,64.39920561360661,NaN,NaN,NaN,NaN,0.8149745161574014,37.82837393773556,12465415,0.06256601551494556,0.8044416684711564,0.7418756529562108
2025-09-04T11:20:00-04:00,507.29,508.04,507.29,507.9,505.30772716161556,NaN,NaN,NaN,NaN,NaN,504.5039000000007,507.74624130777204,501.2615586922294,506.0745542662719,505.510607833954,506.73686895547905,504.28434671242894,14474,24494.566666666666,68.13653305156853,65.42886042867839,NaN,NaN,NaN,NaN,0.8103334792890156,38.21393069591316,12479889,0.08745491562161711,0.8511942974832323,0.7637393818616152
2025-09-04T11:25:00-04:00,507.855,507.99,507.55,507.69,505.45987592699663,NaN,NaN,NaN,NaN,NaN,504.5877000000007,507.9367537224793,501.23864627752215,506.19764341301754,505.5890606116444,506.86180878966934,504.3163124336195,16018,24461.066666666666,65.66608082801852,66.123127451865,NaN,NaN,NaN,NaN,0.7838810879112286,38.571947685649505,12463871,0.07810568927990025,0.8613714934614904,0.7832658041815902
2025-09-04T11:30:00-04:00,507.7,507.74,506.84,506.94,505.45987592699663,NaN,NaN,NaN,NaN,NaN,504.65930000000066,508.05307960929724,501.26552039070407,506.19764341301754,505.621948883848,506.90151234947183,504.3423854182242,9664,24268.633333333335,57.62955498564281,66.10490794466173,NaN,NaN,NaN,NaN,0.7921752959175719,37.45176009981989,12454207,0.013147213350264475,0.7996998208694208,0.7865526075191563
2025-09-04T11:35:00-04:00,506.9,507.1,506.71,507.085,505.45987592699663,NaN,NaN,NaN,NaN,NaN,504.7346000000006,508.17295474558034,501.2962452544209,506.19764341301754,505.64048247825406,506.92080933312025,504.36015562338787,6514,23954.666666666668,58.68237473557041,65.89654277283584,NaN,NaN,NaN,NaN,0.7634484890663199,36.172516139813574,12460721,-0.026173988285678074,0.7538351221620587,0.7800091104477368
2025-09-04T11:40:00-04:00,507.04,507.4,507.02,507.255,505.45987592699663,NaN,NaN,NaN,NaN,NaN,504.81890000000067,508.293424018677,501.34437598132433,506.19764341301754,505.665111325457,506.95048121050434,504.3797414404097,7453,23524.933333333334,59.93920369250236,65.48364597249477,NaN,NaN,NaN,NaN,0.7360593112758682,35.348978303671416,12468174,-0.045709863296770625,0.7228717813267735,0.7685816446235442
2025-09-04T11:45:00-04:00,507.185,507.2,506.83,507.02,505.45987592699663,NaN,NaN,NaN,NaN,NaN,504.8935000000007,508.393591569698,501.3934084303034,506.19764341301754,505.68977054267697,506.97614214710825,504.4033989382457,8911,22985.166666666668,57.3425075635246,64.50385868212719,NaN,NaN,NaN,NaN,0.7138407890418784,34.215261065095284,12459263,-0.07756254785679684,0.6716284598025482,0.749191007659345
2025-09-04T11:50:00-04:00,507.04,507.22,506.8,507.22,505.45987592699663,NaN,NaN,NaN,NaN,NaN,504.9703000000007,508.5025516383016,501.43804836169977,506.19764341301754,505.70670038583387,506.99427583016603,504.4191249415017,6021,21336.366666666665,58.97158496228993,63.65757692116393,NaN,NaN,NaN,NaN,0.692852161253174,33.102799602064586,12465284,-0.08752793517063262,0.6397810886960542,0.7273090238666868
2025-09-04T11:55:00-04:00,507.14,507.24,506.7,506.86,505.45987592699663,NaN,NaN,NaN,NaN,NaN,505.04350000000073,508.5776659548208,501.50933404518065,506.19764341301754,505.7347909021143,507.0206962575459,504.4488855466827,11588,16867.166666666668,54.906868470190155,62.40463889144421,NaN,NaN,NaN,NaN,0.6819341497350916,31.8621233936763,12453696,-0.1187907843964855,0.57882054337108,0.6976113277675655
2025-09-04T12:00:00-04:00,506.89,506.95,506.48,506.64,505.45987592699663,NaN,NaN,NaN,NaN,NaN,505.11250000000075,508.6339134940505,501.591086505951,506.19764341301754,505.74629960274854,507.02867659720835,504.4639226082887,6171,16055.933333333332,52.524262184394445,61.12118247145259,NaN,NaN,NaN,NaN,0.666795996182583,30.256430679606254,12447525,-0.15255839877159283,0.5069133293030745,0.6594717280746674
2025-09-04T12:05:00-04:00,506.65,506.84,506.52,506.81,505.45987592699663,NaN,NaN,NaN,NaN,NaN,505.1835000000007,508.6957882848906,501.6712117151108,506.19764341301754,505.75454268174644,507.0346216892714,504.4744636742215,4358,15237.333333333334,54.17889668050811,59.867861589484676,NaN,NaN,NaN,NaN,0.6420248535981123,28.765430302255496,12451883,-0.1608891969338886,0.45836023190730657,0.6192494288411952
2025-09-04T12:10:00-04:00,506.78,506.94,506.65,506.85,505.45987592699663,NaN,NaN,NaN,NaN,NaN,505.26150000000075,508.7450224983075,501.777977501694,506.19764341301754,505.7624869327575,507.04102351661163,504.48395034890336,3905,14410.466666666667,54.5800155440126,59.28012016725626,NaN,NaN,NaN,NaN,0.6168802211982486,27.562909781795348,12455788,-0.16076957455328067,0.4182874606495943,0.579057035202875
2025-09-04T12:15:00-04:00,506.87,507,506.64,506.8,505.45987592699663,NaN,NaN,NaN,NaN,NaN,505.3445000000007,508.7724931441476,501.91650685585387,505.9207573401035,505.7697775011052,507.04685345292575,504.4927015492846,3636,13795.7,53.944321741902755,58.583407610714055,NaN,NaN,NaN,NaN,0.5985316339698032,26.558525528000548,12452152,-0.1607368264539183,0.37813600213547716,0.5388728285893954
2025-09-04T12:20:00-04:00,506.77,506.83,506,506.08,505.45987592699663,NaN,NaN,NaN,NaN,NaN,505.4035000000008,508.778136127919,502.0288638720826,505.9207573401035,505.77679519649024,507.04690032742616,504.5066900655543,6985,13439.266666666666,45.691589351286076,57.623700248839214,NaN,NaN,NaN,NaN,0.6150650886862447,25.07611227376198,12445167,-0.2031517291971494,0.2849331670929587,0.4880848962901081
2025-09-04T12:25:00-04:00,506.03,506.14,505.81,505.99,505.45987592699663,NaN,NaN,NaN,NaN,NaN,505.4653000000007,508.7666648141729,502.1639351858285,505.9207573401035,505.7782162356726,507.0439858383062,504.51244663303896,3740,12910.933333333332,44.76959161492644,56.211670386166965,NaN,NaN,NaN,NaN,0.5947032966372261,24.046608484415106,12441427,-0.22928038576247084,0.20148441408701956,0.4307647998494904
2025-09-04T12:30:00-04:00,506.04,506.48,505.97,506.19,505.45987592699663,NaN,NaN,NaN,NaN,NaN,505.5317000000007,508.75420561463335,502.309194385368,505.9207573401035,505.7806932721293,507.04327930748457,504.5181072367741,3062,12209.2,47.313855638465526,54.72433628523104,NaN,NaN,NaN,NaN,0.5886530611631378,22.3760001281033,12444489,-0.2248017325028221,0.1497626342209628,0.3745643667237849
2025-09-04T12:35:00-04:00,506.23,506.49,506.16,506.32,505.45987592699663,NaN,NaN,NaN,NaN,NaN,505.59670000000074,508.7482961727645,502.44510382723695,505.9207573401035,505.7853799808808,507.0435041792491,504.5272557825125,4686,11760.366666666667,48.95972355849518,53.53102505169365,NaN,NaN,NaN,NaN,0.5701778425086268,20.804190533249777,12449175,-0.20532865665762462,0.11790354590175411,0.32323220255937873
2025-09-04T12:40:00-04:00,506.34,506.46,506.19,506.3,505.45987592699663,NaN,NaN,NaN,NaN,NaN,505.6665000000007,508.7212315751643,502.6117684248371,505.9207573401035,505.79078363888584,507.0436279744008,504.5379393033709,5575,11104.266666666666,48.70762703219795,52.89374448359045,NaN,NaN,NaN,NaN,0.5487365680437236,19.344653052314364,12443600,-0.18658284206999032,0.09000364997189081,0.2765864920418811
2025-09-04T12:45:00-04:00,506.36,506.74,506.29,506.74,505.45987592699663,NaN,NaN,NaN,NaN,NaN,505.7477000000007,508.69450654885475,502.80089345114664,505.9207573401035,505.79368773009645,507.0451780456775,504.5421974145154,1999,10631.133333333333,54.28459145445592,52.579617106367984,NaN,NaN,NaN,NaN,0.5416839560405997,18.544791265952625,12445599,-0.13949416193086828,0.10221878962829578,0.24171295155916406
2025-09-04T12:50:00-04:00,506.74,507.09,506.64,507.03,505.45987592699663,NaN,NaN,NaN,NaN,NaN,505.8371000000007,508.66027699699754,503.01392300300387,506.0204814497313,505.80000907085656,507.05081581864374,504.5492023230694,3105,9674.033333333333,57.55989487100703,52.40966647626118,NaN,NaN,NaN,NaN,0.5351351020376989,18.47469697120923,12448704,-0.08636390334071287,0.13375807238327297,0.22012197572398584
2025-09-04T12:55:00-04:00,506.97,507.02,506.35,506.36,505.45987592699663,NaN,NaN,NaN,NaN,NaN,505.9083000000007,508.5979108336391,503.21868916636225,506.0204814497313,505.8089430443265,507.05528951877307,504.56259656987993,6438,9136.566666666668,48.85166658611668,51.803177835017756,NaN,NaN,NaN,NaN,0.5454825947492882,17.705799992885765,12442266,-0.09330019283078314,0.10349673468550691,0.19679692751629005
2025-09-04T13:00:00-04:00,506.44,506.94,506.44,506.94,505.45987592699663,NaN,NaN,NaN,NaN,NaN,505.98610000000076,508.5631830712234,503.4090169287781,506.0204814497313,505.8213834101428,507.0644377037011,504.5783291165845,7314,8642.2,55.174003565136424,51.53192202093536,NaN,NaN,NaN,NaN,0.5479481236957665,16.99182422729969,12449580,-0.05753668943416529,0.12487606572358345,0.18241275515774874
2025-09-04T13:05:00-04:00,506.9,507,506.53,506.54,505.45987592699663,NaN,NaN,NaN,NaN,NaN,506.05250000000075,508.5093599870711,503.5956400129304,506.0204814497313,505.8273082546397,507.068177132523,504.58643937675646,3894,7860.966666666666,50.53470259656175,51.219624458533325,NaN,NaN,NaN,NaN,0.5423804005746423,16.458807376250448,12445686,-0.05929473782064726,0.10829433288193968,0.16758907070258694
2025-09-04T13:10:00-04:00,506.5,506.5,506.17,506.17,505.45987592699663,NaN,NaN,NaN,NaN,NaN,506.1061000000007,508.4514061966938,503.7607938033076,506.0204814497313,505.8313983598573,507.0673913163001,504.59540540341453,5205,7405.666666666667,46.6289884115813,50.798533474760966,NaN,NaN,NaN,NaN,0.530067514819311,15.486494091409636,12440481,-0.08242873353395663,0.06455315378514115,0.14698188731909778
2025-09-04T13:15:00-04:00,506.27,506.49,506.23,506.49,505.45987592699663,NaN,NaN,NaN,NaN,NaN,506.1605000000007,508.41079442437103,503.91020557563036,506.0204814497313,505.83306732101727,507.0676411047625,504.598493537272,1686,6961.1,50.21292482797771,50.51524977100879,NaN,NaN,NaN,NaN,0.5150626923322169,14.583631755486026,12442167,-0.0735259768368886,0.05507441627298704,0.12860039310987564
2025-09-04T13:20:00-04:00,506.48,506.78,506.45,506.72,505.45987592699663,NaN,NaN,NaN,NaN,NaN,506.21300000000076,508.38935934440974,504.0366406555918,506.0204814497313,505.83734037577295,507.0700903981833,504.6045903533626,3038,6585.133333333333,52.67288154463205,50.37902591391018,NaN,NaN,NaN,NaN,0.5018439285942004,14.040069498455257,12445205,-0.05058591077076771,0.06536800464641601,0.11595391541718372
2025-09-04T13:25:00-04:00,506.72,506.84,506.57,506.79,505.45987592699663,NaN,NaN,NaN,NaN,NaN,506.26120000000077,508.37900316270185,504.1433968372997,506.0204814497313,505.84326637066397,507.0740775703467,504.61245517098126,3867,6244.8,53.427103188347346,50.34208173151337,NaN,NaN,NaN,NaN,0.4852836479803276,13.67375444933091,12449072,-0.03014561799757634,0.0782718929202133,0.10841751091778964
2025-09-04T13:30:00-04:00,506.77,506.81,506.6,506.74,505.45987592699663,NaN,NaN,NaN,NaN,NaN,506.29640000000074,508.3861741877994,504.2066258122021,506.0204814497313,505.8500872051423,507.078491208954,504.6216832013306,4602,6178.633333333333,52.78008621888237,50.84840293634168,NaN,NaN,NaN,NaN,0.46562053026744554,13.333604760858304,12444470,-0.01993306031573676,0.08350118552311869,0.10343424583885545
2025-09-04T13:35:00-04:00,506.74,507.03,506.74,506.85,505.45987592699663,NaN,NaN,NaN,NaN,NaN,506.32540000000074,508.40482957469413,504.24597042530735,506.1809510677291,505.8592014350821,507.08589565719274,504.6325072129715,5296,6175.633333333333,54.097133053713314,51.51465589625502,NaN,NaN,NaN,NaN,0.4530762066769111,13.547217748756015,12449766,-0.0064101503068289545,0.09542155795531926,0.10183170826214821
2025-09-04T13:40:00-04:00,506.83,507.14,506.74,506.93,505.45987592699663,NaN,NaN,NaN,NaN,NaN,506.32940000000076,508.41269319974634,504.2461068002552,506.2607608541833,505.8689790735453,507.0943617940556,504.643596353035,5445,6166.166666666667,55.078457625999,52.06927032393599,NaN,NaN,NaN,NaN,0.4492850490571301,13.996475239423829,12455211,0.006578811234958029,0.11005522230584575,0.10347641107088772
2025-09-04T13:45:00-04:00,506.97,507.4,506.9,507.33,505.61692475329056,NaN,NaN,NaN,NaN,NaN,506.37360000000075,508.4461298926453,504.3010701073562,506.4466086833466,505.8774074126213,507.10352201019464,504.651292815048,3795,5948.166666666667,59.715734243609134,52.83755680144412,NaN,NaN,NaN,NaN,0.4529075455530494,14.966425494631894,12459006,0.03895885937465554,0.15217498528920714,0.1132161259145516
2025-09-04T13:50:00-04:00,507.37,507.67,507.24,507.53,505.93297362814104,NaN,NaN,NaN,NaN,NaN,506.4324000000007,508.4656321451844,504.39916785481705,506.6922869466773,505.9003790277911,507.1324887154617,504.66826934012045,8781,5758.4,61.83704838840478,53.77537261260175,NaN,NaN,NaN,NaN,0.45127129229926066,16.371188557717694,12467787,0.06894312141258435,0.19939502768028206,0.1304519062676977
2025-09-04T13:55:00-04:00,507.52,507.59,507.24,507.3,505.93297362814104,NaN,NaN,NaN,NaN,NaN,506.4888000000007,508.45770280009816,504.51989719990326,506.6922869466773,505.9123237639555,507.14654516861435,504.67810235929664,4997,5391.033333333334,58.05119964794919,54.04441605499413,NaN,NaN,NaN,NaN,0.4440376285635968,17.675611402011658,12462790,0.06825519581229603,0.21577090103306773,0.1475157052207717
2025-09-04T14:00:00-04:00,507.29,507.525,507.26,507.47,505.93297362814104,NaN,NaN,NaN,NaN,NaN,506.55180000000064,508.4389743524166,504.66462564758467,506.6922869466773,505.9242623969931,507.1608156391757,504.6877091548104,4935,5233.4,60.00048320889871,54.218743793414966,NaN,NaN,NaN,NaN,0.4312492265233389,18.886861185998907,12467725,0.07375009754532383,0.23970332715242648,0.16595322960710265
2025-09-04T14:05:00-04:00,507.41,507.45,507.1,507.31,505.93297362814104,NaN,NaN,NaN,NaN,NaN,506.61760000000066,508.3718226074043,504.86337739259704,506.6922869466773,505.9387456248674,507.17661930254087,504.70087194719395,6689,5239.233333333334,57.301636340288105,54.82231306157007,NaN,NaN,NaN,NaN,0.42687428177167214,19.364679164895843,12461036,0.0616043033906028,0.24295860884535614,0.18135430545475334
2025-09-04T14:10:00-04:00,507.31,507.43,507.08,507.2,505.93297362814104,NaN,NaN,NaN,NaN,NaN,506.6916000000006,508.20981400226174,505.1733859977395,506.6922869466773,505.95357254107176,507.19205986398794,504.7150852181556,7271,5233.166666666667,55.45483451492248,54.84237241512621,NaN,NaN,NaN,NaN,0.42138326164512574,19.72786986504784,12453765,0.04208883993224535,0.23396535537006002,0.19187651543781467
2025-09-04T14:15:00-04:00,507.22,507.335,507.09,507.15,505.93297362814104,NaN,NaN,NaN,NaN,NaN,506.7462000000006,508.1235330158942,505.368866984107,506.6922869466773,505.9732324252172,507.21155745324404,504.73490739719034,10270,5278.466666666666,54.59353053430057,55.132288696393275,NaN,NaN,NaN,NaN,0.4087844572419028,20.06511837233184,12443495,0.022710374220000884,0.22026448321281578,0.1975541089928149
2025-09-04T14:20:00-04:00,507.2,507.45,507.025,507.395,505.93297362814104,NaN,NaN,NaN,NaN,NaN,506.80410000000063,508.0344165269735,505.5737834730278,506.6922869466773,505.9877437750428,507.2268753657079,504.74861218437775,7207,5318,58.033104459846214,55.946868414126484,NaN,NaN,NaN,NaN,0.40994271029605345,20.683001701050937,12450702,0.023208076524477483,0.22656420464841176,0.20335612812393428
2025-09-04T14:25:00-04:00,507.4,507.41,507.01,507.1,505.93297362814104,NaN,NaN,NaN,NaN,NaN,506.85070000000064,507.93743457493576,505.7639654250655,506.6922869466773,505.99609824559286,507.2348324665081,504.7573640246776,4641,5086.433333333333,52.84257674022311,56.13470069357258,NaN,NaN,NaN,NaN,0.40923251670348065,21.18439923275421,12446061,0.0016232511368639846,0.20538519204501426,0.20376194090815028
2025-09-04T14:30:00-04:00,507.11,507.41,506.93,507.41,505.93297362814104,NaN,NaN,NaN,NaN,NaN,506.8987000000007,507.86085759434445,505.93654240565695,506.6922869466773,506.01742935635417,507.2562395196967,504.77861919301165,11398,5260.666666666667,57.17705295518156,56.456427222897545,NaN,NaN,NaN,NaN,0.41428733693894765,21.25552578663285,12457459,0.0059350243074969,0.2111807212925214,0.2052456969850245
2025-09-04T14:35:00-04:00,507.41,507.96,507.41,507.93,506.28333863560425,NaN,NaN,NaN,NaN,NaN,506.9473000000006,507.8664718210635,506.0281281789377,506.9118095433471,506.0416641375451,507.28873826780546,504.7945900072848,9413,5429.166666666667,63.274892186314624,57.15984072275235,NaN,NaN,NaN,NaN,0.4239810985861624,22.669654643493402,12466872,0.03964043576032131,0.25479624168542614,0.21515580592510483
2025-09-04T14:40:00-04:00,507.89,508.15,507.55,507.55,506.4302323339859,NaN,NaN,NaN,NaN,NaN,506.9759000000006,507.8791777849064,506.0726222150948,507.01144763467767,506.06776601382796,507.32289204288935,504.8126399847666,10542,5650.4,56.89863003120295,57.454022423632395,NaN,NaN,NaN,NaN,0.4365538772585769,24.331227748514074,12456330,0.03247607086761006,0.2557508945096174,0.22327482364200735
2025-09-04T14:45:00-04:00,507.55,508,507.48,508,506.4302323339859,NaN,NaN,NaN,NaN,NaN,506.9937000000006,507.94085745083413,506.0465425491671,507.01144763467767,506.07901242461736,507.33794985507353,504.8200749941612,4440,5677.2,61.806948260554485,58.00472350983534,NaN,NaN,NaN,NaN,0.4425143145972487,25.542731891754265,12460770,0.05296553122087219,0.2894817376680976,0.2365162064472254
2025-09-04T14:50:00-04:00,508.01,508.11,507.67,507.69,506.4686827671235,NaN,NaN,NaN,NaN,NaN,507.0057000000007,507.97243472902005,506.0389652709813,507.01144763467767,506.0950187253627,507.3591562752958,504.8308811754296,6431,5658.733333333334,56.9920227520273,58.14140673312307,NaN,NaN,NaN,NaN,0.44233472069744506,26.88179149206068,12454339,0.04109163846478203,0.28788075452820294,0.2467891160634209
2025-09-04T14:55:00-04:00,507.74,507.98,507.5,507.53,506.4686827671235,NaN,NaN,NaN,NaN,NaN,507.00800000000066,507.9791560103358,506.0368439896655,507.01144763467767,506.1130270677173,507.3810216292396,504.845032506195,8106,5804.266666666666,54.626648838472384,57.77790063275616,NaN,NaN,NaN,NaN,0.44502509779048605,27.31804010519825,12446233,0.01903446545767684,0.27058219788551696,0.2515477324278401
2025-09-04T15:00:00-04:00,507.56,507.61,507.42,507.57,506.4686827671235,NaN,NaN,NaN,NaN,NaN,507.01410000000067,507.9954148101003,506.032785189901,507.01144763467767,506.12406958500657,507.3932707963668,504.85486837364635,5555,5887.366666666667,55.12805003558255,57.29868646469743,NaN,NaN,NaN,NaN,0.4268090193768797,27.36049679333628,12451788,0.004471032495414917,0.25713652304710877,0.25266549055169385
2025-09-04T15:05:00-04:00,507.525,507.57,507.23,507.3,506.4686827671235,NaN,NaN,NaN,NaN,NaN,507.01030000000065,507.9856674365918,506.0349325634095,507.01144763467767,506.1388261557044,507.40762889127086,504.87002342013795,8587,6017.4,51.02894055194324,56.79709652926844,NaN,NaN,NaN,NaN,0.42060837513567223,26.587183791703545,12443201,-0.0244256963346757,0.22213337013334922,0.24655906646802492
2025-09-04T15:10:00-04:00,507.28,507.42,507.12,507.4,506.4686827671235,NaN,NaN,NaN,NaN,NaN,507.0227000000006,508.00179797088197,506.04360202911926,507.01144763467767,506.15235812868764,507.4200421639846,504.8846740933907,8428,6112.5,52.439477363326255,56.257024683156125,NaN,NaN,NaN,NaN,0.41199349119741074,25.431714370289388,12451629,-0.03712323634254175,0.20015502103984772,0.23727825738238947
2025-09-04T15:15:00-04:00,507.39,507.44,507.01,507.1,506.4686827671235,NaN,NaN,NaN,NaN,NaN,507.0265000000007,508.0052936433144,506.04770635668694,507.01144763467767,506.15908741379366,507.42535201759654,504.8928228099908,4806,6206.066666666667,47.97504494345221,55.59083958338213,NaN,NaN,NaN,NaN,0.41327967039759617,23.936393708765493,12446823,-0.06444426676038437,0.156722923931909,0.22116719069229338
2025-09-04T15:20:00-04:00,507.09,507.32,506.95,506.95,506.4686827671235,NaN,NaN,NaN,NaN,NaN,507.0351000000007,508.0034418592444,506.066758140757,507.01144763467767,506.1718473061431,507.43381018652843,504.90988442575775,10422,6449.966666666666,45.87217729140298,54.90636406741645,NaN,NaN,NaN,NaN,0.4101882653691967,22.320218513697245,12436401,-0.08977927301037453,0.10894309942932523,0.19872237243969976
2025-09-04T15:25:00-04:00,506.98,507.01,506.55,506.6,506.4686827671235,NaN,NaN,NaN,NaN,NaN,507.0213000000006,507.9943730890072,506.04822691099406,507.01144763467767,506.1832157717976,507.43446469740945,504.9319668461858,15815,6762.533333333334,41.32095196801839,53.95832274125343,NaN,NaN,NaN,NaN,0.41374624641425267,21.932327958388438,12420586,-0.12510028253577388,0.04234701926998241,0.1674473018057563
2025-09-04T15:30:00-04:00,506.63,506.88,506.53,506.78,506.4686827671235,NaN,NaN,NaN,NaN,NaN,506.9989000000007,507.9411065359998,506.05669346400157,506.95332648619376,506.1917314924189,507.4350433184361,504.9484196664017,12064,6920.866666666667,44.377415988972174,52.982916421905294,NaN,NaN,NaN,NaN,0.40919294309895055,21.629017692853616,12432650,-0.13072024909617266,0.004046990435540465,0.13476723953171313
2025-09-04T15:35:00-04:00,506.8,506.84,506.54,506.81,506.4686827671235,NaN,NaN,NaN,NaN,NaN,506.9813000000006,507.90388291579205,506.05871708420915,506.95332648619376,506.20013623043286,507.43550684246577,504.96476561839995,12287,7200.633333333333,44.89262022267374,52.41506238493748,NaN,NaN,NaN,NaN,0.40139344716330794,21.34737244628557,12444937,-0.12670428108032283,-0.023613111818690413,0.10309116926163242
2025-09-04T15:40:00-04:00,506.81,506.93,506.57,506.73,506.4686827671235,NaN,NaN,NaN,NaN,NaN,506.9771000000006,507.9023050349825,506.0518949650187,506.814661188955,506.2083148064936,507.436133239085,504.9804963739022,12029,7428.1,43.72941760312617,51.45451700264781,NaN,NaN,NaN,NaN,0.3984367723659298,20.68555423960634,12432908,-0.12359037796427481,-0.051396803193711094,0.07219357477056372
2025-09-04T15:45:00-04:00,506.73,506.73,506.34,506.38,NaN,NaN,NaN,507.82191680246194,507.82191680246194,507.82191680246194,506.9630000000006,507.9025743700629,506.0234256299383,506.582728951164,506.2138198998263,507.4298976726318,504.99774212702084,16319,7915.866666666667,38.971760062873315,49.718578993830576,NaN,NaN,NaN,NaN,0.39783414576836645,20.798647131060395,12416589,-0.13815418935797488,-0.10049916192690489,0.03765502743107
2025-09-04T15:50:00-04:00,506.37,508.12,506.31,507.35,505.7397612340136,505.7397612340136,505.7397612340136,NaN,NaN,NaN,506.9649000000006,507.90720884356887,506.0225911564324,506.5781831609312,506.2499272889915,507.46000003143723,505.03985454654577,29143,8786.033333333333,53.93118500773742,49.506618635011606,NaN,NaN,NaN,NaN,0.4987031353563404,21.47702603068855,12445732,-0.07848039309078428,-0.06044546393241035,0.01803492915837393
2025-09-04T15:55:00-04:00,507.33,507.97,507.09,507.77,506.0018175415584,NaN,NaN,NaN,NaN,NaN,506.9799000000006,507.94874361821104,506.0110563817902,506.47654652874496,506.418444098365,507.636493911603,505.200394285127,119419,12637.766666666666,58.65672233299159,49.28160249732855,NaN,NaN,NaN,NaN,0.5259386256880341,22.10694929462898,12565151,-0.010324943978638524,0.005128749185075776,0.0154536931637143
2025-09-05T09:30:00-04:00,509.05,511.97,506.69,507.06,507.15128038057856,NaN,NaN,NaN,NaN,NaN,506.9767000000006,507.9434049376895,506.00999506231176,507.92077309777153,508.57333333333327,508.5733409627278,508.57332570393874,86440,15365.7,49.42675798825686,48.74122644277351,NaN,NaN,NaN,NaN,0.8655144381388908,25.625870766957053,12478711,-0.012516607922379155,-0.00019206673925964424,0.01232454118311951
2025-09-05T09:35:00-04:00,507.07,507.48,499.87,500.95,NaN,NaN,NaN,506.7924141821751,506.7924141821751,506.7924141821751,506.8585000000006,508.80355346879605,504.9134465312052,507.92077309777153,504.77986368200305,507.5433762620109,502.0163511019952,162879,20618.466666666667,20.10599281337946,46.27546529812402,NaN,NaN,NaN,NaN,1.3472634068432565,25.059015985692167,12315832,-0.4032724455680411,-0.4917660157769319,-0.08849357020889079
2025-09-05T09:40:00-04:00,501.09,503.65,500.1,502.95,NaN,NaN,NaN,505.33480444662166,NaN,NaN,506.7847000000006,509.0162325756984,504.55316742430284,507.92077309777153,503.8848394357795,506.42077655845713,501.34890231310186,135117,24940.866666666665,33.92360460145814,44.76086205282943,NaN,NaN,NaN,NaN,1.5046017349258778,24.53265083166049,12450949,-0.49860831981002796,-0.7117539699714257,-0.21314565016139778
2025-09-05T09:45:00-04:00,503.12,503.9,501.3,503.62,NaN,NaN,NaN,505.33480444662166,NaN,NaN,506.7209000000006,509.12186454715453,504.31993545284666,507.92077309777153,503.76563410396693,506.1568754421055,501.37439276582836,55505,26664.533333333333,37.804292239661585,43.81624431623788,NaN,NaN,NaN,NaN,1.5828444681454557,23.86216556869785,12506454,-0.4875240838220035,-0.8225507549389022,-0.33502667111689866
2025-09-05T09:50:00-04:00,503.62,503.7,501.75,502.77,NaN,NaN,NaN,505.33480444662166,NaN,NaN,506.6393000000007,509.2822967908306,503.9963032091707,507.92077309777153,503.66823829840916,505.9628947361341,501.3735818606842,46161,27910.533333333333,34.996195985017195,42.57029564635866,NaN,NaN,NaN,NaN,1.6090698632779223,23.239572110232537,12460293,-0.5062105214081452,-0.96778982287708,-0.46157930146893494
2025-09-05T09:55:00-04:00,502.68,502.77,501.16,502.54,NaN,NaN,NaN,505.33480444662166,NaN,NaN,506.55410000000063,509.4348413553461,503.67335864465514,507.92077309777153,503.51624374436415,505.7394474401214,501.2930400486069,54344,29555.433333333334,34.254740380118804,41.59027389183484,NaN,NaN,NaN,NaN,1.6091363016152105,23.000019633022443,12405949,-0.501856358759547,-1.0888997499183688,-0.5870433911588218
2025-09-05T10:00:00-04:00,502.47,502.47,500.95,501.18,NaN,NaN,NaN,505.33480444662166,NaN,NaN,506.4561000000007,509.70459952383777,503.2076004761636,507.92077309777153,503.3422857959525,505.53857947544225,501.1459921164627,51972,31123.333333333332,30.18264977477132,40.46959335493258,NaN,NaN,NaN,NaN,1.6077694229284119,22.897537863805034,12353977,-0.5542591746126224,-1.2798673594245997,-0.7256081848119773
2025-09-05T10:05:00-04:00,501.2,501.2,500.57,500.78,NaN,NaN,NaN,504.64532317019376,NaN,NaN,506.3519000000007,509.9670607925916,502.73673920740976,507.92077309777153,503.219460746632,505.42785671586944,501.0110647773946,30709,31924,29.087413976277247,39.595769212665346,NaN,NaN,NaN,NaN,1.5379287498620964,23.022261049050226,12323268,-0.576960896787555,-1.446809305796421,-0.8698484090088661
2025-09-05T10:10:00-04:00,500.76,501.69,500.25,501.25,NaN,NaN,NaN,504.64532317019376,NaN,NaN,506.2531000000007,510.1403349499481,502.3658650500533,507.92077309777153,503.1017629738867,505.304195055166,500.8993308926074,35979,32880.933333333334,32.200556099801915,38.72599350629604,NaN,NaN,NaN,NaN,1.5309338391576606,22.67791755468865,12359247,-0.5230201089493114,-1.5236235451955054,-1.000603436246194
2025-09-05T10:15:00-04:00,501.24,501.44,500.55,500.57,NaN,NaN,NaN,504.64532317019376,NaN,NaN,506.1381000000007,510.33823661161813,501.93796338838325,507.92077309777153,503.0089647213979,505.21136005826276,500.806569384533,28374,33484.4,30.13897759104148,37.67216188975088,NaN,NaN,NaN,NaN,1.4851528506463982,22.358170024210047,12330873,-0.49606719064427174,-1.6206874245515337,-1.124620233907262
2025-09-05T10:20:00-04:00,500.54,500.87,499.94,499.95,NaN,NaN,NaN,504.09708986468485,NaN,NaN,506.0111000000007,510.55400008213775,501.4681999178636,500.43561847821724,502.865437305959,505.0954176825352,500.6354569293828,37775,34503.333333333336,28.356374443872227,36.5740873783756,NaN,NaN,NaN,NaN,1.4454990756002275,22.466984563685223,12293098,-0.4824829653352394,-1.7277239405763112,-1.2452409752410718
2025-09-05T10:25:00-04:00,500,500,498.17,499.2,NaN,NaN,NaN,502.8588130526538,NaN,NaN,505.8603000000006,510.7812512938563,500.9393487061449,497.26626121622644,502.5611134995319,504.9306283381694,500.19159866089444,64202,36488.7,26.327782518858186,35.670946125231666,NaN,NaN,NaN,NaN,1.4729634273430674,23.537452993365545,12228896,-0.4851867053610952,-1.8517243569424409,-1.3665376515813457
2025-09-05T10:30:00-04:00,499.12,499.58,498.41,498.91,NaN,NaN,NaN,502.7568215502604,NaN,NaN,505.6979000000007,510.9766635253126,500.4191364746888,497.26626121622644,502.4256641365106,504.84879121895074,500.00253705407044,30914,37139.23333333333,25.566175098488188,33.64487398885672,NaN,NaN,NaN,NaN,1.4513231825328454,24.531459392354414,12197982,-0.46749572798783623,-1.9509073115661408,-1.4834115835783046
2025-09-05T10:35:00-04:00,498.85,499.24,498.06,498.99,NaN,NaN,NaN,502.4017387525212,NaN,NaN,505.5505000000006,511.1489855984874,499.95201440151385,497.26626121622644,502.2984738677024,504.77178451450766,499.82516322089714,29516,37809.333333333336,26.20040619077858,31.32656569298436,NaN,NaN,NaN,NaN,1.4319429552090714,25.629969344038688,12227498,-0.4132710741856822,-2.0000004263104074,-1.5867293521247252
2025-09-05T10:40:00-04:00,499.09,499.27,498.5,498.6,NaN,NaN,NaN,502.4017387525212,NaN,NaN,505.3837000000006,511.2948801898204,499.4725198101808,497.26626121622644,502.2330830527419,504.7287589487505,499.7374071567333,16141,37995.96666666667,25.078545723334884,29.587407674061364,NaN,NaN,NaN,NaN,1.3846613155512792,26.61390651393807,12211357,-0.36804273934722764,-2.04678277630876,-1.6787400369615322
2025-09-05T10:45:00-04:00,498.64,498.64,497.25,497.48,NaN,NaN,NaN,501.65319584682203,NaN,NaN,505.20250000000067,511.5033914445745,498.90160855542683,497.26626121622644,502.01402145693294,504.6306288701733,499.39741404369255,44913,39345.066666666666,22.145884184760163,29.733114200588552,NaN,NaN,NaN,NaN,1.3850426501547584,28.13138140873842,12166444,-0.37657211773266375,-2.149455184127362,-1.7728830663946982
2025-09-05T10:50:00-04:00,497.48,497.74,496.9,497.17,NaN,NaN,NaN,500.97418694469377,NaN,NaN,505.02250000000066,511.7051965363161,498.3398034636852,497.26626121622644,501.8447691455926,504.56076941032524,499.1287688808599,33702,40254.1,21.399949672141034,28.83856741992305,NaN,NaN,NaN,NaN,1.3461110322865635,29.69081430574908,12132742,-0.36579807347642346,-2.2301306582402276,-1.8643325847638041
2025-09-05T10:55:00-04:00,497.19,497.4,495.07,495.24,NaN,NaN,NaN,500.0408148108441,NaN,NaN,504.79750000000064,512.004401761268,497.5905982387333,497.26626121622644,501.5973446918625,504.50909715966714,498.6855922240578,41048,41352.166666666664,17.457471353588673,27.385223070917846,NaN,NaN,NaN,NaN,1.416388815694665,31.80080047344814,12091694,-0.44604069866278206,-2.4218834580922817,-1.9758427594294996
2025-09-05T11:00:00-04:00,495.32,495.48,494.55,494.93,NaN,NaN,NaN,498.77464141035114,NaN,NaN,504.56170000000066,512.2565522036762,496.8668477963251,497.26626121622644,501.1632913822559,504.4194557487654,497.9071270157464,69268,43475.933333333334,16.918329426124643,26.093946888139804,NaN,NaN,NaN,NaN,1.381646757430761,33.916266277391,12022426,-0.4747231256013018,-2.569246666431127,-2.094523540829825
2025-09-05T11:05:00-04:00,494.93,495.55,494.59,495.51,NaN,NaN,NaN,498.77464141035114,NaN,NaN,504.33610000000067,512.4085596720215,496.2636403279799,497.06600897298114,500.934118341847,504.3259151111706,497.5423215725234,42286,44599.23333333333,21.785325482392153,25.20327439544504,NaN,NaN,NaN,NaN,1.351529131899995,35.79166775381034,12064712,-0.41170532812201444,-2.609155200982343,-2.1974498728603287
2025-09-05T11:10:00-04:00,495.48,496.21,494.68,496.18,NaN,NaN,NaN,498.77464141035114,NaN,NaN,504.1249000000007,512.4822705168748,495.7675294831267,496.04180717838494,500.7716843236617,504.2319421289036,497.3114265184198,35073,45487.4,27.098153924901013,24.982953263311448,NaN,NaN,NaN,NaN,1.3642770510499933,36.701917454726896,12099785,-0.28783315411618826,-2.557241315505564,-2.269408161389376
2025-09-05T11:15:00-04:00,496.22,497.16,496.1,496.52,NaN,NaN,NaN,498.77464141035114,NaN,NaN,503.91830000000067,512.5036115515078,495.33298844849355,496.0120052753331,500.65512359362134,504.1354706506091,497.1747765366336,32494,46410.333333333336,29.707521169430848,25.027246634250993,NaN,NaN,NaN,NaN,1.3425429759749938,36.473249335609594,12132279,-0.15271601897807363,-2.460303185111968,-2.3075871661338945
2025-09-05T11:20:00-04:00,496.48,497.35,496.39,496.94,NaN,NaN,NaN,498.77464141035114,NaN,NaN,503.7185000000007,512.4773812639679,494.95961873603346,496.0120052753331,500.5830624812817,504.0682694616756,497.09785550088776,22749,46821.23333333333,32.90243041769082,25.077380514100206,NaN,NaN,NaN,NaN,1.3152184776910683,36.057460765230935,12155028,-0.012180339743864899,-2.322812590813726,-2.310632251069861
2025-09-05T11:25:00-04:00,496.89,497.51,496.55,497.11,NaN,NaN,NaN,498.77464141035114,NaN,NaN,503.51410000000067,512.4023636525035,494.62583634749785,496.0120052753331,500.5177726178404,504.00313514506854,497.0324100906123,22402,47040.8,34.20595895543504,25.367879182985458,NaN,NaN,NaN,NaN,1.2898457292845618,35.494226846706326,12177430,0.10845781092915496,-2.1750599874084173,-2.2835177983375723
2025-09-05T11:30:00-04:00,497.14,497.25,496.19,496.67,NaN,NaN,NaN,498.77464141035114,NaN,NaN,503.2969000000007,512.3118690823876,494.2819309176137,495.33860422026646,500.46678714564706,503.95638042045846,496.97719387083566,16392,47185.066666666666,32.4488392142121,25.66019809515259,NaN,NaN,NaN,NaN,1.2734281771928075,35.19682513443647,12161038,0.17112455275722782,-2.0696121073910376,-2.2407366601482654
2025-09-05T11:35:00-04:00,496.78,497.64,496.74,496.97,NaN,NaN,NaN,498.77464141035114,NaN,NaN,503.0903000000007,512.2017939299872,493.97880607001423,494.8806194272123,500.39891302466344,503.88507524488165,496.91275080444524,25360,47620.833333333336,34.904148256820505,26.272795647864182,NaN,NaN,NaN,NaN,1.2517547359647476,34.46290988315823,12186398,0.24100588820995794,-1.939479299885818,-2.180485188095776
2025-09-05T11:40:00-04:00,496.96,497.74,496.94,497.35,NaN,NaN,NaN,498.77464141035114,NaN,NaN,502.88790000000074,512.0507052667327,493.72509473326875,495.13249554176986,500.3442489227283,503.8227467638665,496.8657510815901,22801,47979.9,37.97923580987371,27.159442841534577,NaN,NaN,NaN,NaN,1.219486540538695,33.66278162248088,12209199,0.3163020080346226,-1.7851076780524977,-2.1014096860871203
2025-09-05T11:45:00-04:00,497.33,497.33,496.52,496.86,NaN,NaN,NaN,498.77464141035114,NaN,NaN,502.67890000000074,511.90520614904443,493.45259385095704,495.13249554176986,500.29683895602903,503.7744985883708,496.81917932368725,17806,48029.46666666667,35.641187382270445,27.83378435521257,NaN,NaN,NaN,NaN,1.1916660733573625,33.230735999073644,12191393,0.33480257900061794,-1.6829064623363479,-2.017709041336966
2025-09-05T11:50:00-04:00,496.86,496.9,496.26,496.72,NaN,NaN,NaN,498.77464141035114,NaN,NaN,502.4693000000007,511.7512420401184,493.187357959883,495.13249554176986,500.260078106507,503.7395245865926,496.78063162642144,13075,47493.86666666667,34.97862518225877,28.540932887992845,NaN,NaN,NaN,NaN,1.1522613538318356,33.01795462472425,12178318,0.33830806928891244,-1.5948239547258254,-1.9331320240147378
2025-09-05T11:55:00-04:00,496.74,496.9,496,496.32,NaN,NaN,NaN,498.77464141035114,NaN,NaN,502.2527000000007,511.5928916916227,492.9125083083787,495.13249554176986,500.21162266459197,503.6956838846932,496.72756144449073,16624,44067.36666666667,33.08612043976639,29.322378334779007,NaN,NaN,NaN,NaN,1.1342426857009886,33.008492865646694,12161694,0.31486750480270187,-1.5395476430113604,-1.8544151478140622
2025-09-05T12:00:00-04:00,496.32,496.65,495.78,496.07,NaN,NaN,NaN,498.77464141035114,NaN,NaN,502.0262000000007,511.40578283913476,492.64661716086664,495.13249554176986,500.1791499889948,503.6679219799095,496.6903779980801,10699,41542.666666666664,31.92357364421187,30.07406576135549,NaN,NaN,NaN,NaN,1.1153682081509184,33.15917088036939,12150995,0.2846214711778512,-1.4986383088417483,-1.7832597800195995
2025-09-05T12:05:00-04:00,496.11,496.69,495.8,496.69,NaN,NaN,NaN,498.77464141035114,NaN,NaN,501.81800000000067,511.19998870155933,492.436011298442,495.13249554176986,500.14829814860286,503.6394566752078,496.65713962199794,10950,36478.36666666667,37.763976410778994,31.52453040829766,NaN,NaN,NaN,NaN,1.0992704789972805,33.23663196987937,12161945,0.3065681060180916,-1.400049647496985,-1.7066177535150766
2025-09-05T12:10:00-04:00,496.69,497.17,496.66,496.84,NaN,NaN,NaN,498.77464141035114,NaN,NaN,501.6066000000007,510.9513179602241,492.2618820397773,495.13249554176986,500.12513381329904,503.6146148153056,496.6356528112925,9621,32295.166666666668,39.12470460366254,33.11070006383608,NaN,NaN,NaN,NaN,1.0571797304974742,32.568565350070514,12171566,0.3293845827285402,-1.2948870251044013,-1.6242716078329416
2025-09-05T12:15:00-04:00,496.83,497.03,496.1,496.52,NaN,NaN,NaN,498.77464141035114,NaN,NaN,501.3784000000007,510.65129069039534,492.105509309606,495.13249554176986,500.09425332202255,503.5843465430856,496.6041601009595,11791,30838.033333333333,37.25342306358375,34.21556417677834,NaN,NaN,NaN,NaN,1.0480954640333653,32.42878391331381,12159775,0.32080514597400045,-1.2232651753654409,-1.5440703213394413
2025-09-05T12:20:00-04:00,496.545,497.1,496.39,497.09,NaN,NaN,NaN,498.77464141035114,NaN,NaN,501.1692000000007,510.34719441249877,491.9912055875027,495.13249554176986,500.06402463736873,503.5516825549498,496.57636671978764,12879,29728.633333333335,42.52651290100867,35.317589817928884,NaN,NaN,NaN,NaN,1.0239457880309846,32.189284749904374,12172654,0.3490636481288969,-1.10774076117832,-1.456804409307217
2025-09-05T12:25:00-04:00,497.13,497.15,496.69,496.83,NaN,NaN,NaN,498.77464141035114,NaN,NaN,500.94580000000065,509.9906580661242,491.9009419338771,495.2783547654665,500.0484861875393,503.5346428114412,496.56232956363743,6779,28143.133333333335,40.84054300620243,36.11280566341257,NaN,NaN,NaN,NaN,0.9836639460287699,31.8842462569,12165875,0.34516585171377834,-1.025347094664994,-1.3705129463787724
2025-09-05T12:30:00-04:00,496.87,497.01,496.19,496.25,NaN,NaN,NaN,498.77464141035114,NaN,NaN,500.7170000000007,509.64590609179027,491.7880939082112,495.2783547654665,500.02144330874637,503.5081010098236,496.53478560766916,10584,26763.533333333333,37.28905203838133,36.42613577917618,NaN,NaN,NaN,NaN,0.9719736641695716,32.0542726088059,12155291,0.30010908403724423,-0.9953765913322172,-1.2954856753694615
2025-09-05T12:35:00-04:00,496.27,496.3,495.52,495.58,NaN,NaN,NaN,498.77464141035114,NaN,NaN,500.47800000000063,509.3037931086306,491.65220689137067,495.2783547654665,499.95202682781485,503.45132641201144,496.45272724361826,23328,26517.5,33.64888451330033,36.386344747595125,NaN,NaN,NaN,NaN,0.9582612595860329,32.74143742442846,12131963,0.2251890217183461,-1.0139993982215287,-1.2391884199398748
2025-09-05T12:40:00-04:00,495.5,496.01,495.35,495.48,NaN,NaN,NaN,498.6643624249792,NaN,NaN,500.2362000000007,508.93306370113885,491.5393362988625,495.2783547654665,499.8775249393,503.3921403062021,496.3629095723978,24786,26144.4,33.129057329038446,36.43493175579701,NaN,NaN,NaN,NaN,0.936956883901314,33.50400787924927,12107177,0.17134147537654743,-1.0250115757191907,-1.196353051095738
2025-09-05T12:45:00-04:00,495.46,495.53,494.17,494.24,NaN,NaN,NaN,497.8841641329347,NaN,NaN,499.97500000000065,508.59167615710277,491.3583238428985,495.2783547654665,499.6788941955759,503.2681859770574,496.0896024140944,56975,27097.766666666666,27.463414248363733,35.90345075519296,NaN,NaN,NaN,NaN,0.9671742493369314,34.95004109808258,12050202,0.06038189253149295,-1.120875685431372,-1.181257577962865
2025-09-05T12:50:00-04:00,494.23,494.84,494,494.56,NaN,NaN,NaN,497.4307930359831,NaN,NaN,499.7182000000007,508.19868648581644,491.237713514185,495.2783547654665,499.59443574498107,503.2148423157754,495.97402917418674,24713,26662.366666666665,30.75453954990698,35.38740102233819,NaN,NaN,NaN,NaN,0.9580903743842917,36.383794269419944,12074915,0.018860209343390943,-1.1576823162836263,-1.1765425256270172
2025-09-05T12:55:00-04:00,494.56,495.24,494.43,495.14,NaN,NaN,NaN,497.4307930359831,NaN,NaN,499.47900000000067,507.7860632594402,491.17193674056114,495.2783547654665,499.5191184796559,503.1578727338732,495.8803642254386,25067,25357.866666666665,36.38816452637246,35.44075653263119,NaN,NaN,NaN,NaN,0.9475124904996995,36.992632293361964,12099982,0.03958709802921323,-1.1270586530905007,-1.166645751119714
2025-09-05T13:00:00-04:00,495.12,495.12,494.33,494.41,NaN,NaN,NaN,497.4307930359831,NaN,NaN,499.22820000000064,507.3735060738339,491.0828939261674,495.2783547654665,499.4803471442251,503.13057862682393,495.8301156616263,12366,24739.6,32.77401719372983,35.283284533450555,NaN,NaN,NaN,NaN,0.9376901697497211,37.62591778861517,12087616,0.014552281250619359,-1.1484553995564397,-1.163007680807059
2025-09-05T13:05:00-04:00,494.47,494.97,493.99,494.97,NaN,NaN,NaN,497.4307930359831,NaN,NaN,498.99560000000065,506.9474995564869,491.0437004435144,495.2783547654665,499.40610256659085,503.07669968771205,495.73550544546964,24358,24567.666666666668,37.87183250602175,35.62512110961165,NaN,NaN,NaN,NaN,0.9407123004818851,38.4438903785751,12111974,0.04443889923434474,-1.107459056764128,-1.1518979559984728
2025-09-05T13:10:00-04:00,495,495.22,494.67,495.2,NaN,NaN,NaN,497.4307930359831,NaN,NaN,498.7640000000007,506.4661378847734,491.061862115228,495.2783547654665,499.3529253520314,503.03252324605035,495.6733274580124,19521,24680.333333333332,39.88802694613239,36.1940106311774,NaN,NaN,NaN,NaN,0.912804279018894,38.72466352823142,12131495,0.08602138832178063,-1.044371220596247,-1.1303926089180276
2025-09-05T13:15:00-04:00,495.12,495.25,494.515,494.78,NaN,NaN,NaN,497.4307930359831,NaN,NaN,498.5234000000007,505.9518659086456,491.09493409135587,495.1026838123732,499.2742503662602,502.9690002114575,495.5795005210629,28556,24135.1,37.49512546937935,36.174806992506,NaN,NaN,NaN,NaN,0.9001039733746883,39.10534817094985,12102939,0.09107725841484893,-1.0165460358994665,-1.1076232943143154
2025-09-05T13:20:00-04:00,494.8,495,494.68,494.93,NaN,NaN,NaN,497.4307930359831,NaN,NaN,498.2874000000006,505.40108125209593,491.1737187479053,494.38414704989856,499.2405873640258,502.94112293179194,495.5400517962597,12593,23431.466666666667,38.90479096697081,36.15909887559945,NaN,NaN,NaN,NaN,0.8586679752764957,39.4588410534741,12115532,0.10914239917680679,-0.971195295343307,-1.0803376945201137
2025-09-05T13:25:00-04:00,494.98,494.98,494.32,494.56,NaN,NaN,NaN,497.3942255838797,NaN,NaN,498.0510000000006,504.8519696364815,491.2500303635197,494.14731763991887,499.18749631515766,502.89951888188585,495.47547374842947,19151,22701.566666666666,36.705759014079916,36.11998001492061,NaN,NaN,NaN,NaN,0.8444774056138906,40.07797622747762,12096381,0.10098055144245799,-0.9541120052170413,-1.0550925566594993
2025-09-05T13:30:00-04:00,494.56,495,494.43,494.97,NaN,NaN,NaN,497.3942255838797,NaN,NaN,497.80340000000064,504.1160585331513,491.49074146684995,493.3598541119351,499.15145475797596,502.8693513081387,495.43355820781323,13805,20852.8,40.70530857691671,35.989893991771176,NaN,NaN,NaN,NaN,0.8248718766414694,40.60700754078884,12110186,0.1263556156396335,-0.8971480371099574,-1.0235036527495909
2025-09-05T13:35:00-04:00,494.94,495.3,494.76,494.77,NaN,NaN,NaN,497.3942255838797,NaN,NaN,497.54340000000064,503.23275231429915,491.85404768570214,493.6975179730203,499.10521093060953,502.8285582269622,495.3818636342569,18673,20065.7,39.39749361118914,35.88681903498451,NaN,NaN,NaN,NaN,0.8045238854527945,40.408633548449316,12091513,0.13220399878606037,-0.8582486542670154,-0.9904526530530757
2025-09-05T13:40:00-04:00,494.76,494.83,493.84,494,NaN,NaN,NaN,496.9978759515693,NaN,NaN,497.2822000000006,502.366984030459,492.19741596954225,493.6975179730203,499.0457682817674,502.7849087037971,495.30662785973766,20945,19594.766666666666,34.76624165383032,35.70661829323087,NaN,NaN,NaN,NaN,0.8177721793490241,41.01382222145387,12070568,0.0888294666046987,-0.8794158197972024,-0.9682452864019011
2025-09-05T13:45:00-04:00,493.96,494.21,493.81,493.89,NaN,NaN,NaN,496.60638159013433,NaN,NaN,497.1410000000006,502.20258275606807,492.0794172439331,493.6975179730203,498.9901259774217,502.7460860549013,495.2341658999421,19066,19147.166666666668,34.148665951831006,35.74231696741163,NaN,NaN,NaN,NaN,0.7879313093955208,41.598435120873575,12051502,0.05879392714901299,-0.8947528774656348,-0.9535468046146478
2025-09-05T13:50:00-04:00,493.92,493.93,493.35,493.51,NaN,NaN,NaN,496.19745515421914,NaN,NaN,496.9522000000006,501.83402472407624,492.0703752759249,493.6975179730203,498.9403370889141,502.7143353319278,495.1663388459003,16205,18929.033333333333,32.031818117009664,35.663942737981,NaN,NaN,NaN,NaN,0.7730790730101254,42.478475872357194,12035297,0.021328750040642164,-0.9268858670638451,-0.9482146171044873
2025-09-05T13:55:00-04:00,493.5,493.71,493.37,493.53,NaN,NaN,NaN,496.0275708290273,NaN,NaN,496.7504000000006,501.33837028723616,492.162429712765,493.6975179730203,498.88116928076073,502.6763412119993,495.0859973495222,19434,18830.1,32.26979205094605,36.00725543816546,NaN,NaN,NaN,NaN,0.7421448535094004,43.295656570163416,12054731,0.006649259471251834,-0.9399030427654225,-0.9465523022366743
2025-09-05T14:00:00-04:00,493.56,493.66,493.02,493.07,NaN,NaN,NaN,495.8017721549807,NaN,NaN,496.55640000000056,500.9248903750289,492.18790962497224,493.6975179730203,498.82656197679705,502.6433901319411,495.009733821653,17380,18863.033333333333,29.6945775585408,35.93154386735359,NaN,NaN,NaN,NaN,0.7348487925444463,44.30390790571529,12037351,-0.023626714695053286,-0.9760856956054909,-0.9524589809104376
2025-09-05T14:05:00-04:00,493.09,493.37,492.88,492.88,NaN,NaN,NaN,495.54169160248154,NaN,NaN,496.3632000000006,500.5046247592495,492.22177524075164,493.6975179730203,498.76264341818427,502.6061748536671,494.91911198270145,20030,18685.366666666665,28.67662909142868,35.38071990771475,NaN,NaN,NaN,NaN,0.7173595930769866,45.33631019783762,12017321,-0.04480652673858976,-1.0084671393336748,-0.9636606125950851
2025-09-05T14:10:00-04:00,492.88,493.73,492.84,493.73,NaN,NaN,NaN,495.54169160248154,NaN,NaN,496.21420000000063,500.18423393390947,492.2441660660918,493.6975179730203,498.70193292744017,502.56513172854847,494.8387341263319,20883,18621.433333333334,38.786505019006185,35.81018332380591,NaN,NaN,NaN,NaN,0.7296910507143478,45.38214826449307,12038204,0.007297733668002793,-0.9545384455100816,-0.9618361791780844
2025-09-05T14:15:00-04:00,493.74,494.3,493.59,494.3,NaN,NaN,NaN,495.54169160248154,NaN,NaN,496.0846000000006,499.8686976938323,492.3005023061689,493.6975179730203,498.6338719662248,502.5089719388272,494.75877199362236,27298,18937.833333333332,44.47079273289062,36.281537625725115,NaN,NaN,NaN,NaN,0.7282845470918969,44.166258942901436,12065502,0.08471806062903409,-0.8559386033917917,-0.9406566640208258
2025-09-05T14:20:00-04:00,494.34,494.73,494.19,494.21,NaN,NaN,NaN,495.54169160248154,NaN,NaN,495.94380000000064,499.46327698335705,492.4243230166442,493.6975179730203,498.58851068212215,502.4676152211014,494.70940614314287,20037,19169.9,43.77951564083515,36.55950110391817,NaN,NaN,NaN,NaN,0.7148356508710486,42.21850213704371,12045465,0.13163475846586525,-0.7761132159384942,-0.9077479744043595
2025-09-05T14:25:00-04:00,494.27,494.7,494.19,494.61,NaN,NaN,NaN,495.54169160248154,NaN,NaN,495.8246000000006,499.1048541603365,492.5443458396647,493.19131110718234,498.5529510687001,502.43376270416564,494.6721394332346,16499,19165.733333333334,47.672723493897735,37.286472391383775,NaN,NaN,NaN,NaN,0.7002045329516874,40.40987081731867,12061964,0.1879435547235182,-0.6728185309999617,-0.8607620857234799
2025-09-05T14:30:00-04:00,494.65,494.73,493.12,493.19,NaN,NaN,NaN,495.54169160248154,NaN,NaN,495.6894000000006,498.83276230118804,492.54603769881317,493.19131110718234,498.47402748886753,502.3721210964374,494.57593388129766,31230,19850.1,37.693577023356106,37.199957109697,NaN,NaN,NaN,NaN,0.7651899234551393,39.94668392065307,12030734,0.13061082664394286,-0.6974985524185513,-0.8281093790624942
2025-09-05T14:35:00-04:00,493.18,493.425,492.41,492.78,NaN,NaN,NaN,495.3975468976241,NaN,NaN,495.56100000000055,498.6441808245236,492.4778191754775,493.19131110718234,498.2902334254769,502.25161379621653,494.3288530547373,65404,21665.233333333334,35.39009235818918,37.10598091999053,NaN,NaN,NaN,NaN,0.7830335003511998,40.11936769870062,11965330,0.06921342101787598,-0.7415926027901492,-0.8108060238080251
2025-09-05T14:40:00-04:00,492.84,493.2,492.7,493.07,NaN,NaN,NaN,495.38549931136845,NaN,NaN,495.44420000000065,498.452617762916,492.4357822370853,493.19131110718234,498.2502203032137,502.2231970741108,494.2772435323167,15165,21850.033333333333,38.26388920398956,36.9315938219243,NaN,NaN,NaN,NaN,0.7628168217546856,40.279716921173346,11980495,0.053001520994301554,-0.7445541225651482,-0.7975556435594497
2025-09-05T14:45:00-04:00,493.05,493.05,492.53,492.7,NaN,NaN,NaN,495.1884311608517,NaN,NaN,495.3184000000006,498.24823101159564,492.3885689884056,493.19131110718234,498.1732307480621,502.17072489062343,494.1757366055008,28570,22409.333333333332,36.06008934226362,36.693207802715335,NaN,NaN,NaN,NaN,0.7469013344864953,40.56962053299657,11951925,0.023720415774677095,-0.7679051238411034,-0.7916255396157805
2025-09-05T14:50:00-04:00,492.79,493.75,492.79,493.7,NaN,NaN,NaN,495.1884311608517,NaN,NaN,495.2204000000006,498.0299407732613,492.41085922673994,493.19131110718234,498.1275294502538,502.13277296319984,494.12228593730777,19751,22638.4,45.23983681186854,37.44132174257521,NaN,NaN,NaN,NaN,0.7685512391660322,39.47938243216181,11971676,0.07515888565553808,-0.6976769325463579,-0.772835818201896
2025-09-05T14:55:00-04:00,493.7,493.87,493.08,493.19,NaN,NaN,NaN,495.1884311608517,NaN,NaN,495.13460000000055,497.92483500026765,492.34436499973344,493.19131110718234,498.0800517110361,502.0931172986798,494.06698612339244,20780,23105.1,41.9333053099654,37.99736741101338,NaN,NaN,NaN,NaN,0.7700832935113171,38.25431635735263,11950896,0.07795835715406674,-0.6753878717593125,-0.7533462289133792
2025-09-05T15:00:00-04:00,493.14,493.16,492.38,492.51,NaN,NaN,NaN,495.1884311608517,NaN,NaN,495.0414000000006,497.86457554476266,492.2182244552385,493.19131110718234,497.96062338278,502.0076666938,493.91358007176,47024,24319.766666666666,37.950471120086334,38.42012833980457,NaN,NaN,NaN,NaN,0.7729344868319374,37.83741934749755,11903872,0.03909840812431731,-0.7044732187579825,-0.7435716268822998
2025-09-05T15:05:00-04:00,492.5,493.16,492.45,493.04,NaN,NaN,NaN,495.1884311608517,NaN,NaN,494.99740000000054,497.8748761435631,492.119923856438,493.19131110718234,497.89335909669126,501.9552024084733,493.8315157849092,28529,24493.133333333335,42.53200415517673,39.153143490106764,NaN,NaN,NaN,NaN,0.7684391663439445,37.45030069548926,11932401,0.053294504164182244,-0.676953496677072,-0.7302480008412543
2025-09-05T15:10:00-04:00,493.07,493.31,492.895,493.21,NaN,NaN,NaN,495.1884311608517,NaN,NaN,494.96300000000053,497.88367731815833,492.04232268184273,493.19131110718234,497.8363552917427,501.9068085118545,493.7659020716309,26129,24537.9,43.96128713054984,40.172194173821694,NaN,NaN,NaN,NaN,0.7431935116050928,36.79504471076495,11958530,0.07690509064519557,-0.6341166375347598,-0.7110217281799553
2025-09-05T15:15:00-04:00,493.2,493.53,492.96,493.39,NaN,NaN,NaN,495.1884311608517,NaN,NaN,494.92060000000055,497.8696972443568,491.9715027556443,492.7180488857459,497.77915404152515,501.8554965981598,493.7028114848905,27793,23565.166666666668,45.50669660986818,41.37434185371023,NaN,NaN,NaN,NaN,0.7308225464904429,35.75531163736987,11986323,0.10564168576811228,-0.578969620969815,-0.6846113067379272
2025-09-05T15:20:00-04:00,493.49,494.95,493.49,494.93,NaN,NaN,NaN,495.1884311608517,NaN,NaN,494.8956000000006,497.8226795268095,491.96852047319175,492.8117795531182,497.7360698380886,501.8033028676587,493.6688368085185,29000,23708.066666666666,56.547548881968595,42.64298784392183,NaN,NaN,NaN,NaN,0.7900495074554115,33.76536604415788,12015323,0.2226359880201183,-0.4063163217127794,-0.6289523097328977
2025-09-05T15:25:00-04:00,494.98,495.13,494.45,494.46,NaN,NaN,NaN,495.1884311608517,NaN,NaN,494.8544000000006,497.7466466278535,491.9621533721477,493.07942364249453,497.6911603058289,501.7451115642079,493.63720904744986,33354,23984.3,53.01704417436077,43.25343437545541,NaN,NaN,NaN,NaN,0.782188828351454,32.131751848320924,11981969,0.26003453989193503,-0.303909134867979,-0.563943674759914
2025-09-05T15:30:00-04:00,494.495,494.53,493.38,493.46,NaN,NaN,NaN,495.1884311608517,NaN,NaN,494.78480000000053,497.6401955657093,491.92940443429177,493.07942364249453,497.61502126295915,501.66533005504436,493.5647124708739,45180,25078.1,46.381792980246686,43.43931132827053,NaN,NaN,NaN,NaN,0.8084610548977771,30.424625802424295,11936789,0.21116749042480643,-0.29998431172890605,-0.5111518021537125
2025-09-05T15:35:00-04:00,493.46,493.97,493.31,493.32,NaN,NaN,NaN,495.1884311608517,NaN,NaN,494.7090000000006,497.51425007734747,491.9037499226537,493.07942364249453,497.56829736457314,501.6186972495705,493.51789747957577,26806,25159.7,45.52281178612783,43.28574620628695,NaN,NaN,NaN,NaN,0.797856693833652,28.918132297337245,11909983,0.16519442222050335,-0.3046587743780833,-0.46985319659858665
2025-09-05T15:40:00-04:00,493.35,493.83,493.07,493.72,NaN,NaN,NaN,495.1884311608517,NaN,NaN,494.6500000000005,497.41154159786015,491.8884584021408,493.07942364249453,497.500821382339,501.55028989791396,493.451352866764,39893,25838.766666666666,48.45977861439123,44.05476060564661,NaN,NaN,NaN,NaN,0.7951526442741048,27.79413756945258,11949876,0.15753025656617425,-0.27294037589086884,-0.4304706324570431
2025-09-05T15:45:00-04:00,493.71,493.97,493.56,493.66,NaN,NaN,NaN,495.1884311608517,NaN,NaN,494.58380000000056,497.27757026426065,491.8900297357405,493.07942364249453,497.4460373164034,501.4912239710868,493.40085066172,35111,26057.266666666666,48.04139381355982,44.958424995315944,NaN,NaN,NaN,NaN,0.7676417411116706,26.540453365200133,11914765,0.14456396841541042,-0.2497656719377801,-0.3943296403531905
2025-09-05T15:50:00-04:00,493.66,494.48,493.5,494.15,NaN,NaN,NaN,495.1884311608517,NaN,NaN,494.5198000000005,497.097186241292,491.942413758709,493.07942364249453,497.32565270214513,501.3480585284752,493.3032468758151,88637,28592.066666666666,51.70827395514194,45.918738191826826,NaN,NaN,NaN,NaN,0.782810188175124,24.648159780972282,12003402,0.16372435142716213,-0.18967420106923782,-0.35339855249639995
2025-09-05T15:55:00-04:00,494.68,495.61,494.08,495.06,492.3682818517962,492.3682818517962,492.3682818517962,NaN,NaN,NaN,494.4838000000005,496.97838578457146,491.9892142154295,493.26610971133806,497.1685439011565,501.10279485170935,493.2342929506037,174793,33780.13333333333,57.68138590126107,47.463116517469494,NaN,NaN,NaN,NaN,0.8361808890197601,24.17590622732742,12178195,0.2284469484764478,-0.0678398669008402,-0.296286815377288
2025-09-08T09:30:00-04:00,498.105,498.41,495.05,497.65,493.8776502818222,NaN,NaN,NaN,NaN,NaN,494.5024000000005,497.0760186502016,491.92878134979935,494.85488776907044,497.0366666666667,497.0366666666667,497.0366666666667,87757,36245.2,69.31465922188357,49.18274668961343,NaN,NaN,NaN,NaN,1.0164536826612067,25.642450056158456,12265952,0.4250271915194292,0.2349971740219985,-0.1900300174974307
2025-09-08T09:35:00-04:00,497.6,499.43,496.98,497.35,495.14821163264844,NaN,NaN,NaN,NaN,NaN,494.5230000000005,497.16992803010436,491.8760719698966,495.36091021525635,497.46416862675926,497.9056080965602,497.02272915695835,82303,38366.2,67.0166110319308,50.97441138403953,NaN,NaN,NaN,NaN,1.1188498481854054,27.45134186107579,12183649,0.5085464200137007,0.44565300751969517,-0.06289341249400551
2025-09-08T09:40:00-04:00,497.44,499.55,497.44,498.4,495.2771565584371,NaN,NaN,NaN,NaN,NaN,494.5696000000005,497.3995426419219,491.73965735807906,495.36091021525635,497.64065344256056,498.19349987543916,497.08780700968197,36482,38884.1,70.68050766811578,53.3122711374702,NaN,NaN,NaN,NaN,1.1960748590293042,29.180550425570495,12220131,0.6018177449723563,0.6893787687214399,0.08756102374908356
2025-09-08T09:45:00-04:00,498.37,499.25,498.19,499.24,495.5038767148718,NaN,NaN,NaN,NaN,NaN,494.6206000000005,497.68384901969324,491.5573509803077,495.36091021525635,497.84548725550155,498.53126888374453,497.1597056272586,40375,39594.4,73.24137134258652,55.50579736514233,NaN,NaN,NaN,NaN,1.1863552262414971,30.786244092601294,12260506,0.6815386843097073,0.9394843791362177,0.2579456948265104
2025-09-08T09:50:00-04:00,499.28,500.21,498.7,500.01,496.179155046014,NaN,NaN,NaN,NaN,NaN,494.6840000000004,498.04510219968216,491.3228978003187,496.24362603021126,498.2558838988866,499.22065250036945,497.2911152974038,73212,41494.63333333333,75.36545078459062,57.74895191185953,NaN,NaN,NaN,NaN,1.2094727100813896,32.677695012391546,12333718,0.7425668000917028,1.186154194941139,0.4435873948494361
2025-09-08T09:55:00-04:00,500.02,500.02,498.71,498.795,496.179155046014,NaN,NaN,NaN,NaN,NaN,494.7295000000005,498.24675475288683,491.21224524711414,496.24362603021126,498.33225577609755,499.2902742929335,497.37423725926163,29011,41813.86666666667,66.40776175097434,59.24188513622425,NaN,NaN,NaN,NaN,1.2166532307898617,34.43404229505392,12304707,0.6603088989145317,1.2689735184926008,0.608664619578069
2025-09-08T10:00:00-04:00,498.76,499.44,498.5,498.76,496.179155046014,NaN,NaN,NaN,NaN,NaN,494.7629000000005,498.39889454849043,491.1269054515106,496.24362603021126,498.3601879644306,499.3023786104003,497.41799731846095,18066,41836.73333333333,66.16380065542546,59.92876026289974,NaN,NaN,NaN,NaN,1.1968922857334428,35.74386340365538,12286641,0.5663540590807734,1.3166071934290358,0.7502531343482624
2025-09-08T10:05:00-04:00,498.66,499.11,498.3,498.96,496.179155046014,NaN,NaN,NaN,NaN,NaN,494.80550000000045,498.5844703619919,491.026529638009,496.24362603021126,498.3837693146507,499.3049632900399,497.4625753392615,21316,41879.6,66.91183417726964,60.921245263107515,NaN,NaN,NaN,NaN,1.1692571224667685,36.64934329689769,12307957,0.4836993881963798,1.354877369593737,0.8711779813973572
2025-09-08T10:10:00-04:00,498.96,499.15,498.61,498.85,496.179155046014,NaN,NaN,NaN,NaN,NaN,494.8575000000005,498.7832499915842,490.9317500084168,496.2952132219745,498.41149630152813,499.3131173421398,497.5098752609165,23495,41966.666666666664,66.04698602419248,62.32590190910365,NaN,NaN,NaN,NaN,1.124310185147711,37.51260810585734,12284462,0.3915744141854207,1.360645999129133,0.9690715849437124
2025-09-08T10:15:00-04:00,498.89,499.12,498.35,498.5,496.179155046014,NaN,NaN,NaN,NaN,NaN,494.91590000000053,498.96775571762845,490.8640442823726,496.45117057757966,498.4285562626225,499.3004769630405,497.5566355622045,30814,42083.86666666667,63.245882086546956,63.59183550199072,NaN,NaN,NaN,NaN,1.099002314780016,37.879366293329355,12253648,0.2821342643983884,1.321739415441698,1.0396051510433095
2025-09-08T10:20:00-04:00,498.5,499.8,498.37,499.7,496.179155046014,NaN,NaN,NaN,NaN,NaN,495.0003000000005,499.26581211890857,490.7347878810924,496.9499364620637,498.46572959566595,499.3364075999628,497.5950515913691,19971,42081.666666666664,68.2220990983294,65.00342982227203,NaN,NaN,NaN,NaN,1.122645006581444,38.64338533695815,12273619,0.26585266923766104,1.3719209875903857,1.1060683183527247
2025-09-08T10:25:00-04:00,499.71,500.65,499.65,500.6,496.9740011996198,NaN,NaN,NaN,NaN,NaN,495.1275000000005,499.6653586355813,490.5896413644197,497.86994916965097,498.60373557729145,499.57076129575466,497.6367098588282,37653,42786.8,71.35461911831524,66.66866020118313,NaN,NaN,NaN,NaN,1.1138846489684837,39.801514027926515,12311272,0.28906332830299664,1.4673974787314705,1.178334150428474
2025-09-08T10:30:00-04:00,500.59,500.86,499.81,500.22,497.1601829632735,NaN,NaN,NaN,NaN,NaN,495.2407000000005,499.9935753440909,490.4878246559101,498.1109593357208,498.70579570853556,499.72615222292194,497.6854391941492,32106,42816,68.29354344273196,67.85332230743956,NaN,NaN,NaN,NaN,1.10932145975645,40.97841636320895,12279166,0.2534647826398404,1.4951651287282743,1.241700346088434
2025-09-08T10:35:00-04:00,500.33,500.76,500.03,500.4,497.26494737403374,NaN,NaN,NaN,NaN,NaN,495.34590000000054,500.31321464238687,490.3785853576142,498.1957674685766,498.76104126668724,499.80864418001886,497.7134383533556,17988,41235.46666666667,68.97254645346604,68.6598337754542,NaN,NaN,NaN,NaN,1.0822270697738479,42.07125424597121,12297154,0.21803209559154935,1.5142404655778705,1.2962083699863212
2025-09-08T10:40:00-04:00,500.37,500.84,500.12,500.39,497.39404067521406,NaN,NaN,NaN,NaN,NaN,495.46550000000053,500.621308471679,490.30969152832205,498.42861397486126,498.8080032639055,499.8776143055354,497.7383922222756,15746,41254.833333333336,68.88428799391674,68.62909297345657,NaN,NaN,NaN,NaN,1.0563537076471423,43.12886795492812,12281408,0.17193851014005435,1.5111315076613892,1.3391929975213348
2025-09-08T10:45:00-04:00,500.42,500.83,500.21,500.42,497.48976609906794,NaN,NaN,NaN,NaN,NaN,495.57450000000057,500.91106827900666,490.2379317209945,498.590891179889,498.84612738118875,499.93269490049886,497.75955986187864,13160,40741.166666666664,69.01239533797607,68.77164899531695,NaN,NaN,NaN,NaN,1.0251855856723469,44.11093782753096,12294568,0.12374000592933698,1.493868004933006,1.370127999003669
2025-09-08T10:50:00-04:00,500.47,500.69,499.97,500.41,497.48976609906794,NaN,NaN,NaN,NaN,NaN,495.67870000000056,501.1827780550849,490.1746219449162,498.590891179889,498.88492643172583,499.98374669865643,497.7861061647952,15276,40592,68.9105494672004,68.64522340953728,NaN,NaN,NaN,NaN,1.003386615267177,44.512457219067656,12279292,0.07391408959811252,1.4625206110013096,1.388606521403197
2025-09-08T10:55:00-04:00,500.41,500.65,500.11,500.2,497.48976609906794,NaN,NaN,NaN,NaN,NaN,495.7871000000006,501.427900683988,490.14629931601314,498.658970355129,498.91026106162303,500.01561430007956,497.8049078231665,10688,40255.6,66.68494442836153,68.17690720137836,NaN,NaN,NaN,NaN,0.9702875713195189,44.885296654066,12268604,0.012748101820426516,1.4045416486787303,1.3917935468583038
2025-09-08T11:00:00-04:00,500.165,500.75,499.72,500.36,497.48976609906794,NaN,NaN,NaN,NaN,NaN,495.8957000000005,501.67372734822453,490.11767265177645,498.658970355129,498.95860165789566,500.07318538097144,497.8440179348199,22204,39428.26666666667,67.5450055063702,67.61830396721976,NaN,NaN,NaN,NaN,0.9745527447966943,44.38598751276777,12290808,-0.02873572078510267,1.3558738958769254,1.384609616662028
2025-09-08T11:05:00-04:00,500.34,500.34,499.76,500.02,497.48976609906794,NaN,NaN,NaN,NaN,NaN,496.0049000000005,501.8833319301033,490.12646806989767,498.658970355129,498.9911813566491,500.1043030576463,497.87805965565195,19496,39127.166666666664,63.77712347229296,67.43040123302822,NaN,NaN,NaN,NaN,0.9477989773112178,43.92234331013369,12271312,-0.08755183042639691,1.275169828629032,1.362721659055429
2025-09-08T11:10:00-04:00,500.01,500.79,500,500.24,497.5342708317104,NaN,NaN,NaN,NaN,NaN,496.1103000000005,502.0986828899584,490.1219171100426,498.80599282182607,499.0224580944446,500.1412486272038,497.9036675616853,15323,38766.96666666667,65.13248002990557,67.35673547406252,NaN,NaN,NaN,NaN,0.9365276217889893,43.91621897148372,12286635,-0.11821080407373019,1.2149581539632663,1.3331689580369965
2025-09-08T11:15:00-04:00,500.17,500.5,499.69,499.75,497.5342708317104,NaN,NaN,NaN,NaN,NaN,496.2099000000005,502.27101623026016,490.1487837697409,498.80599282182607,499.04529097850957,500.16027410321675,497.9303078538024,16182,38379.933333333334,59.76834231352818,66.84648605522383,NaN,NaN,NaN,NaN,0.9274899345183474,43.229645915845076,12270453,-0.1746553512907698,1.1148497689235342,1.289505120214304
2025-09-08T11:20:00-04:00,499.72,500.25,499.39,500.1,497.5342708317104,NaN,NaN,NaN,NaN,NaN,496.33190000000053,502.4554228060853,490.20837719391574,498.80599282182607,499.06045646799134,500.1714929432923,497.94941999269037,12067,37815.5,62.16524227906685,66.56921864485773,NaN,NaN,NaN,NaN,0.922669224909895,41.972339497236526,12282520,-0.19029796755480932,1.0516326607707924,1.2419306283256017
2025-09-08T11:25:00-04:00,500.19,500.68,500.19,500.66,497.6552326420427,NaN,NaN,NaN,NaN,NaN,496.46730000000053,502.6677648887506,490.2668351112505,498.80599282182607,499.08367202900195,500.20069716287793,497.96664689512596,11242,37078.433333333334,65.68763151270684,66.74362931815485,NaN,NaN,NaN,NaN,0.8981928517020442,41.28657212840241,12293762,-0.16571127520644247,1.0347915343175487,1.2005028095239911
2025-09-08T11:30:00-04:00,500.635,500.78,500.35,500.42,497.85294934013166,NaN,NaN,NaN,NaN,NaN,496.6055000000005,502.844059528988,490.36694047101304,499.03779065981996,499.107063236923,500.22971641242816,497.98441006141786,11648,35960.7,62.98139014667958,66.36929296446557,NaN,NaN,NaN,NaN,0.8647505051518946,40.75705961000685,12282114,-0.16787494816954474,0.9906591243120602,1.158534072481605
2025-09-08T11:35:00-04:00,500.425,500.65,500.11,500.62,497.85294934013166,NaN,NaN,NaN,NaN,NaN,496.74730000000056,503.0219949596376,490.47260504036353,499.03779065981996,499.128967291399,500.25551071658504,498.002423866213,11743,35458.6,64.30128385941264,65.86548330311538,NaN,NaN,NaN,NaN,0.8415540404981853,39.74632111940955,12293857,-0.15822941551283853,0.9607473030905567,1.1189767186033952
2025-09-08T11:40:00-04:00,500.59,501.195,500.59,500.9,498.26860673346704,NaN,NaN,NaN,NaN,NaN,496.9039000000006,503.19448766384306,490.6133123361581,499.5614860222848,499.19138793944234,500.34489743464036,498.0378784442443,26576,35014.7,66.12242612751993,65.71040349488597,NaN,NaN,NaN,NaN,0.8246573233197447,39.422117614087014,12320433,-0.13622168636643694,0.9486996106453489,1.0849212970117859
2025-09-08T11:45:00-04:00,500.9,501.12,500.24,500.32,498.26860673346704,NaN,NaN,NaN,NaN,NaN,497.0527000000005,503.3073914261865,490.79800857381457,499.5614860222848,499.2191238703435,500.3770570876568,498.06119065303017,15553,34362.76666666667,59.36646542224574,65.0242548497988,NaN,NaN,NaN,NaN,0.8286103716540484,38.39702834959793,12304880,-0.16219196758890786,0.8821813375256511,1.044373305114559
2025-09-08T11:50:00-04:00,500.34,500.6,500.27,500.39,498.26860673346704,NaN,NaN,NaN,NaN,NaN,497.18590000000063,503.43553797001374,490.9362620299875,499.5614860222848,499.24281624023877,500.4013698486577,498.08426263181985,15446,31923.066666666666,59.89900055112981,64.38244860388545,NaN,NaN,NaN,NaN,0.7929953451073335,37.44515974685806,12320326,-0.17502138138288315,0.8255965783859551,1.0006179597688383
2025-09-08T11:55:00-04:00,500.4,500.78,500.39,500.41,498.26860673346704,NaN,NaN,NaN,NaN,NaN,497.30810000000065,503.5661792225811,491.0500207774202,499.5614860222848,499.26884509865266,500.4297815051952,498.10790869211013,16201,26636.666666666668,60.060060553354816,63.74299611926964,NaN,NaN,NaN,NaN,0.7642099633139515,36.79036321042366,12336527,-0.1817337890423627,0.773450723465885,0.9551845125082477
2025-09-08T12:00:00-04:00,500.4,500.4,499.95,500.22,498.26860673346704,NaN,NaN,NaN,NaN,NaN,497.4283000000006,503.6745979785197,491.1820020214815,499.5614860222848,499.2788640593713,500.4374161255711,498.1203119931715,8787,24004.333333333332,57.68957070496641,62.941497636252926,NaN,NaN,NaN,NaN,0.7424806802201004,35.25446707890358,12327740,-0.19724780159712707,0.7086247605118388,0.9058725621089658
2025-09-08T12:05:00-04:00,500.24,500.24,499.38,499.44,498.26860673346704,NaN,NaN,NaN,NaN,NaN,497.52490000000057,503.7431989600423,491.3066010399588,499.5614860222848,499.2884906216399,500.4349595731362,498.14202167014355,19532,21911.966666666667,49.118701015489606,61.68676596390493,NaN,NaN,NaN,NaN,0.750874917347237,32.808901210831145,12308208,-0.25466807342453257,0.5875374703283001,0.8422055437528326
2025-09-08T12:10:00-04:00,499.41,499.68,499.155,499.23,498.26860673346704,NaN,NaN,NaN,NaN,NaN,497.6457000000006,503.75619523659316,491.53520476340805,499.5614860222848,499.28918282361843,500.4296901578657,498.14867548937116,8702,20985.966666666667,47.09023463209288,60.22571090145656,NaN,NaN,NaN,NaN,0.7347409946795797,30.753512285309398,12299506,-0.2983878027436899,0.46922079032322017,0.7676085930669101
2025-09-08T12:15:00-04:00,499.22,499.22,498.93,499.17,498.26860673346704,NaN,NaN,NaN,NaN,NaN,497.7735000000006,503.7371144238705,491.8098855761307,499.5614860222848,499.2866585657553,500.41945220672727,498.15386492478336,11726,20031,46.49937449400642,58.99158597443609,NaN,NaN,NaN,NaN,0.7036880664881819,29.195125358742363,12287780,-0.32097570125522434,0.36638896649787966,0.687364667753104
2025-09-08T12:20:00-04:00,499.23,499.4,498.64,498.695,498.26860673346704,NaN,NaN,NaN,NaN,NaN,497.8860000000006,503.70082347080097,492.0711765292002,499.5614860222848,499.2819945623792,500.40848843032364,498.1555006944348,10678,17946.533333333333,42.0058168771784,57.33968146352701,NaN,NaN,NaN,NaN,0.7077103474533112,28.178752215835225,12277102,-0.3548872445779032,0.24375561203072493,0.5986428566086281
2025-09-08T12:25:00-04:00,498.685,498.83,498.5,498.8,498.26860673346704,NaN,NaN,NaN,NaN,NaN,498.0080000000006,503.63542392187713,492.3805760781241,499.5614860222848,499.2742011246376,500.3949577919122,498.15344445736304,11859,17374.8,43.30997492498359,56.164083792916685,NaN,NaN,NaN,NaN,0.6807310369209307,27.437110487098536,12288961,-0.3562954251246373,0.15327357520283158,0.5095690003274689
2025-09-08T12:30:00-04:00,498.76,498.88,498.03,498.135,NaN,NaN,NaN,500.73988945306473,500.73988945306473,500.73988945306473,498.09670000000057,503.58787568800824,492.6055243119929,499.37318881782784,499.2643108273791,500.38312133139715,498.1455003233611,9398,17085.866666666665,37.5505499924371,54.40589148672884,NaN,NaN,NaN,NaN,0.6928216771408658,27.379041095734586,12279563,-0.38558484022159567,0.02758795005047432,0.41317279027207
2025-09-08T12:35:00-04:00,498.12,498.58,497.79,498.58,NaN,NaN,NaN,500.4737581142891,NaN,NaN,498.2045000000006,503.5147878449605,492.89421215504075,499.3350408434098,499.25515087199113,500.37239484378955,498.1379069001927,8587,16661.566666666666,43.01188170874502,52.78619507216014,NaN,NaN,NaN,NaN,0.6997629859165156,27.617393109385457,12288150,-0.3590978407632851,-0.03569951068203636,0.32339833008124874
2025-09-08T12:40:00-04:00,498.56,498.66,498.4,498.57,NaN,NaN,NaN,500.4737581142891,NaN,NaN,498.32570000000067,503.3810832729259,493.27031672707545,499.3350408434098,499.25010290998,500.36497949383084,498.13522632612916,6345,16089.9,42.9210442679213,51.353313223677404,NaN,NaN,NaN,NaN,0.6683513440653394,27.655479901993406,12281805,-0.3272583379295967,-0.08567459233074715,0.24158374559884954
2025-09-08T12:45:00-04:00,498.51,498.62,498.25,498.52,NaN,NaN,NaN,500.4737581142891,NaN,NaN,498.43530000000055,503.2599017075535,493.6106982924476,499.0140326747278,499.24303973627775,500.3553789365295,498.130700536026,8105,15332.933333333332,42.43844067220496,49.791681567448286,NaN,NaN,NaN,NaN,0.6470405337749583,27.886470492374265,12273700,-0.2955398876293123,-0.12784111393779085,0.16769877369152147
2025-09-08T12:50:00-04:00,498.62,498.8,498.4,498.58,NaN,NaN,NaN,500.4737581142891,NaN,NaN,498.54270000000065,503.1305117699154,493.9548882300859,498.70122613978225,499.2391497542361,500.3492860715871,498.12901343688515,5438,14848.5,43.262870250448124,48.158856147657445,NaN,NaN,NaN,NaN,0.6293947813624637,27.662040289314188,12279138,-0.25786650608336736,-0.15463435891268773,0.10323214717067963
2025-09-08T12:55:00-04:00,498.63,498.75,498.5,498.68,NaN,NaN,NaN,500.4737581142891,NaN,NaN,498.6485000000006,502.9936956223454,494.30330437765576,498.1864809118258,499.2342539181449,500.3411274497384,498.12738038655135,7525,13844.233333333334,44.6848663761904,47.11017050151063,NaN,NaN,NaN,NaN,0.6022951541222878,27.453640815044118,12286663,-0.21529515343068528,-0.16588679461767697,0.04940835881300831
2025-09-08T13:00:00-04:00,498.685,498.72,498.14,498.14,NaN,NaN,NaN,500.4737581142891,NaN,NaN,498.7127000000006,502.9291848910508,494.4962151089504,497.9441477835685,499.2285858941527,500.3342690935143,498.12290269479104,5798,12967.3,39.00052732929971,45.617422414237055,NaN,NaN,NaN,NaN,0.6007026431135559,27.788000452236695,12280865,-0.21223811166849843,-0.2158892807726147,-0.0036511691041162947
2025-09-08T13:05:00-04:00,498.151,498.27,497.99,498.23,NaN,NaN,NaN,500.1234935743979,NaN,NaN,498.78810000000055,502.8288681889227,494.7473318110784,497.9441477835685,499.21859413461794,500.323859814543,498.11332845469286,8726,12658.566666666668,40.36220562932886,44.21043277680663,NaN,NaN,NaN,NaN,0.5777953114625857,28.303067603692984,12289591,-0.19341926784085273,-0.24542525390518222,-0.05200598606432948
2025-09-08T13:10:00-04:00,498.23,498.6,498.17,498.17,NaN,NaN,NaN,500.1234935743979,NaN,NaN,498.88230000000055,502.63087103928615,495.13372896071496,497.6304159012606,499.21245793630874,500.31647282876577,498.1084430438517,6349,12345.333333333334,39.72553961810136,42.92728769917341,NaN,NaN,NaN,NaN,0.5672385035009729,27.90477801139889,12283242,-0.17483955466204906,-0.2705554293918908,-0.09571587472984175
2025-09-08T13:15:00-04:00,498.22,498.53,498.14,498.47,NaN,NaN,NaN,500.1234935743979,NaN,NaN,498.9853000000005,502.3835074152,495.58709258480104,497.6304159012606,499.2043495797862,500.30601245853643,498.10268670103596,9213,12213.766666666666,44.44422150607927,42.593396305644106,NaN,NaN,NaN,NaN,0.5545786103937596,27.583626141367663,12292455,-0.13401084952168313,-0.26322943663194565,-0.12921858711026252
2025-09-08T13:20:00-04:00,498.46,498.54,498.15,498.47,NaN,NaN,NaN,500.1234935743979,NaN,NaN,499.0803000000006,502.1323625216956,496.0282374783056,497.6304159012606,499.1972733499278,500.29677055849754,498.09777614135805,8257,11979.8,44.444221506079266,42.40439536807171,NaN,NaN,NaN,NaN,0.5428229953656369,27.257588741861998,12292455,-0.10021707675581121,-0.25448993305502654,-0.15427285629921533
2025-09-08T13:25:00-04:00,498.489,498.55,498.29,498.31,NaN,NaN,NaN,500.1234935743979,NaN,NaN,499.17330000000055,501.81481214961315,496.53178785038796,497.6304159012606,499.1915101271789,500.28923143098996,498.09378882336784,6804,11850.333333333334,42.39148099480062,42.11097440384272,NaN,NaN,NaN,NaN,0.5226213528395194,26.925070184960436,12285651,-0.08258659994397699,-0.25750610622918657,-0.17491950628520958
2025-09-08T13:30:00-04:00,498.33,498.44,498.2,498.25,NaN,NaN,NaN,500.1097466816979,NaN,NaN,499.25530000000055,501.49141395877064,497.01918604123045,497.6304159012606,499.18543167224965,500.28188466238936,498.08897868210994,6572,11329.266666666666,41.6152566168284,42.083077242389145,NaN,NaN,NaN,NaN,0.502434113350983,26.792064225454183,12279079,-0.06944118467991753,-0.2617209871351065,-0.19227980245518897
2025-09-08T13:35:00-04:00,498.29,498.32,498.11,498.26,NaN,NaN,NaN,499.95203092343894,NaN,NaN,499.31930000000057,501.2311127619003,497.4074872381008,497.6304159012606,499.1796015663334,500.27523356624744,498.0839695664194,5940,10877.4,41.806513247650486,41.975687122579636,NaN,NaN,NaN,NaN,0.4815459623973399,26.8457554932671,12285019,-0.05517051652017285,-0.26124294810540505,-0.2060724315852322
2025-09-08T13:40:00-04:00,498.26,498.3,498.01,498.28,NaN,NaN,NaN,499.8526204269189,NaN,NaN,499.33190000000053,501.20750111871297,497.4562988812881,497.6304159012606,499.17091040515874,500.2655622703214,498.07625853999605,8684,10656.1,42.21422454909598,42.308806733769565,NaN,NaN,NaN,NaN,0.4678641079403885,27.092811338173107,12293703,-0.04017873224613172,-0.25629584689289686,-0.21611711464676514
2025-09-08T13:45:00-04:00,498.28,498.28,497.88,498,NaN,NaN,NaN,499.7550013166044,NaN,NaN,499.34490000000056,501.17380293796526,497.51599706203586,497.58325654602004,499.1568518849924,500.2517048621236,498.06199890786127,12512,10533.766666666666,38.181117706032396,41.96375216214723,NaN,NaN,NaN,NaN,0.4630166716589306,27.57433177744962,12281191,-0.04457458415357568,-0.2718353448387347,-0.22726076068515905
2025-09-08T13:50:00-04:00,497.94,498.01,497.5,497.895,NaN,NaN,NaN,499.42341034766787,NaN,NaN,499.33480000000054,501.1898546721152,497.4797453278859,497.58325654602004,499.141799196799,500.2397796486262,498.0438187449718,11172,10503.933333333332,36.76269962659874,41.523870402052765,NaN,NaN,NaN,NaN,0.4663726236832921,28.67129825167322,12270019,-0.04962210733598024,-0.28928839485513436,-0.23966628751915411
2025-09-08T13:55:00-04:00,497.86,498.13,497.84,497.9,NaN,NaN,NaN,499.42341034766787,NaN,NaN,499.30800000000056,501.20597997790225,497.4100200220989,497.58325654602004,499.1296681053442,500.22850870386804,498.03082750682034,10402,10475.933333333332,36.88294482331454,41.127049269989165,NaN,NaN,NaN,NaN,0.453774579134487,29.23383491042295,12280421,-0.047680444102595365,-0.29926684264739833,-0.25158639854480297
2025-09-08T14:00:00-04:00,497.86,498.09,497.7,497.78,NaN,NaN,NaN,499.42341034766787,NaN,NaN,499.26340000000056,501.1977551267723,497.32904487322884,497.58325654602004,499.11615006097963,500.21690182903507,498.0153982929242,10907,10451.233333333334,35.15519881155994,40.547929881497154,NaN,NaN,NaN,NaN,0.44921925205345126,29.997056835999597,12269514,-0.04932841402234023,-0.31324691607272825,-0.263918502050388
2025-09-08T14:05:00-04:00,497.76,498.13,497.69,498.05,NaN,NaN,NaN,499.42341034766787,NaN,NaN,499.24850000000055,501.20836657620583,497.28863342379526,497.58325654602004,499.10613838366476,500.2073651728229,498.0049115945066,8946,10358,41.7652350251912,40.33938478499721,NaN,NaN,NaN,NaN,0.44856073404963315,30.544968134743648,12278460,-0.02813858883077902,-0.2990917380888618,-0.2709531492580828
2025-09-08T14:10:00-04:00,498.04,498.28,497.865,497.93,NaN,NaN,NaN,499.42341034766787,NaN,NaN,499.2319000000005,501.22186471242577,497.24193528757525,497.58325654602004,499.09381986091023,500.19475091153333,497.9928888102871,11941,9870.166666666666,39.822304677541396,40.39808316701448,NaN,NaN,NaN,NaN,0.446163538760371,30.453807085385787,12266519,-0.018570037109265747,-0.294165695644665,-0.27559565853539925
2025-09-08T14:15:00-04:00,497.9,498.28,497.82,498.28,NaN,NaN,NaN,499.42341034766787,NaN,NaN,499.2183000000005,501.22473824641867,497.21186175358235,497.54660523681605,499.0830189717136,500.1824928532764,497.9835450901508,11836,9746.266666666666,47.49448353184769,40.907531588622966,NaN,NaN,NaN,NaN,0.447151857420343,30.46681666128998,12278355,0.013249553115387613,-0.25903371714116474,-0.27228327025655236
2025-09-08T14:20:00-04:00,498.28,498.28,498.05,498.15,NaN,NaN,NaN,499.42341034766787,NaN,NaN,499.2043000000005,501.23049348450843,497.1781065154926,497.5002841894528,499.06501835934347,500.1611748189925,497.96886189969445,21080,9934.066666666668,45.189939963297874,41.29784589899415,NaN,NaN,NaN,NaN,0.4316410104617443,30.478896981772447,12257275,0.02668495065646631,-0.23892708193596945,-0.26561203259243577
2025-09-08T14:25:00-04:00,498.14,498.45,498,498.44,NaN,NaN,NaN,499.42341034766787,NaN,NaN,499.2031000000006,501.2310308558982,497.17516914410294,497.4992273515623,499.0594876792332,500.1536215600288,497.9653537984376,7837,9655.266666666666,50.91204732321413,41.759833457360926,NaN,NaN,NaN,NaN,0.4329523668573332,29.761556904301518,12265112,0.054635785047531304,-0.1973173012830216,-0.2519530863305529
2025-09-08T14:30:00-04:00,498.46,498.48,498.25,498.31,NaN,NaN,NaN,499.42341034766787,NaN,NaN,499.17530000000056,501.2133062896018,497.1372937103993,497.59942386118576,499.0534259846133,500.1448621718745,497.9619897973521,9338,9673.633333333333,48.46922522772492,42.04733372319276,NaN,NaN,NaN,NaN,0.4184557692246678,28.969673513859917,12255774,0.06329144031082673,-0.1728387859420195,-0.23613022625284624
2025-09-08T14:35:00-04:00,498.29,498.39,498.13,498.19,NaN,NaN,NaN,499.42341034766787,NaN,NaN,499.12710000000055,501.1419102531921,497.112289746809,497.59942386118576,499.04621733759126,500.1355083900765,497.956926285106,9778,9348.5,46.26262273078737,42.32384384719181,NaN,NaN,NaN,NaN,0.40713749999433374,28.578546264721496,12245996,0.05989342999801531,-0.16126343875532712,-0.22115686875334242
2025-09-08T14:40:00-04:00,498.17,498.39,498,498.29,NaN,NaN,NaN,499.42341034766787,NaN,NaN,499.08850000000064,501.0919981896795,497.0850018103218,497.59942386118576,499.04095546350044,500.12871530811583,497.95319561888505,7159,9297.066666666668,48.37196502408133,42.80646587628131,NaN,NaN,NaN,NaN,0.40591339285188033,28.568696208992222,12253155,0.0630219217337204,-0.14237946658619194,-0.20540138831991234
2025-09-08T14:45:00-04:00,498.375,498.58,498.35,498.4,NaN,NaN,NaN,499.42341034766787,NaN,NaN,499.04850000000056,501.02534723647074,497.0716527635304,497.7449450169271,499.03630331295267,500.1210933178119,497.9515133080934,8748,9197.8,50.665971013617956,43.43928428813613,NaN,NaN,NaN,NaN,0.3976338647910292,27.712122033405894,12261903,0.07057163473824554,-0.1171868448971054,-0.18775847963535094
2025-09-08T14:50:00-04:00,498.38,498.44,497.98,498.07,NaN,NaN,NaN,499.42341034766787,NaN,NaN,499.00210000000055,500.9596342542115,497.0445657457896,497.7449450169271,499.02892280172654,500.1120704690137,497.9457751344394,9582,9161.266666666666,44.305714458847085,43.588676424546925,NaN,NaN,NaN,NaN,0.40208858873452563,27.88371792953312,12252321,0.052256096039208694,-0.12243835958634008,-0.17469445562554878
2025-09-08T14:55:00-04:00,498.07,498.33,498.06,498.15,NaN,NaN,NaN,499.42341034766787,NaN,NaN,498.9567000000006,500.88567548877234,497.0277245112288,497.7449450169271,499.02210342852743,500.103550206038,497.94065665101687,9178,9071.9,46.073073016733055,44.152387518168396,NaN,NaN,NaN,NaN,0.39265368953920105,28.043056975936974,12261499,0.04473498942127796,-0.11877571884895133,-0.1635107082702293
2025-09-08T15:00:00-04:00,498.12,498.24,497.9,498.08,NaN,NaN,NaN,499.42341034766787,NaN,NaN,498.9101000000005,500.8087263341286,497.0114736658724,497.7449450169271,499.0135312705809,500.0938182488448,497.93324429231706,10417,9105.866666666667,44.73537570128778,44.72186438064619,NaN,NaN,NaN,NaN,0.3888927117149747,28.56670235879796,12251082,0.034699282883280086,-0.12013660466612919,-0.15483588754940927
2025-09-08T15:05:00-04:00,498.08,498.18,497.85,497.85,NaN,NaN,NaN,499.36738031534594,NaN,NaN,498.86310000000054,500.7479722918133,496.9782277081878,497.7449450169271,499.00414270016245,500.0841533644346,497.9241320358903,10367,9165.2,40.5675988529471,44.98505395419137,NaN,NaN,NaN,NaN,0.38468608944961824,29.16697425261076,12240715,0.013323649255766346,-0.13818132597970134,-0.1515049752354677
2025-09-08T15:10:00-04:00,497.82,497.82,497.35,497.43,NaN,NaN,NaN,498.9440903010121,NaN,NaN,498.80450000000053,500.68174612036444,496.9272538796366,497.7449450169271,498.9868885841939,500.07216251114295,497.9016146572448,13809,9414,34.28592507982809,44.922962973353386,NaN,NaN,NaN,NaN,0.39292279734607405,30.67038312156013,12226906,-0.026194808361333977,-0.18424848568713514,-0.15805367732580117
2025-09-08T15:15:00-04:00,497.44,497.89,497.44,497.69,NaN,NaN,NaN,498.9440903010121,NaN,NaN,498.7579000000005,500.62780383620714,496.8879961637939,497.7449450169271,498.9687959914228,500.05738901619117,497.8802029666544,16440,9691.833333333334,40.434822610209736,44.82793351514043,NaN,NaN,NaN,NaN,0.3977140261070673,31.736922341723144,12243346,-0.031557499057835725,-0.19750055114809584,-0.1659430520902601
2025-09-08T15:20:00-04:00,497.67,497.86,497.54,497.66,NaN,NaN,NaN,498.9440903010121,NaN,NaN,498.7063000000005,500.5519953260474,496.8606046739536,497.7449450169271,498.95115777835974,500.04250357636147,497.859811980358,16649,10065.533333333333,39.970086376530546,44.8384893507825,NaN,NaN,NaN,NaN,0.3921630242422763,32.72728018901737,12226697,-0.03366609223130257,-0.20802566737938832,-0.17435957514808575
2025-09-08T15:25:00-04:00,497.68,497.68,497.3,497.35,NaN,NaN,NaN,498.82268175034494,NaN,NaN,498.65830000000045,500.5177070121149,496.798892987886,497.7449450169271,498.9338390761409,500.0307297608764,497.8369483914054,14062,10283.433333333332,35.437563832527275,43.97728080083105,NaN,NaN,NaN,NaN,0.3912942367963991,34.06971644171661,12212635,-0.05141675821598907,-0.23863052291807207,-0.187213764702083
2025-09-08T15:30:00-04:00,497.34,497.62,497.26,497.27,NaN,NaN,NaN,498.7611962162383,NaN,NaN,498.6017000000004,500.4543981505524,496.7490018494484,497.7449450169271,498.9030399080294,500.0103226996294,497.79575711642946,24812,10917.233333333334,34.35486876921608,43.20334714411093,NaN,NaN,NaN,NaN,0.38905893416808585,35.38260100313818,12187823,-0.06324580128836871,-0.2662710163125439,-0.2030252150241752
2025-09-08T15:35:00-04:00,497.3,497.39,497.125,497.37,NaN,NaN,NaN,498.5547782064093,NaN,NaN,498.5359000000005,500.32408644347197,496.747713556529,497.5419560135417,498.875725473191,499.9930550957509,497.7583958506311,21584,11345.833333333334,36.94806518301283,42.205919848382266,NaN,NaN,NaN,NaN,0.38019758172750734,36.82280264895345,12209407,-0.05911185839418737,-0.2769150380169094,-0.21780317962272205
2025-09-08T15:40:00-04:00,497.39,497.64,497.3,497.36,NaN,NaN,NaN,498.5547782064093,NaN,NaN,498.4747000000005,500.2094223514242,496.73997764857677,497.47656481083334,498.8423995118652,499.9678059007625,497.7169931229679,30053,12135.966666666667,36.79154670338612,41.371799953786635,NaN,NaN,NaN,NaN,0.37732632588982645,36.8834979537545,12179354,-0.05207454840568598,-0.2828963651298295,-0.23082181672414354
2025-09-08T15:45:00-04:00,497.39,498.35,497.36,498.34,NaN,NaN,NaN,498.5547782064093,NaN,NaN,498.42910000000046,500.05212518665473,496.8060748133462,497.3872518486667,498.81833947865744,499.935892003999,497.70078695331586,39038,13130.133333333333,56.31998324707073,42.09018284780687,NaN,NaN,NaN,NaN,0.4210887311834109,34.38265144692781,12218392,0.019711804020663554,-0.2061820616983141,-0.22589386571897765
2025-09-08T15:50:00-04:00,498.32,498.33,497.43,497.5,NaN,NaN,NaN,498.5547782064093,NaN,NaN,498.36110000000053,499.8431071377728,496.8790928622283,497.3328014789334,498.76670759370853,499.8805737427061,497.652841444711,68262,15130.3,43.82239270850221,41.76521339669408,NaN,NaN,NaN,NaN,0.45601096467030783,32.06043683344588,12150130,0.012125367297338957,-0.21073715659730397,-0.22286252389464292
2025-09-08T15:55:00-04:00,497.48,498.64,497.02,498.36,497.04966583804236,497.04966583804236,497.04966583804236,NaN,NaN,NaN,498.3219000000005,499.6942030119551,496.94959698804587,497.15692895417186,498.6841341020252,499.76202320693886,497.60624499711156,171619,20624.133333333335,54.865192896998046,42.065157816935525,NaN,NaN,NaN,NaN,0.539153038622429,30.943731435009035,12321749,0.06364968991573117,-0.14330041149997896,-0.20695010141571013
2025-09-09T09:30:00-04:00,501.44,502.09,500.11,501.44,499.0834685091845,NaN,NaN,NaN,NaN,NaN,498.3429000000005,499.86509984122415,496.82070015877684,498.674947624536,501.21333333333337,501.21333333333337,501.21333333333337,56957,22303.633333333335,74.32818226639904,44.209619803189184,NaN,NaN,NaN,NaN,0.7670706787208241,32.3286301085834,12378706,0.29105264434919864,0.15686570402078814,-0.13418694032841047
2025-09-09T09:35:00-04:00,501.38,501.62,500.66,501.44,499.08421994058517,NaN,NaN,NaN,NaN,NaN,498.3635000000005,500.019073917541,496.70792608246,498.674947624536,501.22108055140336,501.2331872923607,501.208973810446,23323,22883.066666666666,74.32818226639904,46.227841892451046,NaN,NaN,NaN,NaN,0.7808513445264781,33.61460744833102,12378706,0.41955030682321853,0.3902509432006127,-0.029299363622605823
2025-09-09T09:40:00-04:00,501.41,501.93,500.775,501.49,499.2326644887404,NaN,NaN,NaN,NaN,NaN,498.3889000000005,500.1901820868953,496.5876179131057,498.78286647970305,501.2595149762129,501.3333404113703,501.1856895410556,22227,23334.5,74.53492562075938,48.3563811724133,NaN,NaN,NaN,NaN,0.8075762484888747,35.00876593893877,12400933,0.48155463178708835,0.5726439261112546,0.09108929432416625
2025-09-09T09:45:00-04:00,501.52,501.96,500.67,500.96,499.2326644887404,NaN,NaN,NaN,NaN,NaN,498.41930000000053,500.3379922724317,496.5006077275694,498.7972931837624,501.2482033262403,501.31928226214023,501.17712439034034,22499,23667.4,68.25969316701583,50.334387909132495,NaN,NaN,NaN,NaN,0.8420350878825238,36.08290967364639,12378434,0.4605200463892152,0.6667393523106853,0.20621930592147006
2025-09-09T09:50:00-04:00,500.98,501.5,500.47,500.74,499.2326644887404,NaN,NaN,NaN,NaN,NaN,498.44950000000046,500.46345258053566,496.43554741946525,498.7972931837624,501.20823398848125,501.3372818736488,501.0791861033137,16387,23841.233333333334,65.78386293033235,52.58424061273995,NaN,NaN,NaN,NaN,0.8554611530337702,36.65486146063239,12362047,0.40727480587625725,0.7153128132667916,0.3080380073905344
2025-09-09T09:55:00-04:00,500.74,501.63,500.3,500.91,499.2326644887404,NaN,NaN,NaN,NaN,NaN,498.4843000000004,500.60419528910063,496.3644047109002,498.7972931837624,501.1830316228774,501.32796519109394,501.0380980546609,15076,23997.033333333333,66.78636183058077,54.46649341419502,NaN,NaN,NaN,NaN,0.8893567849599284,36.82506860332518,12377123,0.36059238147561373,0.7587784842350516,0.39818610275943783
2025-09-09T10:00:00-04:00,500.91,501.31,499.44,499.88,499.2326644887404,NaN,NaN,NaN,NaN,NaN,498.5080000000005,500.6629932706276,496.35300672937336,498.7972931837624,501.0361307327502,501.40921757649164,500.6630438890088,27823,24560.9,56.067739654871616,55.61632579121938,NaN,NaN,NaN,NaN,0.9594027288913625,35.390229589014005,12349300,0.2430675133385204,0.7020204944325883,0.4589529810940679
2025-09-09T10:05:00-04:00,500,500.86,499.74,500.84,499.2326644887404,NaN,NaN,NaN,NaN,NaN,498.5488000000005,500.79948305997294,496.298116940028,498.7972931837624,500.99053007925164,501.37919564816383,500.60186451033945,16461,24811.4,62.16293113724077,57.52528059869892,NaN,NaN,NaN,NaN,0.9708739625419798,34.057879075725054,12365761,0.21374397266871792,0.7261329469299653,0.5123889742612474
2025-09-09T10:10:00-04:00,500.85,501.82,500.64,501.53,499.2326644887404,NaN,NaN,NaN,NaN,NaN,498.6167000000005,501.01345581494377,496.2199441850572,498.7972931837624,501.0158553174424,501.4002343236502,500.6314763112346,16184,24952.833333333332,65.8322291976486,59.77366348644409,NaN,NaN,NaN,NaN,0.9858115366461246,33.84329605612931,12381945,0.2235225687881509,0.791792185246436,0.5682696164582851
2025-09-09T10:15:00-04:00,501.65,502.14,501.1,502.11,499.2326644887404,NaN,NaN,NaN,NaN,NaN,498.68730000000045,501.2758603791549,496.098739620846,499.04065618436425,501.1219616126628,501.5663672794732,500.6775559458524,34804,25718.433333333334,68.58964311362635,62.033776195773626,NaN,NaN,NaN,NaN,0.9896821411713989,33.930338402806335,12416749,0.2497676203775847,0.880479141930266,0.6307115215526813
2025-09-09T10:20:00-04:00,502.07,502.25,501.1,501.265,499.2326644887404,NaN,NaN,NaN,NaN,NaN,498.7412000000004,501.42811016539883,496.05428983460195,499.19552494749144,501.14160715524827,501.584294272954,500.6989200375425,12466,25431.3,60.880959757205126,63.7544485567607,NaN,NaN,NaN,NaN,1.0011334168020116,34.10888428103478,12404283,0.19344827640541273,0.8725218670594472,0.6790735906540345
2025-09-09T10:25:00-04:00,501.27,501.34,500.76,500.92,499.2326644887404,NaN,NaN,NaN,NaN,NaN,498.7892000000005,501.543492910462,496.034907089539,499.19552494749144,501.1372474923207,501.57337786824115,500.7011171164002,8821,25464.1,58.01412614221753,63.8754587635569,NaN,NaN,NaN,NaN,0.9710524584590097,33.63607105268566,12395462,0.11979944606403614,0.8288228982340797,0.7090234521700436
2025-09-09T10:30:00-04:00,500.97,501.11,499.55,499.55,499.2326644887404,NaN,NaN,NaN,NaN,NaN,498.80860000000047,501.5703798892307,496.0468201107702,499.19552494749144,501.0950808183147,501.57038999875806,500.6197716378714,11231,25527.2,48.28974326766445,64.1945552320685,NaN,NaN,NaN,NaN,1.013120139997652,31.369025046112515,12384231,-0.026536529803865783,0.6758527899152114,0.7023893197190771
2025-09-09T10:35:00-04:00,499.58,499.71,499.01,499.33,NaN,NaN,NaN,502.01052641431033,502.01052641431033,502.01052641431033,498.8216000000004,501.58695309802675,496.056246901974,499.19552494749144,501.0111243774263,501.60653337582,500.41571537903263,14367,25680.166666666668,46.92936474307402,63.627710363931065,NaN,NaN,NaN,NaN,0.9907544157121045,29.633262309367996,12369864,-0.13730943113049743,0.5307525308059553,0.6680619619364527
2025-09-09T10:40:00-04:00,499.3,499.38,498.8,499.1,NaN,NaN,NaN,501.6991388500235,NaN,NaN,498.8408000000004,501.60028137099636,496.08131862900444,499.19552494749144,500.9185221404585,501.6301474086088,500.20689687230816,15151,25946.566666666666,45.48665581919167,61.56760133198768,NaN,NaN,NaN,NaN,0.9614148145898103,28.257397087631723,12354713,-0.22031040844461303,0.3926739513806865,0.6129843598252995
2025-09-09T10:45:00-04:00,499.04,499.71,498.9,499.35,NaN,NaN,NaN,501.6991388500235,NaN,NaN,498.86320000000046,501.62066750419245,496.10573249580847,499.19552494749144,500.8772698281116,501.6239845021595,500.1305551540637,8312,25932.033333333333,47.38021956627347,59.64274685340729,NaN,NaN,NaN,NaN,0.9505994706905383,26.532547399185376,12363025,-0.2504188228182971,0.29996083130242823,0.5503796541207253
2025-09-09T10:50:00-04:00,499.32,499.97,499.05,499.91,NaN,NaN,NaN,501.6991388500235,NaN,NaN,498.89800000000037,501.66350248545365,496.1324975145471,499.19552494749144,500.83960510790706,501.604863475601,500.0743467402131,10141,25950.666666666668,51.44851362968253,57.99371742547323,NaN,NaN,NaN,NaN,0.9484137942126438,24.685353857055112,12373166,-0.2254426396717067,0.26857635453109197,0.49401899420279866
2025-09-09T10:55:00-04:00,500,500.1,499.57,499.73,NaN,NaN,NaN,501.6991388500235,NaN,NaN,498.9232000000004,501.69559734470363,496.1508026552972,499.19552494749144,500.8109173647331,501.5845201070549,500.03731462241126,9428,25959,50.10749395507952,56.69713176747778,NaN,NaN,NaN,NaN,0.9185270946260286,23.141320561699004,12363738,-0.21396103260398847,0.22656770344781307,0.44052873605180154
2025-09-09T11:00:00-04:00,499.73,500.01,499.12,499.35,NaN,NaN,NaN,501.6991388500235,NaN,NaN,498.9408000000005,501.7126386382718,496.16896136172915,499.19552494749144,500.7663938920892,501.5632120817793,499.9695757023991,11949,26010.066666666666,47.30426609276369,55.377160564794295,NaN,NaN,NaN,NaN,0.9164894450098827,21.876803402693675,12351789,-0.22381532149446332,0.16075958418372238,0.3845749056781857
2025-09-09T11:05:00-04:00,499.34,499.75,499.07,499.63,NaN,NaN,NaN,501.6991388500235,NaN,NaN,498.9672000000004,501.7396481306182,496.19475186938257,499.19552494749144,500.7349104142873,501.5465406924458,499.9232801361288,8895,25961,49.544154216449776,54.14557430664208,NaN,NaN,NaN,NaN,0.8995973417948916,20.768664476145354,12360684,-0.20389618000892268,0.12970468066703233,0.333600860675955
2025-09-09T11:10:00-04:00,499.6,499.88,499.39,499.82,NaN,NaN,NaN,501.6991388500235,NaN,NaN,498.99860000000047,501.77340740894977,496.22379259105116,498.6064199579931,500.70920193647663,501.52679777992364,499.8916060930296,9204,25807.5,51.064203890612845,53.788178894909315,NaN,NaN,NaN,NaN,0.8703403888095428,19.53718583983631,12369888,-0.17163869258778058,0.11905249494122927,0.29069118752900985
2025-09-09T11:15:00-04:00,499.8,500.25,499.6,499.75,NaN,NaN,NaN,501.6991388500235,NaN,NaN,499.0284000000004,501.80284224253535,496.2539577574654,498.40037146612457,500.68965814178176,501.50760764988524,499.8717086336783,8827,25553.733333333334,50.46104511140848,52.952329893064146,NaN,NaN,NaN,NaN,0.8546017896088596,18.448164958044135,12361061,-0.14954015305450236,0.1037659962108819,0.25330614926538425
2025-09-09T11:20:00-04:00,499.74,499.91,499.17,499.2,NaN,NaN,NaN,501.6991388500235,NaN,NaN,499.0468000000004,501.8133362887323,496.28026371126856,498.40037146612457,500.6736858827161,501.4986090099967,499.8487627554355,4874,25161.233333333334,45.875939032182536,51.52688059553086,NaN,NaN,NaN,NaN,0.8464159474939417,17.46727163115099,12356187,-0.16525913357910435,0.046732232291503806,0.21199136587060816
2025-09-09T11:25:00-04:00,499.29,499.79,499.24,499.51,NaN,NaN,NaN,501.6991388500235,NaN,NaN,499.0770000000004,501.8301029760916,496.3238970239092,498.40037146612457,500.65390818859606,501.4854473141851,499.82236906300705,6683,24915.266666666666,48.705059031592725,50.10655316109988,NaN,NaN,NaN,NaN,0.8281005226729482,16.556442113321637,12362870,-0.14859753821822774,0.026244443097823478,0.17484198131605122
2025-09-09T11:30:00-04:00,499.5,499.64,499.13,499.15,NaN,NaN,NaN,501.6991388500235,NaN,NaN,499.1021000000004,501.8344455778809,496.3697544221199,498.40037146612457,500.63319607395044,501.47480303387096,499.79158911402993,6122,24292.266666666666,45.71651537413089,49.02337856230887,NaN,NaN,NaN,NaN,0.8053790567677369,15.880696586276208,12356748,-0.15493300447925681,-0.018824274283019804,0.136108730196237
2025-09-09T11:35:00-04:00,499.14,499.355,499.08,499.2,NaN,NaN,NaN,501.53257158075604,NaN,NaN,499.1281000000004,501.8388511056814,496.41734889431945,498.40037146612457,500.61657895324635,501.467089444994,499.7660684614987,4710,23729.8,46.21018653289402,48.18024001878576,NaN,NaN,NaN,NaN,0.7674948384271867,15.333387939658245,12361458,-0.1488321020053001,-0.04993139731038809,0.098900704694912
2025-09-09T11:40:00-04:00,499.25,499.26,498.74,498.8,NaN,NaN,NaN,501.2807501452672,NaN,NaN,499.1485000000004,501.8335938525224,496.4634061474784,498.40037146612457,500.58164275599347,501.4568227764311,499.7064627355558,8540,23012.7,42.852638211460274,47.79187537191404,NaN,NaN,NaN,NaN,0.7498166356823864,15.35802506518402,12352918,-0.16363487418151357,-0.10564288803197996,0.0579919861495336
2025-09-09T11:45:00-04:00,498.81,499.23,498.81,499.04,NaN,NaN,NaN,501.255716047755,NaN,NaN,499.1683000000004,501.8352395263096,496.5013604736912,498.40037146612457,500.5681669634114,501.4513856156757,499.6849483111471,3597,21831.333333333332,45.415300667052826,47.68372793791252,NaN,NaN,NaN,NaN,0.7269725902765022,15.380902396029384,12356515,-0.1495474170575922,-0.12894228517245665,0.020605131885135554
2025-09-09T11:50:00-04:00,499.07,500,499.07,499.87,NaN,NaN,NaN,501.255716047755,NaN,NaN,499.2071000000004,501.8572442143792,496.55695578562165,498.4251979020926,500.55443643686624,501.4381309986908,499.6707418750417,6278,19765.2,53.22694545978552,48.23660576938351,NaN,NaN,NaN,NaN,0.7436174052567506,14.616007866656025,12362793,-0.08009734121969964,-0.07951654463948898,0.0005807965802106449
2025-09-09T11:55:00-04:00,499.92,500.1,499.43,499.43,NaN,NaN,NaN,501.255716047755,NaN,NaN,499.2301000000004,501.8675916032339,496.5926083967669,498.5051583216741,500.5402632240831,501.42412062311973,499.6564058250465,6733,14269,49.20667858489565,48.36706712785651,NaN,NaN,NaN,NaN,0.7383590191669838,14.06926283394184,12356060,-0.060453611266076505,-0.07498621750238499,-0.014532606236308483
2025-09-09T12:00:00-04:00,499.46,499.66,499.12,499.25,NaN,NaN,NaN,501.255716047755,NaN,NaN,499.25210000000044,501.87147556621653,496.63272443378435,498.5051583216741,500.5229086665376,501.411923884343,499.6338934487322,6298,12580.366666666667,47.6220201523579,48.09374616519047,NaN,NaN,NaN,NaN,0.724190517797915,13.13410658933394,12349762,-0.0563269121861877,-0.08494124646904311,-0.02861433428285541
2025-09-09T12:05:00-04:00,499.23,499.33,498.79,498.9,NaN,NaN,NaN,501.255716047755,NaN,NaN,499.2613000000004,501.87241992008336,496.65018007991745,498.5051583216741,500.48567867424794,501.3945270443569,499.576830304139,10934,12167.4,44.613466201808265,47.701315611385375,NaN,NaN,NaN,NaN,0.7110340522409185,12.820372501522934,12338828,-0.07286293825026845,-0.11969300709569097,-0.046830068845422526
2025-09-09T12:10:00-04:00,498.95,499.14,498.59,498.99,NaN,NaN,NaN,501.0372667598991,NaN,NaN,499.2749000000004,501.8731105297918,496.676689470209,498.5051583216741,500.4195835628443,501.3637373669521,499.47542975873654,19454,12074.966666666667,45.565782295379925,47.57713819728654,NaN,NaN,NaN,NaN,0.6995316199379966,12.846413475411422,12358282,-0.0732372728655954,-0.13837665992741677,-0.06513938706182137
2025-09-09T12:15:00-04:00,498.985,499.43,498.91,499.16,NaN,NaN,NaN,501.0372667598991,NaN,NaN,499.2943000000004,501.8742395413593,496.7143604586415,498.5051583216741,500.3915544853253,501.3432985312318,499.43981043941875,10635,11679.5,47.40532472789563,47.424364662389806,NaN,NaN,NaN,NaN,0.686707932799567,12.299370884910145,12368917,-0.05818981348112237,-0.13787665391322435,-0.07968684043210197
2025-09-09T12:20:00-04:00,499.16,499.18,498.51,498.68,NaN,NaN,NaN,500.98332570478414,NaN,NaN,499.30210000000045,501.87218644931863,496.73201355068227,498.5051583216741,500.3555146932326,501.3260062967996,499.38502308966554,10944,11498.066666666668,42.98797475198057,46.84749115248751,NaN,NaN,NaN,NaN,0.6855145090281705,12.434659987909711,12357973,-0.07561394019902631,-0.17420426568088487,-0.09859032548185856
2025-09-09T12:25:00-04:00,498.65,498.74,498.36,498.65,NaN,NaN,NaN,500.64294726365756,NaN,NaN,499.30710000000045,501.8711125500879,496.743087449913,498.5051583216741,500.33321013710037,501.3176033853249,499.34881688887583,6199,11202.166666666666,42.72003878139118,46.29456212891484,NaN,NaN,NaN,NaN,0.6636920440975865,12.786702905339018,12351774,-0.08358693830940031,-0.20307399836860895,-0.11948706005920864
2025-09-09T12:30:00-04:00,498.64,498.66,498.45,498.6,NaN,NaN,NaN,500.58144966076406,NaN,NaN,499.31770000000046,501.86549842942026,496.76990157058066,498.5051583216741,500.3049040926676,501.3061941718293,499.30361401350586,8036,10542.6,42.24741280454859,46.03538168408385,NaN,NaN,NaN,NaN,0.6312854695191901,13.113599900094803,12343738,-0.08630403610764431,-0.22736710519376402,-0.1410630690861197
2025-09-09T12:35:00-04:00,498.61,498.65,498.46,498.53,NaN,NaN,NaN,500.51524740345656,NaN,NaN,499.3253000000004,501.86136025897684,496.789239741024,498.5051583216741,500.2857061143866,501.29813922158115,499.273273007192,5526,10178.1,41.55428317576485,45.52461198009615,NaN,NaN,NaN,NaN,0.5997650788392478,13.417147109510887,12338212,-0.08666405157822168,-0.2493931335588968,-0.16272908198067512
2025-09-09T12:40:00-04:00,498.52,498.65,498.47,498.61,NaN,NaN,NaN,500.45569070329947,NaN,NaN,499.3359000000005,501.8554282806247,496.81637171937626,498.5051583216741,500.26118537265575,501.286670516332,499.2357002289795,7367,9884.2,42.71109180980592,45.30993886835864,NaN,NaN,NaN,NaN,0.5697818589221552,13.699012375397254,12345579,-0.07575764642760713,-0.25742614001518405,-0.18166849358757692
2025-09-09T12:45:00-04:00,498.58,498.85,498.39,498.51,NaN,NaN,NaN,500.45569070329947,NaN,NaN,499.3491000000005,501.8441476462239,496.85405235377704,498.1141266573393,500.2328918790407,501.2723908777388,499.1933928803426,8807,9017.633333333333,41.60262110031599,44.98082705174592,NaN,NaN,NaN,NaN,0.5619402975705753,13.439862704673434,12336772,-0.06967591136529117,-0.2687633827941909,-0.1990874714288997
2025-09-09T12:50:00-04:00,498.505,498.61,498.26,498.42,NaN,NaN,NaN,500.26987520693194,NaN,NaN,499.3689000000005,501.8180053788669,496.9197946211341,497.98571284855774,500.20660022314496,501.2608820166447,499.1523184296452,7729,8859.733333333334,40.581817404686184,44.81862556554778,NaN,NaN,NaN,NaN,0.5468017048869644,13.466964817276969,12329043,-0.0661400185122803,-0.28176249456925007,-0.21562247605696977
2025-09-09T12:55:00-04:00,498.44,499.32,498.44,498.84,NaN,NaN,NaN,500.26987520693194,NaN,NaN,499.3919000000005,501.79874099119996,496.985059008801,498.1010284729423,500.18269806810275,501.24248041410425,499.12291572210125,9626,8886.566666666668,47.10457334585087,44.93928789974763,NaN,NaN,NaN,NaN,0.572030154537894,13.118634310371796,12338669,-0.03168741255313551,-0.25523174174838914,-0.22354432919525363
2025-09-09T13:00:00-04:00,498.92,499.23,498.68,499.2,NaN,NaN,NaN,500.26987520693194,NaN,NaN,499.4227000000005,501.77898454074074,497.0664154592602,498.1010284729423,500.16717007868436,501.22805426606396,499.10628589130476,7412,8759.266666666666,51.97143773274521,44.849608776387605,NaN,NaN,NaN,NaN,0.5704565720709024,12.795184553959851,12346081,0.016580289883953686,-0.20281896684031153,-0.21939925672426522
2025-09-09T13:05:00-04:00,499.18,499.51,499.17,499.38,NaN,NaN,NaN,500.26987520693194,NaN,NaN,499.46330000000046,501.7440767179146,497.1825232820863,498.33985822268306,500.1524624233013,501.20929211087173,499.0956327357309,10068,8615.966666666667,54.23861246377391,45.20903262487892,NaN,NaN,NaN,NaN,0.5539953883515504,13.034231172973119,12356149,0.05945178510850663,-0.14508452533863192,-0.20453631044713855
2025-09-09T13:10:00-04:00,499.45,499.6,499.24,499.49,NaN,NaN,NaN,500.26987520693194,NaN,NaN,499.50770000000045,501.700704522791,497.3146954772099,498.4838865781465,500.142690838377,501.19546452081437,499.08991715593964,7784,8370.4,55.61741743111991,45.78013243050477,NaN,NaN,NaN,NaN,0.5401385748978692,13.422729241771867,12363933,0.0920909084613181,-0.08942267487049094,-0.18151358333180903
2025-09-09T13:15:00-04:00,499.47,499.53,498.82,498.87,NaN,NaN,NaN,500.26987520693194,NaN,NaN,499.53770000000054,501.6525571669998,497.42284283300125,498.4838865781465,500.1244261403675,501.17732686073776,499.0715254199973,9816,8420.533333333333,47.01829354464302,45.95190581213583,NaN,NaN,NaN,NaN,0.5522715338337342,12.746066318130975,12354117,0.06980879418378169,-0.09425259060208191,-0.1640613847858636
2025-09-09T13:20:00-04:00,498.95,499.37,498.85,499.37,NaN,NaN,NaN,500.26987520693194,NaN,NaN,499.5779000000005,501.6000316368765,497.5557683631245,498.4838865781465,500.1132366518198,501.16465726868637,499.06181603495327,7016,8316.366666666667,53.2903887006966,46.5036634125156,NaN,NaN,NaN,NaN,0.5499664242741804,12.117736460464434,12361133,0.08558785252364182,-0.05707656913131132,-0.14266442165495313
2025-09-09T13:25:00-04:00,499.34,499.36,499.09,499.11,NaN,NaN,NaN,500.26987520693194,NaN,NaN,499.5933000000005,501.58904307886564,497.5975569211354,498.4838865781465,500.10442385044496,501.15468992281575,499.05415777807417,5586,8188.3,49.97719661757428,46.687368547492646,NaN,NaN,NaN,NaN,0.5306831082545982,11.53428730691693,12355547,0.07569925565075875,-0.0480403520915047,-0.12373960774226345
2025-09-09T13:30:00-04:00,499.13,499.27,498.85,499.02,NaN,NaN,NaN,500.26987520693194,NaN,NaN,499.62370000000055,501.53551464503465,497.71188535496645,498.4838865781465,500.09528404391426,501.1455753065873,499.0449927812412,5119,7960.633333333333,48.845127815419744,47.10573662345258,NaN,NaN,NaN,NaN,0.5227771719506954,11.025674760878834,12350428,0.06091751527687653,-0.047592713646167795,-0.10851022892304432
2025-09-09T13:35:00-04:00,499.05,499.08,498.85,498.91,NaN,NaN,NaN,500.26987520693194,NaN,NaN,499.6347000000005,501.52349475775117,497.7459052422499,498.4838865781465,500.0861020289126,501.1371756728135,499.0350283850117,4774,7823.266666666666,47.43097025884315,47.44223172898486,NaN,NaN,NaN,NaN,0.5018645168113572,10.553391682414889,12345654,0.04242853399256845,-0.05547456143233376,-0.0979030954249022
2025-09-09T13:40:00-04:00,498.87,499.045,498.78,498.98,NaN,NaN,NaN,500.26987520693194,NaN,NaN,499.5855000000005,501.4107191640888,497.76028083591217,498.4838865781465,500.0725568733096,501.1247756697973,499.02033807682193,7111,7753.5,48.45370738434135,47.885538484684346,NaN,NaN,NaN,NaN,0.48494562275340625,10.29573150030907,12352765,0.03397562515311131,-0.05543356398351307,-0.08940918913662438
2025-09-09T13:45:00-04:00,498.96,498.96,498.71,498.76,NaN,NaN,NaN,500.26987520693194,NaN,NaN,499.53190000000046,501.292387306699,497.7714126933019,498.4838865781465,500.05749962257767,501.11236656674293,499.0026326784124,7294,7702.4,45.460236264987586,48.164535133914534,NaN,NaN,NaN,NaN,0.46959236398530857,10.240856735211667,12345471,0.013671687710751668,-0.0723195794981848,-0.08599126720893646
2025-09-09T13:50:00-04:00,498.76,498.76,498.5,498.75,NaN,NaN,NaN,500.19711120861973,NaN,NaN,499.4771000000005,501.15920592908265,497.7949940709184,498.4838865781465,500.0391761833308,501.0989579014666,498.97939446519507,8185,7812.766666666666,45.32317007489348,48.35111215284936,NaN,NaN,NaN,NaN,0.4546214808435001,10.721432738967673,12337286,0.0003746699440261708,-0.08552292977890374,-0.08589759972292992
2025-09-09T13:55:00-04:00,498.74,499,498.64,498.91,NaN,NaN,NaN,500.19711120861973,NaN,NaN,499.4361000000005,501.07089820064385,497.8013017993572,498.4838865781465,500.0297804264055,501.0906047477464,498.96895610506465,4936,7754.533333333334,48.0234617053232,48.8097436246356,NaN,NaN,NaN,NaN,0.44786280364039394,10.399647891678976,12342222,0.0030146542273796206,-0.08212928193870539,-0.08514393616608501
2025-09-09T14:00:00-04:00,498.92,499.1,498.7,498.9,NaN,NaN,NaN,500.19711120861973,NaN,NaN,499.39930000000044,500.9974639581673,497.80113604183356,498.28210926251717,500.0118355389836,501.0736384941441,498.95003258382303,10083,7886.566666666667,47.86435654371345,49.32992499170898,NaN,NaN,NaN,NaN,0.44444403195179677,9.80029496927955,12332139,0.00464937645040879,-0.07933221560307402,-0.08398159205348281
2025-09-09T14:05:00-04:00,498.92,499.4,498.92,499.29,NaN,NaN,NaN,500.19711120861973,NaN,NaN,499.36690000000044,500.9058306537954,497.82796934620546,498.4429636886582,500.00084044869084,501.0595481250244,498.9421327723573,8752,8021.3,54.232814717887265,49.83908508971157,NaN,NaN,NaN,NaN,0.44841231538381127,9.783533610386145,12340891,0.031084793706719113,-0.045125599920083914,-0.07621039362680303
2025-09-09T14:10:00-04:00,499.35,499.44,498.84,498.99,NaN,NaN,NaN,500.19711120861973,NaN,NaN,499.3491000000005,500.8844640470759,497.8137359529251,498.4429636886582,499.9781522755268,501.0331844488512,498.92312010220235,16440,8284.633333333333,49.249245700115516,49.64464280166659,NaN,NaN,NaN,NaN,0.4592400071421121,9.521005748278306,12324451,0.027573981318614382,-0.04174291697853505,-0.06931689829714943
2025-09-09T14:15:00-04:00,498.96,499.055,498.68,498.705,NaN,NaN,NaN,500.19711120861973,NaN,NaN,499.3064000000005,500.791464361241,497.82133563876,498.4429636886582,499.9556979219603,501.01271576517115,498.8986800787494,12973,8597.166666666666,45.01706860753252,48.98596109764935,NaN,NaN,NaN,NaN,0.4532228637748184,8.886990046343,12311478,0.006371913207218111,-0.0613520067881268,-0.06772391999534491
2025-09-09T14:20:00-04:00,498.74,498.99,498.51,498.76,NaN,NaN,NaN,500.19711120861973,NaN,NaN,499.25100000000043,500.6006192045124,497.9013807954885,498.4429636886582,499.9309289619076,500.99085263919295,498.8710052846223,14155,8859.733333333334,45.98180100285867,48.29770278134498,NaN,NaN,NaN,NaN,0.4551355163623327,8.77997870741163,12325633,-0.0031237609908542907,-0.07162862123391278,-0.06850486024305849
2025-09-09T14:25:00-04:00,498.8,498.8,498.53,498.6,NaN,NaN,NaN,500.15057301401873,NaN,NaN,499.18080000000043,500.2678848344396,498.09371516556126,498.4429636886582,499.9031485592424,500.96813575958174,498.8381613589031,15152,9140.366666666667,43.585909950430924,48.05253252461555,NaN,NaN,NaN,NaN,0.4419115509078831,8.680611035546786,12310481,-0.01849799337994218,-0.09162735196798621,-0.07312935858804404
2025-09-09T14:30:00-04:00,498.64,498.66,498.38,498.61,NaN,NaN,NaN,499.97622878610883,NaN,NaN,499.1277000000004,500.0491276083983,498.2062723916025,498.4429636886582,499.8768581831417,500.94786003446205,498.8058563318213,13915,9394.266666666666,43.783067283513894,47.37343813767392,NaN,NaN,NaN,NaN,0.43034644012875073,9.017988140088228,12324396,-0.025859685972332874,-0.10545396605346014,-0.07959428008112726
2025-09-09T14:35:00-04:00,498.66,498.69,498.42,498.47,NaN,NaN,NaN,499.97622878610883,NaN,NaN,499.07870000000037,499.86422099759847,498.29317900240227,498.4429636886582,499.86204992694763,500.93640527839636,498.7876945754989,7942,9294.533333333333,41.591558283210375,46.774463970933645,NaN,NaN,NaN,NaN,0.4188931229766958,9.219514229621046,12316454,-0.03732707187598201,-0.12625311992610477,-0.08892604805012276
2025-09-09T14:40:00-04:00,498.49,498.6,498.34,498.41,NaN,NaN,NaN,499.86745226172314,NaN,NaN,499.0559000000004,499.8514920797767,498.26030792022414,498.4429636886582,499.8397660887069,500.92004080565687,498.7594913717569,11611,9033.1,40.6524161267001,46.18927027888225,NaN,NaN,NaN,NaN,0.4075436141926495,9.646630298378389,12304843,-0.04557619843583614,-0.14589629609491794,-0.1003200976590818
2025-09-09T14:45:00-04:00,498.42,498.97,498.31,498.97,NaN,NaN,NaN,499.86745226172314,NaN,NaN,499.04870000000045,499.84074749684214,498.25665250315876,498.4429636886582,499.8217255331264,500.90200742705053,498.7414436392023,12385,9091.433333333332,51.63034872409247,46.489225883542915,NaN,NaN,NaN,NaN,0.4255762131788906,9.184659934808929,12317228,-0.011704920599479501,-0.11495124840843118,-0.10324632780895168
2025-09-09T14:50:00-04:00,498.97,499.18,498.74,499.18,NaN,NaN,NaN,499.86745226172314,NaN,NaN,499.0503000000005,499.8430784286888,498.2575215713122,498.4429636886582,499.7951580894763,500.8665695591633,498.72374661978927,26090,9596.3,54.99250798319543,46.95628306917535,NaN,NaN,NaN,NaN,0.42660648366611253,9.37013935168144,12343318,0.024481517896258048,-0.07264443043862912,-0.09712594833488716
2025-09-09T14:55:00-04:00,499.165,499.21,498.94,498.97,NaN,NaN,NaN,499.86745226172314,NaN,NaN,499.0427000000005,499.831114127971,498.25428587203,498.37437095092656,499.7813766860762,500.8477680375674,498.71498533458504,14392,9869.4,51.162646970206126,47.3635981195481,NaN,NaN,NaN,NaN,0.4154203062613889,9.627340969836633,12328926,0.03336288420526541,-0.0554223430783054,-0.08878522728357081
2025-09-09T15:00:00-04:00,498.98,498.99,498.54,498.84,NaN,NaN,NaN,499.86745226172314,NaN,NaN,499.0213000000004,499.77155011658306,498.27104988341773,498.2598641221425,499.7683957739681,500.83375994238037,498.70303160555585,10463,9950.3,48.892617396398464,47.618558642512745,NaN,NaN,NaN,NaN,0.41789028438557463,9.322152051317097,12318463,0.029693756700696086,-0.05166803140770071,-0.0813617881083968
2025-09-09T15:05:00-04:00,498.885,498.885,498.57,498.65,NaN,NaN,NaN,499.86745226172314,NaN,NaN,498.9997000000005,499.7289857034274,498.27041429657356,498.2598641221425,499.75463865167666,500.81993160865704,498.68934569469627,10440,10114.1,45.70108022133248,47.45267425079912,NaN,NaN,NaN,NaN,0.41054097835803344,9.038762341263244,12308023,0.014453826637021383,-0.06329450481212007,-0.07774833144914145
2025-09-09T15:10:00-04:00,498.59,498.66,498.28,498.33,NaN,NaN,NaN,499.8289906376237,NaN,NaN,498.9793000000004,499.72512574200607,498.23347425799477,498.2598641221425,499.73030643511726,500.8007778468148,498.6598350234197,15071,10370.9,40.86305116411556,46.95258100939926,NaN,NaN,NaN,NaN,0.40835947990389193,9.587027162752621,12292952,-0.01556879548119397,-0.0972093258006339,-0.08164053031943994
2025-09-09T15:15:00-04:00,498.33,498.85,498.19,498.44,NaN,NaN,NaN,499.8289906376237,NaN,NaN,498.9555000000005,499.69264652354525,498.2183534764557,498.2598641221425,499.7014996843356,500.77575586801476,498.62724350065645,19661,10732.7,43.09319858708375,46.1568941429133,NaN,NaN,NaN,NaN,0.42633380276790145,9.44524622746795,12312613,-0.025806007253669466,-0.11389803938652676,-0.0880920321328573
2025-09-09T15:20:00-04:00,498.45,498.62,498.26,498.28,NaN,NaN,NaN,499.8132538660993,NaN,NaN,498.9247000000004,499.6432441095115,498.20615589048936,498.2598641221425,499.681463899889,500.7596026933225,498.60332510645554,13064,10910.533333333333,40.68955756194873,45.54548784732996,NaN,NaN,NaN,NaN,0.4215956739987666,9.31359250184647,12299549,-0.040277407691387546,-0.13843879174709173,-0.09816138405570418
2025-09-09T15:25:00-04:00,498.28,498.39,498.07,498.15,NaN,NaN,NaN,499.58446959945843,NaN,NaN,498.8927000000005,499.6038489554945,498.1815510445065,498.2598641221425,499.65643465484516,500.7422848304893,498.570584479201,14767,11081.9,38.7960940781757,45.10113252380447,NaN,NaN,NaN,NaN,0.4143388401417113,9.739324000542569,12284782,-0.05463777055691396,-0.16645859725184664,-0.11182082669493268
2025-09-09T15:30:00-04:00,498.14,498.2,497.95,498.03,NaN,NaN,NaN,499.4019937085739,NaN,NaN,498.8693000000005,499.61463753219704,498.123962467804,498.2598641221425,499.617291736111,500.7177997832785,498.51678368894346,21920,11565.5,37.080773384210595,44.46534483675818,NaN,NaN,NaN,NaN,0.4026003515601605,10.458146632595575,12262862,-0.06741303610321417,-0.19608712182395038,-0.12867408572073621
2025-09-09T15:35:00-04:00,498,498.25,497.98,498.22,NaN,NaN,NaN,499.4019937085739,NaN,NaN,498.8435000000005,499.5876458169224,498.0993541830786,498.2598641221425,499.58975289996806,500.6979208643967,498.48158493553944,17100,11799.9,41.49171897011729,44.31575976673577,NaN,NaN,NaN,NaN,0.3931288978772906,10.925175765923955,12279962,-0.05858796909913855,-0.2019090470946594,-0.14332107799552085
2025-09-09T15:40:00-04:00,498.26,498.29,497.71,498.13,NaN,NaN,NaN,499.32333517661385,NaN,NaN,498.82310000000047,499.5881487285628,498.0580512714381,498.2598641221425,499.56120478440516,500.6786563927073,498.44375317610303,17136,12111.633333333333,40.059124183363544,44.04976383101076,NaN,NaN,NaN,NaN,0.4064768337432013,12.069647729100245,12262826,-0.054422268751865926,-0.21134891393535327,-0.15692664518348734
2025-09-09T15:45:00-04:00,498.13,498.46,498.13,498.32,NaN,NaN,NaN,499.32333517661385,NaN,NaN,498.80550000000045,499.5755292184372,498.0354707815637,498.00489129771404,499.53485459851765,500.6551183580333,498.414590839002,19861,12446.466666666667,44.42188614318001,44.25193010672287,NaN,NaN,NaN,NaN,0.401014202761543,12.4506543736841,12282687,-0.0354023568258541,-0.20117959121580498,-0.16577723438995087
2025-09-09T15:50:00-04:00,498.34,498.6,497.74,498.05,NaN,NaN,NaN,499.32333517661385,NaN,NaN,498.79050000000046,499.5890643350462,497.9919356649547,497.9394130381712,499.46910949311666,500.60237869273556,498.33584029349777,46548,13764.2,39.96978435344469,44.203170694347484,NaN,NaN,NaN,NaN,0.4337989025642909,13.728612592774578,12236139,-0.03734460429201253,-0.21245798975496655,-0.17511338546295402
2025-09-09T15:55:00-04:00,498.03,498.85,498.03,498.43,NaN,NaN,NaN,499.32333517661385,NaN,NaN,498.77830000000046,499.57987746798415,497.97672253201677,497.7628243444296,499.40826304374497,500.5341972379442,498.2823288495457,62290,15654.333333333334,47.886148725698206,43.93572783731933,NaN,NaN,NaN,NaN,0.4613846952382737,14.006755182937045,12298429,-0.01075711395042983,-0.18855977790099132,-0.1778026639505615
2025-09-10T09:30:00-04:00,502.84,503.19,499.97,500.06,499.57953905777003,499.57953905777003,499.57953905777003,NaN,NaN,NaN,498.7821000000005,499.6058380389649,497.95836196103613,499.7168595327724,501.0733333333334,501.0733333333334,501.0733333333334,143623,20271.133333333335,67.61462357802787,44.837307522664496,NaN,NaN,NaN,NaN,0.7684286455783964,17.174468068522568,12442052,0.11211510056941987,-0.037658788238786656,-0.14977388880820652
2025-09-10T09:35:00-04:00,500.04,500.44,497.56,498.435,NaN,NaN,NaN,501.3022581721287,501.3022581721287,501.3022581721287,498.7622000000005,499.57029444804664,497.9541055519544,499.7168595327724,500.226290554145,501.320935222117,499.13164588617303,85998,22978.6,48.075195534234346,44.61677527723794,NaN,NaN,NaN,NaN,0.9192551708942249,16.96413133325538,12356054,0.08091352161807866,-0.048631986785608206,-0.12954550840368687
2025-09-10T09:40:00-04:00,498.41,499.17,496.72,498.28,NaN,NaN,NaN,500.4767009824865,NaN,NaN,498.7428000000005,499.5496932005494,497.9359067994516,499.7168595327724,499.695286434607,501.0276137634253,498.3629591057887,74410,25221.9,46.68923461897519,44.45939079313628,NaN,NaN,NaN,NaN,1.0285940872589223,15.996227839914098,12281644,0.048404659680232526,-0.0690396838033962,-0.11744434348362873
2025-09-10T09:45:00-04:00,498.18,498.465,497.01,498.11,NaN,NaN,NaN,500.35253275600974,NaN,NaN,498.72700000000054,499.5517035813025,497.9022964186986,499.7168595327724,499.4855775872699,500.86855590601573,498.1025992685241,39262,26287.5,45.151764933431245,44.42015398685762,NaN,NaN,NaN,NaN,1.0590516524547124,15.097460310382907,12242382,0.0157129973859943,-0.09780309675113585,-0.11351609413713015
2025-09-10T09:50:00-04:00,498.12,499.4,497.75,498.83,NaN,NaN,NaN,500.35253275600974,NaN,NaN,498.7238000000005,499.5456334607231,497.9019665392779,499.7168595327724,499.37774256506356,500.69691035763515,498.05857477249197,51577,27733.9,52.31400558089797,45.238079302342086,NaN,NaN,NaN,NaN,1.1012622487079455,15.014347580728465,12293959,0.04138241802583406,-0.06178807160483757,-0.10317048963067163
2025-09-10T09:55:00-04:00,498.79,500.64,498.59,500.58,496.7379763524787,496.7379763524787,496.7379763524787,NaN,NaN,NaN,498.7522000000005,499.71791250229245,497.7864874977086,499.7168595327724,499.4492799326307,500.6952090117585,498.2033508535029,57958,29501.3,64.46126804347654,46.76436997779871,NaN,NaN,NaN,NaN,1.169029230943093,15.764771464923102,12351917,0.16792367619083357,0.10673410560787033,-0.06118957058296323
2025-09-10T10:00:00-04:00,500.52,501.64,500.43,501.25,498.12375015463874,NaN,NaN,NaN,NaN,NaN,498.80360000000053,499.99554637336894,497.6116536266321,499.7168595327724,499.6283018459095,500.91256183211215,498.34404185970686,54835,30993.033333333333,67.83909410608385,48.70362258809407,NaN,NaN,NaN,NaN,1.1719557144471564,17.01848209577072,12406752,0.28175013710326374,0.29099810079611643,0.009247963692852704
2025-09-10T10:05:00-04:00,501.26,501.82,500.47,500.47,498.18198878397334,NaN,NaN,NaN,NaN,NaN,498.8400000000005,500.1189448765258,497.56105512347517,499.7168595327724,499.7746417804605,501.0513872796607,498.49789628126035,64863,32863.4,60.61594294950025,50.26218322176011,NaN,NaN,NaN,NaN,1.1846731634152141,18.277370330934854,12341889,0.2884624601637065,0.3698260388974859,0.08136357873377935
2025-09-10T10:10:00-04:00,500.56,502.08,500.33,501.585,498.18198878397334,NaN,NaN,NaN,NaN,NaN,498.8997000000005,500.38954483656124,497.4098551634398,499.7168595327724,499.8544712157215,501.14459825947165,498.56434417197136,30940,33346.73333333333,66.16235072613881,52.33943874618355,NaN,NaN,NaN,NaN,1.225053651742699,19.586428639993187,12372829,0.34796285433562224,0.5163171466533072,0.16835429231768492
2025-09-10T10:15:00-04:00,501.51,502.61,501,501.57,498.6578968052319,NaN,NaN,NaN,NaN,NaN,498.96050000000054,500.6231355574756,497.29786444252545,499.7168595327724,500.0138008388921,501.3538344591221,498.67376721866214,56134,34785.433333333334,66.02763504186254,54.092004179879645,NaN,NaN,NaN,NaN,1.2525498194753644,21.081853428846124,12316695,0.3645236419784074,0.6240088447906942,0.25948520281228676
2025-09-10T10:20:00-04:00,501.57,502.35,501.32,502.18,498.69049240499413,NaN,NaN,NaN,NaN,NaN,499.0319000000005,500.9195841783324,497.14421582166864,498.5611633496511,500.1318794446389,501.5105968001535,498.7531620891243,42838,35741.53333333333,68.80901066346073,56.14556749988658,NaN,NaN,NaN,NaN,1.2366534037985546,22.470462161352422,12359533,0.39235778904395524,0.7499324391172308,0.3575746500732756
2025-09-10T10:25:00-04:00,502.18,502.45,501.48,501.48,498.83115184113075,NaN,NaN,NaN,NaN,NaN,499.09130000000056,501.0930250652501,497.089574934751,498.93393067972085,500.2189910038772,501.611761058313,498.8262209494414,38622,36523.86666666667,62.486719716302716,57.43591275510964,NaN,NaN,NaN,NaN,1.2176067320986557,23.816574975005388,12320911,0.34130334504334253,0.7842038313774538,0.4429004863341112
2025-09-10T10:30:00-04:00,501.49,502.07,501.44,501.93,498.83115184113075,NaN,NaN,NaN,NaN,NaN,499.1615000000005,501.30528100489823,497.01771899510277,498.9421445437767,500.28537253558,501.6855409376533,498.8852041335067,32195,37133.2,64.73024400937217,59.20451701624732,NaN,NaN,NaN,NaN,1.175634822663037,25.008846553504853,12353106,0.31609183283476294,0.8380152773775649,0.5219234445428019
2025-09-10T10:35:00-04:00,501.91,502.15,501.48,501.71,498.83115184113075,NaN,NaN,NaN,NaN,NaN,499.21890000000053,501.47587522291246,496.9619247770886,499.31271563502133,500.3402816332936,501.7429583874789,498.93760487910833,29491,37851.5,62.754258359385496,60.26652484722498,NaN,NaN,NaN,NaN,1.1395180496156745,26.167629450197232,12323615,0.2649215267590803,0.8530753529916524,0.5881538262325721
2025-09-10T10:40:00-04:00,501.69,502.78,500.99,502.7,498.83115184113075,NaN,NaN,NaN,NaN,NaN,499.2889000000005,501.7473045958758,496.83049540412526,499.6151725080171,500.44841438211716,501.8749805624838,499.0218482017505,50814,39158.26666666667,67.55416407854827,60.262206311547864,NaN,NaN,NaN,NaN,1.1859810460716953,27.636074141544142,12374429,0.27677874706398475,0.934127260062553,0.6573485129985682
2025-09-10T10:45:00-04:00,502.64,502.73,501.25,502.62,498.83115184113075,NaN,NaN,NaN,NaN,NaN,499.35370000000046,501.9831469451378,496.72425305486314,499.6151725080171,500.52026121570344,501.9598095032071,499.0807129281998,36509,39962.4,66.80495295146206,61.600046127064125,NaN,NaN,NaN,NaN,1.2069823999237184,28.99962992636627,12337920,0.2586030897406535,0.9806023751743851,0.7219992854337316
2025-09-10T10:50:00-04:00,502.64,502.91,501.3,501.42,498.8361377317034,NaN,NaN,NaN,NaN,NaN,499.3923000000005,502.0845319434046,496.70006805659636,499.6151725080171,500.5506936614471,501.9881071593145,499.1132801635797,20428,39773.666666666664,56.654955372858026,62.31188332377004,NaN,NaN,NaN,NaN,1.2357693713577393,30.380126858289604,12317492,0.15049101231690576,0.9101130508298638,0.7596220385129581
2025-09-10T10:55:00-04:00,501.39,501.42,499.66,499.73,498.8361377317034,NaN,NaN,NaN,NaN,NaN,499.4095000000005,502.0991522074477,496.7198477925533,499.6151725080171,500.5400685569403,501.9510316160398,499.1291054978408,35821,40487.96666666667,46.04467559787613,62.37566265694468,NaN,NaN,NaN,NaN,1.2732144162607573,29.24967183720584,12281671,-0.03993771185148465,0.7096998986986023,0.7496376105500869
2025-09-10T11:00:00-04:00,499.84,499.84,498.72,499.06,NaN,NaN,NaN,502.64026500065864,502.64026500065864,502.64026500065864,499.40330000000046,502.094716436947,496.7118835630539,499.6151725080171,500.4937570347733,501.9013362005147,499.08617786903187,34050,41274.2,42.63561844465018,61.68434929006984,NaN,NaN,NaN,NaN,1.2622705293849852,27.191672803547334,12247621,-0.2067932838536124,0.49114600573307143,0.6979392895866838
2025-09-10T11:05:00-04:00,499.11,499.96,498.53,499.02,NaN,NaN,NaN,502.64026500065864,NaN,NaN,499.40150000000045,502.0938188884733,496.7091811115276,499.6151725080171,500.45557535442987,501.86028801875716,499.0508626901026,29117,41896.76666666667,42.43362611309481,60.110946295042574,NaN,NaN,NaN,NaN,1.2742512058574869,25.405555083297156,12218504,-0.3094503640366145,0.31112633454091565,0.6205766985775302
2025-09-10T11:10:00-04:00,498.88,499.77,498.5,499.69,NaN,NaN,NaN,502.5560472423357,NaN,NaN,499.4149000000005,502.1061595484391,496.7236404515619,499.6151725080171,500.4313746602331,501.83068223460924,499.0320670858569,21982,42127.13333333333,46.965908331763195,58.62000445401967,NaN,NaN,NaN,NaN,1.2739475482962366,23.77791442889235,12240486,-0.3204717782173421,0.21998697580585258,0.5404587540231947
2025-09-10T11:15:00-04:00,499.65,500,499.48,499.69,NaN,NaN,NaN,502.5560472423357,NaN,NaN,499.43050000000045,502.1189131001687,496.7420868998322,499.6151725080171,500.4210069593378,501.8126331562194,499.0293807624561,15328,41982.7,46.965908331763195,57.64500198132417,NaN,NaN,NaN,NaN,1.220094151989361,22.15065324242697,12240486,-0.3155073862328347,0.14607452123215126,0.46158190746498595
2025-09-10T11:20:00-04:00,499.66,499.89,499.19,499.86,NaN,NaN,NaN,502.5560472423357,NaN,NaN,499.44810000000047,502.13600765413213,496.7601923458688,499.6151725080171,500.40605987077,501.7883013661986,499.02381837534136,20604,42234.03333333333,48.1667885036249,56.359604679716035,NaN,NaN,NaN,NaN,1.1829445697044059,20.82661171476057,12261090,-0.2892155342687803,0.10006248962901054,0.38927802389779087
2025-09-10T11:25:00-04:00,499.875,500.87,499.67,500.71,NaN,NaN,NaN,502.5560472423357,NaN,NaN,499.4871000000005,502.1904823919334,496.7837176080676,499.6151725080171,500.40634753825424,501.7697173573136,499.0429777191949,29756,42733.666666666664,53.799828265179094,55.48618990995293,NaN,NaN,NaN,NaN,1.184162814725519,20.135197683246876,12290846,-0.20687911379534646,0.13067913165360778,0.33755824544895424
2025-09-10T11:30:00-04:00,500.69,500.78,499.98,500.45,NaN,NaN,NaN,502.5560472423357,NaN,NaN,499.5211000000005,502.22930256940225,496.81289743059875,499.487510405131,500.4062991431836,501.7586798211559,499.0539184652113,17903,42599.76666666667,51.94040138030696,54.281289246870514,NaN,NaN,NaN,NaN,1.156722613673693,19.493170368269872,12272943,-0.16409734224960826,0.1324365676369439,0.29653390988655215
2025-09-10T11:35:00-04:00,500.39,500.7,500.14,500.29,NaN,NaN,NaN,502.5560472423357,NaN,NaN,499.5487000000005,502.2595550748638,496.83784492513723,499.487510405131,500.4058509843685,501.74797093338174,499.06373103535526,17123,42600.53333333333,50.77734825755596,53.44490557124575,NaN,NaN,NaN,NaN,1.114099569839858,18.8970021472198,12255820,-0.1415945720905854,0.11954069477332041,0.2611352668639058
2025-09-10T11:40:00-04:00,500.23,501.24,500.15,501.1,NaN,NaN,NaN,502.5560472423357,NaN,NaN,499.59270000000055,502.3312851888679,496.8541148111332,498.78328435973845,500.4130597308226,501.7448544977608,499.08126496388445,19575,42681.833333333336,56.13266564456584,52.830792830902446,NaN,NaN,NaN,NaN,1.1123781719941561,18.910101656012614,12275395,-0.07075606295248016,0.17269018817330561,0.24344625112578577
2025-09-10T11:45:00-04:00,501.15,501.46,500.41,501.46,NaN,NaN,NaN,502.5560472423357,NaN,NaN,499.6361000000005,502.42248280875737,496.84971719124366,498.9696274877908,500.4266361579766,501.74890830419946,499.1043640117537,22882,42782.53333333333,58.30395278060804,52.51291386098977,NaN,NaN,NaN,NaN,1.1079225882802846,19.140160256204506,12298277,-0.0018918020831934501,0.24108149852179395,0.2429733006049874
2025-09-10T11:50:00-04:00,501.41,501.55,500.97,501.275,NaN,NaN,NaN,502.5560472423357,NaN,NaN,499.6818000000005,502.49907865801816,496.8645213419829,499.26770199023264,500.4430240617377,501.75744302057694,499.1286051028984,23419,42011.566666666666,56.74944972434175,51.74114854997502,NaN,NaN,NaN,NaN,1.070213831974549,19.444653674825588,12274858,0.027348744890116322,0.2771592317176328,0.24981048682751647
2025-09-10T11:55:00-04:00,501.27,501.27,500.82,500.83,NaN,NaN,NaN,502.5560472423357,NaN,NaN,499.72430000000054,502.54546501411056,496.9031349858905,499.26770199023264,500.4481420223652,501.7572299791616,499.13905406556876,11675,40324.4,53.08318737307131,50.761022437232825,NaN,NaN,NaN,NaN,1.0262699868335086,19.476294675221947,12263183,0.013566151928043724,0.26676817673757114,0.2532020248095274
2025-09-10T12:00:00-04:00,500.81,500.84,500.35,500.4,NaN,NaN,NaN,502.5560472423357,NaN,NaN,499.7571000000005,502.5707816374788,496.9434183625222,499.26770199023264,500.448892931793,501.7519860829581,499.1457997806279,11200,35910.3,49.73927806783061,50.26704548687372,NaN,NaN,NaN,NaN,0.9879649877739689,18.754691832798898,12251983,-0.025533660398243313,0.22128494931172327,0.24681860970996658
2025-09-10T12:05:00-04:00,500.425,500.68,500.06,500.6,NaN,NaN,NaN,502.5560472423357,NaN,NaN,499.7971000000005,502.6006927587429,496.9935072412581,499.26770199023264,500.448865136971,501.74379823190117,499.1539320420408,15436,33558.23333333333,51.27665656844213,50.64075841334272,NaN,NaN,NaN,NaN,0.9616817743615428,17.654445607205858,12267419,-0.0381888139923755,0.1990825922194972,0.2372714062118727
2025-09-10T12:10:00-04:00,500.6,500.6,499.69,499.72,NaN,NaN,NaN,502.5560472423357,NaN,NaN,499.81930000000057,502.60244570886437,497.03615429113677,499.26770199023264,500.4384394239672,501.7199029114157,499.15697593651873,29625,32065.4,44.78543755429057,50.79431692117418,NaN,NaN,NaN,NaN,0.9579902190500057,16.67328469675221,12237794,-0.10244160063941612,0.10921940541260255,0.21166100605201868
2025-09-10T12:15:00-04:00,499.68,500.09,499.52,499.6,NaN,NaN,NaN,502.5560472423357,NaN,NaN,499.8419000000006,502.59908253960924,497.0847174603919,499.26770199023264,500.43072687030786,501.7072276599967,499.154226080619,14068,31225.6,43.96805184012792,50.903918758819394,NaN,NaN,NaN,NaN,0.9302766319750048,15.993026166299165,12223726,-0.1469316371920001,0.027996459562018572,0.17492809675401866
2025-09-10T12:20:00-04:00,499.59,499.74,499.1,499.46,NaN,NaN,NaN,502.23222421358145,NaN,NaN,499.86290000000054,502.59199002363204,497.13380997636904,499.26770199023264,500.4151459399531,501.6876619750592,499.142629904847,20314,30183.5,42.98242480696983,50.61938422133416,NaN,NaN,NaN,NaN,0.909542586833932,15.9060846652667,12203412,-0.17764398997507208,-0.04712689071482146,0.13051709926025062
2025-09-10T12:25:00-04:00,499.43,499.78,499.21,499.24,NaN,NaN,NaN,502.23222421358145,NaN,NaN,499.86830000000054,502.5913634287376,497.14523657126347,499.26770199023264,500.4075361667919,501.6782165696779,499.1368557639059,9920,28582.233333333334,41.41142933740071,50.222635721736836,NaN,NaN,NaN,NaN,0.885289544917222,15.75686783291013,12193492,-0.20281129172539472,-0.12299701539649277,0.07981427632890195
2025-09-10T12:30:00-04:00,499.22,499.59,499,499.59,NaN,NaN,NaN,502.01202660782934,NaN,NaN,499.8765000000006,502.5936862278336,497.1593137721676,499.26770199023264,500.3921397168818,501.6592211431073,499.1250582906563,20198,27427.666666666668,44.86405047927719,49.98672586285486,NaN,NaN,NaN,NaN,0.8641974345659901,15.89594224742168,12213690,-0.18634543503473974,-0.15311751746452273,0.03322791757021701
2025-09-10T12:35:00-04:00,499.59,499.78,499.11,499.32,NaN,NaN,NaN,502.01202660782934,NaN,NaN,499.8835000000006,502.5931016306287,497.17389836937247,499.26770199023264,500.3803312344264,501.64439575952207,499.1162667093308,16081,25801.6,42.77014465524169,49.1988913192879,NaN,NaN,NaN,NaN,0.850326189239845,15.671181300011902,12197609,-0.18379012124450023,-0.19650973398540827,-0.012719612740908048
2025-09-10T12:40:00-04:00,499.32,499.75,499.1,499.64,NaN,NaN,NaN,502.01202660782934,NaN,NaN,499.89950000000056,502.59366944470156,497.20533055529955,499.2166615921861,500.3712578093761,501.63196710203556,499.1105485167167,13970,25235.933333333334,45.987673479481614,48.77369646922896,NaN,NaN,NaN,NaN,0.8360171757227116,15.47730864866414,12211579,-0.1520163035079814,-0.20273999212588478,-0.0507236886179034
2025-09-10T12:45:00-04:00,499.6,499.76,499.16,499.19,NaN,NaN,NaN,502.01202660782934,NaN,NaN,499.9103000000005,502.5886303823562,497.23196961764484,498.9523292737489,500.36380578531674,501.6227595204597,499.1048520501738,10202,23704.866666666665,42.379381821106364,48.17384172376826,NaN,NaN,NaN,NaN,0.8191588060282298,15.27665526538365,12201377,-0.1523876548180768,-0.24120825714049943,-0.08882060232242261
2025-09-10T12:50:00-04:00,499.21,499.38,498.845,499.3,NaN,NaN,NaN,501.67947289169655,NaN,NaN,499.92970000000054,502.5758212438041,497.28357875619696,498.8598634189991,500.3555062616678,501.6139564523333,499.0970560710023,9637,22598.166666666668,43.54545014728592,47.274754902533985,NaN,NaN,NaN,NaN,0.7988617484547825,15.588192316427415,12211014,-0.13680229445380307,-0.25982347038967646,-0.12302117593587339
2025-09-10T12:55:00-04:00,499.37,499.61,499.35,499.49,NaN,NaN,NaN,501.67947289169655,NaN,NaN,499.9507000000005,502.5656806953445,497.3357193046565,498.6888907351993,500.3509919174956,501.6077403483247,499.0942434866665,7182,21550.166666666668,45.593508858924395,46.36686605098515,NaN,NaN,NaN,NaN,0.763943052136584,15.372849525246915,12218196,-0.10661537348206743,-0.25629039278845767,-0.14967501930639024
2025-09-10T13:00:00-04:00,499.51,500.28,499.49,500.16,NaN,NaN,NaN,501.67947289169655,NaN,NaN,499.98830000000055,502.5598120915072,497.4167879084939,498.759062949535,500.3453083271466,501.5933190072609,499.0972976470323,21393,21190.1,52.18139708570986,46.040576576797164,NaN,NaN,NaN,NaN,0.7658042626982539,14.633465542310779,12239589,-0.03798344884491717,-0.1971543303625367,-0.15917088151761954
2025-09-10T13:05:00-04:00,500.18,501.01,500.11,500.99,NaN,NaN,NaN,501.67947289169655,NaN,NaN,500.04510000000045,502.5768373396923,497.5133626603086,499.34325035962803,500.3487635354108,501.59123061261755,499.10629645820404,13730,20664.733333333334,58.831765701962865,46.45118931457513,NaN,NaN,NaN,NaN,0.7753896725055197,14.998254418865193,12253319,0.061444658561852494,-0.08236505831530394,-0.14380971687715643
2025-09-10T13:10:00-04:00,501.015,501.375,500.73,500.8,NaN,NaN,NaN,501.67947289169655,NaN,NaN,500.10050000000047,502.5739908524472,497.62700914755374,499.7191002877024,500.3538326580331,501.5924646275285,499.11520068853775,11736,19362.133333333335,56.8815595518807,46.961352277721566,NaN,NaN,NaN,NaN,0.7660761244694099,15.778526365740161,12241583,0.1097289691201571,-0.006648505476960054,-0.11637747459711716
2025-09-10T13:15:00-04:00,500.8,500.81,500.53,500.62,NaN,NaN,NaN,501.67947289169655,NaN,NaN,500.14850000000047,502.5666871303056,497.73031286969535,499.7191002877024,500.3555486694992,501.59083397741,499.12026336158846,8266,18420.7,55.020763239139235,47.228788468485654,NaN,NaN,NaN,NaN,0.7313564012930256,16.11204913740648,12233317,0.12381427740991885,0.038390372165281406,-0.08542390524463744
2025-09-10T13:20:00-04:00,500.68,500.79,500.1,500.15,NaN,NaN,NaN,501.67947289169655,NaN,NaN,500.1889000000005,502.5373363216961,497.8404636783049,499.7191002877024,500.3554553119594,501.5842318454065,499.1266787785123,15325,18250.6,50.38580740535709,47.62881488641898,NaN,NaN,NaN,NaN,0.7284023726292379,15.634952479183134,12217992,0.09693661819684282,0.03574686750141609,-0.06118975069542673
2025-09-10T13:25:00-04:00,500.15,500.22,499.51,499.72,NaN,NaN,NaN,501.67947289169655,NaN,NaN,500.2169000000005,502.50822790253375,497.9255720974673,499.7191002877024,500.3523762992462,501.578309680463,499.1264429180294,8380,17335.9,46.52432260989614,47.811405655688134,NaN,NaN,NaN,NaN,0.7270879174414377,14.774939897599214,12209612,0.048124904238210565,-0.001033620397663526,-0.04915852463587409
2025-09-10T13:30:00-04:00,499.715,500,499.59,499.99,NaN,NaN,NaN,501.67947289169655,NaN,NaN,500.2557000000005,502.4631066315499,498.0482933684511,499.7191002877024,500.34850925426616,501.57039227074875,499.12662623778357,11608,16587.833333333332,49.159073472505796,48.25259484608356,NaN,NaN,NaN,NaN,0.7044387804813369,13.976356786128436,12221220,0.03268681868250061,-0.008300001282748326,-0.04098681996524894
2025-09-10T13:35:00-04:00,499.96,500.5,499.96,500.28,NaN,NaN,NaN,501.67947289169655,NaN,NaN,500.29270000000054,502.4375918007044,498.14780819929666,499.7191002877024,500.3473807545209,501.562521945176,499.13223956386577,16561,16169.3,51.900297728508136,49.001799731162656,NaN,NaN,NaN,NaN,0.6926931533041001,13.496371930903702,12237781,0.04017782021490545,0.009235455303382878,-0.030942364911522573
2025-09-10T13:40:00-04:00,500.26,500.47,500.15,500.18,NaN,NaN,NaN,501.67947289169655,NaN,NaN,500.2951000000005,502.43921332648796,498.15098667351305,499.7191002877024,500.3468447191949,501.557961956965,499.1357274814248,9992,15769.633333333333,50.881523612154425,49.431619240653895,NaN,NaN,NaN,NaN,0.6660722137823821,13.050671708195024,12227789,0.036667176377009794,0.014891605559739673,-0.02177557081727012
2025-09-10T13:45:00-04:00,500.17,500.77,500.12,500.67,NaN,NaN,NaN,501.67947289169655,NaN,NaN,500.33980000000054,502.41914504995873,498.26045495004234,499.7191002877024,500.34836965706654,501.5542506141114,499.14248870002166,13368,15704.3,55.49181813475766,50.34031020347646,NaN,NaN,NaN,NaN,0.6649241985122103,13.086863026215415,12241157,0.06401379784978288,0.05824167649495848,-0.005772121354824401
2025-09-10T13:50:00-04:00,500.68,500.87,500.42,500.46,NaN,NaN,NaN,501.67947289169655,NaN,NaN,500.38340000000056,502.3778437211246,498.38895627887655,499.7191002877024,500.3501287651024,501.5516579175766,499.1485996126282,11450,15399.166666666666,53.18770940657739,50.8545984839833,NaN,NaN,NaN,NaN,0.6495724700470517,13.26746685797782,12229707,0.06444933526263491,0.07478954772346924,0.010340212460834327
2025-09-10T13:55:00-04:00,500.51,500.75,500.39,500.71,NaN,NaN,NaN,501.67947289169655,NaN,NaN,500.4354000000006,502.32274081622,498.54805918378116,499.7191002877024,500.3517313272129,501.54982013184645,499.1536425225794,9251,14715.666666666666,55.55371040597337,51.79562195433095,NaN,NaN,NaN,NaN,0.6288887221865489,13.372136270110389,12238958,0.07720392723450523,0.10684512150396586,0.029641194269460634
2025-09-10T14:00:00-04:00,500.74,500.89,500.62,500.74,NaN,NaN,NaN,501.67947289169655,NaN,NaN,500.4736000000006,502.3059362564007,498.6412637436005,499.7639292291356,500.3540507297785,501.54903009935674,499.1590713602003,9013,14419.333333333334,55.84213284786634,52.67395643294383,NaN,NaN,NaN,NaN,0.603253813458937,13.694330979224539,12247971,0.08279539775025892,0.1331354414572843,0.05034004370702537
2025-09-10T14:05:00-04:00,500.76,500.76,499.99,500.14,NaN,NaN,NaN,501.67947289169655,NaN,NaN,500.4648000000006,502.2992328378533,498.6303671621479,499.7639292291356,500.35359461115667,501.54382625252254,499.1633629697908,12400,14261.9,48.99429138039174,52.9168694701915,NaN,NaN,NaN,NaN,0.6151642553547259,12.717392928011565,12235571,0.043210212721759345,0.10435280960922455,0.061142596887465206
2025-09-10T14:10:00-04:00,500.16,500.82,500.1,500.62,NaN,NaN,NaN,501.67947289169655,NaN,NaN,500.4522000000006,502.2734942202286,498.63090577977255,499.7639292291356,500.35476100420397,501.54071720025934,499.1688048081486,11475,13991.9,53.8680922928925,53.03734769927598,NaN,NaN,NaN,NaN,0.6226525228293862,11.917334800524644,12247046,0.046208888133786846,0.11890370705469877,0.07269481892091192
2025-09-10T14:15:00-04:00,500.61,500.755,500.33,500.43,NaN,NaN,NaN,501.67947289169655,NaN,NaN,500.4514000000006,502.27269738281063,498.6301026171906,499.7639292291356,500.355794279687,501.53773042709264,499.1738581322814,10883,13591.933333333332,51.75976354779865,52.53220468826425,NaN,NaN,NaN,NaN,0.6085344854844309,11.174423682143932,12236163,0.03287795260222015,0.11379225967368711,0.08091430707146696
2025-09-10T14:20:00-04:00,500.38,501.23,500.36,501.21,NaN,NaN,NaN,501.67947289169655,NaN,NaN,500.44390000000067,502.24948388238334,498.638316117618,499.7639292291356,500.3718624503202,501.5411051858711,499.20261971476924,45285,14320.8,58.875684316590906,52.67464217145783,NaN,NaN,NaN,NaN,0.6272105936641148,11.352788793662718,12281448,0.07183896135592241,0.17071300876636997,0.09887404741044756
2025-09-10T14:25:00-04:00,501.23,501.33,500.58,501.1,NaN,NaN,NaN,501.67947289169655,NaN,NaN,500.43450000000064,502.2213321120306,498.64766788797067,499.7639292291356,500.3781295413959,501.5432383732278,499.213020709564,16316,14475.5,57.58559929553544,52.857844746914715,NaN,NaN,NaN,NaN,0.6359812655452494,11.686263694066271,12265132,0.08457169094322119,0.20458866108947404,0.12001697014625286
2025-09-10T14:30:00-04:00,501.09,501.2,500.75,501.2,NaN,NaN,NaN,501.67947289169655,NaN,NaN,500.4149000000006,502.1453247908149,498.6844752091863,499.7639292291356,500.3838915520554,501.5456466369982,499.2221364671126,14221,14576.2,58.47637752991009,53.43574261295421,NaN,NaN,NaN,NaN,0.6226968894348736,11.995918958726715,12279353,0.09340652596142712,0.23677512759803676,0.14336860163660964
2025-09-10T14:35:00-04:00,501.24,501.27,500.69,500.99,NaN,NaN,NaN,501.67947289169655,NaN,NaN,500.40510000000063,502.11673370978775,498.6934662902135,499.79519560307403,500.3868841964597,501.5465055744977,499.22726281842165,8320,14339,55.82489858579927,54.100069468375864,NaN,NaN,NaN,NaN,0.6196471116180957,12.413147280490211,12271033,0.0793387313775838,0.24254201585858937,0.16320328448100557
2025-09-10T14:40:00-04:00,501.07,501.25,500.92,500.96,NaN,NaN,NaN,501.67947289169655,NaN,NaN,500.38570000000055,502.0490676793515,498.7223323206496,499.90515648245923,500.39027929467585,501.5478561337205,499.2327024556312,8664,13640.3,55.43817267446525,54.54857655423011,NaN,NaN,NaN,NaN,0.5989580322168021,12.8005735792706,12262369,0.062959819764701,0.24190305918688182,0.17894323942218082
2025-09-10T14:45:00-04:00,501,501,500.57,500.7,NaN,NaN,NaN,501.67947289169655,NaN,NaN,500.36550000000057,501.98807850244077,498.74292149756036,499.90515648245923,500.39223307581955,501.5470276988613,499.2374384527778,8981,13470.733333333334,52.07141772262,54.56079941095238,NaN,NaN,NaN,NaN,0.5868896013441738,12.222620528064239,12253388,0.031169393540609214,0.21790498134794234,0.18673558780733313
2025-09-10T14:50:00-04:00,500.68,500.73,500.47,500.675,NaN,NaN,NaN,501.67947289169655,NaN,NaN,500.32500000000056,501.8075221740917,498.84247782590944,499.90515648245923,500.3940500322151,501.54451110437077,499.2435889600594,13250,13235.266666666666,51.74600779789719,54.62254828136258,NaN,NaN,NaN,NaN,0.5635403441053036,11.438065848986705,12240138,0.006311944847039536,0.19462551886613255,0.18831357401909302
2025-09-10T14:55:00-04:00,500.63,501.63,500.63,501.58,NaN,NaN,NaN,501.67947289169655,NaN,NaN,500.30420000000055,501.68288830295626,498.92551169704484,500.19984011901914,500.40217546578543,501.55045871969105,499.2538922118798,15712,13428.333333333334,61.19896963580688,55.03020196000896,NaN,NaN,NaN,NaN,0.5947160338120676,12.424683571869528,12255850,0.04643906184238461,0.24636240132207377,0.19992333947968915
2025-09-10T15:00:00-04:00,501.61,501.88,501.11,501.11,499.52991008169016,499.52991008169016,499.52991008169016,NaN,NaN,NaN,500.2980000000006,501.6592391400113,498.93676085998993,500.3508720952153,500.40802030742014,501.55526356558556,499.2607770492547,10445,13103.233333333334,55.15586245550148,55.1707843206464,NaN,NaN,NaN,NaN,0.6072363171112044,13.702829688911008,12245405,0.03733858410661789,0.2465965696129615,0.2092579855063436
2025-09-10T15:05:00-04:00,501.15,501.2,500.525,500.64,499.52991008169016,NaN,NaN,NaN,NaN,NaN,500.3162000000006,501.67089341046886,498.96150658953235,500.3508720952153,500.40997642136983,501.5545888393887,499.26536400335095,8911,12864.233333333334,49.85430429496704,54.76368388414594,NaN,NaN,NaN,NaN,0.6120765801746906,13.531345726998662,12236494,-0.00222483641488469,0.20647693998773775,0.20870177640262244
2025-09-10T15:10:00-04:00,500.63,500.63,499.5,499.69,NaN,NaN,NaN,502.09882159912115,502.09882159912115,502.09882159912115,500.32880000000057,501.64777165884436,499.0098283411568,500.3508720952153,500.4054721580364,501.54550628562106,499.2654380304517,16765,12957.4,41.22816796296982,53.719829249510475,NaN,NaN,NaN,NaN,0.6497853958764974,13.473965774766885,12219729,-0.08943526721027606,0.09690769238977737,0.18634295960005343
2025-09-10T15:15:00-04:00,499.73,500.005,499.47,500,NaN,NaN,NaN,501.75182970825205,NaN,NaN,500.34840000000054,501.61716386952554,499.07963613047554,500.3508720952153,500.39884783145567,501.53403384830546,499.2636618146059,20193,13290.433333333332,44.5969294565409,53.40573196923542,NaN,NaN,NaN,NaN,0.6415864390281739,13.462818660964453,12239922,-0.12132410860355022,0.03468782384561564,0.15601193244916586
2025-09-10T15:20:00-04:00,499.97,499.97,499.08,499.34,NaN,NaN,NaN,501.5732238124224,NaN,NaN,500.3414000000005,501.62834838947475,499.0544516105262,500.3508720952153,500.39279763766353,501.5267891476831,499.258806127644,11518,13353.133333333333,39.41670816577331,52.37349024586975,NaN,NaN,NaN,NaN,0.6614731219547341,13.98771177028724,12228404,-0.1784933954754973,-0.06710481189520578,0.11138858358029152
2025-09-10T15:25:00-04:00,499.34,499.44,499.11,499.4,NaN,NaN,NaN,501.2751227300395,NaN,NaN,500.33560000000057,501.63677429909114,499.03442570091,500.3508720952153,500.38148743296347,501.5148297506221,499.24814511530485,18917,13744.3,40.09791235612583,51.54050087503599,NaN,NaN,NaN,NaN,0.6377964703865376,14.4751125146584,12247321,-0.20215552682172847,-0.14130582494686905,0.060849701874859406
2025-09-10T15:30:00-04:00,499.4,500,499.38,499.75,NaN,NaN,NaN,501.2751227300395,NaN,NaN,500.33340000000055,501.63815045762755,499.02864954237356,500.3508720952153,500.36926719585216,501.49583079661704,499.2427035950873,33363,14143.3,44.049995278408595,50.48152308659439,NaN,NaN,NaN,NaN,0.6365252939303566,13.84174393349503,12280684,-0.18460773835639774,-0.16990997107063777,0.014697767285759965
2025-09-10T15:35:00-04:00,499.79,500.09,499.38,499.45,NaN,NaN,NaN,501.2751227300395,NaN,NaN,500.3082000000005,501.63142297319894,498.9849770268021,500.3508720952153,500.3638816867146,501.4880131749276,499.2397501985016,13639,14140.266666666666,41.52131960026743,49.33407453693239,NaN,NaN,NaN,NaN,0.6417734872210439,13.092817355794734,12267045,-0.183210977693062,-0.21431595483056753,-0.03110497713750554
2025-09-10T15:40:00-04:00,499.44,500.39,499.3,500.38,NaN,NaN,NaN,501.2751227300395,NaN,NaN,500.3068000000005,501.6295679451931,498.9840320548079,500.3508720952153,500.3576287257326,501.4723300749991,499.24292737646607,34546,14900.6,50.926019253236014,48.79476323145566,NaN,NaN,NaN,NaN,0.6737896667052532,12.442612802235232,12301591,-0.11309728748704839,-0.17247658649631603,-0.05937929900926764
2025-09-10T15:45:00-04:00,500.37,500.54,500.13,500.26,NaN,NaN,NaN,501.2751227300395,NaN,NaN,500.30620000000056,501.6290250967914,498.9833749032097,500.3508720952153,500.35683647656066,501.4622448445903,499.251428108531,31825,15685.9,49.81282358586786,48.36532930288913,NaN,NaN,NaN,NaN,0.6549475476548797,12.09165663898449,12269766,-0.07033940802288985,-0.14730355903787995,-0.0769641510149901
2025-09-10T15:50:00-04:00,500.29,500.6,500.1,500.19,NaN,NaN,NaN,501.2751227300395,NaN,NaN,500.28800000000047,501.5915382606957,498.98446173930523,499.6391976761722,500.3555128227409,501.4487304629009,499.26229518258083,43036,16609.6,49.13806057694888,47.91532129592368,NaN,NaN,NaN,NaN,0.6438798656795311,11.869015483612364,12226730,-0.04361785852719394,-0.13148647417398251,-0.08786861564678858
2025-09-10T15:55:00-04:00,500.19,500.47,500.09,500.2,NaN,NaN,NaN,501.2751227300395,NaN,NaN,500.2628000000005,501.5227224726677,499.0028775273333,498.994075416831,500.35222043279106,501.42783258934145,499.27660827624067,65134,18501.4,49.243836187292956,47.71335118625747,NaN,NaN,NaN,NaN,0.6250313038452827,11.640499468204373,12291864,-0.023143530732223222,-0.1167980290620676,-0.09365449832984438
2025-09-11T09:30:00-04:00,502.17,502.8,500.3,500.82,499.3269435027489,499.3269435027489,499.3269435027489,NaN,NaN,NaN,500.25370000000044,501.49061035941537,499.0167896405855,500.31926033346474,501.3066666666666,501.30667429606115,501.3066590372721,45958,19646.4,55.43237961356466,47.97666345880515,NaN,NaN,NaN,NaN,0.7661004964277642,14.119070445410076,12337822,0.031323385151020816,-0.05450026689106835,-0.08582365204208917
2025-09-11T09:35:00-04:00,500.77,501.16,499.05,499.28,NaN,NaN,NaN,502.51473574737605,502.51473574737605,502.51473574737605,500.2227000000005,501.47784175975477,498.9675582402462,500.31926033346474,500.5774985589297,501.3157750042751,499.83922211358424,44831,20588.733333333334,41.79957445976744,46.59099237480233,NaN,NaN,NaN,NaN,0.8620933181114963,14.409018021487299,12292991,-0.033676595207741425,-0.12791939605176594,-0.09424280084402452
2025-09-11T09:40:00-04:00,499.28,499.63,497.88,498.53,NaN,NaN,NaN,501.29383866794984,NaN,NaN,500.18530000000044,501.52563191312686,498.844968086874,500.31926033346474,499.91486274284915,500.9979028033064,498.83182268239193,48718,21879.6,37.02395473425054,45.29585610899869,NaN,NaN,NaN,NaN,0.9255152239606751,13.452780658616625,12244273,-0.11965599510636254,-0.2438127947269777,-0.12415679962061515
2025-09-11T09:45:00-04:00,498.6,499.6,498.55,499.37,NaN,NaN,NaN,501.29383866794984,NaN,NaN,500.1607000000004,501.51476352781,498.80663647219086,500.31926033346474,499.76434291035605,500.77619130820335,498.75249451250875,35530,22618.333333333332,44.65121667695962,44.92420699342674,NaN,NaN,NaN,NaN,0.9358355651063447,12.564845964522428,12279803,-0.11253490082989903,-0.26482542565798894,-0.1522905248280899
2025-09-11T09:50:00-04:00,499.36,500.09,499,499.63,NaN,NaN,NaN,501.29383866794984,NaN,NaN,500.1589000000004,501.51553891932997,498.80226108067086,500.31926033346474,499.7412214505823,500.69189744451074,498.7905454566539,24106,23040.2,46.79900642717326,45.32212402658413,NaN,NaN,NaN,NaN,0.9468473104558897,12.122148149658035,12303909,-0.08419127520157818,-0.25752961883006265,-0.17333834362848446
2025-09-11T09:55:00-04:00,499.68,500.45,499.38,500.28,NaN,NaN,NaN,501.29383866794984,NaN,NaN,500.1725000000004,501.5200581610273,498.82494183897353,500.31926033346474,499.7720789262243,500.6762661106965,498.86789174175215,23225,23506,51.83137695843684,45.838870276719554,NaN,NaN,NaN,NaN,0.9556439311376114,12.076933517749488,12327134,-0.01895081992646694,-0.19702686853656814,-0.1780760486101012
2025-09-11T10:00:00-04:00,500.26,500.93,499.85,500.88,NaN,NaN,NaN,501.29383866794984,NaN,NaN,500.2009000000004,501.54704960443377,498.854750395567,500.31926033346474,499.881445599542,500.76268808891064,499.0002031101734,36196,24412.1,55.97146589519607,47.02135297167832,NaN,NaN,NaN,NaN,0.9645265074849237,12.495383939401213,12363330,0.0628481504516625,-0.09951586054552308,-0.1623640109971856
2025-09-11T10:05:00-04:00,500.89,501.28,500.19,501.01,NaN,NaN,NaN,501.29383866794984,NaN,NaN,500.2363000000004,501.57256765177027,498.9000323482306,500.31926033346474,499.95184379671946,500.83520981042267,499.06847778301625,20807,24692.333333333332,56.837097033181145,48.21700902003942,NaN,NaN,NaN,NaN,0.9734888998074274,13.201038881818688,12384137,0.1206000944689592,-0.011613892910986578,-0.13221398737994577
2025-09-11T10:10:00-04:00,501.07,501.66,500.71,501.5,498.4929529964599,498.4929529964599,498.4929529964599,NaN,NaN,NaN,500.2745000000005,501.64348246778,498.905517532221,500.31926033346474,500.0405947654314,500.95681907918595,499.1243704516769,19845,24971.333333333332,60.027172277897684,49.358235948574354,NaN,NaN,NaN,NaN,0.9718111212497573,14.186127468601512,12403982,0.1829518628598214,0.09647584119483099,-0.08647602166499041
2025-09-11T10:15:00-04:00,501.48,501.5,500.9,501.01,498.5485005875299,NaN,NaN,NaN,NaN,NaN,500.30830000000043,501.66474182967943,498.95185817032143,500.31926033346474,500.11228082230997,501.03856251318905,499.1859991314309,20939,25306.533333333333,55.60166781398382,50.36397510669695,NaN,NaN,NaN,NaN,0.9452531840176334,15.100852584899846,12383043,0.18195983448001515,0.14097377143502854,-0.040986063044986615
2025-09-11T10:20:00-04:00,501.05,501.9,500.94,501.83,498.7581141971876,NaN,NaN,NaN,NaN,NaN,500.3521000000005,501.75985578739045,498.9443442126106,499.3906333515185,500.2166005077113,501.1839808903761,499.24922012504646,24923,24627.8,60.808877391185526,51.06989354512192,NaN,NaN,NaN,NaN,0.9463065280163724,16.303312578067093,12407966,0.22450356155625595,0.23964338890033332,0.01513982734407738
2025-09-11T10:25:00-04:00,501.87,502.44,501.69,502.33,499.42183627913363,NaN,NaN,NaN,NaN,NaN,500.4149000000005,501.88830760045084,498.94149239955016,500.0575066812148,500.33392824636815,501.3792028506824,499.2886536420539,22253,24825.7,63.61137278960899,52.055504202532,NaN,NaN,NaN,NaN,0.9322846331580601,17.855556686844917,12430219,0.27117110280021983,0.35410370584435213,0.08293260304413233
2025-09-11T10:30:00-04:00,502.26,503.18,501.87,503.09,499.8233437209912,NaN,NaN,NaN,NaN,NaN,500.49070000000046,502.10965028870476,498.87174971129616,500.61900534497187,500.4436757441276,501.58002660859864,499.3073248796565,17762,24943.733333333334,67.42446283822194,53.36167579262293,NaN,NaN,NaN,NaN,0.9592643022181988,19.813900625256988,12447981,0.33395152004354367,0.5003720030985619,0.16642048305501825
2025-09-11T10:35:00-04:00,503.1,503.12,502.43,502.88,500.102055370037,NaN,NaN,NaN,NaN,NaN,500.5585000000005,502.28453620968935,498.83246379031164,500.72620427597747,500.5126395699347,501.70095551248227,499.3243236273872,11560,25051.733333333334,65.38561876285269,54.51466026230577,NaN,NaN,NaN,NaN,0.9400311377740416,21.632362853782485,12436421,0.34087584562460227,0.5925152900857711,0.2516394444611688
2025-09-11T10:40:00-04:00,502.85,503.14,502.6,502.8,500.2449164895808,NaN,NaN,NaN,NaN,NaN,500.6113000000005,502.4435912533502,498.7790087466508,500.954963420782,500.60422480479326,501.85404877150023,499.3544008380863,16200,25302.933333333334,64.58440289332098,55.16837621085979,NaN,NaN,NaN,NaN,0.9114574850758931,23.33519454008241,12420221,0.319947041767256,0.6515732466702389,0.33162620490298284
2025-09-11T10:45:00-04:00,502.83,502.93,501.7,501.73,500.2449164895808,NaN,NaN,NaN,NaN,NaN,500.6261000000005,502.48218759413726,498.7700124058638,500.954963420782,500.6361022269014,501.89169450648694,499.3805099473159,8869,25299.2,54.89534980202204,56.103788735306544,NaN,NaN,NaN,NaN,0.9342105218561877,23.355464839094655,12411352,0.21874884725776178,0.605062263975185,0.38631341671742325
2025-09-11T10:50:00-04:00,501.81,501.93,500.57,500.69,500.2449164895808,NaN,NaN,NaN,NaN,NaN,500.6239000000005,502.4794185682114,498.76838143178963,500.954963420782,500.6496081722691,501.8874538253369,499.4117625192013,13767,25316.433333333334,47.444974512003434,56.84814729086032,NaN,NaN,NaN,NaN,0.9646240560093181,21.88355052004514,12397585,0.07396028738562943,0.47876377594946007,0.40480348856383064
2025-09-11T10:55:00-04:00,500.69,500.94,500.22,500.83,NaN,NaN,NaN,503.29117471731706,503.29117471731706,503.29117471731706,500.6281000000006,502.4845147049653,498.77168529503587,500.954963420782,500.6500600542583,501.8673604491066,499.43275965940995,14826,25286.9,48.459059403683504,57.120136057054886,NaN,NaN,NaN,NaN,0.9471509091515076,20.515373530302835,12412411,-0.015423540600592478,0.38552406281309004,0.4009476034136825
2025-09-11T11:00:00-04:00,500.83,501.57,500.81,501.11,NaN,NaN,NaN,503.29117471731706,NaN,NaN,500.64730000000054,502.50339612816225,498.79120387183883,500.954963420782,500.66082408436074,501.86753594512595,499.45411222359553,9646,25260.266666666666,50.515626197862794,57.38560889781843,NaN,NaN,NaN,NaN,0.9337829870692563,19.54234094619744,12422057,-0.05642548174260931,0.3304157512354209,0.3868412329780302
2025-09-11T11:05:00-04:00,501.18,501.96,501.09,501.65,NaN,NaN,NaN,503.29117471731706,NaN,NaN,500.6859000000006,502.54352610792495,498.8282738920762,500.954963420782,500.67679857103593,501.8787509451964,499.4748461968755,8257,25238.466666666667,54.302681183226206,57.562130628160524,NaN,NaN,NaN,NaN,0.9292270594214527,19.029678155994116,12430314,-0.04823200633721997,0.32655122505650525,0.3747832313937252
2025-09-11T11:10:00-04:00,501.68,501.96,501.64,501.84,NaN,NaN,NaN,503.29117471731706,NaN,NaN,500.7229000000006,502.59722984201176,498.84857015798946,500.954963420782,500.69726460628124,501.8978960696323,499.4966331429302,8586,24965.833333333332,55.59049761839443,57.534918608388985,NaN,NaN,NaN,NaN,0.8857108408913484,18.553634136519594,12438900,-0.03185956427077258,0.3349587760552595,0.36681834032603206
2025-09-11T11:15:00-04:00,501.87,502.62,501.8,502.58,NaN,NaN,NaN,503.29117471731706,NaN,NaN,500.7689000000006,502.70922501313163,498.82857498686957,500.954963420782,500.74056756239867,501.95396518236,499.52716994243735,12963,24724.833333333332,60.2849134727957,57.78119121121859,NaN,NaN,NaN,NaN,0.8810172093991088,18.758975825943644,12451863,0.02395335466983578,0.3967600336633268,0.372806678993491
2025-09-11T11:20:00-04:00,502.58,502.67,502.18,502.31,NaN,NaN,NaN,503.29117471731706,NaN,NaN,500.81150000000054,502.79136287327583,498.83163712672524,500.954963420782,500.7710965715606,501.99353234857165,499.5486607945495,9255,24649.4,57.880789674718905,57.627878168134394,NaN,NaN,NaN,NaN,0.8530874087277445,18.996608393894764,12442608,0.0370505599924687,0.4191198789840769,0.3820693189916082
2025-09-11T11:25:00-04:00,502.29,502.82,502.16,502.69,NaN,NaN,NaN,503.29117471731706,NaN,NaN,500.8519000000005,502.89983250793085,498.80396749207017,501.01355690034046,500.8106752963091,502.04774028311635,499.5736103095019,11312,24395.9,60.281530128599805,57.96215404774983,NaN,NaN,NaN,NaN,0.8392954509614748,19.363749043516336,12453920,0.0640848421757394,0.4621753717112824,0.398090529535543
2025-09-11T11:30:00-04:00,502.71,502.97,502.68,502.73,NaN,NaN,NaN,503.29117471731706,NaN,NaN,500.89730000000054,503.00814742151,498.7864525784911,501.3798455202724,500.8526204980269,502.1093454670993,499.59589552895454,11030,23651.466666666667,60.53651913575961,57.94269988664797,NaN,NaN,NaN,NaN,0.8000600616070852,19.854029215588557,12464950,0.0765933643688479,0.4938322349966029,0.417238870627755
2025-09-11T11:35:00-04:00,502.73,502.83,502.1,502.17,NaN,NaN,NaN,503.29117471731706,NaN,NaN,500.92650000000054,503.0663693878285,498.7866306121726,501.3798455202724,500.8758619582543,502.1367196417537,499.6150042747549,8128,23467.766666666666,55.19414075152225,57.34146902678464,NaN,NaN,NaN,NaN,0.7950557714922907,19.380963874219287,12456822,0.04087653414687864,0.4683345383113533,0.42745800416447466
2025-09-11T11:40:00-04:00,502.14,502.56,501.96,501.96,NaN,NaN,NaN,503.29117471731706,NaN,NaN,500.9509000000005,503.10944737197815,498.79235262802285,501.3798455202724,500.8887237706343,502.14975116870266,499.6276963725659,5357,22494.8,53.294736230339225,56.3322028405073,NaN,NaN,NaN,NaN,0.7811232163857001,18.73086232175299,12451465,-0.0009516609826363265,0.42626842793617925,0.4272200889188156
2025-09-11T11:45:00-04:00,501.95,501.97,500.88,501.04,NaN,NaN,NaN,503.29117471731706,NaN,NaN,500.96890000000053,503.1150736082716,498.8227263917295,501.3798455202724,500.8947171397482,502.14740886405843,499.64202541543796,7975,21699.8,45.85047586845936,54.936835490907775,NaN,NaN,NaN,NaN,0.8031858437867239,18.060868893339048,12443490,-0.08972601041554074,0.3150625758993897,0.4047885863149304
2025-09-11T11:50:00-04:00,500.99,501.85,500.93,501.84,NaN,NaN,NaN,503.29117471731706,NaN,NaN,500.99330000000054,503.1507629630199,498.8358370369812,501.3798455202724,500.9043659841084,502.15012080205787,499.6586111661589,8240,20539.933333333334,52.11417710797512,54.04610507766879,NaN,NaN,NaN,NaN,0.8115297120876733,17.43873213838324,12451730,-0.09330071628393855,0.28816269096000724,0.3814634072439458
2025-09-11T11:55:00-04:00,501.89,502.14,501.77,502.01,NaN,NaN,NaN,503.29117471731706,NaN,NaN,501.0249000000005,503.19468385028847,498.85511614971256,501.3798455202724,500.90997738152834,502.15485708117103,499.66509768188564,2908,18465.733333333334,53.34910053656472,53.93565870156469,NaN,NaN,NaN,NaN,0.7799918755099827,16.45078881059578,12454638,-0.08327902116886071,0.2773646307828699,0.3606436519517306
2025-09-11T12:00:00-04:00,501.97,502.8,501.8,502.76,NaN,NaN,NaN,503.29117471731706,NaN,NaN,501.0559000000005,503.2790110536629,498.83278894633816,501.3798455202724,500.93167989326184,502.1810625764215,499.6822972101022,7901,17197.166666666668,58.44116053080391,54.721100560050445,NaN,NaN,NaN,NaN,0.7957067415449839,15.862071679079365,12462539,-0.028056664392281883,0.3255728214613782,0.3536294858536601
2025-09-11T12:05:00-04:00,502.78,502.93,502.66,502.89,NaN,NaN,NaN,503.29117471731706,NaN,NaN,501.09170000000057,503.3733779870586,498.81002201294257,501.3798455202724,500.95122956922023,502.2088136123876,499.6936455260529,5857,15898.033333333333,59.2710185813671,55.49338335845641,NaN,NaN,NaN,NaN,0.7581562600060552,15.470275025433692,12468396,0.013098739485041533,0.370002910209962,0.3569041707249205
2025-09-11T12:10:00-04:00,502.88,502.91,502.39,502.455,NaN,NaN,NaN,503.29117471731706,NaN,NaN,501.1168000000005,503.43008403722354,498.8035159627775,501.3798455202724,500.9678474474224,502.22971308228205,499.70598181256275,5834,14468.566666666668,55.292364766504,55.834578970502214,NaN,NaN,NaN,NaN,0.7411450985770539,14.710834770615614,12462562,0.007192980796079995,0.36589539672002047,0.3587024159239405
2025-09-11T12:15:00-04:00,502.49,502.8,502.41,502.77,NaN,NaN,NaN,503.29117471731706,NaN,NaN,501.1524000000005,503.5111227384646,498.7936772615364,501.3798455202724,500.9787312387872,502.24378534035196,499.7136771372224,3713,13408,57.51629970840588,56.06412315087219,NaN,NaN,NaN,NaN,0.716063305821549,14.005640248284543,12466275,0.0199466403710426,0.38363571638774374,0.36368907601670114
2025-09-11T12:20:00-04:00,502.78,503.15,502.42,502.47,NaN,NaN,NaN,503.29117471731706,NaN,NaN,501.18260000000043,503.56919777864965,498.7960022213512,501.62311552012955,501.0290621126644,502.30816703943765,499.74995718589116,17599,13191.1,54.72429626709079,56.002251625779074,NaN,NaN,NaN,NaN,0.7170587839771498,13.827642571012738,12448676,0.004433768235478086,0.36923128631104873,0.36479751807557065
2025-09-11T12:25:00-04:00,502.49,502.64,501.95,502.31,NaN,NaN,NaN,503.29117471731706,NaN,NaN,501.21480000000054,503.6178713340784,498.81172866592266,501.62311552012955,501.0418932466696,502.3208516187465,499.7629348745927,6067,12619.166666666666,53.23991396589386,55.499037375286086,NaN,NaN,NaN,NaN,0.7151260136930676,12.928731330326931,12442609,-0.019058440491592,0.3409744674610806,0.3600329079526726
2025-09-11T12:30:00-04:00,502.38,502.56,502.09,502.37,NaN,NaN,NaN,503.29117471731706,NaN,NaN,501.24870000000044,503.6681220874163,498.8292779125846,501.62311552012955,501.0594875793391,502.33858640011897,499.7803887585592,8257,11687.866666666667,53.74658414556616,55.203736980346605,NaN,NaN,NaN,NaN,0.6976170127149933,12.094028035404394,12450866,-0.032237118327362535,0.3197365100434695,0.351973628370832
2025-09-11T12:35:00-04:00,502.4,502.49,502,502.32,NaN,NaN,NaN,503.29117471731706,NaN,NaN,501.2635000000004,503.69984172420897,498.8271582757919,501.62311552012955,501.07343312239715,502.3516866860837,499.7951795587106,7100,11230.966666666667,53.22897542225137,54.699983072750285,NaN,NaN,NaN,NaN,0.6827872260924944,11.286346129137822,12443766,-0.045207094844263995,0.295464759815502,0.340671854659766
2025-09-11T12:40:00-04:00,502.29,502.545,502.2,502.5,NaN,NaN,NaN,503.29117471731706,NaN,NaN,501.2913000000005,503.75160470405655,498.83099529594443,501.62311552012955,501.08579560751434,502.3645871554058,499.8070040596229,5732,10760.533333333333,54.91240507500248,54.298260639839064,NaN,NaN,NaN,NaN,0.6586595670858896,10.517732356961162,12449498,-0.042585255025180735,0.28744028587829007,0.3300255409034708
2025-09-11T12:45:00-04:00,502.57,502.7,502.18,502.27,NaN,NaN,NaN,503.29117471731706,NaN,NaN,501.3239000000005,503.792004770262,498.855795229739,501.62311552012955,501.09623464104095,502.37513549966883,499.8173337824131,5045,10230.733333333334,52.32100662733395,54.09303677382561,NaN,NaN,NaN,NaN,0.648755312294039,10.074113447909774,12444453,-0.05639638972097061,0.2595300537522576,0.3159264434732282
2025-09-11T12:50:00-04:00,502.22,502.24,500.83,501.2,NaN,NaN,NaN,503.29117471731706,NaN,NaN,501.35410000000047,503.7780535385258,498.93014646147515,501.62311552012955,501.1035210790337,502.36901837878065,499.8380237792868,14287,9876.2,42.316156851494604,53.30885253247957,NaN,NaN,NaN,NaN,0.7052727899873218,11.005140939685276,12430166,-0.1332616908073626,0.14934932996402495,0.28261102077138756
2025-09-11T12:55:00-04:00,501.26,501.46,501,501.12,NaN,NaN,NaN,503.29117471731706,NaN,NaN,501.3765000000005,503.7705010436214,498.9824989563796,501.62311552012955,501.10490724337785,502.3606495170445,499.8491649697112,10054,9469.566666666668,41.67451027885566,53.0105692760793,NaN,NaN,NaN,NaN,0.6877533049882258,11.869666467762528,12420112,-0.18213549819945749,0.05494164802206569,0.23707714622152318
2025-09-11T13:00:00-04:00,501.16,501.37,500.6,500.67,NaN,NaN,NaN,503.15850978666634,NaN,NaN,501.4031000000004,503.7347422446824,499.07145775531836,501.62311552012955,501.0993206798491,502.3398628681177,499.8587784915805,16593,9430.6,38.16858296798623,52.01445540893724,NaN,NaN,NaN,NaN,0.6936280689176371,13.127402880248102,12403519,-0.23410014585557526,-0.055548036097945896,0.17855210975762936
2025-09-11T13:05:00-04:00,500.75,501.02,500.25,500.98,NaN,NaN,NaN,502.8147138872724,NaN,NaN,501.4347000000005,503.698742763961,499.17065723604,501.62311552012955,501.09194693070896,502.3203528214999,499.863541039918,14405,9525.433333333332,41.8008904542832,51.18958326020284,NaN,NaN,NaN,NaN,0.6990832068520902,14.660032059687097,12417924,-0.23624301352457228,-0.116751657148086,0.11949135637648628
2025-09-11T13:10:00-04:00,501.01,501.37,500.87,500.92,NaN,NaN,NaN,502.8147138872724,NaN,NaN,501.4581000000005,503.67571934445573,499.2404806555453,501.38323849363604,501.0912485383398,502.3085057141911,499.87399136248854,12570,9404.433333333332,41.2952431759357,49.964874877712255,NaN,NaN,NaN,NaN,0.6848629777912266,15.387814875948793,12405354,-0.23012031203951486,-0.1681590336729073,0.06196127836660756
2025-09-11T13:15:00-04:00,500.97,501.2,500.65,500.82,NaN,NaN,NaN,502.8147138872724,NaN,NaN,501.48550000000046,503.63603690901465,499.33496309098626,501.38323849363604,501.08883217804515,502.2989581043371,499.8787062517532,8446,9390.333333333334,40.41770261783022,48.61820945174534,NaN,NaN,NaN,NaN,0.675229907948997,16.31418749522639,12396908,-0.2211660898814538,-0.21449633398520973,0.006669755896244092
2025-09-11T13:20:00-04:00,500.81,501.015,500.51,500.51,NaN,NaN,NaN,502.8147138872724,NaN,NaN,501.48810000000043,503.6335928471517,499.34260715284915,501.38323849363604,501.08292859985204,502.28531498503247,499.8805422146716,10264,9273.566666666668,37.740269999541525,47.3644883969623,NaN,NaN,NaN,NaN,0.6630706288097825,17.33302221994619,12386644,-0.22380414768852308,-0.2730854287144098,-0.04928128102588668
2025-09-11T13:25:00-04:00,500.54,500.74,500.08,500.08,NaN,NaN,NaN,502.50298475390434,NaN,NaN,501.4845000000004,503.6388094014232,499.33019059857764,501.38323849363604,501.0737770118413,502.2720738253523,499.87548019833025,8441,9060.733333333334,34.34195675639681,45.70917818610451,NaN,NaN,NaN,NaN,0.6628512981805141,18.740238092137695,12378203,-0.24071775538315948,-0.35017847525483603,-0.10946071987167655
2025-09-11T13:30:00-04:00,500.2,500.765,500.19,500.56,NaN,NaN,NaN,502.50298475390434,NaN,NaN,501.49190000000044,503.63085945659515,499.35294054340574,501.38323849363604,501.0660489028582,502.25799729820193,499.87410050751447,9947,9070.766666666666,40.755045378114794,44.71137455117765,NaN,NaN,NaN,NaN,0.6644333483104775,19.990273884415842,12388150,-0.20706964338936645,-0.3682977741083846,-0.16122813071901815
2025-09-11T13:35:00-04:00,500.62,500.69,500.15,500.28,NaN,NaN,NaN,502.48983734808223,NaN,NaN,501.49350000000044,503.62870795170613,499.35829204829474,500.4665907949088,501.0598689160126,502.24827489524836,499.8714629367768,6590,9015.2,38.398912866098144,43.651303044049385,NaN,NaN,NaN,NaN,0.6555452520025877,21.196001576097526,12381560,-0.1915237855679884,-0.40063286267900367,-0.20910907711101526
2025-09-11T13:40:00-04:00,500.275,500.41,500.17,500.32,NaN,NaN,NaN,502.2984811049877,NaN,NaN,501.48350000000045,503.63584592873303,499.33115407126786,499.8112726359271,501.05502603087746,502.2411812420566,499.8688708196983,4738,8886.933333333332,38.941972775251934,42.59383080331265,NaN,NaN,NaN,NaN,0.6258634482881178,22.315605861230516,12386298,-0.16728083564802948,-0.4182101216710521,-0.2509292860230226
2025-09-11T13:45:00-04:00,500.34,500.39,499.82,499.93,NaN,NaN,NaN,502.0999137820337,NaN,NaN,501.4965000000004,503.602812654138,499.39018734586284,499.72145158959466,501.03496134061953,502.2176691414025,499.85225353983657,15093,8957.933333333332,35.642692790165626,41.33766775816367,NaN,NaN,NaN,NaN,0.6218732019818232,23.76601500559615,12371205,-0.16591790096542858,-0.45832666222980833,-0.29240876126437976
2025-09-11T13:50:00-04:00,499.96,500.23,499.82,500.05,NaN,NaN,NaN,501.98514497375936,NaN,NaN,501.52690000000047,503.50078843575545,499.5530115642455,499.72145158959466,501.0266378052134,502.2079258853833,499.8453497250435,6356,8861.3,37.40011488496926,40.08678988744701,NaN,NaN,NaN,NaN,0.6067394018402662,25.112823496792807,12377561,-0.1460419948571966,-0.4749612548358755,-0.3289192599786789
2025-09-11T13:55:00-04:00,500.05,500.26,499.84,500.03,NaN,NaN,NaN,501.97832020222484,NaN,NaN,501.54010000000045,503.46431879133047,499.61588120867043,499.72145158959466,501.0135633243374,502.19236455099644,499.8347620976783,10307,8827.8,37.21769962049071,39.007982244101065,NaN,NaN,NaN,NaN,0.5934008731373913,26.272006376729646,12367254,-0.12420605844378985,-0.4841768330334162,-0.35997077458962634
2025-09-11T14:00:00-04:00,500.02,500.11,499.88,500.05,NaN,NaN,NaN,501.8670329203056,NaN,NaN,501.5485000000005,503.44272517054077,499.65427482946023,499.6061612716757,501.0057981699015,502.1832917843234,499.8283045554796,6065,8662.3,37.54574577494034,38.66723859577576,NaN,NaN,NaN,NaN,0.5674436679132933,27.348390479528135,12373319,-0.09945049159194957,-0.4842838890795633,-0.38483339748761375
2025-09-11T14:05:00-04:00,500.07,500.295,499.74,500.24,NaN,NaN,NaN,501.8670329203056,NaN,NaN,501.5477000000005,503.44409996754325,499.6513000324577,499.48742901734056,500.98915422407265,502.16226315531026,499.81604529283504,14488,8874.3,40.71495678514784,38.59869906051091,NaN,NaN,NaN,NaN,0.5665548344909157,27.73898035487595,12387807,-0.06308701402877914,-0.4636921650235877,-0.40060515099480853
2025-09-11T14:10:00-04:00,500.23,500.73,499.9,500.03,NaN,NaN,NaN,501.8670329203056,NaN,NaN,501.5307000000004,503.4655860527056,499.59581394729526,499.38066731563896,500.9806692149403,502.15005252203235,499.81128590784823,8876,8991.6,38.39583465962772,38.61493132419959,NaN,NaN,NaN,NaN,0.5853723463129962,26.84473817070901,12378931,-0.04673743395696717,-0.45902694344101747,-0.4122895094840503
2025-09-11T14:15:00-04:00,500.04,500.04,499.76,499.8,NaN,NaN,NaN,501.7433604315317,NaN,NaN,501.50650000000047,503.49631833265425,499.5166816673467,499.38066731563896,500.9717199802411,502.14063458815286,499.8028053723294,6516,8942.966666666667,35.97866095229881,38.199057788343566,NaN,NaN,NaN,NaN,0.5635600358620699,26.280246737725637,12372415,-0.04495907831322132,-0.4684883573755769,-0.4235292790623556
2025-09-11T14:20:00-04:00,499.84,500.06,499.68,499.98,NaN,NaN,NaN,501.68138950282577,NaN,NaN,501.47610000000054,503.5113132951077,499.4408867048934,499.38066731563896,500.9596224123389,502.12734649945344,499.79189832522434,9319,8978.933333333332,39.204371919058204,38.04970984142375,NaN,NaN,NaN,NaN,0.5504486047290646,25.9083934114238,12381734,-0.026139195191883957,-0.45620327305221053,-0.4300640778603266
2025-09-11T14:25:00-04:00,499.97,500.2,499.9,500.02,NaN,NaN,NaN,501.68138950282577,NaN,NaN,501.45630000000057,503.5281984619056,499.3844015380955,499.38066731563896,500.9520849975581,502.11796583522477,499.7862041598914,6780,9108,39.928707539592864,38.01478162154965,NaN,NaN,NaN,NaN,0.5325594186769894,25.15458240955306,12388514,-0.00649947858969091,-0.43818842609744024,-0.43168894750774933
2025-09-11T14:30:00-04:00,500,500.74,499.97,500.1,NaN,NaN,NaN,501.68138950282577,NaN,NaN,501.4217000000005,503.5250227134145,499.3183772865865,499.4890333324857,500.9428152154341,502.1034365559953,499.7821938748729,11397,9224.533333333333,41.43165947281738,38.27845229821221,NaN,NaN,NaN,NaN,0.5495194602000603,23.612602027331235,12399911,0.015192067537303011,-0.4126988630861206,-0.4278909306234236
2025-09-11T14:35:00-04:00,500.09,500.62,500.04,500.35,NaN,NaN,NaN,501.68138950282577,NaN,NaN,501.3821000000005,503.49007921164974,499.27412078835124,499.4890333324857,500.934921560112,502.09000695532484,499.77983616489917,11065,9398.133333333333,45.98013937121175,39.10975105641328,NaN,NaN,NaN,NaN,0.5516966416143405,22.180763100982396,12410976,0.04784693102231208,-0.36808226684553347,-0.41592919786784555
2025-09-11T14:40:00-04:00,500.31,500.51,500.1,500.24,NaN,NaN,NaN,501.68138950282577,NaN,NaN,501.3251000000005,503.39912457962373,499.2510754203772,499.4890333324857,500.9314774501505,502.0844745145716,499.77848038572944,4515,9354.166666666666,44.3481539778506,39.366401670680126,NaN,NaN,NaN,NaN,0.5415754529275996,20.85119838365847,12406461,0.06257815572052339,-0.3377065032171913,-0.4002846589377147
2025-09-11T14:45:00-04:00,500.29,500.57,500.23,500.43,NaN,NaN,NaN,501.68138950282577,NaN,NaN,501.2761000000005,503.3163581103643,499.2358418896367,499.4890333324857,500.92687021473193,502.07579943365505,499.7779409958088,7614,9484.2,47.79486450432066,40.0375410734103,NaN,NaN,NaN,NaN,0.527177206289912,19.769909820734057,12414075,0.08430562659500007,-0.29490262569396464,-0.3792082522889647
2025-09-11T14:50:00-04:00,500.44,501.2,500.44,500.86,NaN,NaN,NaN,501.68138950282577,NaN,NaN,501.23730000000046,503.23347154499754,499.2411284550034,499.88692405298616,500.92531187861607,502.06469314929575,499.7859306079364,14601,9384.266666666666,54.641585614905644,41.158941990528426,NaN,NaN,NaN,NaN,0.544521691554917,20.120016819210168,12428676,0.12440330884675432,-0.22370411623052178,-0.3481074250772761
2025-09-11T14:55:00-04:00,500.87,500.93,500.54,500.71,NaN,NaN,NaN,501.68138950282577,NaN,NaN,501.2169000000005,503.2133617593903,499.22043824061075,499.88692405298616,500.92377509660486,502.0588739415619,499.7886762516478,6833,9409.8,52.075842329847035,42.33273838621996,NaN,NaN,NaN,NaN,0.533484427872422,20.445116174937986,12421843,0.1366153116184271,-0.17733828555424225,-0.31395359717266935
2025-09-11T15:00:00-04:00,500.68,500.87,500.49,500.74,NaN,NaN,NaN,501.68138950282577,NaN,NaN,501.2179000000005,503.21335492481126,499.22244507518974,499.88692405298616,500.92182865182093,502.05217105579203,499.79148624784983,7750,9392.9,52.55567395493695,43.415278319789074,NaN,NaN,NaN,NaN,0.5225212544529629,20.5851784716919,12429593,0.1418847429202395,-0.13659766852236999,-0.2784824114426095
2025-09-11T15:05:00-04:00,500.8,500.845,500.61,500.72,NaN,NaN,NaN,501.68138950282577,NaN,NaN,501.2157000000005,503.2131023222382,499.21829767776273,499.88692405298616,500.9206071322211,502.0475426393527,499.79367162508953,5564,9341.7,52.18058288007577,44.48405569547372,NaN,NaN,NaN,NaN,0.501984021992038,20.715236318677675,12424029,0.1390122054082435,-0.10471715468230514,-0.24372936009054863
2025-09-11T15:10:00-04:00,500.68,500.68,500.42,500.53,NaN,NaN,NaN,501.68138950282577,NaN,NaN,501.2041000000005,503.2105393229958,499.19766067700516,499.88692405298616,500.91690908846584,502.0389236770595,499.7948944998722,8875,9446.466666666667,48.629771231682675,45.275771799526744,NaN,NaN,NaN,NaN,0.4875565918497503,20.18773921776895,12415154,0.12002118295847103,-0.09370288139245986,-0.2137240643509309
2025-09-11T15:15:00-04:00,500.55,500.66,500.42,500.54,NaN,NaN,NaN,501.68138950282577,NaN,NaN,501.18190000000044,503.19267188090254,499.17112811909834,499.88692405298616,500.91345798045427,502.030900824782,499.7960151361265,8367,9557.2,48.82714500312623,45.855213815096626,NaN,NaN,NaN,NaN,0.4698739781461974,19.697920481210854,12423521,0.1044129274044423,-0.08320790509537801,-0.1876208324998203
2025-09-11T15:20:00-04:00,500.56,500.69,500.46,500.66,NaN,NaN,NaN,501.68138950282577,NaN,NaN,501.1583000000005,503.16531729855336,499.15128270144766,499.88692405298616,500.9109443570037,502.0241967699423,499.7976919440651,7467,9329.866666666667,51.24782756886997,46.77321330861393,NaN,NaN,NaN,NaN,0.4527401225643275,19.326016094313037,12430988,0.09852509999095904,-0.06446445751112151,-0.16298955750208055
2025-09-11T15:25:00-04:00,500.68,500.83,500.58,500.8,NaN,NaN,NaN,501.68138950282577,NaN,NaN,501.12270000000046,503.0903434729864,499.15505652701455,500.02252273515677,500.90950054146793,502.01824449415017,499.8007565887857,7696,9251.266666666666,53.982781600317985,48.059221926329585,NaN,NaN,NaN,NaN,0.4382586852383041,19.36592137062296,12438684,0.10009029290611765,-0.0378766913694335,-0.13796698427555115
2025-09-11T15:30:00-04:00,500.8,500.95,500.48,500.75,NaN,NaN,NaN,501.68138950282577,NaN,NaN,501.0915000000005,503.03213520444126,499.15086479555976,500.0690181881254,500.9065498527491,502.0065518975786,499.80654780791957,15238,9206.1,52.84261834920548,49.03338238562582,NaN,NaN,NaN,NaN,0.44052592200699453,19.717825692281355,12423446,0.09389136242618919,-0.02060278124281467,-0.11449414366900386
2025-09-11T15:35:00-04:00,500.74,500.8,500.55,500.74,NaN,NaN,NaN,501.68138950282577,NaN,NaN,501.0525000000005,502.9407396555335,499.16426034446755,500.0690181881254,500.90408723953414,501.99785046913075,499.8103240099375,11210,9099.6,52.603320048528325,49.93871185054978,NaN,NaN,NaN,NaN,0.4269169275779235,20.04459399096415,12412236,0.08548969714271198,-0.007632022240613878,-0.09312171938332586
2025-09-11T15:40:00-04:00,500.73,500.79,500.42,500.52,NaN,NaN,NaN,501.68138950282577,NaN,NaN,501.00830000000053,502.8400200759536,499.1765799240475,500.0690181881254,500.900960064979,501.9899532522412,499.8119668777168,9213,8987.7,47.50632633709685,50.372616626569744,NaN,NaN,NaN,NaN,0.4228514327509293,19.77399139183395,12403023,0.06255127182145626,-0.014932629606505543,-0.0774839014279618
2025-09-11T15:45:00-04:00,500.52,500.74,500.45,500.6,NaN,NaN,NaN,501.68138950282577,NaN,NaN,500.9769000000005,502.781512855057,499.17228714494405,500.0690181881254,500.8953159833964,501.97494341443195,499.8156885523609,18230,9313.833333333334,49.42537336304917,50.61870476884384,NaN,NaN,NaN,NaN,0.41336204469729293,19.522717549784474,12421253,0.0507066892356713,-0.014100539883372676,-0.06480722911904398
2025-09-11T15:50:00-04:00,500.52,501.6,500.06,501.52,NaN,NaN,NaN,501.68138950282577,NaN,NaN,500.9681000000005,502.757679715079,499.178520284922,500.1707498498562,500.90099120008057,501.96227812068724,499.8397042794739,35079,10141,65.18703967828395,52.107196604589085,NaN,NaN,NaN,NaN,0.49383618436177346,21.2728147639692,12456332,0.09992769174952244,0.060102385567859073,-0.03982530618166337
2025-09-11T15:55:00-04:00,501.53,502.26,500.64,501.03,499.7294365013776,499.7294365013776,499.7294365013776,NaN,NaN,NaN,500.9679000000005,502.757449763694,499.178350236307,500.3065998798849,500.9363372045191,501.9572198904853,499.91545451855285,96289,13069.266666666666,55.30152109868738,52.64338636132957,NaN,NaN,NaN,NaN,0.5742764569073613,23.757926639886353,12360043,0.09463251227555941,0.0784653341627859,-0.016167178112773517
2025-09-12T09:30:00-04:00,506.52,506.69,503.85,505.095,502.85582575131497,NaN,NaN,NaN,NaN,NaN,501.0330000000005,503.1513314180372,498.91466858196384,502.2972799039079,505.21166666666664,505.21166666666664,505.21166666666664,91215,15778.2,81.01844798954464,54.527447959518064,NaN,NaN,NaN,NaN,0.9375424242711229,27.97542213502833,12451258,0.34591900019527755,0.41623157213132345,0.07031257193604588
2025-09-12T09:35:00-04:00,505.02,505.82,504.01,505.44,502.85582575131497,NaN,NaN,NaN,NaN,NaN,501.1016000000005,503.54001623946675,498.6631837605342,502.2972799039079,505.16534216118237,505.2244199768543,505.10626434551045,56084,17428,81.96674354158408,56.662512331785,NaN,NaN,NaN,NaN,0.9998608225374713,31.89166795194588,12507342,0.5066629247210448,0.7036412278373518,0.1969783031163071
2025-09-12T09:40:00-04:00,505.48,506.83,505.11,506.76,503.3001635461362,NaN,NaN,NaN,NaN,NaN,501.18160000000057,504.0559085701746,498.30729142982653,502.43465913850105,505.39202783957614,505.831870183562,504.9521854955903,39689,18593.033333333333,85.04519475501215,58.98319238893322,NaN,NaN,NaN,NaN,1.0512993352133642,35.698450007492404,12547031,0.6632974974014614,1.0261001748681338,0.36280267746667244
2025-09-12T09:45:00-04:00,506.68,507.86,506.4,507.31,504.3824288394936,NaN,NaN,NaN,NaN,NaN,501.2700000000005,504.58684850373834,497.95315149626265,503.61372731080087,505.88913590875615,506.77606467640277,505.0022071411095,71455,20471.766666666666,86.10923424362015,61.40666748632925,NaN,NaN,NaN,NaN,1.0804922398409835,39.37311417764588,12618486,0.7584939745228461,1.31092014562023,0.5524261710973839
2025-09-12T09:50:00-04:00,507.24,508.11,505.3,506.32,504.3824288394936,NaN,NaN,NaN,NaN,NaN,501.34730000000053,504.939714903181,497.75488509682003,503.61372731080087,506.0151001377942,506.8596456778021,505.1705545977863,57971,22192.266666666666,75.67233886817709,63.33827946036456,NaN,NaN,NaN,NaN,1.2040285084237705,41.022032017191975,12560515,0.7101839234914422,1.4401560754616867,0.7299721519702445
2025-09-12T09:55:00-04:00,506.25,508.08,506.19,507.89,504.3824288394936,NaN,NaN,NaN,NaN,NaN,501.4497000000005,505.46543525480223,497.4339647451988,503.61372731080087,506.20813724797983,507.12485519433255,505.2914193016271,51827,23576.266666666666,79.84452584631565,65.55380666344952,NaN,NaN,NaN,NaN,1.253026472107786,42.55317001105621,12612342,0.7362138200571167,1.6502394270416403,0.9140256069845236
2025-09-12T10:00:00-04:00,508.05,508.37,506.67,507.08,504.3824288394936,NaN,NaN,NaN,NaN,NaN,501.5419000000005,505.8482752224518,497.23552477754924,503.6907083831301,506.35111525514185,507.29101247572424,505.41121803455945,51506,25090.966666666667,72.89827143203951,67.1002669393902,NaN,NaN,NaN,NaN,1.2849531526715146,44.07890052218849,12560836,0.6539100052794766,1.7314131135838693,1.0775031083043927
2025-09-12T10:05:00-04:00,507.08,507.94,507.05,507.44,504.3824288394936,NaN,NaN,NaN,NaN,NaN,501.64450000000056,506.25303219544287,497.03596780455825,503.75156670650404,506.4444134175252,507.39650983157173,505.49231700347866,37938,25872.633333333335,73.98166728264225,68.52875877384193,NaN,NaN,NaN,NaN,1.2567422131949768,45.49565028252561,12598774,0.5811954944680384,1.8039974763894406,1.2228019819214022
2025-09-12T10:10:00-04:00,507.39,507.74,506.62,507.2,504.3824288394936,NaN,NaN,NaN,NaN,NaN,501.74110000000053,506.6019868693305,496.88021313067054,503.8292533652032,506.4832421263253,507.4247199660158,505.5417642866348,25264,26418.9,71.91762339225595,69.89125913405982,NaN,NaN,NaN,NaN,1.246974912252479,46.07943862881043,12573510,0.4786879280325176,1.8211618919620491,1.3424739639295316
2025-09-12T10:15:00-04:00,507.2,507.46,506.79,507.15,504.3824288394936,NaN,NaN,NaN,NaN,NaN,501.83770000000055,506.92735429438056,496.74804570562054,503.9964026921626,506.5149190380425,507.4437782450835,505.5860598310015,24738,27026.3,71.47025674612276,71.23889746960228,NaN,NaN,NaN,NaN,1.205762418520156,46.62152780750347,12548772,0.3739145970462263,1.8098672102373143,1.435952613191088
2025-09-12T10:20:00-04:00,507.17,507.7,506.61,506.77,504.3824288394936,NaN,NaN,NaN,NaN,NaN,501.92310000000055,507.1943923990557,496.6518076009454,504.38412215373006,506.5357680190862,507.4511170694929,505.62041896867953,21562,27434.4,68.00779302514792,72.70328794732022,NaN,NaN,NaN,NaN,1.1974936743401432,47.253578882028016,12527210,0.25130146381302687,1.7500794429573716,1.4987779791443447
2025-09-12T10:25:00-04:00,506.731,507.38,506.52,507.17,504.3824288394936,NaN,NaN,NaN,NaN,NaN,502.0211000000006,507.492925760759,496.5492742392422,504.38412215373006,506.55384245411415,507.456776219168,505.6509086890603,20375,27887.566666666666,69.67329878881655,74.14956833487504,NaN,NaN,NaN,NaN,1.1733869833158483,47.668794854811395,12547585,0.1731392821072788,1.7152020817784432,1.5420627996711644
2025-09-12T10:30:00-04:00,507.21,508.38,507.15,507.91,504.6142370731111,NaN,NaN,NaN,NaN,NaN,502.1553000000006,507.8639980683907,496.4466019316105,505.29883817838726,506.6290789683776,507.55411232348564,505.70404561326956,34918,28671.6,72.52316847473493,74.67357753462151,NaN,NaN,NaN,NaN,1.1774307702218605,48.57771327973376,12582503,0.14823887263436863,1.7273613904641252,1.5791225178297565
2025-09-12T10:35:00-04:00,507.99,508.4,507.9,508.2,505.07427175160603,NaN,NaN,NaN,NaN,NaN,502.2969000000006,508.24218010745096,496.3516198925503,505.68507054270975,506.72283136384914,507.6917871680176,505.7538755596807,37956,29567.966666666667,73.5713250901278,75.97856353401014,NaN,NaN,NaN,NaN,1.1290428580631562,49.43118966753968,12620459,0.12897141566128534,1.7403367874063633,1.611365371745078
2025-09-12T10:40:00-04:00,508.21,508.44,507.68,507.86,505.07427175160603,NaN,NaN,NaN,NaN,NaN,502.44070000000056,508.56668922920136,496.31471077079976,505.8880564341678,506.77227223742983,507.7534500340246,505.7910944408351,25205,30257.633333333335,70.19064285583215,75.20514888160208,NaN,NaN,NaN,NaN,1.1026826539157872,49.78588702989036,12595254,0.07374553596942124,1.7035472917068546,1.6298017557374334
2025-09-12T10:45:00-04:00,507.85,508.41,507.28,508.04,505.07427175160603,NaN,NaN,NaN,NaN,NaN,502.5819000000006,508.8894728736216,496.27432712637955,505.8880564341678,506.80637588772504,507.7920178260349,505.82073394941517,20015,30671,70.95166157637536,74.4183573126586,NaN,NaN,NaN,NaN,1.1046338929218062,49.34807637504542,12615269,0.0318937496092635,1.6696689427490128,1.6377751931397493
2025-09-12T10:50:00-04:00,508.1,508.74,507.81,508.68,505.23157970432226,NaN,NaN,NaN,NaN,NaN,502.73710000000057,509.2519384750653,496.22226152493585,506.18975611786743,506.861635049194,507.8733538234731,505.84991627491485,23830,30978.633333333335,73.5383916890809,73.59644280794923,NaN,NaN,NaN,NaN,1.092160043427392,49.17579451576319,12639099,0.029901958697390985,1.6751526415114881,1.6452506828140971
2025-09-12T10:55:00-04:00,508.69,509.29,508.55,509.07,505.9140078995804,NaN,NaN,NaN,NaN,NaN,502.9021000000006,509.6288115558933,496.17538844410785,506.87980489429395,506.9563028220076,508.03715782228926,505.87544782172597,32511,31834.566666666666,74.99939009887667,72.80288251189613,NaN,NaN,NaN,NaN,1.0670057546111502,49.37434810882716,12671610,0.03697548511999882,1.6914700392140958,1.654494554094097
2025-09-12T11:00:00-04:00,509,509.13,508.61,508.66,505.9297348132358,NaN,NaN,NaN,NaN,NaN,503.0651000000006,509.94527979097563,496.18492020902556,506.94184391543513,507.0258634018563,508.1428149955924,505.90891180812025,28389,32522.533333333333,70.58711223268776,72.4396520379326,NaN,NaN,NaN,NaN,1.0279339149960667,49.558719302386564,12643221,-0.0017782347840895607,1.652271760613985,1.6540499953980745
2025-09-12T11:05:00-04:00,508.62,509.6,508.53,509.31,506.1124741399069,NaN,NaN,NaN,NaN,NaN,503.2497000000006,510.2929664038852,496.20643359611597,507.3144751323481,507.13155876367205,508.31409511022474,505.94902241711935,39467,33652.63333333333,73.27177323069026,71.97016970824508,NaN,NaN,NaN,NaN,1.030938635353494,50.024063048069856,12682688,0.0004267257739067887,1.654583402615458,1.6541566768415512
2025-09-12T11:10:00-04:00,509.34,509.99,509.32,509.74,506.7439525880929,NaN,NaN,NaN,NaN,NaN,503.4333000000006,510.66267939493906,496.20392060506214,507.82158010587847,507.2232591723742,508.4777429240918,505.9687754206566,29519,34340.76666666667,74.90370212009412,72.11341475739184,NaN,NaN,NaN,NaN,1.005871589971102,50.67939126013411,12712207,0.01414734743377788,1.6718408611337736,1.6576935136999957
2025-09-12T11:15:00-04:00,509.77,510.4,509.77,510.09,507.2162729249978,NaN,NaN,NaN,NaN,NaN,503.62950000000063,511.0362143185022,496.2227856814991,508.33526408470277,507.3425949602387,508.6974412478863,505.9877486725912,35723,35252.63333333333,76.17862016900716,72.27033996356076,NaN,NaN,NaN,NaN,0.9811664764017352,51.50515455701182,12747930,0.029228846945352993,1.694229572381687,1.665000725436334
2025-09-12T11:20:00-04:00,510.14,510.56,509.87,510.51,507.3825787011343,NaN,NaN,NaN,NaN,NaN,503.8333000000006,511.423053516169,496.2435464838322,508.56321126776226,507.4230002901999,508.84367776360756,506.0023228167923,23845,35798.566666666666,77.64616247009515,72.67952132626355,NaN,NaN,NaN,NaN,0.9603688709444682,52.35386217169705,12771775,0.04877333921701443,1.725967399457602,1.6771940602405875
2025-09-12T11:25:00-04:00,510.57,511.3,510.55,510.81,508.1135978510827,NaN,NaN,NaN,NaN,NaN,504.05090000000064,511.80267700633726,496.299122993664,509.3075690142098,507.58902369752076,509.1603500025452,506.0176973924963,44355,37020.53333333333,78.65756565347753,73.19290053393175,NaN,NaN,NaN,NaN,0.9481996658770077,53.485618734134455,12816130,0.06232131034353783,1.7550956981700097,1.6927743878264718
2025-09-12T11:30:00-04:00,510.72,511.68,510.195,511.3,508.1135978510827,NaN,NaN,NaN,NaN,NaN,504.2759000000006,512.2012344885962,496.35056551140497,509.3435552113678,507.71423621231145,509.3871608702909,506.04131155433197,34648,37667.53333333333,80.23089197817968,74.06597903057688,NaN,NaN,NaN,NaN,0.9865425468857938,54.6904309494497,12850778,0.08338388440753564,1.7970042433358913,1.7136203589283556
2025-09-12T11:35:00-04:00,511.29,511.74,511.24,511.4,508.6668939097675,NaN,NaN,NaN,NaN,NaN,504.50330000000065,512.5793197149237,496.42728028507753,509.62084416909425,507.8716660679378,509.67332165316515,506.0700104827104,42118,38697.8,80.5460806281854,74.84260630481752,NaN,NaN,NaN,NaN,0.9517895078225228,55.833302862939824,12892896,0.0829733934457384,1.8173371007355286,1.7343637072897902
2025-09-12T11:40:00-04:00,511.37,511.78,510.66,510.87,508.6668939097675,NaN,NaN,NaN,NaN,NaN,504.71970000000067,512.8861568593583,496.5532431406431,509.62084416909425,507.9885314007014,509.8573794187628,506.11968338264,37599,39644,73.82771726583547,74.9357883613247,NaN,NaN,NaN,NaN,0.9638045429780532,55.602232026475775,12855297,0.028731278590155673,1.7702778055274848,1.7415465269373291
2025-09-12T11:45:00-04:00,510.84,511.14,510.15,510.46,508.6668939097675,NaN,NaN,NaN,NaN,NaN,504.92410000000064,513.1432585187233,496.704941481278,509.62084416909425,508.06081599371436,509.9522803163493,506.1693516710794,29794,40029.46666666667,69.03087822826618,74.61147072833458,NaN,NaN,NaN,NaN,0.96567564705105,54.39342028988593,12825503,-0.04881535867621256,1.6805273285920634,1.729342687268276
2025-09-12T11:50:00-04:00,510.54,511.03,510.38,510.68,508.6668939097675,NaN,NaN,NaN,NaN,NaN,505.13710000000066,513.3898173922166,496.88438260778474,509.62084416909425,508.1083036967462,510.01515914159734,506.20144825189504,19622,39514.23333333333,70.15155637557666,74.60867883688776,NaN,NaN,NaN,NaN,0.9431273865474019,53.270952248766775,12845125,-0.09658730795889947,1.6086085523196516,1.705195860278551
2025-09-12T11:55:00-04:00,510.76,511.37,510.63,511.23,508.6668939097675,NaN,NaN,NaN,NaN,NaN,505.36570000000063,513.6475727372383,497.08382726276295,509.62084416909425,508.1542831447424,510.0814947888442,506.2270715006406,17136,36875.8,72.80141673650085,74.74080420546817,NaN,NaN,NaN,NaN,0.9286182875083024,52.51721980943568,12862261,-0.10191280405189262,1.5778048552136852,1.6797176592655778
2025-09-12T12:00:00-04:00,511.22,511.325,510.7,510.93,508.6668939097675,NaN,NaN,NaN,NaN,NaN,505.5847000000007,513.8644358433537,497.3049641566476,509.62084416909425,508.20911463051715,510.15703839715167,506.26119086388263,21852,34563.7,69.19307882069836,74.4304247148694,NaN,NaN,NaN,NaN,0.9069312669719951,51.81732540148537,12840409,-0.13436724865459881,1.5117585984473294,1.6461258471019282
2025-09-12T12:05:00-04:00,510.92,511.59,510.84,511.31,508.6668939097675,NaN,NaN,NaN,NaN,NaN,505.8105000000007,514.086678888582,497.53432111141933,509.62084416909425,508.26361534305363,510.23564601760546,506.2915846685018,20611,33381.26666666667,71.14404545214991,74.15504295438892,NaN,NaN,NaN,NaN,0.8957218907597098,51.39738342755199,12861020,-0.13842201545821853,1.4730983277791552,1.6115203432373737
2025-09-12T12:10:00-04:00,511.3,511.62,511.04,511.38,508.6668939097675,NaN,NaN,NaN,NaN,NaN,506.0361000000007,514.2922684306716,497.77993156932985,509.75401857109046,508.324202135982,510.3231026670299,506.32530160493405,23027,32825.86666666667,71.50207096170998,74.22039714931908,NaN,NaN,NaN,NaN,0.8731703271340151,51.0337172710109,12884047,-0.14393184084492572,1.4316055421812166,1.5755373830261423
2025-09-12T12:15:00-04:00,511.49,512.23,511.44,511.79,509.164057543667,NaN,NaN,NaN,NaN,NaN,506.26490000000064,514.5121401417617,498.01765985823954,510.31221485687234,508.4125745883362,510.46091990265575,506.3642292740167,30390,31457.033333333333,73.57048828318158,74.24173393878274,NaN,NaN,NaN,NaN,0.8715153037673014,51.19344738623328,12914437,-0.128038779133258,1.4154889091095697,1.5435276882428277
2025-09-12T12:20:00-04:00,511.79,511.89,511.31,511.75,509.164057543667,NaN,NaN,NaN,NaN,NaN,506.49510000000066,514.6992424875394,498.2909575124619,510.31221485687234,508.47649587372365,510.553929555881,506.3990621915663,24214,30331.8,73.01370006012556,74.10673379164213,NaN,NaN,NaN,NaN,0.8506927820696358,51.02531130223304,12890223,-0.12799006542887414,1.383540106456735,1.5115301718856091
2025-09-12T12:25:00-04:00,511.7,512.07,511.56,511.91,509.23631069577925,NaN,NaN,NaN,NaN,NaN,506.7247000000007,514.8794498818594,498.569950118142,510.3556175083983,508.5037436965705,510.59465866476216,506.4128287283788,9996,28937.433333333334,73.86570453111958,73.94152553179302,NaN,NaN,NaN,NaN,0.8263575833503796,51.020185648086134,12900219,-0.12481958773990898,1.355505687210723,1.480325274950632
2025-09-12T12:30:00-04:00,511.91,512.05,511.7,511.88,509.36579657324376,NaN,NaN,NaN,NaN,NaN,506.94510000000076,515.0494342697223,498.8407657302792,510.5034940067186,508.5468515680936,510.65862592998695,506.4350772062002,16006,27754.1,73.39778899654358,73.6380702836822,NaN,NaN,NaN,NaN,0.7923320416824929,51.01542611209256,12884213,-0.1316995175799449,1.3157008779757007,1.4474003955556456
2025-09-12T12:35:00-04:00,511.94,512.2,511.82,512.05,509.5630330926418,NaN,NaN,NaN,NaN,NaN,507.17190000000073,515.1999236394475,499.1438763605539,510.77279520537496,508.5812104067003,510.7104786324883,506.4519421809123,12501,26906.2,74.38789620526691,73.3330938945243,NaN,NaN,NaN,NaN,0.7628797529908901,51.14554107769875,12896714,-0.1314544882555413,1.283082285236219,1.4145367734917602
2025-09-12T12:40:00-04:00,512.04,512.44,512,512.28,509.82425886115806,NaN,NaN,NaN,NaN,NaN,507.4027000000008,515.3408330825016,499.4645669175,511.07823616429994,508.6412851993205,510.8035834306246,506.47898696801644,21115,26767.9,75.70535961296096,73.00984158272296,NaN,NaN,NaN,NaN,0.7398169134915447,51.47543882894766,12917829,-0.12262784620393097,1.2612519657368466,1.3838798119407776
2025-09-12T12:45:00-04:00,512.27,512.4,511.75,511.85,509.82425886115806,NaN,NaN,NaN,NaN,NaN,507.62530000000083,515.4243610739534,499.8262389260483,511.07823616429994,508.6893392171502,510.872852464502,506.50582596979837,18666,26565.5,68.60064243745052,72.15659599767046,NaN,NaN,NaN,NaN,0.7334014196707184,51.05757813240888,12899163,-0.15072528716321298,1.1954732029867614,1.3461984901499744
2025-09-12T12:50:00-04:00,511.82,512.16,511.77,512.11,509.82425886115806,NaN,NaN,NaN,NaN,NaN,507.8569,515.4852903648555,500.2285096351445,511.07823616429994,508.7362974752654,510.93953599996127,506.53305895056957,18695,26469.933333333334,70.40894144750956,71.9123977249329,NaN,NaN,NaN,NaN,0.7088727468370947,50.66956462848001,12917858,-0.15611539227921956,1.15105424980095,1.3071696420801695
2025-09-12T12:55:00-04:00,512.13,512.54,512.09,512.32,510.0384364493976,NaN,NaN,NaN,NaN,NaN,508.0925,515.5276119022277,500.65738809777224,511.2537769161215,508.78286309015493,511.00899878496523,506.55672739534464,17438,26372.033333333333,71.82054487333993,72.11165962815245,NaN,NaN,NaN,NaN,0.6903818363487259,50.70904707469593,12935296,-0.14982548561897668,1.1198877850564486,1.2697132706754253
2025-09-12T13:00:00-04:00,512.29,512.3,511.7,511.84,510.0384364493976,NaN,NaN,NaN,NaN,NaN,508.3161,515.5122821237658,501.11991787623424,511.2537769161215,508.812183738052,511.0486224880462,506.5757449880578,12542,25626.166666666668,64.27328466790058,71.69178307760417,NaN,NaN,NaN,NaN,0.6853545623238213,49.64236115440471,12922754,-0.18023720660330644,1.0444167624212923,1.2246539690245988
2025-09-12T13:05:00-04:00,511.91,512.05,511.3,511.34,510.0384364493976,NaN,NaN,NaN,NaN,NaN,508.5269,515.4420621498192,501.61173785018076,511.2537769161215,508.85150476832126,511.09578718505605,506.6072223515865,19623,25015.066666666666,57.49549768138801,70.5985031450961,NaN,NaN,NaN,NaN,0.6899720935864014,47.66860073773081,12903131,-0.23292412032393317,0.9334988186196824,1.1664229389436156
2025-09-12T13:10:00-04:00,511.36,511.69,511.33,511.38,510.0384364493976,NaN,NaN,NaN,NaN,NaN,508.73950000000013,515.3312731300387,502.14772686996156,511.2537769161215,508.8722345258397,511.1196018719508,506.6248671797286,10970,24540.566666666666,57.878180718071945,69.79029613776565,NaN,NaN,NaN,NaN,0.6664026583302309,45.83582320796219,12914101,-0.2618183385837516,0.8391500157139262,1.1009683542976778
2025-09-12T13:15:00-04:00,511.38,511.56,511.28,511.44,510.0384364493976,NaN,NaN,NaN,NaN,NaN,508.95350000000013,515.177031553542,502.7299684464583,511.2537769161215,508.8865765859952,511.13573927138344,506.637413900607,7814,24133.866666666665,58.48201324622213,68.88586526591367,NaN,NaN,NaN,NaN,0.6388024684495023,44.007721277381684,12921915,-0.27241198337284267,0.7604533750816245,1.0328653584544671
2025-09-12T13:20:00-04:00,511.48,512.37,511.4,512.31,510.0384364493976,NaN,NaN,NaN,NaN,NaN,509.18930000000006,514.9963054277687,503.3822945722314,511.2537769161215,508.9192641348129,511.1792743162152,506.65925395341065,14640,23827.533333333333,66.07598984023042,68.49828804295085,NaN,NaN,NaN,NaN,0.6624594349888255,43.459447280753764,12936555,-0.21866665718082035,0.7595320369784417,0.9781986941592621
2025-09-12T13:25:00-04:00,512.33,512.4,512.01,512.01,510.074060191256,NaN,NaN,NaN,NaN,NaN,509.4175000000001,514.7323314176713,504.1026685823289,511.2537769161215,508.9406616976744,511.20829713089205,506.6730262644567,9406,23057.366666666665,61.87333993206338,67.66277744644239,NaN,NaN,NaN,NaN,0.642998046775337,42.98663554250702,12927149,-0.2015806103629768,0.726222931205541,0.9278035415685179
2025-09-12T13:30:00-04:00,512.05,512.14,511.5,511.58,510.074060191256,NaN,NaN,NaN,NaN,NaN,509.61870000000005,514.4632824627462,504.7741175372539,511.2537769161215,508.9673060220539,511.24043237769575,506.694179666412,13605,22564.566666666666,56.34184539629554,66.47193068474026,NaN,NaN,NaN,NaN,0.6427839005770977,41.301375156150385,12913544,-0.216204421765834,0.6575480143612253,0.8737524361270593
2025-09-12T13:35:00-04:00,511.6,512.2,511.6,511.98,510.074060191256,NaN,NaN,NaN,NaN,NaN,509.83770000000004,514.059421549125,505.6159784508751,511.2537769161215,509.0134644770471,511.2984105916602,506.728518362434,22648,22003.933333333334,59.93048035141197,65.47655752904686,NaN,NaN,NaN,NaN,0.6411564791073093,39.8280199542593,12936192,-0.19647531904147109,0.6281582873252205,0.8246336063666916
2025-09-12T13:40:00-04:00,512.07,512.21,511.8,512.13,510.074060191256,NaN,NaN,NaN,NaN,NaN,509.97839999999997,514.0237259151967,505.9330740848032,511.2537769161215,509.02589056903753,511.3143674537554,506.7374136843197,5973,21219.066666666666,61.217874317088146,64.60656362337146,NaN,NaN,NaN,NaN,0.6246453020282176,38.476025610113744,12942165,-0.1717553163937532,0.6099394608745001,0.7816947772682533
2025-09-12T13:45:00-04:00,512.14,512.22,511.66,511.76,510.074060191256,NaN,NaN,NaN,NaN,NaN,510.10479999999995,513.9657475314154,506.24385246858446,511.04288353589976,509.04589252099044,511.3387317441987,506.7530532977822,10290,20371.3,56.40392199482828,63.32199403691156,NaN,NaN,NaN,NaN,0.6200277804547737,36.86539483604649,12931875,-0.17799669782714045,0.5591989049843278,0.7371956028114682
2025-09-12T13:50:00-04:00,511.77,511.83,511.16,511.67,510.074060191256,NaN,NaN,NaN,NaN,NaN,510.203,513.9672151904731,506.43878480952685,511.04288353589976,509.068984859302,511.36377583419073,506.7741938844133,13648,20031.4,55.2655004273186,61.86200409507996,NaN,NaN,NaN,NaN,0.6235972247080012,34.23875512270049,12918227,-0.1850422551044063,0.5058927839309604,0.6909350390353667
2025-09-12T13:55:00-04:00,511.67,511.97,511.55,511.78,510.074060191256,NaN,NaN,NaN,NaN,NaN,510.29239999999993,513.9892560913618,506.5955439086381,511.04288353589976,509.08992098053733,511.38801530013507,506.7918266609396,11591,18939.266666666666,56.42316918516526,60.99218457705958,NaN,NaN,NaN,NaN,0.6090545658002879,32.082031964834336,12929818,-0.17903723297336005,0.46713849781866656,0.6461757307920266
2025-09-12T14:00:00-04:00,511.84,511.85,511.08,511.1,510.074060191256,NaN,NaN,NaN,NaN,NaN,510.388,513.9121974973243,506.8638025026756,511.04288353589976,509.1102448243724,511.4078501468912,506.8126395018536,13593,18237.433333333334,48.131010243016895,59.40090377673868,NaN,NaN,NaN,NaN,0.6205506682431273,30.431447639068015,12916225,-0.21517504603029014,0.37720692325416394,0.5923819692844541
2025-09-12T14:05:00-04:00,511.11,511.37,511.06,511.35,510.074060191256,NaN,NaN,NaN,NaN,NaN,510.4571999999999,513.9177850141879,506.99661498581196,511.04288353589976,509.1323496155512,511.42837671286657,506.8363225182359,15658,17355.433333333334,50.98315321041507,57.91251865795834,NaN,NaN,NaN,NaN,0.5983684776543327,28.935831333286067,12931883,-0.21599191305957177,0.32239207795998936,0.5383839910195611
2025-09-12T14:10:00-04:00,511.35,511.52,511.06,511.27,510.074060191256,NaN,NaN,NaN,NaN,NaN,510.5409999999998,513.8708606578513,507.2111393421484,511.04288353589976,509.1560298447073,511.4503878713157,506.8616718180989,16951,16667.166666666668,50.03501382434299,56.89549931198993,NaN,NaN,NaN,NaN,0.5884850149647359,27.202753589692964,12914932,-0.21519501367894522,0.26939022392087963,0.48458523759982486
2025-09-12T14:15:00-04:00,511.26,511.29,510.67,510.98,510.074060191256,NaN,NaN,NaN,NaN,NaN,510.61179999999985,513.8233483867604,507.4002516132394,510.8578850963045,509.1943456315458,511.4794968357969,506.90919442729466,33039,16775.333333333332,46.648332639184396,56.12070180897539,NaN,NaN,NaN,NaN,0.5907360853243979,26.340663270504212,12881893,-0.2263396479948665,0.20166067760624173,0.42800032560110823
2025-09-12T14:20:00-04:00,511.05,511.3,511.03,511.21,510.074060191256,NaN,NaN,NaN,NaN,NaN,510.69199999999984,513.7556109414638,507.62838905853584,510.8578850963045,509.21323080551537,511.4956405349648,506.9308210760659,15102,16624.666666666668,49.56411089906671,55.52683967904644,NaN,NaN,NaN,NaN,0.5713977935155119,25.515306616030113,12896995,-0.21068372511259986,0.1646456692103584,0.37532939432295825
2025-09-12T14:25:00-04:00,511.25,511.44,511.09,511.29,510.074060191256,NaN,NaN,NaN,NaN,NaN,510.7747999999998,513.6701818126154,507.87941818738415,510.8578850963045,509.2280563388414,511.50889545553804,506.94721722214473,11510,16437.133333333335,50.57590480350129,54.96211764742352,NaN,NaN,NaN,NaN,0.5555836654072627,24.391729669568182,12908505,-0.18814290028542274,0.14015076896617984,0.3282936692516026
2025-09-12T14:30:00-04:00,511.26,511.55,511,511.44,510.074060191256,NaN,NaN,NaN,NaN,NaN,510.86819999999983,513.5329076839079,508.20349231609174,510.8578850963045,509.25033160863984,511.5292396459977,506.971423571282,17131,16279.766666666666,52.50002293849017,53.99240572587065,NaN,NaN,NaN,NaN,0.5551848321638876,23.06962592892586,12925636,-0.1575723273919341,0.13132826001168496,0.28890058740361907
2025-09-12T14:35:00-04:00,511.46,511.86,511.33,511.78,510.074060191256,NaN,NaN,NaN,NaN,NaN,510.96039999999977,513.4178456984723,508.5029543015272,510.6309138614008,509.2774774485213,511.5577011209924,506.99725377605023,18444,16207.533333333333,56.62225397176256,53.617328157277726,NaN,NaN,NaN,NaN,0.5533859155807549,21.738178150428872,12944080,-0.11108692858599772,0.15004192667112193,0.26112885525711965
2025-09-12T14:40:00-04:00,511.78,511.93,511.55,511.81,510.074060191256,NaN,NaN,NaN,NaN,NaN,511.0383999999998,513.3466577327515,508.7301422672481,510.75673108912065,509.29580698108447,511.57754108535624,507.0140728768127,12145,15844.8,56.97703977939433,53.66269918464193,NaN,NaN,NaN,NaN,0.5410012073249864,20.65976082842209,12956225,-0.07659355284102393,0.16538691420583973,0.24198046704686366
2025-09-12T14:45:00-04:00,511.81,512.06,511.43,511.61,510.074060191256,NaN,NaN,NaN,NaN,NaN,511.10659999999984,513.2724868300717,508.940713169928,510.8063848712965,509.3249986925385,511.60807246565116,507.0419249194258,20245,15506.633333333333,53.81686518130524,53.22601238677716,NaN,NaN,NaN,NaN,0.5473582639446258,19.953275453245915,12935980,-0.06592823505866821,0.1595701732235284,0.2254984082821966
2025-09-12T14:50:00-04:00,511.62,512.3,511.61,512.05,510.1303884870733,NaN,NaN,NaN,NaN,NaN,511.1903999999998,513.1629474293064,509.21785257069314,510.95210789703725,509.35308220676546,511.6403052730181,507.0658591405128,17780,15292.166666666666,59.180795167012285,53.080506733200316,NaN,NaN,NaN,NaN,0.5575469593771484,19.81235058464648,12953760,-0.029763407335853143,0.18829414911238018,0.21805755644823333
2025-09-12T14:55:00-04:00,512.09,512.23,511.88,512.17,510.2655981012973,NaN,NaN,NaN,NaN,NaN,511.2729999999998,513.0468150977301,509.4991849022695,510.9766863176298,509.3737301927586,511.6646088001138,507.08285158540343,12794,15385.433333333332,60.527305582924605,53.37503413235005,NaN,NaN,NaN,NaN,0.5427221765644965,19.681491778089864,12966554,0.00013438358537021244,0.2182255359299461,0.21809115234457588
2025-09-12T15:00:00-04:00,512.13,512.5,512.08,512.26,510.5246618239655,NaN,NaN,NaN,NaN,NaN,511.3445999999998,512.977375355296,509.71182464470365,511.28734905410386,509.4037391163192,511.7016182146005,507.10586001803784,17715,15442.4,61.55170244210334,53.82404856197753,NaN,NaN,NaN,NaN,0.5339563068098867,20.11880571578383,12984269,0.022621989446322377,0.24636863915247886,0.2237466497061565
2025-09-12T15:05:00-04:00,512.25,512.35,512.1,512.19,510.5246618239655,NaN,NaN,NaN,NaN,NaN,511.4069999999998,512.9214807693464,509.89251923065325,511.28734905410386,509.42803439390536,511.73069770132724,507.1253710864835,14965,15524.533333333333,60.24218173075971,54.09683517237713,NaN,NaN,NaN,NaN,0.5136737134663234,20.52488294364251,12969304,0.02902381111168864,0.2600264135957673,0.23100260248407864
2025-09-12T15:10:00-04:00,512.18,512.39,511.9,511.9,510.5246618239655,NaN,NaN,NaN,NaN,NaN,511.4717999999998,512.772806933433,510.1707930665666,511.28734905410386,509.46178998137736,511.76877030588446,507.15480965687027,22455,15569.2,55.01971941728706,54.58888582768215,NaN,NaN,NaN,NaN,0.5119827339330152,20.221368924045596,12946849,0.010901743630111704,0.24462978202171826,0.23372803839160655
2025-09-12T15:15:00-04:00,511.885,512.1,511.695,511.78,510.5246618239655,NaN,NaN,NaN,NaN,NaN,511.5211999999998,512.668625919617,510.3737740803825,511.28734905410386,509.50243286669047,511.8106032538714,507.1942624795095,30243,15955.1,52.97327761176849,54.73103757063597,NaN,NaN,NaN,NaN,0.5043411100806591,19.298744407608588,12916606,-0.010817278169295064,0.22020644067998774,0.2310237188492828
2025-09-12T15:20:00-04:00,511.77,511.78,510.98,511.09,510.5246618239655,NaN,NaN,NaN,NaN,NaN,511.54819999999984,512.5848923559389,510.5115076440608,511.28734905410386,509.51975216818136,511.82331093577733,507.2161934005854,17513,15915.7,43.05646834488146,54.232570036388715,NaN,NaN,NaN,NaN,0.5254596022177516,19.12061525045196,12899093,-0.07000366784984355,0.14351913403697836,0.2135228018868219
2025-09-12T15:25:00-04:00,511.1,511.12,510.33,510.66,NaN,NaN,NaN,512.4725755506176,512.4725755506176,512.4725755506176,511.5595999999998,512.5430710777263,510.57612892227337,511.28734905410386,509.5354830988681,511.82769326359795,507.24327293413825,24257,16143,38.25074208829959,53.63274213989695,NaN,NaN,NaN,NaN,0.5443553449164851,20.026687831086104,12874836,-0.13281908439489373,0.04749894639320473,0.18031803078809847
2025-09-12T15:30:00-04:00,510.63,510.83,510.27,510.77,NaN,NaN,NaN,512.2945039346804,NaN,NaN,511.5647999999999,512.5285695993088,510.601030400691,511.28734905410386,509.5521471365105,511.8306536190286,507.27364065399235,28392,16671.333333333332,40.092821724349534,52.95622148456,NaN,NaN,NaN,NaN,0.5454728202795934,20.953812144626387,12903228,-0.1598519567184649,-0.019496915109982638,0.14035504160848225
2025-09-12T15:35:00-04:00,510.8,510.94,510.45,510.59,NaN,NaN,NaN,512.2945039346804,NaN,NaN,511.56039999999985,512.5397954057528,510.58100459424685,511.28734905410386,509.56583871168283,511.8335272865464,507.29815013681923,23193,16790.333333333332,38.09039497485985,52.064399353942754,NaN,NaN,NaN,NaN,0.5415104759739088,21.495522877548698,12880035,-0.18118270327318753,-0.08612333748300216,0.09505936579018537
2025-09-12T15:40:00-04:00,510.59,510.9,510.29,510.67,NaN,NaN,NaN,512.2945039346804,NaN,NaN,511.5477999999998,512.5560562376716,510.53954376232804,511.28734905410386,509.5798710798267,511.83565347652717,507.32408868312626,25318,17268.6,39.535803027488114,51.13838364601405,NaN,NaN,NaN,NaN,0.5464025848329122,22.253745978172297,12905353,-0.18081573025993453,-0.13096029703473278,0.04985543322520174
2025-09-12T15:45:00-04:00,510.62,510.76,510.42,510.7,NaN,NaN,NaN,512.2939125600184,NaN,NaN,511.5337999999998,512.5689571093185,510.49864289068114,511.28734905410386,509.5932389640854,511.837651280276,507.3488266478948,24603,17828.233333333334,40.10057230101256,49.95826352667475,NaN,NaN,NaN,NaN,0.531659543059131,22.95781028589421,12929956,-0.16964705187423113,-0.16220338161758718,0.007443670256643949
2025-09-12T15:50:00-04:00,510.72,511.09,510.4,510.88,NaN,NaN,NaN,512.2939125600184,NaN,NaN,511.5339999999999,512.568647766488,510.4993522335118,511.2689033946265,509.62543144775816,511.84790145483674,507.4029614406796,53257,19115.466666666667,43.50999107657093,48.99633147647308,NaN,NaN,NaN,NaN,0.5429695756977643,22.603596574143083,12983213,-0.14233424488130214,-0.17047413584498372,-0.028139890963681587
2025-09-12T15:55:00-04:00,510.87,510.93,509.87,509.89,NaN,NaN,NaN,512.1868914028266,NaN,NaN,511.5225999999999,512.6152650724806,510.4299349275191,511.2689033946265,509.64743025730877,511.8320255877226,507.4628349268949,74762,21294,32.539691649416014,47.47653336705242,NaN,NaN,NaN,NaN,0.5799003202907812,23.188073812295272,12908451,-0.18067665144728073,-0.2539857052727825,-0.07330905382550178
2025-09-15T09:30:00-04:00,508.79,511.44,507.02,509.28,NaN,NaN,NaN,511.5383963390618,NaN,NaN,511.4945999999998,512.7340851192594,510.2551148807402,511.0006227157012,509.24666666666667,509.24666666666667,509.24666666666667,58384,22786.633333333335,27.875913169290072,45.24047036721511,NaN,NaN,NaN,NaN,0.8541931545557266,26.07680771811573,12850067,-0.23349799072260186,-0.3651815422287541,-0.13168355150615224
2025-09-15T09:35:00-04:00,509.29,510.36,509,509.53,NaN,NaN,NaN,511.5383963390618,NaN,NaN,511.4605999999999,512.8151739406458,510.10602605935406,510.5004981725609,509.4008602943184,509.5888280640267,509.21289252461014,39288,23341.3,32.16693550956752,43.2147296476896,NaN,NaN,NaN,NaN,0.8903222149446043,28.759203487806158,12889355,-0.23721008259287069,-0.4281961547472406,-0.1909860721543699
2025-09-15T09:40:00-04:00,509.6,510.87,509.6,509.94,NaN,NaN,NaN,511.5383963390618,NaN,NaN,511.44079999999985,512.8535127948749,510.02808720512485,509.7088246729478,509.59897238494983,509.96276173684447,509.2351830330552,35987,24341.766666666666,38.616906362010326,41.57652992768296,NaN,NaN,NaN,NaN,0.9224420567342777,30.20214237147786,12925342,-0.19919537963233172,-0.43998029669478456,-0.24078491706245284
2025-09-15T09:45:00-04:00,510,511.5,510,510.675,NaN,NaN,NaN,511.5383963390618,NaN,NaN,511.42809999999986,512.8566165594788,509.99958344052095,509.7088246729478,509.8681905258005,510.44383796885563,509.2925430827454,41997,25398.666666666668,48.1373870026231,40.71190173281606,NaN,NaN,NaN,NaN,0.9679819098246866,30.408230604057223,12967339,-0.11582517629572309,-0.3855663874321067,-0.2697412111363836
2025-09-15T09:50:00-04:00,510.685,511.7,510.42,510.84,508.4381589866766,508.4381589866766,508.4381589866766,NaN,NaN,NaN,511.41729999999984,512.8552418767571,509.9793581232426,509.7088246729478,509.97467502665626,510.613097559519,509.3362524937935,18483,25559.833333333332,50.011773383880424,40.35419130185845,NaN,NaN,NaN,NaN,0.9902689162657784,30.265456744673813,12985822,-0.044509507197319276,-0.32537809513303273,-0.28086858793571345
2025-09-15T09:55:00-04:00,510.74,510.8,509.87,510.21,508.4381589866766,NaN,NaN,NaN,NaN,NaN,511.3856999999999,512.8585122897365,509.9128877102632,509.7088246729478,510.0093620086328,510.62015385677535,509.3985701604903,23714,25963.933333333334,43.541152760941074,39.68046809822793,NaN,NaN,NaN,NaN,0.9888211365325065,30.615006021017926,12962108,-0.03512146840678332,-0.3247704234441926,-0.2896489550374093
2025-09-15T10:00:00-04:00,510.28,511.95,510.28,511.92,508.4381589866766,NaN,NaN,NaN,NaN,NaN,511.3890999999998,512.866039660574,509.9121603394257,509.7088246729478,510.1277700526012,510.8274734224818,509.4280666827206,20545,26195.666666666668,59.034161758132726,40.821731913460155,NaN,NaN,NaN,NaN,1.042476769637328,29.24891869414313,12982653,0.08437277720207881,-0.18418298353481077,-0.2685557607368896
2025-09-15T10:05:00-04:00,511.93,512.14,511.18,511.75,508.90175999019647,NaN,NaN,NaN,NaN,NaN,511.3858999999998,512.8589997118264,509.91280028817323,509.7088246729478,510.23446917232707,511.0164221077513,509.45251623690285,17476,26256.266666666666,57.34928074471906,42.18591324606155,NaN,NaN,NaN,NaN,1.0365855718060888,27.73977168461124,12965177,0.146445863720011,-0.08549843108687583,-0.23194429480688683
2025-09-15T10:10:00-04:00,511.77,512.39,511.46,512.04,509.16531635427845,NaN,NaN,NaN,NaN,NaN,511.3890999999998,512.867165885182,509.91103411481765,509.30968834306674,510.362852187116,511.2412140395806,509.4844903346514,20525,26375.4,59.474147745919545,43.5702936761737,NaN,NaN,NaN,NaN,1.028972316677083,26.02131814684285,12985702,0.1982968519960025,0.01592677018811628,-0.18237008180788622
2025-09-15T10:15:00-04:00,512.07,512.09,510.7,511.3,509.16531635427845,NaN,NaN,NaN,NaN,NaN,511.3740999999998,512.8402073497367,509.9079926502629,509.30968834306674,510.40912325771853,511.2922936821133,509.52595283332374,13403,25720.866666666665,52.31226332152164,44.58614141522096,NaN,NaN,NaN,NaN,1.0547600083430086,25.240847439185586,12972299,0.17483856027459752,0.03617811853536068,-0.13866044173923683
2025-09-15T10:20:00-04:00,511.32,511.95,510.42,510.65,509.16531635427845,NaN,NaN,NaN,NaN,NaN,511.34149999999977,512.7980414518777,509.88495854812186,509.30968834306674,510.43505846930145,511.3073891557247,509.5627277828782,13149,25655.766666666666,46.96269860408187,45.11663395640624,NaN,NaN,NaN,NaN,1.0887057220327918,24.788447755359822,12959150,0.11075269054752243,-0.00021957855483378808,-0.11097226910235622
2025-09-15T10:25:00-04:00,510.655,511.39,510.53,510.66,509.16531635427845,NaN,NaN,NaN,NaN,NaN,511.31769999999983,512.7791091969251,509.8562908030746,509.30968834306674,510.45449379103394,511.3112541513535,509.59773343071436,14520,25756.1,47.05240687480599,45.61319356882005,NaN,NaN,NaN,NaN,1.0723695990304505,24.36836233466447,12973670,0.06642895953639927,-0.027936069681857134,-0.0943650292182564
2025-09-15T10:30:00-04:00,510.71,511.25,510.33,510.72,509.16531635427845,NaN,NaN,NaN,NaN,NaN,511.2898999999998,512.7428232467033,509.8369767532963,509.30968834306674,510.4675695337256,511.30852324210576,509.6266158253455,13879,25647.7,47.62482384015625,45.907110194790434,NaN,NaN,NaN,NaN,1.0614860562425623,24.18601890963031,12987549,0.03985475559217404,-0.04454658472803885,-0.08440134032021289
2025-09-15T10:35:00-04:00,510.72,511.95,510.56,511.43,509.16531635427845,NaN,NaN,NaN,NaN,NaN,511.2720999999998,512.6956168987733,509.8485831012263,509.30968834306674,510.51918273186254,511.35884595833636,509.6795195053887,21535,25750.733333333334,53.96685925274669,47.437622166456904,NaN,NaN,NaN,NaN,1.0849513379395213,22.980555041354236,13009084,0.0671893194623069,-0.00041469099232926965,-0.06760401045463617
2025-09-15T10:40:00-04:00,511.59,512.3,511.59,512.1,509.16531635427845,NaN,NaN,NaN,NaN,NaN,511.2772999999998,512.7109404154951,509.8436595845045,509.44587318100486,510.59465764678043,511.47490493512674,509.7144103584341,18997,25979.133333333335,59.01083898102369,49.66154543872359,NaN,NaN,NaN,NaN,1.0695976709438375,21.399325781283913,13028081,0.12417408700296637,0.08761359829907178,-0.036560488703894584
2025-09-15T10:45:00-04:00,512.1,512.28,511.5,512.07,509.16531635427845,NaN,NaN,NaN,NaN,NaN,511.2918999999997,512.7425645239899,509.84123547600944,509.6066985448039,510.642356082678,511.54232227807216,509.7423898872839,13565,25756.466666666667,58.700685234309226,51.556813276205155,NaN,NaN,NaN,NaN,1.0489121230192757,20.04728675200753,13014516,0.15180040957260113,0.15319002326185682,0.001389613689255699
2025-09-15T10:50:00-04:00,512.06,512.24,511.81,512.05,509.1980125623517,NaN,NaN,NaN,NaN,NaN,511.30529999999976,512.7712691814588,509.83933081854065,509.88635883584317,510.6837490256392,511.6011911812684,509.76630687001,11822,25557.866666666665,58.480013792106504,52.97560666406917,NaN,NaN,NaN,NaN,1.004704114232185,18.79182193910803,13002694,0.15986940292126503,0.201226367340837,0.041356964419571964
2025-09-15T10:55:00-04:00,512.06,512.5,511.98,512.47,509.4706029004267,NaN,NaN,NaN,NaN,NaN,511.32589999999976,512.8273788579672,509.8244211420323,510.3570870686745,510.7363225412215,511.6837849033353,509.7888601791077,13216,25571.933333333334,61.733339215937434,53.94674610787733,NaN,NaN,NaN,NaN,0.9700823917870277,17.65457431227348,13015910,0.18297264861014795,0.2700727751822569,0.08710012657210896
2025-09-15T11:00:00-04:00,512.47,513.17,512.47,513.15,510.0810300413163,NaN,NaN,NaN,NaN,NaN,511.3426999999997,512.9053966568375,509.78000334316187,511.1056696549396,510.8443871471563,511.8830614175855,509.80571287672706,21269,25690.4,66.3329368862024,55.11254350090034,NaN,NaN,NaN,NaN,0.9507907923736637,17.475298050147302,13037179,0.23046352300358547,0.3751795303265908,0.14471600732300532
2025-09-15T11:05:00-04:00,513.15,513.76,513.12,513.47,510.73825594852934,NaN,NaN,NaN,NaN,NaN,511.37189999999964,513.0347347968191,509.7090652031803,511.7885357239517,510.9585347278357,512.1056949586477,509.8113744970236,19781,25850.933333333334,68.2660159903731,56.878605160145476,NaN,NaN,NaN,NaN,0.9285914500612582,17.957465912839485,13056960,0.26725090853022365,0.4787796429857849,0.21152873445556125
2025-09-15T11:10:00-04:00,513.49,514.25,513.38,513.43,511.11742613268706,NaN,NaN,NaN,NaN,NaN,511.4088999999996,513.1681444860143,509.64965551398495,512.2378285791614,511.0762570972257,512.3278537286504,509.824660465801,20363,25781.2,67.7424158311475,57.50062330821796,NaN,NaN,NaN,NaN,0.9244063464854543,18.87799294131171,13036597,0.2718176212044408,0.5513007609611122,0.27948313975667144
2025-09-15T11:15:00-04:00,513.43,513.81,512.99,513.03,511.11742613268706,NaN,NaN,NaN,NaN,NaN,511.4298999999997,513.240237526851,509.61956247314833,512.2378285791614,511.11317732087923,512.3860036062124,509.84035103554606,8053,25041.533333333333,62.573820101376725,57.87380469083637,NaN,NaN,NaN,NaN,0.9169487503079173,19.081729208841928,13028544,0.232355759412263,0.5699278390220002,0.3375720796097372
2025-09-15T11:20:00-04:00,513.07,513.17,512.1,512.23,511.11742613268706,NaN,NaN,NaN,NaN,NaN,511.43189999999964,513.2455448278174,509.6182551721819,512.2378285791614,511.17738051806026,512.454095425144,509.9006656109765,23298,25234.366666666665,53.74217162572921,57.46437782510849,NaN,NaN,NaN,NaN,0.9278809824287758,17.99995770045448,13005246,0.14130964481910702,0.5142091356336209,0.3728994908145139
2025-09-15T11:25:00-04:00,512.29,513.09,512.23,512.48,511.11742613268706,NaN,NaN,NaN,NaN,NaN,511.44629999999967,513.2814422945911,509.61115770540823,512.2378285791614,511.23189025097133,512.5133427064344,509.95043779550826,20051,25094.166666666668,55.839736798690154,57.71634021633481,NaN,NaN,NaN,NaN,0.9230323408267214,16.99545558552328,13025297,0.08939078144081014,0.4846379676155266,0.39524718617471644
2025-09-15T11:30:00-04:00,512.49,513.37,512.49,513.31,511.11742613268706,NaN,NaN,NaN,NaN,NaN,511.4790999999997,513.3862735005348,509.57192649946455,512.2378285791614,511.2570972900137,512.5473679360875,509.96682664393984,7330,24392.1,62.00045551957501,58.79046571029861,NaN,NaN,NaN,NaN,0.920672887910526,16.410127501186423,13032627,0.10152829905484673,0.5221575599932748,0.4206292609384281
2025-09-15T11:35:00-04:00,513.27,513.8,513.07,513.8,511.11742613268706,NaN,NaN,NaN,NaN,NaN,511.51949999999977,513.5330702125493,509.5059297874502,512.2378285791614,511.2893742567597,512.5988063472613,509.97994216625807,7554,23870.8,65.0962654936077,60.07931275449873,NaN,NaN,NaN,NaN,0.9070533959169103,16.369952040081763,13040181,0.13124943733819094,0.5846910576111668,0.45344162027297585
2025-09-15T11:40:00-04:00,513.81,514,512.98,513.05,511.11742613268706,NaN,NaN,NaN,NaN,NaN,511.5584999999997,513.6131768605147,509.50382313948467,512.2378285791614,511.34553838929304,512.6796792717495,510.0113975068366,15130,23531.2,57.389405066166375,60.77678284207088,NaN,NaN,NaN,NaN,0.9151210104942725,16.556618685740883,13025051,0.09100057007446483,0.5671923328660569,0.47619176279159203
2025-09-15T11:45:00-04:00,513.04,513.5,512.93,513.17,511.11742613268706,NaN,NaN,NaN,NaN,NaN,511.5948999999997,513.6974398833715,509.49236011662794,512.2378285791614,511.3713659930841,512.7138903024318,510.02884168373646,7815,22971.6,58.24127504878829,61.08209825607385,NaN,NaN,NaN,NaN,0.8904695097446852,16.645540036273573,13032866,0.06431972982290518,0.5565914250702235,0.49227169524731834
2025-09-15T11:50:00-04:00,513.2,513.2,512.7,513.01,511.11742613268706,NaN,NaN,NaN,NaN,NaN,511.6296999999997,513.7668910633821,509.49250893661724,512.2378285791614,511.3957431290926,512.7423178656022,510.04916839258294,8689,21486,56.61603109719795,60.91104055008629,NaN,NaN,NaN,NaN,0.8625788304772077,16.33351442127658,13024177,0.02952617623628251,0.5291794155426714,0.49965323930638894
2025-09-15T11:55:00-04:00,513.01,513.26,512.54,513.14,511.11742613268706,NaN,NaN,NaN,NaN,NaN,511.67289999999974,513.8428844149292,509.50291558507024,512.2378285791614,511.41985102274407,512.7701408811415,510.0695611643466,8805,19287.433333333334,57.65009685878907,60.83599852326343,NaN,NaN,NaN,NaN,0.8523946283002662,15.771585409224459,13032982,0.009911493052318088,0.5120426056217866,0.5021311125694685
2025-09-15T12:00:00-04:00,513.1,513.38,512.56,512.85,511.11742613268706,NaN,NaN,NaN,NaN,NaN,511.70569999999964,513.8961867133617,509.51521328663756,511.8120765350558,511.4375808558084,512.7897409347729,510.0854207768439,6874,17570.433333333334,54.52778645985967,60.55369657096008,NaN,NaN,NaN,NaN,0.8500807262788223,15.424241019543276,13026108,-0.025987143223650644,0.4696471835399052,0.49563432676355584
2025-09-15T12:05:00-04:00,512.8,513.16,512.55,512.6,511.11742613268706,NaN,NaN,NaN,NaN,NaN,511.73189999999965,513.9331822539257,509.5306177460736,511.8120765350558,511.4497104440411,512.8016377001294,510.0977831879528,5379,16440.133333333335,51.917337875531835,59.85255361807396,NaN,NaN,NaN,NaN,0.8329321029731931,15.082782910493767,13020729,-0.06759844348295457,0.4111362724098626,0.4787347158928172
2025-09-15T12:10:00-04:00,512.555,512.75,512.25,512.31,511.11742613268706,NaN,NaN,NaN,NaN,NaN,511.74929999999966,513.9548276106347,509.5437723893647,511.8120765350558,511.46811192843273,512.8140142763809,510.12220958048454,11226,15614.766666666666,48.98761689521547,58.61360219014632,NaN,NaN,NaN,NaN,0.8091512384751078,14.19948277892448,13009503,-0.11300763376171186,0.33747517369067737,0.4504828074523892
2025-09-15T12:15:00-04:00,512.29,512.78,512.25,512.46,511.11742613268706,NaN,NaN,NaN,NaN,NaN,511.76289999999966,513.977385123286,509.54841487671337,511.8120765350558,511.48002087864865,512.8226253271165,510.1374164301808,7053,14449.966666666667,50.542243870221725,57.347618467278366,NaN,NaN,NaN,NaN,0.7892118642983125,13.432480530274118,13016556,-0.13007950380139216,0.287883427700649,0.41796293150204117
2025-09-15T12:20:00-04:00,512.61,512.75,512.46,512.55,511.11742613268706,NaN,NaN,NaN,NaN,NaN,511.7776999999996,514.0031107130061,509.5522892869931,511.8120765350558,511.48978407099503,512.8304528478347,510.1491152941553,5422,14014.6,51.49735076637702,56.187256676937615,NaN,NaN,NaN,NaN,0.7535538739912876,12.720264156527355,13021978,-0.13202773719055627,0.25292826001384583,0.3849559972044021
2025-09-15T12:25:00-04:00,512.51,512.73,512.18,512.37,511.11742613268706,NaN,NaN,NaN,NaN,NaN,511.7928999999996,514.0238962711117,509.5619037288875,511.8120765350558,511.500099414941,512.836946759751,510.1632520701311,6842,13452.2,49.44089862515158,55.24919085720724,NaN,NaN,NaN,NaN,0.7390143115633433,12.130038890927256,13015136,-0.1413244898184315,0.20830038493136271,0.3496248747497942
2025-09-15T12:30:00-04:00,512.4,512.97,512.23,512.79,511.11742613268706,NaN,NaN,NaN,NaN,NaN,511.8076999999996,514.0550799948996,509.5603200050996,511.4799065487588,511.5116786209884,512.8468587940573,510.17649844791947,6248,12975.633333333333,54.051586358047786,55.27129190951571,NaN,NaN,NaN,NaN,0.739084717880248,11.437586359252592,13021384,-0.11612709541577815,0.20446600548007154,0.3205931008958497
2025-09-15T12:35:00-04:00,512.76,513.11,512.6,512.8,511.11742613268706,NaN,NaN,NaN,NaN,NaN,511.82029999999963,514.082677873247,509.5579221267523,511.63986360185424,511.52747855935206,512.862444157332,510.19251296137213,7575,12645.6,54.1587772660189,55.151223371467765,NaN,NaN,NaN,NaN,0.722721523745944,11.071979783048542,13028959,-0.09653089199309839,0.19992948590447668,0.29646037789757507
2025-09-15T12:40:00-04:00,512.77,513.03,512.49,512.95,511.11742613268706,NaN,NaN,NaN,NaN,NaN,511.8340999999996,514.1153765640225,509.5528234359767,511.63986360185424,511.5405798726358,512.8750914806724,510.20606826459925,6488,12177.7,55.82354715175197,54.71001563090898,NaN,NaN,NaN,NaN,0.7096699863355169,10.485049777842795,13035447,-0.0723181855645641,0.20606264594186996,0.27838083150643406
2025-09-15T12:45:00-04:00,512.92,512.92,512.63,512.82,511.11742613268706,NaN,NaN,NaN,NaN,NaN,511.84669999999954,514.1426125509792,509.55078744902,511.63986360185424,511.5456118754768,512.8797821751804,510.2114415757733,2595,11817.433333333332,53.99344295728841,53.91695687831474,NaN,NaN,NaN,NaN,0.6818364158829836,9.940043344437457,13032852,-0.0641853326647111,0.1981491656755452,0.2623344983402563
2025-09-15T12:50:00-04:00,512.82,512.86,512.16,512.25,511.11742613268706,NaN,NaN,NaN,NaN,NaN,511.8536999999996,514.1523524838352,509.55504751616394,511.63986360185424,511.55561123385746,512.8854264290896,510.2257960386253,7425,11626.633333333333,46.755613669571304,53.15740034998652,NaN,NaN,NaN,NaN,0.683133814748488,10.04741126882897,13025427,-0.09449083874934919,0.14422094990356982,0.238711788652919
2025-09-15T12:55:00-04:00,512.28,512.34,511.79,511.91,511.11742613268706,NaN,NaN,NaN,NaN,NaN,511.85629999999964,514.1549072394507,509.55769276054855,511.63986360185424,511.5627820334489,512.8833633054829,510.2422007614149,10373,11488.4,43.04867148982762,52.07221438148933,NaN,NaN,NaN,NaN,0.6736242565521682,10.813996997639368,13015054,-0.13240667245115506,0.07320344808897516,0.20561012054013023
2025-09-15T13:00:00-04:00,511.88,512.185,511.83,512.06,511.11742613268706,NaN,NaN,NaN,NaN,NaN,511.8756999999998,514.1644621196956,509.586937880304,511.63986360185424,511.5670871362423,512.882253753389,510.2519205190956,6225,11233.266666666666,45.116070361007935,51.25078861461861,NaN,NaN,NaN,NaN,0.6508653810841534,11.525826602963308,13021279,-0.14153246455092677,0.028694539851471745,0.17022700440239852
2025-09-15T13:05:00-04:00,512.07,512.42,511.95,512.04,511.11742613268706,NaN,NaN,NaN,NaN,NaN,511.9032999999998,514.1658893221287,509.6407106778708,511.63986360185424,511.5943881636552,512.8834040484242,510.30537227888624,33648,11637.033333333333,44.88212349493705,50.33879051720061,NaN,NaN,NaN,NaN,0.637946425292426,11.565115486745956,12987631,-0.14266124896205912,-0.008099556800175378,0.13456169216188374
2025-09-15T13:10:00-04:00,512.06,512.44,511.81,512.25,511.11742613268706,NaN,NaN,NaN,NaN,NaN,511.9328999999998,514.1740319373579,509.6917680626417,511.63986360185424,511.59975367840735,512.8838975237632,510.31560983305155,6644,11225.266666666666,47.9349773246195,49.86787557896917,NaN,NaN,NaN,NaN,0.6373788234858279,11.879127144256776,12994275,-0.12371527461570135,-0.020082401107742953,0.1036328735079584
2025-09-15T13:15:00-04:00,512.29,512.62,512.21,512.28,511.11742613268706,NaN,NaN,NaN,NaN,NaN,511.96669999999983,514.1765575611636,509.7568424388361,511.63986360185424,511.605160998622,512.8864043703253,510.3239176269187,5010,10940.1,48.37488466794234,49.61484320699849,NaN,NaN,NaN,NaN,0.6211374789511236,11.693124262764266,12999285,-0.10438521702633052,-0.02684864777495477,0.07753656925137575
2025-09-15T13:20:00-04:00,512.28,512.35,511.79,511.84,511.11742613268706,NaN,NaN,NaN,NaN,NaN,511.9900999999998,514.1691020561495,509.81109794385014,511.63986360185424,511.6078836941048,512.8850366739429,510.3307307142668,5041,10714.066666666668,42.67918162780601,49.164240687897816,NaN,NaN,NaN,NaN,0.6167705161689006,12.34050100606565,12994244,-0.11558412403100862,-0.06694358578738502,0.0486405382436236
2025-09-15T13:25:00-04:00,511.89,512.17,511.81,511.97,511.11742613268706,NaN,NaN,NaN,NaN,NaN,512.0154999999999,514.1631389362639,509.8678610637359,511.6031127051867,511.61104458790294,512.8832726235152,510.3388165522907,6102,10476.933333333332,44.74904897110515,48.75044105224663,NaN,NaN,NaN,NaN,0.598429765013976,12.941636553416934,13000346,-0.10869142141347574,-0.08722373852322107,0.02146768289025466
2025-09-15T13:30:00-04:00,511.96,511.98,511.4,511.73,511.11742613268706,NaN,NaN,NaN,NaN,NaN,512.0324999999998,514.1572515150732,509.9077484849264,511.6031127051867,511.61205622708064,512.8773286644004,510.34678378976093,8033,10035.733333333334,41.751574061492654,48.05431414475489,NaN,NaN,NaN,NaN,0.5971133532272663,14.209173992271772,12992313,-0.11418538111537992,-0.12126404350397024,-0.007078662388590323
2025-09-15T13:35:00-04:00,511.66,511.86,511.56,511.7,511.11742613268706,NaN,NaN,NaN,NaN,NaN,512.0686999999999,514.1060873564398,510.03131264356,511.4564901641494,511.61236634676925,512.8755749651214,510.34915772841714,2410,9456.7,41.378460723937465,47.478425723239596,NaN,NaN,NaN,NaN,0.575890970853891,15.38617304263698,12989903,-0.11349309736116578,-0.14894503409004756,-0.03545193672888178
2025-09-15T13:40:00-04:00,511.72,511.93,511.66,511.86,511.11742613268706,NaN,NaN,NaN,NaN,NaN,512.1202999999998,513.996901620118,510.24369837988166,511.34917789698846,511.6133535506388,512.8735861199311,510.3531209813465,3570,8896.933333333332,44.24046623455405,46.77763142870433,NaN,NaN,NaN,NaN,0.5540416157928975,16.253073049147698,12993473,-0.09657565686287158,-0.15617150780747124,-0.05959585094459967
2025-09-15T13:45:00-04:00,511.88,512.2,511.77,512.2,511.11742613268706,NaN,NaN,NaN,NaN,NaN,512.1736999999999,513.8982182632823,510.4491817367176,511.34917789698846,511.6154651854086,512.8730632027031,510.3578671681141,3536,8746.366666666667,49.84420619478648,46.469447780759154,NaN,NaN,NaN,NaN,0.5451815003791236,16.22562558277718,12997009,-0.058668147692120226,-0.13293103555974994,-0.07426288786762972
2025-09-15T13:50:00-04:00,512.25,512.25,511.88,512.17,511.11742613268706,NaN,NaN,NaN,NaN,NaN,512.2183,513.8204405805699,510.6161594194302,511.34917789698846,511.61860706445185,512.8727242664652,510.3644898624385,4845,8131.266666666666,49.37271576977821,46.00867411061818,NaN,NaN,NaN,NaN,0.5326685360663294,16.051998952472786,12992164,-0.03307046342920576,-0.11560096715413692,-0.08253050372493116
2025-09-15T13:55:00-04:00,512.22,512.76,512.22,512.7,511.11742613268706,NaN,NaN,NaN,NaN,NaN,512.2588,513.8042171734992,510.7133828265007,511.63469805480196,511.6248299583819,512.8771209260334,510.3725389907304,4972,7628.633333333333,57.094391468632324,46.23017043285703,NaN,NaN,NaN,NaN,0.5367636406330224,15.25562359558811,12997136,0.019283054168697925,-0.05842668601405876,-0.07770974018275668
2025-09-15T14:00:00-04:00,512.68,512.94,512.4,512.88,511.11742613268706,NaN,NaN,NaN,NaN,NaN,512.2995999999999,513.8000957047932,510.7991042952067,511.7697584438416,511.63284337135224,512.8841769523021,510.38150979040233,5444,7565.766666666666,59.36136948910749,47.1305815628239,NaN,NaN,NaN,NaN,0.5369948091592406,14.915414980538646,13002580,0.06328201953448503,0.001392784235349609,-0.061889235299135426
2025-09-15T14:05:00-04:00,512.87,513.29,512.74,513.28,511.21461414627584,NaN,NaN,NaN,NaN,NaN,512.361,513.7624235618929,510.9595764381071,512.0788067550732,511.6439371272519,512.8970184681988,510.390855786305,5759,7505.933333333333,63.92314662742976,48.62161550122404,NaN,NaN,NaN,NaN,0.5379237513621488,15.300214724774651,13008339,0.1136336684633092,0.08015285028000108,-0.03348081818330813
2025-09-15T14:10:00-04:00,513.27,513.27,513,513.17,511.37826804871787,NaN,NaN,NaN,NaN,NaN,512.386,513.7996081493832,510.9723918506168,512.1610454040587,511.65291106515883,512.9075985900515,510.39822354026614,4586,7154.466666666666,61.866462202147225,49.81807206130542,NaN,NaN,NaN,NaN,0.5195006262648505,15.6575287729938,13003753,0.13252153707526407,0.13217110316077196,-0.0003504339144921112
2025-09-15T14:15:00-04:00,513.18,513.28,513,513.18,511.42493768286704,NaN,NaN,NaN,NaN,NaN,512.4146,513.8334345076923,510.9957654923075,512.2528363232469,511.6592845485444,512.9151014265328,510.403467670556,3276,7003.166666666667,61.98620316931488,51.0397920380467,NaN,NaN,NaN,NaN,0.502393438674502,16.009919549919847,13007029,0.1380544607247438,0.17221764199143763,0.034163181266693834
2025-09-15T14:20:00-04:00,513.14,513.22,512.96,513.06,511.42493768286704,NaN,NaN,NaN,NaN,NaN,512.435,513.8610168302253,511.00898316977464,512.2682690585975,511.6683105135786,512.9252108873623,510.41141013979495,4931,6877.9,59.56895321218074,51.87079031572965,NaN,NaN,NaN,NaN,0.4850796216263227,16.204934632663473,13002098,0.12631576826175728,0.19205789159389042,0.06574212333213315
2025-09-15T14:25:00-04:00,513.07,513.33,512.975,513.18,511.5075568556702,NaN,NaN,NaN,NaN,NaN,512.4725999999999,513.8758864853571,511.0693135146427,512.391115246878,511.6785071101266,512.9371313218114,510.41988289844176,5336,6762.266666666666,61.198474396293115,52.78676101061185,NaN,NaN,NaN,NaN,0.47578822008158667,16.63838037080156,13007434,0.1193952632118531,0.21498620234694954,0.09559093913509643
2025-09-15T14:30:00-04:00,513.2,513.55,513.2,513.39,511.7543724531397,NaN,NaN,NaN,NaN,NaN,512.5274,513.8535903936563,511.2012096063436,512.6138921975023,511.69155034487653,512.9540930787182,510.4290076110349,6037,6734.366666666667,63.93766117417145,54.305223835352244,NaN,NaN,NaN,NaN,0.46823191864718794,17.51625991952466,13013471,0.12132895278641342,0.2472521301181132,0.12592317733169978
2025-09-15T14:35:00-04:00,513.4,513.53,513.33,513.48,511.85576461436074,NaN,NaN,NaN,NaN,NaN,512.5838,513.824637717013,511.342962282987,512.681113758002,511.6988299646268,512.9637909593142,510.43386896993934,3280,6664.4,65.07557660753015,55.75711866652542,NaN,NaN,NaN,NaN,0.44907249588666964,18.331433786196108,13016751,0.12077625993082391,0.2768935022452297,0.15611724231440577
2025-09-15T14:40:00-04:00,513.44,513.53,512.59,512.62,511.85576461436074,NaN,NaN,NaN,NaN,NaN,512.6218,513.7425618122285,511.50103818777154,512.681113758002,511.7115242110162,512.975904501953,510.4471439200794,8353,6568.633333333333,49.124365094913955,56.28374659748409,NaN,NaN,NaN,NaN,0.48413874618047475,17.261631115298215,13008398,0.05779206965625233,0.2283573293847212,0.17056525972846887
2025-09-15T14:45:00-04:00,512.64,513.02,512.64,513.01,511.85576461436074,NaN,NaN,NaN,NaN,NaN,512.6534,513.7260312319545,511.5807687680456,512.681113758002,511.71731017402465,512.9812697187236,510.45335062932566,3943,6464.966666666666,54.56351708507348,57.22553633756523,NaN,NaN,NaN,NaN,0.47812883573901066,16.26824292089303,13012341,0.03861912158439007,0.21883916170895645,0.18022004012456638
2025-09-15T14:50:00-04:00,513.04,513.25,512.95,513.18,511.85576461436074,NaN,NaN,NaN,NaN,NaN,512.6750000000001,513.7456801574858,511.6043198425143,512.681113758002,511.7280725554934,512.993159944365,510.4629851666218,6180,6490.233333333334,56.73486022789464,58.11799305137527,NaN,NaN,NaN,NaN,0.46540534747193524,15.477805700337472,13018521,0.033783382150364194,0.2224492678125216,0.18866588566215742
2025-09-15T14:55:00-04:00,513.23,513.31,513.1,513.245,511.85576461436074,NaN,NaN,NaN,NaN,NaN,512.6985000000001,513.766609076564,511.63039092343615,512.681113758002,511.7391397668126,513.0059985443311,510.4722809892942,6055,6464,57.56978643126224,58.66982021112354,NaN,NaN,NaN,NaN,0.4471621083667915,14.89773318867226,13024576,0.03140957092186042,0.22792784931448296,0.19651827839262254
2025-09-15T15:00:00-04:00,513.26,513.42,513.21,513.22,511.85576461436074,NaN,NaN,NaN,NaN,NaN,512.7219000000001,513.7833987325953,511.6604012674049,512.681113758002,511.7472315631122,513.0156758522936,510.47878727393083,4295,6398.9,57.11326798923448,59.222716798227566,NaN,NaN,NaN,NaN,0.430221957769158,14.643297698122485,13020281,0.024888109195155605,0.22762841488656704,0.20274030569141144
2025-09-15T15:05:00-04:00,513.19,513.4,513.08,513.34,511.85576461436074,NaN,NaN,NaN,NaN,NaN,512.7393000000001,513.8121727974988,511.6664272025013,512.681113758002,511.7547703338864,513.0245935408271,510.4849471269457,4069,6282.033333333334,58.80201877543671,59.344690177285024,NaN,NaN,NaN,NaN,0.42234896078564216,13.994870258575295,13024350,0.025305682507810984,0.23437240882617516,0.20906672631836418
2025-09-15T15:10:00-04:00,513.35,513.66,513.29,513.29,512.0210421488595,NaN,NaN,NaN,NaN,NaN,512.7421,513.8199647222856,511.6642352777145,512.7978319719822,511.7648946762359,513.037410873681,510.4923784787908,5059,6234.4,57.781075361086664,59.23181202528354,NaN,NaN,NaN,NaN,0.41860974930095374,14.070125811327342,13019291,0.019143939050369874,0.23299665013132653,0.21385271108095666
2025-09-15T15:15:00-04:00,513.32,513.37,513.07,513.37,512.0210421488595,NaN,NaN,NaN,NaN,NaN,512.7401000000001,513.8129140375938,511.6672859624064,512.7978319719822,511.78505028108754,513.0608021082403,510.5092984539348,11249,6522.866666666667,59.00743869247897,58.88069002992991,NaN,NaN,NaN,NaN,0.41013762435088236,13.45106726986129,13030540,0.01743407946446801,0.2356453104115417,0.21821123094707368
2025-09-15T15:20:00-04:00,513.41,513.51,513.19,513.44,512.0210421488595,NaN,NaN,NaN,NaN,NaN,512.7403,513.8136320268677,511.6669679731324,512.7978319719822,511.7955602603962,513.0736331852543,510.51748733553814,5572,6461.1,60.09958822300286,58.75448474570531,NaN,NaN,NaN,NaN,0.4036992226115291,13.243344162264428,13036112,0.01792629567508147,0.2406191005409255,0.22269280486584403
2025-09-15T15:25:00-04:00,513.46,513.84,513.41,513.76,512.2228696788682,NaN,NaN,NaN,NaN,NaN,512.7549,513.8628972742731,511.646902725727,512.9595699696549,511.8115298859079,513.0957544881218,510.527305283694,7266,6357.533333333334,64.72622692951346,58.95020072857664,NaN,NaN,NaN,NaN,0.405577849567853,13.824923736726246,13043378,0.03568648584702,0.26730091217461904,0.23161442632759904
2025-09-15T15:30:00-04:00,513.75,514.21,513.62,514.18,512.4961483298287,NaN,NaN,NaN,NaN,NaN,512.7939000000001,513.9609497673587,511.6268502326416,513.210655975724,511.8778840553179,513.1971022870893,510.55866582354656,26625,7037.533333333334,69.69340127046128,59.67337558988239,NaN,NaN,NaN,NaN,0.4187508603130086,15.081841328301806,13070003,0.0696393187073315,0.31866357471176343,0.24902425600443193
2025-09-15T15:35:00-04:00,514.18,514.36,514.08,514.17,512.827459769382,NaN,NaN,NaN,NaN,NaN,512.8277,514.0528713511263,511.6025286488738,513.4205247805792,511.9174789782439,513.259571609924,510.57538634656373,15234,6423.733333333334,69.4426637934127,60.262246261105226,NaN,NaN,NaN,NaN,0.4088400845763632,16.50759061415983,13054769,0.08436120516270218,0.35447576245780965,0.27011455729510747
2025-09-15T15:40:00-04:00,514.19,514.37,514.13,514.17,512.8880297798646,NaN,NaN,NaN,NaN,NaN,512.8449,514.1198093926475,511.56999060735257,513.4984198244633,511.96052928132957,513.3261787204849,510.59487984217424,17022,6769.666666666667,69.4426637934127,60.65546073390817,NaN,NaN,NaN,NaN,0.39678007853519504,17.849021000986625,13054769,0.08670366174917055,0.37849413448157065,0.2917904727324001
2025-09-15T15:45:00-04:00,514.16,514.56,514.06,514.47,512.9417556989616,NaN,NaN,NaN,NaN,NaN,512.8583,514.1860704770232,511.53052952297674,513.6127358595706,512.0262285514636,513.4289224897761,510.62353461315115,25630,7457,72.84215219092376,61.210216132721996,NaN,NaN,NaN,NaN,0.4041529300683954,19.426159294409707,13080399,0.10011182004007074,0.41693024778248855,0.3168184277424178
2025-09-15T15:50:00-04:00,514.43,514.5,513.86,514.28,512.9417556989616,NaN,NaN,NaN,NaN,NaN,512.8829000000001,514.2682924930377,511.4975075069624,513.6127358595706,512.0884212656574,513.5180208219381,510.65882170937675,27435,8203.466666666667,67.70485255464382,62.53739380841699,NaN,NaN,NaN,NaN,0.42099914934922333,20.139111047160014,13052964,0.08825403760838613,0.42713597475290044,0.3388819371445143
2025-09-15T15:55:00-04:00,514.25,515.47,513.6,515.39,512.9500088083515,NaN,NaN,NaN,NaN,NaN,512.9273000000001,514.4789690496802,511.3756309503199,513.6727509501252,512.3346822876047,513.9067956375021,510.7625689377072,95598,11186.666666666666,77.63055732127174,64.18503953957399,NaN,NaN,NaN,NaN,0.5244992101099933,22.22300380506625,13148562,0.14394347172290578,0.5188112767981465,0.37486780507524076
2025-09-16T09:30:00-04:00,516.545,517.19,514.9,515.4,514.2197811352446,NaN,NaN,NaN,NaN,NaN,512.9751,514.6742556609433,511.2759443390566,514.6072007601002,515.83,515.83,515.83,66925,13149.733333333334,77.69706133790963,65.68233961886078,NaN,NaN,NaN,NaN,0.6506064093878565,25.425234891003868,13215487,0.16852335391442885,0.5855219974682768,0.41699864355384797
2025-09-16T09:35:00-04:00,515.33,516.39,513.74,514.18,NaN,NaN,NaN,517.1686180072667,517.1686180072667,517.1686180072667,512.9959000000001,514.727767997151,511.26403200284926,514.6072007601002,515.4311909555233,515.9446974628864,514.9176844481602,40367,14414.966666666667,55.872868346397226,65.56113118422756,NaN,NaN,NaN,NaN,0.7934202372887222,25.980206509157355,13175120,0.09343602830402203,0.5337936789338755,0.4403576506298535
2025-09-16T09:40:00-04:00,514.11,514.25,512.5,513.11,NaN,NaN,NaN,515.6216353705727,NaN,NaN,513.0011000000001,514.7327457950505,511.26945420494957,514.6072007601002,514.785138174319,515.8586103456171,513.7116660030208,46258,15837.9,44.15769698334049,64.63573325523514,NaN,NaN,NaN,NaN,0.8617473631966706,24.695629338278017,13128862,-0.03082488063356892,0.40182654983789234,0.43265143047146126
2025-09-16T09:45:00-04:00,513.06,513.37,511.8,513.05,NaN,NaN,NaN,514.9436064900921,NaN,NaN,513.0101,514.7379871374953,511.2822128625046,514.6072007601002,514.358290896036,515.6242279033228,513.0923538887492,40501,17070.066666666666,43.60556644731513,63.55027237465504,NaN,NaN,NaN,NaN,0.9123368372540508,23.156208182732392,13088361,-0.1148667801781203,0.2890679552488109,0.4039347354269312
2025-09-16T09:50:00-04:00,513.08,513.31,512.06,512.42,NaN,NaN,NaN,514.9436064900921,NaN,NaN,513.0123,514.7368929490832,511.28770705091677,514.6072007601002,514.1406538725588,515.459985175249,512.8213225698686,27353,17820.333333333332,38.20401691458168,62.151911057047535,NaN,NaN,NaN,NaN,0.9364556345930471,21.726745681154313,13061008,-0.20540883230890034,0.1471736950408058,0.35258252734970613
2025-09-16T09:55:00-04:00,512.47,513.06,511.07,511.3,NaN,NaN,NaN,514.6481311201045,NaN,NaN,512.9891,514.7729785720494,511.2052214279507,514.6072007601002,513.8113267684622,515.2788996735535,512.3437538633709,36433,18869.033333333333,30.88045608634617,60.14284087089519,NaN,NaN,NaN,NaN,1.0117088035506832,21.400521528236474,13024575,-0.32608117715728546,-0.05501894409690067,0.2710622330603848
2025-09-16T10:00:00-04:00,511.26,511.82,510.56,511.29,NaN,NaN,NaN,513.8275342510088,NaN,NaN,512.9639,514.8065104200829,511.12128957991706,514.6072007601002,513.4517091839291,515.0813882226593,511.82203014519894,41610,20074.566666666666,30.823640974939437,58.0517017817478,NaN,NaN,NaN,NaN,1.029443889011348,21.537332605108443,12982965,-0.38773195024201135,-0.2136027047421294,0.17412924549988196
2025-09-16T10:05:00-04:00,511.27,512.2,511.19,511.92,NaN,NaN,NaN,513.8275342510088,NaN,NaN,512.9549,514.8133536474945,511.09644635250544,514.6072007601002,513.3567021554807,514.9865981506606,511.7268061603007,17930,20480.266666666666,38.5003964217189,56.17842817404819,NaN,NaN,NaN,NaN,1.0280550397962551,21.168681904047304,13000895,-0.36743028579693193,-0.285158611746283,0.08227167405064896
2025-09-16T10:10:00-04:00,511.96,512.92,511.91,512.91,NaN,NaN,NaN,513.8275342510088,NaN,NaN,512.9573000000001,514.815205497965,511.0993945020352,514.6072007601002,513.2884808212957,514.8605992822598,511.7163623603316,30561,21346.1,48.2240110302837,54.64490029974979,NaN,NaN,NaN,NaN,1.0267653940965178,19.970153436430156,13031456,-0.2730148610687396,-0.2589969022852756,0.01401795878346404
2025-09-16T10:15:00-04:00,512.93,513.66,512.88,513.47,NaN,NaN,NaN,513.8275342510088,NaN,NaN,512.9707000000001,514.8335322628423,511.1078677371579,514.6072007601002,513.2915006065896,514.8136049111089,511.7693963020703,23263,22012.333333333332,52.772698210912594,53.454188472428356,NaN,NaN,NaN,NaN,1.0091392945181932,18.993270527446057,13054719,-0.16391511914342366,-0.19087594014581555,-0.02696082100239188
2025-09-16T10:20:00-04:00,513.51,514,513.12,513.89,510.903493149928,510.903493149928,510.903493149928,NaN,NaN,NaN,512.9895,514.870006580581,511.108993419419,512.9987606080801,513.3192032674598,514.7878594686101,511.85054706630945,29314,22825.1,55.90183220158443,52.486986215869194,NaN,NaN,NaN,NaN,0.9999150591954648,18.40876151335213,13084033,-0.0598915976533919,-0.10182531806913175,-0.04193372041573985
2025-09-16T10:25:00-04:00,513.79,513.83,513,513.37,510.903493149928,NaN,NaN,NaN,NaN,NaN,513.0005,514.8833449218653,511.11765507813476,511.15171888171244,513.3225748563644,514.7603523372084,511.8847973755205,17441,23228.6,51.36419039991348,50.952846087939896,NaN,NaN,NaN,NaN,0.9920639835386449,17.72361495853121,13066592,-0.02435493659940126,-0.07237739116499142,-0.048022454565590164
2025-09-16T10:30:00-04:00,513.34,513.55,512.17,512.6,510.903493149928,NaN,NaN,NaN,NaN,NaN,513.0075,514.8817147688304,511.1332852311697,511.15171888171244,513.3044145413435,514.721629388531,511.8871996941559,14292,23503.766666666666,45.477480561654765,49.36517665986924,NaN,NaN,NaN,NaN,1.01977369900017,16.746333980145465,13052300,-0.04950630947708411,-0.1099053414119453,-0.060399031934861194
2025-09-16T10:35:00-04:00,512.62,512.84,512.1,512.32,510.903493149928,NaN,NaN,NaN,NaN,NaN,513.0157,514.8741574355776,511.1572425644226,511.15171888171244,513.2704608773354,514.6705557680394,511.8703659866313,17257,23969.666666666668,43.52406939524387,46.92899895086725,NaN,NaN,NaN,NaN,0.9997898633573014,15.911639127292943,13035043,-0.07999379960962408,-0.1603912814468913,-0.08039748183726722
2025-09-16T10:40:00-04:00,512.33,512.92,511.89,512.74,510.903493149928,NaN,NaN,NaN,NaN,NaN,513.0293,514.8694456571766,511.18915434282343,511.15171888171244,513.2468185148472,514.6310314701651,511.86260555952924,14555,24176.4,47.188462227837285,44.7498133001478,NaN,NaN,NaN,NaN,1.0019477302603492,15.361488901957298,13049598,-0.06737297332612065,-0.16461369849491803,-0.09724072516879738
2025-09-16T10:45:00-04:00,512.71,513.41,512.7,513.25,510.903493149928,NaN,NaN,NaN,NaN,NaN,513.0535000000001,514.8726737134274,511.2343262865728,511.15171888171244,513.2447197845165,514.6175265661077,511.87191300292534,7809,24305.266666666666,51.31897449742854,44.4245351680786,NaN,NaN,NaN,NaN,0.981094320956033,14.272477045764791,13057407,-0.022497147650601207,-0.1253621597320489,-0.10286501208144769
2025-09-16T10:50:00-04:00,513.22,513.82,513.12,513.7,510.903493149928,NaN,NaN,NaN,NaN,NaN,513.0825000000001,514.8957338512946,511.26926614870564,511.4918585945277,513.2570055616208,514.6029162629052,511.91109486033633,20014,24766.4,54.68663597531756,45.1766022389341,NaN,NaN,NaN,NaN,0.9610161551734624,13.723787509200431,13077421,0.036465237546141324,-0.05728346514877103,-0.09374870269491235
2025-09-16T10:55:00-04:00,513.76,513.96,513.255,513.3,510.9669923055635,NaN,NaN,NaN,NaN,NaN,513.1029,514.9024600461668,511.3033399538332,511.74498687562215,513.2619797682776,514.5947777092055,511.9291818273497,10068,24900.166666666668,51.2901132136401,45.725498436528746,NaN,NaN,NaN,NaN,0.9427292869467895,13.369647797036674,13067353,0.04683777378848125,-0.03520148545931079,-0.08203925924779204
2025-09-16T11:00:00-04:00,513.32,513.64,513.04,513.31,510.9669923055635,NaN,NaN,NaN,NaN,NaN,513.1323,514.8960451176205,511.3685548823795,511.74498687562215,513.2632279423365,514.5837723726032,511.9426835120697,9383,25069.766666666666,51.37142800071479,46.666027799823965,NaN,NaN,NaN,NaN,0.918248623593449,12.752718906509022,13076736,0.05226987796282781,-0.016701911794257285,-0.0689717897570851
2025-09-16T11:05:00-04:00,513.26,513.43,513,513.3,510.9669923055635,NaN,NaN,NaN,NaN,NaN,513.1589,514.8915687968929,511.42623120310714,511.74498687562215,513.262952872661,514.5743384351292,511.9515673101928,7169,25173.1,51.27923909400241,48.12308372894227,NaN,NaN,NaN,NaN,0.8833737219081991,12.12468654556552,13069567,0.052925168250794144,-0.002815329443592418,-0.05574049769438656
2025-09-16T11:10:00-04:00,513.24,513.48,512.93,512.955,510.9669923055635,NaN,NaN,NaN,NaN,NaN,513.1834000000001,514.8685485867265,511.4982514132737,511.74498687562215,513.2607614384917,514.5620541917501,511.95946868523333,8169,25276.766666666666,48.0739264304853,49.355246975766974,NaN,NaN,NaN,NaN,0.8595613132004755,11.439721298251875,13061398,0.02905254819424906,-0.019424812451575235,-0.048477360645824294
2025-09-16T11:15:00-04:00,512.94,512.94,512.45,512.82,510.9669923055635,NaN,NaN,NaN,NaN,NaN,513.2058000000001,514.8405004127286,511.57109958727153,511.74498687562215,513.2540945460248,514.5484173711686,511.959771720881,6786,25128,46.84012234323823,49.950941684446924,NaN,NaN,NaN,NaN,0.8342355051147269,11.11475616699045,13054612,0.004393244077054603,-0.04298580554950604,-0.04737904962656064
2025-09-16T11:20:00-04:00,512.8,513.1,512.49,512.51,510.9669923055635,NaN,NaN,NaN,NaN,NaN,513.2188000000001,514.8204885587174,511.6171114412828,511.74498687562215,513.2427463374537,514.5261481246206,511.9593445502868,11154,25314.066666666666,44.044727581539405,49.65242143810804,NaN,NaN,NaN,NaN,0.8182186833208187,10.569109516349242,13043458,-0.030644561159439344,-0.08568475107585982,-0.05504018991642048
2025-09-16T11:25:00-04:00,512.53,513.02,512.46,512.57,510.9669923055635,NaN,NaN,NaN,NaN,NaN,513.2262000000001,514.81233563086,511.64006436914013,511.74498687562215,513.2329035360514,514.5070889958569,511.9587180762459,9754,25397,44.73222543046897,49.07810195379064,NaN,NaN,NaN,NaN,0.7997744916550421,10.106624397022879,13053212,-0.046668289418555164,-0.11337555168961444,-0.06670726227105928
2025-09-16T11:30:00-04:00,512.555,512.715,512.3,512.64,510.9669923055635,NaN,NaN,NaN,NaN,NaN,513.2356000000001,514.8020349840805,511.66916501591976,511.74498687562215,513.2239417439838,514.4920960347534,511.95578745321416,7390,24755.833333333332,45.57242182295482,48.34028692674566,NaN,NaN,NaN,NaN,0.7722905993939733,9.920385449825039,13060602,-0.04918982916914834,-0.1281945487324947,-0.07900471956334636
2025-09-16T11:35:00-04:00,512.63,512.83,512.53,512.69,510.9669923055635,NaN,NaN,NaN,NaN,NaN,513.2354000000001,514.8021110005308,511.6686889994695,511.74498687562215,513.2192206438976,514.4828269264063,511.95561436138894,4949,24413,46.201544429198336,47.971526500266016,NaN,NaN,NaN,NaN,0.738555556580123,9.54208063117727,13065551,-0.044280515168552415,-0.13435536352403687,-0.09007484835548446
2025-09-16T11:40:00-04:00,512.69,512.72,512.14,512.46,510.9669923055635,NaN,NaN,NaN,NaN,NaN,513.2270000000001,514.8057007313969,511.6482992686033,511.74498687562215,513.2098633613033,514.4687242196428,511.9510025029638,6888,24075.2,43.699280681454105,47.84451222310883,NaN,NaN,NaN,NaN,0.7272301596815457,9.797034883473769,13058663,-0.05273906196642923,-0.155998675813521,-0.10325961384709177
2025-09-16T11:45:00-04:00,512.45,512.83,512.45,512.56,510.9669923055635,NaN,NaN,NaN,NaN,NaN,513.2126000000002,514.8022015095456,511.6229984904548,511.70691328031853,513.2053847309603,514.4605677428742,511.9502017190464,4339,23365.5,45.091704364102,47.956486149455834,NaN,NaN,NaN,NaN,0.7024280054185779,9.82114041114125,13063002,-0.047952881883857434,-0.16320071620191356,-0.11524783431805613
2025-09-16T11:50:00-04:00,512.54,513.2,512.53,513.14,510.9669923055635,NaN,NaN,NaN,NaN,NaN,513.2120000000001,514.801688019527,511.6223119804732,511.8434760031717,513.2028143570899,514.4517480063323,511.9538807078475,6035,22652.166666666668,52.438906169261564,48.33151785955757,NaN,NaN,NaN,NaN,0.7001117193172561,9.15881885458568,13069037,-0.004374290104202622,-0.12071569694830941,-0.11634140684410679
2025-09-16T11:55:00-04:00,513.1,513.215,512.91,512.98,510.9669923055635,NaN,NaN,NaN,NaN,NaN,513.2080000000002,514.7989959141913,511.61700408580907,511.97728080253734,513.2014072247081,514.4451877981867,511.9576266512295,4938,19630.166666666668,50.434044222563344,48.268308554210066,NaN,NaN,NaN,NaN,0.6718894536517424,8.51661759271213,13064099,0.014019070668774461,-0.09881756850813872,-0.11283663917691318
2025-09-16T12:00:00-04:00,512.95,513.11,512.68,512.74,510.9669923055635,NaN,NaN,NaN,NaN,NaN,513.2016000000002,514.7974927780441,511.6057072219563,511.97728080253734,513.1974749570629,514.4349700400801,511.95997987404576,6539,17617.3,47.50042154010898,47.75500752312373,NaN,NaN,NaN,NaN,0.6546116355337653,8.339819613775745,13057560,0.010525240797364666,-0.09968008818020735,-0.11020532897757201
2025-09-16T12:05:00-04:00,512.72,513.3,512.6,513.24,510.9669923055635,NaN,NaN,NaN,NaN,NaN,513.2028000000001,514.7987162381562,511.606883761844,511.9858597136238,513.1962271212657,514.4286675723005,511.9637866702309,4968,16437.333333333332,53.560909731781535,47.917207274419546,NaN,NaN,NaN,NaN,0.6578536615670629,7.798924490727252,13062528,0.04069717826266772,-0.05933385614923736,-0.10003103441190508
2025-09-16T12:10:00-04:00,513.23,513.72,513.23,513.42,511.4066908666218,NaN,NaN,NaN,NaN,NaN,513.2034000000002,514.7996198341124,511.60718016588805,512.4236877708992,513.1997377848539,514.4242119230893,511.9752636466186,8204,15168.866666666667,55.55024660741976,48.21569431775561,NaN,NaN,NaN,NaN,0.6458641143122733,7.949046246431162,13070732,0.06987409413866832,-0.012688416738569686,-0.08256251087723801
2025-09-16T12:15:00-04:00,513.44,513.57,513.23,513.31,511.4066908666218,NaN,NaN,NaN,NaN,NaN,513.2000000000002,514.7945720426198,511.6054279573805,512.4236877708992,513.2018417795708,514.4188721179902,511.98481144115146,7615,14072.666666666666,54.027101902550285,48.41197023265189,NaN,NaN,NaN,NaN,0.6240166775756846,8.08844501958479,13063117,0.07823146791463345,0.015226824016053797,-0.06300464389857965
2025-09-16T12:20:00-04:00,513.36,513.59,513.3,513.38,511.47664395078544,NaN,NaN,NaN,NaN,NaN,513.2152000000001,514.8018366437366,511.6285633562636,512.4793601733754,513.2029169795518,514.4170873699965,511.9887465891071,3006,13261.1,54.87503596317462,48.89776377070113,NaN,NaN,NaN,NaN,0.6001583434631412,8.255295389630836,13066123,0.08441032284790675,0.04250825966130378,-0.041902063186602966
2025-09-16T12:25:00-04:00,513.32,513.38,513,513.3,511.47664395078544,NaN,NaN,NaN,NaN,NaN,513.2210000000001,514.8067137191999,511.6352862808003,512.4793601733754,513.2031161505524,514.4121865887797,511.99404571232515,5237,12221.233333333334,53.65699148503378,49.3846829951151,NaN,NaN,NaN,NaN,0.5844327475014879,7.73318769352584,13060886,0.0791347808168027,0.0570164128344004,-0.02211836798240229
2025-09-16T12:30:00-04:00,513.24,513.28,513.045,513.16,511.47664395078544,NaN,NaN,NaN,NaN,NaN,513.2206000000001,514.806364976056,511.63483502394416,512.4793601733754,513.2028012226099,514.4072750983587,511.99832734686106,4781,10993.6,51.50252575946815,49.91738286496716,NaN,NaN,NaN,NaN,0.560901836965667,7.248373404285487,13056105,0.06294697330591931,0.05656534864999685,-0.006381624655922461
2025-09-16T12:35:00-04:00,513.15,513.38,513.025,513.3,511.47664395078544,NaN,NaN,NaN,NaN,NaN,513.2217000000002,514.8076074496521,511.63579255034824,512.4793601733754,513.2030537948905,514.4027976913986,512.0033098983823,4975,10561.766666666666,53.512693673161074,50.54455916801658,NaN,NaN,NaN,NaN,0.5461945628966921,7.0254330486079235,13061080,0.05849363780073964,0.06673542259500209,0.00824178479426245
2025-09-16T12:40:00-04:00,513.33,513.34,512.82,513,511.47664395078544,NaN,NaN,NaN,NaN,NaN,513.2173000000001,514.8044221878316,511.63017781216865,512.4793601733754,513.2014879896444,514.3950390066748,512.0079369726141,6703,9766.5,48.84098716549265,50.778028121055,NaN,NaN,NaN,NaN,0.5443235226897842,6.721276185663308,13054377,0.03341560230780015,0.05001128767901264,0.01659568537121249
2025-09-16T12:45:00-04:00,512.98,513,512.64,512.89,511.47664395078544,NaN,NaN,NaN,NaN,NaN,513.2083000000001,514.7976389944903,511.61896100550996,512.4793601733754,513.1982776506426,514.3869468071799,512.0096084941052,5797,9184.3,47.21341495339461,50.850304587069026,NaN,NaN,NaN,NaN,0.5311575567833721,6.848057830927699,13048580,0.008774231697818179,0.027563474993485215,0.018789243295667037
2025-09-16T12:50:00-04:00,512.84,513,512.665,512.77,511.47664395078544,NaN,NaN,NaN,NaN,NaN,513.1979000000001,514.7917633439167,511.6040366560835,512.4793601733754,513.1940753123486,514.376946069288,512.0112045554091,7107,8444.066666666668,45.4346590642557,50.974260185840556,NaN,NaN,NaN,NaN,0.5171463027274196,6.965783644387491,13041473,-0.014959879344822662,0.00008939411463870783,0.01504927345946137
2025-09-16T12:55:00-04:00,512.75,513.81,512.74,513.4,511.47664395078544,NaN,NaN,NaN,NaN,NaN,513.1985000000002,514.7926445978135,511.60435540218685,512.4954713866314,513.1959151088407,514.3699709280793,512.0218592896022,9962,8194.766666666666,55.01648562765742,51.68317313323738,NaN,NaN,NaN,NaN,0.5566358525325994,7.683954267990092,13051435,0.011016188106708048,0.028819508592846432,0.017803320486138384
2025-09-16T13:00:00-04:00,513.38,513.83,513.38,513.8,511.8024105922139,NaN,NaN,NaN,NaN,NaN,513.2057000000002,514.80737663374,511.6040233662605,512.5533771093052,513.2015369561282,514.3697386129986,512.0333352992577,7966,7983.9,59.83866834595156,52.21172757442952,NaN,NaN,NaN,NaN,0.5490190059231312,8.387662893995007,13059401,0.05208475321394375,0.08290926200356807,0.03082450878962432
2025-09-16T13:05:00-04:00,513.76,513.9,513.63,513.68,512.0075282925678,NaN,NaN,NaN,NaN,NaN,513.2041000000003,514.8037170663098,511.6044829336907,512.7437016874441,513.2083834481314,514.37064502815,512.0461218681128,8706,7698.866666666667,57.83561918723456,52.740411500477464,NaN,NaN,NaN,NaN,0.5290890769286206,9.175928556569389,13050695,0.06715622454244988,0.11476978946768668,0.047613564925236794
2025-09-16T13:10:00-04:00,513.74,513.9,513.585,513.9,512.0219588247239,NaN,NaN,NaN,NaN,NaN,513.1985000000002,514.7863290206819,511.61067097931846,512.8174613499554,513.2139229157145,514.3720743019231,512.0557715295059,6487,7429.933333333333,60.449511309707596,53.665346484020226,NaN,NaN,NaN,NaN,0.5137970000051435,9.774826895848628,13057182,0.08668809278439558,0.15597368090573127,0.06928558812133569
2025-09-16T13:15:00-04:00,513.915,514.2,513.77,513.8,512.2840288781455,NaN,NaN,NaN,NaN,NaN,513.1911000000003,514.7641292934975,511.6180707065032,513.1189690799642,513.2287447448775,514.3792165604292,512.0782729293259,14659,7658.266666666666,58.66912778344033,54.030219201995855,NaN,NaN,NaN,NaN,0.5078115000047807,10.92400005632002,13042523,0.087372526471003,0.17850124621008945,0.09112871973908644
2025-09-16T13:20:00-04:00,513.81,514.12,513.74,514.03,512.2840288781455,NaN,NaN,NaN,NaN,NaN,513.1883000000003,514.7548345316311,511.6217654683694,513.1189690799642,513.2377951388646,514.3840258135542,512.091564464175,8752,7282.866666666667,61.479266994771834,54.45372065823529,NaN,NaN,NaN,NaN,0.49868210714729605,11.89462725512933,13051275,0.09706856356745205,0.2124644241984015,0.11539586063094945
2025-09-16T13:25:00-04:00,514.04,514.07,513.54,513.54,512.2840288781455,NaN,NaN,NaN,NaN,NaN,513.1697000000003,514.6965011130739,511.6428988869266,513.1189690799642,513.2463465461979,514.3840656628045,512.1086274295913,12916,7377.8,53.18306108615736,54.39343202849294,NaN,NaN,NaN,NaN,0.500919099493924,12.15980809949919,13038359,0.06573465997075062,0.1975641855943877,0.1318295256236371
2025-09-16T13:30:00-04:00,513.56,513.84,513.4,513.81,512.2840288781455,NaN,NaN,NaN,NaN,NaN,513.1603000000002,514.6652736339327,511.6553263660678,513.1189690799642,513.2522223654413,514.383386840862,512.1210578900206,9858,7393.633333333333,56.65403896201343,54.520503671267136,NaN,NaN,NaN,NaN,0.49656773524436193,11.983590031695332,13048217,0.05867816134759188,0.20517722730812693,0.14649906596053505
2025-09-16T13:35:00-04:00,513.82,513.89,513.32,513.32,512.2840288781455,NaN,NaN,NaN,NaN,NaN,513.1189000000003,514.4835996588308,511.75420034116974,513.1189690799642,513.256875766509,514.378309149312,512.1354423837059,13478,7603.933333333333,49.48386858777453,54.22242346432005,NaN,NaN,NaN,NaN,0.5018128970126172,11.580814235928028,13034739,0.018573019247973943,0.16971534002050248,0.15114232077252854
2025-09-16T13:40:00-04:00,513.27,513.28,513.06,513.08,512.2840288781455,NaN,NaN,NaN,NaN,NaN,513.0725000000003,514.2715166798312,511.8734833201695,513.1189690799642,513.2550509671094,514.3677896936829,512.1423122405358,11842,7726.366666666667,46.38718747786142,53.85704215849099,NaN,NaN,NaN,NaN,0.4845405472260092,11.033559021492854,13022897,-0.02423191021803736,0.12085243299998183,0.1450843432180192
2025-09-16T13:45:00-04:00,513.12,513.34,512.85,512.99,512.2840288781455,NaN,NaN,NaN,NaN,NaN,513.0487000000003,514.2053309865046,511.892069013496,513.1189690799642,513.2518098919674,514.3555466058189,512.1480731781159,12816,7927.366666666667,45.24376293656181,53.266404248733906,NaN,NaN,NaN,NaN,0.4849305081384378,11.056924291107428,13010081,-0.056857229969559664,0.07401280575606961,0.13087003572562927
2025-09-16T13:50:00-04:00,512.96,512.96,512.42,512.44,512.2840288781455,NaN,NaN,NaN,NaN,NaN,513.0353000000002,514.2042386805808,511.86636131941964,513.1189690799642,513.2389836650892,514.335398274727,512.1425690554514,15645,8077.066666666667,38.92861806177299,52.558377884182505,NaN,NaN,NaN,NaN,0.49100690041426726,12.002200712967612,12994436,-0.11061843061982649,-0.007403002549153825,0.10321542807067266
2025-09-16T13:55:00-04:00,512.45,512.76,512.285,512.33,512.2840288781455,NaN,NaN,NaN,NaN,NaN,513.0209000000002,514.2063816569856,511.83541834301485,513.1189690799642,513.2287644319644,514.3215871961218,512.135941667807,10438,8099.866666666667,37.79244555728166,51.885451498745866,NaN,NaN,NaN,NaN,0.4898635503846784,13.134135828812424,12983998,-0.1464770471140269,-0.07988088082186096,0.06659616629216594
2025-09-16T14:00:00-04:00,512.28,512.28,511.72,511.96,NaN,NaN,NaN,513.6173594143627,513.6173594143627,513.6173594143627,513.0117000000002,514.2225602062679,511.8008397937327,513.1189690799642,513.201169502832,514.2971820627696,512.1051569428945,18117,8457.433333333332,34.17894847847026,51.08147217118976,NaN,NaN,NaN,NaN,0.49844472535720236,15.086131821941379,12965881,-0.18549364453277345,-0.16527088937380086,0.02022275515897258
2025-09-16T14:05:00-04:00,511.94,512.45,511.89,512.2,NaN,NaN,NaN,513.6173594143627,NaN,NaN,513.0297000000003,514.1624849041524,511.8969150958482,513.0651752639714,513.1850173307506,514.2797667461294,512.0902679153718,13106,8729.333333333334,38.299946922093206,49.88743369222089,NaN,NaN,NaN,NaN,0.502841530688835,16.3608535680503,12978987,-0.1850927362399179,-0.2111431651409248,-0.0260504289010069
2025-09-16T14:10:00-04:00,512.18,512.31,511.62,511.71,NaN,NaN,NaN,513.6056518630866,NaN,NaN,513.0381000000002,514.1244349202557,511.95176507974475,512.9611402111772,513.1618808651634,514.2604648903639,512.063296839963,14955,8998.233333333334,33.665553347902545,48.01792547807453,NaN,NaN,NaN,NaN,0.5162099927824854,17.946881600278555,12964032,-0.2061717460869047,-0.2837651115096378,-0.07759336542273308
2025-09-16T14:15:00-04:00,511.69,511.69,511.42,511.56,NaN,NaN,NaN,513.1606222329464,NaN,NaN,513.0309000000002,514.151028010134,511.9107719898664,512.7329121689417,513.1333762056692,514.2426097627794,512.024142648559,15250,9361.933333333332,32.37411834417949,46.19924684642774,NaN,NaN,NaN,NaN,0.5000521361551623,19.69517107210185,12948782,-0.21744104314952548,-0.3493946693596399,-0.13195362621011444
2025-09-16T14:20:00-04:00,511.58,511.79,511.58,511.7,NaN,NaN,NaN,513.1606222329464,NaN,NaN,513.0067000000003,514.1869027109972,511.82649728900327,512.7193297351533,513.1149567493704,514.2289336055271,512.0009798932138,11101,9530.8,34.8847943542858,44.373195635326184,NaN,NaN,NaN,NaN,0.4807626978583663,20.985863332731007,12959883,-0.20296833248277557,-0.38566404181358394,-0.18269570933080836
2025-09-16T14:25:00-04:00,511.74,511.82,511.36,511.45,NaN,NaN,NaN,513.1456392659697,NaN,NaN,512.9663000000002,514.2165172768339,511.7160827231664,512.2417710304982,513.0914701724705,514.2134149173365,511.9695254276045,13197,9806.1,32.56012868642351,42.50826712839641,NaN,NaN,NaN,NaN,0.47927964801133865,22.50405311917205,12946686,-0.19754599648776416,-0.42962820494051357,-0.2320822084527494
2025-09-16T14:30:00-04:00,511.45,511.8,511.41,511.65,NaN,NaN,NaN,513.1431102084256,NaN,NaN,512.9215000000002,514.1963996036228,511.64660039637744,512.2417710304982,513.0700694121292,514.1976710488277,511.9424677754307,13033,10022.566666666668,36.22173545730129,40.704157732862804,NaN,NaN,NaN,NaN,0.4729025302962421,23.91380077801016,12959719,-0.16891231181163208,-0.4432225982172895,-0.2743102864056574
2025-09-16T14:35:00-04:00,511.65,511.88,511.35,511.39,NaN,NaN,NaN,513.1431102084256,NaN,NaN,512.8819000000002,514.2200493037292,511.5437506962712,511.7964168243985,513.0508158547841,514.1842064991467,511.91742521042147,11420,10237.633333333333,33.662942862408016,39.30986357402356,NaN,NaN,NaN,NaN,0.47698092098936573,24.923779141329646,12948299,-0.15620236855641623,-0.4695632471011777,-0.31336087854476147
2025-09-16T14:40:00-04:00,511.39,511.589,511.29,511.44,NaN,NaN,NaN,512.9507202518919,NaN,NaN,512.8587000000002,514.254572214416,511.4628277855844,511.59163345951873,513.0289832218849,514.1699766882441,511.8879897555257,12467,10379.733333333334,34.619466334647896,37.73596552921174,NaN,NaN,NaN,NaN,0.46426799806155233,25.964373323520213,12960766,-0.13399990157945058,-0.4808607555190747,-0.3468608539396241
2025-09-16T14:45:00-04:00,511.43,511.63,511.31,511.48,NaN,NaN,NaN,512.9507202518919,NaN,NaN,512.8419000000002,514.2827954017823,511.4010045982181,511.17824541409203,513.0021869712957,514.1512774117627,511.8530965308287,16125,10663.4,35.421699682417525,36.731524893114816,NaN,NaN,NaN,NaN,0.45396314105715524,26.76322113128398,12976891,-0.10734435839822837,-0.48104130193740957,-0.3736969435391812
2025-09-16T14:50:00-04:00,511.48,511.48,510.34,510.66,NaN,NaN,NaN,512.4840663865378,NaN,NaN,512.8003000000002,514.365318095408,511.23528190459245,511.17824541409203,512.9228608754931,514.1222547288259,511.72346702216043,35426,11744.066666666668,27.87159987224298,35.40898292128493,NaN,NaN,NaN,NaN,0.5029657738387902,28.850812757541895,12941465,-0.13393357231926084,-0.5411139089382573,-0.40718033661899644
2025-09-16T14:55:00-04:00,510.655,510.69,510.27,510.62,NaN,NaN,NaN,512.0397906416953,NaN,NaN,512.7477000000002,514.4217169769145,511.07368302308595,510.94759633127353,512.8556958953636,514.1025529801794,511.6088388105478,28018,12503.433333333332,27.56296847360626,34.146069031073814,NaN,NaN,NaN,NaN,0.4970396471360206,30.860860525726125,12913447,-0.14241867845820166,-0.5852036846917485,-0.4427850062335469
2025-09-16T15:00:00-04:00,510.59,510.7,510.24,510.31,NaN,NaN,NaN,512.0216183398,NaN,NaN,512.6799000000002,514.4650571245057,510.8947428754946,510.7470955658318,512.813859175121,514.0898984665682,511.5378198836738,17445,12925.566666666668,25.23111608103406,33.167676032449606,NaN,NaN,NaN,NaN,0.4943939580548748,32.75927797955985,12896002,-0.1560178455436264,-0.6378073131630799,-0.4817894676194535
2025-09-16T15:05:00-04:00,510.315,510.56,510.28,510.36,NaN,NaN,NaN,511.93927205162726,NaN,NaN,512.6211000000002,514.5112717274012,510.7309282725992,510.7470955658318,512.7496866245915,514.0671743330253,511.43219891615774,27776,13685.6,26.313929080993887,32.347781998429056,NaN,NaN,NaN,NaN,0.47908010390810013,34.52209418669116,12923778,-0.1487795609408038,-0.6677639187954583,-0.5189843578546545
2025-09-16T15:10:00-04:00,510.39,510.47,510.12,510.13,NaN,NaN,NaN,511.79294150382606,NaN,NaN,512.5575000000002,514.561258717729,510.5537412822716,510.7470955658318,512.6911846552507,514.0471755440705,511.33519376643096,24936,14293.366666666667,24.552478672237655,31.66017701226958,NaN,NaN,NaN,NaN,0.46986009648609456,36.34271356210338,12898842,-0.14639005530244265,-0.7019719269827078,-0.5555818716802652
2025-09-16T15:15:00-04:00,510.17,510.51,510,510.33,NaN,NaN,NaN,511.7543987081976,NaN,NaN,512.4981000000002,514.584669327564,510.41153067243647,510.7470955658318,512.6178433525818,514.0157859329867,511.21990077217686,33559,15218.766666666666,29.003006510249946,30.99610983999506,NaN,NaN,NaN,NaN,0.4727272324513728,38.16622095259228,12932401,-0.11938968422727692,-0.7048189769643614,-0.5854292927370844
2025-09-16T15:20:00-04:00,510.32,510.64,510.205,510.455,NaN,NaN,NaN,511.7543987081976,NaN,NaN,512.4481000000003,514.6070375995442,510.28916240045635,510.7470955658318,512.5644294357703,513.9857985038394,511.1430603677012,27653,15903.633333333333,31.714206814121155,30.856727944724962,NaN,NaN,NaN,NaN,0.47003243013341783,39.26403089678651,12960054,-0.08289331510169784,-0.6890459366142068,-0.6061526215125089
2025-09-16T15:25:00-04:00,510.47,510.67,510.25,510.37,NaN,NaN,NaN,511.7543987081976,NaN,NaN,512.3991000000002,514.6319955996876,510.1662044003129,510.6253411621323,512.5304601601991,513.965551927921,511.0953683924773,18290,16181.233333333334,30.85144531377894,30.74796558541064,NaN,NaN,NaN,NaN,0.4664586851238891,40.14483955073461,12941764,-0.05557101711212753,-0.6756163929026684,-0.6200453757905409
2025-09-16T15:30:00-04:00,510.39,510.53,510,510.32,NaN,NaN,NaN,511.75007855340135,NaN,NaN,512.3553000000002,514.662457913813,510.04814208618734,510.6253411621323,512.4675896829525,513.9301876873036,511.0049916786014,33079,17018.333333333332,30.328775354739832,30.42253565687164,NaN,NaN,NaN,NaN,0.4709973504721808,41.31489941307214,12908685,-0.03307085336541482,-0.6613839424973094,-0.6283130891318945
2025-09-16T15:35:00-04:00,510.36,510.38,509.6,509.72,NaN,NaN,NaN,511.51393861915585,NaN,NaN,512.2983000000003,514.7194316442635,509.87716835573707,510.1062729297059,512.3900521732282,513.8959289352318,510.88417541122465,36816,17955.333333333332,24.881343756078564,29.87405101898986,NaN,NaN,NaN,NaN,0.4930689682955945,42.86501508767223,12871869,-0.04979694564053616,-0.6905592711825648,-0.6407623255420286
2025-09-16T15:40:00-04:00,509.74,510.1,509.26,509.28,NaN,NaN,NaN,511.24921413646695,NaN,NaN,512.2311000000002,514.7929909342868,509.6692090657136,509.5573479127078,512.2786188756609,513.8544439510391,510.7027938002826,49727,19396.666666666668,21.790417945794886,28.84324262531083,NaN,NaN,NaN,NaN,0.5178497562744828,44.62203513081312,12822142,-0.0799081623329122,-0.7406475284581688,-0.6607393661252566
2025-09-16T15:45:00-04:00,509.3,509.6,509.09,509.56,NaN,NaN,NaN,510.9124316757185,NaN,NaN,512.1685000000002,514.8333724170311,509.5036275829694,509.5573479127078,512.1805688731998,513.814322350894,510.54681539550563,45013,20408.466666666667,27.92635992758059,28.43348670139459,NaN,NaN,NaN,NaN,0.5172890593977375,46.39487028420769,12867155,-0.07069959114714885,-0.7491138550591927,-0.6784142639120438
2025-09-16T15:50:00-04:00,509.57,510.24,508.91,508.96,NaN,NaN,NaN,510.9124316757185,NaN,NaN,512.0985000000002,514.9089634847526,509.28803651524777,509.5573479127078,512.0517661439023,513.7524270209606,510.3511052668441,63104,22220.2,23.64536090229575,27.649622027655145,NaN,NaN,NaN,NaN,0.5753398408693265,45.64746039092316,12804051,-0.09332727267846119,-0.7950733547601203,-0.7017460820816591
2025-09-16T15:55:00-04:00,508.97,509.95,508.62,509.15,NaN,NaN,NaN,510.9124316757185,NaN,NaN,512.0303000000002,514.9558005791948,509.10479942080565,509.5573479127078,511.7758954853085,513.5947026941409,509.95708827647616,149796,26782.866666666665,27.43871012158864,27.079408487595938,NaN,NaN,NaN,NaN,0.6292441379500878,45.3562203450338,12953847,-0.0840944540372871,-0.806864149628268,-0.7227696955909809
2025-09-17T09:30:00-04:00,510.61,510.83,508.93,509.02,NaN,NaN,NaN,510.9124316757185,NaN,NaN,511.94790000000023,514.9740910645174,508.921708935483,509.5573479127078,509.5933333333333,509.5933333333333,509.5933333333333,51559,28172.9,26.469737585377842,26.97927546710557,NaN,NaN,NaN,NaN,0.7200124138107942,42.82698676999775,12902288,-0.07560607488847126,-0.8172772892015701,-0.7416712143130988
2025-09-17T09:35:00-04:00,509.005,509.69,507.56,507.65,NaN,NaN,NaN,510.7870516431827,NaN,NaN,511.8413000000003,515.0824286982638,508.60017130173674,509.5573479127078,508.9708008745105,509.61701702852065,508.3245847205003,47849,29318.6,18.896382173655667,26.36023358853767,NaN,NaN,NaN,NaN,0.8207258128243086,42.231003924785284,12854439,-0.14699085244833598,-0.9254097798735188,-0.7784189274251828
2025-09-17T09:40:00-04:00,507.7,508.05,506.8,507.24,NaN,NaN,NaN,509.6592311139471,NaN,NaN,511.73130000000026,515.2077434755572,508.2548565244433,509.5573479127078,508.56790703342705,509.4613526254718,507.6744614413823,33249,30032.166666666668,17.30102305034211,25.793798372059676,NaN,NaN,NaN,NaN,0.8513882547654293,42.332704990634916,12821190,-0.20309649008470054,-1.0322895400310586,-0.829193049946358
2025-09-17T09:45:00-04:00,507.28,507.98,506.4,507.6,NaN,NaN,NaN,509.5381296996768,NaN,NaN,511.61850000000027,515.2541678889351,507.98283211106553,509.37487833016627,508.34616529420265,509.2851582198752,507.4071723685301,28853,30566.733333333334,23.415039678444515,25.586734843306147,NaN,NaN,NaN,NaN,0.9034319508536158,42.723005263060294,12850043,-0.1970818094653597,-1.0755453117780576,-0.8784635023126979
2025-09-17T09:50:00-04:00,507.67,507.91,506.36,506.53,NaN,NaN,NaN,509.5381296996768,NaN,NaN,511.4807000000003,515.3477298729971,507.6136701270035,509.06590266413303,508.1777719666603,509.17083463012426,507.18470930319637,21855,30773.733333333334,18.93436691299084,25.18544114621709,NaN,NaN,NaN,NaN,0.9496153829355013,43.114715027743685,12828188,-0.243256686280654,-1.1825343601635154,-0.9392776738828614
2025-09-17T09:55:00-04:00,506.54,506.73,505.94,506.5,NaN,NaN,NaN,508.7839983420609,NaN,NaN,511.34450000000027,515.4183926101041,507.27060738989644,508.62872213130646,507.97637466689895,509.06933850314584,506.88341083065205,23279,31201.766666666666,18.825594393747465,24.458483137895485,NaN,NaN,NaN,NaN,0.9382142841543956,43.780221955213605,12804909,-0.2527976017090805,-1.2552746760192122,-1.0024770743101317
2025-09-17T10:00:00-04:00,506.5,506.8,505.92,506.24,NaN,NaN,NaN,508.7839983420609,NaN,NaN,511.2017000000002,515.4758135266912,506.92758647330913,508.4293821640361,507.72111541836034,508.8907845152054,506.5514463215153,37647,31852.766666666666,17.867582352842874,23.469438533518463,NaN,NaN,NaN,NaN,0.9340561210005098,44.24108031873221,12767262,-0.2529787951136915,-1.318700568202246,-1.0657217730885544
2025-09-17T10:05:00-04:00,506.17,506.76,506.04,506.37,NaN,NaN,NaN,508.7839983420609,NaN,NaN,511.06310000000025,515.5023120425517,506.62388795744874,508.4293821640361,507.6169397270025,508.7954433946821,506.4384360593229,20742,32107.3,20.058122915392687,22.698486933633735,NaN,NaN,NaN,NaN,0.9187663980718999,44.669020227713766,12788004,-0.2218185188887336,-1.3429949216994714,-1.1211764028107378
2025-09-17T10:10:00-04:00,506.39,507.46,506.08,507.46,NaN,NaN,NaN,508.7839983420609,NaN,NaN,510.94910000000027,515.4592493055774,506.4389506944232,508.1892045849831,507.56791642787755,508.71087289899657,506.4249599567585,22878,32371.4,35.57369363175421,23.073123953420474,NaN,NaN,NaN,NaN,0.9517116553524781,43.52800733092822,12810882,-0.11087696331598673,-1.2597726069557211,-1.1488956436397344
2025-09-17T10:15:00-04:00,507.4,507.63,506.95,507.39,NaN,NaN,NaN,508.7839983420609,NaN,NaN,510.83090000000016,515.3978244310674,506.26397556893284,508.1892045849831,507.5574720757385,508.67685150462256,506.4380926468544,12843,32291.166666666668,35.10251255283609,23.80320743890315,NaN,NaN,NaN,NaN,0.9323036799701587,42.13628508971328,12798039,-0.029521566134632193,-1.1857976013080247,-1.1562760351733925
2025-09-17T10:20:00-04:00,507.38,508.21,507.28,508.15,NaN,NaN,NaN,508.7839983420609,NaN,NaN,510.73390000000023,515.3184110054098,506.1493889945907,506.5123636679865,507.57694398448706,508.66472321951727,506.48916474945685,19324,32565.266666666666,43.80523229079348,25.375694177831626,NaN,NaN,NaN,NaN,0.9321391314008621,39.80538142412385,12817363,0.08206096238200278,-1.053699832195889,-1.1357607945778918
2025-09-17T10:25:00-04:00,508.16,508.39,507.9,508.205,NaN,NaN,NaN,508.7839983420609,NaN,NaN,510.64020000000016,515.236105551582,506.0442944484184,506.0867864504855,507.597999381459,508.6717010292688,506.5242977336492,11886,32521.566666666666,44.38645354328587,26.551415150382002,NaN,NaN,NaN,NaN,0.9005577648722297,37.34609639094387,12829249,0.16156144417254903,-0.9338089893622055,-1.0953704335347545
2025-09-17T10:30:00-04:00,508.12,508.64,507.74,507.79,NaN,NaN,NaN,508.7839983420609,NaN,NaN,510.5406000000002,515.1633345325976,505.9178654674029,506.3474291603884,507.61536617318006,508.6721768078816,506.5585555384785,13064,32522.6,40.945185223988496,27.78711688764577,NaN,NaN,NaN,NaN,0.9005179245242116,34.69633062819783,12816185,0.18642344077784445,-0.8623411325624488,-1.0487645733402933
2025-09-17T10:35:00-04:00,507.79,507.83,507.16,507.58,NaN,NaN,NaN,508.7839983420609,NaN,NaN,510.42420000000027,515.0461690001927,505.8022309998079,506.3474291603884,507.61310438641374,508.65694548342384,506.56926328940364,8693,32431.7,39.28538805816837,28.633308168830034,NaN,NaN,NaN,NaN,0.8840523584867651,33.042810353167,12807492,0.1883935107993242,-0.813272684841138,-1.0016661956404622
2025-09-17T10:40:00-04:00,507.62,507.91,507.3,507.43,NaN,NaN,NaN,508.7839983420609,NaN,NaN,510.29680000000025,514.8906231396896,505.70297686031086,506.3474291603884,507.6119778946256,508.64696722233293,506.5769885669183,6101,32219.5,38.09742098555026,29.463856983128064,NaN,NaN,NaN,NaN,0.8644771900234257,31.370524994600853,12801391,0.17931176331237142,-0.777526491499998,-0.9568382548123694
2025-09-17T10:45:00-04:00,507.43,507.96,507.23,507.79,NaN,NaN,NaN,508.7839983420609,NaN,NaN,510.17900000000026,514.7215481834147,505.6364518165858,506.3474291603884,507.61282806498366,508.63863444353393,506.5870216864334,6485,31898.166666666668,42.58483268312592,31.15588916237594,NaN,NaN,NaN,NaN,0.854871676450321,29.920514143906402,12807876,0.19591735169785918,-0.7119415651900454,-0.9078589168879045
2025-09-17T10:50:00-04:00,507.75,507.75,507.07,507.26,NaN,NaN,NaN,508.7839983420609,NaN,NaN,510.0462000000002,514.533758159957,505.5586418400435,506.3474291603884,507.6079238287471,508.62433074071583,506.5915169167784,7246,30958.833333333332,38.19496580736023,32.64831364502009,NaN,NaN,NaN,NaN,0.8452379852753001,28.813754380613148,12800630,0.170508516107021,-0.6947232717541283,-0.8652317878611493
2025-09-17T10:55:00-04:00,507.33,507.8,507.2,507.26,NaN,NaN,NaN,508.7839983420609,NaN,NaN,509.9154000000002,514.3384640238455,505.49233597615495,506.3474291603884,507.6044026573081,508.6115646170232,506.59724069759307,7133,30262.666666666668,38.19496580736023,33.70402265422835,NaN,NaN,NaN,NaN,0.8277209863270661,27.68356344544611,12800630,0.15353256509506608,-0.6733160814923167,-0.8268486465873828
2025-09-17T11:00:00-04:00,507.29,507.35,506.99,506.99,NaN,NaN,NaN,508.7839983420609,NaN,NaN,509.7746000000002,514.1121614530524,505.437038546948,506.3474291603884,507.5965500866013,508.59759185163875,506.5955083215639,6144,29885.966666666667,36.00224542059936,34.92315683334325,NaN,NaN,NaN,NaN,0.7943123444465624,26.96766329317332,12794486,0.1251513891654582,-0.67040941013056,-0.7955607992960182
2025-09-17T11:05:00-04:00,507.03,507.55,506.96,507.55,NaN,NaN,NaN,508.7839983420609,NaN,NaN,509.65480000000025,513.8996415563909,505.4099584436097,506.3474291603884,507.5931270304896,508.58751227113703,506.59874178984217,5522,29144.166666666668,43.275915085265126,36.6696083113088,NaN,NaN,NaN,NaN,0.7797186055575246,25.864398769215462,12800008,0.1437928429904718,-0.6158197455579284,-0.7596125885484002
2025-09-17T11:10:00-04:00,507.54,507.81,507.3,507.79,NaN,NaN,NaN,508.7839983420609,NaN,NaN,509.53440000000023,513.6402054701796,505.4285945298208,506.3474291603884,507.59394225647065,508.5782110696366,506.6096734433047,8120,28583.633333333335,46.10313900935086,38.686433786773655,NaN,NaN,NaN,NaN,0.7604529908748436,24.29767881742679,12808128,0.1701805689558059,-0.5468868773536428,-0.7170674463094487
2025-09-17T11:15:00-04:00,507.74,507.85,507.41,507.51,NaN,NaN,NaN,508.7839983420609,NaN,NaN,509.41820000000024,513.4163274415713,505.4200725584291,506.3806421810283,507.5938749885459,508.5697103648041,506.6180396122877,6952,27696.733333333334,43.38622410090549,40.352726728596,NaN,NaN,NaN,NaN,0.7375634915266404,22.76007510958272,12801176,0.16646715890388364,-0.5089834976795942,-0.6754506565834778
2025-09-17T11:20:00-04:00,507.51,507.78,507.31,507.32,NaN,NaN,NaN,508.7839983420609,NaN,NaN,509.30300000000017,513.2031835853235,505.40281641467686,506.3806421810283,507.5928482977913,508.56469623234614,506.6210003632365,3405,26888.466666666667,41.59493278431366,40.782815239493104,NaN,NaN,NaN,NaN,0.7184518135604497,21.534750821420896,12797771,0.1494457804589039,-0.488643431009848,-0.6380892114687519
2025-09-17T11:25:00-04:00,507.37,507.44,506.98,507.07,NaN,NaN,NaN,508.7839983420609,NaN,NaN,509.1846000000002,512.9881172352698,505.3810827647306,506.3806421810283,507.585067099417,508.5497740074777,506.6203601913563,7580,26531.466666666667,39.295962352608804,41.082347368048296,NaN,NaN,NaN,NaN,0.6999909697347019,21.029883834259046,12790191,0.12080583703541314,-0.4870819151744854,-0.6078877522098985
2025-09-17T11:30:00-04:00,507.11,507.48,507.11,507.32,NaN,NaN,NaN,508.7839983420609,NaN,NaN,509.08220000000017,512.8044477939093,505.35995220609107,506.3806421810283,507.5815141210405,508.5406340984464,506.62239414363466,5344,25606.966666666667,42.70620463467579,41.00384539261132,NaN,NaN,NaN,NaN,0.6792773290393679,20.462102263188676,12795535,0.11801844630169345,-0.4603646943327817,-0.5783831406344752
2025-09-17T11:35:00-04:00,507.36,507.42,506.99,507.02,NaN,NaN,NaN,508.7839983420609,NaN,NaN,508.9760000000002,512.6237900157458,505.3282099842546,506.3806421810283,507.57627391683485,508.530830678138,506.6217171555317,5129,24550.733333333334,39.81561144504187,40.677356671308175,NaN,NaN,NaN,NaN,0.6614718055365564,20.168551790152755,12790406,0.09621235136338835,-0.4581177014302398,-0.5543300527936281
2025-09-17T11:40:00-04:00,507.01,507.1,506.82,507.1,NaN,NaN,NaN,508.7839983420609,NaN,NaN,508.8788000000002,512.4617862181061,505.2958137818943,506.3806421810283,507.5669541255366,508.5164233795377,506.6174848715355,7134,23130.966666666667,40.96316375068553,40.67864085178654,NaN,NaN,NaN,NaN,0.6342238194268044,20.220424810903808,12797540,0.08766023745290341,-0.4447547559774989,-0.5324149934304023
2025-09-17T11:45:00-04:00,507.08,507.42,506.92,507.295,NaN,NaN,NaN,508.7839983420609,NaN,NaN,508.7807000000002,512.2617257165105,505.29967428348994,506.3806421810283,507.56201408677913,508.5057767380596,506.6182514354987,6148,21835.466666666667,43.777204491673494,40.99948488275118,NaN,NaN,NaN,NaN,0.6246364037534613,19.41226479419008,12803688,0.0950030139473329,-0.4136612259962362,-0.5086642399435691
2025-09-17T11:50:00-04:00,507.295,508.04,507.14,507.91,NaN,NaN,NaN,508.7839983420609,NaN,NaN,508.7047000000002,512.0912353444295,505.31816465557085,506.66123509112276,507.5654224981096,508.49740405324707,506.6334409429722,11483,20114.766666666666,51.611107263558814,41.96474818832322,NaN,NaN,NaN,NaN,0.6443052320567879,18.723149280144497,12815171,0.13851036705262815,-0.33552628112778393,-0.4740366481804121
2025-09-17T11:55:00-04:00,507.915,508.33,507.66,508.28,NaN,NaN,NaN,508.7839983420609,NaN,NaN,508.63910000000016,511.92750672047674,505.35069327952357,506.8919880728982,507.58411252383564,508.50449175621793,506.66373329145335,16760,15680.233333333334,55.61779848063212,42.89567431671652,NaN,NaN,NaN,NaN,0.6461405726241573,18.59561943972374,12831931,0.18645322803150444,-0.24097011314103156,-0.427423341172536
2025-09-17T12:00:00-04:00,508.29,508.46,507.96,508.25,NaN,NaN,NaN,508.7839983420609,NaN,NaN,508.57010000000014,511.7414022497403,505.39879775026,507.05959045831855,507.58822768795335,508.50706285471426,506.66939252119244,3048,14063.2,55.2185626592584,44.111645520423544,NaN,NaN,NaN,NaN,0.6357019602938603,18.69646945019352,12828883,0.20871090527171632,-0.16653470958289063,-0.37524561485460695
2025-09-17T12:05:00-04:00,508.29,508.44,507.62,507.7,NaN,NaN,NaN,508.7839983420609,NaN,NaN,508.49510000000015,511.5662102160674,505.4239897839329,507.05959045831855,507.59334224776853,508.50598335972904,506.680701135808,7413,12715.333333333334,48.364217212323986,44.83802062077809,NaN,NaN,NaN,NaN,0.6488661059871556,17.981952247010373,12821470,0.18004194317311512,-0.15019318588821307,-0.3302351290613282
2025-09-17T12:10:00-04:00,507.73,507.81,507.5,507.61,NaN,NaN,NaN,508.7839983420609,NaN,NaN,508.4143000000002,511.35912665685686,505.46947334314353,507.05959045831855,507.59370682237875,508.5027846243066,506.68462902045087,3787,11733.266666666666,47.328903801467966,45.647067647982986,NaN,NaN,NaN,NaN,0.6246613841309303,17.049881998156508,12817683,0.14990179786516883,-0.14285788172986713,-0.29275967959503596
2025-09-17T12:15:00-04:00,507.58,507.93,507.51,507.79,NaN,NaN,NaN,508.7839983420609,NaN,NaN,508.3423000000002,511.1661386708858,505.5184613291146,507.05959045831855,507.5950645241974,508.5001196871409,506.69000936125394,4438,10919.433333333332,49.65035096400828,46.10238449646465,NaN,NaN,NaN,NaN,0.6100427138358651,16.428290472251426,12822121,0.13730865235590917,-0.12112386415014953,-0.2584325165060587
2025-09-17T12:20:00-04:00,507.8,508.315,507.76,508.28,NaN,NaN,NaN,508.7839983420609,NaN,NaN,508.2791000000002,510.9606552873295,505.5975447126709,507.05959045831855,507.59971634446504,508.50207736029466,506.6973553286354,4387,10337.166666666666,55.4115993492991,46.76727452074666,NaN,NaN,NaN,NaN,0.6061110914190181,16.573848639538756,12826508,0.1558443014653764,-0.0636271396743382,-0.2194714411397146
2025-09-17T12:25:00-04:00,508.3,508.69,508.21,508.63,NaN,NaN,NaN,508.7839983420609,NaN,NaN,508.2221000000002,510.7455762449824,505.698623755018,507.3874178013818,507.6134977860534,508.51587403528777,506.71112153681906,7586,9814.066666666668,59.018732592655546,47.88388227015738,NaN,NaN,NaN,NaN,0.5971031563176609,17.31344466330676,12834094,0.18362953300029197,0.010065475110650368,-0.1735640578896416
2025-09-17T12:30:00-04:00,508.64,508.77,508.37,508.46,NaN,NaN,NaN,508.7839983420609,NaN,NaN,508.1781000000002,510.6048771959732,505.7513228040272,507.52793424110547,507.6309152231644,508.5334571604211,506.72837328590765,9671,8881.533333333333,56.62268039647076,48.95729281388289,NaN,NaN,NaN,NaN,0.5830243594378263,18.12176680265786,12824423,0.18215196182006202,0.05412589438543591,-0.1280260674346261
2025-09-17T12:35:00-04:00,508.47,508.665,508.35,508.51,NaN,NaN,NaN,508.7839983420609,NaN,NaN,508.13590000000016,510.462680341778,505.8091196582223,507.52793424110547,507.6429336976742,508.5450561719884,506.74081122336,7093,8426.566666666668,57.173394019529184,50.23425221866292,NaN,NaN,NaN,NaN,0.5638797623351243,18.815101962463235,12831516,0.17603521440877973,0.09201795057634854,-0.08401726383243117
2025-09-17T12:40:00-04:00,508.47,508.5,508.08,508.27,NaN,NaN,NaN,508.7839983420609,NaN,NaN,508.0951000000002,510.3379887531072,505.85221124689315,507.52793424110547,507.6506312492447,508.5500272163756,506.75123528211384,6300,7873.966666666666,53.65230189556894,51.016116308726716,NaN,NaN,NaN,NaN,0.5543169221683302,18.700482833631707,12825216,0.14842302884944333,0.10151152222937299,-0.04691150662007034
2025-09-17T12:45:00-04:00,508.22,508.29,507.95,508.21,NaN,NaN,NaN,508.7839983420609,NaN,NaN,508.0521000000002,510.2000823925234,505.904117607477,507.52793424110547,507.6544528234489,508.5514569581375,506.75744868876023,4042,7580.6,52.77720827170443,51.94194465348833,NaN,NaN,NaN,NaN,0.5390085705848803,18.248346303353618,12821174,0.11993428887022356,0.10300635446770912,-0.016927934402514448
2025-09-17T12:50:00-04:00,508.28,508.56,508.03,508.21,NaN,NaN,NaN,508.7839983420609,NaN,NaN,508.0137000000002,510.0787693060487,505.9486306939517,507.52793424110547,507.6615333275942,508.5557342826121,506.76733237257633,6180,7142.466666666666,52.77720827170443,52.78580497641825,NaN,NaN,NaN,NaN,0.5383651012573909,18.357716457165832,12821174,0.09594527371194564,0.1030036577374176,0.007058384025471962
2025-09-17T12:55:00-04:00,508.23,508.4,508.06,508.11,NaN,NaN,NaN,508.7839983420609,NaN,NaN,507.96930000000015,509.92586536794926,506.01273463205104,507.52793424110547,507.6654735192539,508.55749391382625,506.77345312468157,4014,6880.066666666667,51.16415006069908,53.313443945634354,NaN,NaN,NaN,NaN,0.5241961654532897,18.459274457134317,12817160,0.069433697643579,0.09385050607994572,0.024416808436366715
2025-09-17T13:00:00-04:00,508.1,508.59,508.1,508.5,NaN,NaN,NaN,508.7839983420609,NaN,NaN,507.9302000000001,509.76057368839065,506.0998263116096,507.52793424110547,507.6740252268526,508.56429150568573,506.7837589480195,6371,6656.966666666666,56.71988279146226,53.678356483341744,NaN,NaN,NaN,NaN,0.5217535822066227,18.92344452624664,12823531,0.07384321172142203,0.11672082308814424,0.04287761136672222
2025-09-17T13:05:00-04:00,508.5,508.65,508.34,508.42,NaN,NaN,NaN,508.7839983420609,NaN,NaN,507.8912000000002,509.5903663364298,506.1920336635706,507.6126690509603,507.6793043980933,508.56896256179465,506.7896462343919,3637,6488.433333333333,55.32939063030212,53.65775592260389,NaN,NaN,NaN,NaN,0.5066283263347212,19.469597348863715,12819894,0.0672397064367695,0.1269272444126841,0.0596875379759146
2025-09-17T13:10:00-04:00,508.43,508.58,508.3,508.54,NaN,NaN,NaN,508.7839983420609,NaN,NaN,507.8556000000001,509.4188807038892,506.292319296111,507.6126690509603,507.6846716934792,508.57370177384587,506.7956416131125,3732,6409.466666666666,57.03101711421389,53.78721695510071,NaN,NaN,NaN,NaN,0.49044058873938207,19.83943382835667,12823626,0.06668990050345952,0.143049913605239,0.07636001310177948
2025-09-17T13:15:00-04:00,508.5,508.84,508.4,508.75,506.9952665072024,506.9952665072024,506.9952665072024,NaN,NaN,NaN,507.8362000000002,509.32893515362673,506.34346484637365,507.84410819261456,507.69268329312354,508.58244770873006,506.802918877517,4557,6345.2,59.90914699374967,54.61185479663112,NaN,NaN,NaN,NaN,0.48683768954371176,20.700075827257415,12828183,0.07555484774982016,0.17080357278905467,0.09524872503923451
2025-09-17T13:20:00-04:00,508.75,508.89,508.43,508.43,507.046390756875,NaN,NaN,NaN,NaN,NaN,507.8192000000002,509.26438007142156,506.37401992857883,507.8632865540917,507.7005318203078,508.59026942808686,506.8107942125287,4949,6268.633333333333,53.9761689887621,55.08665945286641,NaN,NaN,NaN,NaN,0.48492071171915946,21.594177571068833,12823234,0.055860498107329556,0.16507434767339646,0.1092138495660669
2025-09-17T13:25:00-04:00,508.44,508.56,508.39,508.49,507.046390756875,NaN,NaN,NaN,NaN,NaN,507.7978000000001,509.1690332547912,506.426566745209,507.8632865540917,507.70784758810424,508.5965837449782,506.8191114312303,5321,6208.233333333334,54.87846578588985,55.46009622585795,NaN,NaN,NaN,NaN,0.46242637516779206,22.267090112581386,12828555,0.043421539688137695,0.16349077417623903,0.12006923448810133
2025-09-17T13:30:00-04:00,508.5,508.93,508.49,508.92,507.15762050368164,NaN,NaN,NaN,NaN,NaN,507.79700000000014,509.16556421071385,506.4284357892864,507.9849033946187,507.7175754498443,508.60809248205067,506.8270584176379,5191,6176.466666666666,60.808538244200015,55.845591861208014,NaN,NaN,NaN,NaN,0.46082449122723534,23.588730267989323,12833746,0.05969575982247585,0.19468893426619616,0.1349931744437203
2025-09-17T13:35:00-04:00,508.89,509.8,508.87,509.74,507.7263650262416,NaN,NaN,NaN,NaN,NaN,507.80880000000013,509.2328724135485,506.3847275864518,508.57892271569494,507.76172712160223,508.68284808826394,506.84060615494053,14787,6485.3,69.13820163571233,56.56841107856922,NaN,NaN,NaN,NaN,0.49433702756814757,25.93146143888302,12848533,0.11786655267318424,0.2823263652852006,0.16445981261201637
2025-09-17T13:40:00-04:00,509.77,509.97,509.42,509.42,508.08448479777604,NaN,NaN,NaN,NaN,NaN,507.81680000000017,509.2721497994109,506.36145020058945,508.718138172556,507.78997287154004,508.7316045375591,506.84834120552097,9142,6519.366666666667,63.469041332547455,57.05743685971755,NaN,NaN,NaN,NaN,0.49831295417042354,28.270613530677707,12839391,0.1262271180794694,0.3222437102113531,0.19601659213188372
2025-09-17T13:45:00-04:00,509.45,509.52,509.07,509.39,508.08448479777604,NaN,NaN,NaN,NaN,NaN,507.8516000000002,509.37112945308763,506.33207054691275,508.718138172556,507.81334851138365,508.7665312130402,506.8601658097271,9207,6594.533333333334,62.94792101060328,57.4699030733657,NaN,NaN,NaN,NaN,0.49486202887253533,29.259548129061034,12830184,0.12114874862620545,0.34745252791464054,0.2263037792884351
2025-09-17T13:50:00-04:00,509.37,509.53,509.1,509.185,508.08448479777604,NaN,NaN,NaN,NaN,NaN,507.8905000000002,509.4446007041871,506.3363992958133,508.718138172556,507.82751421391146,508.78677915168237,506.86824927614055,5937,6678.933333333333,59.36121218420775,57.87768237969704,NaN,NaN,NaN,NaN,0.4902290268102078,30.19108180133751,12824247,0.09646911800466085,0.34689017679426115,0.2504210587896003
2025-09-17T13:55:00-04:00,509.2,509.69,509.13,509.53,508.08448479777604,NaN,NaN,NaN,NaN,NaN,507.9291000000002,509.54698589173523,506.3112141082651,508.718138172556,507.8539206819795,508.82724471258626,506.88059665137274,10112,6763.333333333333,63.16507175854256,58.619672628756916,NaN,NaN,NaN,NaN,0.49521266775233597,31.27154862677229,12834359,0.09567738610679566,0.3700177914230949,0.2743404053162992
2025-09-17T14:00:00-04:00,509.69,510.43,508.48,508.66,508.08448479777604,NaN,NaN,NaN,NaN,NaN,507.9717000000002,509.55171089822466,506.3916891017758,508.718138172556,507.91080521559843,508.90064942105283,506.920961010144,27629,7506.166666666667,50.36300219891665,58.447229337843496,NaN,NaN,NaN,NaN,0.5991260486271683,33.0818061463067,12806730,0.032143100582842254,0.31451928104485205,0.2823761804620098
2025-09-17T14:05:00-04:00,508.61,508.76,507.95,508,NaN,NaN,NaN,510.1670847739843,510.1670847739843,510.1670847739843,508.0017000000002,509.52473198872013,506.47866801128026,508.718138172556,507.919342967716,508.89751968795656,506.9411662474754,17460,7917.2,43.20846716185534,57.87896627364038,NaN,NaN,NaN,NaN,0.6141884737252278,33.22512001566829,12789270,-0.054057981022527346,0.21480370418385064,0.268861685206378
2025-09-17T14:10:00-04:00,508.01,508.22,507.1,507.1,NaN,NaN,NaN,509.54244455698506,NaN,NaN,508.0189000000002,509.48013275304953,506.55766724695087,508.718138172556,507.9062798207345,508.8729549560587,506.93960468541025,20107,8349.633333333333,35.75029092698691,56.38113828332071,NaN,NaN,NaN,NaN,0.6503178684591404,31.506983277167084,12769163,-0.1651403983872483,0.062436187222317585,0.2275765856095659
2025-09-17T14:15:00-04:00,507.05,507.59,506.67,507.47,NaN,NaN,NaN,509.0523334407584,NaN,NaN,508.0409000000002,509.4336881241259,506.64811187587446,508.718138172556,507.8953901242174,508.857789142591,506.93299110584377,11465,8526.866666666667,40.31167919083314,55.30844460907293,NaN,NaN,NaN,NaN,0.6695808778549132,29.339315716717707,12780628,-0.20457000968028516,-0.028135926490790553,0.1764340831894946
2025-09-17T14:20:00-04:00,507.39,508.18,506.91,508.03,NaN,NaN,NaN,509.0523334407584,NaN,NaN,508.05230000000023,509.4351784611952,506.66942153880524,508.718138172556,507.89289514237527,508.84915436611425,506.9366359186363,9351,8455.8,46.502271502276784,54.55639135107742,NaN,NaN,NaN,NaN,0.7124679580081323,28.04723099021575,12789979,-0.18443045233714467,-0.05410398223193624,0.13032647010520843
2025-09-17T14:25:00-04:00,508.09,508.91,507.9,508.9,NaN,NaN,NaN,509.0523334407584,NaN,NaN,508.0825000000002,509.47214060049356,506.69285939950686,508.718138172556,507.8997969017849,508.8535979508746,506.9459958526952,7284,8139.933333333333,54.41274056397944,54.16379089180812,NaN,NaN,NaN,NaN,0.7337202467218406,27.73807367720381,12797263,-0.10780601292357672,-0.004431046049262477,0.10337496687431424
2025-09-17T14:30:00-04:00,508.9,509.1,507.58,507.92,506.3504151913751,506.3504151913751,506.3504151913751,NaN,NaN,NaN,508.07790000000017,509.46813895741076,506.6876610425896,508.46543739547894,507.9049091315502,508.85135136216195,506.95846690093845,12380,8451,46.136985708023865,53.60384922889824,NaN,NaN,NaN,NaN,0.7898830862417119,26.901342523048488,12784883,-0.11761168980457466,-0.04363964538140408,0.07397204442317058
2025-09-17T14:35:00-04:00,507.94,508.36,506.96,506.96,506.3504151913751,NaN,NaN,NaN,NaN,NaN,508.05300000000017,509.4774184774166,506.6285815225837,508.46543739547894,507.8963049481474,508.83634645187925,506.9562634444156,13319,8647.866666666667,39.75787648512909,52.523807135986765,NaN,NaN,NaN,NaN,0.8334628657958777,25.172383392267182,12771564,-0.17953164525634846,-0.150442512147265,0.029089133109083468
2025-09-17T14:40:00-04:00,506.93,507.72,506.6,507.16,506.3504151913751,NaN,NaN,NaN,NaN,NaN,508.0404000000002,509.4849052296757,506.5958947703247,508.46543739547894,507.87700509231183,508.8120737307289,506.94193645389475,19927,9185.866666666667,41.57041429184135,51.14965542510401,NaN,NaN,NaN,NaN,0.8539298039533153,23.673388137194358,12791491,-0.19643219554872202,-0.21645111132681905,-0.020018915778097036
2025-09-17T14:45:00-04:00,507.23,508.3,506.52,508.3,506.3504151913751,NaN,NaN,NaN,NaN,NaN,508.05480000000017,509.49500826229996,506.6145917377004,508.46543739547894,507.8738073004326,508.80034572763134,506.94726887323384,14545,9522.766666666666,50.67948270628386,49.8311755015734,NaN,NaN,NaN,NaN,0.9200776750995091,22.458585526558654,12806036,-0.12379318738841094,-0.1747604000136107,-0.05096721262519977
2025-09-17T14:50:00-04:00,508.26,508.44,506.8,507.32,506.3504151913751,NaN,NaN,NaN,NaN,NaN,508.05260000000015,509.4969493201922,506.6082506798081,506.78334991638314,507.8666547519987,508.7851307021258,506.94817880187156,15986,9909.4,44.28759467899417,48.46107216917674,NaN,NaN,NaN,NaN,0.9715006983066861,21.506312608382324,12790050,-0.1338516730761138,-0.21828180397034203,-0.08443013089422823
2025-09-17T14:55:00-04:00,507.4,508.77,507.26,508.72,506.3504151913751,NaN,NaN,NaN,NaN,NaN,508.07120000000015,509.52546209424617,506.6169379057541,506.5062441257506,507.87348033218353,508.78515325199197,506.9618074123751,14335,10134.366666666667,53.34112380031321,47.77487236844173,NaN,NaN,NaN,NaN,1.0099649341419221,21.029204705523178,12804385,-0.04302494842610677,-0.13821131642686169,-0.09518636800075492
2025-09-17T15:00:00-04:00,508.72,510.05,508.67,509.87,506.6419708109637,NaN,NaN,NaN,NaN,NaN,508.1234000000002,509.64333084005307,506.6034691599473,506.6134344160806,507.91765720734656,508.8558524596306,506.9794619550625,22059,10547.3,59.205503233687956,47.763750300547464,NaN,NaN,NaN,NaN,1.0363960102746417,21.84926390370625,12826444,0.09041703120826816,0.017834921009580285,-0.07258211019868788
2025-09-17T15:05:00-04:00,509.97,510.91,509.73,510.54,507.56460850137444,NaN,NaN,NaN,NaN,NaN,508.18900000000025,509.83233076352,506.5456692364805,507.5707475328645,508.0049537743855,509.03338459295463,506.9765229558164,30233,11318.633333333333,62.18735780445352,47.693913589541104,NaN,NaN,NaN,NaN,1.0466534381121677,23.24034288239355,12856677,0.21273562066115215,0.1933374156277523,-0.01939820503339984
2025-09-17T15:10:00-04:00,510.56,511.1,509.2,509.5,507.56460850137444,NaN,NaN,NaN,NaN,NaN,508.2392000000002,509.8863021336192,506.5920978663812,507.5707475328645,508.04755909446897,509.1033270458407,506.99179114309726,19371,11754.333333333334,55.41617353219157,48.054854399060744,NaN,NaN,NaN,NaN,1.107606763961301,23.726865401430413,12837306,0.21205706942347646,0.24567313174594574,0.033616062322469276
2025-09-17T15:15:00-04:00,509.53,510.72,509.51,510.34,507.56460850137444,NaN,NaN,NaN,NaN,NaN,508.29500000000013,510.0315367830944,506.55846321690586,507.5707475328645,508.0809972612101,509.16163147539294,507.00036304702724,13901,12082.966666666667,59.27336896722356,49.20234738515847,NaN,NaN,NaN,NaN,1.1156348522497814,24.178636311964645,12851207,0.2538157510499076,0.35088575113485376,0.09707000008494618
2025-09-17T15:20:00-04:00,510.23,511,510.11,510.88,507.6422858124745,NaN,NaN,NaN,NaN,NaN,508.35680000000013,510.23148905130563,506.48211094869464,507.7493027368266,508.1294104792668,509.2557108371578,507.00311012137587,17017,12444.2,61.574858164906,51.04695933072412,NaN,NaN,NaN,NaN,1.0995180770890818,24.830941438791573,12868224,0.30026041241240586,0.47239551560045356,0.17213510318804767
2025-09-17T15:25:00-04:00,510.91,511.21,510.51,510.84,507.98422736645296,NaN,NaN,NaN,NaN,NaN,508.42340000000013,510.4064919693813,506.44030803061895,508.25944218946125,508.17358880801,509.34250494375937,507.0046726722606,14964,12809.2,61.298526024318136,52.54601981883019,NaN,NaN,NaN,NaN,1.070981071582718,25.609423429536065,12853260,0.3095088499655558,0.5590211656449924,0.2495123156794366
2025-09-17T15:30:00-04:00,510.83,511.3,510.14,510.35,507.98422736645296,NaN,NaN,NaN,NaN,NaN,508.4840000000001,510.513164359853,506.45483564014717,508.359553751569,508.2126191552731,509.4115378604385,507.0137004501077,15105,13100.333333333334,57.872274032140425,53.358162856677595,NaN,NaN,NaN,NaN,1.0773395664696683,25.708059675401707,12838155,0.26553521467254976,0.5814313340201238,0.31589611934757406
2025-09-17T15:35:00-04:00,510.435,510.84,510.1,510.13,507.98422736645296,NaN,NaN,NaN,NaN,NaN,508.54520000000014,510.5846410604889,506.5057589395114,508.359553751569,508.2381431807764,509.45237856426803,507.0239077972847,11298,13355.7,56.34937996329814,53.49649424234321,NaN,NaN,NaN,NaN,1.053243883150403,25.732159329269745,12826857,0.20713374659178208,0.5748133025873017,0.3676795559955196
2025-09-17T15:40:00-04:00,510.05,510.28,509.76,509.76,507.98422736645296,NaN,NaN,NaN,NaN,NaN,508.59400000000016,510.630605999929,506.5573940000713,508.359553751569,508.26112830227237,509.4829353325685,507.03932127197623,13045,13666.133333333333,53.785892186444975,54.042844705087575,NaN,NaN,NaN,NaN,1.0151550343539444,25.180432800922446,12813812,0.13270594461389684,0.5335619867628907,0.40085604214899384
2025-09-17T15:45:00-04:00,509.75,509.865,509.28,509.64,507.98422736645296,NaN,NaN,NaN,NaN,NaN,508.64640000000014,510.65291742061936,506.6398825793809,508.359553751569,508.277515888016,509.5006522315234,507.0543795445086,11967,13913.133333333333,52.94463597992208,54.9847560975728,NaN,NaN,NaN,NaN,0.9844296747572366,23.923149525652203,12801845,0.06778672765975163,0.4855894517236834,0.41780272406393176
2025-09-17T15:50:00-04:00,509.59,509.93,509.04,509.46,507.98422736645296,NaN,NaN,NaN,NaN,NaN,508.6936000000002,510.663079159318,506.72412084068236,508.359553751569,508.31895800645896,509.5405705301255,507.09734548279243,34868,14910.433333333332,51.63990410075101,55.70400536963776,NaN,NaN,NaN,NaN,0.9776846979888616,22.40660102847612,12766977,0.008246920719944262,0.4281113749638621,0.41986445424391783
2025-09-17T15:55:00-04:00,509.42,510.2,509.13,509.99,507.98422736645296,NaN,NaN,NaN,NaN,NaN,508.7475000000002,510.7084163671604,506.78658363283995,508.359553751569,508.42709351790177,509.66279390419527,507.19139313160827,81041,17434.433333333334,55.144987358902966,56.022969987681996,NaN,NaN,NaN,NaN,0.9842786481325139,21.3609618126754,12848018,0.0004917437353837428,0.4204791339131475,0.41998739017776376
2025-09-18T09:30:00-04:00,511.33,511.33,507.73,509.16,NaN,NaN,NaN,512.2451728661345,512.2451728661345,512.2451728661345,508.77250000000015,510.72190837155074,506.82309162844956,508.359553751569,509.40666666666664,509.40667206146327,509.40666127187,74554,19746.533333333333,49.138507161694314,56.369463736446285,NaN,NaN,NaN,NaN,1.1711158875516177,21.016825848121726,12773464,-0.061192434811344065,0.3434968466635837,0.4046892814749278
2025-09-18T09:35:00-04:00,509.17,510.55,508.5,508.8,NaN,NaN,NaN,512.2451728661345,NaN,NaN,508.78290000000015,510.7272292825748,506.8385707174255,508.359553751569,509.35919147836177,509.41920297494084,509.2991799817827,46659,20808.933333333334,46.75951454841143,55.89934878988187,NaN,NaN,NaN,NaN,1.2338933241550742,20.697271023893315,12726805,-0.12331090825996227,0.2505506461499749,0.3738615544099372
2025-09-18T09:40:00-04:00,508.8,509.23,508.16,508.17,NaN,NaN,NaN,511.9734614659975,NaN,NaN,508.7813000000001,510.7275115093905,506.8350884906097,508.359553751569,509.1398601894338,509.51217035127326,508.7675500275944,42890,21933.866666666665,42.84981966645549,54.73108567793669,NaN,NaN,NaN,NaN,1.222186658143997,20.75667365759207,12683915,-0.19939495504296112,0.12461786060623581,0.32401281564919693
2025-09-18T09:45:00-04:00,508.17,509.37,507.66,509.37,NaN,NaN,NaN,511.8776223084521,NaN,NaN,508.8147000000001,510.7427730378664,506.88662696213373,508.359553751569,509.08678570632765,509.4503637341307,508.7232076785246,30370,22639.3,51.21679652806114,53.947474158194375,NaN,NaN,NaN,NaN,1.2570304682765674,21.29631050133644,12714285,-0.16300311495618808,0.12025892195396182,0.2832620369101499
2025-09-18T09:50:00-04:00,509.39,510.94,509.39,510.2,NaN,NaN,NaN,511.8776223084521,NaN,NaN,508.8665000000001,510.80148139509583,506.93151860490434,508.1176430012552,509.21833878165563,509.7105828406712,508.7260947226401,26696,23331.266666666666,56.01358990455733,53.990146756220504,NaN,NaN,NaN,NaN,1.2793854348282407,19.825824217811846,12740981,-0.08126230693290332,0.18168415324402076,0.2629464601769241
2025-09-18T09:55:00-04:00,510.22,510.51,509.22,510.01,NaN,NaN,NaN,511.8776223084521,NaN,NaN,508.9109000000001,510.8469182745476,506.9748817254526,507.87360257331414,509.28201859442464,509.7922193076581,508.77181788119117,22309,23737.833333333332,54.68792924998636,53.66261534784642,NaN,NaN,NaN,NaN,1.2801436180547923,18.54386473272571,12718672,-0.04029143644820904,0.2125821646166628,0.25287360106487183
2025-09-18T10:00:00-04:00,510.02,510.18,509.2,509.42,NaN,NaN,NaN,511.8776223084521,NaN,NaN,508.93370000000016,510.86630943779653,507.0010905622038,507.87360257331414,509.31168299637403,509.80622698401686,508.8171390087312,25051,23651.9,50.677103130496754,52.884204273960044,NaN,NaN,NaN,NaN,1.258704788193737,17.37621777878783,12693621,-0.052457366893016,0.18730189244860185,0.23975925934161785
2025-09-18T10:05:00-04:00,509.39,510.45,509.26,510.37,NaN,NaN,NaN,511.8776223084521,NaN,NaN,508.9685000000001,510.94024871605757,506.9967512839427,507.87360257331414,509.35724371378916,509.86664359243343,508.8478438351449,18276,23679.1,56.24198835954387,52.52302301219046,NaN,NaN,NaN,NaN,1.2537973033227556,16.307024188738342,12711897,0.0011081066770145254,0.241144392687886,0.24003628601087149
2025-09-18T10:10:00-04:00,510.38,511.43,510.38,511.18,NaN,NaN,NaN,511.8776223084521,NaN,NaN,509.02290000000016,511.0836106442028,506.96218935579753,508.2090188149652,509.49791394134115,510.1672814097539,508.8285464729284,26919,23906.166666666668,60.34970224272074,52.69998217008905,NaN,NaN,NaN,NaN,1.2399546387997018,16.357999696589538,12738816,0.08412776168357139,0.3451959881153357,0.2610682264317643
2025-09-18T10:15:00-04:00,511.18,512,511.05,511.37,508.13404024901973,508.13404024901973,508.13404024901973,NaN,NaN,NaN,509.0801000000002,511.2372059220511,506.9229940779493,508.94821505197217,509.6459406473882,510.4735765552333,508.8183047395431,25413,24371.1,61.268169945778425,53.05132431169478,NaN,NaN,NaN,NaN,1.2192435931711507,16.913574338068308,12764229,0.14149800374023835,0.4379407311070622,0.29644272736682387
2025-09-18T10:20:00-04:00,511.41,511.89,510.99,511.13,508.13404024901973,NaN,NaN,NaN,NaN,NaN,509.13730000000015,511.3562377727102,506.9183622272901,508.99857204157775,509.7165382460006,510.59446560159006,508.83861089041113,14778,24552,59.39653614694622,53.452084594587724,NaN,NaN,NaN,NaN,1.1964404793732097,17.344104567881153,12749451,0.1520201497689297,0.486467914577986,0.3344477648090563
2025-09-18T10:25:00-04:00,511.11,511.85,511.1,511.67,508.16588171449945,NaN,NaN,NaN,NaN,NaN,509.2065000000002,511.51926998406816,506.8937300159322,509.16185763326223,509.7882581217228,510.7188901541807,508.85762608926484,14490,24792.2,62.1948962881113,54.112817473744094,NaN,NaN,NaN,NaN,1.1645518737036948,17.743882638421656,12763941,0.1820585216298239,0.5620209168463361,0.37996239521651226
2025-09-18T10:30:00-04:00,511.73,512.91,511.73,512.39,508.99220527293124,NaN,NaN,NaN,NaN,NaN,509.29010000000017,511.7502386056683,506.82996139433203,510.13948610660975,509.9972561212688,511.13108099015466,508.8634312523829,32819,25473.5,65.59922985603592,55.10991217055016,NaN,NaN,NaN,NaN,1.1699410255819989,19.021928248513067,12796760,0.23382685595098318,0.6722459651552413,0.4384191092042581
2025-09-18T10:35:00-04:00,512.3,512.91,512.19,512.45,509.2752868514344,NaN,NaN,NaN,NaN,NaN,509.37690000000015,511.9671763480712,506.7866236519291,510.33358888528784,510.1062471842415,511.3279914473079,508.8845029211751,18142,25634.266666666666,65.8750066296106,55.87634211845785,NaN,NaN,NaN,NaN,1.1378023808975641,20.208684886455092,12814902,0.25384873131195296,0.7557300233441993,0.5018812920322463
2025-09-18T10:40:00-04:00,512.5,513.06,512.025,512.1,509.2755010854601,NaN,NaN,NaN,NaN,NaN,509.44890000000015,512.1359990229618,506.7618009770385,510.48137110823023,510.18052829772216,511.44887700888273,508.9121795865616,14067,25438.933333333334,62.716562182367525,56.84620319136308,NaN,NaN,NaN,NaN,1.130459353690593,21.0308428977828,12800835,0.22617914666456485,0.7846052253629523,0.5584260786983875
2025-09-18T10:45:00-04:00,512.04,512.04,511.08,511.7,509.2755010854601,NaN,NaN,NaN,NaN,NaN,509.5145000000001,512.2574897920592,506.771510207941,510.48137110823023,510.22043926828604,511.49284402977577,508.9480345067963,12479,25370.066666666666,59.22185184556212,57.73637014115956,NaN,NaN,NaN,NaN,1.1225693998555533,20.37162157741056,12788356,0.16636157295262266,0.7663780448891657,0.6000164719365431
2025-09-18T10:50:00-04:00,511.65,512.23,510.53,510.53,509.2755010854601,NaN,NaN,NaN,NaN,NaN,509.5543000000001,512.2973246151519,506.8112753848484,510.48137110823023,510.2537413876297,511.51292859607395,508.99455417918546,17617,25424.433333333334,50.37905737083762,58.27417283432971,NaN,NaN,NaN,NaN,1.163814442723017,19.068149664447663,12770739,0.0400112257470584,0.650030504120366,0.6100192783733076
2025-09-18T10:55:00-04:00,510.58,511.36,510.57,511.16,509.2755010854601,NaN,NaN,NaN,NaN,NaN,509.60250000000013,512.3718683393884,506.83313166061185,510.48137110823023,510.2723536407841,511.52200853100527,509.02269875056294,11387,25326.166666666668,54.33315951702025,58.49677019068394,NaN,NaN,NaN,NaN,1.1399705539570901,17.85778288812497,12782126,-0.006636479750869562,0.6017236786847207,0.6083601584355902
2025-09-18T11:00:00-04:00,511.23,511.53,510.645,510.68,509.2755010854601,NaN,NaN,NaN,NaN,NaN,509.64750000000015,512.4123148218806,506.8826851781197,510.48137110823023,510.2845465395357,511.5262155182522,509.04287756081925,8680,24880.2,50.99868629290277,58.13856278985147,NaN,NaN,NaN,NaN,1.121758371531583,16.94429974529315,12773446,-0.07170524467711847,0.5187286025891922,0.5904338472663107
2025-09-18T11:05:00-04:00,510.69,511.09,510,511.01,509.2755010854601,NaN,NaN,NaN,NaN,NaN,509.6979000000002,512.468345516353,506.92745448364735,510.48137110823023,510.2984947288414,511.52143405404274,509.07555540364,16800,24432.433333333334,53.128438523287436,58.02717059508727,NaN,NaN,NaN,NaN,1.1194899164221825,16.193824331890674,12790246,-0.09305322214996692,0.47411731957885195,0.5671705417288189
2025-09-18T11:10:00-04:00,511.03,511.11,510.46,510.79,509.2755010854601,NaN,NaN,NaN,NaN,NaN,509.7353000000001,512.5132088608996,506.9573911391007,510.48137110823023,510.3244821915544,511.51946147873934,509.1295029043695,28136,24724.6,51.52076777808001,58.087432355628934,NaN,NaN,NaN,NaN,1.085954922392029,15.469252277568005,12762110,-0.12076638878814216,0.41621255574364113,0.5369789445317833
2025-09-18T11:15:00-04:00,510.8,511.21,510.57,511.14,509.2755010854601,NaN,NaN,NaN,NaN,NaN,509.7633000000002,512.5689183701991,506.95768162980124,510.48137110823023,510.33783349331765,511.524036272461,509.1516307141743,11104,24631.366666666665,53.91025341428992,57.920879859539355,NaN,NaN,NaN,NaN,1.054100999364026,14.65067395889122,12773214,-0.11436504328727426,0.39402264042269053,0.5083876837099648
2025-09-18T11:20:00-04:00,511.145,511.46,510.49,510.78,509.2755010854601,NaN,NaN,NaN,NaN,NaN,509.7905000000002,512.6086201179758,506.9723798820246,510.48137110823023,510.34564669251165,511.5255925167246,509.1657008682987,7471,24313.166666666668,51.119299137272556,57.261565352007345,NaN,NaN,NaN,NaN,1.0480937851237362,13.683754752501667,12765743,-0.13196683183770885,0.34342914391282875,0.4753959757505376
2025-09-18T11:25:00-04:00,510.87,510.98,510.35,510.49,509.2755010854601,NaN,NaN,NaN,NaN,NaN,509.81250000000017,512.6349416733156,506.9900583266848,510.48137110823023,510.3497236326321,511.5208655633563,509.1785817019079,8681,24103.733333333334,48.92211355654836,56.37970418134806,NaN,NaN,NaN,NaN,1.0182299433291833,12.83513546629223,12757062,-0.15892258938093323,0.2767427390243711,0.4356653284053043
2025-09-18T11:30:00-04:00,510.55,510.77,510.32,510.46,509.2755010854601,NaN,NaN,NaN,NaN,NaN,509.8380000000002,512.6603422894949,507.01565771050554,509.4670968865842,510.3526069891104,511.51379488741526,509.1914190908056,9768,23925.833333333332,48.68897162439552,55.61487814402302,NaN,NaN,NaN,NaN,0.9776420902342408,12.093516645184476,12747294,-0.17337335879918592,0.2189486299063219,0.39232198870550783
2025-09-18T11:35:00-04:00,510.42,510.45,509.85,510.22,509.2755010854601,NaN,NaN,NaN,NaN,NaN,509.8518000000002,512.674730930639,507.0288690693613,509.3216775092674,510.3486529998565,511.49726594950295,509.20004005021,12755,23974.4,46.76877439196256,54.51301229429811,NaN,NaN,NaN,NaN,0.9513819409317918,12.104256083313038,12734539,-0.19223526715802863,0.152027904757972,0.34426317191600064
2025-09-18T11:40:00-04:00,510.17,510.22,509.84,510.05,509.2755010854601,NaN,NaN,NaN,NaN,NaN,509.8796000000002,512.682341400676,507.0768585993244,509.15232550898935,510.34384646837833,511.48422472366155,509.2034682130951,9049,23841.2,45.40286815125757,53.07041502967109,NaN,NaN,NaN,NaN,0.9105689451509533,12.128611996961473,12725490,-0.2079678400166382,0.08430337189520287,0.2922712119118411
2025-09-18T11:45:00-04:00,510.1,510.1,509.44,509.6,509.2755010854601,NaN,NaN,NaN,NaN,NaN,509.9116000000002,512.6638510349084,507.15934896509197,509.15232550898935,510.3342175620192,511.4684930733162,509.1999420507222,9109,23745.933333333334,41.91334934536677,51.358868080796526,NaN,NaN,NaN,NaN,0.8926711633544585,12.713798507734067,12716381,-0.2383092236369085,-0.00561531763429457,0.23269390600261394
2025-09-18T11:50:00-04:00,509.61,509.63,508.29,508.55,NaN,NaN,NaN,511.84477940342816,511.84477940342816,511.84477940342816,509.9406000000002,512.6028228605246,507.27837713947577,509.15232550898935,510.28658400797127,511.4336318742913,509.13953614165126,19417,23230.9,35.128982881033124,49.38832670212978,NaN,NaN,NaN,NaN,0.9246232231148526,14.497000207140154,12696964,-0.3139640247216372,-0.15976112489943262,0.15420289982220461
2025-09-18T11:55:00-04:00,508.6,508.84,508.16,508.16,NaN,NaN,NaN,511.3463803396359,NaN,NaN,509.9544000000002,512.5720330069577,507.3367669930427,509.15232550898935,510.22641663312527,511.4031685192516,509.04966474699893,20142,21200.933333333334,32.992810778307245,47.51482376875443,NaN,NaN,NaN,NaN,0.9071501357495023,16.2678345870435,12676822,-0.3712192026794431,-0.30982110352709924,0.061398099152343844
2025-09-18T12:00:00-04:00,508.13,508.81,507.89,508.68,NaN,NaN,NaN,511.1924539605616,NaN,NaN,509.9674000000001,512.552934559711,507.3818654402892,509.15232550898935,510.14027967260574,511.3493925436369,508.9311668015746,32605,19802.633333333335,38.373769808766966,46.65730322860652,NaN,NaN,NaN,NaN,0.9080679831959675,18.149074987996087,12709427,-0.3550202845561004,-0.38237725654278165,-0.02735697198668126
2025-09-18T12:05:00-04:00,508.73,509.1,508.45,508.78,NaN,NaN,NaN,511.1924539605616,NaN,NaN,509.96500000000015,512.5547127252704,507.3752872747298,509.15232550898935,510.11240554059617,511.32455327924924,508.9002578019431,13953,18712.433333333334,39.38191215450619,45.58935698842696,NaN,NaN,NaN,NaN,0.8896345558248294,19.290559591008176,12723380,-0.3196251918685642,-0.4268884618223865,-0.10726326995382231
2025-09-18T12:10:00-04:00,508.76,508.85,508.22,508.8,NaN,NaN,NaN,511.1924539605616,NaN,NaN,509.98260000000016,512.5280643897248,507.43713561027545,508.81886040719155,510.0852778393063,511.3027316581904,508.8678240204222,12666,17704.966666666667,39.59474842085772,44.77478999756659,NaN,NaN,NaN,NaN,0.8710892304087698,20.577806022677997,12736046,-0.27843070074181653,-0.455301645881093,-0.17687094513927645
2025-09-18T12:15:00-04:00,508.815,509.29,508.815,508.91,NaN,NaN,NaN,511.1924539605616,NaN,NaN,510.0216000000001,512.4370613968107,507.6061386031895,508.8160883257532,510.0718556749845,511.2876259864298,508.85608536353914,8747,16984.2,40.82537498762138,43.89599974501902,NaN,NaN,NaN,NaN,0.8438685710938584,20.88530424737802,12744793,-0.22938255269060176,-0.46359913600252867,-0.2342165833119269
2025-09-18T12:20:00-04:00,508.92,509.18,508.75,508.97,NaN,NaN,NaN,511.1924539605616,NaN,NaN,510.05780000000016,512.3518315253322,507.76376847466815,508.5818706606026,510.05909411799405,511.2735779651395,508.8446102708486,8224,16368.466666666667,41.52515879459062,43.18202767476977,NaN,NaN,NaN,NaN,0.8143065303014404,21.247008140690728,12753017,-0.18065114355277373,-0.4600305127528941,-0.27937936920012035
2025-09-18T12:25:00-04:00,508.96,509,508.77,508.92,NaN,NaN,NaN,511.1924539605616,NaN,NaN,510.0702000000001,512.3325757069812,507.807824293019,508.5354965284821,510.0502554063093,511.2643196815105,508.83619113110814,5457,15806.733333333334,41.089086696270215,42.266230052054084,NaN,NaN,NaN,NaN,0.7725703495656245,21.58287604162396,12747560,-0.14128104374326073,-0.4559806738791963,-0.31469963013593555
2025-09-18T12:30:00-04:00,508.95,509.36,508.84,509.15,NaN,NaN,NaN,511.1924539605616,NaN,NaN,510.1068000000001,512.2458743417993,507.9677256582009,508.42239722278566,510.04300531685703,511.255119851188,508.83089078252607,5617,15158.933333333332,44.002219774036206,41.75786724039433,NaN,NaN,NaN,NaN,0.7545296103109399,21.142960315544812,12753177,-0.09165132300425821,-0.4292637838912583,-0.3376124608870001
2025-09-18T12:35:00-04:00,509.13,509.2,508.83,508.91,NaN,NaN,NaN,511.1924539605616,NaN,NaN,510.11060000000015,512.2404616291883,507.98073837081205,507.97997921155576,510.03248190922847,511.2431645774133,508.8217992410436,7232,14790.8,41.685782138707644,41.24098642483428,NaN,NaN,NaN,NaN,0.7270632095744445,20.749531400030182,12745945,-0.06797815268886437,-0.42258515174808053,-0.35460699905921617
2025-09-18T12:40:00-04:00,508.88,509.255,508.74,509.23,NaN,NaN,NaN,511.1924539605616,NaN,NaN,510.0978000000001,512.2409427016078,507.9546572983925,507.97997921155576,510.0223205009267,511.2305519081716,508.8140890936818,7836,14154.7,45.78401647046861,41.03348962812522,NaN,NaN,NaN,NaN,0.7119158374619833,20.526410928619704,12753781,-0.025922204324625442,-0.38700975446499797,-0.3610875501403725
2025-09-18T12:45:00-04:00,509.25,509.63,509.18,509.18,NaN,NaN,NaN,511.1924539605616,NaN,NaN,510.0706000000001,512.2250945020762,507.91610549792404,508.37402935631656,510.00631764915505,511.2050263797726,508.8076089185375,17471,13889.966666666667,45.2489161360652,40.92492832413256,NaN,NaN,NaN,NaN,0.6932075633575552,19.514737893278486,12736310,0.0018976172142549652,-0.35871552862255385,-0.3606131458368088
2025-09-18T12:50:00-04:00,509.21,509.63,509.18,509.42,NaN,NaN,NaN,511.1924539605616,NaN,NaN,510.0690000000002,512.2253051730302,507.91269482697015,508.40022348505323,509.9999485686663,511.1938132794386,508.806083857894,8160,13669.366666666667,48.36826516686435,41.1367423966759,NaN,NaN,NaN,NaN,0.6758355945463004,18.5753272176045,12744470,0.037838946697150266,-0.313314462465371,-0.35115340916252125
2025-09-18T12:55:00-04:00,509.4,509.6,509.14,509.54,NaN,NaN,NaN,511.1924539605616,NaN,NaN,510.05300000000017,512.2128935157451,507.8931064842552,508.40022348505323,509.9822272565451,511.1616758064233,508.8027787066669,24370,13998.7,49.905073415330044,41.707579830244704,NaN,NaN,NaN,NaN,0.6604187663644243,17.78131505702121,12768840,0.06924221386616447,-0.2646006418298157,-0.33384285569598016
2025-09-18T13:00:00-04:00,509.53,509.86,509.43,509.56,NaN,NaN,NaN,511.1924539605616,NaN,NaN,510.0266000000001,512.177665261591,507.87553473840916,508.6739430304341,509.9778411158735,511.15086800757973,508.8048142241673,9574,13223.866666666667,50.17127837557165,42.78202950842603,NaN,NaN,NaN,NaN,0.6439602830526802,16.55977413525606,12778414,0.08961531694384606,-0.22182370951617258,-0.31143902646001864
2025-09-18T13:05:00-04:00,509.54,510.1,509.53,509.93,NaN,NaN,NaN,511.1924539605616,NaN,NaN,510.0084000000001,512.1469915364186,507.86980846358165,508.86615442434726,509.9759277010114,511.14000701332515,508.8118483886977,12454,13034.266666666666,54.94166869254185,44.3498050737285,NaN,NaN,NaN,NaN,0.638677405691778,15.92222539305124,12790868,0.12413886603219204,-0.1562654439197786,-0.28040430995197063
2025-09-18T13:10:00-04:00,509.91,509.91,509.47,509.5,NaN,NaN,NaN,511.1924539605616,NaN,NaN,509.9914000000001,512.1323717792527,507.8504282207476,508.86615442434726,509.97211174928964,511.13038353274715,508.81383996583213,8952,12863.766666666666,49.06299154742533,45.11332091220409,NaN,NaN,NaN,NaN,0.6259147338566496,15.18796516874517,12781916,0.11438479040908334,-0.13742332194061646,-0.2518081123496998
2025-09-18T13:15:00-04:00,509.48,509.7,509.35,509.52,NaN,NaN,NaN,511.1924539605616,NaN,NaN,509.9792000000001,512.1238224468589,507.83457755314134,508.86615442434726,509.9690199144275,511.1238916289278,508.8141481999272,5684,12637.266666666666,49.33453293809177,45.824222396745924,NaN,NaN,NaN,NaN,0.6062065385811722,14.216959778910915,12787600,0.105846924821941,-0.11949945632227355,-0.22534638114421454
2025-09-18T13:20:00-04:00,509.55,509.62,509.24,509.36,NaN,NaN,NaN,511.1924539605616,NaN,NaN,509.9712000000002,512.122008740737,507.8203912592634,508.86615442434726,509.96475022313336,511.1162644995989,508.8132359466678,6312,12260.433333333332,47.16819345001248,46.36518275597126,NaN,NaN,NaN,NaN,0.5900489286825168,13.352148878237927,12781288,0.08679049910619596,-0.11685825726146959,-0.20364875636766555
2025-09-18T13:25:00-04:00,509.34,509.36,509.135,509.18,NaN,NaN,NaN,511.1924539605616,NaN,NaN,509.9620000000001,512.1223110886143,507.8016889113859,508.86615442434726,509.95780160862716,511.10611422041245,508.8094889968419,7883,12143.633333333333,44.785593987134604,46.64805554165077,NaN,NaN,NaN,NaN,0.5639740052051958,12.80166791360626,12773405,0.060666046625688974,-0.12781619808555433,-0.1884822447112433
2025-09-18T13:30:00-04:00,509.18,509.24,508.95,509.01,NaN,NaN,NaN,511.0457927190743,NaN,NaN,509.9530000000002,512.125317656115,507.78068234388536,508.86615442434726,509.9489350336241,511.0949387804249,508.80293128682325,8434,12135.433333333332,42.59711163774819,46.72462360187631,NaN,NaN,NaN,NaN,0.5444044334048261,12.722783637527538,12764971,0.03198088531359353,-0.1485061380692514,-0.18048702338284492
2025-09-18T13:35:00-04:00,508.96,509.235,508.75,509.21,NaN,NaN,NaN,510.9207566863891,NaN,NaN,509.93740000000014,512.1196110253677,507.7551889746325,508.86615442434726,509.94004480084783,511.0836772130137,508.796412388682,8612,11862.5,45.94380512752108,47.07138920410852,NaN,NaN,NaN,NaN,0.5401612595901967,13.087801151925085,12773583,0.02673408957679696,-0.1470694114118487,-0.17380350098864566
2025-09-18T13:40:00-04:00,509.2,509.2,508.98,509.055,NaN,NaN,NaN,510.9207566863891,NaN,NaN,509.93530000000015,512.1206991944696,507.74990080553073,508.86615442434726,509.93307328850307,511.0746829627891,508.79146361421704,6984,11157.433333333332,43.81193373713558,47.057797344329906,NaN,NaN,NaN,NaN,0.5180068839051798,13.426745986722807,12766599,0.013736849955334696,-0.15663243854447728,-0.17036928849981198
2025-09-18T13:45:00-04:00,509.03,509.14,508.81,508.9,NaN,NaN,NaN,510.8068826419372,NaN,NaN,509.93730000000016,512.1187189967098,507.7558810032905,508.86615442434726,509.92490144259585,511.0652548411896,508.7845480440021,7236,11028.5,41.726800509054286,47.0607272279261,NaN,NaN,NaN,NaN,0.5045778207690944,14.11773052783532,12759363,-0.0034681900238649477,-0.17470452602964315,-0.1712363360057782
2025-09-18T13:50:00-04:00,508.9,508.99,508.59,508.78,NaN,NaN,NaN,510.59316070366725,NaN,NaN,509.9495000000001,512.0978186447799,507.80118135522036,508.86615442434726,509.91814241362925,511.0584632118378,508.7778216154207,5200,10952.8,40.13425862499109,46.65717309610626,NaN,NaN,NaN,NaN,0.49710797642844723,15.209860285400554,12754163,-0.020167158182776784,-0.1964452837342492,-0.1762781255514724
2025-09-18T13:55:00-04:00,508.79,508.8,508.38,508.38,NaN,NaN,NaN,510.36847158077336,NaN,NaN,509.92970000000014,512.1169141274759,507.74248587252436,508.6929235394778,509.9027093429254,511.0460892299315,508.75932945591927,9774,10989.233333333334,35.29819795483226,45.946407511732495,NaN,NaN,NaN,NaN,0.4916002638264164,16.616046192824694,12744389,-0.05349652366033186,-0.24314878012688723,-0.18965225646655537
2025-09-18T14:00:00-04:00,508.38,508.59,508.22,508.51,NaN,NaN,NaN,510.15308650891996,NaN,NaN,509.8959000000002,512.1173262893552,507.67447371064526,508.55133883158226,509.8889766577131,511.03568591505143,508.74226740037477,8392,10943.366666666667,37.91650571346535,45.19985326506113,NaN,NaN,NaN,NaN,0.48291453069595436,18.20067878055572,12752781,-0.061557028358404764,-0.26659854191456134,-0.20504151355615657
2025-09-18T14:05:00-04:00,508.5,508.625,508.21,508.41,NaN,NaN,NaN,510.1427189403327,NaN,NaN,509.8639000000002,512.1235966962516,507.60420330374876,508.5110710652658,509.86923879686555,511.02077578594515,508.71770180778594,12132,10922.6,36.68665125900968,44.25568025389539,NaN,NaN,NaN,NaN,0.47806349278910193,19.534002793290586,12740649,-0.06789471744216136,-0.28990991035885827,-0.2220151929166969
2025-09-18T14:10:00-04:00,508.4,508.53,508.22,508.41,NaN,NaN,NaN,510.06407262486306,NaN,NaN,509.84370000000024,512.1367196769835,507.55068032301693,508.36035685221265,509.8502762604421,511.00649024413957,508.69406227674466,11738,11012.233333333334,36.68665125900968,43.29249260271239,NaN,NaN,NaN,NaN,0.4660589575898765,20.772089376544393,12740649,-0.06628383476457014,-0.3048699863724096,-0.23858615160783944
2025-09-18T14:15:00-04:00,508.43,508.56,507.9,508,NaN,NaN,NaN,509.9322965964602,NaN,NaN,509.79630000000026,512.1412373635064,507.451362636494,508.2952854817701,509.81011004004364,510.98132085789496,508.6388992221923,22249,11450.233333333334,31.784428500190046,41.63840401754441,NaN,NaN,NaN,NaN,0.4799118891906014,22.502152002303454,12718400,-0.0857895543261587,-0.34582309451553783,-0.26003354018937913
2025-09-18T14:20:00-04:00,508,508.21,507.89,508.11,NaN,NaN,NaN,509.7185558420756,NaN,NaN,509.73490000000027,512.0924347206079,507.3773652793926,508.28638270833284,509.78003270748115,510.96301957835925,508.59704583660306,16533,11354.1,34.32020105455881,40.58534755376822,NaN,NaN,NaN,NaN,0.46848961139127226,24.125584303262652,12734933,-0.08412751209067743,-0.3651929303027259,-0.2810654182120485
2025-09-18T14:25:00-04:00,508.13,508.37,508.05,508.18,NaN,NaN,NaN,509.7185558420756,NaN,NaN,509.6711000000003,512.0208278903477,507.3213721096528,508.28638270833284,509.7633629855138,510.95111470533834,508.5756112656893,10199,11022.666666666666,35.95183783135532,39.629440760429915,NaN,NaN,NaN,NaN,0.45788321057760945,24.91548017069793,12745132,-0.07164601678423665,-0.37062293919234435,-0.2989769224081077
2025-09-18T14:30:00-04:00,508.19,508.26,507.87,508.15,NaN,NaN,NaN,509.68015108751104,NaN,NaN,509.6115000000002,511.9613597828672,507.2616402171332,508.2441061666663,509.7482315852885,510.94113261057606,508.555330560001,8839,10230.466666666667,35.54429851119295,38.799162550514225,NaN,NaN,NaN,NaN,0.45303440982206494,26.006951136676896,12736293,-0.059255869126247585,-0.3730467588159172,-0.3137908896896696
2025-09-18T14:35:00-04:00,508.15,508.71,508.15,508.69,NaN,NaN,NaN,509.68015108751104,NaN,NaN,509.5519000000002,511.8402556452399,507.26354435476054,508.073284933333,509.73615603455255,510.92938114129294,508.54293092781217,9660,10087.366666666667,47.15611903546049,38.96848576825179,NaN,NaN,NaN,NaN,0.460674809120489,25.29492352400865,12745953,-0.011061363930526258,-0.32761759460282747,-0.3165562306723012
2025-09-18T14:40:00-04:00,508.64,508.69,508.16,508.27,NaN,NaN,NaN,509.68015108751104,NaN,NaN,509.46950000000027,511.6366384355216,507.30236156447893,507.85662794666644,509.7255505652945,510.9201413602939,508.5309597702951,7727,9922.733333333334,40.97337919806506,38.852504879702984,NaN,NaN,NaN,NaN,0.46562660846902354,24.633755026530995,12738226,-0.004191562854967301,-0.32179568424101035,-0.31760412138604305
2025-09-18T14:45:00-04:00,508.25,508.93,508.23,508.58,NaN,NaN,NaN,509.68015108751104,NaN,NaN,509.39210000000026,511.3983782356127,507.3858217643878,507.6910450181943,509.7099711759307,510.90380688884943,508.516135463012,13690,10087.5,46.54438178700244,38.89540321252309,NaN,NaN,NaN,NaN,0.4823675650069496,23.221496442331173,12751916,0.023013035952979044,-0.28883782644481926,-0.3118508623977983
2025-09-18T14:50:00-04:00,508.64,508.78,508.5,508.65,NaN,NaN,NaN,509.68015108751104,NaN,NaN,509.3231000000003,511.18416086907666,507.4620391309239,507.6910450181943,509.701957541775,510.89486126879245,508.5090538147576,7620,10067.366666666667,47.743728875104004,39.17624572237798,NaN,NaN,NaN,NaN,0.46791273893502267,21.91011347128848,12759536,0.04616829132590472,-0.2541404982404174,-0.3003087895663221
2025-09-18T14:55:00-04:00,508.6,508.9,508.58,508.82,NaN,NaN,NaN,509.68015108751104,NaN,NaN,509.26550000000026,511.00289834199884,507.5281016580017,507.83506881164436,509.6905808277323,510.8806316888917,508.50052996657286,12489,10301.766666666666,50.6401450748884,39.81291319136613,NaN,NaN,NaN,NaN,0.45734754329680627,20.39402204633392,12772025,0.07184819944059717,-0.21049854026557568,-0.28234673970617286
2025-09-18T15:00:00-04:00,508.84,509.03,508.76,509,NaN,NaN,NaN,509.68015108751104,NaN,NaN,509.23490000000027,510.9356439427674,507.53415605723313,508.0430550493155,509.68224246566376,510.868398980479,508.4960859508485,11381,10493.9,53.57433964087847,40.77291897821523,NaN,NaN,NaN,NaN,0.4439655759184617,19.39857075354377,12783406,0.09823874782402031,-0.15954830492614747,-0.2577870527501678
2025-09-18T15:05:00-04:00,509.02,509.37,508.97,509.17,NaN,NaN,NaN,509.68015108751104,NaN,NaN,509.19510000000025,510.80446321530866,507.58573678469185,508.3804440394524,509.67218108097654,510.84877977556397,508.4955823863891,20799,10946.133333333333,56.22125147726974,42.267422801246475,NaN,NaN,NaN,NaN,0.44082517763856993,19.41422498606247,12804205,0.12282919298980383,-0.10425056151291301,-0.22707975450271684
2025-09-18T15:10:00-04:00,509.18,509.48,509,509.26,NaN,NaN,NaN,509.68015108751104,NaN,NaN,509.1667000000002,510.7193643033608,507.61403569663963,508.44835523156195,509.6661962513389,510.83556532609674,508.496827176581,15106,11188.466666666667,57.59950952792833,43.67335164513669,NaN,NaN,NaN,NaN,0.44362337923581624,19.697046347646268,12819311,0.13961693088113436,-0.052558590901298885,-0.19217552178243325
2025-09-18T15:15:00-04:00,509.27,509.66,509.07,509.52,NaN,NaN,NaN,509.68015108751104,NaN,NaN,509.1369000000002,510.6016114252089,507.6721885747915,508.53968418524954,509.66257229837464,510.8238026344906,508.50134196225866,15828,11133.7,61.381957583703326,45.43730209690052,NaN,NaN,NaN,NaN,0.4540788521475459,20.37606905522729,12835139,0.16116482967769502,0.009280515314685545,-0.15188431436300948
2025-09-18T15:20:00-04:00,509.6,509.65,509.22,509.23,NaN,NaN,NaN,509.68015108751104,NaN,NaN,509.10570000000024,510.49262466955656,507.7187753304439,508.53968418524954,509.65895518945314,510.81352428538094,508.50438609352534,13487,11311.266666666666,55.44117261776084,46.776910765382745,NaN,NaN,NaN,NaN,0.4523589341370033,21.006590140838235,12821652,0.14909968630198037,0.034490293514465975,-0.11460939278751439
2025-09-18T15:25:00-04:00,509.24,509.24,508.66,508.79,NaN,NaN,NaN,509.68015108751104,NaN,NaN,509.0587000000003,510.320297098437,507.79710290156356,508.53968418524954,509.6436410945741,510.7915474314687,508.4957347576795,22620,11252.933333333332,47.870861873558965,47.92594172062338,NaN,NaN,NaN,NaN,0.4614761531272162,19.60436203980914,12799032,0.10668653612053743,0.018748777363157387,-0.08793775875738004
2025-09-18T15:30:00-04:00,508.79,508.89,508.42,508.78,NaN,NaN,NaN,509.68015108751104,NaN,NaN,509.01870000000025,510.1824917506174,507.85490824938313,508.53968418524954,509.6277231814886,510.772432793225,508.4830135697522,19250,11575.466666666667,47.71140782966615,48.8824564902739,NaN,NaN,NaN,NaN,0.46208499933241287,18.760537062979694,12779782,0.07467364587404526,0.005404298585176548,-0.06926934728886872
2025-09-18T15:35:00-04:00,508.77,508.92,508.6,508.77,NaN,NaN,NaN,509.68015108751104,NaN,NaN,508.98430000000025,510.0712443586959,507.8973556413046,508.53968418524954,509.61733603334,510.75903848629025,508.47563358038974,13929,11624.633333333333,47.54087181240372,49.71024463177736,NaN,NaN,NaN,NaN,0.4519360708086686,17.884398002861328,12765853,0.05068740932993212,-0.005910085626453565,-0.056597494956385684
2025-09-18T15:40:00-04:00,508.77,508.86,508.37,508.39,NaN,NaN,NaN,509.68015108751104,NaN,NaN,508.94290000000024,509.95711514427717,507.9286848557233,508.53968418524954,509.6024352328448,510.74317487531647,508.46169559037315,16257,11868.133333333333,41.47432575598677,50.13381800640549,NaN,NaN,NaN,NaN,0.45465492289376436,17.67407578233992,12749596,0.009261459507962769,-0.04502067057143222,-0.05428213007939499
2025-09-18T15:45:00-04:00,508.41,508.46,508.09,508.32,NaN,NaN,NaN,509.68015108751104,NaN,NaN,508.9049000000003,509.86584638698747,507.9439536130131,508.53968418524954,509.58249561871327,510.7258628195513,508.4391284178752,18133,12283.1,40.45033598702071,49.65483350294551,NaN,NaN,NaN,NaN,0.4486081426870672,18.12204085805358,12731463,-0.021161380946527676,-0.08073385626255458,-0.059572475316026906
2025-09-18T15:50:00-04:00,508.28,508.83,508.07,508.51,NaN,NaN,NaN,509.68015108751104,NaN,NaN,508.8741000000002,509.78360467787195,507.9645953221285,508.53968418524954,509.5319942495504,510.6728609330915,508.3911275660093,56756,13964.566666666668,44.458746602020476,49.90378831751375,NaN,NaN,NaN,NaN,0.4708504182094189,17.37876928502283,12788219,-0.026452046386888237,-0.0926375332996372,-0.06618548691274896
2025-09-18T15:55:00-04:00,508.5,508.73,508.09,508.35,NaN,NaN,NaN,509.68015108751104,NaN,NaN,508.8491000000003,509.7460496969092,507.9521503030914,508.53968418524954,509.4164034962235,510.55151411247834,508.28129287996865,140803,18395.233333333334,41.90093991604666,49.57211389815977,NaN,NaN,NaN,NaN,0.4829325311944635,16.68858853863713,12647416,-0.03798889876646444,-0.11367161037082951,-0.07568271160436507
2025-09-19T09:30:00-04:00,510.73,512.25,510.34,511.21,509.2983720806463,509.2983720806463,509.2983720806463,NaN,NaN,NaN,508.9023000000003,510.01223190728206,507.79236809271856,509.2444406943017,511.26666666666665,511.26666666666665,511.26666666666665,110862,21809.5,72.43215389659314,51.33557282826613,NaN,NaN,NaN,NaN,0.7270087789662859,19.4921915356906,12758278,0.13997996986863073,0.09929225073142334,-0.04068771913720739
2025-09-19T09:35:00-04:00,511.28,512.28,510.36,511.05,509.2983720806463,NaN,NaN,NaN,NaN,NaN,508.9601000000003,510.2024823722692,507.7177176277314,509.2444406943017,511.25646927825386,511.27289844467475,511.24004011183297,42710,22946.1,70.20931327578904,52.733370556901896,NaN,NaN,NaN,NaN,0.8122224376115482,22.112515438038454,12715568,0.23434954353068396,0.25224921027614755,0.017899666745463595
2025-09-19T09:40:00-04:00,511.12,513.08,511.12,512.43,509.7540229081922,NaN,NaN,NaN,NaN,NaN,509.0351000000002,510.6092518221381,507.46094817786235,509.37344204435317,511.491865029351,511.90326411115757,511.08046594754444,50339,24391.266666666666,76.81748430101807,54.39359517548329,NaN,NaN,NaN,NaN,0.8992065492107254,24.965571298803937,12765907,0.36911876196689986,0.4792981192040884,0.11017935723718855
2025-09-19T09:45:00-04:00,512.39,514,512.14,513.84,510.5770218669107,NaN,NaN,NaN,NaN,NaN,509.1363000000002,511.20481329204904,507.0677867079513,510.1047536354825,511.88257126498894,512.7176916320108,511.0474508979671,55169,25989.033333333333,81.36567895192209,56.18962570938703,NaN,NaN,NaN,NaN,0.9678346528385317,28.00096025016166,12821076,0.5232181035412944,0.7642019866638066,0.24098388312251218
2025-09-19T09:50:00-04:00,513.89,514.68,513.5,514.14,511.5494299638693,NaN,NaN,NaN,NaN,NaN,509.2431000000002,511.7385028851802,506.7476971148202,510.97380290838595,512.2016038443863,513.2994024281292,511.1038052606435,43387,27261.933333333334,82.16732348909426,57.94446956375602,NaN,NaN,NaN,NaN,0.9829893204929187,31.0562548186614,12864463,0.6093249229578743,1.0026400368198551,0.3933151138619808
2025-09-19T09:55:00-04:00,514.18,514.85,513.97,514.36,511.8649104200572,NaN,NaN,NaN,NaN,NaN,509.3521000000001,512.2270344965635,506.4771655034367,511.44504232670886,512.4085016487223,513.6340841972068,511.1829191002379,31529,27987.1,82.75327413015768,59.470992174217045,NaN,NaN,NaN,NaN,0.9756329404577099,33.949027363063635,12895992,0.6418072971028037,1.1955742352404855,0.5537669381376817
2025-09-19T10:00:00-04:00,514.38,514.59,513.17,513.855,511.8649104200572,NaN,NaN,NaN,NaN,NaN,509.44980000000015,512.5862750660023,506.31332493399805,511.44504232670886,512.5551208808379,513.7979271734105,511.3123145882653,37196,28947.233333333334,76.53648156590229,60.97779995622715,NaN,NaN,NaN,NaN,1.0073734447107359,35.17521385585904,12858796,0.5912455131801515,1.2928238296128711,0.7015783164327196
2025-09-19T10:05:00-04:00,513.8,514.45,513.5,513.5,511.8649104200572,NaN,NaN,NaN,NaN,NaN,509.54140000000024,512.8721338769703,506.21066612303014,511.44504232670886,512.6162552209371,513.8584727175028,511.3740377243714,18904,29172.966666666667,72.41789008757877,62.731159114371415,NaN,NaN,NaN,NaN,1.0032753415171152,36.313815599169054,12839892,0.49950887352749473,1.325964408342088,0.8264555348145933
2025-09-19T10:10:00-04:00,513.5,513.69,512.92,513.11,511.8649104200572,NaN,NaN,NaN,NaN,NaN,509.6206000000002,513.0955438210374,506.145656178963,511.44504232670886,512.6485265610061,513.8660464736571,511.43100664835504,21284,29491.166666666668,68.08335888272752,64.18629847530438,NaN,NaN,NaN,NaN,0.9866128171230423,36.3882300660616,12818608,0.38340151823428414,1.3057074326074485,0.9223059143731643
2025-09-19T10:15:00-04:00,513.18,513.18,512.08,512.15,511.8649104200572,NaN,NaN,NaN,NaN,NaN,509.68540000000024,513.225155833296,506.1456441667045,511.44504232670886,512.6403842498397,513.8303986314604,511.450369868219,19659,29404.833333333332,58.76005630329356,64.98766879608222,NaN,NaN,NaN,NaN,0.994711901614247,35.23724221555122,12798949,0.2208556919493767,1.1983755293098852,0.9775198373605085
2025-09-19T10:20:00-04:00,512.18,513,511.95,512.87,511.8649104200572,NaN,NaN,NaN,NaN,NaN,509.7582000000002,513.4055846848561,506.1108153151443,511.44504232670886,512.6391797163958,513.8077613948586,511.470598037933,15969,29386.033333333333,62.86713658813648,66.51572671266435,NaN,NaN,NaN,NaN,0.9986610514989446,33.994023384489374,12814918,0.14443435293490725,1.1580627785291426,1.0136284255942354
2025-09-19T10:25:00-04:00,512.84,513.46,512.58,513.08,511.8649104200572,NaN,NaN,NaN,NaN,NaN,509.83620000000025,513.5958651764868,506.0765348235138,511.44504232670886,512.6534781739525,513.8034326829853,511.5035236649197,16536,29597.266666666666,63.99347229591592,68.19737930615688,NaN,NaN,NaN,NaN,0.9901852621061625,33.261124869868844,12831454,0.09312410325081744,1.1300335546577571,1.0369094514069397
2025-09-19T10:30:00-04:00,513.06,513.32,512.89,513.1,511.8649104200572,NaN,NaN,NaN,NaN,NaN,509.9098000000002,513.776549001352,506.04305099864837,511.44504232670886,512.6660061490322,513.8022486097278,511.52976368833663,13279,29745.266666666666,64.10514242836015,69.60069329375256,NaN,NaN,NaN,NaN,0.9501720290985841,32.580576249149786,12844733,0.047905161157304255,1.09679090285357,1.0488857416962658
2025-09-19T10:35:00-04:00,513.19,513.45,512.51,512.78,511.8649104200572,NaN,NaN,NaN,NaN,NaN,509.97460000000024,513.9221378857203,506.0270621142802,511.44504232670886,512.679310175355,513.7859778827615,511.5726424679485,27107,30326.833333333332,60.85319269595833,70.95442563517481,NaN,NaN,NaN,NaN,0.9494454555915464,31.37965704298561,12817626,-0.012932606931825408,1.032719983031484,1.0456525899633093
2025-09-19T10:40:00-04:00,512.8,513.26,512.58,513.2,511.8649104200572,NaN,NaN,NaN,NaN,NaN,510.04740000000027,514.0946658621716,506.0001341378289,511.44504232670886,512.6952007083713,513.777561664569,511.6128397521736,25171,30908.3,63.47232242698958,70.31443767306028,NaN,NaN,NaN,NaN,0.9301993516207181,30.264517780118865,12842797,-0.03311618898296631,1.0042573537346016,1.0373735427175679
2025-09-19T10:45:00-04:00,513.2,513.58,512.8,513.5,511.8649104200572,NaN,NaN,NaN,NaN,NaN,510.11880000000025,514.2796295133464,505.9579704866541,511.38935353884375,512.7202927136353,513.7864721843493,511.6541132429213,23168,31224.233333333334,65.260226808944,69.96093149685706,NaN,NaN,NaN,NaN,0.9194708265049586,29.58494378376666,12865965,-0.03434309926976242,0.994444668630365,1.0287877679001274
2025-09-19T10:50:00-04:00,513.5,513.52,512.88,513.14,511.8649104200572,NaN,NaN,NaN,NaN,NaN,510.1916000000003,514.4331659559857,505.95003404401484,511.4474828310749,512.7373141890321,513.7871637352769,511.6874646427873,21235,31678.066666666666,61.37783196606431,68.8580991872175,NaN,NaN,NaN,NaN,0.8995086246117463,28.95391078715389,12844730,-0.06566540153128275,0.9467060159860239,1.0123714175173066
2025-09-19T10:55:00-04:00,513.09,513.81,513.02,513.76,511.8649104200572,NaN,NaN,NaN,NaN,NaN,510.2764000000003,514.628952372918,505.92384762708264,511.7569862648599,512.7555022670019,513.800002730202,511.7110018038019,13468,31710.7,65.21584505630824,67.70453962324508,NaN,NaN,NaN,NaN,0.8916865799966189,28.69929843197702,12858198,-0.051517970321656614,0.9479739546152359,0.9994919249368925
2025-09-19T11:00:00-04:00,513.76,513.95,513.37,513.41,511.8649104200572,NaN,NaN,NaN,NaN,NaN,510.35740000000027,514.7887475330966,505.92605246690385,512.017589011888,512.7746224378014,513.8142924796489,511.734952395954,13993,31797.766666666666,61.50041663621791,66.22833199089676,NaN,NaN,NaN,NaN,0.8694232528540062,28.620264634729153,12844205,-0.07139833681673213,0.9102440039159774,0.9816423407327095
2025-09-19T11:05:00-04:00,513.36,513.36,512.41,512.48,511.8649104200572,NaN,NaN,NaN,NaN,NaN,510.42340000000024,514.8808600120665,505.965939987934,512.017589011888,512.7738728810187,513.7976045298423,511.75014123219523,18869,31733.433333333334,52.87968339697265,64.09450408138356,NaN,NaN,NaN,NaN,0.8787501633644343,26.91511685559171,12825336,-0.14841601978486452,0.7961223160016289,0.9445383357864934
2025-09-19T11:10:00-04:00,512.42,512.6,511.96,512.01,511.8649104200572,NaN,NaN,NaN,NaN,NaN,510.4834000000002,514.9439064465153,506.02289355348506,512.017589011888,512.7529833305592,513.764067461937,511.7418991991815,22999,31996.533333333333,49.131460449717466,62.137002573084644,NaN,NaN,NaN,NaN,0.8616965802669778,25.27363989497956,12802337,-0.22751447609103082,0.6601452406727049,0.8876597167637357
2025-09-19T11:15:00-04:00,512.05,513,511.87,512.97,511.8649104200572,NaN,NaN,NaN,NaN,NaN,510.55860000000024,515.0573140561669,506.0598859438336,512.017589011888,512.7498087625256,513.7495513920563,511.7500661329949,14953,31967.366666666665,55.992929195038116,60.96379108076031,NaN,NaN,NaN,NaN,0.8808611102479077,23.733115206404616,12817290,-0.21199283825886828,0.6226686689401504,0.8346615071990187
2025-09-19T11:20:00-04:00,512.91,513.08,512.76,512.95,511.8649104200572,NaN,NaN,NaN,NaN,NaN,510.6365000000002,515.1631757117681,506.10982428823223,512.017589011888,512.7533530556119,513.7435307758932,511.76317533533063,13198,31957.733333333334,55.823989332901135,60.088121827201284,NaN,NaN,NaN,NaN,0.8407996023730607,22.40983851213974,12804092,-0.2000369644014336,0.5846153016972266,0.7846522660986602
2025-09-19T11:25:00-04:00,512.94,512.94,512.05,512.225,511.8649104200572,NaN,NaN,NaN,NaN,NaN,510.7030000000002,515.223369011419,506.1826309885814,512.017589011888,512.7441099414408,513.7226656526581,511.76555423022353,18289,31813.366666666665,49.941596018283626,59.458231806843436,NaN,NaN,NaN,NaN,0.8450282022035628,21.41156611847563,12785803,-0.23547831727283852,0.49030436950761214,0.7257826867804507
2025-09-19T11:30:00-04:00,512.24,512.24,511.38,512.02,NaN,NaN,NaN,514.2939506636537,514.2939506636537,514.2939506636537,510.76780000000014,515.2688959376014,506.26670406239884,512.017589011888,512.7277652529837,513.7041438803484,511.7513866256189,13289,31614.666666666668,48.38892411506332,58.42407377305249,NaN,NaN,NaN,NaN,0.8460976163318807,21.246079501498222,12772514,-0.2650475514368642,0.3944732474843704,0.6595207989212346
2025-09-19T11:35:00-04:00,511.97,511.98,511.55,511.55,NaN,NaN,NaN,514.2001347243967,NaN,NaN,510.8312000000001,515.2850305131408,506.3773694868593,512.017589011888,512.7146198031212,513.6916693752391,511.73757023100325,9043,31451.8,44.93929642008667,57.06306121049327,NaN,NaN,NaN,NaN,0.8192335008796015,21.09241335716206,12763471,-0.30569377116963703,0.27740358495918827,0.5830973561288253
2025-09-19T11:40:00-04:00,511.6,511.64,511.37,511.43,NaN,NaN,NaN,513.8662649641968,NaN,NaN,510.88960000000014,515.2964822720429,506.4827177279574,512.017589011888,512.6947345538359,513.6762668272614,511.7132022804104,11649,31298.2,44.075343577865695,55.632361292600805,NaN,NaN,NaN,NaN,0.7800025365310572,21.1520220333796,12751822,-0.3281191685807874,0.17294839540284102,0.5010675639836284
2025-09-19T11:45:00-04:00,511.51,511.96,511.45,511.96,NaN,NaN,NaN,513.8662649641968,NaN,NaN,510.9606000000001,515.3195258492942,506.60167415070606,512.017589011888,512.6840786050604,513.6646834613983,511.70347374872256,8620,30981.1,48.76073588154434,54.768614377285516,NaN,NaN,NaN,NaN,0.7621452124931226,20.66035011076158,12760442,-0.2957191997298791,0.13141856432127952,0.4271377640511586
2025-09-19T11:50:00-04:00,511.91,512.15,511.86,511.87,NaN,NaN,NaN,513.8662649641968,NaN,NaN,511.0298000000002,515.334076459456,506.72552354054443,511.31407120951036,512.6760432557254,513.654137572538,511.69794893891276,8213,29363,48.02493426526438,53.66522950859086,NaN,NaN,NaN,NaN,0.728420554457897,19.888645787802602,12752229,-0.26954716104818754,0.09020381274092415,0.3597509737891117
2025-09-19T11:55:00-04:00,511.88,511.99,511.61,511.9,NaN,NaN,NaN,513.8662649641968,NaN,NaN,511.1078000000002,515.3302003409378,506.88539965906267,511.2156844592693,512.667910468233,513.6447540367011,511.6910668997649,7212,24909.966666666667,48.30496310728276,52.454139244186486,NaN,NaN,NaN,NaN,0.7035333719966184,19.506076719842184,12759441,-0.24037817769448688,0.05927825167100309,0.29965642936549
2025-09-19T12:00:00-04:00,511.87,512.43,511.87,512.43,NaN,NaN,NaN,513.8662649641968,NaN,NaN,511.1942000000002,515.3438647381626,507.0445352618379,511.2156844592693,512.6622857456616,513.633850703142,511.69072078818124,10033,21549,53.111310025421936,51.863673391283456,NaN,NaN,NaN,NaN,0.6932809882825702,18.4184712038679,12769474,-0.1784031513885157,0.07665249012984532,0.255055641518361
2025-09-19T12:05:00-04:00,512.41,512.82,512.41,512.53,NaN,NaN,NaN,513.8662649641968,NaN,NaN,511.28120000000024,515.3561672684615,507.206232731539,511.5648761558481,512.6608858043132,513.6234693952229,511.6983022134036,14285,20601.5,53.98070090243685,51.06116309457836,NaN,NaN,NaN,NaN,0.6730466319766782,17.383564647242224,12783759,-0.12614974477878063,0.09736846054488524,0.22351820532366587
2025-09-19T12:10:00-04:00,512.5,512.78,512.33,512.7,NaN,NaN,NaN,513.8662649641968,NaN,NaN,511.37220000000025,515.365809975824,507.3785900241765,511.5648761558481,512.6594943291158,513.6104113776263,511.70857728060525,19118,19560.8,55.49155661156746,50.63195880710333,NaN,NaN,NaN,NaN,0.6571147296926249,16.29568480085006,12802877,-0.07797411372166174,0.1260505631715887,0.20402467689325043
2025-09-19T12:15:00-04:00,512.71,512.98,512.62,512.84,NaN,NaN,NaN,513.8662649641968,NaN,NaN,511.4552000000003,515.3945126099521,507.5158873900485,511.8167207397428,512.6618406660009,513.6056665291475,511.7180148028543,12247,18130.066666666666,56.75084279006508,50.908470192324216,NaN,NaN,NaN,NaN,0.6358922490002954,15.593004038344633,12815124,-0.03661661070463759,0.15825391351245344,0.19487052421709103
2025-09-19T12:20:00-04:00,512.92,513.2,512.68,513.08,NaN,NaN,NaN,513.8662649641968,NaN,NaN,511.5514000000003,515.4089541679872,507.6938458320134,512.0093765917942,512.664905678416,513.6047928682037,511.72501848862817,7649,16938.8,58.89776053449936,51.60606305552293,NaN,NaN,NaN,NaN,0.6276142312145668,15.27149941251589,12822773,0.00476461614216811,0.20082629439480115,0.19606167825263304
2025-09-19T12:25:00-04:00,513.08,513.3,512.78,512.88,NaN,NaN,NaN,513.8662649641968,NaN,NaN,511.6374000000003,515.4170847697616,507.85771523023897,512.0875012734352,512.667524934213,513.6040251917765,511.73102467664955,6653,16109.6,56.385810362355436,51.6341259960456,NaN,NaN,NaN,NaN,0.6199275004135251,15.123308061491581,12816120,0.015900808731532795,0.21593768916704903,0.20003688043551623
2025-09-19T12:30:00-04:00,512.82,512.95,511.92,511.94,NaN,NaN,NaN,513.8662649641968,NaN,NaN,511.70320000000027,515.3858700963979,508.0205299036027,512.0875012734352,512.6604425602095,513.5900514153475,511.7308337050715,14825,15363.9,46.37482050482897,50.95918536546901,NaN,NaN,NaN,NaN,0.6492183932411325,14.554485996200198,12801295,-0.039765090209775755,0.15033051767329653,0.19009560788307228
2025-09-19T12:35:00-04:00,511.97,512.47,511.97,512.13,NaN,NaN,NaN,513.8662649641968,NaN,NaN,511.7693999999999,515.3602320150756,508.17856798492426,512.0875012734352,512.6556872403164,513.5817822135834,511.7295922670494,8497,15017,48.37016710394272,50.84694044301608,NaN,NaN,NaN,NaN,0.6407027937239108,14.026294078429629,12809792,-0.06217855474666795,0.11237241444973733,0.17455096919640528
2025-09-19T12:40:00-04:00,512.11,512.45,512,512.45,NaN,NaN,NaN,513.8662649641968,NaN,NaN,511.83839999999987,515.3453248296217,508.331475170378,512.0875012734352,512.6520698178654,513.5741343298544,511.7300053058764,8637,14595.433333333332,51.634302058758855,51.07875315328005,NaN,NaN,NaN,NaN,0.6270811656007776,13.53583015478553,12818429,-0.05413707295803252,0.10687962799886463,0.16101670095689716
2025-09-19T12:45:00-04:00,512.42,512.67,512.27,512.57,NaN,NaN,NaN,513.8662649641968,NaN,NaN,511.9063999999999,515.3346963933384,508.4781036066614,512.0875012734352,512.6511355712327,513.570374787079,511.7318963553863,5368,14119.066666666668,52.83842718301833,51.64297677920374,NaN,NaN,NaN,NaN,0.6108610823435777,12.664497870661876,12823797,-0.040068712009716845,0.1109308109447511,0.15099952295446795
2025-09-19T12:50:00-04:00,512.5,512.5,512.12,512.12,NaN,NaN,NaN,513.8662649641968,NaN,NaN,511.96359999999993,515.3077746605668,508.6194253394331,512.0875012734352,512.6489561000154,513.5661933907621,511.7317188092687,4630,13741.1,48.01125117999186,51.92411303649847,NaN,NaN,NaN,NaN,0.5993710050333254,12.12578392558598,12819167,-0.05924505036832964,0.0769432099940559,0.13618826036238554
2025-09-19T12:55:00-04:00,512.12,512.69,512.1,512.33,NaN,NaN,NaN,513.8662649641968,NaN,NaN,512.0197999999999,515.2914839456892,508.74811605431074,512.0875012734352,512.6445335257938,513.5550410608196,511.73402599076803,14012,13656.966666666667,50.29342418023344,52.03359077211911,NaN,NaN,NaN,NaN,0.5987016475309473,11.26719416416011,12833179,-0.05599857727795332,0.06619003876494389,0.12218861604289721
2025-09-19T13:00:00-04:00,512.26,512.67,512.15,512.3,NaN,NaN,NaN,513.8662649641968,NaN,NaN,512.0812,515.2549167863757,508.90748321362423,512.0875012734352,512.6420999383389,513.5488738218003,511.73532605487753,7907,13477.9,49.95604838727185,52.17152749511964,NaN,NaN,NaN,NaN,0.5930801012787354,10.469932242836089,12825272,-0.05405671308855568,0.054617724682202606,0.10867443777075829
2025-09-19T13:05:00-04:00,512.28,512.28,511.59,511.86,NaN,NaN,NaN,513.8648041974715,NaN,NaN,512.1425999999999,515.1748851054057,509.1103148945941,512.0875012734352,512.6312262147663,513.5355871782908,511.72686525124186,13285,13017.166666666666,45.17008147080595,51.94760737822845,NaN,NaN,NaN,NaN,0.6014315226159671,10.753482894548238,12811987,-0.07907638419499058,0.009828957527020066,0.08890534172201064
2025-09-19T13:10:00-04:00,511.87,512.02,511.73,511.92,NaN,NaN,NaN,513.7566312794046,NaN,NaN,512.2053999999999,515.0826165994556,509.3281834005442,512.0875012734352,512.626506355602,513.5299094038403,511.7231033073638,5732,12369.2,45.93078414514572,51.43471267249443,NaN,NaN,NaN,NaN,0.5791864138576811,11.016779928280949,12817719,-0.08759438780680244,-0.02058764303649241,0.06700674477031003
2025-09-19T13:15:00-04:00,511.89,512,511.61,511.61,NaN,NaN,NaN,513.654284403068,NaN,NaN,512.2621999999999,514.9732279674766,509.55117203252314,511.4650010187483,512.6177703574238,513.5209661930272,511.7145745218203,8959,11895.566666666668,42.63922423616811,50.62460719633238,NaN,NaN,NaN,NaN,0.5656730985821314,11.474261461681571,12808760,-0.10873582838294137,-0.06891304070836668,0.039822787674574686
2025-09-19T13:20:00-04:00,511.63,511.78,511.5,511.58,NaN,NaN,NaN,513.4434078392921,NaN,NaN,512.3259999999998,514.810171491895,509.84182850810464,511.37665153382346,512.6087866871741,513.5128335506254,511.7047398237228,8260,11463.066666666668,42.32312757982325,49.68400512263636,NaN,NaN,NaN,NaN,0.5452678772548344,12.095249110141129,12800500,-0.1185643486253136,-0.10838264810706733,0.010181700518246281
2025-09-19T13:25:00-04:00,511.55,511.75,511.45,511.71,NaN,NaN,NaN,513.3623438465971,NaN,NaN,512.3937999999999,514.607221387899,510.18037861210087,511.37665153382346,512.5976060552186,513.5023958817202,511.6928162287171,10674,11369.933333333332,44.251756078041296,48.79121321463466,NaN,NaN,NaN,NaN,0.5277487431652041,12.763232898370742,12811174,-0.11030586395370462,-0.1277006294238845,-0.017394765470179877
2025-09-19T13:30:00-04:00,511.65,511.7,511.16,511.16,NaN,NaN,NaN,513.1872373081154,NaN,NaN,512.4467999999999,514.3969453894938,510.49665461050614,511.37665153382346,512.5846853715743,513.4937046429973,511.6756661001514,9634,11224.633333333333,38.401216981224415,47.327174389400746,NaN,NaN,NaN,NaN,0.5293381186534006,13.893891307670234,12801540,-0.13428832043799105,-0.18525516601766867,-0.050966845579677636
2025-09-19T13:35:00-04:00,511.19,511.29,511.07,511.24,NaN,NaN,NaN,512.8873628850192,NaN,NaN,512.5045999999999,514.1056969241957,510.903503075804,511.37665153382346,512.5585731193811,513.478469232064,511.63867700669823,18023,11196.433333333332,39.65103613208287,46.131833372952705,NaN,NaN,NaN,NaN,0.5072425387495882,15.094277290702784,12819563,-0.13671037577884315,-0.2218548153032316,-0.08514443952438844
2025-09-19T13:40:00-04:00,511.25,511.71,511.24,511.71,NaN,NaN,NaN,512.8873628850192,NaN,NaN,512.5145999999999,514.0892565849887,510.93994341501104,511.37665153382346,512.5446717464858,513.4656970854139,511.62364640755777,13402,10876.533333333333,46.51674561865169,46.1419708810829,NaN,NaN,NaN,NaN,0.5045823574103299,15.003392665298701,12832965,-0.10029134174512508,-0.2105086167057948,-0.11021727496066971
2025-09-19T13:45:00-04:00,511.73,511.79,511.34,511.44,NaN,NaN,NaN,512.8873628850192,NaN,NaN,512.5223999999998,514.071618177236,510.9731818227636,511.3593212270587,512.5354459337078,513.4573800970593,511.61351177035635,8834,10672.566666666668,43.45804889033235,45.791105294396445,NaN,NaN,NaN,NaN,0.5006836175953095,14.709201765793617,12824131,-0.08843309828245516,-0.22075864781373866,-0.1323255495312835
2025-09-19T13:50:00-04:00,511.49,511.71,511.41,511.45,NaN,NaN,NaN,512.8873628850192,NaN,NaN,512.5027999999999,514.0807292254004,510.92487077459936,510.876456981647,512.5253759465987,513.4481957977475,511.6025560954499,9828,10560.233333333334,43.60595335155673,45.21765181531057,NaN,NaN,NaN,NaN,0.48634907348135564,14.436024501967465,12833959,-0.07452020845712815,-0.22547581010269369,-0.15095560164556554
2025-09-19T13:55:00-04:00,511.45,511.45,510.97,511.405,NaN,NaN,NaN,512.8436233489919,NaN,NaN,512.4540999999998,514.0141444739332,510.8940555260664,510.7907324682541,512.5086778067331,513.4364837999099,511.5808718135563,13370,10396.266666666666,43.06009164332726,44.519199276761206,NaN,NaN,NaN,NaN,0.48589556823268465,15.082027801725923,12820589,-0.06338896765248414,-0.23019181121117072,-0.16680284355868658
2025-09-19T14:00:00-04:00,511.37,511.43,511.02,511.125,NaN,NaN,NaN,512.8402768331285,NaN,NaN,512.3937999999998,513.9212600619012,510.86633993809846,510.7907324682541,512.495972962065,513.428223377749,511.5637225463811,9752,10278.366666666667,39.72766863140046,43.927514809004684,NaN,NaN,NaN,NaN,0.48047445621606616,15.681888008644492,12810837,-0.06943740331848716,-0.2535995977067955,-0.18416219438830836
2025-09-19T14:05:00-04:00,511.125,511.18,510.36,510.68,NaN,NaN,NaN,512.4236733407135,NaN,NaN,512.3201999999998,513.81591382315,510.8244861768496,510.741482572158,512.4595980371929,513.4154421131097,511.50375396127606,21384,10689.733333333334,35.08098015931823,42.8409116646536,NaN,NaN,NaN,NaN,0.5047262807720609,17.317574307889355,12789453,-0.09630831102058324,-0.3045475831640374,-0.20823927214345417
2025-09-19T14:10:00-04:00,510.67,511.3,510.61,511.08,NaN,NaN,NaN,512.4236733407135,NaN,NaN,512.2646999999998,513.7342025147316,510.7951974852681,510.741482572158,512.4368161812225,513.4023312390864,511.47130112335867,16330,10845.766666666666,41.68373048660836,42.2500318146062,NaN,NaN,NaN,NaN,0.5179601178597707,18.468147263458008,12805783,-0.0806762913647881,-0.3090846363494393,-0.22840834498465118
2025-09-19T14:15:00-04:00,511.08,511.11,510.72,510.82,NaN,NaN,NaN,512.4236733407135,NaN,NaN,512.2111,513.691924486599,510.730275513401,510.741482572158,512.4218088751761,513.3945894591012,511.449028291251,10229,10899.4,38.91328948403271,41.80311810126527,NaN,NaN,NaN,NaN,0.5088201094412147,19.536536436486042,12795554,-0.0811594970931703,-0.32985771635111405,-0.24869821925794375
2025-09-19T14:20:00-04:00,510.855,511.09,510.855,510.94,NaN,NaN,NaN,512.4236733407135,NaN,NaN,512.1676999999999,513.6676736133038,510.66772638669596,510.741482572158,512.4092166221783,513.3871578675887,511.43127537676787,9211,10932.666666666666,40.86675879364729,41.44140200472966,NaN,NaN,NaN,NaN,0.49176153019541236,20.52861209715493,12804765,-0.06728239228433686,-0.3328012096133648,-0.26551881732902793
2025-09-19T14:25:00-04:00,510.92,510.99,510.53,510.69,NaN,NaN,NaN,512.361054978209,NaN,NaN,512.1384999999998,513.6945118896421,510.5824881103575,510.741482572158,512.3840827632594,513.3757497372505,511.39241578926817,16295,11235.433333333332,38.13097830928049,41.119384438523404,NaN,NaN,NaN,NaN,0.4894928494671712,21.981387202494712,12788470,-0.0685911692318511,-0.3512577788688418,-0.2826666096369907
2025-09-19T14:30:00-04:00,510.67,511.07,510.59,511,NaN,NaN,NaN,512.361054978209,NaN,NaN,512.1010999999999,513.6747788618583,510.52742113814145,510.741482572158,512.3645832305575,513.3642912241172,511.3648752369978,14307,11377.9,43.20795241409522,41.182586212399976,NaN,NaN,NaN,NaN,0.488814788790946,23.04081406061605,12802777,-0.043455329527421205,-0.3369857715462672,-0.293530442018846
2025-09-19T14:35:00-04:00,511.05,511.53,510.97,511.52,NaN,NaN,NaN,512.361054978209,NaN,NaN,512.0699,513.6264750736921,510.5133249263078,510.7211860577264,512.3524294948936,513.3523623292336,511.3524966605536,13189,11341.366666666667,50.53980694815407,41.63173270312232,NaN,NaN,NaN,NaN,0.4938994467344459,22.546434741170465,12815966,0.010438574212557894,-0.2804822242531486,-0.2909207984657065
2025-09-19T14:40:00-04:00,511.52,511.9,510.96,511.57,NaN,NaN,NaN,512.361054978209,NaN,NaN,512.0392999999999,513.5736676353458,510.504932364654,510.46624485188266,512.3403871345445,513.3386446382693,511.3421296308196,15502,11220.833333333334,51.19228533434609,42.54538044263101,NaN,NaN,NaN,NaN,0.5257637719676996,21.126535149902885,12831468,0.04951417424780458,-0.22902808065595082,-0.2785422549037554
2025-09-19T14:45:00-04:00,511.59,511.61,510.73,510.84,NaN,NaN,NaN,512.361054978209,NaN,NaN,512.0005,513.5559539529762,510.4450460470237,510.46624485188266,512.32027610774,513.3233768964392,511.31717531904087,17990,11412.266666666666,42.39812276126456,42.74160091614397,NaN,NaN,NaN,NaN,0.5510663596842922,20.30840535616744,12813478,0.027362910479405866,-0.2443386168044981,-0.27170152728390395
2025-09-19T14:50:00-04:00,510.87,511.61,510.77,511.48,NaN,NaN,NaN,512.361054978209,NaN,NaN,511.9660999999999,513.4896724991502,510.4425275008496,510.46624485188266,512.3121330798205,513.3154448041199,511.308821355521,9095,11460.466666666667,50.4369037800928,43.021612213389766,NaN,NaN,NaN,NaN,0.5717044768497022,19.548713404841674,12822573,0.05536487431260906,-0.20249543439314266,-0.2578603087057517
2025-09-19T14:55:00-04:00,511.48,511.6,511.25,511.46,NaN,NaN,NaN,512.361054978209,NaN,NaN,511.9253,513.3905227270716,510.46007727292846,510.46624485188266,512.3014051674401,513.3031915807038,511.2996187541763,14322,11716.1,50.20112662132434,43.50326062274634,NaN,NaN,NaN,NaN,0.5558684427890108,18.84328516432489,12808251,0.07108815449437894,-0.16900011558777805,-0.240088270082157
2025-09-19T15:00:00-04:00,511.49,511.72,511.31,511.34,NaN,NaN,NaN,512.361054978209,NaN,NaN,511.8893,513.3214522404757,510.4571477595244,510.46624485188266,512.291121266495,513.2910911996033,511.29115133338667,14404,11702.066666666668,48.729225111616444,43.869208605607746,NaN,NaN,NaN,NaN,0.5454492683040832,17.837316695932078,12793847,0.07174736264693374,-0.15040406677348983,-0.22215142942042357
2025-09-19T15:05:00-04:00,511.36,511.39,511.18,511.25,NaN,NaN,NaN,512.361054978209,NaN,NaN,511.8391,513.1783963674959,510.49980363250404,510.46624485188266,512.2787075812477,513.2788197096335,511.27859545286185,14609,11905.8,47.6019346367268,44.19362596227914,NaN,NaN,NaN,NaN,0.5214886062823616,17.24108312519688,12779238,0.06468114867261837,-0.14129999357965062,-0.205981142252269
2025-09-19T15:10:00-04:00,511.27,511.62,511.12,511.6,NaN,NaN,NaN,512.361054978209,NaN,NaN,511.8028999999999,513.0660818396626,510.53971816033726,510.46624485188266,512.2661853888143,513.2638993224635,511.268471455165,18302,12227.966666666667,52.23011957408546,45.086658172470926,NaN,NaN,NaN,NaN,0.5199537058336215,16.011327542812293,12797540,0.0810755630465898,-0.10463668844403173,-0.18571225149062154
2025-09-19T15:15:00-04:00,511.55,511.93,511.3,511.32,NaN,NaN,NaN,512.361054978209,NaN,NaN,511.77969999999993,513.0348707613222,510.5245292386777,510.61751079236154,512.2584092062566,513.2538354962953,511.2629829162179,12749,12474,48.536607363171434,46.04777440131759,NaN,NaN,NaN,NaN,0.527814155416934,15.662488939730027,12784791,0.07092530665628996,-0.0970556181702591,-0.16798092482654906
2025-09-19T15:20:00-04:00,511.32,511.4,510.88,511.28,NaN,NaN,NaN,512.361054978209,NaN,NaN,511.76509999999996,513.0261844381465,510.5040155618534,510.61751079236154,512.2391064000042,513.2357719602027,511.2424408398057,22538,13070.933333333332,48.01424096804436,46.49995372142015,NaN,NaN,NaN,NaN,0.5272560014585802,14.85951173499251,12762253,0.05982404429472396,-0.0932008694581441,-0.15302491375286806
2025-09-19T15:25:00-04:00,511.3,511.68,511.15,511.22,NaN,NaN,NaN,512.361054978209,NaN,NaN,511.73009999999994,512.9520091456442,510.50819085435563,510.61751079236154,512.2227220567142,513.2173757794303,511.2280683339982,23493,13386.966666666667,47.19376404049384,47.09141618973881,NaN,NaN,NaN,NaN,0.527452001354398,14.163186177902642,12738760,0.04729595195700165,-0.093904973806616,-0.14120092576361765
2025-09-19T15:30:00-04:00,511.18,511.45,511.05,511.32,NaN,NaN,NaN,512.361054978209,NaN,NaN,511.69749999999993,512.8736007610486,510.5213992389513,510.61751079236154,512.200036807624,513.193373988038,511.2066996272099,31208,14163.666666666666,48.76519331702886,47.65559008426606,NaN,NaN,NaN,NaN,0.5183482869719394,13.26194630686416,12769968,0.04463332270380915,-0.0854092723838562,-0.13004259508766536
2025-09-19T15:35:00-04:00,511.31,511.52,511.07,511.13,NaN,NaN,NaN,512.361054978209,NaN,NaN,511.6755999999999,512.8523746428516,510.49882535714823,510.61751079236154,512.178059664235,513.1704036972682,511.1857156312018,30599,14740.8,45.966293230473426,48.21525543577984,NaN,NaN,NaN,NaN,0.5134662664739429,12.600408571454826,12739369,0.029684903133505358,-0.09293646617078366,-0.12262136930428902
2025-09-19T15:40:00-04:00,511.1,511.15,510.825,510.97,NaN,NaN,NaN,512.361054978209,NaN,NaN,511.65459999999985,512.8434546422609,510.46574535773885,510.61751079236154,512.1474317830198,513.1450498957606,511.14981367027895,35118,15720.333333333334,43.69207975686134,48.249835960263134,NaN,NaN,NaN,NaN,0.5000043902972319,12.052749561723695,12704251,0.009666481078379266,-0.11053826795631494,-0.1202047490346942
2025-09-19T15:45:00-04:00,510.97,512.25,510.97,512.12,NaN,NaN,NaN,512.361054978209,NaN,NaN,511.6659999999998,512.8615366998141,510.4704633001856,510.69579802915285,512.1357317839469,513.1194557432335,511.15200782466025,45118,16925.633333333335,59.284513687327355,48.87445787020408,NaN,NaN,NaN,NaN,0.5557183624188562,13.038984351030836,12749369,0.07109878618647031,-0.03133126630160632,-0.10243005248807663
2025-09-19T15:50:00-04:00,512.14,517.74,512.14,516.98,512.5724482151471,512.5724482151471,512.5724482151471,NaN,NaN,NaN,511.7769999999998,513.6834773800517,509.8705226199479,513.6866384233223,512.6976590994877,514.2641161129267,511.1312020860488,272452,25732.033333333333,81.9865412671328,51.07404757968885,NaN,NaN,NaN,NaN,0.917452765103224,17.195711389303543,13021821,0.41696393041977625,0.4187748605366437,0.0018109301168674347
2025-09-19T15:55:00-04:00,516.91,519.3,516.72,517.99,515.3982460235494,NaN,NaN,NaN,NaN,NaN,511.8975999999999,514.4786674071629,509.3165325928369,514.7673107386578,513.9575299949836,516.5972852416146,511.3177747483526,526069,42911.86666666667,83.98502686504813,54.04454072995911,NaN,NaN,NaN,NaN,1.036206139024417,21.37964163066996,13547890,0.6763268946227359,0.8472195483952873,0.17089265377255142