time,open,high,low,close,Long Stop,Long Stop Start,Buy Label,Short Stop,Short Stop Start,Sell Label,Basis,Upper,Lower,ATR Trailing Stoploss,VWAP,Upper Band #1,Lower Band #1,Volume,Volume MA,RSI,RSI-based MA,Regular Bullish,Regular Bullish Label,Regular Bearish,Regular Bearish Label,ATR,ADX,OnBalanceVolume
2025-08-11T13:20:00-04:00,526.22,526.35,525.82,525.91,525.1264529888265,NaN,NaN,NaN,NaN,NaN,524.7228000000002,528.6056129799855,520.839987020015,525.7756110093494,524.2560903537178,526.2709613589626,522.241219348473,5671,12772.233333333334,50.99249009558812,57.65270474443661,NaN,NaN,NaN,NaN,0.5860560214477373,21.939674334256143,12859359
2025-08-11T13:25:00-04:00,525.9,525.9,525.54,525.64,525.1264529888265,NaN,NaN,NaN,NaN,NaN,524.8306000000002,528.504368985309,521.1568310146914,525.4033150543582,524.2640439501414,526.2761590190137,522.2519288812691,4358,12363.8,47.99938365912755,56.21477016930821,NaN,NaN,NaN,NaN,0.5706234484871849,20.442497233219285,12855001
2025-08-11T13:30:00-04:00,525.59,526.08,525.59,525.81,525.1264529888265,NaN,NaN,NaN,NaN,NaN,524.9338000000002,528.4169770321441,521.4506229678564,525.4033150543582,524.2701710607645,526.2807105677975,522.2596315537314,3100,11796.966666666667,49.989801957564936,54.86659014347582,NaN,NaN,NaN,NaN,0.564864630738101,19.36729061890618,12858101
2025-08-11T13:35:00-04:00,525.76,525.91,525.04,525.04,NaN,NaN,NaN,527.319623703174,527.319623703174,527.319623703174,524.9922000000003,528.3813569212991,521.6030430787014,525.4033150543582,524.278552256555,526.2833253043727,522.2737792087373,6302,11495.833333333334,42.124779115934004,53.23960521461024,NaN,NaN,NaN,NaN,0.5866600142568085,18.561215028425277,12851799
2025-08-11T13:40:00-04:00,525.05,525.23,524.7,525.155,NaN,NaN,NaN,526.7980498984844,NaN,NaN,525.0679000000002,528.2952760793399,521.8405239206605,525.4033150543582,524.2827251504096,526.2826896503045,522.2827606505148,4460,11011.1,43.55317916818509,51.55554957856452,NaN,NaN,NaN,NaN,0.5826128703813203,18.327626581987968,12856259
2025-08-11T13:45:00-04:00,525.15,525.15,524.35,524.35,NaN,NaN,NaN,526.6095021758259,NaN,NaN,525.1425000000003,528.117768222774,522.1672317772266,525.4033150543582,524.2870866867906,526.2743094257044,522.2998639478769,10605,10618.533333333333,36.72106403796113,49.85614116389041,NaN,NaN,NaN,NaN,0.5984976653540794,18.594704669467173,12845654
2025-08-11T13:50:00-04:00,524.43,524.58,523.93,523.94,NaN,NaN,NaN,526.1186157132884,NaN,NaN,525.2043000000002,527.9389992590775,522.4696007409229,525.4033150543582,524.2851115301501,526.2580339238608,522.3121891364393,11870,10303.166666666666,33.8118423938721,48.38372265129512,NaN,NaN,NaN,NaN,0.6021764035430802,19.36422105310605,12833784
2025-08-11T13:55:00-04:00,523.94,524.16,523.43,523.59,NaN,NaN,NaN,525.6734513626843,NaN,NaN,525.2525000000002,527.7787947171199,522.7262052828804,525.4033150543582,524.278558574499,526.2407931337598,522.3163240152383,9782,10105.133333333333,31.516396897986965,46.83115201357811,NaN,NaN,NaN,NaN,0.6113066604328614,20.619764061188743,12824002
2025-08-11T14:00:00-04:00,523.65,523.93,523.57,523.78,NaN,NaN,NaN,525.592158118926,NaN,NaN,525.2811000000003,527.7056397825952,522.8565602174053,525.4033150543582,524.2743365263957,526.229122132565,522.3195509202264,6843,9951.8,34.13067394066151,45.751170245176176,NaN,NaN,NaN,NaN,0.5933561846876498,21.785625425836958,12830845
2025-08-11T14:05:00-04:00,523.79,524,523.68,523.71,NaN,NaN,NaN,525.592158118926,NaN,NaN,525.2839000000002,527.7008404538718,522.8669595461287,525.0956520434867,524.2705755595115,526.2181080346502,522.3230430843728,6670,9613.366666666667,33.621447971771076,44.51329775703515,NaN,NaN,NaN,NaN,0.5738307429242498,22.700822240344177,12824175
2025-08-11T14:10:00-04:00,523.78,523.83,523.25,523.31,NaN,NaN,NaN,525.3392391124925,NaN,NaN,525.2687000000002,527.7252209622045,522.8121790377959,524.8842173078315,524.2529714553716,526.182756295114,522.3231866156292,18886,9888.633333333333,30.79409661451608,43.08801172433688,NaN,NaN,NaN,NaN,0.5742714041439492,24.02571806912607,12805289
2025-08-11T14:15:00-04:00,523.42,523.72,523.2,523.25,NaN,NaN,NaN,525.2483646073792,NaN,NaN,525.2533000000003,527.7502618413461,522.7563381586546,524.8842173078315,524.2436105834888,526.1649809624837,522.3222402044939,9497,9656.766666666666,30.38138482332704,41.23107070578326,NaN,NaN,NaN,NaN,0.5703948752765229,25.30874670613824,12795792
2025-08-11T14:20:00-04:00,523.25,523.31,522.78,522.82,NaN,NaN,NaN,524.8243480343165,NaN,NaN,525.2311000000003,527.793605250201,522.6685947497996,524.5183738462651,524.2201152628173,526.1313799983508,522.3088505272839,16455,9783.9,27.53337937222183,39.16432050227612,NaN,NaN,NaN,NaN,0.5675095270424836,26.92333764924257,12779337
2025-08-11T14:25:00-04:00,522.78,523.18,522.45,522.54,NaN,NaN,NaN,524.6130140327567,NaN,NaN,525.2023000000004,527.8513105392154,522.5532894607853,523.8516990770122,524.1947248286621,526.0995414032528,522.2899082540713,15392,9654.033333333333,25.835068730553147,37.07178491280508,NaN,NaN,NaN,NaN,0.579115989396585,28.718549704720246,12763945
2025-08-11T14:30:00-04:00,522.57,522.6,522.3,522.3,NaN,NaN,NaN,524.2071952130859,NaN,NaN,525.1855000000003,527.8965420500708,522.4744579499297,523.6448592616097,524.1703865210911,526.0735971173764,522.2671759248059,12474,9765.633333333333,24.443335567966145,35.17541673226065,NaN,NaN,NaN,NaN,0.5591791330111195,30.51388102262638,12751471
2025-08-11T14:35:00-04:00,522.38,522.42,522.2,522.32,NaN,NaN,NaN,524.0173227034002,NaN,NaN,525.1729000000003,527.9308347993499,522.4149652006506,523.0508874092877,524.1444204311497,526.0468161553533,522.242024706946,13044,9582.033333333333,24.806855342034297,33.51880756675399,NaN,NaN,NaN,NaN,0.5349520520817477,32.26734451607339,12764515
2025-08-11T14:40:00-04:00,522.33,522.4,521.73,521.73,NaN,NaN,NaN,523.7860807623366,NaN,NaN,525.1441000000003,528.0129399671926,522.2752600328081,522.6794943535554,524.1101180460959,526.0170615896418,522.2031745025499,14837,9444.933333333332,21.517874575431648,31.48509846803019,NaN,NaN,NaN,NaN,0.5445983340759056,34.27142190192637,12749678
2025-08-11T14:45:00-04:00,521.7,522.02,521.62,521.79,NaN,NaN,NaN,523.5173952731393,NaN,NaN,525.1022000000003,528.101598712619,522.1028012873816,522.6794943535554,524.072895899771,525.9864831499622,522.1593086495798,15589,9665.766666666666,22.641143089716238,30.093410180443207,NaN,NaN,NaN,NaN,0.5342698816419108,36.21359428047636,12765267
2025-08-11T14:50:00-04:00,521.79,522.04,521.66,521.74,NaN,NaN,NaN,523.5173952731393,NaN,NaN,525.0550000000003,528.1873282071208,521.9226717928798,522.6794943535554,524.0439946877395,525.9621834355777,522.1258059399014,12481,9853.033333333333,22.35401753043456,28.57918434917531,NaN,NaN,NaN,NaN,0.5232506043817741,37.95266381264894,12752786
2025-08-11T14:55:00-04:00,521.745,522,521.73,521.91,NaN,NaN,NaN,523.4978746187076,NaN,NaN,525.0099000000004,528.2550899724037,521.7647100275971,522.4835954828443,524.0311139244419,525.95081568585,522.1114121630338,5843,9797.1,25.799453695248076,27.799069324695804,NaN,NaN,NaN,NaN,0.5051612754973603,39.56751409252348,12758629
2025-08-11T15:00:00-04:00,521.9,521.99,521.71,521.89,NaN,NaN,NaN,523.4468348633118,NaN,NaN,524.9511000000003,528.3116864305091,521.5905135694916,522.3828763862755,524.0104224834595,525.9325321332421,522.0883128336768,9460,9736.966666666667,25.65522000361962,27.216453439677768,NaN,NaN,NaN,NaN,0.48907832724754696,41.08513772229708,12749169
2025-08-11T15:05:00-04:00,521.88,521.89,521.58,521.64,NaN,NaN,NaN,523.3015241877067,NaN,NaN,524.8829000000003,528.3687606336281,521.3970393663725,521.9753011090203,523.9884542462171,525.9144673010966,522.0624411913376,9528,9792.533333333333,23.859601424582692,26.66953947729175,NaN,NaN,NaN,NaN,0.4762870181584326,42.614952775696835,12739641
2025-08-11T15:10:00-04:00,521.63,521.7,521.33,521.38,NaN,NaN,NaN,523.0607730882656,NaN,NaN,524.8047000000003,528.4234193366276,521.1859806633729,521.7472408872163,523.9582753679714,525.8922267733756,522.0243239625672,12136,10030.9,22.1252223924008,25.812007223844557,NaN,NaN,NaN,NaN,0.46869508828997347,44.25490631250466,12727505
2025-08-11T15:15:00-04:00,521.38,521.48,520.93,521.19,NaN,NaN,NaN,522.7555106751624,NaN,NaN,524.7121000000003,528.4569161980291,520.9672838019715,521.303792709773,523.9046476288864,525.8572085111847,521.9520867465882,20081,10182.166666666666,20.928003489255815,24.905332617950613,NaN,NaN,NaN,NaN,0.47450258198355166,46.08187902102822,12707424
2025-08-11T15:20:00-04:00,521.19,521.5,521.14,521.36,NaN,NaN,NaN,522.7555106751624,NaN,NaN,524.6127000000004,528.4433193803345,520.7820806196662,521.2730341678184,523.8790070475683,525.838534847914,521.9194792472225,10403,10357.4,24.84646287802535,24.480501636772704,NaN,NaN,NaN,NaN,0.46632382612758466,47.698091660925506,12717827
2025-08-11T15:25:00-04:00,521.34,521.5,521.23,521.38,NaN,NaN,NaN,522.7555106751624,NaN,NaN,524.5127000000002,528.413956827947,520.6114431720534,521.1474273342548,523.8583275137828,525.8229035455906,521.893751481975,8670,10277.666666666666,25.315373012760247,24.118643650303643,NaN,NaN,NaN,NaN,0.4523006956898987,49.19886054083013,12726497
2025-08-11T15:30:00-04:00,521.4,521.49,521.1,521.28,NaN,NaN,NaN,522.7555106751624,NaN,NaN,524.4217000000003,528.4071593758981,520.4362406241025,521.0049462361108,523.838516748405,525.8083584646879,521.8686750321222,8177,10252.166666666666,24.49250883761178,23.90143861211721,NaN,NaN,NaN,NaN,0.44785064599776214,50.69861463848547,12718320
2025-08-11T15:35:00-04:00,521.24,521.305,520.88,521.29,NaN,NaN,NaN,522.5647075277316,NaN,NaN,524.3489000000003,528.4264754017757,520.2713245982249,521.0049462361108,523.7922214424945,525.775952348731,521.8084905362579,18633,10623.8,24.755899855201775,23.824355121020684,NaN,NaN,NaN,NaN,0.44621845699791873,52.26087952556551,12736953
2025-08-11T15:40:00-04:00,521.32,521.58,521.23,521.485,NaN,NaN,NaN,522.5647075277316,NaN,NaN,524.2746000000003,528.42221899854,520.1269810014606,521.0049462361108,523.7543746547102,525.7443501441679,521.7643991652525,17577,10950.2,29.89160673596851,24.21351734730657,NaN,NaN,NaN,NaN,0.43934571006949763,52.517443766275505,12754530
2025-08-11T15:45:00-04:00,521.48,521.76,521.33,521.76,NaN,NaN,NaN,522.5647075277316,NaN,NaN,524.2236000000003,528.4305105240132,520.0166894759873,521.0049462361108,523.7167181963375,525.709034976458,521.724401416217,19658,11282.733333333334,36.47644807700032,25.04705968551843,NaN,NaN,NaN,NaN,0.4386781593502442,52.044091899840474,12774188
2025-08-11T15:50:00-04:00,521.74,521.93,520.2,520.545,NaN,NaN,NaN,522.5647075277316,NaN,NaN,524.1461000000003,528.4766372827409,519.8155627172597,520.9469569888887,523.6000868158916,525.630195317429,521.5699783143542,48056,12695.566666666668,25.210190143062647,25.310796511777788,NaN,NaN,NaN,NaN,0.5309154336823628,52.77079909385858,12726132
2025-08-11T15:55:00-04:00,520.5,522.1,520.2,521.97,NaN,NaN,NaN,522.5647075277316,NaN,NaN,524.0841000000004,528.4485842486329,519.7196157513679,520.785778325053,523.2666274828616,525.292621396766,521.2406335689573,210575,19569.466666666667,46.198754991084705,26.993483076161247,NaN,NaN,NaN,NaN,0.6287071884193354,52.90553771675008,12936707
2025-08-12T09:30:00-04:00,523.76,525.8,523.64,525.14,522.4781600963718,522.4781600963718,522.4781600963718,NaN,NaN,NaN,524.0701000000004,528.4164177468682,519.7237822531325,522.0725985024271,524.86,524.86,524.86,57986,21399,67.82818153099865,30.241637647630114,NaN,NaN,NaN,NaN,0.8573709606750919,50.99004887310462,12994693
2025-08-12T09:35:00-04:00,525.16,526.05,525.085,525.91,523.2959710010821,NaN,NaN,NaN,NaN,NaN,524.0669000000003,528.4075551990766,519.726244800924,522.5855788019418,525.1909701123618,525.5939662584832,524.7879739662404,39111,22492.633333333335,70.88956364897757,33.462359787182216,NaN,NaN,NaN,NaN,0.8650587491982937,49.40460536419281,13033804
2025-08-12T09:40:00-04:00,525.92,527.6,525.2,525.51,523.9044495919421,NaN,NaN,NaN,NaN,NaN,524.0501000000004,528.3616841586128,519.738515841388,523.6284630415535,525.5486338163101,526.0937352600783,525.0035323725419,62607,24430.866666666665,67.30651280302797,36.437452129997105,NaN,NaN,NaN,NaN,0.9746974099698426,48.93124465856394,12971197
2025-08-12T09:45:00-04:00,525.4,526.09,524.31,524.55,523.9044495919421,NaN,NaN,NaN,NaN,NaN,523.9943000000004,528.2051692732509,519.7834307267499,523.6284630415535,525.4066857442525,525.9383043182934,524.8750671702117,53548,25862.3,59.529721508706096,38.98531785029163,NaN,NaN,NaN,NaN,1.0322190235434314,47.38734891977372,12917649
2025-08-12T09:50:00-04:00,524.55,525,523.95,524.71,523.9044495919421,NaN,NaN,NaN,NaN,NaN,523.9453000000003,528.0636809484942,519.8269190515065,523.6284630415535,525.2568055152881,525.8385414154912,524.6750696150849,45435,26981.133333333335,60.35196131001694,41.71579920154993,NaN,NaN,NaN,NaN,1.0334890932903258,45.54408369104982,12963084
2025-08-12T09:55:00-04:00,524.685,525.36,524.03,524.73,523.9044495919421,NaN,NaN,NaN,NaN,NaN,523.8973000000004,527.9209452175199,519.8736547824809,523.6284630415535,525.2024073609616,525.7785333331013,524.6262813888219,28386,27601.266666666666,60.46010284610284,44.53952058418185,NaN,NaN,NaN,NaN,1.054668443769591,44.091632387859676,12991470
2025-08-12T10:00:00-04:00,524.68,524.68,523.58,524.37,NaN,NaN,NaN,526.8733326741237,526.8733326741237,526.8733326741237,523.8395000000004,527.749693473043,519.9293065269578,523.6284630415535,525.0918125658383,525.7182751881847,524.4653499434918,36004,28573.3,57.42396695862038,46.866485161367216,NaN,NaN,NaN,NaN,1.06147784064319,42.21856678617602,12955466
2025-08-12T10:05:00-04:00,524.31,524.33,522.65,522.95,NaN,NaN,NaN,526.3431811889363,NaN,NaN,523.7597000000004,527.5752457848724,519.9441542151284,523.6284630415535,524.8818695958074,525.7041938201019,524.059545371513,43151,29789.333333333332,47.32813253874302,48.43882512750884,NaN,NaN,NaN,NaN,1.1085151377401068,39.50748641202481,12912315
2025-08-12T10:10:00-04:00,522.99,524.07,522.99,524.07,NaN,NaN,NaN,526.3431811889363,NaN,NaN,523.6953000000003,527.3766668164401,520.0139331835605,523.6284630415535,524.8332091012509,525.6715371552817,523.99488104722,15866,29688.666666666668,54.171899961916445,50.55878163638774,NaN,NaN,NaN,NaN,1.1093354850443853,36.99005463602726,12928181
2025-08-12T10:15:00-04:00,524.1,525.61,524.1,525.58,NaN,NaN,NaN,526.3431811889363,NaN,NaN,523.6723000000004,527.291382872303,520.0532171276978,523.6284630415535,524.8497152299577,525.6638643148767,524.0355661450387,25539,30223.4,61.44529982328292,53.17945306267926,NaN,NaN,NaN,NaN,1.140097236112641,35.89326312927916,12953720
2025-08-12T10:20:00-04:00,525.63,526.86,525.58,526.58,523.224313393056,523.224313393056,523.224313393056,NaN,NaN,NaN,523.6811000000004,527.3261878119353,520.0360121880655,523.6284630415535,524.9930798972407,525.8831218750714,524.10303791941,43388,31121.166666666668,65.36561373518657,55.71331070548054,NaN,NaN,NaN,NaN,1.150090290676022,35.6410996272246,12997108
2025-08-12T10:25:00-04:00,526.59,526.81,525.74,526.11,523.2695718751899,NaN,NaN,NaN,NaN,NaN,523.6829000000004,527.3326918237588,520.033108176242,523.6284630415535,525.0364139256897,525.9394561027797,524.1333717485996,16513,31158.533333333333,62.16613013714946,57.548287995491194,NaN,NaN,NaN,NaN,1.1443695556277302,35.406947803888215,12980595
2025-08-12T10:30:00-04:00,526.28,526.74,526.03,526.13,523.4193640626812,NaN,NaN,NaN,NaN,NaN,523.6935000000004,527.368492924665,520.0185070753358,523.7178110962955,525.0846900641699,526.0028401042132,524.1665400241266,18572,31361.8,62.250805108716484,60.19404620732361,NaN,NaN,NaN,NaN,1.1133431587971807,35.18952111079015,12999167
2025-08-12T10:35:00-04:00,526.16,526.74,525.98,526.4,523.4255293325593,NaN,NaN,NaN,NaN,NaN,523.7059000000004,527.413013534367,519.9987864656338,523.9422488770364,525.1338064440172,526.0674818762403,524.200131011794,19262,31569.066666666666,63.44038697655466,61.4255913491429,NaN,NaN,NaN,NaN,1.0881043617402386,34.923402149311194,13018429
2025-08-12T10:40:00-04:00,526.45,526.69,525.7,525.73,523.4255293325593,NaN,NaN,NaN,NaN,NaN,523.7053000000004,527.4110929834941,519.9995070165068,523.9567991016291,525.1769155782968,526.1083048883385,524.245526268255,25242,31915.9,58.512811026476164,60.760207741677,NaN,NaN,NaN,NaN,1.0810969073302223,34.30674874808973,12993187
2025-08-12T10:45:00-04:00,525.74,526.01,525,526,523.4255293325593,NaN,NaN,NaN,NaN,NaN,523.6981000000005,527.3845822739714,520.0116177260296,523.9567991016291,525.2023302111916,526.1159272798658,524.2887331425173,28835,32357.433333333334,59.86568397937679,59.97278776527695,NaN,NaN,NaN,NaN,1.0760185568066345,32.869937384061046,13022022
2025-08-12T10:50:00-04:00,525.99,526.67,525.39,525.39,523.4255293325593,NaN,NaN,NaN,NaN,NaN,523.6785000000004,527.3180731887612,520.0389268112397,523.9567991016291,525.226644266056,526.1299556694541,524.3233328626579,23054,32709.866666666665,55.465069527250016,59.12697038843566,NaN,NaN,NaN,NaN,1.0905886598918728,32.079121265223726,12998968
2025-08-12T10:55:00-04:00,525.39,525.41,524.35,525.08,523.4255293325593,NaN,NaN,NaN,NaN,NaN,523.6549000000005,527.2421370923095,520.0676629076914,523.9567991016291,525.2161507907002,526.1039666234464,524.3283349579541,22682,33271.166666666664,53.319996764127765,58.68341862096578,NaN,NaN,NaN,NaN,1.088403755613878,30.207129258604485,12976286
2025-08-12T11:00:00-04:00,525.03,525.41,524.79,525.38,523.4255293325593,NaN,NaN,NaN,NaN,NaN,523.6443000000005,527.2078740536863,520.0807259463147,523.9567991016291,525.2159238703663,526.0993168953829,524.3325308453497,6079,33158.46666666667,55.12857208791034,58.310319390815316,NaN,NaN,NaN,NaN,1.0549463444986011,28.46885096674376,12982365
2025-08-12T11:05:00-04:00,525.42,526.1,525.42,526.05,523.4255293325593,NaN,NaN,NaN,NaN,NaN,523.6525000000005,527.2362350622527,520.0687649377483,523.9567991016291,525.2265326283228,526.1063890916361,524.3466761650096,10291,33183.9,58.9534744734536,58.202703078483225,NaN,NaN,NaN,NaN,1.0310216056058459,27.469404831646933,12992656
2025-08-12T11:10:00-04:00,525.99,526.52,525.97,526.19,523.4255293325593,NaN,NaN,NaN,NaN,NaN,523.6601000000005,527.263661287975,520.056538712026,524.3431253836975,525.2513168770447,526.1340040342819,524.3686297198075,15794,33305.833333333336,59.726000540107904,58.36713404858948,NaN,NaN,NaN,NaN,0.9966629194911393,26.886739929908167,13008450
2025-08-12T11:15:00-04:00,526.2,526.75,526.16,526.75,523.6574097271281,NaN,NaN,NaN,NaN,NaN,523.6943000000005,527.381093191464,520.007506808537,524.7135003069579,525.294281243141,526.1929028469131,524.3956596393689,21749,33361.433333333334,62.74630529936147,59.46843210291936,NaN,NaN,NaN,NaN,0.9676155680989174,26.531668845785944,13030199
2025-08-12T11:20:00-04:00,526.75,527.06,526.635,526.7,524.119118375895,NaN,NaN,NaN,NaN,NaN,523.7252000000004,527.4856084667335,519.9647915332673,525.2183002455663,525.3494983823264,526.2757140167785,524.4232827478743,25119,33851.96666666667,62.29708395195921,60.04880238792242,NaN,NaN,NaN,NaN,0.9288573132347057,26.45150487651362,13005080
2025-08-12T11:25:00-04:00,526.65,526.85,526.04,526.4,524.119118375895,NaN,NaN,NaN,NaN,NaN,523.7662000000005,527.5970069954687,519.9353930045322,525.2183002455663,525.3699673752257,526.2991184037019,524.4408163467494,13212,34003.36666666667,59.54262600650837,59.912897115295664,NaN,NaN,NaN,NaN,0.9203675051465166,25.618766621632776,12991868
2025-08-12T11:30:00-04:00,526.44,526.63,525.95,526.49,524.119118375895,NaN,NaN,NaN,NaN,NaN,523.8172000000004,527.7230659266369,519.911334073364,525.2183002455663,525.3884508331001,526.318528968807,524.4583726973933,13314,34174.6,60.112412481085734,59.53766845428846,NaN,NaN,NaN,NaN,0.9031983976360475,24.7339801868155,13005182
2025-08-12T11:35:00-04:00,526.505,527.04,526.49,526.9,524.1278613616796,NaN,NaN,NaN,NaN,NaN,523.8834000000005,527.88270265876,519.884097341241,525.29084972573,525.4187524103153,526.3614947551071,524.4760100655235,15480,34069.5,62.69029039191622,59.575108472486086,NaN,NaN,NaN,NaN,0.8779699406620408,24.30010149612533,13020662
2025-08-12T11:40:00-04:00,526.9,527.24,526.74,527.09,524.4045494816033,NaN,NaN,NaN,NaN,NaN,523.9496000000004,528.0482118817157,519.850988118285,525.590679780584,525.4512178456304,526.4113325397647,524.4911031514961,14997,33983.5,63.85606459323125,59.689769864237135,NaN,NaN,NaN,NaN,0.8509720877576094,24.082072398639156,13035659
2025-08-12T11:45:00-04:00,527.14,527.27,526.53,526.57,524.4045494816033,NaN,NaN,NaN,NaN,NaN,524.0068000000005,528.1697627714816,519.8438372285193,525.590679780584,525.4717067958312,526.4385175197207,524.5048960719417,11520,33712.23333333333,58.471265654909054,59.33483262697674,NaN,NaN,NaN,NaN,0.843045510060638,23.578849949362954,13024139
2025-08-12T11:50:00-04:00,526.63,526.86,526.36,526.86,524.4045494816033,NaN,NaN,NaN,NaN,NaN,524.0778000000005,528.3112988646221,519.8443011353788,525.590679780584,525.5090766686114,526.4839536241193,524.5341997131036,23753,32902.13333333333,60.473149570411785,59.474856808686425,NaN,NaN,NaN,NaN,0.818542259342021,22.865908687358026,13047892
2025-08-12T11:55:00-04:00,526.93,527.02,526.65,526.99,524.4045494816033,NaN,NaN,NaN,NaN,NaN,524.1526000000005,528.4565266904652,519.8486733095357,525.590679780584,525.5224606590683,526.5019554891364,524.5429658290002,7618,26136.9,61.37207084453579,59.5824558704835,NaN,NaN,NaN,NaN,0.7865035265318768,22.38239735665687,13055510
2025-08-12T12:00:00-04:00,526.92,526.92,526.27,526.52,524.4045494816033,NaN,NaN,NaN,NaN,NaN,524.2266000000004,528.5634400658903,519.8897599341105,525.590679780584,525.5343374534581,526.514558280848,524.5541166260682,8992,24503.766666666666,56.37986305094002,59.64779826503278,NaN,NaN,NaN,NaN,0.7817532746367447,21.362207993422412,13046518
2025-08-12T12:05:00-04:00,526.48,527.15,526.34,526.99,524.4045494816033,NaN,NaN,NaN,NaN,NaN,524.3156000000005,528.6927952842601,519.9384047157408,525.590679780584,525.5564222130789,526.5425591876731,524.5702852384848,13789,23659.7,59.893235471614375,60.117315315567545,NaN,NaN,NaN,NaN,0.7837708978769733,20.696955172366447,13060307
2025-08-12T12:10:00-04:00,527.01,527.56,526.89,527.5,524.8025269509812,NaN,NaN,NaN,NaN,NaN,524.4196000000004,528.8471044163601,519.9920955836407,525.9198790004014,525.5993587421501,526.6105365817375,524.5881809025627,20174,22245.266666666666,63.3434474814725,60.70409212939341,NaN,NaN,NaN,NaN,0.7756444051714723,20.557952971230193,13080481
2025-08-12T12:15:00-04:00,527.5,527.95,527.5,527.71,525.3512757259367,NaN,NaN,NaN,NaN,NaN,524.5274000000004,529.0073313563067,520.0474686436941,526.4129032003211,525.6511462492556,526.7021703816057,524.6001221169055,20703,21150.433333333334,64.69040737153213,61.11387305068469,NaN,NaN,NaN,NaN,0.7523840905163703,20.849112696918308,13101184
2025-08-12T12:20:00-04:00,527.7,528.13,527.67,528.06,525.5714450111213,NaN,NaN,NaN,NaN,NaN,524.6540000000003,529.1681976028469,520.1398023971537,526.6703225602569,525.6826050889462,526.7600981975745,524.6051119803178,11745,20027.433333333334,66.87510335557513,61.62452325178949,NaN,NaN,NaN,NaN,0.7314995126223465,21.306493102922357,13112929
2025-08-12T12:25:00-04:00,528.13,528.18,527.9,527.92,525.779106601525,NaN,NaN,NaN,NaN,NaN,524.7766000000004,529.3059484914804,520.2472515085203,526.8722580482055,525.7233564027686,526.8339200528859,524.6127927526512,15385,19594.066666666666,65.13896694738108,61.79542765521946,NaN,NaN,NaN,NaN,0.6992495474350341,21.784649958796777,13097544
2025-08-12T12:30:00-04:00,527.93,528.04,527.26,527.5,525.779106601525,NaN,NaN,NaN,NaN,NaN,524.8918000000003,529.3993038588562,520.3842961411444,526.8722580482055,525.7496681076843,526.8742767749685,524.6250594404002,12441,18808.633333333335,60.098305347278625,61.63837204059943,NaN,NaN,NaN,NaN,0.7050174369039582,21.09331743866502,13085103
2025-08-12T12:35:00-04:00,527.52,527.77,527.39,527.73,525.779106601525,NaN,NaN,NaN,NaN,NaN,525.0082000000003,529.5022555222836,520.5141444777171,526.8722580482055,525.7631476945836,526.8948907937847,524.6314045953825,6407,17583.833333333332,61.83979387052481,61.80245545945774,NaN,NaN,NaN,NaN,0.6818019056965323,20.45136581282839,13091510
2025-08-12T12:40:00-04:00,527.715,528.08,527.715,527.77,525.779106601525,NaN,NaN,NaN,NaN,NaN,525.1258000000003,529.5949795038724,520.6566204961281,526.8722580482055,525.7775983877063,526.918656741865,524.6365400335477,6217,17262.2,62.149194533718635,61.947939891788664,NaN,NaN,NaN,NaN,0.6591731981467807,20.264657504952037,13097727
2025-08-12T12:45:00-04:00,527.78,528.37,527.66,528.36,525.8539383877944,NaN,NaN,NaN,NaN,NaN,525.2602000000003,529.7061028146949,520.8142971853057,527.012068896545,525.8176930037738,526.9892447707916,524.646141236756,15605,16931.066666666666,66.46785065134806,62.217765624605235,NaN,NaN,NaN,NaN,0.6628036839934418,20.453061632451533,13113332
2025-08-12T12:50:00-04:00,528.355,528.7,528.35,528.67,526.4144411883493,NaN,NaN,NaN,NaN,NaN,525.4060000000003,529.8113018055202,521.0006981944804,527.4386551172361,525.9368765774881,527.2125696222795,524.6611835326967,41389,16864.433333333334,68.50141934887073,62.54957667857949,NaN,NaN,NaN,NaN,0.6404605637081976,21.014802694977263,13154721
2025-08-12T12:55:00-04:00,528.64,528.78,528.16,528.26,526.4144411883493,NaN,NaN,NaN,NaN,NaN,525.5474000000003,529.855109479257,521.2396905207436,527.4609240937888,525.9656174098618,527.2611365242346,524.670098295489,11298,16690.6,63.05485274883188,62.87697575671683,NaN,NaN,NaN,NaN,0.6389990948718981,21.153915871330646,13143423
2025-08-12T13:00:00-04:00,528.29,528.71,528.22,528.67,526.4144411883493,NaN,NaN,NaN,NaN,NaN,525.6936000000003,529.918309239432,521.4688907605686,527.4609240937888,525.9932934904099,527.3088077792479,524.6777792015719,10550,16423.2,65.96882168864903,63.269523765162354,NaN,NaN,NaN,NaN,0.6283563023810489,21.283092392230213,13153973
2025-08-12T13:05:00-04:00,528.66,528.79,528.46,528.68,526.6035457217602,NaN,NaN,NaN,NaN,NaN,525.8396000000004,529.9612282410368,521.7179717589639,527.5847914200248,526.0198790946421,527.3551552979051,524.6846028913791,9919,16111.766666666666,66.0391785617066,63.60288860210312,NaN,NaN,NaN,NaN,0.6070451379252545,21.51294179558824,13163892
2025-08-12T13:10:00-04:00,528.7,528.88,528.48,528.65,526.6958845525893,NaN,NaN,NaN,NaN,NaN,525.9870000000003,529.9706646442246,522.003335355776,527.7158331360199,526.0420778802892,527.3935083079884,524.6906474525899,8352,15548.766666666666,65.60100519650383,64.26154161250054,NaN,NaN,NaN,NaN,0.5922561995020204,21.853779139259032,13155540
2025-08-12T13:15:00-04:00,528.66,528.86,528.4,528.62,526.6958845525893,NaN,NaN,NaN,NaN,NaN,526.1336000000003,529.9510976302703,522.3161023697304,527.7158331360199,526.0752035293763,527.4490577021777,524.7013493565748,12945,15019.1,65.13558277756587,64.63599499149707,NaN,NaN,NaN,NaN,0.5828093281090215,21.970782341063643,13142595
2025-08-12T13:20:00-04:00,528.62,529.08,528.58,528.69,526.894101420851,NaN,NaN,NaN,NaN,NaN,526.2777000000002,529.922461286835,522.6329387131655,527.9009332070527,526.1198490592191,527.5252925919507,524.7144055264874,16930,14814.966666666667,65.7462524693259,64.80762391920088,NaN,NaN,NaN,NaN,0.5768943761012343,22.41535216228058,13159525
2025-08-12T13:25:00-04:00,528.74,528.78,528.15,528.19,526.894101420851,NaN,NaN,NaN,NaN,NaN,526.4063000000002,529.8527351492229,522.9598648507775,527.9009332070527,526.1423533357694,527.5585991448995,524.7261075266392,10359,14404.2,57.93973860886305,64.32543329329594,NaN,NaN,NaN,NaN,0.5806876349511458,21.779129522324762,13149166
2025-08-12T13:30:00-04:00,528.2,528.59,528.16,528.49,526.894101420851,NaN,NaN,NaN,NaN,NaN,526.5652000000002,529.6272051988639,523.5031948011366,527.9009332070527,526.1665087571381,527.5943360845943,524.738681429682,11152,14573.3,60.936763108050805,63.9012661327585,NaN,NaN,NaN,NaN,0.56992423245464,21.1883513566515,13160318
2025-08-12T13:35:00-04:00,528.48,528.49,527.65,527.84,526.894101420851,NaN,NaN,NaN,NaN,NaN,526.6826000000002,529.4685441771148,523.8966558228856,527.9009332070527,526.1916847096415,527.625544311944,524.757825107339,14651,14718.633333333333,52.24959819452735,62.980596936126084,NaN,NaN,NaN,NaN,0.5892153587078823,19.813760792612577,13145667
2025-08-12T13:40:00-04:00,527.865,528.09,527.685,528.09,526.894101420851,NaN,NaN,NaN,NaN,NaN,526.7416000000003,529.519306564338,523.9638934356626,527.9009332070527,526.205436207651,527.6420916287924,524.7687807865096,8356,14470.7,54.91198490626183,62.61014547605346,NaN,NaN,NaN,NaN,0.5760571188001826,18.53735526886215,13154023
2025-08-12T13:45:00-04:00,528.11,528.95,528.11,528.91,526.894101420851,NaN,NaN,NaN,NaN,NaN,526.8016000000002,529.6339286811258,523.9692713188747,527.9009332070527,526.2333208355826,527.6852414783707,524.7814001927945,12329,14156.7,62.33086399141433,62.64522191325985,NaN,NaN,NaN,NaN,0.5963387531715991,18.605425919618792,13166352
2025-08-12T13:50:00-04:00,528.94,529.16,528.84,529.1,527.1133065269395,NaN,NaN,NaN,NaN,NaN,526.8734000000003,529.7527432858399,523.9940567141607,527.9009332070527,526.2625423588763,527.7346293073633,524.7904554103893,11430,13700.4,63.81649922553996,62.76431510553281,NaN,NaN,NaN,NaN,0.5766002708021947,18.96993709632773,13177782
2025-08-12T13:55:00-04:00,529.13,529.3,529.11,529.18,527.3767925938968,NaN,NaN,NaN,NaN,NaN,526.9660000000002,529.8382980343165,524.093701965684,528.1207932117037,526.2819273810919,527.7682736331362,524.7955811290476,7284,13502.8,64.45221091274614,62.62034083848981,NaN,NaN,NaN,NaN,0.5497002514591759,19.505966468166584,13185066
2025-08-12T14:00:00-04:00,529.22,529.61,529.22,529.57,527.6112565669015,NaN,NaN,NaN,NaN,NaN,527.0632000000002,529.9524225663636,524.1739774336368,528.4516345693629,526.3198882081673,527.8372366873828,524.8025397289518,13300,13502.333333333334,67.45416682879667,62.545537087055955,NaN,NaN,NaN,NaN,0.5411502334978108,20.421595863247603,13198366
2025-08-12T14:05:00-04:00,529.55,530.26,529.53,530.21,528.0736994502241,NaN,NaN,NaN,NaN,NaN,527.1728000000002,530.1149489829512,524.2306510170491,528.9683076554903,526.4160545998005,528.0244196145082,524.8076895850928,29940,13984.333333333334,71.68061530503331,63.161662983927485,NaN,NaN,NaN,NaN,0.5546395025336828,22.008072425770855,13228306
2025-08-12T14:10:00-04:00,530.23,530.8,530.16,530.68,528.6542131115776,NaN,NaN,NaN,NaN,NaN,527.2990000000002,530.2903401674639,524.3076598325365,529.4466461243923,526.4874187732084,528.1702230839462,524.8046144624707,20143,14155.866666666667,74.31820990160541,63.758047856281514,NaN,NaN,NaN,NaN,0.5607366809241331,23.97264359908361,13248449
2025-08-12T14:15:00-04:00,530.7,530.86,530.35,530.62,528.7926579701423,NaN,NaN,NaN,NaN,NaN,527.4524000000002,530.3200138089626,524.5847861910379,529.5223168995138,526.548630603325,528.2917276633568,524.8055335432932,17572,14357.6,73.37863387061454,64.28229466406064,NaN,NaN,NaN,NaN,0.5571126322866944,25.847906104087652,13230877
2025-08-12T14:20:00-04:00,530.63,530.95,530.3,530.57,528.8064007896812,NaN,NaN,NaN,NaN,NaN,527.5824000000002,530.4139919475775,524.7508080524229,529.554853519611,526.6144477164254,528.4177403194918,524.811155113359,19511,14216.2,72.55542504681758,64.77903893908305,NaN,NaN,NaN,NaN,0.5637474442662227,27.66865358304355,13211366
2025-08-12T14:25:00-04:00,530.565,530.59,529.96,530.09,528.8064007896812,NaN,NaN,NaN,NaN,NaN,527.6726000000002,530.5305091933698,524.8146908066307,529.554853519611,526.6547261884507,528.4874304301727,524.8220219467287,13616,14416.133333333333,65.01478139348976,64.7704102687919,NaN,NaN,NaN,NaN,0.568479769675778,28.458639700918674,13197750
2025-08-12T14:30:00-04:00,530.07,530.07,529.34,529.38,528.8064007896812,NaN,NaN,NaN,NaN,NaN,527.7286000000003,530.6083250142078,524.8488749857927,529.554853519611,526.7070512731499,528.5645401187621,524.8495624275376,22030,14850.733333333334,55.78014206765409,64.05854524010105,NaN,NaN,NaN,NaN,0.5814455004132224,27.79877384176519,13175720
2025-08-12T14:35:00-04:00,529.37,529.65,529.28,529.58,528.8064007896812,NaN,NaN,NaN,NaN,NaN,527.7980000000002,530.6855899981828,524.9104100018177,529.554853519611,526.7394514703454,528.6102366822921,524.8686662583988,14520,14875.1,57.606812639554924,64.03476481372192,NaN,NaN,NaN,NaN,0.5663422503837069,27.06304422594214,13190240
2025-08-12T14:40:00-04:00,529.59,529.66,529.41,529.46,528.8064007896812,NaN,NaN,NaN,NaN,NaN,527.8646000000002,530.7488391297657,524.9803608702348,529.554853519611,526.7585797038166,528.636957668825,524.8802017388083,8712,14493.033333333333,56.1091549826477,63.689935661907406,NaN,NaN,NaN,NaN,0.5437463753562992,26.395104241703336,13181528
2025-08-12T14:45:00-04:00,529.47,529.53,529.11,529.2,528.8064007896812,NaN,NaN,NaN,NaN,NaN,527.9206000000001,530.7976385047768,525.0435614952235,529.554853519611,526.7729660332491,528.6555811151444,524.8903509513538,7241,14044.3,52.90013605317775,63.73640265181101,NaN,NaN,NaN,NaN,0.5349073485451321,25.12663615509942,13174287
2025-08-12T14:50:00-04:00,529.17,529.48,529.15,529.45,528.8064007896812,NaN,NaN,NaN,NaN,NaN,527.9950000000001,530.833738451876,525.1562615481242,529.554853519611,526.806985598812,528.7002592565011,524.913711941123,16911,14216.5,55.53356844631543,63.78080147610056,NaN,NaN,NaN,NaN,0.5202711093633399,23.94877293182435,13191198
2025-08-12T14:55:00-04:00,529.45,529.82,529.41,529.72,528.8064007896812,NaN,NaN,NaN,NaN,NaN,528.0694000000002,530.8900280431245,525.2487719568759,529.554853519611,526.8234830743613,528.7235660848178,524.9234000639049,7506,13953.866666666667,58.24864180043405,63.489214176744824,NaN,NaN,NaN,NaN,0.5123946015516786,23.455515693583745,13198704
2025-08-12T15:00:00-04:00,529.68,529.91,529.66,529.66,528.8064007896812,NaN,NaN,NaN,NaN,NaN,528.1548000000001,530.9034061628154,525.4061938371849,529.554853519611,526.8401389862552,528.7475131534579,524.9327648190524,7421,13786.533333333333,57.409747782506166,63.031589073670986,NaN,NaN,NaN,NaN,0.493652130012273,23.1489436898864,13191283
2025-08-12T15:05:00-04:00,529.67,529.69,529.29,529.31,528.8064007896812,NaN,NaN,NaN,NaN,NaN,528.2394000000002,530.8617299864902,525.6170700135101,529.554853519611,526.8555075897318,528.7675885778699,524.9434266015937,7766,13831.833333333334,52.64660961154683,62.18833183787103,NaN,NaN,NaN,NaN,0.48696269215425997,21.998995499841214,13183517
2025-08-12T15:10:00-04:00,529.25,529.53,528.87,528.88,528.8064007896812,NaN,NaN,NaN,NaN,NaN,528.3094000000002,530.806548485344,525.8122515146564,529.1588828156888,526.8702489026167,528.7846002887412,524.9558975164922,8678,13913.866666666667,47.43911084229332,60.75868498169223,NaN,NaN,NaN,NaN,0.49932249985752486,20.769285917991137,13174839
2025-08-12T15:15:00-04:00,528.91,529.15,528.91,528.99,528.8064007896812,NaN,NaN,NaN,NaN,NaN,528.3682000000001,530.786998676635,525.9494013233652,528.8976281734687,526.8815535068373,528.7971674120636,524.9659396016111,6975,13626.2,48.83340434310348,59.126741341554386,NaN,NaN,NaN,NaN,0.4829423212962718,19.627412734844636,13181814
2025-08-12T15:20:00-04:00,529,529.4,528.87,529.38,528.8064007896812,NaN,NaN,NaN,NaN,NaN,528.4320000000002,530.7850065868452,526.0789934131553,528.8976281734687,526.8973292276626,528.8160201020055,524.9786383533196,9008,12546.833333333334,53.53921696029673,57.64252756003233,NaN,NaN,NaN,NaN,0.48630358406082186,18.414431501578203,13190822
2025-08-12T15:25:00-04:00,529.4,529.88,529.365,529.75,528.8064007896812,NaN,NaN,NaN,NaN,NaN,528.4920000000001,530.8232829082812,526.160717091719,528.8976281734687,526.9265384653442,528.8559194094031,524.9971575212852,14222,12644.3,57.52995002976533,56.51047871425739,NaN,NaN,NaN,NaN,0.4883533280564765,18.17714583975066,13205044
2025-08-12T15:30:00-04:00,529.75,529.77,529.52,529.74,528.8064007896812,NaN,NaN,NaN,NaN,NaN,528.5528000000002,530.8523200886152,526.2532799113851,528.8976281734687,526.9443083716411,528.8800282992619,525.0085884440203,8764,12584.766666666666,57.386480819762724,55.42698269803919,NaN,NaN,NaN,NaN,0.47132809033815676,17.956809153767942,13196280
2025-08-12T15:35:00-04:00,529.72,530.13,529.7,529.91,528.8064007896812,NaN,NaN,NaN,NaN,NaN,528.6230000000002,530.8690356181336,526.3769643818667,529.0863510399247,526.9803387006283,528.9315477835029,525.0291296177537,16662,12809.533333333333,59.247097296329265,55.01500526252772,NaN,NaN,NaN,NaN,0.4683760838854277,18.359163764495364,13212942
2025-08-12T15:40:00-04:00,529.89,529.9,529.43,529.56,528.8064007896812,NaN,NaN,NaN,NaN,NaN,528.6844000000001,530.8606027842579,526.5081972157423,529.0863510399247,527.0095018525229,528.9695363506934,525.0494673543525,15280,13040.466666666667,54.01772505135703,54.88911833279222,NaN,NaN,NaN,NaN,0.4692063636078984,18.072573504643604,13197662
2025-08-12T15:45:00-04:00,529.51,529.9,529.38,529.88,528.8064007896812,NaN,NaN,NaN,NaN,NaN,528.7440000000001,530.8843924869473,526.603607513053,529.0863510399247,527.0282933708829,528.9944272055657,525.0621595362002,9692,12932.033333333333,57.69433550771836,54.895369966232465,NaN,NaN,NaN,NaN,0.4728344804930472,17.686426078794906,13207354
2025-08-12T15:50:00-04:00,529.88,530.66,528.56,529.54,NaN,NaN,NaN,530.6282918397234,530.6282918397234,530.6282918397234,528.7930000000001,530.8914537159492,526.6945462840511,529.0863510399247,527.1144559821812,529.1015401135346,525.1273718508278,48723,13991.8,52.858356144408916,54.6631700492154,NaN,NaN,NaN,NaN,0.5890605890292598,17.17667466847894,13158631
2025-08-12T15:55:00-04:00,529.49,529.69,529.07,529.38,NaN,NaN,NaN,531.142048542852,NaN,NaN,528.8492000000001,530.854967044816,526.8434329551842,529.0863510399247,527.2430745788556,529.2428717624293,525.2432773952819,87075,16549,50.70446753973409,54.50633658396943,NaN,NaN,NaN,NaN,0.5912705469557417,16.70333407318554,13071556
2025-08-13T09:30:00-04:00,532.18,532.66,529.95,531.5,529.1757718454596,529.1757718454596,529.1757718454596,NaN,NaN,NaN,528.9420000000001,530.999726900743,526.8842730992573,529.5265931087625,531.37,531.37,531.37,57743,18102.033333333333,68.82884351972348,55.45599908921287,NaN,NaN,NaN,NaN,0.7833226507446154,18.420428882937596,13129299
2025-08-13T09:35:00-04:00,531.43,531.46,529.58,531.46,529.1757718454596,NaN,NaN,NaN,NaN,NaN,529.0314000000001,531.1301310828651,526.9326689171351,529.5265931087625,531.1771789608391,531.4346681280998,530.9196897935784,32381,18693.033333333333,68.3184533041163,56.175271339475884,NaN,NaN,NaN,NaN,0.8645138899771398,19.42576217754475,13096918
2025-08-13T09:40:00-04:00,531.41,531.42,529.93,530.22,529.1757718454596,NaN,NaN,NaN,NaN,NaN,529.1054,531.1032036336817,527.1075963663184,529.5265931087625,531.0329958772992,531.3867826265508,530.6792091280475,25496,19264.366666666665,54.76171317393847,55.98612601029248,NaN,NaN,NaN,NaN,0.9120486121216361,20.359285951108536,13071422
2025-08-13T09:45:00-04:00,530.31,530.31,528.88,529.09,NaN,NaN,NaN,532.0795869589781,532.0795869589781,532.0795869589781,529.1474000000002,531.0516554865522,527.2431445134481,529.5265931087625,530.6909538234627,531.4196187298994,529.962288917026,31280,19896.066666666666,45.83561343492714,55.499626283391066,NaN,NaN,NaN,NaN,0.9490451398272299,19.69596928408281,13040142
2025-08-13T09:50:00-04:00,529.06,530.67,529.06,530.58,NaN,NaN,NaN,532.0795869589781,NaN,NaN,529.2090000000001,531.0952884186956,527.3227115813045,529.5265931087625,530.6078421001364,531.313381895195,529.9023023050778,24200,20321.733333333334,56.01614601561093,56.112271652913755,NaN,NaN,NaN,NaN,0.9962562012681431,19.437870860333888,13064342
2025-08-13T09:55:00-04:00,530.58,530.66,529.88,530.265,NaN,NaN,NaN,532.0795869589781,NaN,NaN,529.2601000000002,531.1194251351,527.4007748649004,529.5265931087625,530.5650194249798,531.2341269340324,529.8959119159273,24696,20902.133333333335,53.717452623447265,56.46113224436689,NaN,NaN,NaN,NaN,0.980809329748988,19.198208038281315,13039646
2025-08-13T10:00:00-04:00,530.21,530.57,529.62,530.55,NaN,NaN,NaN,532.0795869589781,NaN,NaN,529.3099000000001,531.171366614899,527.4484333851012,529.5265931087625,530.5326125378083,531.1740150024684,529.8912100731482,22190,21198.466666666667,55.4968681922463,56.60096447522043,NaN,NaN,NaN,NaN,0.9786086633383493,18.602039089231916,13061836
2025-08-13T10:05:00-04:00,530.57,531.8,530.48,531.72,NaN,NaN,NaN,532.0795869589781,NaN,NaN,529.3859000000001,531.3229324618968,527.4488675381034,529.5265931087625,530.6067065616493,531.2602871130402,529.9531260102583,22228,20941.4,61.962332195249665,56.91756320132645,NaN,NaN,NaN,NaN,1.002993758814177,19.237351748703897,13084064
2025-08-13T10:10:00-04:00,531.7,531.8,530.75,531.15,NaN,NaN,NaN,532.0795869589781,NaN,NaN,529.4589000000001,531.3811937231728,527.5366062768273,529.5265931087625,530.6476735391045,531.2982373848013,529.9971096934078,16803,20830.066666666666,57.57390885002007,56.930950917773394,NaN,NaN,NaN,NaN,1.006351347470304,19.82728493249931,13067261
2025-08-13T10:15:00-04:00,531.17,531.4,530.73,530.73,NaN,NaN,NaN,532.0795869589781,NaN,NaN,529.5189000000001,531.4085934032636,527.6292065967367,529.5265931087625,530.6661293640378,531.3009355989967,530.0313231290789,16516,20794.866666666665,54.51039927416377,56.592615344761576,NaN,NaN,NaN,NaN,0.9823262512224222,20.343128030020626,13050745
2025-08-13T10:20:00-04:00,530.735,531.31,530.735,530.92,NaN,NaN,NaN,532.0795869589781,NaN,NaN,529.5819000000001,531.4440008453371,527.7197991546632,528.8011107876468,530.6843568615955,531.3054225930317,530.0632911301592,16402,20691.233333333334,55.659822446006054,56.70990801580793,NaN,NaN,NaN,NaN,0.9535886618493868,20.822125192004705,13067147
2025-08-13T10:25:00-04:00,530.89,531,529.6,529.72,NaN,NaN,NaN,532.0795869589781,NaN,NaN,529.6091000000001,531.4384558314798,527.7797441685204,528.8011107876468,530.6370321653167,531.2528433534349,530.0212209771985,25871,21099.733333333334,47.496904066280514,55.98152005570523,NaN,NaN,NaN,NaN,0.9854751860030004,19.5644490799203,13041276
2025-08-13T10:30:00-04:00,529.76,530.21,529.53,530.13,NaN,NaN,NaN,532.0795869589781,NaN,NaN,529.6383000000002,531.4533169249987,527.8232830750017,528.8011107876468,530.6072575867223,531.2253180032632,529.9891971701815,14453,20847.166666666668,50.18503701114636,55.79056868904363,NaN,NaN,NaN,NaN,0.9636555298599335,18.30587601604777,13055729
2025-08-13T10:35:00-04:00,530.125,530.37,529.855,529.93,NaN,NaN,NaN,532.0795869589781,NaN,NaN,529.6717000000002,531.4450173539069,527.8983826460935,528.8011107876468,530.5866041369056,531.2021093144987,529.9710989593126,12751,20788.2,48.87058660565948,55.65957719375258,NaN,NaN,NaN,NaN,0.9316087062985087,17.343136942200648,13042978
2025-08-13T10:40:00-04:00,529.92,530.53,529.67,530.48,NaN,NaN,NaN,532.0795869589781,NaN,NaN,529.7079000000002,531.4718184668635,527.9439815331369,528.8011107876468,530.5650294525248,531.167888136718,529.9621707683315,21871,21226.833333333332,52.55113994688681,54.49688408140712,NaN,NaN,NaN,NaN,0.926493798705759,16.184707789123735,13064849
2025-08-13T10:45:00-04:00,530.51,530.56,529.87,530.43,NaN,NaN,NaN,532.0795869589781,NaN,NaN,529.7429000000002,531.49324178323,527.9925582167704,528.8011107876468,530.5567481986906,531.1524519502718,529.9610444471093,11188,21358.4,52.183378249368076,53.344378720353674,NaN,NaN,NaN,NaN,0.9096013845124863,15.152317766381524,13053661
2025-08-13T10:50:00-04:00,530.42,530.61,529.9,530.13,NaN,NaN,NaN,532.0795869589781,NaN,NaN,529.7725000000003,531.4977898300189,528.0472101699817,528.8011107876468,530.5465652245712,531.1362548184436,529.9568756306987,11492,21177.766666666666,49.925787525276164,52.99895545973494,NaN,NaN,NaN,NaN,0.895344142761597,14.270060535878978,13042169
2025-08-13T10:55:00-04:00,530.18,530.71,530.16,530.35,NaN,NaN,NaN,532.0795869589781,NaN,NaN,529.8071000000002,531.5077635052063,528.1064364947941,528.8011107876468,530.5404544168438,531.1178297358268,529.9630790978607,17702,21517.633333333335,51.5801201625799,53.40927736885299,NaN,NaN,NaN,NaN,0.8728195611357715,13.609837332895463,13059871
2025-08-13T11:00:00-04:00,530.34,530.34,529.42,529.49,NaN,NaN,NaN,532.0795869589781,NaN,NaN,529.8231000000003,531.4962537758456,528.149946224155,528.8011107876468,530.5157728520488,531.1004553750246,529.9310903290731,13062,21705.666666666668,45.28220596539282,52.64256736526598,NaN,NaN,NaN,NaN,0.8769038781975066,13.436573117452639,13046809
2025-08-13T11:05:00-04:00,529.48,529.55,527.25,527.59,NaN,NaN,NaN,531.1277137475346,NaN,NaN,529.8111000000004,531.5386546756121,528.0835453243886,528.8011107876468,530.2861650485088,531.1828399233798,529.3894901736378,44547,22931.7,35.088737830741366,51.31194488007271,NaN,NaN,NaN,NaN,0.9785536011833956,15.354644147090557,13002262
2025-08-13T11:10:00-04:00,527.63,527.77,526.91,527.43,NaN,NaN,NaN,530.060999486283,NaN,NaN,529.7899000000002,531.6055524882386,527.9742475117619,528.7685037970535,530.1524043921418,531.2197948836065,529.085013900677,22252,23384.166666666668,34.386738901036196,49.80407850212913,NaN,NaN,NaN,NaN,0.9700854868131541,17.359188508746524,12980010
2025-08-13T11:15:00-04:00,527.38,527.52,526.91,527.365,NaN,NaN,NaN,529.8954995096337,NaN,NaN,529.7804000000003,531.6411727850489,527.9196272149518,528.7685037970535,530.0535982810187,531.2265713158616,528.8806252461758,17189,23724.633333333335,34.08837038058364,47.81308122965299,NaN,NaN,NaN,NaN,0.9443650948979297,19.220551130284207,12962821
2025-08-13T11:20:00-04:00,527.45,527.54,526.86,527.25,NaN,NaN,NaN,529.8513858955596,NaN,NaN,529.7636000000003,531.6987961547566,527.8284038452441,528.7685037970535,529.9422499875678,531.2171431904071,528.6673567847286,20521,24108.4,33.53397925700794,46.09594340158069,NaN,NaN,NaN,NaN,0.9254818738337883,20.98475722992699,12942300
2025-08-13T11:25:00-04:00,527.26,527.51,526.99,527.28,NaN,NaN,NaN,529.8513858955596,NaN,NaN,529.7310000000002,531.7745028744415,527.6874971255589,528.7685037970535,529.8455837317312,531.1934393986762,528.4977280647861,19547,24285.9,33.83627918679508,44.61922053819721,NaN,NaN,NaN,NaN,0.8965188828456593,22.62294860816672,12961847
2025-08-13T11:30:00-04:00,527.39,528.22,527.39,528.07,NaN,NaN,NaN,529.8513858955596,NaN,NaN,529.7104000000003,531.7991956715699,527.6216043284306,528.7685037970535,529.806272581705,531.1683785899153,528.4441665734947,11146,24365.3,41.39523514901336,43.600321445554876,NaN,NaN,NaN,NaN,0.8996246769281161,22.83547631530947,12972993
2025-08-13T11:35:00-04:00,528.13,528.3,527.11,527.28,NaN,NaN,NaN,529.8513858955596,NaN,NaN,529.6724000000003,531.8649631023144,527.4798368976861,528.7685037970535,529.7686192118817,531.1496415870914,528.3875968366721,9451,24124.933333333334,36.8601664511747,42.84055447304731,NaN,NaN,NaN,NaN,0.9203657714332465,23.30540954660041,12963542
2025-08-13T11:40:00-04:00,527.32,527.99,527.29,527.99,NaN,NaN,NaN,529.8513858955596,NaN,NaN,529.6408000000002,531.8833292501561,527.3982707498444,528.7685037970535,529.7517296175743,531.1391402192897,528.3643190158588,4766,23774.466666666667,42.91335216874222,42.32114841287559,NaN,NaN,NaN,NaN,0.9053396449023029,23.74177611851342,12968308
2025-08-13T11:45:00-04:00,528,528.14,527.66,528.13,NaN,NaN,NaN,529.8513858955596,NaN,NaN,529.5992000000002,531.8748751608583,527.3235248391421,528.3218030376428,529.730430925619,531.1229697588166,528.3378920924214,6895,23681.233333333334,44.05233429177436,41.97698753331237,NaN,NaN,NaN,NaN,0.8749582416949968,23.861489075997607,12975203
2025-08-13T11:50:00-04:00,528.13,528.2,527.37,527.79,NaN,NaN,NaN,529.8513858955596,NaN,NaN,529.5414000000003,531.8508891551543,527.2319108448463,526.7854424301142,529.6891460188825,531.0950339508577,528.2832580869074,12470,22472.8,41.867612566772344,41.21387843473276,NaN,NaN,NaN,NaN,0.8717469387167858,24.29450730708201,12962733
2025-08-13T11:55:00-04:00,527.77,527.97,527.6,527.97,NaN,NaN,NaN,529.8513858955596,NaN,NaN,529.4884000000003,531.8179874650602,527.1588125349404,526.1871644392447,529.6698032431207,531.0808437898528,528.2587626963885,6229,19777.933333333334,43.46611858670608,40.591217030256914,NaN,NaN,NaN,NaN,0.8359078716655871,24.69659566451753,12968962
2025-08-13T12:00:00-04:00,527.93,528.33,527.89,528.3,NaN,NaN,NaN,529.8513858955596,NaN,NaN,529.4430000000003,531.7749794161969,527.1110205838038,526.6737852411167,529.6546415898274,531.0664921864915,528.2427909931633,6073,18055.6,46.37731044565406,40.33775438171248,NaN,NaN,NaN,NaN,0.807628737975192,24.32734354714482,12975035
2025-08-13T12:05:00-04:00,528.3,528.34,528.1,528.3,NaN,NaN,NaN,529.8513858955596,NaN,NaN,529.4072000000003,531.7532666310719,527.0611333689287,526.8950281928933,529.636960549162,531.048651821235,528.2252692770891,7623,17230.333333333332,46.37731044565406,39.96612511621777,NaN,NaN,NaN,NaN,0.7670838281198218,23.964077947906812,12975035
2025-08-13T12:10:00-04:00,528.31,528.61,528.15,528.23,NaN,NaN,NaN,529.8513858955596,NaN,NaN,529.3842000000003,531.7533174385326,527.015082561468,527.2240225543146,529.611753439574,531.0212729973543,528.2022338817937,11938,16778.4,45.7971423123587,40.00290628385819,NaN,NaN,NaN,NaN,0.7451492689684086,23.0737377743893,12963097
2025-08-13T12:15:00-04:00,528.24,528.33,527.63,527.63,NaN,NaN,NaN,529.8513858955596,NaN,NaN,529.3452000000002,531.7638243689249,526.9265756310755,527.2240225543146,529.5809078467347,530.9967732588293,528.1650424346401,11116,16106.266666666666,41.05619721173385,40.42915338250051,NaN,NaN,NaN,NaN,0.7419243211849541,22.997261291103772,12951981
2025-08-13T12:20:00-04:00,527.64,527.64,526.66,526.67,NaN,NaN,NaN,529.4967085478181,NaN,NaN,529.2894000000003,531.8209549682482,526.7578450317525,527.2240225543146,529.5133008382667,530.970338177995,528.0562634985383,16882,15862.333333333334,34.84140184280646,40.46162930691268,NaN,NaN,NaN,NaN,0.7589297268146016,23.998830235055475,12935099
2025-08-13T12:25:00-04:00,526.65,526.95,526.3,526.34,NaN,NaN,NaN,528.9536763410991,NaN,NaN,529.2322000000003,531.8950857725972,526.5693142274033,527.2240225543146,529.4496035961085,530.9541303240526,527.9450768681645,14115,15509.633333333333,32.99259323095488,40.383359510510616,NaN,NaN,NaN,NaN,0.7511490320421366,25.250285318759747,12920984
2025-08-13T12:30:00-04:00,526.32,526.36,525.64,525.98,NaN,NaN,NaN,528.3210092346856,NaN,NaN,529.1628000000003,531.9759911839524,526.3496088160482,527.2240225543146,529.3663502814185,530.9442890540308,527.7884115088061,16317,15313.866666666667,31.05651752945387,40.206397958542475,NaN,NaN,NaN,NaN,0.7489241011819859,26.928769486754454,12904667
2025-08-13T12:35:00-04:00,525.98,526.22,525.8,525.93,NaN,NaN,NaN,528.2827815421998,NaN,NaN,529.0870000000003,532.0369667790461,526.1370332209545,527.2240225543146,529.2987452481019,530.9310050903196,527.6664854058843,13813,15033.366666666667,30.786298737528412,39.98854221216628,NaN,NaN,NaN,NaN,0.725429522526135,28.487361928463827,12890854
2025-08-13T12:40:00-04:00,525.94,526.26,525.86,526.16,NaN,NaN,NaN,528.2827815421998,NaN,NaN,529.0170000000003,532.0734397585551,525.9605602414455,527.2240225543146,529.2624968925267,530.9205138632989,527.6044799217544,7906,14736.8,33.64632669216529,39.43504875096284,NaN,NaN,NaN,NaN,0.7021845566314094,29.84309479361795,12898760
2025-08-13T12:45:00-04:00,526.2,526.23,525.43,525.5,NaN,NaN,NaN,528.0620178927894,NaN,NaN,528.9408000000004,532.150359695226,525.7312403047748,527.2240225543146,529.1783870530803,530.9030999005635,527.4536742055972,17003,14753.033333333333,29.836331632551932,38.93334626391836,NaN,NaN,NaN,NaN,0.7091713740148851,31.442279926301175,12881757
2025-08-13T12:50:00-04:00,525.45,525.54,524.95,525.34,NaN,NaN,NaN,527.456017079481,NaN,NaN,528.8700000000005,532.2342514764775,525.5057485235234,527.2240225543146,529.0841158357806,530.8901323908881,527.2780992806731,17731,14797.333333333334,28.9796094462813,37.93807892659972,NaN,NaN,NaN,NaN,0.700659133013816,33.26265090933908,12864026
2025-08-13T12:55:00-04:00,525.33,525.34,525.05,525.17,NaN,NaN,NaN,527.3450617576863,NaN,NaN,528.7936000000004,532.3133852430192,525.2738147569817,527.2240225543146,529.0258728820689,530.8796690321221,527.1720767320157,11133,14306.066666666668,28.057757519268137,36.79560915713499,NaN,NaN,NaN,NaN,0.6713263377985489,34.952995393588566,12852893
2025-08-13T13:00:00-04:00,525.18,525.7,525.12,525.15,NaN,NaN,NaN,527.3450617576863,NaN,NaN,528.7090000000004,532.3688928942285,525.0491071057724,526.8712180434517,528.9391027257738,530.8547655859254,527.0234398656221,17878,14420.233333333334,27.945131029788598,35.80114619020758,NaN,NaN,NaN,NaN,0.6648030279557984,35.63964788523795,12835015
2025-08-13T13:05:00-04:00,525.15,525.15,524.53,524.7,NaN,NaN,NaN,526.9590851965695,NaN,NaN,528.6080000000004,532.4228504554206,524.7931495445802,525.9829744347613,528.8557421517753,530.8393297020702,526.8721546014804,15654,14517,25.467996605369507,34.51556604868354,NaN,NaN,NaN,NaN,0.6616028116732416,36.7605504524831,12819361
2025-08-13T13:10:00-04:00,524.78,525.11,524.51,524.74,NaN,NaN,NaN,526.9145813239982,NaN,NaN,528.5080000000004,532.4586308353535,524.5573691646473,525.299379547809,528.766801086043,530.8168290888935,526.7167730831924,17397,14367.866666666667,26.095113841912763,33.06683771984488,NaN,NaN,NaN,NaN,0.6572026108394403,37.816809510399416,12836758
2025-08-13T13:15:00-04:00,524.78,524.9,524.49,524.86,NaN,NaN,NaN,526.7598276274528,NaN,NaN,528.4070000000004,532.4658254455437,524.348174554457,524.8164823284782,528.6982257536671,530.7962291230949,526.6002223842393,13824,14455.733333333334,28.05096961494702,31.757813374794374,NaN,NaN,NaN,NaN,0.6395452814937637,38.81407639938265,12850582
2025-08-13T13:20:00-04:00,524.88,524.95,524.65,524.79,NaN,NaN,NaN,526.7598276274528,NaN,NaN,528.3116000000005,532.4802834560597,524.1429165439412,524.8164823284782,528.613973012346,530.7652947755,526.462651249192,17872,14668.4,27.592244850303473,30.457463556076142,NaN,NaN,NaN,NaN,0.6152920471013569,39.60308603566195,12832710
2025-08-13T13:25:00-04:00,524.77,525.41,524.76,525.21,NaN,NaN,NaN,526.7598276274528,NaN,NaN,528.2182000000005,532.4509096565482,523.9854903434527,524.8164823284782,528.5306234466123,530.7218071704176,526.3394397228069,20265,14753.833333333334,34.51216200998253,29.990032470236763,NaN,NaN,NaN,NaN,0.6177711865941156,39.144479561258265,12852975
2025-08-13T13:30:00-04:00,525.19,525.25,524.4,524.43,NaN,NaN,NaN,526.7598276274528,NaN,NaN,528.1160000000004,532.4613786943186,523.7706213056823,524.6751858627825,528.4539455934854,530.6886046464385,526.2192865405323,17288,14894.7,28.974121965485338,29.57094105042811,NaN,NaN,NaN,NaN,0.6343589589802517,39.1278940326053,12835687
2025-08-13T13:35:00-04:00,524.42,524.47,523.85,523.96,NaN,NaN,NaN,526.1857625068928,NaN,NaN,528.0076000000004,532.4897072005427,523.525492799458,524.3091351617446,528.3480121242607,530.6551967093569,526.0408275391644,21541,14127.833333333334,26.24160847130463,29.088727853310235,NaN,NaN,NaN,NaN,0.6333333190530912,39.65199556162556,12814146
2025-08-13T13:40:00-04:00,523.98,524,523.65,523.78,NaN,NaN,NaN,525.8064096656703,NaN,NaN,527.8532000000005,532.3751450501472,523.3312549498537,524.3091351617446,528.2630941424973,530.6298724275354,525.8963158574592,16909,13949.733333333334,25.259115394238236,28.674627700794826,NaN,NaN,NaN,NaN,0.6130952248350149,40.31526165252749,12797237
2025-08-13T13:45:00-04:00,523.815,523.98,523.7,523.92,NaN,NaN,NaN,525.7695274081399,NaN,NaN,527.7024000000005,532.2360419087682,523.1687580912327,524.3091351617446,528.2132982883428,530.6121807520084,525.8144158246772,10352,13721.833333333334,27.53173690853353,28.442158998723766,NaN,NaN,NaN,NaN,0.589302708775369,40.93115159407928,12807589
2025-08-13T13:50:00-04:00,523.9,524,523.83,523.96,NaN,NaN,NaN,525.7695274081399,NaN,NaN,527.5772000000004,532.1711730775114,522.9832269224894,524.0974654098004,528.1588944784959,530.5902754027949,525.7275135541969,11758,13429.733333333334,28.20345809422342,28.05338267029935,NaN,NaN,NaN,NaN,0.5593525152914112,41.44637191795586,12819347
2025-08-13T13:55:00-04:00,523.98,524.02,523.83,523.87,NaN,NaN,NaN,525.7311396425406,NaN,NaN,527.4728000000005,532.1608030542642,522.7847969457367,524.0974654098004,528.1205757035319,530.5741063785774,525.6670450284864,8418,13058.766666666666,27.583925072712134,27.89249648745365,NaN,NaN,NaN,NaN,0.5329701927705919,41.86442503418796,12810929
2025-08-13T14:00:00-04:00,523.86,523.98,523.66,523.97,NaN,NaN,NaN,525.5876787496978,NaN,NaN,527.3406000000004,532.0434351615784,522.6377648384225,524.0974654098004,528.0649185241375,530.5497658993177,525.5800711489574,12394,13100.366666666667,29.4386152300373,27.92528261486479,NaN,NaN,NaN,NaN,0.5177580361441246,42.43943611425861,12823323
2025-08-13T14:05:00-04:00,523.97,523.99,523.85,523.95,NaN,NaN,NaN,525.5876787496978,NaN,NaN,527.2143000000004,531.9353566652572,522.4932433347436,524.0974654098004,528.0288037319951,530.5325140815977,525.5250933823926,8340,13063.333333333334,29.277112707799446,28.0123794140456,NaN,NaN,NaN,NaN,0.49077531927668616,42.93981517826694,12814983
2025-08-13T14:10:00-04:00,523.94,524.59,523.75,524.57,NaN,NaN,NaN,525.5876787496978,NaN,NaN,527.0947000000004,531.774485640034,522.4149143599669,524.0974654098004,527.9586885074646,530.4898708421118,525.4275061728173,18316,13515,40.22494835904579,28.889509223278253,NaN,NaN,NaN,NaN,0.5157199393283537,41.60680548682612,12833299
2025-08-13T14:15:00-04:00,524.56,524.56,524.18,524.18,NaN,NaN,NaN,525.5876787496978,NaN,NaN,526.9439000000004,531.502144964522,522.3856550354789,523.7749723278404,527.9258914053753,530.4691269159339,525.3826558948167,8819,13579.133333333333,36.407153313050024,29.67087755954115,NaN,NaN,NaN,NaN,0.5067399436620499,40.369010773345366,12824480
2025-08-13T14:20:00-04:00,524.16,524.31,523.81,524.3,NaN,NaN,NaN,525.5876787496978,NaN,NaN,526.8069000000005,531.2618338442255,522.3519661557755,523.523913309382,527.8688618386037,530.4346501114579,525.3030735657495,15019,13664.1,38.34615680321196,30.545952056776805,NaN,NaN,NaN,NaN,0.5062585191147606,39.80103516537941,12839499
2025-08-13T14:25:00-04:00,524.24,524.35,523.81,523.86,NaN,NaN,NaN,525.5876787496978,NaN,NaN,526.6695000000004,531.0552041619877,522.2837958380131,523.523913309382,527.8251933889576,530.4089085331979,525.2414782447173,11402,13836.533333333333,34.22541705139402,30.986984016523024,NaN,NaN,NaN,NaN,0.5086686248922833,39.156721994938934,12828097
2025-08-13T14:30:00-04:00,523.88,523.95,523.47,523.56,NaN,NaN,NaN,525.4015068906367,NaN,NaN,526.5223000000004,530.8206611803322,522.2239388196687,523.523913309382,527.7506363080364,530.3700020146499,525.1312706014229,18380,14246.766666666666,31.722352810060883,31.281991727934265,NaN,NaN,NaN,NaN,0.5066208659714072,39.06097815523632,12809717
2025-08-13T14:35:00-04:00,523.56,523.76,523.17,523.58,NaN,NaN,NaN,525.160074759244,NaN,NaN,526.3995000000004,530.676196972742,522.1228030272589,523.523913309382,527.6496529165582,530.3173594110564,524.9819464220601,25008,14826.266666666666,32.07898524364319,31.108193387481457,NaN,NaN,NaN,NaN,0.5125765184020232,39.3632839695908,12834725
2025-08-13T14:40:00-04:00,523.56,523.61,523.35,523.57,NaN,NaN,NaN,525.1334804520058,NaN,NaN,526.2683000000004,530.481189559025,522.0554104409758,523.523913309382,527.6218113989032,530.3019743496716,524.9416484481349,7122,14665.733333333334,31.98901521718632,31.323542905460094,NaN,NaN,NaN,NaN,0.49453533851616377,39.6439965114914,12827603
2025-08-13T14:45:00-04:00,523.57,523.61,522.8,522.83,NaN,NaN,NaN,524.8937767950963,NaN,NaN,526.1263000000004,530.3144847185698,521.9381152814309,523.523913309382,527.5441214602558,530.2657418060762,524.8225011144355,18429,14909.5,26.145319622613755,31.316665130553606,NaN,NaN,NaN,NaN,0.5170685286221562,40.543553247990175,12809174
2025-08-13T14:50:00-04:00,522.89,522.95,522.43,522.46,NaN,NaN,NaN,524.3729233044103,NaN,NaN,525.9659000000004,530.0886348637404,521.8431651362604,523.523913309382,527.4546355602502,530.230606827042,524.6786642934583,19914,15010.566666666668,23.803849611169852,31.212717574620147,NaN,NaN,NaN,NaN,0.5172779194348662,41.728729453793896,12789260
2025-08-13T14:55:00-04:00,522.45,523.07,522.37,522.67,NaN,NaN,NaN,524.3729233044103,NaN,NaN,525.8107000000005,529.8325622597549,521.788837740246,523.523913309382,527.3976215078628,530.2049667345273,524.5902762811984,13327,14984.3,27.75828898823042,31.228899866027067,NaN,NaN,NaN,NaN,0.5303294966180933,42.44111543388111,12802587
2025-08-13T15:00:00-04:00,522.63,523.07,522.56,522.93,NaN,NaN,NaN,524.3729233044103,NaN,NaN,525.6667000000004,529.5735911472703,521.7598088527305,523.5121306475055,527.3512737844213,530.1813401046742,524.5212074641685,11444,14821.866666666667,32.433709768092044,31.531060699874825,NaN,NaN,NaN,NaN,0.5288773897168083,43.10261670110495,12814031
2025-08-13T15:05:00-04:00,522.92,522.96,522.18,522.33,NaN,NaN,NaN,524.2934290685708,NaN,NaN,525.5063000000005,529.2874251283937,521.7251748716072,523.2217045180043,527.2473675631126,530.1339577624393,524.3607773637858,24507,15178.333333333334,27.93985161179937,31.556484024095344,NaN,NaN,NaN,NaN,0.5468147190227567,44.10562847837829,12789524
2025-08-13T15:10:00-04:00,522.32,522.32,521.75,521.87,NaN,NaN,NaN,523.7591822927269,NaN,NaN,525.3539000000004,529.0945188200169,521.6132811799839,523.2093636144035,527.0530495857564,530.0548486785525,524.0512504929603,43918,16378.733333333334,25.07172562048946,31.24456333769907,NaN,NaN,NaN,NaN,0.5491850962354199,45.40660568748738,12745606
2025-08-13T15:15:00-04:00,521.83,522.04,521.57,522.04,NaN,NaN,NaN,523.5149012794211,NaN,NaN,525.2429000000004,529.0404634763332,521.4453365236676,522.7974908915229,526.8704203134483,529.9693336166939,523.7715070102028,43596,17265.166666666668,28.01279464343412,31.154254904530116,NaN,NaN,NaN,NaN,0.5435290179328838,46.75359615062203,12789202
2025-08-13T15:20:00-04:00,521.995,522.2,521.65,521.67,NaN,NaN,NaN,523.5149012794211,NaN,NaN,525.1277000000005,529.0015844635104,521.2538155364905,522.5429927132183,526.735914274876,529.8989850222733,523.5728435274787,33904,17804.266666666666,25.652696838609344,30.11337979592751,NaN,NaN,NaN,NaN,0.5439912309376826,47.451866878044896,12755298
2025-08-13T15:25:00-04:00,521.67,522.43,521.64,522.43,NaN,NaN,NaN,523.5149012794211,NaN,NaN,525.0290000000003,528.921271829802,521.1367281701987,522.5063941705746,526.6411582350905,529.8382694073807,523.4440470628003,26852,18328.233333333334,37.33197774230828,30.17943868373167,NaN,NaN,NaN,NaN,0.5615632858707027,47.34059361881251,12782150
2025-08-13T15:30:00-04:00,522.42,522.52,521.81,521.89,NaN,NaN,NaN,523.5149012794211,NaN,NaN,524.9218000000004,528.858480205034,520.9851197949669,522.3221153364597,526.5205160376884,529.759045658762,523.2819864166147,35126,18903.166666666668,33.32607910495575,29.820861705284802,NaN,NaN,NaN,NaN,0.5721659083085122,46.947197354658904,12747024
2025-08-13T15:35:00-04:00,521.93,522,520.76,520.92,NaN,NaN,NaN,523.2244675087215,NaN,NaN,524.7946000000004,528.828084270051,520.7611157299498,521.7092030522673,526.0225809603345,529.4707150234487,522.5744468972202,138083,22984.133333333335,27.597451467942975,29.347435592181153,NaN,NaN,NaN,NaN,0.6198683434293334,47.658439093815964,12608941
2025-08-13T15:40:00-04:00,520.93,520.94,519.65,519.92,NaN,NaN,NaN,522.2315371674161,NaN,NaN,524.6316000000004,528.7795389769828,520.4836610230179,521.7092030522673,525.7982107075043,529.3614422716196,522.234979143389,58524,24355.033333333333,23.174692238103944,28.736888408469948,NaN,NaN,NaN,NaN,0.6677348903272436,49.02007148412833,12550417
2025-08-13T15:45:00-04:00,519.9,520,519.38,519.795,NaN,NaN,NaN,521.6230582052608,NaN,NaN,524.4819000000003,528.7744576940871,520.1893423059136,521.7092030522673,525.6521942866581,529.2931867049397,522.0112018683765,37607,25147.8,22.68529286805402,28.065910381642148,NaN,NaN,NaN,NaN,0.6643252553038694,50.4182973530349,12512810
2025-08-13T15:50:00-04:00,519.83,520.98,519.58,519.9,NaN,NaN,NaN,521.6230582052608,NaN,NaN,524.3201000000005,528.6808680466252,519.9593319533758,521.4813624418138,525.4050840826228,529.141237985852,521.6689301793937,73599,27005.366666666665,24.134589268129915,27.504879956709544,NaN,NaN,NaN,NaN,0.7168734513535914,49.54417216187882,12586409
2025-08-13T15:55:00-04:00,519.89,520.82,519.71,520.68,NaN,NaN,NaN,521.6230582052608,NaN,NaN,524.1711000000005,528.5100276504977,519.8321723495033,520.9493760449335,524.8619797661748,528.7174518422122,521.0065076901375,199496,32979.73333333333,34.02797417109326,28.06792671017237,NaN,NaN,NaN,NaN,0.7449539191140502,48.732484484376734,12785905
2025-08-14T09:30:00-04:00,522.8,523.02,520.88,521.34,519.6312178776371,519.6312178776371,519.6312178776371,NaN,NaN,NaN,524.0421000000005,528.3261663342705,519.7580336657304,520.9493760449335,521.7466666666668,521.7466666666668,521.7466666666668,61615,34457.3,41.03493789040254,29.298718730117553,NaN,NaN,NaN,NaN,0.8588857820344774,45.67868560269412,12847520
2025-08-14T09:35:00-04:00,521.4,521.43,520.1,520.45,519.6312178776371,NaN,NaN,NaN,NaN,NaN,523.8917000000005,528.1414913403552,519.6419086596458,520.9493760449335,521.2374319480019,521.7796942421439,520.6951696538599,54338,35550.53333333333,35.551436514788506,29.855372124871707,NaN,NaN,NaN,NaN,0.8925367976034381,42.81207424761902,12793182
2025-08-14T09:40:00-04:00,520.43,522.48,520.18,522.4,519.6312178776371,NaN,NaN,NaN,NaN,NaN,523.7737000000004,527.8514929369696,519.6959070630312,520.9493760449335,521.3486277080156,521.8574039474614,520.8398514685697,38142,36258.3,51.001120840195966,31.18161577287913,NaN,NaN,NaN,NaN,0.9930698834889117,40.38463090453405,12831324
2025-08-14T09:45:00-04:00,522.39,523.43,522.32,522.54,520.2422660372649,NaN,NaN,NaN,NaN,NaN,523.6585000000003,527.5389743263019,519.7780256736988,520.9493760449335,521.6879046975384,522.4373330424987,520.9384763525782,48614,37533.7,51.89277165810623,32.89253863332962,NaN,NaN,NaN,NaN,1.0014220346682678,38.89348985944959,12879938
2025-08-14T09:50:00-04:00,522.5,524.33,522.44,522.8,520.6142084901165,NaN,NaN,NaN,NaN,NaN,523.5499000000004,527.2102248430398,519.8895751569611,520.594840590407,521.9541921008057,522.8436618261215,521.0647223754899,43679,38597.73333333333,53.58213784232272,34.928996649174856,NaN,NaN,NaN,NaN,1.0648918893348192,38.12266843443315,12923617
2025-08-14T09:55:00-04:00,522.85,523.455,522.7,523.19,520.6142084901165,NaN,NaN,NaN,NaN,NaN,523.4611000000003,526.9316937758567,519.9905062241439,520.594840590407,522.086293766575,523.0011792375337,521.1714082956162,31640,39371.8,56.073929661818134,36.933363436202285,NaN,NaN,NaN,NaN,1.0427567543823317,37.40690568263218,12955257
2025-08-14T10:00:00-04:00,523.26,523.46,522.53,522.53,520.6142084901165,NaN,NaN,NaN,NaN,NaN,523.3783000000004,526.7343677044191,520.0222322955817,520.594840590407,522.1516777909897,523.0513497330663,521.252005848913,26410,39839,51.07686607845071,38.749375524762385,NaN,NaN,NaN,NaN,1.0347027004978842,36.5331583107217,12928847
2025-08-14T10:05:00-04:00,522.52,522.93,521.86,522.72,520.6142084901165,NaN,NaN,NaN,NaN,NaN,523.3059000000004,526.5578469179136,520.0539530820872,520.594840590407,522.1737193294662,523.048900191147,521.2985384677853,20358,40239.6,52.39217148321026,39.82510364911252,NaN,NaN,NaN,NaN,1.0372239361766022,34.93125062740914,12949205
2025-08-14T10:10:00-04:00,522.76,522.9,522.03,522.56,520.6142084901165,NaN,NaN,NaN,NaN,NaN,523.2375000000004,526.4043421174244,520.0706578825764,520.594840590407,522.1881771063099,523.0461466721534,521.3302075404664,15222,40136.46666666667,51.14516703754457,41.09789564429743,NaN,NaN,NaN,NaN,1.0252793693068454,33.443764921476046,12933983
2025-08-14T10:15:00-04:00,522.54,523.49,522.49,523.18,520.6142084901165,NaN,NaN,NaN,NaN,NaN,523.1825000000003,526.2544845372504,520.1105154627503,520.6829589646645,522.2383600264112,523.0952799468146,521.3814401060079,20937,40540.4,55.55923965711448,43.09516622923826,NaN,NaN,NaN,NaN,1.0234737000706422,32.57067037211483,12954920
2025-08-14T10:20:00-04:00,523.25,523.71,523.05,523.32,520.6419988606849,NaN,NaN,NaN,NaN,NaN,523.1257000000004,526.0780644823741,520.1733355176267,521.1343671717316,522.3252418157994,523.2012177825517,521.449265849047,30307,41050,56.514662920289304,45.47659270653721,NaN,NaN,NaN,NaN,0.997511292922745,31.94106723499331,12985227
2025-08-14T10:25:00-04:00,523.34,523.91,523.07,523.42,520.7619080033811,NaN,NaN,NaN,NaN,NaN,523.0841000000004,525.9590745663187,520.2091254336821,521.4294937373853,522.3927283621377,523.2840430081072,521.5014137161683,24587,41489.5,57.22210419860627,47.943507801576665,NaN,NaN,NaN,NaN,0.9862604862854002,31.522812458292993,13009814
2025-08-14T10:30:00-04:00,523.46,523.97,523.43,523.84,521.0209121850456,NaN,NaN,NaN,NaN,NaN,523.0541000000004,525.8648761840165,520.2433238159844,521.7105949899083,522.4185654775804,523.3205609439673,521.5165700111935,8090,41146.5,60.154111484407416,50.51633081702505,NaN,NaN,NaN,NaN,0.955099022979305,31.186034032933385,13017904
2025-08-14T10:35:00-04:00,523.83,524.18,523.57,523.99,521.2345070857253,NaN,NaN,NaN,NaN,NaN,523.0305000000004,525.7891491253062,520.2718508746947,522.0674759919266,522.4806171000074,523.4126706137926,521.5485635862223,18361,40924.933333333334,61.177534986902515,52.45558516101143,NaN,NaN,NaN,NaN,0.9304490927664905,31.05906343851824,13036265
2025-08-14T10:40:00-04:00,524.025,525,523.74,525,521.6777113091015,NaN,NaN,NaN,NaN,NaN,523.0275000000005,525.7772347138122,520.2777652861888,522.6799807935413,522.6158557375153,523.654311444653,521.5774000303776,30454,41702.666666666664,67.27283462318287,54.32972064192432,NaN,NaN,NaN,NaN,0.9539884432831691,31.596593579755783,13066719
2025-08-14T10:45:00-04:00,524.98,525.94,524.92,525.77,522.7209971586877,NaN,NaN,NaN,NaN,NaN,523.0489000000005,525.8661918124441,520.2316081875568,523.5739846348331,522.8760793534241,524.1709208774316,521.5812378294165,46123,42625.8,71.00978570625135,56.86245986988594,NaN,NaN,NaN,NaN,0.9587035544772353,32.702348182770855,13112842
2025-08-14T10:50:00-04:00,525.765,525.94,525.27,525.47,522.927770015111,NaN,NaN,NaN,NaN,NaN,523.0635000000004,525.9229462744603,520.2040537255406,523.7121877078664,523.0037966576235,524.3906284538442,521.6169648614028,25925,42826.166666666664,67.76326228304501,58.059755687232304,NaN,NaN,NaN,NaN,0.9380818720145808,33.72912031414199,13086917
2025-08-14T10:55:00-04:00,525.465,525.59,524.05,524.24,522.927770015111,NaN,NaN,NaN,NaN,NaN,523.0511000000005,525.8845355748023,520.2176644251987,523.7121877078664,523.0659280363877,524.4611484049572,521.6707076678183,21688,43104.86666666667,56.38158735884864,58.38038538014247,NaN,NaN,NaN,NaN,0.9810760240135449,32.87260615363136,13065229
2025-08-14T11:00:00-04:00,524.22,524.39,523.87,524.09,522.927770015111,NaN,NaN,NaN,NaN,NaN,523.0371000000004,525.8428113816334,520.2313886183673,523.7121877078664,523.0913258067737,524.4789959175845,521.703655695963,14032,43191.13333333333,55.16471759021806,58.49342679070643,NaN,NaN,NaN,NaN,0.9481420222982904,31.84557760901071,13051197
2025-08-14T11:05:00-04:00,524.08,524.16,523.68,523.89,522.927770015111,NaN,NaN,NaN,NaN,NaN,523.0107000000004,525.7583724762807,520.2630275237201,523.7121877078664,523.1190916988127,524.4910536575625,521.7471297400629,20380,43053.566666666666,53.50651759554867,58.31004021454432,NaN,NaN,NaN,NaN,0.9147033064198424,30.643083974623732,13030817
2025-08-14T11:10:00-04:00,523.96,524.55,523.92,524.49,522.927770015111,NaN,NaN,NaN,NaN,NaN,523.0119000000004,525.7621020937643,520.2616979062366,523.7121877078664,523.1394318246884,524.5085234270939,521.7703402222828,10353,41934.73333333333,57.62200998245575,58.777550493401826,NaN,NaN,NaN,NaN,0.8965102131041371,29.896917615960145,13041170
2025-08-14T11:15:00-04:00,524.49,524.79,524.05,524.1,522.927770015111,NaN,NaN,NaN,NaN,NaN,523.0147000000004,525.769039419321,520.2603605806798,523.7121877078664,523.1620356857106,524.5274452101737,521.7966261612476,12001,40881.566666666666,54.259937621902324,58.910962360451265,NaN,NaN,NaN,NaN,0.885330912168128,29.425604306041542,13029169
2025-08-14T11:20:00-04:00,524.08,524.1,523.4,523.61,522.927770015111,NaN,NaN,NaN,NaN,NaN,523.0113000000005,525.7622698720032,520.2603301279977,523.7121877078664,523.1755153456105,524.5264524970763,521.8245781941447,15917,40282,50.289722420674174,58.849859173531954,NaN,NaN,NaN,NaN,0.8720929898704078,28.09121062610041,13013252
2025-08-14T11:25:00-04:00,523.59,523.62,523.1,523.1,522.927770015111,NaN,NaN,NaN,NaN,NaN,522.9949000000004,525.7337555925868,520.2560444074139,523.7121877078664,523.1783076603515,524.509922898548,521.846692422155,18782,40013,46.477840182096095,58.20118778245921,NaN,NaN,NaN,NaN,0.8469434905939489,26.471079710406247,12994470
2025-08-14T11:30:00-04:00,523.1,523.18,522.25,522.35,NaN,NaN,NaN,525.261369515566,525.261369515566,525.261369515566,522.9627000000004,525.693256873065,520.2321431269357,523.7121877078664,523.15433390373,524.4635237905107,521.8451440169493,28117,39779.36666666667,41.496486951060824,57.12846092751431,NaN,NaN,NaN,NaN,0.8528760984086633,25.158769018340493,12966353
2025-08-14T11:35:00-04:00,522.33,522.41,521.83,521.99,NaN,NaN,NaN,524.6297163557676,NaN,NaN,522.9251000000004,525.6564223824956,520.1937776175051,523.7121877078664,523.1253825986885,524.4285687670725,521.8221964303044,18940,35807.933333333334,39.31817215534918,55.84960863871023,NaN,NaN,NaN,NaN,0.833384948522325,24.3592533212176,12947413
2025-08-14T11:40:00-04:00,521.95,522.23,521.8,522.17,NaN,NaN,NaN,524.4692747032327,NaN,NaN,522.8891000000004,525.6118204698272,520.1663795301737,523.0377501662931,523.1000626298538,524.3976926967656,521.802432562942,17274,34432.933333333334,40.98625334728402,54.48047591462999,NaN,NaN,NaN,NaN,0.804571737913592,23.64687584816501,12964687
2025-08-14T11:45:00-04:00,522.17,522.98,522.17,522.83,NaN,NaN,NaN,524.4692747032327,NaN,NaN,522.8667000000004,525.5725156694604,520.1608843305404,522.8238784681135,523.0893207835487,524.3728133535506,521.8058282135469,18072,33781.76666666667,46.764738924571155,53.45099048160632,NaN,NaN,NaN,NaN,0.8049594709197683,22.035432107758183,12982759
2025-08-14T11:50:00-04:00,522.84,523.36,522.7,523.27,NaN,NaN,NaN,524.4692747032327,NaN,NaN,522.8407000000003,525.5052164734828,520.1761835265178,522.8238784681135,523.0897052650462,524.361213154914,521.8181973751783,14026,31796,50.26135703138728,52.23588493933521,NaN,NaN,NaN,NaN,0.7946052229969255,20.814594688318227,12996785
2025-08-14T11:55:00-04:00,523.23,523.69,523.15,523.39,NaN,NaN,NaN,524.4692747032327,NaN,NaN,522.8249000000003,525.4667345817928,520.1830654182078,522.8238784681135,523.0998913021622,524.35227928148,521.8475033228443,24779,25972.1,51.20272121551114,50.82109461856805,NaN,NaN,NaN,NaN,0.7764191356400078,20.039749723718074,13021564
2025-08-14T12:00:00-04:00,523.45,523.56,522.83,523.33,NaN,NaN,NaN,524.4692747032327,NaN,NaN,522.8055000000003,525.4178018580272,520.1931981419733,522.8238784681135,523.1024962674848,524.3433314792683,521.8616610557012,14761,24410.3,50.68617645875189,49.60130277397568,NaN,NaN,NaN,NaN,0.7731034830942861,18.909466897827848,13006803
2025-08-14T12:05:00-04:00,523.34,523.605,522.97,523.15,NaN,NaN,NaN,524.4692747032327,NaN,NaN,522.7913000000003,525.3881926118023,520.1944073881983,522.1771027744909,523.1038949405473,524.3385572020048,521.8692326790898,8060,22867.7,49.08631889967769,49.08021216974918,NaN,NaN,NaN,NaN,0.7632389485875508,17.913679524595366,12998743
2025-08-14T12:10:00-04:00,523.13,523.35,522.56,522.64,NaN,NaN,NaN,524.4692747032327,NaN,NaN,522.7729000000003,525.3607671444424,520.1850328555581,522.0441465837729,523.1015323087717,524.3306783066489,521.8723863108944,7533,21847.4,44.77409812522139,48.33802506510657,NaN,NaN,NaN,NaN,0.7651504522598741,16.815942273134173,12991210
2025-08-14T12:15:00-04:00,522.61,523.31,522.53,522.8,NaN,NaN,NaN,524.4692747032327,NaN,NaN,522.7573000000003,525.3349013728068,520.1796986271938,522.0441465837729,523.1002208051201,524.325840872002,521.8746007382382,4821,20387.633333333335,46.36599610674051,47.827987815905985,NaN,NaN,NaN,NaN,0.7662111342413097,15.835658866335706,12996031
2025-08-14T12:20:00-04:00,522.74,524.22,522.72,524.2,NaN,NaN,NaN,524.4692747032327,NaN,NaN,522.7699000000003,525.369335699759,520.1704643002417,522.0538227525707,523.1098109019377,524.3281853742469,521.8914364296286,12940,19363,57.822373013897156,47.84229946100894,NaN,NaN,NaN,NaN,0.8186246246526447,15.623972949888811,13008971
2025-08-14T12:25:00-04:00,524.2,524.5,524.1,524.35,521.8973013236991,521.8973013236991,521.8973013236991,NaN,NaN,NaN,522.8003000000003,525.4371196065036,520.163480393497,522.5670582020566,523.1335440601448,524.3514618456123,521.9156262746773,16595,18861.5,58.83689874893853,48.16922525579724,NaN,NaN,NaN,NaN,0.7887228657488828,15.731157829935691,13025566
2025-08-14T12:30:00-04:00,524.33,524.92,524.33,524.81,522.2510603544401,NaN,NaN,NaN,NaN,NaN,522.8473000000004,525.5413357898568,520.1532642101439,523.0786465616453,523.172986388131,524.3999163191752,521.9460564570868,21989,18714.133333333335,61.866198725124555,48.99611642040084,NaN,NaN,NaN,NaN,0.7745283753382425,16.263302944787565,13047555
2025-08-14T12:35:00-04:00,524.86,525.05,524.24,524.28,522.2685121565111,NaN,NaN,NaN,NaN,NaN,522.8795000000003,525.6026189832353,520.1563810167654,523.1719172493163,523.2087484910527,524.4385867076829,521.9789102744224,23555,18820.7,56.689645796503086,49.72553110714419,NaN,NaN,NaN,NaN,0.7770620628140784,16.887925699685372,13024000
2025-08-14T12:40:00-04:00,524.29,524.3,523.81,524,522.2685121565111,NaN,NaN,NaN,NaN,NaN,522.9009000000003,525.6420280081995,520.1597719918011,523.1719172493163,523.2292981417421,524.4505890822865,522.0080072011978,22638,19067.9,54.11356082277667,50.62675066940961,NaN,NaN,NaN,NaN,0.7565576297559307,16.770605420070716,13001362
2025-08-14T12:45:00-04:00,523.98,524.15,523.87,523.95,522.2685121565111,NaN,NaN,NaN,NaN,NaN,522.9333000000003,525.6849464957447,520.1816535042558,523.1719172493163,523.2386368901869,524.4552951558276,522.0219786245461,11336,18747.866666666665,53.64476851932305,51.65007898112203,NaN,NaN,NaN,NaN,0.7225177990590765,16.661665160428534,12990026
2025-08-14T12:50:00-04:00,523.98,524.17,523.91,524,522.2685121565111,NaN,NaN,NaN,NaN,NaN,522.9759000000004,525.726332467246,520.2254675327547,523.1719172493163,523.2464994705318,524.4596038230604,522.0333951180032,9306,18047.833333333332,54.073242865548345,52.58486394671234,NaN,NaN,NaN,NaN,0.689480813411999,16.585902443331555,12999332
2025-08-14T12:55:00-04:00,523.99,524.26,523.87,523.91,522.2685121565111,NaN,NaN,NaN,NaN,NaN,523.0133000000004,525.7626661882375,520.2639338117633,523.1719172493163,523.2560381564481,524.464566264091,522.0475100488052,11748,17619.866666666665,53.121426887053836,53.03891308688967,NaN,NaN,NaN,NaN,0.6680893267397124,16.63566654610332,12987584
2025-08-14T13:00:00-04:00,523.92,524.06,523.84,524,522.2685121565111,NaN,NaN,NaN,NaN,NaN,523.0599000000003,525.795564079783,520.3242359202176,523.1719172493163,523.2616050706899,524.4670193728762,522.0561907685037,7457,17598.766666666666,53.99354248266067,53.305497761980625,NaN,NaN,NaN,NaN,0.6360829462582983,16.622383543838755,12995041
2025-08-14T13:05:00-04:00,524,524.01,523.95,523.99,522.2685121565111,NaN,NaN,NaN,NaN,NaN,523.0911000000003,525.8328930551305,520.3493069448701,523.1719172493163,523.2662275643902,524.4691540768388,522.0633010519416,6136,17191.266666666666,53.87361520852137,53.4962759043385,NaN,NaN,NaN,NaN,0.5949341643827016,16.610049327450234,12988905
2025-08-14T13:10:00-04:00,523.99,524.01,523.97,524,522.2685121565111,NaN,NaN,NaN,NaN,NaN,523.1333000000003,525.8647798987448,520.4018201012558,523.2385490203238,523.2691544011393,524.4705398403431,522.0677689619355,3872,16305.2,53.983686142169844,53.731812310296924,NaN,NaN,NaN,NaN,0.5552960097839347,16.598596126518032,12992777
2025-08-14T13:15:00-04:00,523.99,524.19,523.92,524.04,522.2685121565111,NaN,NaN,NaN,NaN,NaN,523.1957000000003,525.8638979006449,520.5275020993557,523.4378392162591,523.2804672706651,524.4767622658075,522.0841722755227,14141,15239.133333333333,54.45189350053787,54.1150676389298,NaN,NaN,NaN,NaN,0.5349177233708032,16.889514017063846,13006918
2025-08-14T13:20:00-04:00,524.04,524.055,523.96,523.98,522.2685121565111,NaN,NaN,NaN,NaN,NaN,523.2769000000003,525.7836308505674,520.7701691494332,523.4378392162591,523.2850035479477,524.478868764889,522.0911383310064,6207,14581.866666666667,53.571381664625,54.743445034601486,NaN,NaN,NaN,NaN,0.5034950288443111,17.15965205828496,13000711
2025-08-14T13:25:00-04:00,524,524.19,523.99,524.06,522.3515762802836,NaN,NaN,NaN,NaN,NaN,523.3622000000003,525.6716944549307,521.0527055450698,523.5656170984058,523.3005098982029,524.4877758961339,522.1132439002719,19540,14510.266666666666,54.624950091832574,55.33337031925091,NaN,NaN,NaN,NaN,0.48253109821257717,17.64905335009405,13020251
2025-08-14T13:30:00-04:00,524.06,524.06,523.93,523.99,522.3515762802836,NaN,NaN,NaN,NaN,NaN,523.4440000000003,525.5367455643693,521.3512544356313,523.5656170984058,523.3049584387942,524.489699730578,522.1202171470104,6474,14258.333333333334,53.4813554039077,55.023297632823095,NaN,NaN,NaN,NaN,0.45735030548310707,17.928526911018064,13013777
2025-08-14T13:35:00-04:00,523.995,524,523.345,523.35,522.3515762802836,NaN,NaN,NaN,NaN,NaN,523.4974000000003,525.4358810953306,521.55891890467,523.5656170984058,523.3082549906092,524.4858222654034,522.1306877158149,12946,14010.533333333333,44.3411728508708,53.987888640103975,NaN,NaN,NaN,NaN,0.4714681408057403,16.69649295651613,13000831
2025-08-14T13:40:00-04:00,523.4,523.4,522.9,523,522.3515762802836,NaN,NaN,NaN,NaN,NaN,523.5306000000004,525.3747102344134,521.6864897655873,523.5656170984058,523.306228886081,524.478232180515,522.1342255916471,10033,13999.866666666667,40.286254529791165,52.44646405472302,NaN,NaN,NaN,NaN,0.4735061307481874,16.34245251430226,12990798
2025-08-14T13:45:00-04:00,523.01,523.11,522.64,522.7,522.3515762802836,NaN,NaN,NaN,NaN,NaN,523.5756000000002,525.215303191919,521.9358968080815,523.5656170984058,523.2998746776134,524.4655649338681,522.1341844213587,13561,14051.866666666667,37.15026406767617,51.050793931235376,NaN,NaN,NaN,NaN,0.47325569283760455,16.467794822422448,12977237
2025-08-14T13:50:00-04:00,522.68,522.92,522.25,522.485,NaN,NaN,NaN,524.269716043388,524.269716043388,524.269716043388,523.5773000000003,525.2122938339746,521.9423061660259,523.5656170984058,523.2919911064854,524.4540378702534,522.1299443427174,11126,13892.166666666666,35.04482066561101,49.688741062866406,NaN,NaN,NaN,NaN,0.4873088576349156,17.19393675768682,12966111
2025-08-14T13:55:00-04:00,522.495,522.7,522.46,522.5,NaN,NaN,NaN,524.2208653141431,NaN,NaN,523.5765000000004,525.2135610852702,521.9394389147305,523.5656170984058,523.2870458991617,524.4467616511051,522.1273301472183,7117,13503.333333333334,35.32023565798275,48.379845858484956,NaN,NaN,NaN,NaN,0.46964393923242226,17.868211411860884,12973228
2025-08-14T14:00:00-04:00,522.5,522.82,521.94,521.96,NaN,NaN,NaN,524.0662805271367,NaN,NaN,523.5597000000002,525.2448260004019,521.8745739995986,523.5656170984058,523.2682396626445,524.4258756806533,522.1106036446357,19443,13214.2,30.333823911335784,46.6841730760412,NaN,NaN,NaN,NaN,0.49895508643010605,19.221705717513522,12953785
2025-08-14T14:05:00-04:00,521.96,521.99,521.72,521.77,NaN,NaN,NaN,523.5014495940849,NaN,NaN,523.5313000000003,525.2867860400396,521.775813959961,523.5656170984058,523.2456938032326,524.4080858024396,522.0833018040256,17199,13156.166666666666,28.79352871541596,44.94646606378135,NaN,NaN,NaN,NaN,0.4826011516850972,20.74695624393604,12936586
2025-08-14T14:10:00-04:00,521.81,522.4,521.69,521.71,NaN,NaN,NaN,523.5014495940849,NaN,NaN,523.5149000000004,525.3220574245207,521.70774257548,523.5656170984058,523.2261469534533,524.3907502847212,522.0615436221854,16627,13134.6,28.304743173732305,43.11155182742932,NaN,NaN,NaN,NaN,0.4988439265647276,21.092436817574193,12919959
2025-08-14T14:15:00-04:00,521.75,521.76,520.95,521.12,NaN,NaN,NaN,523.0580460144452,NaN,NaN,523.4829000000003,525.3986286751986,521.5671713248021,523.4954936787246,523.184160103112,524.3704059824219,521.9979142238022,24572,13351.266666666666,23.99181683528397,40.97713765791236,NaN,NaN,NaN,NaN,0.5210693603815288,22.325880686340152,12895387
2025-08-14T14:20:00-04:00,521.15,521.52,521.02,521.34,NaN,NaN,NaN,522.9638166501521,NaN,NaN,523.4585000000003,525.4501970144147,521.4668029855859,523.2208949429797,523.1608880213453,524.3581021910924,521.9636738515982,14217,13357.633333333333,28.374459735191692,39.147907200271064,NaN,NaN,NaN,NaN,0.5195644060685625,23.47122142162283,12909604
2025-08-14T14:25:00-04:00,521.35,521.35,520.84,520.9,NaN,NaN,NaN,522.7813704387817,NaN,NaN,523.4129000000003,525.5285579018076,521.2972420981929,522.5267159543838,523.1379329609179,524.3488289066826,521.9270370151531,12579,12950.966666666667,25.23989041932313,37.06133555161286,NaN,NaN,NaN,NaN,0.5188812342065217,24.738155296855577,12897025
2025-08-14T14:30:00-04:00,520.89,521.68,520.8,521.68,NaN,NaN,NaN,522.7813704387817,NaN,NaN,523.3801000000003,525.5506413972314,521.2095586027692,522.1763727635071,523.1054384286125,524.3281048728686,521.8827719843564,22076,13194.8,38.260714853470205,35.96771649367324,NaN,NaN,NaN,NaN,0.5446754317631983,25.071498418672522,12919101
2025-08-14T14:35:00-04:00,521.69,521.72,520.99,521.01,NaN,NaN,NaN,522.7813704387817,NaN,NaN,523.3319000000004,525.6015298281969,521.0622701718038,521.8380982108056,523.0877739920288,524.3179761323175,521.8575718517401,11374,13305.266666666666,32.951728195620845,34.4196292153724,NaN,NaN,NaN,NaN,0.5579129009229712,25.281264719359093,12907727
2025-08-14T14:40:00-04:00,521,521.24,520.92,521.005,NaN,NaN,NaN,522.7813704387817,NaN,NaN,523.2752000000003,525.6312271299639,520.9191728700366,521.7144785686445,523.0685926404549,524.308649189919,521.8285360909907,11442,13435.566666666668,32.91502257291958,32.95060544173039,NaN,NaN,NaN,NaN,0.5409191222856197,25.57856432755955,12896285
2025-08-14T14:45:00-04:00,521.02,521.1,520.89,520.99,NaN,NaN,NaN,522.6603964436543,NaN,NaN,523.2152000000002,525.6469400843033,520.7834599156971,521.5915828549156,523.0420632151904,524.2960304842626,521.7880959461182,15702,13798.266666666666,32.796992044328235,32.12602109840592,NaN,NaN,NaN,NaN,0.5172820421223637,25.900577536678664,12880583
2025-08-14T14:50:00-04:00,521,521.1,520.52,520.52,NaN,NaN,NaN,522.4787875143973,NaN,NaN,523.1256000000003,525.6170924357587,520.634107564242,521.150813027146,523.0117454607839,524.2851837496996,521.7383071718682,16202,13907,29.256861967667405,31.33820734396851,NaN,NaN,NaN,NaN,0.5217618962564835,26.73900455027884,12864381
2025-08-14T14:55:00-04:00,520.53,520.98,520.15,520.94,NaN,NaN,NaN,522.271115354652,NaN,NaN,523.0290000000003,525.4770457506227,520.580954249378,521.150813027146,522.9662116437671,524.2675517818597,521.6648715056746,24895,14183.666666666666,35.91395729574661,31.24989971740211,NaN,NaN,NaN,NaN,0.5437789036667376,27.98170979382048,12889276
2025-08-14T15:00:00-04:00,520.95,521.25,520.53,520.925,NaN,NaN,NaN,522.271115354652,NaN,NaN,522.9381000000003,525.3541595102922,520.5220404897084,520.3556504217169,522.9251797203817,524.2453530026468,521.6050064381167,25740,14308.7,35.784441912184334,31.30272980644306,NaN,NaN,NaN,NaN,0.5563661248334012,28.35636648425363,12863536
2025-08-14T15:05:00-04:00,520.91,521.23,520.72,521.19,NaN,NaN,NaN,522.271115354652,NaN,NaN,522.8771000000003,525.3125326838767,520.4416673161238,520.156973015919,522.8993815070602,524.2285613350521,521.5702016790683,18034,14124.666666666666,39.90748410741237,31.630390409973746,NaN,NaN,NaN,NaN,0.5530542587738719,28.70426198251299,12881570
2025-08-14T15:10:00-04:00,521.19,521.2,520.88,521.15,NaN,NaN,NaN,522.271115354652,NaN,NaN,522.8183000000002,525.275624243516,520.3609757564845,520.156973015919,522.8842044100652,524.2181614375106,521.5502473826198,11026,13737.6,39.49527135716833,32.2847795132475,NaN,NaN,NaN,NaN,0.5364075260043132,29.027307802325247,12870544
2025-08-14T15:15:00-04:00,521.19,522.005,521.06,521.99,NaN,NaN,NaN,522.271115354652,NaN,NaN,522.7803000000002,525.2289056517553,520.3316943482452,520.4652351881139,522.8648833713386,524.1966372411431,521.5331295015341,21684,14082.533333333333,50.952678474229906,33.86757592459136,NaN,NaN,NaN,NaN,0.5655927027182944,27.234815869192403,12892228
2025-08-14T15:20:00-04:00,521.98,522,521.36,521.64,NaN,NaN,NaN,522.271115354652,NaN,NaN,522.7233000000002,525.1425665082343,520.3040334917662,520.4652351881139,522.8501247360232,524.1802334751175,521.5200159969289,16784,14331.8,46.96225139984497,35.2002550835994,NaN,NaN,NaN,NaN,0.5709075096669867,25.570359074140477,12875444
2025-08-14T15:25:00-04:00,521.65,521.755,521.28,521.44,NaN,NaN,NaN,522.271115354652,NaN,NaN,522.6701000000003,525.0829103857286,520.2572896142719,520.4652351881139,522.8356468650699,524.1659821459929,521.5053115841469,14679,14429.5,44.802986341035655,36.686767191153095,NaN,NaN,NaN,NaN,0.5640569732622035,24.194396417065573,12860765
2025-08-14T15:30:00-04:00,521.46,521.62,521.3,521.43,NaN,NaN,NaN,522.271115354652,NaN,NaN,522.6265000000002,525.0485662662041,520.2044337337962,520.4652351881139,522.8032656804371,524.1345259980923,521.4720053627819,32957,15279.5,44.692338024548754,37.852329926107174,NaN,NaN,NaN,NaN,0.5466243323149068,22.916716806924583,12827808
2025-08-14T15:35:00-04:00,521.45,522.07,521.45,521.91,NaN,NaN,NaN,522.271115354652,NaN,NaN,522.6027000000003,525.0290703009996,520.1763296990009,520.6754723330514,522.7824093317182,524.1072948311562,521.4575238322802,30248,16083.233333333334,50.95371543388598,39.689031712861656,NaN,NaN,NaN,NaN,0.5532940228638492,21.88368061768589,12858056
2025-08-14T15:40:00-04:00,521.95,522.13,521.76,522.06,NaN,NaN,NaN,522.271115354652,NaN,NaN,522.5969000000003,525.0270422916163,520.1667577083844,520.8293778664411,522.7756600055341,524.0969635611785,521.4543564498896,12271,16363.2,52.75377310091614,40.7242501591078,NaN,NaN,NaN,NaN,0.5402015926592888,21.0522581147722,12870327
2025-08-14T15:45:00-04:00,522.055,522.25,521.4,521.41,NaN,NaN,NaN,522.271115354652,NaN,NaN,522.5853000000003,525.0323973902691,520.1382026097315,520.8293778664411,522.7607443748426,524.0790581912386,521.4424305584466,20175,16564.333333333332,45.03971782023663,41.587677989437495,NaN,NaN,NaN,NaN,0.5623300503264841,19.699928523145978,12850152
2025-08-14T15:50:00-04:00,521.41,522.92,521.41,522.33,520.3197066919699,520.3197066919699,520.3197066919699,NaN,NaN,NaN,522.5885000000003,525.0338345369569,520.1431654630437,520.9926018345222,522.7398861872568,524.036711938747,521.4430604357667,59097,18327.333333333332,55.057009899034526,43.16924851273142,NaN,NaN,NaN,NaN,0.6300207610174489,19.480038711270435,12909249
2025-08-14T15:55:00-04:00,522.32,523.26,522.13,522.44,520.7794927514259,NaN,NaN,NaN,NaN,NaN,522.5807000000002,525.0253913993755,520.1360086006249,521.1530814676179,522.7308061584525,523.9819202187525,521.4796920981526,115154,21514.466666666667,56.08758175592669,44.83286206355988,NaN,NaN,NaN,NaN,0.6657335638019165,19.81872098799777,13024403
2025-08-15T09:30:00-04:00,522.77,523.07,520.86,520.86,520.7794927514259,NaN,NaN,NaN,NaN,NaN,522.5325000000003,525.0156586734967,520.0493413265038,521.1530814676179,521.5966666666667,521.5966666666667,521.5966666666667,62901,23395.366666666665,41.402110671688604,45.700379828132824,NaN,NaN,NaN,NaN,0.7760383092446393,19.053554605297162,12961502
2025-08-15T09:35:00-04:00,520.92,522.73,520.92,522.04,520.7794927514259,NaN,NaN,NaN,NaN,NaN,522.5055000000002,524.9801193642857,520.0308806357148,521.1530814676179,521.7147491885986,521.8613141046841,521.5681842725131,40829,24324.8,51.59545922570239,46.82048710884395,NaN,NaN,NaN,NaN,0.8541784300128797,18.34304296421802,13002331
2025-08-15T09:40:00-04:00,521.99,523.17,521.99,522.96,520.7794927514259,NaN,NaN,NaN,NaN,NaN,522.4981000000002,524.9650137718991,520.0311862281014,521.1530814676179,521.943766370824,522.3810750524985,521.5064576891496,31139,25028.333333333332,57.764319096741,48.390478336312285,NaN,NaN,NaN,NaN,0.8774513992976705,17.140754414786574,13033470
2025-08-15T09:45:00-04:00,523,523,521.39,521.73,520.7794927514259,NaN,NaN,NaN,NaN,NaN,522.4697000000001,524.938634514844,520.0007654851562,521.1530814676179,521.9598846111903,522.3605084533616,521.559260769019,27134,25480.766666666666,48.80830977865431,49.02625159854385,NaN,NaN,NaN,NaN,0.9297762993478378,16.71510650945893,13006336
2025-08-15T09:50:00-04:00,521.65,522.5,521.52,522.4,520.7794927514259,NaN,NaN,NaN,NaN,NaN,522.4649000000002,524.9334246521394,519.996375347861,521.1530814676179,521.9755812376621,522.3617070429772,521.5894554323471,15466,25625.433333333334,53.07610260835665,49.99631097362873,NaN,NaN,NaN,NaN,0.9333637065372793,16.319862025940402,13021802
2025-08-15T09:55:00-04:00,522.42,522.67,522,522.27,520.7794927514259,NaN,NaN,NaN,NaN,NaN,522.4543000000002,524.921529222844,519.9870707771564,521.1530814676179,521.995587503026,522.3784957490312,521.6126792570207,11174,25760.666666666668,52.16732902424036,50.0830717272009,NaN,NaN,NaN,NaN,0.9145520132131849,15.639430121712858,13010628
2025-08-15T10:00:00-04:00,522.22,523.2,521.13,523.18,520.7794927514259,NaN,NaN,NaN,NaN,NaN,522.4339000000002,524.8595729289054,520.008227071095,521.1530814676179,522.0646794989223,522.4608800939686,521.6684789038759,29713,26103,57.63549322784434,50.845446143486576,NaN,NaN,NaN,NaN,0.9970840122693895,16.19697933781795,13040341
2025-08-15T10:05:00-04:00,523.2,523.84,523.03,523.83,520.8150935213329,NaN,NaN,NaN,NaN,NaN,522.4235000000002,524.820512515241,520.0264874847594,521.1530814676179,522.190101993276,522.7527022022648,521.6275017842872,19895,26192.866666666665,61.05979330121385,52.00664664064215,NaN,NaN,NaN,NaN,0.9837208685358659,15.621483970329056,13060236
2025-08-15T10:10:00-04:00,523.84,524.43,523.71,524.28,521.4709983612722,NaN,NaN,NaN,NaN,NaN,522.4129000000003,524.7719922741351,520.0538077258655,521.6286708727025,522.4377224925616,523.2730922161835,521.6023527689398,34657,26793.866666666665,63.273081615427,53.33384261141917,NaN,NaN,NaN,NaN,0.9648836636404408,14.77080161902212,13094893
2025-08-15T10:15:00-04:00,524.31,524.5,523.345,523.345,521.4709983612722,NaN,NaN,NaN,NaN,NaN,522.3942000000003,524.7081873460482,520.0802126539523,521.6814366981621,522.5421173019145,523.4170328054234,521.6672017984055,23984,26774.266666666666,56.13389554573073,53.70385547655094,NaN,NaN,NaN,NaN,0.9784634019518359,13.95471423214195,13070909
2025-08-15T10:20:00-04:00,523.37,524,523.37,523.59,521.4709983612722,NaN,NaN,NaN,NaN,NaN,522.3860000000003,524.6799869218489,520.0920130781517,521.6814366981621,522.5900813230846,523.4751995494944,521.7049630966749,13393,26746.8,57.48748109584959,54.04197747618905,NaN,NaN,NaN,NaN,0.9553588732409884,13.196918801467502,13084302
2025-08-15T10:25:00-04:00,523.73,524.01,523.09,523.09,521.4709983612722,NaN,NaN,NaN,NaN,NaN,522.3688000000003,524.6282588373572,520.1093411626434,521.6814366981621,522.6399174828177,523.5189749404371,521.7608600251983,20434,27008.633333333335,53.83640176129498,54.6703120434075,NaN,NaN,NaN,NaN,0.9528332394380578,12.887366702259289,13063868
2025-08-15T10:30:00-04:00,523.14,523.29,522.69,522.77,521.4709983612722,NaN,NaN,NaN,NaN,NaN,522.3442000000002,524.5584144065203,520.1299855934801,521.6814366981621,522.6467264100954,523.5159605891943,521.7774922309966,8342,26550.833333333332,51.578617981201795,54.42185547784802,NaN,NaN,NaN,NaN,0.9276308651924757,13.125486236711447,13055526
2025-08-15T10:35:00-04:00,522.72,522.76,522.4,522.59,521.4709983612722,NaN,NaN,NaN,NaN,NaN,522.3178000000003,524.487743003376,520.1478569966246,521.6814366981621,522.644048442255,523.4948201772165,521.7932767072934,14955,26670.2,50.30074424487142,54.00850994134407,NaN,NaN,NaN,NaN,0.8878000891072991,13.701442745724988,13040571
2025-08-15T10:40:00-04:00,522.64,522.72,521.79,521.86,521.4709983612722,NaN,NaN,NaN,NaN,NaN,522.2750000000003,524.3943649986802,520.1556350013204,521.6814366981621,522.6276434347745,523.4698323752359,521.7854544943132,11516,26672.666666666668,45.389325019893015,54.29331096621581,NaN,NaN,NaN,NaN,0.8908143684567823,14.902869504245775,13029055
2025-08-15T10:45:00-04:00,521.9,522.07,521.65,521.99,521.4709983612722,NaN,NaN,NaN,NaN,NaN,522.2350000000002,524.298130630345,520.1718693696555,521.6814366981621,522.5921574917461,523.4282053976381,521.7561095858541,18831,26776.966666666667,46.39315013617349,53.9217174598209,NaN,NaN,NaN,NaN,0.8571847707098745,16.159600405023113,13047886
2025-08-15T10:50:00-04:00,522.02,522.06,521.6,521.675,521.4709983612722,NaN,NaN,NaN,NaN,NaN,522.1885000000003,524.1944234774656,520.182576522535,521.6814366981621,522.5646422146419,523.3994950919671,521.7297893373168,13450,26685.233333333334,44.2697144166069,52.957817125525594,NaN,NaN,NaN,NaN,0.828814429944878,17.37872794876352,13034436
2025-08-15T10:55:00-04:00,521.7,521.78,521.33,521.68,NaN,NaN,NaN,523.9233198197416,523.9233198197416,523.9233198197416,522.1413000000002,524.0806966169929,520.2019033830076,521.6814366981621,522.5158670349134,523.3565176755376,521.6752163942892,21109,26559.033333333333,44.31328375839517,52.636743838364225,NaN,NaN,NaN,NaN,0.8017562563773818,18.793080845082592,13055545
2025-08-15T11:00:00-04:00,521.79,522.24,521.75,522.1,NaN,NaN,NaN,523.9233198197416,NaN,NaN,522.1037000000002,523.9705891874064,520.2368108125941,521.6814366981621,522.5058540645304,523.340656046374,521.6710520826867,8815,25994.866666666665,47.99142699483576,52.273552723112736,NaN,NaN,NaN,NaN,0.7844879523504301,19.146532091344152,13064360
2025-08-15T11:05:00-04:00,522.105,522.51,522.05,522.485,NaN,NaN,NaN,523.9233198197416,NaN,NaN,522.0722000000002,523.8573522731139,520.2870477268865,521.4841194868237,522.5021195787798,523.3273145617612,521.6769245957984,10387,25739.966666666667,51.17500405860618,52.20267236842458,NaN,NaN,NaN,NaN,0.7613102414682592,18.95934366715986,13074747
2025-08-15T11:10:00-04:00,522.44,522.86,522.43,522.65,NaN,NaN,NaN,523.9233198197416,NaN,NaN,522.0454000000002,523.7531374968935,520.3376625031069,521.4841194868237,522.5046135588075,523.3228752217714,521.6863518958436,7692,25628.833333333332,52.51650506922636,51.83703035709471,NaN,NaN,NaN,NaN,0.7376452242205309,18.158987800885466,13082439
2025-08-15T11:15:00-04:00,522.71,523.47,522.59,523.14,NaN,NaN,NaN,523.9233198197416,NaN,NaN,522.0412000000002,523.7370744759096,520.3453255240909,521.9048282690576,522.5219632904073,523.3333414645912,521.7105851162233,14200,25379.366666666665,56.35190699150233,51.50075276354389,NaN,NaN,NaN,NaN,0.7478134224904928,17.260856323303912,13096639
2025-08-15T11:20:00-04:00,523.16,523.3,522.66,522.78,NaN,NaN,NaN,523.9233198197416,NaN,NaN,522.0368000000002,523.7238195724676,520.3497804275328,521.9048282690576,522.5314940006815,523.3351990872727,521.7277889140903,11482,25202.633333333335,52.96686853825292,50.764594686602884,NaN,NaN,NaN,NaN,0.7401124637411709,16.426877094121036,13085157
2025-08-15T11:25:00-04:00,522.77,523.01,522.69,522.92,NaN,NaN,NaN,523.9233198197416,NaN,NaN,522.0412000000002,523.7362440223742,520.3461559776263,521.9048282690576,522.5401662735743,523.335429750418,521.7449027967306,12273,25122.433333333334,54.12106188044429,50.62082085336814,NaN,NaN,NaN,NaN,0.710104430616797,15.652467809879795,13097430
2025-08-15T11:30:00-04:00,522.96,523.19,522.8,522.94,NaN,NaN,NaN,523.9233198197416,NaN,NaN,522.0503000000002,523.7596020909483,520.3409979090521,521.9048282690576,522.5537277088678,523.3401948331175,521.767260584618,15512,24540.933333333334,54.29362108449946,50.39268799541456,NaN,NaN,NaN,NaN,0.6872398284298901,15.227638111129375,13112942
2025-08-15T11:35:00-04:00,523,523,522.26,522.29,NaN,NaN,NaN,523.9233198197416,NaN,NaN,522.0461000000003,523.7519901364903,520.3402098635102,521.9048282690576,522.5529388900977,523.3310096792451,521.7748681009504,10858,23894.6,47.977757248390326,49.97421338734995,NaN,NaN,NaN,NaN,0.69100841211347,14.414922778012173,13102084
2025-08-15T11:40:00-04:00,522.39,522.41,521.99,522.2,NaN,NaN,NaN,523.9233198197416,NaN,NaN,522.0509000000003,523.7571446359395,520.344655364061,521.9048282690576,522.5451183692064,523.3162724792875,521.7739642591254,11560,23870.9,47.15972754354864,49.658578356089,NaN,NaN,NaN,NaN,0.6716506683910763,14.088670727450872,13090524
2025-08-15T11:45:00-04:00,522.22,523.2,522.22,523.2,NaN,NaN,NaN,523.9233198197416,NaN,NaN,522.0795000000002,523.8136629099473,520.345337090053,521.9048282690576,522.5489596132195,523.3164000827505,521.7815191436885,6178,23404.333333333332,56.11343491257215,50.07377054663907,NaN,NaN,NaN,NaN,0.6951041920774281,13.667840686387525,13096702
2025-08-15T11:50:00-04:00,523.24,524.88,523.24,524.69,521.7800346377315,521.7800346377315,521.7800346377315,NaN,NaN,NaN,522.1391000000002,524.0172285253835,520.2609714746169,522.7717328174111,522.6186032156605,523.4433098597802,521.7938965715408,22262,22176.5,65.49526386146815,51.509909035323,NaN,NaN,NaN,NaN,0.7654538926433225,15.069602981496304,13118964
2025-08-15T11:55:00-04:00,524.7,524.87,523.89,523.89,522.0700330632893,NaN,NaN,NaN,NaN,NaN,522.1945000000002,524.112117531828,520.2768824681724,522.7717328174111,522.670977413139,523.5305148775715,521.8114399487065,18641,18959.4,58.29016998802979,52.35969616759844,NaN,NaN,NaN,NaN,0.7807786145973722,16.37123939838303,13100323
2025-08-15T12:00:00-04:00,523.88,524.11,523.49,524.05,522.0700330632893,NaN,NaN,NaN,NaN,NaN,522.2487000000002,524.2191119463183,520.2782880536821,522.7717328174111,522.6862383318318,523.550977299314,521.8214993643495,7251,17104.4,59.25558166757782,53.43011525695351,NaN,NaN,NaN,NaN,0.7692944278404173,16.911662275160523,13107574
2025-08-15T12:05:00-04:00,524,524.83,524,524.49,522.1163731010548,NaN,NaN,NaN,NaN,NaN,522.3205000000002,524.3498489099337,520.2911510900666,522.7739672025145,522.7217410172893,523.6126049588191,521.8308770757595,11902,16140.166666666666,61.86934224225877,54.68411943437234,NaN,NaN,NaN,NaN,0.7736305401375334,18.06414801487065,13119476
2025-08-15T12:10:00-04:00,524.5,524.62,524.15,524.3,522.1267652328252,NaN,NaN,NaN,NaN,NaN,522.3729000000002,524.4676382552594,520.2781617447409,522.7739672025145,522.7453785956149,523.6510557841258,521.8397014071039,8625,15389.7,60.07711787279394,55.54738306851221,NaN,NaN,NaN,NaN,0.7519426444134257,19.134313344601477,13110851
2025-08-15T12:15:00-04:00,524.29,524.29,523.71,523.96,522.1267652328252,NaN,NaN,NaN,NaN,NaN,522.4319000000002,524.5359236591561,520.3278763408442,522.7739672025145,522.7700290891107,523.6832391861509,521.8568189920705,12087,14888.133333333333,56.90065249928314,55.956357957132,NaN,NaN,NaN,NaN,0.7403753126696037,19.384512568072765,13098764
2025-08-15T12:20:00-04:00,523.95,524.01,523.71,523.85,522.1267652328252,NaN,NaN,NaN,NaN,NaN,522.4888000000002,524.5892671475432,520.3883328524572,522.7739672025145,522.7768417860298,523.6912162810885,521.862467290971,3840,14500.6,55.87139741503256,56.195993124689586,NaN,NaN,NaN,NaN,0.7089199331932001,19.61684041843896,13094924
2025-08-15T12:25:00-04:00,523.89,524.41,523.84,523.89,522.1267652328252,NaN,NaN,NaN,NaN,NaN,522.5468000000002,524.6386563617046,520.4549436382957,522.8537289661499,522.7929753447813,523.7125864195388,521.8733642700239,7882,14390.866666666667,56.18179075121539,56.18384196466908,NaN,NaN,NaN,NaN,0.6989970808222526,20.25366686806298,13102806
2025-08-15T12:30:00-04:00,523.91,524.75,523.86,524.75,522.1273903517737,NaN,NaN,NaN,NaN,NaN,522.6314000000001,524.7306684817254,520.5321315182748,523.0599831729199,522.8533317411523,523.8080636472005,521.898599835104,23402,14180.5,62.318597119835026,56.85182257763923,NaN,NaN,NaN,NaN,0.712640146477805,21.177875239917153,13126208
2025-08-15T12:35:00-04:00,524.78,524.79,524.19,524.31,522.329554426693,NaN,NaN,NaN,NaN,NaN,522.6988000000001,524.7929122793274,520.6046877206728,523.137986538336,522.8697109096341,523.8328308533963,521.9065909658719,6758,13742.6,57.85421166739679,57.11847613385013,NaN,NaN,NaN,NaN,0.7045944217293839,22.07516921387684,13119450
2025-08-15T12:40:00-04:00,524.35,524.47,524.11,524.41,522.329554426693,NaN,NaN,NaN,NaN,NaN,522.7685000000001,524.8537867904236,520.6832132095767,523.137986538336,522.8845139819829,523.8538408109713,521.9151871529945,6662,12809.433333333332,58.580453666307996,57.42467846112216,NaN,NaN,NaN,NaN,0.6799805344630003,22.742703846917973,13126112
2025-08-15T12:45:00-04:00,524.42,524.73,524.36,524.67,522.4791807896108,NaN,NaN,NaN,NaN,NaN,522.8381000000002,524.9402340485497,520.7359659514507,523.343711384535,522.904365509881,523.8851981325927,521.9235328871694,7755,12268.466666666667,60.48690724296388,58.31818917502027,NaN,NaN,NaN,NaN,0.6578390677156435,23.642871148151297,13133867
2025-08-15T12:50:00-04:00,524.71,524.98,524.71,524.88,522.8308089355376,NaN,NaN,NaN,NaN,NaN,522.9127000000002,525.0345578741494,520.790842125851,523.715969107628,522.9250083351686,523.9208674536236,521.9291492167137,7106,12058.9,62.00795953847953,59.3787771746582,NaN,NaN,NaN,NaN,0.6329934200216732,24.737087731528923,13140973
2025-08-15T12:55:00-04:00,524.9,525.13,524.765,524.91,522.9750903475585,NaN,NaN,NaN,NaN,NaN,522.9711000000002,525.1481772053055,520.7940227946949,523.9362752861024,522.9586362676491,523.9792264381817,521.9380460971165,11435,11758.933333333332,62.231634799116875,59.81579145226853,NaN,NaN,NaN,NaN,0.6138510328772686,25.905241816693742,13152408
2025-08-15T13:00:00-04:00,524.94,525.09,524.71,525.03,522.9750903475585,NaN,NaN,NaN,NaN,NaN,523.0389000000002,525.2567045805641,520.8210954194363,523.945020228882,522.9770081643047,524.0104913625559,521.9435249660536,6386,11693.733333333334,63.165794890736855,59.64940081150201,NaN,NaN,NaN,NaN,0.5971473876717491,26.85301617294134,13158794
2025-08-15T13:05:00-04:00,525.03,525.03,524.61,524.69,522.9750903475585,NaN,NaN,NaN,NaN,NaN,523.1039000000002,525.3209541621877,520.8868458378126,523.945020228882,522.9938933602525,524.0370466212056,521.9507400992994,6534,11413.033333333333,58.733189568121354,59.68104506722283,NaN,NaN,NaN,NaN,0.5844940028380499,27.475455931743276,13152260
2025-08-15T13:10:00-04:00,524.78,525.25,524.56,525.07,522.9935400271168,NaN,NaN,NaN,NaN,NaN,523.1767000000002,525.4081162403736,520.9452837596268,524.0042129464845,523.0157920021887,524.0734422924236,521.9581417119539,7844,11290.633333333333,61.94723956180536,59.87330634538195,NaN,NaN,NaN,NaN,0.5920301454924788,28.31968192764095,13160104
2025-08-15T13:15:00-04:00,525.08,525.16,524.7,524.71,523.0426972986115,NaN,NaN,NaN,NaN,NaN,523.2327000000001,525.4746618280024,520.9907381719979,524.0042129464845,523.0308856225581,524.0971923361798,521.9645789089365,5822,10857,57.38718310130016,59.553152121027765,NaN,NaN,NaN,NaN,0.5825994208144392,29.10360606668879,13154282
2025-08-15T13:20:00-04:00,524.7,524.82,524.6,524.78,523.0426972986115,NaN,NaN,NaN,NaN,NaN,523.2871000000002,525.5445473100866,521.0296526899139,524.0042129464845,523.0371036955551,524.1064046057166,521.9678027853935,2603,10495.433333333332,58.034065570570355,59.407219813726066,NaN,NaN,NaN,NaN,0.5566994621848383,29.537086178887133,13156885
2025-08-15T13:25:00-04:00,524.75,525.05,524.62,524.85,523.0426972986115,NaN,NaN,NaN,NaN,NaN,523.3559000000002,525.5898800262248,521.1219199737757,524.0042129464845,523.0544958482603,524.13311905438,521.9758726421406,6942,10023.2,58.70909731780965,59.53639444362083,NaN,NaN,NaN,NaN,0.5476495006002035,30.255851093002455,13163827
2025-08-15T13:30:00-04:00,524.87,525.16,524.74,525.14,523.1679573330617,NaN,NaN,NaN,NaN,NaN,523.4121000000002,525.681125420213,521.1430745797875,524.0795656228801,523.0850644163136,524.1824324521878,521.9876963804394,11408,10109.633333333333,61.47391691391575,59.93657440782677,NaN,NaN,NaN,NaN,0.5385316791287574,31.06987793455852,13175235
2025-08-15T13:35:00-04:00,525.15,525.21,525.01,525.1,523.3816865451953,NaN,NaN,NaN,NaN,NaN,523.4653000000002,525.7651864402335,521.1654135597669,524.245652498304,523.1003350484441,524.2074747118696,521.9931953850186,5564,9948.866666666667,60.868503936708066,60.27133963536196,NaN,NaN,NaN,NaN,0.5143508449052779,31.893950527106075,13169671
2025-08-15T13:40:00-04:00,525.12,525.3,524.97,525.23,523.4402462476864,NaN,NaN,NaN,NaN,NaN,523.5527000000002,525.7809389544082,521.3244610455922,524.3635219986433,523.1319174588662,524.2594305077262,522.0044044100061,11433,10073.566666666668,62.172384613352676,60.260895884898936,NaN,NaN,NaN,NaN,0.5011829274120386,32.7851856733861,13181104
2025-08-15T13:45:00-04:00,525.26,525.38,525.13,525.33,523.6031896000643,NaN,NaN,NaN,NaN,NaN,523.6185000000002,525.8584493293771,521.3785506706232,524.5058175989146,523.1470784152353,524.2849053777484,522.0092514527223,5317,9777.466666666667,63.188484551602244,60.64191537662789,NaN,NaN,NaN,NaN,0.4832412897397501,33.72634910786249,13186421
2025-08-15T13:50:00-04:00,525.33,525.42,525.17,525.42,523.6841809818795,NaN,NaN,NaN,NaN,NaN,523.6677000000002,525.9551948825571,521.3802051174433,524.5956540791317,523.1670568884763,524.3186570373845,522.0154567395681,6937,9625.966666666667,64.12254772223872,61.03777923776581,NaN,NaN,NaN,NaN,0.4665811976154823,34.658800207873206,13193358
2025-08-15T13:55:00-04:00,525.44,525.91,525.4,525.85,524.0478545736123,NaN,NaN,NaN,NaN,NaN,523.7501000000002,526.0492507036199,521.4509492963805,524.9955232633054,523.2455718312445,524.4619912330934,522.0291524293957,24124,10021,68.26571019873343,61.59340802032078,NaN,NaN,NaN,NaN,0.4696825406429472,36.15817752704181,13217482
2025-08-15T14:00:00-04:00,525.83,526.1,525.46,525.89,524.1586339111753,NaN,NaN,NaN,NaN,NaN,523.8199000000001,526.1623598093149,521.4774401906852,525.0484186106443,523.3351731215025,524.6198735752567,522.0504726677483,28323,10448.033333333333,68.62863777279318,62.06631360848605,NaN,NaN,NaN,NaN,0.48184807345416425,37.75657353767577,13245805
2025-08-15T14:05:00-04:00,525.78,525.78,524.77,524.77,524.1586339111753,NaN,NaN,NaN,NaN,NaN,523.8699000000001,526.184453511531,521.5553464884692,525.0484186106443,523.3606207687491,524.6533616915478,522.0678798459503,11845,10480.933333333332,51.03059017427319,61.266238992425784,NaN,NaN,NaN,NaN,0.5274303539217243,36.94375266594631,13233960
2025-08-15T14:10:00-04:00,524.77,524.87,524.45,524.52,524.1586339111753,NaN,NaN,NaN,NaN,NaN,523.8967000000002,526.2097106869014,521.5836893130991,525.0484186106443,523.380302746347,524.6722744429096,522.0883310497843,13162,10534.333333333334,48.06767707707119,60.18780200573537,NaN,NaN,NaN,NaN,0.5197567572130268,35.358592094554766,13220798
2025-08-15T14:15:00-04:00,524.55,524.58,524.06,524.06,NaN,NaN,NaN,525.9949052731597,525.9949052731597,525.9949052731597,523.9013000000002,526.2146765879276,521.5879234120729,525.0484186106443,523.4073624711426,524.687437294925,522.1272876473603,27445,11243.233333333334,43.10804810905221,59.07172047294472,NaN,NaN,NaN,NaN,0.5197741316978174,33.003635148631325,13193353
2025-08-15T14:20:00-04:00,524.04,524.19,523.77,523.98,NaN,NaN,NaN,525.6360459425616,NaN,NaN,523.8953000000002,526.2062715786664,521.5843284213341,525.0484186106443,523.4174288211339,524.6884323305914,522.1464253116764,15481,11017.2,42.2907910131275,57.66768843375344,NaN,NaN,NaN,NaN,0.5126474080051213,31.056404009927235,13177872
2025-08-15T14:25:00-04:00,523.94,524.04,523.9,523.99,NaN,NaN,NaN,525.5698620360815,NaN,NaN,523.9082000000002,526.2139352488367,521.6024647511637,525.0484186106443,523.4216088181715,524.6887692092096,522.1544484271335,6632,10616.9,42.43769487567104,56.5998678462085,NaN,NaN,NaN,NaN,0.4860297360047546,29.248260809702014,13184504
2025-08-15T14:30:00-04:00,524,524.02,523.81,523.83,NaN,NaN,NaN,525.4707773980778,NaN,NaN,523.9130000000002,526.217064234666,521.6089357653344,525.0484186106443,523.4277251827909,524.6876397301343,522.1678106354476,11825,10769.366666666667,40.65448986728631,55.35846958168821,NaN,NaN,NaN,NaN,0.46631332629013184,27.756374955217083,13172679
2025-08-15T14:35:00-04:00,523.79,523.8,523.33,523.38,NaN,NaN,NaN,525.1182420618017,NaN,NaN,523.9188000000001,526.2159979100974,521.6216020899029,525.0484186106443,523.42874457155,524.680167261362,522.1773218817381,12288,10782.233333333334,36.06454788564021,53.74100176510468,NaN,NaN,NaN,NaN,0.46871951726940814,27.272026791792666,13160391
2025-08-15T14:40:00-04:00,523.4,523.47,522.9,522.9,NaN,NaN,NaN,524.7453674226286,NaN,NaN,523.9214000000002,526.2136801220688,521.6291198779315,525.0484186106443,523.4228996640082,524.6642629362626,522.1815363917539,16002,11028.133333333333,31.924239862044004,51.63031054711384,NaN,NaN,NaN,NaN,0.47595383746445397,27.48397194024618,13144389
2025-08-15T14:45:00-04:00,522.93,523.55,522.89,523.5,NaN,NaN,NaN,524.7453674226286,NaN,NaN,523.9396000000002,526.2035830737333,521.675616926267,525.0484186106443,523.4215749528985,524.6554691618799,522.1876807439171,11350,11003.566666666668,41.036572724588275,50.21374403196243,NaN,NaN,NaN,NaN,0.48909999193127646,27.4672952328251,13155739
2025-08-15T14:50:00-04:00,523.51,523.71,522.94,523.05,NaN,NaN,NaN,524.7453674226286,NaN,NaN,523.9634000000002,526.1635558485804,521.76324415142,524.3787348885154,523.4181079946909,524.640848698128,522.1953672912538,17614,11462.7,37.032798701758665,48.41805932399143,NaN,NaN,NaN,NaN,0.5091642782218982,27.023711754213014,13138125
2025-08-15T14:55:00-04:00,523.08,523.5,522.75,523.16,NaN,NaN,NaN,524.7453674226286,NaN,NaN,523.9868000000002,526.126563313487,521.8470366865134,523.5389879108124,523.4137582301211,524.6275098308954,522.2000066293467,15013,11700.4,38.6095533606122,46.662421381777854,NaN,NaN,NaN,NaN,0.526366829777477,26.93134320013678,13153138
2025-08-15T15:00:00-04:00,523.11,523.14,522.59,522.66,NaN,NaN,NaN,524.5097275490074,NaN,NaN,524.0065000000002,526.0778070747713,521.9351929252291,523.2551903286499,523.4011469101403,524.6056007400333,522.1966930802472,20266,11595.866666666667,34.39365557720289,44.53892908570386,NaN,NaN,NaN,NaN,0.5294834847933669,27.105495232430847,13132872
2025-08-15T15:05:00-04:00,522.64,522.82,522.42,522.8,NaN,NaN,NaN,524.2445126604161,NaN,NaN,524.0289000000002,526.0218247747082,522.0359752252923,523.0462974482687,523.3891577351319,524.5871114030429,522.191204067221,16765,11929.433333333332,36.48494755121317,42.268874610880985,NaN,NaN,NaN,NaN,0.5202346644509901,27.53503246065448,13149637
2025-08-15T15:10:00-04:00,522.84,523.4,522.82,523.38,NaN,NaN,NaN,524.2445126604161,NaN,NaN,524.0545000000002,525.9793794762378,522.1296205237626,523.0462974482687,523.3877082441528,524.5811771972369,522.1942392910687,7787,11966.933333333332,44.39321357263664,40.53777288229838,NaN,NaN,NaN,NaN,0.5259321884187782,26.38194748949078,13157424
2025-08-15T15:15:00-04:00,523.37,523.39,522.8,523.16,NaN,NaN,NaN,524.2445126604161,NaN,NaN,524.0680000000002,525.9578084553655,522.178191544635,523.0462974482687,523.3837873855,524.5690345016541,522.1985402693459,14916,12205.633333333333,42.24461475029857,39.91020320915733,NaN,NaN,NaN,NaN,0.530508460674582,25.349356111164344,13142508
2025-08-15T15:20:00-04:00,523.17,523.32,523.1,523.13,NaN,NaN,NaN,524.2445126604161,NaN,NaN,524.0776000000002,525.9432197249093,522.211980275091,522.7710379586149,523.3821377435745,524.5626366870247,522.2016388001243,8556,12253.966666666667,41.94647664039962,39.47297460653794,NaN,NaN,NaN,NaN,0.5083292849121138,24.390521259861227,13133952
2025-08-15T15:25:00-04:00,523.11,523.24,522.99,523.13,NaN,NaN,NaN,524.2445126604161,NaN,NaN,524.0774000000001,525.9434238364707,522.2113761635295,522.3618303668919,523.3782089929794,524.5502611053523,522.2061568806064,15819,12400.1,41.94647664039961,39.39000521591989,NaN,NaN,NaN,NaN,0.48987719313267714,23.73298486310102,13133952
2025-08-15T15:30:00-04:00,523.14,523.36,523.03,523.09,NaN,NaN,NaN,524.2445126604161,NaN,NaN,524.0836000000002,525.9343371931241,522.2328628068763,522.3517714348109,523.3751533984753,524.5392528273672,522.2110539695833,14990,12686.9,41.49364596347259,39.33306628380168,NaN,NaN,NaN,NaN,0.4784573936232031,22.779616540676678,13118962
2025-08-15T15:35:00-04:00,523.08,523.17,522.78,522.8,NaN,NaN,NaN,524.2445126604161,NaN,NaN,524.0812000000002,525.9382671064267,522.2241328935737,522.3517714348109,523.3701595877051,524.5288796439436,522.2114395314666,11788,12862.033333333333,38.26812254838798,39.03523968899575,NaN,NaN,NaN,NaN,0.4721390083644019,22.441554619748075,13107174
2025-08-15T15:40:00-04:00,522.81,523.38,522.81,523.24,NaN,NaN,NaN,524.2445126604161,NaN,NaN,524.0872000000002,525.9313737005621,522.2430262994383,522.3039168198445,523.3662047034591,524.5151624093036,522.2172469976146,19205,13240.733333333334,45.225369516852744,39.36173109253621,NaN,NaN,NaN,NaN,0.4798433649098047,21.522377064004523,13126379
2025-08-15T15:45:00-04:00,523.26,523.4,523.06,523.14,NaN,NaN,NaN,524.2445126604161,NaN,NaN,524.1042000000001,525.8967404983088,522.3116595016915,522.3324854117603,523.3635872434053,524.5036497219617,522.2235247648489,17624,13634.133333333333,44.01135281988899,39.929360016411124,NaN,NaN,NaN,NaN,0.46985455313053526,20.61165405762732,13108755
2025-08-15T15:50:00-04:00,523.17,523.22,520.17,520.26,NaN,NaN,NaN,523.5438294452025,NaN,NaN,524.0654000000002,526.0900805569645,522.0407194430359,522.3324854117603,523.0758003521805,524.3644240412714,521.7871766630897,173232,19321.766666666666,24.01621831849043,39.36450133472873,NaN,NaN,NaN,NaN,0.654150656478359,23.23343833643072,12935523
2025-08-15T15:55:00-04:00,520.19,520.53,519.08,520.08,NaN,NaN,NaN,521.7675190158752,NaN,NaN,524.0030000000002,526.3039815292328,521.7020184707675,522.3324854117603,522.4890253242429,524.184664797063,520.7933858514228,292516,28840.9,23.30361536829419,38.09786152356486,NaN,NaN,NaN,NaN,0.7109970381584713,26.20979615130429,12643007
2025-08-18T09:30:00-04:00,521.575,522.48,519.95,522.32,518.9966863939374,518.9966863939374,518.9966863939374,NaN,NaN,NaN,523.9556000000002,526.2953372838313,521.6158627161692,522.3324854117603,521.5833333333334,521.5833333333334,521.5833333333334,40145,29798.8,45.12483529975045,38.67586413770713,NaN,NaN,NaN,NaN,0.8409258211471499,25.969191355572224,12683152
2025-08-18T09:35:00-04:00,522.33,522.82,521.17,521.52,519.6525188305766,NaN,NaN,NaN,NaN,NaN,523.9082000000002,526.3453317235079,521.4710682764925,522.3324854117603,521.6907902424565,521.8159917983734,521.5655886865396,29572,30599.066666666666,40.67394321938482,38.823320556190886,NaN,NaN,NaN,NaN,0.8987168339223599,25.344738102646552,12653580
2025-08-18T09:40:00-04:00,521.56,521.97,520.06,520.89,519.6525188305766,NaN,NaN,NaN,NaN,NaN,523.8450000000001,526.423912173377,521.2660878266233,522.3324854117603,521.5173072252251,521.8432754759175,521.1913389745326,22234,30959.1,37.53420191596582,39.04764529467395,NaN,NaN,NaN,NaN,0.9709513457850544,25.583426067709418,12631346
2025-08-18T09:45:00-04:00,520.9,521,520.4,520.56,519.6525188305766,NaN,NaN,NaN,NaN,NaN,523.7664000000001,526.4969845817517,521.0358154182485,522.3324854117603,521.390564222014,521.8196408430136,520.9614876010143,15808,31308.8,35.96798548336622,39.01071943268488,NaN,NaN,NaN,NaN,0.9444548210861236,25.805064892410652,12615538
2025-08-18T09:50:00-04:00,520.53,520.71,518.34,518.91,NaN,NaN,NaN,522.2009474182975,522.2009474182975,522.2009474182975,523.6586000000002,526.7038586355816,520.6133413644188,522.3324854117603,520.8162676117731,521.8124321963946,519.8201030271516,41360,32456.233333333334,29.369108383555513,37.93756906203623,NaN,NaN,NaN,NaN,1.0462794767228294,27.180281197139088,12574178
2025-08-18T09:55:00-04:00,519.1,519.41,518.42,519.16,NaN,NaN,NaN,521.6043134447384,NaN,NaN,523.5626000000001,526.8563001925049,520.2688998074952,522.3324854117603,520.5482192843515,521.671629805298,519.4248087634049,25762,32510.833333333332,31.422061811439207,37.16452956640342,NaN,NaN,NaN,NaN,1.0422595140997708,28.45726776581549,12599940
2025-08-18T10:00:00-04:00,519.23,520.2,518.92,520.09,NaN,NaN,NaN,521.6043134447384,NaN,NaN,523.4874000000001,526.9201756929227,520.0546243070775,522.3324854117603,520.4787627473434,521.5767528529319,519.3807726417548,16368,32112.333333333332,38.57459763905638,36.92368106630747,NaN,NaN,NaN,NaN,1.0592409773783646,28.683106350575304,12616308
2025-08-18T10:05:00-04:00,520.14,520.215,519.71,519.85,NaN,NaN,NaN,521.6043134447384,NaN,NaN,523.4066000000001,526.9847729636534,519.8284270363469,520.8409883294082,520.4535497557877,521.5324464392116,519.3746530723637,9123,32021.6,37.48797055699968,36.605216346064616,NaN,NaN,NaN,NaN,1.0196523361370526,28.875037150578457,12607185
2025-08-18T10:10:00-04:00,519.85,520,518.76,518.83,NaN,NaN,NaN,521.6043134447384,NaN,NaN,523.2882000000002,527.0668890634054,519.509510936595,519.300946024657,520.3849303900892,521.4721316342241,519.2977291459542,11571,31968.566666666666,33.20664954601068,36.013288030531626,NaN,NaN,NaN,NaN,1.0353914549844068,29.6132434899452,12595614
2025-08-18T10:15:00-04:00,518.83,518.83,518.28,518.28,NaN,NaN,NaN,521.2386470273811,NaN,NaN,523.1676000000001,527.1854791617147,519.1497208382855,519.300946024657,520.220030013774,521.3906082916363,519.0494517359117,19895,31716.9,31.141405972813857,35.504236846562044,NaN,NaN,NaN,NaN,1.0007206367712398,30.552823483643714,12575719
2025-08-18T10:20:00-04:00,518.34,518.95,518.34,518.92,NaN,NaN,NaN,521.2386470273811,NaN,NaN,523.0578000000002,527.230929837167,518.8846701628333,519.300946024657,520.1595990563436,521.3429923604658,518.9762057522214,9846,31529.066666666666,36.12006787350936,34.8538581577518,NaN,NaN,NaN,NaN,0.9770977341447279,31.26711444763896,12585565
2025-08-18T10:25:00-04:00,518.93,519.71,517.9,517.9,NaN,NaN,NaN,521.2386470273811,NaN,NaN,522.9224000000002,527.311246882499,518.5335531175014,518.1997568197256,519.9678267881794,521.2003526679042,518.7353009084546,31648,32362.933333333334,32.13253436666842,34.00537112537891,NaN,NaN,NaN,NaN,1.0365907531343945,30.96988965886792,12553917
2025-08-18T10:30:00-04:00,517.86,518.11,517.695,517.97,NaN,NaN,NaN,520.6120140045621,NaN,NaN,522.7842000000002,527.3494059579028,518.2189940420975,517.6838054557804,519.7997941163304,521.1071546340598,518.492433598601,24498,32785.36666666667,32.68178545750904,34.62434020673738,NaN,NaN,NaN,NaN,0.9921914136247924,30.83468375064639,12578415
2025-08-18T10:35:00-04:00,517.92,518.25,517.92,518.1,NaN,NaN,NaN,520.6120140045621,NaN,NaN,522.6480000000001,527.3555173922337,517.9404826077666,517.1686667146877,519.620302292222,520.9635966413563,518.2770079430878,34933,33540.2,33.754041932472305,35.37079924703581,NaN,NaN,NaN,NaN,0.9448920269373101,30.5293596404984,12613348
2025-08-18T10:40:00-04:00,518.08,518.25,517.95,518,NaN,NaN,NaN,520.6120140045621,NaN,NaN,522.5074000000001,527.3402092201479,517.6745907798522,517.1686667146877,519.5411423265303,520.8936290574422,518.1886555956185,17865,33602.3,33.31445963646169,34.527200985372325,NaN,NaN,NaN,NaN,0.898828310727499,30.245844395360983,12595483
2025-08-18T10:45:00-04:00,518,518.16,517.69,518,NaN,NaN,NaN,520.425717430151,NaN,NaN,522.3736000000001,527.3262425429485,517.4209574570517,517.1686667146877,519.3936849393999,520.762107884349,518.0252619944508,35813,34417.73333333333,33.31445963646169,34.00152358659211,NaN,NaN,NaN,NaN,0.8681977171041001,30.1940079983895,12595483
2025-08-18T10:50:00-04:00,518,518.33,517.97,518.25,NaN,NaN,NaN,520.425717430151,NaN,NaN,522.2372,527.2604388593993,517.2139611406008,517.1686667146877,519.3525985825709,520.7153369757369,517.9898601894048,13579,34283.23333333333,35.74083970082137,33.873426285510355,NaN,NaN,NaN,NaN,0.8318978801680939,29.890560596244725,12609062
2025-08-18T10:55:00-04:00,518.24,518.5,518.1,518.16,NaN,NaN,NaN,520.425717430151,NaN,NaN,522.1062000000001,527.2057088232558,517.0066911767443,517.0292776068117,519.3204298973417,520.6758038298476,517.9650559648358,12059,34184.76666666667,35.24368037265451,33.821690206173805,NaN,NaN,NaN,NaN,0.801048031584657,29.349139587496747,12597003
2025-08-18T11:00:00-04:00,518.17,518.22,517.09,517.44,NaN,NaN,NaN,520.0808625207202,NaN,NaN,521.9594000000001,527.1640831371619,516.7547168628382,517.0292776068117,519.2432966821033,520.6157054468315,517.8708879173751,19148,34147.5,31.472038993286176,33.97189953544028,NaN,NaN,NaN,NaN,0.8245446007571812,29.71140868291976,12577855
2025-08-18T11:05:00-04:00,517.41,517.74,517.13,517.7,NaN,NaN,NaN,519.8337778606874,NaN,NaN,521.8164000000002,527.0880111539022,516.5447888460981,517.0292776068117,519.2067838644514,520.5869971473066,517.8265705815961,9353,33900.433333333334,34.210044186290986,34.17104113364398,NaN,NaN,NaN,NaN,0.8092199864173836,30.047801414383983,12587208
2025-08-18T11:10:00-04:00,517.685,517.725,516.86,516.96,NaN,NaN,NaN,519.700197048838,NaN,NaN,521.6528000000002,527.0087208954008,516.2968791045996,517.0292776068117,519.0913073406932,520.511476638023,517.6711380433634,26642,34528.933333333334,30.477623310855847,33.5926858244868,NaN,NaN,NaN,NaN,0.8132042731018568,30.576111074340506,12560566
2025-08-18T11:15:00-04:00,516.95,517,516.6,516.94,NaN,NaN,NaN,519.1528017284363,NaN,NaN,521.4896000000001,526.912287097578,516.0669129024222,517.0292776068117,519.0237293165188,520.4739987492734,517.5734598837643,14503,34515.166666666664,30.381146244479794,33.085055516449664,NaN,NaN,NaN,NaN,0.7836896821660082,31.270556672532123,12546063
2025-08-18T11:20:00-04:00,517,517.03,516.59,516.91,NaN,NaN,NaN,519.1158561953255,NaN,NaN,521.3232000000002,526.7870220174116,515.8593779825887,517.0292776068117,518.9675595241707,520.4401136145111,517.4950054338303,12738,34654.566666666666,30.226582375533695,32.8721935757013,NaN,NaN,NaN,NaN,0.7591404191541463,31.858902697764197,12533325
2025-08-18T11:25:00-04:00,516.92,517.04,516.63,516.71,NaN,NaN,NaN,519.0919536409926,NaN,NaN,521.1508000000001,526.6419417244642,515.659658275536,517.0292776068117,518.9181416790029,520.4094944955267,517.4267888624792,11500,34510.6,29.161443426059662,32.73076767950458,NaN,NaN,NaN,NaN,0.7342018177859907,32.38509834261439,12521825
2025-08-18T11:30:00-04:00,516.7,516.79,516.2,516.37,NaN,NaN,NaN,518.7298193845838,NaN,NaN,520.9698000000002,526.4826932365547,515.4569067634457,517.0292776068117,518.8333985746222,520.3661604410444,517.3006367081999,18015,34611.433333333334,27.394150028170387,32.10748783340894,NaN,NaN,NaN,NaN,0.7239016879441283,33.24498488673356,12503810
2025-08-18T11:35:00-04:00,516.35,516.48,515.8,516.34,NaN,NaN,NaN,518.3659639580119,NaN,NaN,520.7796000000002,526.2620067121692,515.2971932878312,517.0292776068117,518.7152416471951,520.3090058859761,517.121477408414,24680,35041.166666666664,27.237297804999287,31.757828079004003,NaN,NaN,NaN,NaN,0.7207658530909808,34.356737849121366,12479130
2025-08-18T11:40:00-04:00,516.39,516.64,516.25,516.44,NaN,NaN,NaN,518.3659639580119,NaN,NaN,520.5906000000002,526.0064263042492,515.1747736957512,517.0292776068117,518.6540327788706,520.2686426062912,517.03942295145,15191,34907.36666666667,28.702741405657235,31.473610646728876,NaN,NaN,NaN,NaN,0.6971397207273383,35.03961158948831,12494321
2025-08-18T11:45:00-04:00,516.43,516.76,516.38,516.5,NaN,NaN,NaN,518.3659639580119,NaN,NaN,520.4252000000001,525.825477385292,515.0249226147083,516.4784220854494,518.5974714215856,520.2262718051684,516.9686710380029,15551,34838.26666666667,29.618653501835254,31.178225758826226,NaN,NaN,NaN,NaN,0.6744868835325281,35.407787620452744,12509872
2025-08-18T11:50:00-04:00,516.5,516.76,516.35,516.68,NaN,NaN,NaN,518.3659639580119,NaN,NaN,520.2684000000003,525.6391896772709,514.8976103227296,516.0417376683595,518.5645399419902,520.1998166109158,516.9292632730646,9696,29387.066666666666,32.42333566180261,31.11457404635058,NaN,NaN,NaN,NaN,0.6555949632802023,35.77921113689698,12519568
2025-08-18T11:55:00-04:00,516.66,517.01,516.66,516.85,NaN,NaN,NaN,518.3659639580119,NaN,NaN,520.1242000000002,525.4671341599716,514.7812658400288,515.9338901346877,518.5308490226364,520.1675694527504,516.8941285925224,11738,20027.8,35.05559644253793,31.238940961070313,NaN,NaN,NaN,NaN,0.6337667516173323,35.537141628083084,12531306
2025-08-18T12:00:00-04:00,516.98,517.16,516.89,516.89,NaN,NaN,NaN,518.3659639580119,NaN,NaN,519.9824000000002,525.2846584770988,514.6801415229016,516.0688403258235,518.4983929358061,520.1330402826461,516.8637455889661,12843,19117.733333333334,35.69034843421558,31.235334442027042,NaN,NaN,NaN,NaN,0.6106405550732333,34.9682544912687,12544149
2025-08-18T12:05:00-04:00,516.91,517.02,516.67,516.89,NaN,NaN,NaN,518.3659639580119,NaN,NaN,519.8404000000003,525.0857270019741,514.5950729980265,516.0688403258235,518.4613213613767,520.0956331551798,516.8270095675736,14207,18605.566666666666,35.69034843421558,31.26723930356712,NaN,NaN,NaN,NaN,0.592023372568004,34.721183893164174,12544149
2025-08-18T12:10:00-04:00,516.905,517.15,516.64,516.74,NaN,NaN,NaN,518.3659639580119,NaN,NaN,519.6986000000002,524.8878843589614,514.5093156410389,516.0688403258235,518.4259577892573,520.0595318156669,516.7923837628476,14030,18332.1,34.23510824708099,31.464601393123893,NaN,NaN,NaN,NaN,0.5861645602417173,34.177725175681815,12530119
2025-08-18T12:15:00-04:00,516.73,516.79,516.61,516.76,NaN,NaN,NaN,518.3659639580119,NaN,NaN,519.5662000000002,524.7106306038576,514.4217693961428,516.0688403258235,518.3988493701826,520.0333738868509,516.7643248535143,10365,18150.666666666668,34.61790315863679,31.49373417686288,NaN,NaN,NaN,NaN,0.557152805938734,33.71598360866246,12540484
2025-08-18T12:20:00-04:00,516.78,517.37,516.7,517.27,NaN,NaN,NaN,518.3659639580119,NaN,NaN,519.4536000000003,524.5474311865931,514.3597688134074,516.2632609974573,518.3646579301858,519.9905101323611,516.7388057280104,17823,17366.1,43.62855264378969,32.43308627207244,NaN,NaN,NaN,NaN,0.56521331980025,31.951378420938916,12558307
2025-08-18T12:25:00-04:00,517.29,517.29,517.01,517.19,NaN,NaN,NaN,518.3659639580119,NaN,NaN,519.3274000000002,524.3257450218872,514.3290549781133,516.2646087979658,518.3295041035179,519.9441366458323,516.7148715612036,20200,17180.7,42.63594494704785,33.30842903654159,NaN,NaN,NaN,NaN,0.544840939814516,30.312816460909904,12538107
2025-08-18T12:30:00-04:00,517.25,517.83,517.25,517.55,NaN,NaN,NaN,518.3659639580119,NaN,NaN,519.2174000000002,524.1244525733509,514.3103474266495,516.6896870383728,518.3088778240308,519.9071360386565,516.7106196094051,18599,17255.066666666666,48.33260844529156,34.60171661295286,NaN,NaN,NaN,NaN,0.5516380155420496,28.567036364260467,12556706
2025-08-18T12:35:00-04:00,517.56,517.585,516.8,516.84,NaN,NaN,NaN,518.3659639580119,NaN,NaN,519.0910000000002,523.9101173463314,514.2718826536691,516.6896870383728,518.2933634338447,519.8874816536021,516.6992452140872,9027,17251.866666666665,39.9139008106861,35.369749283283326,NaN,NaN,NaN,NaN,0.5683067287176233,26.932559489757224,12547679
2025-08-18T12:40:00-04:00,516.85,517.03,516.77,516.95,NaN,NaN,NaN,518.3659639580119,NaN,NaN,518.9768000000003,523.7222625736285,514.231337426372,516.6896870383728,518.273118532212,519.8641259284468,516.6821111359773,10715,17223.333333333332,41.610802643025146,36.38522447005867,NaN,NaN,NaN,NaN,0.5462848195235067,25.467214570407265,12558394
2025-08-18T12:45:00-04:00,516.91,516.91,515.81,516,NaN,NaN,NaN,518.239086818941,NaN,NaN,518.8408000000003,523.5296153554507,514.1519846445499,516.6896870383728,518.225588219394,519.8276191935765,516.6235572452115,17442,17141.566666666666,32.95480612987798,36.79361792183571,NaN,NaN,NaN,NaN,0.5886930467004062,25.519183433057176,12540952
2025-08-18T12:50:00-04:00,515.999,516.13,515.77,515.98,NaN,NaN,NaN,517.7927646908075,NaN,NaN,518.6928000000003,523.2648630614226,514.1207369385779,516.6896870383728,518.1826945068681,519.7992501086793,516.5661389050568,14398,17293.3,32.80011074280719,37.08628716020356,NaN,NaN,NaN,NaN,0.5723578290789496,25.616962604063303,12526554
2025-08-18T12:55:00-04:00,515.97,516.03,515.84,516,NaN,NaN,NaN,517.7199117503161,NaN,NaN,518.5496000000003,522.9999212645274,514.0992787354731,516.6896870383728,518.1558411332923,519.7808896462177,516.5307926203668,9286,16547.9,33.13811479226956,37.33767725237744,NaN,NaN,NaN,NaN,0.5450465555733061,25.707757548568992,12535840
2025-08-18T13:00:00-04:00,516,516.18,515.85,516,NaN,NaN,NaN,517.7199117503161,NaN,NaN,518.4070000000003,522.7157877642628,514.0982122357377,516.6896870383728,518.123716727151,519.7574702625628,516.4899631917391,11699,16121.266666666666,33.13811479226956,37.388732904553656,NaN,NaN,NaN,NaN,0.5296860873180648,25.436316501428248,12535840
2025-08-18T13:05:00-04:00,515.99,516.08,515.9,515.97,NaN,NaN,NaN,517.6838348799369,NaN,NaN,518.2638000000003,522.4079773897294,514.1196226102712,516.6896870383728,518.091280259141,519.7335577295431,516.4490027887388,12025,15357.666666666666,32.85066753388659,37.23123798250713,NaN,NaN,NaN,NaN,0.5047085096524933,25.18426410051184,12523815
2025-08-18T13:10:00-04:00,515.95,516.11,515.95,515.995,NaN,NaN,NaN,517.6686605672124,NaN,NaN,518.1219000000002,522.0769074030301,514.1668925969703,516.6896870383728,518.0649130642332,519.7131642454563,516.4166618830102,10223,15102.933333333332,33.36935745775209,37.06545291275974,NaN,NaN,NaN,NaN,0.4800864732487415,24.871652309066626,12534038
2025-08-18T13:15:00-04:00,516,516.25,515.99,516.22,NaN,NaN,NaN,517.6686605672124,NaN,NaN,517.9903000000003,521.7468166893912,514.2337833106094,516.6896870383728,518.0418852671612,519.6933979386436,516.3903725956789,9800,14235.833333333334,38.01036608896288,37.2311684595274,NaN,NaN,NaN,NaN,0.4643660108738307,24.20707370042907,12543838
2025-08-18T13:20:00-04:00,516.21,516.32,516.09,516.09,NaN,NaN,NaN,517.6686605672124,NaN,NaN,517.8473000000002,521.3277834201374,514.3668165798631,516.2802496306982,518.0136084297551,519.6684773934832,516.358739466027,12455,14198.366666666667,36.431445473499316,37.388049689985856,NaN,NaN,NaN,NaN,0.44762558152570125,23.401563392897515,12531383
2025-08-18T13:25:00-04:00,516.085,516.47,516.08,516.36,NaN,NaN,NaN,517.6686605672124,NaN,NaN,517.7117000000003,520.8702069950239,514.5531930049767,515.8561997045584,517.9861245906598,519.6416704645318,516.3305787167877,13490,14246.066666666668,41.83551838468714,37.90359363470373,NaN,NaN,NaN,NaN,0.4435094685595788,22.249996353919663,12544873
2025-08-18T13:30:00-04:00,516.34,517,516.29,516.29,NaN,NaN,NaN,517.6686605672124,NaN,NaN,517.6323000000002,520.7295795866648,514.5350204133356,515.9906651552161,517.9447589689039,519.59454944599,516.2949684918178,24487,14424.033333333333,40.86555525295748,37.70623667821572,NaN,NaN,NaN,NaN,0.4625445065196115,21.366295953291377,12520386
2025-08-18T13:35:00-04:00,516.3,516.38,515.86,515.93,NaN,NaN,NaN,517.6686605672124,NaN,NaN,517.5493000000002,520.601858277551,514.4967417224495,515.9906651552161,517.9209682717827,519.5738039581933,516.2681325853722,11025,14479.766666666666,36.215162295292856,37.24760934594751,NaN,NaN,NaN,NaN,0.46664847033963797,20.096822640755256,12509361
2025-08-18T13:40:00-04:00,515.89,516,515.36,515.4,NaN,NaN,NaN,517.2631278686342,NaN,NaN,517.4109000000003,520.2020085176896,514.619791482311,515.9906651552161,517.8834004228114,519.5489882993165,516.2178125463063,14312,14068.766666666666,30.679834840715912,35.98669694562067,NaN,NaN,NaN,NaN,0.4790307224582343,19.834562402119502,12495049
2025-08-18T13:45:00-04:00,515.4,515.65,515.24,515.4,NaN,NaN,NaN,517.012076601878,NaN,NaN,517.2885000000002,519.8775308993528,514.6994691006477,515.9906651552161,517.837956350958,519.5208777464012,516.1550349555149,16783,14144.766666666666,30.679834840715912,35.32712080490852,NaN,NaN,NaN,NaN,0.4740999565683581,19.789565298839392,12495049
2025-08-18T13:50:00-04:00,515.39,515.52,515.25,515.39,NaN,NaN,NaN,516.9176640290655,NaN,NaN,517.1785000000003,519.6085948536335,514.7484051463672,515.9906651552161,517.8019799473807,519.4983146751056,516.1056452196558,13496,14170.033333333333,30.57756460160161,34.53903237337827,NaN,NaN,NaN,NaN,0.4595213882420455,19.747782274365004,12481553
2025-08-18T13:55:00-04:00,515.39,515.58,515.34,515.52,NaN,NaN,NaN,516.9176640290655,NaN,NaN,517.0777000000003,519.3514644640364,514.8039355359641,515.9906651552161,517.7771217982854,519.4811898245083,516.0730537720625,9951,14118.4,33.67295164720184,34.59032848175854,NaN,NaN,NaN,NaN,0.44384128908190007,19.54788653299612,12491504
2025-08-18T14:00:00-04:00,515.5,515.56,515.29,515.55,NaN,NaN,NaN,516.8895554479708,NaN,NaN,517.0105000000002,519.2621804831059,514.7588195168945,515.9906651552161,517.7591717362675,519.4686857845564,516.0496576879785,7278,13760.5,34.399864649094795,34.70459661792194,NaN,NaN,NaN,NaN,0.43142405414747736,19.46131343712004,12498782
2025-08-18T14:05:00-04:00,515.56,515.6,515.38,515.46,NaN,NaN,NaN,516.8895554479708,NaN,NaN,516.9365000000003,519.1435018119138,514.7294981880867,515.9906651552161,517.7254348325248,519.4444268611919,516.0064428038577,14075,13407,33.22349706705661,34.7106953518353,NaN,NaN,NaN,NaN,0.4163223359940881,19.261063999329846,12484707
2025-08-18T14:10:00-04:00,515.5,515.98,515.49,515.82,NaN,NaN,NaN,516.8895554479708,NaN,NaN,516.8511000000003,518.8872348574102,514.8149651425904,515.9906651552161,517.695527387859,519.4182229025963,515.9728318731217,14718,13391.233333333334,41.797310728814104,35.32920934730277,NaN,NaN,NaN,NaN,0.4237278834230805,18.01940398393509,12499425
2025-08-18T14:15:00-04:00,515.84,516,515.75,515.89,NaN,NaN,NaN,516.8895554479708,NaN,NaN,516.7719000000003,518.636083348732,514.9077166512686,515.9906651552161,517.6712900802565,519.3950874383327,515.9474927221804,13065,13308.366666666667,43.321192575279944,36.07710399311658,NaN,NaN,NaN,NaN,0.4113187488928604,16.81454970876926,12512490
2025-08-18T14:20:00-04:00,515.87,516.2,515.78,516.08,NaN,NaN,NaN,516.8895554479708,NaN,NaN,516.7169000000004,518.4952462984954,514.9385537015053,515.3125321241729,517.6491217945872,519.3718233347029,515.9264202544716,13317,13429.066666666668,47.350606307808455,37.07576462526346,NaN,NaN,NaN,NaN,0.41193883825766126,16.04647445050888,12525807
2025-08-18T14:25:00-04:00,516.1,516.21,516.03,516.09,NaN,NaN,NaN,516.8895554479708,NaN,NaN,516.6731000000003,518.4024986116,514.9437013884007,515.3978569118348,517.6348032457688,519.3558276084651,515.9137788830725,9315,13348.3,47.56190613289801,37.75801748554454,NaN,NaN,NaN,NaN,0.39537177838211857,15.358927000857772,12535122
2025-08-18T14:30:00-04:00,516.07,516.23,516.04,516.19,NaN,NaN,NaN,516.8895554479708,NaN,NaN,516.6185000000003,518.2289909182748,515.0080090817257,515.4852855294678,517.6168080331228,519.3350287112727,515.8985873549728,12312,13330.6,49.73441322726607,38.70822946795646,NaN,NaN,NaN,NaN,0.38070236564054255,14.775107762984957,12547434
2025-08-18T14:35:00-04:00,516.205,516.35,516.15,516.17,NaN,NaN,NaN,516.8895554479708,NaN,NaN,516.5839000000003,518.1566698998291,515.0111301001715,515.6542284235742,517.5877138481213,519.2995367077641,515.8758909884785,21614,13577.5,49.29453972452394,39.24101670651623,NaN,NaN,NaN,NaN,0.3677950538090785,14.565466320915421,12525820
2025-08-18T14:40:00-04:00,516.18,516.18,515.63,515.71,NaN,NaN,NaN,516.8895554479708,NaN,NaN,516.5387000000003,518.0790984023422,514.9983015976584,515.6542284235742,517.5609456621303,519.2731146697508,515.8487766545097,16102,13646.566666666668,40.43617780326508,39.21034688868105,NaN,NaN,NaN,NaN,0.38080969282271254,14.194385160382122,12509718
2025-08-18T14:45:00-04:00,515.72,515.76,515.59,515.72,NaN,NaN,NaN,516.8895554479708,NaN,NaN,516.4911000000003,517.9818626094522,515.0003373905485,515.6542284235742,517.5453186529278,519.2588035083644,515.8318337974912,8855,13596.233333333334,40.685718126091025,39.52967230516664,NaN,NaN,NaN,NaN,0.3657518576210873,13.949940226671757,12518573
2025-08-18T14:50:00-04:00,515.71,515.78,515.65,515.71,NaN,NaN,NaN,516.8895554479708,NaN,NaN,516.4453000000003,517.8877457139241,515.0028542860765,515.6542284235742,517.5159574832425,519.2311548012124,515.8007601652725,17268,13577.733333333334,40.502979720243744,40.231325510847206,NaN,NaN,NaN,NaN,0.3489124392195807,13.657600642270436,12501305
2025-08-18T14:55:00-04:00,515.73,515.8,515.56,515.6,NaN,NaN,NaN,516.8860347246698,NaN,NaN,516.3973000000004,517.7884250257218,515.006174974279,515.6542284235742,517.4750537614399,519.1931375888545,515.7569699340253,24192,13710.8,38.45682423656978,40.7868247534082,NaN,NaN,NaN,NaN,0.3411329792753256,13.633959481620275,12477113
2025-08-18T15:00:00-04:00,515.6,516,515.52,515.88,NaN,NaN,NaN,516.8860347246698,NaN,NaN,516.3499000000004,517.6433643239222,515.0564356760785,515.6542284235742,517.4465036788587,519.1636257910059,515.7293815667115,19102,13727.566666666668,45.942903212770915,41.88434893992029,NaN,NaN,NaN,NaN,0.3510520521842322,12.929293745698706,12496215
2025-08-18T15:05:00-04:00,515.88,516.01,515.7,515.95,NaN,NaN,NaN,516.8860347246698,NaN,NaN,516.3057000000003,517.4956210215319,515.1157789784688,515.6542284235742,517.4225944026718,519.1372478236133,515.7079409817304,17446,14008.2,47.65708584850428,42.88321566858474,NaN,NaN,NaN,NaN,0.3481197627424974,12.241452440931129,12513661
2025-08-18T15:10:00-04:00,516,516,515.43,515.49,NaN,NaN,NaN,516.8860347246698,NaN,NaN,516.2667000000004,517.4329445873916,515.1004554126091,515.6542284235742,517.3801641284838,519.0959414050594,515.6643868519081,27752,14576.1,38.9223807702381,43.20625253438069,NaN,NaN,NaN,NaN,0.3639683511180368,12.405222051449357,12485909
2025-08-18T15:15:00-04:00,515.48,515.51,515.22,515.3,NaN,NaN,NaN,516.575443870332,NaN,NaN,516.2187000000004,517.3417864781159,515.0956135218848,515.6542284235742,517.3297808068268,519.0534846628169,515.6060769508366,29572,14980.433333333332,35.98835944817412,43.40374270446051,NaN,NaN,NaN,NaN,0.3586848974667459,13.098679707669083,12456337
2025-08-18T15:20:00-04:00,515.315,515.34,514.44,514.44,NaN,NaN,NaN,516.1681509671353,NaN,NaN,516.1683000000004,517.3767297404718,514.959870259529,515.6542284235742,517.1973606062288,518.9706734979801,515.4240477144775,64422,16647.9,26.317940275722364,42.29807338638254,NaN,NaN,NaN,NaN,0.39735026193340534,15.199345019932329,12391915
2025-08-18T15:25:00-04:00,514.46,514.73,514.25,514.3,NaN,NaN,NaN,515.7755077413563,NaN,NaN,516.1155000000003,517.4119385823298,514.8190614176709,515.3483827388593,517.1058109838038,518.9185458548353,515.2930761127724,43053,17773.466666666667,25.133923628099467,40.998982747298214,NaN,NaN,NaN,NaN,0.4032538146524491,17.4139118885761,12348862
2025-08-18T15:30:00-04:00,514.31,514.38,514.13,514.2,NaN,NaN,NaN,515.5161664803856,NaN,NaN,516.0613000000004,517.4440636230753,514.6785363769255,515.2455996558695,516.9815452486034,518.8483022036386,515.1147882935683,58988,19349.766666666666,24.293211166899795,39.352025951519025,NaN,NaN,NaN,NaN,0.3923071136058455,19.631247986530884,12289874
2025-08-18T15:35:00-04:00,514.2,514.415,514.04,514.095,NaN,NaN,NaN,515.4824770949134,NaN,NaN,516.0090000000005,517.4843765611536,514.5336234388474,515.2455996558695,516.7015193792661,518.6614187938582,514.741619964674,151452,23997.333333333332,23.40784561473714,37.626735914507535,NaN,NaN,NaN,NaN,0.391070891205428,21.810681952379873,12138422
2025-08-18T15:40:00-04:00,514.1,515.125,514.03,515.125,NaN,NaN,NaN,515.4824770949134,NaN,NaN,515.9841000000005,517.4761947547095,514.4920052452915,515.2455996558695,516.5999693591075,518.5562777839361,514.6436609342788,83527,26440.8,44.69914440996105,37.267073856128604,NaN,NaN,NaN,NaN,0.44135154183361364,21.501471003209826,12221949
2025-08-18T15:45:00-04:00,515.15,516.32,515.15,515.71,514.2860332668247,514.2860332668247,514.2860332668247,NaN,NaN,NaN,515.9715000000006,517.4619995795726,514.4810004204285,515.2455996558695,516.581497468302,518.5210804604371,514.6419144761669,34508,27264.4,52.7354544027038,37.5128534759986,NaN,NaN,NaN,NaN,0.4951835745597877,21.090034667404005,12256457
2025-08-18T15:50:00-04:00,515.7,516.18,515.32,516.18,514.2860332668247,NaN,NaN,NaN,NaN,NaN,515.9663000000005,517.4520318859643,514.4805681140367,515.2455996558695,516.5617810134622,518.4768209066884,514.646741120236,48121,28453.266666666666,58.014450566320505,38.76844438764541,NaN,NaN,NaN,NaN,0.5212418906626528,20.707986641298604,12304578
2025-08-18T15:55:00-04:00,516.17,517.31,516.02,517.11,515.056912542706,NaN,NaN,NaN,NaN,NaN,515.9785000000004,517.4913321114803,514.4656678885204,515.2385777223427,516.5812961994741,518.4217837472365,514.7408086517116,141258,32712.2,66.08611617244415,40.58275853381349,NaN,NaN,NaN,NaN,0.5761531841867464,21.77791730492723,12445836
2025-08-19T09:30:00-04:00,515.145,515.145,512.07,512.18,NaN,NaN,NaN,515.8297653001443,515.8297653001443,515.8297653001443,515.8885000000005,517.7245776119214,514.0524223880795,515.2385777223427,513.1316666666667,513.1316666666667,513.1316666666667,74646,34384.166666666664,31.50680491961458,39.94017461948284,NaN,NaN,NaN,NaN,0.894999385316262,22.240246280742017,12371190
2025-08-19T09:35:00-04:00,512.19,514.13,511.74,513.75,NaN,NaN,NaN,515.3821623319559,NaN,NaN,515.8265000000005,517.7363955461153,513.9166044538856,515.2385777223427,513.1623929954421,513.1992761557991,513.1255098350852,51805,35743.5,41.92785318129914,40.18810525839209,NaN,NaN,NaN,NaN,1.0017851435079566,22.8779899767947,12422995
2025-08-19T09:40:00-04:00,513.74,515.1,512.93,512.93,NaN,NaN,NaN,515.3821623319559,NaN,NaN,515.7473000000005,517.7974962923649,513.697103707636,515.2385777223427,513.2712420653971,513.4777584862513,513.0647256445429,36023,36467.2,38.6226025292816,39.66522663814285,NaN,NaN,NaN,NaN,1.0852290618288218,22.401530605224597,12386972
2025-08-19T09:45:00-04:00,513,513.31,512.4,512.69,NaN,NaN,NaN,515.3821623319559,NaN,NaN,515.6633000000005,517.8583823303787,513.4682176696223,515.2385777223427,513.2060962953534,513.4575094434844,512.9546831472225,26064,36776.566666666666,37.68619239058815,38.95301996257741,NaN,NaN,NaN,NaN,1.072712700269618,22.33553702405307,12360908
2025-08-19T09:50:00-04:00,512.71,513.6,512.43,513.6,NaN,NaN,NaN,515.3821623319559,NaN,NaN,515.6005000000005,517.8478195138099,513.353180486191,515.2385777223427,513.2065913771331,513.4415252437159,512.9716575105504,27384,37239.5,43.29958765257614,39.26567759703012,NaN,NaN,NaN,NaN,1.0796617931075077,21.964171678605567,12388292
2025-08-19T09:55:00-04:00,513.65,513.86,513.31,513.5,NaN,NaN,NaN,515.3821623319559,NaN,NaN,515.5353000000005,517.8328755998809,513.23772440012,515.2385777223427,513.2328231767575,513.4768582867221,512.988788066793,17490,37490.8,42.84285399214379,39.75528435017082,NaN,NaN,NaN,NaN,1.0418288078855478,21.340267672149963,12370802
2025-08-19T10:00:00-04:00,513.56,514.1,513.22,513.85,NaN,NaN,NaN,515.3821623319559,NaN,NaN,515.4669000000005,517.7574509287207,513.1763490712802,515.2385777223427,513.2719666816477,513.541166925101,513.0027664381943,20242,37922.933333333334,45.028450390255934,41.091749358351784,NaN,NaN,NaN,NaN,1.0302696073222941,20.50137328870911,12391044
2025-08-19T10:05:00-04:00,513.83,514.05,513.68,513.84,NaN,NaN,NaN,515.3821623319559,NaN,NaN,515.3999000000005,517.6808835504529,513.118916449548,515.2385777223427,513.3155833068832,513.6166864087437,513.0144802050228,20447,38135.333333333336,44.97553373374385,42.50900722304067,NaN,NaN,NaN,NaN,0.9831074925135591,19.722399932656888,12370597
2025-08-19T10:10:00-04:00,513.91,513.98,512.66,512.69,NaN,NaN,NaN,515.3821623319559,NaN,NaN,515.3027000000005,517.6227743171479,512.9826256828532,515.2385777223427,513.3020298725153,513.5974763521642,513.0065833928663,19346,38289.6,39.26136210160069,43.578160861233584,NaN,NaN,NaN,NaN,1.0071712430483084,19.881009806837042,12351251
2025-08-19T10:15:00-04:00,512.72,513,512.545,512.97,NaN,NaN,NaN,515.339630818031,NaN,NaN,515.2253000000005,517.5927960690691,512.8578039309319,511.3063078262052,513.2720347769823,513.5796889781591,512.9643805758055,20295,38530.6,41.21955162976923,44.850425576593025,NaN,NaN,NaN,NaN,0.9677304399734322,20.119240472241035,12371546
2025-08-19T10:20:00-04:00,512.98,513.01,512.25,512.35,NaN,NaN,NaN,515.1840794172114,NaN,NaN,515.1333000000004,517.5816877220732,512.6849122779277,511.3063078262052,513.2288668588811,513.5737953962087,512.8839383215536,19566,38738.9,38.27686272654148,44.39169117063449,NaN,NaN,NaN,NaN,0.9528925514039007,20.576952004859674,12351980
2025-08-19T10:25:00-04:00,512.41,512.47,510.97,511.23,NaN,NaN,NaN,514.3625303527928,NaN,NaN,515.0379000000005,517.7056639245648,512.3701360754362,511.3063078262052,513.0355280153257,513.660940787683,512.4101152429683,43575,39880.9,33.609097962681005,43.025522853489996,NaN,NaN,NaN,NaN,0.9919716548750507,21.882076422671247,12308405
2025-08-19T10:30:00-04:00,511.2,511.75,511.2,511.61,NaN,NaN,NaN,514.0724153367566,NaN,NaN,514.9505000000005,517.7710398414039,512.1299601585971,511.3063078262052,512.9636633564517,513.6538387192277,512.2734879936756,18761,40095.86666666667,36.44113555195274,41.484571781035164,NaN,NaN,NaN,NaN,0.960402250955405,23.09397766778199,12327166
2025-08-19T10:35:00-04:00,511.62,511.75,511.21,511.69,NaN,NaN,NaN,514.0329873669041,NaN,NaN,514.8643000000005,517.8118542466569,511.9167457533441,511.3063078262052,512.9133996172878,513.6399909307955,512.1868083037801,14586,39861.6,37.0499397908582,39.41055918235045,NaN,NaN,NaN,NaN,0.9303735187443062,24.219314538241967,12341752
2025-08-19T10:40:00-04:00,511.71,511.86,511.13,511.3,NaN,NaN,NaN,514.0314879411358,NaN,NaN,514.7703000000005,517.8631765958556,511.6774234041454,511.3063078262052,512.8366693904628,513.6167726349703,512.0565661459553,22377,40070.76666666667,35.27599494368246,39.679787041212435,NaN,NaN,NaN,NaN,0.9160611245482856,25.08890660436925,12319375
2025-08-19T10:45:00-04:00,511.39,511.5,510.39,510.52,NaN,NaN,NaN,513.5175566710841,NaN,NaN,514.6613000000006,517.9549944662115,511.3676055337897,511.3063078262052,512.706346341203,513.6105381864943,511.80215449591174,29626,40763.13333333333,31.978216160221436,38.96909868256404,NaN,NaN,NaN,NaN,0.9299139013662662,26.412295647357247,12289749
2025-08-19T10:50:00-04:00,510.49,511,510.33,510.65,NaN,NaN,NaN,513.2119859133076,NaN,NaN,514.5544000000006,518.0109379438034,511.0978620561977,511.3063078262052,512.5836055948388,513.5859178718077,511.58129331786984,29494,41170.666666666664,33.10074361386526,38.574680188605726,NaN,NaN,NaN,NaN,0.9113486226972484,27.680697766241103,12319243
2025-08-19T10:55:00-04:00,510.62,510.72,509.68,509.86,NaN,NaN,NaN,512.7730320081573,NaN,NaN,514.4272000000005,518.0910761765131,510.763323823488,511.1250462609642,512.4272024193045,513.5707797674414,511.28362507116765,32859,41459.566666666666,29.87436010990986,38.01669216855728,NaN,NaN,NaN,NaN,0.9205380067903036,29.26833681044515,12286384
2025-08-19T11:00:00-04:00,509.85,509.94,509.01,509.79,NaN,NaN,NaN,512.0578941896047,NaN,NaN,514.3012000000006,518.1560128666606,510.4463871333405,510.6208296070171,512.206322132447,513.5428915522572,510.8697527126368,44119,42293.46666666667,29.599056605623986,37.038082808060686,NaN,NaN,NaN,NaN,0.9212138634481396,31.1089629339659,12242265
2025-08-19T11:05:00-04:00,509.77,509.84,509.13,509.39,NaN,NaN,NaN,512.0473080900772,NaN,NaN,514.1618000000005,518.2080761938738,510.11552380612727,510.6208296070171,512.1050163298511,513.5154457780241,510.6945868816781,21727,42436.166666666664,28.01057639701378,35.97863440840855,NaN,NaN,NaN,NaN,0.9061271589161282,32.81811576294945,12220538
2025-08-19T11:10:00-04:00,509.4,509.4,508.6,509.25,NaN,NaN,NaN,511.55493044961906,NaN,NaN,514.0210000000005,518.247201130677,509.7947988693241,509.8086636856137,511.93412306562306,513.4716487368661,510.39659739438,35394,42690.9,27.45520769651168,34.723402787426814,NaN,NaN,NaN,NaN,0.8985466475649729,34.680990850841944,12185144
2025-08-19T11:15:00-04:00,509.27,509.73,509.17,509.72,NaN,NaN,NaN,511.55493044961906,NaN,NaN,513.8968000000006,518.2542555691275,509.5393444308736,509.7403958070342,511.88475707692095,513.4439209185143,510.3255932353276,13176,42144.36666666667,32.30757776034574,33.81854878932695,NaN,NaN,NaN,NaN,0.874364744167475,35.79282296986407,12198320
2025-08-19T11:20:00-04:00,509.72,509.73,509.21,509.39,NaN,NaN,NaN,511.55493044961906,NaN,NaN,513.7766000000006,518.290329916243,509.2628700837583,509.7403958070342,511.8239890734147,513.4099119059981,510.23806624083124,16311,40540.666666666664,30.752238370973757,33.21075423713931,NaN,NaN,NaN,NaN,0.8490529767269439,36.82523850895604,12182009
2025-08-19T11:25:00-04:00,509.34,509.78,509.34,509.58,NaN,NaN,NaN,511.55493044961906,NaN,NaN,513.6602000000006,518.2989114413989,509.0214885586023,509.7403958070342,511.7594060974127,513.3671390659438,510.1516731288816,19301,39748.933333333334,32.759374649227865,32.60645588138636,NaN,NaN,NaN,NaN,0.8198349069607335,37.68220326619631,12201310
2025-08-19T11:30:00-04:00,509.55,509.8,509.55,509.63,NaN,NaN,NaN,511.55493044961906,NaN,NaN,513.5450000000005,518.2910071636037,508.7989928363974,509.24931664562735,511.7257834593068,513.3422196415416,510.10934727707195,10980,38148.666666666664,33.30721130192384,32.251480779627954,NaN,NaN,NaN,NaN,0.7791324136063953,38.43473574333771,12212290
2025-08-19T11:35:00-04:00,509.63,509.97,509.21,509.28,NaN,NaN,NaN,511.55493044961906,NaN,NaN,513.4202000000005,518.2787442096565,508.56165579034445,508.86445331650185,511.6507928021529,513.290197333248,510.01138827105785,23757,33892.166666666664,31.379892675696652,32.09225183055764,NaN,NaN,NaN,NaN,0.7777658126345133,39.38976089542164,12188533
2025-08-19T11:40:00-04:00,509.23,510,509.23,509.9,NaN,NaN,NaN,511.55493044961906,NaN,NaN,513.3072000000004,518.2248047662831,508.38959523371767,508.4915626532015,511.6141882011709,513.2593807461677,509.9689956561741,13636,31562.466666666667,38.20170925432157,32.21800709501257,NaN,NaN,NaN,NaN,0.7772111117320468,40.205655076291,12202169
2025-08-19T11:45:00-04:00,509.93,509.99,509.59,509.85,NaN,NaN,NaN,511.55493044961906,NaN,NaN,513.1950000000005,518.1667095648272,508.2232904351738,508.48095780153784,511.58994311816434,513.23719558779,509.9426906485387,9848,30740.466666666667,37.874699401579626,32.276918495778375,NaN,NaN,NaN,NaN,0.7502674608940458,40.96327110138399,12192321
2025-08-19T11:50:00-04:00,509.79,509.93,509.67,509.8,NaN,NaN,NaN,511.55493044961906,NaN,NaN,513.0746000000005,518.0776733911531,508.0715266088478,508.5927662412303,511.56548813167404,513.2145919708452,509.9163842925029,10151,29474.8,37.528738758528846,32.4378287682674,NaN,NaN,NaN,NaN,0.7152483565444705,41.66677169611319,12182170
2025-08-19T11:55:00-04:00,509.78,509.98,509.7,509.78,NaN,NaN,NaN,511.55493044961906,NaN,NaN,512.9524000000005,517.9728825422703,507.9319174577306,508.7702129929842,511.53814073570635,513.1885715162374,509.8877099551753,11826,25160.4,37.38164960859503,32.82378830029408,NaN,NaN,NaN,NaN,0.6841591882198675,42.17533906553835,12170344
2025-08-19T12:00:00-04:00,509.8,510.26,509.8,510.17,NaN,NaN,NaN,511.55493044961906,NaN,NaN,512.8342000000005,517.832814751812,507.83558524818903,509.05217039438736,511.5112046160415,513.1581286036377,509.8642806284453,14173,23144.633333333335,42.14362536728234,33.469708425538165,NaN,NaN,NaN,NaN,0.6695763890613069,41.8512508119118,12184517
2025-08-19T12:05:00-04:00,510.17,510.25,509.85,509.99,NaN,NaN,NaN,511.55493044961906,NaN,NaN,512.7122000000004,517.6846996367279,507.7397003632728,509.0837363155099,511.48501571443296,513.1289461202331,509.84108530863284,13841,21879.166666666668,40.60866607210508,34.23644456569497,NaN,NaN,NaN,NaN,0.6503209326997833,41.55031171925856,12170676
2025-08-19T12:10:00-04:00,509.97,510,509.88,509.99,NaN,NaN,NaN,511.55493044961906,NaN,NaN,512.5882000000005,517.5166349480329,507.65976505196807,509.0837363155099,511.4689162390246,513.1115926114675,509.8262398665818,8334,20956.2,40.60866607210508,35.02284524187219,NaN,NaN,NaN,NaN,0.6124408660783704,41.270868276080556,12170676
2025-08-19T12:15:00-04:00,509.98,510.95,509.93,510.76,NaN,NaN,NaN,511.55493044961906,NaN,NaN,512.4800000000005,517.3259966980046,507.63400330199636,509.64559124192635,511.45345692982113,513.0866048199971,509.82030903964517,13488,20537,49.698101944920865,36.571954209579836,NaN,NaN,NaN,NaN,0.641552232787057,38.642039388084264,12184164
2025-08-19T12:20:00-04:00,510.85,510.95,510.32,510.51,NaN,NaN,NaN,511.55493044961906,NaN,NaN,512.3760000000005,517.1630930633142,507.5889069366869,509.64559124192635,511.43632467154936,513.0575861133448,509.81506322975395,16353,20169.3,47.17375930058981,37.98042218129971,NaN,NaN,NaN,NaN,0.6407270733022669,36.20098399208771,12167811
2025-08-19T12:25:00-04:00,510.5,510.66,510.28,510.44,NaN,NaN,NaN,511.55493044961906,NaN,NaN,512.2704000000006,516.9902427258496,507.5505572741516,509.64559124192635,511.42422895665425,513.0390315075334,509.80942640577507,10299,19929.6,46.462135631846905,38.99146202926407,NaN,NaN,NaN,NaN,0.6221037109235372,34.01366155194397,12157512
2025-08-19T12:30:00-04:00,510.46,510.59,510.11,510.16,NaN,NaN,NaN,511.55493044961906,NaN,NaN,512.1594000000005,516.8110090288303,507.50779097117066,509.64559124192635,511.40227905148635,513.0090646622579,509.79549344071484,16356,19800.066666666666,43.62714660914178,39.91109833199037,NaN,NaN,NaN,NaN,0.6119534458575675,32.32348093300493,12141156
2025-08-19T12:35:00-04:00,510.16,510.26,509.81,509.89,NaN,NaN,NaN,511.55493044961906,NaN,NaN,512.0452000000005,516.6332601387727,507.45713986122826,509.64559124192635,511.36571774031984,512.9674356523632,509.7639998282765,22473,19867.6,41.027481035988124,40.501677359616096,NaN,NaN,NaN,NaN,0.6003853425820261,31.315241935916227,12118683
2025-08-19T12:40:00-04:00,509.95,510.22,509.7,510.15,NaN,NaN,NaN,511.55493044961906,NaN,NaN,511.9306000000005,516.4148670033131,507.4463329966879,509.64559124192635,511.3463063694177,512.9444562106988,509.7481565281365,12767,19648.3,44.4596119909439,41.298277408831815,NaN,NaN,NaN,NaN,0.5946435323975985,30.57444257008564,12131450
2025-08-19T12:45:00-04:00,510.09,510.26,509.86,510.07,NaN,NaN,NaN,511.55493044961906,NaN,NaN,511.81300000000044,516.1762364131499,507.449763586851,509.64559124192635,511.32701400455545,512.9207693066938,509.73325870241706,13479,19421.1,43.61843844224233,42.17245924929936,NaN,NaN,NaN,NaN,0.5807404229406254,29.774858487948592,12117971
2025-08-19T12:50:00-04:00,510.04,510.49,510.04,510.15,NaN,NaN,NaN,511.55493044961906,NaN,NaN,511.7062000000005,515.9643482168717,507.4480517831292,509.64559124192635,511.3127350301709,512.9010052015049,509.724464858837,11785,19161.733333333334,44.74429165986752,42.63978656398121,NaN,NaN,NaN,NaN,0.5714018213020086,28.400267455885864,12129756
2025-08-19T12:55:00-04:00,510.14,510.5,510.05,510.4,NaN,NaN,NaN,511.55493044961906,NaN,NaN,511.6082000000005,515.7550869090892,507.4613130909119,509.64559124192635,511.30091528972537,512.8834137913018,509.71841678814894,10906,18072.766666666666,48.22373746240882,43.37900356832615,NaN,NaN,NaN,NaN,0.5627302626375786,27.096552764344995,12140662
2025-08-19T13:00:00-04:00,510.43,510.89,510.19,510.78,NaN,NaN,NaN,511.55493044961906,NaN,NaN,511.53500000000054,515.6079085426171,507.4620914573839,509.64559124192635,511.2903063924486,512.8626914692636,509.7179213156336,14546,17932.266666666666,53.06196310396211,44.48851959299996,NaN,NaN,NaN,NaN,0.5725352438777508,25.434220368867987,12155208
2025-08-19T13:05:00-04:00,510.78,510.92,510.25,510.26,NaN,NaN,NaN,511.55493044961906,NaN,NaN,511.4542000000006,515.4642999284946,507.44410007150657,509.60269254170805,511.28080942999685,512.8464318193793,509.7151870406144,11026,17813.6,46.63934246671657,45.14978336858007,NaN,NaN,NaN,NaN,0.5794970121721983,23.962063553571472,12144182
2025-08-19T13:10:00-04:00,510.25,510.69,509.81,510.67,NaN,NaN,NaN,511.55493044961906,NaN,NaN,511.3836000000005,515.3214938732348,507.4457061267663,509.60269254170805,511.25869026173814,512.8109545809122,509.7064259425641,24053,17869.466666666667,51.61244934206233,45.82612793820721,NaN,NaN,NaN,NaN,0.6009615113027552,22.962221835164883,12168235
2025-08-19T13:15:00-04:00,510.64,510.95,510.42,510.95,NaN,NaN,NaN,511.55493044961906,NaN,NaN,511.3207000000005,515.1830940809848,507.45830591901625,509.60269254170805,511.2554522163215,512.8030343830445,509.70787004959845,6506,17098.8,54.71634391456446,46.83381921266859,NaN,NaN,NaN,NaN,0.595892831923985,21.38673068917742,12174741
2025-08-19T13:20:00-04:00,510.93,511,510.56,510.65,NaN,NaN,NaN,511.55493044961906,NaN,NaN,511.2312000000005,514.9412159348587,507.52118406514234,509.60269254170805,511.24920056590474,512.7884710277301,509.7099301040794,11895,16512.166666666668,50.945592952006905,47.57217113266158,NaN,NaN,NaN,NaN,0.5847576296437003,19.915344964708755,12162846
2025-08-19T13:25:00-04:00,510.7,511.32,510.68,511.3,NaN,NaN,NaN,511.55493044961906,NaN,NaN,511.1430000000005,514.6256294659407,507.66037053406023,509.8550790920669,511.24801728773264,512.781228903163,509.7148056723023,7891,15679.9,57.74088279498978,48.14665547909507,NaN,NaN,NaN,NaN,0.590846370383437,19.283484317606177,12170737
2025-08-19T13:30:00-04:00,511.27,511.45,511.06,511.18,NaN,NaN,NaN,511.55493044961906,NaN,NaN,511.04300000000046,514.2146096854923,507.87139031450863,510.0830632736535,511.2478688391417,512.7747520169571,509.72098566132627,8266,14484.8,56.19325431894586,48.790905123263364,NaN,NaN,NaN,NaN,0.5765002010703333,18.972276456195793,12162471
2025-08-19T13:35:00-04:00,511.16,511.64,511.02,511.29,509.49149237537455,509.49149237537455,509.49149237537455,NaN,NaN,NaN,510.92660000000046,513.5846281708955,508.2685718291055,510.2364506189228,511.2487037691658,512.7663122375649,509.7310953007667,12325,14171.4,57.322474536588764,49.5666436164592,NaN,NaN,NaN,NaN,0.5796073295653097,19.071635290096786,12174796
2025-08-19T13:40:00-04:00,511.31,511.74,511.26,511.65,509.6796063583121,NaN,NaN,NaN,NaN,NaN,510.9160000000005,513.5581294436297,508.2738705563713,510.37716049513824,511.25213418250974,512.7614170845417,509.7428512804778,11696,13381.466666666667,60.876869996151406,50.79876671553132,NaN,NaN,NaN,NaN,0.572492520310646,19.362738519006257,12186492
2025-08-19T13:45:00-04:00,511.67,511.76,511.5,511.5,509.8568969783888,NaN,NaN,NaN,NaN,NaN,510.8710000000005,513.3924099224366,508.3495900775643,510.5397283961106,511.2547410684564,512.7584195846099,509.75106255230287,8068,13211.2,58.683772292093906,52.059930376681734,NaN,NaN,NaN,NaN,0.550171626002742,19.67407012618858,12178424
2025-08-19T13:50:00-04:00,511.52,511.92,511.5,511.85,509.96021984300756,NaN,NaN,NaN,NaN,NaN,510.84940000000046,513.3178324088778,508.38096759112307,510.73378271688847,511.2586860957256,512.7570993455844,509.7602728458668,8202,12940.9,62.113441910833636,53.32091822810243,NaN,NaN,NaN,NaN,0.5408736527168331,20.292721443796914,12186626
2025-08-19T13:55:00-04:00,511.835,511.9,511.25,511.25,509.96021984300756,NaN,NaN,NaN,NaN,NaN,510.82060000000047,513.2354818929772,508.40571810702374,510.73378271688847,511.26049112452466,512.7525126846072,509.76846956444217,9136,12602.066666666668,53.85949303424939,54.05242212753151,NaN,NaN,NaN,NaN,0.5486683918084863,20.02037666049774,12177490
2025-08-19T14:00:00-04:00,511.23,511.24,510.14,510.53,509.96021984300756,NaN,NaN,NaN,NaN,NaN,510.7592000000005,513.0407182307248,508.4776817692761,510.73378271688847,511.2551871333133,512.7419559716826,509.768418294944,9027,12536.966666666667,45.965851224627436,54.139676382157226,NaN,NaN,NaN,NaN,0.5887635066793097,19.96227511279521,12168463
2025-08-19T14:05:00-04:00,510.56,510.76,510.21,510.65,509.96021984300756,NaN,NaN,NaN,NaN,NaN,510.7022000000005,512.8451709837035,508.55922901629754,510.73378271688847,511.2494073870958,512.7315402711099,509.7672745030817,8650,12033.4,47.35082067314458,54.07732518292407,NaN,NaN,NaN,NaN,0.5859946847736455,19.908323675642865,12177113
2025-08-19T14:10:00-04:00,510.63,510.94,510.53,510.72,509.96021984300756,NaN,NaN,NaN,NaN,NaN,510.6396000000006,512.5848463485818,508.69435365141936,510.73378271688847,511.2447973818868,512.7211422311735,509.7684525326001,9585,11898.366666666667,48.18513126788291,53.72898005177556,NaN,NaN,NaN,NaN,0.573423635861244,19.394330710666598,12186698
2025-08-19T14:15:00-04:00,510.7,510.7,510.31,510.4,509.96021984300756,NaN,NaN,NaN,NaN,NaN,510.5708000000006,512.2884255227992,508.85317447720195,510.73378271688847,511.2370012191602,512.7079336711114,509.76606876720905,10977,11936,44.698055344739885,53.59031668592008,NaN,NaN,NaN,NaN,0.5617505190140141,19.334236069669867,12175721
2025-08-19T14:20:00-04:00,510.46,510.73,510.38,510.7,509.96021984300756,NaN,NaN,NaN,NaN,NaN,510.5310000000006,512.1390907924513,508.9229092075498,510.73378271688847,511.234034208083,512.7021564079314,509.76591200823464,5132,11768.7,48.46352398806149,53.36539344634859,NaN,NaN,NaN,NaN,0.5466254819415861,19.196034333548802,12180853
2025-08-19T14:25:00-04:00,510.69,510.75,510.51,510.68,509.96021984300756,NaN,NaN,NaN,NaN,NaN,510.48520000000053,511.93552542444615,509.0348745755549,510.73378271688847,511.22954422252207,512.6929387749674,509.76614967007674,8443,11655.933333333332,48.227764495558844,52.901923487848194,NaN,NaN,NaN,NaN,0.524723661802902,19.009527561654238,12172410
2025-08-19T14:30:00-04:00,510.68,510.86,510.1,510.12,509.96021984300756,NaN,NaN,NaN,NaN,NaN,510.4406000000006,511.7926201760609,509.0885798239403,510.73378271688847,511.22090006842484,512.679555766599,509.76224437025064,11090,11553.166666666666,42.05828565944293,52.267115824093615,NaN,NaN,NaN,NaN,0.5415291145312654,19.62770489978848,12161320
2025-08-19T14:35:00-04:00,510.11,510.17,509.79,509.8,NaN,NaN,NaN,511.67112231857385,511.67112231857385,511.67112231857385,510.4120000000006,511.75649395557923,509.067506044422,510.73378271688847,511.2097905137122,512.6671289448763,509.7524520825482,9609,11412.1,38.988981864505845,50.92769432905906,NaN,NaN,NaN,NaN,0.5299913206361747,20.705981153435513,12151711
2025-08-19T14:40:00-04:00,509.81,510.12,509.46,509.46,NaN,NaN,NaN,511.494253122275,NaN,NaN,510.3690000000006,511.69487932955985,509.04312067044134,510.62602617351075,511.1954827192646,512.6534452542376,509.7375201842916,10623,11488.4,35.98419467088121,49.48419006848301,NaN,NaN,NaN,NaN,0.5392776548764497,22.17640732013095,12141088
2025-08-19T14:45:00-04:00,509.5,509.74,509.34,509.64,NaN,NaN,NaN,511.22133252580795,NaN,NaN,510.3280000000006,511.6141352948484,509.0418647051528,509.6658209388086,511.18074473242336,512.6402077132959,509.7212817515508,10414,11385.933333333332,38.67859541987575,48.152484417289216,NaN,NaN,NaN,NaN,0.5293292509567058,23.700781513615624,12151502
2025-08-19T14:50:00-04:00,509.62,509.83,509.56,509.7,NaN,NaN,NaN,511.22133252580795,NaN,NaN,510.29600000000056,511.56328686448353,509.0287131355176,509.62537300522877,511.1714039976789,512.6309933151485,509.7118146802093,7260,11082.833333333334,39.59131587046233,46.632087694025714,NaN,NaN,NaN,NaN,0.5108057330312256,24.81169769049049,12158762
2025-08-19T14:55:00-04:00,509.68,509.81,509.56,509.69,NaN,NaN,NaN,511.22133252580795,NaN,NaN,510.2794000000006,511.5562236200987,509.00257637990245,509.62537300522877,511.15856951262697,512.6183216520166,509.6988173732374,10058,11074.8,39.4858285220626,45.26080599616633,NaN,NaN,NaN,NaN,0.4921767521004238,25.843262711874292,12148704
2025-08-19T15:00:00-04:00,509.69,509.73,509.14,509.15,NaN,NaN,NaN,511.0438665027712,NaN,NaN,510.2494000000006,511.5600237281398,508.9387762718614,509.62537300522877,511.1288678950986,512.5948850297991,509.6628507603981,19319,11173.566666666668,34.18847864341288,43.26616576277913,NaN,NaN,NaN,NaN,0.4991641269503958,27.402216044180506,12129385
2025-08-19T15:05:00-04:00,509.15,509.25,508.84,508.95,NaN,NaN,NaN,510.6366452980997,NaN,NaN,510.2312000000006,511.58742794423665,508.8749720557646,509.62537300522877,511.0920097308301,512.5713263372664,509.6126931243938,20974,11123.6,32.451960744364214,41.737056313501625,NaN,NaN,NaN,NaN,0.492795260739655,29.209772046108444,12108411
2025-08-19T15:10:00-04:00,508.94,509.24,508.92,509,NaN,NaN,NaN,510.6366452980997,NaN,NaN,510.2154000000006,511.6096924214951,508.82110757850614,509.62537300522877,511.072155847172,512.5578029530607,509.5865087412833,11839,11092.666666666666,33.36321219897289,40.83686781166916,NaN,NaN,NaN,NaN,0.4804527421153934,30.888216905041528,12120250
2025-08-19T15:15:00-04:00,508.99,509.25,508.69,509.02,NaN,NaN,NaN,510.53825532326863,NaN,NaN,510.20800000000054,511.6235027364612,508.7924972635399,509.58029840418305,511.0298444091998,512.5294501616831,509.5302386567165,25175,11482.533333333333,33.748218399355096,39.865253363541335,NaN,NaN,NaN,NaN,0.4861346891071512,32.71319615106451,12145425
2025-08-19T15:20:00-04:00,509.01,509.01,508.65,508.73,NaN,NaN,NaN,510.3774255358473,NaN,NaN,510.1976000000006,511.6483077434417,508.7468922565595,508.9562387233464,511.006509160889,512.5154445350981,509.4975737866798,13103,11526.466666666667,30.955399535923448,38.63455823982995,NaN,NaN,NaN,NaN,0.47783935417092643,34.45311383141201,12132322
2025-08-19T15:25:00-04:00,508.715,509.03,508.67,509,NaN,NaN,NaN,510.37617892058154,NaN,NaN,510.18320000000057,511.66651218459987,508.69988781540127,508.8189909786771,510.97637413764966,512.4952175031666,509.4575307721327,18199,11769.566666666668,36.24537956348747,38.0307956840262,NaN,NaN,NaN,NaN,0.4694222574444286,35.98149557488693,12150521
2025-08-19T15:30:00-04:00,508.99,509.21,508.95,509.2,NaN,NaN,NaN,510.37617892058154,NaN,NaN,510.17940000000056,511.6717667635817,508.68703323641944,508.7828833810827,510.9525566474508,512.4760179929525,509.42909530194913,16534,11835.833333333334,39.91755024042049,37.42036898776613,NaN,NaN,NaN,NaN,0.45446352476982593,36.62039118493623,12167055
2025-08-19T15:35:00-04:00,509.18,509.21,508.56,508.84,NaN,NaN,NaN,510.37617892058154,NaN,NaN,510.1646000000006,511.69465207654173,508.6345479234594,508.7828833810827,510.91402324049886,512.4491953984866,509.3788510825111,24294,12278.1,35.90829947451191,36.54040720054849,NaN,NaN,NaN,NaN,0.46843041585769385,37.76661706619833,12142761
2025-08-19T15:40:00-04:00,508.84,509.15,508.76,509.09,NaN,NaN,NaN,510.37617892058154,NaN,NaN,510.15380000000056,511.70625297415484,508.6013470258463,508.7828833810827,510.8771964873911,512.420096193485,509.3342967812971,25758,12334.933333333332,40.38614146144269,36.420968329262756,NaN,NaN,NaN,NaN,0.4628282432964291,38.83096967022742,12168519
2025-08-19T15:45:00-04:00,509.06,509.12,508.56,508.73,NaN,NaN,NaN,510.34577062125885,NaN,NaN,510.1428000000006,511.72732536645213,508.55827463354905,508.61330670486615,510.84097898841435,512.3942866539545,509.2876713228742,23795,12911.233333333334,36.43819708255547,36.2387694162663,NaN,NaN,NaN,NaN,0.46976908306097004,40.080138107467185,12144724
2025-08-19T15:50:00-04:00,508.77,509.56,508.74,509.32,NaN,NaN,NaN,510.34577062125885,NaN,NaN,510.1312000000006,511.73108319473414,508.53131680526707,508.24879515284044,510.7699387916664,512.3252336003154,509.21464398301737,61918,14578.666666666666,45.79104537361886,36.93925875217614,NaN,NaN,NaN,NaN,0.4954998628423282,39.51452306844279,12206642
2025-08-19T15:55:00-04:00,509.33,510.12,509.2,509.91,NaN,NaN,NaN,510.34577062125885,NaN,NaN,510.1324000000006,511.73152756117815,508.533272438823,508.60087239568276,510.6806730147356,512.1947012719636,509.1666447575076,135655,18837.466666666667,53.20620690789495,37.976945287034646,NaN,NaN,NaN,NaN,0.5258213012107344,37.339232800420675,12342297
2025-08-20T09:30:00-04:00,509.99,510.91,506.38,508.31,508.08574687772494,508.08574687772494,508.08574687772494,NaN,NaN,NaN,510.1026000000006,511.7790572636323,508.42614273636894,508.60087239568276,508.5333333333333,508.53333872812993,508.5333279385367,86304,21438.733333333334,38.01837483798937,37.86459235614372,NaN,NaN,NaN,NaN,0.8118340654099698,38.480330271188286,12255993
2025-08-20T09:35:00-04:00,508.4,509.57,507.65,509.54,NaN,NaN,NaN,510.9243160738382,510.9243160738382,510.9243160738382,510.0978000000006,511.77929119443206,508.4163088055691,508.60087239568276,508.6119146579023,508.7675094979532,508.45631981785135,22013,21761.666666666668,49.86609600740989,38.60604003366853,NaN,NaN,NaN,NaN,0.8909887750235445,39.539920779758205,12278006
2025-08-20T09:40:00-04:00,509.65,511,509.64,510,507.91178920224536,507.91178920224536,507.91178920224536,NaN,NaN,NaN,510.09440000000063,511.7759809694195,508.4128190305818,508.60087239568276,508.9801758327172,509.6677560281637,508.29259563727067,32347,22450.033333333333,53.44978996097141,39.9818479849227,NaN,NaN,NaN,NaN,0.9316324339504326,38.08709795063077,12310353
2025-08-20T09:45:00-04:00,510.05,510.91,509.86,510.27,507.9430715112342,NaN,NaN,NaN,NaN,NaN,510.10000000000065,511.78201783478676,508.41798216521454,508.60087239568276,509.27216157595814,510.1001036172139,508.44421953470237,38224,23455.233333333334,55.46221015406506,41.62543722847277,NaN,NaN,NaN,NaN,0.9400872600968311,36.73804818072672,12348577
2025-08-20T09:50:00-04:00,510.12,510.29,507.62,507.68,NaN,NaN,NaN,511.6500226483674,511.6500226483674,511.6500226483674,510.05380000000065,511.8671367686534,508.2404632313479,508.60087239568276,509.12644729571275,509.9250784906367,508.3278161007888,43703,24638.6,38.33972772452916,41.98090262315536,NaN,NaN,NaN,NaN,1.0636524558042013,37.14676071805514,12304874
2025-08-20T09:55:00-04:00,507.73,507.9,506.27,506.67,NaN,NaN,NaN,509.8797943461688,NaN,NaN,509.9720000000006,512.0060934090492,507.93790659095197,508.60087239568276,508.79909655144326,509.8707411108872,507.7274519919993,39335,25645.233333333334,33.939444955739745,41.99456166289711,NaN,NaN,NaN,NaN,1.1041058518181865,38.17329442790435,12265539
2025-08-20T10:00:00-04:00,506.52,508.26,506.48,507.24,NaN,NaN,NaN,509.8797943461688,NaN,NaN,509.9066000000007,512.0732512770475,507.73994872295395,508.60087239568276,508.6415115449216,509.7517878325127,507.53123525733054,31392,26390.733333333334,38.246971736584435,42.51538824865861,NaN,NaN,NaN,NaN,1.1523840052597427,38.65838155886795,12296931
2025-08-20T10:05:00-04:00,507.34,507.89,506.68,507.79,NaN,NaN,NaN,509.8797943461688,NaN,NaN,509.85360000000065,512.0938634123039,507.61333658769746,508.60087239568276,508.5658015938883,509.678631610336,507.45297157744056,19962,26767.8,42.165688332438506,42.938267446440825,NaN,NaN,NaN,NaN,1.1564994334554741,39.10881960904843,12316893
2025-08-20T10:10:00-04:00,507.82,508.03,506.15,507.17,NaN,NaN,NaN,509.8797943461688,NaN,NaN,509.7938000000006,512.1545418826988,507.43305811730244,508.60087239568276,508.44763015191273,509.58547305512593,507.30978724869954,27815,27375.466666666667,39.149712500001655,42.883421893553766,NaN,NaN,NaN,NaN,1.2081780453515114,39.79743933273942,12289078
2025-08-20T10:15:00-04:00,507.12,508.1,506.98,507.89,NaN,NaN,NaN,509.8797943461688,NaN,NaN,509.75380000000064,512.1737004600491,507.33389953995226,507.4296979165462,508.4057856122113,509.52718647122776,507.2843847531948,19053,27644.666666666668,44.146010695652336,43.47182983792094,NaN,NaN,NaN,NaN,1.2018796135406897,40.333945328103646,12308131
2025-08-20T10:20:00-04:00,507.82,508.24,507.19,507.19,NaN,NaN,NaN,509.8797943461688,NaN,NaN,509.69460000000066,512.2155496933416,507.17365030665974,507.4046853332717,508.31510734204863,509.40877846657344,507.22143621752383,42133,28878.033333333333,40.6513062798031,43.49077018208954,NaN,NaN,NaN,NaN,1.1910310697163555,40.61707599433127,12265998
2025-08-20T10:25:00-04:00,507.14,507.74,507.04,507.43,NaN,NaN,NaN,509.8797943461688,NaN,NaN,509.64180000000067,512.2385354575265,507.0450645424748,507.4046853332717,508.26051408967476,509.3427776014174,507.1782505779321,25621,29450.633333333335,42.33675652590013,43.91209585661416,NaN,NaN,NaN,NaN,1.1559574218794724,40.97165068690534,12291619
2025-08-20T10:30:00-04:00,507.42,507.9,507.13,507.38,NaN,NaN,NaN,509.8797943461688,NaN,NaN,509.58640000000065,512.2546121647895,506.9181878352119,507.4046853332717,508.2289927143893,509.300680167266,507.15730526151253,17771,29673.333333333332,42.06871169848955,43.64621487981922,NaN,NaN,NaN,NaN,1.128389034602366,41.03278583584226,12273848
2025-08-20T10:35:00-04:00,507.39,508.16,506.9,507.79,NaN,NaN,NaN,509.8797943461688,NaN,NaN,509.53420000000074,512.2385789372058,506.8298210627956,506.1507482666173,508.20690351362884,509.2652607689666,507.1485462582911,16679,29909,45.13614215929005,43.0697816834903,NaN,NaN,NaN,NaN,1.1377898178450576,40.65218869575899,12290527
2025-08-20T10:40:00-04:00,507.76,507.76,507.34,507.59,NaN,NaN,NaN,509.8797943461688,NaN,NaN,509.4704000000007,512.2045571563991,506.7362428436023,505.1542658783253,508.17971536446356,509.2235343031185,507.1358964258086,20394,30234.7,43.91461961429548,43.49094202465501,NaN,NaN,NaN,NaN,1.088661973713271,40.298777065681655,12270133
2025-08-20T10:45:00-04:00,507.69,508.11,507.23,507.3,NaN,NaN,NaN,509.8797943461688,NaN,NaN,509.4112000000007,512.2020010025922,506.62039899740927,505.56633016212817,508.1519960041095,509.1808928626115,507.1230991456075,22106,30624.433333333334,42.134034326691086,42.938651904603674,NaN,NaN,NaN,NaN,1.0737575470194656,39.35852122386921,12248027
2025-08-20T10:50:00-04:00,507.33,507.5,506.75,507,NaN,NaN,NaN,509.8797943461688,NaN,NaN,509.3378000000007,512.1847922086399,506.4908077913615,505.56633016212817,508.11081742955906,509.1404518970681,507.08118296205004,20233,31056.866666666665,40.31304580802147,42.00031303653582,NaN,NaN,NaN,NaN,1.0506320079466467,38.92941440701939,12227794
2025-08-20T10:55:00-04:00,507.05,507.26,506.75,506.81,NaN,NaN,NaN,509.85860900739266,NaN,NaN,509.2550000000007,512.1500281511813,506.35997184882,505.56633016212817,508.08628436595114,509.11878371339697,507.0537850185053,11238,31096.2,39.15874252819247,40.835779634687775,NaN,NaN,NaN,NaN,1.012015435950457,38.530958077087405,12216556
2025-08-20T11:00:00-04:00,506.75,506.9,506.03,506.35,NaN,NaN,NaN,509.30753587069296,NaN,NaN,509.16900000000066,512.1474297870171,506.1905702129842,505.56633016212817,508.02442634035026,509.0851594255926,506.9636932551079,20764,31144.366666666665,36.43840618057579,40.69997095297682,NaN,NaN,NaN,NaN,1.0018714762397103,38.77615846978258,12195792
2025-08-20T11:05:00-04:00,506.39,506.48,505.5,506.25,NaN,NaN,NaN,508.8369660583888,NaN,NaN,509.06800000000067,512.0926639476243,506.043336052377,505.56633016212817,507.8597285214108,509.01024176975307,506.7092152730685,51457,32160.466666666667,35.85526507434908,40.8368152471632,NaN,NaN,NaN,NaN,1.000309227936875,39.38904915820837,12144335
2025-08-20T11:10:00-04:00,506.28,506.37,505.64,506.195,NaN,NaN,NaN,508.82210396482566,NaN,NaN,508.9683000000007,512.0362502010437,505.9003497989577,505.56633016212817,507.7794536773544,508.96339823992577,506.59550911478306,28549,32717.466666666667,35.51858507825979,40.641930485854296,NaN,NaN,NaN,NaN,0.9810014259413853,39.958161940318035,12115786
2025-08-20T11:15:00-04:00,506.16,506.23,505.73,506.13,NaN,NaN,NaN,508.73723560278813,NaN,NaN,508.86510000000067,511.96073724556095,505.7694627544404,505.56633016212817,507.7190901139282,508.9254560550645,506.5127241727919,22768,32637.233333333334,35.09911986243313,40.13717559513963,NaN,NaN,NaN,NaN,0.9466441812312864,40.48662380941987,12093018
2025-08-20T11:20:00-04:00,506.15,506.28,506.04,506.16,NaN,NaN,NaN,508.73723560278813,NaN,NaN,508.75530000000066,511.83745795117676,505.67314204882456,505.56633016212817,507.6682778715256,508.8866897598082,506.44986598324306,22230,32941.46666666667,35.47786026698084,39.874900435638146,NaN,NaN,NaN,NaN,0.8961695968576197,40.86334468587888,12115248
2025-08-20T11:25:00-04:00,506.24,506.25,505.5,505.85,NaN,NaN,NaN,508.52078698518505,NaN,NaN,508.64230000000066,511.7279462590571,505.5566537409442,505.56633016212817,507.5903461139244,508.837198605028,506.3434936228208,30839,33362.8,33.31440352166966,39.1012142089251,NaN,NaN,NaN,NaN,0.8857289113677896,41.64657695644463,12084409
2025-08-20T11:30:00-04:00,505.84,507,505.82,506.7,NaN,NaN,NaN,508.52078698518505,NaN,NaN,508.5393000000007,511.53219693039085,505.54640306961056,505.56633016212817,507.55285003787066,508.79384851570506,506.31185156003625,25552,33663.4,43.48996314859482,39.303975413838785,NaN,NaN,NaN,NaN,0.9067482748415194,40.819306030273445,12109961
2025-08-20T11:35:00-04:00,506.67,506.8,506.05,506.1,NaN,NaN,NaN,508.52078698518505,NaN,NaN,508.4363000000007,511.4033152065306,505.4692847934708,505.09006412970257,507.51838423096956,508.7587699655801,506.27799849635903,21180,33559.6,38.969638297851134,39.06346696897815,NaN,NaN,NaN,NaN,0.8955519694956966,40.051125884543055,12088781
2025-08-20T11:40:00-04:00,506.08,506.53,505.11,505.15,NaN,NaN,NaN,508.52078698518505,NaN,NaN,508.32870000000077,511.37339427623283,505.2840057237687,505.077051303762,507.44750223453434,508.717541001405,506.1774634676637,29093,33670.76666666667,33.10282000481497,38.42304613371568,NaN,NaN,NaN,NaN,0.9330125431031439,40.19918304997807,12059688
2025-08-20T11:45:00-04:00,505.15,505.93,504.86,505.67,NaN,NaN,NaN,508.15543071966465,NaN,NaN,508.22910000000076,511.28931286117745,505.16888713882406,505.0233026375787,507.3535334543617,508.6616336876931,506.0454332210303,39702,34201,38.55565785245229,37.95301154037013,NaN,NaN,NaN,NaN,0.9427973614529188,40.53122421196089,12099390
2025-08-20T11:50:00-04:00,505.675,505.68,504.44,504.49,NaN,NaN,NaN,507.86404750513447,NaN,NaN,508.10450000000077,511.2548817222049,504.9541182777966,505.0233026375787,507.2344133498815,508.6166951563601,505.8521315434029,41738,33528.333333333336,32.15128688517575,37.112773488290145,NaN,NaN,NaN,NaN,0.9640261213491395,41.14866414182728,12057652
2025-08-20T11:55:00-04:00,504.48,505.09,504.465,504.82,NaN,NaN,NaN,507.5393180730829,NaN,NaN,507.99290000000076,511.20484276964754,504.780957230354,505.0233026375787,507.17661461816147,508.5920085951192,505.76122064120375,21089,29709.466666666667,35.383843218549,36.63061698056571,NaN,NaN,NaN,NaN,0.939809969824201,41.722001219560354,12078741
2025-08-20T12:00:00-04:00,504.82,505.66,504.76,505.3,NaN,NaN,NaN,507.5393180730829,NaN,NaN,507.88490000000075,511.0886143998387,504.6811856001628,505.0233026375787,507.13784574375495,508.5650152531677,505.7106762343422,18207,27439.566666666666,39.8712808034577,36.599062337382584,NaN,NaN,NaN,NaN,0.9369664005510462,41.08306511267131,12096948
2025-08-20T12:05:00-04:00,505.25,505.65,504.99,505.48,NaN,NaN,NaN,507.5393180730829,NaN,NaN,507.78090000000077,510.9523663415543,504.60943365844724,505.0233026375787,507.10822543464883,508.541407041964,505.67504382733364,15528,27223.4,41.5116537217424,36.76712742263616,NaN,NaN,NaN,NaN,0.9171830862259692,40.48976729913148,12112476
2025-08-20T12:10:00-04:00,505.43,505.85,505.28,505.51,NaN,NaN,NaN,507.5393180730829,NaN,NaN,507.6887000000008,510.85082637879066,504.5265736212109,505.0233026375787,507.08792950277433,508.5227097854691,505.65314922007957,12181,26551.2,41.79665187029047,37.14985925761577,NaN,NaN,NaN,NaN,0.8923842943526893,39.5327598910435,12124657
2025-08-20T12:15:00-04:00,505.49,505.75,505.21,505.67,NaN,NaN,NaN,507.5393180730829,NaN,NaN,507.6061000000007,510.75906006249284,504.4531399375086,505.0233026375787,507.06518614965296,508.5014642537557,505.6289080455502,14006,25743.933333333334,43.38124022468461,37.687428911211164,NaN,NaN,NaN,NaN,0.867213987613213,38.72682327890023,12138663
2025-08-20T12:20:00-04:00,505.69,506.09,505.63,506,NaN,NaN,NaN,507.5393180730829,NaN,NaN,507.53690000000074,510.67591442424913,504.39788557575235,504.843642110063,507.04773080944113,508.4801172618328,505.6153443570495,14551,24772.2,46.6097989384025,38.47965847264993,NaN,NaN,NaN,NaN,0.8381272742122677,37.27577149693439,12153214
2025-08-20T12:25:00-04:00,506,506.29,505.89,506.085,NaN,NaN,NaN,507.5393180730829,NaN,NaN,507.46580000000074,510.57192128475236,504.3596787152491,504.6975975546062,507.03619558367706,508.46377954230564,505.60861162504847,11753,23852.8,47.4411488778054,39.361231973747955,NaN,NaN,NaN,NaN,0.8068324689113939,35.5364187583643,12164967
2025-08-20T12:30:00-04:00,506.08,506.41,505.35,505.35,NaN,NaN,NaN,507.5393180730829,NaN,NaN,507.37880000000075,510.473393710921,504.2842062890805,504.6975975546062,507.0113771283506,508.4370388147483,505.5857154419529,18547,23424.633333333335,41.4332283001918,39.786615404691595,NaN,NaN,NaN,NaN,0.8249158639891517,34.659850285914395,12146420
2025-08-20T12:35:00-04:00,505.4,505.8,504.79,505.74,NaN,NaN,NaN,507.5393180730829,NaN,NaN,507.29980000000074,510.35578884744604,504.24381115255545,504.6975975546062,506.98643179744175,508.4142518151838,505.55861177969973,16102,23295.966666666667,45.38543300773031,40.64883179655307,NaN,NaN,NaN,NaN,0.8381361594184974,34.48765892792867,12162522
2025-08-20T12:40:00-04:00,505.78,505.92,505.31,505.36,NaN,NaN,NaN,507.5393180730829,NaN,NaN,507.22400000000084,510.28067335436447,504.1673266456372,504.6975975546062,506.96880072818124,508.3968617040998,505.54073975226265,12403,22782.233333333334,42.38422520431031,40.56985051481847,NaN,NaN,NaN,NaN,0.8218407194600343,34.07924114868944,12150119
2025-08-20T12:45:00-04:00,505.36,505.5,505.09,505.21,NaN,NaN,NaN,507.5393180730829,NaN,NaN,507.1492000000008,510.21629005987234,504.08210994012927,504.6975975546062,506.9533816780925,508.3840779583813,505.52268539780374,9366,22459.333333333332,41.22535101134373,40.73097285149651,NaN,NaN,NaN,NaN,0.7924235252128907,33.9512288235392,12140753
2025-08-20T12:50:00-04:00,505.21,506.055,505.15,506.05,NaN,NaN,NaN,507.5393180730829,NaN,NaN,507.0902000000008,510.12594370384056,504.054456296161,504.6975975546062,506.9370511248792,508.36478844460856,505.5093138051498,14244,21529.7,49.54506513043253,41.90541893189776,NaN,NaN,NaN,NaN,0.8004647019834007,32.714690457470844,12154997
2025-08-20T12:55:00-04:00,505.96,505.96,504.96,505.12,NaN,NaN,NaN,507.5393180730829,NaN,NaN,507.01220000000075,510.0460109096652,503.9783890903363,504.6975975546062,506.9132630932155,508.3433716239185,505.48315456251254,15916,21206.2,42.39061272184447,42.179344279711486,NaN,NaN,NaN,NaN,0.8211457946988744,31.815283602328115,12139081
2025-08-20T13:00:00-04:00,505.08,505.755,505.05,505.755,NaN,NaN,NaN,507.5393180730829,NaN,NaN,506.9527000000008,509.96604114152416,503.9393588584774,504.6975975546062,506.89487947719726,508.3243898250752,505.46536912931936,14228,21088.1,47.92052282490644,43.30571827540654,NaN,NaN,NaN,NaN,0.8128496665060965,30.980120093981288,12153309
2025-08-20T13:05:00-04:00,505.71,505.82,505.09,505.795,NaN,NaN,NaN,507.5393180730829,NaN,NaN,506.8886000000008,509.8610898915236,503.916110108478,504.6975975546062,506.880745363536,508.30912783596153,505.45236289111045,11613,20919.233333333334,48.25745582084074,44.22526203271309,NaN,NaN,NaN,NaN,0.8069318331842338,30.06467882156338,12164922
2025-08-20T13:10:00-04:00,505.78,506.27,505.71,506,NaN,NaN,NaN,507.5393180730829,NaN,NaN,506.82460000000077,509.73236122732504,503.9168387726765,504.6975975546062,506.86889003551846,508.2913525297615,505.4464275412754,14758,20731.366666666665,50.04133844654171,44.9516947215048,NaN,NaN,NaN,NaN,0.7892938450996458,28.299616140193507,12179680
2025-08-20T13:15:00-04:00,506.04,506.27,505.61,505.92,NaN,NaN,NaN,507.5393180730829,NaN,NaN,506.76620000000077,509.62661085078315,503.9057891492184,504.606078043685,506.85780329506343,508.2754318678284,505.4401747222985,13248,20436.1,49.326643242387384,45.50990825869373,NaN,NaN,NaN,NaN,0.7800585704496689,26.831588568467584,12166432
2025-08-20T13:20:00-04:00,505.93,506.5,505.86,505.9,NaN,NaN,NaN,507.5393180730829,NaN,NaN,506.7024000000008,509.494117921843,503.91068207815863,504.7526935173873,506.8466469783764,508.25699257667947,505.4363013800733,16411,20308.7,49.137699955204894,46.034268836187614,NaN,NaN,NaN,NaN,0.7700543868461202,25.01476785315405,12150021
2025-08-20T13:25:00-04:00,505.9,506.12,505.81,505.92,NaN,NaN,NaN,507.5393180730829,NaN,NaN,506.64620000000076,509.38501986178346,503.90738013821806,504.7526935173873,506.8412594107563,508.24906796630427,505.4334508552084,6857,20162.666666666668,49.34665014021788,46.46036954443999,NaN,NaN,NaN,NaN,0.7371933592142546,23.42359070726215,12156878
2025-08-20T13:30:00-04:00,505.93,506.5,505.85,506.32,NaN,NaN,NaN,507.5393180730829,NaN,NaN,506.5862000000008,509.21741839364023,503.9549816063614,504.9327238511279,506.8328568530932,508.23289123625557,505.4328224699308,15732,19994.933333333334,53.464285022554854,46.94997569330802,NaN,NaN,NaN,NaN,0.7309652621275206,22.290496663657734,12172610
2025-08-20T13:35:00-04:00,506.31,506.81,506.26,506.49,NaN,NaN,NaN,507.5393180730829,NaN,NaN,506.51780000000076,508.97167950705557,504.06392049294595,505.2811790809023,506.82846136496056,508.2191136232494,505.4378091066717,16486,18829.233333333334,55.13358595433448,47.49943548448867,NaN,NaN,NaN,NaN,0.7180391719755557,21.772757676930187,12189096
2025-08-20T13:40:00-04:00,506.44,506.5,506.3,506.45,NaN,NaN,NaN,507.5393180730829,NaN,NaN,506.4806000000008,508.88047469571933,504.0807253042822,505.2811790809023,506.8252855193464,508.2110332137964,505.4395378248964,9120,18181.6,54.63695873885937,48.442559087250636,NaN,NaN,NaN,NaN,0.6810363739773008,21.29200004639746,12179976
2025-08-20T13:45:00-04:00,506.48,507.61,506.48,507.61,504.7750038087077,504.7750038087077,504.7750038087077,NaN,NaN,NaN,506.44200000000086,508.70179821995475,504.18220178004697,505.9715546117775,506.83306019582307,508.20667607682907,505.45944431481706,22969,18188.3,64.59656836538869,49.81478304136909,NaN,NaN,NaN,NaN,0.7152480615503525,22.372148051584546,12202945
2025-08-20T13:50:00-04:00,507.58,507.58,507.23,507.28,505.1863672719482,NaN,NaN,NaN,NaN,NaN,506.3876000000008,508.4218765188505,504.3533234811511,506.07924368942196,506.8419672431535,508.20570157198586,505.4782329143211,20595,18133.8,60.52540533826554,51.11058162236589,NaN,NaN,NaN,NaN,0.6913017714396127,23.375142627829693,12182350
2025-08-20T13:55:00-04:00,507.3,507.33,506.43,506.7,505.1863672719482,NaN,NaN,NaN,NaN,NaN,506.31620000000083,508.02495809731505,504.6074419026866,506.07924368942196,506.84168848333366,508.1967446622906,505.4866323043767,15759,17631.133333333335,54.07477035568055,52.02839728981852,NaN,NaN,NaN,NaN,0.706208787765353,22.613617539748983,12166591
2025-08-20T14:00:00-04:00,506.71,506.71,505.38,505.95,505.1863672719482,NaN,NaN,NaN,NaN,NaN,506.28160000000076,507.94803264352345,504.6151673564781,506.07924368942196,506.8307170968103,508.1800966976076,505.481337496013,16669,17335.033333333333,47.086367927865055,51.8527760610637,NaN,NaN,NaN,NaN,0.7507653029249696,21.67752967961621,12149922
2025-08-20T14:05:00-04:00,505.99,506.1,505.73,505.965,505.1863672719482,NaN,NaN,NaN,NaN,NaN,506.2675000000008,507.9324783768398,504.60252162316175,506.07924368942196,506.8187347668256,508.1630512934142,505.47441824023707,17000,17195.7,47.233246444045385,52.198678469792334,NaN,NaN,NaN,NaN,0.7235677812874721,20.80830523806435,12166922
2025-08-20T14:10:00-04:00,505.98,505.98,504.9,505.22,NaN,NaN,NaN,507.74935024752506,507.74935024752506,507.74935024752506,506.2271000000008,507.8937566398477,504.5604433601539,506.07924368942196,506.7888731067369,508.13516123327935,505.44258498019445,26782,17118.666666666668,41.127084431551076,51.71343287026695,NaN,NaN,NaN,NaN,0.749027225481227,20.990613341381128,12140140
2025-08-20T14:15:00-04:00,505.19,505.63,504.95,505.18,NaN,NaN,NaN,507.5871070544557,NaN,NaN,506.17490000000083,507.8055887977168,504.5442112022849,506.07924368942196,506.7671959320587,508.1161663118783,505.4182255522391,18648,16416.866666666665,40.82194200897085,51.18232474084767,NaN,NaN,NaN,NaN,0.7440967093754256,21.15989943731814,12121492
2025-08-20T14:20:00-04:00,505.19,505.83,504.87,505.78,NaN,NaN,NaN,507.5871070544557,NaN,NaN,506.1471000000009,507.7562340387574,504.53796596124437,506.07924368942196,506.74648094515015,508.09410423348646,505.39885765681385,21836,15753.466666666667,47.15553452674508,50.97619588943363,NaN,NaN,NaN,NaN,0.7595183729914652,20.955609887890816,12143328
2025-08-20T14:25:00-04:00,505.72,505.81,505.37,505.4,NaN,NaN,NaN,507.5871070544557,NaN,NaN,506.0973000000008,507.64035827335385,504.5542417266478,506.07924368942196,506.73284273772896,508.0790350415831,505.3866504338748,15183,15556.6,43.94748911989925,50.59197059497019,NaN,NaN,NaN,NaN,0.7366956320635032,20.765912449136874,12128145
2025-08-20T14:30:00-04:00,505.4,505.45,505.11,505.2,NaN,NaN,NaN,507.5008028203714,NaN,NaN,506.05750000000086,507.58837719777637,504.52662280222535,506.07924368942196,506.713804735196,508.0616618311446,505.3659476392474,17702,15539.766666666666,42.315785330016645,50.10469097888532,NaN,NaN,NaN,NaN,0.7083602297732512,20.929690468806932,12110443
2025-08-20T14:35:00-04:00,505.18,505.71,504.87,505.265,NaN,NaN,NaN,507.5008028203714,NaN,NaN,506.01420000000087,507.509402138408,504.51899786159373,506.07924368942196,506.69430360836753,508.04320274512327,505.3454044716118,18991,15655.2,43.05577387103599,49.65534267394376,NaN,NaN,NaN,NaN,0.7177630705037314,20.562927521660317,12129434
2025-08-20T14:40:00-04:00,505.31,505.415,505.1,505.2,NaN,NaN,NaN,507.43329347889215,NaN,NaN,505.97060000000084,507.4306775852706,504.5105224147311,505.6793949515376,506.6816768428774,508.0314819946816,505.33187169107316,12201,15655.866666666667,42.46906135093814,48.86996955454256,NaN,NaN,NaN,NaN,0.6889942797534648,20.222361927881323,12117233
2025-08-20T14:45:00-04:00,505.24,505.57,505.15,505.36,NaN,NaN,NaN,507.43329347889215,NaN,NaN,505.9220000000008,507.2958224030159,504.54817759698574,504.72451596123005,506.6638476797787,508.0131594996348,505.3145358599226,19238,15830.266666666666,44.474804698990496,48.1086280363037,NaN,NaN,NaN,NaN,0.6697804026282185,19.58180634566803,12136471
2025-08-20T14:50:00-04:00,505.34,505.61,505.01,505.3,NaN,NaN,NaN,507.428977116098,NaN,NaN,505.8762000000009,507.17518815804976,504.577211841952,504.3266127689841,506.645275729073,507.99456773417296,505.295983723973,19786,16004.766666666666,43.857311950655,47.33865326571769,NaN,NaN,NaN,NaN,0.6647960881547759,19.21989398148139,12116685
2025-08-20T14:55:00-04:00,505.29,505.44,504.83,504.86,NaN,NaN,NaN,507.240841792639,NaN,NaN,505.8274000000009,507.0916313690643,504.5631686309375,504.1586891405888,506.6220583497596,507.9751498066592,505.26896689285996,21264,16321.8,39.523596625414086,45.54772671286236,NaN,NaN,NaN,NaN,0.6608820818580072,19.179411424522936,12095421
2025-08-20T15:00:00-04:00,504.885,505.06,504.78,504.99,NaN,NaN,NaN,506.96830352933716,NaN,NaN,505.7872000000009,507.02732766870986,504.54707233129193,504.1586891405888,506.60527203978273,507.9619027078431,505.2486413717224,14819,16197.533333333333,41.36706364966923,44.179273735105475,NaN,NaN,NaN,NaN,0.6336762188681516,19.224760253451866,12110240
2025-08-20T15:05:00-04:00,504.99,505.9,504.89,505.9,NaN,NaN,NaN,506.96830352933716,NaN,NaN,505.7690000000009,506.97478604835777,504.56321395164406,504.3447288399814,506.58925310866067,507.9415051512924,505.23700106602894,23140,16432.133333333335,52.32282690028052,44.054134916862616,NaN,NaN,NaN,NaN,0.6605564889489973,18.192791869095622,12133380
2025-08-20T15:10:00-04:00,505.87,506.77,505.68,506.63,NaN,NaN,NaN,506.96830352933716,NaN,NaN,505.77460000000093,506.9936551072158,504.5555448927861,504.9807830719852,506.58586747433804,507.9283821092033,505.2433528394728,22561,16770.733333333334,58.949369280247865,44.901492156318525,NaN,NaN,NaN,NaN,0.6912310254526386,18.50156600777235,12155941
2025-08-20T15:15:00-04:00,506.61,506.76,506.35,506.66,NaN,NaN,NaN,506.96830352933716,NaN,NaN,505.7828000000009,507.0199178740878,504.545682125914,505.12362645758816,506.5859398336024,507.9166491623538,505.25523050485106,27226,17366.066666666666,59.20033600745541,45.75628426799067,NaN,NaN,NaN,NaN,0.6711430950631622,18.78828485082931,12183167
2025-08-20T15:20:00-04:00,506.69,507.47,506.54,507.23,504.8690797730302,504.8690797730302,504.8690797730302,NaN,NaN,NaN,505.80350000000095,507.10069119421195,504.50630880578996,505.69590116607054,506.59244336891015,507.9155641089465,505.2693226288738,20741,17582.633333333335,63.73664453388904,47.3712528467291,NaN,NaN,NaN,NaN,0.6896328739872225,19.884080451413478,12203908
2025-08-20T15:25:00-04:00,507.21,507.21,506.63,507.01,504.8690797730302,NaN,NaN,NaN,NaN,NaN,505.82110000000097,507.15878051278855,504.4834194872134,505.69590116607054,506.59580091291247,507.91314624168757,505.27845558413736,14936,17549.966666666667,60.921200124512644,48.80691414069638,NaN,NaN,NaN,NaN,0.6832305258452797,20.901604937670207,12188972
2025-08-20T15:30:00-04:00,506.965,507.41,506.75,506.77,504.9657421072445,NaN,NaN,NaN,NaN,NaN,505.8333000000009,507.19404921806233,504.4725507819395,505.7045767462851,506.5994392214346,507.9110006519404,505.28787779092875,15341,17587.066666666666,57.915630495361334,49.57549242416896,NaN,NaN,NaN,NaN,0.6815712025706187,22.066084698597184,12173631
2025-08-20T15:35:00-04:00,506.75,506.88,506.2,506.21,504.9657421072445,NaN,NaN,NaN,NaN,NaN,505.84050000000093,507.2053300240211,504.47566997598074,505.7045767462851,506.59770704122917,507.9026585027627,505.29275557969567,16587,17752.866666666665,51.527694927431476,50.11693569613555,NaN,NaN,NaN,NaN,0.681458973815575,21.957078116355706,12157044
2025-08-20T15:40:00-04:00,506.22,506.59,506.14,506.56,504.9657421072445,NaN,NaN,NaN,NaN,NaN,505.8377000000009,507.1960242744004,504.4793757256014,505.7045767462851,506.59609037494783,507.89484023168285,505.2973405182128,15793,17787.366666666665,54.87752194828711,51.01420259744059,NaN,NaN,NaN,NaN,0.6649261899716045,21.734730076797966,12172837
2025-08-20T15:45:00-04:00,506.57,506.96,506.53,506.94,504.9657421072445,NaN,NaN,NaN,NaN,NaN,505.85450000000094,507.2457645307042,504.4632354692977,505.7045767462851,506.59891386212206,507.8892948209545,505.30853290328963,21914,18076.233333333334,58.2509793929934,52.09957442043754,NaN,NaN,NaN,NaN,0.648145747830776,22.023573646915825,12194751
2025-08-20T15:50:00-04:00,506.96,507.05,505.94,506.59,504.9657421072445,NaN,NaN,NaN,NaN,NaN,505.883300000001,507.274655610245,504.49194438975695,505.7045767462851,506.5973476781712,507.8737088478909,505.32098650845154,36788,18755.466666666667,54.229489850485876,52.9396050275481,NaN,NaN,NaN,NaN,0.6811353372714359,21.14221030510418,12157963
2025-08-20T15:55:00-04:00,506.55,506.55,505.2,505.51,504.9657421072445,NaN,NaN,NaN,NaN,NaN,505.8801000000009,507.27413656859613,504.4860634314056,505.7045767462851,506.54238021575605,507.79392836077125,505.29083207074086,118219,22467.533333333333,44.10995176218413,52.9135441034905,NaN,NaN,NaN,NaN,0.7317685274663324,20.094832160902023,12039744
2025-08-21T09:30:00-04:00,503.7,504.82,502.77,504.25,NaN,NaN,NaN,506.26223712480186,506.26223712480186,506.26223712480186,505.87530000000095,507.28994965077055,504.46065034923134,505.7045767462851,503.94666666666666,503.94666666666666,503.94666666666666,34898,23106.4,35.73237327094239,52.3331913406539,NaN,NaN,NaN,NaN,0.8752136326473092,21.41082376321211,12004846
2025-08-21T09:35:00-04:00,504.23,505.43,503.45,505.1,NaN,NaN,NaN,506.26223712480186,NaN,NaN,505.8809000000009,507.2809366975243,504.48086330247753,505.7045767462851,504.2410094141673,504.59218862787606,503.88983020045856,24516,23374.066666666666,43.524800581415185,52.61899162322539,NaN,NaN,NaN,NaN,0.9541269446010742,21.794126593395248,12029362
2025-08-21T09:40:00-04:00,505.07,505.07,504.23,504.49,NaN,NaN,NaN,506.26223712480186,NaN,NaN,505.8647000000009,507.30928493501483,504.42011506498693,505.7045767462851,504.30962281750345,504.65491932694493,503.96432630806197,14202,23543.466666666667,39.79563608706758,52.50674679732527,NaN,NaN,NaN,NaN,0.9481178771295692,22.150050649993876,12015160
2025-08-21T09:45:00-04:00,504.62,504.68,502.92,504.65,NaN,NaN,NaN,506.26223712480186,NaN,NaN,505.8481000000009,507.32861462485425,504.36758537514754,505.7045767462851,504.2449755800941,504.55419624146833,503.93575491871985,29442,23759.233333333334,41.218266123669,51.71356388471016,NaN,NaN,NaN,NaN,1.0061094573345992,23.39227496052862,12044602
2025-08-21T09:50:00-04:00,504.66,504.67,503.5,504.3,NaN,NaN,NaN,506.26223712480186,NaN,NaN,505.8239000000009,507.36408348073184,504.28371651926994,505.47422329409795,504.2278383760971,504.50762688776683,503.9480498644274,24815,23899.9,39.04476646509081,50.291806540770374,NaN,NaN,NaN,NaN,1.0178159246678433,24.54576896316803,12019787
2025-08-21T09:55:00-04:00,504.31,504.37,503.17,503.2,NaN,NaN,NaN,506.26223712480186,NaN,NaN,505.7745000000009,507.48075232440715,504.06824767559465,505.47422329409795,504.1568994941863,504.4895168567517,503.82428213162086,15724,23898.733333333334,33.131582834081655,48.42975274267225,NaN,NaN,NaN,NaN,1.0308290729058538,25.82614422352328,12004063
2025-08-21T10:00:00-04:00,503.2,505.11,502.94,504.9,NaN,NaN,NaN,506.26223712480186,NaN,NaN,505.75250000000096,507.47484520180774,504.0301547981942,505.47422329409795,504.17881674557964,504.4926296135873,503.86500387757195,22831,24104.133333333335,46.59316973369432,47.20521882837262,NaN,NaN,NaN,NaN,1.1121984248411512,25.948908913417128,12026894
2025-08-21T10:05:00-04:00,504.93,505.88,504.76,505.75,NaN,NaN,NaN,506.26223712480186,NaN,NaN,505.74580000000094,507.4655236505357,504.02607634946617,505.3063786352784,504.3124836974271,504.80448104766083,503.8204863471934,19330,24181.8,51.81629123692136,46.55486819354468,NaN,NaN,NaN,NaN,1.1127556802096408,25.105728046461955,12046224
2025-08-21T10:10:00-04:00,505.79,506.75,505.67,506.485,503.197124626399,503.197124626399,503.197124626399,NaN,NaN,NaN,505.7685000000009,507.4966692608773,504.04033073912456,504.4601029082227,504.53065867211143,505.3064818186508,503.75483552557205,22884,24051.866666666665,55.838208272432716,46.406480891906924,NaN,NaN,NaN,NaN,1.1104159887660938,23.398610497985757,12069108
2025-08-21T10:15:00-04:00,506.56,507.3,506.14,507.25,503.6858916888354,NaN,NaN,NaN,NaN,NaN,505.79870000000096,507.5759009548865,504.02149904511543,504.0403406507103,504.83379782311334,505.90623460839333,503.76136103783335,30660,24452.266666666666,59.6165010396903,46.98425275706826,NaN,NaN,NaN,NaN,1.1139577038542317,22.159031116622906,12099768
2025-08-21T10:20:00-04:00,507.17,507.54,506.71,506.91,504.1156238847974,NaN,NaN,NaN,NaN,NaN,505.82970000000097,507.6291448127513,504.03025518725065,504.5172725205682,504.9710302802204,506.13926356180883,503.802796998632,15771,24250.1,57.27125823861911,47.155233920663406,NaN,NaN,NaN,NaN,1.0936750107217894,21.226574491855747,12083997
2025-08-21T10:25:00-04:00,506.98,507.6,506.46,507.47,504.1156238847974,NaN,NaN,NaN,NaN,NaN,505.874900000001,507.72269705433996,504.027102945662,504.61181801645455,505.0629466433728,506.28858113034033,503.8373121564053,11092,24113.733333333334,60.05828914671959,47.28432747450099,NaN,NaN,NaN,NaN,1.096983938527379,20.086019287814256,12095089
2025-08-21T10:30:00-04:00,507.47,507.55,506.54,506.79,504.1156238847974,NaN,NaN,NaN,NaN,NaN,505.889700000001,507.754644405043,504.02475559495906,504.65445441316365,505.1169168865901,506.3654821647108,503.8683516084694,7794,23783.466666666667,55.3381791965171,47.363519570646076,NaN,NaN,NaN,NaN,1.090770800061137,19.02693231263287,12087295
2025-08-21T10:35:00-04:00,506.78,507.23,506.28,506.35,504.1156238847974,NaN,NaN,NaN,NaN,NaN,505.91430000000105,507.7704120746934,504.0581879253087,504.65445441316365,505.17787424251446,506.4362866570863,503.9194618279426,11580,23536.433333333334,52.46490861300258,47.9603022028474,NaN,NaN,NaN,NaN,1.080715742913916,17.736876103870127,12075715
2025-08-21T10:40:00-04:00,506.29,506.59,506.08,506.54,504.1156238847974,NaN,NaN,NaN,NaN,NaN,505.9300000000011,507.7937210074728,504.06627899252936,504.65445441316365,505.2163472911027,506.47314954594634,503.95954503625904,9255,23438.233333333334,53.585610017029815,49.2355333989965,NaN,NaN,NaN,NaN,1.0399503327057784,16.636628327056503,12084970
2025-08-21T10:45:00-04:00,506.54,506.88,506.16,506.41,504.1156238847974,NaN,NaN,NaN,NaN,NaN,505.94230000000107,507.8104072864849,504.0741927135172,504.65445441316365,505.2548082436745,506.5113323664021,503.99828412094695,9229,23104.6,52.670615666882505,49.888805905101314,NaN,NaN,NaN,NaN,1.0170967375125064,15.636525741515026,12075741
2025-08-21T10:50:00-04:00,506.47,507.21,506.46,507.18,504.1156238847974,NaN,NaN,NaN,NaN,NaN,505.96590000000106,507.86586914552015,504.06593085448196,504.92958452763185,505.302232183298,506.5722035287784,504.03226083781755,8750,22736.733333333334,57.31933635767719,51.14049878157342,NaN,NaN,NaN,NaN,1.0015898276901811,15.098421222997516,12084491
2025-08-21T10:55:00-04:00,507.25,507.25,506.63,506.73,504.1156238847974,NaN,NaN,NaN,NaN,NaN,505.982100000001,507.8940028097308,504.07019719027124,505.1156676221055,505.33418846303624,506.6105235688793,504.0578533571932,6508,22244.866666666665,53.98230350192936,52.05221573716345,NaN,NaN,NaN,NaN,0.9743334114265971,14.646521929011215,12077983
2025-08-21T11:00:00-04:00,506.74,507.45,506.61,506.68,504.1989363230779,NaN,NaN,NaN,NaN,NaN,505.997700000001,507.9193724054922,504.07602759450975,505.32253409768435,505.4145002759702,506.7054520086204,504.12354854332006,17108,22321.166666666668,53.60884875507594,53.09250732930525,NaN,NaN,NaN,NaN,0.9647381677532669,14.472619300275369,12060875
2025-08-21T11:05:00-04:00,506.67,506.67,506.17,506.37,504.1989363230779,NaN,NaN,NaN,NaN,NaN,506.006700000001,507.9310457158443,504.0823542841577,505.32253409768435,505.4384622167818,506.72270972390794,504.1542147096556,8354,21828.3,51.24190357688284,54.38610166807676,NaN,NaN,NaN,NaN,0.9322568700566044,13.653796521633035,12052521
2025-08-21T11:10:00-04:00,506.43,506.46,505.56,505.68,504.1989363230779,NaN,NaN,NaN,NaN,NaN,505.9939000000011,507.91825369767713,504.069546302325,505.32253409768435,505.4542271842213,506.71913176842037,504.1893226000222,12192,21482.666666666668,46.33780433777688,54.36786128265409,NaN,NaN,NaN,NaN,0.9299528079097025,13.266236633524425,12040329
2025-08-21T11:15:00-04:00,505.62,506.17,505.47,506.03,504.1989363230779,NaN,NaN,NaN,NaN,NaN,505.9847000000011,507.90387003770013,504.0655299623021,505.32253409768435,505.46450761710156,506.7161514212227,504.2128638129804,8624,20862.6,49.00389339501688,54.16697572251805,NaN,NaN,NaN,NaN,0.9135276073447229,13.018044278676525,12048953
2025-08-21T11:20:00-04:00,506.03,506.91,505.76,506.88,504.1989363230779,NaN,NaN,NaN,NaN,NaN,505.99330000000106,507.92454893112216,504.06205106887995,505.32253409768435,505.4832669434034,506.73149224205275,504.23504164475406,6636,20392.433333333334,54.8682927946282,54.097696045532025,NaN,NaN,NaN,NaN,0.930418492534388,12.416809185381585,12055589
2025-08-21T11:25:00-04:00,506.85,506.96,506.54,506.67,504.1989363230779,NaN,NaN,NaN,NaN,NaN,505.97450000000106,507.8601948305068,504.0888051694953,505.32253409768435,505.49948431165103,506.74749788953886,504.2514707337632,4932,20058.966666666667,53.23935551652925,53.64218565102052,NaN,NaN,NaN,NaN,0.8939600287819288,11.922903487053961,12050657
2025-08-21T11:30:00-04:00,506.7,507.11,506.43,506.95,504.1989363230779,NaN,NaN,NaN,NaN,NaN,505.967900000001,507.8375128888312,504.0982871111708,505.32253409768435,505.51742949594933,506.7664631579808,504.26839583391785,5156,19719.466666666667,55.15121942110302,53.49075430691222,NaN,NaN,NaN,NaN,0.8786771695832201,11.664217972160547,12055813
2025-08-21T11:35:00-04:00,506.91,507.1,506.56,506.62,504.2059512411253,NaN,NaN,NaN,NaN,NaN,505.96630000000107,507.8335394687921,504.09906053121006,505.3253753428027,505.54297136093214,506.7916112934971,504.2943314283672,8023,19434,52.43039684513537,52.94590485679907,NaN,NaN,NaN,NaN,0.8544859431844201,11.424009994045235,12047790
2025-08-21T11:40:00-04:00,506.65,507.03,506.56,506.88,504.2261352756196,NaN,NaN,NaN,NaN,NaN,505.98490000000106,507.86956600589764,504.1002339941045,505.37530027424214,505.5564353933961,506.8053405267805,504.3075302600117,4148,19045.833333333332,54.34161279621861,52.874721542492026,NaN,NaN,NaN,NaN,0.827022661528388,11.200959728652446,12051938
2025-08-21T11:45:00-04:00,506.88,506.94,506.41,506.43,504.2261352756196,NaN,NaN,NaN,NaN,NaN,505.99420000000106,507.88296611415785,504.10543388584426,505.37530027424214,505.5778467665249,506.8225550548965,504.3331384781533,8317,18592.6,50.55567077169146,52.73834741096981,NaN,NaN,NaN,NaN,0.8058067571335013,10.717853322353003,12043621
2025-08-21T11:50:00-04:00,506.55,506.55,505.92,506.045,504.2261352756196,NaN,NaN,NaN,NaN,NaN,506.01070000000107,507.886494240812,504.13490575919013,505.37530027424214,505.5872877481809,506.8242937923421,504.3502817040198,6507,17583.233333333334,47.50619899506387,52.30410376654367,NaN,NaN,NaN,NaN,0.7932491316239652,10.46719722157374,12037114
2025-08-21T11:55:00-04:00,506.04,506.52,505.98,506.52,504.2261352756196,NaN,NaN,NaN,NaN,NaN,506.0375000000011,507.9033180494786,504.1716819505236,505.37530027424214,505.6014708681539,506.83103413456456,504.37190760174326,7860,13904.6,51.401119265544615,52.21342545216239,NaN,NaN,NaN,NaN,0.7751599079365364,10.234445127992995,12044974
2025-08-21T12:00:00-04:00,506.57,506.76,506.12,506.19,504.2261352756196,NaN,NaN,NaN,NaN,NaN,506.0457000000011,507.91052278879005,504.18087721121213,505.37530027424214,505.6153503997351,506.8377781179396,504.39292268153065,7810,13001.666666666666,48.697755373229086,51.59759823898753,NaN,NaN,NaN,NaN,0.7655056287982115,9.562136420922092,12037164
2025-08-21T12:05:00-04:00,506.27,506.46,505.98,506.39,504.2261352756196,NaN,NaN,NaN,NaN,NaN,506.0655000000011,507.92348950307957,504.2075104969227,505.37530027424214,505.6255790881261,506.841258427217,504.40989974903516,6676,12407,50.40035009661211,51.34174442432201,NaN,NaN,NaN,NaN,0.7451123695983365,9.19339540083172,12043840
2025-08-21T12:10:00-04:00,506.39,506.89,506.34,506.6,504.26214532626665,NaN,NaN,NaN,NaN,NaN,506.0935000000011,507.94063751353593,504.24636248646624,505.43033119509096,505.63798309968917,506.85095938184145,504.4250068175369,5508,12117.2,52.194372736351966,51.240710422984584,NaN,NaN,NaN,NaN,0.7311757717698847,9.017377909619192,12049348
2025-08-21T12:15:00-04:00,506.65,506.72,506.32,506.32,504.26214532626665,NaN,NaN,NaN,NaN,NaN,506.1146000000011,507.94744678953,504.2817532104722,505.43033119509096,505.64699038494166,506.8562548901652,504.43772587971813,4883,11298.566666666668,49.617417444028945,51.124675699209305,NaN,NaN,NaN,NaN,0.7075203595006097,8.813443660538043,12044465
2025-08-21T12:20:00-04:00,506.36,506.37,505.86,506.07,504.26214532626665,NaN,NaN,NaN,NaN,NaN,506.13200000000114,507.94620946795095,504.31779053205133,505.43033119509096,505.6567191664674,506.85472943305825,504.4587088998765,9701,10794.766666666666,47.36866816965313,51.19830883005761,NaN,NaN,NaN,NaN,0.6934117623934226,8.62533805407117,12034764
2025-08-21T12:25:00-04:00,506.07,506.07,505.33,505.45,504.26214532626665,NaN,NaN,NaN,NaN,NaN,506.1338000000011,507.94511836898243,504.32248163101974,505.43033119509096,505.6555955516251,506.83670057717285,504.4744905260773,13038,10705.233333333334,42.25406712976026,50.71617838253928,NaN,NaN,NaN,NaN,0.6967394936510359,9.29550458156056,12021726
2025-08-21T12:30:00-04:00,505.48,505.705,504.98,505.05,504.26214532626665,NaN,NaN,NaN,NaN,NaN,506.12880000000115,507.9506469292714,504.3069530707309,505.43033119509096,505.6435520511781,506.8092668261899,504.4778372761663,14044,10412.333333333334,39.30539971296857,49.60454316242074,NaN,NaN,NaN,NaN,0.698758101247388,10.399680307046031,12007682
2025-08-21T12:35:00-04:00,505.05,505.245,504.78,505.11,504.26214532626665,NaN,NaN,NaN,NaN,NaN,506.13380000000114,507.94301923317363,504.32458076682866,505.43033119509096,505.62702008334713,506.78070132040625,504.473338846288,13600,10221.333333333334,39.98197312814518,48.657587277536166,NaN,NaN,NaN,NaN,0.682061094015434,11.68401215587764,12021282
2025-08-21T12:40:00-04:00,505.1,505.29,505.02,505.08,504.26214532626665,NaN,NaN,NaN,NaN,NaN,506.13560000000115,507.9404375421354,504.3307624578669,505.43033119509096,505.61773777375635,506.7625741988766,504.47290134863607,9371,9770.9,39.74342017395349,47.55703018845406,NaN,NaN,NaN,NaN,0.6526281587286201,12.770757941065805,12011911
2025-08-21T12:45:00-04:00,505.13,505.21,504.87,505.04,504.26214532626665,NaN,NaN,NaN,NaN,NaN,506.1184000000012,507.94811083873816,504.28868916126424,505.43033119509096,505.6062351990967,506.74248735906855,504.4699830391249,10193,9088.666666666666,39.40581868689217,46.626703177150965,NaN,NaN,NaN,NaN,0.6302975759622883,13.987629476250035,12001718
2025-08-21T12:50:00-04:00,504.99,505.54,504.92,505.48,504.26214532626665,NaN,NaN,NaN,NaN,NaN,506.0954000000012,507.9277185731702,504.2630814268322,505.43033119509096,505.60053340572955,506.7263992271113,504.4746675843478,10164,8901.766666666666,44.94578421086706,45.955572563911566,NaN,NaN,NaN,NaN,0.6295620348221252,14.318854905069411,12011882
2025-08-21T12:55:00-04:00,505.57,505.62,504.46,504.63,504.26214532626665,NaN,NaN,NaN,NaN,NaN,506.0548000000012,507.92485022218017,504.1847497778222,505.43033119509096,505.5746985130211,506.687329756694,504.46206726934815,20092,9201.766666666666,37.762989691752246,45.04180962963019,NaN,NaN,NaN,NaN,0.667450460906261,15.29200855286987,11991790
2025-08-21T13:00:00-04:00,504.66,505.06,504.66,505,504.26214532626665,NaN,NaN,NaN,NaN,NaN,506.0102000000012,507.87236321342556,504.1480367865768,505.35226495607276,505.5642660487998,506.67127823417627,504.4572538634234,8602,9228.7,42.100558121492696,44.65569242437511,NaN,NaN,NaN,NaN,0.6504897136986714,16.19565122582744,12000392
2025-08-21T13:05:00-04:00,504.99,505.15,504.86,504.9,504.26214532626665,NaN,NaN,NaN,NaN,NaN,505.9680000000012,507.8332517238354,504.102748276167,505.02081196485824,505.55025530915395,506.6478496314424,504.4526609868655,13300,9286.033333333333,41.263516955559886,43.93157797366191,NaN,NaN,NaN,NaN,0.624740448434478,16.8033055057574,11987092
2025-08-21T13:10:00-04:00,504.9,504.9,504.41,504.59,504.26214532626665,NaN,NaN,NaN,NaN,NaN,505.9244000000012,507.81437739496454,504.03442260503783,504.62064957188653,505.538516109707,506.6339227345406,504.44310948487345,7316,9221.4,38.69512336876988,43.217104259057685,NaN,NaN,NaN,NaN,0.6151161306891547,18.012974362477593,11979776
2025-08-21T13:15:00-04:00,504.58,505,504.52,504.68,504.26214532626665,NaN,NaN,NaN,NaN,NaN,505.89380000000114,507.8135984877541,503.97400151224815,504.2651568517158,505.5248489886799,506.6158879989275,504.43380997843224,9867,9242.666666666666,39.86539135299848,42.464607205942414,NaN,NaN,NaN,NaN,0.6054649784970735,18.86955537938179,11989643
2025-08-21T13:20:00-04:00,504.73,504.77,504.15,504.17,NaN,NaN,NaN,506.45975500399635,506.45975500399635,506.45975500399635,505.8460000000012,507.8154415435566,503.8765584564458,504.2651568517158,505.5088457912582,506.60076945564913,504.41692212686723,8121,9221.7,35.70587932895694,41.28685767684278,NaN,NaN,NaN,NaN,0.6065031943187115,20.165428809451495,11981522
2025-08-21T13:25:00-04:00,504.17,504.58,503.94,504.45,NaN,NaN,NaN,506.25612977654197,NaN,NaN,505.7962000000012,507.77835494687343,503.81404505312895,504.2651568517158,505.4842959958218,506.5779633986133,504.3906285930303,12464,9420.233333333334,39.4417530302524,40.56002450443017,NaN,NaN,NaN,NaN,0.6088958232959454,21.62815054686904,11993986
2025-08-21T13:30:00-04:00,504.48,505.05,504.42,505,NaN,NaN,NaN,506.25612977654197,NaN,NaN,505.7644000000013,507.74561138524354,503.783188614759,504.2651568517158,505.47269062017955,506.5601844373539,504.3851968030052,10757,9208.533333333333,46.0705709308508,40.46730327308715,NaN,NaN,NaN,NaN,0.6104032644890918,21.760649102129673,12004743
2025-08-21T13:35:00-04:00,505,505.825,504.95,505.71,NaN,NaN,NaN,506.25612977654197,NaN,NaN,505.7684000000013,507.74834791676295,503.78845208323963,504.2651568517158,505.4731216204533,506.5500638061359,504.3961794347707,12069,9332.366666666667,53.19336739559265,41.24868186350375,NaN,NaN,NaN,NaN,0.6293030313112995,20.312946429818304,12016812
2025-08-21T13:40:00-04:00,505.77,505.93,505.7,505.74,NaN,NaN,NaN,506.25612977654197,NaN,NaN,505.7982000000013,507.7301065797938,503.8662934202088,504.54850427862476,505.4782020119924,506.54721736244903,504.4091866615357,10179,9265.266666666666,53.472993308140545,42.26065283458747,NaN,NaN,NaN,NaN,0.6007813862176364,18.938988221809286,12026991
2025-08-21T13:45:00-04:00,505.75,506,505.65,505.76,NaN,NaN,NaN,506.25612977654197,NaN,NaN,505.8114000000013,507.73303580136815,503.88976419863445,504.71980342289976,505.4833418902654,506.5446488867041,504.4220348938267,10198,9317.733333333334,53.671698775340005,43.23849038081567,NaN,NaN,NaN,NaN,0.5828684300592355,17.789349912675682,12037189
2025-08-21T13:50:00-04:00,505.8,505.87,504.95,504.96,NaN,NaN,NaN,506.25612977654197,NaN,NaN,505.8208000000013,507.7209666855796,503.92063331442307,504.71980342289976,505.47997520983324,506.5336042063353,504.42634621333116,9873,9425.633333333333,45.33193684852231,43.63767014328487,NaN,NaN,NaN,NaN,0.6069492564835769,17.500401653096993,12027316
2025-08-21T13:55:00-04:00,504.94,505.41,504.85,505.3,NaN,NaN,NaN,506.25612977654197,NaN,NaN,505.83380000000136,507.71049769349975,503.957102306503,504.71980342289976,505.4761171312883,506.5233269801668,504.42890728240974,8730,9552.233333333334,48.96169873546417,44.32023300389716,NaN,NaN,NaN,NaN,0.6035957381633216,17.381275939378874,12036046
2025-08-21T14:00:00-04:00,505.29,505.7,505.19,505.38,NaN,NaN,NaN,506.25612977654197,NaN,NaN,505.85540000000134,507.6852632060537,504.02553679394896,504.71980342289976,505.4754357198027,506.5158812047231,504.4349902348823,8680,9669.7,49.806180826339045,44.66740419071658,NaN,NaN,NaN,NaN,0.5969103282945122,16.68897683995378,12044726
2025-08-21T14:05:00-04:00,505.37,505.38,504.96,505.12,NaN,NaN,NaN,506.25612977654197,NaN,NaN,505.89380000000136,507.5735839839817,504.21401601602105,504.71980342289976,505.4696617040119,506.50162482750767,504.43769858051616,12273,9811.366666666667,47.079738477959076,45.33288624687422,NaN,NaN,NaN,NaN,0.5842738762734767,16.419633197356056,12032453
2025-08-21T14:10:00-04:00,505.06,505.385,504.86,505.3,NaN,NaN,NaN,506.25612977654197,NaN,NaN,505.9018000000013,507.56631645621025,504.23728354379233,504.71980342289976,505.4634864624976,506.48517789777765,504.44179502721755,15002,10173.166666666666,49.154872997028114,45.83676588084103,NaN,NaN,NaN,NaN,0.5800400279682266,16.330244549847666,12047455
2025-08-21T14:15:00-04:00,505.25,505.71,505.13,505.7,NaN,NaN,NaN,506.25612977654197,NaN,NaN,505.9008000000013,507.56574006893356,504.23585993106906,504.71980342289976,505.4644513186228,506.47622960759605,504.4526730296496,13810,10356.266666666666,53.516929169926954,46.71200961043868,NaN,NaN,NaN,NaN,0.5800371688276379,15.565006580239451,12061265
2025-08-21T14:20:00-04:00,505.72,505.9,505.66,505.82,NaN,NaN,NaN,506.25612977654197,NaN,NaN,505.88750000000124,507.5441644178029,504.2308355821996,504.71980342289976,505.4669213947677,506.475292894088,504.45854989544745,5399,10319.333333333334,54.770558320901415,47.86025496416236,NaN,NaN,NaN,NaN,0.5557487996256604,14.480071928100486,12066664
2025-08-21T14:25:00-04:00,505.84,505.86,505.21,505.21,NaN,NaN,NaN,506.25612977654197,NaN,NaN,505.8467000000013,507.4672204204431,504.2261795795595,504.71980342289976,505.4662142391177,506.4657034438158,504.46672503441954,12854,10485.8,47.72446187406081,48.42161714423823,NaN,NaN,NaN,NaN,0.56248102822383,14.272103198821027,12053810
2025-08-21T14:30:00-04:00,505.23,505.23,504.88,504.96,NaN,NaN,NaN,506.25612977654197,NaN,NaN,505.80770000000126,507.41780957179947,504.19759042820306,504.71980342289976,505.45783782817426,506.44966649982223,504.4660091565263,14106,10695.666666666666,45.160257246580485,49.09692985263992,NaN,NaN,NaN,NaN,0.5473038119221295,14.593758536452492,12039704
2025-08-21T14:35:00-04:00,505,505.76,504.99,505.63,NaN,NaN,NaN,506.25612977654197,NaN,NaN,505.7709000000012,507.3098940720074,504.23190592799494,504.6872186787941,505.4578593262427,506.4447449203098,504.47097373217565,7490,10722.8,52.52262953578778,50.03127817446387,NaN,NaN,NaN,NaN,0.5653535396419782,13.844321506815257,12047194
2025-08-21T14:40:00-04:00,505.63,505.67,505.2,505.25,NaN,NaN,NaN,506.25612977654197,NaN,NaN,505.7401000000012,507.25777254494983,504.2224274550525,504.6872186787941,505.4569801171618,506.4387571340837,504.47520310023987,7918,10803.133333333333,48.542154614560914,50.20781986615746,NaN,NaN,NaN,NaN,0.558542572524696,13.148415693580684,12039276
2025-08-21T14:45:00-04:00,505.21,505.37,504.93,505.29,NaN,NaN,NaN,506.25612977654197,NaN,NaN,505.7189000000012,507.23150740225384,504.2062925977486,504.6872186787941,505.45397245984617,506.43045762328893,504.4774872964034,8898,10936.966666666667,48.980469247045555,49.90689856983266,NaN,NaN,NaN,NaN,0.5500752459157889,12.968185432110607,12048174
2025-08-21T14:50:00-04:00,505.33,505.63,505.27,505.42,NaN,NaN,NaN,506.25612977654197,NaN,NaN,505.69650000000127,507.19289065531797,504.20010934468456,504.6872186787941,505.45381738911203,506.42486986823013,504.48276490999393,8643,10901.7,50.45746960414427,49.69150401954722,NaN,NaN,NaN,NaN,0.5364984426360907,12.280127989891119,12056817
2025-08-21T14:55:00-04:00,505.41,505.87,505.22,505.75,NaN,NaN,NaN,506.25612977654197,NaN,NaN,505.6833000000013,507.1658621178611,504.2007378821415,504.6872186787941,505.4576481115487,506.41728077199866,504.4980154510987,19162,11105.833333333334,54.090755378275006,49.721436634042576,NaN,NaN,NaN,NaN,0.5446056967335112,11.618518994991822,12075979
2025-08-21T15:00:00-04:00,505.7,506,505.62,505.77,NaN,NaN,NaN,506.25612977654197,NaN,NaN,505.6551000000013,507.0750302634489,504.2351697365537,504.7773284181336,505.4613287516305,506.41638433905916,504.50627316420184,8758,10929.633333333333,54.30945521028327,50.362687945596925,NaN,NaN,NaN,NaN,0.5328481469668315,11.244000301347349,12084737
2025-08-21T15:05:00-04:00,505.76,506.12,505.66,505.97,NaN,NaN,NaN,506.25612977654197,NaN,NaN,505.63990000000126,507.0294243622762,504.25037563772634,504.91186273450694,505.4667576409719,506.41738824796107,504.5161270339827,9734,10800.766666666666,56.5390805704083,50.903929505235794,NaN,NaN,NaN,NaN,0.5276447078977706,11.11873444734782,12094471
2025-08-21T15:10:00-04:00,506,506.09,505.89,506,NaN,NaN,NaN,506.25612977654197,NaN,NaN,505.6263000000014,506.987867931805,504.26473206819776,505.0234901876055,505.47201095901914,506.4193343383451,504.5246875796932,8227,10762.633333333333,56.87899560155258,51.4091305606082,NaN,NaN,NaN,NaN,0.5042415144765006,11.002416154348257,12102698
2025-08-21T15:15:00-04:00,505.96,506.05,505.84,505.89,NaN,NaN,NaN,506.25612977654197,NaN,NaN,505.6167000000013,506.963850486481,504.26954951352155,505.0917921500844,505.47747330301405,506.4203907930386,504.5345558129895,10028,10757.133333333333,55.17499449584605,51.987363133314396,NaN,NaN,NaN,NaN,0.4832242634424674,10.77065522814372,12092670
2025-08-21T15:20:00-04:00,505.915,506.45,505.82,506.33,504.50725224272423,504.50725224272423,504.50725224272423,NaN,NaN,NaN,505.6297000000013,506.99150822186147,504.2678917781412,505.3684337200675,505.4895973908839,506.4291649929661,504.5500297888017,14245,10893.166666666666,60.298524414943586,52.783338234594076,NaN,NaN,NaN,NaN,0.49370824462514795,11.345900292919866,12106915
2025-08-21T15:25:00-04:00,506.33,506.34,505.99,506.15,504.56351350441855,NaN,NaN,NaN,NaN,NaN,505.6321000000013,506.9971407881148,504.2670592118878,505.3684337200675,505.4969749147702,506.4339722608168,504.5599775687236,9446,10538.3,57.40768814553049,53.061249589994326,NaN,NaN,NaN,NaN,0.48344337000906357,11.880056424497717,12097469
2025-08-21T15:30:00-04:00,506.17,506.18,505.99,506.09,504.56351350441855,NaN,NaN,NaN,NaN,NaN,505.61630000000133,506.9408871934278,504.2917128065749,505.3684337200675,505.503300171877,506.4372362482868,504.5693640954672,9307,10561.8,56.436418790006215,53.18023962350181,NaN,NaN,NaN,NaN,0.46248312929413027,12.376058546677148,12088162
2025-08-21T15:35:00-04:00,506.08,506.09,505.49,505.52,504.56351350441855,NaN,NaN,NaN,NaN,NaN,505.5933000000013,506.8833908623646,504.303209137638,505.3684337200675,505.50534504120515,506.43462807939557,504.5760620030147,9115,10422.3,48.109100670501796,53.2077138232476,NaN,NaN,NaN,NaN,0.47230576291597565,11.49771515373739,12079047
2025-08-21T15:40:00-04:00,505.52,505.56,504.69,504.7,504.56351350441855,NaN,NaN,NaN,NaN,NaN,505.54830000000135,506.80242217625255,504.29417782375015,505.3684337200675,505.49475198614437,506.4174980504506,504.5720059218381,18161,10783.8,39.157774380123286,52.77896504707208,NaN,NaN,NaN,NaN,0.5007124941362634,12.19860861577585,12060886
2025-08-21T15:45:00-04:00,504.7,504.86,504.37,504.795,NaN,NaN,NaN,506.22171088530143,506.22171088530143,506.22171088530143,505.5118000000013,506.7450911388104,504.2785088611922,505.3684337200675,505.47919114140916,506.3999579135343,504.558424369284,17317,11032.133333333333,40.53813671362195,51.92292984548881,NaN,NaN,NaN,NaN,0.49994731598367376,13.32328948837795,12078203
2025-08-21T15:50:00-04:00,504.77,504.95,504.15,504.25,NaN,NaN,NaN,506.192769481424,NaN,NaN,505.4592000000013,506.678852997032,504.23954700297065,505.3684337200675,505.43811096997024,506.3625366386628,504.5136853012777,37927,12025.666666666666,35.554562528929935,50.99524469651517,NaN,NaN,NaN,NaN,0.5213796505562692,14.67001736867178,12040276
2025-08-21T15:55:00-04:00,504.27,504.55,504.05,504.11,NaN,NaN,NaN,505.9362799595412,NaN,NaN,505.4128000000013,506.65745763694855,504.1681423630541,505.3684337200675,505.33175468611,506.27800161726077,504.38550775495924,92284,14686.333333333334,34.38515900500502,49.95272253636942,NaN,NaN,NaN,NaN,0.5198525326593929,16.055978234342025,11947992
2025-08-22T09:30:00-04:00,504.5,504.74,502.44,503.96,NaN,NaN,NaN,505.4655399613803,NaN,NaN,505.3711000000013,506.6668982686757,504.07530173132693,505.3684337200675,503.71333333333337,503.71333333333337,503.71333333333337,39502,15644.5,33.1279387197349,48.714898901768755,NaN,NaN,NaN,NaN,0.6470059231837227,18.880268759667366,11908490
2025-08-22T09:35:00-04:00,503.99,505.79,503.5,505.79,502.54243912777343,502.54243912777343,502.54243912777343,NaN,NaN,NaN,505.35650000000135,506.6161352619278,504.0968647380749,505.3684337200675,504.2853962402541,504.9365900017083,503.6342024787999,30485,16258.366666666667,54.82777102680828,48.76754287666398,NaN,NaN,NaN,NaN,0.7643626429563154,19.429826339720396,11938975
2025-08-22T09:40:00-04:00,505.8,506.47,505.66,506.34,503.94755553105654,NaN,NaN,NaN,NaN,NaN,505.3595000000013,506.6277464245175,504.09125357548504,505.299746976054,504.74679269251055,505.73168149336396,503.76190389165714,22904,16682.533333333333,59.12121616167867,49.111240087477945,NaN,NaN,NaN,NaN,0.7676224541737217,18.899400863078725,11961879
2025-08-22T09:45:00-04:00,506.35,506.35,504.47,504.78,503.94755553105654,NaN,NaN,NaN,NaN,NaN,505.3273000000013,506.5707680667507,504.0838319332519,505.25279758084326,504.84570091648925,505.73640534868457,503.95499648429393,25932,17207,45.81893841239639,48.34551564761995,NaN,NaN,NaN,NaN,0.8470779931613127,19.527356306961103,11935947
2025-08-22T09:50:00-04:00,504.85,504.915,503.74,504.25,NaN,NaN,NaN,506.6617624190167,506.6617624190167,506.6617624190167,505.2803000000013,506.50530678898576,504.0552932110169,505.0482380646746,504.75599271415354,505.59461745829293,503.91736797001414,23462,17659.966666666667,42.33390506166813,47.306580609056766,NaN,NaN,NaN,NaN,0.8705009936497913,20.654644067309466,11912485
2025-08-22T09:55:00-04:00,504.35,504.68,503.48,503.89,NaN,NaN,NaN,506.47179594542513,NaN,NaN,505.2317000000013,506.4804395377196,503.982960462283,504.2915904517397,504.67483887988624,505.49916056809496,503.8505171916775,17544,17953.766666666666,40.10266419367267,46.22998558747296,NaN,NaN,NaN,NaN,0.8940366369605197,21.8808948550905,11894941
2025-08-22T10:00:00-04:00,503.9,507,503.9,506.06,502.74283114300334,502.74283114300334,502.74283114300334,NaN,NaN,NaN,505.23150000000135,506.47970550911793,503.98329449088476,503.70837244738084,504.98048947228034,505.80079746253796,504.1601814820227,72605,20084.6,55.37166781115207,45.87806725863071,NaN,NaN,NaN,NaN,1.0523197343204835,20.343783651024037,11967546
2025-08-22T10:05:00-04:00,506.2,508.71,506.19,508.32,504.5045206365032,NaN,NaN,NaN,NaN,NaN,505.2889000000014,506.80683450213286,503.7709654978699,504.16624588355774,505.60269886704435,506.963223989113,504.24217374497573,67666,21931.033333333333,65.29448649299297,46.441409997735164,NaN,NaN,NaN,NaN,1.1664397532975903,20.137016270488623,12035212
2025-08-22T10:10:00-04:00,508.42,508.65,507.84,508.43,505.32295151666216,NaN,NaN,NaN,NaN,NaN,505.3565000000014,507.108813040747,503.6041869592558,504.6099967068462,505.92684193855854,507.4762085428656,504.37747533425147,40875,22793.466666666667,65.69430195783164,47.10268736686556,NaN,NaN,NaN,NaN,1.1409797709191911,19.94501798856288,12076087
2025-08-22T10:15:00-04:00,508.51,509.4,507.9,508.37,505.65622644772293,NaN,NaN,NaN,NaN,NaN,505.42170000000135,507.3646952220089,503.4787047779938,505.41799736547694,506.1379001136503,507.78665139554045,504.48914883176013,29753,23324.9,65.25272842143353,48.32723220621783,NaN,NaN,NaN,NaN,1.1666240729963917,20.254937983018113,12046334
2025-08-22T10:20:00-04:00,508.35,508.4,507.03,507.8,505.65622644772293,NaN,NaN,NaN,NaN,NaN,505.4761000000014,507.5270893107186,503.42511068928417,505.41799736547694,506.24886235082806,507.89091141798133,504.6068132836748,27526,24062.466666666667,61.054181257689265,49.89126126890112,NaN,NaN,NaN,NaN,1.1811509249252212,19.710589777597107,12018808
2025-08-22T10:25:00-04:00,507.8,508.61,507.7,508.2,505.65622644772293,NaN,NaN,NaN,NaN,NaN,505.5393000000014,507.723089374612,503.35551062539076,505.41799736547694,506.3207602556852,507.9725388657084,504.668981645662,15484,24150.133333333335,62.860150379336446,51.485690816452156,NaN,NaN,NaN,NaN,1.1617830017162787,19.35356273262974,12034292
2025-08-22T10:30:00-04:00,508.31,508.95,508.26,508.38,505.65622644772293,NaN,NaN,NaN,NaN,NaN,505.59730000000144,507.9212545676274,503.2733454323755,505.7338146511242,506.43881995412147,508.12091834374496,504.756721564498,23358,24458.533333333333,63.676423108873415,53.49439514359097,NaN,NaN,NaN,NaN,1.132369930165116,19.264636575543683,12057650
2025-08-22T10:35:00-04:00,508.39,508.86,508.17,508.275,505.65622644772293,NaN,NaN,NaN,NaN,NaN,505.67020000000144,508.09471228755643,503.24568771244645,505.94205172089937,506.5097819134892,508.20255723579436,504.817006591184,16111,24745.9,62.8092215796207,55.52468532749209,NaN,NaN,NaN,NaN,1.1007720780104646,19.087366762670186,12041539
2025-08-22T10:40:00-04:00,508.33,509.86,508.19,509.765,505.9787704188758,NaN,NaN,NaN,NaN,NaN,505.7655000000014,508.4389601161645,503.0920398838383,506.6906413767195,506.76356551083865,508.5632042867982,504.96392673487907,45858,26010.566666666666,69.2161022565468,58.10241129440722,NaN,NaN,NaN,NaN,1.1414312152954325,19.62659266335536,12087397
2025-08-22T10:45:00-04:00,509.72,510.6,509.475,510.38,506.9763263089269,NaN,NaN,NaN,NaN,NaN,505.8751000000014,508.8319398591592,502.9182601408436,507.5020131013756,506.9634574420279,508.88307185902664,505.04384302502916,31290,26756.966666666667,71.40570014260342,59.28654908839259,NaN,NaN,NaN,NaN,1.1402575570600444,20.57915012722984,12118687
2025-08-22T10:50:00-04:00,510.42,510.72,509.4,509.84,506.9763263089269,NaN,NaN,NaN,NaN,NaN,505.9801000000014,509.1144768045248,502.845723195478,507.5816104811005,507.0688892498107,509.03460481312123,505.10317368650016,19164,27107.666666666668,66.90575168741923,59.8425873402312,NaN,NaN,NaN,NaN,1.1530963029843306,21.534703024645978,12099523
2025-08-22T10:55:00-04:00,509.9,510.21,509.64,509.86,506.9763263089269,NaN,NaN,NaN,NaN,NaN,506.0837000000015,509.37770291929496,502.78969708070804,507.5816104811005,507.1441405553411,509.136396732667,505.1518843780152,14987,26968.5,66.98872870599811,61.35471521834561,NaN,NaN,NaN,NaN,1.111446567056878,22.422002143675243,12114510
2025-08-22T11:00:00-04:00,509.89,510.72,509.695,510.48,507.1670971494151,NaN,NaN,NaN,NaN,NaN,506.2099000000014,509.679765408433,502.74003459156984,507.9709307079043,507.2791595662125,509.3302151710828,505.22810396134224,25245,27518.066666666666,69.53850942749938,63.29790124447641,NaN,NaN,NaN,NaN,1.1052718122671035,23.5673573290089,12139755
2025-08-22T11:05:00-04:00,510.48,510.625,510.12,510.17,507.4014336426235,NaN,NaN,NaN,NaN,NaN,506.32430000000136,509.92907849983914,502.7195215001636,508.17324456632343,507.3809160284288,509.46967197862705,505.2921600782306,20523,27877.7,66.76184374276362,65.20212835512577,NaN,NaN,NaN,NaN,1.0623952542480244,24.630901429675863,12119232
2025-08-22T11:10:00-04:00,510.19,510.57,509.8,509.88,507.4014336426235,NaN,NaN,NaN,NaN,NaN,506.4219000000014,510.14042975686834,502.7033702431345,508.22359565305874,507.4418759990263,509.545565168492,505.33818682956064,14084,28072.933333333334,64.18006308437859,65.83129944607052,NaN,NaN,NaN,NaN,1.0415098789445927,25.151268396516418,12105148
2025-08-22T11:15:00-04:00,509.83,509.83,509.23,509.27,507.4014336426235,NaN,NaN,NaN,NaN,NaN,506.4931000000015,510.289884896777,502.696315103226,508.22359565305874,507.48415001123607,509.5853060693718,505.3829939531003,13472,28187.733333333334,59.010686092876675,65.38245656034792,NaN,NaN,NaN,NaN,1.013544887591406,24.851523845654505,12091676
2025-08-22T11:20:00-04:00,509.23,509.265,508.55,508.87,507.4014336426235,NaN,NaN,NaN,NaN,NaN,506.5557000000015,510.4036215211014,502.70777847890156,508.22359565305874,507.53528097227576,509.6147954858453,505.4557664587062,23985,28512.4,55.834848760204906,64.67820990337458,NaN,NaN,NaN,NaN,0.9925773956205891,23.739846907518185,12067691
2025-08-22T11:25:00-04:00,508.85,508.85,508.16,508.255,507.4014336426235,NaN,NaN,NaN,NaN,NaN,506.6056000000015,510.47559981297104,502.735600187032,508.22359565305874,507.5493448329703,509.6152673707684,505.4834222951722,10670,28553.2,51.266482512984155,63.67919233848534,NaN,NaN,NaN,NaN,0.9723932959334027,22.268659431061792,12057021
2025-08-22T11:30:00-04:00,508.27,509,508,508.6,507.4014336426235,NaN,NaN,NaN,NaN,NaN,506.6784000000015,510.55876979584457,502.7980302041584,508.22359565305874,507.58023717548014,509.62069894060846,505.5397754103518,21797,28969.533333333333,53.561884836572915,63.14402830840561,NaN,NaN,NaN,NaN,0.9743652033667312,20.723976759230684,12078818
2025-08-22T11:35:00-04:00,508.61,509.45,508.19,508.27,507.4014336426235,NaN,NaN,NaN,NaN,NaN,506.7378000000015,510.62287562761264,502.8527243723904,508.22359565305874,507.6162843676137,509.63078204342816,505.6017866917992,24527,29483.266666666666,51.08337760194725,62.30283025287781,NaN,NaN,NaN,NaN,0.9947676888405353,19.775027563456803,12054291
2025-08-22T11:40:00-04:00,508.3,508.7,508.1,508.4,507.4014336426235,NaN,NaN,NaN,NaN,NaN,506.79820000000143,510.69085501076466,502.9055449892382,508.22359565305874,507.6338330796861,509.62902133655274,505.63864482281946,16464,29426.7,52.02518424807078,61.47059890567762,NaN,NaN,NaN,NaN,0.9665699967804946,18.782450206520725,12070755
2025-08-22T11:45:00-04:00,508.37,508.47,507.78,507.85,507.4014336426235,NaN,NaN,NaN,NaN,NaN,506.8528000000014,510.7263039218791,502.97929607812375,508.22359565305874,507.64067245481766,509.61938707216325,505.6619578374721,12807,29276.366666666665,47.829479103178485,60.400617300217455,NaN,NaN,NaN,NaN,0.9468149970104632,17.46250676399287,12057948
2025-08-22T11:50:00-04:00,507.85,508.01,507.43,507.85,507.4014336426235,NaN,NaN,NaN,NaN,NaN,506.9038000000015,510.7612974053434,503.04630259465966,508.22359565305874,507.6426645669775,509.6053066860099,505.6800224479451,12350,28423.8,47.829479103178485,58.87300136069115,NaN,NaN,NaN,NaN,0.920613925795429,16.61197456339304,12057948
2025-08-22T11:55:00-04:00,507.88,508.36,507.12,507.38,NaN,NaN,NaN,510.4681763663131,510.4681763663131,510.4681763663131,506.9374000000015,510.7816139576796,503.0931860423234,508.22359565305874,507.64219065583416,509.5842078741767,505.7001734374916,16240,25889,44.28953058636224,56.936132106673924,NaN,NaN,NaN,NaN,0.9434272168100418,15.474785202427817,12041708
2025-08-22T12:00:00-04:00,507.54,507.83,506.9,507.05,NaN,NaN,NaN,510.1572433420332,NaN,NaN,506.9620000000015,510.79301657428186,503.1309834257212,507.62787652244697,507.63474326846404,509.5584717921294,505.71101474479866,15435,25086.766666666666,41.942307438635225,55.1530289460465,NaN,NaN,NaN,NaN,0.9424681298950394,14.59707294413378,12026273
2025-08-22T12:05:00-04:00,507.05,507.7,506.98,507.389,NaN,NaN,NaN,510.10350500830447,NaN,NaN,507.00558000000143,510.8053322454994,503.20582775450345,507.1433012179576,507.6306317614828,509.54039810528707,505.7208654176785,11873,24466.366666666665,45.15773777450171,53.59367245093961,NaN,NaN,NaN,NaN,0.9265775491882488,13.782054418575033,12038146
2025-08-22T12:10:00-04:00,507.4,507.52,506.86,506.99,NaN,NaN,NaN,509.9178911442906,NaN,NaN,507.0461800000014,510.80074938985837,503.29161061014446,507.1064902235943,507.62079972507775,509.51326146898407,505.7283379811714,15890,24232.566666666666,42.195605566518864,51.64060788944101,NaN,NaN,NaN,NaN,0.9075362956748002,13.189730693712267,12022256
2025-08-22T12:15:00-04:00,506.99,507.4,506.53,507.16,NaN,NaN,NaN,509.68753245591375,NaN,NaN,507.07678000000146,510.80955872358305,503.3440012764199,507.1064902235943,507.60951295349815,509.48555458096473,505.7334713260316,15968,23900.433333333334,43.88455022112647,50.00651549503834,NaN,NaN,NaN,NaN,0.9048551316980291,13.083949289682565,12038224
2025-08-22T12:20:00-04:00,507.19,507.21,506.6,506.79,NaN,NaN,NaN,509.58696279882673,NaN,NaN,507.1075800000014,510.80480217988725,503.41035782011556,507.1064902235943,507.59753347984474,509.4607377164124,505.7343292432771,13700,23575.033333333333,41.07177201047747,48.35592327547398,NaN,NaN,NaN,NaN,0.8837940508624526,12.985723700226409,12024524
2025-08-22T12:25:00-04:00,506.74,506.94,506.4,506.91,NaN,NaN,NaN,509.3036917625164,NaN,NaN,507.1399800000014,510.8011393889697,503.4788206110331,506.52519217887544,507.58359985265565,509.4345651194775,505.7326345858338,14200,23463.566666666666,42.3620885912212,47.16673773964145,NaN,NaN,NaN,NaN,0.8592373329437074,13.17331712327377,12038724
2025-08-22T12:30:00-04:00,506.95,507.11,506.75,506.9,NaN,NaN,NaN,509.3036917625164,NaN,NaN,507.1695800000014,510.7984261206552,503.5407338793476,506.3851537431004,507.57661284658786,509.4190534155914,505.7341722775843,9191,21349.766666666666,42.279007705208365,46.19846337857026,NaN,NaN,NaN,NaN,0.8235775234477293,13.026324173202664,12029533
2025-08-22T12:35:00-04:00,506.9,507.03,506.74,506.79,NaN,NaN,NaN,509.3036917625164,NaN,NaN,507.19038000000137,510.7983023239516,503.58245767605115,506.1736983955842,507.57029679834335,509.4059090522139,505.7346845444728,7690,19350.566666666666,41.31905139833293,45.48793258466661,NaN,NaN,NaN,NaN,0.7854648432014603,12.905435159638232,12021843
2025-08-22T12:40:00-04:00,506.79,507.16,506.79,506.95,NaN,NaN,NaN,509.3036917625164,NaN,NaN,507.2139800000014,510.79979928037216,503.62816071963067,506.1736983955842,507.56152140797013,509.3851738062977,505.73786900964257,12991,18421.1,43.33443573554301,44.75740050602161,NaN,NaN,NaN,NaN,0.7557887829727848,12.528645165539023,12034834
2025-08-22T12:45:00-04:00,506.92,506.97,506.66,506.77,NaN,NaN,NaN,509.1706720325882,NaN,NaN,507.2299800000014,510.8005606910868,503.65939930891597,505.8046317195326,507.55320887504115,509.3686060049915,505.7378117450908,9862,17758.066666666666,41.60332059568087,44.08025357700258,NaN,NaN,NaN,NaN,0.7239467270461575,12.406952817506749,12024972
2025-08-22T12:50:00-04:00,506.82,506.89,506.59,506.77,NaN,NaN,NaN,509.02950512201596,NaN,NaN,507.24538000000143,510.8012197454464,503.68954025455645,505.8046317195326,507.5451157623198,509.35312423701527,505.7371072876244,9196,17147.066666666666,41.60332059568086,43.335834744689016,NaN,NaN,NaN,NaN,0.6936648179714328,12.41918476587755,12024972
2025-08-22T12:55:00-04:00,506.77,506.79,506.05,506.27,NaN,NaN,NaN,508.70634579828794,NaN,NaN,507.2529800000014,510.7988099665012,503.7071500335016,505.8046317195326,507.5253125597412,509.32439168488605,505.7262334345964,15644,17152.4,36.85968524363909,42.5522780404362,NaN,NaN,NaN,NaN,0.6969744738306167,13.307275522499001,12009328
2025-08-22T13:00:00-04:00,506.265,506.87,506.22,506.56,NaN,NaN,NaN,508.70634579828794,NaN,NaN,507.2575800000015,510.7992027702834,503.7159572297196,505.8046317195326,507.507598772196,509.29501679278036,505.7201807516116,17172,16946.2,41.05751137576193,42.06856605990645,NaN,NaN,NaN,NaN,0.6936191542712854,13.936540318940748,12026500
2025-08-22T13:05:00-04:00,506.55,506.9,506.37,506.63,NaN,NaN,NaN,508.70634579828794,NaN,NaN,507.2671800000015,510.7993313363871,503.7350286636158,505.8046317195326,507.49457828597514,509.2717940085207,505.71736256342956,14294,16885.633333333335,42.058869428780596,41.909233120079186,NaN,NaN,NaN,NaN,0.6819320718233345,14.444355507468412,12040794
2025-08-22T13:10:00-04:00,506.63,506.96,506.25,506.84,NaN,NaN,NaN,508.70634579828794,NaN,NaN,507.28218000000146,510.8005505693295,503.7638094306734,505.8046317195326,507.48091893777286,509.2461976716214,505.7156402039243,16437,15904.933333333332,45.07359667611119,42.13289663704175,NaN,NaN,NaN,NaN,0.683936923835952,15.121208557244453,12057231
2025-08-22T13:15:00-04:00,506.84,507.39,506.77,507.28,NaN,NaN,NaN,508.70634579828794,NaN,NaN,507.3173800000015,510.79955653414277,503.8352034658602,505.9344223499881,507.47257568454256,509.21646347384404,505.7286878952411,24991,15694.966666666667,50.84458853901208,42.539100263078204,NaN,NaN,NaN,NaN,0.6793700007048128,14.659378669888817,12082222
2025-08-22T13:20:00-04:00,507.27,507.67,507.26,507.51,NaN,NaN,NaN,508.70634579828794,NaN,NaN,507.3735800000015,510.7747318059468,503.9724281940562,506.3005378799905,507.4726799646535,509.20427755497093,505.74108237433603,14263,15531.6,53.58960174682445,43.35295713310004,NaN,NaN,NaN,NaN,0.6601292863687566,13.613427427021024,12096485
2025-08-22T13:25:00-04:00,507.53,507.92,507.53,507.87,NaN,NaN,NaN,508.70634579828794,NaN,NaN,507.4350800000014,510.7578037693757,504.1123562306271,506.6194303039924,507.47574938422395,509.19875030087195,505.75274846757594,10474,15381.166666666666,57.582409884187506,44.331375680461534,NaN,NaN,NaN,NaN,0.64226290877099,13.147292641621972,12106959
2025-08-22T13:30:00-04:00,507.9,507.99,507.54,507.55,NaN,NaN,NaN,508.70634579828794,NaN,NaN,507.5010800000015,510.696787590995,504.305372409008,506.7245442431939,507.4779763372084,509.192277078234,505.76367559618285,10609,14893.3,53.20098863120375,45.1977482962277,NaN,NaN,NaN,NaN,0.6285298438587755,12.85360683357338,12096350
2025-08-22T13:35:00-04:00,507.59,507.61,507.37,507.48,NaN,NaN,NaN,508.70634579828794,NaN,NaN,507.56848000000144,510.6138794206495,504.5230805793534,506.7245442431939,507.478055318528,509.1845483397478,505.7715622973082,9507,14526.1,52.26415631558505,45.905038847967965,NaN,NaN,NaN,NaN,0.6007777121545779,12.176006816998566,12086843
2025-08-22T13:40:00-04:00,507.43,507.97,507.4,507.89,NaN,NaN,NaN,508.70634579828794,NaN,NaN,507.64708000000144,510.51349336297847,504.7806666370244,506.7791083156441,507.48075799288614,509.17907009319885,505.78244589257343,10372,14402.366666666667,57.03630815306822,46.95913173710081,NaN,NaN,NaN,NaN,0.5985793041435402,12.27840722522637,12097215
2025-08-22T13:45:00-04:00,507.88,507.93,507.71,507.755,NaN,NaN,NaN,508.70634579828794,NaN,NaN,507.68638000000135,510.5033250927906,504.8694349072121,506.86728665251525,507.4833717682004,509.17492388182984,505.791819654571,8767,14245.533333333333,55.08364680057236,47.94231712297506,NaN,NaN,NaN,NaN,0.5715379252761464,12.373493318580762,12088448
2025-08-22T13:50:00-04:00,507.76,508.13,507.76,508.02,NaN,NaN,NaN,508.70634579828794,NaN,NaN,507.71998000000144,510.51185192961157,504.9281080703913,507.0923293220122,507.4907876211079,509.1704594623923,505.8111157798236,16484,13995.5,58.114962842490954,48.99806905918563,NaN,NaN,NaN,NaN,0.5574995020421359,12.856264319664662,12104932
2025-08-22T13:55:00-04:00,508.06,508.13,507.86,508.09,NaN,NaN,NaN,508.70634579828794,NaN,NaN,507.7861800000015,510.45010449277464,505.1222555072283,507.1648634576098,507.49451770158754,509.168926347891,505.8201090552841,7582,13892.566666666668,58.90393881667382,50.233827503542265,NaN,NaN,NaN,NaN,0.5369638233248393,13.304551677813997,12112514
2025-08-22T14:00:00-04:00,508.11,508.39,507.99,508.14,NaN,NaN,NaN,508.70634579828794,NaN,NaN,507.86398000000145,510.33013731681893,505.39782268318396,507.4178907660878,507.5009870918327,509.16870232814813,505.8332718555173,10481,13515.366666666667,59.49090630653619,51.51151219717479,NaN,NaN,NaN,NaN,0.5271806930873492,14.22860591185883,12122995
2025-08-22T14:05:00-04:00,508.14,508.38,508.09,508.22,NaN,NaN,NaN,508.70634579828794,NaN,NaN,507.9505800000014,510.1411672106687,505.75999278933415,507.4573126128702,507.50942567856225,509.169293290707,505.8495580664175,12879,13127.1,60.46390506355264,53.19752789859719,NaN,NaN,NaN,NaN,0.5102392150096828,15.086656272043317,12135874
2025-08-22T14:10:00-04:00,508.23,508.42,508.21,508.28,NaN,NaN,NaN,508.70634579828794,NaN,NaN,507.9949800000015,510.1194857946087,505.87047420539426,507.5768500902962,507.51650809715574,509.1706406306708,505.8623755636407,10015,12912.133333333333,61.21631543155677,54.63744247401111,NaN,NaN,NaN,NaN,0.4887935567947081,15.96477842343655,12145889
2025-08-22T14:15:00-04:00,508.28,508.57,508.24,508.41,NaN,NaN,NaN,508.70634579828794,NaN,NaN,507.99678000000137,510.1225363829865,505.87102361701625,507.73048007223696,507.5248351837831,509.17344122123063,505.8762291463356,10601,12838.6,62.865304050119555,56.12361637553532,NaN,NaN,NaN,NaN,0.4774511598807992,17.084686115727816,12156490
2025-08-22T14:20:00-04:00,508.45,508.52,507.72,507.72,NaN,NaN,NaN,508.70634579828794,NaN,NaN,507.9825800000014,510.1060554172486,505.8591045827542,507.73048007223696,507.5297517332616,509.17024378348424,505.889259683039,12194,12833.4,50.57426510723026,56.5165212634724,NaN,NaN,NaN,NaN,0.5004903627464532,16.43424016378346,12144296
2025-08-22T14:25:00-04:00,507.71,507.98,507.69,507.89,NaN,NaN,NaN,508.70634579828794,NaN,NaN,507.9729800000014,510.09370095086206,505.8522590491408,507.73048007223696,507.53267991646277,509.16601990734245,505.8993399255831,10460,12640.733333333334,53.01180029718717,56.67132210334204,NaN,NaN,NaN,NaN,0.48545533683599373,15.74506321976678,12154756
2025-08-22T14:30:00-04:00,507.92,508.01,507.83,508,NaN,NaN,NaN,508.70634579828794,NaN,NaN,507.97698000000145,510.0971351809901,505.8568248190128,507.73048007223696,507.5367503824837,509.1625539731815,505.91094679178593,11478,12508.833333333334,54.57293676001867,56.7415603185702,NaN,NaN,NaN,NaN,0.4636370984905661,15.183382271993096,12166234
2025-08-22T14:35:00-04:00,507.95,508.25,507.92,508.21,NaN,NaN,NaN,508.70634579828794,NaN,NaN,507.97718000000145,510.0974211804807,505.8569388195222,507.73048007223696,507.54346630160745,509.1611999106442,505.9257326925707,13443,12561.166666666666,57.47750818695514,56.73406734019647,NaN,NaN,NaN,NaN,0.4540915914555245,15.266929216050931,12179677
2025-08-22T14:40:00-04:00,508.2,508.2,507.83,507.99,NaN,NaN,NaN,508.70634579828794,NaN,NaN,507.9693800000015,510.08650336327753,505.85225663672543,507.73048007223696,507.54730400718466,509.1588691029626,505.9357389114067,9865,12360.333333333334,53.6102488900728,56.76330021582997,NaN,NaN,NaN,NaN,0.44879933492298674,15.046901771739888,12169812
2025-08-22T14:45:00-04:00,508,508.22,507.96,508.06,NaN,NaN,NaN,508.70634579828794,NaN,NaN,507.9650800000015,510.0805756977907,505.84958430221224,507.73048007223696,507.5514456909176,509.15741534125857,505.94547604057664,9330,12139.066666666668,54.65566323897722,56.93412213892941,NaN,NaN,NaN,NaN,0.43531366814277683,14.895886297217745,12179142
2025-08-22T14:50:00-04:00,508.05,508.22,507.99,508.13,NaN,NaN,NaN,508.70634579828794,NaN,NaN,507.9323800000015,509.98519363383946,505.87956636616354,507.73048007223696,507.5551339686313,509.15646704770506,505.95380088955756,7929,11946.7,55.73004874641693,56.840817895597176,NaN,NaN,NaN,NaN,0.4206484061325798,14.755657642304328,12187071
2025-08-22T14:55:00-04:00,508.14,508.21,508,508,NaN,NaN,NaN,508.70634579828794,NaN,NaN,507.88478000000157,509.8150854367067,505.95447456329646,507.73048007223696,507.5610420649683,509.1541050231032,505.9679791068334,14022,11940.766666666666,53.208606814901856,56.706886468049284,NaN,NaN,NaN,NaN,0.40560209140882264,14.625445319884726,12173049
2025-08-22T15:00:00-04:00,507.96,508.04,507.5,507.58,NaN,NaN,NaN,508.70634579828794,NaN,NaN,507.8395800000015,509.68877100343707,505.9903889965659,507.73048007223696,507.5620081840254,509.14982191983887,505.9741944482119,8161,11906.433333333332,45.97187632309838,55.83952314523553,NaN,NaN,NaN,NaN,0.4152019420224796,14.348414414949115,12164888
2025-08-22T15:05:00-04:00,507.6,507.71,507.41,507.44,NaN,NaN,NaN,508.70634579828794,NaN,NaN,507.79118000000153,509.55082272029824,506.0315372797048,507.4726997683561,507.56154882717436,509.14066342141865,505.9824342329301,13600,12103.433333333332,43.831875248949025,54.762947176112334,NaN,NaN,NaN,NaN,0.40697323187801354,14.34017499209216,12151288
2025-08-22T15:10:00-04:00,507.47,507.73,507.35,507.64,NaN,NaN,NaN,508.70634579828794,NaN,NaN,507.7343800000015,509.31769479342864,506.1510652065744,507.4726997683561,507.56167379234444,509.1323939182778,505.9909536664111,13330,12114.733333333334,47.5855725747662,53.912566195271616,NaN,NaN,NaN,NaN,0.4050465724581551,14.499627540843269,12164618
2025-08-22T15:15:00-04:00,507.6,507.6,506.98,507,NaN,NaN,NaN,508.70634579828794,NaN,NaN,507.6709800000015,509.1060315778682,506.23592842213486,507.4726997683561,507.55348209480803,509.1075874865077,505.99937670310834,28592,12739.066666666668,38.67785616693652,52.35641984551332,NaN,NaN,NaN,NaN,0.4232575315682846,15.561606554523419,12136026
2025-08-22T15:20:00-04:00,506.99,507.49,506.91,507.39,NaN,NaN,NaN,508.6798967303885,NaN,NaN,507.6211800000016,508.9116788581452,506.33068114185795,507.4726997683561,507.5485052793701,509.08968503147656,506.0073255272636,22437,13180.433333333332,45.38685320786138,51.22574397239223,NaN,NaN,NaN,NaN,0.43445342217054883,16.70059949416452,12158463
2025-08-22T15:25:00-04:00,507.4,507.57,507.04,507.12,NaN,NaN,NaN,508.6798967303885,NaN,NaN,507.57818000000157,508.78673170478567,506.36962829521747,507.4726997683561,507.5432039872676,509.07145898996276,506.0149489845724,23125,13429.8,41.96390734204127,49.732787064672344,NaN,NaN,NaN,NaN,0.44127817772979344,17.4205277300608,12135338
2025-08-22T15:30:00-04:00,507.12,507.15,506.4,506.68,NaN,NaN,NaN,508.2946786324407,NaN,NaN,507.53438000000153,508.7107973304004,506.35796266960267,507.4726997683561,507.52659042007485,509.04318715483083,506.0099936853189,28236,13798.6,37.05893574742294,48.76740639611468,NaN,NaN,NaN,NaN,0.4633297364633796,19.325872366757498,12107102
2025-08-22T15:35:00-04:00,506.67,506.77,506.14,506.14,NaN,NaN,NaN,507.99151142187526,NaN,NaN,507.4920800000016,508.7130635244493,506.27109647555386,507.4726997683561,507.5096693342497,509.02182350043284,505.9975151680665,19836,13983.333333333334,32.099971365557906,47.27370432956973,NaN,NaN,NaN,NaN,0.4752347552874236,21.469532572542956,12087266
2025-08-22T15:40:00-04:00,506.15,506.41,505.75,506.38,NaN,NaN,NaN,507.6366699936082,NaN,NaN,507.4476800000016,508.66573342372976,506.2296265762734,507.4726997683561,507.4849029001778,508.9936565545475,505.97614924580813,26178,14308.033333333333,36.187014972455344,45.96042420188663,NaN,NaN,NaN,NaN,0.48843227276689516,23.936085670205596,12113444
2025-08-22T15:45:00-04:00,506.38,506.94,506.3,506.91,NaN,NaN,NaN,507.6366699936082,NaN,NaN,507.42048000000153,508.62452565992663,506.21643434007643,507.18015981468494,507.47567194897596,508.97766794678546,505.97367595116646,17093,14044.766666666666,44.17789860923743,45.01045208919252,NaN,NaN,NaN,NaN,0.49925853899783024,24.427627456267032,12130537
2025-08-22T15:50:00-04:00,506.99,507.84,506.71,507.27,505.6192325058239,505.6192325058239,505.6192325058239,NaN,NaN,NaN,507.3978800000016,508.5695188927982,506.22624110720494,506.8721278517479,507.46838619405383,508.94357429297264,505.993198095135,53136,15340.533333333333,48.86214339144631,44.67130169643349,NaN,NaN,NaN,NaN,0.5443115004979849,22.75426814316891,12183673
2025-08-22T15:55:00-04:00,507.3,507.72,506.8,507.1,505.6192325058239,NaN,NaN,NaN,NaN,NaN,507.3828800000016,508.5501774321468,506.21558256785636,506.86970228139836,507.44229310371117,508.8442081838211,506.04037802360125,163416,20438.6,46.86233481293604,44.11463538028768,NaN,NaN,NaN,NaN,0.5711463933195586,21.200434495292082,12020257
2025-08-25T09:30:00-04:00,506.67,508.14,505.18,506.6,NaN,NaN,NaN,508.6920526134951,508.6920526134951,508.6920526134951,507.3578800000016,508.53756610013045,506.1781938998728,506.58176182511875,506.64000000000004,506.64000000000004,506.64000000000004,44078,21554.233333333334,41.484499108198364,43.09709612041494,NaN,NaN,NaN,NaN,0.7417787937967315,22.037470807392896,11976179
2025-08-25T09:35:00-04:00,506.43,506.46,505.2,505.26,NaN,NaN,NaN,507.9605956765181,NaN,NaN,507.31548000000157,508.63324976407995,505.9977102359232,506.421327568076,506.17968875883093,506.6781110722061,505.6812664454558,37595,22490.5,31.16300776011856,41.5224104736447,NaN,NaN,NaN,NaN,0.7887945942398246,22.814718811486507,11938584
2025-08-25T09:40:00-04:00,505.19,506.41,504.59,506.18,NaN,NaN,NaN,507.78193223667637,NaN,NaN,507.29808000000156,508.6518942144334,505.9442657855697,506.421327568076,506.0704403439006,506.54591139306456,505.59496929473664,25955,23009.933333333334,41.85870321641037,41.22861239459555,NaN,NaN,NaN,NaN,0.8624521232226978,24.127814150792386,11964539
2025-08-25T09:45:00-04:00,506.16,506.7,505.3,506.605,NaN,NaN,NaN,507.78193223667637,NaN,NaN,507.2824000000016,508.64973205644304,505.91506794356013,506.1165230175071,506.0889175833825,506.53200220749846,505.64583295926656,17638,23305.633333333335,46.03048375594864,41.385655859381245,NaN,NaN,NaN,NaN,0.9008484001353606,24.747702630463618,11982177
2025-08-25T09:50:00-04:00,506.53,506.91,506.23,506.41,NaN,NaN,NaN,507.78193223667637,NaN,NaN,507.2708000000016,508.65756076980006,505.88403923020314,506.1165230175071,506.12614419575283,506.5663440544853,505.6859443370204,11941,23154.2,44.4543910118428,41.16200003345814,NaN,NaN,NaN,NaN,0.8850735144114068,24.903122399711535,11970236
2025-08-25T09:55:00-04:00,506.39,506.89,506.2,506.77,NaN,NaN,NaN,507.78193223667637,NaN,NaN,507.2630000000016,508.6565365056273,505.86946349437596,506.1165230175071,506.17276567003273,506.6158611560786,505.72967018398685,14303,23378.233333333334,47.99466368313473,41.827486284615155,NaN,NaN,NaN,NaN,0.871139691953449,25.082770670196027,11984539
2025-08-25T10:00:00-04:00,506.84,507.09,506.06,506.9,NaN,NaN,NaN,507.78193223667637,NaN,NaN,507.26520000000164,508.65608742621123,505.87431257379205,506.1165230175071,506.23011561461277,506.67763352704225,505.7825977021833,19172,23667.933333333334,49.25250858440518,42.10360452579686,NaN,NaN,NaN,NaN,0.8824868568139149,24.827810177335948,12003711
2025-08-25T10:05:00-04:00,506.97,507.29,506.5,507.09,NaN,NaN,NaN,507.78193223667637,NaN,NaN,507.26880000000165,508.65692039553977,505.8806796044635,506.1165230175071,506.2706909977554,506.7366392975211,505.80474269798975,10047,23573.533333333333,51.11357716078693,42.75715236999299,NaN,NaN,NaN,NaN,0.8758806527557796,24.178480543998155,12013758
2025-08-25T10:10:00-04:00,507.06,507.51,506.91,507.31,NaN,NaN,NaN,507.78193223667637,NaN,NaN,507.27700000000164,508.66114738829884,505.8928526117044,505.88121841400573,506.3395514287135,506.85333347071736,505.8257693867096,13770,23698.7,53.251392739599886,43.91375644086276,NaN,NaN,NaN,NaN,0.85617489184465,23.13483105812564,12027528
2025-08-25T10:15:00-04:00,507.37,508,507.01,507.03,505.1278703386062,505.1278703386062,505.1278703386062,NaN,NaN,NaN,507.2818000000016,508.6608137898524,505.90278621015085,505.6079347491517,506.40010263795,506.9527478093492,505.8474574665508,12442,23760.066666666666,50.24010307629042,45.20948013448651,NaN,NaN,NaN,NaN,0.8657338281414614,21.686221193396022,12015086
2025-08-25T10:20:00-04:00,507.09,507.5,506.81,507.5,505.1278703386062,NaN,NaN,NaN,NaN,NaN,507.29280000000165,508.6698245576669,505.9157754423364,505.6079347491517,506.42647934511655,506.99075343685854,505.86220525337455,6471,23569.3,54.854939501329966,46.54290331512043,NaN,NaN,NaN,NaN,0.8531814118456426,20.282059317974024,12021557
2025-08-25T10:25:00-04:00,507.46,507.46,506.87,507.21,505.1278703386062,NaN,NaN,NaN,NaN,NaN,507.30160000000166,508.67074928057207,505.93245071943124,505.6079347491517,506.4472018756238,507.017144185523,505.8772595657246,6035,23421.8,51.67069804768431,47.07810327500948,NaN,NaN,NaN,NaN,0.8372398824280963,18.978194719367885,12015522
2025-08-25T10:30:00-04:00,507.15,507.475,506.93,507.35,505.1278703386062,NaN,NaN,NaN,NaN,NaN,507.31320000000164,508.67393914928175,505.95246085072154,505.6079347491517,506.4731011950177,507.05149611688233,505.8947062731531,7300,23282.533333333333,53.08650095123213,47.37984310070847,NaN,NaN,NaN,NaN,0.8163656051118048,17.73749723989559,12022822
2025-08-25T10:35:00-04:00,507.345,507.53,507.07,507.07,505.1278703386062,NaN,NaN,NaN,NaN,NaN,507.3292000000016,508.6589584113746,505.9994415886286,505.72397007325253,506.50170571475036,507.08687857601376,505.91653285348696,8988,23134.033333333333,49.93571958893714,47.59937058470855,NaN,NaN,NaN,NaN,0.7909109190323887,16.471603525904673,12013834
2025-08-25T10:40:00-04:00,507.04,507.18,506.75,506.96,505.1278703386062,NaN,NaN,NaN,NaN,NaN,507.3372000000016,508.6530923332851,506.0213076667181,505.72397007325253,506.52658570258956,507.1052375964269,505.9479338087522,13429,23252.833333333332,48.7125288615626,48.115658424234574,NaN,NaN,NaN,NaN,0.7651315676729329,15.94407974997086,12000405
2025-08-25T10:45:00-04:00,507.05,508.05,506.89,507.97,505.18999107353466,NaN,NaN,NaN,NaN,NaN,507.3640000000016,508.6757636953547,506.05223630464855,506.1421408468816,506.57600389355247,507.18620701518824,505.9658007719167,11609,23328.8,58.712798061200004,50.08350058859753,NaN,NaN,NaN,NaN,0.7933364556962966,15.795464166914602,12012014
2025-08-25T10:50:00-04:00,507.95,508.1,507.55,507.68,505.57362784291945,NaN,NaN,NaN,NaN,NaN,507.3808000000016,508.68679289148264,506.0748071085206,506.2987126775053,506.6227324480743,507.26443185912933,505.9810330370193,10560,23416.5,55.37416345077208,51.04889060533765,NaN,NaN,NaN,NaN,0.7759552802894191,15.736547123926131,12001454
2025-08-25T10:55:00-04:00,507.65,507.86,507.36,507.36,505.57362784291945,NaN,NaN,NaN,NaN,NaN,507.38240000000155,508.688090986761,506.0767090132421,506.2987126775053,506.6646160848599,507.31944757348134,506.0097845962385,13183,23388.533333333333,51.86920882001726,51.46594239562826,NaN,NaN,NaN,NaN,0.7562441888401749,15.271456773021521,11988271
2025-08-25T11:00:00-04:00,507.35,508.14,507.28,508.14,505.57362784291945,NaN,NaN,NaN,NaN,NaN,507.3950000000016,508.71742504240893,506.0725749575942,506.3571761136034,506.7185672872706,507.40454435018324,506.032590224358,13527,23567.4,58.726814641491785,52.48540122631748,NaN,NaN,NaN,NaN,0.7636553182087348,15.316028673469667,12001798
2025-08-25T11:05:00-04:00,508.11,508.19,507.59,507.64,505.6760051139441,NaN,NaN,NaN,NaN,NaN,507.3904000000016,508.70777441621726,506.0730255837859,506.46374089088266,506.7417211507833,507.4382905344504,506.0451517671162,6480,23330.066666666666,53.46782715123337,52.8763414740388,NaN,NaN,NaN,NaN,0.7519656526223982,15.441124826362639,11995318
2025-08-25T11:10:00-04:00,507.7,507.93,507.52,507.67,505.6760051139441,NaN,NaN,NaN,NaN,NaN,507.39280000000167,508.71176498523647,506.07383501476687,506.46374089088266,506.76622634082014,507.4704510880082,506.0620015936321,7935,23150.233333333334,53.73552768633784,53.196557124176856,NaN,NaN,NaN,NaN,0.727539534577943,15.385230769566588,12003253
2025-08-25T11:15:00-04:00,507.631,507.79,507.48,507.6,505.6760051139441,NaN,NaN,NaN,NaN,NaN,507.39520000000164,508.71522720902016,506.0751727909831,506.46374089088266,506.79980701047657,507.50984706391756,506.0897669570356,12741,22621.866666666665,52.96978025862999,53.32914305973708,NaN,NaN,NaN,NaN,0.6977152821080901,15.230924517319396,11990512
2025-08-25T11:20:00-04:00,507.62,507.73,507.49,507.655,505.6760051139441,NaN,NaN,NaN,NaN,NaN,507.3905000000017,508.70510906448527,506.0758909355181,506.47095533613196,506.84640550742455,507.56192529340234,506.13088572144676,19463,22522.733333333334,53.53011169701664,53.349051556695414,NaN,NaN,NaN,NaN,0.6650213333860843,15.087640140232722,12009975
2025-08-25T11:25:00-04:00,507.67,507.72,507.39,507.39,505.6760051139441,NaN,NaN,NaN,NaN,NaN,507.3832000000017,508.6936789323843,506.0727210676191,506.54776426890555,506.8795878087337,507.5913203186633,506.16785529880406,18434,22366.366666666665,50.41349997732471,53.36143704962644,NaN,NaN,NaN,NaN,0.641091238144224,14.671647733811117,11991541
2025-08-25T11:30:00-04:00,507.38,507.43,507.01,507.21,505.6760051139441,NaN,NaN,NaN,NaN,NaN,507.3670000000017,508.66556227891573,506.0684377210877,506.54776426890555,506.88987846545444,507.59305781641547,506.1866991144934,11434,21806.3,48.3541524628491,52.897095118306375,NaN,NaN,NaN,NaN,0.6252990068482092,13.939415913833372,11980107
2025-08-25T11:35:00-04:00,507.28,507.45,507.16,507.21,505.6760051139441,NaN,NaN,NaN,NaN,NaN,507.3494000000017,508.63204513886564,506.0667548611378,506.54776426890555,506.9030742527289,507.5975749543431,506.20857355111474,13348,21590.033333333333,48.35415246284911,52.660199005103856,NaN,NaN,NaN,NaN,0.6013490777876201,13.206913929225431,11980107
2025-08-25T11:40:00-04:00,507.23,507.23,506.95,507.23,505.6760051139441,NaN,NaN,NaN,NaN,NaN,507.3312000000017,508.5941292269884,506.06827077301494,506.54776426890555,506.9067277559103,507.5963852095895,506.2170703022311,6163,20922.866666666665,48.624588746388994,52.3414909904722,NaN,NaN,NaN,NaN,0.5783955722313637,13.034587782494198,11986270
2025-08-25T11:45:00-04:00,507.21,507.64,507.05,507.06,505.6760051139441,NaN,NaN,NaN,NaN,NaN,507.3080000000017,508.5471626173626,506.0688373826408,506.55253224454367,506.9148438156876,507.598292562585,506.2313950687902,9542,20671.166666666668,46.40048188376432,52.08897401153128,NaN,NaN,NaN,NaN,0.5792244599291216,12.395802625695326,11976728
2025-08-25T11:50:00-04:00,507.06,507.4,506.72,506.72,505.6760051139441,NaN,NaN,NaN,NaN,NaN,507.2768000000017,508.494875134185,506.05872486581836,506.55253224454367,506.91583873809435,507.58854163712937,506.24313583905933,13025,19334.133333333335,42.239174387412845,51.62659154909202,NaN,NaN,NaN,NaN,0.5864227127913236,11.993696550427346,11963703
2025-08-25T11:55:00-04:00,506.72,507.285,506.69,507.2,505.6760051139441,NaN,NaN,NaN,NaN,NaN,507.2526000000017,508.4269529931193,506.07824700688406,506.55253224454367,506.917720404027,507.5861649044912,506.2492759035628,5575,14072.766666666666,49.169851974655444,50.94495254291026,NaN,NaN,NaN,NaN,0.5870353761633739,11.687634003729604,11969278
2025-08-25T12:00:00-04:00,507.16,507.38,507.09,507.18,505.6760051139441,NaN,NaN,NaN,NaN,NaN,507.24180000000166,508.40866890117644,506.0749310988269,506.55253224454367,506.92506731820777,507.58686743076595,506.2632672056496,10637,12958.066666666668,48.90653271848068,50.48297891917516,NaN,NaN,NaN,NaN,0.5658185635802772,11.147043374160726,11958641
2025-08-25T12:05:00-04:00,507.14,507.84,507.09,507.48,505.6760051139441,NaN,NaN,NaN,NaN,NaN,507.2336000000017,508.38782708023973,506.0793729197636,506.55253224454367,506.93809758778116,507.5972162317574,506.27897894380493,10603,12058.333333333334,52.97463476524646,50.56193791526296,NaN,NaN,NaN,NaN,0.5789743804674002,11.15765208004826,11969244
2025-08-25T12:10:00-04:00,507.48,507.55,507.17,507.27,505.6760051139441,NaN,NaN,NaN,NaN,NaN,507.2190000000017,508.35235960429634,506.08564039570706,506.55253224454367,506.9425244023079,507.5992171709541,506.28583163366176,5066,11362.033333333333,49.97504163096962,49.936811271654236,NaN,NaN,NaN,NaN,0.5647619247197284,11.167503021229543,11964178
2025-08-25T12:15:00-04:00,507.28,507.42,507.16,507.16,505.6760051139441,NaN,NaN,NaN,NaN,NaN,507.1980000000016,508.2954752811622,506.10052471884103,506.55253224454367,506.9478970578143,507.5999957111042,506.2957984045244,8065,11042.933333333332,48.42818298792003,49.57683668856043,NaN,NaN,NaN,NaN,0.5429932158111758,11.147086993878244,11956113
2025-08-25T12:20:00-04:00,507.21,507.305,507.06,507.18,505.6760051139441,NaN,NaN,NaN,NaN,NaN,507.18180000000166,508.25569339911715,506.10790660088617,506.55253224454367,506.95012547330003,507.5995060097868,506.30074493681326,4394,10791.366666666667,48.73885900321028,49.21993178262274,NaN,NaN,NaN,NaN,0.5217079861103778,10.823152808925283,11960507
2025-08-25T12:25:00-04:00,507.18,507.36,507.13,507.23,505.6760051139441,NaN,NaN,NaN,NaN,NaN,507.1652000000016,508.2095332001032,506.12086679990006,506.55253224454367,506.9526347479675,507.59975590447306,506.305513591462,4025,10448.766666666666,49.5569865365902,48.97616080247705,NaN,NaN,NaN,NaN,0.5008717013882092,10.671104705033606,11964532
2025-08-25T12:30:00-04:00,507.23,507.23,506.9,507.12,505.6760051139441,NaN,NaN,NaN,NaN,NaN,507.1450000000016,508.1523211965055,506.13767880349764,506.55253224454367,506.9549713478246,507.59651567313716,506.31342702251203,8464,10091.833333333334,47.75136833028508,48.56339341913907,NaN,NaN,NaN,NaN,0.48866657986048295,9.996376871688904,11956068
2025-08-25T12:35:00-04:00,507.2,507.4,506.94,507.21,505.6760051139441,NaN,NaN,NaN,NaN,NaN,507.1292000000017,508.10672413401437,506.151675865989,506.53909320736506,506.9579876219499,507.59581405940224,506.3201611844975,6337,9968.166666666666,49.37656945819208,48.489326953486746,NaN,NaN,NaN,NaN,0.48661896701330415,9.68450891099425,11962405
2025-08-25T12:40:00-04:00,507.25,507.26,506.91,506.91,505.6760051139441,NaN,NaN,NaN,NaN,NaN,507.1158000000016,508.086583926948,506.1450160730553,506.53909320736506,506.9593755930866,507.59079801116945,506.3279531750037,9896,9839.033333333333,44.41699108558265,48.20810114082485,NaN,NaN,NaN,NaN,0.4768604693694943,9.299045115098306,11952509
2025-08-25T12:45:00-04:00,506.925,507.18,506.925,506.99,505.6760051139441,NaN,NaN,NaN,NaN,NaN,507.1068000000016,508.0737307280143,506.1398692719889,506.53909320736506,506.961294316407,507.5843892507031,506.33819938211093,13351,9869.333333333334,45.97535604178605,48.03818711074892,NaN,NaN,NaN,NaN,0.4620847215573862,8.941114447480643,11965860
2025-08-25T12:50:00-04:00,507,507.04,506.72,506.86,505.6760051139441,NaN,NaN,NaN,NaN,NaN,507.0912000000016,508.04833647560895,506.13406352439426,506.53909320736506,506.96059520968646,507.58125819762967,506.33993222174325,4030,9787.966666666667,43.82510987246965,47.69536719118326,NaN,NaN,NaN,NaN,0.4519358128747153,8.677684798995484,11961830
2025-08-25T12:55:00-04:00,506.885,506.95,506.8,506.85,505.6760051139441,NaN,NaN,NaN,NaN,NaN,507.0882000000016,508.0473991622641,506.1290008377391,506.44514788975147,506.95960615439265,507.5770671845931,506.3421451241922,5396,9766.666666666666,43.65596920233997,47.49933057108151,NaN,NaN,NaN,NaN,0.4303689690979483,8.433071553973551,11956434
2025-08-25T13:00:00-04:00,506.845,506.87,506.21,506.39,505.6760051139441,NaN,NaN,NaN,NaN,NaN,507.0682000000017,508.04296922017727,506.0934307798261,506.44514788975147,506.94787006594606,507.5619576613793,506.3337824705128,13135,9961.166666666666,36.649007195041946,47.1000329144836,NaN,NaN,NaN,NaN,0.4467711855909538,9.789125003018563,11943299
2025-08-25T13:05:00-04:00,506.38,506.42,505.93,506.17,505.6760051139441,NaN,NaN,NaN,NaN,NaN,507.0492000000016,508.0557075425392,506.04269245746394,506.44514788975147,506.9224758863057,507.5419624570372,506.30298931557417,17816,10255.433333333332,33.85065283161099,46.00580440426614,NaN,NaN,NaN,NaN,0.44985895804874343,11.601976449597327,11925483
2025-08-25T13:10:00-04:00,506.18,506.39,505.94,506.26,505.6760051139441,NaN,NaN,NaN,NaN,NaN,507.04080000000164,508.0663230046168,506.0152769953865,506.44514788975147,506.91164978626836,507.53276161938425,506.29053795315247,8228,10082.066666666668,36.003442595004046,45.08415510973209,NaN,NaN,NaN,NaN,0.4498690324738324,13.28533850713475,11933711
2025-08-25T13:15:00-04:00,506.26,506.26,505.9,506.045,505.6760051139441,NaN,NaN,NaN,NaN,NaN,507.03890000000166,508.0714198074478,506.0063801925555,506.44514788975147,506.8987085261882,507.52369329200997,506.27372376036647,8597,9981.666666666666,33.22192693245084,43.67324740738953,NaN,NaN,NaN,NaN,0.44344981586855964,14.928970283274298,11925114
2025-08-25T13:20:00-04:00,506.15,506.2,505.87,505.92,505.6760051139441,NaN,NaN,NaN,NaN,NaN,507.0297000000017,508.09327022934747,505.9661297706559,506.44514788975147,506.8876692632115,507.51668571879117,506.2586528076318,6941,9861.033333333333,31.689064652322358,42.36710619462902,NaN,NaN,NaN,NaN,0.43534625759223283,16.51821160310242,11918173
2025-08-25T13:25:00-04:00,505.94,505.95,505.75,505.85,505.6760051139441,NaN,NaN,NaN,NaN,NaN,507.0085000000017,508.12186112415736,505.895138875846,506.32111831180123,506.87383434696994,507.50987768787155,506.23779100606833,7664,9677.066666666668,30.831156403693484,41.11017572432712,NaN,NaN,NaN,NaN,0.41853581062135825,18.246543655203023,11910509
2025-08-25T13:30:00-04:00,505.79,505.91,505.1,505.23,NaN,NaN,NaN,506.971834141731,506.971834141731,506.971834141731,506.9677000000016,508.18445339856834,505.7509466014349,506.293894649441,506.82825530396883,507.5038415417037,506.15266906623395,18517,9843.4,24.503558023576588,39.37908279721044,NaN,NaN,NaN,NaN,0.44649753843411855,20.89825441016786,11891992
2025-08-25T13:35:00-04:00,505.3,505.3,504.79,505.15,NaN,NaN,NaN,506.5147053171069,NaN,NaN,506.9287000000017,508.24677709665576,505.61062290334763,506.1798925756422,506.7725036194642,507.5047751592804,506.040232079648,19545,10278.9,23.824121379872665,37.54102100030203,NaN,NaN,NaN,NaN,0.45103342854596656,23.719706136550915,11872447
2025-08-25T13:40:00-04:00,505.18,505.44,504.87,505.02,NaN,NaN,NaN,506.5147053171069,NaN,NaN,506.89710000000167,508.31700857199434,505.477191428009,506.1798925756422,506.74566640340163,507.50161765994204,505.9897151468612,10056,10349.6,22.72157638335669,35.753178718378585,NaN,NaN,NaN,NaN,0.45953104079268275,25.744461931321048,11862391
2025-08-25T13:45:00-04:00,505,505.27,504.88,505.22,NaN,NaN,NaN,506.5147053171069,NaN,NaN,506.89630000000165,508.31993732490383,505.47266267509946,505.92391406051377,506.72230603103895,507.49728104602525,505.94733101605266,9101,10228.266666666666,28.224894243128688,34.242344774445485,NaN,NaN,NaN,NaN,0.4545645378789187,27.62459231217903,11871492
2025-08-25T13:50:00-04:00,505.2,505.4,505.1,505.31,NaN,NaN,NaN,506.5147053171069,NaN,NaN,506.8789000000017,508.35734281341877,505.4004571865846,505.41813124841104,506.70160144918503,507.4900586868775,505.9131442114926,9141,9884.2,30.619323819294678,33.256797112567774,NaN,NaN,NaN,NaN,0.44352421374470696,28.794970644524163,11880633
2025-08-25T13:55:00-04:00,505.3,505.34,505.16,505.22,NaN,NaN,NaN,506.5147053171069,NaN,NaN,506.85120000000165,508.3993854646494,505.3030145353539,505.3635049987288,506.6862990839112,507.48460230815186,505.8879958596705,6784,9495.866666666667,29.55743357040464,32.08408836461196,NaN,NaN,NaN,NaN,0.4247010556200815,29.881750524558935,11873849
2025-08-25T14:00:00-04:00,505.21,505.3,505.01,505.04,NaN,NaN,NaN,506.5147053171069,NaN,NaN,506.82380000000165,508.44883484051314,505.19876515949016,505.25880399898307,506.66326381528637,507.4778568094071,505.8486708211656,9651,9436.433333333332,27.50305862166971,30.918227560983393,NaN,NaN,NaN,NaN,0.41507955164722,31.15566854406576,11864198
2025-08-25T14:05:00-04:00,505.04,505.21,504.82,504.93,NaN,NaN,NaN,506.38138050594335,NaN,NaN,506.7870000000016,508.4963881925957,505.07761180740755,505.23404319918643,506.6301013822871,507.4697066758877,505.79049608868644,13270,9433.833333333334,26.300034938106563,29.678517970681014,NaN,NaN,NaN,NaN,0.41328815510098904,32.64791486935552,11850928
2025-08-25T14:10:00-04:00,504.945,505.32,504.79,505.29,NaN,NaN,NaN,506.38138050594335,NaN,NaN,506.7548000000017,508.51437944768605,504.99522055231733,505.07723455934917,506.59916328614975,507.45690219459783,505.74142437770166,14160,9700.4,36.14437959971005,29.642473142443027,NaN,NaN,NaN,NaN,0.42162471545091645,33.50025955847938,11865088
2025-08-25T14:15:00-04:00,505.34,505.56,505.29,505.49,NaN,NaN,NaN,506.38138050594335,NaN,NaN,506.72280000000166,508.51472986269687,504.93087013730644,504.8067876474794,506.585925622367,507.4475210446849,505.72433020004905,7960,9647.666666666666,40.86980607349456,30.143841231148993,NaN,NaN,NaN,NaN,0.41079437863299256,33.22342048526731,11873048
2025-08-25T14:20:00-04:00,505.53,505.67,505.42,505.58,NaN,NaN,NaN,506.38138050594335,NaN,NaN,506.6882000000016,508.50013792191226,504.8762620780909,504.7979636253946,506.5638934938594,507.4291376709256,505.69864931679314,15159,9718.8,42.91694031224417,30.63766249666614,NaN,NaN,NaN,NaN,0.3993090658734931,32.5165659389686,11888207
2025-08-25T14:25:00-04:00,505.61,505.64,505.34,505.48,NaN,NaN,NaN,506.38138050594335,NaN,NaN,506.65720000000164,508.49750123425923,504.81689876574404,504.7979636253946,506.5512211566998,507.41916752657187,505.6832747868277,8430,9813.966666666667,41.209760437142606,31.208222032715558,NaN,NaN,NaN,NaN,0.3922155611682444,32.06093769390627,11879777
2025-08-25T14:30:00-04:00,505.51,505.58,505.27,505.41,NaN,NaN,NaN,506.38138050594335,NaN,NaN,506.61540000000167,508.4721001245925,504.75869987541085,504.7979636253946,506.5263809209249,507.4006071141211,505.6521547277287,16089,9995.7,40.009980505092905,31.802573165056312,NaN,NaN,NaN,NaN,0.3863430210847985,31.813993208640806,11863688
2025-08-25T14:35:00-04:00,505.41,505.52,505.295,505.42,NaN,NaN,NaN,506.38138050594335,NaN,NaN,506.5796000000017,508.457961880083,504.70123811992033,504.7979636253946,506.5172398744365,507.3936588610084,505.64082088786455,6058,9844.2,40.27748202674752,32.47731070956017,NaN,NaN,NaN,NaN,0.374818519578739,31.584687615180012,11869746
2025-08-25T14:40:00-04:00,505.41,505.54,505.15,505.22,NaN,NaN,NaN,506.38138050594335,NaN,NaN,506.5370000000016,508.43999342956334,504.6340065704399,504.7979636253946,506.49571166633655,507.37897710910124,505.61244622357185,13338,10119.933333333332,36.748113697996025,33.35192182916156,NaN,NaN,NaN,NaN,0.3759029110374036,31.750414238768176,11856408
2025-08-25T14:45:00-04:00,505.2,505.26,505.09,505.2,NaN,NaN,NaN,506.38138050594335,NaN,NaN,506.4996000000017,508.4324909313746,504.56670906862877,504.7979636253946,506.47270622307343,507.36497557511467,505.5804368710322,13419,10298.4,36.404575270371986,34.25052567848294,NaN,NaN,NaN,NaN,0.3611955602490187,32.05550836036793,11842989
2025-08-25T14:50:00-04:00,505.19,505.25,504.93,504.99,NaN,NaN,NaN,506.29956942048574,NaN,NaN,506.46020000000163,508.43382910214586,504.4865708978574,504.7979636253946,506.4498315629385,507.352689178741,505.54697394713605,12569,10570.9,32.92417527344121,34.97928274206041,NaN,NaN,NaN,NaN,0.3582530202312312,32.723729116074466,11830420
2025-08-25T14:55:00-04:00,504.99,505.16,504.67,504.72,NaN,NaN,NaN,506.1364071741,NaN,NaN,506.39520000000164,508.3796938480163,504.410706151987,504.7979636253946,506.4148766345468,507.33793766475753,505.491815604336,17380,11016.066666666668,29.075357047663147,35.04003008524144,NaN,NaN,NaN,NaN,0.36766351878614384,33.88184363310233,11813040
2025-08-25T15:00:00-04:00,504.71,504.75,504.55,504.58,NaN,NaN,NaN,505.84316139345907,NaN,NaN,506.3332000000016,508.3467488652951,504.3196511347081,504.7979636253946,506.38401796506076,507.3282466075346,505.43978932258693,13968,11199.533333333333,27.293700947724815,34.802485594415025,NaN,NaN,NaN,NaN,0.3556875531585613,35.17614990503036,11799072
2025-08-25T15:05:00-04:00,504.61,505,504.5,504.94,NaN,NaN,NaN,505.84316139345907,NaN,NaN,506.2848000000016,508.3135789019575,504.2560210980457,504.7979636253946,506.3551128024403,507.31413609617715,505.3960895087035,15175,11494.133333333333,37.841430424005694,35.39419965538652,NaN,NaN,NaN,NaN,0.36599558507580693,35.08946706130928,11814247
2025-08-25T15:10:00-04:00,504.93,505.24,504.81,504.99,NaN,NaN,NaN,505.84316139345907,NaN,NaN,506.2218000000016,508.2114851592608,504.23211484074244,504.79237090031563,506.3277266202491,507.29568838259974,505.3597648578985,17181,11736.966666666667,39.16156190293192,36.226949889762395,NaN,NaN,NaN,NaN,0.37056732899896405,33.963232984643135,11831428
2025-08-25T15:15:00-04:00,504.99,505.02,504.78,505,NaN,NaN,NaN,505.84316139345907,NaN,NaN,506.16900000000163,508.1454149343898,504.19258506561346,504.7468967202525,506.295201460059,507.27468600039583,505.31571691972215,20104,11962.066666666668,39.438591913499316,37.165418245147585,NaN,NaN,NaN,NaN,0.36124109121332443,33.00099439753449,11851532
2025-08-25T15:20:00-04:00,505.01,505.37,504.93,505.2,NaN,NaN,NaN,505.84316139345907,NaN,NaN,506.1196000000016,508.0667341384254,504.1724658615778,504.741017376202,506.2739722247204,507.2562399164307,505.29170453301015,16524,12378.533333333333,44.84771599743282,37.78708513069922,NaN,NaN,NaN,NaN,0.3668667275552297,30.7812950183883,11868056
2025-08-25T15:25:00-04:00,505.215,505.3,505.12,505.24,NaN,NaN,NaN,505.84316139345907,NaN,NaN,506.07240000000166,507.9878605066804,504.1569394933229,504.7218139009616,506.25558669891115,507.2389781532908,505.2721952445315,15595,12718.5,45.888675474966796,38.14557580223295,NaN,NaN,NaN,NaN,0.3535191041584281,28.720145594895406,11883651
2025-08-25T15:30:00-04:00,505.265,505.48,505.1,505.12,NaN,NaN,NaN,505.84316139345907,NaN,NaN,506.0217000000016,507.9007695657335,504.1426304342697,504.6420772600847,506.24044291389555,507.2243047325419,505.2565810952492,13443,12728.766666666666,43.25128018731542,38.1694572218809,NaN,NaN,NaN,NaN,0.35541059671854003,27.143991360437063,11870208
2025-08-25T15:35:00-04:00,505.11,505.39,505.11,505.36,NaN,NaN,NaN,505.84316139345907,NaN,NaN,505.9811000000016,507.82759861979224,504.134601380211,504.6420772600847,506.22028278535265,507.2033115017408,505.2372540689645,19595,12788.066666666668,49.50236538493147,38.76178614672296,NaN,NaN,NaN,NaN,0.35002412552435663,25.68041957129717,11889803
2025-08-25T15:40:00-04:00,505.37,505.4,504.99,505.07,NaN,NaN,NaN,505.84316139345907,NaN,NaN,505.9383000000016,507.76800555906624,504.108594440937,504.6420772600847,506.2068860820796,507.19092169088515,505.2228504732741,11788,12906.733333333334,43.29623468098136,38.99651858785785,NaN,NaN,NaN,NaN,0.3543081165583289,23.85589911650803,11878015
2025-08-25T15:45:00-04:00,505.1,505.115,504.65,505.03,NaN,NaN,NaN,505.84316139345907,NaN,NaN,505.8947000000016,507.70490485937677,504.0844951406264,504.6420772600847,506.1719779363088,507.16450797014585,505.17944790247174,26423,13500.933333333332,42.504684522370624,39.15560448040235,NaN,NaN,NaN,NaN,0.36221467966130766,23.266104821618462,11851592
2025-08-25T15:50:00-04:00,505.13,505.3,504.77,504.81,NaN,NaN,NaN,505.84316139345907,NaN,NaN,505.84630000000163,507.6404447078671,504.05215529213615,504.6420772600847,506.13021163806815,507.1302331043138,505.1301901718225,34451,14417.933333333332,38.35170007663948,39.27014636459118,NaN,NaN,NaN,NaN,0.3741993453997878,22.0222222623837,11817141
2025-08-25T15:55:00-04:00,504.79,505.21,504.15,504.17,NaN,NaN,NaN,505.84316139345907,NaN,NaN,505.7885000000016,507.6085398328098,503.96846016719337,504.6420772600847,505.93804768626353,507.0131536805657,504.86294169196134,134524,18646.6,29.363490919363997,38.7672117680906,NaN,NaN,NaN,NaN,0.4231851064426602,22.43619716120373,11682617
2025-08-26T09:30:00-04:00,504.14,504.7,502.6,503.695,NaN,NaN,NaN,505.1522635664669,NaN,NaN,505.72800000000166,507.61985305787476,503.83614694212855,504.6420772600847,503.66499999999996,503.66499999999996,503.66499999999996,48295,19639.2,24.73087449928306,38.18197599850788,NaN,NaN,NaN,NaN,0.5429575988396106,24.809773401148185,11634322
2025-08-26T09:35:00-04:00,503.7,504.93,503.25,504.65,NaN,NaN,NaN,505.1522635664669,NaN,NaN,505.67700000000167,507.54470661310086,503.8092933869025,504.6420772600847,503.916544738243,504.21752110974893,503.615568366737,33734,20112.166666666668,43.89584408244308,39.240582215277875,NaN,NaN,NaN,NaN,0.6241749132082103,26.368101726139347,11668056
2025-08-26T09:40:00-04:00,504.65,504.92,503.83,504.06,NaN,NaN,NaN,505.1522635664669,NaN,NaN,505.61460000000164,507.4857513441876,503.7434486558157,504.6420772600847,503.9897794304786,504.293653385671,503.68590547528623,21438,20491.566666666666,37.53692523194094,39.97224109272189,NaN,NaN,NaN,NaN,0.6574481336933404,27.815120885059713,11646618
2025-08-26T09:45:00-04:00,504.05,504.05,502.12,502.34,NaN,NaN,NaN,505.00674332166136,NaN,NaN,505.5118000000017,507.52137682922466,503.50222317077873,504.6420772600847,503.7846855011084,504.30463617450073,503.2647348277161,22384,20934.333333333332,25.802110681427394,39.11228968253772,NaN,NaN,NaN,NaN,0.749058981286673,30.430824201027658,11624234
2025-08-26T09:50:00-04:00,502.29,503.05,502.29,502.64,NaN,NaN,NaN,504.6080277161313,NaN,NaN,505.41920000000164,507.52076547195026,503.317634528053,504.5796618080678,503.6002775139006,504.2322711205603,502.9682839072409,24682,21452.366666666665,29.917443489099753,38.45199551012114,NaN,NaN,NaN,NaN,0.7498404826233386,32.85969156585504,11648916
2025-08-26T09:55:00-04:00,502.61,503.16,502.5,502.955,NaN,NaN,NaN,504.6080277161313,NaN,NaN,505.3351000000016,507.4872240561082,503.18297594389503,504.5467294464542,503.5140166600292,504.15240399514914,502.87562932490926,20215,21900.066666666666,34.05343440900418,38.06734140265719,NaN,NaN,NaN,NaN,0.7434233052931019,34.829797991404945,11669131
2025-08-26T10:00:00-04:00,502.94,504.25,502.81,504.15,NaN,NaN,NaN,504.6080277161313,NaN,NaN,505.27450000000164,507.385663895274,503.1633361047293,504.3029068457307,503.5354245892267,504.14588466964466,502.9249645088087,18164,22183.833333333332,46.86476602591152,38.211416404691384,NaN,NaN,NaN,NaN,0.7931787834864517,34.30029344347837,11687295
2025-08-26T10:05:00-04:00,504.15,504.22,503.45,503.58,NaN,NaN,NaN,504.6080277161313,NaN,NaN,505.2015000000017,507.289437976229,503.1135620237744,504.3029068457307,503.54729531191396,504.14265353387066,502.95193708995726,11063,22110.266666666666,42.612408199530826,37.97739731358882,NaN,NaN,NaN,NaN,0.7915231560945649,33.808610648975105,11676232
2025-08-26T10:10:00-04:00,503.59,504.06,503,503.48,NaN,NaN,NaN,504.6080277161313,NaN,NaN,505.1287000000017,507.1977382385372,503.05966176146615,503.8823254765845,503.54545165063473,504.1244757129398,502.9664275883297,11479,22020.9,41.894205333587614,37.880463395465405,NaN,NaN,NaN,NaN,0.8107000735163818,33.817164902581254,11664753
2025-08-26T10:15:00-04:00,503.46,503.87,503.35,503.53,NaN,NaN,NaN,504.6080277161313,NaN,NaN,505.0551000000017,507.0841820467984,503.026017953205,502.58786038126766,503.5476269227111,504.1098497084552,502.985404136967,12882,22184.966666666667,42.41679590450827,37.37435128972089,NaN,NaN,NaN,NaN,0.7899357825509247,33.82510813807267,11677635
2025-08-26T10:20:00-04:00,503.55,504.43,503.47,504.38,NaN,NaN,NaN,504.6080277161313,NaN,NaN,505.0045000000017,506.97125900722034,503.0377409927831,502.4002883050141,503.5721663920805,504.1331204028512,503.01121238130975,10563,22031.766666666666,50.55772826446559,37.89302940282691,NaN,NaN,NaN,NaN,0.8020832266544285,32.73584176268764,11688198
2025-08-26T10:25:00-04:00,504.4,504.7,504.29,504.4,502.41355930434776,502.41355930434776,502.41355930434776,NaN,NaN,NaN,504.9527000000017,506.84247904330635,503.06292095669704,502.60590172208316,503.60193234190336,504.1762140836394,503.0276506001673,8117,22021.333333333332,50.734218000614895,38.4808532227015,NaN,NaN,NaN,NaN,0.7740772818933956,31.248566189341364,11696315
2025-08-26T10:30:00-04:00,504.38,504.44,503.6,503.69,502.41355930434776,NaN,NaN,NaN,NaN,NaN,504.88930000000175,506.730961215428,503.0476387845755,502.60590172208316,503.6095241134068,504.1786931122125,503.0403551146011,6140,21689.7,44.641971848028625,38.930158349229295,NaN,NaN,NaN,NaN,0.778786047472437,30.710051703981968,11690175
2025-08-26T10:35:00-04:00,503.725,503.98,503.53,503.58,502.41355930434776,NaN,NaN,NaN,NaN,NaN,504.82390000000174,506.61392825464793,503.03387174535555,502.60590172208316,503.611760949476,504.173746543514,503.04977535543793,6564,21706.566666666666,43.76512515931388,39.95884650922572,NaN,NaN,NaN,NaN,0.7553013297958376,30.288575690803697,11683611
2025-08-26T10:40:00-04:00,503.51,503.81,503.28,503.51,502.41355930434776,NaN,NaN,NaN,NaN,NaN,504.7663000000017,506.5362783141846,502.9963216858188,502.60590172208316,503.6092626343699,504.16239624821367,503.0561290205261,8414,21542.433333333334,43.183836885630775,41.276915251107695,NaN,NaN,NaN,NaN,0.7392083776675656,30.17940224173422,11675197
2025-08-26T10:45:00-04:00,503.59,503.63,502.98,503.15,502.41355930434776,NaN,NaN,NaN,NaN,NaN,504.7059000000017,506.48623557306615,502.9255644269372,502.60590172208316,503.58860800648586,504.13186397935414,503.0453520336176,16272,21637.533333333333,40.22482509460366,41.01469960911917,NaN,NaN,NaN,NaN,0.7328363506913094,30.401580688878262,11658925
2025-08-26T10:50:00-04:00,503.2,503.2,502.82,503.19,502.41355930434776,NaN,NaN,NaN,NaN,NaN,504.6445000000017,506.41795228090734,502.87104771909605,502.60590172208316,503.5707448001497,504.1128761944361,503.0286134058633,10003,21552,40.71094363042235,41.2414152090107,NaN,NaN,NaN,NaN,0.7076337542133583,30.775777631213195,11668928
2025-08-26T10:55:00-04:00,503.26,503.45,502.72,502.78,502.41355930434776,NaN,NaN,NaN,NaN,NaN,504.5792000000017,506.3817741129445,502.7766258870589,502.60590172208316,503.5551847791958,504.09834142498414,503.0120281334075,7902,21236.066666666666,37.357381889199395,42.06679172385155,NaN,NaN,NaN,NaN,0.7092313431981155,30.58098460883179,11661026
2025-08-26T11:00:00-04:00,502.77,503,502.53,503,502.41355930434776,NaN,NaN,NaN,NaN,NaN,504.52080000000177,506.3349999427684,502.70660005723516,502.60590172208316,503.5262505761913,504.0765117325151,502.97598941986746,12639,21191.766666666666,40.20375956408606,42.80152858635057,NaN,NaN,NaN,NaN,0.6921433901125378,30.62522060983176,11673665
2025-08-26T11:05:00-04:00,503.01,503.08,502.8,502.86,502.41355930434776,NaN,NaN,NaN,NaN,NaN,504.46100000000183,506.293030565279,502.62896943472464,502.60590172208316,503.51220845208513,504.0638060109992,502.96061089317107,7291,20928.966666666667,38.989638833869336,43.15411461669809,NaN,NaN,NaN,NaN,0.6627045765330689,30.48378940472804,11666374
2025-08-26T11:10:00-04:00,502.9,503.05,502.75,503.05,502.41355930434776,NaN,NaN,NaN,NaN,NaN,504.4174000000018,506.2776948562503,502.5571051437533,502.60590172208316,503.5004078581449,504.0521040421455,502.9487116741443,6823,20583.7,41.56863950077162,42.775819864902374,NaN,NaN,NaN,NaN,0.6367971067807077,30.418404859604138,11673197
2025-08-26T11:15:00-04:00,503.08,503.18,502.78,503.01,502.41355930434776,NaN,NaN,NaN,NaN,NaN,504.37460000000175,506.263752019376,502.4854479806275,502.3447213776666,503.4897446385542,504.04050668144157,502.93898259566686,6936,20144.766666666666,41.17403470550672,42.67307890104352,NaN,NaN,NaN,NaN,0.6198830277249453,30.034129185652837,11666261
2025-08-26T11:20:00-04:00,503.06,503.26,503,503.2,502.41355930434776,NaN,NaN,NaN,NaN,NaN,504.33820000000173,506.2462479638681,502.4301520361354,502.16885855982673,503.48245828790334,504.0294198182208,502.9354967575859,7350,19838.966666666667,43.89830876125343,42.81622914587678,NaN,NaN,NaN,NaN,0.5941770971731629,29.475053278572823,11673611
2025-08-26T11:25:00-04:00,503.18,503.32,502.7,502.7,502.41355930434776,NaN,NaN,NaN,NaN,NaN,504.2878000000017,506.23278756621005,502.34281243379337,502.16885855982673,503.4674838815843,504.01500967432827,502.91995808884036,9061,19621.166666666668,38.805305796541354,42.55826556673629,NaN,NaN,NaN,NaN,0.5960215902322231,29.421490492319474,11664550
2025-08-26T11:30:00-04:00,502.68,502.68,502.15,502.25,NaN,NaN,NaN,504.2136708284323,504.2136708284323,504.2136708284323,504.2266000000018,506.2307491342311,502.2224508657725,502.16885855982673,503.4295296699235,504.00407630385945,502.8549830359876,12364,19585.2,34.882791256778305,41.43862720904434,NaN,NaN,NaN,NaN,0.5927343337870651,30.094407604902564,11652186
2025-08-26T11:35:00-04:00,502.23,502.59,502.12,502.47,NaN,NaN,NaN,504.13600397259455,NaN,NaN,504.1716000000018,506.21424968908906,502.1289503109145,502.16885855982673,503.4004665046634,503.9921721596747,502.8087608496522,10411,19279.066666666666,38.17316562149128,40.541409181964084,NaN,NaN,NaN,NaN,0.5839675956594155,30.755382079859434,11662597
2025-08-26T11:40:00-04:00,502.45,502.58,502.23,502.5,NaN,NaN,NaN,504.13600397259455,NaN,NaN,504.12080000000174,506.20053686618144,502.04106313382204,502.16885855982673,503.3896500434649,503.9867214284069,502.79257865852287,4213,19026.566666666666,38.62857190996428,40.11188061495949,NaN,NaN,NaN,NaN,0.5672556245408834,31.369144092319384,11666810
2025-08-26T11:45:00-04:00,502.53,502.58,502.23,502.31,NaN,NaN,NaN,504.12105940478136,NaN,NaN,504.06840000000176,506.19543026597023,501.9413697340333,502.16885855982673,503.3715836327022,503.97837179100486,502.76479547439953,6794,18372.266666666666,36.780751982177954,39.612996816592634,NaN,NaN,NaN,NaN,0.5517373656451036,31.939065961032203,11660016
2025-08-26T11:50:00-04:00,502.35,502.52,502.13,502.32,NaN,NaN,NaN,504.0162385227458,NaN,NaN,504.0090000000018,506.1619774714058,501.85602252859775,502.16885855982673,503.3564594916123,503.9716868865614,502.7412320966633,5595,17410.4,36.95169661922666,39.167843940420916,NaN,NaN,NaN,NaN,0.5401846966704523,32.612460535532094,11665611
2025-08-26T11:55:00-04:00,502.35,502.44,502.2,502.32,NaN,NaN,NaN,503.9670913171665,NaN,NaN,503.9456000000018,506.1070769377438,501.78412306225977,502.16885855982673,503.33995247810856,503.96390193026866,502.71600302594845,6276,13135.466666666667,36.95169661922666,38.93404904932255,NaN,NaN,NaN,NaN,0.5187429326225635,33.237755497567704,11665611
2025-08-26T12:00:00-04:00,502.36,502.77,502.36,502.67,NaN,NaN,NaN,503.9670913171665,NaN,NaN,503.8874000000018,506.02630274496966,501.7484972550339,502.16885855982673,503.3301343222416,503.9556867519229,502.70458189256027,5299,11702.266666666666,43.18743599853019,39.11094136133027,NaN,NaN,NaN,NaN,0.5138327231495224,32.677540238658445,11670910
2025-08-26T12:05:00-04:00,502.67,502.68,502.43,502.52,NaN,NaN,NaN,503.9670913171665,NaN,NaN,503.8282000000018,505.9513012769775,501.7050987230261,502.16885855982673,503.31878496146845,503.9468551109082,502.6907148120287,5845,10772.633333333333,41.30207582339216,39.39270521377261,NaN,NaN,NaN,NaN,0.49498752863884227,32.15734035538556,11665065
2025-08-26T12:10:00-04:00,502.54,502.77,502.435,502.75,NaN,NaN,NaN,503.9670913171665,NaN,NaN,503.77500000000174,505.870011215389,501.67998878461447,502.1370868478614,503.3037119419486,503.9325104891421,502.67491339475515,9367,10370.266666666666,45.24892744377424,39.753074348036044,NaN,NaN,NaN,NaN,0.4835598480217806,31.36526199279356,11674432
2025-08-26T12:15:00-04:00,502.75,502.77,502.5,502.6,NaN,NaN,NaN,503.9670913171665,NaN,NaN,503.71860000000174,505.7850743290464,501.6521256709571,501.9068243746389,503.285054617952,503.9150476756741,502.65506156022997,11689,10013.766666666666,43.208391440523876,40.054413819939946,NaN,NaN,NaN,NaN,0.46830557316308064,30.629760656100984,11662743
2025-08-26T12:20:00-04:00,502.61,502.61,502.2,502.22,NaN,NaN,NaN,503.9235429859041,NaN,NaN,503.6586000000018,505.7214243144764,501.5957756855272,501.9068243746389,503.2688464571196,503.9052905948739,502.63240231936527,7465,9439.866666666667,38.47481365140687,39.833426259271036,NaN,NaN,NaN,NaN,0.46414088936571957,30.610311768770952,11655278
2025-08-26T12:25:00-04:00,502.2,502.32,502.09,502.29,NaN,NaN,NaN,503.68588194109026,NaN,NaN,503.60040000000186,505.65014811918735,501.55065188081636,501.9068243746389,503.2519373980846,503.89666250904645,502.6072122871227,7200,9006.033333333333,39.78350142605748,39.73410245359609,NaN,NaN,NaN,NaN,0.44741654012531235,30.813155981067435,11662478
2025-08-26T12:30:00-04:00,502.26,502.26,501.71,501.88,NaN,NaN,NaN,503.4776600346771,NaN,NaN,503.5382000000019,505.60418524488836,501.47221475511543,501.9068243746389,503.1702400999044,503.86972364809156,502.4707565517172,29521,9384.6,35.0772115846798,39.10402408384083,NaN,NaN,NaN,NaN,0.45688678725922155,31.675492875278348,11632957
2025-08-26T12:35:00-04:00,501.9,501.9,501.3,501.3,NaN,NaN,NaN,503.1066300331009,NaN,NaN,503.46980000000184,505.6002018006468,501.3393981993569,501.9068243746389,503.12207939217785,503.8659137901787,502.378244994177,13968,9481.433333333332,29.720893619674797,38.45513749977893,NaN,NaN,NaN,NaN,0.46710915959784616,33.05326404952382,11618989
2025-08-26T12:40:00-04:00,501.29,501.5,501.21,501.24,NaN,NaN,NaN,502.8326923043236,NaN,NaN,503.40300000000184,505.59843161872084,501.20756838128284,501.9068243746389,503.07874564554703,503.86383606568455,502.2936552254095,11913,9495.9,29.223746283770794,38.05092000170697,NaN,NaN,NaN,NaN,0.45445850534085863,34.445948203580286,11607076
2025-08-26T12:45:00-04:00,501.27,501.28,500.79,500.96,NaN,NaN,NaN,502.512342654127,NaN,NaN,503.32340000000187,505.57796109969587,501.06883890030787,501.9068243746389,502.9741943472023,503.863337629286,502.0850510651186,26419,9947.133333333333,26.957561485235843,37.24980542054586,NaN,NaN,NaN,NaN,0.4569971835307939,36.21318060959423,11580657
2025-08-26T12:50:00-04:00,500.96,500.96,500.37,500.45,NaN,NaN,NaN,502.1556452607576,NaN,NaN,503.23260000000175,505.5753285273442,500.8898714726593,501.9068243746389,502.88091442643594,503.86731552912056,501.8945133237513,21316,10305.566666666668,23.398437491766273,36.161938676388864,NaN,NaN,NaN,NaN,0.46649738470716395,38.235794158992285,11559341
2025-08-26T12:55:00-04:00,500.43,500.89,500.42,500.85,NaN,NaN,NaN,502.14197956708676,NaN,NaN,503.1496000000017,505.5297401960448,500.7694598039586,501.9068243746389,502.8213874867882,503.85641083018345,501.7863641433929,15412,10548.733333333334,31.083704121861203,35.75500668636624,NaN,NaN,NaN,NaN,0.466747571513793,40.113935312004756,11574753
2025-08-26T13:00:00-04:00,500.82,501.09,500.75,501.03,NaN,NaN,NaN,502.14197956708676,NaN,NaN,503.0662000000018,505.44534485321736,500.68705514678624,501.9068243746389,502.7655350644036,503.83334405935966,501.6977260694475,17275,10919.9,34.27908133341032,35.56410559452222,NaN,NaN,NaN,NaN,0.4576941735485202,41.0655932164139,11592028
2025-08-26T13:05:00-04:00,501.02,501.05,500.7,500.76,NaN,NaN,NaN,502.14197956708676,NaN,NaN,502.9766000000018,505.3589664186376,500.594233581366,501.71445949971115,502.71679699365444,503.8136284920633,501.6199654952456,14951,11199.466666666667,31.890513080242258,35.20259248459476,NaN,NaN,NaN,NaN,0.4500017325807704,42.00856994837473,11577077
2025-08-26T13:10:00-04:00,500.75,500.75,500.21,500.45,NaN,NaN,NaN,501.9360891971066,NaN,NaN,502.8832000000018,505.28818212726725,500.47821787273637,501.4885675997689,502.6644053182048,503.8001671654707,501.52864347093885,14127,11389.9,29.360865893918856,34.21498033426538,NaN,NaN,NaN,NaN,0.45714446596785907,43.4014874197254,11562950
2025-08-26T13:15:00-04:00,500.46,500.71,500.24,500.45,NaN,NaN,NaN,501.92899423360177,NaN,NaN,502.78500000000184,505.1783741855993,500.3916258144044,501.3048540798151,502.62995094072915,503.78937610476805,501.47052577669024,9649,11169.133333333333,29.36086589391884,33.36203676787442,NaN,NaN,NaN,NaN,0.45806271839872414,44.694910785979594,11562950
2025-08-26T13:20:00-04:00,500.45,500.55,500.31,500.46,NaN,NaN,NaN,501.8506308593471,NaN,NaN,502.6928000000018,505.0821489976212,500.3034510023824,500.83588326385205,502.6051155026182,503.78103789065653,501.4291931145799,7060,11071.033333333333,29.56987469837594,32.24210442891741,NaN,NaN,NaN,NaN,0.44248680994167305,45.89594676892991,11570010
2025-08-26T13:25:00-04:00,500.47,500.62,500.33,500.37,NaN,NaN,NaN,501.8506308593471,NaN,NaN,502.59960000000183,504.98054001444217,500.2186599855615,500.50370661108167,502.5709640768548,503.76836018781046,501.37356796589916,9977,11140.2,28.745515463166228,31.209041859106147,NaN,NaN,NaN,NaN,0.4315948949458407,46.69419016798453,11560033
2025-08-26T13:30:00-04:00,500.4,500.56,499.6,499.81,NaN,NaN,NaN,501.5430748119258,NaN,NaN,502.4996000000018,504.9204583916734,500.07874160833023,500.2379652888653,502.35576560785904,503.7060697120885,501.0054615036296,57536,12636.766666666666,24.220848860138673,30.190901516872707,NaN,NaN,NaN,NaN,0.4693381167354221,48.158543849966065,11502497
2025-08-26T13:35:00-04:00,499.77,499.94,499.77,499.92,NaN,NaN,NaN,501.27475322956553,NaN,NaN,502.4146000000018,504.8926604012891,499.93653959871455,500.01074258231927,502.29609105660467,503.68310582095523,500.9090762922541,17020,12961.066666666668,26.66276288504345,29.253705906800274,NaN,NaN,NaN,NaN,0.44795682268289305,49.518300840377485,11519517
2025-08-26T13:40:00-04:00,499.91,500.08,499.72,499.79,NaN,NaN,NaN,501.27475322956553,NaN,NaN,502.33650000000193,504.89312140177145,499.7798785982324,500.01074258231927,502.2397715877116,503.658613581982,500.8209295934411,16757,13292.2,25.612337520780244,28.577643473664597,NaN,NaN,NaN,NaN,0.4416741924912548,50.18573184757747,11502760
2025-08-26T13:45:00-04:00,499.78,499.84,499.39,499.49,NaN,NaN,NaN,501.0168412690876,NaN,NaN,502.23330000000186,504.8243874998991,499.6422125001046,500.01074258231927,502.1678953763276,503.63259147321384,500.7031992794413,20052,13729.4,23.328288058040656,28.12102879069073,NaN,NaN,NaN,NaN,0.4422688930275929,51.13548871935125,11482708
2025-08-26T13:50:00-04:00,499.51,499.56,498.64,498.79,NaN,NaN,NaN,500.5635757568564,NaN,NaN,502.12790000000183,504.83914627288965,499.416653727114,500.01074258231927,502.03074081243216,503.6019463297908,500.4595352950735,33627,14605.3,19.057695486876298,27.394882305198262,NaN,NaN,NaN,NaN,0.47639254352562316,52.57980084267062,11449081
2025-08-26T13:55:00-04:00,498.79,499.21,498.79,498.9,NaN,NaN,NaN,500.45432231336287,NaN,NaN,502.0591000000019,504.9159987997692,499.2022012002345,499.66212016171795,501.96401728322365,503.581089410251,500.3469451561963,17308,14880.2,21.489954538360124,27.00433895185,NaN,NaN,NaN,NaN,0.47236450470236147,53.920947814324315,11466389
2025-08-26T14:00:00-04:00,498.88,499.49,498.82,499.28,NaN,NaN,NaN,500.45432231336287,NaN,NaN,501.99190000000186,504.94734980537135,499.0364501946324,499.66212016171795,501.8958166421238,503.5494677355949,500.24216554865274,20083,15137.5,29.384218237645825,27.43189471941282,NaN,NaN,NaN,NaN,0.48648132579505105,54.12123498899558,11486472
2025-08-26T14:05:00-04:00,499.31,499.75,499.27,499.68,NaN,NaN,NaN,500.45432231336287,NaN,NaN,501.9264000000019,504.9381948389696,498.91460516103416,499.66212016171795,501.8580754605898,503.5244283645981,500.1917225565815,13422,15237.866666666667,36.609751923146796,27.82661241950465,NaN,NaN,NaN,NaN,0.48601837395254865,53.426574932372716,11499894
2025-08-26T14:10:00-04:00,499.69,499.8,499.01,499.71,NaN,NaN,NaN,500.45432231336287,NaN,NaN,501.8376000000019,504.8437285654479,498.83147143455585,499.66212016171795,501.8189631515486,503.49854176104975,500.1393845420474,14011,15564.466666666667,37.12934349841425,28.03020257414779,NaN,NaN,NaN,NaN,0.5077313472416538,53.09172846025542,11513905
2025-08-26T14:15:00-04:00,499.7,499.85,499.62,499.64,NaN,NaN,NaN,500.45432231336287,NaN,NaN,501.75880000000194,504.7845974538744,498.73300254612946,499.31369612937436,501.8028664476886,503.4861122695131,500.11962062586406,6458,15553.266666666666,36.3800289608635,28.35088227990645,NaN,NaN,NaN,NaN,0.4878933938672513,52.6116909870079,11507447
2025-08-26T14:20:00-04:00,499.6,499.6,498.87,498.88,NaN,NaN,NaN,500.45432231336287,NaN,NaN,501.66680000000196,504.75671764160313,498.5768823584008,499.0343655227996,501.74540098761054,503.455303095463,500.03549887975805,18555,15985.266666666666,29.43451992452198,28.356143282092386,NaN,NaN,NaN,NaN,0.5080438657338748,52.949438138388004,11488892
2025-08-26T14:25:00-04:00,498.91,498.99,498.72,498.81,NaN,NaN,NaN,500.34118200339,NaN,NaN,501.57240000000195,504.71678053547197,498.4280194645319,499.0343655227996,501.6883837887755,503.42872700051055,499.9480405770405,17362,16354.8,28.887479004108414,28.322329932820214,NaN,NaN,NaN,NaN,0.4910407324671682,53.39163357515283,11471530
2025-08-26T14:30:00-04:00,498.82,499,498.51,498.64,NaN,NaN,NaN,500.24044645778133,NaN,NaN,501.457600000002,504.602710642179,498.31248935782503,498.7784924182397,501.6346131863725,503.40404554439664,499.8651808283484,16303,16721.6,27.548433515481037,28.177941276899144,NaN,NaN,NaN,NaN,0.49096639443379964,53.976807670434354,11455227
2025-08-26T14:35:00-04:00,498.645,498.92,498.63,498.845,NaN,NaN,NaN,500.23247161879124,NaN,NaN,501.346500000002,504.4603055481574,498.23269445184656,498.57886335648703,501.5978379016418,503.3848041094097,499.81087169387393,11836,16921.3,31.66217023681608,28.38627376073128,NaN,NaN,NaN,NaN,0.476611651974244,54.52018361605292,11467063
2025-08-26T14:40:00-04:00,498.855,499.22,498.75,499.12,NaN,NaN,NaN,500.23247161879124,NaN,NaN,501.25510000000196,504.3566470255954,498.1535529744085,498.57886335648703,501.5518241630205,503.35517275956767,499.74847556647336,16656,17164.266666666666,36.8427177719926,29.287835825863706,NaN,NaN,NaN,NaN,0.4761393911189428,53.98412644355262,11483719
2025-08-26T14:45:00-04:00,499.11,499.4,499.11,499.33,NaN,NaN,NaN,500.23247161879124,NaN,NaN,501.170100000002,504.24495966376105,498.0952403362429,498.57886335648703,501.5187523933616,503.3294881984045,499.7080165883187,13731,17232.333333333332,40.5490517476978,30.279713601767586,NaN,NaN,NaN,NaN,0.46284372032473003,52.908261846759686,11497450
2025-08-26T14:50:00-04:00,499.33,499.4,498.7,498.74,NaN,NaN,NaN,500.23247161879124,NaN,NaN,501.074700000002,504.14923697844506,498.00016302155893,498.57886335648703,501.474743148746,503.3006462523535,499.64884004513846,16420,17530.833333333332,34.43488648303432,30.90989567050002,NaN,NaN,NaN,NaN,0.4797834545872485,52.428292876183136,11481030
2025-08-26T14:55:00-04:00,498.73,499.15,498.7,499.01,NaN,NaN,NaN,500.23247161879124,NaN,NaN,500.991900000002,504.06140216678966,497.9223978332143,498.57886335648703,501.4248595538614,503.26639489434467,499.5833242133781,19369,17936.466666666667,38.97007887520725,32.027166443154776,NaN,NaN,NaN,NaN,0.47765606497387286,51.98260740350491,11500399
2025-08-26T15:00:00-04:00,499.01,499.24,498.98,499.01,NaN,NaN,NaN,500.23247161879124,NaN,NaN,500.90830000000193,503.96142797506,497.85517202494384,498.57886335648703,501.3894318474478,503.23930314013364,499.5395605547619,14997,17452.333333333332,38.97007887520725,33.44947954232128,NaN,NaN,NaN,NaN,0.4621092031900242,51.261779546819106,11500399
2025-08-26T15:05:00-04:00,499,499.16,498.77,498.96,NaN,NaN,NaN,500.23247161879124,NaN,NaN,500.8319000000019,503.8850379844542,497.7787620155496,498.3340863557229,501.3562945750665,503.2149445484275,499.4976446017055,13765,17445.566666666666,38.39961858886679,34.657312688786035,NaN,NaN,NaN,NaN,0.4569585458193113,50.87796445290278,11486634
2025-08-26T15:10:00-04:00,498.95,499.46,498.94,499.44,NaN,NaN,NaN,500.23247161879124,NaN,NaN,500.760700000002,503.7740556099331,497.74734439007085,498.3529614170433,501.3253960115047,503.18721498356643,499.463577039443,15224,17555.933333333334,46.496734181107904,35.879635256176186,NaN,NaN,NaN,NaN,0.4614615068322164,49.52427981776821,11501858
2025-08-26T15:15:00-04:00,499.45,499.75,499.22,499.36,NaN,NaN,NaN,500.23247161879124,NaN,NaN,500.690700000002,503.6681324562886,497.71326754371535,498.59936913363464,501.29198504301826,503.1538655549141,499.4301045311224,18489,17291.6,45.425028387818664,36.509297860795606,NaN,NaN,NaN,NaN,0.4663571134870561,47.413508353430664,11483369
2025-08-26T15:20:00-04:00,499.36,500.16,499.36,499.64,NaN,NaN,NaN,500.23247161879124,NaN,NaN,500.622500000002,503.5361768852895,497.7088231147145,498.83949530690774,501.26781003184396,503.12541756427106,499.41020249941687,16267,17123.3,49.78736217372499,37.41344205188923,NaN,NaN,NaN,NaN,0.49018874823798153,44.41466934008999,11499636
2025-08-26T15:25:00-04:00,499.64,499.93,499.475,499.84,NaN,NaN,NaN,500.23247161879124,NaN,NaN,500.559100000002,503.3992420301888,497.71895796981516,498.83949530690774,501.24874293670604,503.10239154105346,499.3950943323586,13442,17057.633333333335,52.69593842195214,38.5788641562527,NaN,NaN,NaN,NaN,0.4876752662209817,41.630033113416516,11513078
2025-08-26T15:30:00-04:00,499.83,500.1,499.68,499.71,NaN,NaN,NaN,500.23247161879124,NaN,NaN,500.48930000000195,503.2364163120491,497.7421836879548,498.86287699642094,501.2193529697852,503.0647980276744,499.37390791189597,22660,17237.133333333335,50.6425049556207,40.093720229902615,NaN,NaN,NaN,NaN,0.48284131863376983,38.683433172697086,11490418
2025-08-26T15:35:00-04:00,499.7,499.71,498.86,498.97,NaN,NaN,NaN,500.23247161879124,NaN,NaN,500.414700000002,503.11989382519204,497.7095061748119,498.86287699642094,501.17052104395276,503.0202021966502,499.32083989125533,26835,17633.266666666666,40.87771047793068,40.95016533517563,NaN,NaN,NaN,NaN,0.5090669387313552,37.4884679092384,11463583
2025-08-26T15:40:00-04:00,498.95,499.18,498.67,498.685,NaN,NaN,NaN,500.23247161879124,NaN,NaN,500.343400000002,503.0392526947028,497.64754730530126,498.86287699642094,501.11459240855544,502.9763048010836,499.2528800160273,27617,18082.933333333334,37.85066293707069,41.68603886528918,NaN,NaN,NaN,NaN,0.5091335859648292,36.67205818868387,11435966
2025-08-26T15:45:00-04:00,498.68,499.24,498.55,499.11,NaN,NaN,NaN,500.23247161879124,NaN,NaN,500.276200000002,502.9237396563026,497.6286603437014,498.86287699642094,501.0585587552308,502.9274545246848,499.18966298577686,30759,18786.6,44.456048934006915,42.59988734365995,NaN,NaN,NaN,NaN,0.5220526155387698,36.096373530634814,11466725
2025-08-26T15:50:00-04:00,499.19,503.4,498.87,501.03,499.0539535471116,499.0539535471116,499.0539535471116,NaN,NaN,NaN,500.24680000000194,502.8266920582203,497.66690794178356,499.97147441773404,501.066092719184,502.75666824064916,499.3755171977188,261983,27284.033333333333,63.387619660684344,44.49595176428079,NaN,NaN,NaN,NaN,0.808334571571713,36.64824415276177,11728708
2025-08-26T15:55:00-04:00,501.07,502.6,501.07,502.05,499.63445565860656,NaN,NaN,NaN,NaN,NaN,500.24160000000194,502.80583746015486,497.677362539849,499.97147441773404,501.19692286118186,502.77997824128863,499.6138674810751,265637,35806.03333333333,69.36201208531942,46.55402035982515,NaN,NaN,NaN,NaN,0.8627392450308798,37.16069544473681,11994345
2025-08-27T09:30:00-04:00,501.75,503.57,501.48,501.48,500.1394804013971,NaN,NaN,NaN,NaN,NaN,500.224800000002,502.74497773812476,497.70462226187925,499.97147441773404,502.1766666666667,502.1766720614633,502.17666127187005,50165,35560.333333333336,63.15954926526785,48.60578198712755,NaN,NaN,NaN,NaN,0.9504007275286723,38.16691424287066,11944180
2025-08-27T09:35:00-04:00,501.47,502.77,501.45,501.63,500.1394804013971,NaN,NaN,NaN,NaN,NaN,500.21100000000195,502.6923931554501,497.7296068445538,499.97147441773404,502.0943755978229,502.2033747825721,501.98537641307365,28593,35946.1,64.07009066113386,50.398639971836594,NaN,NaN,NaN,NaN,0.9768006755623382,39.053908803479125,11972773
2025-08-27T09:40:00-04:00,501.65,501.78,500.64,500.82,500.1394804013971,NaN,NaN,NaN,NaN,NaN,500.17400000000197,502.56100062672,497.78699937328395,499.97147441773404,501.8081677209229,502.2739315715943,501.3424038702515,30956,36419.4,56.01845151442338,51.61638087463775,NaN,NaN,NaN,NaN,0.9884577701650273,38.661699350198866,11941817
2025-08-27T09:45:00-04:00,500.8,501.38,500.13,500.24,NaN,NaN,NaN,503.312634955171,503.312634955171,503.312634955171,500.128400000002,502.4195799911346,497.8372200088694,499.97147441773404,501.5655679326375,502.2076410775099,500.92349478776515,27098,36654.26666666667,51.06944775380623,52.52136867213342,NaN,NaN,NaN,NaN,1.0071393580103825,37.61833198093241,11914719
2025-08-27T09:50:00-04:00,500.21,500.99,500.04,500.71,NaN,NaN,NaN,503.0859242753905,NaN,NaN,500.087600000002,502.2601756492545,497.9150243507495,499.97147441773404,501.4162950282822,502.1052464302088,500.7273436263556,24420,36347.36666666667,54.57185194843199,53.09816279837086,NaN,NaN,NaN,NaN,1.0030579752953543,36.53120641182884,11939139
2025-08-27T09:55:00-04:00,500.69,500.79,499.88,500.25,NaN,NaN,NaN,502.91315499014553,NaN,NaN,500.04060000000203,502.09203524184426,497.9891647581598,499.97147441773404,501.2396481694905,501.9905808696745,500.48871546930656,30527,36788,50.74350519138681,53.478053998625725,NaN,NaN,NaN,NaN,0.9964109770599736,35.303864526343524,11908612
2025-08-27T10:00:00-04:00,500.27,500.72,500.17,500.5,NaN,NaN,NaN,502.91315499014553,NaN,NaN,500.00620000000197,501.9659332042064,498.0464667957975,499.97147441773404,501.1680547718235,501.9179542837483,500.4181552598987,19481,36767.933333333334,52.68616857288533,53.68511159856575,NaN,NaN,NaN,NaN,0.9645244786985477,34.16418991839288,11928093
2025-08-27T10:05:00-04:00,500.53,501.22,500.48,501.22,NaN,NaN,NaN,502.91315499014553,NaN,NaN,499.984800000002,501.8661101370358,498.1034898629682,499.97147441773404,501.1575200980348,501.88818132253084,500.4268588735388,12082,36723.26666666667,57.842978678128105,54.05275733114975,NaN,NaN,NaN,NaN,0.9484870159343665,33.583117137192716,11940175
2025-08-27T10:10:00-04:00,501.23,501.74,500.78,501.71,NaN,NaN,NaN,502.91315499014553,NaN,NaN,499.98140000000194,501.8495659862074,498.1132340137965,499.7027436273498,501.17672548419307,501.88222983272016,500.471221135666,18386,36869.1,60.96140486311335,54.78982161025637,NaN,NaN,NaN,NaN,0.9493093719390572,33.492121564845995,11958561
2025-08-27T10:15:00-04:00,501.7,503.24,501.43,503.24,499.6656459145615,499.6656459145615,499.6656459145615,NaN,NaN,NaN,500.020200000002,502.0682243728381,497.9721756271659,500.3182223464693,501.2887952993004,502.0701941879278,500.5073964106729,20097,37323.73333333333,68.73761076062394,56.7798144875916,NaN,NaN,NaN,NaN,1.0107872739434103,34.41668593278157,11978658
2025-08-27T10:20:00-04:00,503.29,503.61,503.08,503.59,500.7247074638996,NaN,NaN,NaN,NaN,NaN,500.067200000002,502.3224189764072,497.8119810235968,501.0075778771755,501.4386598991503,502.36909751666434,500.5082222816363,19736,37363.1,70.19996196148128,59.09047870362093,NaN,NaN,NaN,NaN,0.9764453258045974,35.47617590360405,11998394
2025-08-27T10:25:00-04:00,503.62,504.13,503.48,504.13,501.2151753064496,NaN,NaN,NaN,NaN,NaN,500.13060000000195,502.6458881647695,497.6153118352344,501.72306230174036,501.71519466178694,502.8885811516562,500.5418081719177,35419,37965,72.34903057213879,61.08283453491606,NaN,NaN,NaN,NaN,0.9531278025328388,36.72695245848897,12033813
2025-08-27T10:30:00-04:00,504.14,505.09,503.85,504.94,501.82880370161104,NaN,NaN,NaN,NaN,NaN,500.2204000000019,503.0728872220695,497.36791277793435,502.5444498413923,502.0121637834479,503.43090467095936,500.5934228959364,36002,38621.63333333333,75.23414314460389,61.92901478376746,NaN,NaN,NaN,NaN,0.9736186737804898,38.317272606093425,12069815
2025-08-27T10:35:00-04:00,505.01,505.01,503.95,504.615,501.82880370161104,NaN,NaN,NaN,NaN,NaN,500.2957000000019,503.39848778395316,497.1929122160506,502.5444498413923,502.1843926734823,503.69369302733264,500.675092319632,25972,39092.833333333336,71.98851585152333,62.116622195639174,NaN,NaN,NaN,NaN,0.979788768510455,39.79399845744042,12043843
2025-08-27T10:40:00-04:00,504.59,504.68,504.14,504.48,501.82880370161104,NaN,NaN,NaN,NaN,NaN,500.3647000000019,503.6761621592294,497.0532378407744,502.5444498413923,502.27403894263335,503.8170088453415,500.7310690399252,15732,39062.03333333333,70.62556346533773,62.64990892421559,NaN,NaN,NaN,NaN,0.948375285045424,41.16524389083408,12028111
2025-08-27T10:45:00-04:00,504.43,504.595,504.04,504.13,501.82880370161104,NaN,NaN,NaN,NaN,NaN,500.432100000002,503.90619101087685,496.9580089891271,502.5444498413923,502.34813618795357,503.9079432331897,500.78832914271743,15336,39115.53333333333,67.07965714540711,62.864877958806524,NaN,NaN,NaN,NaN,0.9202770503993227,42.25292415417944,12012775
2025-08-27T10:50:00-04:00,504.18,504.24,503.79,503.82,501.82880370161104,NaN,NaN,NaN,NaN,NaN,500.49950000000194,504.1007971263062,496.8982028736977,502.5444498413923,502.3996674771223,503.95999440531165,500.83934054893297,13628,39022.46666666667,64.0140333622605,63.43599094793775,NaN,NaN,NaN,NaN,0.8866858325136561,42.792057461017585,11999147
2025-08-27T10:55:00-04:00,503.82,504.27,503.78,503.94,501.82880370161104,NaN,NaN,NaN,NaN,NaN,500.5693000000019,504.29711705994157,496.8414829400622,502.5444498413923,502.45995972751905,504.02052254290356,500.89939691213453,16621,38930.86666666667,64.68680742646892,64.40865949598508,NaN,NaN,NaN,NaN,0.8583511301912526,43.31210685191657,12015768
2025-08-27T11:00:00-04:00,503.95,504.33,503.79,503.87,501.82880370161104,NaN,NaN,NaN,NaN,NaN,500.637500000002,504.4778943797355,496.79710562026844,502.62635689922195,502.49113384679634,504.0509048422216,500.9313628513711,9116,38734.833333333336,63.93590695780202,65.07752056808295,NaN,NaN,NaN,NaN,0.8356117637490177,43.83614298612593,12006652
2025-08-27T11:05:00-04:00,503.91,504.08,503.475,503.58,501.82880370161104,NaN,NaN,NaN,NaN,NaN,500.70170000000195,504.628413948308,496.7749860516959,502.62635689922195,502.55009553620783,504.09406624195327,501.0061248304624,22810,39036.333333333336,60.78767424875595,65.79496121503789,NaN,NaN,NaN,NaN,0.8191394949097993,43.66398793030374,11983842
2025-08-27T11:10:00-04:00,503.62,504.32,503.57,504.17,501.82880370161104,NaN,NaN,NaN,NaN,NaN,500.78890000000195,504.8246632675683,496.75313673243556,502.62635689922195,502.6049356951207,504.14523106293973,501.0646403273016,18299,39138.833333333336,64.60613779953813,66.64638758837023,NaN,NaN,NaN,NaN,0.8142009595590993,43.70423909617608,12002141
2025-08-27T11:15:00-04:00,504.19,504.49,504.02,504.41,501.90223996171454,NaN,NaN,NaN,NaN,NaN,500.87870000000197,505.03125574698515,496.7261442530188,502.88913473240166,502.6682475739177,504.21355447164274,501.1229406761927,18953,39154.3,66.05422811620838,67.23290540537596,NaN,NaN,NaN,NaN,0.7896151767334513,43.88184550460248,12021094
2025-08-27T11:20:00-04:00,504.44,504.57,504.37,504.49,502.19691087254574,NaN,NaN,NaN,NaN,NaN,500.972700000002,505.23378822150147,496.7116117785026,503.1893077859213,502.7012754975532,504.25143623844167,501.1511147566647,9477,38927.96666666667,66.545571082122,67.63177442101944,NaN,NaN,NaN,NaN,0.7474998069667754,44.114129380844574,12030571
2025-08-27T11:25:00-04:00,504.47,504.53,504.2,504.5,502.19691087254574,NaN,NaN,NaN,NaN,NaN,501.072900000002,505.4244730893107,496.7213269106933,503.260446228737,502.72954400927404,504.2822023713278,501.1768856472203,8729,38770.86666666667,66.61062927342496,67.4798471719338,NaN,NaN,NaN,NaN,0.7176783921834332,43.92455032012052,12039300
2025-08-27T11:30:00-04:00,504.52,504.73,503.78,503.82,502.19691087254574,NaN,NaN,NaN,NaN,NaN,501.17350000000204,505.54185220551517,496.8051477944889,503.260446228737,502.7731410635254,504.3200398136021,501.22624231344867,17207,38589.1,58.30708860049983,66.63035621757797,NaN,NaN,NaN,NaN,0.7342727927417627,42.80828252806367,12022093
2025-08-27T11:35:00-04:00,503.79,504.11,503.74,504.08,502.19691087254574,NaN,NaN,NaN,NaN,NaN,501.277100000002,505.67049098550865,496.88370901449537,503.260446228737,502.7928502610818,504.3346158827793,501.2510846393843,9071,37996.96666666667,60.34268737342394,65.77276027481263,NaN,NaN,NaN,NaN,0.7082533075459229,41.6851145326659,12031164
2025-08-27T11:40:00-04:00,504.11,504.43,503.8,504.41,502.19691087254574,NaN,NaN,NaN,NaN,NaN,501.37970000000206,505.821086003393,496.9383139966111,503.260446228737,502.82462263451606,504.3634520171363,501.2857932518958,12673,37498.833333333336,62.82365941992634,64.88629715162138,NaN,NaN,NaN,NaN,0.7026637855783566,41.034423255587406,12043837
2025-08-27T11:45:00-04:00,504.38,504.73,504.11,504.6,502.2560921795493,NaN,NaN,NaN,NaN,NaN,501.47810000000203,505.9820635379726,496.9741364620315,503.2863907752907,502.8526919506765,504.39331536341604,501.31206853793697,9773,36799.3,64.21189028070941,64.33082389656323,NaN,NaN,NaN,NaN,0.6967592294656172,40.77052966278596,12053610
2025-08-27T11:50:00-04:00,504.57,504.75,504.26,504.6,502.3726334441152,NaN,NaN,NaN,NaN,NaN,501.575900000002,506.1340832731499,497.0177167268541,503.35011262023255,502.8822773150878,504.42525054105056,501.339304089125,10307,28410.1,64.21189028070941,63.87270438337549,NaN,NaN,NaN,NaN,0.6819907130752166,40.548077664150945,12053610
2025-08-27T11:55:00-04:00,504.58,504.85,504.55,504.62,502.6236501057464,NaN,NaN,NaN,NaN,NaN,501.675500000002,506.27754965113513,497.07345034886885,503.58009009618604,502.91870874641876,504.46669559263296,501.37072190020456,12181,19961.566666666666,64.37429709959392,63.67946438010312,NaN,NaN,NaN,NaN,0.6547056621412733,40.45934787484839,12065791
2025-08-27T12:00:00-04:00,504.64,504.66,504.4,504.56,502.6236501057464,NaN,NaN,NaN,NaN,NaN,501.789100000002,506.38993500589294,497.1882649941111,503.58009009618604,502.92609042874443,504.4744012957758,501.37777956171306,2739,18380.7,63.44412596870257,63.638756709134704,NaN,NaN,NaN,NaN,0.6265124005597572,39.9690683957116,12063052
2025-08-27T12:05:00-04:00,504.52,504.705,504.31,504.52,502.6236501057464,NaN,NaN,NaN,NaN,NaN,501.903300000002,506.48610901103984,497.32049098896414,503.59075766155905,502.9383326955505,504.4868863338915,501.3897790572095,4681,17583.633333333335,62.79271800627389,63.503464607692194,NaN,NaN,NaN,NaN,0.6099758005197733,39.2675765441225,12058371
2025-08-27T12:10:00-04:00,504.49,504.6,504.29,504.48,502.6236501057464,NaN,NaN,NaN,NaN,NaN,502.02010000000206,506.56177259401755,497.47842740598657,503.59075766155905,502.94466981106245,504.49308557861065,501.39625404351426,2541,16636.466666666667,62.105997730203356,63.37275680572086,NaN,NaN,NaN,NaN,0.5885489576255039,38.55913672532464,12055830
2025-08-27T12:15:00-04:00,504.52,504.55,504.07,504.23,502.6236501057464,NaN,NaN,NaN,NaN,NaN,502.127800000002,506.6182993743979,497.63730062560614,503.59075766155905,502.9562251788091,504.50290890851977,501.40954144909847,5301,15909.9,57.84783368002984,63.162768193669,NaN,NaN,NaN,NaN,0.5807954606522548,37.2750983696294,12050529
2025-08-27T12:20:00-04:00,504.23,504.24,503.9,503.93,502.6236501057464,NaN,NaN,NaN,NaN,NaN,502.22400000000204,506.6583716568759,497.7896283431282,503.59075766155905,502.96246488031534,504.5067647127741,501.4181650478566,3612,15216.3,53.1394501515486,62.343719075955455,NaN,NaN,NaN,NaN,0.5635957848913817,35.62292701762458,12046917
2025-08-27T12:25:00-04:00,503.91,504.07,503.45,504.07,502.6236501057464,NaN,NaN,NaN,NaN,NaN,502.31880000000206,506.7040368500787,497.9335631499254,503.59075766155905,502.9942147011157,504.5201259968249,501.4683034054065,22566,14950.933333333332,54.980953401161095,61.5527708820235,NaN,NaN,NaN,NaN,0.5676246573991405,33.145078982579086,12069483
2025-08-27T12:30:00-04:00,504.06,504.57,504,504.455,502.6236501057464,NaN,NaN,NaN,NaN,NaN,502.43310000000207,506.7364112310484,498.12978876895573,503.59075766155905,503.0136673921676,504.53702686130845,501.4903079230267,9379,14614.2,59.67412357068388,61.061953202635074,NaN,NaN,NaN,NaN,0.5677943247277728,31.6949314572272,12078862
2025-08-27T12:35:00-04:00,504.48,504.7,504.15,504.7,502.6236501057464,NaN,NaN,NaN,NaN,NaN,502.54690000000204,506.7825089941483,498.31129100585576,503.59075766155905,503.03499617107065,504.5579192671492,501.5120730749921,9352,14523.2,62.3630242775426,60.75855284578633,NaN,NaN,NaN,NaN,0.5665233015329327,30.57752450714763,12088214
2025-08-27T12:40:00-04:00,504.67,504.91,504.54,504.81,502.9068699974022,NaN,NaN,NaN,NaN,NaN,502.662900000002,506.82168784640083,498.5041121536032,503.7412989251454,503.0520932955351,504.5769882205405,501.5271983705297,6623,14131.1,63.5385605768405,61.132229415524954,NaN,NaN,NaN,NaN,0.5524859228520093,29.900803923516182,12094837
2025-08-27T12:45:00-04:00,504.7,505.17,504.59,505.125,503.06542136115667,NaN,NaN,NaN,NaN,NaN,502.78620000000205,506.86329973279254,498.70910026721157,503.9450391401163,503.09416833666836,504.62800158976796,501.56033508356876,14997,13961.1,66.74202348371773,61.58932485197452,NaN,NaN,NaN,NaN,0.5544512140768687,29.691034654740413,12109834
2025-08-27T12:50:00-04:00,505.15,505.57,505.15,505.35,503.567220390195,NaN,NaN,NaN,NaN,NaN,502.90440000000206,506.928942029991,498.8798579700131,504.36753131209304,503.1403833714001,504.6918387039376,501.5889280388626,14193,13776.333333333334,68.84743206800584,62.01959432683734,NaN,NaN,NaN,NaN,0.5466332702142347,30.06793384168491,12124027
2025-08-27T12:55:00-04:00,505.34,505.34,504.87,505.01,503.567220390195,NaN,NaN,NaN,NaN,NaN,503.0174000000021,506.9538355641926,499.0809644358116,504.36753131209304,503.1600195713348,504.7156968528204,501.60434228984917,7131,12833.4,62.417209598682405,61.89140284954969,NaN,NaN,NaN,NaN,0.5418737509132192,29.68228000883732,12116896
2025-08-27T13:00:00-04:00,505.1,505.28,504.91,505.28,503.567220390195,NaN,NaN,NaN,NaN,NaN,503.1302000000021,506.99564070333673,499.2647592966675,504.36753131209304,503.1804305224201,504.74111261431267,501.6197484305276,7250,11875,65.19707357923568,61.96177308515871,NaN,NaN,NaN,NaN,0.5295970544194141,29.32417287833599,12124146
2025-08-27T13:05:00-04:00,505.28,505.28,505,505.16,503.567220390195,NaN,NaN,NaN,NaN,NaN,503.23660000000217,507.0260487397063,499.447151260298,504.36753131209304,503.1950181055721,504.7590282275221,501.6310079836221,5301,11185.966666666667,62.96784045005422,61.86131189590587,NaN,NaN,NaN,NaN,0.511768693389454,28.99164482858475,12118845
2025-08-27T13:10:00-04:00,505.14,505.41,505.11,505.33,503.59136572256637,NaN,NaN,NaN,NaN,NaN,503.34900000000215,507.04562278178014,499.65237721822416,504.41418882543337,503.20443625449894,504.7711765543069,501.63769595469097,3237,10769.466666666667,64.80384987481887,61.958435032057025,NaN,NaN,NaN,NaN,0.4966423581473509,28.910872186375062,12122082
2025-08-27T13:15:00-04:00,505.35,505.63,505.32,505.41,503.8399400079043,NaN,NaN,NaN,NaN,NaN,503.4778000000021,506.99979213953776,499.95580786046645,504.67835106034664,503.243542849724,504.82417804820795,501.66290765124006,12702,10681.666666666666,65.66650969764746,62.163705867155144,NaN,NaN,NaN,NaN,0.48331076113682603,29.205267444223672,12134784
2025-08-27T13:20:00-04:00,505.43,505.43,505.05,505.17,503.8399400079043,NaN,NaN,NaN,NaN,NaN,503.60750000000206,506.8829463804432,500.33205361956095,504.67835106034664,503.2612272869525,504.84571335453063,501.6767412193743,6606,10447.6,60.84816532265892,62.07386069518769,NaN,NaN,NaN,NaN,0.47593142105562386,28.65621709574004,12128178
2025-08-27T13:25:00-04:00,505.21,505.45,505.2,505.39,503.8399400079043,NaN,NaN,NaN,NaN,NaN,503.7331000000021,506.78292483941664,500.6832751605875,504.67835106034664,503.2799385373654,504.86951120606403,501.6903658686668,6673,10116,63.49258913499847,62.477057513399735,NaN,NaN,NaN,NaN,0.46193631955164877,28.184822961827972,12134851
2025-08-27T13:30:00-04:00,505.4,505.59,505.31,505.59,503.906079020774,NaN,NaN,NaN,NaN,NaN,503.8243000000021,506.8175370489097,500.8310629510945,504.7291557428975,503.32124553838275,504.9242170096115,501.718274067154,14122,10282.866666666667,65.75693894207436,63.378306712722996,NaN,NaN,NaN,NaN,0.4489408681551005,28.020734602962122,12148973
2025-08-27T13:35:00-04:00,505.62,506.22,505.62,506.01,504.36034815619337,NaN,NaN,NaN,NaN,NaN,503.9035000000021,506.9142655157765,500.89273448422773,505.216324594318,503.3810049040468,505.0133732202331,501.74863658786046,17629,10110.166666666666,69.96935384757293,64.44890674460956,NaN,NaN,NaN,NaN,0.4618736632868828,28.886710733535136,12166602
2025-08-27T13:40:00-04:00,506.04,506.3,505.94,505.94,504.58215051273004,NaN,NaN,NaN,NaN,NaN,503.99270000000206,506.97511526807165,501.0102847319325,505.3170596754544,503.41942438339277,505.0710485668548,501.7678001999307,11283,9876.3,68.45782959580299,65.07631431783236,NaN,NaN,NaN,NaN,0.45459697305210645,29.800419997175347,12155319
2025-08-27T13:45:00-04:00,505.98,506.29,505.98,506.22,504.6193254894241,NaN,NaN,NaN,NaN,NaN,504.084500000002,507.0528956932233,501.11610430678064,505.3286477403635,503.44605270776304,505.1115095437632,501.7805958717629,7710,9501.533333333333,71.14317681993941,65.7034680708607,NaN,NaN,NaN,NaN,0.4471257606912434,30.648864313412684,12163029
2025-08-27T13:50:00-04:00,506.2,506.26,506.11,506.16,504.71776523990485,NaN,NaN,NaN,NaN,NaN,504.191300000002,507.064940066432,501.31765993357203,505.4159181922908,503.4698070427615,505.1472803113099,501.7923337742131,6972,9418.033333333333,69.77238858309761,66.14874149987907,NaN,NaN,NaN,NaN,0.4259024920704387,31.436705464204493,12156057
2025-08-27T13:55:00-04:00,506.11,506.56,506.05,506.35,504.8349122744546,NaN,NaN,NaN,NaN,NaN,504.3135000000021,507.01939227266206,501.6076077273421,505.62973455383263,503.5194892572319,505.22360259493036,501.81537591953344,14218,9601,71.63614602070018,66.4983216810921,NaN,NaN,NaN,NaN,0.43190945692254956,32.614785933000476,12170275
2025-08-27T14:00:00-04:00,506.33,506.4,506.05,506.08,504.8349122744546,NaN,NaN,NaN,NaN,NaN,504.42090000000206,506.967768420491,501.87403157951314,505.62973455383263,503.5376978556983,505.2500512650353,501.82534444636127,5628,9215.033333333333,65.45949510949518,66.25632618405562,NaN,NaN,NaN,NaN,0.4260587814280793,33.70871779688245,12164647
2025-08-27T14:05:00-04:00,506.08,506.1,505.69,505.96,504.8349122744546,NaN,NaN,NaN,NaN,NaN,504.53510000000205,506.8224928283728,502.2477071716313,505.62973455383263,503.56120108830186,505.281243755605,501.84115842099874,8195,9185.833333333334,62.86512006390149,66.28831978871412,NaN,NaN,NaN,NaN,0.4249117256117897,33.352907885596494,12156452
2025-08-27T14:10:00-04:00,505.93,506.73,505.92,506.73,504.8390953769464,NaN,NaN,NaN,NaN,NaN,504.65970000000215,506.72195838121587,502.5974416187884,505.62973455383263,503.607034919132,505.35132003714307,501.8627498011209,13326,9207.6,70.84890951350997,66.692022355448,NaN,NaN,NaN,NaN,0.4524180309252334,34.02314721632821,12169778
2025-08-27T14:15:00-04:00,506.73,506.84,506.405,506.405,505.1448183143578,NaN,NaN,NaN,NaN,NaN,504.7634000000021,506.63611400671715,502.89068599328704,505.69666327324984,503.62908696106143,505.3852602355231,501.87291368659976,6363,9093.933333333332,64.54160060400977,66.80443379501625,NaN,NaN,NaN,NaN,0.4511738858591455,34.791295578260765,12163415
2025-08-27T14:20:00-04:00,506.41,506.705,506.41,506.57,505.1448183143578,NaN,NaN,NaN,NaN,NaN,504.8606000000021,506.58817360225663,503.1330263977475,505.69666327324984,503.6425724963857,505.40590105555566,501.87924393721573,3923,8881.133333333333,66.18739229013985,66.90325825325347,NaN,NaN,NaN,NaN,0.4403757511549216,35.50457620005528,12167338
2025-08-27T14:25:00-04:00,506.61,506.83,506.49,506.7,505.22818672857807,NaN,NaN,NaN,NaN,NaN,504.92980000000205,506.66931712591884,503.19028287408526,505.8082644948799,503.65889379077913,505.4314012716133,501.88638630994495,4619,8629.066666666668,67.46855185845993,67.03197555045436,NaN,NaN,NaN,NaN,0.43320605464385403,36.343877394999396,12171957
2025-08-27T14:30:00-04:00,506.71,506.77,506.5,506.5,505.2314509681882,NaN,NaN,NaN,NaN,NaN,504.98800000000205,506.73900199634727,503.2369980036568,505.81761159590394,503.68110427938245,505.46508406411806,501.89712449464685,6549,8756.066666666668,63.48330339718002,67.22019969863445,NaN,NaN,NaN,NaN,0.42154847931214884,37.123228504590365,12165408
2025-08-27T14:35:00-04:00,506.51,506.63,506.37,506.5,505.2314509681882,NaN,NaN,NaN,NaN,NaN,505.035400000002,506.8189412389755,503.25185876102853,505.81761159590394,503.7071722828195,505.50326695486893,501.91107761077006,8067,8868.933333333332,63.48330339718002,67.21953643164741,NaN,NaN,NaN,NaN,0.41000930221842324,37.306948723185876,12165408
2025-08-27T14:40:00-04:00,506.46,506.46,506.25,506.36,505.2314509681882,NaN,NaN,NaN,NaN,NaN,505.06380000000206,506.885181407347,503.24241859265715,505.81761159590394,503.7198495353073,505.52094591574973,501.9187531548648,4194,8924.033333333333,60.57835196953532,66.84963736218033,NaN,NaN,NaN,NaN,0.3985800663456787,36.99305824074023,12161214
2025-08-27T14:45:00-04:00,506.36,506.56,506.33,506.47,505.2314509681882,NaN,NaN,NaN,NaN,NaN,505.10090000000207,506.9593947541075,503.24240524589663,505.81761159590394,503.73453336102085,505.5418641553738,501.9272025666679,4734,8905.133333333333,62.04783718505262,66.28381474342889,NaN,NaN,NaN,NaN,0.38653863303527436,36.90167728872034,12165948
2025-08-27T14:50:00-04:00,506.5,506.5,506.21,506.36,505.2314509681882,NaN,NaN,NaN,NaN,NaN,505.13850000000207,507.0211398994531,503.25586010055105,505.81761159590394,503.74613653343573,505.55784311133635,501.9344299555351,3917,8915.3,59.65315148540654,65.65490916411486,NaN,NaN,NaN,NaN,0.37964301638989906,36.320521084489386,12162031
2025-08-27T14:55:00-04:00,506.36,506.45,506.24,506.3,505.2314509681882,NaN,NaN,NaN,NaN,NaN,505.18190000000214,507.0695862956515,503.2942137043528,505.81761159590394,503.7650553113927,505.5835090026791,501.9466016201063,6529,8380.733333333334,58.330751924519625,64.73973595729915,NaN,NaN,NaN,NaN,0.3675256580763334,35.78087603770349,12155502
2025-08-27T15:00:00-04:00,506.28,506.28,505.99,506.09,505.2314509681882,NaN,NaN,NaN,NaN,NaN,505.2273000000021,507.0908194742574,503.36378052574685,505.81761159590394,503.78602864736735,505.6098363637048,501.9622209310299,8013,8335.2,53.832664350016024,63.60118422636475,NaN,NaN,NaN,NaN,0.3634166824994526,34.26726807071577,12147489
2025-08-27T15:05:00-04:00,506.05,506.25,505.96,506.07,505.2314509681882,NaN,NaN,NaN,NaN,NaN,505.2699000000021,507.1110099779612,503.428790022043,505.81761159590394,503.80473986434095,505.63288710800157,501.9765926206803,7356,8268.666666666666,53.41023874444954,62.29933370663257,NaN,NaN,NaN,NaN,0.35817263374949315,32.74696526798273,12140133
2025-08-27T15:10:00-04:00,506.05,506.05,504.97,505.61,NaN,NaN,NaN,506.83763299938016,506.83763299938016,506.83763299938016,505.3047000000021,507.1039547431957,503.50544525680846,505.81761159590394,503.8326125960968,505.6591461068154,502.0060790853782,14779,8540.533333333333,44.718542839636925,60.8178371159284,NaN,NaN,NaN,NaN,0.4111603027673841,32.16519046071857,12125354
2025-08-27T15:15:00-04:00,505.63,506.15,505.62,506.14,NaN,NaN,NaN,506.83763299938016,NaN,NaN,505.35590000000207,507.10080193164765,503.6109980683565,505.81761159590394,503.8641706709189,505.6954057543546,502.03293558748317,13815,8501.133333333333,54.00577017224345,60.18502640938139,NaN,NaN,NaN,NaN,0.4203631382839969,31.314148977311447,12139169
2025-08-27T15:20:00-04:00,506.12,506.26,505.92,505.96,NaN,NaN,NaN,506.83763299938016,NaN,NaN,505.3917000000021,507.11107268523426,503.67232731477,505.7741771371028,503.8897583578729,505.7253227253156,502.0541939904302,11100,8398.033333333333,50.87947123890588,58.75863796119539,NaN,NaN,NaN,NaN,0.41462291412085245,30.18266735553197,12128069
2025-08-27T15:25:00-04:00,505.88,506.06,505.77,505.95,NaN,NaN,NaN,506.83763299938016,NaN,NaN,505.4225000000021,507.1255223106805,503.71947768932375,505.7741771371028,503.9123782854469,505.75016049933026,502.0745960715635,10632,8514.733333333334,50.70386353285873,57.77022817039888,NaN,NaN,NaN,NaN,0.4057212773979359,29.464826025489906,12117437
2025-08-27T15:30:00-04:00,506,506.35,505.99,506.21,NaN,NaN,NaN,506.83763299938016,NaN,NaN,505.45690000000207,507.15265928444717,503.76114071555696,505.7741771371028,503.94320738115357,505.78729371801063,502.0991210442965,13176,8712.266666666666,55.04804169482688,56.97456027073367,NaN,NaN,NaN,NaN,0.4053126147266572,27.91480579019044,12130613
2025-08-27T15:35:00-04:00,506.25,506.62,506.06,506.41,NaN,NaN,NaN,506.83763299938016,NaN,NaN,505.4951000000021,507.1889659778201,503.8012340221841,505.72634170968223,503.98162083237855,505.83585040949106,502.12739125526605,15654,9057.366666666667,58.10636976683536,56.305832978474776,NaN,NaN,NaN,NaN,0.4163617136747533,26.086529602670982,12146267
2025-08-27T15:40:00-04:00,506.43,506.69,506.4,506.65,NaN,NaN,NaN,506.83763299938016,NaN,NaN,505.5517000000021,507.20656991357475,503.8968300864294,505.7260733677458,504.02356901369393,505.89169621778086,502.155441809607,16183,9488.9,61.49209188794396,56.16360358495791,NaN,NaN,NaN,NaN,0.40733587698370094,24.566482509586955,12162450
2025-08-27T15:45:00-04:00,506.63,506.94,506.52,506.93,505.4340474528982,505.4340474528982,505.4340474528982,NaN,NaN,NaN,505.60870000000216,507.25317658253783,503.9642234174665,505.9083184187041,504.0788064705365,505.9683861793275,502.1892267617455,20373,9744.6,65.04173476737276,56.274920111400256,NaN,NaN,NaN,NaN,0.40824045719915203,23.761454216591222,12182823
2025-08-27T15:50:00-04:00,506.93,507.34,506.355,506.57,505.47613620503915,NaN,NaN,NaN,NaN,NaN,505.6519000000021,507.2815673128583,504.02223268714596,506.0221547349633,504.17391245166095,506.0946155215027,502.2532093818192,37687,10780.633333333333,57.67986510885486,56.067885335637364,NaN,NaN,NaN,NaN,0.44943756739920954,23.83889972257638,12145136
2025-08-27T15:55:00-04:00,506.58,507.13,506.56,506.6,505.47613620503915,NaN,NaN,NaN,NaN,NaN,505.69190000000214,507.3144928480705,504.0693071519338,506.0221547349633,504.32095358061724,506.2802248145034,502.3616823467311,63845,12686.366666666667,58.10542164875538,55.786284225901845,NaN,NaN,NaN,NaN,0.45804916972783694,23.910813406705454,12208981
2025-08-28T09:30:00-04:00,507.09,510.02,506.62,509.38,506.52991439343447,NaN,NaN,NaN,NaN,NaN,505.7875000000021,507.68197538666084,503.8930246133434,507.2385790303765,508.6733333333334,508.6733333333334,508.6733333333334,42304,13625.766666666666,79.08933043118432,57.17458272202883,NaN,NaN,NaN,NaN,0.6696170861758457,26.809035497202583,12251285
2025-08-28T09:35:00-04:00,509.35,510.24,508.15,508.41,507.20128192100566,NaN,NaN,NaN,NaN,NaN,505.86330000000214,507.8651017960281,503.86149820397617,507.2385790303765,508.78108694950055,508.90916933873217,508.6530045602689,29941,14036.166666666666,66.56180536295452,57.76251511048846,NaN,NaN,NaN,NaN,0.771073008591859,29.605384595553986,12221344
2025-08-28T09:40:00-04:00,508.54,508.9,507.6,507.67,507.20128192100566,NaN,NaN,NaN,NaN,NaN,505.92550000000216,507.9545344971529,503.8964655028514,507.2385790303765,508.597163246548,508.93130412401837,508.26302236907765,24584,14479.533333333333,58.89724840254239,58.124271114240344,NaN,NaN,NaN,NaN,0.8088535079781515,31.01196786566232,12196760
2025-08-28T09:45:00-04:00,507.76,507.81,506.38,506.6,NaN,NaN,NaN,509.27580510916636,509.27580510916636,509.27580510916636,505.9671000000021,507.96420298951216,503.9699970104921,507.2385790303765,508.17843201398233,508.95712651135733,507.39973751660733,32477,15305.1,49.942227337233284,57.8765560137249,NaN,NaN,NaN,NaN,0.8532211145511411,30.25537262913714,12164283
2025-08-28T09:50:00-04:00,506.61,506.63,505.5,505.88,NaN,NaN,NaN,508.30076851329517,NaN,NaN,505.9951000000021,507.9467592814937,504.04344071851045,507.2385790303765,507.81010751652036,508.8913865347815,506.72882849825925,26360,15951.366666666667,44.985679592148095,57.895637210332836,NaN,NaN,NaN,NaN,0.872991034940345,28.429258264551997,12137923
2025-08-28T09:55:00-04:00,505.8,506.69,505.57,506.69,NaN,NaN,NaN,508.30076851329517,NaN,NaN,506.04430000000207,507.93868011784116,504.149919882163,507.2385790303765,507.69673459816914,508.80888154087796,506.5845876554603,12788,15903.7,50.890589956804995,57.673124337801525,NaN,NaN,NaN,NaN,0.8906345324446063,26.79825717466989,12150711
2025-08-28T10:00:00-04:00,506.78,507.05,506.27,506.44,NaN,NaN,NaN,508.30076851329517,NaN,NaN,506.09450000000203,507.89269381356416,504.2963061864399,507.2385790303765,507.582175497811,508.6881909810941,506.4761600145279,19385,16362.266666666666,49.137554233051354,57.548701694526194,NaN,NaN,NaN,NaN,0.8827320658414223,25.67375524013332,12131326
2025-08-28T10:05:00-04:00,506.41,507.22,506.11,506.89,NaN,NaN,NaN,508.30076851329517,NaN,NaN,506.150900000002,507.8665674360273,504.43523256397674,507.2385790303765,507.5126211279827,508.59704763487116,506.42819462109424,16910,16652.766666666666,52.32127590852807,57.66423114993115,NaN,NaN,NaN,NaN,0.898965489709893,24.811097960807444,12148236
2025-08-28T10:10:00-04:00,506.89,507.18,506.46,507.18,NaN,NaN,NaN,508.30076851329517,NaN,NaN,506.20540000000204,507.8746127938184,504.5361872061857,507.2385790303765,507.48228982906335,508.54536950925797,506.41921014886873,11452,16590.3,54.30629371831196,57.61124915160866,NaN,NaN,NaN,NaN,0.8861822404449026,24.010059058576275,12159688
2025-08-28T10:15:00-04:00,507.15,507.18,506.28,506.31,NaN,NaN,NaN,508.30076851329517,NaN,NaN,506.237600000002,507.85057890604674,504.6246210939572,507.2385790303765,507.4472315216795,508.5035402126715,506.3909228306875,8842,16672.933333333334,47.86773580811876,56.879918154557465,NaN,NaN,NaN,NaN,0.8871692232702691,22.99119892110233,12150846
2025-08-28T10:20:00-04:00,506.33,506.91,506.28,506.37,NaN,NaN,NaN,508.30076851329517,NaN,NaN,506.268800000002,507.82962229327285,504.7079777067311,506.9698632243012,507.4113049340634,508.46229360255984,506.360316265567,9071,16844.533333333333,48.32278071690472,55.93925307091181,NaN,NaN,NaN,NaN,0.8687999930366822,22.045114507733672,12159917
2025-08-28T10:25:00-04:00,506.37,506.71,505.94,506.02,NaN,NaN,NaN,508.30076851329517,NaN,NaN,506.28670000000204,507.8148277535269,504.7585722464772,505.63389057944096,507.35332684614116,508.4098229230066,506.29683076927574,12012,17090.966666666667,45.810796028455165,54.56561458956055,NaN,NaN,NaN,NaN,0.8617428506769179,20.62475046409214,12147905
2025-08-28T10:30:00-04:00,506.04,506.58,505.85,506.17,NaN,NaN,NaN,508.30076851329517,NaN,NaN,506.303100000002,507.80809021631654,504.7981097836875,504.60021904964555,507.30918062274185,508.36862651635676,506.24973472912694,9796,17199.2,47.080460664333295,53.808514272094726,NaN,NaN,NaN,NaN,0.8523326470571353,19.164830720400474,12157701
2025-08-28T10:35:00-04:00,506.17,506.385,505.85,506.2,NaN,NaN,NaN,508.30076851329517,NaN,NaN,506.326900000002,507.7862873890078,504.86751261099624,504.60021904964555,507.27676082830334,508.3387683815985,506.21475327500815,7331,17174.666666666668,47.34617857392617,53.03999690960693,NaN,NaN,NaN,NaN,0.8296660294101947,17.80919095840106,12165032
2025-08-28T10:40:00-04:00,506.22,506.8,506.17,506.69,NaN,NaN,NaN,508.30076851329517,NaN,NaN,506.355100000002,507.7867067726194,504.92349322738454,504.8659133781879,507.2398893439225,508.2866414033888,506.19313728445627,14138,17506.133333333335,51.619220392994336,51.07784619259335,NaN,NaN,NaN,NaN,0.815404170166609,17.218152741907,12179170
2025-08-28T10:45:00-04:00,506.68,506.7,506.35,506.45,NaN,NaN,NaN,508.30076851329517,NaN,NaN,506.380900000002,507.77132970025013,504.99047029975384,504.97773070255033,507.2146889146575,508.2521769594829,506.17720086983206,9781,17674.366666666665,49.50029867931723,49.859167143762114,NaN,NaN,NaN,NaN,0.782161015154706,16.669331540876804,12169389
2025-08-28T10:50:00-04:00,506.51,507.71,506.51,507.62,NaN,NaN,NaN,508.30076851329517,NaN,NaN,506.42670000000203,507.82647942235127,505.0269205776528,505.70218456204026,507.21747765691833,508.2326599022749,506.20229541156175,12809,17970.766666666666,58.4538199999452,49.82749368643374,NaN,NaN,NaN,NaN,0.8162923712150835,17.510810455806006,12182198
2025-08-28T10:55:00-04:00,507.65,507.65,507,507,NaN,NaN,NaN,508.30076851329517,NaN,NaN,506.458500000002,507.83651922745514,505.08048077254887,505.7187476496322,507.217458344045,508.2204800183756,506.21443666971436,7318,17997.066666666666,53.08288280402706,50.05182621977615,NaN,NaN,NaN,NaN,0.8044143446997187,18.292183733954552,12174880
2025-08-28T11:00:00-04:00,507,507.68,506.99,507.24,NaN,NaN,NaN,508.30076851329517,NaN,NaN,506.49990000000207,507.84456425212886,505.1552357478753,505.7899981197058,507.21950429215684,508.2105921107161,506.2284164735976,7500,17979.966666666667,54.813688453465005,50.753826852727364,NaN,NaN,NaN,NaN,0.7962418915068815,19.05429288119623,12182380
2025-08-28T11:05:00-04:00,507.24,507.44,506.97,507.31,NaN,NaN,NaN,508.30076851329517,NaN,NaN,506.53830000000204,507.86350731630483,505.21309268369924,505.7899981197058,507.21971258042987,508.20575370119775,506.233671459662,3232,17842.5,55.331285654707415,51.071019402577534,NaN,NaN,NaN,NaN,0.7729388992563878,19.71491266744498,12185612
2025-08-28T11:10:00-04:00,507.39,508.12,507.39,507.79,NaN,NaN,NaN,508.30076851329517,NaN,NaN,506.5823000000021,507.9246221785302,505.23997782147393,506.3173987966117,507.2341755058893,508.21104237051077,506.25730864126785,8638,17637.8,58.81506982718244,51.76227051644405,NaN,NaN,NaN,NaN,0.7755861207380745,21.135261579153102,12194250
2025-08-28T11:15:00-04:00,507.81,508.6,507.81,508.11,505.9656809264955,505.9656809264955,505.9656809264955,NaN,NaN,NaN,506.6243000000021,508.0226132806114,505.22598671939284,506.75291903728936,507.27410903756424,508.248584286673,506.2996337884555,14507,17660.866666666665,60.998896225501156,52.38210053908498,NaN,NaN,NaN,NaN,0.7780442549710694,22.91563528618056,12208757
2025-08-28T11:20:00-04:00,508.08,508.7,508.04,508.05,506.14246815710936,NaN,NaN,NaN,NaN,NaN,506.66650000000203,508.1063975627605,505.22660243724357,506.8923352298315,507.31220962979876,508.2865123919482,506.33790686764934,13667,17746.433333333334,60.35270291501122,52.813986910277784,NaN,NaN,NaN,NaN,0.7696125224731336,24.65913449770785,12195090
2025-08-28T11:25:00-04:00,508.08,508.08,507.11,507.22,506.14246815710936,NaN,NaN,NaN,NaN,NaN,506.68650000000207,508.12881237637305,505.2441876236311,506.8923352298315,507.3158589589,508.27912114692845,506.3525967708715,8401,17672.066666666666,52.126317519509115,53.118171318234246,NaN,NaN,NaN,NaN,0.7839259137250505,24.277632851723048,12186689
2025-08-28T11:30:00-04:00,507.2,507.77,507.15,507.6,506.14246815710936,NaN,NaN,NaN,NaN,NaN,506.7153000000021,508.1718471605731,505.2587528394311,506.8923352298315,507.3184446257905,508.27541220484244,506.36147704673857,4990,17399.2,55.14106846287634,53.60519187151793,NaN,NaN,NaN,NaN,0.7722169198875471,23.923381323308593,12191679
2025-08-28T11:35:00-04:00,507.61,508.01,507.42,507.48,506.14246815710936,NaN,NaN,NaN,NaN,NaN,506.73790000000207,508.2060935673564,505.26970643264775,506.8923352298315,507.3271566706023,508.2723612425349,506.3819520986697,10365,17222.9,53.984930963367525,54.18905865258309,NaN,NaN,NaN,NaN,0.7592014256098635,23.90467300999607,12181314
2025-08-28T11:40:00-04:00,507.62,507.81,507.4,507.46,506.14246815710936,NaN,NaN,NaN,NaN,NaN,506.765500000002,508.23506898147275,505.2959310185313,506.8923352298315,507.3295614963619,508.2700914456922,506.38903154703166,4009,16817.1,53.7825316730705,54.66777801035004,NaN,NaN,NaN,NaN,0.7342584666377322,23.844832613553663,12177305
2025-08-28T11:45:00-04:00,507.45,507.69,507.33,507.52,506.14246815710936,NaN,NaN,NaN,NaN,NaN,506.79670000000203,508.26277449716514,505.3306255028389,506.8923352298315,507.3311150344245,508.26781222211656,506.39441784673244,3262,16246.733333333334,54.335652019298834,55.16702611359095,NaN,NaN,NaN,NaN,0.7075257190207523,23.63279853965428,12180567
2025-08-28T11:50:00-04:00,507.56,507.79,507.53,507.79,506.14246815710936,NaN,NaN,NaN,NaN,NaN,506.81790000000206,508.3099296080335,505.3258703919706,506.8923352298315,507.33432249381684,508.2676094330637,506.40103555457,3354,15102.3,56.83889623525399,55.53986010232378,NaN,NaN,NaN,NaN,0.6762738819478443,23.58655113993177,12183921
2025-08-28T11:55:00-04:00,507.85,508.14,507.82,508.07,506.14246815710936,NaN,NaN,NaN,NaN,NaN,506.851200000002,508.37877920632843,505.32362079367556,506.90819258119114,507.3437693089766,508.27389847151477,506.41364014643847,5519,13158.1,59.32885043535442,56.2418995134693,NaN,NaN,NaN,NaN,0.652968604665853,24.045819688708296,12189440
2025-08-28T12:00:00-04:00,508.08,508.33,507.92,508.26,506.14246815710936,NaN,NaN,NaN,NaN,NaN,506.88500000000204,508.4602396615765,505.30976033842757,507.1395540649529,507.35658836786683,508.28510583436014,506.42807090137353,6221,11955.333333333334,60.97410077135124,56.42191956856973,NaN,NaN,NaN,NaN,0.6356137043325756,24.725562524666852,12195661
2025-08-28T12:05:00-04:00,508.29,508.97,508.03,508.745,506.4792782042891,NaN,NaN,NaN,NaN,NaN,506.925900000002,508.5838260392082,505.2679739607958,507.54764325196237,507.39673200288837,508.3355937198719,506.45787028590485,13584,11410.1,64.87961018542302,57.26454295295515,NaN,NaN,NaN,NaN,0.6573555825945384,26.093554789723267,12209245
2025-08-28T12:10:00-04:00,508.76,509.01,508.58,508.98,506.8074928313668,NaN,NaN,NaN,NaN,NaN,506.975500000002,508.72533227523746,505.22566772476654,507.65711460156984,507.4952117610802,508.47300426523884,506.5174192569216,29986,11590.166666666666,66.62257418337381,58.10803479080578,NaN,NaN,NaN,NaN,0.6411158981235004,27.405292727495716,12239231
2025-08-28T12:15:00-04:00,508.95,509,508.77,508.77,506.9564704299411,NaN,NaN,NaN,NaN,NaN,507.0209000000019,508.83561726496396,505.2061827350399,507.80269168125585,507.5471785407082,508.5405791781161,506.55377790330033,17777,11100.166666666666,63.58571427003354,58.69763683475765,NaN,NaN,NaN,NaN,0.611750476828966,28.623335098284418,12221454
2025-08-28T12:20:00-04:00,508.83,509,508.77,508.94,507.0127672285801,NaN,NaN,NaN,NaN,NaN,507.072500000002,508.95458421480384,505.1904157852001,507.9271533450047,507.57924461166016,508.58222484850137,506.57626437481895,11196,10594.7,64.9774766506954,59.13780875072286,NaN,NaN,NaN,NaN,0.5844825856268984,29.75437444258821,12232650
2025-08-28T12:25:00-04:00,508.96,509.2,508.84,508.95,507.1837778090992,NaN,NaN,NaN,NaN,NaN,507.122100000002,509.06770025479165,505.1764997452123,508.16172267600376,507.67754878202186,508.70996146430747,506.64513609973625,35287,11344.666666666666,65.06206805878314,59.428035310243004,NaN,NaN,NaN,NaN,0.568448115224978,31.04531161047937,12267937
2025-08-28T12:30:00-04:00,508.94,509.03,508.24,508.24,507.1837778090992,NaN,NaN,NaN,NaN,NaN,507.159700000002,509.1175604729273,505.20183952707663,508.16172267600376,507.6931928930487,508.7219578519777,506.6644279341197,9825,11026,54.919490205597896,59.039948688142054,NaN,NaN,NaN,NaN,0.5842732498517627,30.513593633933635,12258112
2025-08-28T12:35:00-04:00,508.27,508.37,507.79,507.91,507.1837778090992,NaN,NaN,NaN,NaN,NaN,507.1919000000019,509.1450972639324,505.2387027360714,508.16172267600376,507.69533687158656,508.7210987525345,506.66957499063864,3390,10575.333333333334,50.944313191141894,58.9555198075444,NaN,NaN,NaN,NaN,0.5839680177194928,28.987843697105,12254722
2025-08-28T12:40:00-04:00,507.901,508.04,507.7,507.79,507.1837778090992,NaN,NaN,NaN,NaN,NaN,507.22590000000196,509.160283300073,505.2915166999309,508.16172267600376,507.6964684432413,508.71838265956706,506.6745542269156,4022,10327.666666666666,49.540081778310046,58.55544933007537,NaN,NaN,NaN,NaN,0.5665417307395313,27.379600211413756,12250700
2025-08-28T12:45:00-04:00,507.83,508.02,507.71,507.86,507.1837778090992,NaN,NaN,NaN,NaN,NaN,507.26170000000195,509.17533278389834,505.34806721610556,508.16172267600376,507.6977445975645,508.7158473856681,506.6796418094609,4054,10168.066666666668,50.39896707937343,58.299309052647224,NaN,NaN,NaN,NaN,0.5482173214009934,25.88623126041475,12254754
2025-08-28T12:50:00-04:00,507.86,508,507.68,507.76,507.1837778090992,NaN,NaN,NaN,NaN,NaN,507.30470000000196,509.1637883872284,505.4456116127755,508.16172267600376,507.6984399163937,508.71351526108924,506.6833645716981,3208,9972.633333333333,49.11287913922999,57.96576244308719,NaN,NaN,NaN,NaN,0.5319160841580649,24.428006317393134,12251546
2025-08-28T12:55:00-04:00,507.81,507.96,507.65,507.81,507.1837778090992,NaN,NaN,NaN,NaN,NaN,507.33810000000193,509.1721260499183,505.50407395008557,508.16172267600376,507.69971580299756,508.70885765286357,506.69057395313155,6362,9784.3,49.80261814082395,57.641974308910406,NaN,NaN,NaN,NaN,0.5160649352896318,22.99840264748878,12257908
2025-08-28T13:00:00-04:00,507.8,507.98,507.53,507.91,507.1837778090992,NaN,NaN,NaN,NaN,NaN,507.377100000002,509.17482087701296,505.579379122991,508.16172267600376,507.70066200833094,508.70537986670087,506.695944149961,4817,9618.333333333334,51.22650493220334,57.24108921583536,NaN,NaN,NaN,NaN,0.5113460113403756,21.3621205537154,12262725
2025-08-28T13:05:00-04:00,507.89,508.05,507.79,507.96,507.1837778090992,NaN,NaN,NaN,NaN,NaN,507.41730000000194,509.17502262648327,505.6595773735206,508.16172267600376,507.70229484911476,508.7036694293904,506.7009202688391,3848,9502.233333333334,51.96025769890725,56.71476116323199,NaN,NaN,NaN,NaN,0.4933927248160624,20.02362776482216,12266573
2025-08-28T13:10:00-04:00,507.94,507.96,507.7,507.75,507.1837778090992,NaN,NaN,NaN,NaN,NaN,507.4481000000019,509.17380088715066,505.7223991128531,508.16172267600376,507.7028676092793,508.70142870659106,506.7043065119675,3126,9135.166666666666,48.649850928358966,55.834457603018265,NaN,NaN,NaN,NaN,0.47672181590062873,18.654567869573988,12263447
2025-08-28T13:15:00-04:00,507.81,507.86,507.52,507.55,507.1837778090992,NaN,NaN,NaN,NaN,NaN,507.47090000000185,509.1710713890285,505.7707286109752,507.804378140803,507.7024032517604,508.69707620807156,506.70773029544927,4335,8953.633333333333,45.665862631781266,54.46204706347242,NaN,NaN,NaN,NaN,0.466955971907729,17.865322797215715,12259112
2025-08-28T13:20:00-04:00,507.59,507.98,507.56,507.885,507.1837778090992,NaN,NaN,NaN,NaN,NaN,507.49560000000184,509.1831871984129,505.8080128015908,507.1066331066741,507.7032553615284,508.6939648167011,506.71254590635573,4507,8676.9,51.078566537889,53.35176080308065,NaN,NaN,NaN,NaN,0.46431625962860595,16.774346149224304,12263619
2025-08-28T13:25:00-04:00,507.82,508.62,507.82,508.6,507.1837778090992,NaN,NaN,NaN,NaN,NaN,507.5290000000018,509.2364753269751,505.82152467302853,507.4862369204937,507.71418933729143,508.69995870915267,506.7284199654302,9686,8755.833333333334,60.193293417188286,53.10944502787741,NaN,NaN,NaN,NaN,0.48829366965513493,16.938063786245,12273305
2025-08-28T13:30:00-04:00,508.65,509.03,508.63,508.65,507.23999221747846,NaN,NaN,NaN,NaN,NaN,507.5706000000019,509.2839320028185,505.85726799718526,507.90798953639495,507.7287978866299,508.7154621507215,506.74213362253823,7997,8772.4,60.74409868461071,52.807060887442795,NaN,NaN,NaN,NaN,0.48412983610833604,17.825018249797164,12281302
2025-08-28T13:35:00-04:00,508.67,508.84,508.28,508.415,507.23999221747846,NaN,NaN,NaN,NaN,NaN,507.6069000000018,509.31333240484713,505.9004675951565,507.90798953639495,507.733131232923,508.71877390017045,506.7474885656755,3217,8771.9,56.76824967895032,52.21464528888331,NaN,NaN,NaN,NaN,0.48954913352916934,17.68175050232747,12278085
2025-08-28T13:40:00-04:00,508.36,508.39,508.01,508.195,507.23999221747846,NaN,NaN,NaN,NaN,NaN,507.5832000000019,509.222048080764,505.9443519192398,507.90798953639495,507.739169535345,508.7198091845583,506.7585298861317,7643,8738.733333333334,53.25411452971409,52.09568988346304,NaN,NaN,NaN,NaN,0.4835099097056594,16.887047429267536,12270442
2025-08-28T13:45:00-04:00,508.24,508.44,508.03,508.1,507.23999221747846,NaN,NaN,NaN,NaN,NaN,507.57700000000193,509.20560307985556,505.9483969201483,507.90798953639495,507.7426400392767,508.72029225204113,506.76498782651225,4568,8407.433333333332,51.76397751150581,52.1542373349176,NaN,NaN,NaN,NaN,0.4782592018695427,16.25390130036623,12265874
2025-08-28T13:50:00-04:00,508.13,508.65,508.12,508.65,507.23999221747846,NaN,NaN,NaN,NaN,NaN,507.59660000000184,509.25256671225657,505.9406332877471,507.90798953639495,507.74614486322236,508.7227552939706,506.76953443247413,2860,8047.2,58.92920400864566,52.82488892279872,NaN,NaN,NaN,NaN,0.48338354459314353,16.101588462063827,12268734
2025-08-28T13:55:00-04:00,508.67,508.71,508.21,508.35,507.23999221747846,NaN,NaN,NaN,NaN,NaN,507.63160000000187,509.275764758145,505.98743524185875,507.90798953639495,507.74912659293113,508.72461554651164,506.7736376393506,2637,7855.066666666667,54.199870594218055,53.09638203100191,NaN,NaN,NaN,NaN,0.48457043426506186,16.082799329715332,12266097
2025-08-28T14:00:00-04:00,508.34,508.5,508.28,508.5,507.23999221747846,NaN,NaN,NaN,NaN,NaN,507.68400000000184,509.26740645196753,506.10059354803616,507.90798953639495,507.75211809896194,508.7264872080195,506.7777489899044,2656,7777.266666666666,56.097089139639664,53.595254173888314,NaN,NaN,NaN,NaN,0.4656725461032737,16.065352278248874,12268753
2025-08-28T14:05:00-04:00,508.55,508.79,508.53,508.65,507.23999221747846,NaN,NaN,NaN,NaN,NaN,507.72320000000184,509.30327564123974,506.14312435876394,507.90798953639495,507.762065677914,508.7356433609537,506.7884879948743,6689,7654.733333333334,57.97197288262516,54.1787795125884,NaN,NaN,NaN,NaN,0.45312450709589847,16.65499182643834,12275442
2025-08-28T14:10:00-04:00,508.64,508.65,508.32,508.32,507.23999221747846,NaN,NaN,NaN,NaN,NaN,507.76080000000184,509.30603442626875,506.2155655737349,507.90798953639495,507.76852016360147,508.7395832785474,506.79745704865553,5935,7718.933333333333,52.64538944471676,54.280128406339365,NaN,NaN,NaN,NaN,0.4443298994461903,16.55546735163586,12269507
2025-08-28T14:15:00-04:00,508.39,508.76,508.22,508.68,507.23999221747846,NaN,NaN,NaN,NaN,NaN,507.79660000000183,509.34241814984307,506.2507818501606,507.90798953639495,507.77849804019297,508.7473665716638,506.80962950872214,7909,7873.833333333333,57.25907330528411,54.65861523536629,NaN,NaN,NaN,NaN,0.4511634780571741,16.70201871429468,12277416
2025-08-28T14:20:00-04:00,508.7,509.09,508.7,509.06,507.4305176936053,NaN,NaN,NaN,NaN,NaN,507.8342000000019,509.40937536547614,506.25902463452763,508.05507300158615,507.79380163589144,508.7654691156545,506.82213415612836,8234,8036.5,61.52072739586433,55.577963554473804,NaN,NaN,NaN,NaN,0.4482232296245165,17.49577924365088,12285650
2025-08-28T14:25:00-04:00,509.03,509.38,509.02,509.14,507.75299416207775,NaN,NaN,NaN,NaN,NaN,507.8908000000019,509.446086929107,506.33551307089675,508.37205840126893,507.8072779927533,508.78372986348495,506.8308261220217,6188,8058.8,62.37136351042671,56.771213617234196,NaN,NaN,NaN,NaN,0.4419215703656234,18.731467066077183,12291838
2025-08-28T14:30:00-04:00,509.17,509.71,509.17,509.56,507.98103988198335,NaN,NaN,NaN,NaN,NaN,507.9546000000019,509.51681232612356,506.39238767388025,508.6186467210151,507.82995324838504,508.8188660357615,506.84104046100856,8747,8143,66.55190329140828,57.87645195677129,NaN,NaN,NaN,NaN,0.4510700296252213,20.37236485721002,12300585
2025-08-28T14:35:00-04:00,509.66,509.69,509.27,509.43,508.03008352371137,NaN,NaN,NaN,NaN,NaN,508.0228000000019,509.5382644937457,506.5073355062581,508.6186467210151,507.8380738282565,508.8311924221263,506.84495523438665,3224,7797.666666666667,64.17527974988184,58.16087955196368,NaN,NaN,NaN,NaN,0.44885074179484946,21.89605566326194,12297361
2025-08-28T14:40:00-04:00,509.4,509.5,509.285,509.41,508.03008352371137,NaN,NaN,NaN,NaN,NaN,508.0876000000019,509.55700564580104,506.6181943542027,508.6186467210151,507.8524532652928,508.8521651108869,506.8527414196987,6032,6999.2,63.79781444225967,58.37900210608147,NaN,NaN,NaN,NaN,0.43214711738092987,23.31091141173872,12291329
2025-08-28T14:45:00-04:00,509.39,509.41,509.14,509.22,508.03008352371137,NaN,NaN,NaN,NaN,NaN,508.1480000000019,509.5487512241262,506.7472487758776,508.6186467210151,507.86754553336954,508.8723575112173,506.8627335555218,7111,6643.666666666667,60.17667107416111,58.622460777167966,NaN,NaN,NaN,NaN,0.42056518042515195,24.068507048627392,12284218
2025-08-28T14:50:00-04:00,509.2,509.27,508.96,509.18,508.03008352371137,NaN,NaN,NaN,NaN,NaN,508.1978000000019,509.56430087153257,506.83129912847124,508.6186467210151,507.87630643531185,508.8831427094682,506.8694701611555,4599,6423.766666666666,59.41212080105294,59.06231836797787,NaN,NaN,NaN,NaN,0.4126676675376412,24.117372373887207,12279619
2025-08-28T14:55:00-04:00,509.18,509.63,509.09,509.58,508.03008352371137,NaN,NaN,NaN,NaN,NaN,508.2604000000019,509.58708886778595,506.9337111322178,508.6509293575422,507.8906583008389,508.90382936709443,506.8774872345833,6198,5454.133333333333,64.29713311291616,59.957543768078615,NaN,NaN,NaN,NaN,0.42176283414209687,24.85321299738545,12285817
2025-08-28T15:00:00-04:00,509.57,509.91,509.57,509.62,508.3794516341627,NaN,NaN,NaN,NaN,NaN,508.30040000000196,509.6674315840085,506.9333684159954,508.9567434860338,507.9140996079723,508.9412705821288,506.8869286338157,8826,5420.833333333333,64.75397314635167,60.373598706486185,NaN,NaN,NaN,NaN,0.4159226317033779,25.99157010656718,12294643
2025-08-28T15:05:00-04:00,509.61,509.62,509.42,509.57,508.3794516341627,NaN,NaN,NaN,NaN,NaN,508.3518000000019,509.7126361516808,506.990963848323,508.9567434860338,507.92904910805424,508.963163377078,506.8949348390305,6335,5519,63.657481784257705,61.049142362917586,NaN,NaN,NaN,NaN,0.4004995865817072,26.51489483787009,12288308
2025-08-28T15:10:00-04:00,509.535,509.76,509.535,509.61,508.3794516341627,NaN,NaN,NaN,NaN,NaN,508.39920000000194,509.7669154059139,507.03148459409,508.9574158310616,507.94011206525784,508.97992352371455,506.9003006068011,4488,5534.533333333334,64.18004460222332,61.626496324530706,NaN,NaN,NaN,NaN,0.38796390182586854,27.242052253199073,12292796
2025-08-28T15:15:00-04:00,509.61,509.96,509.6,509.84,508.49344774455113,NaN,NaN,NaN,NaN,NaN,508.4498000000019,509.8396085593594,507.0599914406444,509.1379326648493,507.96165474825193,509.01440702647164,506.9089024700322,8110,5669.733333333334,67.10863053810701,62.279114728493695,NaN,NaN,NaN,NaN,0.38596648026687486,28.24410844492372,12300906
2025-08-28T15:20:00-04:00,509.84,510,509.52,509.52,508.49344774455113,NaN,NaN,NaN,NaN,NaN,508.4844000000019,509.89279573688736,507.0760042631165,509.1379326648493,507.99276196232546,509.0608018967723,506.9247220278786,12909,5993.1,59.784916411867016,62.789080940433,NaN,NaN,NaN,NaN,0.39268316024781363,28.869885958853263,12287997
2025-08-28T15:25:00-04:00,509.54,509.71,509.51,509.71,508.49344774455113,NaN,NaN,NaN,NaN,NaN,508.51640000000197,509.96154225995616,507.07125774004777,509.1379326648493,508.01069591267094,509.0866117054521,506.93478011988975,7833,6042.133333333333,62.40813897830468,63.15687134564876,NaN,NaN,NaN,NaN,0.37892007737296896,29.411346959208856,12295830
2025-08-28T15:30:00-04:00,509.7,509.75,509.57,509.73,508.49344774455113,NaN,NaN,NaN,NaN,NaN,508.55000000000194,510.0279526350128,507.0720473649911,509.1379326648493,508.02709247182474,509.1103300976689,506.9438548459806,7137,6119.466666666666,62.684070619830756,63.23996729021779,NaN,NaN,NaN,NaN,0.36471150041775735,29.991937054565053,12302967
2025-08-28T15:35:00-04:00,509.72,510,509.71,509.87,508.64214172020377,NaN,NaN,NaN,NaN,NaN,508.603000000002,510.07642729415346,507.12957270585053,509.25940121952226,508.0560695918854,509.1547623076455,506.95737687612524,11695,6381.033333333334,64.64063805611752,63.40205832919571,NaN,NaN,NaN,NaN,0.3593749646736333,30.99252776661345,12314662
2025-08-28T15:40:00-04:00,509.91,510.36,509.85,510.31,508.87772618746726,NaN,NaN,NaN,NaN,NaN,508.657200000002,510.1776817103053,507.13671828969865,509.51252097561786,508.1053953326047,509.23721066085255,506.97358000435685,17645,6865,69.96989576906901,63.64620064902862,NaN,NaN,NaN,NaN,0.37013389576837313,32.4745703904479,12332307
2025-08-28T15:45:00-04:00,510.31,510.5,510.16,510.18,509.1121477244006,NaN,NaN,NaN,NaN,NaN,508.7112000000019,510.25225490868365,507.17014509132014,509.65201678049425,508.14740547047256,509.307512962096,506.98729797884914,14920,7217.833333333333,66.7680081672913,63.83139553598643,NaN,NaN,NaN,NaN,0.367981474642059,34.03938865836317,12317387
2025-08-28T15:50:00-04:00,510.19,510.9,510,510.87,509.16477737329143,NaN,NaN,NaN,NaN,NaN,508.77940000000194,510.39304139493464,507.16575860506924,509.7716134243954,508.31835340915717,509.59897505247926,507.0377317658351,58119,9004.9,73.65819260453361,64.53570826186315,NaN,NaN,NaN,NaN,0.4059827978819103,35.962020410657495,12375506
2025-08-28T15:55:00-04:00,510.84,510.84,509.1,509.57,NaN,NaN,NaN,511.4381670527673,511.4381670527673,511.4381670527673,508.820400000002,510.4079236537281,507.2328763462759,509.7716134243954,508.47016169750054,509.7676455232303,507.17267787177076,92255,11757.2,51.84708346173093,63.940737718118136,NaN,NaN,NaN,NaN,0.503412598033201,34.77169818121744,12283251
2025-08-29T09:30:00-04:00,508.97,509.6,507.37,508.23,NaN,NaN,NaN,510.1905230958233,NaN,NaN,508.82920000000195,510.3985531888162,507.2598468111877,509.7716134243954,508.40000000000003,508.40000539479666,508.3999946052034,41307,12867.533333333333,39.02084095002655,62.484217728759106,NaN,NaN,NaN,NaN,0.6267402696022594,33.88237840682382,12241944
2025-08-29T09:35:00-04:00,508.07,508.2,506.99,507.2,NaN,NaN,NaN,509.3920902278314,NaN,NaN,508.8118000000019,510.4328771208311,507.19072287917265,509.7716134243954,508.1027464881838,508.5387141541377,507.6667788222299,19203,13400.4,32.38829443671894,60.205014966173586,NaN,NaN,NaN,NaN,0.6705445360592416,33.479558225419,12222741
2025-08-29T09:40:00-04:00,507.19,507.56,506,506.22,NaN,NaN,NaN,508.70813158111173,NaN,NaN,508.7710000000019,510.541386396143,507.00061360386076,509.7716134243954,507.68754078262714,508.45702475988867,506.9180568053656,22961,13911,27.584142804956045,57.55002708464533,NaN,NaN,NaN,NaN,0.7340770691978673,34.008615577170346,12199780
2025-08-29T09:45:00-04:00,506.2,506.21,505.37,506.09,NaN,NaN,NaN,507.7463983274248,NaN,NaN,508.7179000000019,510.6409071116494,506.7948928883544,509.7716134243954,507.31726372797095,508.31657360651366,506.31795384942825,21655,14480.566666666668,27.011764011887948,54.93247581519035,NaN,NaN,NaN,NaN,0.7423572785408784,34.95481012766252,12178125
2025-08-29T09:50:00-04:00,505.94,506.23,505.58,505.59,NaN,NaN,NaN,507.7463983274248,NaN,NaN,508.6501000000018,510.76120728102734,506.5389927189763,509.7716134243954,507.1188023305167,508.1816898537996,506.0559148072338,15820,14912.566666666668,24.87390369498324,52.12489432181606,NaN,NaN,NaN,NaN,0.7357603300736753,35.79481800784585,12162305
2025-08-29T09:55:00-04:00,505.605,505.74,504.7,504.85,NaN,NaN,NaN,507.2290116991619,NaN,NaN,508.5717000000019,510.93523515554807,506.2081648444557,509.7716134243954,506.80934826807845,508.0287087115451,505.5899878246118,21853,15553.1,22.087640700801657,48.90910933343711,NaN,NaN,NaN,NaN,0.7574917350684142,37.13864948266351,12140452
2025-08-29T10:00:00-04:00,504.79,505.73,504.66,505.09,NaN,NaN,NaN,507.2290116991619,NaN,NaN,508.4947000000019,511.04842465854546,505.94097534145834,509.7716134243954,506.5950097687984,507.860394199111,505.32962533848576,21329,16175.533333333333,25.021108850140706,46.42598022188523,NaN,NaN,NaN,NaN,0.7798137539920983,38.40983494149263,12161781
2025-08-29T10:05:00-04:00,505.06,505.16,504.49,504.815,NaN,NaN,NaN,506.8861656184513,NaN,NaN,508.41200000000185,511.161687980814,505.6623120191897,509.7716134243954,506.38599207415615,507.7048711120879,505.0671130362244,21930,16683.566666666666,23.910234369487654,43.67612989268401,NaN,NaN,NaN,NaN,0.7719699144212352,39.69290317229287,12139851
2025-08-29T10:10:00-04:00,504.88,505.58,504.67,505.57,NaN,NaN,NaN,506.8861656184513,NaN,NaN,508.3586000000019,511.2209710716238,505.49622892838,509.0522907395163,506.2660971827924,507.5587824196888,504.97341194589603,22470,17234.733333333334,32.739372184234924,41.53722286157002,NaN,NaN,NaN,NaN,0.7818292062482876,40.01050052572155,12162321
2025-08-29T10:15:00-04:00,505.47,506,505.29,505.98,NaN,NaN,NaN,506.8861656184513,NaN,NaN,508.32000000000187,511.25661846208163,505.3833815379221,507.0548325916131,506.21732878296416,507.4556868335529,504.97897073237544,22076,17706.966666666667,37.013625423042754,39.563864816350396,NaN,NaN,NaN,NaN,0.7766985486591228,39.50539479956503,12184397
2025-08-29T10:20:00-04:00,505.98,506.38,505.5,505.5,NaN,NaN,NaN,506.8861656184513,NaN,NaN,508.2742000000019,511.3121363771643,505.2362636228395,505.5438660732904,506.1894884594088,507.3910979198702,504.98787899894734,16206,17972.7,34.268065158955494,37.01373405848515,NaN,NaN,NaN,NaN,0.7840772237548995,38.36803537897063,12168191
2025-08-29T10:25:00-04:00,505.48,506.13,505.19,506.12,NaN,NaN,NaN,506.8861656184513,NaN,NaN,508.23940000000187,511.3348376995739,505.14396230042985,504.6550928586324,506.1754729900167,507.35663458053244,504.994311399501,9552,18084.833333333332,40.41606274474463,35.131452242588956,NaN,NaN,NaN,NaN,0.7952145649152637,37.62977875970003,12177743
2025-08-29T10:30:00-04:00,506.05,506.53,505.83,506.33,NaN,NaN,NaN,506.8861656184513,NaN,NaN,508.2108000000019,511.3495483861817,505.07205161382205,504.3717197403477,506.17735307594864,507.33801551643825,505.01669063545904,9155,18098.433333333334,42.38181654031235,32.89742538085886,NaN,NaN,NaN,NaN,0.7884135245641726,36.259625394614986,12186898
2025-08-29T10:35:00-04:00,506.35,506.91,506.27,506.87,504.45256460948207,504.45256460948207,504.45256460948207,NaN,NaN,NaN,508.1920000000019,511.3513189126667,505.03268108733704,504.8633757922782,506.19357761632386,507.3389538209154,505.04820141173235,8796,18284.166666666668,47.20518405296852,32.565861137375826,NaN,NaN,NaN,NaN,0.7778125585238777,34.38544637374021,12195694
2025-08-29T10:40:00-04:00,506.85,506.99,506.23,506.23,504.46608439996015,NaN,NaN,NaN,NaN,NaN,508.15840000000185,511.3643902919432,504.9524097080605,504.97270063382257,506.20098742978394,507.33254847493816,505.0694263846297,7199,18323.066666666666,42.64834327029957,32.82496844596675,NaN,NaN,NaN,NaN,0.7765402329150286,32.5203955827457,12188495
2025-08-29T10:45:00-04:00,506.22,506.585,505.83,505.9,504.46608439996015,NaN,NaN,NaN,NaN,NaN,508.11720000000184,511.3846859803906,504.8497140196131,504.97270063382257,506.1989941051382,507.3188278782178,505.07916033205856,5970,18285.033333333333,40.47855285642648,33.402844047374444,NaN,NaN,NaN,NaN,0.7750016448496692,31.30445741402727,12182525
2025-08-29T10:50:00-04:00,505.91,506.59,505.65,506.56,504.46608439996015,NaN,NaN,NaN,NaN,NaN,508.09340000000185,511.38845716976834,504.79834283023536,504.97270063382257,506.20059778351333,507.30713118392373,505.09406438310293,6978,18364.333333333332,46.35676506002722,34.74374563702238,NaN,NaN,NaN,NaN,0.7867872416461212,30.397230534666893,12189503
2025-08-29T10:55:00-04:00,506.52,506.88,506.26,506.84,504.46608439996015,NaN,NaN,NaN,NaN,NaN,508.0792000000018,511.3895856923822,504.76881430762137,504.97270063382257,506.2103210261491,507.30707703813766,505.1135650141605,6367,18369.966666666667,48.67266235525931,36.29095266154891,NaN,NaN,NaN,NaN,0.7748738672428271,29.04692345797401,12195870
2025-08-29T11:00:00-04:00,506.8,507.1,506.65,506.74,504.7467023478103,NaN,NaN,NaN,NaN,NaN,508.0563000000018,511.3875182804807,504.72508171952285,505.3066341796137,506.23265013629333,507.3156406572081,505.14965961537854,11245,18450.6,47.877668123509046,37.934078692157904,NaN,NaN,NaN,NaN,0.7516685910111999,27.421226619636407,12184625
2025-08-29T11:05:00-04:00,506.7,507.27,506.46,507.26,504.7467023478103,NaN,NaN,NaN,NaN,NaN,508.0295000000018,511.36434947069455,504.69465052930906,505.4303073436909,506.2532536482903,507.32868668498656,505.17782061159403,8649,18527.733333333334,52.24564090028931,40.08822156354987,NaN,NaN,NaN,NaN,0.7558351202246857,26.19023870879502,12193274
2025-08-29T11:10:00-04:00,507.29,507.51,507.19,507.33,505.2617163954222,NaN,NaN,NaN,NaN,NaN,508.0031000000017,511.3387821720072,504.66741782799625,505.87824587495277,506.28578585969797,507.3611669294291,505.21040478996684,9866,18707,52.818838148635365,42.07377365629949,NaN,NaN,NaN,NaN,0.7247040402086362,24.625462300601217,12203140
2025-08-29T11:15:00-04:00,507.34,507.65,507.27,507.58,505.4148201956302,NaN,NaN,NaN,NaN,NaN,507.98640000000177,511.3220271003406,504.6507728996629,506.1545966999622,506.3193600656493,507.39829781915853,505.24042231214,9401,18750.033333333333,54.90086323138003,44.28739000357752,NaN,NaN,NaN,NaN,0.7000823230508761,22.929891232545145,12212541
2025-08-29T11:20:00-04:00,507.56,507.9,507.25,507.86,505.5341465503743,NaN,NaN,NaN,NaN,NaN,507.97970000000174,511.31496994897304,504.64443005103044,506.37867735996974,506.3604057391542,507.44782602989665,505.27298544841176,10656,18674.933333333334,57.179981601111436,46.033147819068695,NaN,NaN,NaN,NaN,0.6965050142615262,21.653335932992597,12223197
2025-08-29T11:25:00-04:00,507.85,508.35,507.7,508.12,505.98827625263004,NaN,NaN,NaN,NaN,NaN,507.98010000000176,511.3154323601189,504.6447676398846,506.80794188797586,506.41471085087915,507.5254730974788,505.30394860427947,11597,18800.4,59.23982720412379,47.62073366057449,NaN,NaN,NaN,NaN,0.6931832275285625,21.163253106956954,12234794
2025-08-29T11:30:00-04:00,508.12,508.17,507.48,507.63,505.98827625263004,NaN,NaN,NaN,NaN,NaN,507.95970000000176,511.2908682083886,504.62853179161493,506.80794188797586,506.4397962563619,507.5551008181242,505.3244916945996,6883,18791.933333333334,53.97053859093725,49.02805319143033,NaN,NaN,NaN,NaN,0.692955854133665,20.288240320723975,12227911
2025-08-29T11:35:00-04:00,507.64,508.01,507.4,507.99,505.98827625263004,NaN,NaN,NaN,NaN,NaN,507.95250000000175,511.2818183975925,504.623181602411,506.80794188797586,506.4715495911684,507.59273138707596,505.35036779526087,8823,18696.2,56.996953914994414,50.212402560733885,NaN,NaN,NaN,NaN,0.6870304359812612,19.322768208335813,12236734
2025-08-29T11:40:00-04:00,507.99,508.2,507.76,507.83,505.98827625263004,NaN,NaN,NaN,NaN,NaN,507.93910000000176,511.2648875386898,504.61331246131374,506.80794188797586,506.52188376586275,507.6552599657039,505.3885075660216,13510,18558.366666666665,55.25799266806081,51.13212942700164,NaN,NaN,NaN,NaN,0.6693854048397424,18.745108092733158,12223224
2025-08-29T11:45:00-04:00,507.81,507.91,507.57,507.72,505.98827625263004,NaN,NaN,NaN,NaN,NaN,507.92050000000177,511.2405736426434,504.6004263573601,506.80794188797586,506.53217831947023,507.6661938819854,505.39816275695506,3355,18172.866666666665,54.03734686799026,51.62014105664604,NaN,NaN,NaN,NaN,0.6458578759226202,17.81909930255033,12219869
2025-08-29T11:50:00-04:00,507.67,507.73,507.415,507.435,505.98827625263004,NaN,NaN,NaN,NaN,NaN,507.9028000000017,511.2236018057223,504.58199819428114,506.80794188797586,506.5553989806664,507.686114553612,505.42468340772075,9439,16550.2,50.90009077253044,52.20955159251968,NaN,NaN,NaN,NaN,0.6222251704995757,16.647173067678565,12210430
2025-08-29T11:55:00-04:00,507.47,507.51,507.15,507.29,505.98827625263004,NaN,NaN,NaN,NaN,NaN,507.87500000000176,511.1925822510702,504.55741774893335,506.80794188797586,506.57389787418236,507.6969250236294,505.45087072473535,10068,13810.633333333333,49.33087523236253,52.84186033365796,NaN,NaN,NaN,NaN,0.6034948011781784,15.86912959601015,12200362
2025-08-29T12:00:00-04:00,507.28,507.95,507.265,507.8,505.98827625263004,NaN,NaN,NaN,NaN,NaN,507.8498000000017,511.15009147693326,504.5495085230702,506.80794188797586,506.5969806459083,507.71924517953227,505.4747161122843,8899,12730.366666666667,54.62907723977173,53.432739775068285,NaN,NaN,NaN,NaN,0.6093166010940231,15.172028335065063,12209261
2025-08-29T12:05:00-04:00,507.79,507.79,507.44,507.72,505.98827625263004,NaN,NaN,NaN,NaN,NaN,507.82140000000174,511.1011676979631,504.5416323020404,506.80794188797586,506.6093051747893,507.7307162687021,505.4878940808765,5012,12257.333333333334,53.68085737749157,53.79046799094202,NaN,NaN,NaN,NaN,0.591508272444451,14.524720021330337,12204249
2025-08-29T12:10:00-04:00,507.69,508.04,507.67,507.98,506.0471847555505,NaN,NaN,NaN,NaN,NaN,507.7898000000017,511.03218736624024,504.5474126337632,506.89293465256014,506.639814431462,507.7650279277825,505.5146009351415,10395,11838.466666666667,56.333631677755534,54.39446538767391,NaN,NaN,NaN,NaN,0.5756862529841335,14.385302438952637,12214644
2025-08-29T12:15:00-04:00,507.96,508.015,507.66,507.69,506.0634490848436,NaN,NaN,NaN,NaN,NaN,507.75500000000176,510.96339648307475,504.54660351692877,506.91984772204813,506.64649430367655,507.77182491595113,505.52116369140197,2566,11202.166666666666,52.70767209914697,54.427467616163746,NaN,NaN,NaN,NaN,0.5599229491995498,14.23206998938177,12212078
2025-08-29T12:20:00-04:00,507.7,507.97,507.63,507.91,506.0634490848436,NaN,NaN,NaN,NaN,NaN,507.7250000000017,510.89880024463247,504.551199755371,506.9238781776385,506.65051096904875,507.77605952827116,505.52496240982634,1494,10724.633333333333,55.070314291396016,54.58828734064665,NaN,NaN,NaN,NaN,0.5442141671138699,14.013928409749562,12213572
2025-08-29T12:25:00-04:00,507.92,507.98,507.38,507.45,506.0634490848436,NaN,NaN,NaN,NaN,NaN,507.68960000000175,510.83527057282794,504.54392942717556,506.9238781776385,506.6803408775938,507.8004885919865,505.56019316320106,14307,10473.1,49.50169915061177,54.20263276344891,NaN,NaN,NaN,NaN,0.5481988694628809,13.189840051772524,12199265
2025-08-29T12:30:00-04:00,507.4,507.96,507.34,507.9,506.0634490848436,NaN,NaN,NaN,NaN,NaN,507.6640000000017,510.7814444651075,504.5465555348959,506.9238781776385,506.7014508088859,507.8200926532714,505.58280896450043,9349,10073.766666666666,54.36333994062827,54.001444073414405,NaN,NaN,NaN,NaN,0.553327521644104,12.327216294376523,12208614
2025-08-29T12:35:00-04:00,507.89,508.44,507.83,508.37,506.38341243754473,NaN,NaN,NaN,NaN,NaN,507.6398000000017,510.7158864475871,504.5637135524163,507.1593856269509,506.72201026221353,507.846734073421,505.5972864510061,6429,9557.066666666668,58.822342914088544,53.97162376698332,NaN,NaN,NaN,NaN,0.5573755558123833,12.56259398266842,12215043
2025-08-29T12:40:00-04:00,508.37,508.42,508.15,508.24,506.5762118722017,NaN,NaN,NaN,NaN,NaN,507.6122000000017,510.64112466609134,504.583275333912,507.2605085015607,506.7380629226639,507.86787583802993,505.6082500072979,4954,8973.2,57.158788161182336,54.19935587914368,NaN,NaN,NaN,NaN,0.5368487303972158,12.781158978939464,12210089
2025-08-29T12:45:00-04:00,508.26,508.45,508.06,508.1,506.5762118722017,NaN,NaN,NaN,NaN,NaN,507.58280000000167,510.56329066982215,504.6023093301812,507.32740680124857,506.77510471373336,507.9140130678167,505.63619635965,12390,8650.333333333334,55.34355992320605,54.081256308301654,NaN,NaN,NaN,NaN,0.5263595353688423,12.728750831736551,12197699
2025-08-29T12:50:00-04:00,508.14,508.25,508,508.25,506.5762118722017,NaN,NaN,NaN,NaN,NaN,507.55560000000173,510.4859949482435,504.62520505175996,507.32740680124857,506.7927041632421,507.93502123982364,505.65038708666054,6278,8319.4,56.92208262426214,54.200119876601754,NaN,NaN,NaN,NaN,0.5066195685567821,12.506276939690036,12203977
2025-08-29T12:55:00-04:00,508.25,508.81,508.22,508.67,506.86734439786443,NaN,NaN,NaN,NaN,NaN,507.5322000000017,510.40742114501523,504.65697885498815,507.6965403527991,506.82376372785376,507.9796942485058,505.66783320720174,8846,8295.866666666667,61.07141362680018,54.70255321651674,NaN,NaN,NaN,NaN,0.5125753136598673,13.456457563189641,12212823
2025-08-29T13:00:00-04:00,508.63,508.64,507.9,507.9,506.86734439786443,NaN,NaN,NaN,NaN,NaN,507.49980000000164,510.32068848290754,504.67891151709574,507.6965403527991,506.8451931496083,508.0038219833703,505.6865643158463,8319,8268,51.31304372409137,54.73204985591396,NaN,NaN,NaN,NaN,0.5309627912555939,13.446332529836624,12204504
2025-08-29T13:05:00-04:00,507.97,508.37,507.97,508.06,506.86734439786443,NaN,NaN,NaN,NaN,NaN,507.4668000000017,510.2213168420008,504.71228315800255,507.6965403527991,506.85688988988227,508.01670081232714,505.6970789674374,4706,8131.666666666667,52.993813627425965,54.9936883127042,NaN,NaN,NaN,NaN,0.5266083061659106,13.436930713151678,12209210
2025-08-29T13:10:00-04:00,508.05,508.07,507.5,507.51,506.86734439786443,NaN,NaN,NaN,NaN,NaN,507.42240000000174,510.10005960356114,504.74474039644235,507.6965403527991,506.8653998580315,508.02234471562946,505.7084550004335,5327,8069.266666666666,46.98875850026678,54.44795125988242,NaN,NaN,NaN,NaN,0.5297077128683451,12.69719810050249,12203883
2025-08-29T13:15:00-04:00,507.55,507.89,507.34,507.76,506.86734439786443,NaN,NaN,NaN,NaN,NaN,507.3802000000017,509.96720518607077,504.79319481393264,507.6965403527991,506.8770013300334,508.0294694282752,505.7245332317916,7725,8127.766666666666,49.77472658379897,54.16894191747581,NaN,NaN,NaN,NaN,0.5311571619491784,12.359024118516096,12211608
2025-08-29T13:20:00-04:00,507.79,508.22,507.79,508.06,506.86734439786443,NaN,NaN,NaN,NaN,NaN,507.3352000000017,509.79177644552976,504.8786235544736,507.6965403527991,506.88904836442833,508.0413891765344,505.7367075523223,5643,8083.266666666666,52.96890507195049,53.928604302775454,NaN,NaN,NaN,NaN,0.5260745075242397,11.683464432145875,12217251
2025-08-29T13:25:00-04:00,508.12,508.32,508.04,508.095,506.86734439786443,NaN,NaN,NaN,NaN,NaN,507.29350000000176,509.62299887157013,504.9640011284334,507.6965403527991,506.9027549057354,508.05626802097544,505.7492417904953,5893,8067.466666666666,53.34172321500335,53.973893668193774,NaN,NaN,NaN,NaN,0.508497756986792,11.276673923940242,12223144
2025-08-29T13:30:00-04:00,508.08,508.21,507.65,507.88,506.86734439786443,NaN,NaN,NaN,NaN,NaN,507.2337000000017,509.33524020489347,505.13215979510994,507.6965403527991,506.92103071543954,508.07197143292916,505.7700899979499,9998,8025.9,50.68383613298756,53.66057379973602,NaN,NaN,NaN,NaN,0.5121764886305927,10.93531313500268,12213146
2025-08-29T13:35:00-04:00,507.84,508.31,507.65,508.19,506.86734439786443,NaN,NaN,NaN,NaN,NaN,507.20610000000175,509.21854158990294,505.19365841010057,507.6965403527991,506.9384088464306,508.0888832964148,505.7879343964464,8643,8025.7,54.22545209081308,53.99798472403611,NaN,NaN,NaN,NaN,0.5227353108712665,10.378675604680158,12221789
2025-08-29T13:40:00-04:00,508.22,508.25,507.81,507.87,506.86734439786443,NaN,NaN,NaN,NaN,NaN,507.19890000000174,509.19917626911285,505.19862373089063,507.6965403527991,506.94428879562236,508.0941435320305,505.7944340592142,3198,7803.433333333333,50.216493841994264,53.70178143127654,NaN,NaN,NaN,NaN,0.516825645809033,9.8617978979521,12218591
2025-08-29T13:45:00-04:00,507.94,508.22,507.93,508.14,506.86734439786443,NaN,NaN,NaN,NaN,NaN,507.2177000000018,509.23525912741763,505.20014087258596,507.36423228223924,506.95231782062376,508.10216212393016,505.80247351731737,3962,7622.133333333333,53.35032398072897,53.31092293603656,NaN,NaN,NaN,NaN,0.5049095282512466,9.381840027418905,12222553
2025-08-29T13:50:00-04:00,508.2,508.94,508.19,508.81,506.9327548984918,NaN,NaN,NaN,NaN,NaN,507.2695000000018,509.3147415487215,505.22425845128214,507.5953712526931,506.9776443707657,508.13723463075075,505.8180541107806,8629,7554.566666666667,60.067837176860785,53.51871215144217,NaN,NaN,NaN,NaN,0.5259874190904441,10.113720118067498,12231182
2025-08-29T13:55:00-04:00,508.86,508.92,508.5,508.65,507.09467513037856,NaN,NaN,NaN,NaN,NaN,507.3207000000018,509.3734279490042,505.2679720509994,507.6342970021545,506.9953517236886,508.16186463685426,505.82883881052294,6032,7369.066666666667,57.92277864544272,53.70294206017336,NaN,NaN,NaN,NaN,0.5184168891554135,10.793323059384049,12225150
2025-08-29T14:00:00-04:00,508.65,508.68,508.4,508.4,507.09467513037856,NaN,NaN,NaN,NaN,NaN,507.37690000000185,509.3905095829065,505.36329041709723,507.6342970021545,507.00820910447,508.17789609714765,505.8385221117923,5050,7307.966666666666,54.639494037182935,53.53990001823912,NaN,NaN,NaN,NaN,0.5013871113586004,11.13095400788772,12220100
2025-08-29T14:05:00-04:00,508.42,508.88,508.3,508.81,507.09467513037856,NaN,NaN,NaN,NaN,NaN,507.4561000000018,509.3752188479919,505.5369811520117,507.65515008137885,507.0207802831218,508.19484366879857,505.846716897445,4503,7163.966666666666,58.76738790839717,53.375326752638905,NaN,NaN,NaN,NaN,0.5070023176901277,11.860042218320913,12224603
2025-08-29T14:10:00-04:00,508.79,508.88,508.64,508.86,507.21207328910924,NaN,NaN,NaN,NaN,NaN,507.5315000000018,509.36727694520755,505.6957230547961,507.78012006510306,507.03933895695866,508.221093796758,505.8575841171593,6273,6922.733333333334,59.25435837680121,53.94256351354676,NaN,NaN,NaN,NaN,0.4879307235694049,12.537052699437451,12230876
2025-08-29T14:15:00-04:00,508.85,508.9,508.71,508.74,507.3015245032406,NaN,NaN,NaN,NaN,NaN,507.6100000000019,509.30467282752625,505.91532717247753,507.92509605208244,507.06082364564713,508.2509277235114,505.8707195677829,7473,7060,57.49918747875845,54.26437593149909,NaN,NaN,NaN,NaN,0.4666499576001616,13.210227151326581,12223403
2025-08-29T14:20:00-04:00,508.73,509,508.5,508.78,507.3015245032406,NaN,NaN,NaN,NaN,NaN,507.67420000000186,509.296548123078,506.0518518769257,507.97007684166596,507.09073552481414,508.291296027027,505.8901750226013,10870,7107.7,57.946350853671454,55.04706109959942,NaN,NaN,NaN,NaN,0.4690321034858643,13.118945504838415,12234273
2025-08-29T14:25:00-04:00,508.81,508.83,508.59,508.7,507.3015245032406,NaN,NaN,NaN,NaN,NaN,507.7286000000019,509.30172814236755,506.15547185763626,507.97007684166596,507.1072687306815,508.3126905410437,505.90184692031926,6383,6984.866666666667,56.66231258592828,55.53903152832294,NaN,NaN,NaN,NaN,0.45267266752258895,13.034183975956545,12227890
2025-08-29T14:30:00-04:00,508.71,509.01,508.64,508.72,507.3735474666145,NaN,NaN,NaN,NaN,NaN,507.7930000000018,509.2556824646845,506.3303175353191,508.06984917866623,507.1391549289867,508.35494566739686,505.9233641905766,12050,7089.9,56.91932792136006,55.821204588995045,NaN,NaN,NaN,NaN,0.4467674769852615,13.430844898569061,12239940
2025-08-29T14:35:00-04:00,508.725,508.79,508.5,508.59,507.3735474666145,NaN,NaN,NaN,NaN,NaN,507.8424000000019,509.2411783785851,506.44362162141863,508.06984917866623,507.16023425356343,508.380116175924,505.94035233120286,9141,7227.533333333334,54.65058062445035,55.914694403955544,NaN,NaN,NaN,NaN,0.43556980005774426,13.294932466084669,12230799
2025-08-29T14:40:00-04:00,508.59,508.77,508.4,508.6,507.3735474666145,NaN,NaN,NaN,NaN,NaN,507.8878000000018,509.23363231965345,506.5419676803501,508.06984917866623,507.1749169337684,508.3970491945281,505.95278467300864,6693,7104.133333333333,54.79982836888859,56.20869384937705,NaN,NaN,NaN,NaN,0.43088624291076283,12.819913374494357,12237492
2025-08-29T14:45:00-04:00,508.57,508.57,508.04,508.05,507.3735474666145,NaN,NaN,NaN,NaN,NaN,507.91140000000183,509.2260361292985,506.59676387070516,508.06984917866623,507.1866606336992,508.40688957954285,505.96643168785556,7407,7265.5,45.86020176337107,55.61117596884548,NaN,NaN,NaN,NaN,0.4401086541314228,12.535042479166222,12230085
2025-08-29T14:50:00-04:00,508.04,508.22,507.66,508.12,507.3735474666145,NaN,NaN,NaN,NaN,NaN,507.9492000000019,509.1738899331631,506.7245100668407,508.06984917866623,507.19162623422113,508.4097733308691,505.9734791375732,4049,7350.666666666667,47.04426051458009,55.38458787403018,NaN,NaN,NaN,NaN,0.44867232169346416,13.192662816676584,12234134
2025-08-29T14:55:00-04:00,508.12,508.41,508.1,508.41,507.3735474666145,NaN,NaN,NaN,NaN,NaN,507.99940000000186,509.08145108584773,506.917348914156,508.06984917866623,507.20718988055677,508.4238584074064,505.99052135370715,9388,7186.7,51.75208052872326,55.270427627458346,NaN,NaN,NaN,NaN,0.4387671558582169,13.187232103555349,12243522
2025-08-29T15:00:00-04:00,508.45,508.63,508.44,508.5,507.3735474666145,NaN,NaN,NaN,NaN,NaN,508.0382000000019,509.04771029328697,507.0286897067168,508.06984917866623,507.21403621698636,508.43122397414277,505.99684845982995,3517,6992.3,53.14427115885857,54.775887197601044,NaN,NaN,NaN,NaN,0.42314093043977075,12.526330549405094,12247039
2025-08-29T15:05:00-04:00,508.5,508.75,508.46,508.72,507.3735474666145,NaN,NaN,NaN,NaN,NaN,508.07580000000183,509.0431621000499,507.10843789995374,508.06984917866623,507.2247493991137,508.44361722398025,506.00588157424716,5106,6948.2,56.45216482954304,54.67084335360821,NaN,NaN,NaN,NaN,0.4136308639797886,11.688425392480442,12252145
2025-08-29T15:10:00-04:00,508.7,508.79,508.53,508.74,507.3735474666145,NaN,NaN,NaN,NaN,NaN,508.11580000000185,509.0224054447052,507.2091945552985,508.06984917866623,507.23256405651426,508.4528347755846,506.0122933374439,3661,6905.1,56.75108557213997,54.821671320390855,NaN,NaN,NaN,NaN,0.40265723083837857,11.024278462032907,12255806
2025-08-29T15:15:00-04:00,508.73,508.93,508.7,508.93,507.51567306277417,NaN,NaN,NaN,NaN,NaN,508.1492000000018,509.05026239098095,507.2481376090227,508.1439320975832,507.26538598320826,508.49462371544143,506.0361482509751,14156,6963.966666666666,59.588988229731775,54.88035705762904,NaN,NaN,NaN,NaN,0.3903245714927814,10.80588014768952,12269962
2025-08-29T15:20:00-04:00,508.95,509,508.74,508.85,507.59427883264806,NaN,NaN,NaN,NaN,NaN,508.1796000000018,509.0705654048494,507.28863459515424,508.2411456780666,507.2834844561112,508.51738245278915,506.0495864594332,8008,7021.633333333333,57.867215063412694,54.781275392387,NaN,NaN,NaN,NaN,0.3810156735290106,10.799268353994993,12261954
2025-08-29T15:25:00-04:00,508.88,508.92,508.58,508.71,507.59427883264806,NaN,NaN,NaN,NaN,NaN,508.20220000000177,509.0884960186292,507.31590398137433,508.2411456780666,507.30437205630335,508.5415209757827,506.067223136824,10311,7070.466666666666,54.87882385060394,54.59410656180454,NaN,NaN,NaN,NaN,0.37808598256265497,10.251945388172325,12251643
2025-08-29T15:30:00-04:00,508.69,509,508.68,508.73,507.59427883264806,NaN,NaN,NaN,NaN,NaN,508.21960000000183,509.1124758885731,507.32672411143056,508.2411456780666,507.32934361427726,508.5710552054414,506.08763202311314,12153,7198.266666666666,55.23448391914717,54.40040178076709,NaN,NaN,NaN,NaN,0.3739369838081791,9.98960802161332,12263796
2025-08-29T15:35:00-04:00,508.71,508.74,508.17,508.425,507.59427883264806,NaN,NaN,NaN,NaN,NaN,508.2257000000017,509.1199371233912,507.33146287661225,508.2411456780666,507.3433023823189,508.5834374022757,506.10316736236206,9243,7349.5,48.90378451914352,53.84622120456818,NaN,NaN,NaN,NaN,0.38794148496473724,10.299269947552107,12254553
2025-08-29T15:40:00-04:00,508.48,508.82,508.45,508.69,507.59427883264806,NaN,NaN,NaN,NaN,NaN,508.24690000000174,509.1338721262306,507.3599278737729,508.2411456780666,507.3619525066374,508.6029700830745,506.1209349302003,10669,7527.566666666667,53.8527861339669,53.627182505468674,NaN,NaN,NaN,NaN,0.3884456646101118,10.324922663414846,12265222
2025-08-29T15:45:00-04:00,508.68,508.92,508.19,508.25,507.59427883264806,NaN,NaN,NaN,NaN,NaN,508.2521000000018,509.13603006089346,507.36816993911015,508.2411456780666,507.3768737877921,508.6158775432467,506.13787003233745,10388,7616.333333333333,45.902906830364216,53.00234866303395,NaN,NaN,NaN,NaN,0.412842402852248,10.992763205787416,12254834
2025-08-29T15:50:00-04:00,508.29,508.38,506.35,506.63,NaN,NaN,NaN,508.89150675362515,508.89150675362515,508.89150675362515,508.2281000000018,509.21565837932343,507.2405416206802,508.2411456780666,507.365289596341,508.5772063796867,506.15337281299526,35883,8624.333333333334,28.954830615210057,51.156277394914056,NaN,NaN,NaN,NaN,0.5283536597913712,14.1073014262122,12218951
2025-08-29T15:55:00-04:00,506.645,506.87,505.28,506.79,NaN,NaN,NaN,507.74893826482395,NaN,NaN,508.2095000000017,509.26717905949596,507.15182094050743,508.2411456780666,507.1798812635771,508.3505819999648,506.0091805271894,170247,14102.8,31.639406567593994,50.14050630950141,NaN,NaN,NaN,NaN,0.604185541234847,17.693402194313297,12389198
2025-09-02T09:30:00-04:00,500.635,501.85,496.82,501.73,NaN,NaN,NaN,502.29239561642294,NaN,NaN,508.09540000000175,510.18760824793185,506.00319175207164,508.2411456780666,500.1333333333334,500.1333333333334,500.1333333333334,102370,17181.866666666665,13.834856236290477,47.768406003909305,NaN,NaN,NaN,NaN,1.273172288289503,22.669202744710816,12286828
2025-09-02T09:35:00-04:00,501.69,502.83,501.38,502.3,499.0843041843236,499.0843041843236,499.0843041843236,NaN,NaN,NaN,507.99560000000173,510.6361557280254,505.35504427197804,508.2411456780666,500.7250580304753,501.64972437533356,499.800391685617,41922,18291.166666666668,19.34120163849606,45.45334322603593,NaN,NaN,NaN,NaN,1.2858028391259662,26.292031095071533,12328750
2025-09-02T09:40:00-04:00,502.32,502.93,500.72,501.16,499.0843041843236,NaN,NaN,NaN,NaN,NaN,507.86280000000176,511.1242359770928,504.60136402291073,508.2183332339626,500.88803429513234,501.78965835838653,499.98641023187815,32876,19280.433333333334,17.00115298214449,42.87169192769921,NaN,NaN,NaN,NaN,1.3518169220455385,29.753579106185867,12295874
2025-09-02T09:45:00-04:00,500.97,503.44,500.97,503.2,499.0843041843236,NaN,NaN,NaN,NaN,NaN,507.7724000000017,511.28551556211596,504.25928443788746,508.2183332339626,501.100280095928,502.10682689256,500.093733299296,26179,20021,32.694101816832784,41.17468742679133,NaN,NaN,NaN,NaN,1.4316871418994264,32.45690443932137,12322053
2025-09-02T09:50:00-04:00,503.09,504.35,502.99,503.29,500.2612252114032,NaN,NaN,NaN,NaN,NaN,507.67860000000167,511.4083040302208,503.94889596978254,507.89423326973605,501.3189081625495,502.50583400913337,500.1319823159657,19986,20399.566666666666,33.29333896376011,39.49913409762134,NaN,NaN,NaN,NaN,1.426566631763754,34.09413523062991,12342039
2025-09-02T09:55:00-04:00,503.29,504.09,503.19,503.46,500.26344224724846,NaN,NaN,NaN,NaN,NaN,507.5940000000017,511.50626021538045,503.68173978462295,507.89423326973605,501.52754232798856,502.8340699490886,500.2210147068885,22702,20955.233333333334,34.47995680486322,37.70563185298787,NaN,NaN,NaN,NaN,1.3889547294949127,35.61442096541639,12364741
2025-09-02T10:00:00-04:00,503.61,504.36,503.09,503.49,500.32874032691905,NaN,NaN,NaN,NaN,NaN,507.50560000000166,511.5816223935792,503.4295776064241,507.81438661578886,501.6817577493452,503.0550052906569,500.3085102080335,19310,21430.566666666666,34.700710075322036,36.05088149669568,NaN,NaN,NaN,NaN,1.3804579631024219,36.754434638663,12384051
2025-09-02T10:05:00-04:00,503.49,503.53,502.43,502.98,500.32874032691905,NaN,NaN,NaN,NaN,NaN,507.41620000000165,511.6847156943495,503.1476843056538,506.4805092926311,501.7927120858062,503.1551998148528,500.43022435675965,24797,22107.033333333333,32.68461963075883,34.465581195278176,NaN,NaN,NaN,NaN,1.3604252514522466,38.02242256563903,12359254
2025-09-02T10:10:00-04:00,502.985,503.87,502.85,503.67,500.32874032691905,NaN,NaN,NaN,NaN,NaN,507.3316000000017,511.724275011058,502.93892498894536,504.55540743410484,501.9127537182293,503.29446215497484,500.5310452814837,22462,22646.666666666668,37.9382472255983,33.23013571716754,NaN,NaN,NaN,NaN,1.3361091620627992,38.84122317606306,12381716
2025-09-02T10:15:00-04:00,503.61,504.55,503.49,504.25,500.65214680386896,NaN,NaN,NaN,NaN,NaN,507.2492000000017,511.7148324784925,502.78356752151086,500.93301678956794,502.02307834906674,503.45186917791204,500.5942875202214,16632,22951.966666666667,42.033543437305184,32.73940421132195,NaN,NaN,NaN,NaN,1.3163870790583136,38.90311353697749,12398348
2025-09-02T10:20:00-04:00,504.31,505.02,503.74,503.78,500.9906855855113,NaN,NaN,NaN,NaN,NaN,507.16000000000173,511.7200811388162,502.59991886118723,501.48641343165434,502.1106273755579,503.57341683791117,500.6478379132046,13929,23053.933333333334,39.74480481205842,31.731691259757053,NaN,NaN,NaN,NaN,1.313788001982718,38.49727744047207,12384419
2025-09-02T10:25:00-04:00,503.81,505.34,503.57,505.34,500.9906855855113,NaN,NaN,NaN,NaN,NaN,507.1048000000017,511.6848060952722,502.5247939047312,501.62813074532346,502.17993338421974,503.68382411539307,500.6760426530464,9254,23149.633333333335,49.56166038418054,31.993030799315363,NaN,NaN,NaN,NaN,1.3463745732696655,37.80715870929575,12393673
2025-09-02T10:30:00-04:00,505.29,505.4,504.56,505.27,501.54686434547625,NaN,NaN,NaN,NaN,NaN,507.0452000000018,511.6415733347576,502.448826665246,502.0105045962588,502.24433256018705,503.7915255864685,500.6971395339056,8013,23015.066666666666,49.174513205774225,33.43729384149852,NaN,NaN,NaN,NaN,1.3102049608932589,37.10556399176158,12385660
2025-09-02T10:35:00-04:00,505.19,505.39,504.55,504.64,501.57837051159095,NaN,NaN,NaN,NaN,NaN,506.9646000000017,511.585450933836,502.34374906616745,502.25840367700704,502.30590460400066,503.8853721210631,500.72643708693823,8689,23000,45.71350991818501,34.4425869379693,NaN,NaN,NaN,NaN,1.2766188922580244,36.46017290584795,12376971
2025-09-02T10:40:00-04:00,504.59,504.6,503.5,503.635,501.57837051159095,NaN,NaN,NaN,NaN,NaN,506.87930000000176,511.5846225216487,502.1739774783548,502.25840367700704,502.3574465337396,503.93692411111806,500.7779689563612,12241,23184.933333333334,40.782397622901954,36.36741132272727,NaN,NaN,NaN,NaN,1.2668603999538788,36.467470457989165,12364730
2025-09-02T10:45:00-04:00,503.67,503.68,503.1,503.21,501.57837051159095,NaN,NaN,NaN,NaN,NaN,506.7823000000017,511.5852158677643,501.97938413223915,502.25840367700704,502.3823067026773,503.94900356904907,500.8156098363055,10004,23271.5,38.87275039782609,37.762521948393704,NaN,NaN,NaN,NaN,1.217798942814315,36.68358366297365,12354726
2025-09-02T10:50:00-04:00,503.23,503.34,502.7,502.7,501.57837051159095,NaN,NaN,NaN,NaN,NaN,506.68610000000166,511.6178170593049,501.7543829406984,502.25840367700704,502.4018339785762,503.94269973000297,500.8609682271494,14941,23634.566666666666,36.65467794119361,39.16634515975436,NaN,NaN,NaN,NaN,1.1765275897561485,37.08909409234601,12339785
2025-09-02T10:55:00-04:00,502.69,503.22,502.66,502.88,501.57837051159095,NaN,NaN,NaN,NaN,NaN,506.58850000000166,511.6234161853119,501.5535838146914,502.25840367700704,502.4185172794632,503.9371317080218,500.89990285090454,13517,23772.2,37.99934191901704,39.54529088133894,NaN,NaN,NaN,NaN,1.1324899047735666,37.486546347401855,12353302
2025-09-02T11:00:00-04:00,502.92,503.25,502.18,502.29,501.57837051159095,NaN,NaN,NaN,NaN,NaN,506.47310000000175,511.63081805672493,501.31538194327857,502.25840367700704,502.42532499191594,503.91051437525493,500.94013560857695,19310,24298.633333333335,35.350483362007225,39.692229766928016,NaN,NaN,NaN,NaN,1.1280263401468829,38.10786403945133,12333992
2025-09-02T11:05:00-04:00,502.26,502.29,501.38,501.6,NaN,NaN,NaN,504.9983015655937,504.9983015655937,504.9983015655937,506.3432000000017,511.6558154606903,501.03058453931305,502.25840367700704,502.4039433728655,503.86992191509535,500.9379648306357,14506,24611.966666666667,32.497408391811334,39.55061916599574,NaN,NaN,NaN,NaN,1.112453030136393,39.06739514311025,12319486
2025-09-02T11:10:00-04:00,501.62,501.67,501.27,501.61,NaN,NaN,NaN,504.5440605853394,NaN,NaN,506.2178000000017,511.6734664701004,500.76213352990305,502.25840367700704,502.38464892551036,503.84036414649376,500.92893370452697,10084,24826.066666666666,32.58233174767925,39.399306428306964,NaN,NaN,NaN,NaN,1.061563527983796,40.008661793463965,12329570
2025-09-02T11:15:00-04:00,501.63,502,500.775,500.95,NaN,NaN,NaN,504.4888760132785,NaN,NaN,506.0730000000017,511.693430587857,500.4525694121464,502.25840367700704,502.3532682417011,503.8009592821101,500.90557720129203,13091,24790.566666666666,29.907958106008977,39.20097346225341,NaN,NaN,NaN,NaN,1.073237561699241,41.107001304100585,12316479
2025-09-02T11:20:00-04:00,500.96,501.15,500.52,501.09,NaN,NaN,NaN,503.8813134672204,NaN,NaN,505.93740000000173,511.7031416654539,500.17165833454953,502.25840367700704,502.3253189539474,503.7724602447225,500.87817766317227,9483,24839.733333333334,31.198017361042687,38.71952847192801,NaN,NaN,NaN,NaN,1.0415777358635805,42.23905331209773,12325962
2025-09-02T11:25:00-04:00,501.06,501.16,500.75,501.05,NaN,NaN,NaN,503.8813134672204,NaN,NaN,505.79560000000174,511.6850962902482,499.90610370975526,501.52472294160566,502.29732418602003,503.7420088645755,500.8526395074646,10387,24842.266666666666,31.022333427266744,37.93301347121098,NaN,NaN,NaN,NaN,0.996465040444755,43.27360427039366,12315575
2025-09-02T11:30:00-04:00,501.01,501.14,500.75,500.92,NaN,NaN,NaN,503.82721950215745,NaN,NaN,505.6378000000017,511.61787965105094,499.6577203489524,500.9297783532845,502.2641846794112,503.7065003150345,500.8218690437879,12399,24850.466666666667,30.422720288360637,37.26715029094685,NaN,NaN,NaN,NaN,0.9531461089844144,44.234258731668454,12303176
2025-09-02T11:35:00-04:00,500.92,501,500.43,500.48,NaN,NaN,NaN,503.54393679751394,NaN,NaN,505.47440000000165,511.5618394085675,499.3869605914358,500.92385814610213,502.2383976054233,503.68360264697037,500.79319256387623,8196,24815.566666666666,28.420454590780764,35.757064162846866,NaN,NaN,NaN,NaN,0.9257785297712414,45.2876835951802,12294980
2025-09-02T11:40:00-04:00,500.48,501.14,500.45,500.83,NaN,NaN,NaN,503.54393679751394,NaN,NaN,505.3230000000016,511.4879116776473,499.158088322356,500.92385814610213,502.21133237363136,503.65603036764685,500.7666343796159,9967,24792.166666666668,32.24071134315396,34.54750688694541,NaN,NaN,NaN,NaN,0.9089372062161526,45.993235509019,12304947
2025-09-02T11:45:00-04:00,500.8,500.955,500.56,500.75,NaN,NaN,NaN,503.4787833217017,NaN,NaN,505.1618000000017,511.3748867556365,498.94871324436684,500.8780865168817,502.1953619537304,503.64009977323644,500.7506241342244,5846,24640.766666666666,31.822643754839007,33.555302160992134,NaN,NaN,NaN,NaN,0.8722274057721403,46.64839085758361,12299101
2025-09-02T11:50:00-04:00,500.69,500.69,500.29,500.66,NaN,NaN,NaN,503.15031589798804,NaN,NaN,504.9978000000017,511.2445611314119,498.7510388685915,499.9374692135054,502.1594305191112,503.6084738838105,500.7103871544119,11877,23840.566666666666,31.330439262109266,32.880162278078366,NaN,NaN,NaN,NaN,0.8427825910741288,47.41995110688685,12287224
2025-09-02T11:55:00-04:00,500.65,501.09,500.43,500.67,NaN,NaN,NaN,503.15031589798804,NaN,NaN,504.8364000000016,511.1050432466104,498.5677567533928,499.7218802966434,502.13671279283324,503.5852683995292,500.6881571861373,8801,18459.033333333333,31.45729576218973,32.35048694696148,NaN,NaN,NaN,NaN,0.8297266917116888,47.2907564787322,12296025
2025-09-02T12:00:00-04:00,500.71,501.11,500.66,500.72,NaN,NaN,NaN,503.15031589798804,NaN,NaN,504.67520000000167,510.9444398130113,498.40596018699205,499.7218802966434,502.12618918904406,503.5736197307201,500.678758647368,4496,15196.566666666668,32.13239199778121,32.02746652243202,NaN,NaN,NaN,NaN,0.8026033565894244,47.12884904686351,12300521
2025-09-02T12:05:00-04:00,500.68,501.25,500.66,500.93,NaN,NaN,NaN,503.15031589798804,NaN,NaN,504.5198000000016,510.7674373000643,498.272162699939,499.81520577832276,502.10912299655945,503.55293084026835,500.66531515285055,8196,14072.366666666667,35.026882511303256,31.815147993309612,NaN,NaN,NaN,NaN,0.787417402547321,46.672900834972396,12308717
2025-09-02T12:10:00-04:00,500.94,501.2,500.87,501,NaN,NaN,NaN,503.15031589798804,NaN,NaN,504.36540000000167,510.57163874443125,498.1591612555721,499.88716462265825,502.1009013668312,503.54230899428944,500.6594937393729,4322,13120.566666666668,36.00661631067048,31.862014632499847,NaN,NaN,NaN,NaN,0.754744730936797,46.249520352502074,12313039
2025-09-02T12:15:00-04:00,500.99,501.45,500.99,501.45,NaN,NaN,NaN,503.15031589798804,NaN,NaN,504.2226000000017,510.36165668265505,498.08354331734836,500.1697316981266,502.092993693039,503.5294909598298,500.65649642624817,5668,12436.866666666667,42.05563278382499,32.54474494621511,NaN,NaN,NaN,NaN,0.7336915358698813,45.27751052737314,12318707
2025-09-02T12:20:00-04:00,501.43,501.67,501.34,501.37,NaN,NaN,NaN,503.15031589798804,NaN,NaN,504.0780000000017,510.13790395905164,498.0180960409517,500.4807853585013,502.0829245103178,503.51014970629797,500.65569931433765,9318,12081.266666666666,41.308071553570116,33.16801207520732,NaN,NaN,NaN,NaN,0.7048564261648927,43.88467897603207,12309389
2025-09-02T12:25:00-04:00,501.35,501.4,500.9,501,NaN,NaN,NaN,503.15031589798804,NaN,NaN,503.9370000000017,509.94854688852206,497.9254531114814,500.4807853585013,502.0754145455018,503.49975079481106,500.65107829619257,4510,11474.866666666667,37.94828866339528,33.742321400734916,NaN,NaN,NaN,NaN,0.6902238242959718,43.122950613271776,12304879
2025-09-02T12:30:00-04:00,500.98,501.2,500.91,501.08,NaN,NaN,NaN,503.15031589798804,NaN,NaN,503.79620000000176,509.7386400907906,497.8537599092129,500.4807853585013,502.0622787436132,503.4819705288706,500.6425869583558,7762,11089.933333333332,39.10162231280003,34.306864611574724,NaN,NaN,NaN,NaN,0.6616364082748284,42.415631419280075,12312641
2025-09-02T12:35:00-04:00,501.03,501.25,500.81,500.83,NaN,NaN,NaN,503.15031589798804,NaN,NaN,503.64460000000173,509.49451960224474,497.7946803977587,500.4807853585013,502.05131601411983,503.4681243256582,500.63450770258146,6026,10464.233333333334,36.799752275946595,34.71953738648043,NaN,NaN,NaN,NaN,0.6458052362551977,41.88166216019359,12306615
2025-09-02T12:40:00-04:00,500.85,501.53,500.83,501.24,NaN,NaN,NaN,503.15031589798804,NaN,NaN,503.4994000000017,509.2189981111366,497.77980188886676,500.4807853585013,502.041473018782,503.45300384981306,500.629942187751,7066,9951.033333333333,42.751923972215955,35.6001947924701,NaN,NaN,NaN,NaN,0.6496762908083971,40.6913557975016,12313681
2025-09-02T12:45:00-04:00,501.25,501.45,500.84,500.99,NaN,NaN,NaN,503.15031589798804,NaN,NaN,503.3448000000018,508.9073166815442,497.78228331845935,500.4807853585013,502.0328181398101,503.44078229591986,500.62485398370035,5630,9584.3,40.261963483121406,36.446016856208715,NaN,NaN,NaN,NaN,0.6468422700363696,39.58607131785904,12308051
2025-09-02T12:50:00-04:00,500.98,501.51,500.98,501.32,NaN,NaN,NaN,503.15031589798804,NaN,NaN,503.19640000000174,508.567883235826,497.8249167641775,500.4807853585013,502.0272184811194,503.4315158835562,500.6229210786826,4561,9272.033333333333,44.82969715764033,37.34523012867203,NaN,NaN,NaN,NaN,0.6384963936051984,38.402396588883775,12312612
2025-09-02T12:55:00-04:00,501.35,501.78,501.28,501.53,NaN,NaN,NaN,503.15031589798804,NaN,NaN,503.0484000000017,508.18234913813814,497.9144508618653,500.49104201361513,502.0210741853442,503.4177485212029,500.62439984948554,7774,9222.7,47.576730745211286,38.47052205655576,NaN,NaN,NaN,NaN,0.62860379406197,36.61303645331534,12320386
2025-09-02T13:00:00-04:00,501.59,501.77,501.35,501.36,NaN,NaN,NaN,503.15031589798804,NaN,NaN,502.89860000000175,507.7774363523296,498.0197636476739,500.52883361089215,502.01137945167505,503.3969792060103,500.6257796973398,11773,9348.033333333333,45.59742349734476,39.48959235907258,NaN,NaN,NaN,NaN,0.6137035230575406,34.9514877560018,12308613
2025-09-02T13:05:00-04:00,501.37,501.5,501.1,501.1,NaN,NaN,NaN,503.15031589798804,NaN,NaN,502.74640000000176,507.3580582866618,498.1347417133417,500.52883361089215,502.00641194993426,503.3889709065314,500.6238529933371,4118,9195.666666666666,42.673374056673296,40.29074080867855,NaN,NaN,NaN,NaN,0.5984389856962861,33.89009759602692,12304495
2025-09-02T13:10:00-04:00,501.09,501.12,500.3,500.5,NaN,NaN,NaN,502.77507864215335,NaN,NaN,502.58180000000175,506.9059700975848,498.25762990241867,500.52883361089215,501.9780673464369,503.36000261353985,500.5961320793339,13663,9243.066666666668,36.80737673564667,40.62466828995465,NaN,NaN,NaN,NaN,0.6142647724322651,34.11119232994312,12290832
2025-09-02T13:15:00-04:00,500.47,500.9,500.47,500.76,NaN,NaN,NaN,502.7148477947827,NaN,NaN,502.42850000000175,506.4457778087706,498.4112221912329,500.52883361089215,501.959644849214,503.3398701432728,500.5794195551552,9710,9233.266666666666,40.61676724173984,41.02394577070013,NaN,NaN,NaN,NaN,0.601103002972814,34.31649458286531,12300542
2025-09-02T13:20:00-04:00,500.88,501.56,500.77,501.43,NaN,NaN,NaN,502.7148477947827,NaN,NaN,502.28330000000176,505.88849603251947,498.67810396748405,500.52883361089215,501.9490011003208,503.32148741433707,500.57651478630453,10226,9076.1,49.1273552162507,41.961141406813,NaN,NaN,NaN,NaN,0.6153099313318996,32.86089911787075,12310768
2025-09-02T13:25:00-04:00,501.47,502.21,501.47,501.88,NaN,NaN,NaN,502.7148477947827,NaN,NaN,502.1559000000018,505.33354169672543,498.97825830327815,500.66385459761716,501.9474910305891,503.3091544517818,500.5858276093964,10883,8988.3,53.905579018457516,42.80756613785818,NaN,NaN,NaN,NaN,0.6270735076653333,30.750452847802194,12321651
2025-09-02T13:30:00-04:00,501.99,502.81,501.89,502.76,500.25681250681043,500.25681250681043,500.25681250681043,NaN,NaN,NaN,502.0785000000018,504.9941873962473,499.16281260375627,501.10808367809375,501.9580244194132,503.3083848351271,500.60766400369937,13738,8802.566666666668,61.51758808065387,44.25110303264987,NaN,NaN,NaN,NaN,0.6487111142606672,29.694296480041704,12335389
2025-09-02T13:35:00-04:00,502.76,503.06,502.62,502.84,500.7819573928645,NaN,NaN,NaN,NaN,NaN,501.9995000000018,504.5969604891631,499.40203951084044,501.478466942475,501.97426168341707,503.317377515311,500.6311458515231,13189,8758.666666666666,62.12985375649185,45.978357682156776,NaN,NaN,NaN,NaN,0.6338031775277623,29.04643108937129,12348578
2025-09-02T13:40:00-04:00,502.78,502.93,502.61,502.61,500.7819573928645,NaN,NaN,NaN,NaN,NaN,502.0171000000018,504.6189394171247,499.4152605828789,501.50477355398,501.98428339367,503.3210512300555,500.6475155572845,9803,8749.3,59.21298354124898,47.41488348418884,NaN,NaN,NaN,NaN,0.6113886648472073,28.4243099017497,12338775
2025-09-02T13:45:00-04:00,502.58,502.68,502.331,502.67,500.7819573928645,NaN,NaN,NaN,NaN,NaN,502.0245000000018,504.6316150708181,499.4173849291855,501.50477355398,501.99132350954227,503.32140440891243,500.6612426101721,8985,8612.433333333332,59.74393665859009,49.0537537972348,NaN,NaN,NaN,NaN,0.5926466173581204,27.272312233710373,12347760
2025-09-02T13:50:00-04:00,502.68,502.97,502.5,502.58,500.7957582095528,NaN,NaN,NaN,NaN,NaN,502.0529000000017,504.65265390235095,499.4531460976525,501.6832550745472,501.99730396922683,503.32317311548525,500.6714348229684,6409,8509.966666666667,58.51348059283881,50.179579270136436,NaN,NaN,NaN,NaN,0.5838861446896851,26.638535933905967,12341351
2025-09-02T13:55:00-04:00,502.54,502.76,502.15,502.27,500.7957582095528,NaN,NaN,NaN,NaN,NaN,502.03430000000174,504.6141914769539,499.45440852304955,501.6832550745472,502.00036359229006,503.32155624133225,500.67917094324787,5774,8356.2,54.36050280272737,51.18661779296543,NaN,NaN,NaN,NaN,0.5857514200689943,25.348565631401794,12335577
2025-09-02T14:00:00-04:00,502.25,503.025,502.18,502.77,500.7957582095528,NaN,NaN,NaN,NaN,NaN,502.0239000000018,504.5876014554484,499.46019854455517,501.6832550745472,502.0107347564991,503.32403303084664,500.6974364821516,11969,8341.866666666667,59.3694799597317,52.22517370740053,NaN,NaN,NaN,NaN,0.6042691757783497,24.56439563607894,12347546
2025-09-02T14:05:00-04:00,502.75,502.83,502.18,502.3,500.7957582095528,NaN,NaN,NaN,NaN,NaN,502.0007000000018,504.53279795082466,499.46860204917897,501.6832550745472,502.0158466221855,503.32206396241475,500.70962928195627,9224,8376.133333333333,53.43298413982064,52.64347752130119,NaN,NaN,NaN,NaN,0.6075356632227518,23.836237783279152,12338322
2025-09-02T14:10:00-04:00,502.31,502.89,502.31,502.66,500.7957582095528,NaN,NaN,NaN,NaN,NaN,501.98410000000183,504.4876476333629,499.4805523666408,501.6832550745472,502.01992693538733,503.322665941345,500.71718792942966,5226,8218.1,56.98123401396286,53.45660684391678,NaN,NaN,NaN,NaN,0.6062831158496963,23.26016766863539,12343548
2025-09-02T14:15:00-04:00,502.69,502.77,501.8,501.81,500.7957582095528,NaN,NaN,NaN,NaN,NaN,501.9607000000018,504.4483977374012,499.4730022626024,501.6832550745472,502.0210250057664,503.31709056666506,500.7249594448677,8043,8291.333333333334,47.73305679263418,53.81801275362826,NaN,NaN,NaN,NaN,0.6322628932890016,21.64803998720685,12335505
2025-09-02T14:20:00-04:00,501.88,501.9,501.6,501.8,500.7957582095528,NaN,NaN,NaN,NaN,NaN,501.92330000000186,504.36284389846685,499.48375610153687,501.6832550745472,502.0186151930819,503.30876194872735,500.7284684374365,7478,8144.7,47.635103922050504,54.591421838371396,NaN,NaN,NaN,NaN,0.6085298294826412,20.427473896439412,12328027
2025-09-02T14:25:00-04:00,501.77,501.86,501.4,501.44,500.7957582095528,NaN,NaN,NaN,NaN,NaN,501.8671000000018,504.21749238270223,499.5167076173014,501.6832550745472,502.0162666880085,503.30346723303177,500.72906614298523,4123,7988.766666666666,44.1246267778868,54.84198323381047,NaN,NaN,NaN,NaN,0.5979205559481695,19.656559956776317,12323904
2025-09-02T14:30:00-04:00,501.42,501.84,501.42,501.73,500.7957582095528,NaN,NaN,NaN,NaN,NaN,501.8261000000018,504.1122297322305,499.5399702677731,501.6832550745472,502.01359590685996,503.2962815409611,500.7309102727588,6050,8040.566666666667,47.48220178523267,54.72447227445203,NaN,NaN,NaN,NaN,0.5852119448090116,18.94071129851773,12329954
2025-09-02T14:35:00-04:00,501.63,501.93,501.5,501.84,500.7957582095528,NaN,NaN,NaN,NaN,NaN,501.75610000000177,503.8101217021305,499.702078297873,501.6832550745472,502.0116168542906,503.2895502856332,500.733683422948,6206,7974.233333333334,48.74043055454068,54.355533098457975,NaN,NaN,NaN,NaN,0.5741253773226541,18.06455648047691,12336160
2025-09-02T14:40:00-04:00,501.84,501.98,501.65,501.9,500.7957582095528,NaN,NaN,NaN,NaN,NaN,501.68870000000175,503.4816560041719,499.8957439958316,501.53498324771016,502.0107650346778,503.28551597530645,500.7360140940491,4099,7966.8,49.451811043722635,53.493691881534325,NaN,NaN,NaN,NaN,0.5566878503710389,17.129854899131924,12340259
2025-09-02T14:45:00-04:00,501.86,502.76,501.84,502.61,500.7957582095528,NaN,NaN,NaN,NaN,NaN,501.6481000000018,503.2540849167048,500.0421150832988,501.53498324771016,502.0166691682256,503.2826997429965,500.75063859345465,12365,8190.033333333334,57.04809525466418,53.13070913140377,NaN,NaN,NaN,NaN,0.58263871820168,17.131183223926744,12352624
2025-09-02T14:50:00-04:00,502.62,503.4,502.62,503.04,501.121147467029,NaN,NaN,NaN,NaN,NaN,501.63620000000185,503.19112451017673,500.08127548982696,501.86580124866055,502.02834128967703,503.2915759546356,500.76510662471844,9677,8202,60.88220678424849,53.2499393630466,NaN,NaN,NaN,NaN,0.5974502383301289,18.06157877450826,12362301
2025-09-02T14:55:00-04:00,503.04,503.135,502.68,502.74,501.121147467029,NaN,NaN,NaN,NaN,NaN,501.6268000000018,503.14889034966785,500.1047096503358,501.86580124866055,502.03889674322824,503.29742067586074,500.78037281059574,10803,8411.766666666666,57.05556502060128,53.05791281747596,NaN,NaN,NaN,NaN,0.5872752213065472,18.92551750004824,12351498
2025-09-02T15:00:00-04:00,502.86,503.39,502.86,503.36,501.25609717553675,NaN,NaN,NaN,NaN,NaN,501.6400000000019,503.20978979232603,500.0702102076778,501.90111279914277,502.04874718814,503.30646614206665,500.79102823421334,7189,8392.666666666666,62.32576379541901,53.330218760517404,NaN,NaN,NaN,NaN,0.5917555626417921,20.065209779624755,12358687
2025-09-02T15:05:00-04:00,503.31,503.5,503.14,503.44,501.48695639483054,NaN,NaN,NaN,NaN,NaN,501.65120000000184,503.26362991546307,500.0387700845406,502.1288902393142,502.05709670485743,503.31513603954284,500.799057370172,5446,8373.333333333334,62.957453670866734,53.94428667967021,NaN,NaN,NaN,NaN,0.5752015938816649,21.26520799397574,12364133
2025-09-02T15:10:00-04:00,503.43,503.55,503.19,503.49,501.571185649611,NaN,NaN,NaN,NaN,NaN,501.67520000000184,503.3590871198005,499.99131288020317,502.2731121914514,502.070464354954,503.32940500953794,500.8115237003701,8535,8422.3,63.3708353029485,54.23009777561426,NaN,NaN,NaN,NaN,0.559830051461547,22.44576001282291,12372668
2025-09-02T15:15:00-04:00,503.48,503.89,503.38,503.79,501.84840448371955,NaN,NaN,NaN,NaN,NaN,501.7190000000019,503.50369605026054,499.9343039497433,502.6134897531611,502.087937762789,503.3511604219181,500.8247151036599,9441,8549.333333333334,65.83446008894668,55.11591748626608,NaN,NaN,NaN,NaN,0.5562707620714359,23.973685622083078,12382109
2025-09-02T15:20:00-04:00,503.79,503.96,503.57,503.66,502.0064315526414,NaN,NaN,NaN,NaN,NaN,501.76000000000187,503.62517130370196,499.8948286963018,502.74379180252885,502.098438112414,503.3643999500073,500.8324762748207,5620,8584.633333333333,63.83097636671827,55.60518479717718,NaN,NaN,NaN,NaN,0.5443942790663324,25.47706804667873,12376489
2025-09-02T15:25:00-04:00,503.65,503.89,503.53,503.85,502.0064315526414,NaN,NaN,NaN,NaN,NaN,501.8180000000019,503.7576824461376,499.8783175538662,502.74379180252885,502.11072557352816,503.37998051936387,500.84147062769244,6561,8544.2,65.48425017124049,56.87312718136335,NaN,NaN,NaN,NaN,0.5312232591330239,26.740367171304936,12383050
2025-09-02T15:30:00-04:00,503.84,503.941,503.56,503.56,502.04935395602246,NaN,NaN,NaN,NaN,NaN,501.86740000000196,503.8556084779274,499.87919152207655,502.82812675361845,502.12210405136517,503.39378995805225,500.8504181446781,6438,8366.366666666667,60.90798372587748,57.821190024493845,NaN,NaN,NaN,NaN,0.5204930263378059,27.98360645894945,12376612
2025-09-02T15:35:00-04:00,503.555,504.06,503.5,504.05,502.0798151398396,NaN,NaN,NaN,NaN,NaN,501.927400000002,503.99288322465827,499.8619167753458,502.8897014028948,502.13812440165,503.41488122275985,500.8613675805401,8250,8504.1,65.31819054974237,59.33501600819782,NaN,NaN,NaN,NaN,0.5233149530279628,29.30412032178421,12384862
2025-09-02T15:40:00-04:00,504.05,504.22,503.88,503.95,502.38073263348326,NaN,NaN,NaN,NaN,NaN,501.988000000002,504.108758352929,499.867241647075,503.11376112231585,502.15777657692337,503.4421386786333,500.87341447521345,9516,8365.866666666667,63.73782793006668,60.49613216140024,NaN,NaN,NaN,NaN,0.5102210278116821,30.747673853667333,12375346
2025-09-02T15:45:00-04:00,503.91,504.38,503.74,504.34,502.38073263348326,NaN,NaN,NaN,NaN,NaN,502.065200000002,504.24106852346995,499.88933147653404,503.17500889785265,502.19232166770746,503.4918497915019,500.892793543913,16024,8576.333333333334,67.08281597003,61.806302548220906,NaN,NaN,NaN,NaN,0.519490954396561,32.29615489854968,12391370
2025-09-02T15:50:00-04:00,504.32,506.79,504.13,505.24,503.4930022548887,NaN,NaN,NaN,NaN,NaN,502.1534000000021,504.47451562639156,499.8322843736126,504.49600711828214,502.3477235484335,503.78955349164903,500.905893605218,47335,9813.3,73.22166451625542,63.504149224830385,NaN,NaN,NaN,NaN,0.6723844576539513,35.37673521165136,12438705
2025-09-02T15:55:00-04:00,505.18,506,504.85,504.93,503.4930022548887,NaN,NaN,NaN,NaN,NaN,502.23700000000207,504.64922303927443,499.8247769607297,504.49600711828214,502.7034136332004,504.3569925857143,501.0498346806865,135369,13962.833333333334,68.48407218032344,64.32100471952035,NaN,NaN,NaN,NaN,0.7064998535358102,38.23727407381721,12303336
2025-09-03T09:30:00-04:00,503.87,505.34,503.04,505.04,NaN,NaN,NaN,506.44557025949194,506.44557025949194,506.44557025949194,502.324600000002,504.8181347103065,499.83106528969756,504.49600711828214,504.47333333333336,504.47333333333336,504.47333333333336,54965,15337.066666666668,69.24449753934594,64.9183112020273,NaN,NaN,NaN,NaN,0.8203212925689635,37.18070809405013,12358301
2025-09-03T09:35:00-04:00,505.11,506.1,504.3,505.27,NaN,NaN,NaN,506.44557025949194,NaN,NaN,502.41660000000206,504.9970793646345,499.83612063536964,504.49600711828214,504.76497081290245,505.1305876754215,504.3993539503834,34972,16063.166666666666,70.82936244851452,65.90215387544967,NaN,NaN,NaN,NaN,0.8902983430997526,36.84570170672517,12393273
2025-09-03T09:40:00-04:00,505.39,506.45,505.2,506.45,503.36506924703315,503.36506924703315,503.36506924703315,NaN,NaN,NaN,502.53120000000206,505.30203565577517,499.76036434422895,504.49600711828214,505.04828342141326,505.6670675294033,504.4294993134232,25867,16598.633333333335,77.29405481253309,66.97131751952925,NaN,NaN,NaN,NaN,0.9159913185926275,36.80155207820581,12419140
2025-09-03T09:45:00-04:00,506.41,507.78,505.07,505.93,503.70733882671345,NaN,NaN,NaN,NaN,NaN,502.6312000000021,505.5219732929572,499.74042670704694,504.49600711828214,505.29165692492074,506.0276314711248,504.5556823787167,29105,17269.3,69.938364542397,67.46995401035284,NaN,NaN,NaN,NaN,1.0441347958360099,37.601858838670076,12390035
2025-09-03T09:50:00-04:00,505.93,506.81,505.37,505.53,503.70733882671345,NaN,NaN,NaN,NaN,NaN,502.721800000002,505.6854320675075,499.7581679324965,504.49600711828214,505.37845403619315,506.0928453791736,504.6640626932127,23963,17854.433333333334,64.82767913873747,67.57401428433776,NaN,NaN,NaN,NaN,1.0724108818477232,38.34500083052976,12366072
2025-09-03T09:55:00-04:00,505.6,505.71,504.32,504.57,503.70733882671345,NaN,NaN,NaN,NaN,NaN,502.78420000000204,505.7693983906237,499.7990016093804,504.49600711828214,505.3232108684705,506.01638284166756,504.6300388952734,20434,18343.1,54.52888817261722,66.76647343317138,NaN,NaN,NaN,NaN,1.095095818858599,37.50590355865555,12345638
2025-09-03T10:00:00-04:00,504.63,505.8,504.34,505.22,503.70733882671345,NaN,NaN,NaN,NaN,NaN,502.86120000000204,505.89473691776635,499.82766308223773,504.49600711828214,505.30046770155553,505.95683353010025,504.6441018730108,23857,18739.366666666665,59.24937558784879,66.4392162346807,NaN,NaN,NaN,NaN,1.1211604032258446,36.795823199484275,12369495
2025-09-03T10:05:00-04:00,505.31,506.22,505.25,505.62,503.70733882671345,NaN,NaN,NaN,NaN,NaN,502.95360000000204,506.03579859052303,499.87140140948105,504.49600711828214,505.32254008685555,505.9668017174628,504.67827845624834,12576,18851.1,61.8725114680945,66.18123489874169,NaN,NaN,NaN,NaN,1.112506088709713,36.45778944263099,12382071
2025-09-03T10:10:00-04:00,505.66,506.13,504.7,505.05,503.70733882671345,NaN,NaN,NaN,NaN,NaN,503.03300000000206,506.1225779633246,499.9434220366795,503.77298441251867,505.3201306448379,505.9372981465897,504.7029631430861,20297,19353.466666666667,56.309992121244626,65.85280692698221,NaN,NaN,NaN,NaN,1.135184225230448,35.38424913123942,12361774
2025-09-03T10:15:00-04:00,505,506.21,504.87,506.15,503.70733882671345,NaN,NaN,NaN,NaN,NaN,503.13940000000207,506.28411088516276,499.9946891148414,503.77298441251867,505.3345024376518,505.94592397206134,504.72308090324225,8649,19373.666666666668,63.188040658013456,65.70065336328729,NaN,NaN,NaN,NaN,1.1498139234282714,34.45730467268421,12370423
2025-09-03T10:20:00-04:00,506.27,506.77,506.055,506.09,503.70733882671345,NaN,NaN,NaN,NaN,NaN,503.2364000000021,506.4394354589087,500.0333645410955,503.77298441251867,505.3830325648132,506.015397691163,504.75066743846344,13406,19571.266666666666,62.60906067408164,65.62002713071692,NaN,NaN,NaN,NaN,1.118755786040536,34.07236971798572,12357017
2025-09-03T10:25:00-04:00,506.14,506.37,504.7,504.75,503.70733882671345,NaN,NaN,NaN,NaN,NaN,503.31160000000204,506.4764680464364,500.14673195356767,503.77298441251867,505.37839834093086,505.9976555184242,504.7591411634375,11825,19828,51.30303536330418,64.49289994452222,NaN,NaN,NaN,NaN,1.1581303727519274,32.029612642233765,12345192
2025-09-03T10:30:00-04:00,504.8,505.78,504.69,505.53,503.70733882671345,NaN,NaN,NaN,NaN,NaN,503.39580000000205,506.5682466002037,500.22335339980043,503.77298441251867,505.37679595225956,505.98500119164834,504.7685907128708,10320,19970.333333333332,56.25498094053723,63.280993974828064,NaN,NaN,NaN,NaN,1.1532639175553594,30.121836746192177,12355512
2025-09-03T10:35:00-04:00,505.6,506.29,505.6,506.03,503.70733882671345,NaN,NaN,NaN,NaN,NaN,503.48580000000214,506.6965073100517,500.2750926899526,503.60707864466826,505.4029569074193,506.0100917876101,504.7958220272285,13312,20207.2,59.12442604217029,62.612447822102844,NaN,NaN,NaN,NaN,1.12517363772998,28.849434601776014,12368824
2025-09-03T10:40:00-04:00,506.02,506.45,505.88,506.08,503.70733882671345,NaN,NaN,NaN,NaN,NaN,503.5802000000021,506.81282491345047,500.3475750865537,503.7891474128561,505.4254589145207,506.0364510985136,504.8144667305277,9604,20390.7,59.4111478741806,61.91006570316246,NaN,NaN,NaN,NaN,1.0855183778921238,27.82030031989931,12378428
2025-09-03T10:45:00-04:00,506.15,506.49,505.97,506.23,503.70733882671345,NaN,NaN,NaN,NaN,NaN,503.6828000000021,506.919675133675,500.44592486632916,504.1013179302849,505.45310350144155,506.07113359184547,504.8350734110376,11143,20349.966666666667,60.310598619051596,61.15872542962939,NaN,NaN,NaN,NaN,1.045124208042685,26.904443013097623,12389571
2025-09-03T10:50:00-04:00,506.23,506.8,506.23,506.7,503.70733882671345,NaN,NaN,NaN,NaN,NaN,503.8068000000021,507.02141024555874,500.5921897544455,504.6040543442279,505.4879444910903,506.12673160232293,504.8491573798576,10378,20373.333333333332,63.071929885025895,60.142859363378875,NaN,NaN,NaN,NaN,1.0111867646110642,26.366763130871256,12399949
2025-09-03T10:55:00-04:00,506.73,507.02,506.51,506.69,503.95068700670873,NaN,NaN,NaN,NaN,NaN,503.9254000000021,507.11911936005833,500.7316806399459,505.0082434753823,505.54221596534006,506.2170249963744,504.86740693430573,15164,20518.7,62.9715434283967,59.64522928380743,NaN,NaN,NaN,NaN,0.9753877099959876,26.085619993828125,12384785
2025-09-03T11:00:00-04:00,506.69,506.93,506.01,506.33,503.95068700670873,NaN,NaN,NaN,NaN,NaN,504.02340000000214,507.2055115239281,500.84128847607616,505.0082434753823,505.5817020523322,506.2659485619286,504.8974555427358,16413,20826.166666666668,59.31166781264843,59.25122847480106,NaN,NaN,NaN,NaN,0.9714314449962753,25.082605406129083,12368372
2025-09-03T11:05:00-04:00,506.35,506.5,505.9,506.5,503.95068700670873,NaN,NaN,NaN,NaN,NaN,504.11580000000214,507.3118653045153,500.91973469548896,505.0082434753823,505.60953554637535,506.29456780386124,504.92450328888947,14764,21136.766666666666,60.479748364030414,59.67628991704486,NaN,NaN,NaN,NaN,0.944900627496543,23.99353301852408,12383136
2025-09-03T11:10:00-04:00,506.535,506.88,506.31,506.36,503.95068700670873,NaN,NaN,NaN,NaN,NaN,504.1878000000021,507.42043926706214,500.95516073294203,505.03058065939575,505.63573366977187,506.3276841011482,504.94378323839555,11331,21229.966666666667,58.97813630625906,59.65691568264559,NaN,NaN,NaN,NaN,0.9181220112467895,23.422133564949,12371805
2025-09-03T11:15:00-04:00,506.3,506.33,505.71,505.93,503.95068700670873,NaN,NaN,NaN,NaN,NaN,504.2496000000021,507.49493131606994,501.00426868393424,505.03058065939575,505.6459547542374,506.33042388488184,504.9614856235929,11656,21303.8,54.502171332549146,59.13046281582093,NaN,NaN,NaN,NaN,0.8989704390148784,22.029423619357782,12360149
2025-09-03T11:20:00-04:00,505.86,506.07,505.56,505.83,503.95068700670873,NaN,NaN,NaN,NaN,NaN,504.31400000000207,507.55442219333327,501.07357780667087,505.03058065939575,505.65033045380693,506.3266897002564,504.97397120735747,10419,21463.766666666666,53.48557501666999,58.92871873692273,NaN,NaN,NaN,NaN,0.8711868362281007,20.53390184650845,12349730
2025-09-03T11:25:00-04:00,505.8,505.9,505.2,505.215,503.95068700670873,NaN,NaN,NaN,NaN,NaN,504.364900000002,507.58028457282853,501.1495154271755,505.03058065939575,505.64413244522734,506.31148759035756,504.9767773000971,12481,21661.1,47.60467096627293,57.81562090179841,NaN,NaN,NaN,NaN,0.8589592050689498,19.464317060912247,12337249
2025-09-03T11:30:00-04:00,505.2,505.34,504.94,505.24,503.95068700670873,NaN,NaN,NaN,NaN,NaN,504.4181000000021,507.6014585332299,501.23474146677427,505.03058065939575,505.63001275088993,506.292171511837,504.96785398994285,13199,21886.466666666667,47.855665423253,56.761806955310654,NaN,NaN,NaN,NaN,0.8261764047068804,18.799553597503113,12350448
2025-09-03T11:35:00-04:00,505.25,505.61,505.09,505.61,503.95068700670873,NaN,NaN,NaN,NaN,NaN,504.484900000002,507.62503151817526,501.3447684818288,505.03058065939575,505.6269328680929,506.28424247500874,504.9696232611771,7124,21848.933333333334,51.55455136267463,56.77977238383711,NaN,NaN,NaN,NaN,0.8043066615135345,17.77597945897401,12357572
2025-09-03T11:40:00-04:00,505.57,505.9,505.12,505.12,503.95068700670873,NaN,NaN,NaN,NaN,NaN,504.53190000000205,507.638117563425,501.4256824365791,505.03058065939575,505.62218474227615,506.27402682109584,504.97034266345645,8768,21824,46.81806482110948,56.10570694673514,NaN,NaN,NaN,NaN,0.8025704714054228,16.607587167880506,12348804
2025-09-03T11:45:00-04:00,505.09,505.55,504.9,505.48,503.95068700670873,NaN,NaN,NaN,NaN,NaN,504.59550000000206,507.64604240934403,501.5449575906601,505.03058065939575,505.6176668186769,506.2658481240847,504.96948551326915,6696,21513.066666666666,50.42194145352124,55.48410090468877,NaN,NaN,NaN,NaN,0.7916725805907522,15.638889694598982,12355500
2025-09-03T11:50:00-04:00,505.48,505.86,505.37,505.59,503.95068700670873,NaN,NaN,NaN,NaN,NaN,504.6541000000021,507.6659935490985,501.64220645090563,505.03058065939575,505.61753047168764,506.26168329438167,504.9733776489936,5807,20128.8,51.503356307629105,54.919258649935095,NaN,NaN,NaN,NaN,0.7701245391199849,14.765140349777456,12361307
2025-09-03T11:55:00-04:00,505.55,505.58,504.85,505.33,503.95068700670873,NaN,NaN,NaN,NaN,NaN,504.7245000000021,507.6298593566576,501.81914064334654,505.03058065939575,505.6101257132381,506.2497650779596,504.97048634851666,9723,15940.6,48.79418640719602,54.09665777765969,NaN,NaN,NaN,NaN,0.7679727863256968,14.217734396793,12351584
2025-09-03T12:00:00-04:00,505.35,505.45,504.89,504.99,503.95068700670873,NaN,NaN,NaN,NaN,NaN,504.78830000000204,507.57150937614193,502.00509062386215,504.5254645275166,505.5998747879222,506.23687886832,504.9628707075244,10007,14442,45.42889168547137,52.8364407634058,NaN,NaN,NaN,NaN,0.7531175873024328,13.709428869021718,12341577
2025-09-03T12:05:00-04:00,505.01,505.65,504.95,505.48,503.95068700670873,NaN,NaN,NaN,NaN,NaN,504.86910000000205,507.48855161268597,502.24964838731813,504.37137162201327,505.59750665357916,506.2318020817813,504.963211225377,4868,13438.533333333333,50.70550524747749,51.96029517905442,NaN,NaN,NaN,NaN,0.7493234739236868,12.905706309806739,12346445
2025-09-03T12:10:00-04:00,505.48,505.6,504.73,504.78,503.95068700670873,NaN,NaN,NaN,NaN,NaN,504.9301000000021,507.3915958767588,502.46860412324537,504.33038676248106,505.58924531185994,506.22246666268774,504.95602396103214,7372,12822.033333333333,44.13942968926459,50.876563884527,NaN,NaN,NaN,NaN,0.7579432257862809,12.499800563152696,12339073
2025-09-03T12:15:00-04:00,504.77,504.8,504.35,504.52,503.95068700670873,NaN,NaN,NaN,NaN,NaN,504.98370000000205,507.2852271519841,502.68217284802,504.33038676248106,505.55318111228735,506.2034913328784,504.9028708916963,18112,12455.6,41.965701487744546,49.5541319647923,NaN,NaN,NaN,NaN,0.7359472810872602,12.674982141139054,12320961
2025-09-03T12:20:00-04:00,504.5,505.17,504.38,504.4,503.95068700670873,NaN,NaN,NaN,NaN,NaN,505.03370000000206,507.16760422263343,502.8997957773707,504.33038676248106,505.54389187784443,506.1972351146771,504.8905486410118,5389,11836.466666666667,40.96301983188738,48.2673379309086,NaN,NaN,NaN,NaN,0.7398081895810288,12.17798965897634,12315572
2025-09-03T12:25:00-04:00,504.37,504.785,504.12,504.47,503.95068700670873,NaN,NaN,NaN,NaN,NaN,505.070900000002,507.0966064820856,503.0451935179184,504.33038676248106,505.5279466643599,506.1894923608224,504.8664009678974,7811,11415.7,41.83603950536305,47.362614228966734,NaN,NaN,NaN,NaN,0.7344647474680996,12.102472155997795,12323383
2025-09-03T12:30:00-04:00,504.51,504.62,504.17,504.38,503.95068700670873,NaN,NaN,NaN,NaN,NaN,505.097700000002,507.0493241522092,503.14607584779486,504.33038676248106,505.5074645321967,506.1802598540879,504.8346692103055,9747,10945.366666666667,40.996623703385175,46.47054627801782,NaN,NaN,NaN,NaN,0.7141458369346632,12.032348760374857,12313636
2025-09-03T12:35:00-04:00,504.37,504.47,504.22,504.29,503.95068700670873,NaN,NaN,NaN,NaN,NaN,505.1287000000021,506.9759907814028,503.28140921860137,504.33038676248106,505.4953295366693,506.17517022969787,504.81548884364076,5623,10713.6,40.129511824054056,45.936606339287906,NaN,NaN,NaN,NaN,0.6809925628679014,11.967234178724988,12308013
2025-09-03T12:40:00-04:00,504.27,504.32,503.84,503.88,NaN,NaN,NaN,506.2488274841659,506.2488274841659,506.2488274841659,505.1391000000021,506.95197802979055,503.3262219702136,504.0560380223903,505.44963741225354,506.1662693673622,504.7330054571449,17406,10617.233333333334,36.356917321030345,45.11526718912914,NaN,NaN,NaN,NaN,0.6666359512344812,12.508052572228262,12290607
2025-09-03T12:45:00-04:00,503.85,504.18,503.73,503.99,NaN,NaN,NaN,506.0866080530675,NaN,NaN,505.15010000000206,506.9279419364982,503.3722580635059,504.0560380223903,505.41948493472387,506.15902901831686,504.6799408511309,11717,10719.5,38.03990840025068,44.14993554895601,NaN,NaN,NaN,NaN,0.6511619547177316,13.175065454734305,12302324
2025-09-03T12:50:00-04:00,504,504.11,503.53,503.54,NaN,NaN,NaN,505.93380768701894,NaN,NaN,505.15110000000203,506.9252581528775,503.37694184712655,504.0560380223903,505.39125791325534,506.155974956449,504.6265408700617,9772,10598.366666666667,34.070599532669306,43.239402314067426,NaN,NaN,NaN,NaN,0.6460789579521824,14.091244753387416,12292552
2025-09-03T12:55:00-04:00,503.56,503.85,503.56,503.61,NaN,NaN,NaN,505.7649982466999,NaN,NaN,505.147500000002,506.9333826924985,503.3616173075055,503.88983041791226,505.35252746880064,506.15042721715497,504.5546277204463,13517,10654.766666666666,35.20325757837608,42.15235346584277,NaN,NaN,NaN,NaN,0.6220733180984552,14.941982673565304,12306069
2025-09-03T13:00:00-04:00,503.6,504.21,503.56,504.06,NaN,NaN,NaN,505.7649982466999,NaN,NaN,505.155500000002,506.91808928609015,503.39291071391386,503.50049146746386,505.3127531080506,506.1332057833424,504.4923004327587,17414,10891.233333333334,42.09083009721853,41.48003016509915,NaN,NaN,NaN,NaN,0.6240680810914211,14.832797489000917,12323483
2025-09-03T13:05:00-04:00,504.05,504.25,503.94,504.07,NaN,NaN,NaN,505.7649982466999,NaN,NaN,505.15990000000204,506.91048902978804,503.40931097021604,503.50049146746386,505.3028927690019,506.1273450102008,504.478440527803,5002,10614.233333333334,42.237766417551605,41.01171445155312,NaN,NaN,NaN,NaN,0.6016346467277484,14.635712847926378,12328485
2025-09-03T13:10:00-04:00,504.1,504.75,504.1,504.26,NaN,NaN,NaN,505.7649982466999,NaN,NaN,505.17390000000205,506.88380910613773,503.46399089386637,503.4553607957491,505.2883535552734,506.1144771046761,504.46223000587065,9847,10622.333333333334,45.08866711451939,40.98741269648512,NaN,NaN,NaN,NaN,0.607232171961481,13.826266959318065,12338332
2025-09-03T13:15:00-04:00,504.33,504.56,504.33,504.53,NaN,NaN,NaN,505.7649982466999,NaN,NaN,505.1835000000021,506.87333342109184,503.4936665789123,503.4553607957491,505.28211826840663,506.1081339050532,504.4561026317601,4871,10413.266666666666,48.94497294468959,40.861660389143125,NaN,NaN,NaN,NaN,0.5852870168213761,13.074638634181774,12343203
2025-09-03T13:20:00-04:00,504.49,504.6,504.09,504.19,NaN,NaN,NaN,505.7649982466999,NaN,NaN,505.18830000000213,506.86540656511835,503.5111934348859,503.4553607957491,505.27517268483786,506.10241421184907,504.44793115782664,4504,10217.466666666667,44.68890070081294,40.900908318539436,NaN,NaN,NaN,NaN,0.5799093727627097,12.428376956567382,12338699
2025-09-03T13:25:00-04:00,504.09,504.09,503.5,504.08,NaN,NaN,NaN,505.73701904401196,NaN,NaN,505.18310000000207,506.8722641575402,503.49393584246394,503.4553607957491,505.2537067512167,506.09215578750394,504.4152577149295,10093,10048.433333333332,43.37477595200646,41.00155649455814,NaN,NaN,NaN,NaN,0.5877729889939446,12.912442769243485,12328606
2025-09-03T13:30:00-04:00,504.04,504.39,503.92,503.93,NaN,NaN,NaN,505.73701904401196,NaN,NaN,505.15690000000205,506.88197725949965,503.43182274050446,503.4553607957491,505.24577193418554,506.0868987855743,504.4046450827968,4433,9649.1,41.57922961029209,41.04557147872991,NaN,NaN,NaN,NaN,0.5793606326372321,12.683314236131874,12324173
2025-09-03T13:35:00-04:00,503.92,504.06,503.69,503.8,NaN,NaN,NaN,505.73701904401196,NaN,NaN,505.1343000000021,506.89980956695496,503.36879043304924,503.4553607957491,505.22471275279065,506.07663419548334,504.37279131009797,10045,9491.8,40.03251898549659,40.91674858445373,NaN,NaN,NaN,NaN,0.5644063017345731,12.868759566529638,12314128
2025-09-03T13:40:00-04:00,503.79,504,503.385,503.48,NaN,NaN,NaN,505.5719748653827,NaN,NaN,505.1031000000021,506.92830014005733,503.27789985994684,503.4553607957491,505.2062339725506,506.0703432545185,504.3421246905827,7764,9372.9,36.43922258191499,40.59121993292014,NaN,NaN,NaN,NaN,0.5680201373249614,13.531292357800401,12306364
2025-09-03T13:45:00-04:00,503.49,503.62,502.95,503.5,NaN,NaN,NaN,505.1704078260471,NaN,NaN,505.0677000000021,506.94645193442705,503.18894806557716,503.4553607957491,505.1738367321138,506.06404857557203,504.28362488865554,12008,9384.633333333333,36.820919039390304,40.354891876872735,NaN,NaN,NaN,NaN,0.5753044132303223,14.761999884139238,12318372
2025-09-03T13:50:00-04:00,503.45,503.77,503.29,503.36,NaN,NaN,NaN,505.1704078260471,NaN,NaN,505.00590000000216,506.90191443850864,503.1098855614957,503.4553607957491,505.164835652004,506.0612215875802,504.2684497164278,3648,9158.933333333332,35.2262236440267,40.274128042801046,NaN,NaN,NaN,NaN,0.5684969551424394,15.536069361335247,12314724
2025-09-03T13:55:00-04:00,503.4,503.43,502.95,503.32,NaN,NaN,NaN,505.0358364696008,NaN,NaN,504.95370000000213,506.88839254173024,503.019007458274,503.4553607957491,505.1488155824671,506.05850208468144,504.2391290802527,5764,8935.033333333333,34.76297233217984,40.04006118079598,NaN,NaN,NaN,NaN,0.5621757440608378,16.721964605776744,12308960
2025-09-03T14:00:00-04:00,503.26,503.27,502.85,503.04,NaN,NaN,NaN,504.88602572098256,NaN,NaN,504.9039000000022,506.90378128419536,502.904018715809,503.39643090927945,505.1363942863355,506.0575340909367,504.21525448173423,4144,8633.2,31.62753162880388,39.86555633051988,NaN,NaN,NaN,NaN,0.5555917623422044,17.954448286496763,12304816
2025-09-03T14:05:00-04:00,503.05,503.36,502.92,503.29,NaN,NaN,NaN,504.88602572098256,NaN,NaN,504.8783000000021,506.92680150869836,502.8297984913059,503.39643090927945,505.124591852548,506.0552831843833,504.1939005207127,4265,8537.9,37.08397469805346,39.9998932676397,NaN,NaN,NaN,NaN,0.5473352078891897,18.854087919207117,12309081
2025-09-03T14:10:00-04:00,503.35,503.55,503.2,503.38,NaN,NaN,NaN,504.88602572098256,NaN,NaN,504.8415000000021,506.92984695186976,502.75315304813444,503.1087157819388,505.1137793687598,506.0516550103879,504.17590372713175,4378,8391.566666666668,38.97215552842773,39.77713079844035,NaN,NaN,NaN,NaN,0.5332398358971063,19.176938757835433,12313459
2025-09-03T14:15:00-04:00,503.32,503.36,503.04,503.2,NaN,NaN,NaN,504.88602572098256,NaN,NaN,504.79310000000214,506.9188703429901,502.6673296570142,503.1087157819388,505.0989071596742,506.0481258399821,504.14968847936626,5543,8353.133333333333,36.60596943522626,39.374859585417106,NaN,NaN,NaN,NaN,0.5194369904758827,19.73659238968743,12307916
2025-09-03T14:20:00-04:00,503.17,503.36,503.07,503.19,NaN,NaN,NaN,504.88602572098256,NaN,NaN,504.75590000000216,506.9270008154929,502.58479918451144,502.84997262555106,505.0907662073099,506.0460033727372,504.13552904188265,3082,8262.3,36.473479209058226,38.759489020741306,NaN,NaN,NaN,NaN,0.503048634013321,20.256270762121428,12304834
2025-09-03T14:25:00-04:00,503.18,503.47,503.09,503.26,NaN,NaN,NaN,504.88602572098256,NaN,NaN,504.6981000000021,506.8715423275252,502.524657672479,502.7244781004408,505.081492740661,506.04304878227697,504.11993669904507,3674,8060.666666666667,38.16072760182556,37.98918578196531,NaN,NaN,NaN,NaN,0.4942594458695161,20.407912234142398,12308508
2025-09-03T14:30:00-04:00,503.21,503.21,502.9,502.95,NaN,NaN,NaN,504.6983773589621,NaN,NaN,504.6353000000022,506.82563185405877,502.4449681459456,502.4578356670269,505.0583417969395,506.0388499513631,504.0778336425159,8178,7999.7,33.870381062040764,37.21643437919587,NaN,NaN,NaN,NaN,0.48466948545026595,20.90100165672218,12300330
2025-09-03T14:35:00-04:00,502.9,503.15,502.62,502.65,NaN,NaN,NaN,504.52595111537295,NaN,NaN,504.5933000000021,506.8526712468767,502.3339287531275,502.4578356670269,505.0413107584708,506.0373944995151,504.0452270174265,5550,8022.433333333333,30.31799287989999,36.28380701690255,NaN,NaN,NaN,NaN,0.48790737934667355,21.83447135785548,12294780
2025-09-03T14:40:00-04:00,502.69,503.22,502.56,503.13,NaN,NaN,NaN,504.52595111537295,NaN,NaN,504.54530000000216,506.82491611486364,502.2656838851407,502.4578356670269,505.01870361508804,506.0324437501384,504.0049634800377,8097,8046.6,40.98343635034449,36.241250355477725,NaN,NaN,NaN,NaN,0.5001997093933415,22.470948039325997,12302877
2025-09-03T14:45:00-04:00,503.12,503.18,502.87,502.9,NaN,NaN,NaN,504.52595111537295,NaN,NaN,504.48270000000207,506.76769208560313,502.197707914401,502.4578356670269,505.0042494892945,506.02874042353216,503.9797585550569,5306,7619.733333333334,37.98342004702321,36.09488614558676,NaN,NaN,NaN,NaN,0.48661401586524583,23.061962100691478,12297571
2025-09-03T14:50:00-04:00,502.96,503.01,502.7,502.87,NaN,NaN,NaN,504.4468302291012,NaN,NaN,504.4185000000021,506.7007482317354,502.1362517682688,502.4578356670269,504.9712096094767,506.0215253730844,503.92089384586905,11693,7829.866666666667,37.59683536856879,36.17757277320489,NaN,NaN,NaN,NaN,0.47399872901772844,23.92481433788731,12285878
2025-09-03T14:55:00-04:00,502.9,503.07,502.82,503.07,NaN,NaN,NaN,504.4468302291012,NaN,NaN,504.3553000000021,506.6082166942463,502.1023833057579,502.4578356670269,504.95585029788487,506.0164494725169,503.8952511232528,5919,7766.8,41.84618263288343,36.53652017274012,NaN,NaN,NaN,NaN,0.4579988198021764,24.498589987857414,12291797
2025-09-03T15:00:00-04:00,503.03,503.07,502.78,502.81,NaN,NaN,NaN,504.4468302291012,NaN,NaN,504.27750000000214,506.46899469338234,502.0860053066219,502.4578356670269,504.931830788842,506.0092985229123,503.8543630547717,8982,7741.3,38.20407072799031,36.749223535880375,NaN,NaN,NaN,NaN,0.4459989041020224,25.112230239902818,12282815
2025-09-03T15:05:00-04:00,502.82,503.21,502.66,502.68,NaN,NaN,NaN,504.4468302291012,NaN,NaN,504.1973000000021,506.3222632541057,502.0723367458985,502.4578356670269,504.9075711363682,506.0017942577726,503.81334801496376,9123,7857.966666666666,36.493776105176146,36.87285237680868,NaN,NaN,NaN,NaN,0.4534275538090176,25.121147542757267,12273692
2025-09-03T15:10:00-04:00,502.72,502.75,502.46,502.56,NaN,NaN,NaN,504.1033675328949,NaN,NaN,504.1219000000021,506.2059622715101,502.0378377284941,502.4578356670269,504.88153515513346,505.9966744581993,503.7663958520676,8895,7574.266666666666,34.938909236848616,37.109379348811885,NaN,NaN,NaN,NaN,0.441754157108375,25.57382789281481,12264797
2025-09-03T15:15:00-04:00,502.53,502.93,502.32,502.8,NaN,NaN,NaN,504.1033675328949,NaN,NaN,504.0479000000021,506.0500928856802,502.04570711432393,502.2202685336215,504.84835629803325,505.98703938771206,503.70967320835445,12134,7588.166666666667,40.4075607346662,37.346778351427076,NaN,NaN,NaN,NaN,0.4537717173149206,25.293338186290747,12276931
2025-09-03T15:20:00-04:00,502.78,503.18,502.74,503.05,NaN,NaN,NaN,504.1033675328949,NaN,NaN,503.98170000000204,505.8904290094746,502.0729709905295,502.21098770758215,504.81757522228554,505.97142857352617,503.6637218710449,13540,7713.766666666666,45.54244324305782,37.8160846167578,NaN,NaN,NaN,NaN,0.45278802322099754,24.160278668697295,12290471
2025-09-03T15:25:00-04:00,503.05,503.53,503,503.22,NaN,NaN,NaN,504.1033675328949,NaN,NaN,503.92750000000206,505.7644107195055,502.0905892804986,502.41036456502565,504.78559734748364,505.9489215301627,503.6222731648046,17023,7830.633333333333,48.77478123114563,38.685285459323474,NaN,NaN,NaN,NaN,0.45830316441949576,22.788804372792782,12307494
2025-09-03T15:30:00-04:00,503.22,503.62,503.22,503.49,NaN,NaN,NaN,504.1033675328949,NaN,NaN,503.88070000000204,505.63888998730926,502.1225100126948,502.52429165202057,504.7612178158994,505.92778207117686,503.5946535606219,15437,7764.733333333334,53.49594398994734,39.90117580081555,NaN,NaN,NaN,NaN,0.45413865267524445,21.753816495823482,12322931
2025-09-03T15:35:00-04:00,503.52,503.83,503.39,503.77,NaN,NaN,NaN,504.1033675328949,NaN,NaN,503.85180000000213,505.5683206177614,502.13527938224286,502.7334333216164,504.7410149702951,505.9061768278674,503.5758531127228,15933,8129.1,57.83591457454442,41.3065462988669,NaN,NaN,NaN,NaN,0.4531287489127268,21.324148084299217,12338864
2025-09-03T15:40:00-04:00,503.76,504.22,503.61,504.095,502.41281718073486,502.41281718073486,502.41281718073486,NaN,NaN,NaN,503.8289000000021,505.50069817906075,502.1571018209434,503.03774665729316,504.72342898781653,505.8808383875062,503.5660195881269,20345,8479.033333333333,62.240746717252804,43.333000988524894,NaN,NaN,NaN,NaN,0.4643338382761044,21.765400912226873,12359209
2025-09-03T15:45:00-04:00,504.16,504.56,503.8,504.38,502.6424618543378,NaN,NaN,NaN,NaN,NaN,503.80430000000206,505.4052372353107,502.2033627646934,503.23419732583454,504.7102953537651,505.8543159154011,503.5662747921291,25104,9153.466666666667,65.63148044374933,45.85539295737128,NaN,NaN,NaN,NaN,0.4854528498278106,22.775213191842987,12384313
2025-09-03T15:50:00-04:00,504.4,505.62,504.4,504.98,503.37325904277697,NaN,NaN,NaN,NaN,NaN,503.80150000000197,505.3936887425185,502.2093112574854,503.9393578606676,504.72692191724724,505.83967097563925,503.6141728588552,55485,10852.833333333334,71.44504881797359,48.031222419344786,NaN,NaN,NaN,NaN,0.5393490748401105,24.9952520334465,12439798
2025-09-03T15:55:00-04:00,504.96,505.55,504.57,505.4,503.37325904277697,NaN,NaN,NaN,NaN,NaN,503.799900000002,505.3854856809351,502.21431431906893,503.9393578606676,504.7853751567867,505.83359089968,503.7371594138934,145664,15371.866666666667,74.67446034663085,50.6520110121739,NaN,NaN,NaN,NaN,0.5708241409229611,27.056716672078334,12585462
2025-09-04T09:30:00-04:00,504.15,506.8,503.96,506.73,503.3738372683154,NaN,NaN,NaN,NaN,NaN,503.8227000000021,505.5380672584401,502.1073327415641,503.9393578606676,505.83,505.83,505.83,30508,16241.033333333333,81.72340723533826,53.80390900265744,NaN,NaN,NaN,NaN,0.7329081308570375,29.883823414283185,12615970
2025-09-04T09:35:00-04:00,506.69,506.89,504.85,505.12,503.6768446652102,NaN,NaN,NaN,NaN,NaN,503.818500000002,505.5200572254781,502.1169427745259,503.9393578606676,505.72781300484655,505.83277531714475,505.62285069254835,28916,16870.066666666666,59.9651769858237,55.09812288501031,NaN,NaN,NaN,NaN,0.826271835795818,32.55909713674579,12587054
2025-09-04T09:40:00-04:00,505.14,505.14,503.9,504.59,503.6768446652102,NaN,NaN,NaN,NaN,NaN,503.8105000000021,505.49361169899083,502.12738830101335,503.9393578606676,505.34195499328683,505.90372247953104,504.7801875070426,28711,17568.3,54.79339738126313,56.28307478881551,NaN,NaN,NaN,NaN,0.8558238475246888,32.73769676308446,12558343
2025-09-04T09:45:00-04:00,504.61,504.93,503.87,504.48,503.6768446652102,NaN,NaN,NaN,NaN,NaN,503.79050000000206,505.41658271362064,502.16441728638347,503.9393578606676,505.15859669975384,505.78034259235267,504.536850807155,22079,17904,53.7571144683772,57.51617038618702,NaN,NaN,NaN,NaN,0.8704078584157825,32.84066761413852,12536264
2025-09-04T09:50:00-04:00,504.48,504.56,503.59,504.32,NaN,NaN,NaN,506.40679297102633,506.40679297102633,506.40679297102633,503.7813000000021,505.38999737091433,502.17260262908985,503.9393578606676,505.020103915804,505.6929441940293,504.3472636375787,17678,18371.666666666668,52.210369002264514,58.749846083716726,NaN,NaN,NaN,NaN,0.8775215828146571,32.347058676833825,12518586
2025-09-04T09:55:00-04:00,504.47,504.76,503.78,504.02,NaN,NaN,NaN,506.40679297102633,NaN,NaN,503.77130000000216,505.3676744018961,502.1749255981082,503.9393578606676,504.90939863847797,505.5968507327718,504.2219465441841,19590,18832.533333333333,49.343556394025974,59.388131487956706,NaN,NaN,NaN,NaN,0.8848414697564685,32.127613043485425,12498996
2025-09-04T10:00:00-04:00,503.84,503.92,503.16,503.5,NaN,NaN,NaN,505.90946425665834,NaN,NaN,503.7533000000021,505.3411861518615,502.16541384814275,503.9393578606676,504.715086423926,505.5132736157574,503.9168992320946,24114,19498.2,44.75619962285546,59.33197122937083,NaN,NaN,NaN,NaN,0.8830670790595747,30.714180809359483,12474882
2025-09-04T10:05:00-04:00,503.55,504.42,503.37,504.42,NaN,NaN,NaN,505.90946425665834,NaN,NaN,503.75230000000215,505.3384414915239,502.1661585084804,503.9393578606676,504.65337812982546,505.4357830596128,503.8709732000381,18151,19961.066666666666,53.06922267316066,59.63871704665762,NaN,NaN,NaN,NaN,0.8949908591267487,30.041324466068424,12493033
2025-09-04T10:10:00-04:00,504.37,505.24,504.32,504.5,NaN,NaN,NaN,505.90946425665834,NaN,NaN,503.7547000000021,505.3449910523753,502.16440894762894,503.9123890308273,504.65728874522296,505.39237944827016,503.92219804217575,25258,20657.066666666666,53.72136564056374,59.65481859313022,NaN,NaN,NaN,NaN,0.896777226331982,30.27577345534647,12518291
2025-09-04T10:15:00-04:00,504.49,504.87,503.96,504.77,NaN,NaN,NaN,505.90946425665834,NaN,NaN,503.7643000000021,505.3730883736902,502.15551162631397,503.9123890308273,504.64860696603483,505.35819323699286,503.9390206950768,16193,21012.066666666666,55.94634250340588,59.51984915947747,NaN,NaN,NaN,NaN,0.8977217101654136,29.8516916073811,12534484
2025-09-04T10:20:00-04:00,504.75,505.12,504.51,505.01,NaN,NaN,NaN,505.90946425665834,NaN,NaN,503.7869000000021,505.4328731320297,502.1409268679745,503.5599112246618,504.6765994210745,505.3461474789543,504.0070513631947,31818,21969.933333333334,57.88462808648859,59.20869782870859,NaN,NaN,NaN,NaN,0.8771701594393136,29.717213998004166,12566302
2025-09-04T10:25:00-04:00,504.98,505.62,504.87,505.5,NaN,NaN,NaN,505.90946425665834,NaN,NaN,503.8171000000021,505.5308842196661,502.10331578033805,503.35847537226863,504.7282211281448,505.39451091535676,504.06193134093286,22562,22599.533333333333,61.5994871411329,58.92069830709313,NaN,NaN,NaN,NaN,0.8680865766222199,30.07425869889711,12588864
2025-09-04T10:30:00-04:00,505.45,506.46,505.44,506.12,503.5195668917506,503.5195668917506,503.5195668917506,NaN,NaN,NaN,503.86870000000215,505.6975059578137,502.0398940421906,504.1407802978149,504.820223274395,505.54213015166306,504.09831639712695,22145,23065.1,65.7197588972775,58.511749027043415,NaN,NaN,NaN,NaN,0.8789375354349171,31.081522057012727,12611009
2025-09-04T10:35:00-04:00,506.09,507.17,506.02,507.11,504.1182229421256,NaN,NaN,NaN,NaN,NaN,503.93870000000214,505.9783223256628,501.89907767434147,504.7396242382519,504.97899841020654,505.8521969203056,504.1057999001075,27331,23791.133333333335,71.05952962867052,58.25353969004625,NaN,NaN,NaN,NaN,0.8982991400467112,32.481499190818916,12638340
2025-09-04T10:40:00-04:00,507.12,507.35,506.89,507.09,504.6930764447563,NaN,NaN,NaN,NaN,NaN,503.9993000000021,506.2216069165738,501.7769930834304,505.17569939060155,505.09258182215467,506.06776414303744,504.1173995012719,18864,24150.033333333333,70.81952961577564,57.47469128864892,NaN,NaN,NaN,NaN,0.8669920586148059,33.89010155399815,12619476
2025-09-04T10:45:00-04:00,507.05,507.45,506.96,507.415,504.8215729699946,NaN,NaN,NaN,NaN,NaN,504.06620000000214,506.48564337221416,501.6467566277901,505.4655595124812,505.18144824872627,506.22944815757506,504.1334483398775,15023,24473.933333333334,72.4480008862663,58.36632156725195,NaN,NaN,NaN,NaN,0.8400640544280347,35.259933139747304,12634499
2025-09-04T10:50:00-04:00,507.42,507.64,506.94,507.265,504.919456016813,NaN,NaN,NaN,NaN,NaN,504.1263000000022,506.7059975076893,501.54660249231506,505.702447609985,505.25990408549853,506.3625801967582,504.1572279742389,14317,24561.4,70.49265206427701,59.48769690175295,NaN,NaN,NaN,NaN,0.8300594791117456,36.65172853360168,12620182
2025-09-04T10:55:00-04:00,507.26,507.55,506.95,507.49,504.919456016813,NaN,NaN,NaN,NaN,NaN,504.18550000000215,506.9301203728812,501.4408796271231,505.702447609985,505.33324456692714,506.481835110649,504.18465402320527,14077,24833.333333333332,71.7253890280589,60.77114508458736,NaN,NaN,NaN,NaN,0.813626659175194,37.94410997075216,12634259
2025-09-04T11:00:00-04:00,507.53,507.56,506.63,506.78,504.919456016813,NaN,NaN,NaN,NaN,NaN,504.23730000000205,507.0764408615342,501.3981591384699,505.702447609985,505.3602622783606,506.5186137134649,504.2019108432563,6587,24753.5,62.8083954552104,61.52814697408349,NaN,NaN,NaN,NaN,0.8219390406626806,38.42291481644338,12627672
2025-09-04T11:05:00-04:00,506.84,507.01,506.6,506.91,504.919456016813,NaN,NaN,NaN,NaN,NaN,504.2939000000021,507.22943966951345,501.35836033049077,505.702447609985,505.3797338434626,506.5427280535293,504.2167396333959,5386,24628.933333333334,63.69829753349363,62.55348562690261,NaN,NaN,NaN,NaN,0.7925148234724869,38.799896703902355,12633058
2025-09-04T11:10:00-04:00,506.96,507.1,506.16,506.52,504.919456016813,NaN,NaN,NaN,NaN,NaN,504.3457000000021,507.3444510785866,501.34694892141766,505.702447609985,505.3964858715408,506.5600730125711,504.2328987305105,5729,24523.4,59.127492417533865,63.5800065408082,NaN,NaN,NaN,NaN,0.8030494789387378,38.188267795236484,12627329
2025-09-04T11:15:00-04:00,506.51,507.29,506.32,507.29,504.919456016813,NaN,NaN,NaN,NaN,NaN,504.4155000000021,507.5207711623224,501.31022883768185,505.702447609985,505.4346355817183,506.6091507394669,504.2601204239697,10335,24463.433333333334,64.53800969233804,64.39920561360658,NaN,NaN,NaN,NaN,0.8149745161574014,37.82837393773556,12637664
2025-09-04T11:20:00-04:00,507.29,508.04,507.29,507.9,505.30772716161556,NaN,NaN,NaN,NaN,NaN,504.5039000000022,507.7462413069836,501.2615586930208,506.0745542662719,505.510607833954,506.73686895547905,504.28434671242894,14474,24494.566666666666,68.13653305156853,65.42886042867835,NaN,NaN,NaN,NaN,0.8103334792890156,38.21393069591316,12652138
2025-09-04T11:25:00-04:00,507.855,507.99,507.55,507.69,505.45987592699663,NaN,NaN,NaN,NaN,NaN,504.5877000000021,507.9367537218028,501.2386462782014,506.19764341301754,505.5890606116444,506.86180878966934,504.3163124336195,16018,24461.066666666666,65.66608082801852,66.12312745186497,NaN,NaN,NaN,NaN,0.7838810879112286,38.571947685649505,12636120
2025-09-04T11:30:00-04:00,507.7,507.74,506.84,506.94,505.45987592699663,NaN,NaN,NaN,NaN,NaN,504.65930000000213,508.0530796085269,501.26552039147737,506.19764341301754,505.621948883848,506.90151234947183,504.3423854182242,9664,24268.633333333335,57.62955498564281,66.1049079446617,NaN,NaN,NaN,NaN,0.7921752959175719,37.45176009981989,12626456
2025-09-04T11:35:00-04:00,506.9,507.1,506.71,507.085,505.45987592699663,NaN,NaN,NaN,NaN,NaN,504.7346000000021,508.1729547448539,501.2962452551503,506.19764341301754,505.64048247825406,506.92080933312025,504.36015562338787,6514,23954.666666666668,58.68237473557041,65.89654277283582,NaN,NaN,NaN,NaN,0.7634484890663199,36.172516139813574,12632970
2025-09-04T11:40:00-04:00,507.04,507.4,507.02,507.255,505.45987592699663,NaN,NaN,NaN,NaN,NaN,504.8189000000021,508.2934240179915,501.34437598201265,506.19764341301754,505.665111325457,506.95048121050434,504.3797414404097,7453,23524.933333333334,59.93920369250236,65.48364597249473,NaN,NaN,NaN,NaN,0.7360593112758682,35.348978303671416,12640423
2025-09-04T11:45:00-04:00,507.185,507.2,506.83,507.02,505.45987592699663,NaN,NaN,NaN,NaN,NaN,504.8935000000021,508.39359156900093,501.3934084310033,506.19764341301754,505.68977054267697,506.97614214710825,504.4033989382457,8911,22985.166666666668,57.3425075635246,64.50385868212716,NaN,NaN,NaN,NaN,0.7138407890418784,34.215261065095284,12631512
2025-09-04T11:50:00-04:00,507.04,507.22,506.8,507.22,505.45987592699663,NaN,NaN,NaN,NaN,NaN,504.9703000000021,508.5025516376109,501.4380483623933,506.19764341301754,505.70670038583387,506.99427583016603,504.4191249415017,6021,21336.366666666665,58.97158496228993,63.6575769211639,NaN,NaN,NaN,NaN,0.692852161253174,33.102799602064586,12637533
2025-09-04T11:55:00-04:00,507.14,507.24,506.7,506.86,505.45987592699663,NaN,NaN,NaN,NaN,NaN,505.0435000000021,508.57766595414694,501.50933404585726,506.19764341301754,505.7347909021143,507.0206962575459,504.4488855466827,11588,16867.166666666668,54.906868470190155,62.40463889144417,NaN,NaN,NaN,NaN,0.6819341497350916,31.8621233936763,12625945
2025-09-04T12:00:00-04:00,506.89,506.95,506.48,506.64,505.45987592699663,NaN,NaN,NaN,NaN,NaN,505.11250000000206,508.6339134934402,501.5910865065639,506.19764341301754,505.74629960274854,507.02867659720835,504.4639226082887,6171,16055.933333333332,52.524262184394445,61.12118247145256,NaN,NaN,NaN,NaN,0.666795996182583,30.256430679606254,12619774
2025-09-04T12:05:00-04:00,506.65,506.84,506.52,506.81,505.45987592699663,NaN,NaN,NaN,NaN,NaN,505.1835000000021,508.6957882842456,501.67121171575855,506.19764341301754,505.75454268174644,507.0346216892714,504.4744636742215,4358,15237.333333333334,54.17889668050811,59.867861589484654,NaN,NaN,NaN,NaN,0.6420248535981123,28.765430302255496,12624132
2025-09-04T12:10:00-04:00,506.78,506.94,506.65,506.85,505.45987592699663,NaN,NaN,NaN,NaN,NaN,505.26150000000206,508.7450224976571,501.777977502347,506.19764341301754,505.7624869327575,507.04102351661163,504.48395034890336,3905,14410.466666666667,54.5800155440126,59.280120167256236,NaN,NaN,NaN,NaN,0.6168802211982486,27.562909781795348,12628037
2025-09-04T12:15:00-04:00,506.87,507,506.64,506.8,505.45987592699663,NaN,NaN,NaN,NaN,NaN,505.3445000000021,508.7724931434527,501.91650685655145,505.9207573401035,505.7697775011052,507.04685345292575,504.4927015492846,3636,13795.7,53.944321741902755,58.583407610714026,NaN,NaN,NaN,NaN,0.5985316339698032,26.558525528000548,12624401
2025-09-04T12:20:00-04:00,506.77,506.83,506,506.08,505.45987592699663,NaN,NaN,NaN,NaN,NaN,505.4035000000021,508.7781361272649,502.02886387273935,505.9207573401035,505.77679519649024,507.04690032742616,504.5066900655543,6985,13439.266666666666,45.691589351286076,57.62370024883919,NaN,NaN,NaN,NaN,0.6150650886862447,25.07611227376198,12617416
2025-09-04T12:25:00-04:00,506.03,506.14,505.81,505.99,505.45987592699663,NaN,NaN,NaN,NaN,NaN,505.4653000000022,508.7666648134162,502.16393518658816,505.9207573401035,505.7782162356726,507.0439858383062,504.51244663303896,3740,12910.933333333332,44.76959161492644,56.21167038616693,NaN,NaN,NaN,NaN,0.5947032966372261,24.046608484415106,12613676
2025-09-04T12:30:00-04:00,506.04,506.48,505.97,506.19,505.45987592699663,NaN,NaN,NaN,NaN,NaN,505.53170000000216,508.75420561384004,502.3091943861643,505.9207573401035,505.7806932721293,507.04327930748457,504.5181072367741,3062,12209.2,47.313855638465526,54.724336285231,NaN,NaN,NaN,NaN,0.5886530611631378,22.3760001281033,12616738
2025-09-04T12:35:00-04:00,506.23,506.49,506.16,506.32,505.45987592699663,NaN,NaN,NaN,NaN,NaN,505.59670000000216,508.7482961719718,502.44510382803253,505.9207573401035,505.7853799808808,507.0435041792491,504.5272557825125,4686,11760.366666666667,48.95972355849518,53.53102505169362,NaN,NaN,NaN,NaN,0.5701778425086268,20.804190533249777,12621424
2025-09-04T12:40:00-04:00,506.34,506.46,506.19,506.3,505.45987592699663,NaN,NaN,NaN,NaN,NaN,505.66650000000215,508.72123157436545,502.61176842563884,505.9207573401035,505.79078363888584,507.0436279744008,504.5379393033709,5575,11104.266666666666,48.70762703219795,52.89374448359041,NaN,NaN,NaN,NaN,0.5487365680437236,19.344653052314364,12615849
2025-09-04T12:45:00-04:00,506.36,506.74,506.29,506.74,505.45987592699663,NaN,NaN,NaN,NaN,NaN,505.74770000000206,508.6945065481055,502.8008934518986,505.9207573401035,505.79368773009645,507.0451780456775,504.5421974145154,1999,10631.133333333333,54.28459145445592,52.57961710636795,NaN,NaN,NaN,NaN,0.5416839560405997,18.544791265952625,12617848
2025-09-04T12:50:00-04:00,506.74,507.09,506.64,507.03,505.45987592699663,NaN,NaN,NaN,NaN,NaN,505.8371000000021,508.66027699615364,503.0139230038506,506.0204814497313,505.80000907085656,507.05081581864374,504.5492023230694,3105,9674.033333333333,57.55989487100703,52.40966647626114,NaN,NaN,NaN,NaN,0.5351351020376989,18.47469697120923,12620953
2025-09-04T12:55:00-04:00,506.97,507.02,506.35,506.36,505.45987592699663,NaN,NaN,NaN,NaN,NaN,505.90830000000204,508.59791083279646,503.21868916720763,506.0204814497313,505.8089430443265,507.05528951877307,504.56259656987993,6438,9136.566666666668,48.85166658611668,51.80317783501771,NaN,NaN,NaN,NaN,0.5454825947492882,17.705799992885765,12614515
2025-09-04T13:00:00-04:00,506.44,506.94,506.44,506.94,505.45987592699663,NaN,NaN,NaN,NaN,NaN,505.98610000000207,508.5631830704116,503.40901692959255,506.0204814497313,505.8213834101428,507.0644377037011,504.5783291165845,7314,8642.2,55.174003565136424,51.531922020935326,NaN,NaN,NaN,NaN,0.5479481236957665,16.99182422729969,12621829
2025-09-04T13:05:00-04:00,506.9,507,506.53,506.54,505.45987592699663,NaN,NaN,NaN,NaN,NaN,506.05250000000206,508.5093599861958,503.5956400138083,506.0204814497313,505.8273082546397,507.068177132523,504.58643937675646,3894,7860.966666666666,50.53470259656175,51.219624458533296,NaN,NaN,NaN,NaN,0.5423804005746423,16.458807376250448,12617935
2025-09-04T13:10:00-04:00,506.5,506.5,506.17,506.17,505.45987592699663,NaN,NaN,NaN,NaN,NaN,506.106100000002,508.4514061957768,503.7607938042272,506.0204814497313,505.8313983598573,507.0673913163001,504.59540540341453,5205,7405.666666666667,46.6289884115813,50.79853347476093,NaN,NaN,NaN,NaN,0.530067514819311,15.486494091409636,12612730
2025-09-04T13:15:00-04:00,506.27,506.49,506.23,506.49,505.45987592699663,NaN,NaN,NaN,NaN,NaN,506.16050000000206,508.41079442333773,503.9102055766664,506.0204814497313,505.83306732101727,507.0676411047625,504.598493537272,1686,6961.1,50.21292482797771,50.515249771008754,NaN,NaN,NaN,NaN,0.5150626923322169,14.583631755486026,12614416
2025-09-04T13:20:00-04:00,506.48,506.78,506.45,506.72,505.45987592699663,NaN,NaN,NaN,NaN,NaN,506.21300000000207,508.38935934342146,504.0366406565827,506.0204814497313,505.83734037577295,507.0700903981833,504.6045903533626,3038,6585.133333333333,52.67288154463205,50.37902591391014,NaN,NaN,NaN,NaN,0.5018439285942004,14.040069498455257,12617454
2025-09-04T13:25:00-04:00,506.72,506.84,506.57,506.79,505.45987592699663,NaN,NaN,NaN,NaN,NaN,506.2612000000021,508.3790031617137,504.14339683829047,506.0204814497313,505.84326637066397,507.0740775703467,504.61245517098126,3867,6244.8,53.427103188347346,50.342081731513325,NaN,NaN,NaN,NaN,0.4852836479803276,13.67375444933091,12621321
2025-09-04T13:30:00-04:00,506.77,506.81,506.6,506.74,505.45987592699663,NaN,NaN,NaN,NaN,NaN,506.29640000000205,508.3861741868258,504.2066258131783,506.0204814497313,505.8500872051423,507.078491208954,504.6216832013306,4602,6178.633333333333,52.78008621888237,50.848402936341635,NaN,NaN,NaN,NaN,0.46562053026744554,13.333604760858304,12616719
2025-09-04T13:35:00-04:00,506.74,507.03,506.74,506.85,505.45987592699663,NaN,NaN,NaN,NaN,NaN,506.32540000000205,508.40482957371574,504.24597042628835,506.1809510677291,505.8592014350821,507.08589565719274,504.6325072129715,5296,6175.633333333333,54.097133053713314,51.51465589625498,NaN,NaN,NaN,NaN,0.4530762066769111,13.547217748756015,12622015
2025-09-04T13:40:00-04:00,506.83,507.14,506.74,506.93,505.45987592699663,NaN,NaN,NaN,NaN,NaN,506.32940000000207,508.41269319871384,504.2461068012903,506.2607608541833,505.8689790735453,507.0943617940556,504.643596353035,5445,6166.166666666667,55.078457625999,52.06927032393594,NaN,NaN,NaN,NaN,0.4492850490571301,13.996475239423829,12627460
2025-09-04T13:45:00-04:00,506.97,507.4,506.9,507.33,505.61692475329056,NaN,NaN,NaN,NaN,NaN,506.37360000000206,508.4461298916636,504.3010701083405,506.4466086833466,505.8774074126213,507.10352201019464,504.651292815048,3795,5948.166666666667,59.715734243609134,52.83755680144408,NaN,NaN,NaN,NaN,0.4529075455530494,14.966425494631894,12631255
2025-09-04T13:50:00-04:00,507.37,507.67,507.24,507.53,505.93297362814104,NaN,NaN,NaN,NaN,NaN,506.432400000002,508.4656321441264,504.39916785587764,506.6922869466773,505.9003790277911,507.1324887154617,504.66826934012045,8781,5758.4,61.83704838840478,53.775372612601714,NaN,NaN,NaN,NaN,0.45127129229926066,16.371188557717694,12640036
2025-09-04T13:55:00-04:00,507.52,507.59,507.24,507.3,505.93297362814104,NaN,NaN,NaN,NaN,NaN,506.488800000002,508.4577027990352,504.51989720096884,506.6922869466773,505.9123237639555,507.14654516861435,504.67810235929664,4997,5391.033333333334,58.05119964794919,54.04441605499409,NaN,NaN,NaN,NaN,0.4440376285635968,17.675611402011658,12635039
2025-09-04T14:00:00-04:00,507.29,507.525,507.26,507.47,505.93297362814104,NaN,NaN,NaN,NaN,NaN,506.55180000000195,508.43897435130754,504.66462564869636,506.6922869466773,505.9242623969931,507.1608156391757,504.6877091548104,4935,5233.4,60.00048320889871,54.21874379341493,NaN,NaN,NaN,NaN,0.4312492265233389,18.886861185998907,12639974
2025-09-04T14:05:00-04:00,507.41,507.45,507.1,507.31,505.93297362814104,NaN,NaN,NaN,NaN,NaN,506.61760000000197,508.371822606211,504.8633773937929,506.6922869466773,505.9387456248674,507.17661930254087,504.70087194719395,6689,5239.233333333334,57.301636340288105,54.82231306157003,NaN,NaN,NaN,NaN,0.42687428177167214,19.364679164895843,12633285
2025-09-04T14:10:00-04:00,507.31,507.43,507.08,507.2,505.93297362814104,NaN,NaN,NaN,NaN,NaN,506.691600000002,508.20981400072947,505.1733859992745,506.6922869466773,505.95357254107176,507.19205986398794,504.7150852181556,7271,5233.166666666667,55.45483451492248,54.84237241512618,NaN,NaN,NaN,NaN,0.42138326164512574,19.72786986504784,12626014
2025-09-04T14:15:00-04:00,507.22,507.335,507.09,507.15,505.93297362814104,NaN,NaN,NaN,NaN,NaN,506.7462000000021,508.1235330140362,505.368866985968,506.6922869466773,505.9732324252172,507.21155745324404,504.73490739719034,10270,5278.466666666666,54.59353053430057,55.13228869639324,NaN,NaN,NaN,NaN,0.4087844572419028,20.06511837233184,12615744
2025-09-04T14:20:00-04:00,507.2,507.45,507.025,507.395,505.93297362814104,NaN,NaN,NaN,NaN,NaN,506.80410000000205,508.03441652508246,505.57378347492164,506.6922869466773,505.9877437750428,507.2268753657079,504.74861218437775,7207,5318,58.033104459846214,55.946868414126456,NaN,NaN,NaN,NaN,0.40994271029605345,20.683001701050937,12622951
2025-09-04T14:25:00-04:00,507.4,507.41,507.01,507.1,505.93297362814104,NaN,NaN,NaN,NaN,NaN,506.850700000002,507.93743457290174,505.7639654271023,506.6922869466773,505.99609824559286,507.2348324665081,504.7573640246776,4641,5086.433333333333,52.84257674022311,56.134700693572555,NaN,NaN,NaN,NaN,0.40923251670348065,21.18439923275421,12618310
2025-09-04T14:30:00-04:00,507.11,507.41,506.93,507.41,505.93297362814104,NaN,NaN,NaN,NaN,NaN,506.898700000002,507.86085759198636,505.93654240801766,506.6922869466773,506.01742935635417,507.2562395196967,504.77861919301165,11398,5260.666666666667,57.17705295518156,56.456427222897524,NaN,NaN,NaN,NaN,0.41428733693894765,21.25552578663285,12629708
2025-09-04T14:35:00-04:00,507.41,507.96,507.41,507.93,506.28333863560425,NaN,NaN,NaN,NaN,NaN,506.9473000000021,507.8664718182786,506.02812818172555,506.9118095433471,506.0416641375451,507.28873826780546,504.7945900072848,9413,5429.166666666667,63.274892186314624,57.15984072275233,NaN,NaN,NaN,NaN,0.4239810985861624,22.669654643493402,12639121
2025-09-04T14:40:00-04:00,507.89,508.15,507.55,507.55,506.4302323339859,NaN,NaN,NaN,NaN,NaN,506.975900000002,507.8791777822658,506.0726222177382,507.01144763467767,506.06776601382796,507.32289204288935,504.8126399847666,10542,5650.4,56.89863003120295,57.45402242363237,NaN,NaN,NaN,NaN,0.4365538772585769,24.331227748514074,12628579
2025-09-04T14:45:00-04:00,507.55,508,507.48,508,506.4302323339859,NaN,NaN,NaN,NaN,NaN,506.993700000002,507.94085744837724,506.0465425516267,507.01144763467767,506.07901242461736,507.33794985507353,504.8200749941612,4440,5677.2,61.806948260554485,58.00472350983531,NaN,NaN,NaN,NaN,0.4425143145972487,25.542731891754265,12633019
2025-09-04T14:50:00-04:00,508.01,508.11,507.67,507.69,506.4686827671235,NaN,NaN,NaN,NaN,NaN,507.00570000000204,507.9724347267334,506.03896527327066,507.01144763467767,506.0950187253627,507.3591562752958,504.8308811754296,6431,5658.733333333334,56.9920227520273,58.14140673312305,NaN,NaN,NaN,NaN,0.44233472069744506,26.88179149206068,12626588
2025-09-04T14:55:00-04:00,507.74,507.98,507.5,507.53,506.4686827671235,NaN,NaN,NaN,NaN,NaN,507.00800000000197,507.97915600805953,506.0368439919444,507.01144763467767,506.1130270677173,507.3810216292396,504.845032506195,8106,5804.266666666666,54.626648838472384,57.777900632756136,NaN,NaN,NaN,NaN,0.44502509779048605,27.31804010519825,12618482
2025-09-04T15:00:00-04:00,507.56,507.61,507.42,507.57,506.4686827671235,NaN,NaN,NaN,NaN,NaN,507.014100000002,507.9954148079069,506.03278519209704,507.01144763467767,506.12406958500657,507.3932707963668,504.85486837364635,5555,5887.366666666667,55.12805003558255,57.29868646469741,NaN,NaN,NaN,NaN,0.4268090193768797,27.36049679333628,12624037
2025-09-04T15:05:00-04:00,507.525,507.57,507.23,507.3,506.4686827671235,NaN,NaN,NaN,NaN,NaN,507.010300000002,507.9856674343255,506.03493256567856,507.01144763467767,506.1388261557044,507.40762889127086,504.87002342013795,8587,6017.4,51.02894055194324,56.79709652926841,NaN,NaN,NaN,NaN,0.42060837513567223,26.587183791703545,12615450
2025-09-04T15:10:00-04:00,507.28,507.42,507.12,507.4,506.4686827671235,NaN,NaN,NaN,NaN,NaN,507.02270000000203,508.0017979685054,506.04360203149866,507.01144763467767,506.15235812868764,507.4200421639846,504.8846740933907,8428,6112.5,52.439477363326255,56.25702468315609,NaN,NaN,NaN,NaN,0.41199349119741074,25.431714370289388,12623878
2025-09-04T15:15:00-04:00,507.39,507.44,507.01,507.1,506.4686827671235,NaN,NaN,NaN,NaN,NaN,507.026500000002,508.00529364117483,506.04770635882915,507.01144763467767,506.15908741379366,507.42535201759654,504.8928228099908,4806,6206.066666666667,47.97504494345221,55.59083958338209,NaN,NaN,NaN,NaN,0.41327967039759617,23.936393708765493,12619072
2025-09-04T15:20:00-04:00,507.09,507.32,506.95,506.95,506.4686827671235,NaN,NaN,NaN,NaN,NaN,507.035100000002,508.0034418570817,506.06675814292225,507.01144763467767,506.1718473061431,507.43381018652843,504.90988442575775,10422,6449.966666666666,45.87217729140298,54.90636406741641,NaN,NaN,NaN,NaN,0.4101882653691967,22.320218513697245,12608650
2025-09-04T15:25:00-04:00,506.98,507.01,506.55,506.6,506.4686827671235,NaN,NaN,NaN,NaN,NaN,507.02130000000193,507.9943730867952,506.0482269132087,507.01144763467767,506.1832157717976,507.43446469740945,504.9319668461858,15815,6762.533333333334,41.32095196801839,53.95832274125341,NaN,NaN,NaN,NaN,0.41374624641425267,21.932327958388438,12592835
2025-09-04T15:30:00-04:00,506.63,506.88,506.53,506.78,506.4686827671235,NaN,NaN,NaN,NaN,NaN,506.998900000002,507.9411065337153,506.05669346628866,506.95332648619376,506.1917314924189,507.4350433184361,504.9484196664017,12064,6920.866666666667,44.377415988972174,52.982916421905266,NaN,NaN,NaN,NaN,0.40919294309895055,21.629017692853616,12604899
2025-09-04T15:35:00-04:00,506.8,506.84,506.54,506.81,506.4686827671235,NaN,NaN,NaN,NaN,NaN,506.98130000000197,507.9038829135221,506.0587170864818,506.95332648619376,506.20013623043286,507.43550684246577,504.96476561839995,12287,7200.633333333333,44.89262022267374,52.41506238493746,NaN,NaN,NaN,NaN,0.40139344716330794,21.34737244628557,12617186
2025-09-04T15:40:00-04:00,506.81,506.93,506.57,506.73,506.4686827671235,NaN,NaN,NaN,NaN,NaN,506.97710000000194,507.90230503265605,506.05189496734783,506.814661188955,506.2083148064936,507.436133239085,504.9804963739022,12029,7428.1,43.72941760312617,51.45451700264778,NaN,NaN,NaN,NaN,0.3984367723659298,20.68555423960634,12605157
2025-09-04T15:45:00-04:00,506.73,506.73,506.34,506.38,NaN,NaN,NaN,507.82191680246194,507.82191680246194,507.82191680246194,506.963000000002,507.9025743675863,506.02342563241774,506.582728951164,506.2138198998263,507.4298976726318,504.99774212702084,16319,7915.866666666667,38.971760062873315,49.71857899383055,NaN,NaN,NaN,NaN,0.39783414576836645,20.798647131060395,12588838
2025-09-04T15:50:00-04:00,506.37,508.12,506.31,507.35,505.7397612340136,505.7397612340136,505.7397612340136,NaN,NaN,NaN,506.964900000002,507.90720884116115,506.02259115884283,506.5781831609312,506.2499272889915,507.46000003143723,505.03985454654577,29143,8786.033333333333,53.93118500773742,49.506618635011584,NaN,NaN,NaN,NaN,0.4987031353563404,21.47702603068855,12617981
2025-09-04T15:55:00-04:00,507.33,507.97,507.09,507.77,506.0018175415584,NaN,NaN,NaN,NaN,NaN,506.97990000000203,507.9487436158093,506.0110563841948,506.47654652874496,506.418444098365,507.636493911603,505.200394285127,119419,12637.766666666666,58.65672233299159,49.281602497328514,NaN,NaN,NaN,NaN,0.5259386256880341,22.10694929462898,12737400
2025-09-05T09:30:00-04:00,509.05,511.97,506.69,507.06,507.15128038057856,NaN,NaN,NaN,NaN,NaN,506.97670000000204,507.9434049352824,506.0099950647217,507.92077309777153,508.57333333333327,508.5733409627278,508.57332570393874,86440,15365.7,49.42675798825686,48.74122644277349,NaN,NaN,NaN,NaN,0.8655144381388908,25.625870766957053,12650960
2025-09-05T09:35:00-04:00,507.07,507.48,499.87,500.95,NaN,NaN,NaN,506.7924141821751,506.7924141821751,506.7924141821751,506.85850000000204,508.8035534676004,504.91344653240367,507.92077309777153,504.77986368200305,507.5433762620109,502.0163511019952,162879,20618.466666666667,20.10599281337946,46.27546529812399,NaN,NaN,NaN,NaN,1.3472634068432565,25.059015985692167,12488081
2025-09-05T09:40:00-04:00,501.09,503.65,500.1,502.95,NaN,NaN,NaN,505.33480444662166,NaN,NaN,506.784700000002,509.01623257476075,504.5531674252432,507.92077309777153,503.8848394357795,506.42077655845713,501.34890231310186,135117,24940.866666666665,33.92360460145814,44.760862052829395,NaN,NaN,NaN,NaN,1.5046017349258778,24.53265083166049,12623198
2025-09-05T09:45:00-04:00,503.12,503.9,501.3,503.62,NaN,NaN,NaN,505.33480444662166,NaN,NaN,506.720900000002,509.121864546162,504.31993545384205,507.92077309777153,503.76563410396693,506.1568754421055,501.37439276582836,55505,26664.533333333333,37.804292239661585,43.81624431623784,NaN,NaN,NaN,NaN,1.5828444681454557,23.86216556869785,12678703
2025-09-05T09:50:00-04:00,503.62,503.7,501.75,502.77,NaN,NaN,NaN,505.33480444662166,NaN,NaN,506.639300000002,509.2822967900391,503.9963032099649,507.92077309777153,503.66823829840916,505.9628947361341,501.3735818606842,46161,27910.533333333333,34.996195985017195,42.57029564635862,NaN,NaN,NaN,NaN,1.6090698632779223,23.239572110232537,12632542
2025-09-05T09:55:00-04:00,502.68,502.77,501.16,502.54,NaN,NaN,NaN,505.33480444662166,NaN,NaN,506.554100000002,509.43484135462006,503.6733586453839,507.92077309777153,503.51624374436415,505.7394474401214,501.2930400486069,54344,29555.433333333334,34.254740380118804,41.590273891834805,NaN,NaN,NaN,NaN,1.6091363016152105,23.000019633022443,12578198
2025-09-05T10:00:00-04:00,502.47,502.47,500.95,501.18,NaN,NaN,NaN,505.33480444662166,NaN,NaN,506.45610000000204,509.7045995231582,503.20760047684587,507.92077309777153,503.3422857959525,505.53857947544225,501.1459921164627,51972,31123.333333333332,30.18264977477132,40.46959335493255,NaN,NaN,NaN,NaN,1.6077694229284119,22.897537863805034,12526226
2025-09-05T10:05:00-04:00,501.2,501.2,500.57,500.78,NaN,NaN,NaN,504.64532317019376,NaN,NaN,506.351900000002,509.9670607920133,502.7367392079907,507.92077309777153,503.219460746632,505.42785671586944,501.0110647773946,30709,31924,29.087413976277247,39.595769212665324,NaN,NaN,NaN,NaN,1.5379287498620964,23.022261049050226,12495517
2025-09-05T10:10:00-04:00,500.76,501.69,500.25,501.25,NaN,NaN,NaN,504.64532317019376,NaN,NaN,506.253100000002,510.1403349494552,502.3658650505488,507.92077309777153,503.1017629738867,505.304195055166,500.8993308926074,35979,32880.933333333334,32.200556099801915,38.725993506296014,NaN,NaN,NaN,NaN,1.5309338391576606,22.67791755468865,12531496
2025-09-05T10:15:00-04:00,501.24,501.44,500.55,500.57,NaN,NaN,NaN,504.64532317019376,NaN,NaN,506.13810000000194,510.338236611162,501.93796338884187,507.92077309777153,503.0089647213979,505.21136005826276,500.806569384533,28374,33484.4,30.13897759104148,37.67216188975085,NaN,NaN,NaN,NaN,1.4851528506463982,22.358170024210047,12503122
2025-09-05T10:20:00-04:00,500.54,500.87,499.94,499.95,NaN,NaN,NaN,504.09708986468485,NaN,NaN,506.011100000002,510.55400008170346,501.4681999183005,500.43561847821724,502.865437305959,505.0954176825352,500.6354569293828,37775,34503.333333333336,28.356374443872227,36.57408737837557,NaN,NaN,NaN,NaN,1.4454990756002275,22.466984563685223,12465347
2025-09-05T10:25:00-04:00,500,500,498.17,499.2,NaN,NaN,NaN,502.8588130526538,NaN,NaN,505.86030000000204,510.7812512934083,500.9393487065958,497.26626121622644,502.5611134995319,504.9306283381694,500.19159866089444,64202,36488.7,26.327782518858186,35.67094612523163,NaN,NaN,NaN,NaN,1.4729634273430674,23.537452993365545,12401145
2025-09-05T10:30:00-04:00,499.12,499.58,498.41,498.91,NaN,NaN,NaN,502.7568215502604,NaN,NaN,505.697900000002,510.976663524939,500.419136475065,497.26626121622644,502.4256641365106,504.84879121895074,500.00253705407044,30914,37139.23333333333,25.566175098488188,33.64487398885669,NaN,NaN,NaN,NaN,1.4513231825328454,24.531459392354414,12370231
2025-09-05T10:35:00-04:00,498.85,499.24,498.06,498.99,NaN,NaN,NaN,502.4017387525212,NaN,NaN,505.550500000002,511.1489855981249,499.95201440187907,497.26626121622644,502.2984738677024,504.77178451450766,499.82516322089714,29516,37809.333333333336,26.20040619077858,31.32656569298433,NaN,NaN,NaN,NaN,1.4319429552090714,25.629969344038688,12399747
2025-09-05T10:40:00-04:00,499.09,499.27,498.5,498.6,NaN,NaN,NaN,502.4017387525212,NaN,NaN,505.38370000000197,511.29488018948695,499.472519810517,497.26626121622644,502.2330830527419,504.7287589487505,499.7374071567333,16141,37995.96666666667,25.078545723334884,29.587407674061335,NaN,NaN,NaN,NaN,1.3846613155512792,26.61390651393807,12383606
2025-09-05T10:45:00-04:00,498.64,498.64,497.25,497.48,NaN,NaN,NaN,501.65319584682203,NaN,NaN,505.20250000000203,511.5033914442433,498.9016085557608,497.26626121622644,502.01402145693294,504.6306288701733,499.39741404369255,44913,39345.066666666666,22.145884184760163,29.733114200588528,NaN,NaN,NaN,NaN,1.3850426501547584,28.13138140873842,12338693
2025-09-05T10:50:00-04:00,497.48,497.74,496.9,497.17,NaN,NaN,NaN,500.97418694469377,NaN,NaN,505.022500000002,511.7051965359952,498.33980346400887,497.26626121622644,501.8447691455926,504.56076941032524,499.1287688808599,33702,40254.1,21.399949672141034,28.838567419923027,NaN,NaN,NaN,NaN,1.3461110322865635,29.69081430574908,12304991
2025-09-05T10:55:00-04:00,497.19,497.4,495.07,495.24,NaN,NaN,NaN,500.0408148108441,NaN,NaN,504.7975000000021,512.0044017609303,497.59059823907404,497.26626121622644,501.5973446918625,504.50909715966714,498.6855922240578,41048,41352.166666666664,17.457471353588673,27.385223070917817,NaN,NaN,NaN,NaN,1.416388815694665,31.80080047344814,12263943
2025-09-05T11:00:00-04:00,495.32,495.48,494.55,494.93,NaN,NaN,NaN,498.77464141035114,NaN,NaN,504.561700000002,512.2565522034052,496.8668477965988,497.26626121622644,501.1632913822559,504.4194557487654,497.9071270157464,69268,43475.933333333334,16.918329426124643,26.09394688813978,NaN,NaN,NaN,NaN,1.381646757430761,33.916266277391,12194675
2025-09-05T11:05:00-04:00,494.93,495.55,494.59,495.51,NaN,NaN,NaN,498.77464141035114,NaN,NaN,504.33610000000203,512.408559671756,496.263640328248,497.06600897298114,500.934118341847,504.3259151111706,497.5423215725234,42286,44599.23333333333,21.785325482392153,25.203274395445014,NaN,NaN,NaN,NaN,1.351529131899995,35.79166775381034,12236961
2025-09-05T11:10:00-04:00,495.48,496.21,494.68,496.18,NaN,NaN,NaN,498.77464141035114,NaN,NaN,504.124900000002,512.4822705166323,495.76752948337173,496.04180717838494,500.7716843236617,504.2319421289036,497.3114265184198,35073,45487.4,27.098153924901013,24.982953263311423,NaN,NaN,NaN,NaN,1.3642770510499933,36.701917454726896,12272034
2025-09-05T11:15:00-04:00,496.22,497.16,496.1,496.52,NaN,NaN,NaN,498.77464141035114,NaN,NaN,503.91830000000203,512.5036115512515,495.3329884487526,496.0120052753331,500.65512359362134,504.1354706506091,497.1747765366336,32494,46410.333333333336,29.707521169430848,25.027246634250965,NaN,NaN,NaN,NaN,1.3425429759749938,36.473249335609594,12304528
2025-09-05T11:20:00-04:00,496.48,497.35,496.39,496.94,NaN,NaN,NaN,498.77464141035114,NaN,NaN,503.718500000002,512.4773812637366,494.9596187362674,496.0120052753331,500.5830624812817,504.0682694616756,497.09785550088776,22749,46821.23333333333,32.90243041769082,25.077380514100177,NaN,NaN,NaN,NaN,1.3152184776910683,36.057460765230935,12327277
2025-09-05T11:25:00-04:00,496.89,497.51,496.55,497.11,NaN,NaN,NaN,498.77464141035114,NaN,NaN,503.514100000002,512.4023636522755,494.62583634772835,496.0120052753331,500.5177726178404,504.00313514506854,497.0324100906123,22402,47040.8,34.20595895543504,25.36787918298543,NaN,NaN,NaN,NaN,1.2898457292845618,35.494226846706326,12349679
2025-09-05T11:30:00-04:00,497.14,497.25,496.19,496.67,NaN,NaN,NaN,498.77464141035114,NaN,NaN,503.29690000000204,512.3118690821501,494.28193091785397,495.33860422026646,500.46678714564706,503.95638042045846,496.97719387083566,16392,47185.066666666666,32.4488392142121,25.660198095152566,NaN,NaN,NaN,NaN,1.2734281771928075,35.19682513443647,12333287
2025-09-05T11:35:00-04:00,496.78,497.64,496.74,496.97,NaN,NaN,NaN,498.77464141035114,NaN,NaN,503.090300000002,512.2017939297776,493.97880607022637,494.8806194272123,500.39891302466344,503.88507524488165,496.91275080444524,25360,47620.833333333336,34.904148256820505,26.27279564786416,NaN,NaN,NaN,NaN,1.2517547359647476,34.46290988315823,12358647
2025-09-05T11:40:00-04:00,496.96,497.74,496.94,497.35,NaN,NaN,NaN,498.77464141035114,NaN,NaN,502.88790000000205,512.050705266518,493.72509473348606,495.13249554176986,500.3442489227283,503.8227467638665,496.8657510815901,22801,47979.9,37.97923580987371,27.159442841534553,NaN,NaN,NaN,NaN,1.219486540538695,33.66278162248088,12381448
2025-09-05T11:45:00-04:00,497.33,497.33,496.52,496.86,NaN,NaN,NaN,498.77464141035114,NaN,NaN,502.67890000000205,511.9052061488376,493.4525938511665,495.13249554176986,500.29683895602903,503.7744985883708,496.81917932368725,17806,48029.46666666667,35.641187382270445,27.833784355212543,NaN,NaN,NaN,NaN,1.1916660733573625,33.230735999073644,12363642
2025-09-05T11:50:00-04:00,496.86,496.9,496.26,496.72,NaN,NaN,NaN,498.77464141035114,NaN,NaN,502.46930000000214,511.75124203988156,493.1873579601227,495.13249554176986,500.260078106507,503.7395245865926,496.78063162642144,13075,47493.86666666667,34.97862518225877,28.540932887992824,NaN,NaN,NaN,NaN,1.1522613538318356,33.01795462472425,12350567
2025-09-05T11:55:00-04:00,496.74,496.9,496,496.32,NaN,NaN,NaN,498.77464141035114,NaN,NaN,502.25270000000205,511.59289169139345,492.91250830861065,495.13249554176986,500.21162266459197,503.6956838846932,496.72756144449073,16624,44067.36666666667,33.08612043976639,29.322378334778982,NaN,NaN,NaN,NaN,1.1342426857009886,33.008492865646694,12333943
2025-09-05T12:00:00-04:00,496.32,496.65,495.78,496.07,NaN,NaN,NaN,498.77464141035114,NaN,NaN,502.02620000000206,511.4057828389003,492.64661716110385,495.13249554176986,500.1791499889948,503.6679219799095,496.6903779980801,10699,41542.666666666664,31.92357364421187,30.074065761355467,NaN,NaN,NaN,NaN,1.1153682081509184,33.15917088036939,12323244
2025-09-05T12:05:00-04:00,496.11,496.69,495.8,496.69,NaN,NaN,NaN,498.77464141035114,NaN,NaN,501.8180000000021,511.19998870132497,492.4360112986792,495.13249554176986,500.14829814860286,503.6394566752078,496.65713962199794,10950,36478.36666666667,37.763976410778994,31.524530408297636,NaN,NaN,NaN,NaN,1.0992704789972805,33.23663196987937,12334194
2025-09-05T12:10:00-04:00,496.69,497.17,496.66,496.84,NaN,NaN,NaN,498.77464141035114,NaN,NaN,501.606600000002,510.9513179600074,492.26188203999664,495.13249554176986,500.12513381329904,503.6146148153056,496.6356528112925,9621,32295.166666666668,39.12470460366254,33.110700063836056,NaN,NaN,NaN,NaN,1.0571797304974742,32.568565350070514,12343815
2025-09-05T12:15:00-04:00,496.83,497.03,496.1,496.52,NaN,NaN,NaN,498.77464141035114,NaN,NaN,501.3784000000021,510.65129069015825,492.10550930984596,495.13249554176986,500.09425332202255,503.5843465430856,496.6041601009595,11791,30838.033333333333,37.25342306358375,34.215564176778315,NaN,NaN,NaN,NaN,1.0480954640333653,32.42878391331381,12332024
2025-09-05T12:20:00-04:00,496.545,497.1,496.39,497.09,NaN,NaN,NaN,498.77464141035114,NaN,NaN,501.1692000000021,510.3471944122655,491.9912055877387,495.13249554176986,500.06402463736873,503.5516825549498,496.57636671978764,12879,29728.633333333335,42.52651290100867,35.31758981792886,NaN,NaN,NaN,NaN,1.0239457880309846,32.189284749904374,12344903
2025-09-05T12:25:00-04:00,497.13,497.15,496.69,496.83,NaN,NaN,NaN,498.77464141035114,NaN,NaN,500.94580000000207,509.9906580658682,491.9009419341359,495.2783547654665,500.0484861875393,503.5346428114412,496.56232956363743,6779,28143.133333333335,40.84054300620243,36.112805663412544,NaN,NaN,NaN,NaN,0.9836639460287699,31.8842462569,12338124
2025-09-05T12:30:00-04:00,496.87,497.01,496.19,496.25,NaN,NaN,NaN,498.77464141035114,NaN,NaN,500.71700000000203,509.6459060915504,491.7880939084537,495.2783547654665,500.02144330874637,503.5081010098236,496.53478560766916,10584,26763.533333333333,37.28905203838133,36.42613577917616,NaN,NaN,NaN,NaN,0.9719736641695716,32.0542726088059,12327540
2025-09-05T12:35:00-04:00,496.27,496.3,495.52,495.58,NaN,NaN,NaN,498.77464141035114,NaN,NaN,500.47800000000206,509.30379310836827,491.65220689163584,495.2783547654665,499.95202682781485,503.45132641201144,496.45272724361826,23328,26517.5,33.64888451330033,36.3863447475951,NaN,NaN,NaN,NaN,0.9582612595860329,32.74143742442846,12304212
2025-09-05T12:40:00-04:00,495.5,496.01,495.35,495.48,NaN,NaN,NaN,498.6643624249792,NaN,NaN,500.23620000000204,508.9330637008792,491.5393362991249,495.2783547654665,499.8775249393,503.3921403062021,496.3629095723978,24786,26144.4,33.129057329038446,36.43493175579699,NaN,NaN,NaN,NaN,0.936956883901314,33.50400787924927,12279426
2025-09-05T12:45:00-04:00,495.46,495.53,494.17,494.24,NaN,NaN,NaN,497.8841641329347,NaN,NaN,499.975000000002,508.5916761568407,491.3583238431633,495.2783547654665,499.6788941955759,503.2681859770574,496.0896024140944,56975,27097.766666666666,27.463414248363733,35.90345075519293,NaN,NaN,NaN,NaN,0.9671742493369314,34.95004109808258,12222451
2025-09-05T12:50:00-04:00,494.23,494.84,494,494.56,NaN,NaN,NaN,497.4307930359831,NaN,NaN,499.718200000002,508.19868648556377,491.23771351444026,495.2783547654665,499.59443574498107,503.2148423157754,495.97402917418674,24713,26662.366666666665,30.75453954990698,35.38740102233816,NaN,NaN,NaN,NaN,0.9580903743842917,36.383794269419944,12247164
2025-09-05T12:55:00-04:00,494.56,495.24,494.43,495.14,NaN,NaN,NaN,497.4307930359831,NaN,NaN,499.47900000000203,507.7860632591683,491.17193674083575,495.2783547654665,499.5191184796559,503.1578727338732,495.8803642254386,25067,25357.866666666665,36.38816452637246,35.44075653263116,NaN,NaN,NaN,NaN,0.9475124904996995,36.992632293361964,12272231
2025-09-05T13:00:00-04:00,495.12,495.12,494.33,494.41,NaN,NaN,NaN,497.4307930359831,NaN,NaN,499.22820000000206,507.3735060735495,491.08289392645463,495.2783547654665,499.4803471442251,503.13057862682393,495.8301156616263,12366,24739.6,32.77401719372983,35.28328453345053,NaN,NaN,NaN,NaN,0.9376901697497211,37.62591778861517,12259865
2025-09-05T13:05:00-04:00,494.47,494.97,493.99,494.97,NaN,NaN,NaN,497.4307930359831,NaN,NaN,498.995600000002,506.94749955619545,491.0437004438086,495.2783547654665,499.40610256659085,503.07669968771205,495.73550544546964,24358,24567.666666666668,37.87183250602175,35.62512110961162,NaN,NaN,NaN,NaN,0.9407123004818851,38.4438903785751,12284223
2025-09-05T13:10:00-04:00,495,495.22,494.67,495.2,NaN,NaN,NaN,497.4307930359831,NaN,NaN,498.76400000000206,506.4661378844876,491.06186211551653,495.2783547654665,499.3529253520314,503.03252324605035,495.6733274580124,19521,24680.333333333332,39.88802694613239,36.19401063117738,NaN,NaN,NaN,NaN,0.912804279018894,38.72466352823142,12303744
2025-09-05T13:15:00-04:00,495.12,495.25,494.515,494.78,NaN,NaN,NaN,497.4307930359831,NaN,NaN,498.5234000000021,505.9518659083492,491.094934091655,495.1026838123732,499.2742503662602,502.9690002114575,495.5795005210629,28556,24135.1,37.49512546937935,36.17480699250597,NaN,NaN,NaN,NaN,0.9001039733746883,39.10534817094985,12275188
2025-09-05T13:20:00-04:00,494.8,495,494.68,494.93,NaN,NaN,NaN,497.4307930359831,NaN,NaN,498.28740000000204,505.40108125177824,491.17371874822584,494.38414704989856,499.2405873640258,502.94112293179194,495.5400517962597,12593,23431.466666666667,38.90479096697081,36.15909887559942,NaN,NaN,NaN,NaN,0.8586679752764957,39.4588410534741,12287781
2025-09-05T13:25:00-04:00,494.98,494.98,494.32,494.56,NaN,NaN,NaN,497.3942255838797,NaN,NaN,498.05100000000203,504.8519696361406,491.25003036386346,494.14731763991887,499.18749631515766,502.89951888188585,495.47547374842947,19151,22701.566666666666,36.705759014079916,36.11998001492058,NaN,NaN,NaN,NaN,0.8444774056138906,40.07797622747762,12268630
2025-09-05T13:30:00-04:00,494.56,495,494.43,494.97,NaN,NaN,NaN,497.3942255838797,NaN,NaN,497.803400000002,504.1160585328115,491.4907414671925,493.3598541119351,499.15145475797596,502.8693513081387,495.43355820781323,13805,20852.8,40.70530857691671,35.98989399177115,NaN,NaN,NaN,NaN,0.8248718766414694,40.60700754078884,12282435
2025-09-05T13:35:00-04:00,494.94,495.3,494.76,494.77,NaN,NaN,NaN,497.3942255838797,NaN,NaN,497.54340000000207,503.23275231389135,491.8540476861128,493.6975179730203,499.10521093060953,502.8285582269622,495.3818636342569,18673,20065.7,39.39749361118914,35.88681903498449,NaN,NaN,NaN,NaN,0.8045238854527945,40.408633548449316,12263762
2025-09-05T13:40:00-04:00,494.76,494.83,493.84,494,NaN,NaN,NaN,496.9978759515693,NaN,NaN,497.28220000000204,502.36698402999104,492.197415970013,493.6975179730203,499.0457682817674,502.7849087037971,495.30662785973766,20945,19594.766666666666,34.76624165383032,35.70661829323085,NaN,NaN,NaN,NaN,0.8177721793490241,41.01382222145387,12242817
2025-09-05T13:45:00-04:00,493.96,494.21,493.81,493.89,NaN,NaN,NaN,496.60638159013433,NaN,NaN,497.141000000002,502.20258275559803,492.079417244406,493.6975179730203,498.9901259774217,502.7460860549013,495.2341658999421,19066,19147.166666666668,34.148665951831006,35.742316967411604,NaN,NaN,NaN,NaN,0.7879313093955208,41.598435120873575,12223751
2025-09-05T13:50:00-04:00,493.92,493.93,493.35,493.51,NaN,NaN,NaN,496.19745515421914,NaN,NaN,496.95220000000205,501.834024723565,492.0703752764391,493.6975179730203,498.9403370889141,502.7143353319278,495.1663388459003,16205,18929.033333333333,32.031818117009664,35.663942737980975,NaN,NaN,NaN,NaN,0.7730790730101254,42.478475872357194,12207546
2025-09-05T13:55:00-04:00,493.5,493.71,493.37,493.53,NaN,NaN,NaN,496.0275708290273,NaN,NaN,496.75040000000206,501.3383702867048,492.16242971329933,493.6975179730203,498.88116928076073,502.6763412119993,495.0859973495222,19434,18830.1,32.26979205094605,36.00725543816543,NaN,NaN,NaN,NaN,0.7421448535094004,43.295656570163416,12226980
2025-09-05T14:00:00-04:00,493.56,493.66,493.02,493.07,NaN,NaN,NaN,495.8017721549807,NaN,NaN,496.55640000000204,500.9248903744308,492.1879096255733,493.6975179730203,498.82656197679705,502.6433901319411,495.009733821653,17380,18863.033333333333,29.6945775585408,35.93154386735356,NaN,NaN,NaN,NaN,0.7348487925444463,44.30390790571529,12209600
2025-09-05T14:05:00-04:00,493.09,493.37,492.88,492.88,NaN,NaN,NaN,495.54169160248154,NaN,NaN,496.36320000000205,500.5046247586326,492.2217752413715,493.6975179730203,498.76264341818427,502.6061748536671,494.91911198270145,20030,18685.366666666665,28.67662909142868,35.38071990771472,NaN,NaN,NaN,NaN,0.7173595930769866,45.33631019783762,12189570
2025-09-05T14:10:00-04:00,492.88,493.73,492.84,493.73,NaN,NaN,NaN,495.54169160248154,NaN,NaN,496.2142000000021,500.18423393326583,492.2441660667384,493.6975179730203,498.70193292744017,502.56513172854847,494.8387341263319,20883,18621.433333333334,38.786505019006185,35.81018332380589,NaN,NaN,NaN,NaN,0.7296910507143478,45.38214826449307,12210453
2025-09-05T14:15:00-04:00,493.74,494.3,493.59,494.3,NaN,NaN,NaN,495.54169160248154,NaN,NaN,496.0846000000021,499.8686976931416,492.30050230686265,493.6975179730203,498.6338719662248,502.5089719388272,494.75877199362236,27298,18937.833333333332,44.47079273289062,36.28153762572509,NaN,NaN,NaN,NaN,0.7282845470918969,44.166258942901436,12237751
2025-09-05T14:20:00-04:00,494.34,494.73,494.19,494.21,NaN,NaN,NaN,495.54169160248154,NaN,NaN,495.94380000000206,499.4632769826473,492.4243230173568,493.6975179730203,498.58851068212215,502.4676152211014,494.70940614314287,20037,19169.9,43.77951564083515,36.559501103918144,NaN,NaN,NaN,NaN,0.7148356508710486,42.21850213704371,12217714
2025-09-05T14:25:00-04:00,494.27,494.7,494.19,494.61,NaN,NaN,NaN,495.54169160248154,NaN,NaN,495.8246000000021,499.104854159575,492.5443458404292,493.19131110718234,498.5529510687001,502.43376270416564,494.6721394332346,16499,19165.733333333334,47.672723493897735,37.28647239138375,NaN,NaN,NaN,NaN,0.7002045329516874,40.40987081731867,12234213
2025-09-05T14:30:00-04:00,494.65,494.73,493.12,493.19,NaN,NaN,NaN,495.54169160248154,NaN,NaN,495.6894000000021,498.83276230035625,492.5460376996479,493.19131110718234,498.47402748886753,502.3721210964374,494.57593388129766,31230,19850.1,37.693577023356106,37.19995710969698,NaN,NaN,NaN,NaN,0.7651899234551393,39.94668392065307,12202983
2025-09-05T14:35:00-04:00,493.18,493.425,492.41,492.78,NaN,NaN,NaN,495.3975468976241,NaN,NaN,495.5610000000021,498.6441808236567,492.47781917634745,493.19131110718234,498.2902334254769,502.25161379621653,494.3288530547373,65404,21665.233333333334,35.39009235818918,37.1059809199905,NaN,NaN,NaN,NaN,0.7830335003511998,40.11936769870062,12137579
2025-09-05T14:40:00-04:00,492.84,493.2,492.7,493.07,NaN,NaN,NaN,495.38549931136845,NaN,NaN,495.444200000002,498.4526177621628,492.43578223784124,493.19131110718234,498.2502203032137,502.2231970741108,494.2772435323167,15165,21850.033333333333,38.26388920398956,36.931593821924274,NaN,NaN,NaN,NaN,0.7628168217546856,40.279716921173346,12152744
2025-09-05T14:45:00-04:00,493.05,493.05,492.53,492.7,NaN,NaN,NaN,495.1884311608517,NaN,NaN,495.318400000002,498.24823101080233,492.38856898920164,493.19131110718234,498.1732307480621,502.17072489062343,494.1757366055008,28570,22409.333333333332,36.06008934226362,36.693207802715314,NaN,NaN,NaN,NaN,0.7469013344864953,40.56962053299657,12124174
2025-09-05T14:50:00-04:00,492.79,493.75,492.79,493.7,NaN,NaN,NaN,495.1884311608517,NaN,NaN,495.22040000000203,498.0299407723511,492.41085922765296,493.19131110718234,498.1275294502538,502.13277296319984,494.12228593730777,19751,22638.4,45.23983681186854,37.44132174257518,NaN,NaN,NaN,NaN,0.7685512391660322,39.47938243216181,12143925
2025-09-05T14:55:00-04:00,493.7,493.87,493.08,493.19,NaN,NaN,NaN,495.1884311608517,NaN,NaN,495.134600000002,497.9248349993512,492.34436500065283,493.19131110718234,498.0800517110361,502.0931172986798,494.06698612339244,20780,23105.1,41.9333053099654,37.99736741101335,NaN,NaN,NaN,NaN,0.7700832935113171,38.25431635735263,12123145
2025-09-05T15:00:00-04:00,493.14,493.16,492.38,492.51,NaN,NaN,NaN,495.1884311608517,NaN,NaN,495.04140000000206,497.8645755438982,492.21822445610593,493.19131110718234,497.96062338278,502.0076666938,493.91358007176,47024,24319.766666666666,37.950471120086334,38.42012833980454,NaN,NaN,NaN,NaN,0.7729344868319374,37.83741934749755,12076121
2025-09-05T15:05:00-04:00,492.5,493.16,492.45,493.04,NaN,NaN,NaN,495.1884311608517,NaN,NaN,494.997400000002,497.874876142715,492.11992385728905,493.19131110718234,497.89335909669126,501.9552024084733,493.8315157849092,28529,24493.133333333335,42.53200415517673,39.153143490106736,NaN,NaN,NaN,NaN,0.7684391663439445,37.45030069548926,12104650
2025-09-05T15:10:00-04:00,493.07,493.31,492.895,493.21,NaN,NaN,NaN,495.1884311608517,NaN,NaN,494.963000000002,497.8836773173228,492.04232268268123,493.19131110718234,497.8363552917427,501.9068085118545,493.7659020716309,26129,24537.9,43.96128713054984,40.172194173821666,NaN,NaN,NaN,NaN,0.7431935116050928,36.79504471076495,12130779
2025-09-05T15:15:00-04:00,493.2,493.53,492.96,493.39,NaN,NaN,NaN,495.1884311608517,NaN,NaN,494.92060000000197,497.86969724358846,491.9715027564155,492.7180488857459,497.77915404152515,501.8554965981598,493.7028114848905,27793,23565.166666666668,45.50669660986818,41.3743418537102,NaN,NaN,NaN,NaN,0.7308225464904429,35.75531163736987,12158572
2025-09-05T15:20:00-04:00,493.49,494.95,493.49,494.93,NaN,NaN,NaN,495.1884311608517,NaN,NaN,494.89560000000193,497.8226795261347,491.96852047386915,492.8117795531182,497.7360698380886,501.8033028676587,493.6688368085185,29000,23708.066666666666,56.547548881968595,42.6429878439218,NaN,NaN,NaN,NaN,0.7900495074554115,33.76536604415788,12187572
2025-09-05T15:25:00-04:00,494.98,495.13,494.45,494.46,NaN,NaN,NaN,495.1884311608517,NaN,NaN,494.854400000002,497.7466466270901,491.96215337291386,493.07942364249453,497.6911603058289,501.7451115642079,493.63720904744986,33354,23984.3,53.01704417436077,43.25343437545539,NaN,NaN,NaN,NaN,0.782188828351454,32.131751848320924,12154218
2025-09-05T15:30:00-04:00,494.495,494.53,493.38,493.46,NaN,NaN,NaN,495.1884311608517,NaN,NaN,494.784800000002,497.6401955648546,491.9294044351494,493.07942364249453,497.61502126295915,501.66533005504436,493.5647124708739,45180,25078.1,46.381792980246686,43.4393113282705,NaN,NaN,NaN,NaN,0.8084610548977771,30.424625802424295,12109038
2025-09-05T15:35:00-04:00,493.46,493.97,493.31,493.32,NaN,NaN,NaN,495.1884311608517,NaN,NaN,494.709000000002,497.51425007653967,491.9037499234643,493.07942364249453,497.56829736457314,501.6186972495705,493.51789747957577,26806,25159.7,45.52281178612783,43.28574620628693,NaN,NaN,NaN,NaN,0.797856693833652,28.918132297337245,12082232
2025-09-05T15:40:00-04:00,493.35,493.83,493.07,493.72,NaN,NaN,NaN,495.1884311608517,NaN,NaN,494.65000000000197,497.41154159699744,491.8884584030065,493.07942364249453,497.500821382339,501.55028989791396,493.451352866764,39893,25838.766666666666,48.45977861439123,44.054760605646585,NaN,NaN,NaN,NaN,0.7951526442741048,27.79413756945258,12122125
2025-09-05T15:45:00-04:00,493.71,493.97,493.56,493.66,NaN,NaN,NaN,495.1884311608517,NaN,NaN,494.58380000000193,497.2775702634193,491.89002973658455,493.07942364249453,497.4460373164034,501.4912239710868,493.40085066172,35111,26057.266666666666,48.04139381355982,44.958424995315916,NaN,NaN,NaN,NaN,0.7676417411116706,26.540453365200133,12087014
2025-09-05T15:50:00-04:00,493.66,494.48,493.5,494.15,NaN,NaN,NaN,495.1884311608517,NaN,NaN,494.519800000002,497.0971862403224,491.94241375968164,493.07942364249453,497.32565270214513,501.3480585284752,493.3032468758151,88637,28592.066666666666,51.70827395514194,45.9187381918268,NaN,NaN,NaN,NaN,0.782810188175124,24.648159780972282,12175651
2025-09-05T15:55:00-04:00,494.68,495.61,494.08,495.06,492.3682818517962,492.3682818517962,492.3682818517962,NaN,NaN,NaN,494.48380000000196,496.97838578366293,491.989214216341,493.26610971133806,497.1685439011565,501.10279485170935,493.2342929506037,174793,33780.13333333333,57.68138590126107,47.46311651746947,NaN,NaN,NaN,NaN,0.8361808890197601,24.17590622732742,12350444
2025-09-08T09:30:00-04:00,498.105,498.41,495.05,497.65,493.8776502818222,NaN,NaN,NaN,NaN,NaN,494.50240000000196,497.0760186492984,491.9287813507055,494.85488776907044,497.0366666666667,497.0366666666667,497.0366666666667,87757,36245.2,69.31465922188357,49.1827466896134,NaN,NaN,NaN,NaN,1.0164536826612067,25.642450056158456,12438201
2025-09-08T09:35:00-04:00,497.6,499.43,496.98,497.35,495.14821163264844,NaN,NaN,NaN,NaN,NaN,494.523000000002,497.1699280291823,491.8760719708217,495.36091021525635,497.46416862675926,497.9056080965602,497.02272915695835,82303,38366.2,67.0166110319308,50.974411384039506,NaN,NaN,NaN,NaN,1.1188498481854054,27.45134186107579,12355898
2025-09-08T09:40:00-04:00,497.44,499.55,497.44,498.4,495.2771565584371,NaN,NaN,NaN,NaN,NaN,494.569600000002,497.3995426410596,491.73965735894444,495.36091021525635,497.64065344256056,498.19349987543916,497.08780700968197,36482,38884.1,70.68050766811578,53.312271137470184,NaN,NaN,NaN,NaN,1.1960748590293042,29.180550425570495,12392380
2025-09-08T09:45:00-04:00,498.37,499.25,498.19,499.24,495.5038767148718,NaN,NaN,NaN,NaN,NaN,494.62060000000207,497.68384901887777,491.5573509811264,495.36091021525635,497.84548725550155,498.53126888374453,497.1597056272586,40375,39594.4,73.24137134258652,55.50579736514231,NaN,NaN,NaN,NaN,1.1863552262414971,30.786244092601294,12432755
2025-09-08T09:50:00-04:00,499.28,500.21,498.7,500.01,496.179155046014,NaN,NaN,NaN,NaN,NaN,494.6840000000021,498.0451021989045,491.32289780109966,496.24362603021126,498.2558838988866,499.22065250036945,497.2911152974038,73212,41494.63333333333,75.36545078459062,57.7489519118595,NaN,NaN,NaN,NaN,1.2094727100813896,32.677695012391546,12505967
2025-09-08T09:55:00-04:00,500.02,500.02,498.71,498.795,496.179155046014,NaN,NaN,NaN,NaN,NaN,494.729500000002,498.2467547521933,491.21224524781076,496.24362603021126,498.33225577609755,499.2902742929335,497.37423725926163,29011,41813.86666666667,66.40776175097434,59.241885136224234,NaN,NaN,NaN,NaN,1.2166532307898617,34.43404229505392,12476956
2025-09-08T10:00:00-04:00,498.76,499.44,498.5,498.76,496.179155046014,NaN,NaN,NaN,NaN,NaN,494.76290000000205,498.3988945478036,491.1269054522005,496.24362603021126,498.3601879644306,499.3023786104003,497.41799731846095,18066,41836.73333333333,66.16380065542546,59.92876026289973,NaN,NaN,NaN,NaN,1.1968922857334428,35.74386340365538,12458890
2025-09-08T10:05:00-04:00,498.66,499.11,498.3,498.96,496.179155046014,NaN,NaN,NaN,NaN,NaN,494.80550000000204,498.58447036130036,491.0265296387037,496.24362603021126,498.3837693146507,499.3049632900399,497.4625753392615,21316,41879.6,66.91183417726964,60.9212452631075,NaN,NaN,NaN,NaN,1.1692571224667685,36.64934329689769,12480206
2025-09-08T10:10:00-04:00,498.96,499.15,498.61,498.85,496.179155046014,NaN,NaN,NaN,NaN,NaN,494.85750000000206,498.7832499909778,490.9317500090263,496.2952132219745,498.41149630152813,499.3131173421398,497.5098752609165,23495,41966.666666666664,66.04698602419248,62.32590190910363,NaN,NaN,NaN,NaN,1.124310185147711,37.51260810585734,12456711
2025-09-08T10:15:00-04:00,498.89,499.12,498.35,498.5,496.179155046014,NaN,NaN,NaN,NaN,NaN,494.915900000002,498.9677557170553,490.8640442829487,496.45117057757966,498.4285562626225,499.3004769630405,497.5566355622045,30814,42083.86666666667,63.245882086546956,63.591835501990715,NaN,NaN,NaN,NaN,1.099002314780016,37.879366293329355,12425897
2025-09-08T10:20:00-04:00,498.5,499.8,498.37,499.7,496.179155046014,NaN,NaN,NaN,NaN,NaN,495.000300000002,499.26581211835065,490.7347878816534,496.9499364620637,498.46572959566595,499.3364075999628,497.5950515913691,19971,42081.666666666664,68.2220990983294,65.00342982227203,NaN,NaN,NaN,NaN,1.122645006581444,38.64338533695815,12445868
2025-09-08T10:25:00-04:00,499.71,500.65,499.65,500.6,496.9740011996198,NaN,NaN,NaN,NaN,NaN,495.127500000002,499.6653586350697,490.58964136493427,497.86994916965097,498.60373557729145,499.57076129575466,497.6367098588282,37653,42786.8,71.35461911831524,66.66866020118313,NaN,NaN,NaN,NaN,1.1138846489684837,39.801514027926515,12483521
2025-09-08T10:30:00-04:00,500.59,500.86,499.81,500.22,497.1601829632735,NaN,NaN,NaN,NaN,NaN,495.24070000000194,499.9935753436392,490.4878246563647,498.1109593357208,498.70579570853556,499.72615222292194,497.6854391941492,32106,42816,68.29354344273196,67.85332230743954,NaN,NaN,NaN,NaN,1.10932145975645,40.97841636320895,12451415
2025-09-08T10:35:00-04:00,500.33,500.76,500.03,500.4,497.26494737403374,NaN,NaN,NaN,NaN,NaN,495.345900000002,500.3132146419196,490.3785853580844,498.1957674685766,498.76104126668724,499.80864418001886,497.7134383533556,17988,41235.46666666667,68.97254645346604,68.65983377545419,NaN,NaN,NaN,NaN,1.0822270697738479,42.07125424597121,12469403
2025-09-08T10:40:00-04:00,500.37,500.84,500.12,500.39,497.39404067521406,NaN,NaN,NaN,NaN,NaN,495.4655000000019,500.6213084712627,490.3096915287411,498.42861397486126,498.8080032639055,499.8776143055354,497.7383922222756,15746,41254.833333333336,68.88428799391674,68.62909297345655,NaN,NaN,NaN,NaN,1.0563537076471423,43.12886795492812,12453657
2025-09-08T10:45:00-04:00,500.42,500.83,500.21,500.42,497.48976609906794,NaN,NaN,NaN,NaN,NaN,495.574500000002,500.91106827858266,490.2379317214213,498.590891179889,498.84612738118875,499.93269490049886,497.75955986187864,13160,40741.166666666664,69.01239533797607,68.77164899531694,NaN,NaN,NaN,NaN,1.0251855856723469,44.11093782753096,12466817
2025-09-08T10:50:00-04:00,500.47,500.69,499.97,500.41,497.48976609906794,NaN,NaN,NaN,NaN,NaN,495.678700000002,501.18277805468443,490.17462194531953,498.590891179889,498.88492643172583,499.98374669865643,497.7861061647952,15276,40592,68.9105494672004,68.64522340953727,NaN,NaN,NaN,NaN,1.003386615267177,44.512457219067656,12451541
2025-09-08T10:55:00-04:00,500.41,500.65,500.11,500.2,497.48976609906794,NaN,NaN,NaN,NaN,NaN,495.78710000000206,501.4279006835561,490.146299316448,498.658970355129,498.91026106162303,500.01561430007956,497.8049078231665,10688,40255.6,66.68494442836153,68.17690720137833,NaN,NaN,NaN,NaN,0.9702875713195189,44.885296654066,12440853
2025-09-08T11:00:00-04:00,500.165,500.75,499.72,500.36,497.48976609906794,NaN,NaN,NaN,NaN,NaN,495.895700000002,501.6737273477929,490.1176726522111,498.658970355129,498.95860165789566,500.07318538097144,497.8440179348199,22204,39428.26666666667,67.5450055063702,67.61830396721973,NaN,NaN,NaN,NaN,0.9745527447966943,44.38598751276777,12463057
2025-09-08T11:05:00-04:00,500.34,500.34,499.76,500.02,497.48976609906794,NaN,NaN,NaN,NaN,NaN,496.004900000002,501.883331929679,490.126468070325,498.658970355129,498.9911813566491,500.1043030576463,497.87805965565195,19496,39127.166666666664,63.77712347229296,67.4304012330282,NaN,NaN,NaN,NaN,0.9477989773112178,43.92234331013369,12443561
2025-09-08T11:10:00-04:00,500.01,500.79,500,500.24,497.5342708317104,NaN,NaN,NaN,NaN,NaN,496.1103000000021,502.09868288952265,490.12191711048155,498.80599282182607,499.0224580944446,500.1412486272038,497.9036675616853,15323,38766.96666666667,65.13248002990557,67.35673547406252,NaN,NaN,NaN,NaN,0.9365276217889893,43.91621897148372,12458884
2025-09-08T11:15:00-04:00,500.17,500.5,499.69,499.75,497.5342708317104,NaN,NaN,NaN,NaN,NaN,496.2099000000021,502.27101622981996,490.14878377018425,498.80599282182607,499.04529097850957,500.16027410321675,497.9303078538024,16182,38379.933333333334,59.76834231352818,66.84648605522383,NaN,NaN,NaN,NaN,0.9274899345183474,43.229645915845076,12442702
2025-09-08T11:20:00-04:00,499.72,500.25,499.39,500.1,497.5342708317104,NaN,NaN,NaN,NaN,NaN,496.3319000000021,502.4554228056497,490.20837719435457,498.80599282182607,499.06045646799134,500.1714929432923,497.94941999269037,12067,37815.5,62.16524227906685,66.56921864485773,NaN,NaN,NaN,NaN,0.922669224909895,41.972339497236526,12454769
2025-09-08T11:25:00-04:00,500.19,500.68,500.19,500.66,497.6552326420427,NaN,NaN,NaN,NaN,NaN,496.46730000000207,502.6677648883391,490.26683511166505,498.80599282182607,499.08367202900195,500.20069716287793,497.96664689512596,11242,37078.433333333334,65.68763151270684,66.74362931815485,NaN,NaN,NaN,NaN,0.8981928517020442,41.28657212840241,12466011
2025-09-08T11:30:00-04:00,500.635,500.78,500.35,500.42,497.85294934013166,NaN,NaN,NaN,NaN,NaN,496.60550000000205,502.8440595285697,490.3669404714344,499.03779065981996,499.107063236923,500.22971641242816,497.98441006141786,11648,35960.7,62.98139014667958,66.36929296446557,NaN,NaN,NaN,NaN,0.8647505051518946,40.75705961000685,12454363
2025-09-08T11:35:00-04:00,500.425,500.65,500.11,500.62,497.85294934013166,NaN,NaN,NaN,NaN,NaN,496.74730000000216,503.0219949592032,490.4726050408011,499.03779065981996,499.128967291399,500.25551071658504,498.002423866213,11743,35458.6,64.30128385941264,65.86548330311538,NaN,NaN,NaN,NaN,0.8415540404981853,39.74632111940955,12466106
2025-09-08T11:40:00-04:00,500.59,501.195,500.59,500.9,498.26860673346704,NaN,NaN,NaN,NaN,NaN,496.9039000000021,503.19448766341895,490.6133123365853,499.5614860222848,499.19138793944234,500.34489743464036,498.0378784442443,26576,35014.7,66.12242612751993,65.71040349488597,NaN,NaN,NaN,NaN,0.8246573233197447,39.422117614087014,12492682
2025-09-08T11:45:00-04:00,500.9,501.12,500.24,500.32,498.26860673346704,NaN,NaN,NaN,NaN,NaN,497.05270000000206,503.30739142575067,490.79800857425346,499.5614860222848,499.2191238703435,500.3770570876568,498.06119065303017,15553,34362.76666666667,59.36646542224574,65.0242548497988,NaN,NaN,NaN,NaN,0.8286103716540484,38.39702834959793,12477129
2025-09-08T11:50:00-04:00,500.34,500.6,500.27,500.39,498.26860673346704,NaN,NaN,NaN,NaN,NaN,497.18590000000216,503.4355379696055,490.93626203039884,499.5614860222848,499.24281624023877,500.4013698486577,498.08426263181985,15446,31923.066666666666,59.89900055112981,64.38244860388544,NaN,NaN,NaN,NaN,0.7929953451073335,37.44515974685806,12492575
2025-09-08T11:55:00-04:00,500.4,500.78,500.39,500.41,498.26860673346704,NaN,NaN,NaN,NaN,NaN,497.3081000000022,503.5661792221827,491.05002077782166,499.5614860222848,499.26884509865266,500.4297815051952,498.10790869211013,16201,26636.666666666668,60.060060553354816,63.74299611926963,NaN,NaN,NaN,NaN,0.7642099633139515,36.79036321042366,12508776
2025-09-08T12:00:00-04:00,500.4,500.4,499.95,500.22,498.26860673346704,NaN,NaN,NaN,NaN,NaN,497.42830000000214,503.6745979780833,491.182002021921,499.5614860222848,499.2788640593713,500.4374161255711,498.1203119931715,8787,24004.333333333332,57.68957070496641,62.94149763625292,NaN,NaN,NaN,NaN,0.7424806802201004,35.25446707890358,12499989
2025-09-08T12:05:00-04:00,500.24,500.24,499.38,499.44,498.26860673346704,NaN,NaN,NaN,NaN,NaN,497.52490000000216,503.7431989595946,491.3066010404097,499.5614860222848,499.2884906216399,500.4349595731362,498.14202167014355,19532,21911.966666666667,49.118701015489606,61.68676596390492,NaN,NaN,NaN,NaN,0.750874917347237,32.808901210831145,12480457
2025-09-08T12:10:00-04:00,499.41,499.68,499.155,499.23,498.26860673346704,NaN,NaN,NaN,NaN,NaN,497.6457000000022,503.7561952361375,491.5352047638669,499.5614860222848,499.28918282361843,500.4296901578657,498.14867548937116,8702,20985.966666666667,47.09023463209288,60.22571090145654,NaN,NaN,NaN,NaN,0.7347409946795797,30.753512285309398,12471755
2025-09-08T12:15:00-04:00,499.22,499.22,498.93,499.17,498.26860673346704,NaN,NaN,NaN,NaN,NaN,497.7735000000022,503.73711442340357,491.8098855766008,499.5614860222848,499.2866585657553,500.41945220672727,498.15386492478336,11726,20031,46.49937449400642,58.99158597443607,NaN,NaN,NaN,NaN,0.7036880664881819,29.195125358742363,12460029
2025-09-08T12:20:00-04:00,499.23,499.4,498.64,498.695,498.26860673346704,NaN,NaN,NaN,NaN,NaN,497.8860000000022,503.70082347031206,492.0711765296923,499.5614860222848,499.2819945623792,500.40848843032364,498.1555006944348,10678,17946.533333333333,42.0058168771784,57.339681463526986,NaN,NaN,NaN,NaN,0.7077103474533112,28.178752215835225,12449351
2025-09-08T12:25:00-04:00,498.685,498.83,498.5,498.8,498.26860673346704,NaN,NaN,NaN,NaN,NaN,498.00800000000214,503.63542392138214,492.38057607862214,499.5614860222848,499.2742011246376,500.3949577919122,498.15344445736304,11859,17374.8,43.30997492498359,56.16408379291666,NaN,NaN,NaN,NaN,0.6807310369209307,27.437110487098536,12461210
2025-09-08T12:30:00-04:00,498.76,498.88,498.03,498.135,NaN,NaN,NaN,500.73988945306473,500.73988945306473,500.73988945306473,498.09670000000216,503.5878756874798,492.6055243125245,499.37318881782784,499.2643108273791,500.38312133139715,498.1455003233611,9398,17085.866666666665,37.5505499924371,54.40589148672882,NaN,NaN,NaN,NaN,0.6928216771408658,27.379041095734586,12451812
2025-09-08T12:35:00-04:00,498.12,498.58,497.79,498.58,NaN,NaN,NaN,500.4737581142891,NaN,NaN,498.2045000000021,503.5147878444687,492.8942121555355,499.3350408434098,499.25515087199113,500.37239484378955,498.1379069001927,8587,16661.566666666666,43.01188170874502,52.78619507216012,NaN,NaN,NaN,NaN,0.6997629859165156,27.617393109385457,12460399
2025-09-08T12:40:00-04:00,498.56,498.66,498.4,498.57,NaN,NaN,NaN,500.4737581142891,NaN,NaN,498.3257000000021,503.3810832724322,493.270316727572,499.3350408434098,499.25010290998,500.36497949383084,498.13522632612916,6345,16089.9,42.9210442679213,51.35331322367739,NaN,NaN,NaN,NaN,0.6683513440653394,27.655479901993406,12454054
2025-09-08T12:45:00-04:00,498.51,498.62,498.25,498.52,NaN,NaN,NaN,500.4737581142891,NaN,NaN,498.4353000000021,503.2599017070001,493.6106982930041,499.0140326747278,499.24303973627775,500.3553789365295,498.130700536026,8105,15332.933333333332,42.43844067220496,49.79168156744827,NaN,NaN,NaN,NaN,0.6470405337749583,27.886470492374265,12445949
2025-09-08T12:50:00-04:00,498.62,498.8,498.4,498.58,NaN,NaN,NaN,500.4737581142891,NaN,NaN,498.5427000000021,503.1305117693332,493.95488823067103,498.70122613978225,499.2391497542361,500.3492860715871,498.12901343688515,5438,14848.5,43.262870250448124,48.15885614765743,NaN,NaN,NaN,NaN,0.6293947813624637,27.662040289314188,12451387
2025-09-08T12:55:00-04:00,498.63,498.75,498.5,498.68,NaN,NaN,NaN,500.4737581142891,NaN,NaN,498.6485000000021,502.99369562171734,494.3033043782869,498.1864809118258,499.2342539181449,500.3411274497384,498.12738038655135,7525,13844.233333333334,44.6848663761904,47.110170501510616,NaN,NaN,NaN,NaN,0.6022951541222878,27.453640815044118,12458912
2025-09-08T13:00:00-04:00,498.685,498.72,498.14,498.14,NaN,NaN,NaN,500.4737581142891,NaN,NaN,498.71270000000214,502.9291848903759,494.4962151096284,497.9441477835685,499.2285858941527,500.3342690935143,498.12290269479104,5798,12967.3,39.00052732929971,45.61742241423705,NaN,NaN,NaN,NaN,0.6007026431135559,27.788000452236695,12453114
2025-09-08T13:05:00-04:00,498.151,498.27,497.99,498.23,NaN,NaN,NaN,500.1234935743979,NaN,NaN,498.78810000000215,502.828868188204,494.7473318118003,497.9441477835685,499.21859413461794,500.323859814543,498.11332845469286,8726,12658.566666666668,40.36220562932886,44.21043277680662,NaN,NaN,NaN,NaN,0.5777953114625857,28.303067603692984,12461840
2025-09-08T13:10:00-04:00,498.23,498.6,498.17,498.17,NaN,NaN,NaN,500.1234935743979,NaN,NaN,498.88230000000215,502.6308710385114,495.1337289614929,497.6304159012606,499.21245793630874,500.31647282876577,498.1084430438517,6349,12345.333333333334,39.72553961810136,42.9272876991734,NaN,NaN,NaN,NaN,0.5672385035009729,27.90477801139889,12455491
2025-09-08T13:15:00-04:00,498.22,498.53,498.14,498.47,NaN,NaN,NaN,500.1234935743979,NaN,NaN,498.9853000000021,502.3835074143793,495.5870925856249,497.6304159012606,499.2043495797862,500.30601245853643,498.10268670103596,9213,12213.766666666666,44.44422150607927,42.593396305644085,NaN,NaN,NaN,NaN,0.5545786103937596,27.583626141367663,12464704
2025-09-08T13:20:00-04:00,498.46,498.54,498.15,498.47,NaN,NaN,NaN,500.1234935743979,NaN,NaN,499.0803000000021,502.13236252080077,496.0282374792035,497.6304159012606,499.1972733499278,500.29677055849754,498.09777614135805,8257,11979.8,44.444221506079266,42.40439536807168,NaN,NaN,NaN,NaN,0.5428229953656369,27.257588741861998,12464704
2025-09-08T13:25:00-04:00,498.489,498.55,498.29,498.31,NaN,NaN,NaN,500.1234935743979,NaN,NaN,499.17330000000214,501.81481214855705,496.53178785144723,497.6304159012606,499.1915101271789,500.28923143098996,498.09378882336784,6804,11850.333333333334,42.39148099480062,42.1109744038427,NaN,NaN,NaN,NaN,0.5226213528395194,26.925070184960436,12457900
2025-09-08T13:30:00-04:00,498.33,498.44,498.2,498.25,NaN,NaN,NaN,500.1097466816979,NaN,NaN,499.2553000000021,501.49141395754873,497.01918604245543,497.6304159012606,499.18543167224965,500.28188466238936,498.08897868210994,6572,11329.266666666666,41.6152566168284,42.08307724238913,NaN,NaN,NaN,NaN,0.502434113350983,26.792064225454183,12451328
2025-09-08T13:35:00-04:00,498.29,498.32,498.11,498.26,NaN,NaN,NaN,499.95203092343894,NaN,NaN,499.3193000000021,501.23111276047086,497.40748723953334,497.6304159012606,499.1796015663334,500.27523356624744,498.0839695664194,5940,10877.4,41.806513247650486,41.97568712257962,NaN,NaN,NaN,NaN,0.4815459623973399,26.8457554932671,12457268
2025-09-08T13:40:00-04:00,498.26,498.3,498.01,498.28,NaN,NaN,NaN,499.8526204269189,NaN,NaN,499.3319000000021,501.2075011172249,497.4562988827793,497.6304159012606,499.17091040515874,500.2655622703214,498.07625853999605,8684,10656.1,42.21422454909598,42.30880673376954,NaN,NaN,NaN,NaN,0.4678641079403885,27.092811338173107,12465952
2025-09-08T13:45:00-04:00,498.28,498.28,497.88,498,NaN,NaN,NaN,499.7550013166044,NaN,NaN,499.34490000000216,501.1738029364392,497.5159970635651,497.58325654602004,499.1568518849924,500.2517048621236,498.06199890786127,12512,10533.766666666666,38.181117706032396,41.96375216214721,NaN,NaN,NaN,NaN,0.4630166716589306,27.57433177744962,12453440
2025-09-08T13:50:00-04:00,497.94,498.01,497.5,497.895,NaN,NaN,NaN,499.42341034766787,NaN,NaN,499.3348000000022,501.18985467054796,497.4797453294564,497.58325654602004,499.141799196799,500.2397796486262,498.0438187449718,11172,10503.933333333332,36.76269962659874,41.52387040205274,NaN,NaN,NaN,NaN,0.4663726236832921,28.67129825167322,12442268
2025-09-08T13:55:00-04:00,497.86,498.13,497.84,497.9,NaN,NaN,NaN,499.42341034766787,NaN,NaN,499.3080000000022,501.2059799763705,497.41002002363393,497.58325654602004,499.1296681053442,500.22850870386804,498.03082750682034,10402,10475.933333333332,36.88294482331454,41.127049269989136,NaN,NaN,NaN,NaN,0.453774579134487,29.23383491042295,12452670
2025-09-08T14:00:00-04:00,497.86,498.09,497.7,497.78,NaN,NaN,NaN,499.42341034766787,NaN,NaN,499.26340000000215,501.19775512535955,497.32904487464475,497.58325654602004,499.11615006097963,500.21690182903507,498.0153982929242,10907,10451.233333333334,35.15519881155994,40.54792988149712,NaN,NaN,NaN,NaN,0.44921925205345126,29.997056835999597,12441763
2025-09-08T14:05:00-04:00,497.76,498.13,497.69,498.05,NaN,NaN,NaN,499.42341034766787,NaN,NaN,499.2485000000022,501.2083665747225,497.2886334252819,497.58325654602004,499.10613838366476,500.2073651728229,498.0049115945066,8946,10358,41.7652350251912,40.33938478499717,NaN,NaN,NaN,NaN,0.44856073404963315,30.544968134743648,12450709
2025-09-08T14:10:00-04:00,498.04,498.28,497.865,497.93,NaN,NaN,NaN,499.42341034766787,NaN,NaN,499.2319000000022,501.22186471087724,497.2419352891272,497.58325654602004,499.09381986091023,500.19475091153333,497.9928888102871,11941,9870.166666666666,39.822304677541396,40.39808316701444,NaN,NaN,NaN,NaN,0.446163538760371,30.453807085385787,12438768
2025-09-08T14:15:00-04:00,497.9,498.28,497.82,498.28,NaN,NaN,NaN,499.42341034766787,NaN,NaN,499.2183000000022,501.2247382449118,497.2118617550926,497.54660523681605,499.0830189717136,500.1824928532764,497.9835450901508,11836,9746.266666666666,47.49448353184769,40.90753158862292,NaN,NaN,NaN,NaN,0.447151857420343,30.46681666128998,12450604
2025-09-08T14:20:00-04:00,498.28,498.28,498.05,498.15,NaN,NaN,NaN,499.42341034766787,NaN,NaN,499.2043000000022,501.23049348307376,497.17810651693065,497.5002841894528,499.06501835934347,500.1611748189925,497.96886189969445,21080,9934.066666666668,45.189939963297874,41.297845898994105,NaN,NaN,NaN,NaN,0.4316410104617443,30.478896981772447,12429524
2025-09-08T14:25:00-04:00,498.14,498.45,498,498.44,NaN,NaN,NaN,499.42341034766787,NaN,NaN,499.20310000000217,501.2310308545795,497.17516914542483,497.4992273515623,499.0594876792332,500.1536215600288,497.9653537984376,7837,9655.266666666666,50.91204732321413,41.75983345736089,NaN,NaN,NaN,NaN,0.4329523668573332,29.761556904301518,12437361
2025-09-08T14:30:00-04:00,498.46,498.48,498.25,498.31,NaN,NaN,NaN,499.42341034766787,NaN,NaN,499.17530000000227,501.2133062881469,497.13729371185764,497.59942386118576,499.0534259846133,500.1448621718745,497.9619897973521,9338,9673.633333333333,48.46922522772492,42.047333723192715,NaN,NaN,NaN,NaN,0.4184557692246678,28.969673513859917,12428023
2025-09-08T14:35:00-04:00,498.29,498.39,498.13,498.19,NaN,NaN,NaN,499.42341034766787,NaN,NaN,499.12710000000226,501.1419102517493,497.1122897482552,497.59942386118576,499.04621733759126,500.1355083900765,497.956926285106,9778,9348.5,46.26262273078737,42.323843847191775,NaN,NaN,NaN,NaN,0.40713749999433374,28.578546264721496,12418245
2025-09-08T14:40:00-04:00,498.17,498.39,498,498.29,NaN,NaN,NaN,499.42341034766787,NaN,NaN,499.0885000000022,501.09199818834463,497.0850018116598,497.59942386118576,499.04095546350044,500.12871530811583,497.95319561888505,7159,9297.066666666668,48.37196502408133,42.806465876281266,NaN,NaN,NaN,NaN,0.40591339285188033,28.568696208992222,12425404
2025-09-08T14:45:00-04:00,498.375,498.58,498.35,498.4,NaN,NaN,NaN,499.42341034766787,NaN,NaN,499.04850000000226,501.02534723497075,497.0716527650338,497.7449450169271,499.03630331295267,500.1210933178119,497.9515133080934,8748,9197.8,50.665971013617956,43.439284288136086,NaN,NaN,NaN,NaN,0.3976338647910292,27.712122033405894,12434152
2025-09-08T14:50:00-04:00,498.38,498.44,497.98,498.07,NaN,NaN,NaN,499.42341034766787,NaN,NaN,499.0021000000022,500.9596342527264,497.044565747278,497.7449450169271,499.02892280172654,500.1120704690137,497.9457751344394,9582,9161.266666666666,44.305714458847085,43.588676424546875,NaN,NaN,NaN,NaN,0.40208858873452563,27.88371792953312,12424570
2025-09-08T14:55:00-04:00,498.07,498.33,498.06,498.15,NaN,NaN,NaN,499.42341034766787,NaN,NaN,498.9567000000022,500.8856754873557,497.02772451264866,497.7449450169271,499.02210342852743,500.103550206038,497.94065665101687,9178,9071.9,46.073073016733055,44.15238751816835,NaN,NaN,NaN,NaN,0.39265368953920105,28.043056975936974,12433748
2025-09-08T15:00:00-04:00,498.12,498.24,497.9,498.08,NaN,NaN,NaN,499.42341034766787,NaN,NaN,498.9101000000022,500.80872633253614,497.0114736674683,497.7449450169271,499.0135312705809,500.0938182488448,497.93324429231706,10417,9105.866666666667,44.73537570128778,44.72186438064614,NaN,NaN,NaN,NaN,0.3888927117149747,28.56670235879796,12423331
2025-09-08T15:05:00-04:00,498.08,498.18,497.85,497.85,NaN,NaN,NaN,499.36738031534594,NaN,NaN,498.86310000000225,500.74797229024006,496.97822770976444,497.7449450169271,499.00414270016245,500.0841533644346,497.9241320358903,10367,9165.2,40.5675988529471,44.985053954191315,NaN,NaN,NaN,NaN,0.38468608944961824,29.16697425261076,12412964
2025-09-08T15:10:00-04:00,497.82,497.82,497.35,497.43,NaN,NaN,NaN,498.9440903010121,NaN,NaN,498.80450000000224,500.6817461188158,496.9272538811887,497.7449450169271,498.9868885841939,500.07216251114295,497.9016146572448,13809,9414,34.28592507982809,44.92296297335333,NaN,NaN,NaN,NaN,0.39292279734607405,30.67038312156013,12399155
2025-09-08T15:15:00-04:00,497.44,497.89,497.44,497.69,NaN,NaN,NaN,498.9440903010121,NaN,NaN,498.75790000000217,500.6278038346212,496.88799616538313,497.7449450169271,498.9687959914228,500.05738901619117,497.8802029666544,16440,9691.833333333334,40.434822610209736,44.82793351514037,NaN,NaN,NaN,NaN,0.3977140261070673,31.736922341723144,12415595
2025-09-08T15:20:00-04:00,497.67,497.86,497.54,497.66,NaN,NaN,NaN,498.9440903010121,NaN,NaN,498.7063000000022,500.5519953244092,496.86060467559525,497.7449450169271,498.95115777835974,500.04250357636147,497.859811980358,16649,10065.533333333333,39.970086376530546,44.83848935078246,NaN,NaN,NaN,NaN,0.3921630242422763,32.72728018901737,12398946
2025-09-08T15:25:00-04:00,497.68,497.68,497.3,497.35,NaN,NaN,NaN,498.82268175034494,NaN,NaN,498.6583000000022,500.5177070104888,496.79889298951565,497.7449450169271,498.9338390761409,500.0307297608764,497.8369483914054,14062,10283.433333333332,35.437563832527275,43.977280800831,NaN,NaN,NaN,NaN,0.3912942367963991,34.06971644171661,12384884
2025-09-08T15:30:00-04:00,497.34,497.62,497.26,497.27,NaN,NaN,NaN,498.7611962162383,NaN,NaN,498.60170000000215,500.4543981488576,496.7490018511467,497.7449450169271,498.9030399080294,500.0103226996294,497.79575711642946,24812,10917.233333333334,34.35486876921608,43.20334714411087,NaN,NaN,NaN,NaN,0.38905893416808585,35.38260100313818,12360072
2025-09-08T15:35:00-04:00,497.3,497.39,497.125,497.37,NaN,NaN,NaN,498.5547782064093,NaN,NaN,498.53590000000213,500.32408644191116,496.7477135580931,497.5419560135417,498.875725473191,499.9930550957509,497.7583958506311,21584,11345.833333333334,36.94806518301283,42.20591984838221,NaN,NaN,NaN,NaN,0.38019758172750734,36.82280264895345,12381656
2025-09-08T15:40:00-04:00,497.39,497.64,497.3,497.36,NaN,NaN,NaN,498.5547782064093,NaN,NaN,498.4747000000022,500.2094223497818,496.7399776502226,497.47656481083334,498.8423995118652,499.9678059007625,497.7169931229679,30053,12135.966666666667,36.79154670338612,41.37179995378658,NaN,NaN,NaN,NaN,0.37732632588982645,36.8834979537545,12351603
2025-09-08T15:45:00-04:00,497.39,498.35,497.36,498.34,NaN,NaN,NaN,498.5547782064093,NaN,NaN,498.42910000000217,500.0521251848991,496.8060748151052,497.3872518486667,498.81833947865744,499.935892003999,497.70078695331586,39038,13130.133333333333,56.31998324707073,42.09018284780682,NaN,NaN,NaN,NaN,0.4210887311834109,34.38265144692781,12390641
2025-09-08T15:50:00-04:00,498.32,498.33,497.43,497.5,NaN,NaN,NaN,498.5547782064093,NaN,NaN,498.3611000000022,499.84310713588917,496.8790928641152,497.3328014789334,498.76670759370853,499.8805737427061,497.652841444711,68262,15130.3,43.82239270850221,41.76521339669403,NaN,NaN,NaN,NaN,0.45601096467030783,32.06043683344588,12322379
2025-09-08T15:55:00-04:00,497.48,498.64,497.02,498.36,497.04966583804236,497.04966583804236,497.04966583804236,NaN,NaN,NaN,498.32190000000213,499.6942030099208,496.9495969900835,497.15692895417186,498.6841341020252,499.76202320693886,497.60624499711156,171619,20624.133333333335,54.865192896998046,42.06515781693547,NaN,NaN,NaN,NaN,0.539153038622429,30.943731435009035,12493998
2025-09-09T09:30:00-04:00,501.44,502.09,500.11,501.44,499.0834685091845,NaN,NaN,NaN,NaN,NaN,498.3429000000022,499.8650998392757,496.82070016072873,498.674947624536,501.21333333333337,501.21333333333337,501.21333333333337,56957,22303.633333333335,74.32818226639904,44.20961980318918,NaN,NaN,NaN,NaN,0.7670706787208241,32.3286301085834,12550955
2025-09-09T09:35:00-04:00,501.38,501.62,500.66,501.44,499.08421994058517,NaN,NaN,NaN,NaN,NaN,498.36350000000215,500.01907391589015,496.70792608411415,498.674947624536,501.22108055140336,501.2331872923607,501.208973810446,23323,22883.066666666666,74.32818226639904,46.227841892451025,NaN,NaN,NaN,NaN,0.7808513445264781,33.61460744833102,12550955
2025-09-09T09:40:00-04:00,501.41,501.93,500.775,501.49,499.2326644887404,NaN,NaN,NaN,NaN,NaN,498.3889000000022,500.1901820852489,496.58761791475547,498.78286647970305,501.2595149762129,501.3333404113703,501.1856895410556,22227,23334.5,74.53492562075938,48.356381172413286,NaN,NaN,NaN,NaN,0.8075762484888747,35.00876593893877,12573182
2025-09-09T09:45:00-04:00,501.52,501.96,500.67,500.96,499.2326644887404,NaN,NaN,NaN,NaN,NaN,498.4193000000022,500.33799227097717,496.5006077290272,498.7972931837624,501.2482033262403,501.31928226214023,501.17712439034034,22499,23667.4,68.25969316701583,50.33438790913248,NaN,NaN,NaN,NaN,0.8420350878825238,36.08290967364639,12550683
2025-09-09T09:50:00-04:00,500.98,501.5,500.47,500.74,499.2326644887404,NaN,NaN,NaN,NaN,NaN,498.4495000000022,500.4634525790345,496.43554742096995,498.7972931837624,501.20823398848125,501.3372818736488,501.0791861033137,16387,23841.233333333334,65.78386293033235,52.584240612739926,NaN,NaN,NaN,NaN,0.8554611530337702,36.65486146063239,12534296
2025-09-09T09:55:00-04:00,500.74,501.63,500.3,500.91,499.2326644887404,NaN,NaN,NaN,NaN,NaN,498.48430000000224,500.60419528761975,496.3644047123847,498.7972931837624,501.1830316228774,501.32796519109394,501.0380980546609,15076,23997.033333333333,66.78636183058077,54.466493414195,NaN,NaN,NaN,NaN,0.8893567849599284,36.82506860332518,12549372
2025-09-09T10:00:00-04:00,500.91,501.31,499.44,499.88,499.2326644887404,NaN,NaN,NaN,NaN,NaN,498.5080000000022,500.6629932692518,496.3530067307526,498.7972931837624,501.0361307327502,501.40921757649164,500.6630438890088,27823,24560.9,56.067739654871616,55.61632579121936,NaN,NaN,NaN,NaN,0.9594027288913625,35.390229589014005,12521549
2025-09-09T10:05:00-04:00,500,500.86,499.74,500.84,499.2326644887404,NaN,NaN,NaN,NaN,NaN,498.5488000000023,500.7994830585782,496.29811694142643,498.7972931837624,500.99053007925164,501.37919564816383,500.60186451033945,16461,24811.4,62.16293113724077,57.52528059869889,NaN,NaN,NaN,NaN,0.9708739625419798,34.057879075725054,12538010
2025-09-09T10:10:00-04:00,500.85,501.82,500.64,501.53,499.2326644887404,NaN,NaN,NaN,NaN,NaN,498.61670000000225,501.01345581370697,496.21994418629754,498.7972931837624,501.0158553174424,501.4002343236502,500.6314763112346,16184,24952.833333333332,65.8322291976486,59.77366348644408,NaN,NaN,NaN,NaN,0.9858115366461246,33.84329605612931,12554194
2025-09-09T10:15:00-04:00,501.65,502.14,501.1,502.11,499.2326644887404,NaN,NaN,NaN,NaN,NaN,498.68730000000227,501.27586037796493,496.0987396220396,499.04065618436425,501.1219616126628,501.5663672794732,500.6775559458524,34804,25718.433333333334,68.58964311362635,62.03377619577361,NaN,NaN,NaN,NaN,0.9896821411713989,33.930338402806335,12588998
2025-09-09T10:20:00-04:00,502.07,502.25,501.1,501.265,499.2326644887404,NaN,NaN,NaN,NaN,NaN,498.7412000000022,501.42811016420916,496.05428983579526,499.19552494749144,501.14160715524827,501.584294272954,500.6989200375425,12466,25431.3,60.880959757205126,63.754448556760686,NaN,NaN,NaN,NaN,1.0011334168020116,34.10888428103478,12576532
2025-09-09T10:25:00-04:00,501.27,501.34,500.76,500.92,499.2326644887404,NaN,NaN,NaN,NaN,NaN,498.7892000000022,501.5434929093437,496.03490709066074,499.19552494749144,501.1372474923207,501.57337786824115,500.7011171164002,8821,25464.1,58.01412614221753,63.875458763556885,NaN,NaN,NaN,NaN,0.9710524584590097,33.63607105268566,12567711
2025-09-09T10:30:00-04:00,500.97,501.11,499.55,499.55,499.2326644887404,NaN,NaN,NaN,NaN,NaN,498.8086000000022,501.5703798881575,496.04682011184684,499.19552494749144,501.0950808183147,501.57038999875806,500.6197716378714,11231,25527.2,48.28974326766445,64.19455523206848,NaN,NaN,NaN,NaN,1.013120139997652,31.369025046112515,12556480
2025-09-09T10:35:00-04:00,499.58,499.71,499.01,499.33,NaN,NaN,NaN,502.01052641431033,502.01052641431033,502.01052641431033,498.8216000000022,501.58695309691296,496.05624690309145,499.19552494749144,501.0111243774263,501.60653337582,500.41571537903263,14367,25680.166666666668,46.92936474307402,63.627710363931044,NaN,NaN,NaN,NaN,0.9907544157121045,29.633262309367996,12542113
2025-09-09T10:40:00-04:00,499.3,499.38,498.8,499.1,NaN,NaN,NaN,501.6991388500235,NaN,NaN,498.8408000000022,501.60028136985915,496.0813186301453,499.19552494749144,500.9185221404585,501.6301474086088,500.20689687230816,15151,25946.566666666666,45.48665581919167,61.56760133198766,NaN,NaN,NaN,NaN,0.9614148145898103,28.257397087631723,12526962
2025-09-09T10:45:00-04:00,499.04,499.71,498.9,499.35,NaN,NaN,NaN,501.6991388500235,NaN,NaN,498.8632000000023,501.6206675030333,496.10573249697126,499.19552494749144,500.8772698281116,501.6239845021595,500.1305551540637,8312,25932.033333333333,47.38021956627347,59.64274685340725,NaN,NaN,NaN,NaN,0.9505994706905383,26.532547399185376,12535274
2025-09-09T10:50:00-04:00,499.32,499.97,499.05,499.91,NaN,NaN,NaN,501.6991388500235,NaN,NaN,498.8980000000022,501.6635024843189,496.1324975156855,499.19552494749144,500.83960510790706,501.604863475601,500.0743467402131,10141,25950.666666666668,51.44851362968253,57.99371742547321,NaN,NaN,NaN,NaN,0.9484137942126438,24.685353857055112,12545415
2025-09-09T10:55:00-04:00,500,500.1,499.57,499.73,NaN,NaN,NaN,501.6991388500235,NaN,NaN,498.92320000000217,501.69559734357165,496.1508026564327,499.19552494749144,500.8109173647331,501.5845201070549,500.03731462241126,9428,25959,50.10749395507952,56.69713176747775,NaN,NaN,NaN,NaN,0.9185270946260286,23.141320561699004,12535987
2025-09-09T11:00:00-04:00,499.73,500.01,499.12,499.35,NaN,NaN,NaN,501.6991388500235,NaN,NaN,498.9408000000022,501.71263863718156,496.1689613628228,499.19552494749144,500.7663938920892,501.5632120817793,499.9695757023991,11949,26010.066666666666,47.30426609276369,55.37716056479427,NaN,NaN,NaN,NaN,0.9164894450098827,21.876803402693675,12524038
2025-09-09T11:05:00-04:00,499.34,499.75,499.07,499.63,NaN,NaN,NaN,501.6991388500235,NaN,NaN,498.9672000000022,501.7396481294863,496.19475187051813,499.19552494749144,500.7349104142873,501.5465406924458,499.9232801361288,8895,25961,49.544154216449776,54.14557430664206,NaN,NaN,NaN,NaN,0.8995973417948916,20.768664476145354,12532933
2025-09-09T11:10:00-04:00,499.6,499.88,499.39,499.82,NaN,NaN,NaN,501.6991388500235,NaN,NaN,498.99860000000217,501.7734074078607,496.22379259214364,498.6064199579931,500.70920193647663,501.52679777992364,499.8916060930296,9204,25807.5,51.064203890612845,53.78817889490929,NaN,NaN,NaN,NaN,0.8703403888095428,19.53718583983631,12542137
2025-09-09T11:15:00-04:00,499.8,500.25,499.6,499.75,NaN,NaN,NaN,501.6991388500235,NaN,NaN,499.02840000000214,501.8028422414252,496.2539577585791,498.40037146612457,500.68965814178176,501.50760764988524,499.8717086336783,8827,25553.733333333334,50.46104511140848,52.95232989306413,NaN,NaN,NaN,NaN,0.8546017896088596,18.448164958044135,12533310
2025-09-09T11:20:00-04:00,499.74,499.91,499.17,499.2,NaN,NaN,NaN,501.6991388500235,NaN,NaN,499.0468000000022,501.81333628763997,496.2802637123644,498.40037146612457,500.6736858827161,501.4986090099967,499.8487627554355,4874,25161.233333333334,45.875939032182536,51.526880595530834,NaN,NaN,NaN,NaN,0.8464159474939417,17.46727163115099,12528436
2025-09-09T11:25:00-04:00,499.29,499.79,499.24,499.51,NaN,NaN,NaN,501.6991388500235,NaN,NaN,499.07700000000216,501.83010297499396,496.32389702501035,498.40037146612457,500.65390818859606,501.4854473141851,499.82236906300705,6683,24915.266666666666,48.705059031592725,50.10655316109986,NaN,NaN,NaN,NaN,0.8281005226729482,16.556442113321637,12535119
2025-09-09T11:30:00-04:00,499.5,499.64,499.13,499.15,NaN,NaN,NaN,501.6991388500235,NaN,NaN,499.10210000000217,501.83444557675364,496.3697544232507,498.40037146612457,500.63319607395044,501.47480303387096,499.79158911402993,6122,24292.266666666666,45.71651537413089,49.02337856230884,NaN,NaN,NaN,NaN,0.8053790567677369,15.880696586276208,12528997
2025-09-09T11:35:00-04:00,499.14,499.355,499.08,499.2,NaN,NaN,NaN,501.53257158075604,NaN,NaN,499.1281000000022,501.8388511045451,496.41734889545927,498.40037146612457,500.61657895324635,501.467089444994,499.7660684614987,4710,23729.8,46.21018653289402,48.18024001878574,NaN,NaN,NaN,NaN,0.7674948384271867,15.333387939658245,12533707
2025-09-09T11:40:00-04:00,499.25,499.26,498.74,498.8,NaN,NaN,NaN,501.2807501452672,NaN,NaN,499.1485000000022,501.83359385137527,496.4634061486291,498.40037146612457,500.58164275599347,501.4568227764311,499.7064627355558,8540,23012.7,42.852638211460274,47.79187537191401,NaN,NaN,NaN,NaN,0.7498166356823864,15.35802506518402,12525167
2025-09-09T11:45:00-04:00,498.81,499.23,498.81,499.04,NaN,NaN,NaN,501.255716047755,NaN,NaN,499.16830000000215,501.8352395251764,496.5013604748279,498.40037146612457,500.5681669634114,501.4513856156757,499.6849483111471,3597,21831.333333333332,45.415300667052826,47.6837279379125,NaN,NaN,NaN,NaN,0.7269725902765022,15.380902396029384,12528764
2025-09-09T11:50:00-04:00,499.07,500,499.07,499.87,NaN,NaN,NaN,501.255716047755,NaN,NaN,499.2071000000022,501.8572442131729,496.55695578683145,498.4251979020926,500.55443643686624,501.4381309986908,499.6707418750417,6278,19765.2,53.22694545978552,48.23660576938348,NaN,NaN,NaN,NaN,0.7436174052567506,14.616007866656025,12535042
2025-09-09T11:55:00-04:00,499.92,500.1,499.43,499.43,NaN,NaN,NaN,501.255716047755,NaN,NaN,499.2301000000022,501.8675916019778,496.59260839802664,498.5051583216741,500.5402632240831,501.42412062311973,499.6564058250465,6733,14269,49.20667858489565,48.367067127856494,NaN,NaN,NaN,NaN,0.7383590191669838,14.06926283394184,12528309
2025-09-09T12:00:00-04:00,499.46,499.66,499.12,499.25,NaN,NaN,NaN,501.255716047755,NaN,NaN,499.2521000000022,501.8714755650183,496.63272443498613,498.5051583216741,500.5229086665376,501.411923884343,499.6338934487322,6298,12580.366666666667,47.6220201523579,48.093746165190446,NaN,NaN,NaN,NaN,0.724190517797915,13.13410658933394,12522011
2025-09-09T12:05:00-04:00,499.23,499.33,498.79,498.9,NaN,NaN,NaN,501.255716047755,NaN,NaN,499.26130000000217,501.8724199188813,496.65018008112304,498.5051583216741,500.48567867424794,501.3945270443569,499.576830304139,10934,12167.4,44.613466201808265,47.70131561138537,NaN,NaN,NaN,NaN,0.7110340522409185,12.820372501522934,12511077
2025-09-09T12:10:00-04:00,498.95,499.14,498.59,498.99,NaN,NaN,NaN,501.0372667598991,NaN,NaN,499.27490000000216,501.87311052853903,496.6766894714653,498.5051583216741,500.4195835628443,501.3637373669521,499.47542975873654,19454,12074.966666666667,45.565782295379925,47.577138197286516,NaN,NaN,NaN,NaN,0.6995316199379966,12.846413475411422,12530531
2025-09-09T12:15:00-04:00,498.985,499.43,498.91,499.16,NaN,NaN,NaN,501.0372667598991,NaN,NaN,499.2943000000022,501.87423954007505,496.7143604599293,498.5051583216741,500.3915544853253,501.3432985312318,499.43981043941875,10635,11679.5,47.40532472789563,47.4243646623898,NaN,NaN,NaN,NaN,0.686707932799567,12.299370884910145,12541166
2025-09-09T12:20:00-04:00,499.16,499.18,498.51,498.68,NaN,NaN,NaN,500.98332570478414,NaN,NaN,499.30210000000216,501.87218644809735,496.73201355190696,498.5051583216741,500.3555146932326,501.3260062967996,499.38502308966554,10944,11498.066666666668,42.98797475198057,46.8474911524875,NaN,NaN,NaN,NaN,0.6855145090281705,12.434659987909711,12530222
2025-09-09T12:25:00-04:00,498.65,498.74,498.36,498.65,NaN,NaN,NaN,500.64294726365756,NaN,NaN,499.30710000000215,501.8711125488637,496.7430874511406,498.5051583216741,500.33321013710037,501.3176033853249,499.34881688887583,6199,11202.166666666666,42.72003878139118,46.294562128914826,NaN,NaN,NaN,NaN,0.6636920440975865,12.786702905339018,12524023
2025-09-09T12:30:00-04:00,498.64,498.66,498.45,498.6,NaN,NaN,NaN,500.58144966076406,NaN,NaN,499.31770000000216,501.8654984281883,496.76990157181604,498.5051583216741,500.3049040926676,501.3061941718293,499.30361401350586,8036,10542.6,42.24741280454859,46.03538168408384,NaN,NaN,NaN,NaN,0.6312854695191901,13.113599900094803,12515987
2025-09-09T12:35:00-04:00,498.61,498.65,498.46,498.53,NaN,NaN,NaN,500.51524740345656,NaN,NaN,499.3253000000022,501.86136025767036,496.789239742334,498.5051583216741,500.2857061143866,501.29813922158115,499.273273007192,5526,10178.1,41.55428317576485,45.52461198009613,NaN,NaN,NaN,NaN,0.5997650788392478,13.417147109510887,12510461
2025-09-09T12:40:00-04:00,498.52,498.65,498.47,498.61,NaN,NaN,NaN,500.45569070329947,NaN,NaN,499.3359000000022,501.85542827935575,496.81637172064865,498.5051583216741,500.26118537265575,501.286670516332,499.2357002289795,7367,9884.2,42.71109180980592,45.309938868358635,NaN,NaN,NaN,NaN,0.5697818589221552,13.699012375397254,12517828
2025-09-09T12:45:00-04:00,498.58,498.85,498.39,498.51,NaN,NaN,NaN,500.45569070329947,NaN,NaN,499.34910000000224,501.8441476448959,496.8540523551086,498.1141266573393,500.2328918790407,501.2723908777388,499.1933928803426,8807,9017.633333333333,41.60262110031599,44.98082705174591,NaN,NaN,NaN,NaN,0.5619402975705753,13.439862704673434,12509021
2025-09-09T12:50:00-04:00,498.505,498.61,498.26,498.42,NaN,NaN,NaN,500.26987520693194,NaN,NaN,499.36890000000216,501.8180053776089,496.9197946223954,497.98571284855774,500.20660022314496,501.2608820166447,499.1523184296452,7729,8859.733333333334,40.581817404686184,44.81862556554777,NaN,NaN,NaN,NaN,0.5468017048869644,13.466964817276969,12501292
2025-09-09T12:55:00-04:00,498.44,499.32,498.44,498.84,NaN,NaN,NaN,500.26987520693194,NaN,NaN,499.3919000000022,501.79874098987153,496.98505901013283,498.1010284729423,500.18269806810275,501.24248041410425,499.12291572210125,9626,8886.566666666668,47.10457334585087,44.939287899747626,NaN,NaN,NaN,NaN,0.572030154537894,13.118634310371796,12510918
2025-09-09T13:00:00-04:00,498.92,499.23,498.68,499.2,NaN,NaN,NaN,500.26987520693194,NaN,NaN,499.42270000000224,501.7789845393591,497.0664154606454,498.1010284729423,500.16717007868436,501.22805426606396,499.10628589130476,7412,8759.266666666666,51.97143773274521,44.849608776387605,NaN,NaN,NaN,NaN,0.5704565720709024,12.795184553959851,12518330
2025-09-09T13:05:00-04:00,499.18,499.51,499.17,499.38,NaN,NaN,NaN,500.26987520693194,NaN,NaN,499.4633000000022,501.7440767164617,497.18252328354276,498.33985822268306,500.1524624233013,501.20929211087173,499.0956327357309,10068,8615.966666666667,54.23861246377391,45.20903262487891,NaN,NaN,NaN,NaN,0.5539953883515504,13.034231172973119,12528398
2025-09-09T13:10:00-04:00,499.45,499.6,499.24,499.49,NaN,NaN,NaN,500.26987520693194,NaN,NaN,499.5077000000022,501.7007045212533,497.31469547875116,498.4838865781465,500.142690838377,501.19546452081437,499.08991715593964,7784,8370.4,55.61741743111991,45.780132430504764,NaN,NaN,NaN,NaN,0.5401385748978692,13.422729241771867,12536182
2025-09-09T13:15:00-04:00,499.47,499.53,498.82,498.87,NaN,NaN,NaN,500.26987520693194,NaN,NaN,499.53770000000225,501.6525571654327,497.4228428345718,498.4838865781465,500.1244261403675,501.17732686073776,499.0715254199973,9816,8420.533333333333,47.01829354464302,45.95190581213581,NaN,NaN,NaN,NaN,0.5522715338337342,12.746066318130975,12526366
2025-09-09T13:20:00-04:00,498.95,499.37,498.85,499.37,NaN,NaN,NaN,500.26987520693194,NaN,NaN,499.5779000000022,501.6000316352662,497.55576836473824,498.4838865781465,500.1132366518198,501.16465726868637,499.06181603495327,7016,8316.366666666667,53.2903887006966,46.50366341251557,NaN,NaN,NaN,NaN,0.5499664242741804,12.117736460464434,12533382
2025-09-09T13:25:00-04:00,499.34,499.36,499.09,499.11,NaN,NaN,NaN,500.26987520693194,NaN,NaN,499.5933000000021,501.5890430773506,497.5975569226536,498.4838865781465,500.10442385044496,501.15468992281575,499.05415777807417,5586,8188.3,49.97719661757428,46.687368547492625,NaN,NaN,NaN,NaN,0.5306831082545982,11.53428730691693,12527796
2025-09-09T13:30:00-04:00,499.13,499.27,498.85,499.02,NaN,NaN,NaN,500.26987520693194,NaN,NaN,499.62370000000215,501.5355146433617,497.7118853566426,498.4838865781465,500.09528404391426,501.1455753065873,499.0449927812412,5119,7960.633333333333,48.845127815419744,47.10573662345257,NaN,NaN,NaN,NaN,0.5227771719506954,11.025674760878834,12522677
2025-09-09T13:35:00-04:00,499.05,499.08,498.85,498.91,NaN,NaN,NaN,500.26987520693194,NaN,NaN,499.6347000000021,501.5234947561194,497.7459052438848,498.4838865781465,500.0861020289126,501.1371756728135,499.0350283850117,4774,7823.266666666666,47.43097025884315,47.44223172898485,NaN,NaN,NaN,NaN,0.5018645168113572,10.553391682414889,12517903
2025-09-09T13:40:00-04:00,498.87,499.045,498.78,498.98,NaN,NaN,NaN,500.26987520693194,NaN,NaN,499.5855000000021,501.4107191623365,497.7602808376678,498.4838865781465,500.0725568733096,501.1247756697973,499.02033807682193,7111,7753.5,48.45370738434135,47.88553848468433,NaN,NaN,NaN,NaN,0.48494562275340625,10.29573150030907,12525014
2025-09-09T13:45:00-04:00,498.96,498.96,498.71,498.76,NaN,NaN,NaN,500.26987520693194,NaN,NaN,499.5319000000021,501.2923873049153,497.77141269508894,498.4838865781465,500.05749962257767,501.11236656674293,499.0026326784124,7294,7702.4,45.460236264987586,48.16453513391453,NaN,NaN,NaN,NaN,0.46959236398530857,10.240856735211667,12517720
2025-09-09T13:50:00-04:00,498.76,498.76,498.5,498.75,NaN,NaN,NaN,500.19711120861973,NaN,NaN,499.47710000000217,501.1592059272503,497.79499407275404,498.4838865781465,500.0391761833308,501.0989579014666,498.97939446519507,8185,7812.766666666666,45.32317007489348,48.35111215284935,NaN,NaN,NaN,NaN,0.4546214808435001,10.721432738967673,12509535
2025-09-09T13:55:00-04:00,498.74,499,498.64,498.91,NaN,NaN,NaN,500.19711120861973,NaN,NaN,499.43610000000217,501.07089819868725,497.8013018013171,498.4838865781465,500.0297804264055,501.0906047477464,498.96895610506465,4936,7754.533333333334,48.0234617053232,48.80974362463558,NaN,NaN,NaN,NaN,0.44786280364039394,10.399647891678976,12514471
2025-09-09T14:00:00-04:00,498.92,499.1,498.7,498.9,NaN,NaN,NaN,500.19711120861973,NaN,NaN,499.3993000000022,500.9974639560566,497.8011360439478,498.28210926251717,500.0118355389836,501.0736384941441,498.95003258382303,10083,7886.566666666667,47.86435654371345,49.32992499170896,NaN,NaN,NaN,NaN,0.44444403195179677,9.80029496927955,12504388
2025-09-09T14:05:00-04:00,498.92,499.4,498.92,499.29,NaN,NaN,NaN,500.19711120861973,NaN,NaN,499.3669000000022,500.9058306516034,497.827969348401,498.4429636886582,500.00084044869084,501.0595481250244,498.9421327723573,8752,8021.3,54.232814717887265,49.83908508971156,NaN,NaN,NaN,NaN,0.44841231538381127,9.783533610386145,12513140
2025-09-09T14:10:00-04:00,499.35,499.44,498.84,498.99,NaN,NaN,NaN,500.19711120861973,NaN,NaN,499.34910000000224,500.8844640448409,497.81373595516357,498.4429636886582,499.9781522755268,501.0331844488512,498.92312010220235,16440,8284.633333333333,49.249245700115516,49.64464280166658,NaN,NaN,NaN,NaN,0.4592400071421121,9.521005748278306,12496700
2025-09-09T14:15:00-04:00,498.96,499.055,498.68,498.705,NaN,NaN,NaN,500.19711120861973,NaN,NaN,499.30640000000227,500.79146435889106,497.8213356411135,498.4429636886582,499.9556979219603,501.01271576517115,498.8986800787494,12973,8597.166666666666,45.01706860753252,48.985961097649344,NaN,NaN,NaN,NaN,0.4532228637748184,8.886990046343,12483727
2025-09-09T14:20:00-04:00,498.74,498.99,498.51,498.76,NaN,NaN,NaN,500.19711120861973,NaN,NaN,499.25100000000225,500.60061920192646,497.90138079807804,498.4429636886582,499.9309289619076,500.99085263919295,498.8710052846223,14155,8859.733333333334,45.98180100285867,48.297702781344974,NaN,NaN,NaN,NaN,0.4551355163623327,8.77997870741163,12497882
2025-09-09T14:25:00-04:00,498.8,498.8,498.53,498.6,NaN,NaN,NaN,500.15057301401873,NaN,NaN,499.18080000000225,500.26788483112165,498.09371516888285,498.4429636886582,499.9031485592424,500.96813575958174,498.8381613589031,15152,9140.366666666667,43.585909950430924,48.05253252461553,NaN,NaN,NaN,NaN,0.4419115509078831,8.680611035546786,12482730
2025-09-09T14:30:00-04:00,498.64,498.66,498.38,498.61,NaN,NaN,NaN,499.97622878610883,NaN,NaN,499.1277000000022,500.0491276044835,498.20627239552095,498.4429636886582,499.8768581831417,500.94786003446205,498.8058563318213,13915,9394.266666666666,43.783067283513894,47.373438137673915,NaN,NaN,NaN,NaN,0.43034644012875073,9.017988140088228,12496645
2025-09-09T14:35:00-04:00,498.66,498.69,498.42,498.47,NaN,NaN,NaN,499.97622878610883,NaN,NaN,499.0787000000022,499.86422099300603,498.29317900699834,498.4429636886582,499.86204992694763,500.93640527839636,498.7876945754989,7942,9294.533333333333,41.591558283210375,46.77446397093363,NaN,NaN,NaN,NaN,0.4188931229766958,9.219514229621046,12488703
2025-09-09T14:40:00-04:00,498.49,498.6,498.34,498.41,NaN,NaN,NaN,499.86745226172314,NaN,NaN,499.0559000000022,499.85149207524245,498.260307924762,498.4429636886582,499.8397660887069,500.92004080565687,498.7594913717569,11611,9033.1,40.6524161267001,46.189270278882226,NaN,NaN,NaN,NaN,0.4075436141926495,9.646630298378389,12477092
2025-09-09T14:45:00-04:00,498.42,498.97,498.31,498.97,NaN,NaN,NaN,499.86745226172314,NaN,NaN,499.0487000000022,499.8407474924345,498.2566525075699,498.4429636886582,499.8217255331264,500.90200742705053,498.7414436392023,12385,9091.433333333332,51.63034872409247,46.48922588354289,NaN,NaN,NaN,NaN,0.4255762131788906,9.184659934808929,12489477
2025-09-09T14:50:00-04:00,498.97,499.18,498.74,499.18,NaN,NaN,NaN,499.86745226172314,NaN,NaN,499.05030000000215,499.84307842450534,498.25752157549897,498.4429636886582,499.7951580894763,500.8665695591633,498.72374661978927,26090,9596.3,54.99250798319543,46.95628306917532,NaN,NaN,NaN,NaN,0.42660648366611253,9.37013935168144,12515567
2025-09-09T14:55:00-04:00,499.165,499.21,498.94,498.97,NaN,NaN,NaN,499.86745226172314,NaN,NaN,499.04270000000224,499.831114123543,498.2542858764615,498.37437095092656,499.7813766860762,500.8477680375674,498.71498533458504,14392,9869.4,51.162646970206126,47.36359811954808,NaN,NaN,NaN,NaN,0.4154203062613889,9.627340969836633,12501175
2025-09-09T15:00:00-04:00,498.98,498.99,498.54,498.84,NaN,NaN,NaN,499.86745226172314,NaN,NaN,499.0213000000022,499.7715501116971,498.27104988830735,498.2598641221425,499.7683957739681,500.83375994238037,498.70303160555585,10463,9950.3,48.892617396398464,47.61855864251272,NaN,NaN,NaN,NaN,0.41789028438557463,9.322152051317097,12490712
2025-09-09T15:05:00-04:00,498.885,498.885,498.57,498.65,NaN,NaN,NaN,499.86745226172314,NaN,NaN,498.9997000000022,499.72898569872,498.27041430128435,498.2598641221425,499.75463865167666,500.81993160865704,498.68934569469627,10440,10114.1,45.70108022133248,47.45267425079909,NaN,NaN,NaN,NaN,0.41054097835803344,9.038762341263244,12480272
2025-09-09T15:10:00-04:00,498.59,498.66,498.28,498.33,NaN,NaN,NaN,499.8289906376237,NaN,NaN,498.9793000000022,499.72512573724714,498.2334742627572,498.2598641221425,499.73030643511726,500.8007778468148,498.6598350234197,15071,10370.9,40.86305116411556,46.95258100939924,NaN,NaN,NaN,NaN,0.40835947990389193,9.587027162752621,12465201
2025-09-09T15:15:00-04:00,498.33,498.85,498.19,498.44,NaN,NaN,NaN,499.8289906376237,NaN,NaN,498.9555000000022,499.6926465188881,498.21835348111625,498.2598641221425,499.7014996843356,500.77575586801476,498.62724350065645,19661,10732.7,43.09319858708375,46.15689414291328,NaN,NaN,NaN,NaN,0.42633380276790145,9.44524622746795,12484862
2025-09-09T15:20:00-04:00,498.45,498.62,498.26,498.28,NaN,NaN,NaN,499.8132538660993,NaN,NaN,498.92470000000225,499.64324410457186,498.20615589543263,498.2598641221425,499.681463899889,500.7596026933225,498.60332510645554,13064,10910.533333333333,40.68955756194873,45.54548784732993,NaN,NaN,NaN,NaN,0.4215956739987666,9.31359250184647,12471798
2025-09-09T15:25:00-04:00,498.28,498.39,498.07,498.15,NaN,NaN,NaN,499.58446959945843,NaN,NaN,498.8927000000022,499.60384895091266,498.18155104909175,498.2598641221425,499.65643465484516,500.7422848304893,498.570584479201,14767,11081.9,38.7960940781757,45.101132523804445,NaN,NaN,NaN,NaN,0.4143388401417113,9.739324000542569,12457031
2025-09-09T15:30:00-04:00,498.14,498.2,497.95,498.03,NaN,NaN,NaN,499.4019937085739,NaN,NaN,498.86930000000217,499.6146375279034,498.1239624721009,498.2598641221425,499.617291736111,500.7177997832785,498.51678368894346,21920,11565.5,37.080773384210595,44.465344836758156,NaN,NaN,NaN,NaN,0.4026003515601605,10.458146632595575,12435111
2025-09-09T15:35:00-04:00,498,498.25,497.98,498.22,NaN,NaN,NaN,499.4019937085739,NaN,NaN,498.8435000000022,499.58764581246555,498.0993541875389,498.2598641221425,499.58975289996806,500.6979208643967,498.48158493553944,17100,11799.9,41.49171897011729,44.31575976673575,NaN,NaN,NaN,NaN,0.3931288978772906,10.925175765923955,12452211
2025-09-09T15:40:00-04:00,498.26,498.29,497.71,498.13,NaN,NaN,NaN,499.32333517661385,NaN,NaN,498.8231000000022,499.5881487241518,498.0580512758527,498.2598641221425,499.56120478440516,500.6786563927073,498.44375317610303,17136,12111.633333333333,40.059124183363544,44.049763831010736,NaN,NaN,NaN,NaN,0.4064768337432013,12.069647729100245,12435075
2025-09-09T15:45:00-04:00,498.13,498.46,498.13,498.32,NaN,NaN,NaN,499.32333517661385,NaN,NaN,498.8055000000022,499.5755292139791,498.0354707860253,498.00489129771404,499.53485459851765,500.6551183580333,498.414590839002,19861,12446.466666666667,44.42188614318001,44.25193010672285,NaN,NaN,NaN,NaN,0.401014202761543,12.4506543736841,12454936
2025-09-09T15:50:00-04:00,498.34,498.6,497.74,498.05,NaN,NaN,NaN,499.32333517661385,NaN,NaN,498.7905000000022,499.58906433067455,497.9919356693299,497.9394130381712,499.46910949311666,500.60237869273556,498.33584029349777,46548,13764.2,39.96978435344469,44.20317069434746,NaN,NaN,NaN,NaN,0.4337989025642909,13.728612592774578,12408388
2025-09-09T15:55:00-04:00,498.03,498.85,498.03,498.43,NaN,NaN,NaN,499.32333517661385,NaN,NaN,498.7783000000023,499.57987746341115,497.9767225365934,497.7628243444296,499.40826304374497,500.5341972379442,498.2823288495457,62290,15654.333333333334,47.886148725698206,43.9357278373193,NaN,NaN,NaN,NaN,0.4613846952382737,14.006755182937045,12470678
2025-09-10T09:30:00-04:00,502.84,503.19,499.97,500.06,499.57953905777003,499.57953905777003,499.57953905777003,NaN,NaN,NaN,498.78210000000223,499.6058380350095,497.95836196499494,499.7168595327724,501.0733333333334,501.0733333333334,501.0733333333334,143623,20271.133333333335,67.61462357802787,44.83730752266447,NaN,NaN,NaN,NaN,0.7684286455783964,17.174468068522568,12614301
2025-09-10T09:35:00-04:00,500.04,500.44,497.56,498.435,NaN,NaN,NaN,501.3022581721287,501.3022581721287,501.3022581721287,498.7622000000023,499.5702944437266,497.95410555627797,499.7168595327724,500.226290554145,501.320935222117,499.13164588617303,85998,22978.6,48.075195534234346,44.61677527723791,NaN,NaN,NaN,NaN,0.9192551708942249,16.96413133325538,12528303
2025-09-10T09:40:00-04:00,498.41,499.17,496.72,498.28,NaN,NaN,NaN,500.4767009824865,NaN,NaN,498.74280000000226,499.5496931962229,497.9359068037816,499.7168595327724,499.695286434607,501.0276137634253,498.3629591057887,74410,25221.9,46.68923461897519,44.45939079313625,NaN,NaN,NaN,NaN,1.0285940872589223,15.996227839914098,12453893
2025-09-10T09:45:00-04:00,498.18,498.465,497.01,498.11,NaN,NaN,NaN,500.35253275600974,NaN,NaN,498.72700000000225,499.55170357713996,497.90229642286454,499.7168595327724,499.4855775872699,500.86855590601573,498.1025992685241,39262,26287.5,45.151764933431245,44.42015398685759,NaN,NaN,NaN,NaN,1.0590516524547124,15.097460310382907,12414631
2025-09-10T09:50:00-04:00,498.12,499.4,497.75,498.83,NaN,NaN,NaN,500.35253275600974,NaN,NaN,498.72380000000226,499.54563345640446,497.90196654360005,499.7168595327724,499.37774256506356,500.69691035763515,498.05857477249197,51577,27733.9,52.31400558089797,45.238079302342044,NaN,NaN,NaN,NaN,1.1012622487079455,15.014347580728465,12466208
2025-09-10T09:55:00-04:00,498.79,500.64,498.59,500.58,496.7379763524787,496.7379763524787,496.7379763524787,NaN,NaN,NaN,498.7522000000023,499.7179124986778,497.7864875013268,499.7168595327724,499.4492799326307,500.6952090117585,498.2033508535029,57958,29501.3,64.46126804347654,46.76436997779867,NaN,NaN,NaN,NaN,1.169029230943093,15.764771464923102,12524166
2025-09-10T10:00:00-04:00,500.52,501.64,500.43,501.25,498.12375015463874,NaN,NaN,NaN,NaN,NaN,498.8036000000022,499.99554637063585,497.6116536293685,499.7168595327724,499.6283018459095,500.91256183211215,498.34404185970686,54835,30993.033333333333,67.83909410608385,48.70362258809404,NaN,NaN,NaN,NaN,1.1719557144471564,17.01848209577072,12579001
2025-09-10T10:05:00-04:00,501.26,501.82,500.47,500.47,498.18198878397334,NaN,NaN,NaN,NaN,NaN,498.84000000000225,500.11894487379686,497.56105512620763,499.7168595327724,499.7746417804605,501.0513872796607,498.49789628126035,64863,32863.4,60.61594294950025,50.26218322176008,NaN,NaN,NaN,NaN,1.1846731634152141,18.277370330934854,12514138
2025-09-10T10:10:00-04:00,500.56,502.08,500.33,501.585,498.18198878397334,NaN,NaN,NaN,NaN,NaN,498.89970000000227,500.3895448342188,497.40985516578576,499.7168595327724,499.8544712157215,501.14459825947165,498.56434417197136,30940,33346.73333333333,66.16235072613881,52.339438746183525,NaN,NaN,NaN,NaN,1.225053651742699,19.586428639993187,12545078
2025-09-10T10:15:00-04:00,501.51,502.61,501,501.57,498.6578968052319,NaN,NaN,NaN,NaN,NaN,498.9605000000023,500.62313555537685,497.29786444462775,499.7168595327724,500.0138008388921,501.3538344591221,498.67376721866214,56134,34785.433333333334,66.02763504186254,54.09200417987961,NaN,NaN,NaN,NaN,1.2525498194753644,21.081853428846124,12488944
2025-09-10T10:20:00-04:00,501.57,502.35,501.32,502.18,498.69049240499413,NaN,NaN,NaN,NaN,NaN,499.0319000000023,500.91958417645316,497.1442158235514,498.5611633496511,500.1318794446389,501.5105968001535,498.7531620891243,42838,35741.53333333333,68.80901066346073,56.14556749988655,NaN,NaN,NaN,NaN,1.2366534037985546,22.470462161352422,12531782
2025-09-10T10:25:00-04:00,502.18,502.45,501.48,501.48,498.83115184113075,NaN,NaN,NaN,NaN,NaN,499.0913000000023,501.0930250634781,497.08957493652656,498.93393067972085,500.2189910038772,501.611761058313,498.8262209494414,38622,36523.86666666667,62.486719716302716,57.435912755109605,NaN,NaN,NaN,NaN,1.2176067320986557,23.816574975005388,12493160
2025-09-10T10:30:00-04:00,501.49,502.07,501.44,501.93,498.83115184113075,NaN,NaN,NaN,NaN,NaN,499.1615000000023,501.3052810031895,497.0177189968151,498.9421445437767,500.28537253558,501.6855409376533,498.8852041335067,32195,37133.2,64.73024400937217,59.20451701624729,NaN,NaN,NaN,NaN,1.175634822663037,25.008846553504853,12525355
2025-09-10T10:35:00-04:00,501.91,502.15,501.48,501.71,498.83115184113075,NaN,NaN,NaN,NaN,NaN,499.21890000000224,501.47587522141833,496.96192477858614,499.31271563502133,500.3402816332936,501.7429583874789,498.93760487910833,29491,37851.5,62.754258359385496,60.26652484722495,NaN,NaN,NaN,NaN,1.1395180496156745,26.167629450197232,12495864
2025-09-10T10:40:00-04:00,501.69,502.78,500.99,502.7,498.83115184113075,NaN,NaN,NaN,NaN,NaN,499.28890000000223,501.7473045944805,496.83049540552395,499.6151725080171,500.44841438211716,501.8749805624838,499.0218482017505,50814,39158.26666666667,67.55416407854827,60.262206311547864,NaN,NaN,NaN,NaN,1.1859810460716953,27.636074141544142,12546678
2025-09-10T10:45:00-04:00,502.64,502.73,501.25,502.62,498.83115184113075,NaN,NaN,NaN,NaN,NaN,499.3537000000023,501.983146943745,496.72425305625956,499.6151725080171,500.52026121570344,501.9598095032071,499.0807129281998,36509,39962.4,66.80495295146206,61.600046127064125,NaN,NaN,NaN,NaN,1.2069823999237184,28.99962992636627,12510169
2025-09-10T10:50:00-04:00,502.64,502.91,501.3,501.42,498.8361377317034,NaN,NaN,NaN,NaN,NaN,499.3923000000023,502.08453194206595,496.70006805793867,499.6151725080171,500.5506936614471,501.9881071593145,499.1132801635797,20428,39773.666666666664,56.654955372858026,62.31188332377004,NaN,NaN,NaN,NaN,1.2357693713577393,30.380126858289604,12489741
2025-09-10T10:55:00-04:00,501.39,501.42,499.66,499.73,498.8361377317034,NaN,NaN,NaN,NaN,NaN,499.4095000000023,502.0991522060861,496.7198477939185,499.6151725080171,500.5400685569403,501.9510316160398,499.1291054978408,35821,40487.96666666667,46.04467559787613,62.37566265694467,NaN,NaN,NaN,NaN,1.2732144162607573,29.24967183720584,12453920
2025-09-10T11:00:00-04:00,499.84,499.84,498.72,499.06,NaN,NaN,NaN,502.64026500065864,502.64026500065864,502.64026500065864,499.4033000000023,502.09471643560795,496.7118835643966,499.6151725080171,500.4937570347733,501.9013362005147,499.08617786903187,34050,41274.2,42.63561844465018,61.684349290069825,NaN,NaN,NaN,NaN,1.2622705293849852,27.191672803547334,12419870
2025-09-10T11:05:00-04:00,499.11,499.96,498.53,499.02,NaN,NaN,NaN,502.64026500065864,NaN,NaN,499.4015000000023,502.09381888711306,496.7091811128915,499.6151725080171,500.45557535442987,501.86028801875716,499.0508626901026,29117,41896.76666666667,42.43362611309481,60.11094629504256,NaN,NaN,NaN,NaN,1.2742512058574869,25.405555083297156,12390753
2025-09-10T11:10:00-04:00,498.88,499.77,498.5,499.69,NaN,NaN,NaN,502.5560472423357,NaN,NaN,499.4149000000023,502.1061595470351,496.72364045296956,499.6151725080171,500.4313746602331,501.83068223460924,499.0320670858569,21982,42127.13333333333,46.965908331763195,58.62000445401967,NaN,NaN,NaN,NaN,1.2739475482962366,23.77791442889235,12412735
2025-09-10T11:15:00-04:00,499.65,500,499.48,499.69,NaN,NaN,NaN,502.5560472423357,NaN,NaN,499.43050000000227,502.1189130987848,496.74208690121975,499.6151725080171,500.4210069593378,501.8126331562194,499.0293807624561,15328,41982.7,46.965908331763195,57.645001981324164,NaN,NaN,NaN,NaN,1.220094151989361,22.15065324242697,12412735
2025-09-10T11:20:00-04:00,499.66,499.89,499.19,499.86,NaN,NaN,NaN,502.5560472423357,NaN,NaN,499.4481000000023,502.136007652748,496.7601923472566,499.6151725080171,500.40605987077,501.7883013661986,499.02381837534136,20604,42234.03333333333,48.1667885036249,56.35960467971603,NaN,NaN,NaN,NaN,1.1829445697044059,20.82661171476057,12433339
2025-09-10T11:25:00-04:00,499.875,500.87,499.67,500.71,NaN,NaN,NaN,502.5560472423357,NaN,NaN,499.48710000000233,502.1904823905357,496.78371760946897,499.6151725080171,500.40634753825424,501.7697173573136,499.0429777191949,29756,42733.666666666664,53.799828265179094,55.48618990995293,NaN,NaN,NaN,NaN,1.184162814725519,20.135197683246876,12463095
2025-09-10T11:30:00-04:00,500.69,500.78,499.98,500.45,NaN,NaN,NaN,502.5560472423357,NaN,NaN,499.52110000000226,502.22930256805,496.8128974319545,499.487510405131,500.4062991431836,501.7586798211559,499.0539184652113,17903,42599.76666666667,51.94040138030696,54.28128924687052,NaN,NaN,NaN,NaN,1.156722613673693,19.493170368269872,12445192
2025-09-10T11:35:00-04:00,500.39,500.7,500.14,500.29,NaN,NaN,NaN,502.5560472423357,NaN,NaN,499.54870000000227,502.2595550735343,496.83784492647027,499.487510405131,500.4058509843685,501.74797093338174,499.06373103535526,17123,42600.53333333333,50.77734825755596,53.44490557124575,NaN,NaN,NaN,NaN,1.114099569839858,18.8970021472198,12428069
2025-09-10T11:40:00-04:00,500.23,501.24,500.15,501.1,NaN,NaN,NaN,502.5560472423357,NaN,NaN,499.5927000000023,502.33128518757314,496.8541148124315,498.78328435973845,500.4130597308226,501.7448544977608,499.08126496388445,19575,42681.833333333336,56.13266564456584,52.830792830902446,NaN,NaN,NaN,NaN,1.1123781719941561,18.910101656012614,12447644
2025-09-10T11:45:00-04:00,501.15,501.46,500.41,501.46,NaN,NaN,NaN,502.5560472423357,NaN,NaN,499.6361000000023,502.42248280746395,496.8497171925406,498.9696274877908,500.4266361579766,501.74890830419946,499.1043640117537,22882,42782.53333333333,58.30395278060804,52.51291386098977,NaN,NaN,NaN,NaN,1.1079225882802846,19.140160256204506,12470526
2025-09-10T11:50:00-04:00,501.41,501.55,500.97,501.275,NaN,NaN,NaN,502.5560472423357,NaN,NaN,499.6818000000023,502.49907865671827,496.8645213432863,499.26770199023264,500.4430240617377,501.75744302057694,499.1286051028984,23419,42011.566666666666,56.74944972434175,51.74114854997502,NaN,NaN,NaN,NaN,1.070213831974549,19.444653674825588,12447107
2025-09-10T11:55:00-04:00,501.27,501.27,500.82,500.83,NaN,NaN,NaN,502.5560472423357,NaN,NaN,499.7243000000022,502.5454650128949,496.90313498710947,499.26770199023264,500.4481420223652,501.7572299791616,499.13905406556876,11675,40324.4,53.08318737307131,50.761022437232825,NaN,NaN,NaN,NaN,1.0262699868335086,19.476294675221947,12435432
2025-09-10T12:00:00-04:00,500.81,500.84,500.35,500.4,NaN,NaN,NaN,502.5560472423357,NaN,NaN,499.75710000000225,502.57078163615654,496.94341836384797,499.26770199023264,500.448892931793,501.7519860829581,499.1457997806279,11200,35910.3,49.73927806783061,50.26704548687373,NaN,NaN,NaN,NaN,0.9879649877739689,18.754691832798898,12424232
2025-09-10T12:05:00-04:00,500.425,500.68,500.06,500.6,NaN,NaN,NaN,502.5560472423357,NaN,NaN,499.7971000000023,502.60069275743666,496.9935072425679,499.26770199023264,500.448865136971,501.74379823190117,499.1539320420408,15436,33558.23333333333,51.27665656844213,50.64075841334272,NaN,NaN,NaN,NaN,0.9616817743615428,17.654445607205858,12439668
2025-09-10T12:10:00-04:00,500.6,500.6,499.69,499.72,NaN,NaN,NaN,502.5560472423357,NaN,NaN,499.8193000000023,502.6024457075694,497.0361542924351,499.26770199023264,500.4384394239672,501.7199029114157,499.15697593651873,29625,32065.4,44.78543755429057,50.79431692117418,NaN,NaN,NaN,NaN,0.9579902190500057,16.67328469675221,12410043
2025-09-10T12:15:00-04:00,499.68,500.09,499.52,499.6,NaN,NaN,NaN,502.5560472423357,NaN,NaN,499.8419000000023,502.5990825382809,497.08471746172364,499.26770199023264,500.43072687030786,501.7072276599967,499.154226080619,14068,31225.6,43.96805184012792,50.90391875881941,NaN,NaN,NaN,NaN,0.9302766319750048,15.993026166299165,12395975
2025-09-10T12:20:00-04:00,499.59,499.74,499.1,499.46,NaN,NaN,NaN,502.23222421358145,NaN,NaN,499.86290000000224,502.5919900222687,497.1338099777358,499.26770199023264,500.4151459399531,501.6876619750592,499.142629904847,20314,30183.5,42.98242480696983,50.619384221334165,NaN,NaN,NaN,NaN,0.909542586833932,15.9060846652667,12375661
2025-09-10T12:25:00-04:00,499.43,499.78,499.21,499.24,NaN,NaN,NaN,502.23222421358145,NaN,NaN,499.86830000000225,502.5913634273713,497.1452365726332,499.26770199023264,500.4075361667919,501.6782165696779,499.1368557639059,9920,28582.233333333334,41.41142933740071,50.222635721736836,NaN,NaN,NaN,NaN,0.885289544917222,15.75686783291013,12365741
2025-09-10T12:30:00-04:00,499.22,499.59,499,499.59,NaN,NaN,NaN,502.01202660782934,NaN,NaN,499.8765000000023,502.5936862264857,497.1593137735189,499.26770199023264,500.3921397168818,501.6592211431073,499.1250582906563,20198,27427.666666666668,44.86405047927719,49.98672586285486,NaN,NaN,NaN,NaN,0.8641974345659901,15.89594224742168,12385939
2025-09-10T12:35:00-04:00,499.59,499.78,499.11,499.32,NaN,NaN,NaN,502.01202660782934,NaN,NaN,499.88350000000224,502.59310162929853,497.17389837070596,499.26770199023264,500.3803312344264,501.64439575952207,499.1162667093308,16081,25801.6,42.77014465524169,49.1988913192879,NaN,NaN,NaN,NaN,0.850326189239845,15.671181300011902,12369858
2025-09-10T12:40:00-04:00,499.32,499.75,499.1,499.64,NaN,NaN,NaN,502.01202660782934,NaN,NaN,499.8995000000023,502.593669443299,497.20533055670563,499.2166615921861,500.3712578093761,501.63196710203556,499.1105485167167,13970,25235.933333333334,45.987673479481614,48.773696469228945,NaN,NaN,NaN,NaN,0.8360171757227116,15.47730864866414,12383828
2025-09-10T12:45:00-04:00,499.6,499.76,499.16,499.19,NaN,NaN,NaN,502.01202660782934,NaN,NaN,499.91030000000234,502.5886303808802,497.23196961912447,498.9523292737489,500.36380578531674,501.6227595204597,499.1048520501738,10202,23704.866666666665,42.379381821106364,48.17384172376826,NaN,NaN,NaN,NaN,0.8191588060282298,15.27665526538365,12373626
2025-09-10T12:50:00-04:00,499.21,499.38,498.845,499.3,NaN,NaN,NaN,501.67947289169655,NaN,NaN,499.92970000000236,502.5758212423321,497.2835787576726,498.8598634189991,500.3555062616678,501.6139564523333,499.0970560710023,9637,22598.166666666668,43.54545014728592,47.274754902533985,NaN,NaN,NaN,NaN,0.7988617484547825,15.588192316427415,12383263
2025-09-10T12:55:00-04:00,499.37,499.61,499.35,499.49,NaN,NaN,NaN,501.67947289169655,NaN,NaN,499.9507000000023,502.5656806938549,497.3357193061497,498.6888907351993,500.3509919174956,501.6077403483247,499.0942434866665,7182,21550.166666666668,45.593508858924395,46.36686605098516,NaN,NaN,NaN,NaN,0.763943052136584,15.372849525246915,12390445
2025-09-10T13:00:00-04:00,499.51,500.28,499.49,500.16,NaN,NaN,NaN,501.67947289169655,NaN,NaN,499.98830000000225,502.5598120901055,497.416787909899,498.759062949535,500.3453083271466,501.5933190072609,499.0972976470323,21393,21190.1,52.18139708570986,46.040576576797164,NaN,NaN,NaN,NaN,0.7658042626982539,14.633465542310779,12411838
2025-09-10T13:05:00-04:00,500.18,501.01,500.11,500.99,NaN,NaN,NaN,501.67947289169655,NaN,NaN,500.04510000000226,502.5768373381767,497.51336266182784,499.34325035962803,500.3487635354108,501.59123061261755,499.10629645820404,13730,20664.733333333334,58.831765701962865,46.45118931457514,NaN,NaN,NaN,NaN,0.7753896725055197,14.998254418865193,12425568
2025-09-10T13:10:00-04:00,501.015,501.375,500.73,500.8,NaN,NaN,NaN,501.67947289169655,NaN,NaN,500.1005000000023,502.57399085087235,497.6270091491322,499.7191002877024,500.3538326580331,501.5924646275285,499.11520068853775,11736,19362.133333333335,56.8815595518807,46.96135227772157,NaN,NaN,NaN,NaN,0.7660761244694099,15.778526365740161,12413832
2025-09-10T13:15:00-04:00,500.8,500.81,500.53,500.62,NaN,NaN,NaN,501.67947289169655,NaN,NaN,500.14850000000223,502.5666871287427,497.73031287126173,499.7191002877024,500.3555486694992,501.59083397741,499.12026336158846,8266,18420.7,55.020763239139235,47.228788468485654,NaN,NaN,NaN,NaN,0.7313564012930256,16.11204913740648,12405566
2025-09-10T13:20:00-04:00,500.68,500.79,500.1,500.15,NaN,NaN,NaN,501.67947289169655,NaN,NaN,500.18890000000226,502.53733632006197,497.84046367994256,499.7191002877024,500.3554553119594,501.5842318454065,499.1266787785123,15325,18250.6,50.38580740535709,47.62881488641897,NaN,NaN,NaN,NaN,0.7284023726292379,15.634952479183134,12390241
2025-09-10T13:25:00-04:00,500.15,500.22,499.51,499.72,NaN,NaN,NaN,501.67947289169655,NaN,NaN,500.2169000000023,502.5082279008843,497.92557209912025,499.7191002877024,500.3523762992462,501.578309680463,499.1264429180294,8380,17335.9,46.52432260989614,47.811405655688134,NaN,NaN,NaN,NaN,0.7270879174414377,14.774939897599214,12381861
2025-09-10T13:30:00-04:00,499.715,500,499.59,499.99,NaN,NaN,NaN,501.67947289169655,NaN,NaN,500.2557000000023,502.463106629785,498.04829337021965,499.7191002877024,500.34850925426616,501.57039227074875,499.12662623778357,11608,16587.833333333332,49.159073472505796,48.25259484608356,NaN,NaN,NaN,NaN,0.7044387804813369,13.976356786128436,12393469
2025-09-10T13:35:00-04:00,499.96,500.5,499.96,500.28,NaN,NaN,NaN,501.67947289169655,NaN,NaN,500.2927000000023,502.4375917989694,498.1478082010352,499.7191002877024,500.3473807545209,501.562521945176,499.13223956386577,16561,16169.3,51.900297728508136,49.00179973116265,NaN,NaN,NaN,NaN,0.6926931533041001,13.496371930903702,12410030
2025-09-10T13:40:00-04:00,500.26,500.47,500.15,500.18,NaN,NaN,NaN,501.67947289169655,NaN,NaN,500.29510000000226,502.4392133247523,498.1509866752522,499.7191002877024,500.3468447191949,501.557961956965,499.1357274814248,9992,15769.633333333333,50.881523612154425,49.431619240653895,NaN,NaN,NaN,NaN,0.6660722137823821,13.050671708195024,12400038
2025-09-10T13:45:00-04:00,500.17,500.77,500.12,500.67,NaN,NaN,NaN,501.67947289169655,NaN,NaN,500.3398000000023,502.41914504811297,498.26045495189163,499.7191002877024,500.34836965706654,501.5542506141114,499.14248870002166,13368,15704.3,55.49181813475766,50.34031020347646,NaN,NaN,NaN,NaN,0.6649241985122103,13.086863026215415,12413406
2025-09-10T13:50:00-04:00,500.68,500.87,500.42,500.46,NaN,NaN,NaN,501.67947289169655,NaN,NaN,500.38340000000227,502.37784371922925,498.3889562807753,499.7191002877024,500.3501287651024,501.5516579175766,499.1485996126282,11450,15399.166666666666,53.18770940657739,50.8545984839833,NaN,NaN,NaN,NaN,0.6495724700470517,13.26746685797782,12401956
2025-09-10T13:55:00-04:00,500.51,500.75,500.39,500.71,NaN,NaN,NaN,501.67947289169655,NaN,NaN,500.43540000000235,502.32274081418626,498.54805918581843,499.7191002877024,500.3517313272129,501.54982013184645,499.1536425225794,9251,14715.666666666666,55.55371040597337,51.79562195433095,NaN,NaN,NaN,NaN,0.6288887221865489,13.372136270110389,12411207
2025-09-10T14:00:00-04:00,500.74,500.89,500.62,500.74,NaN,NaN,NaN,501.67947289169655,NaN,NaN,500.4736000000023,502.3059362543693,498.6412637456353,499.7639292291356,500.3540507297785,501.54903009935674,499.1590713602003,9013,14419.333333333334,55.84213284786634,52.67395643294383,NaN,NaN,NaN,NaN,0.603253813458937,13.694330979224539,12420220
2025-09-10T14:05:00-04:00,500.76,500.76,499.99,500.14,NaN,NaN,NaN,501.67947289169655,NaN,NaN,500.46480000000236,502.29923283576085,498.63036716424386,499.7639292291356,500.35359461115667,501.54382625252254,499.1633629697908,12400,14261.9,48.99429138039174,52.91686947019149,NaN,NaN,NaN,NaN,0.6151642553547259,12.717392928011565,12407820
2025-09-10T14:10:00-04:00,500.16,500.82,500.1,500.62,NaN,NaN,NaN,501.67947289169655,NaN,NaN,500.45220000000234,502.273494218121,498.63090578188365,499.7639292291356,500.35476100420397,501.54071720025934,499.1688048081486,11475,13991.9,53.8680922928925,53.03734769927597,NaN,NaN,NaN,NaN,0.6226525228293862,11.917334800524644,12419295
2025-09-10T14:15:00-04:00,500.61,500.755,500.33,500.43,NaN,NaN,NaN,501.67947289169655,NaN,NaN,500.4514000000023,502.27269738067105,498.63010261933357,499.7639292291356,500.355794279687,501.53773042709264,499.1738581322814,10883,13591.933333333332,51.75976354779865,52.53220468826424,NaN,NaN,NaN,NaN,0.6085344854844309,11.174423682143932,12408412
2025-09-10T14:20:00-04:00,500.38,501.23,500.36,501.21,NaN,NaN,NaN,501.67947289169655,NaN,NaN,500.4439000000023,502.24948388035403,498.6383161196506,499.7639292291356,500.3718624503202,501.5411051858711,499.20261971476924,45285,14320.8,58.875684316590906,52.674642171457826,NaN,NaN,NaN,NaN,0.6272105936641148,11.352788793662718,12453697
2025-09-10T14:25:00-04:00,501.23,501.33,500.58,501.1,NaN,NaN,NaN,501.67947289169655,NaN,NaN,500.4345000000023,502.22133210998,498.6476678900246,499.7639292291356,500.3781295413959,501.5432383732278,499.213020709564,16316,14475.5,57.58559929553544,52.857844746914694,NaN,NaN,NaN,NaN,0.6359812655452494,11.686263694066271,12437381
2025-09-10T14:30:00-04:00,501.09,501.2,500.75,501.2,NaN,NaN,NaN,501.67947289169655,NaN,NaN,500.4149000000023,502.1453247885629,498.68447521144174,499.7639292291356,500.3838915520554,501.5456466369982,499.2221364671126,14221,14576.2,58.47637752991009,53.43574261295419,NaN,NaN,NaN,NaN,0.6226968894348736,11.995918958726715,12451602
2025-09-10T14:35:00-04:00,501.24,501.27,500.69,500.99,NaN,NaN,NaN,501.67947289169655,NaN,NaN,500.4051000000023,502.116733707613,498.6934662923916,499.79519560307403,500.3868841964597,501.5465055744977,499.22726281842165,8320,14339,55.82489858579927,54.10006946837585,NaN,NaN,NaN,NaN,0.6196471116180957,12.413147280490211,12443282
2025-09-10T14:40:00-04:00,501.07,501.25,500.92,500.96,NaN,NaN,NaN,501.67947289169655,NaN,NaN,500.3857000000023,502.0490676770437,498.72233232296094,499.90515648245923,500.39027929467585,501.5478561337205,499.2327024556312,8664,13640.3,55.43817267446525,54.54857655423009,NaN,NaN,NaN,NaN,0.5989580322168021,12.8005735792706,12434618
2025-09-10T14:45:00-04:00,501,501,500.57,500.7,NaN,NaN,NaN,501.67947289169655,NaN,NaN,500.3655000000024,501.9880784999314,498.74292150007335,499.90515648245923,500.39223307581955,501.5470276988613,499.2374384527778,8981,13470.733333333334,52.07141772262,54.56079941095236,NaN,NaN,NaN,NaN,0.5868896013441738,12.222620528064239,12425637
2025-09-10T14:50:00-04:00,500.68,500.73,500.47,500.675,NaN,NaN,NaN,501.67947289169655,NaN,NaN,500.3250000000023,501.8075221714236,498.842477828581,499.90515648245923,500.3940500322151,501.54451110437077,499.2435889600594,13250,13235.266666666666,51.74600779789719,54.62254828136256,NaN,NaN,NaN,NaN,0.5635403441053036,11.438065848986705,12412387
2025-09-10T14:55:00-04:00,500.63,501.63,500.63,501.58,NaN,NaN,NaN,501.67947289169655,NaN,NaN,500.30420000000237,501.68288830000273,498.925511700002,500.19984011901914,500.40217546578543,501.55045871969105,499.2538922118798,15712,13428.333333333334,61.19896963580688,55.03020196000893,NaN,NaN,NaN,NaN,0.5947160338120676,12.424683571869528,12428099
2025-09-10T15:00:00-04:00,501.61,501.88,501.11,501.11,499.52991008169016,499.52991008169016,499.52991008169016,NaN,NaN,NaN,500.29800000000233,501.6592391372336,498.93676086277105,500.3508720952153,500.40802030742014,501.55526356558556,499.2607770492547,10445,13103.233333333334,55.15586245550148,55.17078432064636,NaN,NaN,NaN,NaN,0.6072363171112044,13.702829688911008,12417654
2025-09-10T15:05:00-04:00,501.15,501.2,500.525,500.64,499.52991008169016,NaN,NaN,NaN,NaN,NaN,500.3162000000024,501.6708934075059,498.96150659249895,500.3508720952153,500.40997642136983,501.5545888393887,499.26536400335095,8911,12864.233333333334,49.85430429496704,54.76368388414591,NaN,NaN,NaN,NaN,0.6120765801746906,13.531345726998662,12408743
2025-09-10T15:10:00-04:00,500.63,500.63,499.5,499.69,NaN,NaN,NaN,502.09882159912115,502.09882159912115,502.09882159912115,500.32880000000245,501.6477716556247,499.0098283443802,500.3508720952153,500.4054721580364,501.54550628562106,499.2654380304517,16765,12957.4,41.22816796296982,53.71982924951044,NaN,NaN,NaN,NaN,0.6497853958764974,13.473965774766885,12391978
2025-09-10T15:15:00-04:00,499.73,500.005,499.47,500,NaN,NaN,NaN,501.75182970825205,NaN,NaN,500.3484000000024,501.617163866316,499.07963613368884,500.3508720952153,500.39884783145567,501.53403384830546,499.2636618146059,20193,13290.433333333332,44.5969294565409,53.405731969235376,NaN,NaN,NaN,NaN,0.6415864390281739,13.462818660964453,12412171
2025-09-10T15:20:00-04:00,499.97,499.97,499.08,499.34,NaN,NaN,NaN,501.5732238124224,NaN,NaN,500.34140000000247,501.62834838603936,499.05445161396557,500.3508720952153,500.39279763766353,501.5267891476831,499.258806127644,11518,13353.133333333333,39.41670816577331,52.373490245869725,NaN,NaN,NaN,NaN,0.6614731219547341,13.98771177028724,12400653
2025-09-10T15:25:00-04:00,499.34,499.44,499.11,499.4,NaN,NaN,NaN,501.2751227300395,NaN,NaN,500.33560000000244,501.63677429591684,499.03442570408805,500.3508720952153,500.38148743296347,501.5148297506221,499.24814511530485,18917,13744.3,40.09791235612583,51.54050087503595,NaN,NaN,NaN,NaN,0.6377964703865376,14.4751125146584,12419570
2025-09-10T15:30:00-04:00,499.4,500,499.38,499.75,NaN,NaN,NaN,501.2751227300395,NaN,NaN,500.3334000000024,501.63815045450656,499.0286495454983,500.3508720952153,500.36926719585216,501.49583079661704,499.2427035950873,33363,14143.3,44.049995278408595,50.48152308659436,NaN,NaN,NaN,NaN,0.6365252939303566,13.84174393349503,12452933
2025-09-10T15:35:00-04:00,499.79,500.09,499.38,499.45,NaN,NaN,NaN,501.2751227300395,NaN,NaN,500.30820000000244,501.6314229700336,498.9849770299713,500.3508720952153,500.3638816867146,501.4880131749276,499.2397501985016,13639,14140.266666666666,41.52131960026743,49.334074536932356,NaN,NaN,NaN,NaN,0.6417734872210439,13.092817355794734,12439294
2025-09-10T15:40:00-04:00,499.44,500.39,499.3,500.38,NaN,NaN,NaN,501.2751227300395,NaN,NaN,500.30680000000245,501.6295679419827,498.9840320580222,500.3508720952153,500.3576287257326,501.4723300749991,499.24292737646607,34546,14900.6,50.926019253236014,48.79476323145564,NaN,NaN,NaN,NaN,0.6737896667052532,12.442612802235232,12473840
2025-09-10T15:45:00-04:00,500.37,500.54,500.13,500.26,NaN,NaN,NaN,501.2751227300395,NaN,NaN,500.3062000000025,501.62902509358116,498.9833749064238,500.3508720952153,500.35683647656066,501.4622448445903,499.251428108531,31825,15685.9,49.81282358586786,48.36532930288911,NaN,NaN,NaN,NaN,0.6549475476548797,12.09165663898449,12442015
2025-09-10T15:50:00-04:00,500.29,500.6,500.1,500.19,NaN,NaN,NaN,501.2751227300395,NaN,NaN,500.28800000000257,501.59153825712553,498.9844617428796,499.6391976761722,500.3555128227409,501.4487304629009,499.26229518258083,43036,16609.6,49.13806057694888,47.915321295923654,NaN,NaN,NaN,NaN,0.6438798656795311,11.869015483612364,12398979
2025-09-10T15:55:00-04:00,500.19,500.47,500.09,500.2,NaN,NaN,NaN,501.2751227300395,NaN,NaN,500.2628000000025,501.52272246902,499.0028775309851,498.994075416831,500.35222043279106,501.42783258934145,499.27660827624067,65134,18501.4,49.243836187292956,47.713351186257434,NaN,NaN,NaN,NaN,0.6250313038452827,11.640499468204373,12464113
2025-09-11T09:30:00-04:00,502.17,502.8,500.3,500.82,499.3269435027489,499.3269435027489,499.3269435027489,NaN,NaN,NaN,500.2537000000026,501.49061035551165,499.01678964449354,500.31926033346474,501.3066666666666,501.30667429606115,501.3066590372721,45958,19646.4,55.43237961356466,47.976663458805106,NaN,NaN,NaN,NaN,0.7661004964277642,14.119070445410076,12510071
2025-09-11T09:35:00-04:00,500.77,501.16,499.05,499.28,NaN,NaN,NaN,502.51473574737605,502.51473574737605,502.51473574737605,500.22270000000253,501.4778417561396,498.9675582438655,500.31926033346474,500.5774985589297,501.3157750042751,499.83922211358424,44831,20588.733333333334,41.79957445976744,46.59099237480229,NaN,NaN,NaN,NaN,0.8620933181114963,14.409018021487299,12465240
2025-09-11T09:40:00-04:00,499.28,499.63,497.88,498.53,NaN,NaN,NaN,501.29383866794984,NaN,NaN,500.18530000000254,501.52563190956784,498.84496809043725,500.31926033346474,499.91486274284915,500.9979028033064,498.83182268239193,48718,21879.6,37.02395473425054,45.29585610899865,NaN,NaN,NaN,NaN,0.9255152239606751,13.452780658616625,12416522
2025-09-11T09:45:00-04:00,498.6,499.6,498.55,499.37,NaN,NaN,NaN,501.29383866794984,NaN,NaN,500.1607000000025,501.5147635243731,498.80663647563193,500.31926033346474,499.76434291035605,500.77619130820335,498.75249451250875,35530,22618.333333333332,44.65121667695962,44.9242069934267,NaN,NaN,NaN,NaN,0.9358355651063447,12.564845964522428,12452052
2025-09-11T09:50:00-04:00,499.36,500.09,499,499.63,NaN,NaN,NaN,501.29383866794984,NaN,NaN,500.1589000000025,501.5155389158567,498.8022610841483,500.31926033346474,499.7412214505823,500.69189744451074,498.7905454566539,24106,23040.2,46.79900642717326,45.32212402658409,NaN,NaN,NaN,NaN,0.9468473104558897,12.122148149658035,12476158
2025-09-11T09:55:00-04:00,499.68,500.45,499.38,500.28,NaN,NaN,NaN,501.29383866794984,NaN,NaN,500.17250000000246,501.5200581576169,498.824941842388,500.31926033346474,499.7720789262243,500.6762661106965,498.86789174175215,23225,23506,51.83137695843684,45.83887027671951,NaN,NaN,NaN,NaN,0.9556439311376114,12.076933517749488,12499383
2025-09-11T10:00:00-04:00,500.26,500.93,499.85,500.88,NaN,NaN,NaN,501.29383866794984,NaN,NaN,500.20090000000243,501.5470496009766,498.85475039902826,500.31926033346474,499.881445599542,500.76268808891064,499.0002031101734,36196,24412.1,55.97146589519607,47.021352971678276,NaN,NaN,NaN,NaN,0.9645265074849237,12.495383939401213,12535579
2025-09-11T10:05:00-04:00,500.89,501.28,500.19,501.01,NaN,NaN,NaN,501.29383866794984,NaN,NaN,500.23630000000253,501.572567648244,498.90003235176107,500.31926033346474,499.95184379671946,500.83520981042267,499.06847778301625,20807,24692.333333333332,56.837097033181145,48.21700902003937,NaN,NaN,NaN,NaN,0.9734888998074274,13.201038881818688,12556386
2025-09-11T10:10:00-04:00,501.07,501.66,500.71,501.5,498.4929529964599,498.4929529964599,498.4929529964599,NaN,NaN,NaN,500.27450000000243,501.6434824645505,498.90551753545435,500.31926033346474,500.0405947654314,500.95681907918595,499.1243704516769,19845,24971.333333333332,60.027172277897684,49.358235948574304,NaN,NaN,NaN,NaN,0.9718111212497573,14.186127468601512,12576231
2025-09-11T10:15:00-04:00,501.48,501.5,500.9,501.01,498.5485005875299,NaN,NaN,NaN,NaN,NaN,500.3083000000024,501.66474182633425,498.9518581736706,500.31926033346474,500.11228082230997,501.03856251318905,499.1859991314309,20939,25306.533333333333,55.60166781398382,50.363975106696905,NaN,NaN,NaN,NaN,0.9452531840176334,15.100852584899846,12555292
2025-09-11T10:20:00-04:00,501.05,501.9,500.94,501.83,498.7581141971876,NaN,NaN,NaN,NaN,NaN,500.35210000000245,501.75985578429135,498.94434421571356,499.3906333515185,500.2166005077113,501.1839808903761,499.24922012504646,24923,24627.8,60.808877391185526,51.06989354512187,NaN,NaN,NaN,NaN,0.9463065280163724,16.303312578067093,12580215
2025-09-11T10:25:00-04:00,501.87,502.44,501.69,502.33,499.42183627913363,NaN,NaN,NaN,NaN,NaN,500.41490000000243,501.88830759745036,498.9414924025545,500.0575066812148,500.33392824636815,501.3792028506824,499.2886536420539,22253,24825.7,63.61137278960899,52.05550420253195,NaN,NaN,NaN,NaN,0.9322846331580601,17.855556686844917,12602468
2025-09-11T10:30:00-04:00,502.26,503.18,501.87,503.09,499.8233437209912,NaN,NaN,NaN,NaN,NaN,500.4907000000024,502.10965028597417,498.8717497140306,500.61900534497187,500.4436757441276,501.58002660859864,499.3073248796565,17762,24943.733333333334,67.42446283822194,53.36167579262288,NaN,NaN,NaN,NaN,0.9592643022181988,19.813900625256988,12620230
2025-09-11T10:35:00-04:00,503.1,503.12,502.43,502.88,500.102055370037,NaN,NaN,NaN,NaN,NaN,500.55850000000237,502.2845362071957,498.83246379280905,500.72620427597747,500.5126395699347,501.70095551248227,499.3243236273872,11560,25051.733333333334,65.38561876285269,54.514660262305725,NaN,NaN,NaN,NaN,0.9400311377740416,21.632362853782485,12608670
2025-09-11T10:40:00-04:00,502.85,503.14,502.6,502.8,500.2449164895808,NaN,NaN,NaN,NaN,NaN,500.61130000000236,502.443591251033,498.7790087489717,500.954963420782,500.60422480479326,501.85404877150023,499.3544008380863,16200,25302.933333333334,64.58440289332098,55.168376210859755,NaN,NaN,NaN,NaN,0.9114574850758931,23.33519454008241,12592470
2025-09-11T10:45:00-04:00,502.83,502.93,501.7,501.73,500.2449164895808,NaN,NaN,NaN,NaN,NaN,500.62610000000234,502.48218759188114,498.77001240812353,500.954963420782,500.6361022269014,501.89169450648694,499.3805099473159,8869,25299.2,54.89534980202204,56.10378873530651,NaN,NaN,NaN,NaN,0.9342105218561877,23.355464839094655,12583601
2025-09-11T10:50:00-04:00,501.81,501.93,500.57,500.69,500.2449164895808,NaN,NaN,NaN,NaN,NaN,500.6239000000023,502.47941856598595,498.7683814340187,500.954963420782,500.6496081722691,501.8874538253369,499.4117625192013,13767,25316.433333333334,47.444974512003434,56.84814729086029,NaN,NaN,NaN,NaN,0.9646240560093181,21.88355052004514,12569834
2025-09-11T10:55:00-04:00,500.69,500.94,500.22,500.83,NaN,NaN,NaN,503.29117471731706,503.29117471731706,503.29117471731706,500.6281000000023,502.4845147028349,498.7716852971697,500.954963420782,500.6500600542583,501.8673604491066,499.43275965940995,14826,25286.9,48.459059403683504,57.12013605705484,NaN,NaN,NaN,NaN,0.9471509091515076,20.515373530302835,12584660
2025-09-11T11:00:00-04:00,500.83,501.57,500.81,501.11,NaN,NaN,NaN,503.29117471731706,NaN,NaN,500.64730000000236,502.50339612590614,498.7912038740986,500.954963420782,500.66082408436074,501.86753594512595,499.45411222359553,9646,25260.266666666666,50.515626197862794,57.385608897818386,NaN,NaN,NaN,NaN,0.9337829870692563,19.54234094619744,12594306
2025-09-11T11:05:00-04:00,501.18,501.96,501.09,501.65,NaN,NaN,NaN,503.29117471731706,NaN,NaN,500.6859000000024,502.5435261056707,498.8282738943341,500.954963420782,500.67679857103593,501.8787509451964,499.4748461968755,8257,25238.466666666667,54.302681183226206,57.56213062816049,NaN,NaN,NaN,NaN,0.9292270594214527,19.029678155994116,12602563
2025-09-11T11:10:00-04:00,501.68,501.96,501.64,501.84,NaN,NaN,NaN,503.29117471731706,NaN,NaN,500.7229000000023,502.5972298399017,498.84857016010295,500.954963420782,500.69726460628124,501.8978960696323,499.4966331429302,8586,24965.833333333332,55.59049761839443,57.534918608388935,NaN,NaN,NaN,NaN,0.8857108408913484,18.553634136519594,12611149
2025-09-11T11:15:00-04:00,501.87,502.62,501.8,502.58,NaN,NaN,NaN,503.29117471731706,NaN,NaN,500.7689000000023,502.7092250111534,498.8285749888512,500.954963420782,500.74056756239867,501.95396518236,499.52716994243735,12963,24724.833333333332,60.2849134727957,57.78119121121856,NaN,NaN,NaN,NaN,0.8810172093991088,18.758975825943644,12624112
2025-09-11T11:20:00-04:00,502.58,502.67,502.18,502.31,NaN,NaN,NaN,503.29117471731706,NaN,NaN,500.81150000000235,502.79136287116086,498.83163712884385,500.954963420782,500.7710965715606,501.99353234857165,499.5486607945495,9255,24649.4,57.880789674718905,57.62787816813436,NaN,NaN,NaN,NaN,0.8530874087277445,18.996608393894764,12614857
2025-09-11T11:25:00-04:00,502.29,502.82,502.16,502.69,NaN,NaN,NaN,503.29117471731706,NaN,NaN,500.85190000000244,502.8998325057726,498.80396749423227,501.01355690034046,500.8106752963091,502.04774028311635,499.5736103095019,11312,24395.9,60.281530128599805,57.962154047749785,NaN,NaN,NaN,NaN,0.8392954509614748,19.363749043516336,12626169
2025-09-11T11:30:00-04:00,502.71,502.97,502.68,502.73,NaN,NaN,NaN,503.29117471731706,NaN,NaN,500.89730000000236,503.0081474195263,498.7864525804784,501.3798455202724,500.8526204980269,502.1093454670993,499.59589552895454,11030,23651.466666666667,60.53651913575961,57.94269988664793,NaN,NaN,NaN,NaN,0.8000600616070852,19.854029215588557,12637199
2025-09-11T11:35:00-04:00,502.73,502.83,502.1,502.17,NaN,NaN,NaN,503.29117471731706,NaN,NaN,500.9265000000024,503.06636938581744,498.7866306141874,501.3798455202724,500.8758619582543,502.1367196417537,499.6150042747549,8128,23467.766666666666,55.19414075152225,57.34146902678459,NaN,NaN,NaN,NaN,0.7950557714922907,19.380963874219287,12629071
2025-09-11T11:40:00-04:00,502.14,502.56,501.96,501.96,NaN,NaN,NaN,503.29117471731706,NaN,NaN,500.95090000000243,503.1094473699576,498.7923526300473,501.3798455202724,500.8887237706343,502.14975116870266,499.6276963725659,5357,22494.8,53.294736230339225,56.33220284050725,NaN,NaN,NaN,NaN,0.7811232163857001,18.73086232175299,12623714
2025-09-11T11:45:00-04:00,501.95,501.97,500.88,501.04,NaN,NaN,NaN,503.29117471731706,NaN,NaN,500.96890000000246,503.1150736062665,498.82272639373844,501.3798455202724,500.8947171397482,502.14740886405843,499.64202541543796,7975,21699.8,45.85047586845936,54.93683549090773,NaN,NaN,NaN,NaN,0.8031858437867239,18.060868893339048,12615739
2025-09-11T11:50:00-04:00,500.99,501.85,500.93,501.84,NaN,NaN,NaN,503.29117471731706,NaN,NaN,500.9933000000025,503.15076296102535,498.8358370389796,501.3798455202724,500.9043659841084,502.15012080205787,499.6586111661589,8240,20539.933333333334,52.11417710797512,54.04610507766875,NaN,NaN,NaN,NaN,0.8115297120876733,17.43873213838324,12623979
2025-09-11T11:55:00-04:00,501.89,502.14,501.77,502.01,NaN,NaN,NaN,503.29117471731706,NaN,NaN,501.0249000000025,503.1946838482248,498.8551161517802,501.3798455202724,500.90997738152834,502.15485708117103,499.66509768188564,2908,18465.733333333334,53.34910053656472,53.93565870156465,NaN,NaN,NaN,NaN,0.7799918755099827,16.45078881059578,12626887
2025-09-11T12:00:00-04:00,501.97,502.8,501.8,502.76,NaN,NaN,NaN,503.29117471731706,NaN,NaN,501.0559000000025,503.27901105164875,498.83278894835627,501.3798455202724,500.93167989326184,502.1810625764215,499.6822972101022,7901,17197.166666666668,58.44116053080391,54.7211005600504,NaN,NaN,NaN,NaN,0.7957067415449839,15.862071679079365,12634788
2025-09-11T12:05:00-04:00,502.78,502.93,502.66,502.89,NaN,NaN,NaN,503.29117471731706,NaN,NaN,501.0917000000025,503.3733779851727,498.8100220148323,501.3798455202724,500.95122956922023,502.2088136123876,499.6936455260529,5857,15898.033333333333,59.2710185813671,55.49338335845637,NaN,NaN,NaN,NaN,0.7581562600060552,15.470275025433692,12640645
2025-09-11T12:10:00-04:00,502.88,502.91,502.39,502.455,NaN,NaN,NaN,503.29117471731706,NaN,NaN,501.11680000000246,503.4300840353383,498.8035159646666,501.3798455202724,500.9678474474224,502.22971308228205,499.70598181256275,5834,14468.566666666668,55.292364766504,55.83457897050217,NaN,NaN,NaN,NaN,0.7411450985770539,14.710834770615614,12634811
2025-09-11T12:15:00-04:00,502.49,502.8,502.41,502.77,NaN,NaN,NaN,503.29117471731706,NaN,NaN,501.15240000000244,503.51112273659106,498.7936772634138,501.3798455202724,500.9787312387872,502.24378534035196,499.7136771372224,3713,13408,57.51629970840588,56.06412315087215,NaN,NaN,NaN,NaN,0.716063305821549,14.005640248284543,12638524
2025-09-11T12:20:00-04:00,502.78,503.15,502.42,502.47,NaN,NaN,NaN,503.29117471731706,NaN,NaN,501.1826000000025,503.5691977767737,498.79600222323126,501.62311552012955,501.0290621126644,502.30816703943765,499.74995718589116,17599,13191.1,54.72429626709079,56.00225162577903,NaN,NaN,NaN,NaN,0.7170587839771498,13.827642571012738,12620925
2025-09-11T12:25:00-04:00,502.49,502.64,501.95,502.31,NaN,NaN,NaN,503.29117471731706,NaN,NaN,501.2148000000025,503.6178713322153,498.81172866778974,501.62311552012955,501.0418932466696,502.3208516187465,499.7629348745927,6067,12619.166666666666,53.23991396589386,55.49903737528604,NaN,NaN,NaN,NaN,0.7151260136930676,12.928731330326931,12614858
2025-09-11T12:30:00-04:00,502.38,502.56,502.09,502.37,NaN,NaN,NaN,503.29117471731706,NaN,NaN,501.2487000000025,503.6681220854937,498.8292779145113,501.62311552012955,501.0594875793391,502.33858640011897,499.7803887585592,8257,11687.866666666667,53.74658414556616,55.203736980346555,NaN,NaN,NaN,NaN,0.6976170127149933,12.094028035404394,12623115
2025-09-11T12:35:00-04:00,502.4,502.49,502,502.32,NaN,NaN,NaN,503.29117471731706,NaN,NaN,501.26350000000247,503.69984172234746,498.8271582776575,501.62311552012955,501.07343312239715,502.3516866860837,499.7951795587106,7100,11230.966666666667,53.22897542225137,54.69998307275024,NaN,NaN,NaN,NaN,0.6827872260924944,11.286346129137822,12616015
2025-09-11T12:40:00-04:00,502.29,502.545,502.2,502.5,NaN,NaN,NaN,503.29117471731706,NaN,NaN,501.29130000000254,503.7516047022369,498.8309952977682,501.62311552012955,501.08579560751434,502.3645871554058,499.8070040596229,5732,10760.533333333333,54.91240507500248,54.29826063983902,NaN,NaN,NaN,NaN,0.6586595670858896,10.517732356961162,12621747
2025-09-11T12:45:00-04:00,502.57,502.7,502.18,502.27,NaN,NaN,NaN,503.29117471731706,NaN,NaN,501.32390000000254,503.79200476837735,498.8557952316277,501.62311552012955,501.09623464104095,502.37513549966883,499.8173337824131,5045,10230.733333333334,52.32100662733395,54.093036773825574,NaN,NaN,NaN,NaN,0.648755312294039,10.074113447909774,12616702
2025-09-11T12:50:00-04:00,502.22,502.24,500.83,501.2,NaN,NaN,NaN,503.29117471731706,NaN,NaN,501.3541000000025,503.7780535366548,498.93014646335024,501.62311552012955,501.1035210790337,502.36901837878065,499.8380237792868,14287,9876.2,42.316156851494604,53.30885253247952,NaN,NaN,NaN,NaN,0.7052727899873218,11.005140939685276,12602415
2025-09-11T12:55:00-04:00,501.26,501.46,501,501.12,NaN,NaN,NaN,503.29117471731706,NaN,NaN,501.3765000000026,503.7705010417027,498.9824989583025,501.62311552012955,501.10490724337785,502.3606495170445,499.8491649697112,10054,9469.566666666668,41.67451027885566,53.01056927607925,NaN,NaN,NaN,NaN,0.6877533049882258,11.869666467762528,12592361
2025-09-11T13:00:00-04:00,501.16,501.37,500.6,500.67,NaN,NaN,NaN,503.15850978666634,NaN,NaN,501.4031000000026,503.7347422426126,499.07145775739264,501.62311552012955,501.0993206798491,502.3398628681177,499.8587784915805,16593,9430.6,38.16858296798623,52.01445540893719,NaN,NaN,NaN,NaN,0.6936280689176371,13.127402880248102,12575768
2025-09-11T13:05:00-04:00,500.75,501.02,500.25,500.98,NaN,NaN,NaN,502.8147138872724,NaN,NaN,501.4347000000026,503.6987427618549,499.1706572381503,501.62311552012955,501.09194693070896,502.3203528214999,499.863541039918,14405,9525.433333333332,41.8008904542832,51.18958326020279,NaN,NaN,NaN,NaN,0.6990832068520902,14.660032059687097,12590173
2025-09-11T13:10:00-04:00,501.01,501.37,500.87,500.92,NaN,NaN,NaN,502.8147138872724,NaN,NaN,501.4581000000025,503.67571934243665,499.24048065756836,501.38323849363604,501.0912485383398,502.3085057141911,499.87399136248854,12570,9404.433333333332,41.2952431759357,49.964874877712205,NaN,NaN,NaN,NaN,0.6848629777912266,15.387814875948793,12577603
2025-09-11T13:15:00-04:00,500.97,501.2,500.65,500.82,NaN,NaN,NaN,502.8147138872724,NaN,NaN,501.4855000000025,503.6360369069055,499.33496309309953,501.38323849363604,501.08883217804515,502.2989581043371,499.8787062517532,8446,9390.333333333334,40.41770261783022,48.61820945174528,NaN,NaN,NaN,NaN,0.675229907948997,16.31418749522639,12569157
2025-09-11T13:20:00-04:00,500.81,501.015,500.51,500.51,NaN,NaN,NaN,502.8147138872724,NaN,NaN,501.48810000000253,503.63359284495624,499.3426071550488,501.38323849363604,501.08292859985204,502.28531498503247,499.8805422146716,10264,9273.566666666668,37.740269999541525,47.36448839696225,NaN,NaN,NaN,NaN,0.6630706288097825,17.33302221994619,12558893
2025-09-11T13:25:00-04:00,500.54,500.74,500.08,500.08,NaN,NaN,NaN,502.50298475390434,NaN,NaN,501.4845000000025,503.6388093992638,499.3301906007413,501.38323849363604,501.0737770118413,502.2720738253523,499.87548019833025,8441,9060.733333333334,34.34195675639681,45.70917818610446,NaN,NaN,NaN,NaN,0.6628512981805141,18.740238092137695,12550452
2025-09-11T13:30:00-04:00,500.2,500.765,500.19,500.56,NaN,NaN,NaN,502.50298475390434,NaN,NaN,501.49190000000254,503.6308594544202,499.3529405455849,501.38323849363604,501.0660489028582,502.25799729820193,499.87410050751447,9947,9070.766666666666,40.755045378114794,44.7113745511776,NaN,NaN,NaN,NaN,0.6644333483104775,19.990273884415842,12560399
2025-09-11T13:35:00-04:00,500.62,500.69,500.15,500.28,NaN,NaN,NaN,502.48983734808223,NaN,NaN,501.4935000000026,503.62870794950015,499.35829205050504,500.4665907949088,501.0598689160126,502.24827489524836,499.8714629367768,6590,9015.2,38.398912866098144,43.651303044049335,NaN,NaN,NaN,NaN,0.6555452520025877,21.196001576097526,12553809
2025-09-11T13:40:00-04:00,500.275,500.41,500.17,500.32,NaN,NaN,NaN,502.2984811049877,NaN,NaN,501.48350000000266,503.6358459265176,499.3311540734877,499.8112726359271,501.05502603087746,502.2411812420566,499.8688708196983,4738,8886.933333333332,38.941972775251934,42.593830803312606,NaN,NaN,NaN,NaN,0.6258634482881178,22.315605861230516,12558547
2025-09-11T13:45:00-04:00,500.34,500.39,499.82,499.93,NaN,NaN,NaN,502.0999137820337,NaN,NaN,501.49650000000264,503.60281265187416,499.3901873481311,499.72145158959466,501.03496134061953,502.2176691414025,499.85225353983657,15093,8957.933333333332,35.642692790165626,41.337667758163626,NaN,NaN,NaN,NaN,0.6218732019818232,23.76601500559615,12543454
2025-09-11T13:50:00-04:00,499.96,500.23,499.82,500.05,NaN,NaN,NaN,501.98514497375936,NaN,NaN,501.5269000000026,503.500788433428,499.55301156657725,499.72145158959466,501.0266378052134,502.2079258853833,499.8453497250435,6356,8861.3,37.40011488496926,40.08678988744697,NaN,NaN,NaN,NaN,0.6067394018402662,25.112823496792807,12549810
2025-09-11T13:55:00-04:00,500.05,500.26,499.84,500.03,NaN,NaN,NaN,501.97832020222484,NaN,NaN,501.54010000000267,503.4643187888824,499.61588121112294,499.72145158959466,501.0135633243374,502.19236455099644,499.8347620976783,10307,8827.8,37.21769962049071,39.00798224410102,NaN,NaN,NaN,NaN,0.5934008731373913,26.272006376729646,12539503
2025-09-11T14:00:00-04:00,500.02,500.11,499.88,500.05,NaN,NaN,NaN,501.8670329203056,NaN,NaN,501.5485000000026,503.442725168146,499.6542748318592,499.6061612716757,501.0057981699015,502.1832917843234,499.8283045554796,6065,8662.3,37.54574577494034,38.667238595775714,NaN,NaN,NaN,NaN,0.5674436679132933,27.348390479528135,12545568
2025-09-11T14:05:00-04:00,500.07,500.295,499.74,500.24,NaN,NaN,NaN,501.8670329203056,NaN,NaN,501.54770000000264,503.4440999650592,499.6513000349461,499.48742901734056,500.98915422407265,502.16226315531026,499.81604529283504,14488,8874.3,40.71495678514784,38.598699060510874,NaN,NaN,NaN,NaN,0.5665548344909157,27.73898035487595,12560056
2025-09-11T14:10:00-04:00,500.23,500.73,499.9,500.03,NaN,NaN,NaN,501.8670329203056,NaN,NaN,501.5307000000027,503.46558605021096,499.59581394979443,499.38066731563896,500.9806692149403,502.15005252203235,499.81128590784823,8876,8991.6,38.39583465962772,38.61493132419955,NaN,NaN,NaN,NaN,0.5853723463129962,26.84473817070901,12551180
2025-09-11T14:15:00-04:00,500.04,500.04,499.76,499.8,NaN,NaN,NaN,501.7433604315317,NaN,NaN,501.50650000000263,503.49631833028695,499.5166816697183,499.38066731563896,500.9717199802411,502.14063458815286,499.8028053723294,6516,8942.966666666667,35.97866095229881,38.199057788343524,NaN,NaN,NaN,NaN,0.5635600358620699,26.280246737725637,12544664
2025-09-11T14:20:00-04:00,499.84,500.06,499.68,499.98,NaN,NaN,NaN,501.68138950282577,NaN,NaN,501.47610000000265,503.5113132928789,499.44088670712637,499.38066731563896,500.9596224123389,502.12734649945344,499.79189832522434,9319,8978.933333333332,39.204371919058204,38.0497098414237,NaN,NaN,NaN,NaN,0.5504486047290646,25.9083934114238,12553983
2025-09-11T14:25:00-04:00,499.97,500.2,499.9,500.02,NaN,NaN,NaN,501.68138950282577,NaN,NaN,501.45630000000267,503.5281984597164,499.38440154028893,499.38066731563896,500.9520849975581,502.11796583522477,499.7862041598914,6780,9108,39.928707539592864,38.01478162154961,NaN,NaN,NaN,NaN,0.5325594186769894,25.15458240955306,12560763
2025-09-11T14:30:00-04:00,500,500.74,499.97,500.1,NaN,NaN,NaN,501.68138950282577,NaN,NaN,501.4217000000026,503.52502271123035,499.31837728877485,499.4890333324857,500.9428152154341,502.1034365559953,499.7821938748729,11397,9224.533333333333,41.43165947281738,38.278452298212166,NaN,NaN,NaN,NaN,0.5495194602000603,23.612602027331235,12572160
2025-09-11T14:35:00-04:00,500.09,500.62,500.04,500.35,NaN,NaN,NaN,501.68138950282577,NaN,NaN,501.3821000000026,503.4900792094704,499.27412079053477,499.4890333324857,500.934921560112,502.09000695532484,499.77983616489917,11065,9398.133333333333,45.98013937121175,39.10975105641324,NaN,NaN,NaN,NaN,0.5516966416143405,22.180763100982396,12583225
2025-09-11T14:40:00-04:00,500.31,500.51,500.1,500.24,NaN,NaN,NaN,501.68138950282577,NaN,NaN,501.3251000000026,503.39912457740866,499.2510754225965,499.4890333324857,500.9314774501505,502.0844745145716,499.77848038572944,4515,9354.166666666666,44.3481539778506,39.366401670680084,NaN,NaN,NaN,NaN,0.5415754529275996,20.85119838365847,12578710
2025-09-11T14:45:00-04:00,500.29,500.57,500.23,500.43,NaN,NaN,NaN,501.68138950282577,NaN,NaN,501.27610000000254,503.31635810814106,499.235841891864,499.4890333324857,500.92687021473193,502.07579943365505,499.7779409958088,7614,9484.2,47.79486450432066,40.03754107341026,NaN,NaN,NaN,NaN,0.527177206289912,19.769909820734057,12586324
2025-09-11T14:50:00-04:00,500.44,501.2,500.44,500.86,NaN,NaN,NaN,501.68138950282577,NaN,NaN,501.23730000000256,503.2334715426669,499.2411284573382,499.88692405298616,500.92531187861607,502.06469314929575,499.7859306079364,14601,9384.266666666666,54.641585614905644,41.15894199052838,NaN,NaN,NaN,NaN,0.544521691554917,20.120016819210168,12600925
2025-09-11T14:55:00-04:00,500.87,500.93,500.54,500.71,NaN,NaN,NaN,501.68138950282577,NaN,NaN,501.2169000000026,503.2133617570891,499.22043824291615,499.88692405298616,500.92377509660486,502.0588739415619,499.7886762516478,6833,9409.8,52.075842329847035,42.33273838621991,NaN,NaN,NaN,NaN,0.533484427872422,20.445116174937986,12594092
2025-09-11T15:00:00-04:00,500.68,500.87,500.49,500.74,NaN,NaN,NaN,501.68138950282577,NaN,NaN,501.2179000000026,503.2133549225089,499.2224450774963,499.88692405298616,500.92182865182093,502.05217105579203,499.79148624784983,7750,9392.9,52.55567395493695,43.41527831978904,NaN,NaN,NaN,NaN,0.5225212544529629,20.5851784716919,12601842
2025-09-11T15:05:00-04:00,500.8,500.845,500.61,500.72,NaN,NaN,NaN,501.68138950282577,NaN,NaN,501.21570000000264,503.21310231990907,499.2182976800962,499.88692405298616,500.9206071322211,502.0475426393527,499.79367162508953,5564,9341.7,52.18058288007577,44.484055695473685,NaN,NaN,NaN,NaN,0.501984021992038,20.715236318677675,12596278
2025-09-11T15:10:00-04:00,500.68,500.68,500.42,500.53,NaN,NaN,NaN,501.68138950282577,NaN,NaN,501.20410000000265,503.2105393206772,499.1976606793281,499.88692405298616,500.91690908846584,502.0389236770595,499.7948944998722,8875,9446.466666666667,48.629771231682675,45.2757717995267,NaN,NaN,NaN,NaN,0.4875565918497503,20.18773921776895,12587403
2025-09-11T15:15:00-04:00,500.55,500.66,500.42,500.54,NaN,NaN,NaN,501.68138950282577,NaN,NaN,501.18190000000266,503.19267187853103,499.1711281214743,499.88692405298616,500.91345798045427,502.030900824782,499.7960151361265,8367,9557.2,48.82714500312623,45.85521381509659,NaN,NaN,NaN,NaN,0.4698739781461974,19.697920481210854,12595770
2025-09-11T15:20:00-04:00,500.56,500.69,500.46,500.66,NaN,NaN,NaN,501.68138950282577,NaN,NaN,501.1583000000026,503.1653172963223,499.1512827036829,499.88692405298616,500.9109443570037,502.0241967699423,499.7976919440651,7467,9329.866666666667,51.24782756886997,46.7732133086139,NaN,NaN,NaN,NaN,0.4527401225643275,19.326016094313037,12603237
2025-09-11T15:25:00-04:00,500.68,500.83,500.58,500.8,NaN,NaN,NaN,501.68138950282577,NaN,NaN,501.1227000000027,503.09034347062203,499.15505652938333,500.02252273515677,500.90950054146793,502.01824449415017,499.8007565887857,7696,9251.266666666666,53.982781600317985,48.05922192632955,NaN,NaN,NaN,NaN,0.4382586852383041,19.36592137062296,12610933
2025-09-11T15:30:00-04:00,500.8,500.95,500.48,500.75,NaN,NaN,NaN,501.68138950282577,NaN,NaN,501.0915000000026,503.0321352021338,499.1508647978714,500.0690181881254,500.9065498527491,502.0065518975786,499.80654780791957,15238,9206.1,52.84261834920548,49.033382385625785,NaN,NaN,NaN,NaN,0.44052592200699453,19.717825692281355,12595695
2025-09-11T15:35:00-04:00,500.74,500.8,500.55,500.74,NaN,NaN,NaN,501.68138950282577,NaN,NaN,501.0525000000026,502.940739653162,499.16426034684326,500.0690181881254,500.90408723953414,501.99785046913075,499.8103240099375,11210,9099.6,52.603320048528325,49.938711850549744,NaN,NaN,NaN,NaN,0.4269169275779235,20.04459399096415,12584485
2025-09-11T15:40:00-04:00,500.73,500.79,500.42,500.52,NaN,NaN,NaN,501.68138950282577,NaN,NaN,501.00830000000263,502.8400200735088,499.17657992649646,500.0690181881254,500.900960064979,501.9899532522412,499.8119668777168,9213,8987.7,47.50632633709685,50.37261662656971,NaN,NaN,NaN,NaN,0.4228514327509293,19.77399139183395,12575272
2025-09-11T15:45:00-04:00,500.52,500.74,500.45,500.6,NaN,NaN,NaN,501.68138950282577,NaN,NaN,500.9769000000026,502.7815128525755,499.17228714742976,500.0690181881254,500.8953159833964,501.97494341443195,499.8156885523609,18230,9313.833333333334,49.42537336304917,50.61870476884381,NaN,NaN,NaN,NaN,0.41336204469729293,19.522717549784474,12593502
2025-09-11T15:50:00-04:00,500.52,501.6,500.06,501.52,NaN,NaN,NaN,501.68138950282577,NaN,NaN,500.96810000000266,502.7576797125767,499.1785202874286,500.1707498498562,500.90099120008057,501.96227812068724,499.8397042794739,35079,10141,65.18703967828395,52.10719660458905,NaN,NaN,NaN,NaN,0.49383618436177346,21.2728147639692,12628581
2025-09-11T15:55:00-04:00,501.53,502.26,500.64,501.03,499.7294365013776,499.7294365013776,499.7294365013776,NaN,NaN,NaN,500.9679000000027,502.7574497610941,499.1783502389113,500.3065998798849,500.9363372045191,501.9572198904853,499.91545451855285,96289,13069.266666666666,55.30152109868738,52.643386361329526,NaN,NaN,NaN,NaN,0.5742764569073613,23.757926639886353,12532292
2025-09-12T09:30:00-04:00,506.52,506.69,503.85,505.095,502.85582575131497,NaN,NaN,NaN,NaN,NaN,501.03300000000274,503.1513314157863,498.9146685842192,502.2972799039079,505.21166666666664,505.21166666666664,505.21166666666664,91215,15778.2,81.01844798954464,54.52744795951803,NaN,NaN,NaN,NaN,0.9375424242711229,27.97542213502833,12623507
2025-09-12T09:35:00-04:00,505.02,505.82,504.01,505.44,502.85582575131497,NaN,NaN,NaN,NaN,NaN,501.10160000000263,503.54001623755926,498.663183762446,502.2972799039079,505.16534216118237,505.2244199768543,505.10626434551045,56084,17428,81.96674354158408,56.66251233178496,NaN,NaN,NaN,NaN,0.9998608225374713,31.89166795194588,12679591
2025-09-12T09:40:00-04:00,505.48,506.83,505.11,506.76,503.3001635461362,NaN,NaN,NaN,NaN,NaN,501.1816000000027,504.0559085685769,498.30729143142844,502.43465913850105,505.39202783957614,505.831870183562,504.9521854955903,39689,18593.033333333333,85.04519475501215,58.98319238893318,NaN,NaN,NaN,NaN,1.0512993352133642,35.698450007492404,12719280
2025-09-12T09:45:00-04:00,506.68,507.86,506.4,507.31,504.3824288394936,NaN,NaN,NaN,NaN,NaN,501.2700000000026,504.5868485024067,497.95315149759847,503.61372731080087,505.88913590875615,506.77606467640277,505.0022071411095,71455,20471.766666666666,86.10923424362015,61.40666748632922,NaN,NaN,NaN,NaN,1.0804922398409835,39.37311417764588,12790735
2025-09-12T09:50:00-04:00,507.24,508.11,505.3,506.32,504.3824288394936,NaN,NaN,NaN,NaN,NaN,501.34730000000263,504.9397149019355,497.7548850980698,503.61372731080087,506.0151001377942,506.8596456778021,505.1705545977863,57971,22192.266666666666,75.67233886817709,63.338279460364525,NaN,NaN,NaN,NaN,1.2040285084237705,41.022032017191975,12732764
2025-09-12T09:55:00-04:00,506.25,508.08,506.19,507.89,504.3824288394936,NaN,NaN,NaN,NaN,NaN,501.4497000000027,505.4654352536593,497.4339647463461,503.61372731080087,506.20813724797983,507.12485519433255,505.2914193016271,51827,23576.266666666666,79.84452584631565,65.55380666344948,NaN,NaN,NaN,NaN,1.253026472107786,42.55317001105621,12784591
2025-09-12T10:00:00-04:00,508.05,508.37,506.67,507.08,504.3824288394936,NaN,NaN,NaN,NaN,NaN,501.54190000000267,505.84827522138613,497.2355247786192,503.6907083831301,506.35111525514185,507.29101247572424,505.41121803455945,51506,25090.966666666667,72.89827143203951,67.10026693939017,NaN,NaN,NaN,NaN,1.2849531526715146,44.07890052218849,12733085
2025-09-12T10:05:00-04:00,507.08,507.94,507.05,507.44,504.3824288394936,NaN,NaN,NaN,NaN,NaN,501.64450000000267,506.2530321944598,497.0359678055455,503.75156670650404,506.4444134175252,507.39650983157173,505.49231700347866,37938,25872.633333333335,73.98166728264225,68.5287587738419,NaN,NaN,NaN,NaN,1.2567422131949768,45.49565028252561,12771023
2025-09-12T10:10:00-04:00,507.39,507.74,506.62,507.2,504.3824288394936,NaN,NaN,NaN,NaN,NaN,501.7411000000027,506.6019868683987,496.8802131316067,503.8292533652032,506.4832421263253,507.4247199660158,505.5417642866348,25264,26418.9,71.91762339225595,69.8912591340598,NaN,NaN,NaN,NaN,1.246974912252479,46.07943862881043,12745759
2025-09-12T10:15:00-04:00,507.2,507.46,506.79,507.15,504.3824288394936,NaN,NaN,NaN,NaN,NaN,501.83770000000266,506.9273542935135,496.74804570649184,503.9964026921626,506.5149190380425,507.4437782450835,505.5860598310015,24738,27026.3,71.47025674612276,71.23889746960226,NaN,NaN,NaN,NaN,1.205762418520156,46.62152780750347,12721021
2025-09-12T10:20:00-04:00,507.17,507.7,506.61,506.77,504.3824288394936,NaN,NaN,NaN,NaN,NaN,501.92310000000265,507.1943923982075,496.65180760179777,504.38412215373006,506.5357680190862,507.4511170694929,505.62041896867953,21562,27434.4,68.00779302514792,72.70328794732019,NaN,NaN,NaN,NaN,1.1974936743401432,47.253578882028016,12699459
2025-09-12T10:25:00-04:00,506.731,507.38,506.52,507.17,504.3824288394936,NaN,NaN,NaN,NaN,NaN,502.0211000000026,507.49292575997384,496.54927424003137,504.38412215373006,506.55384245411415,507.456776219168,505.6509086890603,20375,27887.566666666666,69.67329878881655,74.149568334875,NaN,NaN,NaN,NaN,1.1733869833158483,47.668794854811395,12719834
2025-09-12T10:30:00-04:00,507.21,508.38,507.15,507.91,504.6142370731111,NaN,NaN,NaN,NaN,NaN,502.1553000000026,507.8639980676484,496.4466019323568,505.29883817838726,506.6290789683776,507.55411232348564,505.70404561326956,34918,28671.6,72.52316847473493,74.6735775346215,NaN,NaN,NaN,NaN,1.1774307702218605,48.57771327973376,12754752
2025-09-12T10:35:00-04:00,507.99,508.4,507.9,508.2,505.07427175160603,NaN,NaN,NaN,NaN,NaN,502.29690000000255,508.24218010676753,496.35161989323757,505.68507054270975,506.72283136384914,507.6917871680176,505.7538755596807,37956,29567.966666666667,73.5713250901278,75.97856353401009,NaN,NaN,NaN,NaN,1.1290428580631562,49.43118966753968,12792708
2025-09-12T10:40:00-04:00,508.21,508.44,507.68,507.86,505.07427175160603,NaN,NaN,NaN,NaN,NaN,502.44070000000255,508.56668922851924,496.31471077148586,505.8880564341678,506.77227223742983,507.7534500340246,505.7910944408351,25205,30257.633333333335,70.19064285583215,75.20514888160207,NaN,NaN,NaN,NaN,1.1026826539157872,49.78588702989036,12767503
2025-09-12T10:45:00-04:00,507.85,508.41,507.28,508.04,505.07427175160603,NaN,NaN,NaN,NaN,NaN,502.5819000000026,508.88947287296844,496.2743271270367,505.8880564341678,506.80637588772504,507.7920178260349,505.82073394941517,20015,30671,70.95166157637536,74.4183573126586,NaN,NaN,NaN,NaN,1.1046338929218062,49.34807637504542,12787518
2025-09-12T10:50:00-04:00,508.1,508.74,507.81,508.68,505.23157970432226,NaN,NaN,NaN,NaN,NaN,502.7371000000026,509.2519384743972,496.222261525608,506.18975611786743,506.861635049194,507.8733538234731,505.84991627491485,23830,30978.633333333335,73.5383916890809,73.59644280794922,NaN,NaN,NaN,NaN,1.092160043427392,49.17579451576319,12811348
2025-09-12T10:55:00-04:00,508.69,509.29,508.55,509.07,505.9140078995804,NaN,NaN,NaN,NaN,NaN,502.90210000000263,509.6288115552377,496.1753884447676,506.87980489429395,506.9563028220076,508.03715782228926,505.87544782172597,32511,31834.566666666666,74.99939009887667,72.80288251189612,NaN,NaN,NaN,NaN,1.0670057546111502,49.37434810882716,12843859
2025-09-12T11:00:00-04:00,509,509.13,508.61,508.66,505.9297348132358,NaN,NaN,NaN,NaN,NaN,503.06510000000264,509.94527979034314,496.18492020966215,506.94184391543513,507.0258634018563,508.1428149955924,505.90891180812025,28389,32522.533333333333,70.58711223268776,72.43965203793258,NaN,NaN,NaN,NaN,1.0279339149960667,49.558719302386564,12815470
2025-09-12T11:05:00-04:00,508.62,509.6,508.53,509.31,506.1124741399069,NaN,NaN,NaN,NaN,NaN,503.24970000000263,510.2929664032674,496.20643359673784,507.3144751323481,507.13155876367205,508.31409511022474,505.94902241711935,39467,33652.63333333333,73.27177323069026,71.97016970824505,NaN,NaN,NaN,NaN,1.030938635353494,50.024063048069856,12854937
2025-09-12T11:10:00-04:00,509.34,509.99,509.32,509.74,506.7439525880929,NaN,NaN,NaN,NaN,NaN,503.43330000000265,510.6626793943453,496.20392060566,507.82158010587847,507.2232591723742,508.4777429240918,505.9687754206566,29519,34340.76666666667,74.90370212009412,72.11341475739182,NaN,NaN,NaN,NaN,1.005871589971102,50.67939126013411,12884456
2025-09-12T11:15:00-04:00,509.77,510.4,509.77,510.09,507.2162729249978,NaN,NaN,NaN,NaN,NaN,503.6295000000027,511.03621431790697,496.2227856820984,508.33526408470277,507.3425949602387,508.6974412478863,505.9877486725912,35723,35252.63333333333,76.17862016900716,72.27033996356074,NaN,NaN,NaN,NaN,0.9811664764017352,51.50515455701182,12920179
2025-09-12T11:20:00-04:00,510.14,510.56,509.87,510.51,507.3825787011343,NaN,NaN,NaN,NaN,NaN,503.8333000000026,511.4230535155805,496.24354648442477,508.56321126776226,507.4230002901999,508.84367776360756,506.0023228167923,23845,35798.566666666666,77.64616247009515,72.67952132626354,NaN,NaN,NaN,NaN,0.9603688709444682,52.35386217169705,12944024
2025-09-12T11:25:00-04:00,510.57,511.3,510.55,510.81,508.1135978510827,NaN,NaN,NaN,NaN,NaN,504.05090000000257,511.80267700579105,496.2991229942141,509.3075690142098,507.58902369752076,509.1603500025452,506.0176973924963,44355,37020.53333333333,78.65756565347753,73.19290053393173,NaN,NaN,NaN,NaN,0.9481996658770077,53.485618734134455,12988379
2025-09-12T11:30:00-04:00,510.72,511.68,510.195,511.3,508.1135978510827,NaN,NaN,NaN,NaN,NaN,504.2759000000026,512.2012344880548,496.3505655119505,509.3435552113678,507.71423621231145,509.3871608702909,506.04131155433197,34648,37667.53333333333,80.23089197817968,74.06597903057686,NaN,NaN,NaN,NaN,0.9865425468857938,54.6904309494497,13023027
2025-09-12T11:35:00-04:00,511.29,511.74,511.24,511.4,508.6668939097675,NaN,NaN,NaN,NaN,NaN,504.50330000000264,512.5793197143925,496.4272802856129,509.62084416909425,507.8716660679378,509.67332165316515,506.0700104827104,42118,38697.8,80.5460806281854,74.84260630481751,NaN,NaN,NaN,NaN,0.9517895078225228,55.833302862939824,13065145
2025-09-12T11:40:00-04:00,511.37,511.78,510.66,510.87,508.6668939097675,NaN,NaN,NaN,NaN,NaN,504.71970000000255,512.8861568588612,496.55324314114387,509.62084416909425,507.9885314007014,509.8573794187628,506.11968338264,37599,39644,73.82771726583547,74.93578836132467,NaN,NaN,NaN,NaN,0.9638045429780532,55.602232026475775,13027546
2025-09-12T11:45:00-04:00,510.84,511.14,510.15,510.46,508.6668939097675,NaN,NaN,NaN,NaN,NaN,504.92410000000257,513.1432585182152,496.70494148178983,509.62084416909425,508.06081599371436,509.9522803163493,506.1693516710794,29794,40029.46666666667,69.03087822826618,74.61147072833455,NaN,NaN,NaN,NaN,0.96567564705105,54.39342028988593,12997752
2025-09-12T11:50:00-04:00,510.54,511.03,510.38,510.68,508.6668939097675,NaN,NaN,NaN,NaN,NaN,505.13710000000253,513.3898173917247,496.8843826082803,509.62084416909425,508.1083036967462,510.01515914159734,506.20144825189504,19622,39514.23333333333,70.15155637557666,74.60867883688773,NaN,NaN,NaN,NaN,0.9431273865474019,53.270952248766775,13017374
2025-09-12T11:55:00-04:00,510.76,511.37,510.63,511.23,508.6668939097675,NaN,NaN,NaN,NaN,NaN,505.36570000000256,513.6475727367482,497.0838272632569,509.62084416909425,508.1542831447424,510.0814947888442,506.2270715006406,17136,36875.8,72.80141673650085,74.74080420546814,NaN,NaN,NaN,NaN,0.9286182875083024,52.51721980943568,13034510
2025-09-12T12:00:00-04:00,511.22,511.325,510.7,510.93,508.6668939097675,NaN,NaN,NaN,NaN,NaN,505.58470000000256,513.8644358428705,497.3049641571346,509.62084416909425,508.20911463051715,510.15703839715167,506.26119086388263,21852,34563.7,69.19307882069836,74.43042471486937,NaN,NaN,NaN,NaN,0.9069312669719951,51.81732540148537,13012658
2025-09-12T12:05:00-04:00,510.92,511.59,510.84,511.31,508.6668939097675,NaN,NaN,NaN,NaN,NaN,505.81050000000255,514.0866788880986,497.5343211119065,509.62084416909425,508.26361534305363,510.23564601760546,506.2915846685018,20611,33381.26666666667,71.14404545214991,74.15504295438889,NaN,NaN,NaN,NaN,0.8957218907597098,51.39738342755199,13033269
2025-09-12T12:10:00-04:00,511.3,511.62,511.04,511.38,508.6668939097675,NaN,NaN,NaN,NaN,NaN,506.03610000000253,514.292268430194,497.7799315698111,509.75401857109046,508.324202135982,510.3231026670299,506.32530160493405,23027,32825.86666666667,71.50207096170998,74.22039714931906,NaN,NaN,NaN,NaN,0.8731703271340151,51.0337172710109,13056296
2025-09-12T12:15:00-04:00,511.49,512.23,511.44,511.79,509.164057543667,NaN,NaN,NaN,NaN,NaN,506.2649000000025,514.5121401412766,498.0176598587284,510.31221485687234,508.4125745883362,510.46091990265575,506.3642292740167,30390,31457.033333333333,73.57048828318158,74.24173393878273,NaN,NaN,NaN,NaN,0.8715153037673014,51.19344738623328,13086686
2025-09-12T12:20:00-04:00,511.79,511.89,511.31,511.75,509.164057543667,NaN,NaN,NaN,NaN,NaN,506.4951000000026,514.6992424870305,498.29095751297467,510.31221485687234,508.47649587372365,510.553929555881,506.3990621915663,24214,30331.8,73.01370006012556,74.1067337916421,NaN,NaN,NaN,NaN,0.8506927820696358,51.02531130223304,13062472
2025-09-12T12:25:00-04:00,511.7,512.07,511.56,511.91,509.23631069577925,NaN,NaN,NaN,NaN,NaN,506.72470000000254,514.8794498813759,498.5699501186292,510.3556175083983,508.5037436965705,510.59465866476216,506.4128287283788,9996,28937.433333333334,73.86570453111958,73.94152553179299,NaN,NaN,NaN,NaN,0.8263575833503796,51.020185648086134,13072468
2025-09-12T12:30:00-04:00,511.91,512.05,511.7,511.88,509.36579657324376,NaN,NaN,NaN,NaN,NaN,506.9451000000026,515.0494342692358,498.8407657307694,510.5034940067186,508.5468515680936,510.65862592998695,506.4350772062002,16006,27754.1,73.39778899654358,73.63807028368215,NaN,NaN,NaN,NaN,0.7923320416824929,51.01542611209256,13056462
2025-09-12T12:35:00-04:00,511.94,512.2,511.82,512.05,509.5630330926418,NaN,NaN,NaN,NaN,NaN,507.1719000000001,515.1999236395629,499.1438763604373,510.77279520537496,508.5812104067003,510.7104786324883,506.4519421809123,12501,26906.2,74.38789620526691,73.33309389452425,NaN,NaN,NaN,NaN,0.7628797529908901,51.14554107769875,13068963
2025-09-12T12:40:00-04:00,512.04,512.44,512,512.28,509.82425886115806,NaN,NaN,NaN,NaN,NaN,507.40270000000004,515.3408330826402,499.46456691735995,511.07823616429994,508.6412851993205,510.8035834306246,506.47898696801644,21115,26767.9,75.70535961296096,73.00984158272291,NaN,NaN,NaN,NaN,0.7398169134915447,51.47543882894766,13090078
2025-09-12T12:45:00-04:00,512.27,512.4,511.75,511.85,509.82425886115806,NaN,NaN,NaN,NaN,NaN,507.62530000000015,515.4243610740871,499.82623892591323,511.07823616429994,508.6893392171502,510.872852464502,506.50582596979837,18666,26565.5,68.60064243745052,72.15659599767041,NaN,NaN,NaN,NaN,0.7334014196707184,51.05757813240888,13071412
2025-09-12T12:50:00-04:00,511.82,512.16,511.77,512.11,509.82425886115806,NaN,NaN,NaN,NaN,NaN,507.8569,515.4852903648097,500.2285096351903,511.07823616429994,508.7362974752654,510.93953599996127,506.53305895056957,18695,26469.933333333334,70.40894144750956,71.91239772493284,NaN,NaN,NaN,NaN,0.7088727468370947,50.66956462848001,13090107
2025-09-12T12:55:00-04:00,512.13,512.54,512.09,512.32,510.0384364493976,NaN,NaN,NaN,NaN,NaN,508.0925,515.5276119021963,500.65738809780356,511.2537769161215,508.78286309015493,511.00899878496523,506.55672739534464,17438,26372.033333333333,71.82054487333993,72.11165962815241,NaN,NaN,NaN,NaN,0.6903818363487259,50.70904707469593,13107545
2025-09-12T13:00:00-04:00,512.29,512.3,511.7,511.84,510.0384364493976,NaN,NaN,NaN,NaN,NaN,508.31610000000006,515.5122821237093,501.1199178762909,511.2537769161215,508.812183738052,511.0486224880462,506.5757449880578,12542,25626.166666666668,64.27328466790058,71.69178307760411,NaN,NaN,NaN,NaN,0.6853545623238213,49.64236115440471,13095003
2025-09-12T13:05:00-04:00,511.91,512.05,511.3,511.34,510.0384364493976,NaN,NaN,NaN,NaN,NaN,508.5269,515.4420621497771,501.6117378502229,511.2537769161215,508.85150476832126,511.09578718505605,506.6072223515865,19623,25015.066666666666,57.49549768138801,70.59850314509606,NaN,NaN,NaN,NaN,0.6899720935864014,47.66860073773081,13075380
2025-09-12T13:10:00-04:00,511.36,511.69,511.33,511.38,510.0384364493976,NaN,NaN,NaN,NaN,NaN,508.7395,515.3312731300385,502.14772686996145,511.2537769161215,508.8722345258397,511.1196018719508,506.6248671797286,10970,24540.566666666666,57.878180718071945,69.7902961377656,NaN,NaN,NaN,NaN,0.6664026583302309,45.83582320796219,13086350
2025-09-12T13:15:00-04:00,511.38,511.56,511.28,511.44,510.0384364493976,NaN,NaN,NaN,NaN,NaN,508.9535000000001,515.1770315535138,502.72996844648634,511.2537769161215,508.8865765859952,511.13573927138344,506.637413900607,7814,24133.866666666665,58.48201324622213,68.88586526591361,NaN,NaN,NaN,NaN,0.6388024684495023,44.007721277381684,13094164
2025-09-12T13:20:00-04:00,511.48,512.37,511.4,512.31,510.0384364493976,NaN,NaN,NaN,NaN,NaN,509.18930000000006,514.9963054278991,503.3822945721011,511.2537769161215,508.9192641348129,511.1792743162152,506.65925395341065,14640,23827.533333333333,66.07598984023042,68.49828804295079,NaN,NaN,NaN,NaN,0.6624594349888255,43.459447280753764,13108804
2025-09-12T13:25:00-04:00,512.33,512.4,512.01,512.01,510.074060191256,NaN,NaN,NaN,NaN,NaN,509.4175000000001,514.7323314178137,504.1026685821865,511.2537769161215,508.9406616976744,511.20829713089205,506.6730262644567,9406,23057.366666666665,61.87333993206338,67.66277744644233,NaN,NaN,NaN,NaN,0.642998046775337,42.98663554250702,13099398
2025-09-12T13:30:00-04:00,512.05,512.14,511.5,511.58,510.074060191256,NaN,NaN,NaN,NaN,NaN,509.6187000000001,514.4632824628784,504.7741175371218,511.2537769161215,508.9673060220539,511.24043237769575,506.694179666412,13605,22564.566666666666,56.34184539629554,66.4719306847402,NaN,NaN,NaN,NaN,0.6427839005770977,41.301375156150385,13085793
2025-09-12T13:35:00-04:00,511.6,512.2,511.6,511.98,510.074060191256,NaN,NaN,NaN,NaN,NaN,509.8377000000001,514.0594215492767,505.6159784507235,511.2537769161215,509.0134644770471,511.2984105916602,506.728518362434,22648,22003.933333333334,59.93048035141197,65.47655752904679,NaN,NaN,NaN,NaN,0.6411564791073093,39.8280199542593,13108441
2025-09-12T13:40:00-04:00,512.07,512.21,511.8,512.13,510.074060191256,NaN,NaN,NaN,NaN,NaN,509.97839999999997,514.0237259151967,505.9330740848032,511.2537769161215,509.02589056903753,511.3143674537554,506.7374136843197,5973,21219.066666666666,61.217874317088146,64.6065636233714,NaN,NaN,NaN,NaN,0.6246453020282176,38.476025610113744,13114414
2025-09-12T13:45:00-04:00,512.14,512.22,511.66,511.76,510.074060191256,NaN,NaN,NaN,NaN,NaN,510.10479999999995,513.9657475314154,506.24385246858446,511.04288353589976,509.04589252099044,511.3387317441987,506.7530532977822,10290,20371.3,56.40392199482828,63.321994036911505,NaN,NaN,NaN,NaN,0.6200277804547737,36.86539483604649,13104124
2025-09-12T13:50:00-04:00,511.77,511.83,511.16,511.67,510.074060191256,NaN,NaN,NaN,NaN,NaN,510.20300000000003,513.9672151904578,506.43878480954237,511.04288353589976,509.068984859302,511.36377583419073,506.7741938844133,13648,20031.4,55.2655004273186,61.862004095079904,NaN,NaN,NaN,NaN,0.6235972247080012,34.23875512270049,13090476
2025-09-12T13:55:00-04:00,511.67,511.97,511.55,511.78,510.074060191256,NaN,NaN,NaN,NaN,NaN,510.2924,513.9892560913776,506.5955439086224,511.04288353589976,509.08992098053733,511.38801530013507,506.7918266609396,11591,18939.266666666666,56.42316918516526,60.992184577059525,NaN,NaN,NaN,NaN,0.6090545658002879,32.082031964834336,13102067
2025-09-12T14:00:00-04:00,511.84,511.85,511.08,511.1,510.074060191256,NaN,NaN,NaN,NaN,NaN,510.388,513.9121974973409,506.8638025026591,511.04288353589976,509.1102448243724,511.4078501468912,506.8126395018536,13593,18237.433333333334,48.131010243016895,59.40090377673863,NaN,NaN,NaN,NaN,0.6205506682431273,30.431447639068015,13088474
2025-09-12T14:05:00-04:00,511.11,511.37,511.06,511.35,510.074060191256,NaN,NaN,NaN,NaN,NaN,510.4572,513.9177850141543,506.9966149858457,511.04288353589976,509.1323496155512,511.42837671286657,506.8363225182359,15658,17355.433333333334,50.98315321041507,57.91251865795829,NaN,NaN,NaN,NaN,0.5983684776543327,28.935831333286067,13104132
2025-09-12T14:10:00-04:00,511.35,511.52,511.06,511.27,510.074060191256,NaN,NaN,NaN,NaN,NaN,510.541,513.8708606577641,507.2111393422359,511.04288353589976,509.1560298447073,511.4503878713157,506.8616718180989,16951,16667.166666666668,50.03501382434299,56.89549931198989,NaN,NaN,NaN,NaN,0.5884850149647359,27.202753589692964,13087181
2025-09-12T14:15:00-04:00,511.26,511.29,510.67,510.98,510.074060191256,NaN,NaN,NaN,NaN,NaN,510.6118,513.8233483866879,507.40025161331204,510.8578850963045,509.1943456315458,511.4794968357969,506.90919442729466,33039,16775.333333333332,46.648332639184396,56.12070180897534,NaN,NaN,NaN,NaN,0.5907360853243979,26.340663270504212,13054142
2025-09-12T14:20:00-04:00,511.05,511.3,511.03,511.21,510.074060191256,NaN,NaN,NaN,NaN,NaN,510.69199999999995,513.755610941426,507.628389058574,510.8578850963045,509.21323080551537,511.4956405349648,506.9308210760659,15102,16624.666666666668,49.56411089906671,55.52683967904638,NaN,NaN,NaN,NaN,0.5713977935155119,25.515306616030113,13069244
2025-09-12T14:25:00-04:00,511.25,511.44,511.09,511.29,510.074060191256,NaN,NaN,NaN,NaN,NaN,510.77479999999997,513.6701818125351,507.87941818746475,510.8578850963045,509.2280563388414,511.50889545553804,506.94721722214473,11510,16437.133333333335,50.57590480350129,54.962117647423476,NaN,NaN,NaN,NaN,0.5555836654072627,24.391729669568182,13080754
2025-09-12T14:30:00-04:00,511.26,511.55,511,511.44,510.074060191256,NaN,NaN,NaN,NaN,NaN,510.8682,513.5329076838425,508.20349231615745,510.8578850963045,509.25033160863984,511.5292396459977,506.971423571282,17131,16279.766666666666,52.50002293849017,53.9924057258706,NaN,NaN,NaN,NaN,0.5551848321638876,23.06962592892586,13097885
2025-09-12T14:35:00-04:00,511.46,511.86,511.33,511.78,510.074060191256,NaN,NaN,NaN,NaN,NaN,510.9604,513.4178456983541,508.50295430164584,510.6309138614008,509.2774774485213,511.5577011209924,506.99725377605023,18444,16207.533333333333,56.62225397176256,53.61732815727769,NaN,NaN,NaN,NaN,0.5533859155807549,21.738178150428872,13116329
2025-09-12T14:40:00-04:00,511.78,511.93,511.55,511.81,510.074060191256,NaN,NaN,NaN,NaN,NaN,511.0384,513.3466577326004,508.73014226739963,510.75673108912065,509.29580698108447,511.57754108535624,507.0140728768127,12145,15844.8,56.97703977939433,53.66269918464189,NaN,NaN,NaN,NaN,0.5410012073249864,20.65976082842209,13128474
2025-09-12T14:45:00-04:00,511.81,512.06,511.43,511.61,510.074060191256,NaN,NaN,NaN,NaN,NaN,511.1066,513.2724868299644,508.9407131700357,510.8063848712965,509.3249986925385,511.60807246565116,507.0419249194258,20245,15506.633333333333,53.81686518130524,53.22601238677713,NaN,NaN,NaN,NaN,0.5473582639446258,19.953275453245915,13108229
2025-09-12T14:50:00-04:00,511.62,512.3,511.61,512.05,510.1303884870733,NaN,NaN,NaN,NaN,NaN,511.1904,513.1629474290115,509.2178525709885,510.95210789703725,509.35308220676546,511.6403052730181,507.0658591405128,17780,15292.166666666666,59.180795167012285,53.080506733200274,NaN,NaN,NaN,NaN,0.5575469593771484,19.81235058464648,13126009
2025-09-12T14:55:00-04:00,512.09,512.23,511.88,512.17,510.2655981012973,NaN,NaN,NaN,NaN,NaN,511.273,513.0468150973365,509.4991849026635,510.9766863176298,509.3737301927586,511.6646088001138,507.08285158540343,12794,15385.433333333332,60.527305582924605,53.37503413235002,NaN,NaN,NaN,NaN,0.5427221765644965,19.681491778089864,13138803
2025-09-12T15:00:00-04:00,512.13,512.5,512.08,512.26,510.5246618239655,NaN,NaN,NaN,NaN,NaN,511.34460000000007,512.9773753548328,509.7118246451674,511.28734905410386,509.4037391163192,511.7016182146005,507.10586001803784,17715,15442.4,61.55170244210334,53.8240485619775,NaN,NaN,NaN,NaN,0.5339563068098867,20.11880571578383,13156518
2025-09-12T15:05:00-04:00,512.25,512.35,512.1,512.19,510.5246618239655,NaN,NaN,NaN,NaN,NaN,511.40700000000004,512.9214807689239,509.8925192310762,511.28734905410386,509.42803439390536,511.73069770132724,507.1253710864835,14965,15524.533333333333,60.24218173075971,54.096835172377105,NaN,NaN,NaN,NaN,0.5136737134663234,20.52488294364251,13141553
2025-09-12T15:10:00-04:00,512.18,512.39,511.9,511.9,510.5246618239655,NaN,NaN,NaN,NaN,NaN,511.47180000000003,512.7728069329859,510.17079306701424,511.28734905410386,509.46178998137736,511.76877030588446,507.15480965687027,22455,15569.2,55.01971941728706,54.58888582768212,NaN,NaN,NaN,NaN,0.5119827339330152,20.221368924045596,13119098
2025-09-12T15:15:00-04:00,511.885,512.1,511.695,511.78,510.5246618239655,NaN,NaN,NaN,NaN,NaN,511.5212,512.6686259190086,510.37377408099144,511.28734905410386,509.50243286669047,511.8106032538714,507.1942624795095,30243,15955.1,52.97327761176849,54.73103757063593,NaN,NaN,NaN,NaN,0.5043411100806591,19.298744407608588,13088855
2025-09-12T15:20:00-04:00,511.77,511.78,510.98,511.09,510.5246618239655,NaN,NaN,NaN,NaN,NaN,511.54820000000007,512.5848923552653,510.5115076447348,511.28734905410386,509.51975216818136,511.82331093577733,507.2161934005854,17513,15915.7,43.05646834488146,54.23257003638868,NaN,NaN,NaN,NaN,0.5254596022177516,19.12061525045196,13071342
2025-09-12T15:25:00-04:00,511.1,511.12,510.33,510.66,NaN,NaN,NaN,512.4725755506176,512.4725755506176,512.4725755506176,511.55960000000005,512.5430710770754,510.5761289229247,511.28734905410386,509.5354830988681,511.82769326359795,507.24327293413825,24257,16143,38.25074208829959,53.6327421398969,NaN,NaN,NaN,NaN,0.5443553449164851,20.026687831086104,13047085
2025-09-12T15:30:00-04:00,510.63,510.83,510.27,510.77,NaN,NaN,NaN,512.2945039346804,NaN,NaN,511.5648000000001,512.5285695986446,510.6010304013556,511.28734905410386,509.5521471365105,511.8306536190286,507.27364065399235,28392,16671.333333333332,40.092821724349534,52.956221484559954,NaN,NaN,NaN,NaN,0.5454728202795934,20.953812144626387,13075477
2025-09-12T15:35:00-04:00,510.8,510.94,510.45,510.59,NaN,NaN,NaN,512.2945039346804,NaN,NaN,511.5604000000001,512.5397954050399,510.5810045949603,511.28734905410386,509.56583871168283,511.8335272865464,507.29815013681923,23193,16790.333333333332,38.09039497485985,52.06439935394271,NaN,NaN,NaN,NaN,0.5415104759739088,21.495522877548698,13052284
2025-09-12T15:40:00-04:00,510.59,510.9,510.29,510.67,NaN,NaN,NaN,512.2945039346804,NaN,NaN,511.5478000000001,512.5560562369791,510.53954376302113,511.28734905410386,509.5798710798267,511.83565347652717,507.32408868312626,25318,17268.6,39.535803027488114,51.138383646014,NaN,NaN,NaN,NaN,0.5464025848329122,22.253745978172297,13077602
2025-09-12T15:45:00-04:00,510.62,510.76,510.42,510.7,NaN,NaN,NaN,512.2939125600184,NaN,NaN,511.5338000000001,512.5689571085315,510.49864289146865,511.28734905410386,509.5932389640854,511.837651280276,507.3488266478948,24603,17828.233333333334,40.10057230101256,49.95826352667471,NaN,NaN,NaN,NaN,0.531659543059131,22.95781028589421,13102205
2025-09-12T15:50:00-04:00,510.72,511.09,510.4,510.88,NaN,NaN,NaN,512.2939125600184,NaN,NaN,511.5340000000001,512.5686477659256,510.4993522340746,511.2689033946265,509.62543144775816,511.84790145483674,507.4029614406796,53257,19115.466666666667,43.50999107657093,48.99633147647303,NaN,NaN,NaN,NaN,0.5429695756977643,22.603596574143083,13155462
2025-09-12T15:55:00-04:00,510.87,510.93,509.87,509.89,NaN,NaN,NaN,512.1868914028266,NaN,NaN,511.52260000000007,512.6152650720014,510.4299349279988,511.2689033946265,509.64743025730877,511.8320255877226,507.4628349268949,74762,21294,32.539691649416014,47.47653336705237,NaN,NaN,NaN,NaN,0.5799003202907812,23.188073812295272,13080700
2025-09-15T09:30:00-04:00,508.79,511.44,507.02,509.28,NaN,NaN,NaN,511.5383963390618,NaN,NaN,511.49460000000005,512.7340851187901,510.2551148812101,511.0006227157012,509.24666666666667,509.24666666666667,509.24666666666667,58384,22786.633333333335,27.875913169290072,45.240470367215075,NaN,NaN,NaN,NaN,0.8541931545557266,26.07680771811573,13022316
2025-09-15T09:35:00-04:00,509.29,510.36,509,509.53,NaN,NaN,NaN,511.5383963390618,NaN,NaN,511.4606000000001,512.8151739402163,510.10602605978397,510.5004981725609,509.4008602943184,509.5888280640267,509.21289252461014,39288,23341.3,32.16693550956752,43.214729647689566,NaN,NaN,NaN,NaN,0.8903222149446043,28.759203487806158,13061604
2025-09-15T09:40:00-04:00,509.6,510.87,509.6,509.94,NaN,NaN,NaN,511.5383963390618,NaN,NaN,511.4408000000001,512.8535127944218,510.0280872055783,509.7088246729478,509.59897238494983,509.96276173684447,509.2351830330552,35987,24341.766666666666,38.616906362010326,41.57652992768293,NaN,NaN,NaN,NaN,0.9224420567342777,30.20214237147786,13097591
2025-09-15T09:45:00-04:00,510,511.5,510,510.675,NaN,NaN,NaN,511.5383963390618,NaN,NaN,511.42810000000014,512.8566165589901,509.99958344101015,509.7088246729478,509.8681905258005,510.44383796885563,509.2925430827454,41997,25398.666666666668,48.1373870026231,40.711901732816024,NaN,NaN,NaN,NaN,0.9679819098246866,30.408230604057223,13139588
2025-09-15T09:50:00-04:00,510.685,511.7,510.42,510.84,508.4381589866766,508.4381589866766,508.4381589866766,NaN,NaN,NaN,511.4173000000001,512.8552418762312,509.97935812376915,509.7088246729478,509.97467502665626,510.613097559519,509.3362524937935,18483,25559.833333333332,50.011773383880424,40.35419130185841,NaN,NaN,NaN,NaN,0.9902689162657784,30.265456744673813,13158071
2025-09-15T09:55:00-04:00,510.74,510.8,509.87,510.21,508.4381589866766,NaN,NaN,NaN,NaN,NaN,511.38570000000016,512.8585122891835,509.9128877108168,509.7088246729478,510.0093620086328,510.62015385677535,509.3985701604903,23714,25963.933333333334,43.541152760941074,39.68046809822788,NaN,NaN,NaN,NaN,0.9888211365325065,30.615006021017926,13134357
2025-09-15T10:00:00-04:00,510.28,511.95,510.28,511.92,508.4381589866766,NaN,NaN,NaN,NaN,NaN,511.38910000000016,512.8660396599831,509.9121603400172,509.7088246729478,510.1277700526012,510.8274734224818,509.4280666827206,20545,26195.666666666668,59.034161758132726,40.821731913460106,NaN,NaN,NaN,NaN,1.042476769637328,29.24891869414313,13154902
2025-09-15T10:05:00-04:00,511.93,512.14,511.18,511.75,508.90175999019647,NaN,NaN,NaN,NaN,NaN,511.38590000000016,512.858999711234,509.9128002887663,509.7088246729478,510.23446917232707,511.0164221077513,509.45251623690285,17476,26256.266666666666,57.34928074471906,42.185913246061496,NaN,NaN,NaN,NaN,1.0365855718060888,27.73977168461124,13137426
2025-09-15T10:10:00-04:00,511.77,512.39,511.46,512.04,509.16531635427845,NaN,NaN,NaN,NaN,NaN,511.38910000000016,512.8671658847097,509.9110341152906,509.30968834306674,510.362852187116,511.2412140395806,509.4844903346514,20525,26375.4,59.474147745919545,43.57029367617365,NaN,NaN,NaN,NaN,1.028972316677083,26.02131814684285,13157951
2025-09-15T10:15:00-04:00,512.07,512.09,510.7,511.3,509.16531635427845,NaN,NaN,NaN,NaN,NaN,511.37410000000017,512.8402073492607,509.90799265073963,509.30968834306674,510.40912325771853,511.2922936821133,509.52595283332374,13403,25720.866666666665,52.31226332152164,44.586141415220915,NaN,NaN,NaN,NaN,1.0547600083430086,25.240847439185586,13144548
2025-09-15T10:20:00-04:00,511.32,511.95,510.42,510.65,509.16531635427845,NaN,NaN,NaN,NaN,NaN,511.34150000000017,512.7980414513986,509.8849585486018,509.30968834306674,510.43505846930145,511.3073891557247,509.5627277828782,13149,25655.766666666666,46.96269860408187,45.116633956406176,NaN,NaN,NaN,NaN,1.0887057220327918,24.788447755359822,13131399
2025-09-15T10:25:00-04:00,510.655,511.39,510.53,510.66,509.16531635427845,NaN,NaN,NaN,NaN,NaN,511.3177000000002,512.7791091964474,509.8562908035529,509.30968834306674,510.45449379103394,511.3112541513535,509.59773343071436,14520,25756.1,47.05240687480599,45.613193568819995,NaN,NaN,NaN,NaN,1.0723695990304505,24.36836233466447,13145919
2025-09-15T10:30:00-04:00,510.71,511.25,510.33,510.72,509.16531635427845,NaN,NaN,NaN,NaN,NaN,511.2899000000002,512.7428232461428,509.8369767538576,509.30968834306674,510.4675695337256,511.30852324210576,509.6266158253455,13879,25647.7,47.62482384015625,45.90711019479038,NaN,NaN,NaN,NaN,1.0614860562425623,24.18601890963031,13159798
2025-09-15T10:35:00-04:00,510.72,511.95,510.56,511.43,509.16531635427845,NaN,NaN,NaN,NaN,NaN,511.27210000000014,512.695616898283,509.84858310171734,509.30968834306674,510.51918273186254,511.35884595833636,509.6795195053887,21535,25750.733333333334,53.96685925274669,47.43762216645685,NaN,NaN,NaN,NaN,1.0849513379395213,22.980555041354236,13181333
2025-09-15T10:40:00-04:00,511.59,512.3,511.59,512.1,509.16531635427845,NaN,NaN,NaN,NaN,NaN,511.2773000000002,512.7109404150083,509.8436595849921,509.44587318100486,510.59465764678043,511.47490493512674,509.7144103584341,18997,25979.133333333335,59.01083898102369,49.661545438723536,NaN,NaN,NaN,NaN,1.0695976709438375,21.399325781283913,13200330
2025-09-15T10:45:00-04:00,512.1,512.28,511.5,512.07,509.16531635427845,NaN,NaN,NaN,NaN,NaN,511.29190000000017,512.7425645234287,509.8412354765716,509.6066985448039,510.642356082678,511.54232227807216,509.7423898872839,13565,25756.466666666667,58.700685234309226,51.55681327620509,NaN,NaN,NaN,NaN,1.0489121230192757,20.04728675200753,13186765
2025-09-15T10:50:00-04:00,512.06,512.24,511.81,512.05,509.1980125623517,NaN,NaN,NaN,NaN,NaN,511.3053000000002,512.7712691809035,509.83933081909703,509.88635883584317,510.6837490256392,511.6011911812684,509.76630687001,11822,25557.866666666665,58.480013792106504,52.975606664069105,NaN,NaN,NaN,NaN,1.004704114232185,18.79182193910803,13174943
2025-09-15T10:55:00-04:00,512.06,512.5,511.98,512.47,509.4706029004267,NaN,NaN,NaN,NaN,NaN,511.32590000000016,512.8273788575411,509.82442114245913,510.3570870686745,510.7363225412215,511.6837849033353,509.7888601791077,13216,25571.933333333334,61.733339215937434,53.946746107877274,NaN,NaN,NaN,NaN,0.9700823917870277,17.65457431227348,13188159
2025-09-15T11:00:00-04:00,512.47,513.17,512.47,513.15,510.0810300413163,NaN,NaN,NaN,NaN,NaN,511.3427000000001,512.905396656391,509.7800033436092,511.1056696549396,510.8443871471563,511.8830614175855,509.80571287672706,21269,25690.4,66.3329368862024,55.112543500900266,NaN,NaN,NaN,NaN,0.9507907923736637,17.475298050147302,13209428
2025-09-15T11:05:00-04:00,513.15,513.76,513.12,513.47,510.73825594852934,NaN,NaN,NaN,NaN,NaN,511.37190000000015,513.0347347962595,509.70906520374086,511.7885357239517,510.9585347278357,512.1056949586477,509.8113744970236,19781,25850.933333333334,68.2660159903731,56.87860516014541,NaN,NaN,NaN,NaN,0.9285914500612582,17.957465912839485,13229209
2025-09-15T11:10:00-04:00,513.49,514.25,513.38,513.43,511.11742613268706,NaN,NaN,NaN,NaN,NaN,511.40890000000013,513.1681444854523,509.649655514548,512.2378285791614,511.0762570972257,512.3278537286504,509.824660465801,20363,25781.2,67.7424158311475,57.50062330821789,NaN,NaN,NaN,NaN,0.9244063464854543,18.87799294131171,13208846
2025-09-15T11:15:00-04:00,513.43,513.81,512.99,513.03,511.11742613268706,NaN,NaN,NaN,NaN,NaN,511.4299000000002,513.2402375263692,509.61956247363116,512.2378285791614,511.11317732087923,512.3860036062124,509.84035103554606,8053,25041.533333333333,62.573820101376725,57.8738046908363,NaN,NaN,NaN,NaN,0.9169487503079173,19.081729208841928,13200793
2025-09-15T11:20:00-04:00,513.07,513.17,512.1,512.23,511.11742613268706,NaN,NaN,NaN,NaN,NaN,511.43190000000016,513.2455448273365,509.6182551726638,512.2378285791614,511.17738051806026,512.454095425144,509.9006656109765,23298,25234.366666666665,53.74217162572921,57.46437782510842,NaN,NaN,NaN,NaN,0.9278809824287758,17.99995770045448,13177495
2025-09-15T11:25:00-04:00,512.29,513.09,512.23,512.48,511.11742613268706,NaN,NaN,NaN,NaN,NaN,511.4463000000002,513.2814422941159,509.6111577058845,512.2378285791614,511.23189025097133,512.5133427064344,509.95043779550826,20051,25094.166666666668,55.839736798690154,57.71634021633474,NaN,NaN,NaN,NaN,0.9230323408267214,16.99545558552328,13197546
2025-09-15T11:30:00-04:00,512.49,513.37,512.49,513.31,511.11742613268706,NaN,NaN,NaN,NaN,NaN,511.4791000000002,513.386273500108,509.57192649989236,512.2378285791614,511.2570972900137,512.5473679360875,509.96682664393984,7330,24392.1,62.00045551957501,58.790465710298534,NaN,NaN,NaN,NaN,0.920672887910526,16.410127501186423,13204876
2025-09-15T11:35:00-04:00,513.27,513.8,513.07,513.8,511.11742613268706,NaN,NaN,NaN,NaN,NaN,511.5195000000003,513.5330702121452,509.5059297878554,512.2378285791614,511.2893742567597,512.5988063472613,509.97994216625807,7554,23870.8,65.0962654936077,60.07931275449865,NaN,NaN,NaN,NaN,0.9070533959169103,16.369952040081763,13212430
2025-09-15T11:40:00-04:00,513.81,514,512.98,513.05,511.11742613268706,NaN,NaN,NaN,NaN,NaN,511.55850000000027,513.613176860062,509.5038231399385,512.2378285791614,511.34553838929304,512.6796792717495,510.0113975068366,15130,23531.2,57.389405066166375,60.776782842070816,NaN,NaN,NaN,NaN,0.9151210104942725,16.556618685740883,13197300
2025-09-15T11:45:00-04:00,513.04,513.5,512.93,513.17,511.11742613268706,NaN,NaN,NaN,NaN,NaN,511.5949000000002,513.6974398829844,509.492360117016,512.2378285791614,511.3713659930841,512.7138903024318,510.02884168373646,7815,22971.6,58.24127504878829,61.082098256073785,NaN,NaN,NaN,NaN,0.8904695097446852,16.645540036273573,13205115
2025-09-15T11:50:00-04:00,513.2,513.2,512.7,513.01,511.11742613268706,NaN,NaN,NaN,NaN,NaN,511.62970000000024,513.7668910628925,509.492508937108,512.2378285791614,511.3957431290926,512.7423178656022,510.04916839258294,8689,21486,56.61603109719795,60.911040550086234,NaN,NaN,NaN,NaN,0.8625788304772077,16.33351442127658,13196426
2025-09-15T11:55:00-04:00,513.01,513.26,512.54,513.14,511.11742613268706,NaN,NaN,NaN,NaN,NaN,511.67290000000025,513.8428844145542,509.5029155854463,512.2378285791614,511.41985102274407,512.7701408811415,510.0695611643466,8805,19287.433333333334,57.65009685878907,60.83599852326336,NaN,NaN,NaN,NaN,0.8523946283002662,15.771585409224459,13205231
2025-09-15T12:00:00-04:00,513.1,513.38,512.56,512.85,511.11742613268706,NaN,NaN,NaN,NaN,NaN,511.7057000000002,513.8961867129372,509.5152132870633,511.8120765350558,511.4375808558084,512.7897409347729,510.0854207768439,6874,17570.433333333334,54.52778645985967,60.553696570960014,NaN,NaN,NaN,NaN,0.8500807262788223,15.424241019543276,13198357
2025-09-15T12:05:00-04:00,512.8,513.16,512.55,512.6,511.11742613268706,NaN,NaN,NaN,NaN,NaN,511.7319000000002,513.9331822535297,509.5306177464708,511.8120765350558,511.4497104440411,512.8016377001294,510.0977831879528,5379,16440.133333333335,51.917337875531835,59.8525536180739,NaN,NaN,NaN,NaN,0.8329321029731931,15.082782910493767,13192978
2025-09-15T12:10:00-04:00,512.555,512.75,512.25,512.31,511.11742613268706,NaN,NaN,NaN,NaN,NaN,511.7493000000003,513.9548276101866,509.54377238981397,511.8120765350558,511.46811192843273,512.8140142763809,510.12220958048454,11226,15614.766666666666,48.98761689521547,58.61360219014626,NaN,NaN,NaN,NaN,0.8091512384751078,14.19948277892448,13181752
2025-09-15T12:15:00-04:00,512.29,512.78,512.25,512.46,511.11742613268706,NaN,NaN,NaN,NaN,NaN,511.7629000000003,513.977385122866,509.5484148771345,511.8120765350558,511.48002087864865,512.8226253271165,510.1374164301808,7053,14449.966666666667,50.542243870221725,57.3476184672783,NaN,NaN,NaN,NaN,0.7892118642983125,13.432480530274118,13188805
2025-09-15T12:20:00-04:00,512.61,512.75,512.46,512.55,511.11742613268706,NaN,NaN,NaN,NaN,NaN,511.77770000000027,514.0031107125621,509.55228928743844,511.8120765350558,511.48978407099503,512.8304528478347,510.1491152941553,5422,14014.6,51.49735076637702,56.18725667693756,NaN,NaN,NaN,NaN,0.7535538739912876,12.720264156527355,13194227
2025-09-15T12:25:00-04:00,512.51,512.73,512.18,512.37,511.11742613268706,NaN,NaN,NaN,NaN,NaN,511.7929000000003,514.0238962705645,509.56190372943615,511.8120765350558,511.500099414941,512.836946759751,510.1632520701311,6842,13452.2,49.44089862515158,55.24919085720718,NaN,NaN,NaN,NaN,0.7390143115633433,12.130038890927256,13187385
2025-09-15T12:30:00-04:00,512.4,512.97,512.23,512.79,511.11742613268706,NaN,NaN,NaN,NaN,NaN,511.80770000000024,514.0550799944859,509.5603200055146,511.4799065487588,511.5116786209884,512.8468587940573,510.17649844791947,6248,12975.633333333333,54.051586358047786,55.271291909515654,NaN,NaN,NaN,NaN,0.739084717880248,11.437586359252592,13193633
2025-09-15T12:35:00-04:00,512.76,513.11,512.6,512.8,511.11742613268706,NaN,NaN,NaN,NaN,NaN,511.82030000000026,514.0826778728102,509.5579221271903,511.63986360185424,511.52747855935206,512.862444157332,510.19251296137213,7575,12645.6,54.1587772660189,55.151223371467715,NaN,NaN,NaN,NaN,0.722721523745944,11.071979783048542,13201208
2025-09-15T12:40:00-04:00,512.77,513.03,512.49,512.95,511.11742613268706,NaN,NaN,NaN,NaN,NaN,511.8341000000003,514.1153765634874,509.5528234365132,511.63986360185424,511.5405798726358,512.8750914806724,510.20606826459925,6488,12177.7,55.82354715175197,54.71001563090892,NaN,NaN,NaN,NaN,0.7096699863355169,10.485049777842795,13207696
2025-09-15T12:45:00-04:00,512.92,512.92,512.63,512.82,511.11742613268706,NaN,NaN,NaN,NaN,NaN,511.8467000000003,514.1426125504474,509.5507874495531,511.63986360185424,511.5456118754768,512.8797821751804,510.2114415757733,2595,11817.433333333332,53.99344295728841,53.916956878314686,NaN,NaN,NaN,NaN,0.6818364158829836,9.940043344437457,13205101
2025-09-15T12:50:00-04:00,512.82,512.86,512.16,512.25,511.11742613268706,NaN,NaN,NaN,NaN,NaN,511.85370000000034,514.1523524833295,509.55504751667115,511.63986360185424,511.55561123385746,512.8854264290896,510.2257960386253,7425,11626.633333333333,46.755613669571304,53.15740034998646,NaN,NaN,NaN,NaN,0.683133814748488,10.04741126882897,13197676
2025-09-15T12:55:00-04:00,512.28,512.34,511.79,511.91,511.11742613268706,NaN,NaN,NaN,NaN,NaN,511.85630000000026,514.1549072390462,509.55769276095435,511.63986360185424,511.5627820334489,512.8833633054829,510.2422007614149,10373,11488.4,43.04867148982762,52.072214381489275,NaN,NaN,NaN,NaN,0.6736242565521682,10.813996997639368,13187303
2025-09-15T13:00:00-04:00,511.88,512.185,511.83,512.06,511.11742613268706,NaN,NaN,NaN,NaN,NaN,511.8756999999998,514.1644621198483,509.5869378801514,511.63986360185424,511.5670871362423,512.882253753389,510.2519205190956,6225,11233.266666666666,45.116070361007935,51.250788614618564,NaN,NaN,NaN,NaN,0.6508653810841534,11.525826602963308,13193528
2025-09-15T13:05:00-04:00,512.07,512.42,511.95,512.04,511.11742613268706,NaN,NaN,NaN,NaN,NaN,511.9032999999999,514.165889322206,509.6407106777937,511.63986360185424,511.5943881636552,512.8834040484242,510.30537227888624,33648,11637.033333333333,44.88212349493705,50.338790517200565,NaN,NaN,NaN,NaN,0.637946425292426,11.565115486745956,13159880
2025-09-15T13:10:00-04:00,512.06,512.44,511.81,512.25,511.11742613268706,NaN,NaN,NaN,NaN,NaN,511.93289999999985,514.1740319374619,509.69176806253785,511.63986360185424,511.59975367840735,512.8838975237632,510.31560983305155,6644,11225.266666666666,47.9349773246195,49.86787557896913,NaN,NaN,NaN,NaN,0.6373788234858279,11.879127144256776,13166524
2025-09-15T13:15:00-04:00,512.29,512.62,512.21,512.28,511.11742613268706,NaN,NaN,NaN,NaN,NaN,511.96669999999983,514.1765575612953,509.7568424387044,511.63986360185424,511.605160998622,512.8864043703253,510.3239176269187,5010,10940.1,48.37488466794234,49.614843206998444,NaN,NaN,NaN,NaN,0.6211374789511236,11.693124262764266,13171534
2025-09-15T13:20:00-04:00,512.28,512.35,511.79,511.84,511.11742613268706,NaN,NaN,NaN,NaN,NaN,511.9900999999998,514.169102056283,509.81109794371656,511.63986360185424,511.6078836941048,512.8850366739429,510.3307307142668,5041,10714.066666666668,42.67918162780601,49.16424068789777,NaN,NaN,NaN,NaN,0.6167705161689006,12.34050100606565,13166493
2025-09-15T13:25:00-04:00,511.89,512.17,511.81,511.97,511.11742613268706,NaN,NaN,NaN,NaN,NaN,512.0154999999999,514.1631389363722,509.86786106362746,511.6031127051867,511.61104458790294,512.8832726235152,510.3388165522907,6102,10476.933333333332,44.74904897110515,48.75044105224658,NaN,NaN,NaN,NaN,0.598429765013976,12.941636553416934,13172595
2025-09-15T13:30:00-04:00,511.96,511.98,511.4,511.73,511.11742613268706,NaN,NaN,NaN,NaN,NaN,512.0324999999998,514.1572515151828,509.9077484848168,511.6031127051867,511.61205622708064,512.8773286644004,510.34678378976093,8033,10035.733333333334,41.751574061492654,48.05431414475485,NaN,NaN,NaN,NaN,0.5971133532272663,14.209173992271772,13164562
2025-09-15T13:35:00-04:00,511.66,511.86,511.56,511.7,511.11742613268706,NaN,NaN,NaN,NaN,NaN,512.0686999999998,514.1060873566682,510.0313126433313,511.4564901641494,511.61236634676925,512.8755749651214,510.34915772841714,2410,9456.7,41.378460723937465,47.478425723239546,NaN,NaN,NaN,NaN,0.575890970853891,15.38617304263698,13162152
2025-09-15T13:40:00-04:00,511.72,511.93,511.66,511.86,511.11742613268706,NaN,NaN,NaN,NaN,NaN,512.1202999999998,513.9969016203041,510.24369837969556,511.34917789698846,511.6133535506388,512.8735861199311,510.3531209813465,3570,8896.933333333332,44.24046623455405,46.77763142870428,NaN,NaN,NaN,NaN,0.5540416157928975,16.253073049147698,13165722
2025-09-15T13:45:00-04:00,511.88,512.2,511.77,512.2,511.11742613268706,NaN,NaN,NaN,NaN,NaN,512.1736999999999,513.8982182634173,510.4491817365826,511.34917789698846,511.6154651854086,512.8730632027031,510.3578671681141,3536,8746.366666666667,49.84420619478648,46.4694477807591,NaN,NaN,NaN,NaN,0.5451815003791236,16.22562558277718,13169258
2025-09-15T13:50:00-04:00,512.25,512.25,511.88,512.17,511.11742613268706,NaN,NaN,NaN,NaN,NaN,512.2183,513.8204405807878,510.6161594192122,511.34917789698846,511.61860706445185,512.8727242664652,510.3644898624385,4845,8131.266666666666,49.37271576977821,46.008674110618124,NaN,NaN,NaN,NaN,0.5326685360663294,16.051998952472786,13164413
2025-09-15T13:55:00-04:00,512.22,512.76,512.22,512.7,511.11742613268706,NaN,NaN,NaN,NaN,NaN,512.2588,513.8042171737252,510.7133828262747,511.63469805480196,511.6248299583819,512.8771209260334,510.3725389907304,4972,7628.633333333333,57.094391468632324,46.23017043285697,NaN,NaN,NaN,NaN,0.5367636406330224,15.25562359558811,13169385
2025-09-15T14:00:00-04:00,512.68,512.94,512.4,512.88,511.11742613268706,NaN,NaN,NaN,NaN,NaN,512.2995999999999,513.8000957050259,510.7991042949739,511.7697584438416,511.63284337135224,512.8841769523021,510.38150979040233,5444,7565.766666666666,59.36136948910749,47.13058156282384,NaN,NaN,NaN,NaN,0.5369948091592406,14.915414980538646,13174829
2025-09-15T14:05:00-04:00,512.87,513.29,512.74,513.28,511.21461414627584,NaN,NaN,NaN,NaN,NaN,512.3609999999999,513.7624235623912,510.9595764376086,512.0788067550732,511.6439371272519,512.8970184681988,510.390855786305,5759,7505.933333333333,63.92314662742976,48.621615501223985,NaN,NaN,NaN,NaN,0.5379237513621488,15.300214724774651,13180588
2025-09-15T14:10:00-04:00,513.27,513.27,513,513.17,511.37826804871787,NaN,NaN,NaN,NaN,NaN,512.386,513.7996081497125,510.9723918502874,512.1610454040587,511.65291106515883,512.9075985900515,510.39822354026614,4586,7154.466666666666,61.866462202147225,49.81807206130537,NaN,NaN,NaN,NaN,0.5195006262648505,15.6575287729938,13176002
2025-09-15T14:15:00-04:00,513.18,513.28,513,513.18,511.42493768286704,NaN,NaN,NaN,NaN,NaN,512.4145999999998,513.8334345081025,510.99576549189715,512.2528363232469,511.6592845485444,512.9151014265328,510.403467670556,3276,7003.166666666667,61.98620316931488,51.03979203804664,NaN,NaN,NaN,NaN,0.502393438674502,16.009919549919847,13179278
2025-09-15T14:20:00-04:00,513.14,513.22,512.96,513.06,511.42493768286704,NaN,NaN,NaN,NaN,NaN,512.4349999999998,513.861016830715,511.0089831692847,512.2682690585975,511.6683105135786,512.9252108873623,510.41141013979495,4931,6877.9,59.56895321218074,51.87079031572959,NaN,NaN,NaN,NaN,0.4850796216263227,16.204934632663473,13174347
2025-09-15T14:25:00-04:00,513.07,513.33,512.975,513.18,511.5075568556702,NaN,NaN,NaN,NaN,NaN,512.4725999999998,513.8758864858548,511.0693135141449,512.391115246878,511.6785071101266,512.9371313218114,510.41988289844176,5336,6762.266666666666,61.198474396293115,52.78676101061179,NaN,NaN,NaN,NaN,0.47578822008158667,16.63838037080156,13179683
2025-09-15T14:30:00-04:00,513.2,513.55,513.2,513.39,511.7543724531397,NaN,NaN,NaN,NaN,NaN,512.5274,513.8535903939196,511.2012096060802,512.6138921975023,511.69155034487653,512.9540930787182,510.4290076110349,6037,6734.366666666667,63.93766117417145,54.30522383535218,NaN,NaN,NaN,NaN,0.46823191864718794,17.51625991952466,13185720
2025-09-15T14:35:00-04:00,513.4,513.53,513.33,513.48,511.85576461436074,NaN,NaN,NaN,NaN,NaN,512.5837999999999,513.824637717482,511.34296228251776,512.681113758002,511.6988299646268,512.9637909593142,510.43386896993934,3280,6664.4,65.07557660753015,55.75711866652542,NaN,NaN,NaN,NaN,0.44907249588666964,18.331433786196108,13189000
2025-09-15T14:40:00-04:00,513.44,513.53,512.59,512.62,511.85576461436074,NaN,NaN,NaN,NaN,NaN,512.6217999999999,513.7425618128516,511.5010381871482,512.681113758002,511.7115242110162,512.975904501953,510.4471439200794,8353,6568.633333333333,49.124365094913955,56.28374659748409,NaN,NaN,NaN,NaN,0.48413874618047475,17.261631115298215,13180647
2025-09-15T14:45:00-04:00,512.64,513.02,512.64,513.01,511.85576461436074,NaN,NaN,NaN,NaN,NaN,512.6533999999999,513.7260312326056,511.58076876739426,512.681113758002,511.71731017402465,512.9812697187236,510.45335062932566,3943,6464.966666666666,54.56351708507348,57.22553633756523,NaN,NaN,NaN,NaN,0.47812883573901066,16.26824292089303,13184590
2025-09-15T14:50:00-04:00,513.04,513.25,512.95,513.18,511.85576461436074,NaN,NaN,NaN,NaN,NaN,512.6749999999998,513.7456801583554,511.60431984164427,512.681113758002,511.7280725554934,512.993159944365,510.4629851666218,6180,6490.233333333334,56.73486022789464,58.11799305137527,NaN,NaN,NaN,NaN,0.46540534747193524,15.477805700337472,13190770
2025-09-15T14:55:00-04:00,513.23,513.31,513.1,513.245,511.85576461436074,NaN,NaN,NaN,NaN,NaN,512.6985,513.7666090772178,511.63039092278206,512.681113758002,511.7391397668126,513.0059985443311,510.4722809892942,6055,6464,57.56978643126224,58.669820211123536,NaN,NaN,NaN,NaN,0.4471621083667915,14.89773318867226,13196825
2025-09-15T15:00:00-04:00,513.26,513.42,513.21,513.22,511.85576461436074,NaN,NaN,NaN,NaN,NaN,512.7218999999999,513.7833987334725,511.66040126652734,512.681113758002,511.7472315631122,513.0156758522936,510.47878727393083,4295,6398.9,57.11326798923448,59.222716798227566,NaN,NaN,NaN,NaN,0.430221957769158,14.643297698122485,13192530
2025-09-15T15:05:00-04:00,513.19,513.4,513.08,513.34,511.85576461436074,NaN,NaN,NaN,NaN,NaN,512.7392999999998,513.8121727982581,511.66642720174156,512.681113758002,511.7547703338864,513.0245935408271,510.4849471269457,4069,6282.033333333334,58.80201877543671,59.34469017728502,NaN,NaN,NaN,NaN,0.42234896078564216,13.994870258575295,13196599
2025-09-15T15:10:00-04:00,513.35,513.66,513.29,513.29,512.0210421488595,NaN,NaN,NaN,NaN,NaN,512.7420999999999,513.8199647228255,511.6642352771744,512.7978319719822,511.7648946762359,513.037410873681,510.4923784787908,5059,6234.4,57.781075361086664,59.23181202528353,NaN,NaN,NaN,NaN,0.41860974930095374,14.070125811327342,13191540
2025-09-15T15:15:00-04:00,513.32,513.37,513.07,513.37,512.0210421488595,NaN,NaN,NaN,NaN,NaN,512.7400999999999,513.8129140384617,511.6672859615381,512.7978319719822,511.78505028108754,513.0608021082403,510.5092984539348,11249,6522.866666666667,59.00743869247897,58.88069002992991,NaN,NaN,NaN,NaN,0.41013762435088236,13.45106726986129,13202789
2025-09-15T15:20:00-04:00,513.41,513.51,513.19,513.44,512.0210421488595,NaN,NaN,NaN,NaN,NaN,512.7402999999999,513.8136320274099,511.66696797259,512.7978319719822,511.7955602603962,513.0736331852543,510.51748733553814,5572,6461.1,60.09958822300286,58.75448474570531,NaN,NaN,NaN,NaN,0.4036992226115291,13.243344162264428,13208361
2025-09-15T15:25:00-04:00,513.46,513.84,513.41,513.76,512.2228696788682,NaN,NaN,NaN,NaN,NaN,512.7548999999999,513.8628972747983,511.6469027252015,512.9595699696549,511.8115298859079,513.0957544881218,510.527305283694,7266,6357.533333333334,64.72622692951346,58.95020072857664,NaN,NaN,NaN,NaN,0.405577849567853,13.824923736726246,13215627
2025-09-15T15:30:00-04:00,513.75,514.21,513.62,514.18,512.4961483298287,NaN,NaN,NaN,NaN,NaN,512.7938999999999,513.9609497680567,511.6268502319431,513.210655975724,511.8778840553179,513.1971022870893,510.55866582354656,26625,7037.533333333334,69.69340127046128,59.67337558988239,NaN,NaN,NaN,NaN,0.4187508603130086,15.081841328301806,13242252
2025-09-15T15:35:00-04:00,514.18,514.36,514.08,514.17,512.827459769382,NaN,NaN,NaN,NaN,NaN,512.8276999999999,514.0528713516964,511.6025286483035,513.4205247805792,511.9174789782439,513.259571609924,510.57538634656373,15234,6423.733333333334,69.4426637934127,60.262246261105226,NaN,NaN,NaN,NaN,0.4088400845763632,16.50759061415983,13227018
2025-09-15T15:40:00-04:00,514.19,514.37,514.13,514.17,512.8880297798646,NaN,NaN,NaN,NaN,NaN,512.8448999999999,514.1198093932866,511.56999060671325,513.4984198244633,511.96052928132957,513.3261787204849,510.59487984217424,17022,6769.666666666667,69.4426637934127,60.65546073390817,NaN,NaN,NaN,NaN,0.39678007853519504,17.849021000986625,13227018
2025-09-15T15:45:00-04:00,514.16,514.56,514.06,514.47,512.9417556989616,NaN,NaN,NaN,NaN,NaN,512.8583,514.1860704774616,511.53052952253836,513.6127358595706,512.0262285514636,513.4289224897761,510.62353461315115,25630,7457,72.84215219092376,61.210216132721996,NaN,NaN,NaN,NaN,0.4041529300683954,19.426159294409707,13252648
2025-09-15T15:50:00-04:00,514.43,514.5,513.86,514.28,512.9417556989616,NaN,NaN,NaN,NaN,NaN,512.8829,514.2682924935418,511.4975075064581,513.6127358595706,512.0884212656574,513.5180208219381,510.65882170937675,27435,8203.466666666667,67.70485255464382,62.53739380841699,NaN,NaN,NaN,NaN,0.42099914934922333,20.139111047160014,13225213
2025-09-15T15:55:00-04:00,514.25,515.47,513.6,515.39,512.9500088083515,NaN,NaN,NaN,NaN,NaN,512.9273,514.4789690501302,511.3756309498696,513.6727509501252,512.3346822876047,513.9067956375021,510.7625689377072,95598,11186.666666666666,77.63055732127174,64.185039539574,NaN,NaN,NaN,NaN,0.5244992101099933,22.22300380506625,13320811
2025-09-16T09:30:00-04:00,516.545,517.19,514.9,515.4,514.2197811352446,NaN,NaN,NaN,NaN,NaN,512.9751,514.6742556611489,511.27594433885105,514.6072007601002,515.83,515.83,515.83,66925,13149.733333333334,77.69706133790963,65.6823396188608,NaN,NaN,NaN,NaN,0.6506064093878565,25.425234891003868,13387736
2025-09-16T09:35:00-04:00,515.33,516.39,513.74,514.18,NaN,NaN,NaN,517.1686180072667,517.1686180072667,517.1686180072667,512.9959,514.727767997487,511.26403200251303,514.6072007601002,515.4311909555233,515.9446974628864,514.9176844481602,40367,14414.966666666667,55.872868346397226,65.56113118422758,NaN,NaN,NaN,NaN,0.7934202372887222,25.980206509157355,13347369
2025-09-16T09:40:00-04:00,514.11,514.25,512.5,513.11,NaN,NaN,NaN,515.6216353705727,NaN,NaN,513.0011,514.7327457954539,511.2694542045461,514.6072007601002,514.785138174319,515.8586103456171,513.7116660030208,46258,15837.9,44.15769698334049,64.63573325523515,NaN,NaN,NaN,NaN,0.8617473631966706,24.695629338278017,13301111
2025-09-16T09:45:00-04:00,513.06,513.37,511.8,513.05,NaN,NaN,NaN,514.9436064900921,NaN,NaN,513.0101,514.7379871377649,511.2822128622351,514.6072007601002,514.358290896036,515.6242279033228,513.0923538887492,40501,17070.066666666666,43.60556644731513,63.550272374655044,NaN,NaN,NaN,NaN,0.9123368372540508,23.156208182732392,13260610
2025-09-16T09:50:00-04:00,513.08,513.31,512.06,512.42,NaN,NaN,NaN,514.9436064900921,NaN,NaN,513.0123,514.7368929492857,511.28770705071423,514.6072007601002,514.1406538725588,515.459985175249,512.8213225698686,27353,17820.333333333332,38.20401691458168,62.15191105704754,NaN,NaN,NaN,NaN,0.9364556345930471,21.726745681154313,13233257
2025-09-16T09:55:00-04:00,512.47,513.06,511.07,511.3,NaN,NaN,NaN,514.6481311201045,NaN,NaN,512.9891,514.7729785723104,511.20522142768965,514.6072007601002,513.8113267684622,515.2788996735535,512.3437538633709,36433,18869.033333333333,30.88045608634617,60.1428408708952,NaN,NaN,NaN,NaN,1.0117088035506832,21.400521528236474,13196824
2025-09-16T10:00:00-04:00,511.26,511.82,510.56,511.29,NaN,NaN,NaN,513.8275342510088,NaN,NaN,512.9639,514.8065104202724,511.1212895797275,514.6072007601002,513.4517091839291,515.0813882226593,511.82203014519894,41610,20074.566666666666,30.823640974939437,58.05170178174781,NaN,NaN,NaN,NaN,1.029443889011348,21.537332605108443,13155214
2025-09-16T10:05:00-04:00,511.27,512.2,511.19,511.92,NaN,NaN,NaN,513.8275342510088,NaN,NaN,512.9549,514.8133536478077,511.09644635219223,514.6072007601002,513.3567021554807,514.9865981506606,511.7268061603007,17930,20480.266666666666,38.5003964217189,56.17842817404819,NaN,NaN,NaN,NaN,1.0280550397962551,21.168681904047304,13173144
2025-09-16T10:10:00-04:00,511.96,512.92,511.91,512.91,NaN,NaN,NaN,513.8275342510088,NaN,NaN,512.9573000000001,514.8152054981531,511.0993945018472,514.6072007601002,513.2884808212957,514.8605992822598,511.7163623603316,30561,21346.1,48.2240110302837,54.6449002997498,NaN,NaN,NaN,NaN,1.0267653940965178,19.970153436430156,13203705
2025-09-16T10:15:00-04:00,512.93,513.66,512.88,513.47,NaN,NaN,NaN,513.8275342510088,NaN,NaN,512.9707000000001,514.8335322630297,511.10786773697043,514.6072007601002,513.2915006065896,514.8136049111089,511.7693963020703,23263,22012.333333333332,52.772698210912594,53.45418847242836,NaN,NaN,NaN,NaN,1.0091392945181932,18.993270527446057,13226968
2025-09-16T10:20:00-04:00,513.51,514,513.12,513.89,510.903493149928,510.903493149928,510.903493149928,NaN,NaN,NaN,512.9895000000001,514.870006580705,511.1089934192953,512.9987606080801,513.3192032674598,514.7878594686101,511.85054706630945,29314,22825.1,55.90183220158443,52.4869862158692,NaN,NaN,NaN,NaN,0.9999150591954648,18.40876151335213,13256282
2025-09-16T10:25:00-04:00,513.79,513.83,513,513.37,510.903493149928,NaN,NaN,NaN,NaN,NaN,513.0005000000001,514.883344921989,511.1176550780112,511.15171888171244,513.3225748563644,514.7603523372084,511.8847973755205,17441,23228.6,51.36419039991348,50.952846087939896,NaN,NaN,NaN,NaN,0.9920639835386449,17.72361495853121,13238841
2025-09-16T10:30:00-04:00,513.34,513.55,512.17,512.6,510.903493149928,NaN,NaN,NaN,NaN,NaN,513.0075000000002,514.8817147689548,511.1332852310456,511.15171888171244,513.3044145413435,514.721629388531,511.8871996941559,14292,23503.766666666666,45.477480561654765,49.36517665986925,NaN,NaN,NaN,NaN,1.01977369900017,16.746333980145465,13224549
2025-09-16T10:35:00-04:00,512.62,512.84,512.1,512.32,510.903493149928,NaN,NaN,NaN,NaN,NaN,513.0157000000002,514.874157435703,511.1572425642974,511.15171888171244,513.2704608773354,514.6705557680394,511.8703659866313,17257,23969.666666666668,43.52406939524387,46.92899895086725,NaN,NaN,NaN,NaN,0.9997898633573014,15.911639127292943,13207292
2025-09-16T10:40:00-04:00,512.33,512.92,511.89,512.74,510.903493149928,NaN,NaN,NaN,NaN,NaN,513.0293000000001,514.8694456573032,511.189154342697,511.15171888171244,513.2468185148472,514.6310314701651,511.86260555952924,14555,24176.4,47.188462227837285,44.74981330014781,NaN,NaN,NaN,NaN,1.0019477302603492,15.361488901957298,13221847
2025-09-16T10:45:00-04:00,512.71,513.41,512.7,513.25,510.903493149928,NaN,NaN,NaN,NaN,NaN,513.0535000000001,514.8726737136194,511.23432628638085,511.15171888171244,513.2447197845165,514.6175265661077,511.87191300292534,7809,24305.266666666666,51.31897449742854,44.424535168078606,NaN,NaN,NaN,NaN,0.981094320956033,14.272477045764791,13229656
2025-09-16T10:50:00-04:00,513.22,513.82,513.12,513.7,510.903493149928,NaN,NaN,NaN,NaN,NaN,513.0825000000001,514.8957338515513,511.2692661484488,511.4918585945277,513.2570055616208,514.6029162629052,511.91109486033633,20014,24766.4,54.68663597531756,45.176602238934116,NaN,NaN,NaN,NaN,0.9610161551734624,13.723787509200431,13249670
2025-09-16T10:55:00-04:00,513.76,513.96,513.255,513.3,510.9669923055635,NaN,NaN,NaN,NaN,NaN,513.1029000000002,514.902460046167,511.3033399538334,511.74498687562215,513.2619797682776,514.5947777092055,511.9291818273497,10068,24900.166666666668,51.2901132136401,45.72549843652876,NaN,NaN,NaN,NaN,0.9427292869467895,13.369647797036674,13239602
2025-09-16T11:00:00-04:00,513.32,513.64,513.04,513.31,510.9669923055635,NaN,NaN,NaN,NaN,NaN,513.1323000000002,514.8960451175546,511.3685548824457,511.74498687562215,513.2632279423365,514.5837723726032,511.9426835120697,9383,25069.766666666666,51.37142800071479,46.66602779982397,NaN,NaN,NaN,NaN,0.918248623593449,12.752718906509022,13248985
2025-09-16T11:05:00-04:00,513.26,513.43,513,513.3,510.9669923055635,NaN,NaN,NaN,NaN,NaN,513.1589000000001,514.8915687970274,511.4262312029729,511.74498687562215,513.262952872661,514.5743384351292,511.9515673101928,7169,25173.1,51.27923909400241,48.123083728942284,NaN,NaN,NaN,NaN,0.8833737219081991,12.12468654556552,13241816
2025-09-16T11:10:00-04:00,513.24,513.48,512.93,512.955,510.9669923055635,NaN,NaN,NaN,NaN,NaN,513.1834000000001,514.8685485870029,511.4982514129974,511.74498687562215,513.2607614384917,514.5620541917501,511.95946868523333,8169,25276.766666666666,48.0739264304853,49.35524697576698,NaN,NaN,NaN,NaN,0.8595613132004755,11.439721298251875,13233647
2025-09-16T11:15:00-04:00,512.94,512.94,512.45,512.82,510.9669923055635,NaN,NaN,NaN,NaN,NaN,513.2058000000002,514.8405004129423,511.57109958705803,511.74498687562215,513.2540945460248,514.5484173711686,511.959771720881,6786,25128,46.84012234323823,49.95094168444694,NaN,NaN,NaN,NaN,0.8342355051147269,11.11475616699045,13226861
2025-09-16T11:20:00-04:00,512.8,513.1,512.49,512.51,510.9669923055635,NaN,NaN,NaN,NaN,NaN,513.2188000000001,514.8204885590081,511.61711144099206,511.74498687562215,513.2427463374537,514.5261481246206,511.9593445502868,11154,25314.066666666666,44.044727581539405,49.65242143810806,NaN,NaN,NaN,NaN,0.8182186833208187,10.569109516349242,13215707
2025-09-16T11:25:00-04:00,512.53,513.02,512.46,512.57,510.9669923055635,NaN,NaN,NaN,NaN,NaN,513.2262000000002,514.8123356309335,511.64006436906686,511.74498687562215,513.2329035360514,514.5070889958569,511.9587180762459,9754,25397,44.73222543046897,49.078101953790664,NaN,NaN,NaN,NaN,0.7997744916550421,10.106624397022879,13225461
2025-09-16T11:30:00-04:00,512.555,512.715,512.3,512.64,510.9669923055635,NaN,NaN,NaN,NaN,NaN,513.2356000000002,514.8020349842292,511.6691650157712,511.74498687562215,513.2239417439838,514.4920960347534,511.95578745321416,7390,24755.833333333332,45.57242182295482,48.34028692674569,NaN,NaN,NaN,NaN,0.7722905993939733,9.920385449825039,13232851
2025-09-16T11:35:00-04:00,512.63,512.83,512.53,512.69,510.9669923055635,NaN,NaN,NaN,NaN,NaN,513.2354000000001,514.8021110008281,511.6686889991723,511.74498687562215,513.2192206438976,514.4828269264063,511.95561436138894,4949,24413,46.201544429198336,47.97152650026603,NaN,NaN,NaN,NaN,0.738555556580123,9.54208063117727,13237800
2025-09-16T11:40:00-04:00,512.69,512.72,512.14,512.46,510.9669923055635,NaN,NaN,NaN,NaN,NaN,513.2270000000001,514.8057007317656,511.6482992682346,511.74498687562215,513.2098633613033,514.4687242196428,511.9510025029638,6888,24075.2,43.699280681454105,47.844512223108836,NaN,NaN,NaN,NaN,0.7272301596815457,9.797034883473769,13230912
2025-09-16T11:45:00-04:00,512.45,512.83,512.45,512.56,510.9669923055635,NaN,NaN,NaN,NaN,NaN,513.2126000000002,514.8022015098385,511.6229984901618,511.70691328031853,513.2053847309603,514.4605677428742,511.9502017190464,4339,23365.5,45.091704364102,47.95648614945584,NaN,NaN,NaN,NaN,0.7024280054185779,9.82114041114125,13235251
2025-09-16T11:50:00-04:00,512.54,513.2,512.53,513.14,510.9669923055635,NaN,NaN,NaN,NaN,NaN,513.2120000000002,514.8016880196003,511.6223119804001,511.8434760031717,513.2028143570899,514.4517480063323,511.9538807078475,6035,22652.166666666668,52.438906169261564,48.33151785955757,NaN,NaN,NaN,NaN,0.7001117193172561,9.15881885458568,13241286
2025-09-16T11:55:00-04:00,513.1,513.215,512.91,512.98,510.9669923055635,NaN,NaN,NaN,NaN,NaN,513.2080000000002,514.7989959144841,511.6170040855164,511.97728080253734,513.2014072247081,514.4451877981867,511.9576266512295,4938,19630.166666666668,50.434044222563344,48.268308554210066,NaN,NaN,NaN,NaN,0.6718894536517424,8.51661759271213,13236348
2025-09-16T12:00:00-04:00,512.95,513.11,512.68,512.74,510.9669923055635,NaN,NaN,NaN,NaN,NaN,513.2016000000001,514.7974927784817,511.6057072215185,511.97728080253734,513.1974749570629,514.4349700400801,511.95997987404576,6539,17617.3,47.50042154010898,47.75500752312373,NaN,NaN,NaN,NaN,0.6546116355337653,8.339819613775745,13229809
2025-09-16T12:05:00-04:00,512.72,513.3,512.6,513.24,510.9669923055635,NaN,NaN,NaN,NaN,NaN,513.2028000000001,514.798716238448,511.60688376155224,511.9858597136238,513.1962271212657,514.4286675723005,511.9637866702309,4968,16437.333333333332,53.560909731781535,47.917207274419546,NaN,NaN,NaN,NaN,0.6578536615670629,7.798924490727252,13234777
2025-09-16T12:10:00-04:00,513.23,513.72,513.23,513.42,511.4066908666218,NaN,NaN,NaN,NaN,NaN,513.2034000000002,514.7996198343312,511.60718016566926,512.4236877708992,513.1997377848539,514.4242119230893,511.9752636466186,8204,15168.866666666667,55.55024660741976,48.21569431775562,NaN,NaN,NaN,NaN,0.6458641143122733,7.949046246431162,13242981
2025-09-16T12:15:00-04:00,513.44,513.57,513.23,513.31,511.4066908666218,NaN,NaN,NaN,NaN,NaN,513.2000000000002,514.7945720428388,511.6054279571615,512.4236877708992,513.2018417795708,514.4188721179902,511.98481144115146,7615,14072.666666666666,54.027101902550285,48.41197023265189,NaN,NaN,NaN,NaN,0.6240166775756846,8.08844501958479,13235366
2025-09-16T12:20:00-04:00,513.36,513.59,513.3,513.38,511.47664395078544,NaN,NaN,NaN,NaN,NaN,513.2152000000002,514.8018366438835,511.62856335611696,512.4793601733754,513.2029169795518,514.4170873699965,511.9887465891071,3006,13261.1,54.87503596317462,48.89776377070113,NaN,NaN,NaN,NaN,0.6001583434631412,8.255295389630836,13238372
2025-09-16T12:25:00-04:00,513.32,513.38,513,513.3,511.47664395078544,NaN,NaN,NaN,NaN,NaN,513.2210000000002,514.8067137193469,511.6352862806536,512.4793601733754,513.2031161505524,514.4121865887797,511.99404571232515,5237,12221.233333333334,53.65699148503378,49.3846829951151,NaN,NaN,NaN,NaN,0.5844327475014879,7.73318769352584,13233135
2025-09-16T12:30:00-04:00,513.24,513.28,513.045,513.16,511.47664395078544,NaN,NaN,NaN,NaN,NaN,513.2206000000001,514.8063649762763,511.63483502372395,512.4793601733754,513.2028012226099,514.4072750983587,511.99832734686106,4781,10993.6,51.50252575946815,49.91738286496716,NaN,NaN,NaN,NaN,0.560901836965667,7.248373404285487,13228354
2025-09-16T12:35:00-04:00,513.15,513.38,513.025,513.3,511.47664395078544,NaN,NaN,NaN,NaN,NaN,513.2217000000002,514.8076074499457,511.6357925500546,512.4793601733754,513.2030537948905,514.4027976913986,512.0033098983823,4975,10561.766666666666,53.512693673161074,50.54455916801659,NaN,NaN,NaN,NaN,0.5461945628966921,7.0254330486079235,13233329
2025-09-16T12:40:00-04:00,513.33,513.34,512.82,513,511.47664395078544,NaN,NaN,NaN,NaN,NaN,513.2173000000001,514.8044221880517,511.6301778119486,512.4793601733754,513.2014879896444,514.3950390066748,512.0079369726141,6703,9766.5,48.84098716549265,50.77802812105501,NaN,NaN,NaN,NaN,0.5443235226897842,6.721276185663308,13226626
2025-09-16T12:45:00-04:00,512.98,513,512.64,512.89,511.47664395078544,NaN,NaN,NaN,NaN,NaN,513.2083000000001,514.79763899471,511.6189610052902,512.4793601733754,513.1982776506426,514.3869468071799,512.0096084941052,5797,9184.3,47.21341495339461,50.850304587069026,NaN,NaN,NaN,NaN,0.5311575567833721,6.848057830927699,13220829
2025-09-16T12:50:00-04:00,512.84,513,512.665,512.77,511.47664395078544,NaN,NaN,NaN,NaN,NaN,513.1979000000001,514.7917633441359,511.6040366558644,512.4793601733754,513.1940753123486,514.376946069288,512.0112045554091,7107,8444.066666666668,45.4346590642557,50.97426018584057,NaN,NaN,NaN,NaN,0.5171463027274196,6.965783644387491,13213722
2025-09-16T12:55:00-04:00,512.75,513.81,512.74,513.4,511.47664395078544,NaN,NaN,NaN,NaN,NaN,513.1985000000001,514.7926445981785,511.60435540182164,512.4954713866314,513.1959151088407,514.3699709280793,512.0218592896022,9962,8194.766666666666,55.01648562765742,51.68317313323738,NaN,NaN,NaN,NaN,0.5566358525325994,7.683954267990092,13223684
2025-09-16T13:00:00-04:00,513.38,513.83,513.38,513.8,511.8024105922139,NaN,NaN,NaN,NaN,NaN,513.2057000000001,514.8073766340306,511.6040233659696,512.5533771093052,513.2015369561282,514.3697386129986,512.0333352992577,7966,7983.9,59.83866834595156,52.211727574429524,NaN,NaN,NaN,NaN,0.5490190059231312,8.387662893995007,13231650
2025-09-16T13:05:00-04:00,513.76,513.9,513.63,513.68,512.0075282925678,NaN,NaN,NaN,NaN,NaN,513.2041000000002,514.8037170666008,511.6044829333995,512.7437016874441,513.2083834481314,514.37064502815,512.0461218681128,8706,7698.866666666667,57.83561918723456,52.74041150047747,NaN,NaN,NaN,NaN,0.5290890769286206,9.175928556569389,13222944
2025-09-16T13:10:00-04:00,513.74,513.9,513.585,513.9,512.0219588247239,NaN,NaN,NaN,NaN,NaN,513.1985000000001,514.7863290209751,511.6106709790251,512.8174613499554,513.2139229157145,514.3720743019231,512.0557715295059,6487,7429.933333333333,60.449511309707596,53.665346484020226,NaN,NaN,NaN,NaN,0.5137970000051435,9.774826895848628,13229431
2025-09-16T13:15:00-04:00,513.915,514.2,513.77,513.8,512.2840288781455,NaN,NaN,NaN,NaN,NaN,513.1911000000001,514.7641292940153,511.6180707059849,513.1189690799642,513.2287447448775,514.3792165604292,512.0782729293259,14659,7658.266666666666,58.66912778344033,54.030219201995855,NaN,NaN,NaN,NaN,0.5078115000047807,10.92400005632002,13214772
2025-09-16T13:20:00-04:00,513.81,514.12,513.74,514.03,512.2840288781455,NaN,NaN,NaN,NaN,NaN,513.1883000000001,514.7548345319283,511.621765468072,513.1189690799642,513.2377951388646,514.3840258135542,512.091564464175,8752,7282.866666666667,61.479266994771834,54.453720658235284,NaN,NaN,NaN,NaN,0.49868210714729605,11.89462725512933,13223524
2025-09-16T13:25:00-04:00,514.04,514.07,513.54,513.54,512.2840288781455,NaN,NaN,NaN,NaN,NaN,513.1697,514.6965011134549,511.64289888654514,513.1189690799642,513.2463465461979,514.3840656628045,512.1086274295913,12916,7377.8,53.18306108615736,54.39343202849294,NaN,NaN,NaN,NaN,0.500919099493924,12.15980809949919,13210608
2025-09-16T13:30:00-04:00,513.56,513.84,513.4,513.81,512.2840288781455,NaN,NaN,NaN,NaN,NaN,513.1603000000001,514.6652736343193,511.65532636568093,513.1189690799642,513.2522223654413,514.383386840862,512.1210578900206,9858,7393.633333333333,56.65403896201343,54.520503671267136,NaN,NaN,NaN,NaN,0.49656773524436193,11.983590031695332,13220466
2025-09-16T13:35:00-04:00,513.82,513.89,513.32,513.32,512.2840288781455,NaN,NaN,NaN,NaN,NaN,513.1189000000002,514.4835996591719,511.7542003408284,513.1189690799642,513.256875766509,514.378309149312,512.1354423837059,13478,7603.933333333333,49.48386858777453,54.22242346432005,NaN,NaN,NaN,NaN,0.5018128970126172,11.580814235928028,13206988
2025-09-16T13:40:00-04:00,513.27,513.28,513.06,513.08,512.2840288781455,NaN,NaN,NaN,NaN,NaN,513.0725000000001,514.2715166804135,511.87348331958674,513.1189690799642,513.2550509671094,514.3677896936829,512.1423122405358,11842,7726.366666666667,46.38718747786142,53.85704215849099,NaN,NaN,NaN,NaN,0.4845405472260092,11.033559021492854,13195146
2025-09-16T13:45:00-04:00,513.12,513.34,512.85,512.99,512.2840288781455,NaN,NaN,NaN,NaN,NaN,513.0487,514.2053309871083,511.89206901289185,513.1189690799642,513.2518098919674,514.3555466058189,512.1480731781159,12816,7927.366666666667,45.24376293656181,53.26640424873391,NaN,NaN,NaN,NaN,0.4849305081384378,11.056924291107428,13182330
2025-09-16T13:50:00-04:00,512.96,512.96,512.42,512.44,512.2840288781455,NaN,NaN,NaN,NaN,NaN,513.0353,514.2042386811781,511.8663613188219,513.1189690799642,513.2389836650892,514.335398274727,512.1425690554514,15645,8077.066666666667,38.92861806177299,52.558377884182505,NaN,NaN,NaN,NaN,0.49100690041426726,12.002200712967612,13166685
2025-09-16T13:55:00-04:00,512.45,512.76,512.285,512.33,512.2840288781455,NaN,NaN,NaN,NaN,NaN,513.0209,514.2063816575745,511.8354183424254,513.1189690799642,513.2287644319644,514.3215871961218,512.135941667807,10438,8099.866666666667,37.79244555728166,51.885451498745866,NaN,NaN,NaN,NaN,0.4898635503846784,13.134135828812424,13156247
2025-09-16T14:00:00-04:00,512.28,512.28,511.72,511.96,NaN,NaN,NaN,513.6173594143627,513.6173594143627,513.6173594143627,513.0117,514.2225602068445,511.8008397931556,513.1189690799642,513.201169502832,514.2971820627696,512.1051569428945,18117,8457.433333333332,34.17894847847026,51.081472171189766,NaN,NaN,NaN,NaN,0.49844472535720236,15.086131821941379,13138130
2025-09-16T14:05:00-04:00,511.94,512.45,511.89,512.2,NaN,NaN,NaN,513.6173594143627,NaN,NaN,513.0296999999998,514.1624849048712,511.89691509512835,513.0651752639714,513.1850173307506,514.2797667461294,512.0902679153718,13106,8729.333333333334,38.299946922093206,49.88743369222089,NaN,NaN,NaN,NaN,0.502841530688835,16.3608535680503,13151236
2025-09-16T14:10:00-04:00,512.18,512.31,511.62,511.71,NaN,NaN,NaN,513.6056518630866,NaN,NaN,513.0380999999999,514.1244349208984,511.95176507910145,512.9611402111772,513.1618808651634,514.2604648903639,512.063296839963,14955,8998.233333333334,33.665553347902545,48.01792547807453,NaN,NaN,NaN,NaN,0.5162099927824854,17.946881600278555,13136281
2025-09-16T14:15:00-04:00,511.69,511.69,511.42,511.56,NaN,NaN,NaN,513.1606222329464,NaN,NaN,513.0308999999999,514.1510280107573,511.91077198924245,512.7329121689417,513.1333762056692,514.2426097627794,512.024142648559,15250,9361.933333333332,32.37411834417949,46.19924684642775,NaN,NaN,NaN,NaN,0.5000521361551623,19.69517107210185,13121031
2025-09-16T14:20:00-04:00,511.58,511.79,511.58,511.7,NaN,NaN,NaN,513.1606222329464,NaN,NaN,513.0066999999999,514.1869027114901,511.82649728850976,512.7193297351533,513.1149567493704,514.2289336055271,512.0009798932138,11101,9530.8,34.8847943542858,44.37319563532619,NaN,NaN,NaN,NaN,0.4807626978583663,20.985863332731007,13132132
2025-09-16T14:25:00-04:00,511.74,511.82,511.36,511.45,NaN,NaN,NaN,513.1456392659697,NaN,NaN,512.9662999999999,514.216517277113,511.7160827228868,512.2417710304982,513.0914701724705,514.2134149173365,511.9695254276045,13197,9806.1,32.56012868642351,42.50826712839642,NaN,NaN,NaN,NaN,0.47927964801133865,22.50405311917205,13118935
2025-09-16T14:30:00-04:00,511.45,511.8,511.41,511.65,NaN,NaN,NaN,513.1431102084256,NaN,NaN,512.9214999999999,514.1963996038966,511.6466003961033,512.2417710304982,513.0700694121292,514.1976710488277,511.9424677754307,13033,10022.566666666668,36.22173545730129,40.70415773286281,NaN,NaN,NaN,NaN,0.4729025302962421,23.91380077801016,13131968
2025-09-16T14:35:00-04:00,511.65,511.88,511.35,511.39,NaN,NaN,NaN,513.1431102084256,NaN,NaN,512.8818999999999,514.2200493042508,511.54375069574894,511.7964168243985,513.0508158547841,514.1842064991467,511.91742521042147,11420,10237.633333333333,33.662942862408016,39.30986357402357,NaN,NaN,NaN,NaN,0.47698092098936573,24.923779141329646,13120548
2025-09-16T14:40:00-04:00,511.39,511.589,511.29,511.44,NaN,NaN,NaN,512.9507202518919,NaN,NaN,512.8586999999999,514.2545722149162,511.4628277850837,511.59163345951873,513.0289832218849,514.1699766882441,511.8879897555257,12467,10379.733333333334,34.619466334647896,37.73596552921174,NaN,NaN,NaN,NaN,0.46426799806155233,25.964373323520213,13133015
2025-09-16T14:45:00-04:00,511.43,511.63,511.31,511.48,NaN,NaN,NaN,512.9507202518919,NaN,NaN,512.8418999999999,514.2827954022667,511.401004597733,511.17824541409203,513.0021869712957,514.1512774117627,511.8530965308287,16125,10663.4,35.421699682417525,36.73152489311481,NaN,NaN,NaN,NaN,0.45396314105715524,26.76322113128398,13149140
2025-09-16T14:50:00-04:00,511.48,511.48,510.34,510.66,NaN,NaN,NaN,512.4840663865378,NaN,NaN,512.8002999999999,514.365318095854,511.2352819041458,511.17824541409203,512.9228608754931,514.1222547288259,511.72346702216043,35426,11744.066666666668,27.87159987224298,35.408982921284924,NaN,NaN,NaN,NaN,0.5029657738387902,28.850812757541895,13113714
2025-09-16T14:55:00-04:00,510.655,510.69,510.27,510.62,NaN,NaN,NaN,512.0397906416953,NaN,NaN,512.7476999999998,514.4217169774008,511.0736830225987,510.94759633127353,512.8556958953636,514.1025529801794,511.6088388105478,28018,12503.433333333332,27.56296847360626,34.14606903107381,NaN,NaN,NaN,NaN,0.4970396471360206,30.860860525726125,13085696
2025-09-16T15:00:00-04:00,510.59,510.7,510.24,510.31,NaN,NaN,NaN,512.0216183398,NaN,NaN,512.6798999999999,514.4650571248314,510.8947428751682,510.7470955658318,512.813859175121,514.0898984665682,511.5378198836738,17445,12925.566666666668,25.23111608103406,33.1676760324496,NaN,NaN,NaN,NaN,0.4943939580548748,32.75927797955985,13068251
2025-09-16T15:05:00-04:00,510.315,510.56,510.28,510.36,NaN,NaN,NaN,511.93927205162726,NaN,NaN,512.6210999999998,514.5112717277087,510.7309282722909,510.7470955658318,512.7496866245915,514.0671743330253,511.43219891615774,27776,13685.6,26.313929080993887,32.34778199842905,NaN,NaN,NaN,NaN,0.47908010390810013,34.52209418669116,13096027
2025-09-16T15:10:00-04:00,510.39,510.47,510.12,510.13,NaN,NaN,NaN,511.79294150382606,NaN,NaN,512.5574999999998,514.5612587181352,510.5537412818644,510.7470955658318,512.6911846552507,514.0471755440705,511.33519376643096,24936,14293.366666666667,24.552478672237655,31.660177012269575,NaN,NaN,NaN,NaN,0.46986009648609456,36.34271356210338,13071091
2025-09-16T15:15:00-04:00,510.17,510.51,510,510.33,NaN,NaN,NaN,511.7543987081976,NaN,NaN,512.4980999999998,514.5846693279541,510.4115306720455,510.7470955658318,512.6178433525818,514.0157859329867,511.21990077217686,33559,15218.766666666666,29.003006510249946,30.996109839995057,NaN,NaN,NaN,NaN,0.4727272324513728,38.16622095259228,13104650
2025-09-16T15:20:00-04:00,510.32,510.64,510.205,510.455,NaN,NaN,NaN,511.7543987081976,NaN,NaN,512.4480999999998,514.6070375998673,510.28916240013234,510.7470955658318,512.5644294357703,513.9857985038394,511.1430603677012,27653,15903.633333333333,31.714206814121155,30.856727944724955,NaN,NaN,NaN,NaN,0.47003243013341783,39.26403089678651,13132303
2025-09-16T15:25:00-04:00,510.47,510.67,510.25,510.37,NaN,NaN,NaN,511.7543987081976,NaN,NaN,512.3990999999999,514.6319955999479,510.16620440005187,510.6253411621323,512.5304601601991,513.965551927921,511.0953683924773,18290,16181.233333333334,30.85144531377894,30.74796558541063,NaN,NaN,NaN,NaN,0.4664586851238891,40.14483955073461,13114013
2025-09-16T15:30:00-04:00,510.39,510.53,510,510.32,NaN,NaN,NaN,511.75007855340135,NaN,NaN,512.3552999999998,514.6624579140649,510.0481420859347,510.6253411621323,512.4675896829525,513.9301876873036,511.0049916786014,33079,17018.333333333332,30.328775354739832,30.422535656871627,NaN,NaN,NaN,NaN,0.4709973504721808,41.31489941307214,13080934
2025-09-16T15:35:00-04:00,510.36,510.38,509.6,509.72,NaN,NaN,NaN,511.51393861915585,NaN,NaN,512.2982999999999,514.7194316445035,509.8771683554963,510.1062729297059,512.3900521732282,513.8959289352318,510.88417541122465,36816,17955.333333333332,24.881343756078564,29.87405101898985,NaN,NaN,NaN,NaN,0.4930689682955945,42.86501508767223,13044118
2025-09-16T15:40:00-04:00,509.74,510.1,509.26,509.28,NaN,NaN,NaN,511.24921413646695,NaN,NaN,512.2311,514.7929909343775,509.66920906562245,509.5573479127078,512.2786188756609,513.8544439510391,510.7027938002826,49727,19396.666666666668,21.790417945794886,28.84324262531082,NaN,NaN,NaN,NaN,0.5178497562744828,44.62203513081312,12994391
2025-09-16T15:45:00-04:00,509.3,509.6,509.09,509.56,NaN,NaN,NaN,510.9124316757185,NaN,NaN,512.1684999999999,514.8333724172055,509.5036275827943,509.5573479127078,512.1805688731998,513.814322350894,510.54681539550563,45013,20408.466666666667,27.92635992758059,28.43348670139458,NaN,NaN,NaN,NaN,0.5172890593977375,46.39487028420769,13039404
2025-09-16T15:50:00-04:00,509.57,510.24,508.91,508.96,NaN,NaN,NaN,510.9124316757185,NaN,NaN,512.0984999999998,514.9089634849594,509.28803651504035,509.5573479127078,512.0517661439023,513.7524270209606,510.3511052668441,63104,22220.2,23.64536090229575,27.64962202765514,NaN,NaN,NaN,NaN,0.5753398408693265,45.64746039092316,12976300
2025-09-16T15:55:00-04:00,508.97,509.95,508.62,509.15,NaN,NaN,NaN,510.9124316757185,NaN,NaN,512.0302999999999,514.9558005793934,509.1047994206063,509.5573479127078,511.7758954853085,513.5947026941409,509.95708827647616,149796,26782.866666666665,27.43871012158864,27.079408487595934,NaN,NaN,NaN,NaN,0.6292441379500878,45.3562203450338,13126096
2025-09-17T09:30:00-04:00,510.61,510.83,508.93,509.02,NaN,NaN,NaN,510.9124316757185,NaN,NaN,511.9478999999998,514.974091064767,508.9217089352325,509.5573479127078,509.5933333333333,509.5933333333333,509.5933333333333,51559,28172.9,26.469737585377842,26.97927546710557,NaN,NaN,NaN,NaN,0.7200124138107942,42.82698676999775,13074537
2025-09-17T09:35:00-04:00,509.005,509.69,507.56,507.65,NaN,NaN,NaN,510.7870516431827,NaN,NaN,511.84129999999976,515.0824286985506,508.6001713014489,509.5573479127078,508.9708008745105,509.61701702852065,508.3245847205003,47849,29318.6,18.896382173655667,26.36023358853767,NaN,NaN,NaN,NaN,0.8207258128243086,42.231003924785284,13026688
2025-09-17T09:40:00-04:00,507.7,508.05,506.8,507.24,NaN,NaN,NaN,509.6592311139471,NaN,NaN,511.7312999999998,515.2077434757745,508.25485652422515,509.5573479127078,508.56790703342705,509.4613526254718,507.6744614413823,33249,30032.166666666668,17.30102305034211,25.793798372059673,NaN,NaN,NaN,NaN,0.8513882547654293,42.332704990634916,12993439
2025-09-17T09:45:00-04:00,507.28,507.98,506.4,507.6,NaN,NaN,NaN,509.5381296996768,NaN,NaN,511.61849999999976,515.2541678892067,507.98283211079286,509.37487833016627,508.34616529420265,509.2851582198752,507.4071723685301,28853,30566.733333333334,23.415039678444515,25.586734843306147,NaN,NaN,NaN,NaN,0.9034319508536158,42.723005263060294,13022292
2025-09-17T09:50:00-04:00,507.67,507.91,506.36,506.53,NaN,NaN,NaN,509.5381296996768,NaN,NaN,511.4806999999998,515.3477298732374,507.61367012676214,509.06590266413303,508.1777719666603,509.17083463012426,507.18470930319637,21855,30773.733333333334,18.93436691299084,25.18544114621709,NaN,NaN,NaN,NaN,0.9496153829355013,43.114715027743685,13000437
2025-09-17T09:55:00-04:00,506.54,506.73,505.94,506.5,NaN,NaN,NaN,508.7839983420609,NaN,NaN,511.34449999999975,515.4183926103321,507.2706073896673,508.62872213130646,507.97637466689895,509.06933850314584,506.88341083065205,23279,31201.766666666666,18.825594393747465,24.458483137895485,NaN,NaN,NaN,NaN,0.9382142841543956,43.780221955213605,12977158
2025-09-17T10:00:00-04:00,506.5,506.8,505.92,506.24,NaN,NaN,NaN,508.7839983420609,NaN,NaN,511.2016999999997,515.4758135269086,506.92758647309074,508.4293821640361,507.72111541836034,508.8907845152054,506.5514463215153,37647,31852.766666666666,17.867582352842874,23.469438533518463,NaN,NaN,NaN,NaN,0.9340561210005098,44.24108031873221,12939511
2025-09-17T10:05:00-04:00,506.17,506.76,506.04,506.37,NaN,NaN,NaN,508.7839983420609,NaN,NaN,511.06309999999974,515.502312042761,506.6238879572385,508.4293821640361,507.6169397270025,508.7954433946821,506.4384360593229,20742,32107.3,20.058122915392687,22.698486933633728,NaN,NaN,NaN,NaN,0.9187663980718999,44.669020227713766,12960253
2025-09-17T10:10:00-04:00,506.39,507.46,506.08,507.46,NaN,NaN,NaN,508.7839983420609,NaN,NaN,510.94909999999976,515.4592493057833,506.4389506942162,508.1892045849831,507.56791642787755,508.71087289899657,506.4249599567585,22878,32371.4,35.57369363175421,23.07312395342047,NaN,NaN,NaN,NaN,0.9517116553524781,43.52800733092822,12983131
2025-09-17T10:15:00-04:00,507.4,507.63,506.95,507.39,NaN,NaN,NaN,508.7839983420609,NaN,NaN,510.83089999999976,515.3978244312327,506.26397556876674,508.1892045849831,507.5574720757385,508.67685150462256,506.4380926468544,12843,32291.166666666668,35.10251255283609,23.803207438903154,NaN,NaN,NaN,NaN,0.9323036799701587,42.13628508971328,12970288
2025-09-17T10:20:00-04:00,507.38,508.21,507.28,508.15,NaN,NaN,NaN,508.7839983420609,NaN,NaN,510.7338999999998,515.3184110055997,506.1493889943998,506.5123636679865,507.57694398448706,508.66472321951727,506.48916474945685,19324,32565.266666666666,43.80523229079348,25.375694177831626,NaN,NaN,NaN,NaN,0.9321391314008621,39.80538142412385,12989612
2025-09-17T10:25:00-04:00,508.16,508.39,507.9,508.205,NaN,NaN,NaN,508.7839983420609,NaN,NaN,510.64019999999977,515.2361055517462,506.0442944482533,506.0867864504855,507.597999381459,508.6717010292688,506.5242977336492,11886,32521.566666666666,44.38645354328587,26.551415150382002,NaN,NaN,NaN,NaN,0.9005577648722297,37.34609639094387,13001498
2025-09-17T10:30:00-04:00,508.12,508.64,507.74,507.79,NaN,NaN,NaN,508.7839983420609,NaN,NaN,510.54059999999976,515.1633345327859,505.9178654672136,506.3474291603884,507.61536617318006,508.6721768078816,506.5585555384785,13064,32522.6,40.945185223988496,27.78711688764577,NaN,NaN,NaN,NaN,0.9005179245242116,34.69633062819783,12988434
2025-09-17T10:35:00-04:00,507.79,507.83,507.16,507.58,NaN,NaN,NaN,508.7839983420609,NaN,NaN,510.42419999999976,515.0461690003937,505.80223099960585,506.3474291603884,507.61310438641374,508.65694548342384,506.56926328940364,8693,32431.7,39.28538805816837,28.633308168830037,NaN,NaN,NaN,NaN,0.8840523584867651,33.042810353167,12979741
2025-09-17T10:40:00-04:00,507.62,507.91,507.3,507.43,NaN,NaN,NaN,508.7839983420609,NaN,NaN,510.2967999999998,514.8906231398666,505.702976860133,506.3474291603884,507.6119778946256,508.64696722233293,506.5769885669183,6101,32219.5,38.09742098555026,29.463856983128064,NaN,NaN,NaN,NaN,0.8644771900234257,31.370524994600853,12973640
2025-09-17T10:45:00-04:00,507.43,507.96,507.23,507.79,NaN,NaN,NaN,508.7839983420609,NaN,NaN,510.1789999999998,514.7215481836065,505.6364518163931,506.3474291603884,507.61282806498366,508.63863444353393,506.5870216864334,6485,31898.166666666668,42.58483268312592,31.15588916237594,NaN,NaN,NaN,NaN,0.854871676450321,29.920514143906402,12980125
2025-09-17T10:50:00-04:00,507.75,507.75,507.07,507.26,NaN,NaN,NaN,508.7839983420609,NaN,NaN,510.0461999999998,514.5337581600993,505.5586418399004,506.3474291603884,507.6079238287471,508.62433074071583,506.5915169167784,7246,30958.833333333332,38.19496580736023,32.64831364502009,NaN,NaN,NaN,NaN,0.8452379852753001,28.813754380613148,12972879
2025-09-17T10:55:00-04:00,507.33,507.8,507.2,507.26,NaN,NaN,NaN,508.7839983420609,NaN,NaN,509.91539999999986,514.3384640239767,505.492335976023,506.3474291603884,507.6044026573081,508.6115646170232,506.59724069759307,7133,30262.666666666668,38.19496580736023,33.70402265422835,NaN,NaN,NaN,NaN,0.8277209863270661,27.68356344544611,12972879
2025-09-17T11:00:00-04:00,507.29,507.35,506.99,506.99,NaN,NaN,NaN,508.7839983420609,NaN,NaN,509.77459999999985,514.1121614531997,505.4370385468,506.3474291603884,507.5965500866013,508.59759185163875,506.5955083215639,6144,29885.966666666667,36.00224542059936,34.92315683334325,NaN,NaN,NaN,NaN,0.7943123444465624,26.96766329317332,12966735
2025-09-17T11:05:00-04:00,507.03,507.55,506.96,507.55,NaN,NaN,NaN,508.7839983420609,NaN,NaN,509.6547999999999,513.8996415565414,505.4099584434585,506.3474291603884,507.5931270304896,508.58751227113703,506.59874178984217,5522,29144.166666666668,43.275915085265126,36.6696083113088,NaN,NaN,NaN,NaN,0.7797186055575246,25.864398769215462,12972257
2025-09-17T11:10:00-04:00,507.54,507.81,507.3,507.79,NaN,NaN,NaN,508.7839983420609,NaN,NaN,509.5343999999999,513.640205470321,505.4285945296787,506.3474291603884,507.59394225647065,508.5782110696366,506.6096734433047,8120,28583.633333333335,46.10313900935086,38.686433786773655,NaN,NaN,NaN,NaN,0.7604529908748436,24.29767881742679,12980377
2025-09-17T11:15:00-04:00,507.74,507.85,507.41,507.51,NaN,NaN,NaN,508.7839983420609,NaN,NaN,509.4181999999999,513.4163274417166,505.4200725582832,506.3806421810283,507.5938749885459,508.5697103648041,506.6180396122877,6952,27696.733333333334,43.38622410090549,40.352726728596,NaN,NaN,NaN,NaN,0.7375634915266404,22.76007510958272,12973425
2025-09-17T11:20:00-04:00,507.51,507.78,507.31,507.32,NaN,NaN,NaN,508.7839983420609,NaN,NaN,509.30299999999994,513.2031835854127,505.4028164145871,506.3806421810283,507.5928482977913,508.56469623234614,506.6210003632365,3405,26888.466666666667,41.59493278431366,40.782815239493104,NaN,NaN,NaN,NaN,0.7184518135604497,21.534750821420896,12970020
2025-09-17T11:25:00-04:00,507.37,507.44,506.98,507.07,NaN,NaN,NaN,508.7839983420609,NaN,NaN,509.18459999999993,512.988117235392,505.38108276460787,506.3806421810283,507.585067099417,508.5497740074777,506.6203601913563,7580,26531.466666666667,39.295962352608804,41.082347368048296,NaN,NaN,NaN,NaN,0.6999909697347019,21.029883834259046,12962440
2025-09-17T11:30:00-04:00,507.11,507.48,507.11,507.32,NaN,NaN,NaN,508.7839983420609,NaN,NaN,509.08219999999994,512.8044477939873,505.3599522060126,506.3806421810283,507.5815141210405,508.5406340984464,506.62239414363466,5344,25606.966666666667,42.70620463467579,41.00384539261132,NaN,NaN,NaN,NaN,0.6792773290393679,20.462102263188676,12967784
2025-09-17T11:35:00-04:00,507.36,507.42,506.99,507.02,NaN,NaN,NaN,508.7839983420609,NaN,NaN,508.9759999999999,512.623790015905,505.3282099840947,506.3806421810283,507.57627391683485,508.530830678138,506.6217171555317,5129,24550.733333333334,39.81561144504187,40.677356671308175,NaN,NaN,NaN,NaN,0.6614718055365564,20.168551790152755,12962655
2025-09-17T11:40:00-04:00,507.01,507.1,506.82,507.1,NaN,NaN,NaN,508.7839983420609,NaN,NaN,508.87879999999996,512.4617862182196,505.29581378178034,506.3806421810283,507.5669541255366,508.5164233795377,506.6174848715355,7134,23130.966666666667,40.96316375068553,40.67864085178654,NaN,NaN,NaN,NaN,0.6342238194268044,20.220424810903808,12969789
2025-09-17T11:45:00-04:00,507.08,507.42,506.92,507.295,NaN,NaN,NaN,508.7839983420609,NaN,NaN,508.7806999999999,512.2617257166773,505.2996742833225,506.3806421810283,507.56201408677913,508.5057767380596,506.6182514354987,6148,21835.466666666667,43.777204491673494,40.99948488275118,NaN,NaN,NaN,NaN,0.6246364037534613,19.41226479419008,12975937
2025-09-17T11:50:00-04:00,507.295,508.04,507.14,507.91,NaN,NaN,NaN,508.7839983420609,NaN,NaN,508.70469999999995,512.0912353445668,505.3181646554331,506.66123509112276,507.5654224981096,508.49740405324707,506.6334409429722,11483,20114.766666666666,51.611107263558814,41.96474818832322,NaN,NaN,NaN,NaN,0.6443052320567879,18.723149280144497,12987420
2025-09-17T11:55:00-04:00,507.915,508.33,507.66,508.28,NaN,NaN,NaN,508.7839983420609,NaN,NaN,508.63909999999987,511.92750672065347,505.3506932793463,506.8919880728982,507.58411252383564,508.50449175621793,506.66373329145335,16760,15680.233333333334,55.61779848063212,42.89567431671652,NaN,NaN,NaN,NaN,0.6461405726241573,18.59561943972374,13004180
2025-09-17T12:00:00-04:00,508.29,508.46,507.96,508.25,NaN,NaN,NaN,508.7839983420609,NaN,NaN,508.57009999999985,511.74140224992357,505.39879775007614,507.05959045831855,507.58822768795335,508.50706285471426,506.66939252119244,3048,14063.2,55.2185626592584,44.111645520423544,NaN,NaN,NaN,NaN,0.6357019602938603,18.69646945019352,13001132
2025-09-17T12:05:00-04:00,508.29,508.44,507.62,507.7,NaN,NaN,NaN,508.7839983420609,NaN,NaN,508.49509999999987,511.5662102162756,505.42398978372415,507.05959045831855,507.59334224776853,508.50598335972904,506.680701135808,7413,12715.333333333334,48.364217212323986,44.83802062077809,NaN,NaN,NaN,NaN,0.6488661059871556,17.981952247010373,12993719
2025-09-17T12:10:00-04:00,507.73,507.81,507.5,507.61,NaN,NaN,NaN,508.7839983420609,NaN,NaN,508.41429999999986,511.35912665713323,505.4694733428665,507.05959045831855,507.59370682237875,508.5027846243066,506.68462902045087,3787,11733.266666666666,47.328903801467966,45.647067647982986,NaN,NaN,NaN,NaN,0.6246613841309303,17.049881998156508,12989932
2025-09-17T12:15:00-04:00,507.58,507.93,507.51,507.79,NaN,NaN,NaN,508.7839983420609,NaN,NaN,508.3422999999998,511.166138671174,505.5184613288256,507.05959045831855,507.5950645241974,508.5001196871409,506.69000936125394,4438,10919.433333333332,49.65035096400828,46.102384496464644,NaN,NaN,NaN,NaN,0.6100427138358651,16.428290472251426,12994370
2025-09-17T12:20:00-04:00,507.8,508.315,507.76,508.28,NaN,NaN,NaN,508.7839983420609,NaN,NaN,508.2790999999998,510.9606552876764,505.5975447123232,507.05959045831855,507.59971634446504,508.50207736029466,506.6973553286354,4387,10337.166666666666,55.4115993492991,46.76727452074666,NaN,NaN,NaN,NaN,0.6061110914190181,16.573848639538756,12998757
2025-09-17T12:25:00-04:00,508.3,508.69,508.21,508.63,NaN,NaN,NaN,508.7839983420609,NaN,NaN,508.2220999999998,510.745576245328,505.6986237546716,507.3874178013818,507.6134977860534,508.51587403528777,506.71112153681906,7586,9814.066666666668,59.018732592655546,47.88388227015738,NaN,NaN,NaN,NaN,0.5971031563176609,17.31344466330676,13006343
2025-09-17T12:30:00-04:00,508.64,508.77,508.37,508.46,NaN,NaN,NaN,508.7839983420609,NaN,NaN,508.17809999999974,510.60487719642845,505.75132280357104,507.52793424110547,507.6309152231644,508.5334571604211,506.72837328590765,9671,8881.533333333333,56.62268039647076,48.95729281388289,NaN,NaN,NaN,NaN,0.5830243594378263,18.12176680265786,12996672
2025-09-17T12:35:00-04:00,508.47,508.665,508.35,508.51,NaN,NaN,NaN,508.7839983420609,NaN,NaN,508.13589999999976,510.46268034220293,505.8091196577966,507.52793424110547,507.6429336976742,508.5450561719884,506.74081122336,7093,8426.566666666668,57.173394019529184,50.23425221866292,NaN,NaN,NaN,NaN,0.5638797623351243,18.815101962463235,13003765
2025-09-17T12:40:00-04:00,508.47,508.5,508.08,508.27,NaN,NaN,NaN,508.7839983420609,NaN,NaN,508.0950999999997,510.3379887536258,505.85221124637366,507.52793424110547,507.6506312492447,508.5500272163756,506.75123528211384,6300,7873.966666666666,53.65230189556894,51.016116308726716,NaN,NaN,NaN,NaN,0.5543169221683302,18.700482833631707,12997465
2025-09-17T12:45:00-04:00,508.22,508.29,507.95,508.21,NaN,NaN,NaN,508.7839983420609,NaN,NaN,508.0520999999997,510.2000823931191,505.90411760688033,507.52793424110547,507.6544528234489,508.5514569581375,506.75744868876023,4042,7580.6,52.77720827170443,51.94194465348833,NaN,NaN,NaN,NaN,0.5390085705848803,18.248346303353618,12993423
2025-09-17T12:50:00-04:00,508.28,508.56,508.03,508.21,NaN,NaN,NaN,508.7839983420609,NaN,NaN,508.01369999999974,510.0787693065838,505.9486306934157,507.52793424110547,507.6615333275942,508.5557342826121,506.76733237257633,6180,7142.466666666666,52.77720827170443,52.78580497641825,NaN,NaN,NaN,NaN,0.5383651012573909,18.357716457165832,12993423
2025-09-17T12:55:00-04:00,508.23,508.4,508.06,508.11,NaN,NaN,NaN,508.7839983420609,NaN,NaN,507.9692999999997,509.9258653684843,506.01273463151506,507.52793424110547,507.6654735192539,508.55749391382625,506.77345312468157,4014,6880.066666666667,51.16415006069908,53.313443945634354,NaN,NaN,NaN,NaN,0.5241961654532897,18.459274457134317,12989409
2025-09-17T13:00:00-04:00,508.1,508.59,508.1,508.5,NaN,NaN,NaN,508.7839983420609,NaN,NaN,507.93019999999973,509.76057368889906,506.0998263111004,507.52793424110547,507.6740252268526,508.56429150568573,506.7837589480195,6371,6656.966666666666,56.71988279146226,53.67835648334175,NaN,NaN,NaN,NaN,0.5217535822066227,18.92344452624664,12995780
2025-09-17T13:05:00-04:00,508.5,508.65,508.34,508.42,NaN,NaN,NaN,508.7839983420609,NaN,NaN,507.89119999999974,509.59036633704596,506.1920336629535,507.6126690509603,507.6793043980933,508.56896256179465,506.7896462343919,3637,6488.433333333333,55.32939063030212,53.65775592260389,NaN,NaN,NaN,NaN,0.5066283263347212,19.469597348863715,12992143
2025-09-17T13:10:00-04:00,508.43,508.58,508.3,508.54,NaN,NaN,NaN,508.7839983420609,NaN,NaN,507.85559999999975,509.41888070444736,506.29231929555215,507.6126690509603,507.6846716934792,508.57370177384587,506.7956416131125,3732,6409.466666666666,57.03101711421389,53.78721695510071,NaN,NaN,NaN,NaN,0.49044058873938207,19.83943382835667,12995875
2025-09-17T13:15:00-04:00,508.5,508.84,508.4,508.75,506.9952665072024,506.9952665072024,506.9952665072024,NaN,NaN,NaN,507.83619999999974,509.3289351542892,506.3434648457103,507.84410819261456,507.69268329312354,508.58244770873006,506.802918877517,4557,6345.2,59.90914699374967,54.611854796631114,NaN,NaN,NaN,NaN,0.48683768954371176,20.700075827257415,13000432
2025-09-17T13:20:00-04:00,508.75,508.89,508.43,508.43,507.046390756875,NaN,NaN,NaN,NaN,NaN,507.8191999999997,509.2643800721461,506.3740199278533,507.8632865540917,507.7005318203078,508.59026942808686,506.8107942125287,4949,6268.633333333333,53.9761689887621,55.08665945286641,NaN,NaN,NaN,NaN,0.48492071171915946,21.594177571068833,12995483
2025-09-17T13:25:00-04:00,508.44,508.56,508.39,508.49,507.046390756875,NaN,NaN,NaN,NaN,NaN,507.7977999999997,509.16903325551243,506.426566744487,507.8632865540917,507.70784758810424,508.5965837449782,506.8191114312303,5321,6208.233333333334,54.87846578588985,55.46009622585795,NaN,NaN,NaN,NaN,0.46242637516779206,22.267090112581386,13000804
2025-09-17T13:30:00-04:00,508.5,508.93,508.49,508.92,507.15762050368164,NaN,NaN,NaN,NaN,NaN,507.7969999999997,509.165564211564,506.42843578843537,507.9849033946187,507.7175754498443,508.60809248205067,506.8270584176379,5191,6176.466666666666,60.808538244200015,55.845591861208014,NaN,NaN,NaN,NaN,0.46082449122723534,23.588730267989323,13005995
2025-09-17T13:35:00-04:00,508.89,509.8,508.87,509.74,507.7263650262416,NaN,NaN,NaN,NaN,NaN,507.8087999999997,509.23287241428375,506.3847275857156,508.57892271569494,507.76172712160223,508.68284808826394,506.84060615494053,14787,6485.3,69.13820163571233,56.56841107856922,NaN,NaN,NaN,NaN,0.49433702756814757,25.93146143888302,13020782
2025-09-17T13:40:00-04:00,509.77,509.97,509.42,509.42,508.08448479777604,NaN,NaN,NaN,NaN,NaN,507.81679999999966,509.2721498002503,506.361450199749,508.718138172556,507.78997287154004,508.7316045375591,506.84834120552097,9142,6519.366666666667,63.469041332547455,57.057436859717555,NaN,NaN,NaN,NaN,0.49831295417042354,28.270613530677707,13011640
2025-09-17T13:45:00-04:00,509.45,509.52,509.07,509.39,508.08448479777604,NaN,NaN,NaN,NaN,NaN,507.8515999999997,509.37112945381494,506.3320705461844,508.718138172556,507.81334851138365,508.7665312130402,506.8601658097271,9207,6594.533333333334,62.94792101060328,57.4699030733657,NaN,NaN,NaN,NaN,0.49486202887253533,29.259548129061034,13002433
2025-09-17T13:50:00-04:00,509.37,509.53,509.1,509.185,508.08448479777604,NaN,NaN,NaN,NaN,NaN,507.8904999999997,509.4446007048982,506.33639929510116,508.718138172556,507.82751421391146,508.78677915168237,506.86824927614055,5937,6678.933333333333,59.36121218420775,57.87768237969704,NaN,NaN,NaN,NaN,0.4902290268102078,30.19108180133751,12996496
2025-09-17T13:55:00-04:00,509.2,509.69,509.13,509.53,508.08448479777604,NaN,NaN,NaN,NaN,NaN,507.92909999999966,509.5469858924543,506.311214107545,508.718138172556,507.8539206819795,508.82724471258626,506.88059665137274,10112,6763.333333333333,63.16507175854256,58.619672628756916,NaN,NaN,NaN,NaN,0.49521266775233597,31.27154862677229,13006608
2025-09-17T14:00:00-04:00,509.69,510.43,508.48,508.66,508.08448479777604,NaN,NaN,NaN,NaN,NaN,507.9716999999997,509.5517108989978,506.39168910100165,508.718138172556,507.91080521559843,508.90064942105283,506.920961010144,27629,7506.166666666667,50.36300219891665,58.4472293378435,NaN,NaN,NaN,NaN,0.5991260486271683,33.0818061463067,12978979
2025-09-17T14:05:00-04:00,508.61,508.76,507.95,508,NaN,NaN,NaN,510.1670847739843,510.1670847739843,510.1670847739843,508.00169999999974,509.5247319893694,506.4786680106301,508.718138172556,507.919342967716,508.89751968795656,506.9411662474754,17460,7917.2,43.20846716185534,57.87896627364038,NaN,NaN,NaN,NaN,0.6141884737252278,33.22512001566829,12961519
2025-09-17T14:10:00-04:00,508.01,508.22,507.1,507.1,NaN,NaN,NaN,509.54244455698506,NaN,NaN,508.0188999999998,509.48013275368646,506.55766724631314,508.718138172556,507.9062798207345,508.8729549560587,506.93960468541025,20107,8349.633333333333,35.75029092698691,56.38113828332071,NaN,NaN,NaN,NaN,0.6503178684591404,31.506983277167084,12941412
2025-09-17T14:15:00-04:00,507.05,507.59,506.67,507.47,NaN,NaN,NaN,509.0523334407584,NaN,NaN,508.04089999999974,509.43368812483595,506.6481118751635,508.718138172556,507.8953901242174,508.857789142591,506.93299110584377,11465,8526.866666666667,40.31167919083314,55.30844460907293,NaN,NaN,NaN,NaN,0.6695808778549132,29.339315716717707,12952877
2025-09-17T14:20:00-04:00,507.39,508.18,506.91,508.03,NaN,NaN,NaN,509.0523334407584,NaN,NaN,508.05229999999983,509.43517846182624,506.6694215381734,508.718138172556,507.89289514237527,508.84915436611425,506.9366359186363,9351,8455.8,46.502271502276784,54.55639135107742,NaN,NaN,NaN,NaN,0.7124679580081323,28.04723099021575,12962228
2025-09-17T14:25:00-04:00,508.09,508.91,507.9,508.9,NaN,NaN,NaN,509.0523334407584,NaN,NaN,508.08249999999975,509.4721406012471,506.69285939875243,508.718138172556,507.8997969017849,508.8535979508746,506.9459958526952,7284,8139.933333333333,54.41274056397944,54.16379089180811,NaN,NaN,NaN,NaN,0.7337202467218406,27.73807367720381,12969512
2025-09-17T14:30:00-04:00,508.9,509.1,507.58,507.92,506.3504151913751,506.3504151913751,506.3504151913751,NaN,NaN,NaN,508.0778999999998,509.4681389580384,506.6876610419611,508.46543739547894,507.9049091315502,508.85135136216195,506.95846690093845,12380,8451,46.136985708023865,53.60384922889824,NaN,NaN,NaN,NaN,0.7898830862417119,26.901342523048488,12957132
2025-09-17T14:35:00-04:00,507.94,508.36,506.96,506.96,506.3504151913751,NaN,NaN,NaN,NaN,NaN,508.0529999999998,509.47741847790667,506.628581522093,508.46543739547894,507.8963049481474,508.83634645187925,506.9562634444156,13319,8647.866666666667,39.75787648512909,52.523807135986765,NaN,NaN,NaN,NaN,0.8334628657958777,25.172383392267182,12943813
2025-09-17T14:40:00-04:00,506.93,507.72,506.6,507.16,506.3504151913751,NaN,NaN,NaN,NaN,NaN,508.04039999999986,509.4849052301992,506.5958947698005,508.46543739547894,507.87700509231183,508.8120737307289,506.94193645389475,19927,9185.866666666667,41.57041429184135,51.149655425104,NaN,NaN,NaN,NaN,0.8539298039533153,23.673388137194358,12963740
2025-09-17T14:45:00-04:00,507.23,508.3,506.52,508.3,506.3504151913751,NaN,NaN,NaN,NaN,NaN,508.0547999999999,509.49500826270383,506.61459173729594,508.46543739547894,507.8738073004326,508.80034572763134,506.94726887323384,14545,9522.766666666666,50.67948270628386,49.8311755015734,NaN,NaN,NaN,NaN,0.9200776750995091,22.458585526558654,12978285
2025-09-17T14:50:00-04:00,508.26,508.44,506.8,507.32,506.3504151913751,NaN,NaN,NaN,NaN,NaN,508.05259999999987,509.4969493205949,506.6082506794048,506.78334991638314,507.8666547519987,508.7851307021258,506.94817880187156,15986,9909.4,44.28759467899417,48.46107216917674,NaN,NaN,NaN,NaN,0.9715006983066861,21.506312608382324,12962299
2025-09-17T14:55:00-04:00,507.4,508.77,507.26,508.72,506.3504151913751,NaN,NaN,NaN,NaN,NaN,508.07119999999986,509.5254620947262,506.6169379052735,506.5062441257506,507.87348033218353,508.78515325199197,506.9618074123751,14335,10134.366666666667,53.34112380031321,47.77487236844173,NaN,NaN,NaN,NaN,1.0099649341419221,21.029204705523178,12976634
2025-09-17T15:00:00-04:00,508.72,510.05,508.67,509.87,506.6419708109637,NaN,NaN,NaN,NaN,NaN,508.1233999999999,509.64333084047405,506.60346915952573,506.6134344160806,507.91765720734656,508.8558524596306,506.9794619550625,22059,10547.3,59.205503233687956,47.76375030054745,NaN,NaN,NaN,NaN,1.0363960102746417,21.84926390370625,12998693
2025-09-17T15:05:00-04:00,509.97,510.91,509.73,510.54,507.56460850137444,NaN,NaN,NaN,NaN,NaN,508.18899999999985,509.8323307640155,506.5456692359842,507.5707475328645,508.0049537743855,509.03338459295463,506.9765229558164,30233,11318.633333333333,62.18735780445352,47.69391358954109,NaN,NaN,NaN,NaN,1.0466534381121677,23.24034288239355,13028926
2025-09-17T15:10:00-04:00,510.56,511.1,509.2,509.5,507.56460850137444,NaN,NaN,NaN,NaN,NaN,508.2391999999998,509.8863021340782,506.5920978659214,507.5707475328645,508.04755909446897,509.1033270458407,506.99179114309726,19371,11754.333333333334,55.41617353219157,48.05485439906073,NaN,NaN,NaN,NaN,1.107606763961301,23.726865401430413,13009555
2025-09-17T15:15:00-04:00,509.53,510.72,509.51,510.34,507.56460850137444,NaN,NaN,NaN,NaN,NaN,508.2949999999999,510.0315367832953,506.5584632167045,507.5707475328645,508.0809972612101,509.16163147539294,507.00036304702724,13901,12082.966666666667,59.27336896722356,49.20234738515846,NaN,NaN,NaN,NaN,1.1156348522497814,24.178636311964645,13023456
2025-09-17T15:20:00-04:00,510.23,511,510.11,510.88,507.6422858124745,NaN,NaN,NaN,NaN,NaN,508.35679999999985,510.2314890515848,506.4821109484149,507.7493027368266,508.1294104792668,509.2557108371578,507.00311012137587,17017,12444.2,61.574858164906,51.04695933072411,NaN,NaN,NaN,NaN,1.0995180770890818,24.830941438791573,13040473
2025-09-17T15:25:00-04:00,510.91,511.21,510.51,510.84,507.98422736645296,NaN,NaN,NaN,NaN,NaN,508.42339999999984,510.4064919696452,506.4403080303545,508.25944218946125,508.17358880801,509.34250494375937,507.0046726722606,14964,12809.2,61.298526024318136,52.546019818830175,NaN,NaN,NaN,NaN,1.070981071582718,25.609423429536065,13025509
2025-09-17T15:30:00-04:00,510.83,511.3,510.14,510.35,507.98422736645296,NaN,NaN,NaN,NaN,NaN,508.48399999999987,510.51316436002486,506.4548356399749,508.359553751569,508.2126191552731,509.4115378604385,507.0137004501077,15105,13100.333333333334,57.872274032140425,53.35816285667757,NaN,NaN,NaN,NaN,1.0773395664696683,25.708059675401707,13010404
2025-09-17T15:35:00-04:00,510.435,510.84,510.1,510.13,507.98422736645296,NaN,NaN,NaN,NaN,NaN,508.5451999999999,510.5846410606599,506.5057589393399,508.359553751569,508.2381431807764,509.45237856426803,507.0239077972847,11298,13355.7,56.34937996329814,53.4964942423432,NaN,NaN,NaN,NaN,1.053243883150403,25.732159329269745,12999106
2025-09-17T15:40:00-04:00,510.05,510.28,509.76,509.76,507.98422736645296,NaN,NaN,NaN,NaN,NaN,508.59399999999994,510.63060600015746,506.5573939998424,508.359553751569,508.26112830227237,509.4829353325685,507.03932127197623,13045,13666.133333333333,53.785892186444975,54.04284470508757,NaN,NaN,NaN,NaN,1.0151550343539444,25.180432800922446,12986061
2025-09-17T15:45:00-04:00,509.75,509.865,509.28,509.64,507.98422736645296,NaN,NaN,NaN,NaN,NaN,508.6463999999999,510.6529174207642,506.63988257923563,508.359553751569,508.277515888016,509.5006522315234,507.0543795445086,11967,13913.133333333333,52.94463597992208,54.98475609757277,NaN,NaN,NaN,NaN,0.9844296747572366,23.923149525652203,12974094
2025-09-17T15:50:00-04:00,509.59,509.93,509.04,509.46,507.98422736645296,NaN,NaN,NaN,NaN,NaN,508.69359999999995,510.66307915952467,506.7241208404752,508.359553751569,508.31895800645896,509.5405705301255,507.09734548279243,34868,14910.433333333332,51.63990410075101,55.70400536963775,NaN,NaN,NaN,NaN,0.9776846979888616,22.40660102847612,12939226
2025-09-17T15:55:00-04:00,509.42,510.2,509.13,509.99,507.98422736645296,NaN,NaN,NaN,NaN,NaN,508.74749999999995,510.7084163673383,506.7865836326616,508.359553751569,508.42709351790177,509.66279390419527,507.19139313160827,81041,17434.433333333334,55.144987358902966,56.02296998768197,NaN,NaN,NaN,NaN,0.9842786481325139,21.3609618126754,13020267