time,open,high,low,close,Long Stop,Long Stop Start,Buy Label,Short Stop,Short Stop Start,Sell Label,Basis,Upper,Lower,ATR Trailing Stoploss,VWAP,Upper Band #1,Lower Band #1,Volume,Volume MA,RSI,RSI-based MA,Regular Bullish,Regular Bullish Label,Regular Bearish,Regular Bearish Label,ATR,ADX,OnBalanceVolume,Histogram,MACD,Signal
2025-09-22T10:30:00-04:00,514.575,515.48,514.565,515.17,NaN,NaN,NaN,515.8806477302611,NaN,NaN,512.4547999999999,516.1073191088706,508.8022808911292,512.9933706420379,514.7292194306681,515.775610131824,513.6828287295122,20473,54061.73333333333,58.95037187159103,58.741333865540106,NaN,NaN,NaN,NaN,1.0699232050969452,20.989165976439146,12475217,-0.06484009881997266,0.5912557287880418,0.6560958276080144
2025-09-22T10:35:00-04:00,515.19,516,515.19,515.9,512.6534334046731,512.6534334046731,512.6534334046731,NaN,NaN,NaN,512.5261999999999,516.303607873205,508.7487921267948,513.5956965136303,514.7522221459858,515.7965517722735,513.7078925196981,12302,54032.166666666664,62.120372809517015,57.1795728615736,NaN,NaN,NaN,NaN,1.0527858333043092,21.662894944316534,12487519,0.019187667145466714,0.6800804115398478,0.6608927443943811
2025-09-22T10:40:00-04:00,515.9,516.3,515.88,516.23,513.2248682499152,NaN,NaN,NaN,NaN,NaN,512.6048,516.5211064027621,508.6884935972378,514.1665572109042,514.7949554047506,515.8505576347186,513.7393531747825,16479,54064.73333333333,63.49284610567217,57.23235715936044,NaN,NaN,NaN,NaN,1.0075868452111414,22.470481294339116,12503998,0.08588338980877686,0.7682469816553521,0.6823635918465752
2025-09-22T10:45:00-04:00,516.21,516.61,515.82,515.89,513.3723742385555,NaN,NaN,NaN,NaN,NaN,512.6854,516.7016787951188,508.66912120488115,514.5082457687234,514.8397996257662,515.9042302991003,513.7753689524321,18898,54095,61.038956786816165,56.86602574945194,NaN,NaN,NaN,NaN,0.9920449276960573,23.407841167347705,12485100,0.09526584314085551,0.8014458957726447,0.7061800526317892
2025-09-22T10:50:00-04:00,515.91,516.32,515.78,515.93,513.3723742385555,NaN,NaN,NaN,NaN,NaN,512.7656,516.8765724592056,508.6546275407943,514.5082457687234,514.8629492283321,515.9293227532971,513.7965757033671,11156,54163.7,61.22880439353355,56.77514965193809,NaN,NaN,NaN,NaN,0.9597560042892016,24.22583906483175,12496256,0.09226718801510658,0.8215140376506724,0.7292468496355659
2025-09-22T10:55:00-04:00,515.93,516.1,515.72,515.93,513.3723742385555,NaN,NaN,NaN,NaN,NaN,512.8519999999999,517.0429994035563,508.6610005964434,514.5082457687234,514.8764661355581,515.9425925778834,513.8103396932328,7328,53930.566666666666,61.22880439353355,56.86289444732656,NaN,NaN,NaN,NaN,0.9183448611256868,24.901937662519533,12496256,0.0789024862886829,0.8278749574964195,0.7489724712077366
2025-09-22T11:00:00-04:00,515.89,516.26,515.79,515.845,513.3723742385555,NaN,NaN,NaN,NaN,NaN,512.9372999999999,517.1943619963132,508.68023800368667,514.6241018335863,514.914867806134,515.9811014365273,513.8486341757407,20890,54146.76666666667,60.50223967911589,56.80667833473398,NaN,NaN,NaN,NaN,0.8863202281881397,25.64474456410019,12475366,0.054136810974136695,0.8166434849254074,0.7625066739512707
2025-09-22T11:05:00-04:00,515.84,516.01,515.63,515.72,513.3723742385555,NaN,NaN,NaN,NaN,NaN,513.0174999999999,517.3297872122153,508.7052127877846,514.6241018335863,514.931625032643,515.9943245719825,513.8689254933034,11605,54046.63333333333,59.386199507886,57.06510731030098,NaN,NaN,NaN,NaN,0.8501544976032722,26.08822632191555,12463761,0.020847388615875095,0.7885659097211146,0.7677185211052395
2025-09-22T11:10:00-04:00,515.7,515.76,514.93,515.36,513.3723742385555,NaN,NaN,NaN,NaN,NaN,513.1015,517.4293813523784,508.7736186476216,514.6241018335863,514.9385704066867,515.9937670786752,513.8833737346982,10192,53776.3,56.172471770583314,57.439617483027725,NaN,NaN,NaN,NaN,0.8487148906316129,25.490502103818923,12453569,-0.031084133141725312,0.7288633546780829,0.7599474878198083
2025-09-22T11:15:00-04:00,515.33,515.58,515.09,515.1,513.3723742385555,NaN,NaN,NaN,NaN,NaN,513.1786999999999,517.5087142309841,508.8486857690158,514.6241018335863,514.9421522983275,515.991927889209,513.892376707446,6992,53584.4,53.90366568268259,57.82259109283598,NaN,NaN,NaN,NaN,0.8230923984436412,24.935472472729202,12446577,-0.08552521205304531,0.6530409727535016,0.7385661848065469
2025-09-22T11:20:00-04:00,515.06,515.32,515.04,515.1,513.3723742385555,NaN,NaN,NaN,NaN,NaN,513.2464999999999,517.5885480191868,508.90445198081295,514.6241018335863,514.9448205919596,515.9882097426074,513.9014314413117,7946,53098,53.90366568268259,58.236786416352416,NaN,NaN,NaN,NaN,0.7843000842691017,24.34607965885433,12446577,-0.121897819603205,0.5861939103025406,0.7080917299057456
2025-09-22T11:25:00-04:00,515.12,515.21,514.66,515.1,513.3723742385555,NaN,NaN,NaN,NaN,NaN,513.3196999999999,517.6608645489159,508.9785354510838,514.6241018335863,514.9456778114726,515.9791394762009,513.9122161467443,12163,52720.333333333336,53.90366568268259,58.373829400187866,NaN,NaN,NaN,NaN,0.7675643639641707,23.238733832247004,12446577,-0.14476091736970564,0.5271405831936136,0.6719015005633192
2025-09-22T11:30:00-04:00,515.15,515.49,514.78,514.88,513.3723742385555,NaN,NaN,NaN,NaN,NaN,513.3882999999998,517.7175015939384,509.05909840606125,514.6241018335863,514.9476485345381,515.97140075006,513.9238963190162,12343,52091.5,51.69697062704644,58.119905833408055,NaN,NaN,NaN,NaN,0.7634526236810182,22.540097242690496,12434234,-0.1716679413891231,0.4573165738269154,0.6289845152160385
2025-09-22T11:35:00-04:00,514.83,514.91,514.15,514.42,513.3723742385555,NaN,NaN,NaN,NaN,NaN,513.4485999999998,517.7495203853456,509.14767961465407,514.6241018335863,514.9405736135698,515.9578796222838,513.9232676048557,10336,51416.066666666666,47.3336801350393,57.490193937741594,NaN,NaN,NaN,NaN,0.763206007703802,21.005904958822423,12423898,-0.21462408273215972,0.3607044118008389,0.5753284945329986
2025-09-22T11:40:00-04:00,514.4,514.48,514.03,514.09,513.3723742385555,NaN,NaN,NaN,NaN,NaN,513.5079,517.7605265249531,509.2552734750468,514.6241018335863,514.9298229577144,515.9435951863784,513.9160507290503,9777,50571.36666666667,44.43616072803054,56.453464570344416,NaN,NaN,NaN,NaN,0.7408341500106765,19.5879092554023,12414121,-0.25660219998491285,0.2545757445518575,0.5111779445367703
2025-09-22T11:45:00-04:00,514.16,514.5,514.13,514.28,513.3723742385555,NaN,NaN,NaN,NaN,NaN,513.5799,517.7598552581876,509.39994474181225,514.6241018335863,514.9227523133534,515.9329575797459,513.9125470469609,7688,49323.7,46.46802048769508,55.33543940449999,NaN,NaN,NaN,NaN,0.717203139295626,18.24288217574343,12421809,-0.26199671490917475,0.18368205090030187,0.44567876580947663
2025-09-22T11:50:00-04:00,514.31,514.42,513.95,513.98,513.3723742385555,NaN,NaN,NaN,NaN,NaN,513.6379,517.7575378919106,509.51826210808935,514.511281466869,514.9099469145575,515.917151537448,513.902742291667,10996,40608.5,43.74776502614065,53.92507647024774,NaN,NaN,NaN,NaN,0.6995457722030751,17.253343133737566,12410813,-0.2748520590104827,0.10211369204637322,0.3769657510568559
2025-09-22T11:55:00-04:00,513.94,514.07,513.77,513.87,513.3723742385555,NaN,NaN,NaN,NaN,NaN,513.6988999999999,517.7393946678545,509.65840533214526,514.1460251734952,514.8971924660766,515.9043088422993,513.8900760898539,8883,23368.966666666667,42.75934246284198,52.619389732821006,NaN,NaN,NaN,NaN,0.6710067884742889,16.593426547419924,12401930,-0.27895800835491247,0.028268240613215312,0.3072262489681278
2025-09-22T12:00:00-04:00,513.88,514.06,512.65,512.96,NaN,NaN,NaN,515.6443157175124,515.6443157175124,515.6443157175124,513.7393,517.7084087212066,509.7701912787932,514.0438201387963,514.8276528604322,515.8686664373453,513.7866392835191,30388,20919.266666666666,35.59454914552431,50.78837150082035,NaN,NaN,NaN,NaN,0.7237920178689803,17.311783051812174,12371542,-0.3277830952458941,-0.10250262008923983,0.22528047515665425
2025-09-22T12:05:00-04:00,512.81,513.39,512.58,513.2,NaN,NaN,NaN,515.2807104576256,NaN,NaN,513.7895,517.6654712331894,509.91352876681066,514.0388759110635,514.7747565398765,515.8435041071818,513.7060089725712,22520,19940.266666666666,38.52043878211733,49.16634538571919,NaN,NaN,NaN,NaN,0.7299497308783349,18.049311213198894,12394062,-0.32794038209487086,-0.18464500246193438,0.1432953796329365
2025-09-22T12:10:00-04:00,513.17,513.97,513.15,513.66,NaN,NaN,NaN,515.2807104576256,NaN,NaN,513.8427,517.6362035046969,510.04919649530314,514.0388759110635,514.7376515720845,515.8094759507964,513.6658271933726,24448,19861.066666666666,43.79117293910871,47.97269776143297,NaN,NaN,NaN,NaN,0.7363818929584574,17.757048109895223,12418510,-0.28279806098670807,-0.2102021966004486,0.07259586438625949
2025-09-22T12:15:00-04:00,513.68,513.95,513.4,513.61,NaN,NaN,NaN,515.2807104576256,NaN,NaN,513.8845,517.6203288237534,510.1486711762466,514.0388759110635,514.7171400582781,515.7890058893317,513.6452742272245,15009,19368,43.356074859698445,46.827688857991,NaN,NaN,NaN,NaN,0.7230689006042867,17.485660942541813,12403501,-0.2435317128388429,-0.2318187766622941,0.011712936176548769
2025-09-22T12:20:00-04:00,513.6,514.12,513.6,514.05,NaN,NaN,NaN,515.2807104576256,NaN,NaN,513.9341000000001,517.6110844655929,510.2571155344073,513.3691007288509,514.6991992934874,515.7654309147624,513.6329676722123,18347,18708.5,48.23068987136292,46.2604187223324,NaN,NaN,NaN,NaN,0.7085639791325506,16.94753121494828,12421848,-0.17818100425484845,-0.21101331914201182,-0.03283231488716336
2025-09-22T12:25:00-04:00,514.1,514.68,514.03,514.59,NaN,NaN,NaN,515.2807104576256,NaN,NaN,514.0091,517.5820896110341,510.43611038896586,513.1288244664646,514.6943277972135,515.7513475023068,513.6373080921203,15152,17815.733333333334,53.517593046409964,46.23284210545579,NaN,NaN,NaN,NaN,0.7043808377659382,15.896921207418616,12437000,-0.09311903908556693,-0.149231113744122,-0.05611207465855509
2025-09-22T12:30:00-04:00,514.59,514.99,514.56,514.93,NaN,NaN,NaN,515.2807104576256,NaN,NaN,514.0781000000001,517.5857128008013,510.5704871991989,513.4674222775997,514.6964747988466,515.7450184542903,513.6479311434028,13637,16525.033333333333,56.52789130028519,46.4202867924274,NaN,NaN,NaN,NaN,0.6847822064969471,15.354296815477547,12450637,-0.012712824568940892,-0.0720031053697312,-0.05929028080079031
2025-09-22T12:35:00-04:00,514.95,515.57,514.81,515.5,513.000492248347,513.000492248347,513.000492248347,NaN,NaN,NaN,514.1589,517.6071779992903,510.7106220007097,513.9719378220797,514.711037561862,515.7507963233396,513.6712788003844,21022,15988.033333333333,61.07870279590922,46.93278944337216,NaN,NaN,NaN,NaN,0.6901549060328869,15.57781017941803,12471659,0.07526726678230121,0.034793802677086205,-0.040473464105215004
2025-09-22T12:40:00-04:00,515.52,515.93,515.17,515.32,513.3563789643312,NaN,NaN,NaN,NaN,NaN,514.2385,517.6056104823466,510.8713895176535,514.2715502576636,514.7230726696997,515.758958472063,513.6871868673364,13821,15103.1,58.97899976437211,47.45293438175257,NaN,NaN,NaN,NaN,0.6951438413162514,16.187704335842987,12457838,0.11534765844503159,0.1037111089510745,-0.0116365494939571
2025-09-22T12:45:00-04:00,515.31,515.44,514.9,515.29,513.3563789643312,NaN,NaN,NaN,NaN,NaN,514.3193000000001,517.5881346608397,511.0504653391605,514.2715502576636,514.7286172326017,515.7598832984119,513.6973511667915,10083,14453.466666666667,58.6173173093112,48.258908465629126,NaN,NaN,NaN,NaN,0.6840621383650961,16.285391381647756,12447755,0.132614114880323,0.15413109410644665,0.021516979226123653
2025-09-22T12:50:00-04:00,515.23,515.42,515.02,515.15,513.3563789643312,NaN,NaN,NaN,NaN,NaN,514.3903000000001,517.5728702882668,511.2077297117335,514.2715502576636,514.7388222203563,515.7610717265185,513.7165727141941,19737,14475.133333333333,56.864789417746664,49.146667657751706,NaN,NaN,NaN,NaN,0.6637719856247305,16.37610078132361,12428018,0.1273539051038005,0.18070936060587428,0.053355455502073774
2025-09-22T12:55:00-04:00,515.1,515.1,514.43,514.92,513.3563789643312,NaN,NaN,NaN,NaN,NaN,514.4623000000001,517.5243785162845,511.4002214837158,514.2715502576636,514.7395688967904,515.7569322230204,513.7222055705604,8767,14312.6,54.00797906949757,49.68523612788045,NaN,NaN,NaN,NaN,0.6677882723658232,15.468328389739048,12419251,0.10221631119397712,0.18112584449454516,0.07890953330056805
2025-09-22T13:00:00-04:00,514.92,515.24,514.72,514.78,513.3563789643312,NaN,NaN,NaN,NaN,NaN,514.5323000000001,517.4571310789246,511.60746892107557,514.2715502576636,514.7409283309829,515.754419840034,513.7274368219319,7207,13870.4,52.286075202431775,50.29511542618695,NaN,NaN,NaN,NaN,0.6572319671968344,14.82704202833827,12412044,0.07144833030308143,0.16821994617941982,0.0967716158763384
2025-09-22T13:05:00-04:00,514.82,514.83,514.52,514.72,513.3563789643312,NaN,NaN,NaN,NaN,NaN,514.6023,517.3699973895998,511.8346026104002,514.2715502576636,514.7405261324227,515.7500178285658,513.7310344362796,7333,13704.766666666666,51.52784539068031,50.9214370638897,NaN,NaN,NaN,NaN,0.6324296838256361,13.903421751032615,12404711,0.04370680823934407,0.1514051261755185,0.10769831793617442
2025-09-22T13:10:00-04:00,514.71,514.82,514.62,514.7,513.3563789643312,NaN,NaN,NaN,NaN,NaN,514.6699000000001,517.273888087601,512.0659119123992,514.2715502576636,514.7403757672405,515.7470745735291,513.7336769609519,5163,13327.566666666668,51.26099657088428,52.04046902284398,NaN,NaN,NaN,NaN,0.6015418492666653,13.045774350677366,12399548,0.021769558259172983,0.13491026576014065,0.11314070750096766
2025-09-22T13:15:00-04:00,514.7,515,514.7,514.97,513.3563789643312,NaN,NaN,NaN,NaN,NaN,514.7467,517.1470946426601,512.3463053573399,514.2715502576636,514.741774514755,515.7438602139932,513.7396888155167,8811,12991.333333333334,54.67365231866023,53.1942699897399,NaN,NaN,NaN,NaN,0.5800031457476145,12.55132560766667,12408359,0.02307780574747649,0.14198796468531327,0.11891015893783678
2025-09-22T13:20:00-04:00,514.98,515.29,514.89,515.27,513.3563789643312,NaN,NaN,NaN,NaN,NaN,514.8327000000002,516.9805223483529,512.6848776516474,514.2715502576636,514.7459652679328,515.7437429539837,513.7481875818819,9776,12945.333333333334,58.17766959473407,54.221876893713144,NaN,NaN,NaN,NaN,0.5671457781942119,12.558626608392792,12418135,0.04074923114078499,0.169846697863818,0.12909746672303302
2025-09-22T13:25:00-04:00,515.3,515.34,514.99,515.1,513.3563789643312,NaN,NaN,NaN,NaN,NaN,514.8923000000001,516.8962832434889,512.8883167565112,514.3049084803814,514.7503507242401,515.7434753180399,513.7572261304402,10627,13055.3,55.556686621254094,55.09334916239568,NaN,NaN,NaN,NaN,0.5516353654660555,12.644959759048167,12407508,0.037663236383086746,0.17617651220189146,0.1385132758188047
2025-09-22T13:30:00-04:00,515.11,515.2,514.88,515.12,513.3563789643312,NaN,NaN,NaN,NaN,NaN,514.8551000000001,516.7697493046912,512.940450695309,514.3049084803814,514.7526005836162,515.7425439333814,513.762657233851,6898,12588.9,55.80892328860606,55.634651549341626,NaN,NaN,NaN,NaN,0.5350899822184837,12.486831857355945,12414406,0.0337681797484074,0.18072350050431396,0.14695532075590656
2025-09-22T13:35:00-04:00,515.1,515.14,514.93,514.96,513.3563789643312,NaN,NaN,NaN,NaN,NaN,514.7945000000001,516.4873865880674,513.1016134119328,514.3049084803814,514.7547312994036,515.740844650265,513.7686179485422,8095,12471.9,53.20728132214495,55.612486426179835,NaN,NaN,NaN,NaN,0.5118692692028803,12.339998805784596,12406311,0.018006060109076488,0.16946289589225216,0.15145683578317568
2025-09-22T13:40:00-04:00,514.98,515.25,514.96,515.15,513.3809030315787,NaN,NaN,NaN,NaN,NaN,514.7949000000001,516.4881129104978,513.1016870895024,514.3886331419553,514.7585402822258,515.7402001255224,513.7768804389292,10305,12475.666666666666,55.839924469530416,55.563345938268775,NaN,NaN,NaN,NaN,0.49602146425981486,12.414079331821556,12416616,0.017927314521685334,0.17386597893528233,0.155938664413597
2025-09-22T13:45:00-04:00,515.14,515.27,514.92,514.94,513.4015438028705,NaN,NaN,NaN,NaN,NaN,514.7699,516.4162444234267,513.1235555765733,514.4059065135642,514.7606405643605,515.7389774411902,513.7823036875309,7342,12487.333333333334,52.335168984075416,54.938807808852076,NaN,NaN,NaN,NaN,0.48559135966982975,12.379886507374438,12409274,0.0021148064232988373,0.15858217244272055,0.1564673660194217
2025-09-22T13:50:00-04:00,514.99,515.01,514.64,514.65,513.4015438028705,NaN,NaN,NaN,NaN,NaN,514.7517,516.3827531690947,513.1206468309053,514.4059065135642,514.7606904007432,515.7349735666847,513.7864072348017,8302,12499.2,47.86716082819908,54.145105027696864,NaN,NaN,NaN,NaN,0.47733483397912796,11.64872954705793,12400972,-0.027840634576996343,0.12166657279817628,0.14950720737517262
2025-09-22T13:55:00-04:00,514.66,514.74,514.41,514.57,513.4015438028705,NaN,NaN,NaN,NaN,NaN,514.7407000000001,516.3690857160803,513.1123142839198,514.4059065135642,514.7591417183512,515.7295381248884,513.788745311814,8367,12372.666666666666,46.68314607132508,53.292664224983575,NaN,NaN,NaN,NaN,0.466810917266336,11.187589308347617,12392605,-0.0516251143703412,0.08497581441224611,0.1366009287825873
2025-09-22T14:00:00-04:00,514.54,514.69,514.47,514.63,513.4015438028705,NaN,NaN,NaN,NaN,NaN,514.7241,516.339688673071,513.108511326929,514.4059065135642,514.7576592315378,515.7237418843788,513.7915765786968,9321,12271.933333333332,47.72747868683999,52.63999917277596,NaN,NaN,NaN,NaN,0.4491815660330282,10.75938765811661,12401926,-0.061242796484898304,0.06004743317646444,0.12129022966136274
2025-09-22T14:05:00-04:00,514.67,514.81,514.49,514.62,513.4015438028705,NaN,NaN,NaN,NaN,NaN,514.7267,516.3411913875385,513.1122086124616,514.4059065135642,514.756738394821,515.7190890473152,513.7943877423269,8058,12196,47.56027259552423,52.179448710349284,NaN,NaN,NaN,NaN,0.4399543113163788,10.04881876602914,12393868,-0.06580448122788936,0.03903462812650105,0.1048391093543904
2025-09-22T14:10:00-04:00,514.62,514.8,514.51,514.79,513.4015438028705,NaN,NaN,NaN,NaN,NaN,514.7517,516.3302254006506,513.1731745993494,514.4059065135642,514.7563835351343,515.7157304744044,513.7970365958643,6480,12086.1,50.720945638937266,52.067653741528254,NaN,NaN,NaN,NaN,0.429243289079492,9.389004794805059,12400348,-0.05532087250655013,0.03568801872120275,0.09100889122775288
2025-09-22T14:15:00-04:00,514.81,515.15,514.53,515.15,513.4015438028705,NaN,NaN,NaN,NaN,NaN,514.7939000000001,516.2981995579528,513.2896004420475,514.4059065135642,514.7581483675106,515.7131275136253,513.8031692213958,9874,12158.966666666667,56.67600273193025,52.43537926590325,NaN,NaN,NaN,NaN,0.4428687684309572,9.549636280582769,12410222,-0.023705289825950243,0.061377278945315084,0.08508256877126533
2025-09-22T14:20:00-04:00,515.16,515.17,514.76,514.8,513.4328848513716,NaN,NaN,NaN,NaN,NaN,514.8309000000002,516.2399588206196,513.4218411793807,514.4059065135642,514.7595758707937,515.7101686604138,513.8089830811736,9926,12123.3,50.31050369800138,52.36748691784019,NaN,NaN,NaN,NaN,0.4405209992573151,9.746396733440788,12400296,-0.025758448508391596,0.05288450813577583,0.07864295664416743
2025-09-22T14:25:00-04:00,514.8,515.07,514.71,515.04,513.4328848513716,NaN,NaN,NaN,NaN,NaN,514.8577000000001,516.2302002149011,513.4851997850992,514.4059065135642,514.7607035576851,515.7084276708482,513.812979444522,6641,12048.566666666668,54.11608974737943,52.32766101989155,NaN,NaN,NaN,NaN,0.43476949931036496,9.769457805691719,12406937,-0.011095761667508433,0.06477325455978189,0.07586901622729032
2025-09-22T14:30:00-04:00,515.05,515.56,515.05,515.36,513.7912339244936,NaN,NaN,NaN,NaN,NaN,514.8773000000001,516.2499430127048,513.5046569872954,514.543805837871,514.7681215284288,515.7117620885464,513.8244809683111,14196,11508.833333333334,58.662084642055554,52.36226209470023,NaN,NaN,NaN,NaN,0.4408573922167661,10.90588256107313,12421133,0.01840615362519621,0.09887670825878558,0.08047055463358938
2025-09-22T14:35:00-04:00,515.38,515.48,515.23,515.31,513.8759505642894,NaN,NaN,NaN,NaN,NaN,514.8921000000001,516.2671259488575,513.5170740511428,514.543805837871,514.7736762998528,515.7143962960798,513.8329563036258,10561,11110.2,57.700139960076235,52.5153659046161,NaN,NaN,NaN,NaN,0.42722472134413997,11.961134119641583,12410572,0.03200798371883837,0.12048053428213734,0.08847255056329897
2025-09-22T14:40:00-04:00,515.32,515.32,515.045,515.14,513.8759505642894,NaN,NaN,NaN,NaN,NaN,514.8915000000001,516.2660664772828,513.5169335227173,514.543805837871,514.7763728054988,515.714437067834,513.8383085431636,7480,10544.6,54.4319300677114,52.41700924598076,NaN,NaN,NaN,NaN,0.41635152696242217,12.30689908098321,12403092,0.02719984570860301,0.12247235769905274,0.09527251199044973
2025-09-22T14:45:00-04:00,515.16,515.265,514.19,514.25,513.8759505642894,NaN,NaN,NaN,NaN,NaN,514.8585000000002,516.2137243356083,513.503275664392,514.543805837871,514.7736998367311,515.7060127592943,513.841386914168,14249,10519.266666666666,41.25681217166229,51.56340430666057,NaN,NaN,NaN,NaN,0.46339784646510146,12.397867210649673,12388843,-0.03490596500845848,0.05164005572987662,0.0865460207383351
2025-09-22T14:50:00-04:00,514.24,514.45,513.78,513.83,NaN,NaN,NaN,515.6668493448644,515.6668493448644,515.6668493448644,514.8105000000002,516.1377381097684,513.4832618902319,514.543805837871,514.7604060533153,515.6897709298964,513.8310411767341,19912,10571.433333333332,36.73766677881601,50.19895732875239,NaN,NaN,NaN,NaN,0.47815514314617086,13.213338363230873,12368931,-0.0995952979656375,-0.03794810171871177,0.06164719624692573
2025-09-22T14:55:00-04:00,513.82,514,513.65,513.95,NaN,NaN,NaN,515.354038011007,NaN,NaN,514.7717000000001,516.0837786714916,513.4596213285087,514.543805837871,514.7515247408105,515.680499865179,513.8225496164421,11331,10444.066666666668,38.80032099723325,49.23218247254938,NaN,NaN,NaN,NaN,0.4690012043500174,14.182059832300517,12380262,-0.12782427459235537,-0.0981331469935185,0.029691127598836888
2025-09-22T15:00:00-04:00,513.98,514.01,513.62,513.65,NaN,NaN,NaN,515.3277181014158,NaN,NaN,514.7261000000002,516.032452616937,513.4197473830634,514.543805837871,514.739655517718,515.6693285243788,513.8099825110572,13815,10450,35.66920374893709,48.360899824030675,NaN,NaN,NaN,NaN,0.46335826118215806,15.131622494486896,12366447,-0.1582328780502045,-0.16809996996391874,-0.009867091913714238
2025-09-22T15:05:00-04:00,513.69,513.74,513.18,513.31,NaN,NaN,NaN,514.9803218240787,NaN,NaN,514.6737000000002,515.9928100181419,513.3545899818585,514.543805837871,514.7074834768762,515.6482929058342,513.7666740479182,28616,10703.133333333333,32.47102753009082,47.3457484996568,NaN,NaN,NaN,NaN,0.47026124252629387,16.69335645399431,12337831,-0.19060562195466385,-0.24812411935704404,-0.0575184974023802
2025-09-22T15:10:00-04:00,513.31,513.45,513.19,513.28,NaN,NaN,NaN,514.8066708320752,NaN,NaN,514.6224000000001,515.9547516653478,513.2900483346524,514.543805837871,514.6823836440068,515.63306394076,513.7317033472535,21578,10961.7,32.19671380156872,46.23640815070885,NaN,NaN,NaN,NaN,0.45524258234584364,18.143537987822622,12316253,-0.2022945137590827,-0.3103866396012336,-0.10809212584215089
2025-09-22T15:15:00-04:00,513.24,513.52,513.2,513.45,NaN,NaN,NaN,514.8066708320752,NaN,NaN,514.5770000000001,515.9113537762191,513.2426462237811,514.543805837871,514.6549268830938,515.6137400502895,513.6961137158982,26140,11496.933333333332,35.520881702633034,45.37645165835948,NaN,NaN,NaN,NaN,0.44558239789256454,19.258740008417398,12342393,-0.18718181387614347,-0.3420693931873302,-0.15488757931118674
2025-09-22T15:20:00-04:00,513.43,514.13,513.29,514.13,NaN,NaN,NaN,514.8066708320752,NaN,NaN,514.5524000000001,515.873390900787,513.2314090992134,514.5420446702968,514.6388090483943,515.5946479940932,513.6829701026953,25141,11677.066666666668,46.76390422736379,45.09380584324709,NaN,NaN,NaN,NaN,0.4737550837573837,18.559139800832508,12367534,-0.12308899449337168,-0.30874882242790136,-0.18565982793452968
2025-09-22T15:25:00-04:00,514.12,514.47,514.08,514.45,NaN,NaN,NaN,514.8066708320752,NaN,NaN,514.5394000000001,515.8513415231419,513.2274584768584,514.4321357362375,514.6337023598721,515.5823269999953,513.685077719749,21346,12096.366666666667,51.086260910149925,44.694538570262786,NaN,NaN,NaN,NaN,0.4677725777747125,17.326045577526685,12388880,-0.0543500508686289,-0.2535973915203158,-0.1992473406516869
2025-09-22T15:30:00-04:00,514.42,514.6,514.06,514.27,NaN,NaN,NaN,514.8066708320752,NaN,NaN,514.5228000000002,515.8269290733324,513.218670926668,514.0172085889899,514.6274451484567,515.5679131468509,513.6869771500625,25169,12695.1,48.69143373655035,44.57889071587342,NaN,NaN,NaN,NaN,0.4729316793622385,16.45529467293592,12363711,-0.018087372739064134,-0.22185655657551706,-0.20376918383645293
2025-09-22T15:35:00-04:00,514.33,514.34,513.9,514.12,NaN,NaN,NaN,514.8066708320752,NaN,NaN,514.5032000000001,515.8014846530248,513.2049153469754,513.3667839581963,514.6166255420248,515.5498965142035,513.6833545698462,28367,13396.233333333334,46.72567992131709,44.05100429972612,NaN,NaN,NaN,NaN,0.47057941655065394,15.281316040762846,12335344,-0.0021253834649685166,-0.20642591316766357,-0.20430052970269505
2025-09-22T15:40:00-04:00,514.11,514.43,513.97,514.07,NaN,NaN,NaN,514.8066708320752,NaN,NaN,514.4870000000002,515.7862874969815,513.1877125030189,513.3667839581963,514.6069993018685,515.5327968618946,513.6812017418425,28439,14172.1,46.05818674623152,43.15072587859583,NaN,NaN,NaN,NaN,0.4698237439398874,14.394476924723037,12306905,0.006662384031030727,-0.19597254966390665,-0.20263493369493737
2025-09-22T15:45:00-04:00,514.09,514.16,513.9,514.01,NaN,NaN,NaN,514.8066708320752,NaN,NaN,514.4788000000002,515.7848330163515,513.1727669836489,513.3667839581963,514.5965831813696,515.5173308716309,513.6758354911084,24691,14701.433333333332,45.22331545372554,42.25952412814221,NaN,NaN,NaN,NaN,0.45483633365846626,13.39764342450074,12282214,0.00983945745207343,-0.1903356118798456,-0.20017506933191903
2025-09-22T15:50:00-04:00,514.13,514.63,513.77,514.43,NaN,NaN,NaN,514.8066708320752,NaN,NaN,514.4856000000003,515.7869971566748,513.1842028433258,513.3667839581963,514.5789125216404,515.4768490896287,513.6809759536521,80889,17071.866666666665,51.80847210414439,42.072134273601705,NaN,NaN,NaN,NaN,0.4837765955400054,13.508347888410757,12363103,0.03994336160408199,-0.15024586732681655,-0.19018922893089854
2025-09-22T15:55:00-04:00,514.46,514.79,513.92,514.38,NaN,NaN,NaN,514.8066708320752,NaN,NaN,514.4876000000003,515.7880341427566,513.1871658572439,513.3667839581963,514.5656744091942,515.4371425295928,513.6942062887956,95811,19911.333333333332,51.02208930721672,42.769654068998456,NaN,NaN,NaN,NaN,0.5113639815728624,13.919251153202309,12267292,0.055261044203889165,-0.1211129236760371,-0.17637396787992626
2025-09-23T09:30:00-04:00,513.93,514.58,511.39,512.12,NaN,NaN,NaN,514.8066708320752,NaN,NaN,514.4504000000003,515.9041617960248,512.9966382039757,513.3667839581963,512.6966666666667,512.6966666666667,512.6966666666667,49498,21331.333333333332,29.342431092360357,42.24142294853733,NaN,NaN,NaN,NaN,0.7026951257462333,15.49687678539318,12217794,-0.08065495677676543,-0.27719266385088304,-0.1965377070741176
2025-09-23T09:35:00-04:00,512.14,512.79,511.7,512.4,NaN,NaN,NaN,514.2272835097665,NaN,NaN,514.4210000000003,515.9764253436338,512.8655746563668,513.3667839581963,512.5012841818069,512.7012308711295,512.3013374924843,47264,22636.966666666667,33.13329663206845,41.836635493882696,NaN,NaN,NaN,NaN,0.7303597596215006,16.96181487242756,12265058,-0.1419556643220489,-0.3739822874766787,-0.23202662315462982
2025-09-23T09:40:00-04:00,512.39,512.4,510.91,511.05,NaN,NaN,NaN,513.7503615320499,NaN,NaN,514.3828000000003,516.1581424005813,512.6074575994194,513.3667839581963,512.19861710937,512.7026061717753,511.6946280469648,39296,23603.333333333332,25.914264206444727,41.13985409799039,NaN,NaN,NaN,NaN,0.78461977679139,18.978983451863403,12225762,-0.25697471344556794,-0.5532450149615897,-0.2962703015160218
2025-09-23T09:45:00-04:00,511.07,511.775,510.37,511.28,NaN,NaN,NaN,513.2642087351385,NaN,NaN,514.3444000000003,516.2948385556756,512.393961444325,513.3667839581963,512.0085822838989,512.6193852041952,511.3977793636027,29825,24352.766666666666,28.762032276120692,40.874925865563945,NaN,NaN,NaN,NaN,0.8289326498777172,21.22651008418575,12255587,-0.2982162835735344,-0.6690406559829398,-0.3708243724094054
2025-09-23T09:50:00-04:00,511.2,511.54,510.71,511.35,NaN,NaN,NaN,513.2642087351385,NaN,NaN,514.2982000000002,516.4137413113679,512.1826586886325,513.3310347092772,511.9002205905385,512.5318527344833,511.26858844659364,25671,24931.733333333334,29.648369668184273,40.69290128460791,NaN,NaN,NaN,NaN,0.8290088891721689,23.313499099913653,12281258,-0.3005847388973933,-0.746555296031147,-0.4459705571337537
2025-09-23T09:55:00-04:00,511.25,511.92,511.09,511.72,NaN,NaN,NaN,513.2642087351385,NaN,NaN,514.2604000000002,516.4883316327019,512.0324683672985,513.3310347092772,511.86777599031797,512.4747341243097,511.2608178563262,21349,25364.466666666667,34.301361467939785,40.60579269641554,NaN,NaN,NaN,NaN,0.8290796828027311,24.473189018050114,12302607,-0.258633728050479,-0.7692627171968525,-0.5106289891463734
2025-09-23T10:00:00-04:00,511.67,512.59,511.42,512.59,NaN,NaN,NaN,513.2642087351385,NaN,NaN,514.2312000000003,516.5071495248299,511.9552504751707,513.3310347092772,511.91280634901295,512.4884773716573,511.33713532636864,33382,26166.5,43.7260635076134,40.388804073576225,NaN,NaN,NaN,NaN,0.8534311340311086,24.345066299689176,12335989,-0.15860496523641454,-0.7088851956918916,-0.550280230455477
2025-09-23T10:05:00-04:00,512.62,512.84,512.19,512.78,NaN,NaN,NaN,513.2642087351385,NaN,NaN,514.1950000000002,516.5043037912213,511.88569620877894,513.3310347092772,511.93971640158367,512.5196650572187,511.3597677459486,9987,26230.8,45.56271496696882,39.99426507763472,NaN,NaN,NaN,NaN,0.8389003387431707,23.820144525991616,12345976,-0.07045238427668377,-0.6383457108013317,-0.567893326524648
2025-09-23T10:10:00-04:00,512.76,513.05,512.5,512.9,NaN,NaN,NaN,513.2642087351385,NaN,NaN,514.1544000000001,516.4818953405916,511.8269046594087,513.3158277674218,511.9947939812613,512.5951964000772,511.39439156244543,17174,26587.266666666666,46.744920048044435,39.85522838559858,NaN,NaN,NaN,NaN,0.8182646002615125,22.996586813248236,12363150,0.0013286707852735447,-0.566232488043056,-0.5675611588283296
2025-09-23T10:15:00-04:00,512.9,513.01,511.75,511.8,NaN,NaN,NaN,513.2642087351385,NaN,NaN,514.0804000000002,516.4665968401752,511.6942031598252,511.8056622139374,512.0011732308054,512.5925117829318,511.4098346786791,9404,26571.6,38.4926990360166,39.26715832236283,NaN,NaN,NaN,NaN,0.849817128814261,23.071200567178114,12353746,-0.018775089102459175,-0.5910300202064036,-0.5722549311039444
2025-09-23T10:20:00-04:00,511.83,512.17,511.62,511.72,NaN,NaN,NaN,513.2642087351385,NaN,NaN,514.0084000000002,516.4570710191759,511.55972898082445,510.75289209306266,511.99315016658136,512.5709759502013,511.41532438296144,14502,26724.133333333335,37.96773076452387,38.68926860938371,NaN,NaN,NaN,NaN,0.8284016196132391,23.272861311164153,12339244,-0.030279789262701806,-0.6101046676823216,-0.5798248784196198
2025-09-23T10:25:00-04:00,511.73,512,511.56,511.56,NaN,NaN,NaN,513.2642087351385,NaN,NaN,513.9338000000001,516.4481393248316,511.4194606751687,510.75289209306266,511.9822394662353,512.5516017725569,511.4128771599137,11773,26895.2,36.884276362904735,38.09362296003936,NaN,NaN,NaN,NaN,0.8006586467837219,23.52353989026261,12327471,-0.040828069325068994,-0.6308599650759561,-0.5900318957508871
2025-09-23T10:30:00-04:00,511.61,511.62,511.04,511.1,NaN,NaN,NaN,513.2642087351385,NaN,NaN,513.8528000000001,516.4642671432713,511.241332856729,510.75289209306266,511.93438878041206,512.5135962651026,511.35518129572154,21719,27145.966666666667,33.890011299373356,36.81373290255573,NaN,NaN,NaN,NaN,0.7848973148705978,24.2823359552262,12305752,-0.06927616924453683,-0.6766271073065582,-0.6073509380620213
2025-09-23T10:35:00-04:00,511.1,511.66,510.97,511.47,NaN,NaN,NaN,513.2642087351385,NaN,NaN,513.7838,516.4603317559599,511.10726824404014,510.75289209306266,511.91234676416576,512.4906926959521,511.3340008323794,13364,27239.4,38.23342382803817,35.90025679690011,NaN,NaN,NaN,NaN,0.7781189352369834,25.054534257413675,12319116,-0.05432567769582153,-0.6752580351817983,-0.6209323574859767
2025-09-23T10:40:00-04:00,511.47,511.75,511.03,511.22,NaN,NaN,NaN,513.2642087351385,NaN,NaN,513.7126000000001,516.4675949111532,510.9576050888469,510.75289209306266,511.8962273076035,512.4743671583077,511.3180874568993,9857,27318.633333333335,36.48901182244585,36.41072684904908,NaN,NaN,NaN,NaN,0.773967582720058,25.583303134896624,12309259,-0.052400651615192695,-0.6864331720049677,-0.634032520389775
2025-09-23T10:45:00-04:00,511.22,511.52,511.15,511.36,NaN,NaN,NaN,513.2642087351385,NaN,NaN,513.6454000000001,516.4620510895757,510.82874891042457,510.75289209306266,511.8757307621875,512.452590402407,511.298871121968,13631,27298.033333333333,38.18975619584404,36.7719025321759,NaN,NaN,NaN,NaN,0.7451127553829113,26.074302806845072,12322890,-0.03373232741947041,-0.676197929664113,-0.6424656022446426
2025-09-23T10:50:00-04:00,511.37,511.72,511.29,511.67,NaN,NaN,NaN,513.2642087351385,NaN,NaN,513.5848000000001,516.4382252820624,510.73137471793785,510.75289209306266,511.86377143886335,512.4328015943189,511.2947412834078,14476,27116.833333333332,41.89985704815068,37.913730592297746,NaN,NaN,NaN,NaN,0.7226047014269896,26.077251052550317,12337366,0.005377632907517249,-0.635743561110246,-0.6411211940177632
2025-09-23T10:55:00-04:00,511.68,511.7,510.85,511.07,NaN,NaN,NaN,513.2642087351385,NaN,NaN,513.5068000000001,516.4171496422451,510.59645035775515,510.75289209306266,511.8239609547898,512.397330875206,511.25059103437366,24647,27560.7,37.2406047943637,38.51934291502939,NaN,NaN,NaN,NaN,0.7317043656107736,26.61763839516173,12312719,-0.002836524792536821,-0.6446668500084343,-0.6418303252158974
2025-09-23T11:00:00-04:00,511.09,511.35,510.84,511.2,NaN,NaN,NaN,513.1995853514861,NaN,NaN,513.4254000000001,516.3614904891401,510.4893095108601,510.54231367445016,511.7996216412163,512.3771342649317,511.2221090175009,14787,27593.1,38.82781504975635,39.17501758514169,NaN,NaN,NaN,NaN,0.7158683394957217,27.131215882826126,12327506,0.006311436469199849,-0.6339410296293977,-0.6402524660985975
2025-09-23T11:05:00-04:00,511.19,511.21,510.89,511.01,NaN,NaN,NaN,513.1025587446003,NaN,NaN,513.3436,516.3161834152081,510.3710165847919,510.1694854687001,511.78289198901297,512.3648642061193,511.2009197719067,9452,26954.3,37.34139622863043,39.39216292519102,NaN,NaN,NaN,NaN,0.687592029531741,27.60810926422878,12318054,0.005426048828379715,-0.633469905063123,-0.6388959538915027
2025-09-23T11:10:00-04:00,511.08,511.31,510.85,511.27,NaN,NaN,NaN,513.1019878925731,NaN,NaN,513.2666,516.2505694637143,510.2826305362858,510.1694854687001,511.76715526747694,512.3504003819455,511.18391015300836,10874,26597.5,40.687569273420216,39.175127622748654,NaN,NaN,NaN,NaN,0.6713354559937581,27.782962219057527,12328928,0.027003947611862755,-0.6051410193766742,-0.632144966988537
2025-09-23T11:15:00-04:00,511.3,511.41,510.94,511.24,NaN,NaN,NaN,513.1019878925731,NaN,NaN,513.1922,516.1890471166652,510.19535288333475,510.1694854687001,511.74867875347024,512.3312221594636,511.16613534747694,14792,26219.233333333334,40.41935023512318,38.80774442761682,NaN,NaN,NaN,NaN,0.6569543519942059,27.67304820208344,12314136,0.042961580063981875,-0.5784429919085596,-0.6214045719725415
2025-09-23T11:20:00-04:00,511.24,511.27,511.06,511.13,NaN,NaN,NaN,513.0971625219519,NaN,NaN,513.1118000000001,516.1099345933484,510.1136654066519,510.1694854687001,511.73324282351655,512.3159172820591,511.150568364974,12157,25786.433333333334,39.39390377725909,38.28267183684643,NaN,NaN,NaN,NaN,0.6250290411374755,27.57098518632179,12301979,0.04935668176370389,-0.5597087197679116,-0.6090654015316155
2025-09-23T11:25:00-04:00,511.19,511.33,510.87,510.92,NaN,NaN,NaN,513.0070642254996,NaN,NaN,513.0314000000001,516.0446852769595,510.01811472304064,510.1694854687001,511.70921490816295,512.2955781959978,511.1228516203281,16835,25636.066666666666,37.440993380910456,38.20755000433885,NaN,NaN,NaN,NaN,0.6132412524847972,27.795822214547606,12285144,0.04292867240292764,-0.5554045610279559,-0.5983332334308835
2025-09-23T11:30:00-04:00,510.95,511.18,510.77,510.89,NaN,NaN,NaN,512.8512885788859,NaN,NaN,512.9562000000001,515.9917438129352,509.92065618706505,510.1694854687001,511.69367240999105,512.2839472227173,511.1033975972648,10106,25133.966666666667,37.157601363953404,38.14968361858382,NaN,NaN,NaN,NaN,0.5987240201644564,28.169107886699674,12275038,0.04018968868613637,-0.548096122573213,-0.5882858112593494
2025-09-23T11:35:00-04:00,510.95,511.08,510.62,510.65,NaN,NaN,NaN,512.7037300071183,NaN,NaN,512.8778000000001,515.9448957990072,509.8107042009929,510.1694854687001,511.6760775938795,512.2739051300715,511.07825005768746,9772,24514.133333333335,34.882884685325365,38.0067270701853,NaN,NaN,NaN,NaN,0.5888151615812794,28.759547505895362,12265266,0.02641318699528128,-0.5552693275152478,-0.5816825145105291
2025-09-23T11:40:00-04:00,510.64,511.09,510.53,511.03,NaN,NaN,NaN,512.655833188613,NaN,NaN,512.8058,515.8740036178497,509.7375963821503,510.1621679349655,511.6522553290947,512.2563871759817,511.04812348220776,15664,24088.3,41.037649561099585,38.5172726603086,NaN,NaN,NaN,NaN,0.5867569357540453,29.452560749520856,12280930,0.04594752042471273,-0.5242481139796382,-0.570195634404351
2025-09-23T11:45:00-04:00,511.04,511.05,510.31,510.37,NaN,NaN,NaN,512.5428407709487,NaN,NaN,512.7208,515.8185923494813,509.62300765051884,510.1621679349655,511.6251451588571,512.244984275816,511.00530604189817,13478,23714.533333333333,34.87249032328256,38.27720598139748,NaN,NaN,NaN,NaN,0.5977028689144712,30.436408381151754,12267452,0.018861323868447966,-0.546618979568791,-0.565480303437239
2025-09-23T11:50:00-04:00,510.39,510.57,509.85,510.18,NaN,NaN,NaN,512.086348008633,NaN,NaN,512.6286000000001,515.7488948835305,509.5083051164697,510.1621679349655,511.5611156844218,512.2349780905499,510.88725327829366,25155,21856.733333333334,33.32057283339404,38.05088891075093,NaN,NaN,NaN,NaN,0.6064383782777212,31.952030556155393,12242297,-0.006074501289789591,-0.573073430049476,-0.5669989287596864
2025-09-23T11:55:00-04:00,510.15,510.48,510.03,510.37,NaN,NaN,NaN,512.086348008633,NaN,NaN,512.533,515.6312556383277,509.4347443616723,510.1621679349655,511.54160101633585,512.2282307314167,510.854971301255,8753,18954.8,36.37009385300801,37.92091302911978,NaN,NaN,NaN,NaN,0.5952642084007442,33.35939400437306,12251050,-0.004090780888237666,-0.5721124048699835,-0.5680216239817458
2025-09-23T12:00:00-04:00,510.39,510.56,510.19,510.52,NaN,NaN,NaN,512.086348008633,NaN,NaN,512.4474,515.5268332206482,509.36796677935183,510.1621679349655,511.5263891028286,512.2205264303515,510.83225177530574,7842,17566.266666666666,38.75162720327408,37.69603946877145,NaN,NaN,NaN,NaN,0.5791739078006913,34.35128940079048,12258892,0.012118216414964134,-0.5528738534630406,-0.5649920698780048
2025-09-23T12:05:00-04:00,510.58,510.73,510.24,510.27,NaN,NaN,NaN,512.086348008633,NaN,NaN,512.3520000000001,515.3996325238121,509.3043674761881,510.1621679349655,511.51010174396237,512.2119845796651,510.8082189082596,8561,16276.166666666666,36.31223412161136,37.62972727786057,NaN,NaN,NaN,NaN,0.5728043429577855,34.61621140226392,12250331,0.010838953874442447,-0.5514433775349517,-0.5622823314093941
2025-09-23T12:10:00-04:00,510.29,510.43,510.07,510.27,NaN,NaN,NaN,512.0199718558625,NaN,NaN,512.2502,515.2283779397604,509.27202206023946,510.1621679349655,511.4952798055788,512.2060348079594,510.7845248031981,7001,15199.666666666666,36.31223412161136,37.45004292585021,NaN,NaN,NaN,NaN,0.557604032746516,35.14073163790128,12250331,0.0145951617100325,-0.5440383792718535,-0.558633540981886
2025-09-23T12:15:00-04:00,510.29,510.78,510.17,510.57,NaN,NaN,NaN,512.0199718558625,NaN,NaN,512.1554,515.0381853476142,509.27261465238576,510.04073434797243,511.47582134666806,512.1928205290028,510.7588221643333,11887,14601.733333333334,41.44233828772457,37.74296735864265,NaN,NaN,NaN,NaN,0.5613466018360475,34.3858127926634,12262218,0.040422632022056315,-0.5081052509543156,-0.5485278829763719
2025-09-23T12:20:00-04:00,510.57,510.86,510.43,510.6,NaN,NaN,NaN,512.0199718558625,NaN,NaN,512.0646,514.8499881884737,509.2792118115263,509.93858747837794,511.46757643306876,512.1858955387299,510.7492573274076,5945,13944.2,41.94594028951049,37.8328510026491,NaN,NaN,NaN,NaN,0.5519647017049018,33.42439685761753,12268163,0.06140712280539362,-0.4717689794696298,-0.5331761022750234
2025-09-23T12:25:00-04:00,510.63,510.63,510.33,510.38,NaN,NaN,NaN,512.0199718558625,NaN,NaN,511.98720000000003,514.7402667700549,509.23413322994514,509.89686998270236,511.4519924655625,512.1757140576764,510.72827087344865,9454,13547.7,39.27821230815033,37.75134115072247,NaN,NaN,NaN,NaN,0.5339672230116953,32.745745575943005,12258709,0.06216171095355938,-0.45547396358307424,-0.5176356745366336
2025-09-23T12:30:00-04:00,510.33,510.53,510.19,510.53,NaN,NaN,NaN,512.0199718558625,NaN,NaN,511.92119999999994,514.6525282923944,509.18987170760545,509.7254959861619,511.4426821307382,512.1697415350959,510.7156227263805,5620,12622.3,41.98732912398411,37.93658581834569,NaN,NaN,NaN,NaN,0.520112421368001,32.40933110938259,12264329,0.07366788778991706,-0.4255508147992373,-0.49921870258915435
2025-09-23T12:35:00-04:00,510.51,510.74,510.01,510.66,NaN,NaN,NaN,512.0199718558625,NaN,NaN,511.8553999999999,514.5462740886445,509.16452591135527,509.63871553583715,511.4210081998716,512.1541170011719,510.6878993985713,14243,12764.166666666666,44.306457565458366,38.42697611724197,NaN,NaN,NaN,NaN,0.5351043912702879,31.36244728323791,12278572,0.08986552202629278,-0.3868868000562884,-0.47675232208258117
2025-09-23T12:40:00-04:00,510.73,511.11,510.62,511.08,NaN,NaN,NaN,512.0199718558625,NaN,NaN,511.80400000000003,514.4536580912421,509.154341908758,509.8871618834789,511.41324072206874,512.142988026479,510.6834934176585,10418,12538.966666666667,51.10694080252064,39.42335750571106,NaN,NaN,NaN,NaN,0.5318826490366966,29.278099596676633,12288990,0.12645686492478975,-0.318681240926594,-0.44513810585138375
2025-09-23T12:45:00-04:00,511.08,511.37,511.06,511.31,NaN,NaN,NaN,512.0199718558625,NaN,NaN,511.764,514.3817028098434,509.14629719015664,510.2367295067831,511.41140345228314,512.1373236340067,510.68548327055953,7245,12467,54.391266183930384,40.81681332703999,NaN,NaN,NaN,NaN,0.5160338883912184,27.694929211185375,12296235,0.16149883376176538,-0.24326456364917703,-0.4047633974109424
2025-09-23T12:50:00-04:00,511.32,511.34,510.99,510.99,NaN,NaN,NaN,512.0199718558625,NaN,NaN,511.7182,514.3081890039293,509.12821099607066,510.2583836054265,511.4084515781301,512.1314636602375,510.6854394960227,6425,12197.766666666666,49.417487551777825,41.415373183517,NaN,NaN,NaN,NaN,0.5041743249347004,26.02823012857297,12289810,0.15826492343308873,-0.20693224311958147,-0.3651971665526702
2025-09-23T12:55:00-04:00,510.9,510.91,510.44,510.44,NaN,NaN,NaN,512.0199718558625,NaN,NaN,511.65799999999996,514.2239929853447,509.0920070146552,510.2583836054265,511.4003683351345,512.1242728913779,510.67646377889105,6671,12027.7,42.263895053460125,41.943330664243966,NaN,NaN,NaN,NaN,0.5074475874393655,25.188951499358758,12283139,0.11617118004133548,-0.21998319150100087,-0.33615437154233635
2025-09-23T13:00:00-04:00,510.45,510.52,510.1,510.18,NaN,NaN,NaN,511.9247877406686,NaN,NaN,511.579,514.0780502197102,509.0799497802898,510.2583836054265,511.3859519956969,512.1163697197888,510.655534271605,8629,11591.366666666667,39.36303079343389,42.37493480424682,NaN,NaN,NaN,NaN,0.5012013311936936,25.060298450958513,12274510,0.07016981459967248,-0.24844210329274574,-0.3186119178924182
2025-09-23T13:05:00-04:00,510.25,510.38,510.01,510.13,NaN,NaN,NaN,511.7868428433655,NaN,NaN,511.49260000000004,513.8850775778557,509.10012242214447,510.2583836054265,511.3714283478278,512.1093449160609,510.63351177959476,8226,11420.1,38.81133733374739,42.54930933858535,NaN,NaN,NaN,NaN,0.4918298075370015,25.101736389579294,12266284,0.037372473150827146,-0.2718963264538843,-0.30926879960471143
2025-09-23T13:10:00-04:00,510.12,510.15,509.33,509.35,NaN,NaN,NaN,511.37130453230344,NaN,NaN,511.39419999999996,513.7255861629673,509.0628138370326,510.2583836054265,511.32962519918067,512.1064673662405,510.55278303212083,16696,11648.066666666668,31.414463179443132,42.025226194026,NaN,NaN,NaN,NaN,0.5152705355700723,26.165614335329536,12249588,-0.03210162504281955,-0.3493958309082359,-0.31729420586541635
2025-09-23T13:15:00-04:00,509.36,509.49,509.07,509.33,NaN,NaN,NaN,510.8944270535623,NaN,NaN,511.29839999999996,513.5666869661516,509.03011303384835,510.2583836054265,511.28764110270595,512.1089875801549,510.466294625257,14835,11688.2,31.25000337584234,41.66363828361392,NaN,NaN,NaN,NaN,0.5084654973150683,27.469121591095746,12234753,-0.0723474661911207,-0.40772853860431724,-0.33538107241319653
2025-09-23T13:20:00-04:00,509.34,510.105,509.21,509.86,NaN,NaN,NaN,510.8944270535623,NaN,NaN,511.2142,513.3746965726656,509.05370342733437,510.2583836054265,511.2676392897193,512.1024030929733,510.43287548646526,9314,11516.133333333333,40.186367562856724,41.94036210084573,NaN,NaN,NaN,NaN,0.536075104649709,27.050156663269338,12244067,-0.056899238963173615,-0.4065051211171635,-0.3496058821539899
2025-09-23T13:25:00-04:00,509.84,510.04,509.67,509.94,NaN,NaN,NaN,510.8944270535623,NaN,NaN,511.1328,513.1689258901448,509.0966741098551,510.2583836054265,511.2399899369595,512.0887673986678,510.3912124752512,14830,11188.9,41.42404188283868,41.93905521478246,NaN,NaN,NaN,NaN,0.5242125971747301,26.661117801716244,12258897,-0.03594113409148275,-0.39453229976834336,-0.3585911656768606
2025-09-23T13:30:00-04:00,509.9,510.16,509.71,509.96,NaN,NaN,NaN,510.8944270535623,NaN,NaN,511.0434,512.8748348911058,509.2119651088942,510.2583836054265,511.2242733263614,512.0797398987308,510.368806753992,9110,10999.666666666666,41.7485589691086,41.924956549039464,NaN,NaN,NaN,NaN,0.5189116973765383,26.00010575615167,12268007,-0.016375345860054347,-0.37906034800192856,-0.3626850021418742
2025-09-23T13:35:00-04:00,509.97,510.02,509.2,509.37,NaN,NaN,NaN,510.8944270535623,NaN,NaN,510.94320000000005,512.5702780682458,509.31612193175425,510.2583836054265,511.1844139760219,512.0679014445299,510.30092650751396,18108,11288.2,35.5003260809367,41.65510753280993,NaN,NaN,NaN,NaN,0.5404180047067851,26.191048422669517,12249899,-0.03759935787833152,-0.4096841994897886,-0.3720848416114571
2025-09-23T13:40:00-04:00,509.41,509.64,508.89,509.18,NaN,NaN,NaN,510.8944270535623,NaN,NaN,510.8844000000001,512.549174627397,509.2196253726033,509.76970688434125,511.106583379171,512.0525731327315,510.16059362561055,32037,11993.633333333333,33.748632373793384,41.066629193510586,NaN,NaN,NaN,NaN,0.5553881472277291,26.785986046801142,12217862,-0.05766426661308227,-0.44416517487780993,-0.38650090826472766
2025-09-23T13:45:00-04:00,509.2,510.05,509.08,509.93,NaN,NaN,NaN,510.8944270535623,NaN,NaN,510.8350000000001,512.4631339010857,509.2068660989145,509.39776550747297,511.06387442878724,512.0265782114594,510.10117064611507,24863,12329.333333333334,45.2358429127905,41.13301386117717,NaN,NaN,NaN,NaN,0.5850032795686076,26.33385972888523,12242725,-0.015830803677233662,-0.40628941286126974,-0.3904586091840361
2025-09-23T13:50:00-04:00,509.86,509.95,509.4,509.5,NaN,NaN,NaN,510.8944270535623,NaN,NaN,510.80400000000003,512.4730883740127,509.1349116259874,509.29721240597837,511.04914935438933,512.0178918285827,510.08040688019594,8497,12207.333333333334,40.86138091319738,40.40118815479694,NaN,NaN,NaN,NaN,0.582503045313708,25.914028147963315,12234228,-0.012662381503629139,-0.4062865860635725,-0.39362420455994335
2025-09-23T13:55:00-04:00,509.52,510,509.46,509.88,NaN,NaN,NaN,510.8944270535623,NaN,NaN,510.776,512.4591209107953,509.0928790892047,508.87376992478266,511.0314069988345,512.0048264620239,510.0579875356451,11840,12040.833333333334,45.84537310674063,39.79076722071195,NaN,NaN,NaN,NaN,0.5794671135055874,25.398812121588836,12246068,0.017826616081710378,-0.37134093445780536,-0.38916755053951574
2025-09-23T14:00:00-04:00,509.87,510.02,509.67,509.87,NaN,NaN,NaN,510.8944270535623,NaN,NaN,510.7464,512.4401237556378,509.0526762443621,508.870336161191,511.0193931303493,511.9950423366651,510.04374392403344,8726,11994.833333333334,45.736136867563594,39.52781360041094,NaN,NaN,NaN,NaN,0.563076605398043,24.867509582317076,12237342,0.03891181806060684,-0.3405277779637572,-0.37943959602436406
2025-09-23T14:05:00-04:00,509.81,509.88,509.54,509.65,NaN,NaN,NaN,510.8944270535623,NaN,NaN,510.705,512.4026984421334,509.00730155786647,508.870336161191,511.0045768765988,511.98476029271677,510.0243934604808,9644,11990.566666666668,43.29220923874703,39.60126461364571,NaN,NaN,NaN,NaN,0.5471425621553239,24.619322960022235,12227698,0.039507184699717146,-0.3300556151497176,-0.36956279984943474
2025-09-23T14:10:00-04:00,509.67,510.07,509.65,509.83,NaN,NaN,NaN,510.8944270535623,NaN,NaN,510.64979999999997,512.2767553898318,509.02284461016814,508.870336161191,510.9955363492863,511.97716401615395,510.0139086824186,6829,11696.066666666668,45.84212024561796,40.06405671737315,NaN,NaN,NaN,NaN,0.5380609505728019,23.853154855857493,12234527,0.05266573006054065,-0.30373063727375893,-0.3563963673342996
2025-09-23T14:15:00-04:00,509.82,510.23,509.74,509.88,NaN,NaN,NaN,510.8944270535623,NaN,NaN,510.5917999999999,512.1142700459724,509.0693299540275,508.9702306240713,510.974226003404,511.9569667272424,509.9914852795656,18146,11851.666666666666,46.560945364122595,40.61760014811424,NaN,NaN,NaN,NaN,0.5346280255318882,22.71008686507248,12252673,0.06459250761536273,-0.27565573281509614,-0.34024824043045887
2025-09-23T14:20:00-04:00,509.91,510.15,509.67,509.84,NaN,NaN,NaN,510.8944270535623,NaN,NaN,510.5305999999999,511.9169356596296,509.14426434037017,508.9702306240713,510.9609609214607,511.94495798140383,509.97696386151756,10993,11379.6,46.03454028401166,41.66189136986913,NaN,NaN,NaN,NaN,0.5307260237081791,21.809192466714716,12241680,0.06923120645100511,-0.2537092323667025,-0.3229404388177076
2025-09-23T14:25:00-04:00,509.87,510.29,509.78,509.94,NaN,NaN,NaN,510.8944270535623,NaN,NaN,510.49339999999995,511.84076252016274,509.14603747983716,509.03674759940566,510.948136127601,511.93170110271353,509.9645711524885,12234,11495.633333333333,47.62864477992288,42.831794327303456,NaN,NaN,NaN,NaN,0.5292455934433126,20.580175121570445,12253914,0.0778353914919287,-0.22564619945279674,-0.30348159094472543
2025-09-23T14:30:00-04:00,509.95,510.55,509.85,510.51,NaN,NaN,NaN,510.8944270535623,NaN,NaN,510.4691999999999,511.77023860093357,509.1681613990662,509.19739807952453,510.9427069534445,511.92389293000684,509.9615209768821,7757,11492.8,55.667319187382326,43.93757658619814,NaN,NaN,NaN,NaN,0.5414423367687894,19.459469060470806,12261671,0.1182909202570483,-0.15561794062341505,-0.27390886088046335
2025-09-23T14:35:00-04:00,510.46,510.52,509.94,509.94,NaN,NaN,NaN,510.8944270535623,NaN,NaN,510.43679999999995,511.70790937407276,509.16569062592714,509.19739807952453,510.93636996611144,511.9163072575024,509.9564326747205,7270,11449.766666666666,47.77076678010749,44.3909140788602,NaN,NaN,NaN,NaN,0.5441964555710176,18.418813432306855,12254401,0.10356776285085156,-0.1444491573168989,-0.24801692016775045
2025-09-23T14:40:00-04:00,509.99,510.27,509.96,510.06,NaN,NaN,NaN,510.8944270535623,NaN,NaN,510.41599999999994,511.67701546410814,509.15498453589174,509.19739807952453,510.9299133675664,511.90882772891865,509.9509990062142,7195,11456.233333333334,49.39816760720205,44.93731469586687,NaN,NaN,NaN,NaN,0.5288967087445152,17.452490349011754,12261596,0.09882962233437578,-0.12447989224978073,-0.22330951458415652
2025-09-23T14:45:00-04:00,510.07,510.19,509.67,509.8,NaN,NaN,NaN,510.8944270535623,NaN,NaN,510.38259999999997,511.61839163317876,509.1468083668212,509.19739807952453,510.9212978448592,511.9007228978909,509.94187279182756,7792,11319.733333333334,46.05014293136798,45.69087304232625,NaN,NaN,NaN,NaN,0.5282612295484771,16.697492972894715,12253804,0.07612231316655696,-0.12815662312596032,-0.20427893629251728
2025-09-23T14:50:00-04:00,509.8,509.8,509.33,509.41,NaN,NaN,NaN,510.8944270535623,NaN,NaN,510.3463999999999,511.58797809301626,509.10482190698355,509.19739807952453,510.9085776034548,511.89262777095,509.92452743595953,8602,11408.3,41.50588068222866,46.244962207214485,NaN,NaN,NaN,NaN,0.5240997131521593,16.82199947489505,12245202,0.034872837431401765,-0.16068788950326507,-0.19556072693466683
2025-09-23T14:55:00-04:00,509.41,509.43,508.6,508.78,NaN,NaN,NaN,510.66864546295574,NaN,NaN,510.29479999999995,511.57736143745143,509.0122385625485,509.19739807952453,510.865583972277,511.88055827004104,509.850609674513,21222,11800.566666666668,35.424564910270234,45.54415663560589,NaN,NaN,NaN,NaN,0.5459497336412896,18.23673398897968,12223980,-0.03123186497396574,-0.234600558152124,-0.20336869317815826
2025-09-23T15:00:00-04:00,508.78,508.91,507.74,507.81,NaN,NaN,NaN,510.0630252146396,NaN,NaN,510.21759999999995,511.6189454109503,508.8162545890496,509.19739807952453,510.789469626693,511.88578650641597,509.69315274697004,28104,12550.033333333333,28.500562361779558,44.661241024790336,NaN,NaN,NaN,NaN,0.590524752666913,20.548648579342803,12195876,-0.13107684615770654,-0.36721475087529143,-0.2361379047175849
2025-09-23T15:05:00-04:00,507.79,508.32,507.3,507.97,NaN,NaN,NaN,509.6081149776105,NaN,NaN,510.1556,511.6703285435247,508.6408714564753,509.19739807952453,510.72520535322747,511.8911514376636,509.5592592687913,22488,12824.866666666667,30.899755496435944,43.593696909768575,NaN,NaN,NaN,NaN,0.6212015560478464,23.077695169563647,12218364,-0.17442283076178083,-0.4541664431698109,-0.2797436124080301
2025-09-23T15:10:00-04:00,507.96,508.51,507.88,508.36,NaN,NaN,NaN,509.6081149776105,NaN,NaN,510.0988,511.66474068879035,508.5328593112096,509.19739807952453,510.7016405200306,511.8866555043953,509.51662553566587,9842,12805.666666666666,36.49358812089077,42.9335148564348,NaN,NaN,NaN,NaN,0.6218300163301428,24.891763921060832,12228206,-0.16500846314688417,-0.4860041913416353,-0.32099572819475114
2025-09-23T15:15:00-04:00,508.35,508.67,508.25,508.55,NaN,NaN,NaN,509.6081149776105,NaN,NaN,510.0496,511.6520878660142,508.4471121339858,509.19739807952453,510.6692547810221,511.875187725658,509.4633218363862,15363,13076.266666666666,39.0809471864071,42.6327104241248,NaN,NaN,NaN,NaN,0.6074135865922765,26.134155146327693,12243569,-0.13540589070413023,-0.4902530915749139,-0.3548472008707837
2025-09-23T15:20:00-04:00,508.52,508.69,508.38,508.62,NaN,NaN,NaN,509.6081149776105,NaN,NaN,509.99659999999994,511.60938695464273,508.38381304535716,509.1479184636196,510.63778256882586,511.8616404796109,509.4139246580408,15917,13392.666666666666,40.050021937062795,42.21898911637086,NaN,NaN,NaN,NaN,0.5861697589785427,27.23108970827998,12259486,-0.10205106059260827,-0.482411026611544,-0.38035996601893574
2025-09-23T15:25:00-04:00,508.62,508.91,508.5,508.75,NaN,NaN,NaN,509.6081149776105,NaN,NaN,509.9468,511.55670653162156,508.33689346837843,509.0073347708957,510.61505398456217,511.8492130430264,509.38089492609794,12774,13596.1,41.89852959898853,41.88595941886128,NaN,NaN,NaN,NaN,0.5735862047657915,27.622999675055993,12272260,-0.06403124853932851,-0.4603990266930964,-0.3963677781537679
2025-09-23T15:30:00-04:00,508.77,509.18,508.66,509.18,NaN,NaN,NaN,509.6081149776105,NaN,NaN,509.9078,511.4954890881366,508.3201109118634,508.9198678167166,510.59344815555534,511.83319470757317,509.3537016035375,14676,13797.666666666666,47.648566016863086,42.00124697120781,NaN,NaN,NaN,NaN,0.5697586187110908,27.268861443150556,12286936,-0.005789338240361208,-0.4036044509542194,-0.39781511271385817
2025-09-23T15:35:00-04:00,509.2,509.32,508.69,508.74,NaN,NaN,NaN,509.6081149776105,NaN,NaN,509.8642,511.4580285481112,508.27037145188876,508.54889425337325,510.56798271770964,511.8152520827284,509.32071335269086,16848,14085.066666666668,42.96314675024213,41.667997111944906,NaN,NaN,NaN,NaN,0.5740615745174411,26.584463830410186,12270088,0.006566081845335858,-0.38960751040718833,-0.3961735922525242
2025-09-23T15:40:00-04:00,508.75,509.23,508.72,509.15,NaN,NaN,NaN,509.6081149776105,NaN,NaN,509.8294,511.40802932965914,508.2507706703409,508.0141154026986,510.54410159650496,511.7961204904111,509.2920827025988,17536,14113.066666666668,48.085861128986735,41.126464393488085,NaN,NaN,NaN,NaN,0.5694857477661946,25.948951761436994,12287624,0.04374309611344007,-0.34149472211072407,-0.38523781822416414
2025-09-23T15:45:00-04:00,509.14,509.28,508.88,509.21,NaN,NaN,NaN,509.6081149776105,NaN,NaN,509.8006,511.37081481358547,508.2303851864145,507.969300448512,510.5215323685173,511.77620629962234,509.2668584374122,18190,14224.9,48.81042748528245,41.20072587242915,NaN,NaN,NaN,NaN,0.5573796229257505,25.219874094861517,12305814,0.07209304252034637,-0.2951215150737312,-0.36721455759407756
2025-09-23T15:50:00-04:00,509.25,509.49,508.6,509.24,NaN,NaN,NaN,509.6081149776105,NaN,NaN,509.76480000000004,511.30255025292246,508.2270497470776,507.99644035880965,510.4678784025783,511.7277295175602,509.20802728759645,45246,15422.633333333333,49.192263636671086,41.18601844596265,NaN,NaN,NaN,NaN,0.5811382212881959,25.088470077169685,12351060,0.09134535822244866,-0.25303285981601675,-0.3443782180384654
2025-09-23T15:55:00-04:00,509.23,509.9,508.56,509.61,507.39567907710233,507.39567907710233,507.39567907710233,NaN,NaN,NaN,509.7496,511.2781180275893,508.2210819724107,508.0351522870477,510.3990086221274,511.6482639840011,509.14975326025365,78648,17549.9,53.77224294767669,41.73759701855614,NaN,NaN,NaN,NaN,0.635342634053323,23.86418483381992,12429708,0.12537602819653065,-0.1876581827928021,-0.31303421098933276
2025-09-24T09:30:00-04:00,510.31,512.37,509.18,509.32,508.58905730087037,NaN,NaN,NaN,NaN,NaN,509.73240000000004,511.2605128755155,508.2042871244846,509.28312182963816,510.28999999999996,510.28999999999996,510.28999999999996,75521,19763.6,49.97012924879229,42.34218620188211,NaN,NaN,NaN,NaN,0.8178181601923712,25.04588806474674,12354187,0.12448012492197058,-0.15743405483686956,-0.28191417975884014
2025-09-24T09:35:00-04:00,509.32,509.65,507.21,507.63,NaN,NaN,NaN,510.84930894007823,510.84930894007823,510.84930894007823,509.67760000000004,511.30369992325416,508.0515000767459,509.28312182963816,509.2022486286482,510.26530156112045,508.13919569617593,79071,21795.7,34.611296634656625,42.28409561076685,NaN,NaN,NaN,NaN,0.9336882916072017,23.356542553408147,12275116,0.012111442176294562,-0.2667748770384719,-0.2788863192147665
2025-09-24T09:40:00-04:00,507.76,509.55,507.76,509.17,NaN,NaN,NaN,510.84930894007823,NaN,NaN,509.65060000000005,511.2646404456519,508.03655955434823,509.28312182963816,509.1017375718526,510.02656369964063,508.17691144406456,56488,22610.733333333334,49.76376852596607,43.80289605106589,NaN,NaN,NaN,NaN,1.0041391279209742,21.787864578593737,12331604,0.04186778257915469,-0.22655159099082312,-0.2684193735699778
2025-09-24T09:45:00-04:00,509.21,509.73,508.96,509.31,NaN,NaN,NaN,510.84930894007823,NaN,NaN,509.63140000000004,511.2383350206386,508.0244649793615,509.28312182963816,509.1290208567555,510.00086839445567,508.25717331905537,28187,22721.533333333333,50.87818410018681,45.22992666561952,NaN,NaN,NaN,NaN,0.9874149044980501,20.53268206586358,12359791,0.06970530304809691,-0.18128774475985665,-0.25099304780795356
2025-09-24T09:50:00-04:00,509.26,509.36,508.46,508.78,NaN,NaN,NaN,510.84930894007823,NaN,NaN,509.6016,511.21530807778134,507.9878919222187,509.28312182963816,509.1026915277349,509.93338317152717,508.27199988394267,26691,23328,46.65837997073753,45.95598322632286,NaN,NaN,NaN,NaN,0.9811709827481918,19.35167625818605,12333100,0.05196414829044982,-0.1860378624448913,-0.2380020107353411
2025-09-24T09:55:00-04:00,508.81,509.21,508.34,508.57,NaN,NaN,NaN,510.84930894007823,NaN,NaN,509.56160000000006,511.17645781425887,507.94674218574124,509.28312182963816,509.0634547400798,509.86075027560133,508.2661592045583,29248,23908.266666666666,45.06355066766328,46.383312046412584,NaN,NaN,NaN,NaN,0.9732301982661785,18.391928727997005,12303852,0.02688839917114888,-0.20439151177140502,-0.2312799109425539
2025-09-24T10:00:00-04:00,508.57,509.4,508.45,509.19,NaN,NaN,NaN,510.84930894007823,NaN,NaN,509.53340000000003,511.1237992456051,507.943000754395,509.28312182963816,509.05935697326,509.8234888832418,508.29522506327817,26284,24493.533333333333,50.44868804635361,47.12607391136193,NaN,NaN,NaN,NaN,0.9715708983900221,17.251673767455795,12330136,0.05143735747316769,-0.1669832141010943,-0.21842057157426198
2025-09-24T10:05:00-04:00,509.24,509.41,508.62,508.81,NaN,NaN,NaN,510.84930894007823,NaN,NaN,509.50200000000007,511.0862828031455,507.91771719685465,509.28312182963816,509.0512333677764,509.78788463884496,508.3145820967078,24976,25004.6,47.38295104007656,47.51781830001107,NaN,NaN,NaN,NaN,0.9586015485050219,16.17923895057134,12305160,0.04186832407709051,-0.16608516647789884,-0.20795349055498935
2025-09-24T10:10:00-04:00,508.71,509.29,508.03,508.775,NaN,NaN,NaN,510.84930894007823,NaN,NaN,509.4669000000001,511.036219457638,507.8975805423622,509.28312182963816,509.03247248252575,509.75363487083894,508.31131009421256,19453,25425.4,47.09905044538569,47.47856718776269,NaN,NaN,NaN,NaN,0.9801300093260952,15.922336304349574,12285707,0.03333808664015478,-0.16628088225479587,-0.19961896889495065
2025-09-24T10:15:00-04:00,508.73,510,508.39,509.88,NaN,NaN,NaN,510.84930894007823,NaN,NaN,509.45130000000006,510.9880378567638,507.9145621432363,509.28312182963816,509.0446649907379,509.7577350353516,508.3315949461242,11782,25213.266666666666,56.05193307676866,48.4134804968003,NaN,NaN,NaN,NaN,1.0251207229456607,14.8560671872095,12297489,0.09858226803655554,-0.07639113384925622,-0.17497340188581176
2025-09-24T10:20:00-04:00,509.93,510.12,509.58,509.72,NaN,NaN,NaN,510.84930894007823,NaN,NaN,509.4241,510.89112650300757,507.95707349699245,507.408496126529,509.0769357435523,509.79141752042835,508.3624539666763,16703,25403.6,54.61074741732632,48.879543803110266,NaN,NaN,NaN,NaN,0.9904692427352578,14.017856267063358,12280786,0.12569258445076092,-0.017857671322360602,-0.14355025577312153
2025-09-24T10:25:00-04:00,509.77,510.09,509.61,510.09,NaN,NaN,NaN,510.84930894007823,NaN,NaN,509.3997000000001,510.7783695180637,508.0210304819365,507.6807969012232,509.1237137718495,509.8449683305315,508.4024592131675,22882,25758.533333333333,57.34220325123732,49.48895635782133,NaN,NaN,NaN,NaN,0.9540071539684509,13.239517555499084,12303668,0.16101704848407533,0.05772105483197265,-0.10329599365210268
2025-09-24T10:30:00-04:00,510.05,510.55,509.86,510.27,NaN,NaN,NaN,510.84930894007823,NaN,NaN,509.3853000000001,510.71125989389014,508.05934010611,508.27763752097854,509.16926977267434,509.9087915151818,508.4297480301669,17978,26099.233333333334,58.64601235555351,50.16422412345578,NaN,NaN,NaN,NaN,0.9351495001135613,13.119964275134038,12321646,0.187145867785812,0.1306363410801623,-0.05650952670564968
2025-09-24T10:35:00-04:00,510.31,510.8,510.14,510.29,NaN,NaN,NaN,510.84930894007823,NaN,NaN,509.38230000000004,510.69935005235385,508.06524994764624,508.65211001678284,509.21737597932366,509.9809600559604,508.45379190268693,17557,26442.133333333335,58.79670418966955,50.52311421216957,NaN,NaN,NaN,NaN,0.9154959643911659,13.315571684439067,12339203,0.19550394973619784,0.18787041046459763,-0.007633539271600216
2025-09-24T10:40:00-04:00,510.19,510.27,509.38,510.15,NaN,NaN,NaN,510.84930894007823,NaN,NaN,509.3817000000001,510.6973224534706,508.0660775465296,508.65211001678284,509.2531314865946,510.0135675913884,508.49269538180084,23803,26995.733333333334,57.224753286605,51.0413016434419,NaN,NaN,NaN,NaN,0.9151033955060843,12.366502430228524,12315400,0.1816291140655879,0.21940285331038467,0.03777373924479676
2025-09-24T10:45:00-04:00,510.15,510.37,510.13,510.2,NaN,NaN,NaN,510.84930894007823,NaN,NaN,509.38310000000007,510.7020494153498,508.06415058465035,508.65211001678284,509.2775189670987,510.0437994340324,508.51123850016495,12161,27141.366666666665,57.66012699390087,52.68764666910221,NaN,NaN,NaN,NaN,0.8668817243985075,11.6173216677063,12327561,0.16625784480085154,0.2455960452458612,0.07933820044500965
2025-09-24T10:50:00-04:00,510.29,510.47,509.41,509.41,NaN,NaN,NaN,510.84930894007823,NaN,NaN,509.3843,510.70323595008375,508.06536404991624,508.65211001678284,509.28691219823094,510.04869145678776,508.5251329396741,9637,27175.866666666665,49.14834747990942,52.643688022955295,NaN,NaN,NaN,NaN,0.8806758869414715,11.590364896697793,12317924,0.09676865441907566,0.20029901846885423,0.10353036404977857
2025-09-24T10:55:00-04:00,509.43,509.61,509.09,509.39,NaN,NaN,NaN,510.84930894007823,NaN,NaN,509.38550000000004,510.7043453284229,508.06665467157717,508.65211001678284,509.28863890610205,510.04184855375746,508.53542925844664,11522,26852.533333333333,48.951333571754084,52.506055842352964,NaN,NaN,NaN,NaN,0.854913323588512,11.933380309516895,12306402,0.0459211835066152,0.16093184343304756,0.11501065992643236
2025-09-24T11:00:00-04:00,509.39,510.7,509.39,509.74,NaN,NaN,NaN,510.84930894007823,NaN,NaN,509.38310000000007,510.69891592942713,508.067284070573,508.65211001678284,509.33033348389455,510.0764924148507,508.5841745529384,34685,27071.9,52.536969282115,52.92595507887993,NaN,NaN,NaN,NaN,0.8874195147607613,11.369682504438591,12341087,0.032931361600555736,0.15617486192712704,0.1232435003265713
2025-09-24T11:05:00-04:00,509.81,510,509.56,509.82,NaN,NaN,NaN,510.84930894007823,NaN,NaN,509.38070000000005,510.6928768326584,508.0685231673417,508.65211001678284,509.3369195379206,510.0797785053267,508.5940605705145,7859,26584.266666666666,53.343645386657904,53.51739041595097,NaN,NaN,NaN,NaN,0.8554609779921353,10.84624882829445,12348946,0.027045102130974275,0.15704987799028913,0.13000477585931486
2025-09-24T11:10:00-04:00,509.85,510,509.45,509.83,NaN,NaN,NaN,510.84930894007823,NaN,NaN,509.3781000000001,510.68618392702246,508.0700160729777,508.65211001678284,509.3450909824053,510.0830418853174,508.60714007949315,10881,26618.9,53.450147134463755,53.73178035081598,NaN,NaN,NaN,NaN,0.8336423367069835,10.210575105514131,12359827,0.02139090769998489,0.15674341048429596,0.13535250278431107
2025-09-24T11:15:00-04:00,509.85,510.7,509.79,510.59,NaN,NaN,NaN,510.84930894007823,NaN,NaN,509.4025000000001,510.7538670855683,508.0511329144319,508.78143976207326,509.3604994662509,510.1032676436678,508.61773128883397,8685,26396.3,60.777960224748355,54.688566721149684,NaN,NaN,NaN,NaN,0.8390964555136253,10.46953091455445,12368512,0.06399306301223373,0.21534383154960324,0.1513507685373695
2025-09-24T11:20:00-04:00,510.56,510.88,510.56,510.63,508.3257045098122,508.3257045098122,508.3257045098122,NaN,NaN,NaN,509.4315,510.82412665495843,508.0388733450416,509.18515180965863,509.38261099526875,510.1385457049373,508.6266762856002,9675,26188.233333333334,61.124824454953234,55.69040772183308,NaN,NaN,NaN,NaN,0.8020181372626516,10.909931352820799,12378187,0.08851351700074028,0.26199266478829486,0.17347914778755458
2025-09-24T11:25:00-04:00,510.65,510.73,509.5,509.61,508.3257045098122,NaN,NaN,NaN,NaN,NaN,509.42510000000004,510.8114311148978,508.0387688851023,509.18515180965863,509.3985880518535,510.14959259594576,508.6475835077612,16958,26327.7,49.18081970975226,55.199613909903334,NaN,NaN,NaN,NaN,0.8325882703153207,10.365631413299585,12361229,0.03256684432761184,0.21418770319706937,0.18162085886945753
2025-09-24T11:30:00-04:00,509.63,509.73,509.41,509.69,508.3257045098122,NaN,NaN,NaN,NaN,NaN,509.42890000000006,510.8170718769747,508.0407281230254,509.18515180965863,509.4017900406979,510.14753275737405,508.65604732402176,9207,26145.4,50.00595491755436,54.87070015991963,NaN,NaN,NaN,NaN,0.7959748224356543,9.966453110818339,12370436,-0.0007570436271234215,0.18067455433555324,0.18143159796267666
2025-09-24T11:35:00-04:00,509.58,509.76,509.38,509.38,508.3257045098122,NaN,NaN,NaN,NaN,NaN,509.4189,510.8011203732837,508.0366796267163,509.18515180965863,509.4035312630934,510.14317884995023,508.66388367623654,10263,25925.9,46.832713085368276,54.120022290928986,NaN,NaN,NaN,NaN,0.7662623351188216,9.59578754422861,12360173,-0.04304167855812441,0.12762949976502114,0.17067117832314554
2025-09-24T11:40:00-04:00,509.41,509.52,509.16,509.32,508.3257045098122,NaN,NaN,NaN,NaN,NaN,509.4079,510.7843273901259,508.0314726098741,509.18515180965863,509.4021923073465,510.1348148377987,508.6695697768944,12020,25742.033333333333,46.2213512510181,53.23254649774788,NaN,NaN,NaN,NaN,0.7372435968960456,9.535771826216683,12348153,-0.07267358901392415,0.07982919205574035,0.1525027810696645
2025-09-24T11:45:00-04:00,509.355,509.355,508.65,508.78,508.3257045098122,NaN,NaN,NaN,NaN,NaN,509.39050000000003,510.77621028726463,508.00478971273543,509.18515180965863,509.3909817408194,510.118459723756,508.66350375788284,15270,25644.7,41.03002864103305,51.96349824427384,NaN,NaN,NaN,NaN,0.7349404828320453,10.095634167753325,12332883,-0.12328850400492139,-0.001607848936487244,0.12168065506843415
2025-09-24T11:50:00-04:00,508.83,509.1,508.66,508.93,508.3257045098122,NaN,NaN,NaN,NaN,NaN,509.37250000000006,510.7582882234056,507.9867117765945,509.18515180965863,509.37916607561704,510.1018521520518,508.6564799991823,15806,24663.366666666665,42.94691640670942,50.943652752852735,NaN,NaN,NaN,NaN,0.7138733054868991,10.615506342037348,12348689,-0.14008665477569157,-0.053427663401180325,0.08665899137451125
2025-09-24T11:55:00-04:00,508.93,508.97,508.22,508.28,NaN,NaN,NaN,510.81815161762194,510.81815161762194,510.81815161762194,509.3405,510.7515963823309,507.92940361766915,509.18515180965863,509.358166070627,510.08492032731283,508.6314118139412,15995,22574.933333333334,37.29016770118114,49.48865566051561,NaN,NaN,NaN,NaN,0.7164537836664062,11.607853383636808,12332694,-0.1855433712830674,-0.145270222729323,0.04027314855374439
2025-09-24T12:00:00-04:00,508.23,508.67,508.03,508.55,NaN,NaN,NaN,510.5593719986391,NaN,NaN,509.3147,510.7354609370237,507.89393906297636,509.18515180965863,509.3317373724182,510.0649015025844,508.59857324225203,19560,20709.566666666666,40.77949794739307,48.8908806939073,NaN,NaN,NaN,NaN,0.7109927991188089,12.737482596314281,12352254,-0.18744466380553032,-0.19403268120316852,-0.006588017397638195
2025-09-24T12:05:00-04:00,508.65,508.69,508.06,508.17,NaN,NaN,NaN,510.5593719986391,NaN,NaN,509.2793000000001,510.72397852476064,507.83462147523954,509.18515180965863,509.31796855657575,510.055690684763,508.5802464283885,9487,18390.1,37.60781980832979,48.08062971080556,NaN,NaN,NaN,NaN,0.7052075991817508,13.746767145599739,12342767,-0.20300084866380072,-0.2603390782273891,-0.05733822956358838
2025-09-24T12:10:00-04:00,508.2,508.4,507.84,508.22,NaN,NaN,NaN,510.2914525855369,NaN,NaN,509.23350000000005,510.6643406619938,507.8026593380063,508.7591214477269,509.27409158394033,510.0309969360183,508.51718623186235,27651,17428.866666666665,38.287944182873844,47.062842203716905,NaN,NaN,NaN,NaN,0.6948356278116259,14.940350976891253,12370418,-0.1983958991447216,-0.3053331034944904,-0.10693720434976878
2025-09-24T12:15:00-04:00,508.18,508.82,508,508.74,NaN,NaN,NaN,510.2914525855369,NaN,NaN,509.20950000000005,510.6323678786973,507.7866321213028,508.1806377265452,509.26568524381815,510.02251260204616,508.50885788559015,8274,16765.1,45.00252563631367,46.467047935835176,NaN,NaN,NaN,NaN,0.7037759401107949,15.194558357385862,12378692,-0.15094925386729918,-0.29562377168389276,-0.14467451781659357
2025-09-24T12:20:00-04:00,508.77,508.88,508.19,508.2,NaN,NaN,NaN,510.2914525855369,NaN,NaN,509.1723,510.6015224600554,507.74307753994464,508.1806377265452,509.2503422024983,510.00865838030074,508.49202602469586,13770,16334.4,40.120597081264094,45.514937217749484,NaN,NaN,NaN,NaN,0.7027919443885952,15.312909072943675,12364922,-0.14644017498063971,-0.3277247365423932,-0.1812845615617535
2025-09-24T12:25:00-04:00,508.22,508.3,507.61,508.11,NaN,NaN,NaN,510.12938978161696,NaN,NaN,509.13849999999996,510.586555593006,507.69044440699395,508.0765101812362,509.22545979253954,509.9960861302979,508.4548334547812,15434,15873.933333333332,39.354329448402865,43.98467787658195,NaN,NaN,NaN,NaN,0.7018782340751238,16.17383904693156,12349488,-0.14002818873647116,-0.35631979748234244,-0.21629160874587128
2025-09-24T12:30:00-04:00,508.13,508.45,508,508.24,NaN,NaN,NaN,510.12938978161696,NaN,NaN,509.11510000000004,510.5825338009593,507.64766619904077,507.8477081449889,509.2121852976914,509.9861257049557,508.4382448904271,10426,15345.333333333334,41.10411009304831,42.5546268507316,NaN,NaN,NaN,NaN,0.6838869316411856,16.663765056279342,12359914,-0.118400585333511,-0.36429234041276004,-0.24589175507924904
2025-09-24T12:35:00-04:00,508.3,508.44,507.87,508,NaN,NaN,NaN,510.12938978161696,NaN,NaN,509.0995,510.59712512018996,507.60187487981,507.67416651599115,509.20373367138205,509.9807269117881,508.426740430976,6005,14712.966666666667,38.87414905940244,41.818436089992325,NaN,NaN,NaN,NaN,0.6757521508096719,17.287891019162398,12353909,-0.11171255930775614,-0.3855324542139442,-0.2738198949061881
2025-09-24T12:40:00-04:00,508.02,508.5,507.99,508.49,NaN,NaN,NaN,510.12938978161696,NaN,NaN,509.1131,510.57557583253987,507.6506241674601,507.45433321279296,509.1823898749153,509.9616787384086,508.40310101142205,19651,14719.566666666668,45.38842629362534,41.488612616854546,NaN,NaN,NaN,NaN,0.6639127114661232,17.732483295252454,12373560,-0.06789745822329235,-0.3586917176853035,-0.29079425946201115
2025-09-24T12:45:00-04:00,508.49,508.49,507.9,507.91,NaN,NaN,NaN,510.12938978161696,NaN,NaN,509.11189999999993,510.5782190515391,507.64558094846075,507.23879430716795,509.16850013793754,509.95229811743627,508.3847021584388,10497,14676.733333333334,39.95989600336946,40.997697110997485,NaN,NaN,NaN,NaN,0.6586332320756881,18.2751281840238,12363063,-0.0712388340063227,-0.3798428019699145,-0.3086039679635918
2025-09-24T12:50:00-04:00,507.91,508.05,507.61,507.69,NaN,NaN,NaN,509.8718510773551,NaN,NaN,509.0984999999999,510.60378701610216,507.5932129838976,507.23879430716795,509.1570952686368,509.9476322013133,508.3665583359603,6791,14346.333333333334,38.09855879807559,40.41749765007302,NaN,NaN,NaN,NaN,0.6430165726417103,19.185264469983107,12356272,-0.08082508878994749,-0.40963532895102617,-0.3288102401610787
2025-09-24T12:55:00-04:00,507.69,507.82,507.45,507.52,NaN,NaN,NaN,509.63449421020255,NaN,NaN,509.07789999999994,510.63977591073393,507.51602408926595,507.23879430716795,509.14251196388716,509.94354354230785,508.34148038546647,7781,13842.966666666667,36.676872025103066,40.106557891792306,NaN,NaN,NaN,NaN,0.6235153888815884,20.24373082489718,12348491,-0.09044788551401317,-0.44187009705359515,-0.351422211539582
2025-09-24T13:00:00-04:00,507.51,507.8,507.15,507.46,NaN,NaN,NaN,509.4722444733752,NaN,NaN,509.0546999999999,510.6764082477253,507.4329917522745,507.23879430716795,509.11306768574843,509.93692105162734,508.28921431986953,14920,13741.033333333333,36.163941965017436,39.62205971738574,NaN,NaN,NaN,NaN,0.6254071468186203,21.60558875064531,12333571,-0.09236305106649334,-0.4668760253726987,-0.37451297430620534
2025-09-24T13:05:00-04:00,507.48,507.73,506.94,507.4,NaN,NaN,NaN,509.3491879064036,NaN,NaN,509.0277,510.7125254629073,507.34287453709265,507.23879430716795,509.07795522306367,509.92977936771365,508.2261310784137,17288,13732.066666666668,35.6273622937462,39.50328790256896,NaN,NaN,NaN,NaN,0.6371637791887202,23.1178922109444,12316283,-0.08913631250282589,-0.4859333649347377,-0.3967970524319118
2025-09-24T13:10:00-04:00,507.5,508.17,507.5,507.9,NaN,NaN,NaN,509.3491879064036,NaN,NaN,509.0020999999999,510.71554575655733,507.2886542434425,507.024122148216,509.0515884948494,509.91266066593204,508.19051632376676,19082,13574.7,43.191742614355775,39.675591093066295,NaN,NaN,NaN,NaN,0.6466520806752429,23.357372984490716,12335365,-0.0469148275972619,-0.4554405869284892,-0.4085257593312273
2025-09-24T13:15:00-04:00,507.87,508.05,507.75,507.83,NaN,NaN,NaN,509.3491879064036,NaN,NaN,508.98389999999995,510.72716738066714,507.24063261933276,507.024122148216,509.0400959019161,509.90471350256956,508.1754783012627,8731,13460.366666666667,42.43984525109747,40.020735767549695,NaN,NaN,NaN,NaN,0.6218912177698692,23.579747988498013,12326634,-0.018734651138935687,-0.4319440732548969,-0.41320942211596123
2025-09-24T13:20:00-04:00,507.82,508.06,507.65,508.06,NaN,NaN,NaN,509.3491879064036,NaN,NaN,508.9620999999999,510.7236789396433,507.2005210603565,507.024122148216,509.03396042496036,509.90014211434703,508.1677787355737,4931,13303.5,45.77974818303899,40.55586462470435,NaN,NaN,NaN,NaN,0.6067561307863089,23.939731545293057,12331565,0.01835545299944047,-0.39026510586666063,-0.4086205588661011
2025-09-24T13:25:00-04:00,508.03,508.17,507.91,508.04,NaN,NaN,NaN,509.3491879064036,NaN,NaN,508.93869999999987,510.7174847652142,507.15991523478556,507.024122148216,509.0293055928288,509.8961170865122,508.16249409914536,4223,13060.2,45.532337367838416,40.59370831981325,NaN,NaN,NaN,NaN,0.5819878357301433,23.966583883031362,12327342,0.043089550901490414,-0.3547586202392381,-0.3978481711407285
2025-09-24T13:30:00-04:00,508.07,508.2,508.03,508.1,NaN,NaN,NaN,509.3491879064036,NaN,NaN,508.9158999999999,510.707828224208,507.1239717757918,507.1569010053824,509.0225556662484,509.88973790414246,508.1553734283544,6670,12126.366666666667,46.467037907368315,41.04702552167784,NaN,NaN,NaN,NaN,0.5525601331779914,23.905098193022084,12334012,0.06378974448986596,-0.3181109905283961,-0.38190073501826205
2025-09-24T13:35:00-04:00,508.11,508.33,507.38,507.52,NaN,NaN,NaN,509.3491879064036,NaN,NaN,508.8740999999999,510.69655953612653,507.05164046387324,507.1569010053824,509.00429680633357,509.8785365422379,508.13005707042925,13154,12302.866666666667,39.424057218901986,41.052006076713496,NaN,NaN,NaN,NaN,0.5809486950938483,24.864448082298864,12320858,0.039887732076407834,-0.3320410699227523,-0.3719288019991601
2025-09-24T13:40:00-04:00,507.46,507.63,507.35,507.54,NaN,NaN,NaN,509.31643450611136,NaN,NaN,508.83849999999984,510.6939700216174,506.98302997838226,507.1569010053824,508.9958857775155,509.8748217972797,508.11694975775134,5205,12113.666666666666,39.763104895361245,40.95621999116441,NaN,NaN,NaN,NaN,0.5594523597300001,25.796069568970964,12326063,0.027482590096996606,-0.33757556437791436,-0.36505815447491097
2025-09-24T13:45:00-04:00,507.5,507.54,507.1,507.23,NaN,NaN,NaN,509.1234147558336,NaN,NaN,508.8304999999998,510.7100363793455,506.9509636206541,507.1569010053824,508.9741429772122,509.8681788001961,508.08010715422824,11965,12223,36.365545351236364,40.7770340120097,NaN,NaN,NaN,NaN,0.5509200483207142,26.99650183035283,12314098,0.0018112943735463238,-0.36279403650797803,-0.36460533088152436
2025-09-24T13:50:00-04:00,507.23,507.51,507.13,507.51,NaN,NaN,NaN,509.0932595396593,NaN,NaN,508.7972999999997,510.7100270693048,506.8845729306947,507.1569010053824,508.9610689069363,509.8629327716246,508.059205042248,7779,12159.8,41.24854232411952,40.48132801418785,NaN,NaN,NaN,NaN,0.5387114734406628,28.11118893020742,12321877,0.006819055579200317,-0.356081511407524,-0.3629005669867243
2025-09-24T13:55:00-04:00,507.56,507.75,507.53,507.64,NaN,NaN,NaN,509.0932595396593,NaN,NaN,508.76389999999975,510.6978547981892,506.8299452018103,507.1569010053824,508.9531306596517,509.8580588059082,508.04820251339527,5722,11785.266666666666,43.41940158813038,40.72843555595649,NaN,NaN,NaN,NaN,0.5173749396234733,28.35534600993063,12327599,0.021205148618924086,-0.33639413121306916,-0.35759927983199324
2025-09-24T14:00:00-04:00,507.66,507.93,507.51,507.9,NaN,NaN,NaN,509.0932595396593,NaN,NaN,508.74629999999974,510.69530673203394,506.79729326796553,507.1569010053824,508.94505324102806,509.8520632695895,508.0380432124666,6602,11698.433333333332,47.59038685655429,41.40642327441925,NaN,NaN,NaN,NaN,0.5104195867932263,28.027625857312565,12334201,0.04896322106799761,-0.29639525349699625,-0.34535847456499386
2025-09-24T14:05:00-04:00,507.9,508.01,507.82,507.95,NaN,NaN,NaN,509.0932595396593,NaN,NaN,508.7338999999997,510.69508667177564,506.7727133282238,507.1569010053824,508.94046767630414,509.8479982584574,508.0329370941509,4337,11500.9,48.378490185330456,42.24225314300692,NaN,NaN,NaN,NaN,0.4875324734508529,27.48046289617395,12338538,0.07013416063992206,-0.2576907737650913,-0.32782493440501337
2025-09-24T14:10:00-04:00,507.95,508.09,507.78,507.96,NaN,NaN,NaN,509.0932595396593,NaN,NaN,508.70929999999976,510.67782839490224,506.7407716050973,507.20192854857913,508.93102944332236,509.83940055901996,508.02265832762475,9204,11407.033333333333,48.54514323310424,43.126624662155976,NaN,NaN,NaN,NaN,0.4748515824900778,26.725343360298492,12347742,0.08335404081128522,-0.22363238339090685,-0.3069864242021921
2025-09-24T14:15:00-04:00,508.01,508.2,507.98,508.2,NaN,NaN,NaN,509.0932595396593,NaN,NaN,508.69709999999975,510.6705356744922,506.7236643255073,507.3695428388633,508.92708983763384,509.83497203074995,508.01920764451773,4786,11057.566666666668,52.50792055257046,44.33237882350057,NaN,NaN,NaN,NaN,0.45807646945507285,25.68336320421859,12352528,0.10538542498284065,-0.17525464297364124,-0.2806400679564819
2025-09-24T14:20:00-04:00,508.17,508.19,508.02,508.09,NaN,NaN,NaN,509.0932595396593,NaN,NaN,508.6833999999997,510.66398015776383,506.7028198422356,507.43563427109063,508.92068259844865,509.8279439422227,508.0134212546746,7629,10785,50.585000704064896,44.86046868705122,NaN,NaN,NaN,NaN,0.4382138644939967,24.715810202144397,12344899,0.10920839055411208,-0.14412957976384178,-0.25333797031795385
2025-09-24T14:25:00-04:00,508.09,508.16,507.94,508.13,NaN,NaN,NaN,509.0932595396593,NaN,NaN,508.64839999999975,510.60486358550384,506.6919364144957,507.4465074168725,508.91642243694594,509.8233656191675,508.0094792547244,4996,10418.366666666667,51.28365613545628,45.49216946450542,NaN,NaN,NaN,NaN,0.4226271598872846,24.02621171232214,12349895,0.11074200749004298,-0.11491046095540014,-0.22565246844544312
2025-09-24T14:30:00-04:00,508.13,508.31,507.99,508.25,NaN,NaN,NaN,509.0932595396593,NaN,NaN,508.61899999999974,510.5542322861621,506.68376771383737,507.57920593349803,508.9101492557994,509.815724599814,508.0045739117848,8543,10051.133333333333,53.41173032750555,46.03731104625304,NaN,NaN,NaN,NaN,0.4152966484667638,22.868394002337222,12358438,0.11561331998891303,-0.08113581845930184,-0.19674913844821487
2025-09-24T14:35:00-04:00,508.24,508.62,508.16,508.51,NaN,NaN,NaN,509.0932595396593,NaN,NaN,508.5873999999998,510.47657255995256,506.698227440047,507.80536474679843,508.9077284139973,509.8116579207067,508.0037989072879,5059,9903.533333333333,57.72108911670372,46.90793617117199,NaN,NaN,NaN,NaN,0.41848974500485064,21.623152624155804,12363497,0.130992239946161,-0.03300883851551362,-0.1640010784616746
2025-09-24T14:40:00-04:00,508.53,508.83,508.53,508.82,NaN,NaN,NaN,509.0932595396593,NaN,NaN,508.55839999999984,510.3869091635661,506.7298908364336,508.01829179743874,508.90575671202464,509.80494737243555,508.00656605161373,11047,9350.066666666668,62.20949199985464,48.03239717777815,NaN,NaN,NaN,NaN,0.41145476321878943,21.02268309822841,12374544,0.1550432616745477,0.029802998631510036,-0.12524026304303768
2025-09-24T14:45:00-04:00,508.85,508.93,508.58,508.59,NaN,NaN,NaN,509.0932595396593,NaN,NaN,508.5243999999998,510.2848052264979,506.7639947735017,508.105633437951,508.90444393131185,509.80091117344875,508.00797668917494,6514,9291.4,57.34523818755257,49.31248153268177,NaN,NaN,NaN,NaN,0.4070651372745918,20.7160963451257,12368030,0.14845408106819907,0.06032733829221115,-0.0881267427759879
2025-09-24T14:50:00-04:00,508.63,509.24,508.63,509.23,507.4878349883878,507.4878349883878,507.4878349883878,NaN,NaN,NaN,508.50599999999974,510.2165835266819,506.7954164733176,508.2555067503608,508.90565337192453,509.79799120688176,508.0133155369673,9671,9154.766666666666,65.4425079952743,51.14672461124699,NaN,NaN,NaN,NaN,0.42441762746926626,21.13966878193098,12377701,0.17818864161470505,0.13460905924239341,-0.04357958237231164
2025-09-24T14:55:00-04:00,509.27,509.7,509.27,509.66,508.03952430709745,NaN,NaN,NaN,NaN,NaN,508.4951999999997,510.1692955294419,506.82110447055754,508.6774054002886,508.9101328180098,509.80092445702354,508.01934117899606,7291,8883.333333333334,69.6159122631046,53.521750819237575,NaN,NaN,NaN,NaN,0.4276735112214594,22.370627050949004,12384992,0.21532364725033667,0.22557497669060922,0.010251329440272537
2025-09-24T15:00:00-04:00,509.63,509.93,509.52,509.82,508.28931865677487,NaN,NaN,NaN,NaN,NaN,508.5033999999998,510.1992141883803,506.8075858116192,508.90692432023087,508.9218944773382,509.8120085726665,508.03178038200986,14624,9023.266666666666,71.01842382804558,55.64817092666086,NaN,NaN,NaN,NaN,0.42641111756278555,23.862556441375137,12399616,0.2374288947609842,0.3070374478915028,0.06960855313051859
2025-09-24T15:05:00-04:00,509.82,509.96,509.67,509.86,508.40503144510325,NaN,NaN,NaN,NaN,NaN,508.5127999999997,510.23320014005935,506.79239985994,508.99653945618473,508.93566198144686,509.8259451078982,508.04537885499553,16203,9363.2,71.37417226055237,57.64494026040529,NaN,NaN,NaN,NaN,0.41666746630829826,25.292547037860647,12415819,0.24075571931572545,0.3705532022751754,0.12979748295944996
2025-09-24T15:10:00-04:00,509.88,510.17,509.84,509.89,508.61412092487126,NaN,NaN,NaN,NaN,NaN,508.51579999999973,510.24524888379614,506.7863511162033,509.2342315649478,508.9589486148403,509.8523513085943,508.06554592108637,24697,9531.4,71.65519432818479,59.36385507980747,NaN,NaN,NaN,NaN,0.4104769330005656,26.927613693214365,12440516,0.2309512868973998,0.4184865915811997,0.18753530468379992
2025-09-24T15:15:00-04:00,509.86,509.92,509.62,509.85,508.61412092487126,NaN,NaN,NaN,NaN,NaN,508.5163999999997,510.2476781872976,506.7851218127018,509.2342315649478,508.971279809104,509.86380283689243,508.0787567813155,16336,9726.033333333333,70.6591601020063,60.95533150242718,NaN,NaN,NaN,NaN,0.402585723500526,27.60348993581915,12424180,0.2084367803847887,0.44808128016478577,0.23964449977999708
2025-09-24T15:20:00-04:00,509.86,509.9,509.46,509.52,508.61412092487126,NaN,NaN,NaN,NaN,NaN,508.51019999999977,510.22475645622313,506.7956435437764,509.2342315649478,508.9828772355464,509.871678356571,508.09407611452184,19992,10166.066666666668,62.89202603624409,61.980108845508596,NaN,NaN,NaN,NaN,0.40525817182191687,27.659450921909993,12404188,0.16015390120770834,0.43983687628963253,0.2796829750819242
2025-09-24T15:25:00-04:00,509.53,509.54,509.11,509.24,508.61412092487126,NaN,NaN,NaN,NaN,NaN,508.4831999999998,510.10596031547146,506.8604396845281,509.2342315649478,508.98758900545397,509.870516984785,508.1046610261229,17223,10480.8,57.151535460764244,62.311795624665294,NaN,NaN,NaN,NaN,0.407025445263209,26.59772785639839,12386965,0.10107683362525793,0.4060290171134966,0.30495218348823866
2025-09-24T15:30:00-04:00,509.24,509.585,509.09,509.55,508.61412092487126,NaN,NaN,NaN,NaN,NaN,508.46159999999975,509.9958195937132,506.9273804062863,509.2342315649478,508.9973658830416,509.872274472565,508.1224572935182,27287,10893.033333333333,61.35698802020388,63.081223290103786,NaN,NaN,NaN,NaN,0.41330934203012293,25.71484972362533,12414252,0.07575314247424197,0.3996436115810411,0.32389046910679914
2025-09-24T15:35:00-04:00,509.55,509.56,509.26,509.33,508.61412092487126,NaN,NaN,NaN,NaN,NaN,508.4559999999998,509.97538408624547,506.9366159137541,509.2342315649478,509.0021230339631,509.87266536829065,508.1315806996355,14654,10805.233333333334,57.075700497592074,63.49494074454206,NaN,NaN,NaN,NaN,0.4052158175994007,24.895034314621782,12399598,0.03891690493610517,0.3725366002769306,0.3336196953408254
2025-09-24T15:40:00-04:00,509.34,509.64,509.2,509.3,508.61412092487126,NaN,NaN,NaN,NaN,NaN,508.44819999999976,509.946015423086,506.9503845769135,509.2342315649478,509.0113557290167,509.87317420189066,508.14953725614276,29777,11161.733333333334,56.49678212480197,63.7153015872061,NaN,NaN,NaN,NaN,0.40770040205658614,24.335759356326246,12369821,0.00883249942525316,0.34466031962239185,0.3358278201971387
2025-09-24T15:45:00-04:00,509.31,509.38,509.02,509.28,508.61412092487126,NaN,NaN,NaN,NaN,NaN,508.44619999999975,509.93929284428293,506.95310715571657,509.2342315649478,509.0158662450708,509.8691672110822,508.16256527905944,26077,11739.933333333332,56.08833853727572,63.59867654581838,NaN,NaN,NaN,NaN,0.4042932304811167,23.19780479752019,12343744,-0.01482486874127742,0.31729673427054195,0.33212160301181937
2025-09-24T15:50:00-04:00,509.27,510.02,509.25,510,508.61412092487126,NaN,NaN,NaN,NaN,NaN,508.45979999999975,509.9962399896584,506.92336001034107,509.2342315649478,509.0590315077109,509.90508682556214,508.2129761898597,77020,14142.9,65.70157683600098,63.84811117697169,NaN,NaN,NaN,NaN,0.4304151425896071,23.585393857985572,12420764,0.014045124018157384,0.3496780080345161,0.3356328840163587
2025-09-24T15:55:00-04:00,510.01,510.52,509.93,510.12,508.82899411934875,NaN,NaN,NaN,NaN,NaN,508.4865999999997,510.0897449596788,506.88345504032065,509.2933583587132,509.17122366106986,510.0424870826546,508.29996023948513,145564,18854.266666666666,66.99833537920807,64.5376181192328,NaN,NaN,NaN,NaN,0.44181406097606196,24.743868333325132,12566328,0.03600222628680605,0.3806356668748663,0.3446334405880602
2025-09-25T09:30:00-04:00,508.3,508.96,506.52,508.54,NaN,NaN,NaN,509.56346015880354,509.56346015880354,509.56346015880354,508.47879999999975,510.07702721839945,506.88057278160005,509.2933583587132,508.0066666666667,508.0066666666667,508.0066666666667,85618,21485.866666666665,43.61587954686253,62.97857323006053,NaN,NaN,NaN,NaN,0.6673987709063448,25.475572288983646,12480710,-0.05609664970881312,0.2745126284520438,0.33060927816085695
2025-09-25T09:35:00-04:00,508.55,508.85,506.775,508.375,NaN,NaN,NaN,509.56346015880354,NaN,NaN,508.4806999999998,510.07820306462105,506.8831969353785,509.2933583587132,508.0033372701724,508.0066706084355,508.00000393190925,85416,23894.6,41.968618880659726,61.0037665598859,NaN,NaN,NaN,NaN,0.7679417158416092,26.15501167638084,12395294,-0.12442577806918392,0.17507705557437703,0.29950283364356095
2025-09-25T09:40:00-04:00,508.33,509.14,508.23,508.83,NaN,NaN,NaN,509.56346015880354,NaN,NaN,508.48629999999974,510.08669596407725,506.88590403592224,509.2933583587132,508.178347083437,508.49001435363266,507.8666798132414,53934,25518.9,47.820914948151604,59.346801639893464,NaN,NaN,NaN,NaN,0.7780887361386348,26.30265864914986,12449228,-0.13442402020729333,0.1314728083844443,0.26589682859173763
2025-09-25T09:45:00-04:00,508.84,509.27,507.07,507.56,NaN,NaN,NaN,509.56346015880354,NaN,NaN,508.47409999999974,510.09314625066105,506.8550537493384,509.2933583587132,508.1395158035338,508.4328235545199,507.8462080525477,50540,26804.733333333334,36.696738732403276,56.86984210216853,NaN,NaN,NaN,NaN,0.8796538264144458,27.35014192287717,12398688,-0.21711655909639557,-0.00549887027875684,0.21161768881763873
2025-09-25T09:50:00-04:00,507.6,508.52,506.3,506.73,NaN,NaN,NaN,509.56346015880354,NaN,NaN,508.4442999999997,510.1342538579775,506.7543461420219,509.2933583587132,508.01485461409294,508.4373139373773,507.59239529080855,41304,27922.233333333334,31.53391879631053,54.004036707034665,NaN,NaN,NaN,NaN,0.9753928388134119,28.797750258078853,12357384,-0.31246297069875395,-0.17896102455580376,0.13350194614295022
2025-09-25T09:55:00-04:00,506.74,506.86,505.5,506.25,NaN,NaN,NaN,508.7156446682708,NaN,NaN,508.39449999999977,510.19011270925597,506.59888729074356,509.2933583587132,507.7923724812115,508.5065752957501,507.07816966667286,44357,29210.066666666666,28.993485668805107,51.02791710466314,NaN,NaN,NaN,NaN,1.0028647788981693,30.560732441258377,12313027,-0.3876940194717638,-0.35111557819675454,0.03657844127500927
2025-09-25T10:00:00-04:00,506.27,506.5,505.04,506.17,NaN,NaN,NaN,508.38947900153113,NaN,NaN,508.3538999999997,510.25402556472176,506.4537744352777,509.2933583587132,507.5739767734373,508.4772900982484,506.67066344862627,47214,30563.8,28.5802204743959,48.57707385024541,NaN,NaN,NaN,NaN,1.0355172946911557,32.413155772889866,12265813,-0.4199627140127044,-0.48837495124087127,-0.06841223722816685
2025-09-25T10:05:00-04:00,506.13,506.99,505.77,506.89,NaN,NaN,NaN,508.38947900153113,NaN,NaN,508.32949999999977,510.27237853495376,506.3866214650458,509.2933583587132,507.51488124382297,508.42367371602637,506.60608877161957,25012,31252.966666666667,37.24932070169355,47.15548708174037,NaN,NaN,NaN,NaN,1.0486946307846465,33.35966781863156,12290825,-0.37160054792167857,-0.5329129221302651,-0.16131237420858652
2025-09-25T10:10:00-04:00,506.89,506.96,506.19,506.24,NaN,NaN,NaN,508.38947900153113,NaN,NaN,508.28949999999975,510.3185433710809,506.2604566289186,509.2933583587132,507.45067589876464,508.3665735179667,506.5347782795626,28183,31885.6,33.31750191216092,45.15266664545158,NaN,NaN,NaN,NaN,1.0287878714428849,34.23857186110599,12262642,-0.3618189917414426,-0.6135861138853898,-0.25176712214394714
2025-09-25T10:15:00-04:00,506.24,507.19,506.08,506.43,NaN,NaN,NaN,508.38947900153113,NaN,NaN,508.2580999999998,510.351658588031,506.16454141196857,506.17868668697054,507.39622205009243,508.30856392600606,506.4838801741788,30299,32736.033333333333,35.461951749395766,43.60882744915185,NaN,NaN,NaN,NaN,1.034588737768394,34.67694428512985,12292941,-0.32230028348342216,-0.6546424764982248,-0.33234219301480267
2025-09-25T10:20:00-04:00,506.43,508.17,506.13,507.95,NaN,NaN,NaN,508.38947900153113,NaN,NaN,508.24729999999977,510.3415332347912,506.15306676520834,506.0749594796611,507.3974607509662,508.2817457136611,506.5131757882713,31724,33539.2,49.463696921860794,43.106464220370334,NaN,NaN,NaN,NaN,1.106403827927796,33.652116666707805,12324665,-0.18060245997773472,-0.5580952679869711,-0.37749280800923635
2025-09-25T10:25:00-04:00,507.98,508.2,507.575,508.19,NaN,NaN,NaN,508.38947900153113,NaN,NaN,508.2528999999997,510.3449918626588,506.16080813734067,506.0749594796611,507.42510780024867,508.2974284726533,506.55278712784406,25702,34229.4,51.26169451014593,42.761703932718206,NaN,NaN,NaN,NaN,1.0720178402186675,32.66021668199735,12350367,-0.06356376077412751,-0.45694750897689573,-0.3933837482027682
2025-09-25T10:30:00-04:00,508.16,509.03,507.96,508.76,505.68211073452414,505.68211073452414,505.68211073452414,NaN,NaN,NaN,508.2742999999997,510.36481190904726,506.18378809095213,505.9535149257057,507.49143063745856,508.38013078694576,506.60273048797137,33365,35056.8,55.32687872956695,42.02065406797293,NaN,NaN,NaN,NaN,1.0718737087744765,30.69113919510898,12383732,0.053088418762344936,-0.327023224749837,-0.38011164351218196
2025-09-25T10:35:00-04:00,508.71,509.2,508.47,509.08,506.05042388295493,NaN,NaN,NaN,NaN,NaN,508.3054999999997,510.39661477487317,506.21438522512625,506.3738119405646,507.53563921594724,508.44467344894014,506.62660498295435,18652,35509.9,57.47149561609261,41.340165513464676,NaN,NaN,NaN,NaN,1.0474541581477255,28.665199320484913,12402384,0.14730782005017484,-0.19597686844946338,-0.3432846884996382
2025-09-25T10:40:00-04:00,509.1,509.89,508.85,509.28,506.57017734282056,NaN,NaN,NaN,NaN,NaN,508.3418999999997,510.4362360670502,506.2475639329493,507.1090495524517,507.5945607089446,508.54440429888314,506.64471711900603,20299,35818.3,58.8026766605121,42.42493673586821,NaN,NaN,NaN,NaN,1.0469217182800281,27.20530743933726,12422683,0.2145337898439279,-0.07511745119472835,-0.28965124103865625
2025-09-25T10:45:00-04:00,509.31,510,509.17,509.89,506.79926019087424,NaN,NaN,NaN,NaN,NaN,508.3916999999997,510.5123316139333,506.271068386066,507.36023964196136,507.6573291763285,508.6585848296788,506.65607352297826,19227,36242.066666666666,62.64336676181323,43.90170444166489,NaN,NaN,NaN,NaN,1.0314273098314535,25.963756448786796,12441910,0.28699297956700426,0.06908998342009909,-0.21790299614690517
2025-09-25T10:50:00-04:00,509.85,509.93,509.45,509.55,506.9654301821981,NaN,NaN,NaN,NaN,NaN,508.42469999999963,510.5649601809541,506.2844398190452,507.5781917135691,507.7028018198924,508.7361458549594,506.6694577848254,15017,36420.26666666667,59.32364374495242,44.72332792715066,NaN,NaN,NaN,NaN,0.9920396448434937,24.810887671847077,12426893,0.29765292401925847,0.15416315887716792,-0.14348976514209055
2025-09-25T10:55:00-04:00,509.6,510.02,509.6,509.71,507.14518335573456,NaN,NaN,NaN,NaN,NaN,508.4622999999997,510.6253822550059,506.2992177449935,507.90355337085526,507.75140286459356,508.8196752687634,506.68313046042374,15739,36701.86666666667,60.387504314460564,46.41552546872618,NaN,NaN,NaN,NaN,0.954751098783242,23.844989893687966,12442632,0.3002499075690691,0.23182261931924586,-0.06842728824982326
2025-09-25T11:00:00-04:00,509.72,509.81,508.54,508.78,507.14518335573456,NaN,NaN,NaN,NaN,NaN,508.4766999999997,510.638463734093,506.3149362659064,507.90355337085526,507.783709238072,508.85765639801235,506.70976207813163,17225,36788.566666666666,51.89197370587945,47.86967224798111,NaN,NaN,NaN,NaN,0.9772688774415805,22.693399723387646,12425407,0.2274114614268352,0.21583703853372072,-0.011574422893114465
2025-09-25T11:05:00-04:00,508.77,509.03,507.77,508.24,507.14518335573456,NaN,NaN,NaN,NaN,NaN,508.4806999999996,510.6399554370157,506.3214445629835,507.90355337085526,507.80075407249745,508.862708300573,506.7387998444219,21507,36965.36666666667,47.69610547309493,49.20557366257324,NaN,NaN,NaN,NaN,0.9974639576243242,22.401061969117027,12403900,0.1354804332551074,0.1577761186757698,0.02229568542066239
2025-09-25T11:10:00-04:00,508.245,509.17,507.97,509.11,507.14518335573456,NaN,NaN,NaN,NaN,NaN,508.50089999999966,510.664424615575,506.3373753844243,507.90355337085526,507.82339563541865,508.88255915450117,506.76423211633613,17357,36720.7,54.13112561612337,51.030638315553766,NaN,NaN,NaN,NaN,1.0119308177940145,21.938478192583414,12421257,0.12607583962826238,0.17989048495599036,0.053814645327727985
2025-09-25T11:15:00-04:00,509.06,509.24,508.89,509.24,507.14518335573456,NaN,NaN,NaN,NaN,NaN,508.5352999999997,510.6900235650918,506.38057643490765,507.90355337085526,507.8491578664269,508.913310360932,506.7850053719218,14713,36666.6,55.02161455264843,52.300087876336256,NaN,NaN,NaN,NaN,0.9646500450944436,21.40955067781212,12435970,0.12137779714359326,0.20553689175721956,0.0841590946136263
2025-09-25T11:20:00-04:00,509.26,509.3,508.43,508.46,507.14518335573456,NaN,NaN,NaN,NaN,NaN,508.55369999999965,510.6897438296935,506.4176561703058,507.90355337085526,507.86096307941614,508.92280241905354,506.79912373977874,10085,36336.36666666667,48.88885114119891,53.412327106981834,NaN,NaN,NaN,NaN,0.957889327587698,21.396351288569107,12425885,0.06152529025800857,0.16106570743613702,0.09954041717812845
2025-09-25T11:25:00-04:00,508.46,508.46,507.75,507.98,507.14518335573456,NaN,NaN,NaN,NaN,NaN,508.56869999999975,510.6777138078936,506.4596861921059,507.90355337085526,507.8650402038647,508.9165132716406,506.81356713608875,15472,36278,45.525956379652094,54.13118458057158,NaN,NaN,NaN,NaN,0.9401829470457181,22.00768211178084,12410413,-0.01075432851846099,0.08609750653005221,0.0968518350485132
2025-09-25T11:30:00-04:00,508.06,508.74,507.99,508.64,507.14518335573456,NaN,NaN,NaN,NaN,NaN,508.5912999999997,510.67855543285935,506.50404456714006,507.90355337085526,507.8713404025714,508.9189614481933,506.8237193569495,8266,35643.96666666667,50.56160259560984,54.20960641441079,NaN,NaN,NaN,NaN,0.9273127365424518,22.140536693017108,12418679,-0.01425735518012218,0.07903014107336048,0.09328749625348266
2025-09-25T11:35:00-04:00,508.66,509,508.38,508.82,507.14518335573456,NaN,NaN,NaN,NaN,NaN,508.6148999999997,510.68521252766527,506.5445874723341,507.90355337085526,507.88809966423213,508.93229172405717,506.8439076044071,15391,35668.53333333333,51.868402592751984,54.25294270602551,NaN,NaN,NaN,NaN,0.9053618267894199,21.868003817790612,12434070,-0.005068895118166786,0.08695137735577418,0.09202027247394097
2025-09-25T11:40:00-04:00,508.83,508.97,508.55,508.7,507.14518335573456,NaN,NaN,NaN,NaN,NaN,508.63089999999977,510.6912064727883,506.57059352721126,507.90355337085526,507.8979474974904,508.9400728864615,506.8558221085193,9258,34984.566666666666,50.902404076985874,53.93690880226972,NaN,NaN,NaN,NaN,0.870693124875891,21.61493757650887,12424812,-0.007541077420474815,0.08259392569834745,0.09013500311882226
2025-09-25T11:45:00-04:00,508.67,508.93,508.54,508.79,507.14518335573456,NaN,NaN,NaN,NaN,NaN,508.64769999999976,510.69920404383294,506.5961959561666,507.4818426966842,507.90731848342773,508.9475375059816,506.8670994608739,8871,34411.03333333333,51.630008852305934,53.519659747713526,NaN,NaN,NaN,NaN,0.8363579016704693,21.391568509763154,12433683,-0.003773431528604196,0.08541821370806701,0.08919164523667121
2025-09-25T11:50:00-04:00,508.75,508.75,508.25,508.72,507.14518335573456,NaN,NaN,NaN,NaN,NaN,508.6628999999997,510.70503818387215,506.62076181612724,507.29621043552237,507.9219069487847,508.95527883555366,506.8885350620157,18134,32448.166666666668,50.99698506665071,52.962110348152,NaN,NaN,NaN,NaN,0.8151894801225801,21.52515096184038,12415549,-0.006494514230647383,0.08107350244836198,0.08756801667900936
2025-09-25T11:55:00-04:00,508.77,508.93,508.24,508.68,507.14518335573456,NaN,NaN,NaN,NaN,NaN,508.67249999999973,510.7103520559601,506.6346479440394,507.3233746787343,507.9316948489819,508.961023622378,506.90236607558586,11830,27990.366666666665,50.61508962539088,52.102947695550405,NaN,NaN,NaN,NaN,0.8062473743995385,21.317498209898332,12403719,-0.011210630429998494,0.07355472864151125,0.08476535907150974
2025-09-25T12:00:00-04:00,508.62,508.92,508.59,508.59,507.14518335573456,NaN,NaN,NaN,NaN,NaN,508.6824999999997,510.7137166309822,506.6512833690172,507.4696997429874,507.9381986979661,508.9655756227553,506.91082177317685,7169,25375.4,49.71302558667888,51.41647496995943,NaN,NaN,NaN,NaN,0.7722297047995744,21.124677797380713,12396550,-0.020095300267518032,0.0596462337371122,0.07974153400463023
2025-09-25T12:05:00-04:00,508.57,508.95,508.5,508.61,507.14518335573456,NaN,NaN,NaN,NaN,NaN,508.6920999999997,510.71730921444987,506.6668907855495,507.56475979438994,507.94969516791457,508.9732983049471,506.92609203088205,13211,22968.566666666666,49.926593824310274,50.66926707780584,NaN,NaN,NaN,NaN,0.7492132973138897,21.06990733417659,12409761,-0.024061245418969507,0.04966497723091834,0.07372622264988785
2025-09-25T12:10:00-04:00,508.59,509.05,508.59,508.725,507.14518335573456,NaN,NaN,NaN,NaN,NaN,508.70159999999964,510.7228772601615,506.6803227398378,507.71180783551193,507.9578905775988,508.97981531074737,506.9359658444502,8488,21453.7,51.20971318095843,50.62053418316862,NaN,NaN,NaN,NaN,0.7285552046486146,20.804607425691742,12418249,-0.01861880932232743,0.05045271099697857,0.069071520319306
2025-09-25T12:15:00-04:00,508.77,508.99,508.46,508.63,507.14518335573456,NaN,NaN,NaN,NaN,NaN,508.70399999999967,510.72464643181394,506.6833535681854,507.71180783551193,507.96620263750225,508.98530566110315,506.94709961390134,9929,20100,50.06832484136454,50.78997842375931,NaN,NaN,NaN,NaN,0.7143726900308585,20.757447760432274,12408320,-0.020923956992505335,0.04291657407867433,0.06384053107117967
2025-09-25T12:20:00-04:00,508.63,508.74,508.19,508.31,507.14518335573456,NaN,NaN,NaN,NaN,NaN,508.69379999999967,510.717148275086,506.67045172491333,507.71180783551193,507.97166301051664,508.9857140933405,506.95761192769277,10861,19085.233333333334,46.323005337386526,50.23225554670669,NaN,NaN,NaN,NaN,0.7026317836000837,21.11393910012096,12397459,-0.0422755848506546,0.010996050007861413,0.053271634858516013
2025-09-25T12:25:00-04:00,508.37,508.47,508.03,508.11,507.14518335573456,NaN,NaN,NaN,NaN,NaN,508.68419999999975,510.71397177086925,506.65442822913025,507.71180783551193,507.97462978009565,508.98250363489996,506.96675592529135,11537,17991.233333333334,44.10249075653325,49.45231813269846,NaN,NaN,NaN,NaN,0.6838723704857959,21.672309653978786,12385922,-0.0666914156172975,-0.030092634663105855,0.03659878095419164
2025-09-25T12:30:00-04:00,508.11,508.68,508.04,508.61,507.14518335573456,NaN,NaN,NaN,NaN,NaN,508.6717999999998,510.69564956006946,506.6479504399301,507.71180783551193,507.9819476796386,508.98360938750955,506.98028597176767,14289,16893.733333333334,50.49186282909974,49.56681896754852,NaN,NaN,NaN,NaN,0.6807386297368094,21.664694360001118,12400211,-0.046923543310593605,-0.02205564818405037,0.024867895126543235
2025-09-25T12:35:00-04:00,508.58,508.66,508.21,508.26,507.14518335573456,NaN,NaN,NaN,NaN,NaN,508.64379999999977,510.65085611330386,506.6367438866957,507.71180783551193,507.9875304877066,508.9831749279672,506.991886047446,13130,16497.666666666668,46.486216116409985,49.635408948745514,NaN,NaN,NaN,NaN,0.6642572990413262,21.657623015593288,12387081,-0.054636512427495044,-0.04342774540782557,0.011208767019669474
2025-09-25T12:40:00-04:00,508.22,508.25,507.6,507.71,507.14518335573456,NaN,NaN,NaN,NaN,NaN,508.6015999999998,510.5966523205455,506.6065476794541,507.71180783551193,507.9856707150176,508.97451646566134,506.99682496437384,13046,15993.1,40.983918727430144,48.95128867244697,NaN,NaN,NaN,NaN,0.6639532062526579,22.55524273278547,12374035,-0.09180861906995867,-0.10355200681777887,-0.011743387747820197
2025-09-25T12:45:00-04:00,507.72,508.11,507.61,507.64,507.14518335573456,NaN,NaN,NaN,NaN,NaN,508.5571999999998,510.5370072233205,506.5773927766791,507.71180783551193,507.984031825097,508.96896157598985,506.9991020742042,7817,15243.7,40.329637863038506,48.127091191753145,NaN,NaN,NaN,NaN,0.6522422629488965,23.388746755892495,12366218,-0.1146547900946476,-0.1550618753661297,-0.0404070852714821
2025-09-25T12:50:00-04:00,507.64,507.93,507.59,507.93,507.14518335573456,NaN,NaN,NaN,NaN,NaN,508.51799999999974,510.46809025479723,506.56790974520226,507.71180783551193,507.98316145260196,508.9656005852169,507.000722319987,4962,14351.633333333333,44.29710335611294,47.655283997405085,NaN,NaN,NaN,NaN,0.6299392441668348,24.191371706236982,12371180,-0.10408842774365917,-0.17051761995105608,-0.0664291922073969
2025-09-25T12:55:00-04:00,507.93,508.22,507.87,508.05,507.14518335573456,NaN,NaN,NaN,NaN,NaN,508.48199999999974,510.398572983675,506.56542701632446,507.71180783551193,507.9836305813988,508.9624493325988,507.00481183019883,7101,13731.6,45.900050764635075,47.246001276857164,NaN,NaN,NaN,NaN,0.6099435838692054,24.100423006087475,12378281,-0.0837454072229868,-0.1711109512361304,-0.0873655440131436
2025-09-25T13:00:00-04:00,508.03,508.25,507.82,507.85,507.14518335573456,NaN,NaN,NaN,NaN,NaN,508.4485999999998,510.3497965079237,506.54740349207583,507.6544462684095,507.98353203735263,508.95765642662144,507.0094076480838,9288,12929.033333333333,43.64572517638333,46.72091128469521,NaN,NaN,NaN,NaN,0.5970904707356912,24.1034605536984,12368993,-0.07857176121647914,-0.18558024553374253,-0.10700848431726338
2025-09-25T13:05:00-04:00,507.79,508.09,507.74,507.89,507.14518335573456,NaN,NaN,NaN,NaN,NaN,508.42159999999984,510.31540298908845,506.52779701091123,507.39655701472765,507.98283404105587,508.95255285954306,507.0131152225687,8894,12603.766666666666,44.235620600225886,46.265234925754854,NaN,NaN,NaN,NaN,0.5794411513974251,24.25068369636053,12377887,-0.06768187609503597,-0.19161082943605834,-0.12392895334102237
2025-09-25T13:10:00-04:00,507.87,508.07,507.62,507.74,507.14518335573456,NaN,NaN,NaN,NaN,NaN,508.3853999999998,510.2606470135649,506.51015298643466,507.3503571915405,507.9799351430505,508.9417432849276,507.0181270011734,16708,12484.066666666668,42.441487298832165,45.7458393337658,NaN,NaN,NaN,NaN,0.5701953548690368,24.60506866970457,12361179,-0.06575112425011798,-0.20611785865366983,-0.14036673440355185
2025-09-25T13:15:00-04:00,507.79,507.97,507.48,507.63,507.14518335573456,NaN,NaN,NaN,NaN,NaN,508.3513999999998,510.2185358176931,506.48426418230645,507.3503571915405,507.97601952857235,508.93181407928427,507.02022497786044,13798,12303.1,41.124242173062555,45.117099930105255,NaN,NaN,NaN,NaN,0.5644671152355348,25.183418026145798,12347381,-0.06683443011286672,-0.22390977204463525,-0.15707534193176853
2025-09-25T13:20:00-04:00,507.65,507.68,507.2,507.44,507.14518335573456,NaN,NaN,NaN,NaN,NaN,508.31419999999974,510.17836883403635,506.45003116596314,507.3503571915405,507.96935812387727,508.92104945827407,507.0176667894805,12709,12226.166666666666,38.87961820391329,44.236378860316314,NaN,NaN,NaN,NaN,0.5584337498615694,26.18189437939523,12334672,-0.07470318419132446,-0.2504543221709241,-0.17575113797959965
2025-09-25T13:25:00-04:00,507.44,508.09,507.44,507.98,507.14518335573456,NaN,NaN,NaN,NaN,NaN,508.2881999999998,510.13393428251294,506.44246571748664,507.09388824452395,507.96813044913233,508.91549416559445,507.0207667326702,9550,12019.866666666667,47.62872430616701,44.06212167923077,NaN,NaN,NaN,NaN,0.5649741963000271,25.8022004416664,12344222,-0.039655274409599595,-0.22532023099159915,-0.18566495658199955
2025-09-25T13:30:00-04:00,507.95,508.08,507.7,507.885,507.14518335573456,NaN,NaN,NaN,NaN,NaN,508.24589999999984,510.02864023945756,506.4631597605421,507.09388824452395,507.96723683958453,508.90931850871203,507.025155170457,11690,11835.366666666667,46.37113205664166,44.065559302034714,NaN,NaN,NaN,NaN,0.5517617537071676,25.449627499489637,12332532,-0.019979134631332496,-0.21063887487116517,-0.19065974023983268
2025-09-25T13:35:00-04:00,507.91,507.95,507.53,507.74,507.14518335573456,NaN,NaN,NaN,NaN,NaN,508.1982999999998,509.90376018470073,506.49283981529885,507.09388824452395,507.9654865393337,508.9041432395531,507.0268298391143,8103,11388.566666666668,44.44229108498508,44.08983075406699,NaN,NaN,NaN,NaN,0.5423501998709425,25.458345410592187,12324429,-0.014114524952666935,-0.20830289643066635,-0.19418837147799942
2025-09-25T13:40:00-04:00,507.75,507.86,507.43,507.79,507.14518335573456,NaN,NaN,NaN,NaN,NaN,508.18329999999986,509.88966761611005,506.4769323838897,507.09388824452395,507.9630363739245,508.89781173942407,507.028261008425,9557,11128.566666666668,45.28741931672218,43.71808478889716,NaN,NaN,NaN,NaN,0.5343251855944471,25.659428848881948,12333986,-0.004737532994925853,-0.20011028772165673,-0.19537275472673088
2025-09-25T13:45:00-04:00,507.82,507.92,507.62,507.65,507.14518335573456,NaN,NaN,NaN,NaN,NaN,508.1687999999999,509.8807177085798,506.45688229142,507.09388824452395,507.9616285549315,508.89375099628757,507.02950611357545,6452,10853.2,43.30122743001555,43.49058559701184,NaN,NaN,NaN,NaN,0.5175876723377016,25.63616030499328,12327534,-0.005765163613354829,-0.20257920924342443,-0.1968140456300696
2025-09-25T13:50:00-04:00,507.65,507.87,507.6,507.78,507.14518335573456,NaN,NaN,NaN,NaN,NaN,508.1477999999999,509.8525042678855,506.44309573211433,506.99011059561917,507.9597428333159,508.88791621810566,507.0315694485261,9602,10837.1,45.68341569949395,43.82626395215925,NaN,NaN,NaN,NaN,0.4999028385992931,25.658073825807076,12337136,0.003983569208429072,-0.19183458411953325,-0.19581815332796232
2025-09-25T13:55:00-04:00,507.81,507.86,507.15,507.25,507.14518335573456,NaN,NaN,NaN,NaN,NaN,508.14159999999987,509.85703165447507,506.4261683455247,506.96508847649534,507.9553245264289,508.8809696085791,507.0296794442787,8894,10617.833333333334,38.56874045113829,43.70048556559495,NaN,NaN,NaN,NaN,0.5149097786993462,26.55167726316924,12328242,-0.022153064301551645,-0.22350948370490187,-0.20135641940335022
2025-09-25T14:00:00-04:00,507.2,507.25,506.5,506.56,NaN,NaN,NaN,508.6243448555115,508.6243448555115,508.6243448555115,508.13819999999987,509.86544261208024,506.4109573879195,506.89838823997246,507.9338449996447,508.8645925784833,507.00309742080606,20052,11010.7,31.65651989238134,42.79758674675698,NaN,NaN,NaN,NaN,0.5317019373636785,28.28386439104006,12308190,-0.07957215959203529,-0.3008216188933943,-0.22124945930135903
2025-09-25T14:05:00-04:00,506.6,506.98,506.53,506.6,NaN,NaN,NaN,508.4861928166246,NaN,NaN,508.1451999999998,509.84438564063305,506.4460143593666,506.89838823997246,507.91915686236007,508.85393419430153,506.9843795304186,13368,10943.266666666666,32.41273024431723,41.83420670959141,NaN,NaN,NaN,NaN,0.5258660846948476,29.892323866920105,12321558,-0.10682023639438037,-0.3547747547943345,-0.24795451839995414
2025-09-25T14:10:00-04:00,506.65,507.17,506.5,507.15,NaN,NaN,NaN,508.4861928166246,NaN,NaN,508.1647999999999,509.79354670871135,506.53605329128845,506.89838823997246,507.9104979844968,508.8456369158808,506.97535905311287,9992,10967.733333333334,41.927596933056634,41.7114832636395,NaN,NaN,NaN,NaN,0.5361613643595026,30.68810064291298,12331550,-0.08093884063370915,-0.3491280691920906,-0.26818922855838145
2025-09-25T14:15:00-04:00,507.14,507.4,507.08,507.22,NaN,NaN,NaN,508.4861928166246,NaN,NaN,508.17139999999984,509.78200366369083,506.56079633630884,506.89838823997246,507.90251921787467,508.83499998754655,506.9700384482028,13472,11121.1,43.02692545381748,41.62514789603891,NaN,NaN,NaN,NaN,0.5207212669052519,30.642543751558648,12345022,-0.053561668934551054,-0.33514131472657027,-0.2815796457920192
2025-09-25T14:20:00-04:00,507.22,507.22,506.79,507.02,NaN,NaN,NaN,508.4861928166246,NaN,NaN,508.18699999999984,509.7364205372683,506.63757946273137,506.8858918230927,507.8967298579161,508.8289389584225,506.96452075740973,7465,10765.466666666667,40.658675365715425,41.49780418653057,NaN,NaN,NaN,NaN,0.51424117641202,31.07804959421811,12337557,-0.043790821787117185,-0.3363181730259157,-0.2925273512387985
2025-09-25T14:25:00-04:00,506.98,507.11,506.75,506.85,NaN,NaN,NaN,508.4861928166246,NaN,NaN,508.19539999999984,509.7108086450443,506.67999135495535,506.8858918230927,507.8909552247489,508.823513730769,506.9583967187288,6729,10595.433333333332,38.70839939190358,41.32524398787636,NaN,NaN,NaN,NaN,0.5032239495254481,31.54573580218277,12330828,-0.04355314367520946,-0.34696878083281035,-0.3034156371576009
2025-09-25T14:30:00-04:00,506.81,506.99,506.49,506.68,NaN,NaN,NaN,508.3941904512331,NaN,NaN,508.16999999999985,509.7425075521172,506.5974924478825,506.8858918230927,507.8747154274156,508.8108545500172,506.938576304814,16280,10899.133333333333,36.807064114755725,41.1772044100794,NaN,NaN,NaN,NaN,0.5029936674164875,32.37782421474606,12314548,-0.04920386428163803,-0.36492046750964846,-0.31571660322801043
2025-09-25T14:35:00-04:00,506.7,506.94,506.45,506.92,NaN,NaN,NaN,508.3408181579952,NaN,NaN,508.14459999999985,509.7555523150347,506.533647684965,506.8858918230927,507.8623307274009,508.8004458711956,506.92421558360616,13309,10902.4,41.19833397983388,40.71789081534131,NaN,NaN,NaN,NaN,0.5020655483153106,33.209626874618145,12327857,-0.03197171129103349,-0.3556812423418023,-0.32370953105076883
2025-09-25T14:40:00-04:00,506.92,507.67,506.91,507.26,NaN,NaN,NaN,508.3408181579952,NaN,NaN,508.1145999999998,509.73443683174787,506.4947631682518,506.7177134584742,507.8557888789777,508.79063658599955,506.92094117195586,13488,11069.066666666668,46.83473560438144,40.75100535446558,NaN,NaN,NaN,NaN,0.5204894377213592,31.6909964277449,12341345,0.0051542819996840405,-0.31726667855116375,-0.3224209605508478
2025-09-25T14:45:00-04:00,507.25,507.29,506.76,507.21,NaN,NaN,NaN,508.3408181579952,NaN,NaN,508.0771999999999,509.6924958370663,506.4619041629335,506.3501133756714,507.8457765900226,508.7786023362883,506.91295084375685,15836,11265.966666666667,46.13438929083323,40.87186951202617,NaN,NaN,NaN,NaN,0.5211687635984071,30.576227835091522,12325509,0.027902506526553517,-0.2875428273926559,-0.3154453339192094
2025-09-25T14:50:00-04:00,507.21,507.47,507.1,507.44,NaN,NaN,NaN,508.3408181579952,NaN,NaN,508.04039999999986,509.6280105823765,506.45278941762325,506.3501133756714,507.8417977835398,508.77205214066777,506.9115434264118,9582,11223.333333333334,49.849426699266935,41.197727182207935,NaN,NaN,NaN,NaN,0.5103709947699498,29.06661786831152,12335091,0.058251875029039224,-0.24263049013291038,-0.3008823651619496
2025-09-25T14:55:00-04:00,507.47,507.57,506.98,507.17,NaN,NaN,NaN,508.3408181579952,NaN,NaN,507.9859999999998,509.50112243780916,506.4708775621905,506.3501133756714,507.8360842534315,508.7637495876534,506.9084189192096,11752,11230.5,45.8515767523658,41.37989499094725,NaN,NaN,NaN,NaN,0.5160587808578088,27.92008972978035,12323339,0.05973292955477194,-0.22621620321848468,-0.2859491327732566
2025-09-25T15:00:00-04:00,507.11,507.67,507.11,507.57,NaN,NaN,NaN,508.3408181579952,NaN,NaN,507.94639999999987,509.3981162812481,506.4946837187516,506.359294438675,507.83191345164414,508.7554172923402,506.90840961094807,13518,11204.8,51.994037797405255,41.83065371222663,NaN,NaN,NaN,NaN,0.5191974393679655,26.57935533241612,12336857,0.08566393615513074,-0.17886921257934318,-0.2645331487344739
2025-09-25T15:05:00-04:00,507.59,507.66,507.37,507.5,NaN,NaN,NaN,508.3408181579952,NaN,NaN,507.9021999999999,509.2685032756931,506.53589672430667,506.46643555094005,507.8270799886233,508.7444601899666,506.90969978728003,19075,11402.966666666667,50.90574409016732,42.71186825787156,NaN,NaN,NaN,NaN,0.5028261936988265,25.334387677720766,12317782,0.09537080539376047,-0.14531964199227332,-0.2406904473860338
2025-09-25T15:10:00-04:00,507.52,507.75,507.35,507.39,NaN,NaN,NaN,508.3408181579952,NaN,NaN,507.8743999999998,509.22459945248914,506.5242005475105,506.595148440752,507.8233777834857,508.73626671611964,506.9104888508517,14396,11447.966666666667,49.164252655386086,43.96242059808618,NaN,NaN,NaN,NaN,0.49548146557748013,23.909606475403717,12303386,0.09162977361287755,-0.12615323036993686,-0.21778300398281442
2025-09-25T15:15:00-04:00,507.41,507.42,506.91,507.07,NaN,NaN,NaN,508.3408181579952,NaN,NaN,507.85099999999983,509.2155218948227,506.48647810517696,506.595148440752,507.81435568569725,508.72463831889155,506.90407305250295,17021,11754.766666666666,44.40510251087154,44.81901861712578,NaN,NaN,NaN,NaN,0.4965185037505166,23.624663264992485,12286365,0.06604541687918125,-0.13522623288383784,-0.2012716497630191
2025-09-25T15:20:00-04:00,507.09,507.33,506.63,506.65,NaN,NaN,NaN,508.3408181579952,NaN,NaN,507.80179999999984,509.15856933974595,506.44503066025374,506.595148440752,507.8050200723188,508.71559792587,506.89444221876767,12998,12022.633333333333,39.06064779611755,44.61423653591584,NaN,NaN,NaN,NaN,0.5110528963397646,23.90485353655962,12273367,0.021578964250264537,-0.17429794445018842,-0.19587690870045296
2025-09-25T15:25:00-04:00,506.66,506.88,506.42,506.53,NaN,NaN,NaN,508.25687495304686,NaN,NaN,507.7475999999998,509.0866283646697,506.4085716353299,506.595148440752,507.79074245575873,508.7051295960032,506.8763553155143,15899,12315.9,37.66577665103338,44.231297335716974,NaN,NaN,NaN,NaN,0.5074062608869229,24.534700083949623,12257468,-0.013295299033850128,-0.2124960324927656,-0.19920073345891548
2025-09-25T15:30:00-04:00,506.51,506.92,506.49,506.7,NaN,NaN,NaN,508.25687495304686,NaN,NaN,507.7123999999998,509.0671091797577,506.3576908202418,506.595148440752,507.7746001322694,508.69165237703606,506.8575478875028,20052,12674.7,40.88636117275472,44.247560607648346,NaN,NaN,NaN,NaN,0.5018772422521431,24.98265461438817,12277520,-0.021791772176931568,-0.22644044868007995,-0.20464867650314839
2025-09-25T15:35:00-04:00,506.72,507,506.31,506.38,NaN,NaN,NaN,508.25687495304686,NaN,NaN,507.68039999999974,509.0830529726974,506.2777470273021,506.595148440752,507.7548890669096,508.677269803273,506.83250833054615,22345,13123.066666666668,37.010090980240754,44.12625286395814,NaN,NaN,NaN,NaN,0.5153145820912756,25.721875397258103,12255175,-0.044530745734260024,-0.26031210867097343,-0.2157813629367134
2025-09-25T15:40:00-04:00,506.38,506.73,506.37,506.64,NaN,NaN,NaN,508.1398965946814,NaN,NaN,507.6403999999997,509.0453780645315,506.2354219354679,506.595148440752,507.7345480016347,508.6616624198615,506.80743358340794,24192,13372.533333333333,41.83516658284724,44.4854030402504,NaN,NaN,NaN,NaN,0.5042206833704711,26.40829469563733,12279367,-0.037888888468418674,-0.26314247352223674,-0.22525358505381807
2025-09-25T15:45:00-04:00,506.61,506.63,506.17,506.49,NaN,NaN,NaN,507.9817194767413,NaN,NaN,507.59379999999976,508.9937407993816,506.1938592006179,506.595148440752,507.70942315777376,508.6449081569688,506.7739381585787,27440,13827.266666666666,39.9345917046449,44.39513573487975,NaN,NaN,NaN,NaN,0.5017763488440068,27.404740789619293,12251927,-0.039258758501252905,-0.2743270331803842,-0.2350682746791313
2025-09-25T15:50:00-04:00,506.48,507.1,506.38,506.79,NaN,NaN,NaN,507.9817194767413,NaN,NaN,507.55559999999974,508.9368279181178,506.1743720818817,506.595148440752,507.6733498646701,508.6087993213521,506.73790040798815,56067,15272.533333333333,45.288116593608244,44.284662948395955,NaN,NaN,NaN,NaN,0.5173637524980083,26.68196312493424,12307994,-0.016770985771419833,-0.2560320068934061,-0.23926102112198627
2025-09-25T15:55:00-04:00,506.74,507.3,506.54,507.02,NaN,NaN,NaN,507.9817194767413,NaN,NaN,507.52019999999976,508.8632665813287,506.17713341867085,506.595148440752,507.6451636553971,508.57269257765137,506.7176347331428,60331,16965.233333333334,49.03828436640795,44.49208402522272,NaN,NaN,NaN,NaN,0.5346949130338642,25.423929602637656,12368325,0.015062437038656229,-0.22043297482366597,-0.2354954118623222