time,open,high,low,close,Long Stop,Long Stop Start,Buy Label,Short Stop,Short Stop Start,Sell Label,Basis,Upper,Lower,ATR Trailing Stoploss,VWAP,Upper Band #1,Lower Band #1,Volume,Volume MA,RSI,RSI-based MA,Regular Bullish,Regular Bullish Label,Regular Bearish,Regular Bearish Label,ATR,ADX,OnBalanceVolume,Histogram,MACD,Signal
2025-09-11T07:55:00-04:00,23947.75,23950.25,23945.75,23945.75,23931.475596037373,NaN,NaN,NaN,NaN,NaN,23933.275,23953.957903562852,23912.59209643715,23939.45178001194,23908.588676092102,23929.562286581586,23887.61506560262,1063,946.8,57.793482329981444,65.70709053314673,NaN,NaN,NaN,NaN,6.507072528012624,29.81748250133719,-176088,-0.29070676991762134,4.883020442353882,5.173727212271503
2025-09-11T08:00:00-04:00,23946,23952,23943.25,23946.25,23931.475596037373,NaN,NaN,NaN,NaN,NaN,23933.545,23954.54349757996,23912.546502420035,23939.45178001194,23908.891332449588,23930.057945734206,23887.72471916497,1231,972.6666666666666,58.39438527665042,64.57658050062027,NaN,NaN,NaN,NaN,6.6672816331545794,29.21897967539363,-174857,-0.47885954768398875,4.575152777666517,5.054012325350506
2025-09-11T08:05:00-04:00,23946.75,23951.25,23939.25,23944.75,23931.475596037373,NaN,NaN,NaN,NaN,NaN,23933.825,23955.039205147,23912.610794853,23939.45178001194,23909.28353338208,23930.66602916648,23887.90103759768,1719,995.2666666666667,55.826525244085964,63.555546232780905,NaN,NaN,NaN,NaN,7.048190087929252,27.573355710535864,-176576,-0.7134904162653415,4.162149305018829,4.875639721284171
2025-09-11T08:10:00-04:00,23944.25,23947.5,23939.5,23944.25,23931.475596037373,NaN,NaN,NaN,NaN,NaN,23934.045,23955.45800773041,23912.631992269587,23939.45178001194,23909.524107994293,23931.02419382481,23888.024022163776,1115,1008.5666666666667,54.958959909265644,62.38137686440156,NaN,NaN,NaN,NaN,7.11617651022002,26.045276314596506,-177691,-0.8995092610992153,3.7512531449101516,4.650762406009367
2025-09-11T08:15:00-04:00,23944.75,23950.25,23939.25,23943.5,23931.475596037373,NaN,NaN,NaN,NaN,NaN,23934.28,23955.844470781572,23912.715529218425,23939.45178001194,23909.980870611875,23931.703646037055,23888.258095186695,2124,1038.1,53.61307400477701,61.29935765184659,NaN,NaN,NaN,NaN,7.393592473775733,25.236571752025522,-179815,-1.0592118683873455,3.3267475705251854,4.385959438912531
2025-09-11T08:20:00-04:00,23943,23957.75,23940.5,23942.25,23931.475596037373,NaN,NaN,NaN,NaN,NaN,23934.34,23955.97602551219,23912.70397448781,23939.45178001194,23910.679963373066,23932.775256253626,23888.584670492506,3130,1113.7,51.35575822170837,60.24391620481949,NaN,NaN,NaN,NaN,8.097621582791751,25.77094760044461,-182945,-1.223542767048805,2.8565309801015246,4.08007374715033
2025-09-11T08:25:00-04:00,23942.75,23967,23931.5,23956.75,23931.475596037373,NaN,NaN,NaN,NaN,NaN,23934.815,23957.33716908472,23912.292830915278,23939.45178001194,23911.857185467758,23934.686354550806,23889.02801638471,4869,1250.5333333333333,68.12249646483025,60.71208439394473,NaN,NaN,NaN,NaN,10.054934326878055,27.319222991806296,-178076,-0.37424318523217703,3.612269765610108,3.986512950842285
2025-09-11T08:30:00-04:00,23958.5,23976.25,23845,23882.75,NaN,NaN,NaN,23954.195096344487,23954.195096344487,23954.195096344487,23933.875,23960.68027000495,23907.06972999505,23939.45178001194,23910.375953719016,23931.851763052186,23888.900144385847,27825,2138.233333333333,23.536182505953406,58.235829387752815,NaN,NaN,NaN,NaN,18.711724732101054,29.22421671210037,-205901,-4.58115161496295,-1.7399265678614029,2.841225047101547
2025-09-11T08:35:00-04:00,23882.75,23914.25,23881.25,23898.5,NaN,NaN,NaN,23943.83963741974,NaN,NaN,23933.35,23961.825779187973,23904.874220812024,23935.886424009554,23909.731437083636,23930.82059340254,23888.642280764732,10861,2456.5666666666666,33.51078789151212,56.24052588934626,NaN,NaN,NaN,NaN,19.732315822665264,30.993139452373438,-195040,-5.998583480989739,-4.657004304135626,1.3415791768541125
2025-09-11T08:40:00-04:00,23898.25,23925,23897.5,23924.75,NaN,NaN,NaN,23943.83963741974,NaN,NaN,23933.405,23961.803396085055,23905.006603914942,23934.072311366115,23909.991300893573,23930.656389546177,23889.32621224097,9411,2744.9666666666667,46.125007845259965,55.035850540752385,NaN,NaN,NaN,NaN,20.2871504067606,31.643460830140164,-185629,-4.9095639021901665,-4.795375700883596,0.11418820130657048
2025-09-11T08:45:00-04:00,23924.5,23947.5,23915,23931.75,23881.24373945846,23881.24373945846,23881.24373945846,NaN,NaN,NaN,23933.61,23961.80896452166,23905.41103547834,23934.072311366115,23911.29430641554,23931.965402253987,23890.623210577094,14114,3188.5333333333333,48.908629346356996,53.83940985540571,NaN,NaN,NaN,NaN,21.159496806277698,30.556372059702834,-171515,-3.523937460901944,-4.290733624820859,-0.7667961639189155
2025-09-11T08:50:00-04:00,23932.25,23959,23928.25,23949.5,23891.698569483076,NaN,NaN,NaN,NaN,NaN,23934.1,23962.533958575055,23905.66604142494,23931.74981873556,23912.79392416694,23934.18967681234,23891.39817152154,10614,3524.4666666666667,55.22596812467962,52.89939462832153,NaN,NaN,NaN,NaN,21.844532748686436,28.839277915189516,-160901,-1.3309687597976305,-2.4305071136659535,-1.099538353868323
2025-09-11T08:55:00-04:00,23949.25,23961.25,23939.5,23959.25,23897.842952688392,NaN,NaN,NaN,NaN,NaN,23934.825,23963.93054071258,23905.719459287422,23931.74981873556,23913.96385897728,23936.113956886154,23891.813761068406,7212,3737.5,58.277696219972285,51.84751074872981,NaN,NaN,NaN,NaN,21.83778040949455,27.110819816118177,-153689,0.7455596224142234,-0.1675888258505438,-0.9131484482647672
2025-09-11T09:00:00-04:00,23959.25,23965,23952.25,23954,23906.7421366571,NaN,NaN,NaN,NaN,NaN,23935.415,23964.8535138821,23905.976486117903,23931.74981873556,23915.117690394403,23938.050624370968,23892.18475641784,6871,3933.4666666666667,56.0619147330562,51.55077629414927,NaN,NaN,NaN,NaN,21.188653237387797,25.276764362415776,-160560,1.6812861810123452,1.1884592780006642,-0.49282690301168086
2025-09-11T09:05:00-04:00,23953.5,23955.5,23941,23950,23906.7421366571,NaN,NaN,NaN,NaN,NaN,23935.97,23965.441111271775,23906.498888728227,23931.74981873556,23915.91859426207,23939.151931541193,23892.68525698295,6248,4123.866666666667,54.36587391891464,51.30594712193022,NaN,NaN,NaN,NaN,20.710892291860098,24.2079863915848,-166808,1.9288680136365133,1.9182581140339607,-0.010609899602552486
2025-09-11T09:10:00-04:00,23950.75,23954.75,23940,23949.5,23906.7421366571,NaN,NaN,NaN,NaN,NaN,23936.49,23965.980161063195,23906.99983893681,23928.44985498845,23916.409912692525,23939.800175647688,23893.01964973736,4080,4204.933333333333,54.145365912977,51.00244573881069,NaN,NaN,NaN,NaN,20.28511427101295,23.270324121629173,-170888,1.9511209578097204,2.428291297659598,0.47717033984987767
2025-09-11T09:15:00-04:00,23949.25,23953.5,23939,23951.25,23906.7421366571,NaN,NaN,NaN,NaN,NaN,23936.995,23966.613826790344,23907.376173209654,23900.094526657984,23916.877415398798,23940.403938825748,23893.350891971848,4023,4311.666666666667,54.83583572320715,50.93168220160506,NaN,NaN,NaN,NaN,19.871891823083452,22.45758759705872,-166865,1.970118328199339,2.9398182500990515,0.9696999218997124
2025-09-11T09:20:00-04:00,23951.75,23961.25,23950.5,23953.25,23906.7421366571,NaN,NaN,NaN,NaN,NaN,23937.555,23967.322816513966,23907.787183486034,23913.150621326386,23917.388748085043,23941.164895547972,23893.612600622113,3686,4402.3,55.65761863333639,50.98158639618155,NaN,NaN,NaN,NaN,19.220328121434637,21.137356183598683,-163179,1.997543412235818,3.466629187194485,1.469085774958667
2025-09-11T09:25:00-04:00,23953.5,23978.25,23952.5,23977,23914.156207299708,NaN,NaN,NaN,NaN,NaN,23938.53,23970.15066413347,23906.909335866527,23926.89549706111,23919.059859452525,23944.17883282944,23893.940886075612,9150,4676.133333333333,64.0280120058944,51.7255105391185,NaN,NaN,NaN,NaN,19.686733255617874,20.407311360501364,-154029,3.412294538226437,5.734453947741713,2.322159409515276
2025-09-11T09:30:00-04:00,23977,23997.75,23967.5,23985,23929.609334240628,NaN,NaN,NaN,NaN,NaN,23939.71,23973.687839842587,23905.73216015741,23941.54139764889,23926.310520600593,23957.51843109704,23895.102610104146,36054,5838.533333333334,66.33336593863544,52.79533966175615,NaN,NaN,NaN,NaN,20.441252308788023,20.68592904515925,-117975,4.6095256439355605,8.084066464434727,3.4745408204991666
2025-09-11T09:35:00-04:00,23985.25,23987.25,23926.75,23934.75,NaN,NaN,NaN,24015.85586277031,24015.85586277031,24015.85586277031,23939.895,23973.66141674605,23906.12858325395,23941.54139764889,23928.617151152423,23959.043550037222,23898.190752267623,35207,6989.066666666667,46.27323396307649,51.23467805448802,NaN,NaN,NaN,NaN,23.30259142958888,19.716578955941085,-153182,1.879773623373187,5.82425784971565,3.944484226342463
2025-09-11T09:40:00-04:00,23935,23946,23911.5,23924.75,NaN,NaN,NaN,23989.635141735296,NaN,NaN,23939.94,23973.61945367975,23906.26054632025,23941.54139764889,23928.526801984735,23957.787567090712,23899.26603687876,28910,7935.533333333334,43.45674799670173,52.65757558954148,NaN,NaN,NaN,NaN,24.10240632747539,19.42989080867378,-182092,-0.6038606464794123,3.189658418243198,3.7935190647226102
2025-09-11T09:45:00-04:00,23925,23965.5,23909.75,23950,NaN,NaN,NaN,23989.635141735296,NaN,NaN,23940.6,23973.744531983713,23907.455468016284,23941.54139764889,23929.557243708532,23957.877482999924,23901.23700441714,32464,8990.3,51.48625063176163,53.94153721384502,NaN,NaN,NaN,NaN,26.36294873265572,18.230293821579902,-149628,-0.5520878957092981,3.1034091950859874,3.6554970907952855
2025-09-11T09:50:00-04:00,23950,23978.25,23940,23971,NaN,NaN,NaN,23989.635141735296,NaN,NaN,23941.74,23975.06701005962,23908.41298994038,23941.54139764889,23931.578886673327,23960.16845567624,23902.989317670414,26733,9854.6,56.96042282252702,54.71549542650695,NaN,NaN,NaN,NaN,27.212023823180314,17.279937976514667,-122895,0.8161480922115465,4.675682206059719,3.8595341138481722
2025-09-11T09:55:00-04:00,23970.75,23988,23960,23979.25,NaN,NaN,NaN,23989.635141735296,NaN,NaN,23943.06,23976.991483899932,23909.12851610007,23941.54139764889,23933.64188773656,23963.070747304977,23904.213028168146,21720,10554.7,58.92146915195866,55.43069826976421,NaN,NaN,NaN,NaN,27.268307835810294,16.785891833365554,-101175,2.1222571613920405,6.512355565588223,4.390098404196182
2025-09-11T10:00:00-04:00,23978.75,23983.25,23961.5,23980.5,NaN,NaN,NaN,23989.635141735296,NaN,NaN,23944.285,23979.100658836942,23909.469341163058,23941.54139764889,23935.175971059747,23965.096184735878,23905.255757383617,17877,11120.9,59.22461988581607,55.716316252702526,NaN,NaN,NaN,NaN,26.874142990395274,16.327134700441377,-83298,2.8693971857671823,7.976844886405161,5.107447700637978
2025-09-11T10:05:00-04:00,23980,24003.25,23977.25,23986,23921.29686248528,23921.29686248528,23921.29686248528,NaN,NaN,NaN,23945.6,23981.630681377334,23909.569318622664,23941.54139764889,23937.572744273395,23968.84719774333,23906.29829080346,22580,11836.466666666667,60.602310911633666,55.88236015924978,NaN,NaN,NaN,NaN,26.811704205367043,16.66801215383932,-60718,3.491705061843639,9.472079027942527,5.980373966098888
2025-09-11T10:10:00-04:00,23986.5,23991.5,23954.75,23959,23921.29686248528,NaN,NaN,NaN,NaN,NaN,23946.235,23982.06828201305,23910.40171798695,23941.54139764889,23939.045525386136,23970.26483589913,23907.826214873145,25348,12639.366666666667,51.41785337315276,55.55064149068524,NaN,NaN,NaN,NaN,27.521582476412252,15.888402385214178,-86066,1.9211157823777452,8.38176869407107,6.460652911693325
2025-09-11T10:15:00-04:00,23959.25,23979.75,23948.25,23952.75,23921.29686248528,NaN,NaN,NaN,NaN,NaN,23946.655,23982.291061794785,23911.018938205212,23941.54139764889,23939.901545471745,23970.767672720656,23909.035418222833,22332,13331.9,49.545991552465374,55.206364178796,NaN,NaN,NaN,NaN,27.805755156668518,14.877968429894656,-108398,0.37823184734757387,6.9334427208777925,6.555210873530219
2025-09-11T10:20:00-04:00,23952.5,23969.5,23946.75,23968.75,23921.29686248528,NaN,NaN,NaN,NaN,NaN,23947.33,23983.334088653075,23911.32591134693,23926.010265716217,23940.47393980571,23971.12998604148,23909.81789356994,14941,13783.733333333334,54.14795537231205,55.20654914017708,NaN,NaN,NaN,NaN,27.444629788335053,13.871844911550571,-93457,0.35267456389109064,6.996054078394081,6.643379514502991
2025-09-11T10:25:00-04:00,23968.5,23971.5,23951,23965.75,23921.29686248528,NaN,NaN,NaN,NaN,NaN,23947.945,23984.13564658655,23911.75435341345,23926.010265716217,23940.969489013907,23971.46014359455,23910.478834433263,12926,14179.166666666666,53.16871426109837,55.087469035740746,NaN,NaN,NaN,NaN,26.948584803453976,13.031347555764878,-106383,0.0661485559620516,6.726065209455555,6.659916653493504
2025-09-11T10:30:00-04:00,23965,23999.25,23961.5,23997.75,23921.29686248528,NaN,NaN,NaN,NaN,NaN,23949.195,23987.78337778485,23910.60662221515,23926.010265716217,23942.32842596379,23973.33327829811,23911.323573629474,18012,14738.533333333333,61.224046672091966,55.485071038509,NaN,NaN,NaN,NaN,27.72011446035012,13.405140177880295,-88371,1.8645400418178664,8.990591705765837,7.126051663947971
2025-09-11T10:35:00-04:00,23998,24012.75,23996.25,24012.25,23932.39397907175,NaN,NaN,NaN,NaN,NaN,23950.685,23992.967125065017,23908.402874934985,23944.29574709591,23944.27516313625,23976.75087907443,23911.799447198075,18568,15300.166666666666,64.22672489984558,55.49926481664837,NaN,NaN,NaN,NaN,26.918677713182255,14.216946098208675,-69803,3.754383987098622,11.819031647821248,8.064647660722626
2025-09-11T10:40:00-04:00,24012.25,24018,24006,24014.25,23941.535161841213,NaN,NaN,NaN,NaN,NaN,23952.205,23997.915030621873,23906.49496937813,23957.23659767673,23945.72965267224,23979.341406419797,23912.11789892468,13404,15709.8,64.63352843759844,55.37784785228859,NaN,NaN,NaN,NaN,25.85305787652638,15.144118704648344,-56399,4.796202021527973,14.059900187632593,9.26369816610462
2025-09-11T10:45:00-04:00,24014.25,24022,23996.5,24006.25,23941.535161841213,NaN,NaN,NaN,NaN,NaN,23953.505,24001.533271882476,23905.476728117526,23960.639278141385,23947.324814161075,23981.93855052846,23912.71107779369,16522,16189.733333333334,61.61525260201123,56.47370632649821,NaN,NaN,NaN,NaN,25.82783945677449,15.467673348313529,-72921,4.602771868385581,15.017163001586596,10.414391133201015
2025-09-11T10:50:00-04:00,24006.5,24009.75,23975.5,23991.25,23941.535161841213,NaN,NaN,NaN,NaN,NaN,23954.505,24003.542484642414,23905.467515357588,23960.639278141385,23948.730345807286,23983.681855865554,23913.778835749017,20954,16783.866666666665,56.30590722707489,57.39150341438201,NaN,NaN,NaN,NaN,26.429422352719172,14.713048709947781,-93875,3.1880377154056703,14.399438277458103,11.211400562052432
2025-09-11T10:55:00-04:00,23991.5,24005.25,23975.25,24004,23941.535161841213,NaN,NaN,NaN,NaN,NaN,23955.705,24006.558386315726,23904.851613684277,23960.639278141385,23949.780787652875,23985.010025300435,23914.551550005315,15587,17141.133333333335,59.500435296091574,57.963945176119864,NaN,NaN,NaN,NaN,26.684463613239227,14.000487581917747,-78288,2.84565056607023,14.76846376964022,11.92281320356999
2025-09-11T11:00:00-04:00,24003.5,24012.25,24001.25,24006.25,23941.535161841213,NaN,NaN,NaN,NaN,NaN,23956.88,24009.60136568682,23904.158634313182,23960.639278141385,23950.625673874983,23986.261566158708,23914.98978159126,10329,16557.933333333334,60.055442491109766,58.18501800959006,NaN,NaN,NaN,NaN,25.56414478372214,13.648247642506142,-67959,2.5167669605969962,15.068771904316236,12.55200494371924
2025-09-11T11:05:00-04:00,24006.25,24017.75,24000.25,24006.5,23941.535161841213,NaN,NaN,NaN,NaN,NaN,23958.1,24012.50772004308,23903.69227995692,23961.09864832671,23951.524054742902,23987.59310509555,23915.455004390253,11014,16563.033333333333,60.12083627599021,58.27068708987803,NaN,NaN,NaN,NaN,24.9881344420277,13.561822276535512,-56945,2.0802161882361254,15.152275179014396,13.07205899077827
2025-09-11T11:10:00-04:00,24006.75,24019,24005.5,24016.75,23943.27029171967,NaN,NaN,NaN,NaN,NaN,23959.495,24016.220169896173,23902.769830103825,23966.928918661368,23952.23344890117,23988.699657367804,23915.767240434536,8135,16520.5,62.809170522315945,58.526726421056594,NaN,NaN,NaN,NaN,24.167553410454293,13.537779465253951,-48810,2.2325018390791147,15.862686289627163,13.630184450548049
2025-09-11T11:15:00-04:00,24016.5,24048.75,24013.5,24039.75,23960.47391482332,NaN,NaN,NaN,NaN,NaN,23961.375,24022.2335450024,23900.5164549976,23989.468134929095,23954.954167169057,23993.691723403612,23916.2166109345,24561,16868.733333333334,68.01894230211465,59.05648580609091,NaN,NaN,NaN,NaN,24.959156738278985,14.675890487148111,-24249,3.554462577270744,18.07326267213648,14.518800094865735
2025-09-11T11:20:00-04:00,24040,24044,24025.5,24029.25,23964.78760051317,NaN,NaN,NaN,NaN,NaN,23963.07,24026.615656026042,23899.524343973957,23989.468134929095,23956.43552884675,23996.252380741313,23916.618676952185,14297,16991.5,63.63632006298155,59.92923342679297,NaN,NaN,NaN,NaN,24.497788399830487,15.73270786462126,-38546,3.394260556404939,18.76162579037191,15.36736523396697
2025-09-11T11:25:00-04:00,24029,24039.5,24024.5,24038,23964.78760051317,NaN,NaN,NaN,NaN,NaN,23964.985,24031.602295802062,23898.36770419794,23989.468134929095,23957.354437063856,23997.81466291584,23916.89421121187,9021,17051.8,65.62407133743045,61.07766769714762,NaN,NaN,NaN,NaN,23.81937494269974,16.647030439046897,-29525,3.534219509177394,19.785139620438713,16.25092011126132
2025-09-11T11:30:00-04:00,24037.75,24045.75,24035,24037.25,23973.20987980642,NaN,NaN,NaN,NaN,NaN,23966.92,24036.149360823732,23897.690639176264,23998.102685083697,23958.351584476357,23999.556786361038,23917.146382591676,9376,17135.3,65.29460623888887,61.87385704476025,NaN,NaN,NaN,NaN,22.885848161078325,17.733422578369353,-38901,3.240653658135365,20.301737183930527,17.061083525795162
2025-09-11T11:35:00-04:00,24037.5,24039,24022.75,24024.25,23973.20987980642,NaN,NaN,NaN,NaN,NaN,23968.545,24039.25077699187,23897.839223008126,23998.102685083697,23959.224884703966,24000.90731473735,23917.542454670584,9694,17250.166666666668,59.69979007898568,62.340362460323625,NaN,NaN,NaN,NaN,22.411859006715588,17.90040119241321,-48595,1.901599578872748,19.438082999386097,17.53648342051335
2025-09-11T11:40:00-04:00,24024.5,24028.5,24018.5,24019,23973.20987980642,NaN,NaN,NaN,NaN,NaN,23970.04,24041.78122664016,23898.298773359842,23998.102685083697,23959.867600451093,24001.814829451287,23917.9203714509,8074,17383.3,57.554964700400895,62.07828517663141,NaN,NaN,NaN,NaN,21.525297649093044,17.778296713135205,-56669,0.4677019246450307,18.121110826319637,17.653408901674606
2025-09-11T11:45:00-04:00,24019.25,24024,24003,24011.75,23973.20987980642,NaN,NaN,NaN,NaN,NaN,23971.345,24043.697186560526,23898.992813439476,23998.102685083697,23960.715553047477,24002.854710396,23918.576395698954,12810,17676.2,54.63579215093292,61.393218551709076,NaN,NaN,NaN,NaN,21.48777638844354,16.730173287051677,-69479,-1.0791758754374854,16.30443905737775,17.383614932815235
2025-09-11T11:50:00-04:00,24011.5,24029.5,24010.5,24026.75,23973.20987980642,NaN,NaN,NaN,NaN,NaN,23972.9,24046.593961758845,23899.20603824116,23998.102685083697,23961.512915285188,24003.952618870157,23919.07321170022,10521,17904.033333333333,59.241849862862836,61.008098653513684,NaN,NaN,NaN,NaN,21.310078074983288,16.042502074588423,-58958,-1.1933748717207777,15.891896343164262,17.08527121488504
2025-09-11T11:55:00-04:00,24026.5,24030,24021.75,24024.25,23973.20987980642,NaN,NaN,NaN,NaN,NaN,23974.305,24049.173370491848,23899.436629508153,23998.102685083697,23961.88713852915,24004.481859091266,23919.292417967034,4789,17758.666666666668,58.18153547367464,60.76283314434678,NaN,NaN,NaN,NaN,20.377215355341626,15.430648179129914,-63747,-1.5177012233737983,15.188144685667794,16.705845909041592
2025-09-11T12:00:00-04:00,24024,24043.5,24021.25,24041.25,23973.20987980642,NaN,NaN,NaN,NaN,NaN,23976.185,24052.938554311582,23899.43144568842,24000.41814227858,23962.78624801403,24005.88297262142,23919.689523406636,10122,16894.266666666666,63.02748250871208,61.24294566446372,NaN,NaN,NaN,NaN,20.510985687102938,15.554688880037142,-53625,-0.7088260147206533,15.819813390640775,16.528639405361428
2025-09-11T12:05:00-04:00,24041.5,24042.75,24033,24037,23976.738947872145,NaN,NaN,NaN,NaN,NaN,23978.01,24056.10967733834,23899.910322661657,24003.409513822866,23963.30155777009,24006.692914683026,23919.910200857154,5736,15911.9,61.12060448604351,61.35867203517457,NaN,NaN,NaN,NaN,19.74234385230987,15.669869530879568,-59361,-0.586594395126653,15.795396411453112,16.381990806579765
2025-09-11T12:10:00-04:00,24037,24040.5,24032.25,24034,23976.892859332504,NaN,NaN,NaN,NaN,NaN,23979.765,24058.868312827253,23900.661687172746,24004.902611058293,23963.652667067472,24007.229261894274,23920.07607224067,4064,15083.7,59.74649173442148,61.33660412398255,NaN,NaN,NaN,NaN,18.92146214857345,15.720723878113036,-63425,-0.8200362110815931,15.356945542727772,16.176981753809365
2025-09-11T12:15:00-04:00,24033.75,24038.75,24025,24037.75,23976.892859332504,NaN,NaN,NaN,NaN,NaN,23981.625,24061.71490260903,23901.53509739097,24004.902611058293,23964.243394232457,24008.107327382164,23920.37946108275,7102,14238.3,60.92894652925025,61.3943262849297,NaN,NaN,NaN,NaN,18.552071995103915,15.22569338204006,-56323,-0.8315315809898216,15.137567277572089,15.96909885856191
2025-09-11T12:20:00-04:00,24037,24041.75,24030,24032,23978.285384226518,NaN,NaN,NaN,NaN,NaN,23983.38,24063.961216172538,23902.798783827464,24007.592671077306,23964.756741686942,24008.868509691216,23920.64497368267,6203,13553.966666666667,58.11020980683194,61.058686233823686,NaN,NaN,NaN,NaN,18.06620970973935,14.95004909134227,-62526,-1.3076851896427026,14.334492371508532,15.642177561151234
2025-09-11T12:25:00-04:00,24032.5,24037.5,24022.75,24024.5,23978.285384226518,NaN,NaN,NaN,NaN,NaN,23985,24065.565935728977,23904.434064271023,24007.592671077306,23965.135230699358,24009.386071914276,23920.88438948444,5097,12999.866666666667,54.56437781700488,60.09764591345871,NaN,NaN,NaN,NaN,17.82933758761511,14.149353730819895,-67623,-2.158817254058242,12.943655993578432,15.102473247636674
2025-09-11T12:30:00-04:00,24024.75,24033.25,24022.5,24025.25,23978.285384226518,NaN,NaN,NaN,NaN,NaN,23986.66,24067.0543256709,23906.2656743291,24007.592671077306,23965.563253434175,24009.957910133664,23921.168596734686,5957,12602.533333333333,54.860999118263926,59.470837274550306,NaN,NaN,NaN,NaN,17.323670617071176,13.38705490597993,-61666,-2.6689446930602507,11.76629238131136,14.43523707437161
2025-09-11T12:35:00-04:00,24025,24026.5,24016.25,24017,23978.285384226518,NaN,NaN,NaN,NaN,NaN,23987.865,24068.23608994995,23907.493910050052,24007.592671077306,23965.933734739396,24010.402278100544,23921.465191378247,5909,12046.833333333334,50.92281826858628,58.42074776963286,NaN,NaN,NaN,NaN,16.81840843013752,12.65496202529493,-67575,-3.506871225442442,10.051648042568559,13.558519268011
2025-09-11T12:40:00-04:00,24016.5,24019,24006.25,24014.75,23978.285384226518,NaN,NaN,NaN,NaN,NaN,23990.505,24065.37505342565,23915.63494657435,24007.592671077306,23966.385659262356,24010.88076499111,23921.8905535336,8345,11480.066666666668,49.87134964463518,57.319086584329035,NaN,NaN,NaN,NaN,16.52780782798484,12.661644533375568,-75920,-4.115431533799736,8.41422985076133,12.529661384561066
2025-09-11T12:45:00-04:00,24014.5,24017.75,24007.25,24016.5,23978.285384226518,NaN,NaN,NaN,NaN,NaN,23992.865,24063.293063296158,23922.436936703845,24007.592671077306,23966.694904623317,24011.208813899026,23922.180995347608,5742,10927.066666666668,50.72359205531423,56.677929582638214,NaN,NaN,NaN,NaN,16.097250125985923,12.667849719450446,-70178,-4.283677243334262,7.175064830393239,11.458742073727501
2025-09-11T12:50:00-04:00,24016.25,24016.25,23994.75,24008.25,23978.285384226518,NaN,NaN,NaN,NaN,NaN,23994.535,24062.3341157754,23926.7358842246,24007.592671077306,23967.147680185437,24011.607570109365,23922.68779026151,10158,10767.633333333333,46.69333619039397,55.90209897478058,NaN,NaN,NaN,NaN,16.501017974129784,13.457333278224807,-80336,-4.795535845776222,5.464322266507224,10.259858112283446
2025-09-11T12:55:00-04:00,24008,24017.25,24002.25,24008.5,23978.285384226518,NaN,NaN,NaN,NaN,NaN,23996.07,24061.549312763866,23930.590687236134,24007.592671077306,23967.528083583074,24011.966357754656,23923.089809411493,8109,10607.066666666668,46.83119998239342,55.34462810559919,NaN,NaN,NaN,NaN,16.393802404549085,14.09570860125426,-72227,-4.942551740174219,4.081668437065673,9.024220177239892
2025-09-11T13:00:00-04:00,24008.75,24011.25,23998.25,24001.5,23978.285384226518,NaN,NaN,NaN,NaN,NaN,23997.11,24061.235436450446,23932.984563549555,24007.592671077306,23967.775892423928,24012.161847099906,23923.38993774795,6209,10213.633333333333,43.44327352791442,54.21615836738859,NaN,NaN,NaN,NaN,16.151387947081293,14.933120561699306,-78436,-5.304597464720469,2.393473346339306,7.698070811059774
2025-09-11T13:05:00-04:00,24001.25,24013.75,23997.25,24012.75,23978.285384226518,NaN,NaN,NaN,NaN,NaN,23998.18,24061.523432176768,23934.836567823233,24007.592671077306,23968.087191473864,24012.44069486979,23923.733688077937,7077,9830.6,49.73672176043021,53.61295738787113,NaN,NaN,NaN,NaN,16.176288808004056,15.451462816853809,-71359,-4.605678070548489,1.9409732228741632,6.546651293422652
2025-09-11T13:10:00-04:00,24012.5,24026.25,24011,24024.75,23978.285384226518,NaN,NaN,NaN,NaN,NaN,23999.595,24062.08266997975,23937.10733002025,24002.799136861846,23968.61955377659,24013.060786099926,23924.17832145325,9334,9694.933333333332,55.43346535669866,53.07052759129874,NaN,NaN,NaN,NaN,16.11012532171805,14.759338340600289,-62025,-3.2200442840003207,2.5215959384222515,5.741640222422572
2025-09-11T13:15:00-04:00,24024.5,24027.5,24012,24016.75,23978.285384226518,NaN,NaN,NaN,NaN,NaN,24000.93,24061.95745611584,23939.90254388416,24000.114309489476,23969.035974162558,24013.525513025008,23924.546435300108,7722,9401.6,51.26221146814223,52.36635666144865,NaN,NaN,NaN,NaN,16.066544941595332,14.008832028558693,-69747,-2.745642577009855,2.309587001160253,5.055229578170108
2025-09-11T13:20:00-04:00,24016,24027,24013.75,24025,23978.285384226518,NaN,NaN,NaN,NaN,NaN,24002.44,24062.021671680497,23942.8583283195,23994.86644759158,23969.354421169348,24013.898084221622,23924.810758117073,5632,8890.866666666667,55.021041081056936,52.02882447192261,NaN,NaN,NaN,NaN,15.865363160052809,13.311933310234354,-64115,-1.823957493522319,2.7752827112672094,4.599240204789528
2025-09-11T13:25:00-04:00,24024.75,24030.25,24012.25,24014,23978.285384226518,NaN,NaN,NaN,NaN,NaN,24003.695,24061.52866579827,23945.86133420173,23992.19707851774,23969.76710175431,24014.35227673613,23925.181926772493,7866,8633.5,49.53541676386467,51.21500091725221,NaN,NaN,NaN,NaN,16.01783722004904,12.364602097350174,-71981,-1.8945729704638925,2.2310239917096624,4.125596962173555
2025-09-11T13:30:00-04:00,24014,24030,24013.5,24026.5,23978.285384226518,NaN,NaN,NaN,NaN,NaN,24005.16,24061.49984025454,23948.82015974546,23992.19707851774,23970.114369032406,24014.762235464234,23925.46650260058,6154,8494.333333333334,55.0230972200623,50.99449287534009,NaN,NaN,NaN,NaN,16.052277418616963,11.484937399672006,-65827,-1.0794082198955337,2.7763366873041377,3.8557449071996714
2025-09-11T13:35:00-04:00,24026.75,24030.5,24020.25,24024,23978.285384226518,NaN,NaN,NaN,NaN,NaN,24006.1,24062.09642846094,23950.103571539057,23994.421130251354,23970.366873135892,24015.066103490997,23925.667642780787,4394,8273.666666666666,53.76386087133011,50.937313093506184,NaN,NaN,NaN,NaN,15.637829031572894,10.720281492779135,-70221,-0.7065906339442392,2.9725066147693724,3.6790972487136115
2025-09-11T13:40:00-04:00,24024.25,24034.5,24021,24029.5,23978.285384226518,NaN,NaN,NaN,NaN,NaN,24006.99,24063.031231248246,23950.948768751758,23998.88690420108,23970.79309134046,24015.602183715277,23925.983998965643,7064,8237.966666666667,56.141902076618194,51.02880616196006,NaN,NaN,NaN,NaN,15.485126957889117,10.430040029082956,-63157,-0.11841962147104379,3.531072721874807,3.649492343345851
2025-09-11T13:45:00-04:00,24029.75,24032,24006.25,24009.75,23978.285384226518,NaN,NaN,NaN,NaN,NaN,24008.49,24060.593163048943,23956.38683695106,23998.88690420108,23971.182017032417,24015.99285920987,23926.371174854965,8337,7697.166666666667,46.82798480245451,50.73631805723637,NaN,NaN,NaN,NaN,16.218332175182752,10.660311936256603,-71494,-1.0372282588477866,2.3529570197861176,3.390185278633904
2025-09-11T13:50:00-04:00,24010,24024.75,24003.5,24024.25,23978.285384226518,NaN,NaN,NaN,NaN,NaN,24010.48,24056.93189339461,23964.02810660539,23998.88690420108,23971.555808386336,24016.377457598297,23926.734159174375,7884,7483.4,52.99374326613009,50.95934617305743,NaN,NaN,NaN,NaN,16.577737019812556,11.101269540304557,-63610,-0.6642980399054039,2.5598127287521493,3.224110768657553
2025-09-11T13:55:00-04:00,24023.75,24033,24018,24032.5,23978.285384226518,NaN,NaN,NaN,NaN,NaN,24012.13,24055.639222006783,23968.62077799322,23998.88690420108,23971.899960730414,24016.79922998602,23927.00069147481,6011,7383.066666666667,56.11205321887753,51.3442362561691,NaN,NaN,NaN,NaN,16.465041518397374,10.623389216887121,-57599,0.1013731214648601,3.3508271704886283,3.249454049023768
2025-09-11T14:00:00-04:00,24032.75,24035.75,24023.25,24026.25,23978.718665137723,NaN,NaN,NaN,NaN,NaN,24013.235,24055.29191500878,23971.17808499122,23998.88690420108,23972.269818011962,24017.253347596084,23927.28628842784,6475,7286.366666666667,53.23107734904904,51.8112177675016,NaN,NaN,NaN,NaN,16.181824267083275,9.905445623177965,-64074,0.14748177419719477,3.4338062667702616,3.286324492573067
2025-09-11T14:05:00-04:00,24026.5,24032.75,24024.25,24029.25,23978.86781672237,NaN,NaN,NaN,NaN,NaN,24014.235,24055.3799158456,23973.090084154403,23998.88690420108,23972.52287372247,24017.563747285214,23927.48200015973,4453,7111.666666666667,54.440256503001876,52.35472180468792,NaN,NaN,NaN,NaN,15.633122533720185,9.238783714733747,-59621,0.33014274451332337,3.699002923214721,3.3688601787013974
2025-09-11T14:10:00-04:00,24029.25,24034.75,24021,24026.75,23978.86781672237,NaN,NaN,NaN,NaN,NaN,24015.16,24055.296860862163,23975.023139137837,23998.88690420108,23972.8156418114,24017.914276537653,23927.71700708515,5321,7019.9,53.20574469269294,53.05204117360067,NaN,NaN,NaN,NaN,15.498613781311601,8.960457625536126,-64942,0.23706705903916747,3.665194002500357,3.4281269434611894
2025-09-11T14:15:00-04:00,24026.75,24030,24021.25,24022.5,23978.86781672237,NaN,NaN,NaN,NaN,NaN,24015.89,24055.19803480398,23976.58196519602,23998.88690420108,23973.056362768206,24018.187647430008,23927.925078106404,4668,6748.5,51.08493576607819,53.14834217400409,NaN,NaN,NaN,NaN,15.016569939789344,8.70201197128119,-69610,-0.1361770746063673,3.2579056002032303,3.3940826748095976
2025-09-11T14:20:00-04:00,24022.5,24025.75,24015,24021,23978.86781672237,NaN,NaN,NaN,NaN,NaN,24017.13,24052.93701606931,23981.32298393069,23998.88690420108,23973.29997053299,24018.44320156545,23928.15673950053,5172,6570.2,50.32251906355025,52.783274581636356,NaN,NaN,NaN,NaN,14.711814944090106,9.115550063476196,-74782,-0.4896503389625435,2.782019751106418,3.2716700900689615
2025-09-11T14:25:00-04:00,24021,24028.75,24014,24021.5,23978.86781672237,NaN,NaN,NaN,NaN,NaN,24018.505,24049.23812381589,23987.771876184113,23998.88690420108,23973.58919968346,24018.74996289421,23928.428436472714,6102,6613.966666666666,50.587248367627595,52.735062931599586,NaN,NaN,NaN,NaN,14.714542448083671,9.110388426986384,-68680,-0.6834506130644704,2.4173568237383734,3.1008074368028438
2025-09-11T14:30:00-04:00,24021.25,24025.5,24017.25,24020,23978.86781672237,NaN,NaN,NaN,NaN,NaN,24019.53,24046.77805313995,23992.281946860046,23998.72836061489,23973.748480710172,24018.91642944942,23928.580531970925,3428,6390.833333333333,49.7310468524559,52.35720620098523,NaN,NaN,NaN,NaN,14.252789416077695,9.10559547881727,-72108,-0.8930892250871847,1.984445905443863,2.8775351305310477
2025-09-11T14:35:00-04:00,24019.75,24029.75,24017,24029.5,23978.86781672237,NaN,NaN,NaN,NaN,NaN,24020.805,24043.44396861839,23998.16603138161,23999.007429206285,23973.961109068743,24019.157223605518,23928.764994531968,4209,6339.933333333333,54.93347441434618,52.7427817474482,NaN,NaN,NaN,NaN,14.145447314929287,8.536339187730745,-67899,-0.39763556503517394,2.3804906742370804,2.7781262392722543
2025-09-11T14:40:00-04:00,24029,24034.25,24025.75,24032.75,23984.988310859462,NaN,NaN,NaN,NaN,NaN,24021.505,24043.401458612934,23999.608541387068,24005.40594336503,23974.19812558805,24019.448887967843,23928.947363208255,4274,6346.933333333333,56.58868619751223,52.854609531551766,NaN,NaN,NaN,NaN,13.742201078148623,8.39716790840697,-63625,0.11582966471509026,2.922913320166117,2.807083655451027
2025-09-11T14:45:00-04:00,24032.75,24038.25,24030,24035.5,23990.03429672949,NaN,NaN,NaN,NaN,NaN,24021.97,24044.047282435276,23999.892717564726,24011.049754692023,23974.452454281174,24019.77684449135,23929.128064071,4344,6255,57.99453716013856,53.15680069503808,NaN,NaN,NaN,NaN,13.349901001138008,8.722503649973861,-59281,0.5814946704657902,3.5339519935332646,2.9524573230674744
2025-09-11T14:50:00-04:00,24036,24042.25,24032.5,24034.75,23993.958874150874,NaN,NaN,NaN,NaN,NaN,24022.38,24044.629323577457,24000.130676422545,24015.61480375362,23974.791630587246,24020.222905613835,23929.360355560657,5669,6237.2,57.44811863273009,53.2501018776175,NaN,NaN,NaN,NaN,13.092765215342435,9.449601865900876,-64950,0.7681013254324425,3.9125839798580273,3.144482654425585
2025-09-11T14:55:00-04:00,24034.75,24041.5,24030.75,24033.5,23993.958874150874,NaN,NaN,NaN,NaN,NaN,24022.925,24044.900497722087,24000.949502277912,24015.61480375362,23975.06445103582,24020.573864626145,23929.555037445498,4701,6224,56.49276405922605,53.940443253101186,NaN,NaN,NaN,NaN,12.925424842817975,9.859782842618959,-69651,0.7363578929879644,4.06493002066054,3.328572127672576
2025-09-11T15:00:00-04:00,24033.5,24035,24027.75,24031,23993.958874150874,NaN,NaN,NaN,NaN,NaN,24023.72,24043.85321632984,24003.586783670162,24015.61480375362,23975.300865285688,24020.85982946441,23929.741901106965,4402,6172.166666666667,54.539267041237295,54.050837808465985,NaN,NaN,NaN,NaN,12.520037354045261,9.792543106041052,-74053,0.4879705107137142,3.9385352660647186,3.4505647553510044
2025-09-11T15:05:00-04:00,24030.25,24037.5,24023.75,24025,23993.958874150874,NaN,NaN,NaN,NaN,NaN,24024.14,24043.470328505042,24004.809671494957,24015.61480375362,23975.578926953316,24021.181623527733,23929.9762303789,5471,6157.566666666667,50.06473355468211,53.618886403880595,NaN,NaN,NaN,NaN,12.607891828756314,9.165822337560341,-79524,-0.10765823206346115,3.315991965271678,3.423650197335139
2025-09-11T15:10:00-04:00,24025,24031.75,24021.75,24023.5,23993.958874150874,NaN,NaN,NaN,NaN,NaN,24024.485,24043.12941203094,24005.84058796906,24015.61480375362,23975.84517520794,24021.472101350333,23930.21824906555,5620,6066.733333333334,48.982784950070645,53.31543694681071,NaN,NaN,NaN,NaN,12.421613840988005,8.709588737033354,-85144,-0.6022824274256582,2.6707971630530665,3.2730795904787247
2025-09-11T15:15:00-04:00,24023.5,24033.75,24021,24031,23993.958874150874,NaN,NaN,NaN,NaN,NaN,24024.975,24042.979791046004,24006.970208953993,24015.61480375362,23976.11973552028,24021.78572570112,23930.453745339437,5533,6059.766666666666,54.30067325838915,53.30546671505266,NaN,NaN,NaN,NaN,12.445069995203147,8.17461263957001,-79611,-0.431938213761653,2.7331568232766585,3.1650950370383115
2025-09-11T15:20:00-04:00,24030.75,24036.5,24027.5,24033.25,23993.958874150874,NaN,NaN,NaN,NaN,NaN,24025.305,24043.299524175825,24007.310475824175,24015.61480375362,23976.33734286861,24022.048667484094,23930.626018253126,4124,5858.633333333333,55.78953206404992,53.49002295586387,NaN,NaN,NaN,NaN,12.19899356697435,8.0621718683991,-75487,-0.1877926695449661,2.9303542001071037,3.1181468696520698
2025-09-11T15:25:00-04:00,24033.25,24038.75,24030,24032.75,23994.441895543572,NaN,NaN,NaN,NaN,NaN,24025.165,24042.813402186574,24007.51659781343,24015.61480375362,23976.5317112768,24022.287575017035,23930.775847536563,3619,5708.966666666666,55.35791795867715,53.79523596962094,NaN,NaN,NaN,NaN,11.95263688361904,8.263287866479397,-79106,-0.08525895198093059,3.0115731796759064,3.096832131656837
2025-09-11T15:30:00-04:00,24033,24041.5,24025.5,24036.25,23994.441895543572,NaN,NaN,NaN,NaN,NaN,24025.305,24043.190270482664,24007.419729517336,24015.61480375362,23976.906095621074,24022.7491898408,23931.063001401348,6969,5734.3,57.81801718411878,54.330628692518694,NaN,NaN,NaN,NaN,12.241734249074822,7.738977349370001,-72137,0.17860520687607018,3.3200886402519245,3.1414834333758543
2025-09-11T15:35:00-04:00,24036.25,24039.75,24029.75,24035.75,23994.91839036098,NaN,NaN,NaN,NaN,NaN,24025.26,24043.028218831627,24007.49178116837,24015.61480375362,23977.20555521701,24023.11964556163,23931.29146487239,5575,5684.233333333334,57.331955284538196,54.81239347229802,NaN,NaN,NaN,NaN,12.081610374140906,7.252117583482705,-77712,0.27407823295912914,3.4840812245747657,3.2100029916156365
2025-09-11T15:40:00-04:00,24036,24037.5,24024.75,24025.75,23994.91839036098,NaN,NaN,NaN,NaN,NaN,24025.03,24042.46606607974,24007.593933920256,24014.816843002896,23977.45639543698,24023.40171364119,23931.51107723277,5237,5547.666666666667,48.542444424569595,54.72749329887756,NaN,NaN,NaN,NaN,12.1293524902737,7.415722936719786,-82949,-0.3478903804913993,2.7751400160013873,3.1230303964927866
2025-09-11T15:45:00-04:00,24026.25,24037.25,24023.5,24036.75,23994.91839036098,NaN,NaN,NaN,NaN,NaN,24025.28,24043.01996618921,24007.540033810787,24013.13633049215,23977.761194288974,24023.76083860336,23931.761549974588,6060,5492.266666666666,56.451405916409485,54.83591697759637,NaN,NaN,NaN,NaN,12.24511302668272,7.743132632827521,-76889,-0.04596903925827833,3.0655690974199388,3.111538136678217
2025-09-11T15:50:00-04:00,24036.25,24044.25,24027.25,24036.25,23995.414698829172,NaN,NaN,NaN,NaN,NaN,24025.625,24043.53316852351,24007.71683147649,24013.13633049215,23978.41327162306,24024.562359625426,23932.264183620693,12410,5718.2,56.029853292273714,54.796000341507906,NaN,NaN,NaN,NaN,12.584747810491097,7.4589002339547035,-89299,0.08540305007615201,3.2182919492734072,3.132888899197255
2025-09-11T15:55:00-04:00,24035.75,24040.5,24007.5,24011.75,23995.414698829172,NaN,NaN,NaN,NaN,NaN,24025.625,24043.53316852351,24007.71683147649,24013.13633049215,23979.151315690215,24025.215969893074,23933.086661487356,20038,6123.933333333333,40.19197122348693,53.524388488889926,NaN,NaN,NaN,NaN,14.042980109741732,8.87742742448225,-109337,-1.4288271520474045,1.3468549591379997,2.775682111185404
2025-09-11T16:00:00-04:00,24011.75,24015.25,24003.75,24010,23995.414698829172,NaN,NaN,NaN,NaN,NaN,24025.29,24043.720507316644,24006.859492683358,24013.13633049215,23979.460767046126,24025.393122084708,23933.528412007545,11544,6303.6,39.336645392562716,52.23071182887797,NaN,NaN,NaN,NaN,13.861338673331607,10.494266455780165,-120881,-2.4400021025490335,-0.2743205170008878,2.1656815855481457
2025-09-11T16:05:00-04:00,24010.25,24024,24009.25,24020.5,23995.414698829172,NaN,NaN,NaN,NaN,NaN,24025.215,24043.692286055673,24006.737713944327,24013.13633049215,23979.64232662771,24025.541885736293,23933.742767519125,5400,6337.133333333333,46.66995713873807,51.529082763128834,NaN,NaN,NaN,NaN,13.924814482379348,10.805796049891725,-115481,-2.295536665215732,-0.7037392459715193,1.5917974192442128
2025-09-11T16:10:00-04:00,24019.75,24021.75,24004.5,24007.5,23995.414698829172,NaN,NaN,NaN,NaN,NaN,24024.54,24043.09056871175,24005.989431288253,24013.13633049215,23979.752068608894,24025.609581173485,23933.894556044303,3985,6234.5,40.1918200402415,50.504265120200564,NaN,NaN,NaN,NaN,14.162327733637966,11.514363777300966,-119466,-2.9287944455273394,-2.0691956376649614,0.859598807862378
2025-09-11T16:15:00-04:00,24007.5,24016,24005.75,24011.25,23995.414698829172,NaN,NaN,NaN,NaN,NaN,24024.025,24042.593050505136,24005.456949494866,24013.009064393722,23979.824998022486,24025.65377781391,23933.996218231063,2685,6046.1,42.66417813433137,49.97565401874694,NaN,NaN,NaN,NaN,13.882875752663825,12.172319524180976,-116781,-2.940696468477161,-2.816271777734073,0.1244246907430877
2025-09-11T16:20:00-04:00,24011,24013.25,24009.5,24011.25,23995.414698829172,NaN,NaN,NaN,NaN,NaN,24023.57,24042.252622942942,24004.887377057057,24011.957251514978,23979.848069322838,24025.667994904885,23934.02814374079,843,5811.4,42.66417813433137,49.52432496047985,NaN,NaN,NaN,NaN,13.159098913187837,12.783278431998127,-116781,-2.7951346138888455,-3.3694935766179697,-0.5743589627291239
2025-09-11T16:25:00-04:00,24010.75,24013.25,24008.75,24012,23995.414698829172,NaN,NaN,NaN,NaN,NaN,24023.055,24041.56453538121,24004.54546461879,24011.94011277567,23979.87995218001,24025.68761995014,23934.072284409882,1167,5649.933333333333,43.20872066068513,48.73204263207242,NaN,NaN,NaN,NaN,12.540591847960133,13.426550972507181,-115614,-2.5042741193421287,-3.704701611906785,-1.200427492564656
2025-09-11T16:30:00-04:00,24011.75,24014.5,24010.25,24012.5,23995.414698829172,NaN,NaN,NaN,NaN,NaN,24022.665,24041.22587551009,24004.104124489913,24011.94011277567,23979.912218383,24025.708619168512,23934.11581759749,1144,5472.233333333334,43.59333863762784,47.860885958756555,NaN,NaN,NaN,NaN,11.94840671596298,13.81936020530721,-114470,-2.147837308595752,-3.8852241283093463,-1.7373868197135942
2025-09-11T16:35:00-04:00,24012.5,24013.25,24007.5,24008.75,23995.414698829172,NaN,NaN,NaN,NaN,NaN,24022.35,24041.306001698682,24003.393998301315,24011.94011277567,23979.947839806537,24025.728600146515,23934.16707946656,1375,5369.633333333333,41.33242111703256,46.859064755781944,NaN,NaN,NaN,NaN,11.505663379108482,14.489650565274662,-115845,-2.035313255418542,-4.2815283889867715,-2.2462151335682297
2025-09-11T16:40:00-04:00,24007.75,24008.75,24005,24006.75,23995.414698829172,NaN,NaN,NaN,NaN,NaN,24021.98,24041.411376691707,24002.548623308292,23998.152090220534,23979.973653764973,24025.740006321852,23934.207301208095,1110,5229.266666666666,40.13680757375612,45.5961212121846,NaN,NaN,NaN,NaN,10.951687423457875,15.381492614872746,-116955,-1.9652478878235784,-4.7027749933477025,-2.737527105524124
2025-09-11T16:45:00-04:00,24006.5,24012,24004.25,24011.25,23995.414698829172,NaN,NaN,NaN,NaN,NaN,24021.865,24041.480098763812,24002.24990123619,23992.45257459508,23980.009920758337,24025.759394483426,23934.260447033248,1438,5121.6,44.05789044559136,44.647973723688395,NaN,NaN,NaN,NaN,10.722995464639455,15.626093233490948,-115517,-1.506173731855414,-4.620244270343392,-3.1140705384879777
2025-09-11T16:50:00-04:00,24011,24011.75,24007,24010,23995.414698829172,NaN,NaN,NaN,NaN,NaN,24021.77,24041.567181606555,24001.972818393446,23993.737059676063,23980.032565435744,24025.771835986434,23934.293294885054,887,4978.766666666666,43.21120000314755,44.26717055072968,NaN,NaN,NaN,NaN,10.296352931450922,15.8532223793507,-116404,-1.1908605218761652,-4.602646190833184,-3.4117856689570187
2025-09-11T16:55:00-04:00,24009.75,24010.75,24006,24006.5,23995.414698829172,NaN,NaN,NaN,NaN,NaN,24021.57,24041.77396991565,24001.36603008435,23993.964647740853,23980.058239576818,24025.784096346513,23934.332382807122,1074,4811.166666666667,40.844324620581034,43.15237902959908,NaN,NaN,NaN,NaN,9.900184864918714,16.194295267170425,-117478,-1.1230586588020666,-4.815608992459602,-3.692550333657535
2025-09-11T18:00:00-04:00,24028,24029.5,24010.75,24018.75,23995.414698829172,NaN,NaN,NaN,NaN,NaN,24021.78,24041.641178216472,24001.918821783525,24004.57171819268,24019.666666666668,24019.666666666668,24019.666666666668,3695,4820.066666666667,50.96748202030725,42.79078108160148,NaN,NaN,NaN,NaN,10.83588594599595,16.25122997811452,-113783,-0.20625851559699493,-3.9503734781537787,-3.7441149625567838
2025-09-11T18:05:00-04:00,24018.25,24025,24014,24023.25,23995.414698829172,NaN,NaN,NaN,NaN,NaN,24022.075,24041.57326915102,24002.57673084898,24004.57171819268,24020.014034442607,24020.519653508243,24019.50841537697,1744,4737.9,54.076449225437656,43.782529510312244,NaN,NaN,NaN,NaN,10.84760837842481,16.304097923991183,-112039,0.7005003336156999,-2.868489545537159,-3.5689898791528587
2025-09-11T18:10:00-04:00,24024,24024.5,24014.5,24015.25,23995.414698829172,NaN,NaN,NaN,NaN,NaN,24022.35,24041.05133685724,24003.648663142758,24004.57171819268,24019.744897151897,24020.56172163382,24018.928072669973,881,4624.8,48.22256164117225,44.417237813784354,NaN,NaN,NaN,NaN,10.787064922823038,16.35318958801951,-112920,0.7541143173784288,-2.6263469824298227,-3.3804612998082515
2025-09-11T18:15:00-04:00,24014.5,24017,24010,24010.25,23995.414698829172,NaN,NaN,NaN,NaN,NaN,24022.3,24041.11674786385,24003.48325213615,24004.57171819268,24018.833183245588,24021.369760116366,24016.29660637481,898,4509.933333333333,44.94759155533805,44.29421170068435,NaN,NaN,NaN,NaN,10.516560285478535,15.684369350500216,-113818,0.4599173064037627,-2.805564666803548,-3.2654819732073106
2025-09-11T18:20:00-04:00,24010,24017.5,24003.5,24014.5,23995.414698829172,NaN,NaN,NaN,NaN,NaN,24022.095,24041.02352080588,24003.166479194122,24004.57171819268,24017.763487871674,24021.19778883451,24014.32918690884,1302,4364.366666666667,48.169729609795226,44.86406238422391,NaN,NaN,NaN,NaN,10.765377407944355,14.961795715714917,-112516,0.5524065413383901,-2.574973796534323,-3.127380337872713
2025-09-11T18:25:00-04:00,24014.5,24016.75,24010.25,24014,23995.414698829172,NaN,NaN,NaN,NaN,NaN,24022.04,24041.04614637794,24003.033853622062,24004.57171819268,24017.48391477107,24020.9561984738,24014.01163106834,624,4228.466666666666,47.81516187825877,45.23198979450443,NaN,NaN,NaN,NaN,10.460707593091186,14.290834483414283,-113140,0.5780218359410965,-2.4048530429463426,-2.982874878887439
2025-09-11T18:30:00-04:00,24014.5,24016.5,24006,24007.75,23995.414698829172,NaN,NaN,NaN,NaN,NaN,24021.695,24041.095847919358,24002.29415208064,24004.57171819268,24016.660988530326,24020.677080929705,24012.644896130947,1144,4119.866666666667,43.50441041715633,45.29200638613479,NaN,NaN,NaN,NaN,10.463514193584672,14.219093767852206,-114284,0.1921100486023839,-2.742737318134459,-2.934847366736843
2025-09-11T18:35:00-04:00,24008,24010.75,24005.25,24006.5,23995.414698829172,NaN,NaN,NaN,NaN,NaN,24021.545,24041.2943518892,24001.795648110798,24004.57171819268,24015.996191291804,24020.535661414284,24011.456721169325,805,3964.3333333333335,42.675737645225404,45.25393617074481,NaN,NaN,NaN,NaN,10.108977465471481,14.247213626110014,-115089,-0.11285834608502521,-3.0759202993431245,-2.9630619532580993
2025-09-11T18:40:00-04:00,24006.75,24007.5,24001,24005.25,23995.414698829172,NaN,NaN,NaN,NaN,NaN,24021.12,24041.333668644605,24000.906331355392,24004.57171819268,24015.06543577855,24020.421041555397,24009.709830001702,985,3809.8333333333335,41.81791628898209,45.127120288698684,NaN,NaN,NaN,NaN,9.851193360794948,14.794014770027422,-116074,-0.3508488162071832,-3.401622973517078,-3.050774157309895
2025-09-11T18:45:00-04:00,24004.75,24010.5,24003,24008,23995.414698829172,NaN,NaN,NaN,NaN,NaN,24020.8,24041.325350178788,24000.27464982121,24004.57171819268,24014.73219666931,24020.2088347553,24009.255558583318,532,3643.133333333333,44.462803372582634,45.35071902123798,NaN,NaN,NaN,NaN,9.683250977881022,14.771109437499295,-115542,-0.27831265639342195,-3.3986649778016726,-3.1203523214082507
2025-09-11T18:50:00-04:00,24008,24014.25,24007.75,24012.25,23995.414698829172,NaN,NaN,NaN,NaN,NaN,24020.455,24040.96370302429,23999.946296975715,23999.557374554144,24014.57086005281,24019.96001011118,24009.18170999444,645,3527.1666666666665,48.369127270737174,45.93874185673662,NaN,NaN,NaN,NaN,9.455875908032377,14.129897549440054,-114897,0.08141394037390004,-3.018584895940876,-3.099998836314776
2025-09-11T18:55:00-04:00,24012.25,24014.5,24011.25,24013,23995.414698829172,NaN,NaN,NaN,NaN,NaN,24020.52,24040.91285169114,24000.12714830886,23999.145899643318,24014.517830193272,24019.827895533155,24009.20776485339,439,3421.1666666666665,49.0501849979954,46.295334324765484,NaN,NaN,NaN,NaN,9.012599057458635,13.493575086983201,-114458,0.3787410943973848,-2.626572468318045,-3.00531356271543
2025-09-11T19:00:00-04:00,24013.5,24014,24009.75,24011.5,23995.414698829172,NaN,NaN,NaN,NaN,NaN,24020.265,24040.78338443557,23999.74661556443,23997.918306635715,24014.43299473821,24019.682771902935,24009.183217573485,433,3203.3,47.69511103115928,46.61561368390918,NaN,NaN,NaN,NaN,8.672413410497304,13.131525499472357,-114891,0.4769181347063074,-2.4091658943325456,-2.886084029038853
2025-09-11T19:05:00-04:00,24011.75,24012,24005.25,24006.5,23995.414698829172,NaN,NaN,NaN,NaN,NaN,24019.745,24040.314513858135,23999.175486141863,23997.918306635715,24014.183253914227,24019.48126572956,24008.885242098895,563,3036.233333333333,43.39188374482442,46.79758219278371,NaN,NaN,NaN,NaN,8.535098166890354,13.43929802520285,-115454,0.22067632297608775,-2.6102386253187433,-2.830914948294831
2025-09-11T19:10:00-04:00,24007,24018,24006.25,24016.5,23995.414698829172,NaN,NaN,NaN,NaN,NaN,24019.55,24040.053902063933,23999.046097936065,23999.132716246855,24014.14577084264,24019.277657721883,24009.013883963395,979,2894.3,52.60253279298648,46.91437153368937,NaN,NaN,NaN,NaN,8.764734012112472,12.68612510507472,-114475,0.7124862514953278,-1.9403071339256712,-2.652793385420999
2025-09-11T19:15:00-04:00,24015.75,24018.5,24014,24018.25,23995.414698829172,NaN,NaN,NaN,NaN,NaN,24019.33,24039.648080616735,23999.01191938327,24001.156172997486,24014.245827181756,24019.3106570489,24009.180997314612,587,2711.866666666667,54.01270492946944,46.90981836969164,NaN,NaN,NaN,NaN,8.460110154104438,11.905956304057362,-113888,1.1192594027216898,-1.2537191320188867,-2.3729785347405765
2025-09-11T19:20:00-04:00,24017.5,24024,24016.75,24022.25,23995.414698829172,NaN,NaN,NaN,NaN,NaN,24019.24,24039.465469094815,23999.014530905188,24006.49993839799,24014.600149607522,24019.75518476076,24009.445114454284,900,2328.2,57.15080162797112,47.54754979732013,NaN,NaN,NaN,NaN,8.37367371452555,11.76706003954629,-112988,1.5924481536393569,-0.38241834269138053,-1.9748664963307374
2025-09-11T19:25:00-04:00,24022.25,24022.5,24015.75,24018.25,23995.414698829172,NaN,NaN,NaN,NaN,NaN,24019.155,24039.360665056967,23998.94933494303,24006.49993839799,24014.78830158553,24019.902430892762,24009.674172278297,798,1686.8666666666666,53.23844444512896,48.13975357516234,NaN,NaN,NaN,NaN,8.257697020630868,11.464795827625387,-113786,1.5682887575217284,-0.01450554942857707,-1.5827943069503054
2025-09-11T19:30:00-04:00,24018.5,24023,24018,24021.5,23995.414698829172,NaN,NaN,NaN,NaN,NaN,24019.165,24039.37480207736,23998.95519792264,24006.599960574713,24015.05448769146,24020.20627293257,24009.902702450352,827,1329.6333333333334,55.88114787543958,48.69056916556551,NaN,NaN,NaN,NaN,8.025004376300092,11.26166308849339,-112959,1.6927712689106673,0.5331697791880288,-1.1596014897226385
2025-09-11T19:35:00-04:00,24021.5,24025.5,24017.5,24019,23995.414698829172,NaN,NaN,NaN,NaN,NaN,24019.115,24039.31381431575,23998.916185684255,24008.37996845977,24015.289545284493,24020.45609148428,24010.122999084706,821,1177,53.3819796803911,49.08819900857496,NaN,NaN,NaN,NaN,8.023218349421514,11.461132847212172,-113780,1.5330843342238316,0.7567539280571509,-0.7763304061666807
2025-09-11T19:40:00-04:00,24019.25,24021.5,24017.5,24020.75,23995.414698829172,NaN,NaN,NaN,NaN,NaN,24019.13,24039.332534489215,23998.927465510787,24008.37996845977,24015.365696604782,24020.52325958357,24010.208133625994,328,1055.1,54.902408992839845,49.90234176398092,NaN,NaN,NaN,NaN,7.735845610177121,11.646354766022467,-113452,1.4713874109149985,1.0629038574770675,-0.408483553437931
2025-09-11T19:45:00-04:00,24020.5,24020.5,24016.75,24016.75,23995.414698829172,NaN,NaN,NaN,NaN,NaN,24018.875,24038.868311383467,23998.881688616533,24008.37996845977,24015.420952661654,24020.53808114125,24010.303824182058,427,979.8333333333334,50.822286226223085,50.48423809119504,NaN,NaN,NaN,NaN,7.468999495164469,11.653227036920768,-113879,1.1040378265346693,0.9715637297304056,-0.1324740968042637
2025-09-11T19:50:00-04:00,24017.5,24022.5,24015.75,24020.75,23995.414698829172,NaN,NaN,NaN,NaN,NaN,24018.635,24038.240665000332,23999.029334999665,24008.37996845977,24015.525315444815,24020.62174164124,24010.42888924839,513,968.8333333333334,54.466451072469106,51.38770486144411,NaN,NaN,NaN,NaN,7.417642388367007,12.006362378424788,-113366,1.0723931329087728,1.2080173193317023,0.1356241864229295
2025-09-11T19:55:00-04:00,24020.75,24025.5,24018,24019.25,23996.111442213278,NaN,NaN,NaN,NaN,NaN,24018.31,24037.31619898861,23999.303801011392,24009.73363508112,24015.72267229839,24020.826380461967,24010.618964134814,793,956.3666666666667,52.88385976696697,51.98920888961442,NaN,NaN,NaN,NaN,7.42352507491222,12.82040965664307,-114159,0.8993792763855375,1.2598482819048513,0.3604690055193139
2025-09-11T20:00:00-04:00,24019.75,24020.5,24008.25,24010.25,23996.111442213278,NaN,NaN,NaN,NaN,NaN,24017.82,24036.36320360593,23999.276796394068,24009.73363508112,24015.506427417986,24020.458297969824,24010.554556866147,1869,980.5333333333333,44.52447301289946,51.71459072834029,NaN,NaN,NaN,NaN,7.768273283847061,12.191241167117418,-116028,0.16614529365518194,0.5681506225882913,0.40200532893310936
2025-09-11T20:05:00-04:00,24010.25,24011.75,24006,24009.5,23996.111442213278,NaN,NaN,NaN,NaN,NaN,24017.34,24035.472776946528,23999.207223053472,24009.73363508112,24015.26299112801,24020.272584352497,24010.25339790352,927,965.6,43.90169114294114,51.34684116726499,NaN,NaN,NaN,NaN,7.624110906429414,11.965749776615258,-116955,-0.3536694261637381,-0.04008145377156325,0.31358797239217484
2025-09-11T20:10:00-04:00,24009.75,24016,24008.25,24013,23996.111442213278,NaN,NaN,NaN,NaN,NaN,24016.98,24034.724249769093,23999.235750230906,24009.73363508112,24015.14818665725,24020.087557544597,24010.208815769904,1028,962.8666666666667,47.5861578298348,51.33905879574181,NaN,NaN,NaN,NaN,7.633102984541599,11.214925038719336,-115927,-0.4404363846551099,-0.2369575084267126,0.20347887622839733
2025-09-11T20:15:00-04:00,24012.75,24016,24011.25,24013,23996.111442213278,NaN,NaN,NaN,NaN,NaN,24016.74,24034.368091202876,23999.111908797127,24009.73363508112,24015.10823207738,24019.997199682297,24010.21926447246,602,935,47.5861578298348,51.63864980181398,NaN,NaN,NaN,NaN,7.427167057074342,10.517730639244553,-115927,-0.47358690828544525,-0.3885047591284092,0.08508214915703602
2025-09-11T20:20:00-04:00,24012.75,24023.75,24012,24018.5,23996.111442213278,NaN,NaN,NaN,NaN,NaN,24016.64,24034.170019978774,23999.109980021225,24009.73363508112,24015.23331436195,24020.05551078114,24010.41111794276,1145,943.6,53.18932731256081,51.68056369606929,NaN,NaN,NaN,NaN,7.7359408387118895,11.06026392662758,-114782,-0.11931733268308242,-0.06406451669681701,0.05525281598626541
2025-09-11T20:25:00-04:00,24018.5,24023,24016,24018.5,23996.111442213278,NaN,NaN,NaN,NaN,NaN,24016.39,24033.443785509065,23999.336214490933,24009.73363508112,24015.36818729832,24020.160737290058,24010.575637306585,967,940.0333333333333,53.18932731256081,51.621751009147246,NaN,NaN,NaN,NaN,7.683373635946755,11.564044836340393,-114782,0.10848305632806551,0.1908566363963473,0.0823735800682818
2025-09-11T20:30:00-04:00,24018,24019.5,24009,24009.75,23996.111442213278,NaN,NaN,NaN,NaN,NaN,24015.92,24032.37400863839,23999.465991361605,24009.73363508112,24015.242758271437,24019.952413276573,24010.5331032663,1419,864.1666666666666,44.426494276920636,50.71287191264364,NaN,NaN,NaN,NaN,7.88456123337913,10.762613145286478,-116201,-0.31357847674998135,-0.3095995158691949,0.003978960880786461
2025-09-11T20:35:00-04:00,24010.25,24015.5,24009.25,24014.25,23996.111442213278,NaN,NaN,NaN,NaN,NaN,24015.55,24031.290076238696,23999.809923761302,24009.73363508112,24015.205161825725,24019.88404290948,24010.526280741968,505,822.8666666666667,49.07330198873656,50.415361737187034,NaN,NaN,NaN,NaN,7.767806859566335,10.018426575022124,-115696,-0.2745369553237764,-0.3391922332739341,-0.06465527795015766
2025-09-11T20:40:00-04:00,24014,24014.5,24009.25,24013,23996.111442213278,NaN,NaN,NaN,NaN,NaN,24015.085,24029.6838389971,24000.486161002897,24009.73363508112,24015.153217127576,24019.80702491444,24010.49940934071,539,811.4666666666667,47.875776083282446,49.84354946631867,NaN,NaN,NaN,NaN,7.587963512454453,9.327396188348082,-116235,-0.31485743514837844,-0.4582270718856307,-0.14336963673725228
2025-09-11T20:45:00-04:00,24012.75,24015,24010.75,24014,23996.111442213278,NaN,NaN,NaN,NaN,NaN,24014.65,24028.002902295528,24001.297097704475,24004.347877543383,24015.127863762147,24019.755716920023,24010.50001060427,414,795.3333333333334,48.94906829690241,49.52691293892662,NaN,NaN,NaN,NaN,7.349537547279135,8.779996682624017,-115821,-0.25849944631144894,-0.46649394462656346,-0.20799449831511452
2025-09-11T20:50:00-04:00,24014.25,24016,24007.25,24009.5,23996.111442213278,NaN,NaN,NaN,NaN,NaN,24014.325,24027.368868288348,24001.281131711654,24004.347877543383,24014.982893701195,24019.594750922304,24010.371036480086,1108,788.8666666666667,44.507756368892004,48.78443775150178,NaN,NaN,NaN,NaN,7.449570579616339,8.693182371253357,-116929,-0.49490762365828844,-0.8266290278879751,-0.33172140422968666
2025-09-11T20:55:00-04:00,24010,24011,24008.25,24009.25,23996.111442213278,NaN,NaN,NaN,NaN,NaN,24013.775,24025.210143191463,24002.33985680854,24004.347877543383,24014.908121622586,24019.53235646763,24010.283886777543,445,782.9,44.267450963685505,48.316235232749094,NaN,NaN,NaN,NaN,7.113886966786601,8.612569082123457,-117374,-0.6300699890353111,-1.1193088905238255,-0.48923890148851445
2025-09-11T21:00:00-04:00,24010,24011.25,24006,24010.75,23996.111442213278,NaN,NaN,NaN,NaN,NaN,24013.265,24022.754156984927,24003.77584301507,24004.347877543383,24014.81472413897,24019.455547948513,24010.173900329428,556,763.3,46.14624745994032,47.72193497471132,NaN,NaN,NaN,NaN,6.980752183444701,8.956231860461969,-116818,-0.5815710377537626,-1.2162026986807177,-0.6346316609269551
2025-09-11T21:05:00-04:00,24011,24011.5,24008,24010.5,23996.111442213278,NaN,NaN,NaN,NaN,NaN,24013.24,24022.751550857975,24003.72844914203,24004.347877543383,24014.754269689667,24019.396923806282,24010.111615573052,422,750.5333333333333,45.86871051779623,47.22085288548484,NaN,NaN,NaN,NaN,6.732127027484365,9.21435981545625,-117240,-0.5308545201114736,-1.2981998110662971,-0.7673452909548235
2025-09-11T21:10:00-04:00,24011,24015.25,24010.25,24014.5,23996.111442213278,NaN,NaN,NaN,NaN,NaN,24013.33,24022.80229642519,24003.857703574813,24003.978302034706,24014.726090485772,24019.32674617721,24010.125434794336,680,740.3666666666667,50.9516344908515,47.679935848195704,NaN,NaN,NaN,NaN,6.6084036683783385,8.582291351478206,-116560,-0.20897172244441298,-1.0285599440103397,-0.8195882215659267
2025-09-11T21:15:00-04:00,24015,24017.25,24011,24015,23996.111442213278,NaN,NaN,NaN,NaN,NaN,24013.22,24022.48209478689,24003.957905213112,24003.285271261117,24014.720603682057,24019.280469630954,24010.16073773316,619,743.2666666666667,51.56388511726612,48.22723541779035,NaN,NaN,NaN,NaN,6.582803406351315,8.363418489659638,-115941,0.04311368350753697,-0.7656961171815055,-0.8088098006890425
2025-09-11T21:20:00-04:00,24015.25,24016,24008.75,24009.25,23996.111442213278,NaN,NaN,NaN,NaN,NaN,24013.255,24022.44330232296,24004.06669767704,24003.285271261117,24014.668156734446,24019.21187097847,24010.12444249042,549,740.0666666666667,44.659829475342164,48.01821196389802,NaN,NaN,NaN,NaN,6.63046030589765,7.871673698064131,-116490,-0.1607219606661301,-1.0097122515217052,-0.8489902908555751
2025-09-11T21:25:00-04:00,24009.25,24009.5,24003.75,24008.75,23996.111442213278,NaN,NaN,NaN,NaN,NaN,24013.205,24022.463342151543,24003.94665784846,24003.285271261117,24014.377505417116,24019.054538689008,24009.700472145225,1463,774.2,44.10679652247978,47.7696861562298,NaN,NaN,NaN,NaN,6.567570284047818,8.37886716949776,-117953,-0.30422563220735677,-1.229272331114771,-0.9250466989074143
2025-09-11T21:30:00-04:00,24008.5,24009.5,24003,24007.25,23996.111442213278,NaN,NaN,NaN,NaN,NaN,24013.125,24022.51768331455,24003.73231668545,24003.285271261117,24014.180377351848,24018.95729931433,24009.403455389365,958,791.7,42.41008116397975,46.99974000275973,NaN,NaN,NaN,NaN,6.56274383518726,8.98129340100545,-118911,-0.4655159646001219,-1.5069416546575667,-1.0414256900574448
2025-09-11T21:35:00-04:00,24007,24007.75,24003,24006,23996.111442213278,NaN,NaN,NaN,NaN,NaN,24013.005,24022.60317169383,24003.40682830617,24003.285271261117,24014.05667082997,24018.90835491962,24009.204986740322,553,791.3666666666667,40.994822183863235,46.12870392213847,NaN,NaN,NaN,NaN,6.433262132673884,9.54068918740545,-119464,-0.6124841046848413,-1.8070308209134964,-1.1945467162286552
2025-09-11T21:40:00-04:00,24006,24006.75,24002.75,24005.75,23996.111442213278,NaN,NaN,NaN,NaN,NaN,24012.87,24022.680321104293,24003.059678895705,24003.285271261117,24013.947799655554,24018.86901216154,24009.02658714957,472,774.4666666666667,40.70227215282487,45.86268805613163,NaN,NaN,NaN,NaN,6.25945769462575,10.10943664812292,-119936,-0.6775574203558468,-2.0414934916734637,-1.363936071317617
2025-09-11T21:45:00-04:00,24005.75,24006,24001,24003,23996.111442213278,NaN,NaN,NaN,NaN,NaN,24012.755,24022.885394852336,24002.624605147666,24003.285271261117,24013.733922289666,24018.828506996393,24008.63933758294,800,781.5666666666667,37.529618530706465,45.03813923770092,NaN,NaN,NaN,NaN,6.16949643072391,10.984482546322996,-120736,-0.8458892650430532,-2.4212976526214334,-1.5754083875783802
2025-09-11T21:50:00-04:00,24002.75,24006.5,24001.5,24004.75,23996.111442213278,NaN,NaN,NaN,NaN,NaN,24012.715,24022.955122082734,24002.474877917266,24003.285271261117,24013.624832980622,24018.78999909716,24008.459666864084,462,766.9666666666667,40.697487004324834,44.52540430348966,NaN,NaN,NaN,NaN,6.085960971386489,11.641516148872503,-120274,-0.7810098818894269,-2.551670739940164,-1.770660858050737
2025-09-11T21:55:00-04:00,24004.75,24008.25,24001.75,24004.75,23996.111442213278,NaN,NaN,NaN,NaN,NaN,24012.585,24023.058590608525,24002.111409391473,24003.285271261117,24013.47734170399,24018.72040393035,24008.23427947763,692,763.4333333333333,40.69748700432485,43.93600563973411,NaN,NaN,NaN,NaN,6.115535187716025,11.712082679110825,-120274,-0.6832601358338326,-2.624736027843028,-1.9414758920091952
2025-09-11T22:00:00-04:00,24004.5,24006.5,24003,24005.75,23996.111442213278,NaN,NaN,NaN,NaN,NaN,24012.5,24023.124029362043,24001.875970637957,24003.285271261117,24013.381276715863,24018.670155453576,24008.09239797815,473,751.6333333333333,42.62564285483121,43.80156896015835,NaN,NaN,NaN,NaN,5.928711245736309,11.777608742903553,-119801,-0.5046571344465396,-2.57229731006737,-2.0676401756208302
2025-09-11T22:05:00-04:00,24005.25,24005.5,23999.5,24003,23996.111442213278,NaN,NaN,NaN,NaN,NaN,24012.43,24023.255451497447,24001.604548502553,24001.203217008893,24013.14052743614,24018.6054425715,24007.675612300776,950,755.9333333333333,38.881680749526716,43.416871087718434,NaN,NaN,NaN,NaN,5.95166044246943,12.632489916493322,-120751,-0.5229055670963763,-2.7212721344913007,-2.1983665673949244
2025-09-11T22:10:00-04:00,24003.75,24004,23996,23997.5,NaN,NaN,NaN,24020.170671127627,24020.170671127627,24020.170671127627,24012.005,24023.45510479792,24000.554895202084,23994.787573607115,24012.82175792174,24018.612858130764,24007.03065771272,987,777.9,32.69621193849672,42.45615426475818,NaN,NaN,NaN,NaN,6.097970410864471,14.082686044635958,-121738,-0.837886819894825,-3.2457250922634557,-2.4078382723686307
2025-09-11T22:15:00-04:00,23997.75,23998.75,23993,23993.75,NaN,NaN,NaN,24015.912913349097,NaN,NaN,24011.415,24023.50863883113,23999.321361168873,23994.481465695662,24012.209633876977,24018.75230057797,24005.666967175985,1554,815.4666666666667,29.27642607995037,41.27099109062633,NaN,NaN,NaN,NaN,6.073115381517008,15.908826798995987,-123292,-1.208751992708578,-3.918778263254353,-2.710026270545775
2025-09-11T22:20:00-04:00,23994.25,23996,23992,23992.5,NaN,NaN,NaN,24013.672553651413,NaN,NaN,24010.96,24024.10814057131,23997.81185942869,23994.481465695662,24011.949486282534,24018.80593400306,24005.09303856201,632,819.4333333333333,28.21698805778304,39.64708777397858,NaN,NaN,NaN,NaN,5.92503571140865,17.75406276130123,-123924,-1.43290360891296,-4.501155781686975,-3.0682521727740153
2025-09-11T22:25:00-04:00,23992.5,23996.5,23992.25,23995.25,NaN,NaN,NaN,24013.672553651413,NaN,NaN,24010.66,24024.52425621321,23996.795743786788,23994.481465695662,24011.720244297787,24018.812261785137,24004.628226810437,611,813.3666666666667,33.885409986922866,38.38433955038263,NaN,NaN,NaN,NaN,5.805390303450889,19.28185718422844,-123313,-1.29481107959145,-4.686766022263328,-3.3919549426718776
2025-09-11T22:30:00-04:00,23994.5,23996.5,23992,23995,NaN,NaN,NaN,24013.341624298086,NaN,NaN,24010.27,24024.763046606055,23995.776953393946,23994.481465695662,24011.501743255598,24018.807454385427,24004.19603212577,592,770.8,33.625453510788134,37.596169838628775,NaN,NaN,NaN,NaN,5.712148138918684,20.743021318151424,-123905,-1.1254118313518084,-4.798719731861638,-3.6733079005098297
2025-09-11T22:35:00-04:00,23995.5,24001,23995.5,24000,NaN,NaN,NaN,24013.341624298086,NaN,NaN,24009.99,24024.722942675395,23995.25705732461,23994.481465695662,24011.25337437923,24018.697282033456,24003.809466725004,933,771,43.0376404890585,37.519801550527255,NaN,NaN,NaN,NaN,5.732708986138777,20.509584905971032,-122972,-0.6076625504676456,-4.432886088594387,-3.825223538126741
2025-09-11T22:40:00-04:00,23999.75,24004.5,23999.25,24003.75,NaN,NaN,NaN,24013.341624298086,NaN,NaN,24009.91,24024.733886132813,23995.086113867186,23994.481465695662,24011.087184772896,24018.556242727536,24003.618126818255,921,767.4333333333333,48.8913278539254,37.98274774266623,NaN,NaN,NaN,NaN,5.69822977284315,19.304886206557505,-122051,0.02289741547487445,-3.796601768783148,-3.8194991842580226
2025-09-11T22:45:00-04:00,24003.75,24004.5,24000.75,24003.25,NaN,NaN,NaN,24013.341624298086,NaN,NaN,24009.845,24024.756368141163,23994.93363185884,23993.73517255653,24011.006314213784,24018.483023743607,24003.52960468396,480,763.3666666666667,48.18038411900168,38.49600216660469,NaN,NaN,NaN,NaN,5.559070503354354,18.186237414244946,-122531,0.4198326788730937,-3.2947083356666553,-3.714541014539749
2025-09-11T22:50:00-04:00,24003,24007,24003,24006,NaN,NaN,NaN,24013.341624298086,NaN,NaN,24009.86,24024.754347903297,23994.965652096704,23995.07772884978,24010.95263321067,24018.414125414936,24003.4911410064,468,740.8,52.28964243848801,39.32367147272348,NaN,NaN,NaN,NaN,5.447708324543329,17.284834988030166,-122063,0.8559790261710543,-2.6445672318259312,-3.5005462579969855
2025-09-11T22:55:00-04:00,24006,24007,24003,24003.75,NaN,NaN,NaN,24013.341624298086,NaN,NaN,24009.775,24024.759074865047,23994.790925134956,23995.462183079824,24010.88132272382,24018.33113182234,24003.431513625303,560,727.2333333333333,48.874667086005516,40.13403208381628,NaN,NaN,NaN,NaN,5.344300587075948,16.447818449402156,-122623,0.9727993405565583,-2.2845470823012874,-3.2573464228578457
2025-09-11T23:00:00-04:00,24004,24005.75,24002.25,24003.5,NaN,NaN,NaN,24013.341624298086,NaN,NaN,24009.6,24024.668510209798,23994.5314897902,23995.462183079824,24010.801220854006,24018.246154116205,24003.356287591807,575,699.1,48.49568630612312,40.69104631965901,NaN,NaN,NaN,NaN,5.212564830856238,15.444437015289022,-123198,1.008766491133982,-1.996388308940368,-3.00515480007435
2025-09-11T23:05:00-04:00,24003.25,24004.5,24001.25,24002.5,NaN,NaN,NaN,24013.341624298086,NaN,NaN,24009.39,24024.55547394698,23994.224526053018,23995.462183079824,24010.747161414878,24018.196133947804,24003.298188881952,342,693.6666666666666,46.928171399548326,41.13609520503212,NaN,NaN,NaN,NaN,5.072381628652221,14.471786678862122,-123540,0.9420085568043639,-1.827644104068895,-2.769652660873259
2025-09-11T23:10:00-04:00,24002.75,24005.75,24002.5,24003,NaN,NaN,NaN,24013.341624298086,NaN,NaN,24009.22,24024.47733921237,23993.96266078763,23995.79763773687,24010.69846012374,24018.14422345687,24003.252696790605,357,687.6,47.836062221271725,41.508268016920724,NaN,NaN,NaN,NaN,4.94221151231992,13.690524376966154,-123183,0.9079435582788475,-1.6347232130246994,-2.542666771303547
2025-09-11T23:15:00-04:00,24003,24004.75,24002,24004.75,NaN,NaN,NaN,24013.341624298086,NaN,NaN,24009.185,24024.47513079623,23993.894869203774,23995.79763773687,24010.677244692364,24018.121253196234,24003.233236188495,159,679.1,50.995831185534556,42.37356447663557,NaN,NaN,NaN,NaN,4.78562497572564,12.801053796605649,-123024,0.973858294801837,-1.3253439028012508,-2.299202197603088
2025-09-11T23:20:00-04:00,24004.25,24007,24003.25,24006,NaN,NaN,NaN,24013.341624298086,NaN,NaN,24008.975,24024.14544824399,23993.804551756006,23997.6554881516,24010.642608897128,24018.074259114506,24003.21095867975,341,653.5333333333333,53.17753543818249,43.836516155184555,NaN,NaN,NaN,NaN,4.711651763173809,12.659731737038161,-122683,1.0648545809648402,-0.9681339713970374,-2.0329885523618776
2025-09-11T23:25:00-04:00,24005.75,24005.75,24000.25,24002.5,NaN,NaN,NaN,24013.341624298086,NaN,NaN,24008.66,24023.700531901126,23993.619468098874,23997.6554881516,24010.572378911384,24018.007178945983,24003.137578876784,470,654.3666666666667,46.88354590331879,45.094167571139444,NaN,NaN,NaN,NaN,4.78581949437568,11.950593747724126,-123153,0.8612403987247539,-0.9564380539559352,-1.817678452680689
2025-09-11T23:30:00-04:00,24002.5,24003.25,24001,24003,NaN,NaN,NaN,24013.341624298086,NaN,NaN,24008.275,24022.883644697737,23993.666355302266,23997.6554881516,24010.541441896523,24017.979044243504,24003.10383954954,199,642.4666666666667,47.83344314615462,46.495342934594554,NaN,NaN,NaN,NaN,4.6046895304917035,11.29210847193252,-122954,0.736951588522283,-0.8964889670278353,-1.6334405555501184
2025-09-11T23:35:00-04:00,24003,24003.5,24000.5,24002.75,NaN,NaN,NaN,24013.341624298086,NaN,NaN,24007.965,24022.370210858848,23993.559789141153,23997.6554881516,24010.49164108783,24017.934497638515,24003.048784537143,317,638.9666666666667,47.37722572441123,47.45904405870086,NaN,NaN,NaN,NaN,4.490068849742296,10.841116694696003,-123271,0.6193548999321097,-0.8592469306349813,-1.478601830567091
2025-09-11T23:40:00-04:00,24002.75,24003.75,24000.75,24002.75,NaN,NaN,NaN,24013.341624298086,NaN,NaN,24007.59,24021.53516403162,23993.64483596838,23997.6554881516,24010.46389098691,24017.908960030793,24003.018821943027,182,622.3666666666667,47.37722572441123,48.44131350253109,NaN,NaN,NaN,NaN,4.383635360474989,10.330234476220761,-123271,0.5266600971105766,-0.8202767091788701,-1.3469368062894467
2025-09-11T23:45:00-04:00,24003,24003,24000.25,24002,NaN,NaN,NaN,24013.341624298086,NaN,NaN,24007.25,24020.891480863622,23993.608519136378,23997.6554881516,24010.427679371707,24017.878380261198,24002.976978482217,221,609.1,45.85554783487999,48.6425925986612,NaN,NaN,NaN,NaN,4.266947120441062,10.033153040744795,-123492,0.405368915833763,-0.840225661497243,-1.245594577331006
2025-09-11T23:50:00-04:00,24002,24004.25,24001.5,24003.5,NaN,NaN,NaN,24013.341624298086,NaN,NaN,24006.905,24020.025933665747,23993.78406633425,23997.6554881516,24010.40029973773,24017.85055665316,24002.950042822296,199,597.4333333333333,49.35880280898568,48.67598366687979,NaN,NaN,NaN,NaN,4.158593754695271,9.367801306641956,-123293,0.4151781885289334,-0.7266218416698393,-1.1418000301987727
2025-09-11T23:55:00-04:00,24003.75,24010,24003.25,24008.5,NaN,NaN,NaN,24013.341624298086,NaN,NaN,24006.74,24019.56573974216,23993.914260257843,24000.18060982881,24010.356076837827,24017.763134809407,24002.949018866246,760,574,58.90392616022666,49.44195095553872,NaN,NaN,NaN,NaN,4.343694200788467,10.47503261642176,-122533,0.7290600159340382,-0.23047501028122497,-0.9595350262152632
2025-09-12T00:00:00-04:00,24008.75,24011.5,24007.5,24010.5,NaN,NaN,NaN,24013.341624298086,NaN,NaN,24006.535,24018.772650913794,23994.297349086206,24001.644487863046,24010.347557097954,24017.6943046759,24003.000809520006,897,571.9666666666667,61.99009077951689,50.134840122755065,NaN,NaN,NaN,NaN,4.319144615017862,11.84645875081948,-121636,1.0239597590131095,0.32041467255112366,-0.7035450864619859
2025-09-12T00:05:00-04:00,24010.5,24014.5,24010.25,24013.75,23997.68534257696,23997.68534257696,23997.68534257696,NaN,NaN,NaN,24006.425,24018.29692065819,23994.553079341807,24004.49059029044,24010.378996089126,24017.68441968661,24003.07357249164,705,577.0333333333333,66.40508689517549,51.3870129662672,NaN,NaN,NaN,NaN,4.3142057139451575,13.72820157216432,-120931,1.3689410359028442,1.0076312084165693,-0.3613098274862748
2025-09-12T00:10:00-04:00,24013.5,24018.75,24013.5,24015.75,24001.3871451871,NaN,NaN,NaN,NaN,NaN,24006.535,24018.646156012706,23994.423843987293,24008.117472232352,24010.474650395896,24017.754041688902,24003.19525910289,965,593.4666666666667,68.80630512199498,52.83777145311519,NaN,NaN,NaN,NaN,4.381048162949075,16.163982202267995,-119966,1.644335786051597,1.6941099050782213,0.04977411902662443
2025-09-12T00:15:00-04:00,24015.75,24016.5,24012.25,24013.25,24001.3871451871,NaN,NaN,NaN,NaN,NaN,24006.61,24018.839538001554,23994.380461998448,24008.117472232352,24010.507538302965,24017.760817502203,24003.254259103727,534,584.6,62.767035451274474,53.96911888538135,NaN,NaN,NaN,NaN,4.371687579881284,17.928789610696665,-120500,1.5707511404383112,2.0132130445745133,0.44246190413620223
2025-09-12T00:20:00-04:00,24013.25,24021.75,24012.5,24018,24001.88193394114,NaN,NaN,NaN,NaN,NaN,24006.71,24019.225334603398,23994.1946653966,24008.620182228704,24010.61647724016,24017.863638146657,24003.369316333665,917,599.7666666666667,68.43580926622712,55.440529388592445,NaN,NaN,NaN,NaN,4.72013846703262,20.308847555148454,-119583,1.7413884022261015,2.619197406918829,0.8778090046927276
2025-09-12T00:25:00-04:00,24018,24018.75,24015.75,24018.25,24002.290709671084,NaN,NaN,NaN,NaN,NaN,24006.815,24019.6242974126,23994.005702587398,24008.620182228704,24010.661702654685,24017.90693778165,24003.41646752772,380,589.3666666666667,68.70586632158997,56.70553189831069,NaN,NaN,NaN,NaN,4.597271433673147,22.51890136071083,-119203,1.7650056733850714,3.084066096424067,1.3190604230389955
2025-09-12T00:30:00-04:00,24018.5,24021.5,24017.5,24020.5,24004.675222867856,NaN,NaN,NaN,NaN,NaN,24006.855,24019.82152998709,23993.88847001291,24009.89691662637,24010.718226345904,24017.97667938292,24003.45977330889,363,585.7,71.1022282851811,57.98586710166773,NaN,NaN,NaN,NaN,4.5546091884107796,24.906615145420012,-118840,1.818848128972964,3.592620584255201,1.7737724552822367
2025-09-12T00:35:00-04:00,24020.75,24023.5,24018.5,24022.75,24006.167258192043,NaN,NaN,NaN,NaN,NaN,24006.94,24020.261621523437,23993.61837847656,24011.717533301096,24010.825438183612,24018.127399669636,24003.52347669759,587,573.6,73.30375681257831,59.87302502375769,NaN,NaN,NaN,NaN,4.58642281781001,27.34458009910452,-118253,1.8846671113077869,4.12960634441697,2.2449392331091835
2025-09-12T00:40:00-04:00,24022.75,24024.5,24021.25,24023.5,24008.273291910587,NaN,NaN,NaN,NaN,NaN,24007.215,24021.302941649723,23993.127058350277,24013.449026640876,24010.920511345,24018.273160941182,24003.56786174882,465,556.2,74.01440723453152,61.743093887213185,NaN,NaN,NaN,NaN,4.490964045109295,29.714930367281855,-117788,1.8545203754634105,4.563089702438447,2.708569326975036
2025-09-12T00:45:00-04:00,24023.5,24024.25,24020.5,24022.75,24008.273291910587,NaN,NaN,NaN,NaN,NaN,24007.385,24022.003553289465,23992.76644671053,24013.5342213127,24010.986764348185,24018.37018668208,24003.60334201429,345,515.9,71.95172761324011,63.49841545070096,NaN,NaN,NaN,NaN,4.438038041887203,31.588411956050983,-118133,1.6658512055506676,4.790883333913371,3.125032128362703
2025-09-12T00:50:00-04:00,24022.5,24025.5,24022.25,24023.5,24009.639249447457,NaN,NaN,NaN,NaN,NaN,24007.595,24022.819286507736,23992.370713492266,24015.30237705016,24011.07880691298,24018.51440225362,24003.643211572344,438,509.43333333333334,72.76899444680717,65.31211321658638,NaN,NaN,NaN,NaN,4.353178181752402,33.48155606649394,-117695,1.4796432785599802,4.974586226562678,3.494942948002698
2025-09-12T00:55:00-04:00,24023.5,24023.5,24018.25,24020.25,24009.639249447457,NaN,NaN,NaN,NaN,NaN,24007.72,24023.2521086746,23992.187891325404,24015.30237705016,24011.160197912588,24018.61623443741,24003.704161387766,520,506.4,64.05852655383381,66.61232598222594,NaN,NaN,NaN,NaN,4.417236883055802,33.61458379828168,-118215,1.0460962765714075,4.802563293716958,3.75646701714555
2025-09-12T01:00:00-04:00,24020.25,24025.75,24018,24024,24009.639249447457,NaN,NaN,NaN,NaN,NaN,24008.01,24024.192076521384,23991.827923478613,24015.30237705016,24011.290900777323,24018.803047459496,24003.77875409515,709,510.3,68.71226364064793,67.99471604163038,NaN,NaN,NaN,NaN,4.655291391408959,34.108392578753495,-117506,0.9245885660838691,4.9122027247503866,3.9876141586665175
2025-09-12T01:05:00-04:00,24024.25,24027.75,24021.75,24023.25,24009.889318569956,NaN,NaN,NaN,NaN,NaN,24008.29,24025.02330810451,23991.55669189549,24015.30237705016,24011.443426417663,24019.040891973556,24003.84596086177,738,503.8,66.84799275573337,68.56214936988087,NaN,NaN,NaN,NaN,4.7513420063083185,34.86972845185745,-118244,0.715743861724297,4.882293985821889,4.166550124097592
2025-09-12T01:10:00-04:00,24023.25,24028,24020.75,24024.75,24009.889318569956,NaN,NaN,NaN,NaN,NaN,24008.57,24025.915904407208,23991.224095592792,24015.30237705016,24011.594497953352,24019.275856450462,24003.913139456243,734,497.56666666666666,68.67834287195913,69.03988166219817,NaN,NaN,NaN,NaN,4.929817577286296,35.194467116775016,-117510,0.6050644246505996,4.922880654910841,4.317816230260242
2025-09-12T01:15:00-04:00,24024.5,24027.75,24022.75,24027.25,24010.08406919287,NaN,NaN,NaN,NaN,NaN,24008.905,24027.017120254885,23990.792879745113,24015.30237705016,24011.678217886438,24019.41452243559,24003.941913337287,373,494,71.50235612459728,69.40397232144258,NaN,NaN,NaN,NaN,4.934830607480132,35.496010162769906,-117137,0.6241536739230868,5.0980083226641,4.473854648741013
2025-09-12T01:20:00-04:00,24027.5,24029,24022.5,24025,24010.38706604774,NaN,NaN,NaN,NaN,NaN,24009.115,24027.718550727393,23990.51144927261,24015.30237705016,24011.79974032766,24019.60929130763,24003.99018934769,566,497.26666666666665,65.75609683929295,69.18610030124958,NaN,NaN,NaN,NaN,5.046628421231551,35.99610738775515,-117703,0.41902225615452604,4.997632468934171,4.578610212779645
2025-09-12T01:25:00-04:00,24025,24029.5,24022.75,24027.75,24010.539926681937,NaN,NaN,NaN,NaN,NaN,24009.37,24028.627268771837,23990.11273122816,24015.30237705016,24011.92953949361,24019.826974128664,24004.032104858554,567,497.5,69.03187604336172,69.63358891497009,NaN,NaN,NaN,NaN,5.168297819715012,36.54854139843159,-117136,0.4022402786524868,5.081410561095254,4.679170282442767
2025-09-12T01:30:00-04:00,24027.5,24034,24026.5,24028.75,24014.350611832757,NaN,NaN,NaN,NaN,NaN,24009.76,24029.766988782507,23989.75301121749,24018.44497237084,24012.301123742327,24020.520168766878,24004.082078717776,1383,524.4333333333333,70.15009364427542,69.7560377991164,NaN,NaN,NaN,NaN,5.334847975449654,37.7530130476124,-115753,0.39179412172399175,5.168912934597756,4.7771188128737645
2025-09-12T01:35:00-04:00,24028.75,24033.5,24024.5,24033.25,24014.350611832757,NaN,NaN,NaN,NaN,NaN,24010.25,24031.306590419972,23989.193409580028,24018.44497237084,24012.498337210694,24020.88588927518,24004.110785146207,730,537.3666666666667,74.59556803721514,70.17673077880393,NaN,NaN,NaN,NaN,5.596644548631822,38.03775505547127,-115023,0.6083355844994474,5.5375382934980735,4.929202708998626
2025-09-12T01:40:00-04:00,24033.25,24035.25,24032,24033.75,24017.52349136001,NaN,NaN,NaN,NaN,NaN,24010.78,24032.818974581936,23988.74102541806,24020.069782317336,24012.648476098817,24021.192930703786,24004.104021493848,479,541.4333333333333,75.04035869173995,70.45802580784384,NaN,NaN,NaN,NaN,5.429027080872406,38.58054500648729,-114544,0.6991398534090347,5.803127525759919,5.103987672350884
2025-09-12T01:45:00-04:00,24033.5,24039.5,24032.5,24037,24019.67583266183,NaN,NaN,NaN,NaN,NaN,24011.4,24034.58081102776,23988.21918897224,24023.85582585387,24012.91855988524,24021.778533463006,24004.05858630747,779,562.1,77.76540243699739,70.77671478101664,NaN,NaN,NaN,NaN,5.541239432238663,39.66278158027974,-113765,0.8802794696652869,6.204337009432493,5.324057539767206
2025-09-12T01:50:00-04:00,24037,24037.25,24033.75,24034.5,24019.67583266183,NaN,NaN,NaN,NaN,NaN,24011.975,24035.978385185874,23987.971614814123,24023.85582585387,24013.040020964057,24022.02657206824,24004.053469859875,375,563.2333333333333,71.31540118014296,70.58392863427459,NaN,NaN,NaN,NaN,5.395436615650186,40.66771554165845,-114140,0.7395859916239527,6.248540029297146,5.508954037673194
2025-09-12T01:55:00-04:00,24034.25,24036.5,24032.75,24035,24019.67583266183,NaN,NaN,NaN,NaN,NaN,24012.615,24037.323138330557,23987.906861669446,24023.85582585387,24013.161026580194,24022.267088492208,24004.05496466818,385,560.4,71.81884024995209,70.57443667975402,NaN,NaN,NaN,NaN,5.27790542881803,41.17209068954687,-113755,0.5943164749993439,6.251849631422374,5.65753315642303
2025-09-12T02:00:00-04:00,24035,24036.25,24025.5,24028.5,24019.67583266183,NaN,NaN,NaN,NaN,NaN,24013.09,24038.0865517527,23988.0934482473,24023.85582585387,24013.423440276318,24022.697398662298,24004.149481890337,1088,590.0333333333333,57.65284962902511,69.49471204991244,NaN,NaN,NaN,NaN,5.668769326759599,39.17503276776377,-114843,0.005715839961065505,5.664677956374362,5.658962116413297
2025-09-12T02:05:00-04:00,24028,24031.75,24024.75,24029.25,24019.67583266183,NaN,NaN,NaN,NaN,NaN,24013.58,24038.86229419641,23988.297705803594,24023.85582585387,24013.590755749763,24022.94840326485,24004.233108234675,783,605.5666666666667,58.665942345861765,69.10952746362872,NaN,NaN,NaN,NaN,5.763857231991056,37.1154732786528,-114060,-0.3672356983183285,5.199917493515386,5.5671531918337145
2025-09-12T02:10:00-04:00,24029.5,24029.5,24025.5,24029,24019.67583266183,NaN,NaN,NaN,NaN,NaN,24014.045,24039.58804015515,23988.501959844845,24023.85582585387,24013.667725186708,24023.059262204166,24004.27618816925,381,612.2,58.166413334621005,68.35625244176967,NaN,NaN,NaN,NaN,5.63786742970598,35.203025181621186,-114441,-0.6484524840339443,4.756587586791284,5.405040070825228
2025-09-12T02:15:00-04:00,24028.5,24030.5,24028,24028.75,24019.67583266183,NaN,NaN,NaN,NaN,NaN,24014.56,24040.229546159837,23988.890453840166,24023.85582585387,24013.777594495026,24023.225026807497,24004.330162182556,512,621.9,57.63788607403866,67.69838767879148,NaN,NaN,NaN,NaN,5.413734041869838,33.668927397208215,-114953,-0.8559519010650929,4.335100194493862,5.1910520955589545
2025-09-12T02:20:00-04:00,24028.25,24032,24024.5,24025.75,24019.67583266183,NaN,NaN,NaN,NaN,NaN,24015.125,24040.509690271338,23989.740309728662,24023.85582585387,24013.910330282317,24023.406546873877,24004.414113690756,706,638.8,51.58098265971362,66.47714766363107,NaN,NaN,NaN,NaN,5.562753038879135,31.295426269100872,-115659,-1.1799169252030275,3.71615593905517,4.896072864258198
2025-09-12T02:25:00-04:00,24025.25,24025.25,24013.25,24018.75,NaN,NaN,NaN,24036.652745679257,24036.652745679257,24036.652745679257,24015.625,24040.280273273107,23990.969726726893,24023.85582585387,24014.04635048254,24023.453374194254,24004.639326770823,1959,678.7666666666667,40.80577392757305,64.28453464955791,NaN,NaN,NaN,NaN,6.058270678959197,31.233916718927368,-117618,-1.8124789395969376,2.630474189762026,4.442953129358964
2025-09-12T02:30:00-04:00,24019,24024.5,24014.25,24014.75,NaN,NaN,NaN,24036.652745679257,NaN,NaN,24016.07,24039.82648121991,23992.31351878009,24023.85582585387,24014.11634675345,24023.449976085853,24004.782717421047,1403,695.6333333333333,36.15760056269408,62.170356344086564,NaN,NaN,NaN,NaN,6.357679916176396,31.17680070805197,-119021,-2.4097196253321798,1.430803597693739,3.8405232230259188
2025-09-12T02:35:00-04:00,24014.25,24015,24008.25,24009,NaN,NaN,NaN,24029.736282736678,NaN,NaN,24016.345,24039.440213785612,23993.24978621439,24023.212728546478,24014.066580137158,24023.339864167436,24004.79329610688,1139,710.1,30.737346875435833,59.435032832091856,NaN,NaN,NaN,NaN,6.385702779306654,31.9042737589478,-120160,-3.0597019161277843,0.015895827866188483,3.075597743993973
2025-09-12T02:40:00-04:00,24008.75,24014.25,24007.25,24008.5,NaN,NaN,NaN,24028.99258806683,NaN,NaN,24016.615,24039.01080540382,23994.219194596182,24023.212728546478,24014.01282921561,24023.236323568708,24004.789334862515,1032,712.3333333333334,30.311827852946777,56.58944241842553,NaN,NaN,NaN,NaN,6.429581152213322,32.69463286973872,-121192,-3.3666520628488845,-1.1327173345671326,2.233934728281752
2025-09-12T02:45:00-04:00,24008.25,24012.75,24006,24010.5,NaN,NaN,NaN,24027.708834063793,NaN,NaN,24016.825,24038.78638656304,23994.863613436963,24020.24518283718,24013.93947833275,24023.100062046615,24004.77889461889,1367,740.1,34.23376181875612,53.70645625996417,NaN,NaN,NaN,NaN,6.452468212769513,33.573549514205105,-119825,-3.2752880328003124,-1.8601753127186385,1.4151127200816738
2025-09-12T02:50:00-04:00,24010.5,24018.75,24010.5,24018,NaN,NaN,NaN,24027.708834063793,NaN,NaN,24017.11,24038.752818673012,23995.46718132699,24017.62242689011,24013.96365040136,24023.06525008558,24004.862050717144,1075,745.3666666666667,46.41291945743399,51.66163917179946,NaN,NaN,NaN,NaN,6.5808633404288335,32.78004039280772,-118750,-2.5805956518594204,-1.810631844742602,0.7699638071168186
2025-09-12T02:55:00-04:00,24017.75,24024.25,24015,24023.5,NaN,NaN,NaN,24027.708834063793,NaN,NaN,24017.515,24038.861055851565,23996.168944148434,24017.62242689011,24014.03915703353,24023.1198408686,24004.95847319846,884,762.1666666666666,53.25015491635407,49.910550063182086,NaN,NaN,NaN,NaN,6.771515958969631,30.87966937336473,-117866,-1.6659192996708,-1.3124353174716816,0.35348398219911853
2025-09-12T03:00:00-04:00,24023,24027.75,24017.5,24027.5,24003.05250870917,24003.05250870917,24003.05250870917,NaN,NaN,NaN,24017.945,24039.211943829723,23996.678056170276,24017.62242689011,24014.250802997864,24023.353875979545,24005.147730016182,1723,807.5,57.49749424688679,48.923556710806636,NaN,NaN,NaN,NaN,7.019979104757515,28.86649066351933,-116143,-0.7532396305763508,-0.5880655560213199,0.16517407455503083
2025-09-12T03:05:00-04:00,24027.5,24031.5,24019.5,24023.25,24005.180803767842,NaN,NaN,NaN,NaN,NaN,24018.335,24039.258816570877,23997.41118342912,24017.62242689011,24014.442382870173,24023.57083327777,24005.313932462577,1545,839.4333333333333,52.08312986616819,47.51386311196494,NaN,NaN,NaN,NaN,7.375694882989121,27.608179395706017,-117688,-0.41443456115986654,-0.3528691268948023,0.061565434265064195
2025-09-12T03:10:00-04:00,24023.5,24026.5,24020,24022.25,24005.180803767842,NaN,NaN,NaN,NaN,NaN,24018.71,24039.224960400985,23998.195039599013,24008.860892403038,24014.5322956956,24023.653608437635,24005.410982953566,908,854.2,50.86932113614765,47.029325362473685,NaN,NaN,NaN,NaN,7.3131452484898976,26.439747504165084,-118596,-0.24473170700913546,-0.24434919949635514,0.00038250751278032236
2025-09-12T03:15:00-04:00,24022,24024.25,24016,24023,24005.180803767842,NaN,NaN,NaN,NaN,NaN,24019.12,24039.136053563696,23999.103946436302,24008.860892403038,24014.629801125033,24023.71766550868,24005.541936741385,1293,885.8,51.7770433489448,46.537261148408184,NaN,NaN,NaN,NaN,7.380063445026333,24.575275884995104,-117303,-0.07767624461995266,-0.0967127982621605,-0.019036553642207844
2025-09-12T03:20:00-04:00,24023.25,24027.75,24019.75,24023.5,24005.180803767842,NaN,NaN,NaN,NaN,NaN,24019.53,24039.041955313256,24000.01804468674,24008.860892403038,24014.703162523932,24023.79031793611,24005.616007111756,711,894.9,52.408327074883914,46.12596927271267,NaN,NaN,NaN,NaN,7.4243446275244525,23.446326226427164,-116592,0.06318518443323343,0.05994492689933395,-0.0032402575338994835
2025-09-12T03:25:00-04:00,24023,24024.75,24017.5,24022.75,24005.180803767842,NaN,NaN,NaN,NaN,NaN,24019.89,24038.957029133544,24000.822970866455,24008.860892403038,24014.74661874667,24023.821958353987,24005.671279139355,550,895.9,51.32300465246822,45.674906314029066,NaN,NaN,NaN,NaN,7.411891439844134,21.968086219635236,-117142,0.10032842039618937,0.12217026796133723,0.02184184756514786
2025-09-12T03:30:00-04:00,24022.25,24023,24015,24018,24005.180803767842,NaN,NaN,NaN,NaN,NaN,24020.13,24038.789378338995,24001.470621661007,24008.860892403038,24014.79672039639,24023.824622900538,24005.76881789224,1141,910.3,44.97103529924903,45.202767216853026,NaN,NaN,NaN,NaN,7.453899194140981,20.658236633815733,-118283,-0.1849833315572985,-0.20938731688147527,-0.02440398532417677
2025-09-12T03:35:00-04:00,24017.75,24021.5,24015.75,24017.75,24005.180803767842,NaN,NaN,NaN,NaN,NaN,24020.435,24038.417994735875,24002.452005264127,24008.860892403038,24014.81782745055,24023.82287064356,24005.812784257545,536,903.5666666666667,44.657761300409085,45.4779091720556,NaN,NaN,NaN,NaN,7.332192108845197,19.441947732697624,-118819,-0.3698460078419832,-0.4867114951266558,-0.11686548728467258
2025-09-12T03:40:00-04:00,24017.5,24018.25,24006.75,24009,24005.180803767842,NaN,NaN,NaN,NaN,NaN,24020.555,24038.146841856775,24002.963158143226,24008.860892403038,24014.758372642806,24023.6976573828,24005.81908790281,1559,931.0666666666667,35.370538498538195,45.42169045318732,NaN,NaN,NaN,NaN,7.629892672499111,19.729872315712687,-120378,-1.0236655311431928,-1.3964474012136634,-0.3727818700704707
2025-09-12T03:45:00-04:00,24008.75,24017,24007.75,24015.5,24005.180803767842,NaN,NaN,NaN,NaN,NaN,24020.81,24037.718447588177,24003.901552411826,24008.860892403038,24014.74166675674,24023.626370427286,24005.856963086197,1152,957.0333333333333,44.58929928175567,46.41111562506732,NaN,NaN,NaN,NaN,7.745614624463461,19.99723085708382,-119226,-0.9615913071243525,-1.5747710039759113,-0.6131796968515588
2025-09-12T03:50:00-04:00,24015.75,24019.25,24014.5,24017.5,24005.180803767842,NaN,NaN,NaN,NaN,NaN,24021.105,24037.23977299857,24004.970227001428,24008.860892403038,24014.7611685138,24023.61135710439,24005.91097992321,777,964.0666666666667,47.090106521120525,47.609564101365436,NaN,NaN,NaN,NaN,7.5316421512875,19.74863687589555,-118449,-0.7390506109277691,-1.5369929605112702,-0.7979423495835011
2025-09-12T03:55:00-04:00,24017.25,24019,24008,24010.5,24005.180803767842,NaN,NaN,NaN,NaN,NaN,24021.275,24036.76733680919,24005.782663190814,24006.778776910356,24014.740468351745,24023.552685565865,24005.928251137626,862,973.9,40.2440432248958,48.0388699160897,NaN,NaN,NaN,NaN,7.779381997624107,20.407073735241728,-119311,-1.000273118268552,-2.048283747419191,-1.048010629150639
2025-09-12T04:00:00-04:00,24010.25,24019,24002.25,24004.75,NaN,NaN,NaN,24033.719828943602,24033.719828943602,24033.719828943602,24021.3,24036.68115731668,24005.918842683317,24006.778776910356,24014.577750330747,24023.32627127486,24005.829229386636,2592,1014.2,35.658144440247185,47.27067170057636,NaN,NaN,NaN,NaN,8.420140426365242,21.6496474827639,-121903,-1.4689634095120936,-2.884214891040756,-1.4152514815286623
2025-09-12T04:05:00-04:00,24004.5,24012.5,24002.25,24004.75,NaN,NaN,NaN,24030.817791264348,NaN,NaN,24021.225,24036.889051206206,24005.56094879379,24006.778776910356,24014.485312448916,24023.22595979371,24005.74466510412,1120,1027.2,35.658144440247185,46.01409952371158,NaN,NaN,NaN,NaN,8.550844681624868,22.803465962605916,-121903,-1.672821337138903,-3.506278152952291,-1.833456815813388
2025-09-12T04:10:00-04:00,24003.5,24004.75,23984.5,23984.75,NaN,NaN,NaN,24019.763573479606,NaN,NaN,24020.71,24039.190627703905,24002.229372296093,24004.348021528283,24013.64348446808,24023.256095355828,24004.030873580334,3693,1134.3333333333333,24.428762680464317,43.65204726896712,NaN,NaN,NaN,NaN,9.386498632937377,25.24378196596107,-125596,-2.972541478631334,-5.5491336641025555,-2.5765921854712213
2025-09-12T04:15:00-04:00,23985,23985.25,23968.75,23978.25,NaN,NaN,NaN,24003.245911048714,NaN,NaN,24020,24041.905935266168,23998.094064733832,24002.678417222625,24012.106823081667,24024.01437578959,24000.199270373745,4499,1258.3333333333333,22.003509382099068,41.50350294867646,NaN,NaN,NaN,NaN,9.894605873441849,28.208960974228976,-130095,-4.02267986304186,-7.604942014273547,-3.582262151231687
2025-09-12T04:20:00-04:00,23978.5,23987,23973.25,23986.5,NaN,NaN,NaN,24003.245911048714,NaN,NaN,24019.415,24043.223319966448,23995.606680033554,24002.3677337781,24011.424658049582,24024.01243572826,23998.836880370905,2480,1328.5,31.323000925550332,40.10733721934809,NaN,NaN,NaN,NaN,10.169991168196002,30.64673015065261,-127615,-3.9108562055094023,-8.47083240811844,-4.559976202609038
2025-09-12T04:25:00-04:00,23986.5,23992.5,23985.5,23991,NaN,NaN,NaN,24003.245911048714,NaN,NaN,24018.97,24044.021874177077,23993.918125822926,23999.69927969439,24011.09225196865,24023.86540353814,23998.31910039916,1684,1371.8,35.82714007704307,38.968058414212244,NaN,NaN,NaN,NaN,9.943563227610573,31.95604162825602,-125931,-3.307001838880761,-8.69372850120999,-5.386726662329228
2025-09-12T04:30:00-04:00,23991,23994,23989.5,23991.25,NaN,NaN,NaN,24003.245911048714,NaN,NaN,24018.435,24044.661858365205,23992.208141634797,23999.69927969439,24010.94104726841,24023.77910985484,23998.10298468198,861,1364.2333333333333,36.07796072716994,37.80160367508982,NaN,NaN,NaN,NaN,9.554737282781247,32.92067728559031,-125070,-2.6900949448274414,-8.74934534336353,-6.059250398536088
2025-09-12T04:35:00-04:00,23991,24000.5,23985,23995.25,NaN,NaN,NaN,24003.245911048714,NaN,NaN,24017.975,24044.99355844663,23990.956441553368,23999.69927969439,24010.668064366557,24023.586564639332,23997.74956409378,1775,1397.3,40.111271213503066,37.0007655723066,NaN,NaN,NaN,NaN,9.979398905439728,32.78556309580679,-123295,-1.8518987483833982,-8.374123834015336,-6.522225085631938
2025-09-12T04:40:00-04:00,23995.5,23998.75,23992.5,23998.5,NaN,NaN,NaN,24003.245911048714,NaN,NaN,24017.535,24045.086045353644,23989.983954646355,23997.85942375551,24010.581493662787,24023.5071935646,23997.655793760972,698,1407.8666666666666,43.244738848320445,36.877458682954554,NaN,NaN,NaN,NaN,9.713013269336889,32.66009991957924,-122597,-0.9625847299724173,-7.725455998097459,-6.762871268125042
2025-09-12T04:45:00-04:00,23998.75,24001,23996,23998.5,NaN,NaN,NaN,24003.245911048714,NaN,NaN,24017.05,24045.06660221776,23989.033397782237,23993.71253900441,24010.485765432855,24023.40463838327,23997.566892482442,907,1421.0333333333333,43.244738848320445,36.776528507805374,NaN,NaN,NaN,NaN,9.376369464384254,32.185096337647536,-122597,-0.29306384353570625,-7.129201072544674,-6.836137229008968
2025-09-12T04:50:00-04:00,23998.75,24000,23994,23997,NaN,NaN,NaN,24003.245911048714,NaN,NaN,24016.52,24045.026813222066,23988.013186777935,23987.145031203527,24010.396702970873,24023.31909444842,23997.474311493326,761,1422.8666666666666,42.06660443721791,37.25481893199678,NaN,NaN,NaN,NaN,9.135200216928236,31.93095600568226,-123358,0.1085390307385854,-6.700463440585736,-6.809002471324321
2025-09-12T04:55:00-04:00,23997.75,24002.75,23996.25,24002.75,NaN,NaN,NaN,24003.245911048714,NaN,NaN,24016.12,24044.82648707768,23987.413512922318,23982.1634801397,24010.32769835525,24023.230659168305,23997.424737542195,816,1384.7666666666667,47.92346532308458,37.49297364923456,NaN,NaN,NaN,NaN,8.946971630004791,31.23770604490737,-122542,0.7835940794063294,-5.82950987206641,-6.613103951472739
2025-09-12T05:00:00-04:00,24002.5,24005,23998.5,24002.25,23976.583178680685,23976.583178680685,23976.583178680685,NaN,NaN,NaN,24015.695,24044.58051367051,23986.80948632949,23985.28078411176,24010.25776156009,24023.12964686264,23997.38587625754,973,1370.4333333333334,47.4740180412316,37.52039590067106,NaN,NaN,NaN,NaN,8.772187942147307,30.227207151850894,-123515,1.1940097839394657,-5.120591721548408,-6.3146015054878735
2025-09-12T05:05:00-04:00,24002.25,24005.5,24000.25,24002.75,23978.13621601338,NaN,NaN,NaN,NaN,NaN,24015.345,24044.42469910524,23986.265300894764,23987.099627289408,24010.217188500395,24023.06551827675,23997.36885872404,643,1353.9,47.99921850148857,38.07433699185626,NaN,NaN,NaN,NaN,8.520603089136785,29.205637853012647,-122872,1.4781362790699877,-4.466931156650389,-5.945067435720377
2025-09-12T05:10:00-04:00,24002.5,24004.5,24001.25,24004.25,23978.81752437641,NaN,NaN,NaN,NaN,NaN,24014.95,24044.08520206995,23985.814797930052,23988.15470183153,24010.196132674708,24023.030428398608,23997.361836950808,361,1331.5333333333333,49.62648655679379,39.072075714466735,NaN,NaN,NaN,NaN,8.144131439912728,28.257037789805693,-122511,1.7286614562406628,-3.7842406154195487,-5.5129020716602115
2025-09-12T05:15:00-04:00,24004.25,24005.25,24000.25,24002.5,23979.104227813845,NaN,NaN,NaN,NaN,NaN,24014.535,24043.77641070603,23985.29358929397,23989.673761465223,24010.166900174147,24022.98481301196,23997.348987336332,460,1301.3,47.74913249274156,39.93571771821633,NaN,NaN,NaN,NaN,7.919550622776105,27.511716343055408,-122971,1.7336456579860542,-3.3458449991776433,-5.0794906571636975
2025-09-12T05:20:00-04:00,24002.25,24002.75,23996.75,24001.25,23979.104227813845,NaN,NaN,NaN,NaN,NaN,24014.065,24043.389871697756,23984.74012830224,23989.673761465223,24010.101133384756,24022.901804120975,23997.300462648538,791,1291.8333333333333,46.398934937482885,41.505015736574805,NaN,NaN,NaN,NaN,7.782439864006384,27.279776731469536,-123762,1.612425755935722,-3.0639584622440452,-4.676384218179767
2025-09-12T05:25:00-04:00,24001.5,24003.75,23999.75,24002.25,23979.104227813845,NaN,NaN,NaN,NaN,NaN,24013.565,24042.82603382177,23984.303966178228,23989.673761465223,24010.062274531403,24022.84490831021,23997.279640752597,569,1281.3333333333333,47.67368961704729,43.3386000390711,NaN,NaN,NaN,NaN,7.512265588005929,26.85535216816039,-123193,1.5583728133095667,-2.7284182015428087,-4.286791014852375
2025-09-12T05:30:00-04:00,24002,24007.5,24001.25,24001.5,23981.690881271978,NaN,NaN,NaN,NaN,NaN,24013.095,24042.361173309226,23983.828826690777,23992.879965870194,24010.01448777107,24022.76345166935,23997.26552387279,868,1252.8333333333333,46.7751964827567,44.442328293157274,NaN,NaN,NaN,NaN,7.42210376029122,25.708478600560674,-124061,1.434019605631959,-2.4942665078124264,-3.9282861134443854
2025-09-12T05:35:00-04:00,24001.25,24003.5,23995.75,24002.75,23981.690881271978,NaN,NaN,NaN,NaN,NaN,24012.595,24041.696355635147,23983.493644364855,23992.879965870194,24009.933572865764,24022.65674057241,23997.21040515912,1054,1236.4666666666667,48.51674442007727,45.348728603374006,NaN,NaN,NaN,NaN,7.445524920270418,25.41215440049453,-123007,1.3964892612734494,-2.1826745368525735,-3.579163798126023
2025-09-12T05:40:00-04:00,24002.5,24009.25,24000.75,24007.75,23982.16333396889,NaN,NaN,NaN,NaN,NaN,24012.175,24040.935780593758,23983.41421940624,23992.879965870194,24009.890494373805,24022.552016581318,23997.228972166293,1320,1250.2,54.876864447186435,46.69150744051804,NaN,NaN,NaN,NaN,7.520844568822531,24.09870629147351,-121687,1.6514785660798035,-1.5148155905262684,-3.166294156606072
2025-09-12T05:45:00-04:00,24007.75,24015,24006.75,24014.75,23987.95136424303,NaN,NaN,NaN,NaN,NaN,24011.805,24039.940971641976,23983.669028358025,23997.50954252554,24009.912688962726,24022.514314787015,23997.311063138437,1212,1247.5,61.96174612120286,48.252255648210884,NaN,NaN,NaN,NaN,7.572927099620921,22.747802122166007,-120475,2.2003178331532247,-0.41589686516454094,-2.6162146983177657
2025-09-12T05:50:00-04:00,24014.5,24019.5,24012.75,24015.5,23993.322893141074,NaN,NaN,NaN,NaN,NaN,24011.44,24038.892970700814,23983.987029299184,24002.132634020432,24009.95937075088,24022.5229836917,23997.39575781006,974,1256.2666666666667,62.638614477001795,49.63753247883097,NaN,NaN,NaN,NaN,7.514146592505141,22.08745740924709,-119501,2.5006901341831425,0.5096479694111622,-1.99104216477198
2025-09-12T05:55:00-04:00,24016,24017.25,24008.5,24010.75,23993.322893141074,NaN,NaN,NaN,NaN,NaN,24010.915,24037.378864043287,23984.451135956715,24002.132634020432,24009.97238534343,24022.50004476606,23997.4447259208,743,1262.7,55.85915555209448,50.53856224338626,NaN,NaN,NaN,NaN,7.602421835897631,20.810206502897465,-120244,2.2728854124864233,0.8500646008360491,-1.4228208116503742
2025-09-12T06:00:00-04:00,24010.75,24011.5,24005.25,24007.25,23993.322893141074,NaN,NaN,NaN,NaN,NaN,24010.37,24035.977077150437,23984.76292284956,24002.132634020432,24009.959695392787,24022.44798520527,23997.471405580305,816,1251.8666666666666,51.44118353189654,51.208175035863306,NaN,NaN,NaN,NaN,7.505820276190657,19.4936991414443,-121060,1.8005631795351456,0.8278831627685577,-0.9726800167665879
2025-09-12T06:05:00-04:00,24007.25,24013.5,24006.25,24011.5,23993.322893141074,NaN,NaN,NaN,NaN,NaN,24009.9,24034.525393385095,23985.27460661491,24002.132634020432,24009.962460097282,24022.41296557022,23997.511954624344,772,1259.7333333333333,55.99272630605155,51.78455082036095,NaN,NaN,NaN,NaN,7.4875473993198955,18.22529950499235,-120288,1.6902250664339358,1.1401013162758318,-0.550123750158104
2025-09-12T06:10:00-04:00,24011.25,24014.25,24008.75,24012,23993.322893141074,NaN,NaN,NaN,NaN,NaN,24009.57,24033.625153287496,23985.514846712504,24002.132634020432,24009.969707965593,24022.394204652723,23997.545211278462,545,1225.9333333333334,56.509206444539366,52.42992142059722,NaN,NaN,NaN,NaN,7.345579727939904,17.159616224185033,-119743,1.5693870889274508,1.4116101110012096,-0.15777697792624124
2025-09-12T06:15:00-04:00,24012.25,24014.75,24010.25,24011.75,23993.322893141074,NaN,NaN,NaN,NaN,NaN,24009.22,24032.619923072998,23985.820076927004,24002.132634020432,24009.97726324086,24022.381851992326,23997.572674489395,426,1201.7333333333333,56.15433818076107,53.01242996911668,NaN,NaN,NaN,NaN,7.142324033087054,16.248363136285843,-120169,1.3968623277915027,1.5883009318131371,0.19143860402163448
2025-09-12T06:20:00-04:00,24012,24015.25,24010.25,24010.25,23993.322893141074,NaN,NaN,NaN,NaN,NaN,24008.845,24031.5557661726,23986.1342338274,24002.132634020432,24009.98423707929,24022.367047288066,23997.601426870515,464,1191.3,53.964596810271615,53.322294987222236,NaN,NaN,NaN,NaN,6.98930088786655,15.48457137151608,-120633,1.1180295135076503,1.5889754959061975,0.47094598239854707
2025-09-12T06:25:00-04:00,24010.25,24016.5,24010.25,24015.5,23993.322893141074,NaN,NaN,NaN,NaN,NaN,24008.58,24030.65587822607,23986.504121773934,24002.132634020432,24010.00002766284,24022.361572528735,23997.63848279695,499,1179.2,59.86386081454897,54.1876327244942,NaN,NaN,NaN,NaN,6.936493681590369,14.987539370355204,-120134,1.215402763265888,1.990199436480907,0.7747966732150191
2025-09-12T06:30:00-04:00,24016,24022.25,24012,24018,23995.130203157038,NaN,NaN,NaN,NaN,NaN,24008.425,24030.122062019684,23986.727937980315,24004.908295496098,24010.072765933597,24022.395238098325,23997.75029376887,1283,1135.5666666666666,62.33880476790024,55.32619485523829,NaN,NaN,NaN,NaN,7.173172704333914,15.40689774509801,-118851,1.3652014947423048,2.4812985416429,1.1160970469005953
2025-09-12T06:35:00-04:00,24018.25,24020.25,24016.5,24016.75,23996.868603013536,NaN,NaN,NaN,NaN,NaN,24008.385,24030.01303968113,23986.756960318868,24004.908295496098,24010.108255973224,24022.41366474231,23997.802847204137,601,1118.2666666666667,60.33545377555024,56.230606580845645,NaN,NaN,NaN,NaN,6.928660368310063,15.796301950216332,-119452,1.2975789958016974,2.738070791652717,1.4404917958510197
2025-09-12T06:40:00-04:00,24016.75,24021,24016.5,24019.25,23997.607530149286,NaN,NaN,NaN,NaN,NaN,24008.475,24030.245220488418,23986.70477951158,24006.151309117504,24010.141308797338,24022.435410345075,23997.8472072496,495,1011.6666666666666,62.90318674327556,57.382605885168424,NaN,NaN,NaN,NaN,6.7551846277164875,16.270876953850742,-118957,1.3335847592315053,3.1074727448904014,1.773887985658896
2025-09-12T06:45:00-04:00,24019.5,24022,24018,24021.25,23999.273096960682,NaN,NaN,NaN,NaN,NaN,24008.72,24030.782103246303,23986.6578967537,24008.121047294,24010.21086130479,24022.492216790906,23997.929505818673,899,891.6666666666666,64.86288043144,58.55018702883718,NaN,NaN,NaN,NaN,6.558385725736739,16.866110910359396,-118058,1.3977068869512714,3.5210215943479852,2.123314707396714
2025-09-12T06:50:00-04:00,24021.75,24023,24017.25,24018.25,23999.556138007923,NaN,NaN,NaN,NaN,NaN,24008.915,24031.13764835373,23986.69235164627,24009.0218378352,24010.259494081733,24022.52698823816,23997.991999925303,699,832.3,59.763000772539556,58.89919676636241,NaN,NaN,NaN,NaN,6.500643888184115,17.575911237690974,-118757,1.1538164434063352,3.5655852616546326,2.4117688182482975
2025-09-12T06:55:00-04:00,24018,24024.25,24017.75,24022.75,24000.479722643926,NaN,NaN,NaN,NaN,NaN,24009.16,24031.714768904727,23986.605231095273,24009.81747026816,24010.317379414162,24022.58009781958,23998.054661008744,686,799.0333333333333,64.29758278125948,59.06604224208075,NaN,NaN,NaN,NaN,6.500597896170964,18.43254552589096,-118071,1.2056575250087294,3.9188407245092094,2.71318319950048
2025-09-12T07:00:00-04:00,24023,24024,24015.75,24019,24000.479722643926,NaN,NaN,NaN,NaN,NaN,24009.18,24031.767837437535,23986.592162562465,24009.81747026816,24010.400924900317,24022.639616742686,23998.16223305795,1221,811.0333333333333,58.39192958121273,58.76270760666724,NaN,NaN,NaN,NaN,6.625555189301609,18.662319272841764,-119292,0.9108961382696954,3.8518033723375993,2.940907234067904
2025-09-12T07:05:00-04:00,24019.5,24022,24009.5,24013.5,24000.479722643926,NaN,NaN,NaN,NaN,NaN,24008.98,24031.231705554357,23986.728294445642,24009.81747026816,24010.458341233272,24022.631112987085,23998.28556947946,1712,808.9333333333333,50.99402550427315,58.41519831753715,NaN,NaN,NaN,NaN,7.04515839006578,17.39326119630538,-121004,0.3005858899063498,3.316639596450841,3.0160537065444912
2025-09-12T07:10:00-04:00,24014,24018.25,24012.5,24013.75,24000.479722643926,NaN,NaN,NaN,NaN,NaN,24008.705,24030.366414990604,23987.0435850094,24009.81747026816,24010.480718167117,24022.626330019157,23998.335106315077,705,809.1666666666666,51.296077570244016,58.40483360599054,NaN,NaN,NaN,NaN,6.9526470764896535,16.214850125235888,-120299,-0.10924432911456972,2.8794982951512793,2.988742624265849
2025-09-12T07:15:00-04:00,24014,24015.25,24011.5,24012,24000.479722643926,NaN,NaN,NaN,NaN,NaN,24008.48,24029.762819356765,23987.197180643234,24009.81747026816,24010.490609879173,24022.61252655302,23998.368693205324,562,797.6666666666666,49.018488250660496,57.90667374489118,NaN,NaN,NaN,NaN,6.723886571026107,15.213831729633458,-120861,-0.4993199101023911,2.36459273663786,2.863912646740251
2025-09-12T07:20:00-04:00,24012.5,24021.5,24009.5,24021,24000.479722643926,NaN,NaN,NaN,NaN,NaN,24008.455,24029.675907132558,23987.234092867446,24009.81747026816,24010.542814820663,24022.63307172428,23998.452557917044,1064,807.7666666666667,59.08098169108648,58.0903719767874,NaN,NaN,NaN,NaN,7.100751815952813,15.219601026868427,-119797,-0.16938732303798743,2.6521784929427668,2.821565815980754
2025-09-12T07:25:00-04:00,24020.75,24026.5,24019.75,24025.5,24001.665474170586,NaN,NaN,NaN,NaN,NaN,24008.505,24029.87401728242,23987.135982717584,24009.81747026816,24010.638027452074,24022.73752932295,23998.5385255812,1000,813.9,63.012027580967626,58.58020693394501,NaN,NaN,NaN,NaN,7.075698114813326,16.002595509308776,-118797,0.30774340427443025,3.206245071323792,2.898501667049362
2025-09-12T07:30:00-04:00,24025.25,24028,24022,24023.25,24003.69772534465,NaN,NaN,NaN,NaN,NaN,24008.5,24029.855093068443,23987.144906931557,24010.16633514078,24010.769194291075,24022.88506795877,23998.65332062338,1350,826.4666666666667,59.91277459774651,59.005076775907504,NaN,NaN,NaN,NaN,6.998862535183803,16.939878742219015,-120147,0.4206524528090858,3.4243172330607194,3.0036647802516336
2025-09-12T07:35:00-04:00,24023,24029,24020.75,24028,24003.69772534465,NaN,NaN,NaN,NaN,NaN,24008.605,24030.288424541985,23986.921575458015,24010.608068112626,24010.887572004947,24023.02949542017,23998.745648589724,1117,842.2666666666667,63.94458287937554,59.29655692339511,NaN,NaN,NaN,NaN,7.088229496956388,17.491611832548813,-119030,0.7451204250276242,3.935065311536164,3.1899448865085396
2025-09-12T07:40:00-04:00,24028.25,24028.75,24024.25,24028.75,24005.4027828037,NaN,NaN,NaN,NaN,NaN,24008.82,24031.0773673181,23986.5626326819,24011.7864544901,24010.978192301092,24023.14718432663,23998.809200275555,796,856.7666666666667,64.5508335600777,59.45455897997922,NaN,NaN,NaN,NaN,6.9033559614595035,18.00393541642648,-118234,0.928211349335665,4.350209073178121,3.421997723842456
2025-09-12T07:45:00-04:00,24028.75,24035.5,24027.25,24032,24010.111747221712,NaN,NaN,NaN,NaN,NaN,24009.105,24032.162989945893,23986.047010054106,24017.80416359208,24011.241722074166,24023.552329679143,23998.93111446919,1862,903.5,67.13004862938611,59.93988718382464,NaN,NaN,NaN,NaN,6.999544821355253,19.436748001634925,-116372,1.1705205282605418,4.885148384168133,3.714627855907591
2025-09-12T07:50:00-04:00,24032,24035.25,24029.75,24035,24011.453258711634,NaN,NaN,NaN,NaN,NaN,24009.625,24033.79590192931,23985.45409807069,24018.343330873664,24011.411420100194,24023.82540482238,23998.99743537801,1127,914.7,69.34709961617736,60.400166674746195,NaN,NaN,NaN,NaN,6.892434476972736,20.767216830757057,-115245,1.418622045368081,5.4879054126176925,4.069283367249612
2025-09-12T07:55:00-04:00,24034.75,24048,24034.5,24044.5,24019.31901967929,NaN,NaN,NaN,NaN,NaN,24010.205,24036.232425908707,23984.177574091296,24027.72466469893,24012.088005093436,24025.172294258,23999.00371592887,3282,1005.1333333333333,75.07932711154754,61.12991286618245,NaN,NaN,NaN,NaN,7.364403442903255,23.24308376350292,-111963,2.0689296845532787,6.65544547294121,4.586515788387931
2025-09-12T08:00:00-04:00,24044.5,24047,24029,24029.75,24019.31901967929,NaN,NaN,NaN,NaN,NaN,24010.45,24036.97338591221,23983.92661408779,24027.72466469893,24012.509620167824,24025.838911278264,23999.180329057384,2781,1068.9,57.19530109074798,60.94650574605448,NaN,NaN,NaN,NaN,8.12408891126731,24.262665396127108,-114744,1.384948271167568,6.317701127347391,4.932752856179823
2025-09-12T08:05:00-04:00,24030,24037,24024.5,24031.5,24019.31901967929,NaN,NaN,NaN,NaN,NaN,24010.87,24038.04043246651,23983.699567533487,24027.72466469893,24012.839013751294,24026.273560380872,23999.404467121716,2771,1126.1333333333334,58.459590236321404,60.529506278558905,NaN,NaN,NaN,NaN,8.43665398903393,24.30394496131363,-111973,0.9503506407585594,6.120691157128022,5.170340516369462
2025-09-12T08:10:00-04:00,24031.25,24034.25,24028.75,24032.5,24019.31901967929,NaN,NaN,NaN,NaN,NaN,24011.425,24039.199673713396,23983.650326286603,24027.72466469893,24012.962153389883,24026.439569351063,23999.484737428702,1015,1115.9666666666667,59.20115563801008,60.58730813975871,NaN,NaN,NaN,NaN,8.226892989817221,24.342275986129682,-110958,0.6448149708670154,5.976359229953232,5.3315442590862165
2025-09-12T08:15:00-04:00,24032.5,24044,24032.25,24043.25,24019.31901967929,NaN,NaN,NaN,NaN,NaN,24012.195,24041.290066593916,23983.099933406083,24027.72466469893,24013.301587026304,24027.02572792438,23999.577446128227,2003,1142.3333333333333,66.18882162796727,61.67265072002258,NaN,NaN,NaN,NaN,8.478543490544563,25.387543316430623,-108955,1.0569420806425667,6.652721859889425,5.595779779246858
2025-09-12T08:20:00-04:00,24042.75,24044,24035.75,24038.75,24019.31901967929,NaN,NaN,NaN,NaN,NaN,24013.275,24042.22344555083,23984.326554449173,24027.72466469893,24013.567021973908,24027.471238312963,23999.662805634853,1623,1163.9666666666667,61.444683550947744,62.3975511472157,NaN,NaN,NaN,NaN,8.462218955505666,26.358148694567213,-110578,0.9216535751506019,6.747846748185111,5.826193173034509
2025-09-12T08:25:00-04:00,24038.75,24042,24027.25,24037,24019.31901967929,NaN,NaN,NaN,NaN,NaN,24014.45,24042.367378102437,23986.532621897564,24027.72466469893,24013.962778509915,24028.04525223245,23999.88030478738,2955,1237.7,59.65398552828625,63.15722952418896,NaN,NaN,NaN,NaN,8.911346172969546,25.673372548022915,-113533,0.6237455547957564,6.605875116529205,5.982129561733449
2025-09-12T08:30:00-04:00,24036.5,24038.75,24014.75,24027.25,NaN,NaN,NaN,24053.546741288366,24053.546741288366,24053.546741288366,24015.265,24042.23413235991,23988.29586764009,24027.72466469893,24014.34969742559,24028.394446387803,24000.304948463378,5023,1377.9333333333334,50.77541977986992,62.563975101959215,NaN,NaN,NaN,NaN,9.989107160614578,24.32593743425769,-118556,-0.272435349147762,5.641585375298746,5.914020724446508
2025-09-12T08:35:00-04:00,24027.5,24032.5,24020,24029,NaN,NaN,NaN,24053.546741288366,NaN,NaN,24016.025,24042.350130575353,23989.69986942465,24027.72466469893,24014.59226065464,24028.612673608743,24000.57184770054,3244,1460.3333333333333,52.151949876517214,61.78825526592704,NaN,NaN,NaN,NaN,10.16845664914211,23.074747685761405,-115312,-0.7620987530253327,4.9613972831648425,5.723496036190175
2025-09-12T08:40:00-04:00,24028.75,24036.75,24024.5,24031.75,NaN,NaN,NaN,24053.546741288366,NaN,NaN,24016.835,24042.546205730585,23991.123794269413,24027.72466469893,24014.77176231526,24028.819340958646,24000.724183671875,1896,1505.3666666666666,54.314001881871405,61.38834292907882,NaN,NaN,NaN,NaN,10.31713831706053,21.502869379288672,-113416,-0.9057412576228261,4.591319464161643,5.497060721784469
2025-09-12T08:45:00-04:00,24032,24039.75,24031.5,24038.75,NaN,NaN,NaN,24053.546741288366,NaN,NaN,24017.705,24043.379635336496,23992.030364663507,24021.779731759147,24014.983826467735,24029.126716078485,24000.840936856985,1695,1547.6666666666667,59.3492459579591,61.060104577549076,NaN,NaN,NaN,NaN,10.169485580127636,20.41843492646671,-111721,-0.5516851498750874,4.80745428444061,5.359139434315697
2025-09-12T08:50:00-04:00,24038.75,24043.25,24036.5,24042.5,NaN,NaN,NaN,24053.546741288366,NaN,NaN,24018.585,24044.580501532568,23992.58949846743,24019.884778128544,24015.31921642387,24029.670068064323,24000.96836478342,2308,1609.1333333333334,61.77950005681577,60.862152184458935,NaN,NaN,NaN,NaN,9.92523661011852,19.829887927127647,-109413,-0.11039140550929272,5.221150177429081,5.331541582938374
2025-09-12T08:55:00-04:00,24042.5,24044.5,24040.5,24042,NaN,NaN,NaN,24053.546741288366,NaN,NaN,24019.455,24045.614642572647,23993.295357427356,24020.541199422183,24015.563197561016,24030.075892598343,24001.05050252369,1616,1646.3666666666666,61.25367815609425,60.44241143636666,NaN,NaN,NaN,NaN,9.502005423681481,19.43070685559121,-111029,0.0914743852481461,5.445884564498556,5.35441017925041
2025-09-12T09:00:00-04:00,24041.75,24053.75,24038.5,24043.25,24018.33631887525,24018.33631887525,24018.33631887525,NaN,NaN,NaN,24020.38,24046.56897477142,23994.19102522858,24026.957959537747,24016.259671847543,24031.28618591616,24001.233157778926,4311,1747.3,62.121658574441526,59.926308504814095,NaN,NaN,NaN,NaN,9.91257646484709,20.02579007589304,-106718,0.24416165791044353,5.659612251638464,5.41545059372802
2025-09-12T09:05:00-04:00,24043.5,24051,24042.75,24050.75,24019.224440744554,NaN,NaN,NaN,NaN,NaN,24021.34,24048.378816541837,23994.301183458163,24026.957959537747,24016.75053286477,24032.169462981292,24001.33160274825,2863,1822.7,66.91122372983928,59.3428725489778,NaN,NaN,NaN,NaN,9.793821003072297,20.578367351887593,-103855,0.7563245740934494,6.360856311344833,5.604531737251383
2025-09-12T09:10:00-04:00,24050.75,24051.75,24046.25,24048.25,24021.856284347075,NaN,NaN,NaN,NaN,NaN,24022.26,24049.764356021937,23994.75564397806,24028.553094104158,24017.121876648645,24032.82949821409,24001.4142550832,2185,1879.0333333333333,64.00593815694114,59.829346625134455,NaN,NaN,NaN,NaN,9.487119502852847,21.166854016408262,-106040,0.8270509781901483,6.638345459989068,5.81129448179892
2025-09-12T09:15:00-04:00,24048.25,24050,24045.75,24047.75,24021.856284347075,NaN,NaN,NaN,NaN,NaN,24023.16,24050.994827110804,23995.325172889196,24029.317475283326,24017.43028945579,24033.356002619334,24001.50457629225,1910,1912.7333333333333,63.41290066126361,60.18315451263033,NaN,NaN,NaN,NaN,9.113039538363358,21.61780206106851,-107950,0.7431362447442247,6.740214787729201,5.997078542984976
2025-09-12T09:20:00-04:00,24048.25,24049.25,24044.5,24046.75,24021.856284347075,NaN,NaN,NaN,NaN,NaN,24024.01,24052.077767993273,23995.942232006724,24030.328980226663,24017.68347858722,24033.771510680966,24001.595446493473,1652,1944.5,62.17218379283186,60.39537080940331,NaN,NaN,NaN,NaN,8.80139385705169,21.78900001241765,-109602,0.5330918014442911,6.663443294790341,6.1303514933460495
2025-09-12T09:25:00-04:00,24046.5,24049,24037.75,24040.25,24021.856284347075,NaN,NaN,NaN,NaN,NaN,24024.765,24052.50673930651,23997.023260693488,24030.328980226663,24018.39302263577,24034.774757332823,24002.011287938716,5686,2111.1666666666665,54.68283389636494,59.57351454286029,NaN,NaN,NaN,NaN,8.976294295833712,20.738735547138678,-115288,-0.09720959870315493,6.008839494967106,6.1060490936702605
2025-09-12T09:30:00-04:00,24040.5,24063.5,24026.25,24034.5,24021.856284347075,NaN,NaN,NaN,NaN,NaN,24025.43,24052.470347628954,23998.389652371046,24030.328980226663,24021.79744022789,24038.986731353405,24004.608149102372,34277,3213.0333333333333,49.05349812581831,58.688429869636764,NaN,NaN,NaN,NaN,10.99584470327416,21.356360612580296,-149565,-0.909793668549943,4.968807007982832,5.878600676532775
2025-09-12T09:35:00-04:00,24034.5,24035.5,24002,24013.5,NaN,NaN,NaN,24052.119726338984,24052.119726338984,24052.119726338984,24025.655,24052.100772820075,23999.209227179923,24030.328980226663,24021.214940540038,24037.402932772104,24005.026948307972,32036,4223.833333333333,34.91613443660577,56.921440505945306,NaN,NaN,NaN,NaN,12.603284367326006,20.52118328075638,-181601,-2.765177754105859,2.422128483900451,5.18730623800631
2025-09-12T09:40:00-04:00,24013.25,24034,24007.25,24030.5,NaN,NaN,NaN,24052.119726338984,NaN,NaN,24026.235,24051.793444785726,24000.676555214275,24030.328980226663,24021.39797606303,24037.042743995822,24005.753208130234,19174,4839.466666666666,47.98508343939084,56.72213076733965,NaN,NaN,NaN,NaN,13.61376405537415,19.745661472634165,-162427,-2.7455327629598596,1.7553902843064861,4.500923047266346
2025-09-12T09:45:00-04:00,24030,24039.25,24020,24026.75,NaN,NaN,NaN,24052.119726338984,NaN,NaN,24026.715,24051.37691597782,24002.05308402218,24030.328980226663,24021.85357667626,24037.102227867075,24006.604925485448,18926,5451.6,45.800327459322254,56.268443451825725,NaN,NaN,NaN,NaN,14.016352337133139,18.47376407878313,-181353,-2.8696445944706896,0.9138673041779839,3.7835118986486735
2025-09-12T09:50:00-04:00,24026.5,24034.25,24011,24025.5,NaN,NaN,NaN,24052.119726338984,NaN,NaN,24027.07,24051.133466089843,24003.006533910157,24030.328980226663,24021.942264308043,24036.799758418903,24007.084770197183,16318,5960.066666666667,45.063801703762046,55.60771486767506,NaN,NaN,NaN,NaN,14.675898598766485,18.09876819110897,-197671,-2.9112696100558004,0.144424886078923,3.0556944961347234
2025-09-12T09:55:00-04:00,24025.75,24049.75,24025.25,24046,NaN,NaN,NaN,24052.119726338984,NaN,NaN,24027.695,24052.067379856624,24003.322620143375,24030.328980226663,24022.93076041422,24037.966808505862,24007.894712322577,18078,6529.333333333333,57.21544267434528,55.45530034741693,NaN,NaN,NaN,NaN,15.377620127426022,17.283970880720993,-179593,-1.5043418749870425,1.1752671524009202,2.6796090273879627
2025-09-12T10:00:00-04:00,24044.75,24055.25,24018,24049,23997.8645989937,23997.8645989937,23997.8645989937,NaN,NaN,NaN,24028.365,24053.197078046458,24003.532921953545,24030.328980226663,24023.872478950183,24039.039169507596,24008.70578839277,18767,7109.9,58.65667439561477,55.23224137161686,NaN,NaN,NaN,NaN,16.93993297546702,16.191692809066733,-160826,-0.3766232330283694,2.2088299861025007,2.58545321913087
2025-09-12T10:05:00-04:00,24049.5,24058.25,24046.25,24057.5,24009.65090528145,NaN,NaN,NaN,NaN,NaN,24029.3,24054.916791364067,24003.68320863593,24030.328980226663,24024.967837875975,24040.888450224753,24009.047225527196,13398,7519.266666666666,62.510071252494726,55.32198373564546,NaN,NaN,NaN,NaN,16.587080620076517,15.147832776322026,-147428,0.8688312353964411,3.6714922633764218,2.8026610279799806
2025-09-12T10:10:00-04:00,24057.5,24061,24028.25,24031.25,24009.65090528145,NaN,NaN,NaN,NaN,NaN,24029.78,24054.61357404639,24004.946425953607,24028.26554734506,24025.824349470146,24041.68204459145,24009.966654348842,22007,8226.3,47.71834738289177,54.29317579339191,NaN,NaN,NaN,NaN,17.741574861499622,15.291382592017651,-169435,-0.0968526021189069,2.681595275331347,2.7784478774502537
2025-09-12T10:15:00-04:00,24031.25,24056.25,24026.5,24054,24009.65090528145,NaN,NaN,NaN,NaN,NaN,24030.63,24055.809602859266,24005.450397140736,24028.26554734506,24026.781955223094,24042.822019104682,24010.741891341506,19890,8827.233333333334,57.17616849069907,53.59781470488189,NaN,NaN,NaN,NaN,18.59931951424965,15.536784673997515,-149545,0.7294739232878049,3.69029028156001,2.960816358272205
2025-09-12T10:20:00-04:00,24053.75,24074,24050.5,24071.5,24014.05372218365,NaN,NaN,NaN,NaN,NaN,24031.82,24058.91631709485,24004.72368290515,24011.813817069866,24028.830921630422,24046.674730116785,24010.98711314406,23037,9557.566666666668,62.7573225961799,53.508627879113234,NaN,NaN,NaN,NaN,18.94936812037468,14.54343406569488,-126508,2.298975071592081,5.834535197762307,3.5355601261702256
2025-09-12T10:25:00-04:00,24071,24076.5,24065.75,24071.75,24023.653552993484,NaN,NaN,NaN,NaN,NaN,24033.02,24061.721540027396,24004.318459972605,24021.37605365589,24030.02071275065,24048.958551037627,24011.082874463675,12483,9864.266666666666,62.83184658997794,53.46712401687854,NaN,NaN,NaN,NaN,18.363698968919348,13.799140834644108,-114025,3.1459133020912526,7.467951753784291,4.322038451693039
2025-09-12T10:30:00-04:00,24071.75,24084.5,24064.5,24079.75,24026.459073311962,NaN,NaN,NaN,NaN,NaN,24034.41,24065.220186628118,24003.599813371882,24030.400842924715,24031.821371176888,24052.428971577934,24011.21377077584,18073,10374,65.22957447058783,53.68550906528968,NaN,NaN,NaN,NaN,18.480577613996534,13.65816930027769,-95952,3.982981914360807,9.300765844644047,5.31778393028324
2025-09-12T10:35:00-04:00,24080,24088.25,24076.75,24081.5,24035.0745699796,NaN,NaN,NaN,NaN,NaN,24035.73,24068.761627266715,24002.698372733284,24039.22067433977,24033.03650094432,24054.810863048722,24011.262138839917,11476,10664.166666666666,65.7500751210846,54.476026295626795,NaN,NaN,NaN,NaN,17.981964927282498,13.772726048724063,-84476,4.362045500963882,10.770340806488093,6.408295305524211
2025-09-12T10:40:00-04:00,24082,24087.25,24075.25,24081.5,24035.0745699796,NaN,NaN,NaN,NaN,NaN,24037,24072.029701681913,24001.970298318087,24042.026539471815,24033.82780351018,24056.27654496061,24011.37906205975,7920,10894.333333333334,65.7500751210846,55.66863893814582,NaN,NaN,NaN,NaN,17.55468171819089,13.743163677612888,-84476,4.312546375200164,11.798978274524416,7.486431899324252
2025-09-12T10:45:00-04:00,24081.75,24096.5,24079.25,24095,24040.748730084717,NaN,NaN,NaN,NaN,NaN,24038.565,24076.691081632685,24000.438918367312,24051.696231577454,24035.31672510957,24059.242417051268,24011.39103316787,13102,11264.3,69.79536747676703,58.160012726728766,NaN,NaN,NaN,NaN,17.53291873832011,14.327250174368409,-71374,4.848736565944142,13.54735260675443,8.698616040810288
2025-09-12T10:50:00-04:00,24094.75,24107.25,24091,24107,24051.924924171777,NaN,NaN,NaN,NaN,NaN,24040.32,24082.58228105499,23998.05771894501,24063.28198526196,24037.100619663815,24063.031200913938,24011.170038413693,13700,11666.866666666667,72.86351377161371,59.93704346474469,NaN,NaN,NaN,NaN,17.441281685582958,15.48344543556792,-57674,5.617139750615937,15.72004072908021,10.102900978464273
2025-09-12T10:55:00-04:00,24107,24115.75,24100.25,24106,24060.831745800333,NaN,NaN,NaN,NaN,NaN,24042.015,24087.73834305591,23996.29165694409,24072.82558820957,24039.13275094944,24067.266935334097,24010.998566564784,15202,12075.1,72.2052878994281,61.82311206760939,NaN,NaN,NaN,NaN,17.30261870804132,16.98235610537191,-72876,5.648376349148023,17.163371414899302,11.514995065751279
2025-09-12T11:00:00-04:00,24106.25,24111.25,24085.25,24086.25,24060.831745800333,NaN,NaN,NaN,NaN,NaN,24043.375,24090.221371257343,23996.528628742657,24072.82558820957,24040.681393250918,24069.87473275794,24011.488053743895,15189,12413.966666666667,60.56781848028606,62.930541837361105,NaN,NaN,NaN,NaN,17.92386022889551,17.009102915376804,-88065,4.006478749840756,16.523093503052223,12.516614753211467
2025-09-12T11:05:00-04:00,24086.75,24096,24083,24092.25,24060.831745800333,NaN,NaN,NaN,NaN,NaN,24044.765,24093.17908989539,23996.350910104607,24072.82558820957,24041.683043833164,24071.413518132544,24011.952569533783,11111,12676.2,62.542932432999955,63.31107682012215,NaN,NaN,NaN,NaN,17.572155926831545,16.848500002812266,-76954,3.036137302388207,16.311786381196725,13.275649078808518
2025-09-12T11:10:00-04:00,24092.75,24099,24080.75,24095.5,24060.831745800333,NaN,NaN,NaN,NaN,NaN,24046.295,24096.168609255757,23996.42139074424,24072.82558820957,24042.621362360343,24072.844432695187,24012.3982920255,10537,12964.233333333334,63.6063022536134,63.664621667122056,NaN,NaN,NaN,NaN,17.62057336062929,16.886814715022826,-66417,2.3551625962487677,16.219602324119478,13.86443972787071
2025-09-12T11:15:00-04:00,24095,24105.5,24087.5,24088.25,24060.831745800333,NaN,NaN,NaN,NaN,NaN,24047.79,24098.1210401212,23997.4589598788,24072.82558820957,24043.713430175958,24074.512246234426,24012.91461411749,12271,13316.766666666666,59.545263739743156,63.452849701925516,NaN,NaN,NaN,NaN,17.64767526344148,17.317890407804338,-78688,1.215801814907632,15.384191996505251,14.16839018159762
2025-09-12T11:20:00-04:00,24088.5,24093,24079,24092.25,24060.831745800333,NaN,NaN,NaN,NaN,NaN,24049.36,24100.240169022425,23998.479830977576,24072.82558820957,24044.607012482506,24075.724743599414,24013.489281365597,11808,13633.433333333332,61.02383654998093,64.40324178528903,NaN,NaN,NaN,NaN,17.38712703033852,16.960934341757568,-66880,0.5640383565871936,14.87343812733161,14.309399770744417
2025-09-12T11:25:00-04:00,24092.25,24098.75,24086,24087,24060.831745800333,NaN,NaN,NaN,NaN,NaN,24050.86,24101.668184375932,24000.05181562407,24072.82558820957,24045.226658214488,24076.585354325976,24013.867962103,8010,13846.566666666668,58.02618364434838,64.46395715340684,NaN,NaN,NaN,NaN,17.055903671028624,16.99970599611529,-74890,-0.33954097634175184,13.884973550317227,14.224514526658979
2025-09-12T11:30:00-04:00,24087,24097,24077.25,24093.25,24060.831745800333,NaN,NaN,NaN,NaN,NaN,24052.305,24103.739841305145,24000.870158694855,24072.82558820957,24045.953894779752,24077.553235491785,24014.35455406772,10002,14036.266666666666,60.51298738893323,64.30364749574635,NaN,NaN,NaN,NaN,17.24833912309801,16.294410608282725,-64888,-0.618909482796278,13.450877673163632,14.06978715595991
2025-09-12T11:35:00-04:00,24092.75,24096.25,24082,24086,24060.831745800333,NaN,NaN,NaN,NaN,NaN,24053.515,24105.216393598777,24001.81360640122,24072.82558820957,24046.353566300728,24078.0667155845,24014.640417016955,5788,14133.766666666666,56.34290207784417,63.84015145916538,NaN,NaN,NaN,NaN,17.034172042876722,15.639493462438203,-70676,-1.3525176190795456,12.379140132110479,13.731657751190024
2025-09-12T11:40:00-04:00,24085.5,24091.75,24076.5,24080.25,24060.831745800333,NaN,NaN,NaN,NaN,NaN,24054.655,24106.15003762679,24003.159962373207,24072.82558820957,24046.804317274444,24078.57752982188,24015.031104727008,7633,14315.366666666667,53.21097198433924,62.981679853004756,NaN,NaN,NaN,NaN,16.906731182671244,14.568486318158588,-78309,-2.2335682475545546,10.93969744174683,13.173265689301385
2025-09-12T11:45:00-04:00,24080.5,24083.5,24072,24080.5,24060.831745800333,NaN,NaN,NaN,NaN,NaN,24055.705,24107.12412970319,24004.285870296815,24063.910470567655,24047.3258632458,24079.096256276425,24015.55547021517,10280,14594.366666666667,53.3324352164877,62.09470557410497,NaN,NaN,NaN,NaN,16.52053609819473,13.84556325765459,-68029,-2.7728501071436735,9.707203055371792,12.480053162515466
2025-09-12T11:50:00-04:00,24080.25,24090.25,24079.25,24089,24060.831745800333,NaN,NaN,NaN,NaN,NaN,24056.91,24108.56924505746,24005.25075494254,24060.80216093064,24047.80354904561,24079.666846822685,24015.940251268534,7820,14799.966666666667,57.383270027009765,61.49707663881391,NaN,NaN,NaN,NaN,16.12621209118082,13.102676355347226,-60209,-2.5368322645724373,9.309012831799919,11.845845096372356
2025-09-12T11:55:00-04:00,24088.75,24099.75,24087.75,24090.75,24060.831745800333,NaN,NaN,NaN,NaN,NaN,24058.085,24110.09582675812,24006.07417324188,24064.973532592,24048.391165970796,24080.454578192846,24016.327753748745,8423,14891.2,58.18797084948517,60.667976879722346,NaN,NaN,NaN,NaN,15.831482656096478,13.121590149805657,-51786,-2.2522313109385994,9.030555957699107,11.282787268637707
2025-09-12T12:00:00-04:00,24090.75,24092.25,24074.25,24080.5,24060.831745800333,NaN,NaN,NaN,NaN,NaN,24058.995,24110.950508850015,24007.039491149982,24064.973532592,24048.82051209356,24080.90550373904,24016.73552044808,8254,14023.766666666666,51.99516094084929,59.17738024895346,NaN,NaN,NaN,NaN,15.986376752089587,12.329941915896347,-60040,-2.7127773318484643,7.891815603827126,10.60459293567559
2025-09-12T12:05:00-04:00,24080.25,24091.5,24071.25,24091.25,24060.831745800333,NaN,NaN,NaN,NaN,NaN,24059.93,24112.487591266916,24007.372408733085,24064.973532592,24049.260830549418,24081.391676478946,24017.12998461989,8115,13226.4,57.146393915782156,58.101744964407324,NaN,NaN,NaN,NaN,16.290921269797472,11.815234766690978,-51925,-2.2698705486244144,7.7672547498950735,10.037125298519488
2025-09-12T12:10:00-04:00,24091.25,24101.75,24090,24097.75,24060.831745800333,NaN,NaN,NaN,NaN,NaN,24061.29,24114.171599826015,24008.408400173987,24064.973532592,24049.813879310568,24082.157724534118,24017.47003408702,7826,12848.133333333333,59.94518499018433,58.057271143685774,NaN,NaN,NaN,NaN,15.966569750526224,11.38513866480771,-44099,-1.5499665331028751,8.099667132140894,9.649633665243769
2025-09-12T12:15:00-04:00,24097.5,24107.25,24097.5,24101,24060.831745800333,NaN,NaN,NaN,NaN,NaN,24062.68,24116.008138913083,24009.351861086918,24072.342558949684,24050.360625624802,24082.969440064204,24017.7518111854,7089,12453.566666666668,61.30594651849699,57.96891500693556,NaN,NaN,NaN,NaN,15.522529054060064,11.366742437541841,-37010,-0.8980592969326722,8.527059544077929,9.425118841010601
2025-09-12T12:20:00-04:00,24101,24106.75,24091.5,24104.25,24060.831745800333,NaN,NaN,NaN,NaN,NaN,24064.115,24117.97623002424,24010.253769975763,24072.342558949684,24050.97197809323,24083.849599071953,24018.094357114504,8283,12185.733333333334,62.67163286713173,57.902152907901154,NaN,NaN,NaN,NaN,15.503062693055773,10.854609594269217,-28727,-0.3208983204951892,9.023995940391615,9.344894260886804
2025-09-12T12:25:00-04:00,24104.5,24106.5,24101,24105.25,24060.831745800333,NaN,NaN,NaN,NaN,NaN,24065.355,24120.085438517744,24010.624561482255,24075.309237727797,24051.236951471197,24084.246178385496,24018.2277245569,3418,11697.066666666668,63.10314932249917,58.15628759238372,NaN,NaN,NaN,NaN,14.788558214980359,10.379057668373209,-25309,0.036299064913873025,9.390268092029146,9.353969027115273
2025-09-12T12:30:00-04:00,24105,24112.5,24102,24110.25,24063.24061819566,NaN,NaN,NaN,NaN,NaN,24066.785,24122.38949711842,24011.18050288158,24082.297390182237,24051.77543835375,24085.08802667318,24018.46285003432,6553,11289.933333333332,65.265256191536,58.45924613820908,NaN,NaN,NaN,NaN,14.482232628196048,10.399054627304652,-18756,0.49209057804415224,9.969082249670464,9.476991671626312
2025-09-12T12:35:00-04:00,24110.5,24111,24097,24098.5,24063.24061819566,NaN,NaN,NaN,NaN,NaN,24068.015,24123.650457219625,24012.379542780374,24082.297390182237,24052.221684211734,24085.720772879904,24018.722595543564,6199,11049.966666666667,56.836428371212364,58.37426361869937,NaN,NaN,NaN,NaN,14.44778744046776,9.966459890107673,-24955,-0.08428180684673237,9.371639413067896,9.455921219914629
2025-09-12T12:40:00-04:00,24098.25,24102,24096.25,24100.75,24063.24061819566,NaN,NaN,NaN,NaN,NaN,24069.485,24124.61615362391,24014.353846376092,24082.297390182237,24052.505323169804,24086.103790194407,24018.9068561452,4210,10456.733333333334,57.95616728062982,58.191633610963414,NaN,NaN,NaN,NaN,13.826516909005777,9.496672304605369,-20745,-0.3837407451195425,8.976245288515202,9.359986033634744
2025-09-12T12:45:00-04:00,24101,24110.25,24096.75,24104.75,24063.24061819566,NaN,NaN,NaN,NaN,NaN,24071,24125.7597479917,24016.2402520083,24082.297390182237,24053.02592534285,24086.84780837426,24019.204042311438,7204,10033.866666666667,59.94552374623768,58.44896373013438,NaN,NaN,NaN,NaN,13.803194272648222,9.734362814554943,-13541,-0.3813820329191824,8.883258492485766,9.264640525404948
2025-09-12T12:50:00-04:00,24105.25,24114.25,24102,24111.5,24065.7855675727,NaN,NaN,NaN,NaN,NaN,24072.595,24127.33464650749,24017.855353492512,24084.930011018645,24053.409980934808,24087.43279022939,24019.387171640225,4893,9429.066666666668,63.117023869925255,59.15653886481909,NaN,NaN,NaN,NaN,13.692251824601922,10.257189803712413,-8648,-0.013605689874014004,9.247633413062431,9.261239102936445
2025-09-12T12:55:00-04:00,24111.75,24124.75,24107.25,24110.5,24073.198723592122,NaN,NaN,NaN,NaN,NaN,24074.03,24128.907102696445,24019.152897303553,24092.544008814915,24054.33060132768,24088.900790286443,24019.76041236892,11021,9380.333333333334,62.32963518262912,59.79919600525777,NaN,NaN,NaN,NaN,13.964233837130354,11.45727599875911,-19669,0.06937201677618354,9.347954123906675,9.278582107130491
2025-09-12T13:00:00-04:00,24110.5,24112.25,24101.25,24101.75,24073.198723592122,NaN,NaN,NaN,NaN,NaN,24075.215,24129.87595590371,24020.55404409629,24092.544008814915,24054.730881632808,24089.45590826654,24020.005854999075,5782,8970.633333333333,55.773292054771,59.684197578669284,NaN,NaN,NaN,NaN,13.7525028487639,11.944559031197608,-25451,-0.5252513803398422,8.622017881705688,9.14726926204553
2025-09-12T13:05:00-04:00,24102.25,24104.75,24098,24098.75,24073.198723592122,NaN,NaN,NaN,NaN,NaN,24076.35,24130.559962190946,24022.14003780905,24092.544008814915,24055.01399150038,24089.81695452611,24020.211028474645,4563,8740.2,53.68811410677397,59.36277923990419,NaN,NaN,NaN,NaN,13.252324073852193,12.06970613645973,-30014,-1.1452621598444601,7.715691562239954,8.860953722084414
2025-09-12T13:10:00-04:00,24098.75,24106.25,24097.5,24105,24073.198723592122,NaN,NaN,NaN,NaN,NaN,24077.585,24131.535311396834,24023.634688603164,24092.544008814915,24055.28364163665,24090.173070277197,24020.394212996107,4176,8615.4,57.272142230490985,59.739706474878595,NaN,NaN,NaN,NaN,12.930729497148466,12.302384089376707,-25838,-1.1557595947734374,7.416254228617618,8.572013823391055
2025-09-12T13:15:00-04:00,24105,24111,24098.75,24100.75,24073.198723592122,NaN,NaN,NaN,NaN,NaN,24078.585,24132.361910472682,24024.808089527316,24092.544008814915,24055.647379246682,24090.654451299386,24020.64030719398,5639,8366.633333333333,54.20046518395496,59.5292829940338,NaN,NaN,NaN,NaN,12.882105961637862,12.884541632248245,-31477,-1.4511268408583948,6.758105272318062,8.209232113176457
2025-09-12T13:20:00-04:00,24101.25,24106.75,24099.25,24105.5,24073.198723592122,NaN,NaN,NaN,NaN,NaN,24079.73,24133.312164942497,24026.1478350575,24092.544008814915,24055.832064960756,24090.898618831623,24020.76551108989,2876,8005.833333333333,56.977715082038806,59.31732085773769,NaN,NaN,NaN,NaN,12.497669821520873,13.425116493486103,-28601,-1.3318949406571177,6.544363437355059,7.876258378012177
2025-09-12T13:25:00-04:00,24105.5,24106,24099.75,24100.75,24073.198723592122,NaN,NaN,NaN,NaN,NaN,24080.79,24133.89445931904,24027.685540680963,24092.544008814915,24055.982612086784,24091.09131103511,24020.873913138457,2446,7580.633333333333,53.484944009884934,58.758677821408256,NaN,NaN,NaN,NaN,12.051407691412239,13.927078864635542,-31047,-1.5622828091964234,5.923404866516648,7.485687675713072
2025-09-12T13:30:00-04:00,24101,24107.5,24098.25,24099.5,24073.198723592122,NaN,NaN,NaN,NaN,NaN,24081.845,24134.29439370473,24029.39560629527,24092.544008814915,24056.191337219094,24091.355360499136,24021.027313939052,3449,7189.3,52.571635163365194,58.03724941399637,NaN,NaN,NaN,NaN,11.85130714202565,14.393186780702877,-34496,-1.7728056808540869,5.269680574645463,7.04248625549955
2025-09-12T13:35:00-04:00,24099.5,24104,24091.5,24098.5,24073.198723592122,NaN,NaN,NaN,NaN,NaN,24083.01,24134.286598954808,24031.73340104519,24092.544008814915,24056.580033134087,24091.80945921745,24021.350607050725,7097,7055.5,51.80943394864718,57.23055545872122,NaN,NaN,NaN,NaN,11.897642346166675,13.933779384852516,-41593,-1.9398466018046143,4.617678003243782,6.557524605048396
2025-09-12T13:40:00-04:00,24098,24105.25,24097.75,24103.5,24073.198723592122,NaN,NaN,NaN,NaN,NaN,24084.39,24134.058919862076,24034.721080137922,24092.544008814915,24056.755167967935,24092.029769151923,24021.480566783946,2944,6802.4,55.29913903865811,56.51868994780137,NaN,NaN,NaN,NaN,11.583525035726199,13.640393835125872,-38649,-1.683550031641741,4.45308706549622,6.136637097137961
2025-09-12T13:45:00-04:00,24103,24114.5,24102.75,24113.5,24073.198723592122,NaN,NaN,NaN,NaN,NaN,24086.39,24132.398277516306,24040.381722483693,24089.46254348412,24057.16698532345,24092.6152442986,24021.7187263483,5945,6591.533333333334,61.330435297502795,56.8396904425364,NaN,NaN,NaN,NaN,11.595416104602899,14.26341995122677,-32704,-0.852423743016514,5.071107418367319,5.923531161383833
2025-09-12T13:50:00-04:00,24113.75,24121.75,24110.75,24117.75,24079.07597686768,NaN,NaN,NaN,NaN,NaN,24088.135,24132.105013647077,24044.16498635292,24096.220034787297,24057.69092533337,24093.418685084365,24021.963165582372,6851,6426.3,63.57956019446659,57.24136136495332,NaN,NaN,NaN,NaN,11.552886382845548,15.424352236320562,-25853,-0.06958305739608317,5.836552339638729,5.906135397034812
2025-09-12T13:55:00-04:00,24118,24129,24116.75,24124,24085.720250646424,NaN,NaN,NaN,NaN,NaN,24090.08,24131.54907763147,24048.610922368534,24102.451027829837,24058.542722639515,24094.80572470444,24022.27972057459,10256,6501.166666666667,66.65139419222069,57.72035211109496,NaN,NaN,NaN,NaN,11.602680212642294,17.006660683418936,-15597,0.7697492668818464,6.86832198063712,6.098572713755273
2025-09-12T14:00:00-04:00,24124,24124.75,24113,24113.75,24085.720250646424,NaN,NaN,NaN,NaN,NaN,24091.845,24129.506636973918,24054.183363026084,24102.451027829837,24059.00098356164,24095.48907801555,24022.51288910773,6219,6375.066666666667,58.00999762858587,57.35556452242787,NaN,NaN,NaN,NaN,11.613203054596415,17.949542912431195,-21816,0.5457444012053321,6.780753215261939,6.235008814056607
2025-09-12T14:05:00-04:00,24113.5,24121.25,24113,24120.25,24085.720250646424,NaN,NaN,NaN,NaN,NaN,24093.33,24129.468406160147,24057.191593839856,24102.451027829837,24059.2773034109,24095.902915005598,24022.651691816205,3733,6306.566666666667,61.42546088873688,57.29098064429271,NaN,NaN,NaN,NaN,11.372974264982386,18.82507641079972,-18083,0.7347050973992104,7.15339018580562,6.418685088406409
2025-09-12T14:10:00-04:00,24120.75,24125,24115.75,24123.75,24085.720250646424,NaN,NaN,NaN,NaN,NaN,24094.825,24129.665529562433,24059.98447043757,24102.451027829837,24059.598616193303,24096.40076382865,24022.796468557957,4149,6190.433333333333,63.16297231932508,57.818814948903714,NaN,NaN,NaN,NaN,11.221333246055071,19.9296665809781,-13934,0.9794714423774931,7.643024391378276,6.663552949000783
2025-09-12T14:15:00-04:00,24124,24124,24116.5,24120.5,24085.720250646424,NaN,NaN,NaN,NaN,NaN,24096.085,24129.978894732525,24062.191105267473,24102.451027829837,24059.84577306528,24096.77592784539,24022.915618285173,3283,5957.2,60.44055098576337,58.30113186883154,NaN,NaN,NaN,NaN,10.955523728479708,20.9553574532866,-17217,0.8133829863047755,7.680281681881752,6.866898695576976
2025-09-12T14:20:00-04:00,24120.5,24124.5,24118.5,24121.75,24086.803561111912,NaN,NaN,NaN,NaN,NaN,24097.895,24127.085767370805,24068.704232629196,24102.451027829837,24060.05117441857,24097.09085080054,24023.0114980366,2693,5786.3,61.13440708995871,58.57700793022209,NaN,NaN,NaN,NaN,10.601557747874015,21.949857490024222,-14524,0.6838109546524844,7.721662388892582,7.037851434240098
2025-09-12T14:25:00-04:00,24122,24126.25,24120.5,24122.25,24089.47158106137,NaN,NaN,NaN,NaN,NaN,24099.26,24126.425411840217,24072.09458815978,24105.632626239425,24060.344005017923,24097.54485346319,24023.143156572656,3783,5631.633333333333,61.4258544786472,59.09310716555725,NaN,NaN,NaN,NaN,10.255017908740157,23.025345990581737,-10741,0.5344972990431511,7.705973058044037,7.171475759000886
2025-09-12T14:30:00-04:00,24122,24137.5,24119.5,24132,24093.683100104034,NaN,NaN,NaN,NaN,NaN,24100.47,24127.969207259805,24072.970792740198,24112.00610099154,24061.1190670595,24098.822635037628,24023.41549908137,9195,5663,66.67391112384905,59.78569259711513,NaN,NaN,NaN,NaN,10.808230915258719,24.85424128892969,-1546,0.9697324074053979,8.383641268257634,7.413908860852236
2025-09-12T14:35:00-04:00,24132,24141,24128.75,24139.25,24099.970231917487,NaN,NaN,NaN,NaN,NaN,24101.82,24130.161496076205,24073.478503923794,24114.47988079323,24061.679055387336,24099.79441597964,24023.563694795033,6169,5598.133333333333,69.94802168342746,60.96162671665388,NaN,NaN,NaN,NaN,10.911214421311668,26.76613131267925,4623,1.586781237001886,9.397385407104593,7.810604170102708
2025-09-12T14:40:00-04:00,24139,24143,24135.5,24139.25,24104.909085012147,NaN,NaN,NaN,NaN,NaN,24103.01,24132.517449906605,24073.50255009339,24118.033904634587,24062.280628973527,24100.85285907425,24023.708398872805,6476,5553.133333333333,69.94802168342746,62.202797182372606,NaN,NaN,NaN,NaN,10.667556248360835,28.660985938455248,4623,1.8191460073899055,10.08453667934009,8.265390671950184
2025-09-12T14:45:00-04:00,24139,24141.75,24118,24129.25,24104.909085012147,NaN,NaN,NaN,NaN,NaN,24103.965,24133.715799985755,24074.214200014245,24118.033904634587,24062.956866767676,24101.918360098836,24023.995373436515,8465,5599,60.448043626317606,62.819840730777635,NaN,NaN,NaN,NaN,11.60201651633506,27.728918518743644,-3842,1.1558944769025299,9.710258768078347,8.554364291175817
2025-09-12T14:50:00-04:00,24129.25,24158.5,24129.25,24153.5,24105.504972087514,NaN,NaN,NaN,NaN,NaN,24105.405,24137.54125522964,24073.268744770357,24118.396698966135,24064.189769041477,24104.164146393043,24024.21539168991,12546,5741.1,70.80359049948407,63.927301549408064,NaN,NaN,NaN,NaN,12.86258676516827,28.081969671218243,8704,2.1491772096286788,11.240835803211667,9.091658593582988
2025-09-12T14:55:00-04:00,24153.75,24159,24150,24154,24116.64679153808,NaN,NaN,NaN,NaN,NaN,24106.585,24141.3330373583,24071.836962641697,24122.41735917291,24065.026947943614,24105.74396919912,24024.309926688107,8025,5894.666666666667,70.97234677803898,64.6160095123035,NaN,NaN,NaN,NaN,12.586687710513393,28.44085454695421,16729,2.6081060786949166,12.351791191951634,9.743685113256717
2025-09-12T15:00:00-04:00,24154,24157.5,24151,24153,24117.23102828635,NaN,NaN,NaN,NaN,NaN,24107.505,24144.604526949333,24070.40547305067,24124.983887338327,24065.44836695596,24106.524585062212,24024.372148849707,4120,5813.566666666667,70.09965466532019,65.08173054593591,NaN,NaN,NaN,NaN,12.151924302619578,28.77410478870903,12609,2.606383591470024,13.001664602594246,10.395281011124222
2025-09-12T15:05:00-04:00,24153.5,24157.25,24147,24150,24117.23102828635,NaN,NaN,NaN,NaN,NaN,24108.385,24147.340899430128,24069.42910056987,24126.11210987066,24066.014459115686,24107.541448094096,24024.487470137276,5755,5798.766666666666,67.42125930992614,65.1367209114863,NaN,NaN,NaN,NaN,12.01607256671818,28.54617654419835,6854,2.182448250990902,13.12334132486285,10.940893073871948
2025-09-12T15:10:00-04:00,24150.5,24150.75,24136.5,24138.75,24117.23102828635,NaN,NaN,NaN,NaN,NaN,24109.435,24148.776048531963,24070.09395146804,24126.11210987066,24066.593829613696,24108.48690921481,24024.70075001258,6715,5882.266666666666,58.40862520460209,65.16519430977317,NaN,NaN,NaN,NaN,12.175638811952595,27.098728200645883,139,0.9846314972614998,12.171682445448823,11.187050948187323
2025-09-12T15:15:00-04:00,24139.5,24142,24133.5,24137.75,24117.23102828635,NaN,NaN,NaN,NaN,NaN,24110.345,24150.156039920308,24070.533960079694,24126.11210987066,24067.151047370022,24109.348507257568,24024.953587482476,6951,5873.833333333333,57.67064980373699,64.89699351798745,NaN,NaN,NaN,NaN,11.913093182527408,25.44014086560575,-6812,0.01643927958321889,11.207600047666347,11.191160768083128
2025-09-12T15:20:00-04:00,24137.5,24140.25,24124.75,24128.5,24117.23102828635,NaN,NaN,NaN,NaN,NaN,24111.005,24150.9038082507,24071.106191749303,24126.11210987066,24067.68045909783,24110.101092269942,24025.25982592572,7402,5957.466666666666,51.22359485926456,64.04418084226884,NaN,NaN,NaN,NaN,12.16930081234688,24.186368286968648,-14214,-1.2836076864899884,9.586651159970643,10.870258846460631
2025-09-12T15:25:00-04:00,24128,24133.5,24119.5,24124.5,24117.23102828635,NaN,NaN,NaN,NaN,NaN,24111.73,24151.264268676336,24072.195731323663,24126.11210987066,24068.2399597927,24110.835971300985,24025.643948284414,8695,5879.933333333333,48.68882373423227,63.204771752873775,NaN,NaN,NaN,NaN,12.300065040036388,23.47084343745542,-22909,-2.385535832964809,7.888339055254619,10.273874888219428
2025-09-12T15:30:00-04:00,24124.75,24126.5,24104.5,24111,NaN,NaN,NaN,24153.9801443432,24153.9801443432,24153.9801443432,24112.105,24151.246805019597,24072.963194980402,24126.11210987066,24069.100652384528,24111.749657298627,24026.45164747043,17324,6264.666666666667,41.26671870830416,61.785651154184166,NaN,NaN,NaN,NaN,12.992917537176647,23.86974921435716,-40233,-3.9063527347877347,5.3909339697347605,9.297286704522495
2025-09-12T15:35:00-04:00,24110.75,24115.5,24097.5,24100.25,NaN,NaN,NaN,24145.6855923276,NaN,NaN,24112.37,24151.00447165788,24073.735528342117,24126.11210987066,24069.556493795062,24112.116456150303,24026.99653143982,12044,6514.033333333334,36.495818815704745,60.00493432111684,NaN,NaN,NaN,NaN,13.350566284521173,24.64645099704354,-52277,-5.425595314662272,2.5152925611946557,7.9408878758569275
2025-09-12T15:40:00-04:00,24100.25,24114.25,24087.5,24113.5,NaN,NaN,NaN,24141.92715631271,NaN,NaN,24112.775,24151.02186261319,24074.528137386813,24126.11210987066,24070.213639764694,24112.649002599774,24027.778276929614,17585,6961,44.94457172468398,58.45283864974791,NaN,NaN,NaN,NaN,14.307668692769662,25.879488430459112,-34692,-5.320219972739981,1.2906129099319514,6.610832882671932
2025-09-12T15:45:00-04:00,24113.25,24123.5,24108,24119.25,NaN,NaN,NaN,24141.92715631271,NaN,NaN,24113.44,24150.950739803997,24075.929260196,24126.11210987066,24070.79508012949,24113.282230938872,24028.307929320108,11985,7172.533333333334,48.16734946823896,56.89707634866302,NaN,NaN,NaN,NaN,14.392835214714685,26.02503976271527,-22707,-4.668596162208795,0.7750876799109392,5.443683842119734
2025-09-12T15:50:00-04:00,24119,24134.5,24118,24132.75,NaN,NaN,NaN,24141.92715631271,NaN,NaN,24114.49,24151.15537330832,24077.824626691683,24126.11210987066,24071.69585287659,24114.451335701968,24028.940370051212,15288,7586.266666666666,54.849863578465296,55.81863648402287,NaN,NaN,NaN,NaN,14.543346985092208,25.1358242499937,-7419,-3.2035260214492,1.4392763153082342,4.642802336757434
2025-09-12T15:55:00-04:00,24132.75,24133.25,24108.5,24109.5,NaN,NaN,NaN,24141.92715631271,NaN,NaN,24115.07,24150.461671333254,24079.678328666745,24118.71468789653,24072.728262694338,24115.532964155333,24029.923561233343,22763,8263.5,44.26528436551435,54.6627251082512,NaN,NaN,NaN,NaN,15.272393629014193,24.893034040197552,-30182,-3.643402539157529,0.08854916281052283,3.7319517019680517
2025-09-12T16:00:00-04:00,24109.75,24112.25,24096.75,24106,NaN,NaN,NaN,24141.92715631271,NaN,NaN,24115.41,24150.113279387548,24080.706720612452,24112.121750317223,24073.11213860219,24115.805097281842,24030.41917992254,12047,8550.1,42.92248036384463,52.67121724141981,NaN,NaN,NaN,NaN,15.28865122694175,25.292143400038448,-42229,-3.985500751753211,-1.2499242377234623,2.7355765140297486
2025-09-12T16:05:00-04:00,24105.5,24112.5,24105,24108.5,NaN,NaN,NaN,24141.92715631271,NaN,NaN,24115.765,24149.8088555446,24081.721144455398,24108.597400253777,24073.227926891443,24115.899419380774,24030.55643440211,3309,8423.833333333334,44.22400778014935,50.760621598713406,NaN,NaN,NaN,NaN,14.732318996445912,25.63894714580882,-38920,-3.8563903180901575,-2.0849113835829485,1.771478934507209
2025-09-12T16:10:00-04:00,24108.5,24113,24108,24111,NaN,NaN,NaN,24141.92715631271,NaN,NaN,24116.375,24148.929915147008,24083.820084852992,24101.177920203023,24073.291379078273,24115.954498732,24030.628259424546,1725,8383.2,45.56086230251842,49.00785071565614,NaN,NaN,NaN,NaN,14.037153353842632,25.91013290488965,-37195,-3.429914122452403,-2.515913718558295,0.9140004038941081
2025-09-12T16:15:00-04:00,24111.75,24119.25,24109.75,24114.75,NaN,NaN,NaN,24141.92715631271,NaN,NaN,24116.845,24148.604233296086,24085.085766703916,24091.785100892128,24073.376117189076,24116.036383946044,24030.71585043211,2093,8254.8,47.59006939584692,47.59133715036477,NaN,NaN,NaN,NaN,13.7130709714253,25.527906315775212,-35102,-2.7518218671797747,-2.5257769300806103,0.2260449370991644
2025-09-12T16:20:00-04:00,24114.75,24116.75,24111.5,24113,NaN,NaN,NaN,24141.92715631271,NaN,NaN,24117.15,24148.459583196873,24085.84041680313,24091.785100892128,24073.42249854483,24116.080183809612,24030.76481328005,1173,8065.533333333334,46.7149595388048,46.75607531709353,NaN,NaN,NaN,NaN,13.108565902037778,25.172981625883235,-36275,-2.2962934491809763,-2.644321874377056,-0.3480284251960797
2025-09-12T16:25:00-04:00,24112.75,24115,24112,24113.5,NaN,NaN,NaN,24141.92715631271,NaN,NaN,24117.4,24148.38773950728,24086.41226049272,24091.785100892128,24073.45301220894,24116.108781462153,24030.79724295573,778,7749.6,47.01475003717458,45.99493961948194,NaN,NaN,NaN,NaN,12.38652548046365,24.84340869955497,-35497,-1.8553198241514768,-2.667178205385426,-0.811858381233949
2025-09-12T16:30:00-04:00,24113.25,24115,24110.5,24113.5,NaN,NaN,NaN,24141.92715631271,NaN,NaN,24117.585,24148.366262160554,24086.803737839444,24093.39198751249,24073.49310495293,24116.145818418474,24030.840391487385,1037,7576.866666666667,47.01475003717458,45.69430784647551,NaN,NaN,NaN,NaN,11.823202231859103,24.65167437292016,-35497,-1.474265610218479,-2.654690394007048,-1.1804247837885689
2025-09-12T16:35:00-04:00,24114,24115,24110,24111.5,NaN,NaN,NaN,24141.92715631271,NaN,NaN,24117.71,24148.34027260993,24087.079727390068,24095.213590009993,24073.532536630184,24116.181363789354,24030.883709471014,1044,7487.233333333334,45.818873541548335,45.48931140414094,NaN,NaN,NaN,NaN,11.335830643869167,24.513550216590545,-36541,-1.2750183919804825,-2.774197773764172,-1.4991793817836894
2025-09-12T16:40:00-04:00,24111.25,24115,24110.75,24113,NaN,NaN,NaN,24141.92715631271,NaN,NaN,24117.765,24148.351338458593,24087.178661541406,24097.045872007995,24073.580327496267,24116.2253177696,24030.935337222934,1244,7390.4,46.90959580335017,45.89237405378708,NaN,NaN,NaN,NaN,10.829699883592799,24.38529207142733,-35297,-0.9739012966913276,-2.716556002647849,-1.7426547059565212
2025-09-12T16:45:00-04:00,24113,24117.25,24113,24113.5,NaN,NaN,NaN,24141.92715631271,NaN,NaN,24118.065,24148.180246970747,24087.94975302925,24100.761697606395,24073.632416312386,24116.2753289595,24030.989503665274,1304,7324.433333333333,47.290502363997284,46.663422878665116,NaN,NaN,NaN,NaN,10.359721320479027,23.94964472495873,-33993,-0.6863171374849035,-2.6005511278126505,-1.914233990327747
2025-09-12T16:50:00-04:00,24113.25,24114.75,24111.75,24113,NaN,NaN,NaN,24141.92715631271,NaN,NaN,24118.31,24148.05484156918,24088.56515843082,24100.761697606395,24073.661511875285,24116.30221008414,24031.02081366643,756,7259.866666666667,46.927910278892064,46.805089918251404,NaN,NaN,NaN,NaN,9.834026940444812,23.66855590525466,-34749,-0.4845442055044922,-2.519914247208362,-2.03537004170387
2025-09-12T16:55:00-04:00,24113.25,24115.75,24108,24114.5,NaN,NaN,NaN,24141.92715631271,NaN,NaN,24118.505,24148.01863921465,24088.991360785352,24100.761697606395,24073.72620759977,24116.361221944615,24031.091193254928,1703,7190.533333333334,48.210800597662605,46.80819357035309,NaN,NaN,NaN,NaN,9.685167873270183,23.77295187142349,-33046,-0.2183936569313465,-2.3083621128680534,-2.089968455936707
2025-09-14T18:00:00-04:00,24112.25,24119.75,24099.25,24105.25,NaN,NaN,NaN,24141.92715631271,NaN,NaN,24118.38,24148.06370596484,24088.696294035162,24100.761697606395,24108.083333333332,24108.083333333332,24108.083333333332,2787,6976.933333333333,41.542024266555195,45.85763361950238,NaN,NaN,NaN,NaN,10.457655882322314,24.610362673831762,-35833,-0.6113866397445511,-2.854201755617396,-2.242815115872845
2025-09-14T18:05:00-04:00,24104.5,24121.75,24100.25,24119,NaN,NaN,NaN,24141.92715631271,NaN,NaN,24118.55,24148.148479693587,24088.95152030641,24100.761697606395,24109.83868388684,24112.430874401805,24107.246493371873,1278,6813.9,52.1399446659522,46.42010935524794,NaN,NaN,NaN,NaN,11.24639474787072,25.068965367393947,-34555,0.07228306488393699,-2.1524612847679236,-2.2247443496518606
2025-09-14T18:10:00-04:00,24118,24122.75,24113.25,24120.5,NaN,NaN,NaN,24141.92715631271,NaN,NaN,24118.925,24148.135143787327,24089.71485621267,24100.761697606395,24111.750177579746,24116.089633552394,24107.4107216071,1097,6634.6,53.13803673371958,47.14979195309615,NaN,NaN,NaN,NaN,11.121652265879955,25.331603054984676,-33458,0.6130138584523053,-1.458477026586479,-2.0714908850387843
2025-09-14T18:15:00-04:00,24120.75,24129.75,24119.75,24124.25,NaN,NaN,NaN,24141.92715631271,NaN,NaN,24119.435,24148.10376523151,24090.766234768493,24102.42097045733,24114.25035095929,24120.65319933731,24107.84750258127,1249,6394.066666666667,55.62929324136824,47.96445520032607,NaN,NaN,NaN,NaN,11.04153424688853,24.50705133912435,-32209,1.1779998710496442,-0.5989910462267289,-1.7769909172763731
2025-09-14T18:20:00-04:00,24124,24124.75,24115.75,24119,NaN,NaN,NaN,24141.92715631271,NaN,NaN,24119.715,24148.086290065206,24091.343709934794,24102.42097045733,24114.775037686075,24121.08357589951,24108.46649947264,665,5998.033333333334,51.50138887576659,48.38877852698665,NaN,NaN,NaN,NaN,10.895710372110779,24.152296572322104,-32874,1.1515272103087864,-0.33758190439039026,-1.4891091146991766
2025-09-14T18:25:00-04:00,24117.75,24125.75,24117,24123,NaN,NaN,NaN,24141.92715631271,NaN,NaN,24120.16,24148.020861429985,24092.299138570015,24102.42097045733,24115.121700058266,24121.463733860663,24108.77966625587,361,5742.566666666667,54.28476811177352,48.86697129240997,NaN,NaN,NaN,NaN,10.742445345531438,23.67219463505333,-32513,1.3434162790646733,0.19016123413166497,-1.1532550449330083
2025-09-14T18:30:00-04:00,24122.5,24124,24118.5,24120.5,NaN,NaN,NaN,24141.92715631271,NaN,NaN,24120.46,24148.004211740867,24092.91578825913,24102.42097045733,24115.407455972025,24121.721270432725,24109.093641511325,380,5617.9,52.26581824056108,49.263461199678275,NaN,NaN,NaN,NaN,10.367984963707764,23.226385693303754,-32893,1.2442343751777487,0.4020379240391776,-0.8421964511385711
2025-09-14T18:35:00-04:00,24120.5,24124,24118,24123,NaN,NaN,NaN,24141.92715631271,NaN,NaN,24120.905,24147.87403595491,24093.93596404509,24102.502029499323,24115.591641834282,24121.901168465072,24109.282115203492,237,5433.966666666666,54.10407576466954,49.769841608785065,NaN,NaN,NaN,NaN,10.055986037728639,22.872164408968473,-32656,1.2840665611777082,0.7628867503335641,-0.5211798108441441
2025-09-14T18:40:00-04:00,24122.75,24126.25,24121.75,24124,NaN,NaN,NaN,24141.92715631271,NaN,NaN,24121.395,24147.67200325927,24095.11799674073,24106.80162359946,24115.94278207416,24122.344097165078,24109.54146698324,351,5221.833333333333,54.85302130056086,50.329718127598376,NaN,NaN,NaN,NaN,9.659129892176594,22.147945040229665,-32305,1.3102888733943348,1.1166812808987743,-0.19360759249556042
2025-09-14T18:45:00-04:00,24124,24128.75,24124,24125.25,NaN,NaN,NaN,24141.92715631271,NaN,NaN,24121.93,24147.39743802863,24096.46256197137,24110.816298879567,24116.524502111122,24123.16669893043,24109.882305291816,516,5007.333333333333,55.82344776407934,51.04433057206487,NaN,NaN,NaN,NaN,9.308477757021123,21.048488541966844,-31789,1.3395741660254032,1.4808601150361937,0.14128594901079045
2025-09-14T18:50:00-04:00,24125.5,24127.25,24121.25,24124.75,NaN,NaN,NaN,24141.92715631271,NaN,NaN,24122.355,24147.281509988206,24097.428490011793,24110.816298879567,24116.797794250262,24123.48159547555,24110.113993024974,320,4771.266666666666,55.31130327298575,51.6444525341817,NaN,NaN,NaN,NaN,9.0721579172339,20.421193140592944,-32109,1.2545100198340289,1.7094234738033265,0.45491345396929767
2025-09-14T18:55:00-04:00,24124,24125.75,24121.25,24124.75,NaN,NaN,NaN,24141.92715631271,NaN,NaN,24122.58,24147.385531625878,24097.774468374126,24110.816298879567,24116.965536066495,24123.65781226924,24110.27325986375,223,4488.866666666667,55.31130327298575,52.21736688482373,NaN,NaN,NaN,NaN,8.74557520886005,19.838704553602895,-32109,1.1312826136250915,1.869016721000662,0.7377341073755705
2025-09-14T19:00:00-04:00,24124.5,24129.25,24123.75,24125.75,NaN,NaN,NaN,24141.92715631271,NaN,NaN,24122.74,24147.52204187617,24097.957958123832,24113.597945026337,24117.32937394247,24124.132103883963,24110.526644000976,386,3924.266666666667,56.242471180326106,52.88269266349759,NaN,NaN,NaN,NaN,8.513748408227189,18.65440309776694,-31723,1.051834241543556,2.0525269093050156,1.0006926677614596
2025-09-14T19:05:00-04:00,24125.5,24126.25,24119.25,24120,NaN,NaN,NaN,24141.92715631271,NaN,NaN,24122.66,24147.451079040315,24097.868920959685,24113.597945026337,24117.494980116044,24124.225063904923,24110.764896327164,376,3535.3333333333335,49.81496283786197,52.99727568065469,NaN,NaN,NaN,NaN,8.405623521925246,18.245625382123226,-32099,0.57082396109042,1.7142226191244845,1.1433986580340645
2025-09-14T19:10:00-04:00,24119,24122.25,24117.5,24120.25,NaN,NaN,NaN,24141.92715631271,NaN,NaN,24122.79,24147.46070326339,24098.11929673661,24113.597945026337,24117.58950472068,24124.208624814495,24110.970384626864,401,2962.5333333333333,50.08207375403165,53.607279215474435,NaN,NaN,NaN,NaN,8.144507556073444,18.11600982727449,-31698,0.24494276938499526,1.4495771197653085,1.2046343503803132
2025-09-14T19:15:00-04:00,24120.25,24123,24118.5,24119.75,NaN,NaN,NaN,24141.92715631271,NaN,NaN,24122.78,24147.455218342333,24098.104781657665,24113.597945026337,24117.682139498193,24124.211342720162,24111.152936276223,360,2575.0333333333333,49.51444552434557,53.41974356250254,NaN,NaN,NaN,NaN,7.884185587782484,17.84418828900713,-32058,-0.015044806267209498,1.1858283425463014,1.200873148813511
2025-09-14T19:20:00-04:00,24119.5,24122.75,24116.25,24118.25,NaN,NaN,NaN,24141.92715631271,NaN,NaN,24122.67,24147.37595880284,24097.964041197156,24113.597945026337,24117.7257569077,24124.15713892045,24111.29437489495,353,2077.2,47.765400287103446,53.035983816315664,NaN,NaN,NaN,NaN,7.785315188655163,17.931912198703717,-32411,-0.2838859352810208,0.846015729712235,1.1299016649932558
2025-09-14T19:25:00-04:00,24118.25,24118.25,24110.25,24111.25,NaN,NaN,NaN,24140.91598176176,NaN,NaN,24122.485,24147.390904923064,24097.579095076937,24113.597945026337,24117.416399879603,24123.72454216115,24111.108257598054,842,1346.5,40.56421955007212,51.959907124080225,NaN,NaN,NaN,NaN,7.800649818036938,18.808913610620532,-33253,-0.8945333213280154,0.011735013333236566,0.906268334661252
2025-09-14T19:30:00-04:00,24111,24114.75,24102,24102.75,NaN,NaN,NaN,24135.567528045314,NaN,NaN,24122.105,24147.616583642422,24096.593416357577,24113.597945026337,24116.34480184582,24123.159207239376,24109.53039645226,1326,989.1333333333333,33.884002627228256,50.701522392041774,NaN,NaN,NaN,NaN,8.154174831034299,20.467184192460124,-34579,-1.7810947757106899,-1.3201001349771104,0.46099464073357954
2025-09-14T19:35:00-04:00,24102.75,24109.25,24100,24108.75,NaN,NaN,NaN,24131.84286767962,NaN,NaN,24121.835,24147.61902801343,24096.05097198657,24113.597945026337,24115.71344246721,24122.76572756622,24108.661157368202,878,908.1,41.240070304956056,49.76975826298338,NaN,NaN,NaN,NaN,8.232448057388991,22.182283864985923,-33701,-1.8647032057437103,-1.8698843664460583,-0.005181160702348031
2025-09-14T19:40:00-04:00,24108.5,24109.5,24100.75,24108,NaN,NaN,NaN,24131.84286767962,NaN,NaN,24121.355,24147.25752691005,24095.45247308995,24113.597945026337,24115.25201301566,24122.434099771053,24108.069926260265,724,874.7333333333333,40.63151938734584,48.93873691632515,NaN,NaN,NaN,NaN,8.269416053289778,23.716409178764586,-34425,-1.8671725388138964,-2.3391468342197186,-0.47197429540582214
2025-09-14T19:45:00-04:00,24108.25,24111,24100.5,24109.75,NaN,NaN,NaN,24131.84286767962,NaN,NaN,24120.765,24146.352186248823,24095.177813751176,24113.597945026337,24114.933037607054,24122.149131701106,24107.716943513,614,825.4333333333333,42.75419042767942,48.128030820825856,NaN,NaN,NaN,NaN,8.428743478054793,24.778572142315706,-33811,-1.6548561878632708,-2.540544530234911,-0.88568834237164
2025-09-14T19:50:00-04:00,24108.75,24111.25,24105.25,24106.25,NaN,NaN,NaN,24131.84286767962,NaN,NaN,24120.105,24145.45220694299,24094.757793057008,24110.22835602107,24114.77032027363,24121.987565119558,24107.553075427702,356,798.2,39.69715270736603,47.04546877845479,NaN,NaN,NaN,NaN,8.25526180105088,25.70251560765388,-34167,-1.6503172882546866,-2.9485849526899983,-1.2982676644353117
2025-09-14T19:55:00-04:00,24105.75,24112.5,24101.75,24111,NaN,NaN,NaN,24131.84286767962,NaN,NaN,24119.74,24145.075540250804,24094.4044597492,24108.596147853485,24114.54324078516,24121.727821210723,24107.358660359594,596,792.1333333333333,45.40277392918514,46.30113493310521,NaN,NaN,NaN,NaN,8.433457386690103,26.946318543355375,-33571,-1.2459900730317055,-2.8557552557249437,-1.6097651826932382
2025-09-14T20:00:00-04:00,24110.25,24113.5,24104,24105.75,NaN,NaN,NaN,24131.84286767962,NaN,NaN,24118.785,24142.506722111306,24095.063277888694,24108.596147853485,24114.28951875156,24121.455376563426,24107.123660939695,647,779.1333333333333,40.80708078272614,45.265119040943794,NaN,NaN,NaN,NaN,8.509639001926525,27.83557369899331,-34218,-1.2476155622686402,-3.1692846355290385,-1.9216690732603983
2025-09-14T20:05:00-04:00,24105.75,24110.5,24100,24110.5,NaN,NaN,NaN,24131.84286767962,NaN,NaN,24117.915,24139.50147955298,24096.328520447023,24107.976918282788,24114.03293418732,24121.19858860784,24106.867279766797,632,765.4,46.12091317545801,44.6086626054061,NaN,NaN,NaN,NaN,8.651807644646059,29.09719089983085,-33586,-0.8625789248098314,-2.9998927292726876,-2.137313804462856
2025-09-14T20:10:00-04:00,24110.5,24115.5,24106.5,24113.75,NaN,NaN,NaN,24131.84286767962,NaN,NaN,24117.13,24136.27216288714,24097.98783711286,24102.43153462623,24113.932239726993,24120.93983770759,24106.9246417464,897,753.8333333333334,49.46375261828585,44.12446842240322,NaN,NaN,NaN,NaN,8.67667852717134,29.02814728376018,-32689,-0.3491347178809008,-2.573732201813982,-2.2245974839330813
2025-09-14T20:15:00-04:00,24113.25,24113.75,24095,24107.75,NaN,NaN,NaN,24131.84286767962,NaN,NaN,24116.285,24133.142345572043,24099.427654427956,24095.720227700986,24113.26535505512,24120.36474386058,24106.165966249657,1619,764.3333333333334,44.032263927865706,43.71141850026063,NaN,NaN,NaN,NaN,9.396201489516244,30.135474947924035,-34308,-0.37164036949859547,-2.689147945806326,-2.3175075763077304
2025-09-14T20:20:00-04:00,24108,24109,24101,24101.75,NaN,NaN,NaN,24131.84286767962,NaN,NaN,24115.545,24131.62314977883,24099.466850221168,24092.749401197085,24113.03333015752,24120.193337480854,24105.873322834184,521,756.5,39.37589924516484,42.94669174962729,NaN,NaN,NaN,NaN,9.296472811693656,31.16370777893333,-34829,-0.7280421823573668,-3.227560304254439,-2.499518121897072
2025-09-14T20:25:00-04:00,24101.25,24104.25,24091.5,24096.75,NaN,NaN,NaN,24126.831971961063,NaN,NaN,24114.725,24130.36573208554,24099.08426791446,24092.749401197085,24112.37978765477,24120.050077612508,24104.70949769703,922,730.4666666666667,35.96291491717561,41.97872527768658,NaN,NaN,NaN,NaN,9.54315332514411,32.82930516971259,-35751,-1.2095634492647802,-4.011472433478048,-2.8019089842132674
2025-09-14T20:30:00-04:00,24096.25,24103.5,24095,24101.75,NaN,NaN,NaN,24126.831971961063,NaN,NaN,24114.19,24129.739135022774,24098.640864977224,24092.749401197085,24112.04199396441,24119.868660403517,24104.2153275253,619,658.2,41.43009077024843,41.526203169339794,NaN,NaN,NaN,NaN,9.468642373348102,34.37593131829333,-35132,-1.1033315475647916,-4.181073418669257,-3.0777418711044655
2025-09-14T20:35:00-04:00,24101,24101.75,24095.75,24099,NaN,NaN,NaN,24126.831971961063,NaN,NaN,24113.68,24129.513205617422,24097.846794382578,24092.749401197085,24111.846220269326,24119.77694312708,24103.915497411574,339,626.9,39.43588288389617,41.445607693184364,NaN,NaN,NaN,NaN,9.220882203823237,35.81208417054688,-35471,-1.1263483770887084,-4.485677342465351,-3.3593289653766427
2025-09-14T20:40:00-04:00,24099,24099.5,24094.5,24099,NaN,NaN,NaN,24124.70398359611,NaN,NaN,24113.44,24129.783977494415,24097.096022505582,24092.749401197085,24111.60250157557,24119.67787918693,24103.52712396421,400,603.6666666666666,39.43588288389617,41.84217056866065,NaN,NaN,NaN,NaN,8.919390617835862,37.23876649338203,-35471,-1.051103475858444,-4.673208310199698,-3.6221048343412536
2025-09-14T20:45:00-04:00,24099.5,24106.25,24097,24104.75,NaN,NaN,NaN,24124.70398359611,NaN,NaN,24113.53,24129.630198761086,24097.42980123891,24092.749401197085,24111.391064636122,24119.485097264907,24103.297032007336,564,580.8333333333334,45.76624739325157,42.16546893211033,NaN,NaN,NaN,NaN,8.94300557370473,36.97489716122242,-34907,-0.5488672431049997,-4.308188888222503,-3.7593216451175033
2025-09-14T20:50:00-04:00,24104.5,24109.5,24100.75,24107.25,NaN,NaN,NaN,24124.70398359611,NaN,NaN,24113.405,24129.60095320925,24097.209046790747,24092.749401197085,24111.24375127629,24119.27953948384,24103.207963068744,649,580.3,48.29664573105345,42.71297795666087,NaN,NaN,NaN,NaN,8.929219461297249,36.072407178635316,-34258,-0.01148559710949737,-3.7736786415043753,-3.762193044394878
2025-09-14T20:55:00-04:00,24108,24114.5,24107,24109.5,NaN,NaN,NaN,24124.70398359611,NaN,NaN,24113.21,24129.354460349823,24097.065539650175,24093.25213351803,24111.216728091727,24119.13386588291,24103.299590300543,749,593.2333333333333,50.533598176816355,43.26864993874208,NaN,NaN,NaN,NaN,8.827132356918874,34.32411202205823,-33509,0.5038258411995464,-3.132410742895445,-3.6362365840949913
2025-09-14T21:00:00-04:00,24109.5,24113,24105.75,24107,NaN,NaN,NaN,24124.70398359611,NaN,NaN,24112.695,24127.930580068023,24097.459419931976,24093.25213351803,24111.15596528584,24118.991212025157,24103.320718546525,596,600.4333333333333,48.04623300070971,43.86501281683805,NaN,NaN,NaN,NaN,8.714480045710383,32.87025861060178,-34105,0.6740083996620712,-2.7937260845174023,-3.4677344841794735
2025-09-14T21:05:00-04:00,24107,24113.75,24106.75,24110.25,NaN,NaN,NaN,24124.70398359611,NaN,NaN,24112.71,24127.934440887282,24097.485559112716,24093.751365451542,24111.1464215029,24118.940838074235,24103.352004931567,275,601.7,51.39560153034461,44.29307193120659,NaN,NaN,NaN,NaN,8.592017185302499,31.381410745473065,-33830,0.9843649770330671,-2.2372782628881396,-3.2216432399212067
2025-09-14T21:10:00-04:00,24110.25,24111.5,24105.75,24107.5,NaN,NaN,NaN,24124.70398359611,NaN,NaN,24112.74,24127.91727247691,24097.562727523095,24093.751365451542,24111.1222158911,24118.88847217865,24103.355959603552,220,597.3333333333334,48.543834847220495,44.84569722152762,NaN,NaN,NaN,NaN,8.389015957780892,30.149117936193097,-34050,0.9811609594029962,-1.9951920406674617,-2.976353000070458
2025-09-14T21:15:00-04:00,24107.5,24110.5,24105.25,24107.5,NaN,NaN,NaN,24124.70398359611,NaN,NaN,24112.72,24127.922184054045,24097.517815945957,24093.751365451542,24111.08509592506,24118.816500424,24103.35369142612,293,589.9,48.5438348472205,45.018763055224944,NaN,NaN,NaN,NaN,8.164800532225113,29.082791035157157,-34050,0.9548535066041586,-1.7827861168152594,-2.737639623419418
2025-09-14T21:20:00-04:00,24108,24111,24105.25,24110.25,NaN,NaN,NaN,24124.70398359611,NaN,NaN,24112.705,24127.915420761386,24097.494579238617,24093.945699111187,24111.06613830527,24118.76767716417,24103.364599446366,226,586.7666666666667,51.65490512070141,45.17527394825462,NaN,NaN,NaN,NaN,7.992314779923319,27.981519943659773,-33824,1.0887666195907224,-1.3766813489310152,-2.4654479685217376
2025-09-14T21:25:00-04:00,24110.75,24113.25,24108,24113.25,NaN,NaN,NaN,24124.70398359611,NaN,NaN,24112.675,24127.875082237246,24097.474917762753,24096.98155928895,24111.070870179316,24118.73042837193,24103.4113119867,296,589.2,54.86114621100743,45.9487655399076,NaN,NaN,NaN,NaN,7.796435152785939,26.46034185847652,-33528,1.3295558291504626,-0.8035031820836593,-2.133059011234122
2025-09-14T21:30:00-04:00,24113.5,24114.5,24108,24111,NaN,NaN,NaN,24124.70398359611,NaN,NaN,24112.635,24127.84197537286,24097.428024627137,24098.235247431163,24111.07217921694,24118.67923245887,24103.465125975006,376,588.8666666666667,52.07186172818357,46.855620002980366,NaN,NaN,NaN,NaN,7.7038326418726575,24.77776914054651,-33904,1.2866372755410662,-0.5247624168077891,-1.8113996923488553
2025-09-14T21:35:00-04:00,24111.75,24118,24109.25,24114.75,NaN,NaN,NaN,24124.70398359611,NaN,NaN,24112.66,24127.87668821621,24097.44331178379,24100.613197944927,24111.143498327598,24118.670874186708,24103.616122468487,687,599.2333333333333,56.0798393390256,48.29254317596966,NaN,NaN,NaN,NaN,7.778558881738896,23.51009543473983,-33217,1.4481195301046212,-0.0012502797180786729,-1.4493698098227
2025-09-14T21:40:00-04:00,24114.5,24114.75,24108.5,24111,NaN,NaN,NaN,24124.70398359611,NaN,NaN,24112.61,24127.83174760252,24097.388252397483,24100.613197944927,24111.147365538774,24118.62133906531,24103.67339201224,405,599.3666666666667,51.446684617909476,49.008014165088305,NaN,NaN,NaN,NaN,7.669376104471832,22.166357682070423,-33622,1.2473180487428532,0.10977775110586663,-1.1375402976369866
2025-09-14T21:45:00-04:00,24111.25,24118.75,24111.25,24115.5,NaN,NaN,NaN,24124.70398359611,NaN,NaN,24112.69,24127.92960630146,24097.45039369854,24101.247446684756,24111.221150876707,24118.64583487369,24103.796466879725,535,605.2,56.130489165435385,50.2004860423411,NaN,NaN,NaN,NaN,7.675134954152415,21.67589942768831,-33087,1.3536233221207212,0.5544888550139149,-0.7991344671068064
2025-09-14T21:50:00-04:00,24116,24118,24113.75,24116,NaN,NaN,NaN,24124.70398359611,NaN,NaN,24112.75,24128.017612776875,24097.482387223125,24101.872957347805,24111.253314135764,24118.6626542168,24103.843974054726,201,600.1333333333333,56.631100239051236,51.42871585342361,NaN,NaN,NaN,NaN,7.4304824574272414,21.220473905762066,-32886,1.3884886249990893,0.9364763141420553,-0.45201231085703397
2025-09-14T21:55:00-04:00,24116,24117.5,24114,24114.75,NaN,NaN,NaN,24124.70398359611,NaN,NaN,24112.775,24128.051534290957,24097.498465709046,24102.848365878242,24111.29015796347,24118.67693878929,24103.903377137653,262,580.8,54.943088657046545,52.08420451512325,NaN,NaN,NaN,NaN,7.149733710468153,20.797578778259123,-33148,1.261903483482608,1.125367043496226,-0.13653643998638199
2025-09-14T22:00:00-04:00,24114,24116.25,24108.25,24115,NaN,NaN,NaN,24124.70398359611,NaN,NaN,24112.815,24128.104149764116,24097.52585023588,24102.848365878242,24111.3224868603,24118.649430412694,24103.995543307905,519,553.9,55.230508839170746,52.57948045141734,NaN,NaN,NaN,NaN,7.2104670168632845,19.5902858793015,-32629,1.1336104959599957,1.2804766799636127,0.14686618400361695
2025-09-14T22:05:00-04:00,24114.25,24121.75,24114.25,24120,NaN,NaN,NaN,24124.70398359611,NaN,NaN,24112.925,24128.339684563452,24097.510315436546,24105.422954162077,24111.45910162018,24118.785092486527,24104.133110753835,571,543.6666666666666,60.638567758698095,53.30126399298032,NaN,NaN,NaN,NaN,7.231147944230193,18.999098725116212,-32058,1.3115225695516954,1.7862693959432363,0.47474682639154087
2025-09-14T22:10:00-04:00,24119.5,24123,24119.25,24119.75,NaN,NaN,NaN,24124.70398359611,NaN,NaN,24113.215,24128.586730549865,24097.843269450135,24108.06336332966,24111.597665650563,24118.95423422339,24104.241097077735,469,535.1666666666666,60.246693119972285,54.17272543007051,NaN,NaN,NaN,NaN,6.982494519642322,18.669258480753882,-32527,1.3339996381115247,2.1422463740309468,0.8082467359194221
2025-09-14T22:15:00-04:00,24119.5,24125,24115,24122.75,24098.2748866647,24098.2748866647,24098.2748866647,NaN,NaN,NaN,24113.29,24128.809780919113,24097.77021908089,24108.06336332966,24111.778292585706,24119.17564117738,24104.380943994034,616,535.2333333333333,63.31079013101964,55.02381033011873,NaN,NaN,NaN,NaN,7.198030625382157,17.444534793892256,-31911,1.4622417241164638,2.636048891065002,1.1738071669485381
2025-09-14T22:20:00-04:00,24122.5,24123.25,24114,24119.25,24098.2748866647,NaN,NaN,NaN,NaN,NaN,24113.265,24128.74221229048,24097.78778770952,24108.06336332966,24111.871176835888,24119.26353814987,24104.478815521907,424,537.5,57.72101095035995,55.6793229089144,NaN,NaN,NaN,NaN,7.344599866426289,16.290546301273736,-32335,1.2319050525033366,2.713688482577709,1.4817834300743722
2025-09-14T22:25:00-04:00,24118.75,24121,24115.5,24119.5,24098.2748866647,NaN,NaN,NaN,NaN,NaN,24113.17,24128.43317138632,24097.906828613675,24108.06336332966,24111.948775209497,24119.334185396376,24104.56336502262,372,530.0333333333333,58.00621689059457,56.355207340583966,NaN,NaN,NaN,NaN,7.212842733110125,15.21898555812797,-31963,1.0254012698885506,2.7635350174350606,1.73813374754651
2025-09-14T22:30:00-04:00,24119.25,24119.25,24115,24115.5,24098.2748866647,NaN,NaN,NaN,NaN,NaN,24113.1,24128.28749486664,24097.912505133358,24108.06336332966,24111.97508622531,24119.347729982397,24104.602442468222,186,514.6666666666666,51.965932789787246,56.37742360266153,NaN,NaN,NaN,NaN,7.019068252173687,14.335415250219688,-32149,0.5710985817588063,2.452006974745018,1.8809083929862116
2025-09-14T22:35:00-04:00,24116.25,24116.25,24112.25,24112.25,24098.2748866647,NaN,NaN,NaN,NaN,NaN,24112.885,24127.80787170916,24097.962128290837,24108.06336332966,24111.99611159642,24119.322681596623,24104.66954159622,434,508.06666666666666,47.62643976597592,55.860658856587854,NaN,NaN,NaN,NaN,6.803420519875567,14.109031776916057,-32583,0.031857236598582084,1.9207299387344392,1.8888727021358571
2025-09-14T22:40:00-04:00,24112.5,24118.75,24112.25,24118.5,24098.2748866647,NaN,NaN,NaN,NaN,NaN,24112.845,24127.696562194986,24097.993437805017,24108.06336332966,24112.031379200405,24119.339997147494,24104.722761253317,262,486.9,55.34856783727296,56.09470929295138,NaN,NaN,NaN,NaN,6.78174762559874,13.284769051205632,-32321,0.07384110629860663,1.9811740850091155,1.9073329787105089
2025-09-14T22:45:00-04:00,24118.75,24120.75,24115.25,24116.25,24098.2748866647,NaN,NaN,NaN,NaN,NaN,24112.71,24127.310465752736,24098.10953424726,24108.06336332966,24112.086656214866,24119.37790016631,24104.795412263422,347,444.5,52.35577484439375,55.828704686191955,NaN,NaN,NaN,NaN,6.690194223770258,12.609959052278702,-32668,-0.06469362462291484,1.8264659479318652,1.89115957255478
2025-09-14T22:50:00-04:00,24117.25,24119,24115.25,24118,24098.2748866647,NaN,NaN,NaN,NaN,NaN,24112.59,24126.91332363406,24098.26667636594,24108.06336332966,24112.127336151385,24119.405499447963,24104.849172854807,260,435.8,54.42012622752141,56.041093372592805,NaN,NaN,NaN,NaN,6.480180350643812,11.983349767560837,-32408,-0.053693592548276214,1.8240425818694348,1.877736174417711
2025-09-14T22:55:00-04:00,24118.25,24119.5,24114.75,24118.5,24098.2748866647,NaN,NaN,NaN,NaN,NaN,24112.455,24126.42127722579,24098.488722774215,24108.06336332966,24112.156488753924,24119.426071150614,24104.886906357235,183,411.1666666666667,55.019794986343335,55.96175807408623,NaN,NaN,NaN,NaN,6.35659603988354,11.401498288894249,-32225,-0.02919440906836579,1.8412431630822539,1.8704375721506197
2025-09-14T23:00:00-04:00,24118.25,24121,24116.25,24120.25,24098.2748866647,NaN,NaN,NaN,NaN,NaN,24112.365,24126.06872575163,24098.661274248374,24108.050690663727,24112.203453692957,24119.471177260933,24104.93573012498,231,398.23333333333335,57.144961308477434,55.998462436188106,NaN,NaN,NaN,NaN,6.2418391798918575,11.24088991399916,-31994,0.08232011304301179,1.9733377134543844,1.8910176004113726
2025-09-14T23:05:00-04:00,24121,24124,24119.75,24122.25,24101.560480043245,NaN,NaN,NaN,NaN,NaN,24112.315,24125.854870760257,24098.77512923974,24111.405444135773,24112.276492798675,24119.565950863464,24104.987034733887,259,395.56666666666666,59.500026142687595,56.32395797087675,NaN,NaN,NaN,NaN,6.099564952756724,11.782131976089124,-31735,0.25829517989086614,2.2138865752749552,1.955591395384089
2025-09-14T23:10:00-04:00,24122.5,24123.5,24119.5,24123.5,24101.56341276855,NaN,NaN,NaN,NaN,NaN,24112.27,24125.644916807254,24098.895083192747,24111.42435530862,24112.347159107143,24119.658140137446,24105.03617807684,250,390.56666666666666,60.94462250428907,56.73210894695662,NaN,NaN,NaN,NaN,5.949596027559815,12.204447029085339,-31485,0.4169960087547233,2.476836406327493,2.0598403975727697
2025-09-14T23:15:00-04:00,24123,24132.5,24120.25,24126.25,24105.674166733617,NaN,NaN,NaN,NaN,NaN,24112.395,24126.167468900676,24098.622531099325,24116.714484246895,24112.766693927708,24120.352127383772,24105.181260471643,1082,407.8333333333333,63.98793896840758,56.971349747650166,NaN,NaN,NaN,NaN,6.3996248827341145,14.173870542857667,-30403,0.6513263976914465,2.873998394687078,2.2226719969956314
2025-09-14T23:20:00-04:00,24126,24130.75,24124.5,24128.75,24107.012840973,NaN,NaN,NaN,NaN,NaN,24112.565,24126.918678988,24098.211321011997,24116.714484246895,24112.894419855576,24120.574636800233,24105.21420291092,305,396.3666666666667,66.54050865991421,57.42090800050316,NaN,NaN,NaN,NaN,6.3889373911102485,16.002620948503402,-30098,0.9033370229293363,3.351843275657302,2.4485062527279657
2025-09-14T23:25:00-04:00,24128.75,24129,24120.5,24121.75,24107.012840973,NaN,NaN,NaN,NaN,NaN,24112.605,24127.04940722685,24098.16059277315,24116.714484246895,24113.04102936124,24120.771432989324,24105.310625733156,498,388,54.82300312494203,56.81463750006905,NaN,NaN,NaN,NaN,6.539727577459517,16.48778806634594,-30596,0.5448917702825278,3.1296209655811253,2.5847291952985976
2025-09-14T23:30:00-04:00,24121.5,24123,24116.75,24119.75,24107.012840973,NaN,NaN,NaN,NaN,NaN,24112.635,24127.132313546554,24098.137686453443,24116.714484246895,24113.13010518145,24120.8484301785,24105.411780184404,490,384.46666666666664,52.00518883282803,56.40636449167391,NaN,NaN,NaN,NaN,6.5190327504981225,15.980001277496154,-31086,0.14046129284622166,2.7603058113563748,2.619844518510153
2025-09-14T23:35:00-04:00,24120,24125,24118.5,24122.25,24107.012840973,NaN,NaN,NaN,NaN,NaN,24112.855,24127.593415792027,24098.11658420797,24116.714484246895,24113.214185995133,24120.942975540813,24105.485396449454,361,387.3333333333333,55.11106103794641,56.199567645056185,NaN,NaN,NaN,NaN,6.517673268319685,15.890694668989495,-30725,0.015268428790201405,2.638930054497905,2.6236616257077037
2025-09-14T23:40:00-04:00,24122.5,24127.75,24122,24125.75,24107.012840973,NaN,NaN,NaN,NaN,NaN,24113.315,24128.19814818957,24098.431851810426,24116.714484246895,24113.36528126744,24121.160292599492,24105.57026993539,483,396.1,59.1014055850425,56.7092442732887,NaN,NaN,NaN,NaN,6.462839463439708,16.297493409156107,-30242,0.13544197185597762,2.7929640905276756,2.657522118671698
2025-09-14T23:45:00-04:00,24126.5,24128.75,24124.75,24124.75,24107.012840973,NaN,NaN,NaN,NaN,NaN,24113.635,24128.79719312415,24098.472806875845,24116.714484246895,24113.46141241763,24121.304644027216,24105.618180808044,291,396.03333333333336,57.527907308944826,57.416491954929334,NaN,NaN,NaN,NaN,6.2869223589083,16.8462122454334,-30533,0.11561854283249495,2.8020452972123167,2.6864267543798217
2025-09-14T23:50:00-04:00,24125.25,24127.25,24125,24126,24107.012840973,NaN,NaN,NaN,NaN,NaN,24113.995,24129.456723720148,24098.53327627985,24116.714484246895,24113.507145198713,24121.372800617115,24105.64148978031,140,393.1666666666667,58.997423272185834,57.67712448599453,NaN,NaN,NaN,NaN,6.016427904700564,17.35573687911945,-30393,0.15241312634232296,2.8769431623077253,2.7245300359654023
2025-09-14T23:55:00-04:00,24126,24126,24121.25,24122,24107.012840973,NaN,NaN,NaN,NaN,NaN,24114.24,24129.81271972668,24098.667280273323,24116.714484246895,24113.55694798451,24121.432303000696,24105.681592968325,202,390.03333333333336,52.712255055910866,57.70258735824576,NaN,NaN,NaN,NaN,5.925968768650525,16.790965773990575,-30595,-0.11262416501771311,2.583749829693261,2.696373994710974
2025-09-15T00:00:00-04:00,24121.25,24124,24120.5,24123,24107.012840973,NaN,NaN,NaN,NaN,NaN,24114.575,24130.166423916147,24098.983576083854,24116.714484246895,24113.62707971458,24121.511058231015,24105.743101198146,307,387.73333333333335,54.03074263047836,57.67477424417125,NaN,NaN,NaN,NaN,5.752685285175487,16.074046804279167,-30288,-0.2336051229835272,2.4043675909815647,2.637972713965092
2025-09-15T00:05:00-04:00,24123.25,24128.25,24122,24125.5,24107.012840973,NaN,NaN,NaN,NaN,NaN,24114.865,24130.716880005977,24099.013119994026,24115.46897307225,24113.71897913498,24121.638912923492,24105.79904534647,312,375.23333333333335,57.24058623079283,57.83340219020336,NaN,NaN,NaN,NaN,5.78820776480581,16.27837967047545,-29976,-0.16169341123053949,2.4358559499269177,2.597549361157457
2025-09-15T00:10:00-04:00,24125,24125,24120,24123.5,24107.012840973,NaN,NaN,NaN,NaN,NaN,24115.22,24131.034436435868,24099.405563564134,24115.46897307225,24113.772480874035,24121.69977054004,24105.84519120803,233,369.5,53.99252158014633,57.60822792389399,NaN,NaN,NaN,NaN,5.767621495891109,15.94063685688707,-30209,-0.25946099699267133,2.273223114916618,2.5326841119092895
2025-09-15T00:15:00-04:00,24123.5,24126.25,24121,24125,24107.012840973,NaN,NaN,NaN,NaN,NaN,24115.51,24131.498420811575,24099.521579188422,24115.46897307225,24113.807688284072,24121.74425684255,24105.871119725594,136,356.2,56.008719411703915,57.35884887168088,NaN,NaN,NaN,NaN,5.730648531898886,15.880461065258764,-30073,-0.23450195335011514,2.2395566702216456,2.4740586235717608
2025-09-15T00:20:00-04:00,24125.25,24129.75,24125.25,24128.5,24109.03476741035,NaN,NaN,NaN,NaN,NaN,24115.805,24132.191973480683,24099.418026519317,24116.971114212993,24113.928135527116,24121.935821527033,24105.9204495272,345,361,60.37249954279822,57.3179829458601,NaN,NaN,NaN,NaN,5.660602208191823,16.478993734764604,-29728,-0.005758825294205572,2.466860091954004,2.4726189172482096
2025-09-15T00:25:00-04:00,24128,24130,24125,24128,24109.192277982605,NaN,NaN,NaN,NaN,NaN,24116.21,24132.78056426451,24099.639435735487,24117.27689137039,24114.00837045285,24122.060973755895,24105.955767149808,236,360.1333333333333,59.46500430627041,56.99491618427887,NaN,NaN,NaN,NaN,5.613416336178121,17.03477407073432,-29964,0.08346359642069023,2.5769484127740725,2.4934848163533823
2025-09-15T00:30:00-04:00,24127.75,24132.25,24127.75,24129.75,24111.91081080158,NaN,NaN,NaN,NaN,NaN,24116.77,24133.24022767649,24100.29977232351,24119.821513096314,24114.112402481394,24122.240410884286,24105.984394078503,266,351.7,61.63847499872606,56.64477092276543,NaN,NaN,NaN,NaN,5.533886597879684,17.953699498629554,-29698,0.22395946875953232,2.773434152302798,2.5494746835432656
2025-09-15T00:35:00-04:00,24129.5,24136,24129,24130,24114.278501219687,NaN,NaN,NaN,NaN,NaN,24117.435,24133.291799798862,24101.57820020114,24122.55721047705,24114.321772698193,24122.62286126529,24106.020684131097,491,349.03333333333336,61.95233667548208,57.1540090335183,NaN,NaN,NaN,NaN,5.638608983745421,19.397303370785025,-29207,0.29299057617582847,2.915712903763051,2.6227223275872227
2025-09-15T00:40:00-04:00,24129.75,24132.25,24128,24131.75,24114.278501219687,NaN,NaN,NaN,NaN,NaN,24118.035,24133.742007995603,24102.327992004397,24122.55721047705,24114.44002258824,24122.826222153773,24106.053823022703,300,343.4,64.16268450027786,58.02240158119328,NaN,NaN,NaN,NaN,5.539422627763606,20.414606158398456,-28907,0.40866893965439033,3.1335585021552106,2.7248895625008203
2025-09-15T00:45:00-04:00,24131.75,24132.25,24129.25,24131.25,24114.278501219687,NaN,NaN,NaN,NaN,NaN,24118.68,24133.846753122412,24103.51324687759,24122.55721047705,24114.498225757354,24122.92648274824,24106.069968766467,147,327.76666666666665,63.0359092701914,58.588462169210786,NaN,NaN,NaN,NaN,5.358035297209063,21.359244461182353,-29054,0.4029996657954258,3.2286391447451024,2.8256394789496766
2025-09-15T00:50:00-04:00,24130.25,24131.25,24127.5,24130,24114.278501219687,NaN,NaN,NaN,NaN,NaN,24119.3,24133.71388218878,24104.88611781122,24122.55721047705,24114.580784121594,24123.059306158026,24106.10226208516,229,321.26666666666665,60.19010793128645,58.66622662251392,NaN,NaN,NaN,NaN,5.243175633122702,21.64149536625047,-29283,0.2727874708303082,3.1666238174875616,2.8938363466572534
2025-09-15T00:55:00-04:00,24130,24131.25,24128.5,24131,24114.278501219687,NaN,NaN,NaN,NaN,NaN,24119.825,24133.990892140402,24105.6591078596,24122.55721047705,24114.62186851953,24123.127097863653,24106.11663917541,110,312.53333333333336,61.68053478691296,58.96284287094022,NaN,NaN,NaN,NaN,5.065091659328223,21.903585492385155,-29173,0.2143081299069527,3.1617215090409445,2.947413379133992
2025-09-15T01:00:00-04:00,24131,24133.25,24128.5,24129.5,24114.278501219687,NaN,NaN,NaN,NaN,NaN,24120.27,24134.224153503583,24106.315846496418,24122.55721047705,24114.71171165833,24123.275497866507,24106.14792545015,240,314.3333333333333,58.16296939205183,58.90323902235922,NaN,NaN,NaN,NaN,5.04258511223335,22.55402374010949,-29413,0.04382252475743309,3.002191535080783,2.95836901032335
2025-09-15T01:05:00-04:00,24129.25,24131.25,24129,24129.5,24114.278501219687,NaN,NaN,NaN,NaN,NaN,24120.67,24134.51248533995,24106.827514660046,24122.55721047705,24114.765575183617,24123.361779237188,24106.169371130047,150,304.8666666666667,58.16296939205182,59.292575760655,NaN,NaN,NaN,NaN,4.843114747073825,23.158002112996375,-29413,-0.09230268441802814,2.842990654800815,2.935293339218843
2025-09-15T01:10:00-04:00,24129.75,24131.75,24128,24129.5,24114.278501219687,NaN,NaN,NaN,NaN,NaN,24121.12,24134.61416170327,24107.625838296728,24122.55721047705,24114.817767291894,24123.444277993938,24106.19125658985,148,301.06666666666666,58.16296939205182,59.58773481505311,NaN,NaN,NaN,NaN,4.765035122282837,23.322333190803292,-29413,-0.1995451781815505,2.685861866491905,2.8854070446734554
2025-09-15T01:15:00-04:00,24129.5,24130,24122.75,24124.25,24114.278501219687,NaN,NaN,NaN,NaN,NaN,24121.4,24134.557127333,24108.242872667004,24122.55721047705,24114.936705693402,24123.589858176536,24106.28355321027,471,305.2,46.556578350947966,58.82459139506419,NaN,NaN,NaN,NaN,4.94253261354835,21.74302773718456,-29884,-0.6176506479599984,2.1133437347234576,2.730994382683456
2025-09-15T01:20:00-04:00,24124.5,24127.5,24123.75,24127,24114.278501219687,NaN,NaN,NaN,NaN,NaN,24121.79,24134.421452799834,24109.158547200168,24122.55721047705,24115.008882182443,24123.68018658806,24106.337577776827,280,305.8666666666667,51.963835521588976,58.67968524802438,NaN,NaN,NaN,NaN,4.85735171258061,20.276529815967166,-29604,-0.6967321677711142,1.860079172969563,2.556811340740677
2025-09-15T01:25:00-04:00,24126.75,24130.75,24126.5,24128.5,24114.278501219687,NaN,NaN,NaN,NaN,NaN,24122.21,24134.297745871503,24110.122254128495,24122.53166672912,24115.085979596373,24123.792590504167,24106.37936868858,247,308,54.65860076123389,58.583248201562235,NaN,NaN,NaN,NaN,4.813969447396281,19.774566242562937,-29357,-0.6373585460081221,1.7601131582305243,2.3974717042386464
2025-09-15T01:30:00-04:00,24128.75,24132,24126.5,24130.75,24114.278501219687,NaN,NaN,NaN,NaN,NaN,24122.62,24134.445075046067,24110.79492495393,24122.53166672912,24115.167794724046,24123.918519173185,24106.417070274907,244,308.43333333333334,58.42606937444395,58.444217475251214,NaN,NaN,NaN,NaN,4.862971629725117,19.606163517177393,-29113,-0.4450004702800179,1.841221116388624,2.286221586668642
2025-09-15T01:35:00-04:00,24131.25,24138,24130.5,24135,24117.986898516396,NaN,NaN,NaN,NaN,NaN,24123.055,24135.068030428098,24111.041969571903,24125.088090594432,24115.381134905736,24124.314720789484,24106.44754902199,488,316.06666666666666,64.43702952761345,58.7993621339186,NaN,NaN,NaN,NaN,5.051330799030467,20.623318027849848,-28625,-0.05072446960742516,2.2228159996593604,2.2735404692667855
2025-09-15T01:40:00-04:00,24135,24144.75,24134.5,24139.5,24122.703403129286,NaN,NaN,NaN,NaN,NaN,24123.625,24135.995226353552,24111.254773646448,24129.295472475544,24115.947693292994,24125.50445261336,24106.390933972627,1060,343.06666666666666,69.47033280450238,59.358780548616906,NaN,NaN,NaN,NaN,5.422664313385433,22.485542710286126,-27565,0.4655112024352026,2.8554294723107887,2.389918269875586
2025-09-15T01:45:00-04:00,24139.75,24140,24135.25,24136.25,24122.703403129286,NaN,NaN,NaN,NaN,NaN,24124.055,24136.653924544018,24111.456075455982,24129.295472475544,24116.11967244237,24125.825910258176,24106.413434626567,370,319.3333333333333,62.58134389350089,59.403709635618256,NaN,NaN,NaN,NaN,5.37461686242933,24.214751343976953,-27935,0.5354790179913782,3.0592670423648087,2.5237880243734305
2025-09-15T01:50:00-04:00,24135.25,24140.75,24134.5,24138.25,24122.703403129286,NaN,NaN,NaN,NaN,NaN,24124.6,24137.250296447506,24111.94970355249,24129.295472475544,24116.227580519775,24126.029330220197,24106.425830819353,228,316.76666666666665,64.88879824790726,59.45557490330608,NaN,NaN,NaN,NaN,5.437144229398664,25.820445075261294,-27707,0.65588922828581,3.343649559730693,2.687760331444883
2025-09-15T01:55:00-04:00,24139,24140.75,24137.25,24140,24122.703403129286,NaN,NaN,NaN,NaN,NaN,24125.09,24138.18265441681,24111.99734558319,24129.295472475544,24116.338846590457,24126.246931993788,24106.430761187126,222,307.56666666666666,66.81700353814819,59.725653065303,NaN,NaN,NaN,NaN,5.298776784441616,27.311446397168183,-27485,0.7841543319993618,3.6679532464440854,2.8837989144447236
2025-09-15T02:00:00-04:00,24140,24144.5,24137,24141.25,24123.8833548297,NaN,NaN,NaN,NaN,NaN,24125.595,24139.18466150296,24112.00533849704,24129.80382552598,24116.57643588036,24126.725531477994,24106.427340282728,450,306.23333333333335,68.16196689838117,60.29507156295262,NaN,NaN,NaN,NaN,5.456007014124358,29.17849784152282,-27035,0.8769227838028892,3.9799523941983352,3.103029610395446
2025-09-15T02:05:00-04:00,24141.5,24145,24136,24144,24123.8833548297,NaN,NaN,NaN,NaN,NaN,24126.18,24140.357460988005,24112.002539011995,24129.80382552598,24116.793371240357,24127.162047314065,24106.42469516665,406,307.73333333333335,70.95146723396128,60.95728102345607,NaN,NaN,NaN,NaN,5.7091493702583325,30.527273039712295,-26629,1.0363073576510766,4.398413807459292,3.3621064498082154
2025-09-15T02:10:00-04:00,24143.5,24146,24138.5,24141.25,24124.68762289235,NaN,NaN,NaN,NaN,NaN,24126.705,24141.12952424784,24112.280475752163,24129.80382552598,24117.044439993537,24127.65950902767,24106.429370959402,474,307.43333333333334,64.83405101962889,61.43378685399729,NaN,NaN,NaN,NaN,5.837067272382738,31.91489935688074,-27103,0.8757313184114031,4.456770597822469,3.5810392794110664
2025-09-15T02:15:00-04:00,24141.25,24143.25,24139,24143,24124.68762289235,NaN,NaN,NaN,NaN,NaN,24127.165,24142.160535996903,24112.1694640031,24129.80382552598,24117.16263105255,24127.888610718765,24106.436651386335,228,305.3333333333333,66.79599736769123,62.05043170940011,NaN,NaN,NaN,NaN,5.723705324355399,33.203409508537156,-26875,0.8082113452320803,4.591303460951167,3.7830921157190867
2025-09-15T02:20:00-04:00,24142.25,24142.25,24134.75,24135.5,24124.68762289235,NaN,NaN,NaN,NaN,NaN,24127.48,24142.50093207247,24112.459067927528,24129.80382552598,24117.349092169097,24128.20032283205,24106.497861506145,441,315.3666666666667,53.118203316918155,61.69009127546199,NaN,NaN,NaN,NaN,5.9041549440443,32.768948931090044,-27316,0.21040115257721848,4.04609355644061,3.8356924038633915
2025-09-15T02:25:00-04:00,24135.25,24137.75,24132,24134.25,24124.68762289235,NaN,NaN,NaN,NaN,NaN,24127.71,24142.786259485772,24112.633740514226,24129.80382552598,24117.517023189423,24128.448049356226,24106.58599702262,471,324.3333333333333,51.23513139157484,62.02427363550676,NaN,NaN,NaN,NaN,5.893143876612564,31.494502204200653,-27787,-0.29006562600834584,3.473110371352959,3.763175997361305
2025-09-15T02:30:00-04:00,24134,24146,24131.5,24140.5,24124.68762289235,NaN,NaN,NaN,NaN,NaN,24128.135,24143.429839008502,24112.840160991494,24129.80382552598,24117.85835207966,24129.0363624479,24106.68034171142,772,339.8333333333333,59.05166904105413,62.53054745832571,NaN,NaN,NaN,NaN,6.507919313997381,31.748780433436103,-27015,-0.22399054612782532,3.483187814701523,3.7071783608293485
2025-09-15T02:35:00-04:00,24139.5,24145,24138.25,24143.5,24124.68762289235,NaN,NaN,NaN,NaN,NaN,24128.615,24144.297222413268,24112.932777586735,24129.80382552598,24118.031123184763,24129.355751467152,24106.706494902373,352,341.1666666666667,62.18494084495193,63.068143178591285,NaN,NaN,NaN,NaN,6.5252107915689965,31.984895932011874,-26663,-0.013178657614800748,3.6907050388108473,3.703883696425648
2025-09-15T02:40:00-04:00,24143,24148.25,24142.5,24146.75,24126.550432417793,NaN,NaN,NaN,NaN,NaN,24129.24,24145.268711724064,24113.21128827594,24129.80382552598,24118.283366566968,24129.86062632938,24106.706106804555,455,348.56666666666666,65.2840554808871,63.55799932905149,NaN,NaN,NaN,NaN,6.469838592171212,32.65667354038205,-26208,0.29328480376719934,4.0704897011346475,3.777204897367448
2025-09-15T02:45:00-04:00,24146.5,24147.5,24142,24145.75,24126.550432417793,NaN,NaN,NaN,NaN,NaN,24129.91,24145.84228170198,24113.97771829802,24129.977770131805,24118.441675917118,24130.165959466816,24106.71739236742,298,353.96666666666664,63.55804004384852,63.49521436592543,NaN,NaN,NaN,NaN,6.400564407016126,33.119838890694,-26506,0.37174197027055067,4.241882360205636,3.8701403899350857
2025-09-15T02:50:00-04:00,24145.25,24147,24141.25,24144,24126.550432417793,NaN,NaN,NaN,NaN,NaN,24130.42,24146.490606724146,24114.34939327585,24130.107216105444,24118.58873680338,24130.438619681536,24106.738853925224,291,352.1666666666667,60.54147112262323,62.85743853150548,NaN,NaN,NaN,NaN,6.354095520800689,33.30096796458955,-26797,0.2544658310397283,4.188222678734746,3.933756847695018
2025-09-15T02:55:00-04:00,24143.75,24150,24142,24147,24127.104778326557,NaN,NaN,NaN,NaN,NaN,24131.035,24147.242408798575,24114.827591201425,24132.485772884356,24118.969486830596,24131.172415755536,24106.766557905656,706,367.8333333333333,63.72034834099685,62.938795992040916,NaN,NaN,NaN,NaN,6.471660126457783,33.91678552855794,-26091,0.32320958079934936,4.337768823694205,4.0145592428948556
2025-09-15T03:00:00-04:00,24146.75,24153,24144,24146,24129.236379311715,NaN,NaN,NaN,NaN,NaN,24131.595,24147.89680663178,24115.293193368223,24134.488618307485,24119.564898004508,24132.314562909803,24106.815233099212,1090,395.3,61.92935949385971,62.727407509608945,NaN,NaN,NaN,NaN,6.652255831710798,34.88242080152932,-27181,0.24893601693437883,4.325729264062829,4.0767932471284505
2025-09-15T03:05:00-04:00,24146.75,24147.25,24143,24146.75,24129.236379311715,NaN,NaN,NaN,NaN,NaN,24132.16,24148.565108966202,24115.754891033797,24134.488618307485,24119.735681687816,24132.616634878,24106.854728497634,346,390.46666666666664,62.774447311782076,62.438653493439936,NaN,NaN,NaN,NaN,6.4806661294457415,35.43203745669379,-26835,0.20002905068365529,4.32682956048302,4.126800509799365
2025-09-15T03:10:00-04:00,24146.75,24148.75,24144,24145.75,24129.236379311715,NaN,NaN,NaN,NaN,NaN,24132.67,24149.14769402805,24116.192305971945,24134.488618307485,24119.922287211077,24132.94706727801,24106.897507144142,376,393,60.835386846356066,61.91532634686671,NaN,NaN,NaN,NaN,6.357047120199617,36.149705393472466,-27211,0.05744834202900062,4.198610937335616,4.141162595306615
2025-09-15T03:15:00-04:00,24145.75,24148,24138.5,24146.5,24129.236379311715,NaN,NaN,NaN,NaN,NaN,24133.155,24149.80399096023,24116.506009039767,24134.488618307485,24120.20767995992,24133.419297636094,24106.996062283746,630,409.1,61.78872276328875,61.26084459896153,NaN,NaN,NaN,NaN,6.581543754471072,35.087242067547955,-26581,-0.024820961968115896,4.110136392846471,4.134957354814587
2025-09-15T03:20:00-04:00,24147,24154.25,24145.5,24149.5,24130.358217227826,NaN,NaN,NaN,NaN,NaN,24133.675,24150.70504697698,24116.64495302302,24135.884738058747,24120.627597687697,24134.203120766575,24107.05207460882,777,427.3666666666667,65.4151780952554,61.302353675792,NaN,NaN,NaN,NaN,6.736433486294567,35.051908288724725,-25804,0.07867076249347171,4.233295807931427,4.154625045437955
2025-09-15T03:25:00-04:00,24149.75,24151.25,24143.25,24143.75,24130.358217227826,NaN,NaN,NaN,NaN,NaN,24134.025,24151.149324799197,24116.900675200806,24135.884738058747,24120.86746762347,24134.600884571584,24107.134050675355,520,441.03333333333336,54.69979401885221,60.438339150874924,NaN,NaN,NaN,NaN,6.826688237273527,34.42740161819136,-26324,-0.2654151713944328,3.8228560811949137,4.0882712525893465
2025-09-15T03:30:00-04:00,24144.25,24153.25,24140.5,24152.5,24130.358217227826,NaN,NaN,NaN,NaN,NaN,24134.5,24152.316284687786,24116.683715312214,24135.884738058747,24121.207358513086,24135.195535618586,24107.219181407585,681,455.73333333333335,64.28679779760392,61.23609589949533,NaN,NaN,NaN,NaN,7.249781934611133,33.171393562384,-25643,0.05396450293749577,4.1557268812612165,4.101762378323721
2025-09-15T03:35:00-04:00,24152.5,24159.25,24147.25,24151.25,24131.985497252714,NaN,NaN,NaN,NaN,NaN,24135.09,24153.130720602814,24117.049279397186,24136.186985886077,24122.07724482811,24136.80073219915,24107.35375745707,1593,503.8333333333333,62.25969237390948,62.023564541090664,NaN,NaN,NaN,NaN,7.5890832249960525,32.89439586843671,-27236,0.13414952256347767,4.269449281528068,4.135299758964591
2025-09-15T03:40:00-04:00,24150.75,24155,24143,24143.75,24131.985497252714,NaN,NaN,NaN,NaN,NaN,24135.57,24153.22560533815,24117.91439466185,24136.186985886077,24122.326660405863,24137.18766470571,24107.465656106015,575,518.0666666666667,51.72159141443917,61.49998756776102,NaN,NaN,NaN,NaN,7.904148708924906,31.690552007926748,-27811,-0.3389576173975781,3.7116027372176177,4.050560354615196
2025-09-15T03:45:00-04:00,24144.25,24148.75,24143.75,24147,24131.985497252714,NaN,NaN,NaN,NaN,NaN,24136.065,24153.586361256497,24118.5436387435,24136.186985886077,24122.461283514403,24137.389635355485,24107.532931673322,325,513.2,55.255850799590256,61.0050525645209,NaN,NaN,NaN,NaN,7.696709515430269,30.572696994596072,-27486,-0.44724406687301643,3.491505271023925,3.9387493378969416
2025-09-15T03:50:00-04:00,24147.5,24147.5,24139.75,24144.75,24131.985497252714,NaN,NaN,NaN,NaN,NaN,24136.445,24153.87895824765,24119.01104175235,24136.186985886077,24122.679754110413,24137.688187577063,24107.671320643763,598,523.8,52.39609945811477,60.08448427718002,NaN,NaN,NaN,NaN,7.700515978613821,28.70063328613905,-28084,-0.6711692119895512,3.0997878229100024,3.7709570348995536
2025-09-15T03:55:00-04:00,24144.75,24146.25,24137.5,24138.5,24131.985497252714,NaN,NaN,NaN,NaN,NaN,24136.72,24153.838305972393,24119.60169402761,24136.186985886077,24122.81361679799,24137.84642870848,24107.7808048875,440,530.2333333333333,45.37158745088456,58.78545194911116,NaN,NaN,NaN,NaN,7.775479122998548,26.767184228249473,-28524,-1.2095768499855817,2.2589859724175767,3.4685628224031584
2025-09-15T04:00:00-04:00,24139,24141.5,24075.5,24085.25,NaN,NaN,NaN,24138.404889199443,24138.404889199443,24138.404889199443,24135.905,24158.11128064983,24113.698719350166,24136.186985886077,24120.407850196258,24136.1760680925,24104.639632300015,7269,764.4,20.345063589460054,55.91427998245665,NaN,NaN,NaN,NaN,11.934373471355794,29.400561437652357,-35793,-4.913545133036542,-2.673368593892519,2.2401765391440227
2025-09-15T04:05:00-04:00,24085,24123.25,24082,24121.25,NaN,NaN,NaN,24136.795576054014,NaN,NaN,24135.89,24158.13481062433,24113.645189375668,24136.186985886077,24119.962130718013,24135.58334527106,24104.340916164965,2670,837.1333333333333,43.16820802453911,54.44626995985253,NaN,NaN,NaN,NaN,14.02834679483038,31.84584027495503,-33123,-4.700531904399286,-3.635488341355085,1.065043563044201
2025-09-15T04:10:00-04:00,24120.25,24121.75,24104.5,24113,NaN,NaN,NaN,24136.795576054014,NaN,NaN,24135.69,24158.565655190927,24112.81434480907,24136.186985886077,24119.85162794878,24135.370977862778,24104.332278034784,1132,839.5333333333333,40.31725617330344,52.90254829409851,NaN,NaN,NaN,NaN,14.258464880913923,34.11645633816466,-34255,-4.856815215115115,-5.005975455849693,-0.149160240734578
2025-09-15T04:15:00-04:00,24112.25,24122.5,24097.25,24119.5,NaN,NaN,NaN,24136.795576054014,NaN,NaN,24135.57,24158.719522676758,24112.42047732324,24136.186985886077,24119.731434372723,24135.138321928534,24104.32454681691,1274,869.6666666666666,43.48419635904503,51.52467322604586,NaN,NaN,NaN,NaN,15.043574532277216,36.44384888032906,-32981,-4.2839936072170275,-5.504152249755862,-1.2201586425388347
2025-09-15T04:20:00-04:00,24120,24120.25,24101,24112.75,NaN,NaN,NaN,24136.795576054014,NaN,NaN,24135.355,24159.139888060672,24111.570111939327,24136.186985886077,24119.61427465318,24134.944990865726,24104.283558440635,1015,895.9,41.048286504450466,50.11130891590975,NaN,NaN,NaN,NaN,15.344033494257415,38.60499909805314,-33996,-4.120031374265943,-6.370197860371263,-2.2501664861053206
2025-09-15T04:25:00-04:00,24113.5,24113.5,24094.75,24098.25,NaN,NaN,NaN,24136.795576054014,NaN,NaN,24134.82,24160.62969585123,24109.01030414877,24130.549588708862,24119.43296381937,24134.786108415083,24104.079819223658,764,913.9666666666667,36.33903325290452,48.2934739508823,NaN,NaN,NaN,NaN,15.587316816096171,40.796664242366454,-34760,-4.706125957480499,-8.132823932955944,-3.426697975475445
2025-09-15T04:30:00-04:00,24098,24104.25,24080.25,24080.75,NaN,NaN,NaN,24132.38183422541,NaN,NaN,24133.865,24163.75115230073,24103.978847699273,24126.68967096709,24118.87044703829,24134.636701231506,24103.104192845076,1358,944.2333333333333,31.623586303738364,45.8797888229168,NaN,NaN,NaN,NaN,16.18822275780359,43.18852075294881,-36118,-5.912344353972199,-10.817128417940694,-4.904784063968495
2025-09-15T04:35:00-04:00,24081.25,24096.5,24080,24095.5,NaN,NaN,NaN,24128.80765994244,NaN,NaN,24133.215,24164.9402281301,24101.4897718699,24125.97673677367,24118.39933464653,24134.445761456056,24102.352907837,1272,973.1,38.82862609588486,44.74613397127627,NaN,NaN,NaN,NaN,16.21049256081762,45.41506030699078,-34846,-5.372417294458294,-11.620305682041362,-6.247888387583068
2025-09-15T04:40:00-04:00,24094.5,24101.25,24089.25,24101,NaN,NaN,NaN,24128.80765994244,NaN,NaN,24132.64,24165.613195178576,24099.666804821423,24124.65638941894,24118.19963879819,24134.301387338106,24102.097890258272,723,981.4,41.31195948149399,43.10507409155414,NaN,NaN,NaN,NaN,15.90974309218779,46.75992520246517,-34123,-4.344412524795751,-11.678404043577757,-7.333991518782006
2025-09-15T04:45:00-04:00,24100.5,24116.5,24100,24116,NaN,NaN,NaN,24128.80765994244,NaN,NaN,24132.36,24165.654317833792,24099.06568216621,24091.22511153515,24118.10457810079,24134.1236834385,24102.085472763076,1005,1007.3,47.564100533679685,42.05538896010915,NaN,NaN,NaN,NaN,15.951904299888664,46.04845155283704,-33118,-2.448210209576514,-10.394254280752648,-7.946044071176134
2025-09-15T04:50:00-04:00,24116.25,24117,24100.75,24101.75,NaN,NaN,NaN,24128.80765994244,NaN,NaN,24131.76,24166.14022106401,24097.379778935985,24071.439509035834,24117.967052394728,24133.940394178415,24101.99371061104,934,1023.7333333333333,42.88955895678951,41.424529498848464,NaN,NaN,NaN,NaN,15.973196849896615,45.330485653053024,-34052,-1.9683272516509867,-10.406453135739866,-8.43812588408888
2025-09-15T04:55:00-04:00,24102,24102,24091,24095.25,NaN,NaN,NaN,24128.80765994244,NaN,NaN,24131.04,24166.908420645545,24095.171579354457,24071.439509035834,24117.747420791933,24133.789397831173,24101.705443752693,799,1034.6666666666667,40.91432603373619,40.40013487271603,NaN,NaN,NaN,NaN,15.617968503475428,45.1651455047651,-34851,-1.9022489752872467,-10.815937103197939,-8.913688127910692
2025-09-15T05:00:00-04:00,24095.5,24096.5,24086,24089.75,NaN,NaN,NaN,24128.80765994244,NaN,NaN,24130.235,24167.921258766903,24092.5487412331,24071.439509035834,24117.48813700243,24133.668564871998,24101.307709132863,772,1034.6666666666667,39.26645781648202,39.46230332688513,NaN,NaN,NaN,NaN,15.252399324655755,45.24405066006482,-35623,-2.0308461150163986,-11.452245771681191,-9.421399656664793
2025-09-15T05:05:00-04:00,24090,24095.75,24087,24092.25,NaN,NaN,NaN,24128.80765994244,NaN,NaN,24129.46,24168.616526916205,24090.303473083794,24071.439509035834,24117.314245378606,24133.57779486765,24101.05069588956,545,1041.1,40.44070261272104,39.11009726701629,NaN,NaN,NaN,NaN,14.787942230037487,45.31731973284314,-35078,-1.7595507398686063,-11.620838081500551,-9.861287341631945
2025-09-15T05:10:00-04:00,24092,24096.5,24088,24090.75,NaN,NaN,NaN,24128.80765994244,NaN,NaN,24128.685,24169.31390719478,24088.056092805222,24071.439509035834,24117.13918648602,24133.483493765132,24100.794879206907,558,1044.5333333333333,39.941711697036126,40.509857846128874,NaN,NaN,NaN,NaN,14.338803499320523,45.282584610247454,-35636,-1.5030925186754,-11.740152989976195,-10.237060471300795
2025-09-15T05:15:00-04:00,24090.75,24092.25,24082.75,24087,NaN,NaN,NaN,24126.073389036137,NaN,NaN,24127.835,24170.105274427293,24085.564725572705,24071.439509035834,24116.91880042553,24133.401560644746,24100.436040206314,607,1054.8333333333333,38.657512071203115,40.18766527803344,NaN,NaN,NaN,NaN,13.993174677940486,45.52236649105318,-36243,-1.40954179356247,-11.998987713253882,-10.589445919691412
2025-09-15T05:20:00-04:00,24087.5,24091.75,24080.25,24090.5,NaN,NaN,NaN,24124.38823498904,NaN,NaN,24127.055,24170.593866547468,24083.516133452533,24071.439509035834,24116.65492760796,24133.29637354996,24100.01348166596,743,1069.9,40.577841553219706,40.206278519456035,NaN,NaN,NaN,NaN,13.815090772373308,45.870455547483424,-35500,-0.9571117210014002,-11.785835570943163,-10.828723849941763
2025-09-15T05:25:00-04:00,24090.25,24094.75,24088.25,24093,NaN,NaN,NaN,24124.38823498904,NaN,NaN,24126.43,24170.997032657073,24081.862967342928,24071.439509035834,24116.50759093927,24133.20769941894,24099.807482459597,498,1062.9666666666667,41.97512723221909,40.0984878675399,NaN,NaN,NaN,NaN,13.292584288632357,45.739100170854215,-35002,-0.3650963707141184,-11.285094313334412,-10.919997942620293
2025-09-15T05:30:00-04:00,24093,24099.75,24090.75,24093,NaN,NaN,NaN,24124.38823498904,NaN,NaN,24125.75,24171.288445296253,24080.211554703747,24073.190128420283,24116.34922899441,24133.09279045532,24099.605667533502,604,1046.7666666666667,41.97512723221909,40.164690776666234,NaN,NaN,NaN,NaN,12.985971125158617,44.89089742525347,-35002,0.12466187344471891,-10.764170600814396,-10.888832474259114
2025-09-15T05:35:00-04:00,24094,24100.5,24089.25,24098.5,NaN,NaN,NaN,24124.38823498904,NaN,NaN,24125.15,24171.31394696792,24078.986053032084,24073.627102736224,24116.218493661443,24132.98663932914,24099.450347993745,545,1053.4,45.259394053411086,40.80185940527384,NaN,NaN,NaN,NaN,12.861973187647289,44.208613853861635,-34457,0.8753664294612893,-9.794624437432503,-10.669990866893793
2025-09-15T05:40:00-04:00,24098.25,24098.75,24087.5,24093.75,NaN,NaN,NaN,24124.38823498904,NaN,NaN,24124.41,24171.37048977641,24077.44951022359,24073.627102736224,24116.07234257756,24132.88598003501,24099.25870512011,543,1058.9666666666667,42.99596176157015,41.61417193797611,NaN,NaN,NaN,NaN,12.746832245672483,43.70092962894596,-35000,1.0941477137773816,-9.302306224672066,-10.396453938449447
2025-09-15T05:45:00-04:00,24093.25,24098.75,24091.25,24095.25,NaN,NaN,NaN,24124.38823498904,NaN,NaN,24123.615,24171.17351238142,24076.05648761858,24073.627102736224,24115.967218230468,24132.804020254975,24099.13041620596,428,1052.2333333333333,43.94924632774241,41.97993052596593,NaN,NaN,NaN,NaN,12.372058513838734,43.22950856295282,-34572,1.3644275349148351,-8.690919519805902,-10.055347054720738
2025-09-15T05:50:00-04:00,24095.5,24099.5,24092.75,24097.75,NaN,NaN,NaN,24124.38823498904,NaN,NaN,24122.78,24170.65855888067,24074.901441119328,24075.766076600947,24115.906203946728,24132.751251831545,24099.06115606191,271,1035.3666666666666,45.58262894298009,42.28497834464351,NaN,NaN,NaN,NaN,11.970482905707396,42.66088695244039,-34301,1.7135249838703057,-7.913440824882855,-9.62696580875316
2025-09-15T05:55:00-04:00,24098,24099.5,24095,24095.5,NaN,NaN,NaN,24124.38823498904,NaN,NaN,24121.965,24170.28394141976,24073.64605858024,24078.262861280757,24115.850705066317,24132.703058072602,24098.998352060033,248,1026.3,44.330535776530986,42.054009433418614,NaN,NaN,NaN,NaN,11.436876983871153,42.13288117125028,-34549,1.786684156676408,-7.393610612907651,-9.180294769584059
2025-09-15T06:00:00-04:00,24095.75,24098.25,24091.25,24096,NaN,NaN,NaN,24124.38823498904,NaN,NaN,24121.12,24169.746971942757,24072.49302805724,24078.262861280757,24115.7656476848,24132.635325169656,24098.89597019994,355,1015.4333333333333,44.694099808608506,42.18290520854854,NaN,NaN,NaN,NaN,11.119957199308928,41.975133465841665,-34194,1.854481799971012,-6.862192519620294,-8.716674319591306
2025-09-15T06:05:00-04:00,24095.5,24104,24095.5,24102,NaN,NaN,NaN,24124.38823498904,NaN,NaN,24120.36,24168.970714866053,24071.74928513395,24083.358231219685,24115.658187638983,24132.516764715536,24098.79961056243,612,982.7333333333333,48.99850097227054,42.760346275586706,NaN,NaN,NaN,NaN,10.93281739935829,40.767664052062415,-33582,2.2621352878014243,-5.8890052098395245,-8.151140497640949
2025-09-15T06:10:00-04:00,24101.75,24102.5,24096,24102.25,NaN,NaN,NaN,24124.38823498904,NaN,NaN,24119.58,24168.076333878376,24071.083666121627,24083.358231219685,24115.596230806535,24132.44911187748,24098.743349735592,351,975.2666666666667,49.175994941628545,43.46817035595432,NaN,NaN,NaN,NaN,10.616187585118412,39.64644245355311,-33231,2.4893265345803766,-5.039482329415478,-7.528808863995854
2025-09-15T06:15:00-04:00,24102,24108.75,24100.75,24108,NaN,NaN,NaN,24124.38823498904,NaN,NaN,24118.86,24166.952011810085,24070.767988189917,24088.939267980597,24115.54671305583,24132.371100951863,24098.7223251598,445,979.2666666666667,53.2093996219967,44.380220142331154,NaN,NaN,NaN,NaN,10.429317043324241,37.55089849785165,-32786,2.9368212765158814,-3.857782268351002,-6.794603544866884
2025-09-15T06:20:00-04:00,24108,24114.5,24106.25,24109,NaN,NaN,NaN,24124.38823498904,NaN,NaN,24118.215,24165.95230302437,24070.47769697563,24094.52641438448,24115.509485394017,24132.28436401301,24098.734606775026,584,978.8,53.89468387937904,45.37686101249851,NaN,NaN,NaN,NaN,10.273651540229652,34.95725950022185,-32202,3.1891120545254434,-2.8082134767100797,-5.997325531235523
2025-09-15T06:25:00-04:00,24110,24123,24109.25,24122.75,NaN,NaN,NaN,24124.38823498904,NaN,NaN,24117.81,24165.040240308048,24070.579759691955,24100.021131507583,24115.54316205371,24132.22053103219,24098.865793075227,1066,999.6666666666666,62.11155228289494,47.05214959904792,NaN,NaN,NaN,NaN,10.539819287356107,33.55666155876179,-31136,4.112233852414162,-0.85703321571782,-4.969267068131982
2025-09-15T06:30:00-04:00,24122.25,24133.25,24122.25,24124.5,24095.242748325825,24095.242748325825,24095.242748325825,NaN,NaN,NaN,24117.59,24164.590506378045,24070.589493621956,24109.366905206065,24115.71819358035,24132.321640089227,24099.11474707147,1429,805,63.01499585670862,48.65480347786856,NaN,NaN,NaN,NaN,10.572689338259242,33.20233581957249,-29707,4.632243388794789,0.8210371678615047,-3.8112062209332844
2025-09-15T06:35:00-04:00,24125.75,24130.75,24118.5,24119.75,24095.242748325825,NaN,NaN,NaN,NaN,NaN,24117.3,24164.064088787385,24070.535911212613,24109.366905206065,24115.796875510576,24132.327527439596,24099.266223581555,992,749.0666666666667,58.90902113733656,49.864367328234096,NaN,NaN,NaN,NaN,10.692497242669296,32.33986210347409,-30699,4.44695757556792,1.7474907485266158,-2.699466827041304
2025-09-15T06:40:00-04:00,24119.5,24122.25,24116,24118,24095.242748325825,NaN,NaN,NaN,NaN,NaN,24116.85,24163.143088039044,24070.556911960954,24109.366905206065,24115.81678026614,24132.293399604852,24099.34016092743,623,732.1,57.42445895388115,50.967891022638526,NaN,NaN,NaN,NaN,10.37517601105006,31.19268164614043,-31322,4.010636765157322,2.313829129405349,-1.6968076357519735
2025-09-15T06:45:00-04:00,24118,24124.75,24116,24122.5,24095.242748325825,NaN,NaN,NaN,NaN,NaN,24116.43,24162.125518379708,24070.734481620293,24109.366905206065,24115.841845048377,24132.283205340682,24099.400484756072,442,704.3666666666667,60.20185949960585,52.03520998308101,NaN,NaN,NaN,NaN,10.25909201026077,30.374565559762303,-30880,3.8295640861414713,3.0901474719248654,-0.7394166142166056
2025-09-15T06:50:00-04:00,24122.5,24129.25,24119.75,24127.5,24095.242748325825,NaN,NaN,NaN,NaN,NaN,24116.045,24161.031074512914,24071.058925487083,24109.366905206065,24115.89304929293,24132.305761113013,24099.480337472844,495,687.0333333333333,63.08350760052147,53.47003468586325,NaN,NaN,NaN,NaN,10.204871152385001,30.04006883113694,-30385,3.8411486006617768,4.0620191366106155,0.22087053594883865
2025-09-15T06:55:00-04:00,24127.25,24128.25,24124,24127.25,24095.33259275793,NaN,NaN,NaN,NaN,NaN,24115.675,24159.976834049536,24071.373165950463,24109.366905206065,24115.92521524952,24132.323396906555,24099.527033592487,284,671.0333333333333,62.83851174233672,54.81926792976285,NaN,NaN,NaN,NaN,9.77952321292893,29.729464725984815,-30669,3.6290821426221624,4.757223214226542,1.1281410716043794
2025-09-15T07:00:00-04:00,24127.5,24136.5,24126.25,24135,24100.584520359844,NaN,NaN,NaN,NaN,NaN,24115.495,24159.4064438389,24071.5835561611,24114.84714999834,24116.131974908956,24132.532104851365,24099.731844966547,1177,665,67.1036837869625,56.35648613290444,NaN,NaN,NaN,NaN,9.813128697719721,30.16402730188421,-29492,3.7902223602223297,5.865919021882291,2.0756966616599617
2025-09-15T07:05:00-04:00,24134.5,24144.25,24130.5,24142.25,24106.109087616216,NaN,NaN,NaN,NaN,NaN,24115.4,24159.058218006296,24071.741781993707,24120.05271999867,24116.37769321983,24132.85898381904,24099.896402620623,1030,656.9333333333333,70.51319526520476,58.22667609638115,NaN,NaN,NaN,NaN,10.094333790739741,31.122814454285262,-28462,4.136286540068284,7.246054836745316,3.1097682966770326
2025-09-15T07:10:00-04:00,24142.5,24144.25,24137.25,24139.5,24109.950719997294,NaN,NaN,NaN,NaN,NaN,24115.27,24158.600455801254,24071.939544198747,24121.392175998935,24116.55111402246,24133.09774066543,24100.004487379487,699,656.1333333333333,67.64910744253699,59.866319498804614,NaN,NaN,NaN,NaN,9.873309948544046,32.01311681008624,-29161,3.932512148841078,8.02540848272838,4.092896333887302
2025-09-15T07:15:00-04:00,24138.75,24140.5,24131.75,24136.25,24109.950719997294,NaN,NaN,NaN,NaN,NaN,24115.06,24157.87688451661,24072.243115483394,24121.392175998935,24116.69189501825,24133.2619744262,24100.121815610302,698,645.9,64.32386424958462,60.96098830432704,NaN,NaN,NaN,NaN,9.793073523648044,31.910144797029588,-29859,3.3539199611587893,8.28529628533579,4.931376324177
2025-09-15T07:20:00-04:00,24136.75,24141.25,24135.75,24135.75,24109.950719997294,NaN,NaN,NaN,NaN,NaN,24114.86,24157.192276105194,24072.527723894807,24121.392175998935,24116.778745695145,24133.36889281814,24100.18859857215,406,628.3,63.804248546719506,62.00586356183354,NaN,NaN,NaN,NaN,9.48642541481604,31.879675288091818,-30265,2.73858431211856,8.3546067143252,5.6160224022066405
2025-09-15T07:25:00-04:00,24136.25,24139,24131.5,24134.75,24109.950719997294,NaN,NaN,NaN,NaN,NaN,24114.625,24156.378592662077,24072.871407337923,24121.392175998935,24116.856014104855,24133.453590667083,24100.258437542627,414,615.4666666666667,62.71310195113822,62.68469944248651,NaN,NaN,NaN,NaN,9.344537885186323,31.154351728463638,-30679,2.094324865343002,8.233928483885393,6.139603618542391
2025-09-15T07:30:00-04:00,24134.25,24138.25,24129.5,24135.5,24109.950719997294,NaN,NaN,NaN,NaN,NaN,24114.345,24155.340230205395,24073.349769794608,24121.392175998935,24116.95606871661,24133.558989318946,24100.35314811427,562,608.4666666666667,63.2211186249912,63.350873352887376,NaN,NaN,NaN,NaN,9.3020708933873,30.16566251538415,-30117,1.5726172089526056,8.105375129733147,6.532757920780542
2025-09-15T07:35:00-04:00,24135.25,24148,24133.75,24144,24110.810594255017,NaN,NaN,NaN,NaN,NaN,24114.35,24155.35963302004,24073.340366979955,24124.284948231332,24117.210799365806,24133.918197404244,24100.50340132737,1017,624.2,68.46504176127938,63.80469402991484,NaN,NaN,NaN,NaN,9.655494401002494,30.1918925121827,-29100,1.6460739998467249,8.590350420588948,6.944276420742223
2025-09-15T07:40:00-04:00,24143.25,24146.25,24135.75,24142.25,24110.870339970697,NaN,NaN,NaN,NaN,NaN,24114.145,24154.486800899685,24073.803199100315,24124.284948231332,24117.379642731397,24134.15011004093,24100.609175421865,700,628.9333333333333,66.36700156578996,64.04412300913494,NaN,NaN,NaN,NaN,9.715816229502318,30.216248937781355,-29800,1.430834819940518,8.73281994566787,7.301985125727352
2025-09-15T07:45:00-04:00,24142.25,24148,24141,24143.5,24114.785324517485,NaN,NaN,NaN,NaN,NaN,24113.99,24153.81661923615,24074.163380763854,24125.122366868054,24117.50504168898,24134.335825864793,24100.674257513165,472,624.4333333333333,67.14155011743748,64.63216079342786,NaN,NaN,NaN,NaN,9.521829355966437,30.398686676497732,-29328,1.234121621454963,8.844637152546056,7.610515531091093
2025-09-15T07:50:00-04:00,24143.25,24145,24139.75,24140.25,24114.785324517485,NaN,NaN,NaN,NaN,NaN,24113.92,24153.54895911501,24074.291040884986,24125.122366868054,24117.57838687668,24134.43608966239,24100.72068409097,307,609.9,63.074364668375715,65.03572548732032,NaN,NaN,NaN,NaN,9.21669868768312,30.33880404540269,-29635,0.7693398801402527,8.57219038126641,7.802850501126157
2025-09-15T07:55:00-04:00,24140,24146,24134.75,24143.75,24114.785324517485,NaN,NaN,NaN,NaN,NaN,24113.855,24153.276832785807,24074.433167214193,24125.122366868054,24117.741190854984,24134.65615776117,24100.8262239488,693,616.4,65.49825537951922,65.41403947874271,NaN,NaN,NaN,NaN,9.361934495705754,29.410285109378187,-28942,0.5899183459885551,8.54024843361185,7.950330087623295
2025-09-15T08:00:00-04:00,24144,24152.5,24141.5,24151.75,24117.53926937983,NaN,NaN,NaN,NaN,NaN,24113.995,24153.901451864785,24074.088548135212,24129.106651836442,24118.03073631608,24135.12682998352,24100.934642648637,965,628.4333333333333,70.2976122775793,65.92933266996113,NaN,NaN,NaN,NaN,9.478939174583914,29.236832451625077,-27977,0.8845955785835411,9.056074560852721,8.17147898226918
2025-09-15T08:05:00-04:00,24151.75,24153.25,24143.75,24149,24119.082938953474,NaN,NaN,NaN,NaN,NaN,24114.205,24154.730756004763,24073.67924399524,24129.785321469153,24118.301916098564,24135.562379151994,24101.041453045134,918,640.8666666666667,66.85488570573472,66.21621652448955,NaN,NaN,NaN,NaN,9.480443519256491,29.150289223824156,-28895,0.7729252075891715,9.137635491755645,8.364710284166474
2025-09-15T08:10:00-04:00,24149.25,24151.75,24145.5,24148.5,24119.69280536468,NaN,NaN,NaN,NaN,NaN,24115.47,24156.249362420724,24074.69063757928,24129.853257175324,24118.468303893922,24135.82622290953,24101.110384878313,573,641.8666666666667,66.21988765667093,66.15308822946872,NaN,NaN,NaN,NaN,9.249697553595313,29.069927655151872,-29468,0.5542460669977824,9.057517867913703,8.50327180091592
2025-09-15T08:15:00-04:00,24148.75,24164,24143.25,24151.75,24123.178359666286,NaN,NaN,NaN,NaN,NaN,24116.08,24158.081123793647,24074.078876206357,24136.107605740257,24119.513531776654,24137.60160735483,24101.425456198478,3255,736.1,68.32581202554802,65.99684656949326,NaN,NaN,NaN,NaN,10.071147728338506,30.09037019178482,-26213,0.518012425045292,9.150787332222535,8.632774907177243
2025-09-15T08:20:00-04:00,24151,24172.5,24147.75,24170.75,24127.68729786327,NaN,NaN,NaN,NaN,NaN,24117.235,24161.92397067231,24072.546029327692,24137.811084592206,24120.55272150538,24139.638883060925,24101.466559949837,2592,813.4666666666667,77.25367984017188,66.6828874550386,NaN,NaN,NaN,NaN,11.119637176314328,31.593487138724836,-23621,1.6019790644915641,10.635248737791699,9.033269673300135
2025-09-15T08:25:00-04:00,24171,24172,24155.5,24157.25,24130.536738869487,NaN,NaN,NaN,NaN,NaN,24117.99,24164.060702183557,24071.919297816446,24137.811084592206,24121.244995640616,24140.89341904064,24101.596572240593,1890,868.2,63.54778149903774,66.62745297285667,NaN,NaN,NaN,NaN,11.503948806577588,32.98923858945484,-25511,1.253516907619046,10.600165807823942,9.346648900204896
2025-09-15T08:30:00-04:00,24157.75,24158.5,24145.75,24152.5,24130.536738869487,NaN,NaN,NaN,NaN,NaN,24118.785,24165.828172725473,24071.741827274527,24137.811084592206,24121.865600240282,24141.79522009845,24101.935980382113,2288,932.6333333333333,59.54485947699522,66.3232108964478,NaN,NaN,NaN,NaN,11.592952463250617,32.61791302994085,-27799,0.5810506338493404,10.07296219251657,9.49191155866723
2025-09-15T08:35:00-04:00,24152.25,24152.5,24141.75,24145.75,24130.536738869487,NaN,NaN,NaN,NaN,NaN,24119.735,24166.998983115693,24072.47101688431,24137.811084592206,24122.165893167854,24142.159341022587,24102.17244531312,1401,958.9333333333333,54.309490320624995,65.72295292283972,NaN,NaN,NaN,NaN,11.532741573018429,31.690011022930527,-29200,-0.3882030096836644,9.00665779656265,9.394860806246314
2025-09-15T08:40:00-04:00,24145.75,24156,24140.25,24155.5,24130.536738869487,NaN,NaN,NaN,NaN,NaN,24121.23,24168.194757002122,24074.265242997877,24137.811084592206,24122.518079264817,24142.634442598515,24102.40171593112,1452,995.6333333333333,59.80669915087279,65.47906581754555,NaN,NaN,NaN,NaN,11.833974317802827,31.15434377092437,-27748,-0.4387911030708551,8.846371927407745,9.2851630304786
2025-09-15T08:45:00-04:00,24155.5,24156,24148.75,24156,24130.536738869487,NaN,NaN,NaN,NaN,NaN,24122.44,24169.806502935895,24075.073497064102,24137.811084592206,24122.760901936203,24142.984387207485,24102.53741666492,923,1011.5666666666667,60.07200316875687,64.8795630609368,NaN,NaN,NaN,NaN,11.50654758081691,30.656938465490075,-26825,-0.500238812321232,8.65986451507706,9.160103327398293
2025-09-15T08:50:00-04:00,24155.25,24168.25,24153.75,24168.25,24130.536738869487,NaN,NaN,NaN,NaN,NaN,24123.785,24172.441552484706,24075.128447515293,24137.811084592206,24123.394368858648,24144.081794993413,24102.706942723882,1869,1054.4,65.9943286793353,64.85294356904716,NaN,NaN,NaN,NaN,11.72036561075856,31.209298449960617,-24956,0.18572576735165036,9.392260536587855,9.206534769236205
2025-09-15T08:55:00-04:00,24168,24175,24159.5,24173,24132.761231931592,NaN,NaN,NaN,NaN,NaN,24124.925,24175.434231828305,24074.415768171693,24141.36995916747,24124.10475365839,24145.396508442078,24102.812998874702,1891,1081.9,67.97772343221074,64.9126702343881,NaN,NaN,NaN,NaN,11.990339495704376,32.162402895746645,-23065,0.8251387079397396,10.237958154160879,9.412819446221139
2025-09-15T09:00:00-04:00,24173.25,24179,24168,24170.5,24139.07890320743,NaN,NaN,NaN,NaN,NaN,24126.3,24177.941262573368,24074.65873742663,24146.59596733398,24125.05716917828,24147.184130777838,24102.93020757872,2446,1115.8,65.80236710042601,65.10752755096313,NaN,NaN,NaN,NaN,11.91960096029692,33.28508158506321,-25511,0.9372961793821073,10.584439670448774,9.647143491066666
2025-09-15T09:05:00-04:00,24171,24178.5,24170,24171.5,24140.23440760709,NaN,NaN,NaN,NaN,NaN,24127.825,24180.206604595325,24075.443395404676,24148.326773867182,24125.648392010375,24148.27136375452,24103.02542026623,1541,1134.1,66.26737317550946,65.162464536391,NaN,NaN,NaN,NaN,11.67534374884714,34.327568939428595,-23970,0.9343261931852958,10.815051232548285,9.88072503936299
2025-09-15T09:10:00-04:00,24171.75,24176.25,24169.25,24172,24140.23440760709,NaN,NaN,NaN,NaN,NaN,24129.47,24182.130672232463,24076.80932776754,24148.611419093744,24125.933718269727,24148.780349943027,24103.087086596428,771,1139.0333333333333,66.51256117025443,64.89210374301065,NaN,NaN,NaN,NaN,11.341390623929486,35.1595383344554,-23199,0.8253138882158364,10.912367399632785,10.087053511416949
2025-09-15T09:15:00-04:00,24172,24173.75,24162.25,24170,24140.23440760709,NaN,NaN,NaN,NaN,NaN,24131.025,24183.789216089346,24078.260783910657,24148.611419093744,24126.58782962196,24149.858048224534,24103.317611019385,1968,1189.9,64.49322867568,64.7234139551496,NaN,NaN,NaN,NaN,11.352719865077379,34.73690647942864,-25167,0.49412570054579774,10.704710637099197,10.2105849365534
2025-09-15T09:20:00-04:00,24169.75,24177.5,24169,24173.5,24140.23440760709,NaN,NaN,NaN,NaN,NaN,24132.68,24185.478393911802,24079.881606088198,24150.961308219998,24127.002243310533,24150.579832575844,24103.424654045222,1150,1211.7333333333333,66.4148766912418,64.73734174333323,NaN,NaN,NaN,NaN,11.148954160428996,34.65795832041677,-24017,0.39091434449151485,10.699227867167792,10.308313522676277
2025-09-15T09:25:00-04:00,24173.5,24183.25,24167.5,24177,24141.621813639074,NaN,NaN,NaN,NaN,NaN,24134.48,24187.062491385324,24081.897508614675,24154.144046576,24128.07763410864,24152.47285429362,24103.682413923656,2916,1299.4666666666667,68.26453781888218,64.73296501428567,NaN,NaN,NaN,NaN,11.477600291826926,35.02509595958397,-21101,0.43511398681792635,10.852206006198685,10.417092019380759
2025-09-15T09:30:00-04:00,24177.75,24212.25,24172,24201,24154.417413019117,NaN,NaN,NaN,NaN,NaN,24136.69,24190.954496685834,24082.425503314164,24168.8402372608,24135.25955462961,24166.25936894136,24104.259740317862,15923,1791,77.439763438106,64.7462566998524,NaN,NaN,NaN,NaN,13.532771699553575,36.80821905105432,-5178,1.876661364287635,12.762918724740302,10.886257360452667
2025-09-15T09:35:00-04:00,24201,24224.75,24196,24214.5,24170.460939700064,NaN,NaN,NaN,NaN,NaN,24139.12,24196.152117269532,24082.087882730466,24175.64718980864,24140.692716638416,24176.452954805212,24104.93247847162,11359,2135.3,80.802045166673,65.97870410468349,NaN,NaN,NaN,NaN,14.619716578156892,38.84897196570627,6181,3.444108174508603,15.19139257858842,11.747284404079817
2025-09-15T09:40:00-04:00,24213.75,24227.5,24197.75,24204,24170.468396986427,NaN,NaN,NaN,NaN,NaN,24141.34,24199.64555376669,24083.03444623331,24175.64718980864,24145.645365565302,24184.434150200683,24106.85658092992,12355,2523.8333333333335,71.83468052578742,66.85654846531149,NaN,NaN,NaN,NaN,15.700451108288544,40.820442501339,-6174,3.4688244073990653,16.08331491332865,12.614490505929584
2025-09-15T09:45:00-04:00,24204,24234.5,24204,24228.5,24174.850515305225,NaN,NaN,NaN,NaN,NaN,24143.94,24205.854663857026,24082.02533614297,24175.92420147753,24150.07984221608,24191.768864548463,24108.390819883698,10573,2853,77.9764252120938,68.54704381470212,NaN,NaN,NaN,NaN,16.75756174341079,42.83839570644809,4399,4.75100341742834,18.55324477771501,13.802241360286668
2025-09-15T09:50:00-04:00,24228.75,24251.25,24226,24246.5,24192.80049188226,NaN,NaN,NaN,NaN,NaN,24146.995,24213.598715363103,24080.391284636895,24191.764361182024,24155.627982259244,24201.532812773905,24109.723151744583,11848,3234.4,81.2170705802837,70.07635605966004,NaN,NaN,NaN,NaN,17.364164476024307,45.082557770797024,16247,6.328478480032917,21.712839460327814,15.384360980294897
2025-09-15T09:55:00-04:00,24246.5,24262.25,24238.75,24260.75,24203.553878614886,NaN,NaN,NaN,NaN,NaN,24150.305,24222.507790111566,24078.102209888435,24202.911488945618,24159.915866793726,24209.092977689405,24110.738755898048,8881,3516.633333333333,83.31073874761177,71.73626574386397,NaN,NaN,NaN,NaN,17.80243844202257,47.36132748928188,25128,7.754605416221878,25.077617750572244,17.323012334350366
2025-09-15T10:00:00-04:00,24260.5,24265.5,24248.75,24253,24210.02870231421,NaN,NaN,NaN,NaN,NaN,24153.41,24229.550774882307,24077.269225117692,24209.654191156496,24164.29769259856,24216.341331090905,24112.254054106215,9754,3823.0333333333333,78.20508854686551,72.60846287725899,NaN,NaN,NaN,NaN,17.727264267592385,49.53096102388954,15374,7.589447429990617,26.809821621838637,19.22037419184802
2025-09-15T10:05:00-04:00,24253.25,24262.25,24245.5,24249.5,24210.02870231421,NaN,NaN,NaN,NaN,NaN,24156.49,24235.419396297188,24077.560603702816,24209.654191156496,24167.293568530487,24220.879698997425,24113.70743806355,7508,4039.4,75.94158715333961,73.17731028591105,NaN,NaN,NaN,NaN,17.657459677050074,51.11470572921429,7866,6.689487922594246,27.582234095090826,20.89274617249658
2025-09-15T10:10:00-04:00,24250,24254.25,24238,24247.25,24210.02870231421,NaN,NaN,NaN,NaN,NaN,24159.515,24240.505827261804,24078.524172738194,24209.654191156496,24170.002416293468,24224.59627803101,24115.408554555925,7820,4276.733333333334,74.44979466656832,73.79498368349265,NaN,NaN,NaN,NaN,17.55692684297507,51.631243063568,46,5.440671805344387,27.69358592917706,22.252914123832674
2025-09-15T10:15:00-04:00,24248.25,24250,24239,24241.75,24210.02870231421,NaN,NaN,NaN,NaN,NaN,24162.31,24244.800215177864,24079.81978482214,24209.654191156496,24171.29885567351,24226.268740494113,24116.32897085291,4101,4397.7,70.7891281702277,74.11796618311537,NaN,NaN,NaN,NaN,17.088574925619707,52.110884874039286,-4055,3.8188563289653352,27.026484535039344,23.20762820607401
2025-09-15T10:20:00-04:00,24242,24243.25,24229,24235,24210.02870231421,NaN,NaN,NaN,NaN,NaN,24164.965,24248.094838805515,24081.835161194485,24209.654191156496,24173.40654999875,24228.67203031616,24118.141069681336,7869,4649.766666666666,66.46951425157367,74.1148914032096,NaN,NaN,NaN,NaN,16.88581957378973,51.34178459622488,-11924,1.9597943018535133,25.6573710833909,23.697576781537386
2025-09-15T10:25:00-04:00,24234.5,24258,24230.25,24254.5,24210.02870231421,NaN,NaN,NaN,NaN,NaN,24167.895,24253.08860832878,24082.70139167122,24209.654191156496,24176.207867797013,24232.23351143275,24120.182224161275,9444,4941.466666666666,71.81939604830959,74.63818907268315,NaN,NaN,NaN,NaN,17.661832461376175,51.23811358426157,-2480,1.720232743962761,25.847867711490835,24.127634967528074
2025-09-15T10:30:00-04:00,24254.25,24258,24221,24240.75,24210.02870231421,NaN,NaN,NaN,NaN,NaN,24170.53,24256.42130573027,24084.638694269728,24209.654191156496,24178.392353642346,24234.656411156004,24122.12829612869,8879,5205.266666666666,64.05814916938499,74.46985139255051,NaN,NaN,NaN,NaN,19.043130142706445,50.182646769770514,-11359,0.3824428376363862,24.605688514573558,24.22324567693717
2025-09-15T10:35:00-04:00,24241.25,24253.75,24237,24248.25,24210.02870231421,NaN,NaN,NaN,NaN,NaN,24173.04,24260.51978966414,24085.56021033586,24209.654191156496,24179.675827697472,24236.168261844465,24123.18339355048,4986,5340.866666666667,66.20352973725778,74.32263652957735,NaN,NaN,NaN,NaN,18.879335132513127,49.202570442028815,-6373,-0.21831247225283335,23.95035508662113,24.168667558873963
2025-09-15T10:40:00-04:00,24248.5,24260,24246,24255.25,24210.02870231421,NaN,NaN,NaN,NaN,NaN,24175.655,24264.972125458262,24086.337874541736,24209.654191156496,24180.81652291936,24237.60952007847,24124.023525760247,4128,5459.366666666667,68.11642992414403,73.65668413572291,NaN,NaN,NaN,NaN,18.530811194476478,48.590222747095666,-2245,-0.35702744340416004,23.722383254618762,24.079410698022922
2025-09-15T10:45:00-04:00,24255.75,24263.5,24240,24244,24210.02870231421,NaN,NaN,NaN,NaN,NaN,24178.14,24268.009358517047,24088.27064148295,24211.2537625787,24182.2936208562,24239.342006336163,24125.245235376235,5921,5548.233333333334,62.03893678522318,72.3164621084765,NaN,NaN,NaN,NaN,18.885753252013874,47.38362839304679,-8166,-1.3627314403522277,22.37599639758264,23.738727837934867
2025-09-15T10:50:00-04:00,24244,24257,24240.25,24251.75,24210.02870231421,NaN,NaN,NaN,NaN,NaN,24180.815,24271.32471273865,24090.305287261348,24211.2537625787,24183.239893973685,24240.43836897923,24126.04141896814,3903,5591.933333333333,64.39566418649233,71.78510379852685,NaN,NaN,NaN,NaN,18.7331994482986,46.26321935000141,-4263,-1.643485143791775,21.684371408195148,23.327856551986923
2025-09-15T10:55:00-04:00,24251.5,24262.75,24251,24262,24210.02870231421,NaN,NaN,NaN,NaN,NaN,24183.605,24275.34430945727,24091.86569054273,24216.73740805037,24184.21695176731,24241.67910157102,24126.7548019636,3651,5650.633333333333,67.2882215848438,71.02166068229471,NaN,NaN,NaN,NaN,18.23439948770584,45.54452425775763,-612,-1.2918464801944864,21.713048451743816,23.004894931938303
2025-09-15T11:00:00-04:00,24262,24278.75,24257.5,24265.75,24216.849281955365,NaN,NaN,NaN,NaN,NaN,24186.37,24279.501747542818,24093.23825245718,24231.314926440296,24186.44363229722,24244.697873417997,24128.189391176445,7750,5832.7,68.302814633272,70.09921382893673,NaN,NaN,NaN,NaN,18.449799524298278,45.62902322193755,7138,-0.9741404475901341,21.787219372450636,22.76135982004077
2025-09-15T11:05:00-04:00,24265.75,24267.75,24249,24249.5,24216.849281955365,NaN,NaN,NaN,NaN,NaN,24188.815,24282.028883623654,24095.601116376343,24231.314926440296,24187.756889836084,24246.2188215816,24129.29495809057,5615,5973.166666666667,59.66655880457715,68.41034383300568,NaN,NaN,NaN,NaN,18.471242415419827,44.80352958338528,1523,-1.9684904191412116,20.300746796114254,22.269237215255465
2025-09-15T11:10:00-04:00,24250,24266,24245.5,24255.75,24216.849281955365,NaN,NaN,NaN,NaN,NaN,24191.23,24284.99693660338,24097.46306339662,24231.314926440296,24188.91877590018,24247.54507898303,24130.29247281733,5127,6095.666666666667,61.67377555367339,67.22953576206339,NaN,NaN,NaN,NaN,18.616153671461266,43.68421669299453,6650,-2.2927021830105616,19.403359486492263,21.696061669502825
2025-09-15T11:15:00-04:00,24255.75,24261.75,24247,24250,24216.849281955365,NaN,NaN,NaN,NaN,NaN,24193.385,24287.50222531068,24099.267774689317,24231.314926440296,24189.55716464336,24248.23600557005,24130.87832371667,3023,6165.666666666667,58.775766057659986,66.00340568380055,NaN,NaN,NaN,NaN,18.339999837785463,42.644854723345986,3627,-2.9404750184152597,18.02046789648375,20.96094291489901
2025-09-15T11:20:00-04:00,24250,24251.25,24240.5,24247.75,24216.849281955365,NaN,NaN,NaN,NaN,NaN,24195.55,24289.58967247943,24101.51032752057,24231.314926440296,24190.356559292653,24249.005937170237,24131.70718141507,4315,6247.2,57.6345148069613,64.80231426525721,NaN,NaN,NaN,NaN,17.79785699222936,41.001682470314336,-688,-3.527028581884533,16.552157187543344,20.079185769427877
2025-09-15T11:25:00-04:00,24247.5,24264.25,24247.5,24253.75,24216.849281955365,NaN,NaN,NaN,NaN,NaN,24197.9,24291.767086882108,24104.032913117895,24231.314926440296,24191.38170732097,24250.124618054502,24132.638796587435,4940,6348.833333333333,59.87211579673396,64.02252766715051,NaN,NaN,NaN,NaN,17.72301006421298,40.26047124628185,4252,-3.5099284466096563,15.691775211165805,19.20170365777546
2025-09-15T11:30:00-04:00,24253.5,24257.5,24250,24250.5,24216.849281955365,NaN,NaN,NaN,NaN,NaN,24200.195,24293.481080955764,24106.908919044236,24231.314926440296,24191.839989438362,24250.6005303437,24133.079448533023,2353,6345.733333333334,58.08260892498726,63.42346300096576,NaN,NaN,NaN,NaN,16.99279505962634,39.57220368110884,1899,-3.697679838422534,14.579603859747294,18.27728369816983
2025-09-15T11:35:00-04:00,24251,24267.25,24250.25,24265,24216.849281955365,NaN,NaN,NaN,NaN,NaN,24202.8,24295.904672280696,24109.695327719302,24231.314926440296,24192.540151846402,24251.409308126582,24133.670995566223,3226,6401.9,63.34635847593636,62.81824603151053,NaN,NaN,NaN,NaN,16.993309698224458,39.459663096002345,5125,-2.862794667498715,14.698790363796434,17.56158503129515
2025-09-15T11:40:00-04:00,24265.5,24274.75,24260.25,24261,24218.278248641458,NaN,NaN,NaN,NaN,NaN,24205.31,24297.786567839354,24112.83343216065,24236.782419249128,24193.682909025032,24252.784952897022,24134.580865153042,5070,6545.2,61.06815533144765,62.60467504308644,NaN,NaN,NaN,NaN,16.815216148351283,39.71347542066482,55,-2.6048086635520775,14.305574201855052,16.91038286540713
2025-09-15T11:45:00-04:00,24261.25,24278.75,24258.5,24277.5,24218.879237339574,NaN,NaN,NaN,NaN,NaN,24207.98,24300.929440020453,24115.030559979547,24238.250935399305,24194.99504348178,24254.448467881124,24135.541619082436,5533,6664.033333333334,66.43124079693621,62.62094011877775,NaN,NaN,NaN,NaN,17.06055785204048,40.129909656314474,5588,-1.4077369395986707,15.150711690908793,16.558448630507463
2025-09-15T11:50:00-04:00,24277.25,24282.5,24272.5,24281.5,24228.651772005956,NaN,NaN,NaN,NaN,NaN,24210.765,24304.01388256825,24117.516117431747,24245.100748319444,24196.153849964267,24256.000844083133,24136.3068558454,4604,6779.166666666667,67.59660320698279,62.583809638980526,NaN,NaN,NaN,NaN,16.556232291180443,40.683501825478366,10192,-0.4793292377715552,15.95928708329302,16.438616321064575
2025-09-15T11:55:00-04:00,24281.5,24289.75,24275,24280.25,24233.735782369324,NaN,NaN,NaN,NaN,NaN,24213.5,24306.718667657235,24120.281332342765,24252.455598655553,24197.585849566214,24257.935562036593,24137.236137095835,5673,6871.066666666667,66.81598123284195,62.92502709952472,NaN,NaN,NaN,NaN,16.42721569895327,41.50286595333406,4519,-0.10193385273074895,16.31119900515114,16.413132857881887
2025-09-15T12:00:00-04:00,24280,24281,24266,24270,24233.735782369324,NaN,NaN,NaN,NaN,NaN,24216.095,24308.230329269158,24123.959670730845,24252.455598655553,24198.5384366925,24259.08568141872,24137.991191966277,4373,6486.066666666667,60.63266972343993,62.656241780735265,NaN,NaN,NaN,NaN,16.325271720456605,41.189869828809506,146,-0.6638126491579648,15.583367046434432,16.247179695592397
2025-09-15T12:05:00-04:00,24269.5,24284.5,24269,24283.25,24233.735782369324,NaN,NaN,NaN,NaN,NaN,24218.885,24310.53576159053,24127.234238409466,24252.455598655553,24199.242671775857,24259.98770140562,24138.497642146096,3033,6208.533333333334,65.12554993749657,62.50176523449618,NaN,NaN,NaN,NaN,16.266323740423992,41.077698148022904,3179,-0.28372762777869553,15.892520160869026,16.17624778864772
2025-09-15T12:10:00-04:00,24283,24294.25,24276.25,24286,24236.610650405924,NaN,NaN,NaN,NaN,NaN,24221.57,24313.062132995186,24130.077867004813,24255.155266511643,24200.362433685168,24261.496636060776,24139.22823130956,4553,5948.466666666666,65.99302768456056,62.33678045244536,NaN,NaN,NaN,NaN,16.390157758965135,41.43290686212197,7732,-0.002601416580709781,16.172996017921832,16.175597434502542
2025-09-15T12:15:00-04:00,24285.5,24291.25,24280.5,24281.75,24237.98062084202,NaN,NaN,NaN,NaN,NaN,24224.225,24314.839747697417,24133.61025230258,24255.155266511643,24200.95958309859,24262.284548928892,24139.634617268286,2507,5679.6,63.36957817201402,62.60128183583371,NaN,NaN,NaN,NaN,15.987289347610483,41.76274352521395,5225,-0.24495548854988058,15.869403073815192,16.114358562365073
2025-09-15T12:20:00-04:00,24281.75,24288.25,24276.75,24279.25,24237.98062084202,NaN,NaN,NaN,NaN,NaN,24226.84,24316.09893568672,24137.58106431328,24255.155266511643,24201.531527163283,24263.010851070747,24140.05220325582,2529,5368.966666666666,61.812932506426044,62.61122161817319,NaN,NaN,NaN,NaN,15.66676867992402,41.595863688630615,2696,-0.6904730447976508,15.25126725636801,15.94174030116566
2025-09-15T12:25:00-04:00,24279.5,24280.5,24267.5,24270,24237.98062084202,NaN,NaN,NaN,NaN,NaN,24229.205,24316.627690988233,24141.78230901177,24255.155266511643,24202.272544994477,24263.85579915677,24140.689290832186,3745,5197.766666666666,56.302068328113954,62.43452892320561,NaN,NaN,NaN,NaN,15.47628520278659,40.37003397274145,-1049,-1.6691702736140837,13.855277459148056,15.52444773276214
2025-09-15T12:30:00-04:00,24270.25,24287.5,24268.75,24284.75,24237.98062084202,NaN,NaN,NaN,NaN,NaN,24231.485,24318.636558217353,24144.333441782648,24255.155266511643,24202.942036639197,24264.68167955577,24141.202393722622,3110,4976.3,62.103954729250354,62.753774631940544,NaN,NaN,NaN,NaN,15.710121974016118,39.66664989296447,2061,-1.3953209575183667,13.780296535864181,15.175617493382548
2025-09-15T12:35:00-04:00,24284.75,24286.75,24276.75,24284.5,24237.98062084202,NaN,NaN,NaN,NaN,NaN,24234.03,24319.782355070554,24148.277644929443,24255.155266511643,24203.380212604312,24265.23144472087,24141.528980487754,2004,4792.833333333333,61.95381036554656,62.90246710114145,NaN,NaN,NaN,NaN,15.302256118729252,39.01350753317156,57,-1.304840105151369,13.544567361943336,14.849407467094705
2025-09-15T12:40:00-04:00,24284.5,24286.75,24275.5,24283.5,24237.98062084202,NaN,NaN,NaN,NaN,NaN,24236.65,24320.25633946959,24153.043660530413,24255.155266511643,24203.810350972406,24265.76371283435,24141.856989110463,2008,4599.1,61.315248550345245,63.13336993152416,NaN,NaN,NaN,NaN,15.012809253105733,38.25400423778355,-1951,-1.3789234625280287,13.12575313893467,14.504676601462698
2025-09-15T12:45:00-04:00,24283.75,24283.75,24272,24276.75,24237.98062084202,NaN,NaN,NaN,NaN,NaN,24239.27,24319.45839317532,24159.081606824682,24255.155266511643,24204.198422732894,24266.218194636316,24142.17865082947,1941,4527.1,57.041451020967635,62.683019399026385,NaN,NaN,NaN,NaN,14.779751449312467,37.11632839403311,-3892,-1.9160776278751364,12.109579566618777,14.025657194493913
2025-09-15T12:50:00-04:00,24276.5,24280.25,24268,24273.5,24237.98062084202,NaN,NaN,NaN,NaN,NaN,24241.63,24318.702968021822,24164.55703197818,24255.155266511643,24204.654694454763,24266.72627606492,24142.583112844604,2428,4345.733333333334,55.051780826098344,62.25327836293001,NaN,NaN,NaN,NaN,14.59905491721872,35.58061713042491,-6320,-2.487588143676234,10.91617201489862,13.403760158574855
2025-09-15T12:55:00-04:00,24273,24275.75,24260,24265.75,24237.98062084202,NaN,NaN,NaN,NaN,NaN,24243.825,24317.17970332504,24170.47029667496,24255.155266511643,24205.40367876884,24267.476036815526,24143.33132072215,4499,4180.9,50.52585697180994,61.117179518278135,NaN,NaN,NaN,NaN,14.681265280274525,33.28199093130918,-10819,-3.332182799344981,9.23853165939363,12.57071445873861
2025-09-15T13:00:00-04:00,24266.25,24271,24262.25,24264.5,24237.98062084202,NaN,NaN,NaN,NaN,NaN,24245.75,24316.05903213765,24175.44096786235,24254.599213209316,24205.801355535496,24267.862319563017,24143.740391507974,2484,3967.733333333333,49.81450476725483,59.84702962972614,NaN,NaN,NaN,NaN,14.25760347454063,31.147552317844568,-13303,-3.8812567224427674,7.71914355568515,11.600400278127918
2025-09-15T13:05:00-04:00,24264.75,24280.25,24264.75,24273,24237.98062084202,NaN,NaN,NaN,NaN,NaN,24247.75,24315.30264613717,24180.19735386283,24253.43207018443,24206.3247458852,24268.42255376209,24144.226938008305,2982,3900.9333333333334,54.505093601024264,58.967680513167736,NaN,NaN,NaN,NaN,14.364203226359157,30.021920280477097,-10321,-3.585252221811672,7.118835000863328,10.704087222675
2025-09-15T13:10:00-04:00,24273,24275.5,24262,24266,24237.98062084202,NaN,NaN,NaN,NaN,NaN,24249.66,24313.675682452274,24185.644317547725,24253.43207018443,24206.822806688644,24268.9138683027,24144.731745074587,3110,3867,50.332896009359956,58.23198239073345,NaN,NaN,NaN,NaN,14.30247442447636,28.661706885929974,-13431,-3.7560882562623537,6.008976902347058,9.765065158609412
2025-09-15T13:15:00-04:00,24265.5,24268.75,24256.25,24259.75,24237.98062084202,NaN,NaN,NaN,NaN,NaN,24251.425,24311.466423199716,24191.383576800283,24253.43207018443,24207.296734731262,24269.326259674268,24145.267209788257,3353,3781.4,46.882231670808615,56.92888822882717,NaN,NaN,NaN,NaN,14.173726251299476,26.770544713333617,-16784,-4.154151253900881,4.572376091233309,8.72652734513419
2025-09-15T13:20:00-04:00,24259.5,24265.25,24253,24261.25,24237.98062084202,NaN,NaN,NaN,NaN,NaN,24253.21,24308.84527298693,24197.574727013067,24253.43207018443,24207.758974539363,24269.709595242457,24145.80835383627,3439,3765.9333333333334,47.807054472072195,55.62989014222085,NaN,NaN,NaN,NaN,14.036317233349513,25.038094945218788,-13345,-4.16971354425497,3.5143854148154787,7.6840989590704485
2025-09-15T13:25:00-04:00,24261,24262.25,24253.5,24253.5,24237.98062084202,NaN,NaN,NaN,NaN,NaN,24254.88,24305.181316083297,24204.578683916705,24253.43207018443,24207.99176690158,24269.885149714097,24146.098384089066,1879,3706.866666666667,43.584760219821426,54.21668885992138,NaN,NaN,NaN,NaN,13.658723145253118,23.429391589112157,-15224,-4.525525770271936,2.0271917462305282,6.552717516502464
2025-09-15T13:30:00-04:00,24253.75,24261.5,24248.75,24258.25,24237.98062084202,NaN,NaN,NaN,NaN,NaN,24256.575,24301.18242650896,24211.96757349104,24251.220656147543,24208.58097820208,24270.322177759506,24146.839778644655,4863,3610.633333333333,46.692342922553436,53.13664674678763,NaN,NaN,NaN,NaN,13.59381434916361,22.43936663755804,-10361,-4.2679124130182995,1.2178270002295903,5.48573941324789
2025-09-15T13:35:00-04:00,24258.25,24265.75,24251.5,24263.25,24237.98062084202,NaN,NaN,NaN,NaN,NaN,24258.3,24296.704557019282,24219.895442980716,24248.101524918035,24208.963705869075,24270.6345293693,24147.29288236885,2972,3522.5333333333333,49.82542001210398,52.674029009929775,NaN,NaN,NaN,NaN,13.640684752794781,21.010020553225736,-7389,-3.6136384504142525,0.968691350230074,4.5823298006443265
2025-09-15T13:40:00-04:00,24263.25,24273,24263,24268.5,24237.98062084202,NaN,NaN,NaN,NaN,NaN,24259.65,24294.48216903572,24224.817830964283,24247.374980758035,24209.390974437254,24271.04286068775,24147.739088186758,2912,3448.7,52.95218288295661,52.02033102090879,NaN,NaN,NaN,NaN,13.380635841880869,20.118111809810095,-4477,-2.720852798285281,1.1812638027877256,3.9021166010730064
2025-09-15T13:45:00-04:00,24268.5,24277,24263,24276,24237.98062084202,NaN,NaN,NaN,NaN,NaN,24260.88,24293.522493779295,24228.237506220707,24247.374980758035,24209.777732621664,24271.434364057342,24148.121101185985,2508,3431.5333333333333,57.068198004293016,51.67135870939069,NaN,NaN,NaN,NaN,13.424876138889378,19.680216782003114,-1969,-1.5755828215489847,1.9326380741367757,3.5082208956857603
2025-09-15T13:50:00-04:00,24276,24279.25,24273.5,24276.25,24237.98062084202,NaN,NaN,NaN,NaN,NaN,24262.325,24290.91262844409,24233.73737155591,24251.42097552939,24210.093758171202,24271.77376115818,24148.413755184225,1937,3352.266666666667,57.20260388113452,51.37759837587564,NaN,NaN,NaN,NaN,12.87667070039728,19.48814857492482,-32,-0.7911844969561406,2.519240274490585,3.3104247714467254
2025-09-15T13:55:00-04:00,24276.75,24288.25,24275.25,24287.25,24240.901358473046,NaN,NaN,NaN,NaN,NaN,24263.5,24291.24707191931,24235.75292808069,24259.48678042351,24210.685431747817,24272.46669635635,24148.904167139284,3311,3297.9666666666667,62.731278103355216,51.784014596046184,NaN,NaN,NaN,NaN,12.885479936083188,20.085104298657114,3279,0.4137501665366421,3.827612479617528,3.413862313080886
2025-09-15T14:00:00-04:00,24286.75,24288,24277.75,24286.75,24242.485387633362,NaN,NaN,NaN,NaN,NaN,24264.305,24292.36623482586,24236.243765174142,24259.864424338808,24211.202263014282,24273.07138738193,24149.333138646634,2913,3316.633333333333,62.337082182130345,52.30439326433418,NaN,NaN,NaN,NaN,12.697231369220104,20.6394203278371,366,1.0842580397593662,4.769184862780094,3.6849268230207275
2025-09-15T14:05:00-04:00,24287,24292,24280,24282.25,24245.80991546821,NaN,NaN,NaN,NaN,NaN,24264.735,24293.22085789305,24236.24914210695,24263.491539471048,24211.627410770856,24273.568912689167,24149.685908852545,2408,3289.366666666667,58.75838436144618,52.89243093502249,NaN,NaN,NaN,NaN,12.647429128561525,21.47958264276751,-2042,1.1269065250708339,5.09355997935927,3.966653454288436
2025-09-15T14:10:00-04:00,24282.25,24286,24273.25,24282,24245.80991546821,NaN,NaN,NaN,NaN,NaN,24265.315,24294.001723411868,24236.62827658813,24263.491539471048,24212.0142768537,24273.995198161174,24150.033355546228,2356,3198.9,58.5572568590541,53.51691322729387,NaN,NaN,NaN,NaN,12.654755619378559,21.286198820794564,-4398,1.0424458289257226,5.269710740445589,4.227264911519867
2025-09-15T14:15:00-04:00,24281.5,24285,24270.75,24275.5,24245.80991546821,NaN,NaN,NaN,NaN,NaN,24265.835,24294.297889879494,24237.372110120505,24263.491539471048,24212.411486519064,24274.410453361037,24150.41251967709,2573,3100.233333333333,53.43581675462925,53.44053630969422,NaN,NaN,NaN,NaN,12.768701646565804,20.772034011529133,-6971,0.4815067858452844,4.829148393826472,4.3476416079811875
2025-09-15T14:20:00-04:00,24275,24277,24270,24272,24245.80991546821,NaN,NaN,NaN,NaN,NaN,24266.33,24294.340076744673,24238.31992325533,24263.491539471048,24212.59178089751,24274.586336060613,24150.597225734407,1258,2988.7,50.856542199073495,53.47793960895948,NaN,NaN,NaN,NaN,12.356651528953961,20.19206545312051,-8229,-0.15831876253509947,4.149743154812313,4.308061917347413
2025-09-15T14:25:00-04:00,24272,24276.25,24263.75,24264.5,24245.80991546821,NaN,NaN,NaN,NaN,NaN,24266.785,24293.90823910847,24239.66176089153,24263.491539471048,24212.902381462012,24274.86212776649,24150.942635157535,2376,2878.8,45.75943594596423,53.39773991432774,NaN,NaN,NaN,NaN,12.36689070545725,18.837140631571977,-10605,-1.0689579464367487,2.971864484301477,4.040822430738226
2025-09-15T14:30:00-04:00,24264.5,24279.5,24263.25,24276.25,24245.80991546821,NaN,NaN,NaN,NaN,NaN,24267.61,24293.286674234616,24241.933325765385,24263.491539471048,24213.3201520492,24275.265738178194,24151.374565920207,2976,2832.233333333333,53.604770561554936,53.81186249214793,NaN,NaN,NaN,NaN,12.644255655067445,17.958308558780526,-7629,-0.8706742598899,2.952479605875851,3.823153865765751
2025-09-15T14:35:00-04:00,24276.25,24278.5,24265,24266.75,24245.80991546821,NaN,NaN,NaN,NaN,NaN,24267.855,24293.258954415116,24242.451045584883,24263.491539471048,24213.590011786513,24275.511398145256,24151.66862542777,2045,2799.3,47.60897853575012,54.099306657571404,NaN,NaN,NaN,NaN,12.705380251134056,17.14225020547418,-9674,-1.341874473418435,2.1458107739927073,3.487685247411142
2025-09-15T14:40:00-04:00,24266.75,24267.5,24245.25,24252,NaN,NaN,NaN,24297.335304170585,24297.335304170585,24297.335304170585,24268.08,24292.707107007274,24243.45289299273,24263.491539471048,24214.14497435437,24275.832864684206,24152.457084024536,5855,2842.7,40.10786467050619,53.62898678242517,NaN,NaN,NaN,NaN,13.387138804624481,17.542100129632168,-15529,-2.539977463322696,0.312713418257772,2.852690881580468
2025-09-15T14:45:00-04:00,24251.75,24263,24251.5,24261.75,NaN,NaN,NaN,24297.335304170585,NaN,NaN,24268.35,24292.39059068089,24244.309409319107,24263.491539471048,24214.478427359827,24276.05529291608,24152.901561803574,3284,2868.6,46.1478667085204,53.36630440359777,NaN,NaN,NaN,NaN,13.252343175722732,17.91338934492173,-12245,-2.5615606065550622,-0.34925987661335967,2.2123007299417026
2025-09-15T14:50:00-04:00,24261.5,24273.5,24258,24272.25,NaN,NaN,NaN,24297.335304170585,NaN,NaN,24268.69,24292.459215389714,24244.920784610284,24263.491539471048,24214.90477574987,24276.419492323927,24153.390059175814,3533,2902.0666666666666,51.78686573862765,53.283067464717135,NaN,NaN,NaN,NaN,13.412890091742538,16.98797077479501,-8712,-1.7908909162042506,-0.026312915313610574,1.76457800089064
2025-09-15T14:55:00-04:00,24273,24274,24266,24271,NaN,NaN,NaN,24297.335304170585,NaN,NaN,24269.23,24291.933929175397,24246.526070824602,24256.818231576835,24215.13761228744,24276.62758207118,24153.647642503696,1868,2839.5,51.10085226032068,52.85682848300483,NaN,NaN,NaN,NaN,13.0262550851895,16.073363698593987,-10580,-1.3098280240905207,0.12729297077748924,1.43712099486801
2025-09-15T15:00:00-04:00,24271.75,24277.75,24265.75,24267,NaN,NaN,NaN,24297.335304170585,NaN,NaN,24269.535,24291.694650264606,24247.375349735394,24254.52958526147,24215.501601873162,24276.94998974345,24154.053214002874,2961,2834.5333333333333,48.86990561894473,52.26163574999127,NaN,NaN,NaN,NaN,12.952951150533108,15.04480483501687,-13541,-1.2080163866968288,-0.07289948850302608,1.1351168981938027
2025-09-15T15:05:00-04:00,24267.75,24276,24262.5,24273,NaN,NaN,NaN,24297.335304170585,NaN,NaN,24269.755,24291.829304065126,24247.680695934876,24249.123668209177,24215.78030191901,24277.197080217662,24154.36352362036,2280,2843.733333333333,52.23825525789137,51.51213411817242,NaN,NaN,NaN,NaN,12.992026068352173,14.212700294560426,-11261,-0.708319270835718,0.24971780964915524,0.9580370804848732
2025-09-15T15:10:00-04:00,24273.25,24278.75,24269.5,24271,NaN,NaN,NaN,24297.335304170585,NaN,NaN,24269.86,24291.90703154532,24247.81296845468,24248.53414765387,24215.98676846191,24277.388872266278,24154.58466465754,1627,2831.0333333333333,51.03143720190251,50.70458804815615,NaN,NaN,NaN,NaN,12.724738492041302,13.275917487000827,-12888,-0.4943571015622654,0.3400907035320415,0.8344478050943069
2025-09-15T15:15:00-04:00,24270.5,24273.75,24261.5,24273.75,NaN,NaN,NaN,24297.335304170585,NaN,NaN,24270.345,24291.632998961035,24249.057001038967,24248.53414765387,24216.3054750211,24277.663771073985,24154.947178968217,2697,2856.233333333333,52.6511930556089,50.268360097739205,NaN,NaN,NaN,NaN,12.690828599752637,13.114528156432586,-10191,-0.16644366870266958,0.62639321921597,0.7928368879186396
2025-09-15T15:20:00-04:00,24273.5,24277.5,24268.25,24273.25,NaN,NaN,NaN,24297.335304170585,NaN,NaN,24270.695,24291.58334363511,24249.80665636489,24248.455833578017,24216.548551151896,24277.88712669811,24155.20997560568,1956,2840.5,52.312381134456864,49.82229754598226,NaN,NaN,NaN,NaN,12.445055128341734,12.512360422832733,-12147,0.008674395945649671,0.8036798828507017,0.795005486905052
2025-09-15T15:25:00-04:00,24273,24277.75,24269.25,24273.75,NaN,NaN,NaN,24297.335304170585,NaN,NaN,24271.17,24291.217553475388,24251.12244652461,24250.26466686241,24216.7811322306,24278.102329716483,24155.45993474472,1868,2752.8,52.64058333897816,49.765495159150035,NaN,NaN,NaN,NaN,12.163265476317324,11.922708537119627,-10279,0.1426411987327263,0.9733069853209599,0.8306657865882336
2025-09-15T15:30:00-04:00,24273.25,24278,24268.75,24276.75,NaN,NaN,NaN,24297.335304170585,NaN,NaN,24271.75,24290.701780920965,24252.798219079035,24251.38673348993,24217.009922360594,24278.316831620195,24155.703013100992,1823,2730.766666666667,54.657007838270275,50.03695699052123,NaN,NaN,NaN,NaN,11.955175085151803,11.43472523204558,-8456,0.4030114780489674,1.334430134149443,0.9314186561004755
2025-09-15T15:35:00-04:00,24277.75,24283.75,24273.5,24279.75,NaN,NaN,NaN,24297.335304170585,NaN,NaN,24272.27,24290.6354131371,24253.9045868629,24257.334386791943,24217.359203764947,24278.668988724323,24156.04941880557,2606,2718.233333333333,56.64493359234568,50.81449253669133,NaN,NaN,NaN,NaN,11.833376864783817,10.985038417216343,-5850,0.728041422647971,1.8414704344104393,1.1134290117624683
2025-09-15T15:40:00-04:00,24279.75,24285.5,24275.25,24278,NaN,NaN,NaN,24297.335304170585,NaN,NaN,24272.82,24290.163309950185,24255.476690049814,24259.242509433556,24217.71276135664,24279.02676078167,24156.39876193161,2643,2702.6666666666665,55.126649439714775,50.923198170845616,NaN,NaN,NaN,NaN,11.72027851729926,10.77697334025649,-8493,0.7717669291945826,2.0781376732556964,1.3063707440611139
2025-09-15T15:45:00-04:00,24277.75,24293,24275.25,24290.5,NaN,NaN,NaN,24297.335304170585,NaN,NaN,24273.33,24291.214753267326,24255.445246732677,24263.119007546844,24218.292909408443,24279.668877033542,24156.916941783344,3971,2723.266666666667,62.79716669152744,52.00806875340113,NaN,NaN,NaN,NaN,12.15097290892074,11.403783331055747,-4522,1.5445267968916017,3.237029240175616,1.6925024432840143
2025-09-15T15:50:00-04:00,24290.25,24291.75,24265.5,24287.75,NaN,NaN,NaN,24297.335304170585,NaN,NaN,24273.865,24291.842544314262,24255.88745568574,24263.119007546844,24219.277179231576,24280.67678310241,24157.87757536074,7401,2855.3333333333335,60.35293748180652,53.45414538277972,NaN,NaN,NaN,NaN,13.15804627256926,10.715005357073485,-11923,1.7569822670091062,3.888730277045397,2.131748010036291
2025-09-15T15:55:00-04:00,24287.5,24315.75,24276,24311.5,24252.569379330915,24252.569379330915,24252.569379330915,NaN,NaN,NaN,24274.545,24295.367989710005,24253.722010289992,24266.25116482998,24221.47843569489,24283.476021270413,24159.48085011937,13177,3231.9333333333334,70.89071494333125,55.22149168526622,NaN,NaN,NaN,NaN,15.057471538814314,12.060527185492319,1254,3.2942761019983657,6.249593137534248,2.955317035535882
2025-09-15T16:00:00-04:00,24311.25,24313.5,24292.25,24293.75,24258.640089361328,NaN,NaN,NaN,NaN,NaN,24274.79,24296.21413591937,24253.36586408063,24266.25116482998,24222.256733183032,24284.43308637376,24160.080379992305,4913,3233.6,58.39803371190074,55.693717969071436,NaN,NaN,NaN,NaN,15.499795000327577,13.309940311881238,-3659,2.925424104582489,6.612097166263993,3.686673061681504
2025-09-15T16:05:00-04:00,24294,24300.75,24290,24296.25,24258.640089361328,NaN,NaN,NaN,NaN,NaN,24275.11,24297.31454008142,24252.90545991858,24266.25116482998,24222.578276881006,24284.8074255081,24160.34912825391,2176,3207.0666666666666,59.481088451685075,56.2923062684546,NaN,NaN,NaN,NaN,15.160523928875607,14.193971050764912,-1483,2.666812717821914,7.020188958958897,4.353376241136983
2025-09-15T16:10:00-04:00,24296.5,24296.5,24285.75,24287.5,24258.640089361328,NaN,NaN,NaN,NaN,NaN,24275.46,24297.88194461612,24253.038055383877,24266.25116482998,24222.79512877309,24285.04102620005,24160.54923134613,1605,3163.5,54.165938185875945,56.6705943089497,NaN,NaN,NaN,NaN,14.84548650538449,14.501087677316123,-3088,1.7668279227583197,6.561911144584883,4.795083221826563
2025-09-15T16:15:00-04:00,24287.75,24297.25,24286.25,24295.25,24258.640089361328,NaN,NaN,NaN,NaN,NaN,24275.7,24298.699782602693,24252.70021739731,24266.25116482998,24222.900350766464,24285.158723554843,24160.641977978084,749,3104.866666666667,57.765749703729625,57.06541534079529,NaN,NaN,NaN,NaN,14.570808897857026,14.848904355973266,-2339,1.5609858857148273,6.746315578970098,5.18532969325527
2025-09-15T16:20:00-04:00,24295,24299,24294.25,24295.25,24258.640089361328,NaN,NaN,NaN,NaN,NaN,24275.885,24299.357155845766,24252.41284415423,24266.25116482998,24222.970153209455,24285.23990049141,24160.7004059275,476,3056.1666666666665,57.765749703729625,57.54643766235437,NaN,NaN,NaN,NaN,13.869322548010095,15.323480393271605,-2339,1.302864964162051,6.813910898457834,5.511045934295783
2025-09-15T16:25:00-04:00,24295.75,24296.5,24289.5,24289.75,24258.640089361328,NaN,NaN,NaN,NaN,NaN,24276.045,24299.78245774822,24252.307542251776,24266.25116482998,24223.045142269704,24285.322495183784,24160.767789355625,544,2963.9333333333334,54.25832654837914,57.661232911837956,NaN,NaN,NaN,NaN,13.37865665172366,15.144128060098904,-2883,0.6715411320489775,6.350472349357005,5.678931217308028
2025-09-15T16:30:00-04:00,24290,24294.25,24289.25,24293,24258.640089361328,NaN,NaN,NaN,NaN,NaN,24276.32,24300.513809130003,24252.126190869996,24267.485181882552,24223.11789566572,24285.40280525301,24160.832986078432,527,2884.4,55.95997809131268,57.92177555161337,NaN,NaN,NaN,NaN,12.78018117660054,14.94508574408784,-2356,0.39626996455605656,6.174268673003098,5.777998708447042
2025-09-15T16:35:00-04:00,24292.5,24298.5,24291.75,24298,24258.640089361328,NaN,NaN,NaN,NaN,NaN,24276.88,24301.749507427623,24252.01049257238,24273.71314550604,24223.23254981919,24285.53557302897,24160.92952660941,788,2830.4,58.51680932071096,58.34150597888,NaN,NaN,NaN,NaN,12.349453949700502,15.19073341447165,-1568,0.4693736110986846,6.364715722320398,5.895342111221713
2025-09-15T16:40:00-04:00,24297.25,24304.25,24296.5,24301.5,24262.60565398706,NaN,NaN,NaN,NaN,NaN,24277.215,24302.936199428867,24251.493800571134,24280.545516404833,24223.407291163036,24285.74854188391,24161.06604044216,1133,2789.633333333333,60.256236489407485,58.74145088253266,NaN,NaN,NaN,NaN,12.020921524721896,15.949721180408174,-435,0.660203334856643,6.720596279792517,6.060392944935874
2025-09-15T16:45:00-04:00,24300.75,24303.75,24298,24299,24264.0383515331,NaN,NaN,NaN,NaN,NaN,24277.505,24303.867186935397,24251.142813064605,24281.911413123868,24223.570075411622,24285.945397259627,24161.194753563617,1067,2739.4333333333334,58.373428863323525,58.864914830459654,NaN,NaN,NaN,NaN,11.572998558670331,16.654495534492096,-1502,0.5304071537796489,6.723401887160435,6.192994733380786
2025-09-15T16:50:00-04:00,24299,24304,24297.5,24299,24264.70138100887,NaN,NaN,NaN,NaN,NaN,24277.815,24304.808853001752,24250.821146998245,24283.279130499093,24223.690480461773,24286.090584531892,24161.290376391655,793,2723.9333333333334,58.373428863323525,59.09682764643171,NaN,NaN,NaN,NaN,11.210641518765309,17.22714528548099,-1502,0.36478825174584717,6.648980048063095,6.284191796317248
2025-09-15T16:55:00-04:00,24298.25,24301.75,24295,24295.75,24264.70138100887,NaN,NaN,NaN,NaN,NaN,24278.195,24305.64919640315,24250.74080359685,24283.279130499093,24223.82775621124,24286.25086497718,24161.404647445303,940,2676.0666666666666,55.74715868556212,58.593255646005616,NaN,NaN,NaN,NaN,10.89202426742493,17.342909712422852,-2442,-0.02284045488730957,6.255641227708111,6.27848168259542
2025-09-15T18:00:00-04:00,24536,24537.5,24526,24530.5,24465.05952277874,NaN,NaN,NaN,NaN,NaN,24283.335,24359.090634114073,24207.579365885926,24400.66364351942,24531.33333333333,24531.333678600313,24531.332988066344,1429,2624.5,90.16538496523144,60.72271618053596,NaN,NaN,NaN,NaN,27.381879676894577,22.237807422674,-1013,14.659355577951434,24.602676155034715,9.94332057708328
2025-09-15T18:05:00-04:00,24530.75,24537,24529.25,24532,24468.409089925164,NaN,NaN,NaN,NaN,NaN,24288.66,24391.361010706216,24185.958989293784,24423.655914815536,24531.64496906841,24532.231797309814,24531.058140827005,403,2569.766666666667,90.21773981004725,62.103217956729964,NaN,NaN,NaN,NaN,25.97960255711639,26.783069582192926,-610,23.098479107136203,38.816419461003534,15.71794035386733
2025-09-15T18:10:00-04:00,24533,24535.75,24528,24532.75,24469.043904019472,NaN,NaN,NaN,NaN,NaN,24294.025,24417.118714297372,24170.93128570263,24441.19973185243,24531.750761531766,24532.315150027607,24531.186373035925,466,2390.133333333333,90.24570065421554,64.37805130975245,NaN,NaN,NaN,NaN,24.67748808875093,30.93658287446758,-144,27.081663584963284,49.570019835071434,22.48835625010815
2025-09-15T18:15:00-04:00,24533,24533,24529.25,24530.75,24470.638499291315,NaN,NaN,NaN,NaN,NaN,24299.18,24438.799126197187,24159.560873802813,24455.48478548194,24531.662792931234,24532.24547267692,24531.080113185548,305,2290.8333333333335,89.51094887628501,66.52304134008101,NaN,NaN,NaN,NaN,23.182667510983006,34.79341664586547,-449,27.825923514186435,57.270760642841196,29.44483712865476
2025-09-15T18:20:00-04:00,24530.75,24537,24528.25,24532.25,24473.694703868983,NaN,NaN,NaN,NaN,NaN,24304.505,24458.250682541002,24150.759317459,24470.612828385554,24531.813838161208,24532.431821502374,24531.195854820042,573,2192.1666666666665,89.57947398190416,69.05257961122588,NaN,NaN,NaN,NaN,22.151762688769935,38.394574188247574,124,26.661013864494166,62.771104459272465,36.1100905947783
2025-09-15T18:25:00-04:00,24531.75,24532.25,24527.25,24530,24473.694703868983,NaN,NaN,NaN,NaN,NaN,24309.91,24475.525450970305,24144.294549029695,24476.640262708443,24531.551465901848,24532.435830126273,24530.667101677423,485,2146.0666666666666,88.64398489631151,71.25816783926744,NaN,NaN,NaN,NaN,20.926636782429227,41.67326542994142,-361,24.06045811536641,66.18566323898631,42.1252051236199
2025-09-15T18:30:00-04:00,24529.5,24531.25,24525,24527.25,24473.694703868983,NaN,NaN,NaN,NaN,NaN,24315.23,24491.02754947217,24139.432450527827,24483.637210166755,24530.95322408129,24532.541528347654,24529.36491981493,702,2070.766666666667,87.4420378174644,73.37790270453421,NaN,NaN,NaN,NaN,19.878305583684284,44.56231816112786,-1063,20.609645150906573,67.88726156225312,47.27761641134654
2025-09-15T18:35:00-04:00,24527.25,24531,24526.5,24529.5,24475.44750446381,NaN,NaN,NaN,NaN,NaN,24320.75,24505.549837662318,24135.950162337682,24490.659768133402,24530.755286646072,24532.372227812124,24529.13834548002,492,2011.1666666666667,87.59030049814629,75.75875798666043,NaN,NaN,NaN,NaN,18.77985518484969,47.24500998294384,-571,17.07891952277498,68.62626581481527,51.54734629204029
2025-09-15T18:40:00-04:00,24529.75,24533.75,24529.5,24533,24480.165799715454,NaN,NaN,NaN,NaN,NaN,24326.245,24519.43326284292,24133.05673715708,24499.352814506725,24530.84577735125,24532.442129095092,24529.249425607406,355,1968.7666666666667,87.83097966733126,78.03525809923319,NaN,NaN,NaN,NaN,17.742008385931857,49.75710623180246,-216,13.724038424361517,68.70239432249218,54.978355898130665
2025-09-15T18:45:00-04:00,24532.5,24533.5,24530.75,24532,24482.629854273844,NaN,NaN,NaN,NaN,NaN,24331.62,24532.307524276963,24130.932475723035,24504.60725160538,24530.9069664903,24532.48630843828,24529.32762454232,271,1887.9,87.30995576706667,80.09191141683003,NaN,NaN,NaN,NaN,16.67115064407958,52.08976703431403,-487,10.336782334522361,67.89933381628362,57.562551481761254
2025-09-15T18:50:00-04:00,24532,24533.75,24530,24530.25,24484.11826998867,NaN,NaN,NaN,NaN,NaN,24336.855,24544.227710114723,24129.482289885276,24508.7608012843,24530.922049161094,24532.475203355152,24529.368894967036,201,1829.4,86.34464300258114,81.95536902491385,NaN,NaN,NaN,NaN,15.748211312359611,54.1883135911925,-688,7.035376922952771,66.35677263545222,59.321395712499445
2025-09-15T18:55:00-04:00,24530.25,24532,24526,24530.25,24484.11826998867,NaN,NaN,NaN,NaN,NaN,24341.94,24555.471907686737,24128.40809231326,24509.00864102744,24530.82281220889,24532.36968258501,24529.275941832773,401,1780.5,86.34464300258114,83.9533128920037,NaN,NaN,NaN,NaN,15.051910504333923,55.762447921867555,-688,4.056492044867994,64.39201076858444,60.33551872371645
2025-09-15T19:00:00-04:00,24530.75,24533.75,24528,24531.25,24485.796037324388,NaN,NaN,NaN,NaN,NaN,24347.04,24566.160249178276,24127.919750821726,24512.481912821953,24530.831877502213,24532.339163482062,24529.324591522363,328,1730.6666666666667,86.44397018455098,85.95835155780564,NaN,NaN,NaN,NaN,14.38748832545293,57.24695045812956,-360,1.4904869544968875,62.19862741683755,60.708140462340666
2025-09-15T19:05:00-04:00,24531.5,24533.75,24529.5,24529.5,24488.015535627823,NaN,NaN,NaN,NaN,NaN,24351.885,24576.155221162117,24127.61477883788,24514.610530257563,24530.83496167143,24532.314665472626,24529.355257870233,242,1651.8666666666666,85.27498385202671,88.06748192683884,NaN,NaN,NaN,NaN,13.663382016492006,58.625417098944276,-602,-0.861114553547111,59.63174727040678,60.49286182395389
2025-09-15T19:10:00-04:00,24530,24533.75,24529.75,24530.5,24489.54323855383,NaN,NaN,NaN,NaN,NaN,24356.76,24585.703070653468,24127.81692934653,24516.31342420605,24530.85377494938,24532.308385527314,24529.399164371447,261,1572.4666666666667,85.39651230026173,87.72684816505527,NaN,NaN,NaN,NaN,12.990997586742578,59.905421836843665,-341,-2.777595983239145,57.02086684490496,59.7984628281441
2025-09-15T19:15:00-04:00,24530.75,24540.5,24530.75,24540,24493.973091346837,NaN,NaN,NaN,NaN,NaN,24361.915,24595.475797437342,24128.35420256266,24521.55073936484,24531.591663479114,24534.02425584569,24529.15907111254,929,1471.0666666666666,86.53357105259842,87.46369325380894,NaN,NaN,NaN,NaN,12.777354901975253,61.195804383266115,588,-3.772106608564613,55.08332956743834,58.855436176002954
2025-09-15T19:20:00-04:00,24539.75,24546.5,24538.75,24546,24501.809541740164,NaN,NaN,NaN,NaN,NaN,24367.195,24605.184921845303,24129.205078154697,24527.465591491873,24532.652847278794,24536.797378902713,24528.508315654875,750,1249.3666666666666,87.21086888325364,87.24691955588308,NaN,NaN,NaN,NaN,12.418258123262735,62.480518564616595,1338,-4.351374334314812,53.41621825810944,57.76759259242425
2025-09-15T19:25:00-04:00,24546.25,24549,24544.25,24546,24507.017062570158,NaN,NaN,NaN,NaN,NaN,24372.605,24614.280797092564,24130.929202907435,24531.397473193498,24533.518902217376,24538.740634218833,24528.29717021592,577,829.3666666666667,87.21086888325364,87.08262812780943,NaN,NaN,NaN,NaN,11.87052540017254,63.709265516003754,1338,-5.012998004427345,51.50134508689007,56.514343091317414
2025-09-15T19:30:00-04:00,24545.5,24546.25,24540.25,24544.25,24507.017062570158,NaN,NaN,NaN,NaN,NaN,24378.05,24622.663675005926,24133.436324994072,24531.397473193498,24534.03534726533,24539.584973011577,24528.485721519082,496,682.1333333333333,85.75196233761048,86.8092344389313,NaN,NaN,NaN,NaN,11.451202157303072,64.33906144315644,842,-5.7918126540998855,49.27457727369256,55.06638992779244
2025-09-15T19:35:00-04:00,24544,24544.75,24540.5,24542.5,24507.017062570158,NaN,NaN,NaN,NaN,NaN,24383.61,24630.276194683884,24136.943805316118,24531.397473193498,24534.300142021722,24539.960322007566,24528.63996203588,309,619.9,84.23445323776804,86.49426789189248,NaN,NaN,NaN,NaN,10.936830574638567,64.92387194694106,533,-6.590052875928087,46.828823832882335,53.41887670881042
2025-09-15T19:40:00-04:00,24542.25,24546.75,24540.25,24541.75,24507.017062570158,NaN,NaN,NaN,NaN,NaN,24388.92,24637.53615876789,24140.303841232108,24531.397473193498,24534.64032258065,24540.435858981466,24528.844786179834,410,580.0666666666667,83.55203259651458,86.21641037611035,NaN,NaN,NaN,NaN,10.619914105021525,65.5112107291323,123,-7.2797858712362356,44.31914436976513,51.59893024100136
2025-09-15T19:45:00-04:00,24542,24543.25,24537.5,24542,24507.017062570158,NaN,NaN,NaN,NaN,NaN,24394.425,24644.16368843329,24144.686311566707,24531.397473193498,24534.87926083735,24540.688918018368,24529.069603656335,411,568.8,83.59972803786151,85.93136948609,NaN,NaN,NaN,NaN,10.272063097519988,65.65654698861884,534,-7.784941927384118,41.86775283177121,49.65269475915533
2025-09-15T19:50:00-04:00,24542.25,24545.75,24541.25,24545,24508.75886261084,NaN,NaN,NaN,NaN,NaN,24400.285,24650.131132849423,24150.438867150577,24531.397473193498,24535.170417862268,24541.107206458917,24529.23362926562,356,564.8,84.19211347609755,85.67145047243046,NaN,NaN,NaN,NaN,9.859772876268561,65.86265970147106,890,-7.954685585840885,39.70933777685423,47.66402336269511
2025-09-15T19:55:00-04:00,24544.75,24547.25,24544.25,24546,24512.17891431035,NaN,NaN,NaN,NaN,NaN,24405.97,24655.88415806239,24156.055841937614,24533.978163212836,24535.360122717397,24541.410347739762,24529.30989769503,202,553.4,84.39445991085745,85.46320076841552,NaN,NaN,NaN,NaN,9.369789099392236,66.09775071557226,1092,-8.014805998494701,37.64551586457674,45.66032186307144
2025-09-15T20:00:00-04:00,24546.75,24547.5,24538.5,24544,24512.17891431035,NaN,NaN,NaN,NaN,NaN,24411.405,24661.27022147055,24161.539778529448,24533.978163212836,24535.930010358737,24542.11126555351,24529.748755163964,874,564.9666666666667,82.13013389222083,85.16216440338978,NaN,NaN,NaN,NaN,9.343375592292789,65.41807826602239,218,-8.176250700412318,35.44000848755604,43.61625918796836
2025-09-15T20:05:00-04:00,24544,24544.25,24540.25,24542.75,24512.17891431035,NaN,NaN,NaN,NaN,NaN,24416.84,24666.07384120105,24167.60615879895,24533.978163212836,24536.115019464523,24542.302428556537,24529.92761037251,359,550.6666666666666,80.67326867957264,84.75706623746059,NaN,NaN,NaN,NaN,8.96170590712902,64.78695384858322,-141,-8.32624172872093,33.2084570270672,41.53469875578813
2025-09-15T20:10:00-04:00,24542.5,24543.5,24538.75,24540.25,24512.17891431035,NaN,NaN,NaN,NaN,NaN,24422.305,24670.136158048896,24174.473841951105,24533.978163212836,24536.252583879672,24542.400591084213,24530.10457667513,378,525.5,77.70449122880785,84.1328177406218,NaN,NaN,NaN,NaN,8.660869770905517,63.954952993036486,-519,-8.521985929399968,30.88221634403817,39.40420227343814
2025-09-15T20:15:00-04:00,24539.5,24542.25,24536.5,24541.5,24512.17891431035,NaN,NaN,NaN,NaN,NaN,24427.675,24673.963798974157,24181.38620102584,24533.978163212836,24536.436808614777,24542.490900441415,24530.38271678814,655,511.76666666666665,78.13770125674131,83.62301184095857,NaN,NaN,NaN,NaN,8.452950501555124,62.80713356695824,136,-8.477406528611553,28.807444112673693,37.284850641285246
2025-09-15T20:20:00-04:00,24541.75,24542.25,24538.75,24538.75,24512.17891431035,NaN,NaN,NaN,NaN,NaN,24433.03,24677.092935326415,24188.967064673583,24533.978163212836,24536.53729649435,24542.53172830705,24530.542864681647,405,498.8333333333333,74.69893324660383,82.85889905141157,NaN,NaN,NaN,NaN,8.099168322872616,61.74130124274273,-269,-8.52048280710629,26.63424713240238,35.15472993950867
2025-09-15T20:25:00-04:00,24538.75,24539.5,24534.25,24535.5,24512.17891431035,NaN,NaN,NaN,NaN,NaN,24438.265,24679.651607126605,24196.878392873394,24533.978163212836,24536.533473718122,24542.43219651016,24530.634750926085,459,482.8,70.73685243594278,81.73056200736472,NaN,NaN,NaN,NaN,7.895656299810287,59.973016312334096,-728,-8.628730765580883,24.368816482532566,32.99754724811345
2025-09-15T20:30:00-04:00,24536,24537,24526.5,24534,24512.17891431035,NaN,NaN,NaN,NaN,NaN,24443.48,24681.62602327232,24205.333976727678,24533.978163212836,24536.270545587533,24542.06003198218,24530.481059192887,1010,468.8333333333333,68.91988943889211,80.42406347562462,NaN,NaN,NaN,NaN,8.081680849823837,57.15429858364336,-1738,-8.640804999121382,22.19654099921172,30.837345998333102
2025-09-15T20:35:00-04:00,24534.5,24537,24532.25,24537,24512.17891431035,NaN,NaN,NaN,NaN,NaN,24448.745,24683.260809489046,24214.229190510952,24533.978163212836,24536.247227279382,24541.958810538243,24530.53564402052,435,469.9,70.54922934482565,79.2339463657369,NaN,NaN,NaN,NaN,7.843703646264991,54.5369178355734,-1303,-8.285092824161218,20.480979968131578,28.766072792292796
2025-09-15T20:40:00-04:00,24537.25,24542,24535.25,24540.25,24512.17891431035,NaN,NaN,NaN,NaN,NaN,24454.015,24684.64423513726,24223.385764862738,24533.978163212836,24536.33986282495,24541.983347974823,24530.696377675074,522,471.76666666666665,72.24665684716922,78.26928168784823,NaN,NaN,NaN,NaN,7.765581957246064,52.57523101413663,-781,-7.6826684551580975,19.162737223345175,26.845405678503273
2025-09-15T20:45:00-04:00,24541.25,24546,24537.25,24543.5,24513.41795818366,NaN,NaN,NaN,NaN,NaN,24459.29,24685.76225790359,24232.817742096413,24532.38253057027,24536.67118047586,24542.32023882461,24531.02212212711,977,494.1666666666667,73.86862216534081,77.52886518267486,NaN,NaN,NaN,NaN,7.835897531728487,51.099559398061814,196,-6.939679387967196,18.17080644354428,25.110485831511475
2025-09-15T20:50:00-04:00,24544,24546.25,24542,24543.5,24516.620550993495,NaN,NaN,NaN,NaN,NaN,24464.6,24686.218862013313,24242.981137986684,24530.886636544026,24536.818216313448,24542.502227698464,24531.134204928432,361,487.1,73.86862216534081,76.8371930090196,NaN,NaN,NaN,NaN,7.579761993747881,49.75093161535763,196,-6.339126280103933,17.18657798138156,23.525704261485494
2025-09-15T20:55:00-04:00,24544.75,24545.25,24541.75,24544.25,24516.768480493793,NaN,NaN,NaN,NaN,NaN,24469.675,24686.687816442893,24252.662183557106,24531.20930923522,24536.90935315655,24542.610813085535,24531.20789322756,237,478.8333333333333,74.27105691426468,76.1708593573341,NaN,NaN,NaN,NaN,7.288350422765889,48.45359555998442,433,-5.79701985945481,16.279429437166982,22.076449296621792
2025-09-15T21:00:00-04:00,24544.75,24545.75,24541.5,24544.75,24517.52900410771,NaN,NaN,NaN,NaN,NaN,24474.815,24686.456319453442,24263.173680546555,24532.392447388178,24537.070425589587,24542.804916151923,24531.33593502725,419,469.4,74.55242381808473,75.48231009604748,NaN,NaN,NaN,NaN,7.071325392568326,47.29860862853802,852,-5.3227066394894464,15.423065997259982,20.74577263674943
2025-09-15T21:05:00-04:00,24545,24551.25,24544.75,24550,24522.203822102812,NaN,NaN,NaN,NaN,NaN,24479.585,24686.996465691765,24272.173534308233,24537.31395791054,24537.515388492084,24543.56389823853,24531.466878745636,736,477.53333333333336,77.35293306760536,74.97934389295804,NaN,NaN,NaN,NaN,7.030516435956303,46.746058626548574,1588,-4.600483738860323,14.995167963174026,19.59565170203435
2025-09-15T21:10:00-04:00,24550.25,24556.25,24549.5,24551.75,24527.330921098142,NaN,NaN,NaN,NaN,NaN,24484.745,24686.1571766431,24283.332823356897,24541.726166328433,24538.140495936583,24544.77634723195,24531.504644641216,835,493.53333333333336,78.21360833620143,74.69959206752809,NaN,NaN,NaN,NaN,7.01047954767371,46.644029541437106,2423,-3.9736123614037453,14.62863625027967,18.602248611683414
2025-09-15T21:15:00-04:00,24551.75,24553.75,24550,24550.75,24527.330921098142,NaN,NaN,NaN,NaN,NaN,24489.835,24684.692219779256,24294.977780220743,24541.726166328433,24538.42401792991,24545.265606092158,24531.58242976766,434,498.96666666666664,76.42623023336017,74.3962321785129,NaN,NaN,NaN,NaN,6.777588151411302,46.54928824811931,1989,-3.605809014018355,14.094987344160472,17.700796358178827
2025-09-15T21:20:00-04:00,24550.25,24551.5,24549,24550.75,24527.330921098142,NaN,NaN,NaN,NaN,NaN,24495.1,24681.862282060836,24308.33771793916,24541.726166328433,24538.641668267075,24545.60734635671,24531.67599017744,378,504.8666666666667,76.42623023336017,74.3049278216952,NaN,NaN,NaN,NaN,6.472046140596208,46.237016643900546,1989,-3.3476293161923927,13.516259712938336,16.86388902913073
2025-09-15T21:25:00-04:00,24551,24553.5,24548,24548.75,24527.330921098142,NaN,NaN,NaN,NaN,NaN,24500.17,24678.530293789274,24321.809706210723,24541.726166328433,24538.910423210964,24546.008573460716,24531.81227296121,501,508.2,72.57903132495059,73.90787996942444,NaN,NaN,NaN,NaN,6.402614273410764,46.13072977342291,1488,-3.2916992077992155,12.74926501938171,16.040964227180925
2025-09-15T21:30:00-04:00,24549,24553,24548.5,24552.75,24527.458202740112,NaN,NaN,NaN,NaN,NaN,24505.32,24674.341005795053,24336.298994204946,24541.726166328433,24539.042696881133,24546.218182808927,24531.86721095334,228,504.8666666666667,75.2612525152309,73.94804563146923,NaN,NaN,NaN,NaN,6.2667132538814245,46.0320348222651,1716,-2.9750587412944043,12.32214080056292,15.297199541857324
2025-09-15T21:35:00-04:00,24552.25,24556.5,24551.5,24555.5,24531.08510261556,NaN,NaN,NaN,NaN,NaN,24510.635,24668.555587955827,24352.71441204417,24544.2728301825,24539.52816843398,24547.087196948392,24531.969139919565,699,520.1,76.93188632159203,74.39054805187276,NaN,NaN,NaN,NaN,6.176233735747037,46.26711358274475,2415,-2.5846002087126756,12.06644928096648,14.651049489679156
2025-09-15T21:40:00-04:00,24555.5,24561.5,24551.25,24560.75,24533.10396158758,NaN,NaN,NaN,NaN,NaN,24515.99,24661.71552830497,24370.264471695034,24546.593264146002,24540.550126562586,24549.012491498404,24532.087761626768,1316,555.2666666666667,79.74420279630898,75.16371329168824,NaN,NaN,NaN,NaN,6.467217040336535,46.894352855475944,3731,-2.00290743765353,12.147415192612243,14.150322630265773
2025-09-15T21:45:00-04:00,24560.75,24562.75,24558.25,24558.75,24537.673099697236,NaN,NaN,NaN,NaN,NaN,24521.205,24653.38611400465,24389.023885995353,24548.5746113168,24541.111753034547,24550.06140287658,24532.162103192513,704,547.7666666666667,75.94571480490434,75.54917653883672,NaN,NaN,NaN,NaN,6.326701537455354,47.57156976166324,3027,-1.7899590784822728,11.912873782162933,13.702832860645206
2025-09-15T21:50:00-04:00,24559.25,24560,24553.5,24555.5,24537.673099697236,NaN,NaN,NaN,NaN,NaN,24526.285,24642.908711569682,24409.661288430318,24548.5746113168,24541.42134449825,24550.53637499759,24532.306313998906,504,539.5666666666667,70.10211076814574,75.39599467604933,NaN,NaN,NaN,NaN,6.339079999065686,46.99653638249376,2523,-1.8949880787451345,11.334097762213787,13.229085840958922
2025-09-15T21:55:00-04:00,24555.25,24558.25,24553.25,24556.25,24537.673099697236,NaN,NaN,NaN,NaN,NaN,24531.43,24628.5606357424,24434.2993642576,24548.5746113168,24541.6827025956,24550.91882188353,24532.446583307672,455,535.5,70.66309973070162,75.16702878786081,NaN,NaN,NaN,NaN,6.243431427703852,46.40206504327372,2978,-1.934223617491936,10.811306319094001,12.745529936585937
2025-09-15T22:00:00-04:00,24556.5,24558,24553.75,24558,24537.673099697236,NaN,NaN,NaN,NaN,NaN,24536.61,24607.755004040497,24465.464995959504,24548.5746113168,24541.81902452751,24551.12161327172,24532.516435783302,233,526.7333333333333,71.98403298652762,75.03241527508844,NaN,NaN,NaN,NaN,6.101043468582148,45.8500559425694,3211,-1.861938146719579,10.418107253186463,12.280045399906042
2025-09-15T22:05:00-04:00,24557.75,24559.75,24555.75,24558,24537.673099697236,NaN,NaN,NaN,NaN,NaN,24541.855,24560.485375732773,24523.224624267226,24548.5746113168,24541.958647957857,24551.339486841644,24532.57780907407,224,523.9,71.98403298652762,74.86905642310724,NaN,NaN,NaN,NaN,5.9509689351119945,45.54326177229627,3211,-1.8309799695430211,9.991320437977265,11.822300407520286
2025-09-15T22:10:00-04:00,24557.75,24561.75,24557.5,24560.25,24538.578222338456,NaN,NaN,NaN,NaN,NaN,24542.45,24561.48759438134,24523.412405618663,24549.40880863629,24542.28043738613,24551.87544911058,24532.68542566168,471,525.9333333333333,73.74667759829192,74.81150312169345,NaN,NaN,NaN,NaN,5.829471154032567,45.48656431824023,3682,-1.6797849008387846,9.722569281471806,11.40235418231059
2025-09-15T22:15:00-04:00,24560.25,24564.75,24560.25,24563,24541.796257686707,NaN,NaN,NaN,NaN,NaN,24543.07,24562.715365868917,24523.424634131083,24552.62704690903,24542.721826465233,24552.66538572806,24532.778267202404,579,531.5333333333333,75.75449935407927,74.69732928501301,NaN,NaN,NaN,NaN,5.734508928744527,45.75410129920085,4261,-1.4254161717594247,9.62058396761131,11.046000139370735
2025-09-15T22:20:00-04:00,24563,24564.5,24561,24563.25,24542.510064155493,NaN,NaN,NaN,NaN,NaN,24543.68,24563.891640217837,24523.468359782164,24553.051637527224,24542.935520571256,24553.039874737075,24532.831166405438,286,529.2,75.93468674681542,74.53454917148544,NaN,NaN,NaN,NaN,5.574901148119918,46.00252849580714,4547,-1.276009968023164,9.450987679341779,10.726997647364943
2025-09-15T22:25:00-04:00,24563,24566.25,24561.25,24565.25,24543.74824305752,NaN,NaN,NaN,NaN,NaN,24544.37,24565.11734682333,24523.62265317667,24554.59131002178,24543.453359084506,24553.95987082553,24532.946847343483,673,544.9,77.38281324165283,74.60287652922064,NaN,NaN,NaN,NaN,5.533836780397067,46.421894138301504,5220,-1.0856351652790543,9.369953690766124,10.455588856045178
2025-09-15T22:30:00-04:00,24565,24584,24565,24580,24552.816504736722,NaN,NaN,NaN,NaN,NaN,24545.325,24568.054111282978,24522.595888717024,24565.173048017423,24546.327134260173,24560.000825563213,24532.653442957133,2653,604.2,84.69668346071941,75.19362318831772,NaN,NaN,NaN,NaN,6.495705581797276,48.05704827894527,7873,-0.06341220429664851,10.376323600674368,10.439735804971017
2025-09-15T22:35:00-04:00,24579.5,24580,24573,24574.75,24554.847572703235,NaN,NaN,NaN,NaN,NaN,24546.22,24569.966292336827,24522.473707663175,24565.173048017423,24547.049897152403,24561.307059629893,24532.792734674913,760,617.5666666666667,75.35600354745306,75.3919783470679,NaN,NaN,NaN,NaN,6.5317266116688995,49.575405695257324,7113,0.15040170282367527,10.627737933500612,10.477336230676936
2025-09-15T22:40:00-04:00,24575,24575,24569.5,24572.25,24554.847572703235,NaN,NaN,NaN,NaN,NaN,24547.12,24571.328725696825,24522.911274303173,24565.173048017423,24547.409955647072,24561.877377020937,24532.942534273207,451,620,71.32231022618606,75.11062532642184,NaN,NaN,NaN,NaN,6.458031853692549,50.059758477224214,6662,0.021467777740284077,10.504170952852292,10.482703175112007
2025-09-15T22:45:00-04:00,24573.25,24573.25,24569.25,24572.25,24554.847572703235,NaN,NaN,NaN,NaN,NaN,24547.975,24572.64932876957,24523.300671230427,24565.173048017423,24547.630775991962,24562.214448714054,24533.04710326987,291,607.8666666666667,71.32231022618606,74.70994131960713,NaN,NaN,NaN,NaN,6.282458149857367,50.44415191353105,6662,-0.15603968889339548,10.287653563995264,10.443693252888659
2025-09-15T22:50:00-04:00,24571.75,24574.5,24571.25,24572.5,24554.847572703235,NaN,NaN,NaN,NaN,NaN,24548.765,24573.994032885203,24523.535967114796,24565.173048017423,24547.787496880457,24562.45953511528,24533.115458645636,200,601.0333333333333,71.4992440098468,74.1210156920027,NaN,NaN,NaN,NaN,6.065853996296126,50.89832469827006,6862,-0.33837681365900707,10.020722235814901,10.359099049473908
2025-09-15T22:55:00-04:00,24571.75,24572.25,24567.75,24571,24554.847572703235,NaN,NaN,NaN,NaN,NaN,24549.545,24575.062384278663,24524.027615721334,24565.173048017423,24548.037194714376,24562.81731234304,24533.257077085713,359,597.7,68.75813307336085,73.60761699689245,NaN,NaN,NaN,NaN,5.971864425132117,50.37530213560394,6503,-0.6250923436745293,9.577733619880746,10.202825963555275
2025-09-15T23:00:00-04:00,24572,24574,24570,24573.75,24554.847572703235,NaN,NaN,NaN,NaN,NaN,24550.415,24576.20639585666,24524.62360414334,24565.173048017423,24548.29791736613,24563.213120902543,24533.382713829717,348,575.6333333333333,70.95650023774606,73.66864481614961,NaN,NaN,NaN,NaN,5.831016966194109,50.0647412470289,6851,-0.6895503509759848,9.340888024835294,10.03043837581128
2025-09-15T23:05:00-04:00,24573.75,24577.25,24573.25,24576.5,24555.78209853681,NaN,NaN,NaN,NaN,NaN,24551.34,24577.487229296945,24525.192770703055,24565.173048017423,24548.610896546168,24563.72338076076,24533.498412331577,379,573.7666666666667,73.00235069473104,73.83573417072314,NaN,NaN,NaN,NaN,5.700230040037387,50.084572411086704,7230,-0.6097510288986943,9.268249589687912,9.878000618586606
2025-09-15T23:10:00-04:00,24577.5,24579.25,24575.5,24576.5,24558.280639512406,NaN,NaN,NaN,NaN,NaN,24552.245,24578.678972459293,24525.811027540705,24567.34450239967,24548.82321833228,24564.077211621603,24533.569225042957,249,564.6666666666666,73.00235069473104,73.90847114988053,NaN,NaN,NaN,NaN,5.5609278943204306,50.28145848220089,7230,-0.6178260493867089,9.10571805685322,9.72354410623993
2025-09-15T23:15:00-04:00,24576.5,24577.75,24574.5,24576,24558.280639512406,NaN,NaN,NaN,NaN,NaN,24553.175,24579.614600985034,24526.735399014964,24567.34450239967,24548.986331070882,24564.3392426914,24533.633419450365,201,538.8,71.93387397411698,73.90488836327977,NaN,NaN,NaN,NaN,5.3958616161546855,50.17629799336451,7029,-0.7110563808350676,8.834723630196095,9.545780011031162
2025-09-15T23:20:00-04:00,24575.75,24577.5,24573.75,24575.5,24558.280639512406,NaN,NaN,NaN,NaN,NaN,24554.075,24580.429363960666,24527.720636039336,24567.34450239967,24549.1413995679,24564.582835227615,24533.699963908184,197,533.3333333333334,70.81764223652146,73.69567155172474,NaN,NaN,NaN,NaN,5.278300072143637,49.856907284388264,6832,-0.8511524821082102,8.4818394083959,9.33299189050411
2025-09-15T23:25:00-04:00,24576.25,24581,24575.75,24579.5,24560.125927641286,NaN,NaN,NaN,NaN,NaN,24554.865,24581.84503149721,24527.884968502793,24569.61438522863,24549.4681115729,24565.132519298248,24533.803703847552,377,538,74.25893833570143,73.58884576469775,NaN,NaN,NaN,NaN,5.294135781276234,49.928348876849675,7209,-0.7241596349837938,8.427792346774368,9.151951981758161
2025-09-15T23:30:00-04:00,24579.5,24587.75,24578.25,24584.5,24564.284976384864,NaN,NaN,NaN,NaN,NaN,24555.635,24583.733435899027,24527.53656410097,24573.891508182904,24550.2286605431,24566.513454380933,24533.943866705267,781,550.0666666666667,77.7853698099083,73.72103741206152,NaN,NaN,NaN,NaN,5.594554654042217,50.57260302908897,7990,-0.3709496141576558,8.68826496406109,9.059214578218747
2025-09-15T23:35:00-04:00,24584,24584.5,24578.75,24581.5,24564.284976384864,NaN,NaN,NaN,NaN,NaN,24556.345,24585.217112839924,24527.47288716008,24573.891508182904,24550.710999351977,24567.324423577615,24534.09757512634,546,543.7333333333333,71.45970538236263,73.29795827925508,NaN,NaN,NaN,NaN,5.605657893039202,51.170839027596884,7444,-0.40416274568805477,8.554011146108678,8.958173891796733
2025-09-15T23:40:00-04:00,24582.25,24584.75,24581,24581.5,24564.562860714308,NaN,NaN,NaN,NaN,NaN,24557.09,24586.59080676511,24527.58919323489,24573.891508182904,24550.94596780207,24567.719608611587,24534.17232699255,265,524.7333333333333,71.45970538236261,72.35245984508674,NaN,NaN,NaN,NaN,5.473110900679258,51.74693519035013,7444,-0.48546317551946494,8.351344922397402,8.836808097916867
2025-09-15T23:45:00-04:00,24582,24586.25,24579.5,24584.75,24564.562860714308,NaN,NaN,NaN,NaN,NaN,24557.935,24588.128014087528,24527.741985912475,24573.891508182904,24551.282040814436,24568.290216237743,24534.27386539113,373,522.7,74.1054508193591,72.26313465022288,NaN,NaN,NaN,NaN,5.564317264916454,52.281881627192426,7817,-0.38412801325955215,8.356648081342428,8.74077609460198
2025-09-15T23:50:00-04:00,24585,24585.25,24578.75,24581.75,24564.562860714308,NaN,NaN,NaN,NaN,NaN,24558.735,24589.287808383404,24528.182191616597,24573.891508182904,24551.61415984522,24568.824793825628,24534.40352586481,396,523.3,67.85259199398661,72.0152976336372,NaN,NaN,NaN,NaN,5.63115174599385,52.507350167738664,7421,-0.5716174501848368,8.026254281870933,8.59787173205577
2025-09-15T23:55:00-04:00,24582.25,24586.75,24582,24585.25,24566.081614206912,NaN,NaN,NaN,NaN,NaN,24559.6,24590.65350222071,24528.546497779287,24573.891508182904,24551.927861539705,24569.35384349242,24534.50187958699,350,518.2666666666667,70.93397437448698,71.98755935851584,NaN,NaN,NaN,NaN,5.58606947842286,52.87223010940279,7771,-0.5141903977156446,7.955133734911215,8.46932413262686
2025-09-16T00:00:00-04:00,24585,24585.5,24581.5,24583.25,24566.081614206912,NaN,NaN,NaN,NaN,NaN,24560.365,24591.824054341592,24528.90594565841,24573.891508182904,24552.176918834568,24569.75655278944,24534.597284879696,294,520.4666666666667,66.98294287908828,71.66496642060453,NaN,NaN,NaN,NaN,5.472778801392655,53.016991119948585,7477,-0.6560900625679036,7.649211554416979,8.305301616984883
2025-09-16T00:05:00-04:00,24583.25,24584.25,24580.5,24582.25,24566.081614206912,NaN,NaN,NaN,NaN,NaN,24561.09,24592.86070348161,24529.31929651839,24573.891508182904,24552.42633823359,24570.14488387363,24534.70779259355,310,507.5,65.03246468471575,71.39884724998701,NaN,NaN,NaN,NaN,5.349723172721752,52.75535334001449,7167,-0.8501722115453543,7.2425863525531895,8.092758564098544
2025-09-16T00:10:00-04:00,24582.25,24582.5,24577,24578.25,24566.081614206912,NaN,NaN,NaN,NaN,NaN,24561.775,24593.519172687877,24530.030827312126,24573.891508182904,24552.710280168238,24570.547301046117,24534.873259290358,401,477,57.784250260043905,70.45797225157972,NaN,NaN,NaN,NaN,5.360457231813055,51.24412749752479,6766,-1.2563025006836357,6.522380438243999,7.778682938927635
2025-09-16T00:15:00-04:00,24577.75,24581,24577.5,24579.25,24566.081614206912,NaN,NaN,NaN,NaN,NaN,24562.505,24594.1441355715,24530.865864428502,24573.891508182904,24552.896719091303,24570.808657938414,24534.98478024419,268,462.46666666666664,59.01412181167178,69.4588130456469,NaN,NaN,NaN,NaN,5.227567429540694,49.84084635807006,7034,-1.4520987485518884,5.963559503237775,7.415658251789663
2025-09-16T00:20:00-04:00,24579,24585,24579,24583.75,24566.081614206912,NaN,NaN,NaN,NaN,NaN,24563.375,24594.910575146623,24531.839424853377,24572.811249401373,24553.18034425463,24571.23890751013,24535.12178099913,368,457.93333333333334,64.08474563987706,68.82184125601448,NaN,NaN,NaN,NaN,5.282741184573502,49.20288404839761,7402,-1.2791262812125055,5.816750400274032,7.095876681486537
2025-09-16T00:25:00-04:00,24583.25,24583.25,24580,24580.75,24566.081614206912,NaN,NaN,NaN,NaN,NaN,24564.16,24595.431354306682,24532.888645693318,24572.811249401373,24553.278671771914,24571.382021464025,24535.175322079802,135,447.26666666666665,58.85695306176401,67.8877754765607,NaN,NaN,NaN,NaN,5.173259671389681,48.610490475130334,7267,-1.3598013210743547,5.396125030143594,6.755926351217949
2025-09-16T00:30:00-04:00,24580.5,24581,24577,24580.5,24566.081614206912,NaN,NaN,NaN,NaN,NaN,24564.995,24595.73284150519,24534.25715849481,24572.811249401373,24553.464576536768,24571.63729840607,24535.291854667466,276,448.7,58.42919615382684,67.00288647065395,NaN,NaN,NaN,NaN,5.08945540914756,46.99484348267128,6991,-1.416630747814211,4.985137916450185,6.401768664264396
2025-09-16T00:35:00-04:00,24581,24583,24579.25,24581.75,24566.081614206912,NaN,NaN,NaN,NaN,NaN,24565.92,24595.824086681474,24536.015913318523,24572.811249401373,24553.77114560574,24572.07591704191,24535.46637416957,433,455.6666666666667,59.99476014078474,65.98401659958846,NaN,NaN,NaN,NaN,4.993780022779878,45.86802251460173,7424,-1.356579830004728,4.706043876758486,6.062623706763214
2025-09-16T00:40:00-04:00,24581,24584.75,24580.25,24582.25,24566.081614206912,NaN,NaN,NaN,NaN,NaN,24566.885,24595.700830725007,24538.06916927499,24573.637276243495,24553.90731142014,24572.274508675117,24535.54011416516,188,446.23333333333335,60.6333984975791,64.75887579156496,NaN,NaN,NaN,NaN,4.958510021152743,45.12830190292751,7612,-1.2711898729442241,4.473636365582934,5.744826238527158
2025-09-16T00:45:00-04:00,24582,24582.75,24578.5,24579,24566.081614206912,NaN,NaN,NaN,NaN,NaN,24567.725,24595.434610250395,24540.015389749602,24573.637276243495,24554.008840419097,24572.41244758002,24535.605233258175,154,432.06666666666666,54.53884243769417,63.550242724088626,NaN,NaN,NaN,NaN,4.907902162498976,43.831830175381945,7458,-1.4108131200870195,3.981309838418383,5.392122958505403
2025-09-16T00:50:00-04:00,24579,24580.5,24577,24579.5,24566.081614206912,NaN,NaN,NaN,NaN,NaN,24568.51,24595.269289982232,24541.750710017765,24573.637276243495,24554.18881276255,24572.647388231057,24535.730237294043,288,432.1333333333333,55.283521404535065,62.39480101138666,NaN,NaN,NaN,NaN,4.807337722320478,42.12967142801819,7746,-1.4416192352703483,3.5900989144174673,5.031718149687816
2025-09-16T00:55:00-04:00,24579,24581.25,24578.75,24580,24566.081614206912,NaN,NaN,NaN,NaN,NaN,24569.24,24595.210167495476,24543.269832504528,24573.637276243495,24554.2967878486,24572.79189521324,24535.801680483964,168,415.3,56.05867265627769,61.10574542830942,NaN,NaN,NaN,NaN,4.642527885011872,40.71327960937326,7914,-1.3993202309686552,3.2825678609769966,4.681888091945652
2025-09-16T01:00:00-04:00,24580.25,24583.75,24577.25,24580.75,24566.081614206912,NaN,NaN,NaN,NaN,NaN,24569.985,24595.08129653988,24544.88870346012,24573.637276243495,24554.566928309137,24573.156756704153,24535.977099914122,417,340.76666666666665,57.255616719035004,60.348818622955726,NaN,NaN,NaN,NaN,4.775204464653881,39.91697985932277,8331,-1.294273987945223,3.0640456070141227,4.358319594959346
2025-09-16T01:05:00-04:00,24580.75,24586.5,24579.25,24585,24566.798074167207,NaN,NaN,NaN,NaN,NaN,24570.8,24595.135570678885,24546.464429321113,24574.067182679468,24554.821396000258,24573.526208897358,24536.116583103158,359,327.4,63.348282603793066,59.80698349647759,NaN,NaN,NaN,NaN,4.951975574321461,39.679237993025325,8690,-0.929093953360125,3.19695215325919,4.126046106619315
2025-09-16T01:10:00-04:00,24584.75,24593.25,24584,24590.25,24572.01747988688,NaN,NaN,NaN,NaN,NaN,24571.71,24595.47728003443,24547.94271996557,24578.678746143574,24555.726508736872,24574.98571155331,24536.467305920436,1108,349.3,69.19039032016487,59.96465831369734,NaN,NaN,NaN,NaN,5.258977319012785,40.403314083552516,9798,-0.3540751818217034,3.683452129342186,4.037527311163889
2025-09-16T01:15:00-04:00,24590.25,24591.75,24582.75,24584.75,24572.01747988688,NaN,NaN,NaN,NaN,NaN,24572.405,24595.618119132105,24549.191880867893,24578.678746143574,24556.238992313323,24575.737419219106,24536.74056540754,714,363.4,58.64434897074522,59.508364334128025,NaN,NaN,NaN,NaN,5.526193224797586,40.648267356324915,9084,-0.3629098664706283,3.5838899780756037,3.946799844546232
2025-09-16T01:20:00-04:00,24584.75,24588,24582,24587.5,24572.01747988688,NaN,NaN,NaN,NaN,NaN,24573.12,24595.94328635444,24550.29671364556,24578.678746143574,24556.524825323293,24576.14354060247,24536.906110044118,417,370.6333333333333,61.78107671157589,59.79385193780888,NaN,NaN,NaN,NaN,5.560036565883473,40.61725628421998,9501,-0.20990658607849877,3.6844166119481088,3.8943231980266075
2025-09-16T01:25:00-04:00,24587.25,24590.75,24585.25,24589.5,24572.01747988688,NaN,NaN,NaN,NaN,NaN,24573.895,24596.254134600804,24551.535865399197,24578.678746143574,24556.95011845723,24576.77920232088,24537.12103459358,582,378.06666666666666,63.92416629020484,60.14456940056124,NaN,NaN,NaN,NaN,5.555748239748938,40.974356676371144,10083,-0.010871917600214775,3.880733301026339,3.891605218626554
2025-09-16T01:30:00-04:00,24589,24589.5,24583.25,24585,24572.01747988688,NaN,NaN,NaN,NaN,NaN,24574.58,24596.145351833886,24553.014648166118,24578.678746143574,24557.210564161793,24577.138776624826,24537.28235169876,397,379.7,56.27762807963369,59.58691814625814,NaN,NaN,NaN,NaN,5.605337651195443,40.618459366715406,9686,-0.2082094285678311,3.631343432916765,3.839552861484596
2025-09-16T01:35:00-04:00,24584.75,24589,24584.25,24589,24572.01747988688,NaN,NaN,NaN,NaN,NaN,24575.385,24596.01827652143,24554.751723478566,24578.678746143574,24557.482422474088,24577.524809502193,24537.440035445983,401,380.43333333333334,60.76976384925852,59.72354748822204,NaN,NaN,NaN,NaN,5.544242104681483,40.28798329346365,10087,-0.10071589034554673,3.7136579985526623,3.814373888898209
2025-09-16T01:40:00-04:00,24588.75,24592,24586.25,24590.5,24572.079183498587,NaN,NaN,NaN,NaN,NaN,24576.14,24596.158531415582,24556.121468584417,24578.678746143574,24557.78149041668,24577.9672720232,24537.59570881016,419,386.1,62.332659797390086,60.00236631990513,NaN,NaN,NaN,NaN,5.558939097204234,40.452613614663406,10506,0.03289024739297641,3.85548669813943,3.8225964507464534
2025-09-16T01:45:00-04:00,24589.75,24594,24586,24594,24572.63808424865,NaN,NaN,NaN,NaN,NaN,24576.91,24596.653545781377,24557.166454218623,24578.678746143574,24558.080202227215,24578.42156936974,24537.73883508469,404,392.8666666666667,65.7603382699478,60.414193329131066,NaN,NaN,NaN,NaN,5.733300590261074,40.888158759108634,10910,0.30341976622076405,4.201871158522408,3.898451392301644
2025-09-16T01:50:00-04:00,24593.25,24602,24593,24599.25,24579.699989510078,NaN,NaN,NaN,NaN,NaN,24577.68,24597.841111076938,24557.518888923063,24584.8880788666,24559.239241847125,24580.376993995982,24538.101489698267,1354,431.43333333333334,70.14845241335846,61.093840037401016,NaN,NaN,NaN,NaN,5.9666362623852836,42.166741243405454,12264,0.7565779599192357,4.844173842200689,4.0875958822814535
2025-09-16T01:55:00-04:00,24598.5,24599,24593,24594.5,24579.699989510078,NaN,NaN,NaN,NaN,NaN,24578.395,24598.354731953565,24558.435268046436,24584.8880788666,24559.598776483046,24580.936117424215,24538.261435541877,468,434.46666666666664,62.361237432911636,61.6525825370594,NaN,NaN,NaN,NaN,5.9868765293577635,43.35399640739536,11796,0.6605479352105208,4.913280801294604,4.2527328660840835
2025-09-16T02:00:00-04:00,24594.75,24603,24594,24600.5,24580.240589615587,NaN,NaN,NaN,NaN,NaN,24579.295,24599.101738752866,24559.48826124713,24585.048370474622,24560.306816132605,24582.093267869175,24538.520364396034,860,437.1,67.29936772126013,62.51085727396834,NaN,NaN,NaN,NaN,6.202099634403638,44.80147723498838,12656,0.9098657910096488,5.390065104846144,4.480199313836495
2025-09-16T02:05:00-04:00,24600,24600.5,24596,24599.25,24580.240589615587,NaN,NaN,NaN,NaN,NaN,24580.155,24599.61570143144,24560.694298568556,24585.048370474622,24560.6000289071,24582.55795850977,24538.642099304434,371,431.26666666666665,65.37502457039989,63.17631098211992,NaN,NaN,NaN,NaN,6.080521089089092,46.145566574896186,12285,0.8978195229652313,5.602473717543035,4.704654194577803
2025-09-16T02:10:00-04:00,24599.5,24603.75,24597.25,24601.5,24582.39070252164,NaN,NaN,NaN,NaN,NaN,24581.025,24600.334906769996,24561.715093230006,24587.210957103758,24561.061546207275,24583.309586060364,24538.813506354185,562,441.1666666666667,67.19342535727415,63.88615445627987,NaN,NaN,NaN,NaN,6.110483868439871,47.65211853932418,12847,0.9439022818991898,5.88453204695179,4.9406297650526
2025-09-16T02:15:00-04:00,24601.75,24602.5,24598.5,24601,24582.668397861566,NaN,NaN,NaN,NaN,NaN,24581.885,24600.84343084401,24562.92656915599,24587.268765683006,24561.40771539369,24583.86298598273,24538.952444804647,432,443.1333333333333,66.35940853062486,64.10123487962498,NaN,NaN,NaN,NaN,5.959735020694166,49.05105964915018,12415,0.8463535346909037,5.99857168341623,5.152218148725327
2025-09-16T02:20:00-04:00,24601,24603.25,24596.75,24597.25,24582.668397861566,NaN,NaN,NaN,NaN,NaN,24582.625,24601.02805681493,24564.22194318507,24587.815012546405,24561.718428110864,24584.339003759625,24539.097852462102,411,443.6333333333333,60.312906077913,63.46712886232128,NaN,NaN,NaN,NaN,5.998325376358869,49.651494951269584,12004,0.4545565902473516,5.720413886534516,5.265857296287164
2025-09-16T02:25:00-04:00,24597,24597.5,24591.75,24593.75,24582.668397861566,NaN,NaN,NaN,NaN,NaN,24583.24,24601.02340799548,24565.456592004524,24587.815012546405,24562.15682305585,24584.93660682009,24539.377039291612,679,454.6,55.25260939549293,63.22486174980327,NaN,NaN,NaN,NaN,5.980587849476093,48.49388891989053,11325,-0.08621239091213351,5.158091807646997,5.2443041985591305
2025-09-16T02:30:00-04:00,24593.75,24594,24585,24587.75,24582.668397861566,NaN,NaN,NaN,NaN,NaN,24583.73,24600.610414701583,24566.849585298416,24587.815012546405,24562.689517406845,24585.549083453803,24539.829951359887,1026,479,47.842162246615665,62.22922500230611,NaN,NaN,NaN,NaN,6.196260145942086,45.68918115406142,10299,-0.8513538191111447,4.1801119246702,5.031465743781345
2025-09-16T02:35:00-04:00,24587.5,24590,24585.5,24588.5,24582.668397861566,NaN,NaN,NaN,NaN,NaN,24584.195,24600.275513052988,24568.11448694701,24587.815012546405,24562.879114513118,24585.75723044736,24540.000998578875,389,481.6333333333333,48.7671475947918,61.1465808097766,NaN,NaN,NaN,NaN,6.075098706946222,43.084809657220106,10688,-1.2843079339597967,3.4260808263315994,4.710388760291396
2025-09-16T02:40:00-04:00,24588.5,24595.75,24586.5,24593.25,24582.668397861566,NaN,NaN,NaN,NaN,NaN,24584.46,24600.691253814988,24568.22874618501,24587.815012546405,24563.229977932915,24586.188668402676,24540.271287463154,637,489.5,54.2954494312207,61.004996620604246,NaN,NaN,NaN,NaN,6.301877370735778,41.65219010656232,11325,-1.228159453374805,3.17518944357289,4.403348896947695
2025-09-16T02:45:00-04:00,24593.5,24593.75,24588.75,24589.5,24582.668397861566,NaN,NaN,NaN,NaN,NaN,24584.755,24600.804763242217,24568.705236757785,24587.815012546405,24563.421230353626,24586.413358728983,24540.42910197827,369,492.8666666666667,49.73288312262236,60.21664799727309,NaN,NaN,NaN,NaN,6.2088861299689375,40.32190052380866,10956,-1.4080452562197854,2.643292326672963,4.0513375828927485
2025-09-16T02:50:00-04:00,24589.25,24591.5,24587.75,24589.25,24582.668397861566,NaN,NaN,NaN,NaN,NaN,24585.095,24600.78700113777,24569.40299886223,24587.815012546405,24563.61826712161,24586.63442501285,24540.602109230367,403,494.03333333333336,49.43463991864179,59.29536086307679,NaN,NaN,NaN,NaN,6.033251406399728,38.825179201851824,10553,-1.4998718208287691,2.176497806856787,3.676369627685556
2025-09-16T02:55:00-04:00,24588.75,24590,24585.5,24588.25,24582.668397861566,NaN,NaN,NaN,NaN,NaN,24585.415,24600.693288509425,24570.136711490577,24587.815012546405,24563.791497586328,24586.81639802997,24540.766597142687,383,502.3,48.1897630846659,58.040319778413796,NaN,NaN,NaN,NaN,5.923733448799747,36.8620284308828,10170,-1.5761355972345283,1.7062001311423955,3.282335728376924
2025-09-16T03:00:00-04:00,24588.5,24595.75,24585,24595.5,24582.668397861566,NaN,NaN,NaN,NaN,NaN,24585.875,24600.953875950905,24570.796124049095,24587.815012546405,24564.413177313734,24587.558342712895,24541.268011914573,1207,533.3333333333334,56.702685252651364,57.07990783836329,NaN,NaN,NaN,NaN,6.268466773885479,36.02805277062508,11377,-1.1085589879796567,1.8966369934023533,3.00519598138201
2025-09-16T03:05:00-04:00,24595,24595.5,24582,24590.25,NaN,NaN,NaN,24605.57554110011,24605.57554110011,24605.57554110011,24586.26,24600.7723947212,24571.747605278797,24587.815012546405,24564.96148082868,24588.13883944122,24541.784122216137,1240,560.2333333333333,50.262305575421955,56.21569841997117,NaN,NaN,NaN,NaN,6.785004861465088,34.532339611136074,10137,-1.1198190669698143,1.6054221476697421,2.7252412146395564
2025-09-16T03:10:00-04:00,24590.75,24604.5,24589.75,24600.25,NaN,NaN,NaN,24605.57554110011,NaN,NaN,24586.79,24601.37161854971,24572.20838145029,24582.277010037124,24566.007516322952,24589.542743419213,24542.47228922669,1827,614.8666666666667,59.66083892454667,55.670089220205924,NaN,NaN,NaN,NaN,7.353933085646154,34.39734278174026,11964,-0.45484276620742614,2.156687756880274,2.6115305230877
2025-09-16T03:15:00-04:00,24600.25,24607.75,24593.25,24604.75,24578.8515798584,24578.8515798584,24578.8515798584,NaN,NaN,NaN,24587.355,24602.477198917382,24572.232801082617,24581.75068396305,24566.76870400998,24590.6207398851,24542.91666813486,1256,651.6,63.04495584670363,55.503655739941905,NaN,NaN,NaN,NaN,7.864366436671429,34.63001572481902,13220,0.24916576767364607,2.9229877326797578,2.6738219650061117
2025-09-16T03:20:00-04:00,24605.25,24614.5,24595.25,24607.5,24581.585598955746,NaN,NaN,NaN,NaN,NaN,24587.975,24603.792158416174,24572.157841583823,24584.075547170443,24568.448926858404,24593.087746085814,24543.810107630994,2669,730.9666666666667,64.97851692128069,55.345447994513805,NaN,NaN,NaN,NaN,8.677625976909185,35.48150916108079,15889,0.8284848475602535,3.709428024456429,2.8809431768961753
2025-09-16T03:25:00-04:00,24607.25,24611.75,24605.25,24609.75,24585.38284445776,NaN,NaN,NaN,NaN,NaN,24588.65,24605.227695849993,24572.07230415001,24584.160437736355,24568.956169167705,24593.850580988004,24544.061757347405,786,751.5666666666667,66.5219195150625,55.35705592197364,NaN,NaN,NaN,NaN,8.522081264272815,36.27218163760958,16675,1.265485013410744,4.4627994436596055,3.1973144302488614
2025-09-16T03:30:00-04:00,24609.75,24615.75,24606.5,24614.5,24587.79726061877,NaN,NaN,NaN,NaN,NaN,24589.43,24607.093816117093,24571.766183882908,24589.053350189082,24569.479992122873,24594.672001995197,24544.28798225055,768,763.2666666666667,69.57074002794201,56.018329775547144,NaN,NaN,NaN,NaN,8.5740754596819,37.34734112494141,17443,1.747034033537333,5.381106972170528,3.634072938633195
2025-09-16T03:35:00-04:00,24614.5,24617.75,24608.75,24612.75,24589.755339681553,NaN,NaN,NaN,NaN,NaN,24590.095,24608.692282061373,24571.49771793863,24591.892680151268,24570.206815799385,24595.804125528393,24544.609506070377,1076,787.1666666666666,67.14462340536514,56.86775934768087,NaN,NaN,NaN,NaN,8.604498641133192,38.50523091956345,16367,1.8124651583426052,5.899654386561451,4.087189228218846
2025-09-16T03:40:00-04:00,24613.25,24614.25,24604.25,24609.5,24589.755339681553,NaN,NaN,NaN,NaN,NaN,24590.595,24609.894712431946,24571.295287568057,24591.892680151268,24570.717104458432,24596.53148553211,24544.902723384756,853,778.6666666666666,62.76692442893068,57.9338137892748,NaN,NaN,NaN,NaN,8.70417730962368,38.48297747028618,15514,1.5137941697762027,5.979431940439099,4.465637770662896
2025-09-16T03:45:00-04:00,24609.5,24610,24603.75,24606.75,24589.755339681553,NaN,NaN,NaN,NaN,NaN,24591.1,24610.73975560609,24571.460244393907,24591.892680151268,24571.119002620693,24597.06741975392,24545.170585487467,736,779.4,59.246987041629055,58.68237374976318,NaN,NaN,NaN,NaN,8.528878930364845,38.34553330584418,14778,1.0310264459174148,5.754420828059665,4.72339438214225
2025-09-16T03:50:00-04:00,24605.75,24606.5,24595.75,24601.25,24589.755339681553,NaN,NaN,NaN,NaN,NaN,24591.495,24611.140989413027,24571.84901058697,24591.892680151268,24571.51619520782,24597.519980416397,24545.512409999243,886,795.0333333333333,52.861969321768456,58.57998231337374,NaN,NaN,NaN,NaN,8.705387578195928,36.56620147480574,13892,0.28032944342031296,5.073806186417642,4.793476742997329
2025-09-16T03:55:00-04:00,24601,24604.25,24598.5,24602.25,24589.755339681553,NaN,NaN,NaN,NaN,NaN,24591.845,24611.62096772885,24572.069032271153,24591.892680151268,24571.730136039296,24597.76479281958,24545.69547925901,479,791.6,53.83610681412624,58.87306971990973,NaN,NaN,NaN,NaN,8.494288465467648,34.91396477455576,14371,-0.18477177562846325,4.56251202346175,4.747283799090213
2025-09-16T04:00:00-04:00,24602.5,24625.5,24601.25,24622.75,24589.755339681553,NaN,NaN,NaN,NaN,NaN,24592.665,24614.034513326147,24571.295486673855,24595.434073431967,24573.32647866934,24600.20686000306,24546.446097335618,2496,861.5666666666667,68.29911781432699,60.220532426744356,NaN,NaN,NaN,NaN,9.619696432219959,35.499469192591945,16867,0.7983798606202521,5.745258624865528,4.946878764245276
2025-09-16T04:05:00-04:00,24622,24635.25,24620.25,24632.5,24600.96827811544,NaN,NaN,NaN,NaN,NaN,24593.61,24617.60232377039,24569.617676229613,24603.697258745575,24575.25026325106,24603.565982779866,24546.93454372225,2490,931.2,72.68270300799279,61.97002813555342,NaN,NaN,NaN,NaN,10.004003829918533,36.631771197836514,19357,1.9498703406615459,7.384216690072208,5.434346349410662
2025-09-16T04:10:00-04:00,24633,24635.25,24628,24634,24605.071992746558,NaN,NaN,NaN,NaN,NaN,24594.625,24620.958106536935,24568.291893463065,24606.38280699646,24575.90741106898,24604.71189274841,24547.102929389548,843,945.3333333333334,73.29453140862036,63.15516000383692,NaN,NaN,NaN,NaN,9.807289270638638,37.68319448842076,20200,2.6155694375898166,8.703808146397932,6.088238708808116
2025-09-16T04:15:00-04:00,24634.25,24638,24629.25,24629.5,24607.085765803535,NaN,NaN,NaN,NaN,NaN,24595.57,24623.407212502578,24567.73278749742,24610.53124559717,24576.725133487416,24606.103022337353,24547.34724463748,1080,967.8666666666667,68.3488189720976,64.44705381788518,NaN,NaN,NaN,NaN,9.731768608450164,38.81672084891365,19120,2.553019465524657,9.279513040713937,6.72649357518928
2025-09-16T04:20:00-04:00,24630,24634,24625,24633.75,24607.085765803535,NaN,NaN,NaN,NaN,NaN,24596.68,24626.050059584057,24567.309940415944,24610.53124559717,24577.510289196718,24607.384830180566,24547.63574821287,1094,959.2,70.38155349950603,65.21281914466799,NaN,NaN,NaN,NaN,9.679499422132295,39.10126862982988,20214,2.589881769057559,9.963845786511229,7.37396401745367
2025-09-16T04:25:00-04:00,24634,24636.5,24628.5,24636.25,24607.085765803535,NaN,NaN,NaN,NaN,NaN,24597.82,24628.77739652689,24566.86260347311,24611.31999718219,24578.428312120293,24608.902995720808,24547.95362851978,1253,985.3666666666667,71.53945013669906,65.81956873681052,NaN,NaN,NaN,NaN,9.559535177694274,39.53902792482055,21467,2.5695376020214926,10.585886019980535,8.016348417959042
2025-09-16T04:30:00-04:00,24636.25,24636.75,24627.75,24628.75,24607.085765803535,NaN,NaN,NaN,NaN,NaN,24598.72,24630.591874742073,24566.84812525793,24612.105997745748,24578.854249852462,24609.56972109459,24548.138778610333,626,977.5666666666667,63.51705894486154,65.71517888135202,NaN,NaN,NaN,NaN,9.51956837928754,39.805095030030394,20841,1.870370868222592,10.354312003237283,8.48394113501469
2025-09-16T04:35:00-04:00,24628.25,24632.25,24626.5,24632,24607.085765803535,NaN,NaN,NaN,NaN,NaN,24599.745,24632.52281109368,24566.967188906317,24612.105997745748,24579.378823730032,24610.37070305058,24548.386944409485,798,991.8,65.33133011036723,65.63013678101665,NaN,NaN,NaN,NaN,9.250313495052714,39.80942427101355,21639,1.4641597085575864,10.314140770711674,8.849981062154088
2025-09-16T04:40:00-04:00,24632,24638.5,24631.75,24636,24609.338599666986,NaN,NaN,NaN,NaN,NaN,24600.855,24634.692566406105,24567.017433593894,24617.05283855728,24579.816174915388,24611.078248796766,24548.55410103401,615,993.5666666666667,67.47515313530863,65.4804520029714,NaN,NaN,NaN,NaN,9.07171967397752,40.299925211358826,22254,1.3073878192053137,10.484215836160729,9.176828016955415
2025-09-16T04:45:00-04:00,24635.75,24645.75,24635,24645.5,24614.294799682124,NaN,NaN,NaN,NaN,NaN,24602.13,24637.74927006468,24566.510729935322,24623.217270845824,24580.993016301858,24613.098151475064,24548.887881128652,1518,1029.7666666666667,71.91682308980832,65.82132340900306,NaN,NaN,NaN,NaN,9.191596840121983,41.22749116375402,23772,1.663195223236798,11.255822046001413,9.592626822764615
2025-09-16T04:50:00-04:00,24645.75,24646.75,24640.5,24643.75,24617.877990605662,NaN,NaN,NaN,NaN,NaN,24603.36,24640.368669256433,24566.351330743568,24625.59881667666,24581.695151302498,24614.294302566872,24549.096000038124,910,1046.4,70.0198918603154,66.33939251124482,NaN,NaN,NaN,NaN,8.98148278011327,42.149126025844446,22862,1.599885909691773,11.59248420987933,9.992598300187558
2025-09-16T04:55:00-04:00,24643.75,24643.75,24633.25,24639.25,24617.877990605662,NaN,NaN,NaN,NaN,NaN,24604.565,24642.2400328484,24566.889967151597,24625.59881667666,24582.34442510618,24615.31765575664,24549.37119445572,935,1054.9333333333334,65.25355822432455,66.76843331000879,NaN,NaN,NaN,NaN,9.089948295819465,41.64315264781995,21927,1.098056096933643,11.36516842135461,10.267112324420967
2025-09-16T05:00:00-04:00,24639.5,24645.5,24638.75,24643.5,24617.877990605662,NaN,NaN,NaN,NaN,NaN,24605.845,24644.366018935412,24567.32398106459,24625.59881667666,24582.875641381353,24616.182755853122,24549.568526909585,731,1045.1,67.5034486980779,67.81425326545947,NaN,NaN,NaN,NaN,8.922809131832361,41.317808856921154,22658,0.9035787452833546,11.39658575602516,10.493007010741806
2025-09-16T05:05:00-04:00,24644,24645.25,24640.25,24643,24617.877990605662,NaN,NaN,NaN,NaN,NaN,24607.105,24646.277961341333,24567.932038658666,24625.86059413845,24583.1986559559,24616.704628333806,24549.692683577996,449,1047.1,66.9541679032825,68.75125762897063,NaN,NaN,NaN,NaN,8.642608479558621,41.01570390822941,22209,0.6067454441147113,11.251438815885194,10.644693371770483
2025-09-16T05:10:00-04:00,24642.25,24642.25,24637,24637.25,24617.877990605662,NaN,NaN,NaN,NaN,NaN,24608.235,24647.561124902,24568.908875098,24625.86059413845,24583.517899607104,24617.19084542074,24549.84495379347,481,1041.9,60.82459515196408,68.21736315308756,NaN,NaN,NaN,NaN,8.45385073101872,40.11947724514338,21728,-0.07510772175138314,10.550808719581255,10.625916441332638
2025-09-16T05:15:00-04:00,24637.5,24638.5,24629,24630.75,24617.877990605662,NaN,NaN,NaN,NaN,NaN,24609.15,24648.399968146052,24569.90003185395,24625.86059413845,24583.975250167427,24617.822571661007,24550.127928673846,786,1055.8,54.72541014058947,66.93469937684446,NaN,NaN,NaN,NaN,8.528575678803097,37.97626072319878,20942,-1.0102320722401856,9.363126351032406,10.373358423272592
2025-09-16T05:20:00-04:00,24631.25,24635,24629,24631,24617.877990605662,NaN,NaN,NaN,NaN,NaN,24609.965,24649.303531996502,24570.6264680035,24625.86059413845,24584.312177275493,24618.275429988775,24550.34892456221,602,1062.4333333333334,54.912675900304485,65.62170969767905,NaN,NaN,NaN,NaN,8.347963130317162,35.98613109567879,21544,-1.62200937689364,8.34584670215554,9.96785607904918
2025-09-16T05:25:00-04:00,24631.5,24634.75,24627.75,24632.5,24617.877990605662,NaN,NaN,NaN,NaN,NaN,24610.92,24650.081644505404,24571.758355494592,24625.86059413845,24584.59555847185,24618.653432039293,24550.537684904408,513,1066.7666666666667,56.08632841973318,64.7458175153673,NaN,NaN,NaN,NaN,8.251680049580221,33.93966250131338,22057,-1.915579673025249,7.5733814877676195,9.488961160792869
2025-09-16T05:30:00-04:00,24632,24632.75,24621.5,24624.75,24617.877990605662,NaN,NaN,NaN,NaN,NaN,24611.665,24650.43143006036,24572.898569939643,24625.86059413845,24585.032535129427,24619.176966213472,24550.88810404538,907,1056.7666666666667,48.99065744889617,63.217896368895175,NaN,NaN,NaN,NaN,8.465845760324491,31.908622481916595,21150,-2.580261937638431,6.263633738744829,8.84389567638326
2025-09-16T05:35:00-04:00,24625,24627.75,24616.5,24617.75,NaN,NaN,NaN,24647.535271877874,24647.535271877874,24647.535271877874,24612.23,24650.50817133143,24573.95182866857,24625.86059413845,24585.396103018178,24619.55412644863,24551.238079587725,893,1045.2,43.62246934661104,61.22382631246031,NaN,NaN,NaN,NaN,8.664713920301313,30.653319670309344,20257,-3.388962065065634,4.607693095051218,7.996655160116852
2025-09-16T05:40:00-04:00,24617.25,24623.25,24617,24622.25,NaN,NaN,NaN,24645.23253224706,NaN,NaN,24612.975,24650.547762742382,24575.402237257615,24625.86059413845,24585.701163844362,24619.869041852682,24551.53328583604,760,1009.6333333333333,47.59771387736747,60.08673023621075,NaN,NaN,NaN,NaN,8.492234354565506,29.487681345245463,21017,-3.503909137856266,3.6167687377965194,7.1206778756527855
2025-09-16T05:45:00-04:00,24621.5,24625.25,24620.75,24621.5,NaN,NaN,NaN,24645.23253224706,NaN,NaN,24613.625,24650.636518476844,24576.613481523156,24625.86059413845,24585.89396901408,24620.075615717833,24551.712322310326,465,983.2666666666667,47.002852939977,58.77755329546858,NaN,NaN,NaN,NaN,8.207074757810826,28.066016145771655,20552,-3.5050561380831233,2.7393577030488814,6.244413841132005
2025-09-16T05:50:00-04:00,24621,24625.5,24619.5,24624.75,NaN,NaN,NaN,24645.23253224706,NaN,NaN,24614.31,24650.848960024217,24577.771039975785,24625.86059413845,24586.053651367085,24620.249121608853,24551.858181125317,381,907,49.923442979130144,57.52385971288441,NaN,NaN,NaN,NaN,8.049426560824338,26.92157785127602,20933,-3.171555942641888,2.279968912829645,5.451524855471533
2025-09-16T05:55:00-04:00,24624.5,24627.75,24619.75,24626.5,NaN,NaN,NaN,24645.23253224706,NaN,NaN,24614.96,24651.18559316398,24578.734406836018,24623.738475310758,24586.30799580927,24620.53348494582,24552.082506672723,591,900.5,51.474153036917386,56.063668994820766,NaN,NaN,NaN,NaN,8.04589609219403,25.458013458349697,21524,-2.734285877674722,2.03366750837813,4.767953386052852
2025-09-16T06:00:00-04:00,24626.5,24626.75,24620.25,24621.25,NaN,NaN,NaN,24645.23253224706,NaN,NaN,24615.4,24651.385274760385,24579.414725239618,24618.94078024861,24586.552881688047,24620.79286868542,24552.312894690673,607,895.1333333333333,46.79270475808713,54.40458420180447,NaN,NaN,NaN,NaN,7.935474942751599,24.09898937920383,20917,-2.695388944321212,1.3987172056513373,4.094106149972549
2025-09-16T06:05:00-04:00,24620.5,24624.75,24618.5,24622,NaN,NaN,NaN,24645.23253224706,NaN,NaN,24615.95,24651.478439312486,24580.421560687515,24616.352624198887,24586.721955048746,24620.96618630037,24552.47772379712,436,873.8,47.52690470169164,53.138394664473545,NaN,NaN,NaN,NaN,7.815083875412199,23.125959288041788,21353,-2.5191742940864423,0.9451382823644963,3.4643125764509386
2025-09-16T06:10:00-04:00,24622.5,24624.75,24617.75,24622.25,NaN,NaN,NaN,24644.932621147862,NaN,NaN,24616.385,24651.67794689623,24581.092053103766,24616.332099359108,24586.91940178056,24621.166590553516,24552.672213007605,517,862.6,47.78554568141619,51.72997302042628,NaN,NaN,NaN,NaN,7.756863598597042,22.34751913504363,21870,-2.292296146454784,0.5989423933824582,2.8912385398372424
2025-09-16T06:15:00-04:00,24622,24625.25,24620.25,24625,NaN,NaN,NaN,24644.932621147862,NaN,NaN,24616.9,24651.92827429405,24581.871725705954,24612.390679487286,24587.10123213208,24621.35993002884,24552.842534235322,456,853.2666666666667,50.6661463874296,50.56654291215108,NaN,NaN,NaN,NaN,7.559944770125825,21.513658294040415,22326,-1.8807876614221835,0.5402539630595129,2.4210416244816964
2025-09-16T06:20:00-04:00,24625,24630.75,24623.75,24629.75,NaN,NaN,NaN,24644.932621147862,NaN,NaN,24617.465,24652.392640919377,24582.537359080623,24614.044460685727,24587.439275431254,24621.757154766306,24553.1213960962,763,849.1666666666666,55.257667055246436,50.168905190956956,NaN,NaN,NaN,NaN,7.519948715116838,20.328764058618322,23089,-1.2432063894021277,0.8670336377290369,2.1102400271311645
2025-09-16T06:25:00-04:00,24630,24630.75,24625.25,24629.25,NaN,NaN,NaN,24644.932621147862,NaN,NaN,24618.03,24652.78753731253,24583.272462687466,24614.635568548583,24587.645991538484,24622.000083611045,24553.291899465923,469,848.8333333333334,54.680758326903415,50.16571577569367,NaN,NaN,NaN,NaN,7.375666664037063,19.228505125726382,22620,-0.8295593542927651,1.073290834265208,1.9028501885579732
2025-09-16T06:30:00-04:00,24629.5,24630.25,24622.75,24624.5,NaN,NaN,NaN,24644.932621147862,NaN,NaN,24618.575,24652.863518484566,24584.286481515435,24614.635568548583,24587.84904832721,24622.224053960825,24553.474042693597,497,782.2,49.40380501229871,49.77222499797897,NaN,NaN,NaN,NaN,7.384547616605844,18.021585039699982,22123,-0.8472883593081828,0.8437397394227446,1.6910280987309274
2025-09-16T06:35:00-04:00,24623.75,24625,24620.25,24623,NaN,NaN,NaN,24644.932621147862,NaN,NaN,24619.16,24652.724826827845,24585.595173172154,24614.635568548583,24588.037712157482,24622.41506483139,24553.660359483572,508,716.1333333333333,47.8339228506161,49.18276745732775,NaN,NaN,NaN,NaN,7.196365643991141,17.384461043991756,21615,-0.9251275764273279,0.5346186281967675,1.4597462046240954
2025-09-16T06:40:00-04:00,24623.25,24625,24621,24622,NaN,NaN,NaN,24644.932621147862,NaN,NaN,24619.845,24652.193707856637,24587.496292143365,24614.635568548583,24588.164376590325,24622.542419574893,24553.786333605756,345,699.5333333333333,46.76698420716199,49.02393365434674,NaN,NaN,NaN,NaN,6.968053812277488,16.79284590511983,21270,-1.0025448647866704,0.20656512364075752,1.209109988427428
2025-09-16T06:45:00-04:00,24621.5,24628,24621.5,24625.75,NaN,NaN,NaN,24644.932621147862,NaN,NaN,24620.59,24651.709248061707,24589.470751938294,24614.635568548583,24588.40238275818,24622.796583973115,24554.008181543246,612,683.9333333333333,51.16587154089166,49.56274809679535,NaN,NaN,NaN,NaN,6.93462139711481,15.628881058364218,21882,-0.7702204485191482,0.24633442777849268,1.0165548762976409
2025-09-16T06:50:00-04:00,24626.25,24632.25,24625,24632,NaN,NaN,NaN,24644.932621147862,NaN,NaN,24621.365,24651.64076752784,24591.089232472164,24616.712623102,24588.678838245905,24623.1230829827,24554.23459350911,639,668.7666666666667,57.47335756101172,50.26815121705566,NaN,NaN,NaN,NaN,6.957148440178038,15.389179801744927,22521,-0.19463511453770432,0.7732609831255104,0.9678960976632147
2025-09-16T06:55:00-04:00,24631.75,24631.75,24623.5,24626.25,NaN,NaN,NaN,24644.932621147862,NaN,NaN,24622.1,24650.9987889079,24593.2012110921,24616.712623102,24588.87994459074,24623.34596405163,24554.413925129847,502,643.7333333333333,50.95295057337415,50.5503010480126,NaN,NaN,NaN,NaN,7.067352123022464,14.821393807001071,22019,-0.19944197473503267,0.7185936292444239,0.9180356039794566
2025-09-16T07:00:00-04:00,24626.75,24627,24620.25,24623.5,NaN,NaN,NaN,24644.932621147862,NaN,NaN,24622.785,24650.117948986313,24595.452051013686,24616.712623102,24589.360832828654,24623.826798061516,24554.89486759579,1350,667.8666666666667,48.139989888770685,50.42291154155835,NaN,NaN,NaN,NaN,7.044684114235145,13.931736466674478,20669,-0.3758678745680486,0.44820076076939586,0.8240686353374445
2025-09-16T07:05:00-04:00,24622.75,24626,24617.5,24623.5,NaN,NaN,NaN,24643.87024581678,NaN,NaN,24623.49,24648.979794025767,24598.000205974236,24616.712623102,24589.636375588663,24624.08902671523,24555.183724462095,821,668.6333333333333,48.13998988877069,50.184757030976435,NaN,NaN,NaN,NaN,7.148635248932635,13.641114824108708,20669,-0.47425747201706725,0.23124679531611037,0.7055042673331776
2025-09-16T07:10:00-04:00,24624,24627.5,24618.75,24621.5,NaN,NaN,NaN,24643.87024581678,NaN,NaN,24624.01,24648.223417775527,24599.79658222447,24616.712623102,24589.93545835686,24624.37343862632,24555.4974780874,900,678.1333333333333,45.99808235112303,50.12799828762186,NaN,NaN,NaN,NaN,7.263018445437447,13.032575290116096,19769,-0.6451320805895494,-0.10091083340375917,0.5442212471857902
2025-09-16T07:15:00-04:00,24620.75,24620.75,24600.25,24608.75,NaN,NaN,NaN,24634.691690919833,NaN,NaN,24624.38,24647.033750240935,24601.726249759067,24616.712623102,24590.34294802123,24624.54476421172,24556.141131830736,2064,696.3333333333334,35.23505297314526,49.25000887843998,NaN,NaN,NaN,NaN,8.262088556477629,14.936808361036382,17705,-1.5370508600605048,-1.3770923278898408,0.15995853217066397
2025-09-16T07:20:00-04:00,24608.5,24614.75,24606,24611.5,NaN,NaN,NaN,24634.660250423476,NaN,NaN,24624.605,24646.506618663854,24602.703381336145,24616.712623102,24590.560585473293,24624.644054831635,24556.47711611495,1091,702.3666666666667,38.57359677076269,48.59201252767901,NaN,NaN,NaN,NaN,8.296939373872084,16.705024784033792,18796,-1.8414732616595766,-2.141883044903807,-0.30040978324423023
2025-09-16T07:25:00-04:00,24611,24615,24608.75,24610.25,NaN,NaN,NaN,24634.660250423476,NaN,NaN,24624.715,24646.269120257148,24603.160879742853,24616.712623102,24590.681710544635,24624.70244812866,24556.66097296061,600,691.2,37.62420300633452,47.66044514331508,NaN,NaN,NaN,NaN,8.150729418595507,18.290284414097687,18196,-2.0127795551942116,-2.8163842272369948,-0.8036046720427832
2025-09-16T07:30:00-04:00,24610,24614,24606.5,24606.75,NaN,NaN,NaN,24634.213936852797,NaN,NaN,24624.7,24646.303009050993,24603.09699094901,24616.712623102,24590.803047344125,24624.74412735055,24556.8619673377,683,689.6,35.0247944250152,46.21523995544142,NaN,NaN,NaN,NaN,8.104248745838685,19.98996959313262,17513,-2.230673303945398,-3.591946301974531,-1.3612729980291327
2025-09-16T07:35:00-04:00,24607.25,24608.75,24601.25,24602.25,NaN,NaN,NaN,24628.897394268577,NaN,NaN,24624.55,24646.6642487994,24602.4357512006,24616.712623102,24590.939834543595,24624.7322772502,24557.14739183699,1078,710.5666666666667,31.966807283460227,44.59281488090976,NaN,NaN,NaN,NaN,8.061088121135922,22.047636687918533,16435,-2.5250783248524185,-4.517620904094656,-1.9925425792422375
2025-09-16T07:40:00-04:00,24603.25,24605.5,24597.25,24600.75,NaN,NaN,NaN,24625.31114907455,NaN,NaN,24624.275,24647.20909033231,24601.34090966769,24615.0700984816,24591.05986846453,24624.671463816336,24557.448273112725,1243,735.9666666666667,30.995357971242385,43.277925806548595,NaN,NaN,NaN,NaN,8.074581826769071,24.27589257426445,15192,-2.6547977754761654,-5.311039798587444,-2.656242023111279
2025-09-16T07:45:00-04:00,24601,24606,24600.5,24601.25,NaN,NaN,NaN,24625.31114907455,NaN,NaN,24624.045,24647.657431063937,24600.43256893606,24610.28107878528,24591.141439616957,24624.64779102492,24557.635088208994,755,734.9333333333333,31.740005173203244,42.128360258161955,NaN,NaN,NaN,NaN,7.890683124856994,26.218522728148518,15947,-2.540809244407794,-5.832253578621021,-3.291444334213227
2025-09-16T07:50:00-04:00,24601,24605.5,24599.25,24605.25,NaN,NaN,NaN,24625.31114907455,NaN,NaN,24623.96,24647.81065198323,24600.10934801677,24609.024890422577,24591.21190116643,24624.634069172775,24557.789733160083,620,735.5333333333333,37.546373560022204,41.469745211937685,NaN,NaN,NaN,NaN,7.773491473081494,28.126960715220505,16567,-2.050891897393101,-5.855059205954603,-3.804167308561502
2025-09-16T07:55:00-04:00,24605.25,24609.75,24605,24605,NaN,NaN,NaN,24625.31114907455,NaN,NaN,24623.925,24647.881470940116,24599.968529059883,24609.024890422577,24591.337389786204,24624.65157976516,24558.02319980725,883,747.8666666666667,37.33263069315974,40.48165657995684,NaN,NaN,NaN,NaN,7.557527796432816,28.812451237474246,15684,-1.6175826021144877,-5.826145561204612,-4.208562959090124
2025-09-16T08:00:00-04:00,24605,24607,24591.25,24592.25,NaN,NaN,NaN,24623.19183375524,NaN,NaN,24623.745,24648.502118174434,24598.987881825564,24595.344912338063,24591.419132648407,24624.49134007855,24558.346925218262,1633,772.0666666666667,28.440345844436408,38.40787002877289,NaN,NaN,NaN,NaN,8.1427043824019,30.593858817305748,14051,-2.0365029260203578,-6.7541916166155715,-4.717688690595214
2025-09-16T08:05:00-04:00,24593,24596.25,24590.5,24595.75,NaN,NaN,NaN,24617.131977675457,NaN,NaN,24623.615,24648.88518203169,24598.344817968315,24592.239229567967,24591.45226108421,24624.32584725883,24558.57867490959,1340,786.9666666666667,33.14776880562877,37.136071331076785,NaN,NaN,NaN,NaN,7.97179692651605,32.29722199948862,15391,-1.9259451300394943,-7.125120103144582,-5.199174973105087
2025-09-16T08:10:00-04:00,24595.25,24601.25,24588.5,24598.75,NaN,NaN,NaN,24617.131977675457,NaN,NaN,24623.135,24649.34686945661,24596.923130543386,24592.239229567967,24591.524071875207,24624.151438133074,24558.89670561734,1719,818.9333333333333,36.974842472250124,36.33856080132532,NaN,NaN,NaN,NaN,8.313097146050618,32.813297759128744,17110,-1.5168355419424078,-7.095219400533097,-5.578383858590689
2025-09-16T08:15:00-04:00,24598.25,24600.5,24594.75,24598.5,NaN,NaN,NaN,24617.131977675457,NaN,NaN,24622.455,24649.413243638668,24595.496756361335,24592.239229567967,24591.587724146393,24624.058449502867,24559.11699878992,1135,841.2666666666667,36.78585405133916,35.527551098651635,NaN,NaN,NaN,NaN,8.130018778475574,33.29251096450886,15975,-1.1459959074662676,-7.0108787429235235,-5.864882835457256
2025-09-16T08:20:00-04:00,24599,24602,24593.25,24594.5,NaN,NaN,NaN,24617.131977675457,NaN,NaN,24621.665,24649.523680866216,24593.806319133786,24592.239229567967,24591.634568700545,24623.956280495633,24559.312856905457,1079,864.5333333333333,33.80831758360651,34.656853615257596,NaN,NaN,NaN,NaN,8.174303151441604,33.73749465521897,14896,-1.0552874477630176,-7.183992145161028,-6.12870469739801
2025-09-16T08:25:00-04:00,24595,24596.75,24586.5,24591,NaN,NaN,NaN,24616.111478576004,NaN,NaN,24620.895,24649.947554104285,24591.842445895716,24592.239229567967,24591.631208874885,24623.702780083193,24559.559637666578,1802,904.9,31.412409090974023,34.38380762367394,NaN,NaN,NaN,NaN,8.322567212052919,34.75574122927223,13094,-1.1106008232465658,-7.516955726456217,-6.406354903209651
2025-09-16T08:30:00-04:00,24589,24601,24576.25,24598,NaN,NaN,NaN,24615.37345682255,NaN,NaN,24620.18,24649.687971801814,24590.672028198187,24592.239229567967,24591.634653411867,24623.237827379973,24560.03147944376,3490,1001,40.4950916765856,34.52105725980415,NaN,NaN,NaN,NaN,9.495955268334853,36.39355242327317,16584,-0.5819214835538862,-7.133756757652009,-6.5518352740981225
2025-09-16T08:35:00-04:00,24598,24608.25,24595,24600.5,NaN,NaN,NaN,24615.37345682255,NaN,NaN,24619.465,24649.112935849495,24589.817064150506,24592.239229567967,24591.833990334148,24623.137858071914,24560.53012259638,2548,1071.4,43.37894518706913,34.932110272713764,NaN,NaN,NaN,NaN,9.76410132059665,36.51424300610678,19132,-0.0007742388058673555,-6.552803072605457,-6.552028833799589
2025-09-16T08:40:00-04:00,24600.25,24601,24590.25,24600.25,NaN,NaN,NaN,24615.37345682255,NaN,NaN,24618.895,24648.90068112782,24588.88931887218,24592.239229567967,24591.939297326317,24622.941416773883,24560.93717787875,2476,1136.7,43.153716712627705,35.512747578971805,NaN,NaN,NaN,NaN,9.834522654839747,36.98294018546076,16656,0.40729736263621685,-6.042907130504318,-6.450204493140535
2025-09-16T08:45:00-04:00,24600,24605.75,24597.75,24603.75,NaN,NaN,NaN,24615.37345682255,NaN,NaN,24618.33,24648.391177619196,24588.268822380807,24585.116383654375,24592.058833346466,24622.903671202028,24561.213995490903,1447,1169.7333333333333,47.28064669855291,36.60659325147842,NaN,NaN,NaN,NaN,9.703485322351193,36.60159124149838,18103,0.9238846424741629,-5.295348690047831,-6.219233332521994
2025-09-16T08:50:00-04:00,24604,24604,24595,24596.5,NaN,NaN,NaN,24615.37345682255,NaN,NaN,24617.54,24647.77778430731,24587.302215692693,24580.809470744833,24592.123388804754,24622.819974744485,24561.426802865022,1284,1187.1,40.69079231582769,37.29912427609166,NaN,NaN,NaN,NaN,9.65323637075468,36.47917396706508,16819,0.7932614823774307,-5.227656479550205,-6.020917961927636
2025-09-16T08:55:00-04:00,24596.25,24604.75,24588,24597,NaN,NaN,NaN,24615.37345682255,NaN,NaN,24616.57,24646.264619041962,24586.875380958038,24580.809470744833,24592.196898918315,24622.644754245903,24561.749043590728,2147,1243.0333333333333,41.29844953701416,37.98187030207815,NaN,NaN,NaN,NaN,10.160148058557919,36.90085199921745,18966,0.7566057301889026,-5.075160799191508,-5.831766529380411
2025-09-16T09:00:00-04:00,24597.25,24607.75,24593,24606,NaN,NaN,NaN,24615.37345682255,NaN,NaN,24615.815,24644.61305722969,24587.016942770308,24580.809470744833,24592.351238170097,24622.58973814767,24562.11273819252,2031,1294.1666666666667,51.02517433085332,38.94464178570894,NaN,NaN,NaN,NaN,10.48799462580378,36.77935918927378,20997,1.3214941688701582,-4.179898818292713,-5.5013929871628715
2025-09-16T09:05:00-04:00,24605.75,24609.75,24596.75,24598,NaN,NaN,NaN,24615.37345682255,NaN,NaN,24614.99,24643.416389145943,24586.56361085406,24580.809470744833,24592.515588811675,24622.50587990301,24562.52529772034,2420,1357.9,44.03973237935235,39.423720477579835,NaN,NaN,NaN,NaN,10.66742358110351,36.32900678917162,18577,1.145894229731435,-4.069025199998578,-5.2149194297300125
2025-09-16T09:10:00-04:00,24597.5,24601.25,24596,24596.75,NaN,NaN,NaN,24615.37345682255,NaN,NaN,24614.055,24641.73446711449,24586.37553288551,24578.250413388254,24592.56321196243,24622.42734604581,24562.699077879053,1180,1385.7333333333333,43.048061188690625,40.46712871645514,NaN,NaN,NaN,NaN,10.28046475388183,35.97994483028745,17397,0.943533266017865,-4.035502847207681,-4.979036113225546
2025-09-16T09:15:00-04:00,24597,24601.25,24594.75,24598.75,NaN,NaN,NaN,24615.37345682255,NaN,NaN,24613.17,24639.904517028535,24586.43548297146,24578.250413388254,24592.633474329894,24622.319191345076,24562.947757314712,1700,1422,45.175242038157485,41.32623394735005,NaN,NaN,NaN,NaN,10.010431557175986,35.77517304726577,19097,0.9402640108922125,-3.803706099610281,-4.743970110502493
2025-09-16T09:20:00-04:00,24599,24609.5,24597,24608.25,NaN,NaN,NaN,24615.37345682255,NaN,NaN,24612.59,24638.453828016343,24586.726171983657,24582.842211654784,24592.86720887012,24622.316982829172,24563.41743491107,2669,1489.6666666666667,53.96985169451955,42.540163177512156,NaN,NaN,NaN,NaN,10.18825787452056,34.18107016958025,21766,1.5384423881734888,-2.820917125285632,-4.359359513459121
2025-09-16T09:25:00-04:00,24608,24608,24586.5,24588.25,NaN,NaN,NaN,24615.37345682255,NaN,NaN,24611.74,24637.951821748968,24585.528178251036,24582.842211654784,24592.917502547713,24621.82791440037,24564.007090695053,5294,1649.4,39.57634528812743,42.73948398013988,NaN,NaN,NaN,NaN,11.014096597769091,33.7413204565231,16472,0.5961114864710755,-3.614220155370276,-4.210331641841352
2025-09-16T09:30:00-04:00,24588.25,24600.25,24559.5,24569.5,NaN,NaN,NaN,24614.630085647095,NaN,NaN,24610.51,24638.689240587802,24582.330759412194,24582.842211654784,24590.4270918403,24617.713674554278,24563.140509126326,25873,2466.8333333333335,31.180652483772974,42.55179361586606,NaN,NaN,NaN,NaN,13.138089697928441,34.96747580072025,-9401,-1.1839688225636325,-5.690292670045892,-4.50632384748226
2025-09-16T09:35:00-04:00,24570.25,24578.75,24555.25,24557.5,NaN,NaN,NaN,24603.379854481318,NaN,NaN,24609.01,24640.1739150299,24577.846084970097,24582.842211654784,24588.033321832056,24615.15282277528,24560.913820888833,16957,3004.7,27.203195966215375,42.25113553552615,NaN,NaN,NaN,NaN,13.87822614807641,36.28536809730312,-26358,-2.9623517437641373,-8.209263527187431,-5.246911783423294
2025-09-16T09:40:00-04:00,24557.5,24573.25,24552.25,24567.75,NaN,NaN,NaN,24600.339861095803,NaN,NaN,24607.87,24640.76927659587,24574.970723404127,24582.842211654784,24586.235338639613,24613.044000263682,24559.426677015545,15524,3492.1666666666665,34.84814082919415,41.847781903569626,NaN,NaN,NaN,NaN,14.386924280356666,37.6336296887191,-10834,-3.2197501849930115,-9.271599514664558,-6.051849329671547
2025-09-16T09:45:00-04:00,24568,24570.25,24544.5,24562,NaN,NaN,NaN,24596.76759468236,NaN,NaN,24606.755,24641.938872727063,24571.57112727294,24582.842211654784,24583.632584900293,24610.363841737402,24556.901328063184,21473,4139.133333333333,32.76913510065566,41.08993832596866,NaN,NaN,NaN,NaN,15.198572546045474,39.18756674139573,-32307,-3.5240759280464724,-10.456944239729637,-6.932868311683165
2025-09-16T09:50:00-04:00,24562.5,24566,24527.25,24538.25,NaN,NaN,NaN,24589.511113105887,NaN,NaN,24605.075,24644.85995318249,24565.29004681751,24582.842211654784,24579.78523299171,24607.781731470342,24551.78873451308,24119,4906.733333333334,25.896821254979017,39.85730293613661,NaN,NaN,NaN,NaN,16.880817364185084,41.16525454732013,-56426,-4.982547403255445,-13.16105256575247,-8.178505162497025
2025-09-16T09:55:00-04:00,24538,24546.75,24523.5,24538,NaN,NaN,NaN,24579.2321988738,NaN,NaN,24603.405,24647.108877409482,24559.701122590515,24582.842211654784,24577.46033571139,24606.41380914164,24548.506862281138,14019,5354.033333333334,25.835400622496138,38.325499644989705,NaN,NaN,NaN,NaN,17.335758981029006,43.09956743629424,-70445,-5.576888246008076,-15.14961547000712,-9.572727223999044
2025-09-16T10:00:00-04:00,24538,24548,24529.25,24537,NaN,NaN,NaN,24579.2321988738,NaN,NaN,24601.65,24648.703480208515,24554.59651979149,24582.842211654784,24575.32466837979,24604.860615045072,24545.78872171451,15112,5835,25.574116428922977,37.24573708163937,NaN,NaN,NaN,NaN,17.43677619666979,44.719848631094635,-85557,-5.6336048117119795,-16.61473323863902,-10.98112842692704
2025-09-16T10:05:00-04:00,24536.75,24555.5,24535,24544.5,NaN,NaN,NaN,24579.2321988738,NaN,NaN,24600.01,24649.154273321088,24550.86572667891,24582.842211654784,24573.91152810426,24603.45091434629,24544.372141862234,13619,6253.033333333334,31.19451296536512,36.524027326521576,NaN,NaN,NaN,NaN,17.655577896907662,45.20139147261486,-71938,-4.795085452604795,-16.974985242683033,-12.179899790078238
2025-09-16T10:10:00-04:00,24544.5,24550.75,24517.75,24538,NaN,NaN,NaN,24579.2321988738,NaN,NaN,24598.345,24650.071191618605,24546.618808381398,24575.79876932383,24571.483150839485,24601.562907847543,24541.403393831428,19723,6869.033333333334,29.14061684083687,34.96084464866326,NaN,NaN,NaN,NaN,18.751608047128546,46.25965377629217,-91661,-4.321924453573967,-17.582305357045698,-13.26038090347173
2025-09-16T10:15:00-04:00,24538.25,24560,24535.75,24546.5,NaN,NaN,NaN,24579.2321988738,NaN,NaN,24596.835,24650.09611245952,24543.57388754048,24554.11401545906,24570.322282644614,24600.117227671355,24540.527337617874,15811,7370.9,35.15342770626559,34.326108600585634,NaN,NaN,NaN,NaN,19.144350329476506,46.18638042802528,-75850,-3.1354513805723485,-17.179695129187166,-14.044243748614818
2025-09-16T10:20:00-04:00,24546.75,24561,24534.75,24556.75,NaN,NaN,NaN,24579.2321988738,NaN,NaN,24595.525,24649.439307002693,24541.61069299731,24530.09121236725,24569.537723672212,24598.977086716262,24540.098360628162,13749,7808.533333333334,41.59003141976764,34.221963617091134,NaN,NaN,NaN,NaN,19.651896734513894,46.11834089034888,-62101,-1.445257758184459,-15.850815946345392,-14.405558188160933
2025-09-16T10:25:00-04:00,24556.75,24557.75,24535,24539,NaN,NaN,NaN,24579.2321988738,NaN,NaN,24593.805,24649.31196262297,24538.29803737703,24523.8229698938,24568.61539223268,24597.911417018928,24539.319367446435,12754,8204.233333333334,35.0938273754643,33.50186256975591,NaN,NaN,NaN,NaN,19.873189824905758,46.05516131964937,-74855,-1.311545148844953,-16.044989624217123,-14.73344447537217
2025-09-16T10:30:00-04:00,24538.75,24549,24535,24545.25,NaN,NaN,NaN,24579.2321988738,NaN,NaN,24592.115,24648.28298108947,24535.947018910534,24517.83337591504,24568.036237061307,24597.246516769093,24538.82595735352,8223,8423.9,38.723210025752095,32.412816736272525,NaN,NaN,NaN,NaN,19.45367626598392,45.9964945754284,-66632,-0.625800912050348,-15.515695615435106,-14.889894703384758
2025-09-16T10:35:00-04:00,24545.25,24557,24527,24533.75,NaN,NaN,NaN,24579.2321988738,NaN,NaN,24590.205,24647.671920048764,24532.73807995124,24504.691700732033,24567.052703140747,24596.232025224166,24537.87338105733,12824,8806.7,34.86057390602463,32.075975923265176,NaN,NaN,NaN,NaN,20.206985104127927,45.94201831293749,-79456,-0.7613389977255309,-15.841568450541672,-15.080229452816141
2025-09-16T10:40:00-04:00,24533.75,24538.75,24530.5,24531.5,NaN,NaN,NaN,24579.2321988738,NaN,NaN,24588.345,24647.25356389123,24529.436436108772,24498.9201507748,24566.457467901495,24595.712525461422,24537.202410341568,6796,8975.933333333332,34.14297273625239,32.28757022701371,NaN,NaN,NaN,NaN,19.352914739547362,45.89143321205308,-86252,-0.8124871659373074,-16.095838410237775,-15.283351244300468
2025-09-16T10:45:00-04:00,24532,24544,24527.25,24538,NaN,NaN,NaN,24579.2321988738,NaN,NaN,24586.645,24646.35555936912,24526.93444063088,24498.9201507748,24565.803338734764,24595.06842065981,24536.53825680972,8506,9221.633333333333,38.10673432946243,33.06639439581706,NaN,NaN,NaN,NaN,19.166992258151122,45.06008673362082,-77746,-0.24780371628500752,-15.593105889656727,-15.345302173371719
2025-09-16T10:50:00-04:00,24538.25,24550.75,24536.25,24547,NaN,NaN,NaN,24579.2321988738,NaN,NaN,24585.145,24644.995571425377,24525.294428574623,24503.539743746413,24565.478458332807,24594.633945091027,24536.322971574587,6098,9388.933333333332,43.20399697520429,33.66324126338922,NaN,NaN,NaN,NaN,18.833635668283186,43.37932618940115,-71648,0.8333783756203257,-14.303579203846311,-15.136957579466637
2025-09-16T10:55:00-04:00,24547,24547.5,24535.25,24537.75,NaN,NaN,NaN,24579.2321988738,NaN,NaN,24583.385,24643.530673996287,24523.23932600371,24503.60679499713,24565.086880545812,24594.184136561722,24535.989624529902,6234,9536.666666666666,39.594761236277485,34.150785987362205,NaN,NaN,NaN,NaN,18.363375977691533,41.90210603779624,-77882,1.0150426558536303,-13.8681542596496,-14.88319691550323
2025-09-16T11:00:00-04:00,24538,24539.5,24511,24516.25,NaN,NaN,NaN,24577.07838038513,NaN,NaN,24581.07,24642.45045617303,24519.68954382697,24503.60679499713,24563.518949473117,24593.1899415936,24533.847957352635,15310,9930.666666666666,32.74705681413097,34.640088527301636,NaN,NaN,NaN,NaN,19.087420550713567,42.07670888980969,-93192,-0.16069641277157665,-15.084067431467702,-14.923371018696125
2025-09-16T11:05:00-04:00,24516.75,24530,24515.5,24528,NaN,NaN,NaN,24574.19981764035,NaN,NaN,24579.105,24640.863650405478,24517.34634959452,24503.60679499713,24562.67277276083,24592.565527127565,24532.780018394096,9272,10154.8,38.96011050066165,35.57756780431345,NaN,NaN,NaN,NaN,18.759747654234026,42.23884010953646,-83920,-0.003291836823510863,-14.927485814725515,-14.924193977902004
2025-09-16T11:10:00-04:00,24527.75,24536.25,24519.5,24529.75,NaN,NaN,NaN,24574.19981764035,NaN,NaN,24577.23,24639.17568911325,24515.28431088675,24503.60679499713,24561.97316911309,24591.951510024497,24531.994828201685,8936,10370.133333333333,39.85137049516236,36.5973716661877,NaN,NaN,NaN,NaN,18.616194250360167,41.592978517185436,-74984,0.34328080487307133,-14.495092971810664,-14.838373776683735
2025-09-16T11:15:00-04:00,24529.75,24534.5,24517.75,24530.5,NaN,NaN,NaN,24574.19981764035,NaN,NaN,24575.37,24637.2315583404,24513.508441659596,24503.60679499713,24561.408622558432,24591.459308425478,24531.357936691387,7285,10564.733333333334,40.254001666725586,37.244478001999155,NaN,NaN,NaN,NaN,18.48289466104873,41.101860456643145,-67699,0.7256523446138061,-13.931308345916477,-14.656960690530283
2025-09-16T11:20:00-04:00,24531,24542,24524.5,24525.75,NaN,NaN,NaN,24574.19981764035,NaN,NaN,24573.455,24635.413993694874,24511.49600630513,24503.60679499713,24560.70769781242,24590.764248044652,24530.65114758019,10383,10868.033333333333,38.496406383848914,37.91274868364287,NaN,NaN,NaN,NaN,18.41268789954525,39.73102956379115,-78082,0.7577663326823654,-13.709752774677327,-14.467519107359692
2025-09-16T11:25:00-04:00,24525.75,24532,24515,24517.5,NaN,NaN,NaN,24574.19981764035,NaN,NaN,24571.63,24634.68880112854,24508.57119887146,24503.60679499713,24559.949717992346,24590.199932603773,24529.699503380918,8953,11094.9,35.5898361045963,37.943920712095064,NaN,NaN,NaN,NaN,18.311781621006304,39.09841711599157,-87035,0.343573278541907,-14.038052509182307,-14.381625787724214
2025-09-16T11:30:00-04:00,24517.25,24524.25,24512,24514.75,NaN,NaN,NaN,24568.83791148161,NaN,NaN,24569.695,24633.67228424839,24505.71771575161,24503.60679499713,24559.314688825634,24589.784621216037,24528.844756435232,6950,11258.866666666667,34.65068412070556,37.44825304787634,NaN,NaN,NaN,NaN,17.878797219505852,38.69650652894099,-93985,0.021570379067233247,-14.354662813890172,-14.376233192957406
2025-09-16T11:35:00-04:00,24514.25,24521.75,24508.25,24519,NaN,NaN,NaN,24565.248688232445,NaN,NaN,24567.87,24632.31992164373,24503.420078356266,24503.60679499713,24558.692180714486,24589.373429847885,24528.010931581088,6908,11408.466666666667,37.400003059897294,37.612979882478704,NaN,NaN,NaN,NaN,17.56602598954115,38.55208169746764,-87077,0.2209048900607442,-14.100102080381475,-14.32100697044222
2025-09-16T11:40:00-04:00,24519.5,24523.5,24502.5,24512.25,NaN,NaN,NaN,24563.82829331279,NaN,NaN,24565.98,24631.295070237687,24500.66492976231,24503.60679499713,24557.715501874856,24588.783879659775,24526.647124089937,10360,11714.466666666667,34.889405114759825,37.33913667455069,NaN,NaN,NaN,NaN,17.81130984743107,38.75108085127534,-97437,0.03405635657426842,-14.278436524724384,-14.312492881298652
2025-09-16T11:45:00-04:00,24511.75,24524,24510.25,24512.25,NaN,NaN,NaN,24563.82829331279,NaN,NaN,24564.18,24630.35258042429,24498.00741957571,24497.25827458466,24557.078757140247,24588.338318654325,24525.81919562617,7463,11906.566666666668,34.889405114759825,37.3411960466032,NaN,NaN,NaN,NaN,17.521216286900277,38.86671963691323,-97437,0.045642290742467395,-14.25544001787057,-14.301082308613037
2025-09-16T11:50:00-04:00,24511.75,24525.75,24507,24522,NaN,NaN,NaN,24563.82829331279,NaN,NaN,24562.605,24628.969379755163,24496.240620244836,24497.25827458466,24556.603283671673,24587.962978224594,24525.243589118752,6134,12022.066666666668,41.47121385553705,37.86464184083782,NaN,NaN,NaN,NaN,17.608986552121685,39.16896329995412,-91303,0.8031139453128535,-13.29718987697197,-14.100303822284824
2025-09-16T11:55:00-04:00,24522.5,24525.25,24502.75,24509,NaN,NaN,NaN,24563.82829331279,NaN,NaN,24560.76,24627.84963854718,24493.670361452816,24497.25827458466,24556.066186132884,24587.609615715734,24524.522756550035,6152,12050.666666666666,36.214656737716936,37.72949344142743,NaN,NaN,NaN,NaN,17.958344655541563,39.69563703692863,-97455,0.5347020924444514,-13.431926206729258,-13.96662829917371
2025-09-16T12:00:00-04:00,24508.75,24515.75,24499,24500.25,NaN,NaN,NaN,24558.74624795849,NaN,NaN,24558.66,24626.615482485875,24490.704517514125,24497.25827458466,24555.336954232684,24587.235021619883,24523.438886845484,7346,11433.1,33.167358826877816,37.01259071654697,NaN,NaN,NaN,NaN,17.87203432300288,40.39236949545458,-104801,-0.09263669836594524,-14.082424172131141,-13.989787473765196
2025-09-16T12:05:00-04:00,24500.25,24516,24499.75,24514.5,NaN,NaN,NaN,24558.74624795849,NaN,NaN,24556.85,24624.592601075095,24489.1073989249,24497.25827458466,24554.83525555504,24586.907961123754,24522.762549986328,5767,11060.1,41.76201272771126,37.167394394506516,NaN,NaN,NaN,NaN,17.756174728502675,40.99781336983613,-99034,0.5559596013131269,-13.294837972123787,-13.850797573436914
2025-09-16T12:10:00-04:00,24514.5,24519.75,24508.75,24517.5,NaN,NaN,NaN,24558.74624795849,NaN,NaN,24555.355,24623.205872507577,24487.504127492422,24487.706619667726,24554.471104874407,24586.618075854523,24522.32413389429,4840,10703.966666666667,43.411906209184956,37.92916935129609,NaN,NaN,NaN,NaN,17.27359081932391,40.931379230727835,-94194,1.2510709446196362,-12.28695889266237,-13.538029837282005
2025-09-16T12:15:00-04:00,24518,24520,24514.5,24516,NaN,NaN,NaN,24558.74624795849,NaN,NaN,24553.76,24621.486875021947,24486.03312497805,24484.96723923709,24554.21280867584,24586.399616991574,24522.026000360103,3628,10109.133333333333,42.759620181060875,38.200562899896035,NaN,NaN,NaN,NaN,16.43262004651506,40.82740546250652,-97822,1.6488671999613835,-11.476945837330277,-13.12581303729166
2025-09-16T12:20:00-04:00,24516.25,24518.75,24510.25,24517,NaN,NaN,NaN,24558.74624795849,NaN,NaN,24552.125,24619.37388474841,24484.87611525159,24486.47379138967,24553.927652711485,24586.167344156693,24521.687961266278,3906,9435.366666666667,43.37051335035463,38.45193024669548,NaN,NaN,NaN,NaN,15.86600432890684,41.04134509251115,-93916,1.9952450387529073,-10.631756738850527,-12.627001777603434
2025-09-16T12:25:00-04:00,24516.25,24528.75,24514.25,24526,NaN,NaN,NaN,24558.74624795849,NaN,NaN,24550.675,24616.981504207717,24484.36849579228,24495.679033111737,24553.61145736342,24585.836453940698,24521.38646078614,5501,9151.433333333332,48.67915880434112,39.05372718509659,NaN,NaN,NaN,NaN,15.76843259112778,39.658303396234004,-88415,2.797230855019878,-9.130463208828587,-11.927694063848465
2025-09-16T12:30:00-04:00,24526.25,24527,24517,24521.25,NaN,NaN,NaN,24558.74624795849,NaN,NaN,24549.21,24614.81170424649,24483.608295753507,24495.679033111737,24553.355354738524,24585.576427762862,24521.134281714185,4360,8793.033333333333,46.21666318496484,39.60517409946202,NaN,NaN,NaN,NaN,15.35640169176151,38.37405039254808,-92775,2.9588731708326357,-8.22910260030767,-11.187975771140305
2025-09-16T12:35:00-04:00,24520.75,24527.25,24507.5,24524,NaN,NaN,NaN,24558.74624795849,NaN,NaN,24547.87,24612.735494680386,24483.00450531961,24495.679033111737,24552.913066306905,24585.15189938861,24520.6742332252,7198,8579,47.86110309326145,40.48169317008096,NaN,NaN,NaN,NaN,15.670230142349974,37.99289958860966,-85577,3.18257563693982,-7.209756224965531,-10.392331861905351
2025-09-16T12:40:00-04:00,24524.25,24527.25,24512.75,24520.5,NaN,NaN,NaN,24558.74624795849,NaN,NaN,24546.32,24610.013095387247,24482.626904612753,24495.679033111737,24552.65733620124,24584.89914987168,24520.4155225308,4326,8065.766666666666,45.936044747305615,41.28779035769525,NaN,NaN,NaN,NaN,15.586642275039262,37.63897384209541,-89903,3.027335217513567,-6.608162840013392,-9.63549805752696
2025-09-16T12:45:00-04:00,24520.25,24524.75,24514.75,24517.5,NaN,NaN,NaN,24558.74624795849,NaN,NaN,24544.66,24606.928752999993,24482.391247000007,24495.679033111737,24552.422211974437,24584.673272657226,24520.171151291648,3897,7668.633333333333,44.291595728677414,41.780046976893836,NaN,NaN,NaN,NaN,15.187596398250744,37.31032850604646,-93800,2.667727620669723,-6.300838531689806,-8.968566152359529
2025-09-16T12:50:00-04:00,24517.25,24524,24515.25,24522.5,NaN,NaN,NaN,24558.74624795849,NaN,NaN,24543.105,24603.601205668045,24482.608794331954,24495.679033111737,24552.259584459887,24584.508143115287,24520.011025804488,2864,7305.8,47.654973668697906,42.69187330217512,NaN,NaN,NaN,NaN,14.727768084089975,37.005157836858146,-90936,2.703338880389902,-5.589392551872152,-8.292731432262054
2025-09-16T12:55:00-04:00,24522.75,24532.75,24521.75,24524,NaN,NaN,NaN,24558.74624795849,NaN,NaN,24541.51,24599.687225785405,24483.332774214592,24502.485444456044,24551.986424802344,24584.175480296453,24519.797369308235,5932,7078.4,48.65646378519144,43.67523463577738,NaN,NaN,NaN,NaN,14.461498935226405,35.274429658502356,-85004,2.7552755821639225,-4.848636954557151,-7.603912536721073
2025-09-16T13:00:00-04:00,24524,24533.75,24523.5,24531,NaN,NaN,NaN,24558.74624795849,NaN,NaN,24540.2,24596.277178955603,24484.1228210444,24504.413355564833,24551.840163955985,24583.975820350646,24519.704507561324,3696,6927.5,53.16024536940097,44.510165458196234,NaN,NaN,NaN,NaN,14.160677582710234,33.51909933810738,-81308,3.159439467621647,-3.654613202194014,-6.814052669815661
2025-09-16T13:05:00-04:00,24531.25,24537.5,24527.75,24535.5,NaN,NaN,NaN,24558.74624795849,NaN,NaN,24538.97,24592.65674323689,24485.283256763112,24509.155684451867,24551.704620328506,24583.759098814397,24519.650141842616,4266,6642.233333333334,55.84188972714714,45.91211067172696,NaN,NaN,NaN,NaN,13.845629183945217,31.34220537387685,-77042,3.596440428134822,-2.318502134647133,-5.914942562781955
2025-09-16T13:10:00-04:00,24535.75,24539.5,24531.75,24537.25,NaN,NaN,NaN,24558.74624795849,NaN,NaN,24537.595,24587.74974952046,24487.440250479543,24512.949547561493,24551.612820067,24583.594643171262,24519.630996962736,3415,6529.533333333334,56.87588134941867,47.60557656619416,NaN,NaN,NaN,NaN,13.410227099377702,29.167388489110323,-73627,3.8474191279542955,-1.1056686528390856,-4.953087780793381
2025-09-16T13:15:00-04:00,24537.75,24541.5,24533.75,24536.5,NaN,NaN,NaN,24558.74624795849,NaN,NaN,24536.365,24583.456847488258,24489.273152511745,24516.384638049196,24551.512786097686,24583.405417397124,24519.62015479825,4054,6381.133333333333,56.26778242139678,48.64170297288598,NaN,NaN,NaN,NaN,13.005925163707866,27.427702595303582,-77681,3.800332754461521,-0.20267183771647979,-4.003004592178001
2025-09-16T13:20:00-04:00,24536.5,24546,24536,24541.5,NaN,NaN,NaN,24558.74624795849,NaN,NaN,24535.26,24579.113843620118,24491.40615637988,24520.907710439355,24551.43227614739,24583.213581678003,24519.650970616774,4565,6330.033333333334,59.385392409198495,49.78266627288695,NaN,NaN,NaN,NaN,12.79121622344302,26.406520295577447,-73116,3.92718315288107,0.905974348923337,-3.021208803957733
2025-09-16T13:25:00-04:00,24541.75,24542.25,24531,24532.5,NaN,NaN,NaN,24558.74624795849,NaN,NaN,24533.935,24573.863286962816,24494.006713037186,24520.907710439355,24551.313953468696,24583.008854445095,24519.619052492297,4321,6266.266666666666,52.175276715211744,50.45521316818344,NaN,NaN,NaN,NaN,12.681129350339946,24.69320092886901,-77437,3.254005904480254,1.0462985766425845,-2.2077073278376695
2025-09-16T13:30:00-04:00,24533,24536.75,24528,24534.25,NaN,NaN,NaN,24558.74624795849,NaN,NaN,24532.455,24566.27358808246,24498.636411917545,24520.907710439355,24551.178084699703,24582.794280481627,24519.56188891778,4417,5903.166666666667,53.36102318321259,51.16882101338758,NaN,NaN,NaN,NaN,12.400334396744237,23.17829205089657,-73020,2.7932992382642983,1.2839167199927033,-1.509382518271595
2025-09-16T13:35:00-04:00,24533.5,24535.5,24524.75,24532.25,NaN,NaN,NaN,24558.74624795849,NaN,NaN,24531.335,24561.161768183832,24501.508231816166,24520.907710439355,24551.033110869117,24582.582902964936,24519.4833187733,4273,5736.533333333334,51.78091887541187,51.39037530417835,NaN,NaN,NaN,NaN,12.282453368405362,22.20604751857273,-77293,2.244233288142597,1.2959090919066512,-0.9483241962359458
2025-09-16T13:40:00-04:00,24532.5,24532.75,24527.25,24528.75,NaN,NaN,NaN,24558.74624795849,NaN,NaN,24530.52,24558.28667787083,24502.75332212917,24520.907710439355,24550.937707459638,24582.44960062504,24519.425814294234,2679,5527.966666666666,49.04395045962605,51.59232439522558,NaN,NaN,NaN,NaN,11.797992413519264,21.303249024272024,-79972,1.567726837711781,1.0113343509037804,-0.5563924868080006
2025-09-16T13:45:00-04:00,24528.75,24535.75,24527.25,24534,NaN,NaN,NaN,24558.74624795849,NaN,NaN,24530.05,24556.74906365685,24503.350936343148,24520.907710439355,24550.839695262664,24582.297316069005,24519.382074456324,3190,5391.466666666666,53.05251012477361,51.963139183190734,NaN,NaN,NaN,NaN,11.562421526839316,19.97030473230617,-76782,1.401638128451742,1.195655173756677,-0.20598295469506506
2025-09-16T13:50:00-04:00,24533.5,24534.5,24521.75,24533.5,NaN,NaN,NaN,24558.74624795849,NaN,NaN,24529.365,24553.823374844396,24504.906625155607,24520.907710439355,24550.64182740414,24582.015770918482,24519.267883889795,5781,5238.066666666667,52.627886731413675,52.441127896341314,NaN,NaN,NaN,NaN,11.647248560636509,19.5040623368005,-82563,1.1940298317399582,1.2865543349798827,0.0925245032399245
2025-09-16T13:55:00-04:00,24533.5,24538.5,24532,24534.25,NaN,NaN,NaN,24558.74624795849,NaN,NaN,24528.81,24551.474633237798,24506.145366762205,24520.907710439355,24550.552432231823,24581.859402029506,24519.24546243414,3495,5056.133333333333,53.232555532996486,53.0797678823641,NaN,NaN,NaN,NaN,11.279587949162472,18.423334155765083,-79068,1.0483316762092763,1.4029390985015198,0.35460742229224357
2025-09-16T14:00:00-04:00,24534.25,24535,24523,24527.5,NaN,NaN,NaN,24558.74624795849,NaN,NaN,24528.595,24551.10075259103,24506.08924740897,24520.907710439355,24550.38961099944,24581.637872028936,24519.14134996994,4573,4976.9,47.371940793815284,53.059551248443924,NaN,NaN,NaN,NaN,11.331045952793724,18.528212689593285,-83641,0.4680534972649212,0.9396742938733951,0.4716207966084739
2025-09-16T14:05:00-04:00,24527.5,24539.25,24524,24531,NaN,NaN,NaN,24558.74624795849,NaN,NaN,24528.455,24550.811585154635,24506.098414845368,24520.907710439355,24550.227038172958,24581.390237074353,24519.063839271563,5353,4925.066666666667,50.41998635231686,53.185517146095734,NaN,NaN,NaN,NaN,11.610971241879886,17.972759902492612,-78288,0.298872385392317,0.8452112783488701,0.5463388929565531
2025-09-16T14:10:00-04:00,24531,24534.75,24523.25,24525.75,NaN,NaN,NaN,24558.74624795849,NaN,NaN,24528.23,24550.464171905984,24505.995828094015,24516.551168351485,24550.11468327281,24581.239405622127,24518.989960923496,3162,4685.133333333333,46.10637493993921,52.68166925827704,NaN,NaN,NaN,NaN,11.603044724602752,17.548021248658646,-81450,-0.1628580446966208,0.3427663370857772,0.505624381782398
2025-09-16T14:15:00-04:00,24525.25,24531.25,24524,24529.25,NaN,NaN,NaN,24558.74624795849,NaN,NaN,24527.925,24549.671091601107,24506.17890839889,24515.65000547633,24550.025386565576,24581.118132459702,24518.93264067145,2565,4521.866666666667,49.225125078680975,52.20904321195803,NaN,NaN,NaN,NaN,11.292112958559699,17.15362107009854,-78885,-0.2249723028688445,0.22440900319634238,0.4493813060651869
2025-09-16T14:20:00-04:00,24528.75,24533.75,24525.5,24531.5,NaN,NaN,NaN,24558.74624795849,NaN,NaN,24527.795,24549.375706663606,24506.21429333639,24515.65000547633,24549.945628711834,24581.00091180752,24518.890345616146,2553,4402.5,51.18095732241678,51.80226292431504,NaN,NaN,NaN,NaN,11.074819175805434,16.36873526028073,-76332,-0.11261807667021528,0.30860871022741776,0.42122678689763304
2025-09-16T14:25:00-04:00,24531.25,24535,24528.75,24530.5,NaN,NaN,NaN,24558.74624795849,NaN,NaN,24527.475,24548.401358985295,24506.548641014702,24515.65000547633,24549.870907749217,24580.885747876375,24518.85606762206,2563,4282.866666666667,50.25442785219387,51.3727375979434,NaN,NaN,NaN,NaN,10.730189234676475,15.432130171146424,-78895,-0.1039509067083933,0.29128815351214143,0.39523906022053473
2025-09-16T14:30:00-04:00,24530,24536.25,24526.5,24531.25,NaN,NaN,NaN,24558.74624795849,NaN,NaN,24526.965,24546.18608477545,24507.74391522455,24515.65000547633,24549.78780526391,24580.757818303282,24518.817792224538,2862,4133.4,50.97130886657018,50.77173163061281,NaN,NaN,NaN,NaN,10.66017571791387,14.91094834314643,-76033,-0.0488092853918618,0.3342274534807075,0.3830367388725693
2025-09-16T14:35:00-04:00,24531.25,24539.75,24528.5,24532.25,NaN,NaN,NaN,24558.74624795849,NaN,NaN,24526.83,24545.80430894018,24507.855691059824,24515.653307862776,24549.69150680452,24580.595069501534,24518.787944107506,3797,4067.733333333333,51.96527452901597,50.756731474455975,NaN,NaN,NaN,NaN,10.702306023777165,13.866525101673824,-72236,0.048636668955594875,0.44383257506706286,0.395195906111468
2025-09-16T14:40:00-04:00,24532.25,24538.75,24532,24536,NaN,NaN,NaN,24558.74624795849,NaN,NaN,24526.645,24545.06973609197,24508.22026390803,24516.09764629022,24549.637933789174,24580.494968568124,24518.780899010224,2448,3988,55.600374352425405,50.91668512939975,NaN,NaN,NaN,NaN,10.419998450650224,12.896703520306405,-69788,0.34287760442018667,0.8237929116367013,0.48091530721651465
2025-09-16T14:45:00-04:00,24536,24544.75,24536,24540.75,NaN,NaN,NaN,24558.74624795849,NaN,NaN,24526.785,24545.527201047815,24508.042798952185,24522.253117032178,24549.59129750376,24580.37637767076,24518.80621733676,3307,3977.3,59.75489670749927,51.48625497454884,NaN,NaN,NaN,NaN,10.300712847032353,12.95138184607156,-66481,0.8080774018511692,1.491012059530476,0.682934657679307
2025-09-16T14:50:00-04:00,24540.5,24547.5,24540.25,24543.5,NaN,NaN,NaN,24558.74624795849,NaN,NaN,24527.025,24546.302253427653,24507.74774657235,24525.87749362574,24549.549873353324,24580.22951734612,24518.870229360527,4628,4001.366666666667,61.97336610806197,52.409784663722846,NaN,NaN,NaN,NaN,10.082804786530042,13.385060452399838,-61853,1.2265672603581188,2.2161437331269553,0.9895764727688366
2025-09-16T14:55:00-04:00,24543.75,24549,24541,24546.75,NaN,NaN,NaN,24558.74624795849,NaN,NaN,24527.2,24547.02372316239,24507.37627683761,24527.70199490059,24549.53048245246,24580.1362944561,24518.92467044882,3206,3924.866666666667,64.46632905329695,53.22505744433165,NaN,NaN,NaN,NaN,9.93403301606361,13.991296941621279,-58647,1.62295554117962,3.018270899243362,1.3953153580637419
2025-09-16T15:00:00-04:00,24546.75,24555,24545.5,24550.25,NaN,NaN,NaN,24558.74624795849,NaN,NaN,24527.265,24547.367340665387,24507.16265933461,24533.211595920475,24549.53722642824,24579.999346835168,24519.075106021315,6205,3986.366666666667,66.97712912807458,54.250003329807434,NaN,NaN,NaN,NaN,9.903030657773353,15.288796878612063,-52442,1.996967024590764,3.891524138802197,1.8945571142114328
2025-09-16T15:05:00-04:00,24550.5,24558.25,24549.5,24551,NaN,NaN,NaN,24558.74624795849,NaN,NaN,24527.53,24548.508474688617,24506.55152531138,24536.44427673638,24549.568913105286,24579.889635378262,24519.24819083231,6266,3955.3,67.50696365433271,55.26960390990288,NaN,NaN,NaN,NaN,9.820671325075256,16.839178626638684,-46176,2.157296797617736,4.591178111233603,2.433881313615867
2025-09-16T15:10:00-04:00,24551,24553.25,24545.5,24550.5,NaN,NaN,NaN,24558.74624795849,NaN,NaN,24528.215,24549.900250740055,24506.529749259946,24536.44427673638,24549.57011818532,24579.789787894046,24519.35044847659,4477,3960.3333333333335,66.73819912520858,56.65290807643097,NaN,NaN,NaN,NaN,9.672766230427024,17.433820742530653,-50653,2.0906012670927367,5.047132897481788,2.956531630389051
2025-09-16T15:15:00-04:00,24550.5,24552.5,24546.75,24549.5,NaN,NaN,NaN,24558.74624795849,NaN,NaN,24528.645,24551.133906149294,24506.156093850706,24536.44427673638,24549.570162391454,24579.739245698056,24519.40107908485,2258,3905.7,65.14044422902168,57.70436935333846,NaN,NaN,NaN,NaN,9.392568642539379,17.985988421573197,-52911,1.848433229353179,5.267073167080525,3.418639937727346
2025-09-16T15:20:00-04:00,24549.5,24553.5,24544.5,24546.25,NaN,NaN,NaN,24558.74624795849,NaN,NaN,24528.975,24551.997000353706,24505.95299964629,24536.44427673638,24549.56205043921,24579.64892116947,24519.47517970895,3703,3933.6666666666665,60.10418120829748,58.70421265822119,NaN,NaN,NaN,NaN,9.364528025215138,18.021928760185585,-56614,1.361174575438317,5.120108157025243,3.7589335815869256
2025-09-16T15:25:00-04:00,24546.25,24547,24533.5,24536.75,NaN,NaN,NaN,24558.74624795849,NaN,NaN,24529.1,24552.221418649846,24505.97858135015,24536.44427673638,24549.456971799107,24579.410810640453,24519.50313295776,6875,3965.1,48.3393996607813,58.64094655694264,NaN,NaN,NaN,NaN,9.659918880556916,17.269417211832092,-63489,0.3438779842395814,4.188781061886402,3.844903077646821
2025-09-16T15:30:00-04:00,24537,24539,24530.25,24535.75,NaN,NaN,NaN,24558.74624795849,NaN,NaN,24529.3,24552.474986513993,24506.125013486006,24536.44427673638,24549.333621116435,24579.189024313262,24519.478217919608,5900,4038.5666666666666,47.290074093390736,58.36302632629792,NaN,NaN,NaN,NaN,9.59492467480285,17.001539826753646,-69389,-0.4106413742268402,3.3316013598632708,3.742242734090111
2025-09-16T15:35:00-04:00,24535.75,24540.25,24528.75,24534.75,NaN,NaN,NaN,24558.74624795849,NaN,NaN,24529.645,24552.619788354725,24506.670211645276,24536.44427673638,24549.21697405327,24578.982780043585,24519.451168062955,5512,4080.1,46.20981503711611,58.074125410935224,NaN,NaN,NaN,NaN,9.731001483745505,16.94671374142363,-74901,-0.959967967745853,2.542282774407795,3.502250742153648
2025-09-16T15:40:00-04:00,24534.5,24543.5,24532,24536.25,NaN,NaN,NaN,24558.74624795849,NaN,NaN,24530.075,24552.721026135572,24507.42897386443,24536.44427673638,24549.119633538772,24578.78361451646,24519.455652561086,5716,4156.8,48.12406990512147,57.87075119940317,NaN,NaN,NaN,NaN,9.857358520620826,16.329165768855113,-69185,-1.1901549829701699,2.0145570134409354,3.2047119964111053
2025-09-16T15:45:00-04:00,24536.25,24547.5,24536,24544.5,NaN,NaN,NaN,24558.74624795849,NaN,NaN,24530.585,24553.358583387166,24507.811416612833,24536.44427673638,24549.074840583562,24578.640541423163,24519.50913974396,4912,4185.4,57.155202007435165,58.241460305004544,NaN,NaN,NaN,NaN,9.974690054862196,15.21160119567025,-64273,-0.7747628748527853,2.236258402845124,3.011021277697909
2025-09-16T15:50:00-04:00,24545,24561.25,24536,24540.75,24521.292407739147,24521.292407739147,24521.292407739147,NaN,NaN,NaN,24531.155,24553.486791239728,24508.82320876027,24536.44427673638,24549.017478753085,24578.30905865787,24519.7258988483,13452,4481.633333333333,52.6669572759859,58.0319305138303,NaN,NaN,NaN,NaN,11.065783622372038,15.840591435625,-77725,-0.7405559443852683,2.0853263472163235,2.8258822916015918
2025-09-16T15:55:00-04:00,24540.75,24548.75,24516.75,24524,NaN,NaN,NaN,24569.41718309772,24569.41718309772,24569.41718309772,24531.39,24553.161348155623,24509.618651844376,24533.055469689025,24548.529238679348,24577.603085500392,24519.455391858304,18831,4965.3,38.227161667090066,56.49423515380107,NaN,NaN,NaN,NaN,12.561084792202607,15.310694870870476,-96556,-1.7750034351354693,0.6071279976822552,2.3821314328177245
2025-09-16T16:00:00-04:00,24524.25,24539,24521.25,24536.25,NaN,NaN,NaN,24567.54594750237,NaN,NaN,24531.675,24553.319918573587,24510.030081426412,24533.055469689025,24548.369773250644,24577.346219528135,24519.393326973153,7282,5060.8,49.19737204915908,55.58166414959372,NaN,NaN,NaN,NaN,12.931721592759564,14.818648060741271,-89274,-1.5702775244323068,0.4192845272773411,1.989562051709648
2025-09-16T16:05:00-04:00,24536.25,24537.5,24527.25,24533.75,NaN,NaN,NaN,24567.54594750237,NaN,NaN,24532.17,24552.827550684247,24511.51244931575,24533.055469689025,24548.31976140514,24577.262915311407,24519.37660749887,2413,4998.8,47.349297267443916,54.35901902203279,NaN,NaN,NaN,NaN,12.740170050419595,14.361747451335582,-91687,-1.5373253642091247,0.0679053464482422,1.6052307106573669
2025-09-16T16:10:00-04:00,24533.5,24535.5,24531.75,24534.75,NaN,NaN,NaN,24567.54594750237,NaN,NaN,24532.86,24551.403235955284,24514.316764044717,24528.03774904616,24548.293010072604,24577.215727129522,24519.370293015687,1403,4956.266666666666,48.187704743670984,53.01691728028967,NaN,NaN,NaN,NaN,12.098015046818194,13.937482599744586,-90284,-1.3868993708273822,-0.12839350287686102,1.2585058679505212
2025-09-16T16:15:00-04:00,24535,24541,24534.75,24539.25,NaN,NaN,NaN,24567.54594750237,NaN,NaN,24533.355,24551.220354736695,24515.489645263304,24528.03774904616,24548.276658836814,24577.178437160554,24519.374880513074,1235,4891.1,51.899609066827196,51.902106238325004,NaN,NaN,NaN,NaN,11.68029968633118,13.047753866519013,-89049,-0.9442057862411641,0.0782486351490661,1.0224544213902302
2025-09-16T16:20:00-04:00,24539,24539.25,24535.25,24537.25,NaN,NaN,NaN,24567.54594750237,NaN,NaN,24533.75,24551.06040150012,24516.43959849988,24528.03774904616,24548.266773383948,24577.15747836044,24519.376068407455,675,4720.9,50.17897739203355,50.71930468595536,NaN,NaN,NaN,NaN,11.131706851593238,12.221577185666696,-89724,-0.7541940457082384,0.07971186425493215,0.8339059099631706
2025-09-16T16:25:00-04:00,24538,24539.5,24536.25,24538.75,NaN,NaN,NaN,24567.54594750237,NaN,NaN,24534.205,24550.80671376597,24517.603286234033,24528.03774904616,24548.261490831235,24577.145562742022,24519.37741892045,394,4617.533333333334,51.4782673279339,49.74343490730623,NaN,NaN,NaN,NaN,10.56872779076515,11.488135213725023,-89330,-0.507438335034845,0.19960799116961425,0.7070463262044593
2025-09-16T16:30:00-04:00,24539,24542,24538.25,24539.5,NaN,NaN,NaN,24567.54594750237,NaN,NaN,24534.655,24550.572565778064,24518.737434221934,24528.03774904616,24548.248473040472,24577.111885756545,24519.3850603244,1177,4504.333333333333,52.150203803510834,49.17529366410718,NaN,NaN,NaN,NaN,10.081675805710498,11.150766114894063,-88153,-0.28475863854262984,0.35109802802617196,0.6358566665688018
2025-09-16T16:35:00-04:00,24539,24542.25,24538,24542.25,NaN,NaN,NaN,24567.54594750237,NaN,NaN,24534.98,24550.840907915568,24519.11909208443,24528.03774904616,24548.239520770487,24577.086654101076,24519.392387439897,912,4356.3,54.63108746924353,49.624699936140196,NaN,NaN,NaN,NaN,9.665127533874033,10.837494808836743,-87241,0.039441791215151456,0.6851589055877412,0.6457171143725897
2025-09-16T16:40:00-04:00,24542.25,24542.5,24540,24542,NaN,NaN,NaN,24567.54594750237,NaN,NaN,24535.395,24550.87856871137,24519.91143128863,24526.905889740166,24548.233201210754,24577.067544441546,24519.398857979962,709,4274.533333333334,54.35518266352162,50.1293505482924,NaN,NaN,NaN,NaN,9.15333271002589,10.584288681386665,-87950,0.21873544028012282,0.9191364147227432,0.7004009744426204
2025-09-16T16:45:00-04:00,24542.25,24544,24538.5,24539.75,NaN,NaN,NaN,24567.54594750237,NaN,NaN,24535.71,24550.891356985154,24520.528643014844,24528.774711792135,24548.22379121383,24577.041219660463,24519.406362767197,952,4220.766666666666,51.818693165381355,50.52998470031135,NaN,NaN,NaN,NaN,8.892380373595469,10.349168705897306,-88902,0.16967158721723385,0.9124904584641627,0.7428188712469288
2025-09-16T16:50:00-04:00,24539.75,24542.25,24538.25,24539,NaN,NaN,NaN,24567.54594750237,NaN,NaN,24536.08,24550.649982824612,24521.51001717539,24528.774711792135,24548.209132116644,24577.003507994435,24519.414756238853,1325,4179.833333333333,50.964950193055195,50.73290472087805,NaN,NaN,NaN,NaN,8.542924632624365,10.080870687535988,-90227,0.07538946394965629,0.8370557011839992,0.7616662372343429
2025-09-16T16:55:00-04:00,24539.25,24540.75,24530.25,24531,NaN,NaN,NaN,24564.281966873645,NaN,NaN,24536.35,24550.004303370515,24522.695696629482,24528.774711792135,24548.183790326977,24576.958723998727,24519.408856655227,1355,4139.566666666667,42.854412637524135,49.7114197658844,NaN,NaN,NaN,NaN,8.682715730294053,10.286859000807933,-91582,-0.5051420608764989,0.13023866113871918,0.6353807220152181
2025-09-16T18:00:00-04:00,24531,24536,24525.25,24530.75,NaN,NaN,NaN,24559.564604743024,NaN,NaN,24536.515,24549.68671591304,24523.343284086957,24528.774711792135,24530.666666666668,24530.666666666668,24530.666666666668,2286,4120.366666666667,42.626121757791395,48.99421722887051,NaN,NaN,NaN,NaN,8.830378892415906,11.161493947442459,-93868,-0.8642746530476453,-0.4449625942943385,0.4193120587533068
2025-09-16T18:05:00-04:00,24531.25,24536.75,24531.25,24534.75,NaN,NaN,NaN,24559.564604743024,NaN,NaN,24536.73,24549.419696605684,24524.040303394315,24528.774711792135,24531.757909948283,24533.406993469944,24530.10882642662,1001,4027.1666666666665,47.449736142872666,49.652972548569274,NaN,NaN,NaN,NaN,8.628208971529055,11.820956428974474,-92867,-0.7926174315376222,-0.571459730668721,0.2211577008689012
2025-09-16T18:10:00-04:00,24535,24540.25,24534.25,24539,NaN,NaN,NaN,24559.564604743024,NaN,NaN,24536.89,24549.488079211802,24524.291920788197,24528.774711792135,24532.82834168755,24535.584758325098,24530.07192505,703,3969,52.06139708310568,49.857545765279745,NaN,NaN,NaN,NaN,8.44047975927698,11.74007879890123,-92164,-0.4369449391448603,-0.32502347306217416,0.11192146608268613
2025-09-16T18:15:00-04:00,24539.5,24540.5,24535,24537.25,NaN,NaN,NaN,24559.564604743024,NaN,NaN,24536.925,24549.517160278396,24524.332839721603,24528.774711792135,24533.54750762249,24536.60546955829,24530.48954568669,711,3882.4666666666667,50.111318553376414,50.054832999989216,NaN,NaN,NaN,NaN,8.230445490757196,11.616253211391188,-92875,-0.30381221403051356,-0.26784380145545583,0.03596841257505773
2025-09-16T18:20:00-04:00,24537.25,24545.5,24536.75,24544.5,NaN,NaN,NaN,24559.564604743024,NaN,NaN,24537.07,24549.839510581303,24524.300489418696,24528.774711792135,24534.997665898478,24539.276674901274,24530.718656895682,940,3759.5333333333333,57.25477683090759,50.7024810062204,NaN,NaN,NaN,NaN,8.267556527131683,10.99254163385661,-91935,0.25790928267603125,0.3583550159200968,0.10044573324406554
2025-09-16T18:25:00-04:00,24544.75,24546.25,24541.75,24545.5,NaN,NaN,NaN,24559.564604743024,NaN,NaN,24537.25,24550.23422119931,24524.26577880069,24529.863854110743,24535.806735863334,24540.683660206152,24530.929811520517,525,3670.1666666666665,58.14500324499712,51.148580590375396,NaN,NaN,NaN,NaN,7.998445346622277,10.542251858988434,-91410,0.6593673229229633,0.9246548868977698,0.2652875639748064
2025-09-16T18:30:00-04:00,24545.75,24549.5,24545.25,24548.25,NaN,NaN,NaN,24559.564604743024,NaN,NaN,24537.385,24550.679814778356,24524.09018522164,24534.266083288596,24537.64908675799,24543.857594026707,24531.44057948927,1134,3501.133333333333,60.576561955424964,51.89126520204621,NaN,NaN,NaN,NaN,7.730699250434972,10.667262912670939,-90276,1.049508319810652,1.5771729637381213,0.5276646439274694
2025-09-16T18:35:00-04:00,24547.75,24551.5,24547,24549.25,NaN,NaN,NaN,24559.564604743024,NaN,NaN,24537.72,24551.345578876764,24524.094421123238,24537.062866630877,24538.664166666666,24545.44047040862,24531.887862924712,700,3315.6,61.45351081121745,52.60378259370932,NaN,NaN,NaN,NaN,7.499935018261046,11.097943562191826,-89576,1.2980312239985976,2.1502036739257164,0.8521724499271188
2025-09-16T18:40:00-04:00,24549,24550.5,24544.25,24547,NaN,NaN,NaN,24559.564604743024,NaN,NaN,24537.975,24551.80693768887,24524.143062311126,24537.062866630877,24539.50891280664,24546.43276434706,24532.585061266218,873,3195.4666666666667,58.31058334831778,53.043809704052684,NaN,NaN,NaN,NaN,7.4106539455281135,10.920939679779423,-90449,1.2343967868500998,2.3951684334897436,1.1607716466396438
2025-09-16T18:45:00-04:00,24547,24549.5,24545.25,24548.75,NaN,NaN,NaN,24559.564604743024,NaN,NaN,24538.305,24552.3603512883,24524.249648711702,24537.062866630877,24539.838682036294,24546.815572003066,24532.86179206952,366,3132.4,60.02310825664151,53.42895404600967,NaN,NaN,NaN,NaN,7.184892949418962,10.756578931825048,-90083,1.2309012132893384,2.699398163251317,1.4684969499619784
2025-09-16T18:50:00-04:00,24548,24550,24546.75,24549.25,NaN,NaN,NaN,24559.564604743024,NaN,NaN,24538.715,24552.82740943224,24524.60259056776,24537.28318771501,24540.178608596103,24547.227578365553,24533.129638826653,370,3021.3,60.52208683937298,53.869447201427626,NaN,NaN,NaN,NaN,6.903829167317608,10.697849181855277,-89713,1.182705205460089,2.94687845678709,1.7641732513270008
2025-09-16T18:55:00-04:00,24549.25,24550,24545.75,24546,NaN,NaN,NaN,24559.564604743024,NaN,NaN,24538.955,24553.146437531956,24524.763562468048,24537.701550172005,24540.392698556865,24547.439096610524,24533.346300503206,300,2802.133333333333,55.659058743445414,54.1437590284322,NaN,NaN,NaN,NaN,6.714269941080636,10.407337820808864,-90013,0.8670064820752095,2.8479313539210125,1.980924871845803
2025-09-16T19:00:00-04:00,24546,24550.25,24545,24547.25,NaN,NaN,NaN,24559.564604743024,NaN,NaN,24539.23,24553.52050034119,24524.93949965881,24537.786240137604,24540.647864370498,24547.691837945444,24533.60389079555,369,2617.766666666667,57.087263355258905,54.58106711144676,NaN,NaN,NaN,NaN,6.609679231003448,9.95708931019058,-89644,0.6853950917508751,2.837668736534397,2.152273644783522
2025-09-16T19:05:00-04:00,24547.5,24548.75,24545.5,24547.75,NaN,NaN,NaN,24559.564604743024,NaN,NaN,24539.5,24553.9135353054,24525.0864646946,24537.786240137604,24540.773595863164,24547.809872396952,24533.737319329375,197,2440.6,57.67452553543486,55.63964660415466,NaN,NaN,NaN,NaN,6.369702143074631,9.539001407473604,-89447,0.5479220113430969,2.837176158962393,2.289254147619296
2025-09-16T19:10:00-04:00,24547.5,24547.75,24544.75,24545,NaN,NaN,NaN,24559.564604743024,NaN,NaN,24539.85,24553.92693149533,24525.773068504666,24537.786240137604,24540.88184323617,24547.880841755406,24533.882844716933,229,2257.7,53.35009991522285,56.4056450439712,NaN,NaN,NaN,NaN,6.129009132855015,8.951880222128786,-89676,0.23666430202294464,2.585084525147977,2.348420223125032
2025-09-16T19:15:00-04:00,24545,24547,24542,24546.25,NaN,NaN,NaN,24559.564604743024,NaN,NaN,24540.155,24554.112037655872,24526.197962344126,24537.786240137604,24541.086110864217,24547.9723934483,24534.199828280132,547,2112.2,55.001691247690744,56.94507040860106,NaN,NaN,NaN,NaN,6.048365623365371,8.90958265078911,-89129,0.08752964697903298,2.457832281848823,2.37030263486979
2025-09-16T19:20:00-04:00,24546.25,24546.5,24541.75,24541.75,NaN,NaN,NaN,24559.564604743024,NaN,NaN,24540.475,24553.81638299822,24527.13361700178,24537.786240137604,24541.174195844007,24547.938240943186,24534.41015074483,459,1679.1,48.363405601606914,56.68092815992258,NaN,NaN,NaN,NaN,5.955625221696416,8.930958546688915,-89588,-0.31932259816634545,1.9711493871618586,2.290471985328204
2025-09-16T19:25:00-04:00,24541.5,24542,24536.5,24538.25,NaN,NaN,NaN,24559.564604743024,NaN,NaN,24540.655,24553.6233807872,24527.686619212796,24537.786240137604,24541.051329672693,24547.64864062596,24534.454018719425,674,1073.8666666666666,43.92309787157808,56.23891239693699,NaN,NaN,NaN,NaN,5.923080563003815,10.074333556574198,-90262,-0.8018339043741727,1.2881796048604883,2.090013509234661
2025-09-16T19:30:00-04:00,24537.75,24542,24537,24539.25,NaN,NaN,NaN,24559.564604743024,NaN,NaN,24540.81,24553.51966560176,24528.10033439824,24537.786240137604,24540.970167293373,24547.411407045533,24534.528927541214,647,852.7,45.46372763392248,55.39669459715234,NaN,NaN,NaN,NaN,5.857146237074971,11.136038922896244,-89615,-1.0174657754690504,0.818181289898348,1.8356470653673984
2025-09-16T19:35:00-04:00,24539,24543.75,24539,24542.75,NaN,NaN,NaN,24559.564604743024,NaN,NaN,24541.055,24553.428071558807,24528.681928441194,24537.786240137604,24540.998980045988,24547.333699820876,24534.6642602711,450,787.2666666666667,50.58123936608067,54.8564257486583,NaN,NaN,NaN,NaN,5.778064362998188,11.561726993689081,-89165,-0.8926558380949032,0.7198272677487694,1.6124831058436726
2025-09-16T19:40:00-04:00,24542.75,24544.5,24540,24540.5,NaN,NaN,NaN,24559.564604743024,NaN,NaN,24541.24,24553.29361354195,24529.186386458052,24537.786240137604,24541.018407154,24547.261297406763,24534.775516901234,404,753.9666666666667,47.495728317647476,53.92208048881705,NaN,NaN,NaN,NaN,5.686774051355459,11.72151539614305,-89569,-0.9259233375105225,0.45507893395551946,1.381002271466042
2025-09-16T19:45:00-04:00,24540.25,24543,24538.5,24540.5,NaN,NaN,NaN,24559.564604743024,NaN,NaN,24541.405,24553.184596774317,24529.62540322568,24537.786240137604,24541.010434996828,24547.18239460527,24534.838475388387,322,723.5333333333333,47.49572831764747,52.92509602499062,NaN,NaN,NaN,NaN,5.6020044762586405,12.2219342226759,-89569,-0.9108266643786782,0.24246894099269412,1.1532956053713723
2025-09-16T19:50:00-04:00,24540.75,24543.75,24540.25,24543.25,NaN,NaN,NaN,24559.564604743024,NaN,NaN,24541.55,24553.23802806865,24529.86197193135,24537.153992110085,24541.0390405921,24547.151127210815,24534.926953973383,295,710.8666666666667,51.674366229546266,52.45108051650694,NaN,NaN,NaN,NaN,5.451861299383023,12.43331771464777,-89274,-0.6886331237043377,0.2925042007409502,0.9811373244452879
2025-09-16T19:55:00-04:00,24543.25,24546.25,24542.75,24543,NaN,NaN,NaN,24559.564604743024,NaN,NaN,24541.595,24553.287685736257,24529.902314263745,24536.973193688067,24541.117551632316,24547.1667957852,24535.068307479432,395,710.9,51.27484810854848,51.82620479164315,NaN,NaN,NaN,NaN,5.312442635141379,11.832925760368267,-89669,-0.5381664884164842,0.3084292139246827,0.8465957023411669
2025-09-16T20:00:00-04:00,24543,24549.25,24540.5,24547.25,NaN,NaN,NaN,24559.564604743024,NaN,NaN,24541.67,24553.458316261935,24529.881683738062,24536.37992923337,24541.50349141991,24547.427642581722,24535.579340258097,1381,717.7,57.316490906560325,51.597233653585114,NaN,NaN,NaN,NaN,5.557982446916995,11.526450608043366,-88288,-0.152138520033115,0.6564225522997731,0.8085610723328881
2025-09-16T20:05:00-04:00,24547.25,24550,24545.75,24548,NaN,NaN,NaN,24559.564604743024,NaN,NaN,24541.695,24553.531507087322,24529.858492912677,24537.5789433867,24541.684953040432,24547.620721738633,24535.749184342232,474,703.1,58.299151967039144,51.78581174098466,NaN,NaN,NaN,NaN,5.4645551292800665,11.433872139885,-87814,0.1382834354698994,0.9814153666702623,0.8431319312003629
2025-09-16T20:10:00-04:00,24547.5,24549.5,24530.75,24534,NaN,NaN,NaN,24559.564604743024,NaN,NaN,24541.37,24553.14125311359,24529.598746886408,24537.5789433867,24541.358101751335,24547.111904306934,24535.604299195737,1672,735.2,39.85444233592305,50.554895953889236,NaN,NaN,NaN,NaN,6.413515477188633,12.918310816238353,-89486,-0.5880687217432085,0.1080460290213523,0.6961147507645608
2025-09-16T20:15:00-04:00,24533.5,24539,24532.75,24537.75,NaN,NaN,NaN,24556.526757484837,NaN,NaN,24541.105,24552.590247063774,24529.619752936225,24537.5789433867,24541.13495762346,24546.846337412913,24535.423577834008,887,733.0333333333333,44.88448183459807,49.64132140382947,NaN,NaN,NaN,NaN,6.401835800246587,14.29671815856647,-88599,-0.7795347539620902,-0.2783036916880519,0.5012310622740382
2025-09-16T20:20:00-04:00,24537.25,24539,24532.5,24534.5,NaN,NaN,NaN,24556.34940487189,NaN,NaN,24540.785,24552.09561890279,24529.47438109721,24537.5789433867,24540.95589514537,24546.66727530009,24535.24451499065,615,709.3666666666667,41.634659401469875,48.80450422427568,NaN,NaN,NaN,NaN,6.408847528800402,15.61243923462985,-89214,-1.0706544890481902,-0.8370870490361995,0.2335674400119907
2025-09-16T20:25:00-04:00,24534.25,24540.25,24534,24539.75,NaN,NaN,NaN,24556.34940487189,NaN,NaN,24540.59,24551.6257419343,24529.554258065702,24537.5789433867,24540.888913413117,24546.552321304807,24535.225505521426,462,679.6,48.16381573143768,48.31608454454333,NaN,NaN,NaN,NaN,6.39750127674323,16.47148070430246,-88752,-0.8640838763087647,-0.8465374053739652,0.017546470934799524
2025-09-16T20:30:00-04:00,24540.25,24543.25,24538,24538.5,NaN,NaN,NaN,24556.34940487189,NaN,NaN,24540.435,24551.36560381786,24529.504396182143,24537.5789433867,24540.862110082988,24546.44917500836,24535.275045157614,578,622.6666666666666,46.82081453156807,48.20589946811198,NaN,NaN,NaN,NaN,6.315536899832999,16.44872197698733,-89330,-0.7692447611532739,-0.9440094805067929,-0.17476471935351898
2025-09-16T20:35:00-04:00,24538.5,24538.5,24532,24533,NaN,NaN,NaN,24555.512428485967,NaN,NaN,24540.36,24551.441137136026,24529.278862863976,24537.5789433867,24540.67537037037,24546.283601343945,24535.067139396793,634,610.4333333333333,41.35648931044948,48.02257028517422,NaN,NaN,NaN,NaN,6.328712835559214,17.399947070899145,-89964,-1.0188802140254094,-1.4483649868852808,-0.4294847728598714
2025-09-16T20:40:00-04:00,24533.25,24538.75,24533,24534.5,NaN,NaN,NaN,24555.512428485967,NaN,NaN,24540.335,24551.463166969515,24529.206833030483,24537.5789433867,24540.565714717435,24546.16580646654,24534.96562296833,460,602.3333333333334,43.300030083704286,47.86802046015864,NaN,NaN,NaN,NaN,6.287376204447841,18.216189751951344,-89504,-1.0222934687858194,-1.7073516088421457,-0.6850581400563263
2025-09-16T20:45:00-04:00,24534,24540.5,24533.25,24540.5,NaN,NaN,NaN,24555.512428485967,NaN,NaN,24540.45,24551.463173927703,24529.4368260723,24537.5789433867,24540.525745952455,24546.089351311894,24534.962140593016,361,590.6666666666666,50.383477748776535,47.8538946303512,NaN,NaN,NaN,NaN,6.356135046987281,18.498362445966684,-89143,-0.5816909906465078,-1.412171878364461,-0.8304808877179533
2025-09-16T20:50:00-04:00,24540.75,24541,24536.5,24540.5,NaN,NaN,NaN,24555.512428485967,NaN,NaN,24540.535,24551.48260704631,24529.58739295369,24537.5789433867,24540.51280495875,24546.047516726176,24534.978093191326,246,567.5333333333333,50.383477748776535,48.06016244686042,NaN,NaN,NaN,NaN,6.223553972202475,18.623732747607487,-89143,-0.26746535457814447,-1.1648125809406338,-0.8973472263624893
2025-09-16T20:55:00-04:00,24540.5,24542.75,24538.5,24540.5,NaN,NaN,NaN,24555.512428485967,NaN,NaN,24540.455,24551.343842903472,24529.56615709653,24530.188154709358,24540.5142018018,24545.993839673312,24535.03456393029,458,565.3,50.383477748776535,48.266430263369635,NaN,NaN,NaN,NaN,6.082585831330869,18.26141540495443,-89143,-0.04831289423011231,-0.9577383441501297,-0.9094254499200174
2025-09-16T21:00:00-04:00,24540.75,24546,24540.5,24544.5,NaN,NaN,NaN,24555.512428485967,NaN,NaN,24540.53,24551.477438068374,24529.582561931624,24531.62966848128,24540.59042605564,24546.025028042717,24535.155824068566,573,546.6,55.05838819870248,48.50814611830936,NaN,NaN,NaN,NaN,6.040972557664378,17.111548337282162,-88570,0.3551419774816018,-0.4654979780680151,-0.8206399555496169
2025-09-16T21:05:00-04:00,24544.5,24545.5,24540.75,24544.5,NaN,NaN,NaN,24555.512428485967,NaN,NaN,24540.94,24550.86852457051,24531.01147542949,24531.62966848128,24540.64266760645,24546.04387010356,24535.241465109342,421,537.3,55.05838819870248,48.77839898189179,NaN,NaN,NaN,NaN,5.948760232116922,16.043814631586482,-88570,0.5968841633733126,-0.07453475133297616,-0.6714189147062888
2025-09-16T21:10:00-04:00,24544.5,24547.25,24542.5,24545.25,NaN,NaN,NaN,24555.512428485967,NaN,NaN,24541.12,24551.02819864933,24531.21180135067,24533.77798782802,24540.72021094641,24546.104047249228,24535.33637464359,437,522.7666666666667,55.96070281887052,48.68155697562823,NaN,NaN,NaN,NaN,5.863134501251428,15.173403531848791,-88133,0.7710982739636579,0.2924539277482836,-0.47864434621537433
2025-09-16T21:15:00-04:00,24544.5,24544.75,24538,24540.5,NaN,NaN,NaN,24555.512428485967,NaN,NaN,24541.255,24550.939260411185,24531.570739588817,24533.77798782802,24540.729574968922,24546.04385169244,24535.415298245403,650,532.2333333333333,49.22050770029414,48.03308238514645,NaN,NaN,NaN,NaN,5.9621963225906125,14.854915123456808,-88783,0.5410998637009802,0.19773048341085087,-0.3433693802901293
2025-09-16T21:20:00-04:00,24540.25,24541.5,24535.25,24540.25,NaN,NaN,NaN,24555.512428485967,NaN,NaN,24541.365,24550.87457937131,24531.855420628694,24533.77798782802,24540.694615045737,24545.96053701777,24535.428693073703,520,537.2333333333333,48.88676506478932,48.67824829435119,NaN,NaN,NaN,NaN,5.982753728119854,15.09830915309596,-89303,0.35575198412060594,0.10132059986062814,-0.2544313842599778
2025-09-16T21:25:00-04:00,24540,24543.25,24536.75,24540.5,NaN,NaN,NaN,24555.512428485967,NaN,NaN,24541.39,24550.88376637079,24531.89623362921,24533.77798782802,24540.68504382784,24545.9034897168,24535.466597938885,475,543.0666666666667,49.25729550813196,48.99059212817504,NaN,NaN,NaN,NaN,6.019699890397007,14.861730517071589,-88828,0.23920443544119854,0.04457416004152037,-0.19463027539967817
2025-09-16T21:30:00-04:00,24540,24540.25,24527.75,24530.5,NaN,NaN,NaN,24553.97036757528,NaN,NaN,24541.255,24551.163324761437,24531.346675238565,24533.77798782802,24540.345846723147,24545.69411364651,24534.997579799783,1183,570.2,37.535844145561455,48.697819609895866,NaN,NaN,NaN,NaN,6.500435612511507,16.10837500217283,-90011,-0.482787033048814,-0.7981140667106956,-0.31532703366188164
2025-09-16T21:35:00-04:00,24531,24535,24528.5,24529,NaN,NaN,NaN,24551.698987230946,NaN,NaN,24541.06,24551.52592564987,24530.594074350134,24533.77798782802,24540.106763972944,24545.593307411582,24534.620220534307,706,587.1666666666666,36.1463669533335,47.839430411459844,NaN,NaN,NaN,NaN,6.500404497332114,17.26597345262398,-90717,-1.0028605235104966,-1.5689026880500023,-0.5660421645395057
2025-09-16T21:40:00-04:00,24529.25,24535,24529.25,24533.5,NaN,NaN,NaN,24551.698987230946,NaN,NaN,24540.94,24551.610313976496,24530.2696860235,24533.77798782802,24539.970538543996,24545.498958715623,24534.442118372368,518,596.8,42.96717822098367,47.56417067498954,NaN,NaN,NaN,NaN,6.464661318951249,18.34088629947148,-90199,-0.9839209204956697,-1.795943315159093,-0.8120223946634232
2025-09-16T21:45:00-04:00,24533.25,24536,24532.5,24535,NaN,NaN,NaN,24551.698987230946,NaN,NaN,24540.795,24551.586519846463,24530.003480153533,24533.77798782802,24539.909088814387,24545.436520600968,24534.381657027807,325,589.4,45.07336481504349,47.82966178246054,NaN,NaN,NaN,NaN,6.252899796169017,19.04334799865291,-89874,-0.8173416348472922,-1.8336994382225384,-1.0163578033752463
2025-09-16T21:50:00-04:00,24536,24536.25,24531.5,24534.25,NaN,NaN,NaN,24551.698987230946,NaN,NaN,24540.64,24551.579451555805,24529.700548444194,24533.77798782802,24539.84305080884,24545.374499180314,24534.311602437363,327,585,44.19455393062042,47.89355634295455,NaN,NaN,NaN,NaN,6.145549810728373,19.862846417724157,-90201,-0.7086838744639268,-1.9022126464551548,-1.193528771991228
2025-09-16T21:55:00-04:00,24534.25,24536,24530.5,24530.75,NaN,NaN,NaN,24551.698987230946,NaN,NaN,24540.46,24551.742889714576,24529.17711028542,24533.77798782802,24539.783381925845,24545.332313998693,24534.234449852996,237,570.4333333333333,40.25053849227656,47.16977496749026,NaN,NaN,NaN,NaN,6.099439109962061,20.792107827685488,-90438,-0.8159095649334156,-2.2134157281579974,-1.3975061632245818
2025-09-16T22:00:00-04:00,24530.75,24533.5,24528.25,24529.25,NaN,NaN,NaN,24549.800345988788,NaN,NaN,24540.265,24551.971156502274,24528.558843497725,24530.347390262417,24539.628034344783,24545.26083068653,24533.995238003037,493,565.3,38.658256396710215,46.33225915662838,NaN,NaN,NaN,NaN,6.038764887821913,22.019052108956146,-90931,-0.9233309215909304,-2.551669815213245,-1.6283388936223144
2025-09-16T22:05:00-04:00,24529,24531.25,24526.5,24528.75,NaN,NaN,NaN,24547.587830262026,NaN,NaN,24540.22,24552.084501669284,24528.35549833072,24528.282329767946,24539.46112241883,24545.206703539858,24533.715541297803,471,566,38.11696630965832,45.456079768119935,NaN,NaN,NaN,NaN,5.946710252977491,23.423293166850254,-91402,-0.9593215912423025,-2.8274908826751926,-1.86816929143289
2025-09-16T22:10:00-04:00,24529.5,24529.75,24523.75,24525.75,NaN,NaN,NaN,24545.43042888648,NaN,NaN,24540.12,24552.37978795041,24527.86021204959,24528.282329767946,24539.187764492868,24545.171993287582,24533.203535698154,652,574.2666666666667,34.954493776864126,44.0200873094172,NaN,NaN,NaN,NaN,5.950516663479099,25.110038300395427,-92054,-1.106011871332511,-3.250684130598529,-2.144672259266018
2025-09-16T22:15:00-04:00,24526.25,24527.5,24520.75,24522,NaN,NaN,NaN,24542.876773028,NaN,NaN,24539.865,24553.055985539908,24526.674014460095,24521.900863814357,24538.868915656327,24545.19457171706,24532.543259595594,642,584.9333333333333,31.44274395216685,42.3332555775218,NaN,NaN,NaN,NaN,6.007622616087735,27.04491197693738,-92696,-1.3597391988473748,-3.8443462578252365,-2.4846070589778617
2025-09-16T22:20:00-04:00,24522,24522.25,24513.25,24513.5,NaN,NaN,NaN,24536.87669243582,NaN,NaN,24539.355,24554.47157699417,24524.23842300583,24521.37519381836,24538.06546660998,24545.551987256782,24530.578945963178,1174,614.2333333333333,25.25033032370105,40.13965754215254,NaN,NaN,NaN,NaN,6.221363857795754,29.551150171010892,-93870,-1.9672892507133009,-4.943718622369488,-2.976429371656187
2025-09-16T22:25:00-04:00,24514,24519.5,24513.25,24518.5,NaN,NaN,NaN,24535.484570052377,NaN,NaN,24538.98,24555.178407331518,24522.78159266848,24521.37519381836,24537.655019948787,24545.61712873299,24529.692911164584,657,622.9666666666667,33.541669949617386,39.01974055996135,NaN,NaN,NaN,NaN,6.223409296524628,31.878371351222018,-93213,-1.8987374421893102,-5.349851174392825,-3.4511137322035146
2025-09-16T22:30:00-04:00,24518.5,24524.5,24515.75,24521,NaN,NaN,NaN,24535.484570052377,NaN,NaN,24538.51,24555.389857840502,24521.630142159494,24521.37519381836,24537.33267593837,24545.558398350593,24529.10695352615,640,598.2666666666667,37.28730596722867,38.19120776727844,NaN,NaN,NaN,NaN,6.403880061058584,32.43616474645884,-92573,-1.565228237762354,-5.407649029406457,-3.842420791644103
2025-09-16T22:35:00-04:00,24521,24521.25,24518,24520.75,NaN,NaN,NaN,24535.484570052377,NaN,NaN,24538.015,24555.48709490312,24520.542905096878,24521.37519381836,24537.098376327038,24545.50991626458,24528.686836389497,469,598.1,37.0623519220376,37.3201403682717,NaN,NaN,NaN,NaN,6.178602913840114,32.954115756321606,-93042,-1.255063077984266,-5.411249639124435,-4.156186561140169
2025-09-16T22:40:00-04:00,24520,24523.75,24520,24522.25,NaN,NaN,NaN,24535.484570052377,NaN,NaN,24537.495,24555.262805168695,24519.727194831303,24521.35015505469,24536.948439536187,24545.45095043523,24528.445928637142,348,553.9666666666667,39.42376001517966,37.454991501815854,NaN,NaN,NaN,NaN,6.00513127713725,32.69362371263283,-92694,-0.8612474290334191,-5.232745847431943,-4.371498418398524
2025-09-16T22:45:00-04:00,24523,24524.75,24517.75,24519.5,NaN,NaN,NaN,24535.484570052377,NaN,NaN,24536.9,24555.041940362444,24518.75805963756,24519.15512404375,24536.795632508834,24545.40253858876,24528.188726428907,332,535.4666666666667,36.70476096472214,37.49487678834362,NaN,NaN,NaN,NaN,6.076193328770303,32.790988393364714,-93026,-0.7049078552361099,-5.252633237443661,-4.547725382207551
2025-09-16T22:50:00-04:00,24519.25,24522.75,24518,24520,NaN,NaN,NaN,24535.484570052377,NaN,NaN,24536.36,24554.870850868723,24517.849149131278,24517.399099235,24536.666619919783,24545.362547822122,24527.970692017443,278,524.2333333333333,37.548131538036245,37.107802025275944,NaN,NaN,NaN,NaN,5.981465233858139,32.88139845404433,-92748,-0.4965952284712287,-5.168469417796587,-4.671874189325358
2025-09-16T22:55:00-04:00,24520.25,24525.5,24520,24524.25,NaN,NaN,NaN,24535.484570052377,NaN,NaN,24535.87,24554.34004061351,24517.399959386486,24515.669279388,24536.529920877292,24545.285721647182,24527.774120107402,367,521.0666666666667,44.337281773894816,37.055224665193904,NaN,NaN,NaN,NaN,5.947074860011129,32.13273183002601,-92381,-0.026178910814775413,-4.704597827843827,-4.6784189170290515
2025-09-16T23:00:00-04:00,24524,24524.5,24519.75,24523.25,NaN,NaN,NaN,24535.484570052377,NaN,NaN,24535.35,24553.74782595904,24516.95217404096,24512.8604235104,24536.407525387345,24545.22214149215,24527.59290928254,317,512.3666666666667,43.148688319373804,36.980519978676284,NaN,NaN,NaN,NaN,5.861569512867477,31.48432885666631,-92698,0.24887585379521138,-4.367324099785037,-4.6161999535802485
2025-09-16T23:05:00-04:00,24523.25,24525,24521,24521,NaN,NaN,NaN,24535.484570052377,NaN,NaN,24534.85,24553.42094505173,24516.279054948267,24512.032331667746,24536.33163400303,24545.182670341987,24527.48059766407,197,497.8,40.51680482044954,36.99953900211721,NaN,NaN,NaN,NaN,5.728600261948372,30.72529174664327,-92895,0.3067236382838123,-4.232795405725483,-4.539519044009295
2025-09-16T23:10:00-04:00,24521.25,24525.25,24520,24524.5,NaN,NaN,NaN,24535.484570052377,NaN,NaN,24534.395,24552.84278848435,24515.94721151565,24512.250865334197,24536.246612097642,24545.131243642863,24527.36198055242,239,490.43333333333334,46.03136299614251,37.52618947350523,NaN,NaN,NaN,NaN,5.694414528952059,30.229830388146052,-92656,0.591650300917399,-3.799956167862547,-4.391606468779946
2025-09-16T23:15:00-04:00,24524.5,24524.5,24521,24523,NaN,NaN,NaN,24535.484570052377,NaN,NaN,24533.9,24552.215567150328,24515.584432849675,24512.35069226736,24536.161798218352,24545.08188734041,24527.241709096295,234,486.2,44.14258008226583,37.956590457262905,NaN,NaN,NaN,NaN,5.537670634026911,29.76975912668435,-92890,0.6835324688435138,-3.537190882725554,-4.220723351569068
2025-09-16T23:20:00-04:00,24523.75,24526.75,24521.75,24521.75,NaN,NaN,NaN,24535.484570052377,NaN,NaN,24533.435,24551.78024732779,24515.08975267221,24514.530553813885,24536.052874225294,24545.011912250393,24527.093836200194,319,488.6333333333333,42.574803057206054,38.50089826300161,NaN,NaN,NaN,NaN,5.499265588739275,28.56334477802135,-93209,0.6639979795057149,-3.3907258771869238,-4.054723856692639
2025-09-16T23:25:00-04:00,24522,24523.25,24521.5,24522.5,NaN,NaN,NaN,24535.484570052377,NaN,NaN,24532.96,24551.182886716768,24514.73711328323,24514.530553813885,24535.978391196608,24544.969279066907,24526.98750332631,205,480.2,43.86308540241639,39.388065509448005,NaN,NaN,NaN,NaN,5.231460903829327,27.508037322085276,-93004,0.7017756600298917,-3.177504281655274,-3.8792799416851658
2025-09-16T23:30:00-04:00,24522.25,24523,24518.5,24520.75,NaN,NaN,NaN,24535.484570052377,NaN,NaN,24532.54,24550.90065357707,24514.17934642293,24514.530553813885,24535.80509970234,24544.88943299856,24526.720766406117,432,475.5,41.52235187871284,40.55035276337742,NaN,NaN,NaN,NaN,5.179213696412947,27.259832401328925,-93436,0.6123514816376288,-3.11384058963813,-3.726192071275759
2025-09-16T23:35:00-04:00,24520.5,24521.25,24517.75,24518.25,NaN,NaN,NaN,24535.484570052377,NaN,NaN,24532.14,24550.853674146856,24513.426325853143,24514.530553813885,24535.67572771548,24544.842691605823,24526.508763825135,296,471.3333333333333,38.37203477942734,40.895378822649555,NaN,NaN,NaN,NaN,5.0592698609548785,27.197568408385692,-93732,0.3986284848262107,-3.227906465242995,-3.626534950069206
2025-09-16T23:40:00-04:00,24518,24522.75,24518,24520.75,NaN,NaN,NaN,24535.484570052377,NaN,NaN,24531.77,24550.63765486176,24512.90234513824,24514.530553813885,24535.55492316202,24544.78438652068,24526.32545980336,307,467,43.027095693629384,41.305363803106744,NaN,NaN,NaN,NaN,5.037179156600958,26.574706206732824,-93425,0.4363808734903776,-3.0810588582062337,-3.5174397316966113
2025-09-16T23:45:00-04:00,24521,24523,24519,24519.25,NaN,NaN,NaN,24535.484570052377,NaN,NaN,24531.3,24550.220887941025,24512.379112058974,24514.530553813885,24535.44232616994,24544.72894313028,24526.1557092096,289,454.96666666666664,41.02479238413485,41.588395264685126,NaN,NaN,NaN,NaN,4.963094931129461,25.902319668915013,-93714,0.37350886373439973,-3.0505536520286114,-3.424062515763011
2025-09-16T23:50:00-04:00,24519.5,24520.75,24516.25,24517.75,NaN,NaN,NaN,24534.51871463189,NaN,NaN,24530.845,24549.952299642086,24511.737700357917,24514.530553813885,24535.329357571412,24544.689058706426,24525.9696564364,257,446.2,39.06693155402737,41.56290751745996,NaN,NaN,NaN,NaN,4.930016721763072,25.966098972584543,-93971,0.2500119828541747,-3.1115475371952925,-3.3615595200494672
2025-09-16T23:55:00-04:00,24517.75,24520.25,24517,24518.5,NaN,NaN,NaN,24534.358773057713,NaN,NaN,24530.405,24549.615645502017,24511.19435449798,24514.530553813885,24535.22173038655,24544.64678822963,24525.79667254347,253,438.8,40.59352672553117,41.84067650037489,NaN,NaN,NaN,NaN,4.810015527351424,26.025322611706255,-93718,0.2380104335283244,-3.064046478139062,-3.3020569116673864
2025-09-17T00:00:00-04:00,24518.75,24523,24517.25,24517.25,NaN,NaN,NaN,24534.358773057713,NaN,NaN,24529.885,24549.084273439406,24510.68572656059,24514.530553813885,24535.058232755004,24544.572712569097,24525.54375294091,405,412.8666666666667,38.846667002676206,41.933429033563456,NaN,NaN,NaN,NaN,4.87715727539775,25.003935921431307,-94123,0.16834333748294705,-3.0916277398137026,-3.2599710772966497
2025-09-17T00:05:00-04:00,24517.25,24519.5,24515,24518.5,NaN,NaN,NaN,24532.948024624897,NaN,NaN,24529.395,24548.480620241968,24510.309379758033,24514.530553813885,24534.95347737705,24544.534236607782,24525.37271814632,241,397.3666666666667,41.55518615258067,41.7347079177553,NaN,NaN,NaN,NaN,4.850217470012197,24.65319914049476,-93882,0.22534512924402916,-2.978289665741613,-3.2036347949856423
2025-09-17T00:10:00-04:00,24518.75,24521.25,24513.5,24513.5,NaN,NaN,NaN,24532.948024624897,NaN,NaN,24528.72,24547.618317384753,24509.82168261525,24512.59944305111,24534.7685446416,24544.48177672855,24525.05531255465,396,393.3,34.89714659690834,41.145312080436334,NaN,NaN,NaN,NaN,5.057344793582755,23.696523241891356,-94278,-0.04062160821158933,-3.254411805250129,-3.2137901970385396
2025-09-17T00:15:00-04:00,24513.5,24514,24507.75,24514,NaN,NaN,NaN,24527.039419131364,NaN,NaN,24528.04,24546.557386424305,24509.522613575697,24512.465531873735,24534.199977476386,24544.430766044206,24523.969188908566,1031,416.8333333333333,36.001418870381556,40.82278451257434,NaN,NaN,NaN,NaN,5.1425344511839866,24.117275118173573,-93247,-0.14398661111161593,-3.3937734609280596,-3.2497868498164437
2025-09-17T00:20:00-04:00,24514,24516.75,24511.25,24511.75,NaN,NaN,NaN,24527.039419131364,NaN,NaN,24527.595,24546.581545240897,24508.608454759105,24512.465531873735,24533.975902847407,24544.377521725237,24523.574283969578,448,420.8666666666667,33.26687236764795,39.91103518196758,NaN,NaN,NaN,NaN,5.168067704670845,23.618034827224694,-93695,-0.31518783354643,-3.643771641749481,-3.328583808203051
2025-09-17T00:25:00-04:00,24511.5,24514.5,24510.5,24512.25,NaN,NaN,NaN,24527.039419131364,NaN,NaN,24527.085,24546.321322423675,24507.848677576323,24512.465531873735,24533.88161001505,24544.357509157737,24523.405710872365,184,419.1,34.45826739566952,39.219298561496416,NaN,NaN,NaN,NaN,5.084634297194356,23.317019204665474,-93511,-0.3437158808765717,-3.7582286592987657,-3.414512778422194
2025-09-17T00:30:00-04:00,24511.75,24516,24510.75,24511.75,NaN,NaN,NaN,24527.039419131364,NaN,NaN,24526.63,24546.216280908,24507.043719092002,24512.465531873735,24533.761226129696,24544.327028024112,24523.19542423528,242,410.73333333333335,33.80825484769858,38.5931165465316,NaN,NaN,NaN,NaN,5.096446133109045,22.561191173620447,-93753,-0.3443579245060837,-3.8449601840547984,-3.5006022595487147
2025-09-17T00:35:00-04:00,24512,24520.5,24511.5,24519.25,NaN,NaN,NaN,24527.039419131364,NaN,NaN,24526.22,24545.547089780008,24506.892910219995,24511.991352319354,24533.58842045764,24544.23415385875,24522.94268705653,443,409.8,49.26756072677008,38.97915049827115,NaN,NaN,NaN,NaN,5.375271409315542,21.27084198990578,-93310,0.18383826763947653,-3.270804424999369,-3.4546426926388456
2025-09-17T00:40:00-04:00,24519.5,24522,24518.5,24518.75,NaN,NaN,NaN,24527.039419131364,NaN,NaN,24525.825,24544.938149911075,24506.711850088926,24511.991352319354,24533.487210742198,24544.15928214424,24522.815139340157,315,398.56666666666666,48.45506927232046,39.47434459781455,NaN,NaN,NaN,NaN,5.24132345150729,20.42749462327842,-93625,0.5048507883357529,-2.8235792072191543,-3.3284299955549073
2025-09-17T00:45:00-04:00,24518.75,24520,24516,24516,NaN,NaN,NaN,24527.039419131364,NaN,NaN,24525.485,24544.6801582347,24506.2898417653,24511.991352319354,24533.41589037084,24544.11809934765,24522.713681394034,191,383.53333333333336,44.14316977755827,39.88656852625247,NaN,NaN,NaN,NaN,5.152657490685341,18.976740648998227,-93816,0.5344361901421801,-2.660384757877182,-3.194820948019362
2025-09-17T00:50:00-04:00,24516.25,24518.5,24516,24517.25,NaN,NaN,NaN,24527.039419131364,NaN,NaN,24525.14,24544.294675678822,24505.985324321176,24508.529465484386,24533.364486124865,24544.088357839457,24522.640614410273,138,349,46.47474873871026,40.13282945804396,NaN,NaN,NaN,NaN,4.963181955636387,17.62961195859519,-93678,0.6338623711472846,-2.4024929840852565,-3.036355355232541
2025-09-17T00:55:00-04:00,24517.25,24519.25,24516,24518.75,NaN,NaN,NaN,24527.039419131364,NaN,NaN,24524.705,24543.42763069239,24505.982369307614,24508.529465484386,24533.30488737911,24544.0504672545,24522.559307503718,169,332.73333333333335,49.21431066776236,40.71779504973164,NaN,NaN,NaN,NaN,4.840811815948074,16.5845528390628,-93509,0.7863610302026105,-2.0534040674792777,-2.8397650976818882
2025-09-17T01:00:00-04:00,24519.5,24521.75,24517.25,24520,NaN,NaN,NaN,24527.039419131364,NaN,NaN,24524.295,24542.506998802623,24506.083001197374,24510.830420766695,24533.19958852422,24543.969963601456,24522.429213446987,339,322.7,51.444610674466404,41.60191498690586,NaN,NaN,NaN,NaN,4.8164681148089254,16.26440632303196,-93170,0.9463835668092977,-1.6567856391702662,-2.603169205979564
2025-09-17T01:05:00-04:00,24519.75,24526.75,24509.25,24525.5,NaN,NaN,NaN,24527.039419131364,NaN,NaN,24523.995,24541.61387909408,24506.37612090592,24510.830420766695,24532.880949737617,24543.69924487069,24522.062654604542,1130,344.73333333333335,59.80826457369213,42.974396261774494,NaN,NaN,NaN,NaN,5.72243467803686,16.19507562914855,-92040,1.3718013499535648,-0.888417518537608,-2.260218868491173
2025-09-17T01:10:00-04:00,24525.25,24527,24517,24519.25,NaN,NaN,NaN,24527.039419131364,NaN,NaN,24523.49,24540.150420151618,24506.829579848385,24510.830420766695,24532.722783266512,24543.553638579473,24521.89192795355,612,353.53333333333336,49.39585722694949,43.72790984922259,NaN,NaN,NaN,NaN,6.027975058177084,16.063518436254153,-92652,1.1882784662802865,-0.7748707856408146,-1.9631492519211011
2025-09-17T01:15:00-04:00,24519,24520.5,24499.75,24507.75,NaN,NaN,NaN,24527.039419131364,NaN,NaN,24522.755,24538.87687643626,24506.63312356374,24510.830420766695,24531.88778104029,24543.3748420827,24520.400719997877,1690,398.8,36.726122240347834,43.38297671263452,NaN,NaN,NaN,NaN,7.079548268307292,18.2501316629082,-94342,0.29495288057878977,-1.594458151197614,-1.8894110317764037
2025-09-17T01:20:00-04:00,24507.5,24516,24506.75,24511.5,NaN,NaN,NaN,24527.039419131364,NaN,NaN,24522.08,24537.17120272038,24506.988797279624,24510.830420766695,24531.553018811723,24543.23786598029,24519.868171643157,787,415.76666666666665,41.95446369651275,43.88707079117769,NaN,NaN,NaN,NaN,7.234580534856771,20.28055823051553,-93555,-0.023886568295416355,-1.919269242145674,-1.8953826738502577
2025-09-17T01:25:00-04:00,24510.75,24512.5,24508.75,24511,NaN,NaN,NaN,24527.039419131364,NaN,NaN,24521.49,24535.947855984436,24507.032144015568,24510.830420766695,24531.45064683097,24543.19726019036,24519.70403347158,238,411.46666666666664,41.46251641128093,44.277149186956215,NaN,NaN,NaN,NaN,6.985681925224144,22.16595432900805,-93793,-0.23710577439085734,-2.1917648918388295,-1.9546591174479722
2025-09-17T01:30:00-04:00,24510.75,24511.25,24508,24511,NaN,NaN,NaN,24527.039419131364,NaN,NaN,24520.905,24534.627569014447,24507.18243098555,24510.830420766695,24531.320668927245,24543.148769204756,24519.492568649734,296,410.76666666666665,41.46251641128093,44.86255233293,NaN,NaN,NaN,NaN,6.7188475019938485,23.993169907335034,-93793,-0.3404977114751677,-2.380281256791932,-2.039783545316764
2025-09-17T01:35:00-04:00,24511.25,24512.75,24507.25,24512,NaN,NaN,NaN,24527.039419131364,NaN,NaN,24520.335,24533.08788595935,24507.582114040648,24510.830420766695,24531.141003049004,24543.072704244423,24519.209301853585,427,418.43333333333334,43.01247311536021,45.47356702719362,NaN,NaN,NaN,NaN,6.6317869661371445,25.25231830699719,-93366,-0.30503834088308546,-2.421081471420621,-2.1160431305375353
2025-09-17T01:40:00-04:00,24512,24516,24508.75,24514.75,NaN,NaN,NaN,24527.039419131364,NaN,NaN,24520.02,24532.528732949486,24507.511267050515,24510.830420766695,24530.888641719892,24542.923549696283,24518.8537337435,699,433.76666666666665,47.15625142377603,46.426995354056295,NaN,NaN,NaN,NaN,6.675945039984491,25.529226215012237,-92667,-0.07203234367367362,-2.2060835601296276,-2.134051216455954
2025-09-17T01:45:00-04:00,24514.75,24519.75,24514.5,24516.5,NaN,NaN,NaN,24527.039419131364,NaN,NaN,24519.77,24532.048371225996,24507.491628774005,24510.830420766695,24530.788613022232,24542.83808047081,24518.739145573654,359,437.93333333333334,49.664558058094244,46.45535230629373,NaN,NaN,NaN,NaN,6.574091822842742,24.875246968326895,-92308,0.20892400504878506,-1.8728962101449724,-2.0818202151937575
2025-09-17T01:50:00-04:00,24516.75,24517.75,24513.25,24516.5,NaN,NaN,NaN,24527.039419131364,NaN,NaN,24519.43,24531.09492178448,24507.76507821552,24509.264336613356,24530.69260338029,24542.762574918077,24518.6226318425,324,438.1,49.664558058094244,46.54174436242043,NaN,NaN,NaN,NaN,6.425942406925403,24.472540170765736,-92308,0.39304941734347887,-1.590508443514409,-1.9835578608578879
2025-09-17T01:55:00-04:00,24516.5,24519.5,24515.5,24518.25,NaN,NaN,NaN,24527.039419131364,NaN,NaN,24519.095,24529.881051159366,24508.308948840637,24508.011469290686,24530.644061272425,24542.717325922895,24518.570796621956,190,437.6,52.29093628671602,47.12372768450313,NaN,NaN,NaN,NaN,6.252660806430732,23.680442966483774,-92118,0.6176159887951047,-1.2115378748640069,-1.8291538636591116
2025-09-17T02:00:00-04:00,24518.25,24524.75,24515.75,24517,NaN,NaN,NaN,24527.039419131364,NaN,NaN,24518.75,24528.641410422817,24508.858589577183,24508.45354687211,24530.38648321819,24542.443947235988,24518.32901920039,1163,461.96666666666664,50.27314569788911,47.3950417530159,NaN,NaN,NaN,NaN,6.448899320257108,22.141803909466,-93281,0.6628974813593882,-1.0005320119598764,-1.6634294933192646
2025-09-17T02:05:00-04:00,24517.25,24520.25,24515,24516,NaN,NaN,NaN,24527.039419131364,NaN,NaN,24518.455,24527.759670870342,24509.15032912966,24508.45354687211,24530.270445184073,24542.338772846233,24518.202117521912,456,467.3,48.655597772596984,47.355133689075515,NaN,NaN,NaN,NaN,6.363263654524458,20.562574035749968,-93737,0.6078763676444008,-0.9035840337637637,-1.5114604014081645
2025-09-17T02:10:00-04:00,24515.5,24522.5,24509.25,24521.5,NaN,NaN,NaN,24527.039419131364,NaN,NaN,24518.3,24527.126097670847,24509.47390232915,24508.45354687211,24530.046290382164,24542.12078068718,24517.97180007715,953,488.8333333333333,56.87432194624759,47.742970208488465,NaN,NaN,NaN,NaN,6.855173393486996,20.131305232020686,-92784,0.9063011628075455,-0.37858394789873273,-1.2848851107062782
2025-09-17T02:15:00-04:00,24521.25,24522.25,24516.25,24516.25,NaN,NaN,NaN,24527.039419131364,NaN,NaN,24518.05,24526.371658488544,24509.728341511454,24508.45354687211,24529.946750117968,24542.018509336067,24517.87499089987,453,494.3,48.8381089323246,46.95938766267649,NaN,NaN,NaN,NaN,6.794089579666496,19.7308413428435,-93237,0.7225095556683707,-0.38174816612081486,-1.1042577217891856
2025-09-17T02:20:00-04:00,24517,24526.75,24517,24526.25,NaN,NaN,NaN,24527.039419131364,NaN,NaN,24518.06,24526.419760738994,24509.70023926101,24508.45354687211,24529.86727276073,24541.88789581007,24517.84664971139,653,507.5,60.33474612375749,47.74073686959135,NaN,NaN,NaN,NaN,7.058797466833175,18.404542436594735,-92584,1.217681337192076,0.41784394970090943,-0.7998373874911666
2025-09-17T02:25:00-04:00,24526.5,24529.5,24523.75,24525.75,24506.65703285091,24506.65703285091,24506.65703285091,NaN,NaN,NaN,24518.135,24526.699584046844,24509.570415953152,24510.697778239053,24529.823086475837,24541.77477645018,24517.871396501494,688,522,59.613434273661376,49.37554487197089,NaN,NaN,NaN,NaN,6.965311933487948,17.52216687920708,-93272,1.4395956818367384,0.9996572148047562,-0.43993846703198203
2025-09-17T02:30:00-04:00,24524.75,24526.25,24516.75,24523.25,24506.65703285091,NaN,NaN,NaN,NaN,NaN,24518.33,24526.907552095334,24509.75244790467,24510.697778239053,24529.73107727117,24541.641092287704,24517.82106225464,662,530.5666666666667,56.007978574861134,50.379367363281496,NaN,NaN,NaN,NaN,7.146361081095952,17.076997118896493,-93934,1.3476879848892076,1.2446715140795277,-0.10301647080968002
2025-09-17T02:35:00-04:00,24524,24529.25,24523.75,24528.25,24506.65703285091,NaN,NaN,NaN,NaN,NaN,24518.525,24527.541235330904,24509.5087646691,24510.697778239053,24529.707889068864,24541.56820303526,24517.84757510247,492,538.9333333333333,61.078165825302875,51.780485178568775,NaN,NaN,NaN,NaN,7.064478146731956,16.10580091973525,-93442,1.5394614904621922,1.8213103922680602,0.281848901805868
2025-09-17T02:40:00-04:00,24528.25,24530.75,24524.25,24529,24507.285326468096,NaN,NaN,NaN,NaN,NaN,24518.685,24528.14428643308,24509.225713566924,24512.433262458395,24529.691927207317,24541.497831878867,24517.886022535768,530,543.4,61.7895563933018,53.232416605855974,NaN,NaN,NaN,NaN,7.024158279108244,14.97591768522051,-92912,1.6242539785398926,2.312166374980734,0.6879123964408413
2025-09-17T02:45:00-04:00,24529.25,24530.75,24527,24528.75,24509.067811628636,NaN,NaN,NaN,NaN,NaN,24518.845,24528.700906848342,24508.98909315166,24514.221609966717,24529.686062803197,24541.451792314292,24517.920333292102,390,522.0333333333333,61.3867900630913,54.5448678164082,NaN,NaN,NaN,NaN,6.790289830600512,13.926740396028253,-93302,1.5700282078978791,2.6504476563131902,1.0804194484153111
2025-09-17T02:50:00-04:00,24528.5,24534,24527.75,24531,24511.115865645515,NaN,NaN,NaN,NaN,NaN,24519.02,24529.40789678337,24508.63210321663,24517.65228797337,24529.703883173963,24541.385037405686,24518.02272894224,839,535.0666666666667,63.68132795543972,55.725230425812754,NaN,NaN,NaN,NaN,6.751697699843333,13.549512628539112,-92463,1.5874768380890842,3.0647654960266664,1.4772886579375821
2025-09-17T02:55:00-04:00,24530.5,24534,24528.5,24532,24511.639008116173,NaN,NaN,NaN,NaN,NaN,24519.27,24530.27538048502,24508.26461951498,24518.1718303787,24529.72001237249,24541.34983410355,24518.090190641433,525,546.4333333333333,64.68573930576571,56.798171943503576,NaN,NaN,NaN,NaN,6.662290721283094,13.19922970158491,-91938,1.5655446475371912,3.434219467359071,1.8686748198218799
2025-09-17T03:00:00-04:00,24531.75,24535.25,24525.25,24534.5,24511.639008116173,NaN,NaN,NaN,NaN,NaN,24519.56,24531.362355694415,24507.757644305588,24518.1718303787,24529.765411216355,24541.262574991637,24518.268247441072,1396,584.9,67.13292748528329,58.04591261687421,NaN,NaN,NaN,NaN,6.90069852690573,12.326463897140961,-90542,1.6122373459435924,3.88397150225137,2.2717341563077778
2025-09-17T03:05:00-04:00,24534.5,24538.75,24529.5,24536.25,24513.69329045296,NaN,NaN,NaN,NaN,NaN,24519.8,24532.43289357798,24507.167106422017,24519.994971442367,24529.856371575912,24541.26974070425,24518.443002447573,1094,606.6,68.76465014846917,59.2226064641423,NaN,NaN,NaN,NaN,7.068505774983892,12.048069417873474,-89448,1.647957223959163,4.331680686256732,2.6837234622975688
2025-09-17T03:10:00-04:00,24536.75,24539,24531.75,24532.25,24514.883368159644,NaN,NaN,NaN,NaN,NaN,24519.98,24533.05319395017,24506.90680604983,24520.370977153892,24529.910215576623,24541.265235099407,24518.55519605384,742,620.8333333333334,61.276325522798,60.008547880207225,NaN,NaN,NaN,NaN,7.081469648199329,11.836109402878572,-90190,1.3042194608923148,4.313997788412962,3.0097783275206473
2025-09-17T03:15:00-04:00,24532.5,24536.75,24530.75,24536.25,24514.883368159644,NaN,NaN,NaN,NaN,NaN,24520.285,24534.128052400876,24506.441947599124,24520.370977153892,24529.93979512949,24541.26488628649,24518.614703972486,393,627.5666666666667,65.34095280800125,61.20035895416466,NaN,NaN,NaN,NaN,7.004221816185091,11.407532996722576,-89797,1.2482330318211798,4.570069617297122,3.321836585475942
2025-09-17T03:20:00-04:00,24536.75,24543.75,24535.5,24542.25,24519.047913963645,NaN,NaN,NaN,NaN,NaN,24520.64,24535.749652559083,24505.530347440916,24525.302425378493,24530.11409789323,24541.425641022364,24518.802554764097,1042,657.7,70.36570560801793,62.1640292157197,NaN,NaN,NaN,NaN,7.093205972171871,12.241505630441123,-88755,1.5003288174204332,5.197247607251484,3.6969187898310505
2025-09-17T03:25:00-04:00,24542.5,24549,24541.75,24548.25,24524.744599692567,NaN,NaN,NaN,NaN,NaN,24521.145,24538.110285142415,24504.179714857586,24530.616940302793,24530.371987529226,24541.775181055997,24518.968794002456,1020,686.0666666666667,74.36765111348504,63.98756794294544,NaN,NaN,NaN,NaN,7.104405545588166,13.723940765784867,-87735,1.92888973612075,6.108030959981988,4.179141223861238
2025-09-17T03:30:00-04:00,24548,24553,24545.75,24553,24528.69370879745,NaN,NaN,NaN,NaN,NaN,24521.77,24540.937900239252,24502.60209976075,24534.668552242234,24530.740388882932,24542.3581693621,24519.122608403763,1191,714.4666666666667,77.01410887859149,65.17895099686216,NaN,NaN,NaN,NaN,7.1148051494747255,15.558172536517207,-86544,2.361421300376638,7.130917849332036,4.769496548955398
2025-09-17T03:35:00-04:00,24552.25,24552.5,24542.25,24545,24528.69370879745,NaN,NaN,NaN,NaN,NaN,24522.22,24542.461699519106,24501.978300480896,24534.668552242234,24530.968136885185,24542.655261009062,24519.28101276131,953,708.5666666666667,64.86679949002874,65.55419136945982,NaN,NaN,NaN,NaN,7.374461924512246,16.43827863988891,-87497,1.954710198532874,7.212884297121491,5.258174098588617
2025-09-17T03:40:00-04:00,24545.25,24548.25,24541.25,24545.75,24528.69370879745,NaN,NaN,NaN,NaN,NaN,24522.72,24544.000187964022,24501.43981203598,24534.668552242234,24531.113954159573,24542.827826847613,24519.400081471533,692,711.2333333333333,65.4175083191677,66.2263006369103,NaN,NaN,NaN,NaN,7.347714644189942,17.028954021017398,-86805,1.5972478988894938,7.2547339722004835,5.65748607331099
2025-09-17T03:45:00-04:00,24546,24549.75,24543.5,24546,24528.69370879745,NaN,NaN,NaN,NaN,NaN,24523.275,24545.486990004112,24501.06300999589,24534.668552242234,24531.3463554301,24543.12061975632,24519.572091103884,1033,689.3333333333334,65.61101107782356,66.55007529780463,NaN,NaN,NaN,NaN,7.269306455319232,17.784623090968147,-85772,1.2538432758256262,7.224790168093023,5.9709468922673965
2025-09-17T03:50:00-04:00,24546,24553,24546,24548.5,24528.69370879745,NaN,NaN,NaN,NaN,NaN,24523.83,24547.122367848424,24500.53763215158,24534.668552242234,24531.523515812252,24543.371753939595,24519.67527768491,683,685.8666666666667,67.56545567515974,66.96263953222305,NaN,NaN,NaN,NaN,7.250070279939287,18.912787467821367,-85089,1.0779835510264286,7.318426331050432,6.240442780024003
2025-09-17T03:55:00-04:00,24548.25,24551.25,24547.25,24550,24528.69370879745,NaN,NaN,NaN,NaN,NaN,24524.445,24548.819841533048,24500.07015846695,24534.668552242234,24531.632227768132,24543.526522246473,24519.73793328979,418,691.8666666666667,68.7143627300594,67.48603757986363,NaN,NaN,NaN,NaN,7.017922402800766,19.96036867489936,-84671,0.950081973558424,7.428045246972033,6.477963273413609
2025-09-17T04:00:00-04:00,24550,24550.75,24538.75,24539.5,24528.69370879745,NaN,NaN,NaN,NaN,NaN,24524.88,24549.536082413833,24500.22391758617,24534.668552242234,24531.887374423088,24543.767367620152,24520.007381226023,1587,734.9,54.232631139719466,66.81113066445504,NaN,NaN,NaN,NaN,7.373785088314997,19.02381689652439,-86258,0.09096705096297786,6.591672087117331,6.500705036154353
2025-09-17T04:05:00-04:00,24539.25,24542,24531.5,24541,24528.69370879745,NaN,NaN,NaN,NaN,NaN,24525.33,24550.32288698096,24500.337113019043,24534.668552242234,24532.01543269741,24543.807111941,24520.22375345382,1472,769.7333333333333,55.66996510128171,66.16714679270618,NaN,NaN,NaN,NaN,7.597086153435354,18.360811091031522,-84786,-0.41581737303765376,5.980933319857286,6.39675069289494
2025-09-17T04:10:00-04:00,24540.75,24541.5,24527.25,24527.75,NaN,NaN,NaN,24557.153176838354,24557.153176838354,24557.153176838354,24525.54,24550.434047484465,24500.645952515537,24534.668552242234,24532.017399380096,24543.73216934937,24520.302629410824,951,778.1333333333333,42.864194653384615,64.43366587614199,NaN,NaN,NaN,NaN,8.072294285332829,18.320696689595536,-85737,-1.6155641987731872,4.377295444428455,5.992859643201642
2025-09-17T04:15:00-04:00,24528,24531,24520.75,24526.25,NaN,NaN,NaN,24549.01553243661,NaN,NaN,24525.695,24550.50815981855,24500.88184018145,24534.668552242234,24531.903890960966,24543.53648511169,24520.271296810242,1406,813.0333333333333,41.69489004704218,62.500111583182914,NaN,NaN,NaN,NaN,8.227844693523341,19.036096249929294,-87143,-2.4332139744494174,2.951342175139871,5.384556149589288
2025-09-17T04:20:00-04:00,24526.5,24529.5,24522.75,24525.75,NaN,NaN,NaN,24549.01553243661,NaN,NaN,24525.94,24550.507368614548,24501.37263138545,24534.49943899842,24531.84011170095,24543.42578834783,24520.254435054067,814,829.3666666666667,41.29054969458247,61.0725561668818,NaN,NaN,NaN,NaN,8.122284358271674,19.70039584166778,-87957,-2.899146718603289,1.7606227513351769,4.659769469938466
2025-09-17T04:25:00-04:00,24525.5,24530.5,24522.75,24527,NaN,NaN,NaN,24549.01553243661,NaN,NaN,24526.2,24550.53043361287,24501.869566387133,24534.49943899842,24531.796046688065,24543.341099688263,24520.250993687867,658,844.9666666666667,42.78438766679816,59.46137294251015,NaN,NaN,NaN,NaN,8.095692618395125,20.112270612121943,-87299,-3.0019164234348508,0.9073739406449022,3.909290364079753
2025-09-17T04:30:00-04:00,24527.75,24529,24501.25,24501.25,NaN,NaN,NaN,24540.882815636312,NaN,NaN,24525.99,24550.98779189849,24500.992208101514,24534.49943899842,24530.9032308552,24542.982825110237,24518.823636600166,3326,917.0666666666667,27.347380232130902,56.388635415661085,NaN,NaN,NaN,NaN,9.499571717081187,22.310788150515055,-90625,-4.587910161431036,-1.8255973377090413,2.7623128237219943
2025-09-17T04:35:00-04:00,24501,24504.75,24470.5,24487.25,NaN,NaN,NaN,24516.882460380115,NaN,NaN,24525.49,24552.487214668152,24498.49278533185,24534.49943899842,24526.241147339326,24543.872303882104,24508.609990796547,9547,1220.1,22.577666340855927,52.689350789044724,NaN,NaN,NaN,NaN,11.26745945157539,25.560474681869433,-100172,-6.260105250959961,-5.062818739977956,1.1972865109820041
2025-09-17T04:40:00-04:00,24487,24489.5,24456,24485.75,NaN,NaN,NaN,24505.245757635566,NaN,NaN,24524.97,24553.93560719385,24496.004392806153,24534.449551198737,24523.40742488178,24544.003729898974,24502.81111986459,5437,1369.5666666666666,22.13226615805368,48.76921916614917,NaN,NaN,NaN,NaN,12.855498062177148,28.92037957260291,-105609,-7.086681603992526,-7.661065494008653,-0.5743838900161273
2025-09-17T04:45:00-04:00,24485.5,24508.5,24479.75,24500,24459.185867711505,24459.185867711505,24459.185867711505,NaN,NaN,NaN,24524.585,24554.345310814526,24494.824689185472,24531.30964095899,24522.465890012692,24543.30888656205,24501.622893463336,3366,1466.6666666666667,35.208875423187536,46.65079601851765,NaN,NaN,NaN,NaN,13.990819629164495,29.899957976635168,-102243,-6.3186298310727995,-8.472671178857127,-2.154041347784327
2025-09-17T04:50:00-04:00,24500,24519.75,24499.5,24510,24473.51264645189,NaN,NaN,NaN,NaN,NaN,24524.41,24554.407459892183,24494.412540107816,24521.19771276719,24522.17735513046,24542.869349116358,24501.485361144565,2268,1520.5,42.505674886043636,45.01423648758022,NaN,NaN,NaN,NaN,14.437903941367031,29.794128428068174,-99975,-4.848182220681953,-8.214269123636768,-3.366086902954815
2025-09-17T04:55:00-04:00,24509.25,24514.5,24505.75,24513,24474.460935249535,NaN,NaN,NaN,NaN,NaN,24524.35,24554.426402720892,24494.273597279105,24517.733170213753,24522.072250630936,24542.694016687426,24501.450484574445,956,1529.4333333333334,44.52416523269707,43.50803321292833,NaN,NaN,NaN,NaN,14.031625088412243,29.695858132970248,-99019,-3.4502434593251943,-7.678891227111308,-4.228647767786113
2025-09-17T05:00:00-04:00,24513.5,24519,24509.75,24518.5,24479.070665465464,NaN,NaN,NaN,NaN,NaN,24524.375,24554.42982490415,24494.32017509585,24508.476383149442,24521.988845914377,24542.486833237122,24501.49085859163,1349,1552.3333333333333,48.12021723449146,42.11908761002345,NaN,NaN,NaN,NaN,13.690080439239939,29.199233581698397,-97670,-2.0036261373680766,-6.733180439496209,-4.7295543021281325
2025-09-17T05:05:00-04:00,24518.25,24533,24517.75,24522.5,24489.59586248976,NaN,NaN,NaN,NaN,NaN,24524.45,24554.466995185743,24494.43300481426,24508.476383149442,24522.034665719988,24542.340991947218,24501.728339492758,1967,1601.5,50.62687321498835,40.82712407323266,NaN,NaN,NaN,NaN,13.801503265008515,27.60735281692119,-95703,-0.6934919335938421,-5.596419219120435,-4.902927285526593
2025-09-17T05:10:00-04:00,24522.25,24524.25,24515.5,24517.5,24489.59586248976,NaN,NaN,NaN,NaN,NaN,24524.4,24554.45478331251,24494.345216687492,24508.476383149442,24522.009175766336,24542.229465648506,24501.788885884165,908,1614.1,47.53511294518752,40.34872991648037,NaN,NaN,NaN,NaN,13.440681603222192,26.274356414875356,-96611,-0.11036046999746141,-5.040877873023419,-4.9305174030259575
2025-09-17T05:15:00-04:00,24517.5,24521,24510.75,24516,24489.59586248976,NaN,NaN,NaN,NaN,NaN,24524.21,24554.35454511479,24494.065454885207,24497.50610651955,24521.950122141527,24542.08102899089,24501.819215292162,1029,1635.4,46.615383883493955,39.701974115209815,NaN,NaN,NaN,NaN,13.212775774420606,25.344162569301133,-97640,0.21014440273208823,-4.6678368996108475,-4.877981302342936
2025-09-17T05:20:00-04:00,24516,24522.5,24515.75,24519.5,24489.59586248976,NaN,NaN,NaN,NaN,NaN,24524.215,24554.35633540731,24494.07366459269,24491.22039582997,24521.930352957308,24541.988750208206,24501.87195570641,783,1633.5333333333333,49.09055490291536,40.14671413303345,NaN,NaN,NaN,NaN,12.751148933390564,24.352365225104208,-96857,0.6678479786816558,-4.043171328990866,-4.7110193076725215
2025-09-17T05:25:00-04:00,24519,24526,24518.75,24522.75,24489.59586248976,NaN,NaN,NaN,NaN,NaN,24524.515,24554.291233815045,24494.738766184953,24497.042074131954,24521.934556350687,24541.918871150556,24501.950241550818,795,1642.5333333333333,51.346374152861685,40.8361058548777,NaN,NaN,NaN,NaN,12.358209723862666,23.12686066296175,-96062,1.1700748894677808,-3.2484256958377955,-4.418500585305576
2025-09-17T05:30:00-04:00,24523.5,24528,24520.75,24525.75,24491.043829471197,NaN,NaN,NaN,NaN,NaN,24524.8,24554.344373412925,24495.255626587073,24501.208659305565,24521.954038671927,24541.8724923726,24502.035584971254,729,1620.3,53.399063174577634,41.700999674877366,NaN,NaN,NaN,NaN,11.99333760072962,21.812791636948198,-95333,1.6552593461023521,-2.3494264026776364,-4.0046857487799885
2025-09-17T05:35:00-04:00,24525.25,24528.25,24523.75,24526,24493.570246313415,NaN,NaN,NaN,NaN,NaN,24525.1,24554.38122265793,24495.81877734207,24504.56692744445,24521.969311498695,24541.851683410518,24502.086939586872,411,1597.5333333333333,53.57484128155705,42.471746361645856,NaN,NaN,NaN,NaN,11.458099200677504,20.569495547682184,-94922,1.9250565053287096,-1.5983651171191013,-3.523421622447811
2025-09-17T05:40:00-04:00,24526.5,24529,24516.5,24517,24493.570246313415,NaN,NaN,NaN,NaN,NaN,24525.22,24554.317704371788,24496.122295628214,24504.56692744445,24521.96295163117,24541.78977004679,24502.136133215547,613,1593.2333333333333,46.73975843046797,43.85691623295565,NaN,NaN,NaN,NaN,11.532520686343398,20.01532375346217,-95535,1.4510088828877978,-1.7096605188380636,-3.1606694017258614
2025-09-17T05:45:00-04:00,24516.5,24524.25,24515,24516.5,24493.570246313415,NaN,NaN,NaN,NaN,NaN,24525.31,24554.271104946925,24496.348895053077,24504.56692744445,24521.940081157736,24541.70164241493,24502.178519900543,746,1605,46.38569656672989,45.55748982051807,NaN,NaN,NaN,NaN,11.369483494461727,19.620389642792787,-96281,1.0747271213603367,-1.8172605000254407,-2.8919876213857774
2025-09-17T05:50:00-04:00,24516.75,24518,24506.75,24514.75,24493.570246313415,NaN,NaN,NaN,NaN,NaN,24525.31,24554.271104946925,24496.348895053077,24504.56692744445,24521.845216837308,24541.52058262702,24502.169851047594,1205,1610.4333333333334,45.09803124870849,47.197901612707696,NaN,NaN,NaN,NaN,11.360948959143032,19.8777478105755,-97486,0.6972268188502628,-2.020454097822949,-2.7176809166732117
2025-09-17T05:55:00-04:00,24514.5,24518.5,24508.25,24511.75,24493.570246313415,NaN,NaN,NaN,NaN,NaN,24525.215,24554.321873761604,24496.108126238396,24504.56692744445,24521.797117424278,24541.43088893366,24502.163345914894,598,1596.3666666666666,42.89946921476522,47.74722974067753,NaN,NaN,NaN,NaN,11.281595462061388,20.05841720635462,-98084,0.2573907473816761,-2.3959424824461166,-2.6533332298277927
2025-09-17T06:00:00-04:00,24511.75,24520.5,24508.25,24514.25,24493.570246313415,NaN,NaN,NaN,NaN,NaN,24525.17,24554.33752304364,24496.002476956357,24504.56692744445,24521.749854404094,24541.330316584103,24502.169392224085,714,1580.4666666666667,45.29293906759317,47.94632003935964,NaN,NaN,NaN,NaN,11.35076721477129,19.983603180995964,-97370,0.15195126265178827,-2.4633941515130573,-2.6153454141648456
2025-09-17T06:05:00-04:00,24515,24516.25,24510.25,24515.5,24493.570246313415,NaN,NaN,NaN,NaN,NaN,24525.115,24554.34481525136,24495.885184748644,24504.56692744445,24521.713256539268,24541.254654851866,24502.17185822667,535,1566.5333333333333,46.5004542463662,48.087483540336,NaN,NaN,NaN,NaN,10.96856955657334,19.9141330145915,-96835,0.1815139847377476,-2.388452933242661,-2.5699669179804085
2025-09-17T06:10:00-04:00,24515.5,24516.25,24503.75,24504,24493.570246313415,NaN,NaN,NaN,NaN,NaN,24524.855,24554.595727967226,24495.114272032773,24504.56692744445,24521.585424755445,24541.080122210515,24502.090727300376,1066,1579,38.15621081529189,47.375768796107465,NaN,NaN,NaN,NaN,11.077957445389531,20.397307868268495,-97901,-0.519945172875953,-3.21989838407535,-2.699953211199397
2025-09-17T06:15:00-04:00,24504.25,24511.5,24501,24506.75,24493.570246313415,NaN,NaN,NaN,NaN,NaN,24524.67,24554.74198697168,24494.598013028317,24504.56692744445,24521.40287389092,24540.850374567584,24501.955373214252,1393,1591,40.8878664046122,46.68012545250917,NaN,NaN,NaN,NaN,11.03667477071885,21.06253976890875,-96508,-0.7322362646686909,-3.6152485420352605,-2.8830122773665696
2025-09-17T06:20:00-04:00,24507,24510.5,24502.25,24502.5,24493.570246313415,NaN,NaN,NaN,NaN,NaN,24524.29,24554.986312480047,24493.593687519955,24504.56692744445,24521.304077146342,24540.733905377023,24501.87424891566,705,1591.7333333333333,38.087870101762405,46.00532239226452,NaN,NaN,NaN,NaN,10.837626572810361,21.680255105217555,-97213,-1.0718523718929576,-4.2228277422327665,-3.150975370339809
2025-09-17T06:25:00-04:00,24502.75,24504.75,24498,24501.5,24493.570246313415,NaN,NaN,NaN,NaN,NaN,24523.995,24555.272706124608,24492.71729387539,24503.80354195556,24521.1562682895,24540.58897501588,24501.723561563118,872,1606.8666666666666,37.438228170040105,45.349811269874955,NaN,NaN,NaN,NaN,10.545653246181049,22.60028986891078,-98085,-1.2636197187934828,-4.730500018831663,-3.46688030003818
2025-09-17T06:30:00-04:00,24501.75,24505.5,24495.5,24501.5,24493.570246313415,NaN,NaN,NaN,NaN,NaN,24523.5,24555.39655153565,24491.60344846435,24499.46783356445,24520.921022184782,24540.362843652136,24501.47920071743,1374,1599.7666666666667,37.43822817004011,44.517502217526726,NaN,NaN,NaN,NaN,10.506678014310975,23.65037224048257,-98085,-1.2859678570621136,-5.074340121365822,-3.788372264303708
2025-09-17T06:35:00-04:00,24500.5,24504.75,24490,24503.25,NaN,NaN,NaN,24529.213184499455,24529.213184499455,24529.213184499455,24523.05,24555.437960726464,24490.662039273535,24493.986530784998,24520.55628071338,24540.03290666609,24501.07965476067,2040,1618.7,39.5314922837715,43.67358208402028,NaN,NaN,NaN,NaN,10.80977244186019,25.029719873709272,-96045,-1.0863438986663674,-5.146302137636667,-4.0599582389702995
2025-09-17T06:40:00-04:00,24504,24508,24498.25,24499.25,NaN,NaN,NaN,24529.213184499455,NaN,NaN,24522.57,24555.636151876985,24489.503848123015,24493.986530784998,24520.326532504365,24539.792731192574,24500.860333816156,1500,1637,36.52338938903859,42.46817681362463,NaN,NaN,NaN,NaN,10.734074410298748,25.755813167985202,-97545,-1.122532317620923,-5.463123635996453,-4.34059131837553
2025-09-17T06:45:00-04:00,24499.25,24506.5,24499.25,24500,NaN,NaN,NaN,24529.213184499455,NaN,NaN,24522.005,24555.624412542915,24488.385587457087,24493.986530784998,24520.217690518595,24539.67750811928,24500.75787291791,727,1614.3666666666666,37.48395477066126,41.31882777713208,NaN,NaN,NaN,NaN,10.485211952420267,26.430042655527142,-96818,-0.9989339281823391,-5.589258728603454,-4.590324800421115
2025-09-17T06:50:00-04:00,24500,24502.5,24494.5,24502,NaN,NaN,NaN,24529.213184499455,NaN,NaN,24521.465,24555.48264395053,24487.44735604947,24492.039224628,24520.02678389193,24539.496083613885,24500.557484169978,1153,1625.6666666666667,40.08760877377066,40.843674230225126,NaN,NaN,NaN,NaN,10.307696812961677,27.44641061876371,-95665,-0.6996146423774459,-5.464843103392923,-4.765228461015477
2025-09-17T06:55:00-04:00,24502.25,24502.25,24492.25,24500.25,NaN,NaN,NaN,24528.144409149132,NaN,NaN,24520.895,24555.357456385405,24486.432543614595,24490.631379702398,24519.824802578714,24539.31571296491,24500.333892192517,1162,1642.4666666666667,38.57378015445597,40.28568020077699,NaN,NaN,NaN,NaN,10.2857184691787,28.564974426889115,-96827,-0.5435693906069714,-5.444690199274191,-4.90112080866722
2025-09-17T07:00:00-04:00,24500.5,24504.75,24491.75,24494.25,NaN,NaN,NaN,24528.144409149132,NaN,NaN,24520.16,24555.290152287118,24485.02984771288,24485.779083009536,24519.36150887373,24538.921957248163,24499.8010604993,2586,1617.8,33.85349765894786,39.482499230079796,NaN,NaN,NaN,NaN,10.479595721380221,29.12296235448646,-99413,-0.7554918442703489,-5.845485614005156,-5.089993769734807
2025-09-17T07:05:00-04:00,24493.5,24504.25,24486.75,24503,NaN,NaN,NaN,24527.728170319766,NaN,NaN,24519.58,24554.86632029076,24484.293679709244,24485.779083009536,24519.06676397469,24538.65097227384,24499.48255567554,1789,1359.2,44.51653337459112,39.5980038129245,NaN,NaN,NaN,NaN,10.981053169853064,30.059046501376198,-97624,-0.24390754173013818,-5.39487819689748,-5.150970655167342
2025-09-17T07:10:00-04:00,24503.5,24519.5,24502.5,24514.75,NaN,NaN,NaN,24527.728170319766,NaN,NaN,24519.185,24554.235793140055,24484.134206859948,24487.68292451797,24518.963771528695,24538.41725124328,24499.51029181411,1989,1244.2666666666667,55.005797761067356,40.29177943388694,NaN,NaN,NaN,NaN,11.410977943434988,28.571355491280855,-95635,0.8863475905305336,-4.043036167004175,-4.929383757534708
2025-09-17T07:15:00-04:00,24514.75,24516.25,24506.25,24507.75,NaN,NaN,NaN,24527.728170319766,NaN,NaN,24518.615,24553.463559505242,24483.76644049476,24487.68292451797,24518.892506398613,24538.283966181494,24499.501046615733,1065,1167.5666666666666,49.05580169771107,40.474304251840145,NaN,NaN,NaN,NaN,11.310193804618203,27.189928124763746,-96700,1.1465224094918538,-3.496230745669891,-4.642753155161745
2025-09-17T07:20:00-04:00,24507,24516,24506.5,24513,NaN,NaN,NaN,24527.728170319766,NaN,NaN,24518.23,24552.892348452326,24483.567651547673,24487.68292451797,24518.852363202717,24538.19589253447,24499.508833870965,759,1117.2666666666667,53.14908873287187,41.545224103095855,NaN,NaN,NaN,NaN,11.180894247145474,25.90717414156929,-95941,1.6268621756826542,-2.609175435558427,-4.236037611241081
2025-09-17T07:25:00-04:00,24512.75,24514.25,24504.25,24507.25,NaN,NaN,NaN,24527.728170319766,NaN,NaN,24517.65,24552.056394750307,24483.243605249696,24487.68292451797,24518.785859882883,24538.084239371725,24499.48748039404,870,1114.4,48.54817973419063,42.092389340922885,NaN,NaN,NaN,NaN,11.096544658063655,24.98186042546798,-96811,1.5143146112532415,-2.3431443471745297,-3.857458958427771
2025-09-17T07:30:00-04:00,24507,24508.25,24498,24498.25,NaN,NaN,NaN,24527.728170319766,NaN,NaN,24516.77,24550.863964272725,24482.676035727276,24487.68292451797,24518.66130818214,24537.94553563878,24499.377080725502,975,1101.9333333333334,42.36621113144773,42.397985128757554,NaN,NaN,NaN,NaN,11.036077182487679,24.801903415010155,-97786,0.82519784671315,-2.8259616500363336,-3.6511594967494836
2025-09-17T07:35:00-04:00,24498.25,24498.5,24487,24492,NaN,NaN,NaN,24525.36973264904,NaN,NaN,24515.645,24549.21791914115,24482.072080858852,24487.68292451797,24518.23042365346,24537.642875129983,24498.817972176934,2266,1111.9,38.68246125416978,42.486858920481104,NaN,NaN,NaN,NaN,11.069214526595701,25.584883138456433,-100052,-0.015558900264422526,-3.6706081220800115,-3.655049221815589
2025-09-17T07:40:00-04:00,24492.25,24496.25,24489.75,24490,NaN,NaN,NaN,24525.023381164992,NaN,NaN,24514.385,24546.969844643616,24481.80015535638,24487.68292451797,24518.031189438858,24537.503406775635,24498.55897210208,1053,1116.7333333333333,37.55708676161534,42.49534881987933,NaN,NaN,NaN,NaN,10.742842060410295,26.311935738799402,-101105,-0.6360262594099475,-4.450082046078023,-3.8140557866680758
2025-09-17T07:45:00-04:00,24490,24502.75,24489.75,24502,NaN,NaN,NaN,24525.023381164992,NaN,NaN,24513.525,24545.086091544577,24481.963908455426,24487.68292451797,24517.845099265185,24537.32013932167,24498.3700592087,1311,1126.1333333333334,47.43787930606633,43.06009075004325,NaN,NaN,NaN,NaN,10.904067627523846,25.966936262152768,-99794,-0.19099764779101802,-4.052802846406848,-3.8618051986158304
2025-09-17T07:50:00-04:00,24502,24508.5,24500.5,24506.5,NaN,NaN,NaN,24525.023381164992,NaN,NaN,24512.74,24542.98085977094,24482.49914022906,24487.68292451797,24517.775094986333,24537.219005101553,24498.331184871113,777,1125.9333333333334,50.595029342056996,44.06520788954457,NaN,NaN,NaN,NaN,10.696634225557856,24.856190611576853,-99017,0.4203369046648082,-3.33638406778482,-3.7567209724496284
2025-09-17T07:55:00-04:00,24505.5,24506.25,24498.75,24501.75,NaN,NaN,NaN,24525.023381164992,NaN,NaN,24511.855,24540.708784851045,24483.001215148954,24487.68292451797,24517.65033565484,24537.06550623981,24498.235165069866,1140,1137.4333333333334,47.36124376130696,44.770728531733546,NaN,NaN,NaN,NaN,10.486160352303724,24.010280617586623,-100157,0.5125902083835743,-3.1159832119701605,-3.6285734203537348
2025-09-17T08:00:00-04:00,24502.5,24509.25,24498.75,24503.75,NaN,NaN,NaN,24525.023381164992,NaN,NaN,24510.96,24537.925971157085,24483.994028842913,24486.8870716915,24517.505028630414,24536.8682691246,24498.14178813623,1517,1163.7,48.843838276649876,45.39617349622491,NaN,NaN,NaN,NaN,10.487148898567742,22.81471713816776,-98640,0.704258305048179,-2.748250539043511,-3.45250884409169
2025-09-17T08:05:00-04:00,24503.5,24505.75,24500.75,24502,NaN,NaN,NaN,24525.023381164992,NaN,NaN,24510,24534.65704766979,24485.34295233021,24486.8870716915,24517.4612608478,24536.812147880486,24498.11037381511,429,1164.3,47.5810132145287,46.03954728623012,NaN,NaN,NaN,NaN,10.09520969152719,21.704551050135958,-99069,0.7072687231515666,-2.5684229401522316,-3.2756916633037982
2025-09-17T08:10:00-04:00,24502,24509.5,24498.25,24508.75,NaN,NaN,NaN,24525.023381164992,NaN,NaN,24509.385,24532.557442696136,24486.21255730386,24486.047951765606,24517.356961667574,24536.655363965587,24498.05855936956,1265,1186.0333333333333,52.664596031450884,47.383197169980335,NaN,NaN,NaN,NaN,10.177694713560962,20.16035155204485,-97804,1.1327124861123101,-1.8598010556634108,-2.992513541775721
2025-09-17T08:15:00-04:00,24508,24512.25,24504,24512.25,NaN,NaN,NaN,24525.023381164992,NaN,NaN,24508.81,24530.172013011404,24487.447986988598,24489.363361412485,24517.310017472337,24536.560206082184,24498.05982886249,872,1190.2333333333333,55.09630881703662,48.13889541586929,NaN,NaN,NaN,NaN,10.040002234020893,19.093189316910937,-96932,1.5906377323841632,-1.004216376295517,-2.59485410867968
2025-09-17T08:20:00-04:00,24512.25,24515,24508.75,24513.75,NaN,NaN,NaN,24525.023381164992,NaN,NaN,24508.53,24529.24898647536,24487.81101352464,24493.565689129988,24517.282067875585,24536.479727797057,24498.084407954113,853,1178.5,56.1363226758722,48.21964719549821,NaN,NaN,NaN,NaN,9.769287788733687,18.457259402277455,-96079,1.9136558322466128,-0.20278431837141397,-2.116440150618027
2025-09-17T08:25:00-04:00,24513.5,24519,24512.75,24516.25,NaN,NaN,NaN,24525.023381164992,NaN,NaN,24508.33,24528.5479227421,24488.112077257905,24498.72755130399,24517.269939271257,24536.376979727313,24498.1628988152,1402,1205.3,57.8870022869928,48.85044723758976,NaN,NaN,NaN,NaN,9.517910089538422,18.35368908092971,-94677,2.1946396588497077,0.6268594229441078,-1.5677802359056
2025-09-17T08:30:00-04:00,24516.5,24525.25,24516,24517,24491.105778028472,24491.105778028472,24491.105778028472,NaN,NaN,NaN,24508.155,24527.913008504176,24488.39699149582,24504.407041043192,24517.299820793298,24536.275081188327,24498.32456039827,2092,1251.2333333333333,58.42311916347228,49.22716369691836,NaN,NaN,NaN,NaN,9.498773654571393,18.928928504382313,-92585,2.3178646414275916,1.3295505658788898,-0.988314075548702
2025-09-17T08:35:00-04:00,24516.75,24523,24516,24518.5,24491.105778028472,NaN,NaN,NaN,NaN,NaN,24507.985,24527.231145060592,24488.73885493941,24504.407041043192,24517.31126489837,24536.228836200473,24498.393693596267,927,1264.3,59.53270816261822,50.01177287037748,NaN,NaN,NaN,NaN,9.320289822102009,19.463079397588302,-91658,2.378330145150893,1.9845986058899143,-0.3937315392609787
2025-09-17T08:40:00-04:00,24518.75,24521.5,24511.75,24512.5,24491.105778028472,NaN,NaN,NaN,NaN,NaN,24508.21,24527.398892624606,24489.021107375393,24504.407041043192,24517.29184817379,24536.12116149205,24498.46253485553,1438,1276.7,53.394375466567894,50.79949889431463,NaN,NaN,NaN,NaN,9.35098340623758,19.218717393799214,-93096,1.912236347639983,1.9965638952890004,0.08432754764901718
2025-09-17T08:45:00-04:00,24513,24518,24507.75,24515,24491.105778028472,NaN,NaN,NaN,NaN,NaN,24508.765,24527.082316938537,24490.447683061462,24504.407041043192,24517.233481949046,24535.919737123386,24498.547226774706,2441,1311.6333333333334,55.45530986533427,51.99755950939782,NaN,NaN,NaN,NaN,9.41519887722061,18.355791621950868,-90655,1.6786305573231008,2.1826157443028933,0.5039851869797924
2025-09-17T08:50:00-04:00,24514.25,24520.5,24511.25,24520.5,24491.105778028472,NaN,NaN,NaN,NaN,NaN,24509.46,24526.844866986536,24492.075133013463,24504.407041043192,24517.235190259627,24535.834119243307,24498.636261275948,1460,1336.8,59.679637798245174,53.57774172629995,NaN,NaN,NaN,NaN,9.403398957419139,17.880256149841948,-89195,1.7906168002786993,2.7422561873281666,0.9516393870494673
2025-09-17T08:55:00-04:00,24520.75,24525.75,24518.75,24524.75,24493.475935520204,NaN,NaN,NaN,NaN,NaN,24509.955,24527.641065130367,24492.268934869637,24504.510579209033,24517.30275915263,24535.804489272137,24498.801029033122,1830,1368.7333333333333,62.62886917795923,54.66281243143515,NaN,NaN,NaN,NaN,9.23172760331777,18.069183216364806,-87365,2.029489672889384,3.488501478161197,1.4590118052718133
2025-09-17T09:00:00-04:00,24524.75,24528.5,24521,24524,24496.261120269286,NaN,NaN,NaN,NaN,NaN,24510.235,24528.353060039582,24492.11693996042,24507.758463367227,24517.39064533363,24535.796046796517,24498.985243870746,1958,1388.2,61.770210585864824,55.46103966313571,NaN,NaN,NaN,NaN,9.108032774509358,18.547638953130924,-89323,2.0116565794896366,3.973582529633859,1.9619259501442223
2025-09-17T09:05:00-04:00,24524.5,24528.25,24519.5,24521,24496.261120269286,NaN,NaN,NaN,NaN,NaN,24510.395,24528.74768100206,24492.04231899794,24507.758463367227,24517.45192287925,24535.76413748429,24499.139708274208,1798,1380.1333333333334,58.325527296117784,56.24420277276505,NaN,NaN,NaN,NaN,9.082459004901546,18.720972860037925,-91121,1.6856852841861478,4.069032555376907,2.3833472711907593
2025-09-17T09:10:00-04:00,24520.75,24524,24519.75,24521.25,24496.261120269286,NaN,NaN,NaN,NaN,NaN,24510.45,24528.915643774835,24491.984356225166,24507.758463367227,24517.478655852363,24535.73576978419,24499.221541920535,1035,1364.6333333333334,58.533054816172914,56.93628966844526,NaN,NaN,NaN,NaN,8.737283361694292,18.88192577359443,-90086,1.3872322771680485,4.11738761765082,2.7301553404827716
2025-09-17T09:15:00-04:00,24521.5,24523.75,24516.5,24520.25,24496.261120269286,NaN,NaN,NaN,NaN,NaN,24510.405,24528.76361922636,24492.046380773638,24507.758463367227,24517.509288036672,24535.664318149396,24499.354257923947,1881,1403.1,57.303822829240254,57.63077606949609,NaN,NaN,NaN,NaN,8.631048835858985,18.418094370925033,-91967,1.038738737188722,4.028578761968674,2.9898400247799524
2025-09-17T09:20:00-04:00,24520.5,24521.5,24512.5,24518.5,24496.261120269286,NaN,NaN,NaN,NaN,NaN,24510.425,24528.816642125086,24492.033357874912,24507.758463367227,24517.509148148587,24535.526942211036,24499.491354086138,2524,1448.8,55.12218904291173,57.80631842745758,NaN,NaN,NaN,NaN,8.657402490440486,17.29714201403631,-94491,0.6269186242544373,3.773488305097999,3.1465696808435615
2025-09-17T09:25:00-04:00,24519,24531.75,24516.75,24521.25,24496.261120269286,NaN,NaN,NaN,NaN,NaN,24510.53,24529.106770447546,24491.95322955245,24508.653413276174,24517.664432420086,24535.461259208812,24499.86760563136,4659,1565.3666666666666,57.838583157739464,58.00219516607921,NaN,NaN,NaN,NaN,9.110445169694737,17.588763081218488,-89832,0.4827455458763046,3.7500016131889424,3.267256067312638
2025-09-17T09:30:00-04:00,24521,24540.75,24496,24501.5,NaN,NaN,NaN,24542.08565126581,24542.08565126581,24542.08565126581,24510.17,24528.7351393902,24491.604860609797,24508.653413276174,24516.980436915685,24533.579782205066,24500.381091626303,27849,2407.4666666666667,39.39569385824594,56.80643596482019,NaN,NaN,NaN,NaN,11.656127657573686,17.36144681181839,-117681,-0.9231114760681018,2.1133667222275108,3.0364781982956126
2025-09-17T09:35:00-04:00,24501.75,24510.75,24478.25,24481.75,NaN,NaN,NaN,24530.441304247463,NaN,NaN,24509.35,24529.197669896115,24489.502330103882,24508.653413276174,24514.036858895957,24531.791132625498,24496.282585166417,24761,3173.2,29.325438007618104,54.76632423057914,NaN,NaN,NaN,NaN,13.144975682032708,18.456225187709336,-142442,-3.0439662450184874,-0.7684796079774969,2.2754866370409905
2025-09-17T09:40:00-04:00,24481.5,24488,24462,24476,NaN,NaN,NaN,24512.853063145307,NaN,NaN,24508.355,24529.742634280043,24486.967365719956,24508.653413276174,24510.492811970576,24530.764891154704,24490.22073278645,22665,3862.4,27.149534805184317,52.53249677641571,NaN,NaN,NaN,NaN,14.063191704744657,20.309158614000104,-165107,-4.601403930203724,-3.4762682757136645,1.1251356544900595
2025-09-17T09:45:00-04:00,24476.25,24500,24462.75,24496.75,NaN,NaN,NaN,24512.853063145307,NaN,NaN,24507.77,24528.792093141255,24486.747906858745,24508.653413276174,24508.64361877986,24529.14316516605,24488.144072393672,20670,4515.9,43.45473826084166,51.38407035486024,NaN,NaN,NaN,NaN,15.719392297262896,20.776309477401096,-144437,-4.022403623991107,-3.902868875498825,0.1195347484922824
2025-09-17T09:50:00-04:00,24496.5,24520.5,24493,24499.5,24463.661258580414,24463.661258580414,24463.661258580414,NaN,NaN,NaN,24507.42,24528.39842702411,24486.441572975888,24508.653413276174,24508.294036389714,24527.979905663226,24488.608167116203,23671,5279.633333333333,45.20512146599537,50.79912364053364,NaN,NaN,NaN,NaN,16.560864276029832,19.554493293173312,-120766,-3.2742276044668284,-3.973249757091253,-0.6990221526244247
2025-09-17T09:55:00-04:00,24499.5,24506.75,24472.5,24477.75,24463.661258580414,NaN,NaN,NaN,NaN,NaN,24506.645,24529.039662305393,24484.250337694608,24508.653413276174,24506.87262353548,24526.70521481751,24487.04003225345,19563,5902.733333333334,35.77310058676683,49.39325154920739,NaN,NaN,NaN,NaN,17.82437397059913,19.551295373909028,-140329,-4.0153062850763925,-5.718155008969916,-1.702848723893523
2025-09-17T10:00:00-04:00,24477.5,24480.5,24447,24472,NaN,NaN,NaN,24512.03695240917,24512.03695240917,24512.03695240917,24505.79,24530.06681197722,24481.513188022782,24508.653413276174,24503.877142418296,24525.697101704245,24482.057183132347,24958,6702.166666666667,33.767217332536276,47.54236437308533,NaN,NaN,NaN,NaN,18.944061544127766,20.586092237624527,-165287,-4.620738074741929,-7.478771317320934,-2.858033242579005
2025-09-17T10:05:00-04:00,24471,24478.5,24461.25,24465.75,NaN,NaN,NaN,24512.03695240917,NaN,NaN,24504.87,24531.541940316834,24478.198059683164,24508.653413276174,24502.487745063037,24524.951814122287,24480.023676003788,13751,7085,31.687367022603155,45.33225707627418,NaN,NaN,NaN,NaN,18.82305714811864,21.546975039646068,-179038,-5.130788521394452,-9.271518894322071,-4.140730372927619
2025-09-17T10:10:00-04:00,24465.5,24475.5,24460,24474.5,NaN,NaN,NaN,24512.03695240917,NaN,NaN,24504.075,24531.92482046107,24476.22517953893,24508.653413276174,24501.577130780133,24524.364064540405,24478.79019701986,10097,7386.466666666666,37.492126751268245,43.598108230945854,NaN,NaN,NaN,NaN,18.58569592325302,22.487081105661414,-168941,-4.585359040700736,-9.872429173803539,-5.287070133102803
2025-09-17T10:15:00-04:00,24474.5,24480.75,24454.5,24463.75,NaN,NaN,NaN,24512.03695240917,NaN,NaN,24503.04,24532.88918089179,24473.19081910821,24499.897730620938,24500.41026170965,24523.68720878665,24477.13331463265,12335,7753.933333333333,33.703017684990044,41.83935754443673,NaN,NaN,NaN,NaN,19.13314621444923,23.57419757249095,-181276,-4.6409609879150695,-11.08827136799664,-6.4473103800815705
2025-09-17T10:20:00-04:00,24463.75,24473.5,24451.75,24453.5,NaN,NaN,NaN,24512.03695240917,NaN,NaN,24502.03,24534.941341513277,24469.11865848672,24461.81818449675,24499.399685181448,24523.245907584544,24475.553462778353,9456,8043.233333333334,30.534289855286374,39.83944576151625,NaN,NaN,NaN,NaN,19.320064341988573,24.691029917171107,-190732,-5.027876523509193,-12.732156034468062,-7.704279510958869
2025-09-17T10:25:00-04:00,24454,24458.5,24436.25,24440,NaN,NaN,NaN,24498.55888553378,NaN,NaN,24500.695,24537.871106574872,24463.518893425127,24458.476910462337,24497.56933780927,24522.984128044114,24472.154547574424,13280,8447.9,26.94149494548094,37.67070805553345,NaN,NaN,NaN,NaN,19.529345460417964,26.28282267246692,-204012,-5.798118105740526,-14.951927143134526,-9.153809037394
2025-09-17T10:30:00-04:00,24440.25,24459.75,24434.5,24448.25,NaN,NaN,NaN,24498.55888553378,NaN,NaN,24499.61,24539.57412890864,24459.64587109136,24458.476910462337,24495.98644101152,24522.4862652672,24469.486616755836,12905,8827.5,32.19232900992584,36.032860910320174,NaN,NaN,NaN,NaN,19.93796364181668,27.818848126614803,-191107,-5.366994419202284,-15.862552061396855,-10.495557642194571
2025-09-17T10:35:00-04:00,24448.25,24449.75,24431,24443.25,NaN,NaN,NaN,24492.855048595862,NaN,NaN,24498.445,24541.404665965376,24455.485334034624,24458.476910462337,24494.479687627794,24522.10139612471,24466.857979130877,11573,9198.966666666667,30.749876169926907,34.09795326833357,NaN,NaN,NaN,NaN,19.85310909597263,29.3641070900659,-202680,-5.038830052233106,-16.794095207485952,-11.755265155252847
2025-09-17T10:40:00-04:00,24443,24449.25,24423.75,24425.25,NaN,NaN,NaN,24490.071864568778,NaN,NaN,24496.92,24544.502395911237,24449.33760408876,24440.006528369868,24492.690789681667,24521.812543430777,24463.569035932556,12528,9574.4,26.198766921279372,33.15531562997881,NaN,NaN,NaN,NaN,20.2564584462603,31.038813262696056,-215208,-5.610546627184849,-18.768448439233907,-13.157901812049058
2025-09-17T10:45:00-04:00,24424.75,24435,24416,24429.25,NaN,NaN,NaN,24479.22768890656,NaN,NaN,24495.44,24546.61084717162,24444.269152828376,24419.9908740203,24490.943204473424,24521.56645746352,24460.31995148333,11769,9937.633333333333,28.72337061485399,33.11231081620995,NaN,NaN,NaN,NaN,20.166711414384565,32.833333231977804,-203439,-5.29954464071864,-19.782332612947357,-14.482787972228717
2025-09-17T10:50:00-04:00,24429,24432,24409.75,24430,NaN,NaN,NaN,24475.194612138082,NaN,NaN,24494.055,24548.389270034313,24439.720729965687,24419.9908740203,24489.215428359774,24521.253398851746,24457.1774578678,11750,10300.866666666667,29.212330426851665,33.259653360614756,NaN,NaN,NaN,NaN,20.315517741928524,34.68162360331526,-191689,-4.6469036722789525,-20.291417562577408,-15.644513890298455
2025-09-17T10:55:00-04:00,24429.75,24436.5,24417.5,24420.25,NaN,NaN,NaN,24475.194612138082,NaN,NaN,24492.46,24550.554609045415,24434.365390954583,24419.9908740203,24487.955136050543,24520.909982003835,24455.00029009725,9089,10557.1,26.65260323810051,32.05950085899038,NaN,NaN,NaN,NaN,20.22155218893363,35.90914675027639,-200778,-4.473836763230576,-21.236809844336676,-16.7629730811061
2025-09-17T11:00:00-04:00,24420.25,24425.75,24408.5,24411.75,NaN,NaN,NaN,24471.444109406806,NaN,NaN,24490.655,24552.91091457948,24428.39908542052,24419.9908740203,24486.80582775354,24520.731901584506,24452.87975392257,7476,10736.566666666668,24.62663969158885,30.589609303675633,NaN,NaN,NaN,NaN,20.009298461152657,37.34111887537366,-208254,-4.520461178349624,-22.41354955404313,-17.893088375693505
2025-09-17T11:05:00-04:00,24411.75,24417.75,24403.5,24416.25,NaN,NaN,NaN,24464.418240797404,NaN,NaN,24488.975,24554.549633054765,24423.400366945232,24414.017699216238,24485.490758300406,24520.513555289603,24450.46796131121,8511,10989.366666666667,27.75749543760942,30.017066078735812,NaN,NaN,NaN,NaN,19.597919999641753,38.82299796535754,-199743,-3.8624070553934224,-22.721097194935282,-18.85869013954186
2025-09-17T11:10:00-04:00,24416.25,24433.25,24407.25,24432,NaN,NaN,NaN,24464.418240797404,NaN,NaN,24487.73,24555.193311513754,24420.266688486245,24400.156327498393,24484.456466659853,24520.069186036537,24448.84374728317,8250,11216.433333333332,37.537075805243404,30.286341683929177,NaN,NaN,NaN,NaN,20.055211428238774,38.62891235102289,-191493,-2.0704184362585707,-21.446713184865075,-19.376294748606504
2025-09-17T11:15:00-04:00,24431.75,24443,24424.75,24437.5,NaN,NaN,NaN,24464.418240797404,NaN,NaN,24486.42,24555.17772247638,24417.662277523617,24400.156327498393,24483.591715374158,24519.48043621842,24447.702994529896,8720,11425.733333333334,40.56295410612054,30.920312189894705,NaN,NaN,NaN,NaN,19.926267754793148,37.611787932846,-182773,-0.31105279912888406,-19.76511074751761,-19.454057948388726
2025-09-17T11:20:00-04:00,24437.25,24438.75,24422,24423.25,NaN,NaN,NaN,24464.418240797404,NaN,NaN,24484.59,24555.082961352942,24414.097038647058,24392.700061998716,24482.9404241072,24519.11628323609,24446.76456497831,5902,11573.8,35.73307368769069,30.794665542496308,NaN,NaN,NaN,NaN,19.699391486593637,36.804936274925524,-188675,0.07594662282901155,-19.359124669852463,-19.435071292681474
2025-09-17T11:25:00-04:00,24423.5,24425.5,24405.75,24412.75,NaN,NaN,NaN,24464.418240797404,NaN,NaN,24482.69,24555.66112853852,24409.71887146148,24392.22673187366,24481.813997679394,24518.72927388389,24444.898721474896,8451,11794.5,32.64827933067757,30.719327088616843,NaN,NaN,NaN,NaN,19.703006380408375,36.79008787721624,-197126,-0.178370519315056,-19.658034441825293,-19.479663922510237
2025-09-17T11:30:00-04:00,24412.75,24420.5,24408,24415.25,NaN,NaN,NaN,24464.418240797404,NaN,NaN,24480.735,24555.567172892082,24405.90282710792,24392.22673187366,24480.95376050536,24518.402328916844,24443.505192093875,6639,11950.533333333333,34.1068632387946,30.974510901724567,NaN,NaN,NaN,NaN,19.18850592466492,36.77630007934333,-190487,0.008715437481189525,-19.46876962565875,-19.47748506313994
2025-09-17T11:35:00-04:00,24415.5,24423.75,24406.75,24408.5,NaN,NaN,NaN,24464.418240797404,NaN,NaN,24478.76,24555.86667675364,24401.653323246355,24392.22673187366,24480.162354247303,24518.099345985764,24442.22536250884,6114,12094.4,32.0863947032188,31.34200374156299,NaN,NaN,NaN,NaN,19.03218407290314,36.45761846751366,-196601,-0.12767630426407806,-19.63708044347004,-19.509404139205962
2025-09-17T11:40:00-04:00,24408.25,24418.25,24400,24417,NaN,NaN,NaN,24463.11453665584,NaN,NaN,24477.135,24555.936218899868,24398.33378110013,24392.22673187366,24479.07522655854,24517.669736054202,24440.480717062877,8477,12342.466666666667,37.13658903614698,31.69516517200736,NaN,NaN,NaN,NaN,18.976313781981485,36.478492036774476,-188124,0.5138426531733273,-18.867100822739303,-19.38094347591263
2025-09-17T11:45:00-04:00,24416.5,24424,24408.5,24416,NaN,NaN,NaN,24463.11453665584,NaN,NaN,24475.615,24556.124080851496,24395.105919148507,24392.22673187366,24478.21496480533,24517.234765384477,24439.195164226185,7396,12526.3,36.789974676759634,32.126600779638274,NaN,NaN,NaN,NaN,18.728005654697093,35.94400879572723,-195520,1.001872524796159,-18.128602819917432,-19.13047534471359
2025-09-17T11:50:00-04:00,24416,24418.25,24401.25,24403.25,NaN,NaN,NaN,24463.11453665584,NaN,NaN,24473.88,24556.77784315718,24390.982156842823,24392.22673187366,24477.540421238777,24516.976361572586,24438.104480904967,5215,12616,32.6107118333919,32.58459684478917,NaN,NaN,NaN,NaN,18.60457667936159,35.81028264968837,-200735,0.6159740587104707,-18.3605077713255,-18.976481830035972
2025-09-17T11:55:00-04:00,24403.5,24414.75,24402,24411.25,NaN,NaN,NaN,24461.209203509556,NaN,NaN,24472.065,24556.382365354693,24387.747634645304,24392.22673187366,24477.029782060392,24516.75532470205,24437.304239418732,4119,12598,37.41475230909294,33.20540982294909,NaN,NaN,NaN,NaN,18.186392630835762,35.68610837122371,-196616,1.0253562713540596,-17.6947864908434,-18.720142762197458
2025-09-17T12:00:00-04:00,24410.75,24414,24401.5,24401.5,NaN,NaN,NaN,24459.88719425912,NaN,NaN,24469.965,24555.960756291322,24383.969243708678,24392.22673187366,24476.464871621945,24516.53507245804,24436.394670785852,4390,11816.033333333333,34.21354920179637,33.56263973544514,NaN,NaN,NaN,NaN,17.780221728633208,35.59757779615352,-201006,0.7766439871010036,-17.749337778321205,-18.52598176542221
2025-09-17T12:05:00-04:00,24401.25,24411.25,24395.25,24403.5,NaN,NaN,NaN,24455.199139974615,NaN,NaN,24468,24555.47805438993,24380.52194561007,24389.756385498928,24475.697352894815,24516.24745365973,24435.1472521299,5882,11186.733333333334,35.433900781854746,34.18987527428473,NaN,NaN,NaN,NaN,17.653063033730835,35.84826400725819,-195124,0.8765761516347013,-17.43026157587883,-18.306837727513532
2025-09-17T12:10:00-04:00,24403,24405,24392.25,24400.75,NaN,NaN,NaN,24449.95145179395,NaN,NaN,24465.94,24554.7937877652,24377.086212234797,24380.210972400288,24474.955240699346,24515.99730518295,24433.91317621574,5500,10614.566666666668,34.486603446142695,34.894158399610006,NaN,NaN,NaN,NaN,17.302844245607204,36.23522400610602,-200624,0.8846614956109917,-17.20101085799979,-18.085672353610782
2025-09-17T12:15:00-04:00,24401,24407.25,24398.75,24404.75,NaN,NaN,NaN,24449.95145179395,NaN,NaN,24463.995,24553.858089755144,24374.131910244854,24380.210972400288,24474.498142127057,24515.802840582677,24433.193443671436,3648,10047.166666666666,37.11985801056389,35.562898583392474,NaN,NaN,NaN,NaN,16.67406965663526,36.31368721307203,-196976,1.263508093009289,-16.50628723734917,-17.76979533035846
2025-09-17T12:20:00-04:00,24404.75,24416.25,24402.75,24413,NaN,NaN,NaN,24449.95145179395,NaN,NaN,24462.08,24552.12723427056,24372.032765729444,24381.86359131912,24473.99152370419,24515.52005404599,24432.46299336239,4557,9410.033333333333,42.27352561149062,35.90121642669585,NaN,NaN,NaN,NaN,16.447350395447028,35.33630098977872,-192419,2.1232261772651633,-15.115762608777004,-17.238988786042167
2025-09-17T12:25:00-04:00,24413,24421.75,24409.5,24420.25,NaN,NaN,NaN,24449.95145179395,NaN,NaN,24460.24,24549.870238200383,24370.60976179962,24388.115873055296,24473.514564695517,24515.192123342727,24431.837006048307,4860,8919.933333333332,46.42882929598827,36.3202075116864,NaN,NaN,NaN,NaN,16.147539652915096,33.85216697133825,-187559,3.1706204250960113,-13.275713254672155,-16.446333679768166
2025-09-17T12:30:00-04:00,24420.5,24421,24397.25,24398.75,NaN,NaN,NaN,24449.95145179395,NaN,NaN,24457.94,24547.86127445925,24368.018725540747,24388.115873055296,24472.65542593293,24514.757399224767,24430.553452641096,7426,8335.533333333333,37.75050885981885,36.46431002398126,NaN,NaN,NaN,NaN,16.690572534849732,33.30620952608026,-194985,2.438755999104723,-13.397888680887263,-15.836644679991986
2025-09-17T12:35:00-04:00,24398.75,24403.5,24381.5,24381.75,NaN,NaN,NaN,24443.3515669334,NaN,NaN,24455.25,24546.075547068045,24364.424452931955,24388.115873055296,24471.561983378346,24514.454851625716,24428.669115130975,7759,8135.8,32.56703086273424,36.45850656198531,NaN,NaN,NaN,NaN,17.069817353789038,33.63632902427831,-202744,0.9116733178351701,-14.697053032698022,-15.608726350533193
2025-09-17T12:40:00-04:00,24381.75,24396.75,24374.75,24394.75,NaN,NaN,NaN,24437.290132072794,NaN,NaN,24452.805,24543.431391848695,24362.178608151306,24388.115873055296,24470.138989277646,24514.00241540233,24426.27556315296,10389,8145.533333333334,39.41756292772247,36.83784225405158,NaN,NaN,NaN,NaN,17.42197325708982,34.24566160344023,-192355,0.8786674642563561,-14.510392020212748,-15.389059484469104
2025-09-17T12:45:00-04:00,24395,24395.25,24376,24385,NaN,NaN,NaN,24437.290132072794,NaN,NaN,24450.135,24540.728388833373,24359.541611166624,24388.115873055296,24469.286274105274,24513.74020888505,24424.832339325498,6147,7939.266666666666,36.428473295339465,37.14799072491735,NaN,NaN,NaN,NaN,17.55254659586912,34.81147042694773,-198502,0.3299957298428602,-14.976564822165528,-15.306560552008388
2025-09-17T12:50:00-04:00,24385.5,24399.25,24384.5,24394.5,NaN,NaN,NaN,24437.290132072794,NaN,NaN,24447.775,24537.893546925494,24357.65645307451,24388.115873055296,24468.609706101597,24513.442815603346,24423.776596599848,5447,7805.633333333333,41.114064746620066,37.43209613280828,NaN,NaN,NaN,NaN,17.352364696164184,34.88161042955106,-193055,0.7146147918557482,-14.413292062188702,-15.12790685404445
2025-09-17T12:55:00-04:00,24394.25,24398,24383.75,24389.75,NaN,NaN,NaN,24437.290132072794,NaN,NaN,24445.27,24534.735459256106,24355.804540743895,24388.115873055296,24468.13208686638,24513.24079605607,24423.023377676687,3791,7489.333333333333,39.54462750459229,37.62885704908204,NaN,NaN,NaN,NaN,17.13076721786674,34.987884438672296,-196846,0.7530096163726707,-14.186644833578612,-14.939654449951282
2025-09-17T13:00:00-04:00,24390,24402.25,24388.5,24399.5,NaN,NaN,NaN,24437.290132072794,NaN,NaN,24442.85,24530.57382800737,24355.126171992626,24388.115873055296,24467.610671810708,24512.963512623046,24422.25783099837,4562,7211.233333333334,44.24900187298209,38.46016348048135,NaN,NaN,NaN,NaN,16.889283845161973,34.580966507933425,-192284,1.4960249402828758,-13.069623274597689,-14.565648214880564
2025-09-17T13:05:00-04:00,24400,24403,24395.5,24397.25,NaN,NaN,NaN,24437.290132072794,NaN,NaN,24440.3,24525.73535568069,24354.86464431931,24388.115873055296,24467.305541031546,24512.789132888814,24421.82194917428,2773,6917.9,43.40951389332168,38.88836073649769,NaN,NaN,NaN,NaN,16.21862071336469,34.112904471542485,-195057,1.8725109421240038,-12.22500953722556,-14.097520479349564
2025-09-17T13:10:00-04:00,24397.75,24402.75,24388,24402.5,NaN,NaN,NaN,24437.290132072794,NaN,NaN,24437.87,24520.510379961775,24355.229620038222,24388.115873055296,24466.84273029767,24512.526084240722,24421.15937635462,4202,6640.366666666667,45.984590450827945,39.7291493971428,NaN,NaN,NaN,NaN,16.11371923383864,34.16759573264367,-190855,2.4738920948432757,-11.00515536079547,-13.479047455638746
2025-09-17T13:15:00-04:00,24402.25,24404.5,24395.5,24404,NaN,NaN,NaN,24437.290132072794,NaN,NaN,24435.53,24515.194649628265,24355.865350371732,24382.217698444238,24466.568265021266,24512.351774715342,24420.78475532719,2657,6336.633333333333,46.730425159839946,40.53604399557031,NaN,NaN,NaN,NaN,15.605596431421594,33.99333532861928,-188198,2.9397530376091225,-9.804356158627343,-12.744109196236465
2025-09-17T13:20:00-04:00,24404.25,24407.75,24395,24406.5,NaN,NaN,NaN,24437.290132072794,NaN,NaN,24433.235,24509.42538062717,24357.04461937283,24374.54635251086,24466.141001795957,24512.064467597105,24420.21753599481,4297,6088.2,48.018691204479275,41.50262169259435,NaN,NaN,NaN,NaN,15.401625257748622,33.411565047032035,-183901,3.353368709816312,-8.552398308966076,-11.905767018782388
2025-09-17T13:25:00-04:00,24406.5,24410.5,24401.5,24409.75,NaN,NaN,NaN,24437.290132072794,NaN,NaN,24431.025,24503.30108525304,24358.748914746964,24379.437082008688,24465.88752150814,24511.87394018387,24419.90110283241,2760,5877.233333333334,49.721010060397155,42.402703981868164,NaN,NaN,NaN,NaN,14.944366310766577,32.520035698252016,-181141,3.75277588384869,-7.214797163971525,-10.967573047820215
2025-09-17T13:30:00-04:00,24409.75,24423.75,24409.75,24421,NaN,NaN,NaN,24437.290132072794,NaN,NaN,24429.075,24496.931558266755,24361.218441733246,24391.89966560695,24465.51734396607,24511.515979100524,24419.518708831612,5013,5795.133333333333,55.19129487038828,43.32540178607513,NaN,NaN,NaN,NaN,14.876911574283252,30.235854441927295,-176128,4.624327837627053,-5.187163250786398,-9.811491088413451
2025-09-17T13:35:00-04:00,24420.5,24444.5,24419.25,24442,24384.03116840127,24384.03116840127,24384.03116840127,NaN,NaN,NaN,24427.49,24490.16479237757,24364.815207622432,24406.39473248556,24465.182742076744,24511.035759927276,24419.329724226212,7224,5752.233333333334,63.232770582406154,44.52568330653355,NaN,NaN,NaN,NaN,15.617846461834448,29.627400477170635,-168904,6.357805242476164,-1.8642345353182463,-8.22203977779441
2025-09-17T13:40:00-04:00,24441.25,24449,24433.5,24435.75,24393.46725165576,NaN,NaN,NaN,NaN,NaN,24426.175,24485.238292321435,24367.111707678563,24410.76578598845,24464.89577088002,24510.572836291813,24419.218705468225,7360,5722.566666666667,59.793452095278994,46.10017925192357,NaN,NaN,NaN,NaN,15.6094288574177,29.337311928291467,-176264,6.78712700855813,0.2618689829032519,-6.525258025654878
2025-09-17T13:45:00-04:00,24435.75,24441.5,24426.75,24429,24393.46725165576,NaN,NaN,NaN,NaN,NaN,24425.12,24482.01966959564,24368.220330404358,24410.76578598845,24464.683709678226,24510.28650010209,24419.08091925436,4343,5576.666666666667,56.235892269210794,47.79081220952903,NaN,NaN,NaN,NaN,15.548041081887865,28.408047560915172,-180607,6.329145462297459,1.3861738022169448,-4.942971660080514
2025-09-17T13:50:00-04:00,24429,24434.5,24423.25,24434.25,24393.46725165576,NaN,NaN,NaN,NaN,NaN,24424.285,24479.36993532755,24369.20006467245,24410.76578598845,24464.51669105136,24510.06948987921,24418.963892223514,3282,5489.333333333333,58.3133663961212,49.140512457271804,NaN,NaN,NaN,NaN,15.241038147467304,27.21725359960984,-177325,6.090414102263285,2.6700459677485924,-3.4203681345146926
2025-09-17T13:55:00-04:00,24434.5,24460,24423.75,24454.75,24393.46725165576,NaN,NaN,NaN,NaN,NaN,24423.445,24475.2685747508,24371.6214252492,24413.079082426084,24464.378884005677,24509.787955306718,24418.969812704636,5058,5376.233333333334,65.25003781010972,51.19919563689825,NaN,NaN,NaN,NaN,16.741678279791067,27.60208304614183,-172267,6.960957291272214,5.280828479575575,-1.6801288116966389
2025-09-17T14:00:00-04:00,24459.25,24524.25,24442.25,24512.75,24424.532949291643,NaN,NaN,NaN,NaN,NaN,24423.71,24477.195358748217,24370.22464125178,24445.713265940867,24465.78234091147,24510.497911058977,24421.066770763966,34623,6309.033333333334,76.94105942605213,53.75826668542912,NaN,NaN,NaN,NaN,21.402986974091707,29.84077347032743,-137644,10.85843392836536,11.89291359876006,1.034479670394701
2025-09-17T14:05:00-04:00,24511.75,24515,24436,24440.75,24424.532949291643,NaN,NaN,NaN,NaN,NaN,24422.97,24474.429657983554,24371.51034201645,24445.713265940867,24465.704530425068,24509.479297106634,24421.9297637435,30819,7132.533333333334,53.071338011164684,54.72446029304143,NaN,NaN,NaN,NaN,25.517059333085154,31.47302849900027,-168463,8.12777678002541,11.194200645426463,3.0664238654010534
2025-09-17T14:10:00-04:00,24441,24453,24323.5,24324,NaN,NaN,NaN,24469.692601988398,24469.692601988398,24469.692601988398,24420.01,24476.616886511827,24363.40311348817,24445.713265940867,24460.239473851307,24508.413962563205,24412.06498513941,43235,8291.133333333333,34.42280924554616,54.02258939108172,NaN,NaN,NaN,NaN,32.94441223786479,30.17937383516059,-211698,-1.4884859600208338,1.2058164153750113,2.694302375395845
2025-09-17T14:15:00-04:00,24324,24389,24291.5,24374.75,NaN,NaN,NaN,24431.286120079836,NaN,NaN,24418.19,24474.648795595796,24361.7312044042,24445.713265940867,24455.035373240116,24507.446859936827,24402.623886543406,39411,9358.3,43.686075968415444,54.042343825016985,NaN,NaN,NaN,NaN,37.555525649445876,29.702229547679472,-172287,-4.223561255596163,-2.5851491940993583,1.6384120614968045
2025-09-17T14:20:00-04:00,24374.25,24425,24333.5,24413.5,NaN,NaN,NaN,24431.286120079836,NaN,NaN,24416.97,24471.097039450266,24362.842960549737,24445.713265940867,24453.16808555439,24505.931564526087,24400.40460658269,24546,10002.666666666666,49.54642701493453,54.29676072245318,NaN,NaN,NaN,NaN,41.408702388771175,28.16390053539569,-147741,-3.2584500206111864,-2.434650464267179,0.8237995563440077
2025-09-17T14:25:00-04:00,24413.5,24444.25,24387,24441.5,24312.959857530564,24312.959857530564,24312.959857530564,NaN,NaN,NaN,24416.525,24469.459039141268,24363.590960858735,24445.713265940867,24452.529792917278,24504.8804010147,24400.179184819855,19098,10501.966666666667,53.326089645877374,54.767879614312996,NaN,NaN,NaN,NaN,42.540223646716086,26.219908129582205,-128643,-0.7033394978330373,-0.05537481594728888,0.6479646818857484
2025-09-17T14:30:00-04:00,24442,24453.75,24347.25,24365.75,24312.959857530564,NaN,NaN,NaN,NaN,NaN,24414.77,24468.496794059447,24361.043205940554,24445.713265940867,24450.4426886491,24503.15967439445,24397.725702903746,29351,11334,43.77240669796728,54.46457357813356,NaN,NaN,NaN,NaN,47.108779100522085,25.328975180292527,-157994,-3.905070908688909,-4.233373953975388,-0.3283030452864789
2025-09-17T14:35:00-04:00,24366,24415,24322.5,24324.5,24312.959857530564,NaN,NaN,NaN,NaN,NaN,24412.46,24471.334388321047,24353.58561167895,24445.713265940867,24447.31646860913,24501.91247240345,24392.72046481481,29970,12136.933333333332,39.61071618937911,53.74240973020369,NaN,NaN,NaN,NaN,50.35100916477051,24.992916617854497,-187964,-8.336629415592503,-10.749089814777108,-2.4124603991846048
2025-09-17T14:40:00-04:00,24324.75,24374,24288.25,24319,NaN,NaN,NaN,24457.383018821325,24457.383018821325,24457.383018821325,24409.875,24473.40273016595,24346.34726983405,24445.713265940867,24443.376846196814,24501.18003118976,24385.573661203867,31321,12997.633333333333,39.077238041495974,52.591405670997105,NaN,NaN,NaN,NaN,52.87950851014404,25.28302116707274,-219285,-11.006227754608988,-16.17024509244584,-5.164017337836851
2025-09-17T14:45:00-04:00,24318.75,24361.5,24264.25,24341.5,NaN,NaN,NaN,24446.655381602173,NaN,NaN,24407.84,24473.44569792126,24342.23430207874,24445.713265940867,24439.61037666205,24500.2616410861,24378.959112238,30721,13900.066666666668,42.48959813385634,51.10975049610068,NaN,NaN,NaN,NaN,56.04882933084804,25.928415287428138,-188564,-10.619538832723277,-18.43844087874095,-7.818902046017671
2025-09-17T14:50:00-04:00,24341.75,24354,24241.75,24268.25,NaN,NaN,NaN,24440.881273347528,NaN,NaN,24404.7,24480.852806908217,24328.547193091785,24412.670612752696,24435.29791102489,24500.175936471413,24370.419885578365,28885,14711,35.515299415040886,49.37559673322654,NaN,NaN,NaN,NaN,60.06319866435889,26.85467435580006,-217449,-14.423836371513616,-25.848697510409693,-11.424861138896077
2025-09-17T14:55:00-04:00,24267.5,24397.25,24266.5,24392.75,NaN,NaN,NaN,24440.881273347528,NaN,NaN,24403.97,24479.86681416109,24328.07318583891,24306.386490202156,24432.823920973628,24498.271905429407,24367.37593651785,31148,15587.266666666666,50.413340808014645,48.959700200283955,NaN,NaN,NaN,NaN,65.11225590261897,26.463914934925924,-186301,-8.002717606995144,-21.42825814764001,-13.425540540644864
2025-09-17T15:00:00-04:00,24391.75,24455.5,24381.75,24450.75,24261.24789969781,24261.24789969781,24261.24789969781,NaN,NaN,NaN,24404.385,24481.069431930264,24327.700568069733,24272.758882983504,24432.72999528936,24497.29389981201,24368.166090766706,28942,16304.466666666667,55.5638720201677,48.7633077448587,NaN,NaN,NaN,NaN,65.72923762386047,24.76065819350749,-157359,0.26525350951204985,-13.093973653754801,-13.359227163266851
2025-09-17T15:05:00-04:00,24450.5,24512.5,24435.75,24490.25,24313.43549516609,NaN,NaN,NaN,NaN,NaN,24405.785,24486.049251694265,24325.520748305735,24288.01999047733,24433.952879451575,24498.102734496188,24369.803024406963,28878,17008.433333333334,58.70939058016815,48.29611865700573,NaN,NaN,NaN,NaN,66.51643493644187,23.83188649145702,-128481,8.076143845634135,-3.2640473562241823,-11.340191201858318
2025-09-17T15:10:00-04:00,24489.75,24519.25,24412.5,24431,24313.43549516609,NaN,NaN,NaN,NaN,NaN,24406.17,24486.729136047445,24325.610863952552,24288.01999047733,24434.38371277579,24497.916478305226,24370.850947246356,23952,17460.533333333333,52.684927187394024,46.56353778281586,NaN,NaN,NaN,NaN,69.3902610124103,22.50668556950253,-152433,8.870683557978419,-0.2518367543852946,-9.122520312363713
2025-09-17T15:15:00-04:00,24430.75,24502.25,24430,24471,24313.43549516609,NaN,NaN,NaN,NaN,NaN,24407.265,24489.806408397522,24324.723591602477,24288.01999047733,24434.970165657025,24498.09457688503,24371.84575442902,20188,17928.566666666666,55.969794488324425,46.77057038832727,NaN,NaN,NaN,NaN,69.59452808295244,21.276141856259073,-132245,11.53954459572462,5.301910432292061,-6.237634163432558
2025-09-17T15:20:00-04:00,24471.75,24529.5,24453,24520.75,24318.391974618065,NaN,NaN,NaN,NaN,NaN,24409.04,24497.254758401283,24320.82524159872,24313.256235124394,24436.101049458302,24499.2676503753,24372.934448541306,19989,18413.3,59.71581914363327,48.577213952476356,NaN,NaN,NaN,NaN,70.08777607702726,20.627696657569018,-112256,15.839209088787115,13.561377197551337,-2.2778318912357784
2025-09-17T15:25:00-04:00,24521,24550.75,24510.75,24530.5,24360.294612135425,NaN,NaN,NaN,NaN,NaN,24410.9,24505.15184348249,24316.648156517513,24357.754988099514,24437.841052620817,24501.70121353602,24373.980891705614,21905,19017.1,60.42641316330139,49.772952323539634,NaN,NaN,NaN,NaN,67.93864921438245,20.388050008328594,-90351,18.3468267619848,20.655701561245223,2.3088747992604217
2025-09-17T15:30:00-04:00,24530.25,24547.25,24473.75,24494,24360.294612135425,NaN,NaN,NaN,NaN,NaN,24412.315,24509.34926250505,24315.280737494948,24357.754988099514,24439.088969142333,24502.999796648688,24375.178141635977,22540,19616.366666666665,56.41450722463906,50.26352948137567,NaN,NaN,NaN,NaN,68.33588855621227,19.346458123236772,-112891,16.606387663197665,23.066859378257504,6.460471715059838
2025-09-17T15:35:00-04:00,24493,24530.5,24489.5,24491.5,24360.294612135425,NaN,NaN,NaN,NaN,NaN,24413.89,24513.425579569262,24314.354420430736,24357.754988099514,24439.952937914175,24503.869120986972,24376.036754841378,16406,20070.8,56.1395754861788,50.46449275568291,NaN,NaN,NaN,NaN,66.38332508791139,18.37926565850865,-129297,14.426536824951292,24.493642746248952,10.06710592129766
2025-09-17T15:40:00-04:00,24491.5,24515.25,24476.25,24497.75,24360.294612135425,NaN,NaN,NaN,NaN,NaN,24415.54,24517.808732269386,24313.271267730615,24357.754988099514,24440.480975627503,24504.329310692563,24376.632640562442,11606,20317.6,56.70760433141582,51.38843544378638,NaN,NaN,NaN,NaN,64.42737329591772,17.186223988369832,-117691,12.611066166998791,25.83093863004615,13.219872463047357
2025-09-17T15:45:00-04:00,24498.75,24503.5,24475,24490,24360.294612135425,NaN,NaN,NaN,NaN,NaN,24417.17,24521.514834085858,24312.82516591414,24362.66324312556,24440.934175365062,24504.65960265024,24377.208748079884,11581,20615.066666666666,55.74355645693456,52.5407811771832,NaN,NaN,NaN,NaN,61.86113234620931,16.04971835061257,-129272,10.196961454450271,25.966074281110195,15.769112826659924
2025-09-17T15:50:00-04:00,24490.25,24510.5,24456.25,24482.5,24360.294612135425,NaN,NaN,NaN,NaN,NaN,24418.48,24524.415916479196,24312.544083520803,24370.70559450045,24441.460809734104,24504.959711126518,24377.96190834169,15849,21000.133333333335,54.7731157806962,53.66191530141178,NaN,NaN,NaN,NaN,61.31748003576579,15.24603619932943,-145121,7.526909350268941,25.1777495144961,17.65084016422716
2025-09-17T15:55:00-04:00,24483,24505,24447,24475.5,24360.294612135425,NaN,NaN,NaN,NaN,NaN,24419.67,24526.797794714475,24312.54220528552,24370.70559450045,24442.013928964796,24505.14816943886,24378.87968849073,20746,21599.666666666668,53.83116212913533,54.472027015360275,NaN,NaN,NaN,NaN,61.080517176068234,14.709723694226822,-165867,4.851156405854706,23.714785671545542,18.863629265690836
2025-09-17T16:00:00-04:00,24475,24512.75,24471.5,24503.5,24360.294612135425,NaN,NaN,NaN,NaN,NaN,24421.675,24531.223676397214,24312.126323602784,24379.456580480288,24442.451859160774,24505.515023201933,24379.388695119615,10560,21784.566666666666,57.01549658430215,56.00775538459323,NaN,NaN,NaN,NaN,59.66405166349193,14.00313687393567,-155307,4.53465914292121,24.53195319434235,19.99729405142114
2025-09-17T16:05:00-04:00,24503.25,24523.25,24499,24512.5,24360.294612135425,NaN,NaN,NaN,NaN,NaN,24423.7,24536.108851964604,24311.291148035398,24404.49026438423,24442.66844758979,24505.751163361285,24379.585731818293,4085,21679.933333333334,58.017810994158594,56.550931826460655,NaN,NaN,NaN,NaN,57.13447654467108,13.062199467010757,-151222,4.4906179262839,25.610566459276015,21.119948532992115
2025-09-17T16:10:00-04:00,24512.25,24518.75,24503.5,24507.5,24360.294612135425,NaN,NaN,NaN,NaN,NaN,24425.82,24540.450451451317,24311.189548548682,24416.117211507382,24442.805668790097,24505.89701514022,24379.714322439973,2666,21523.466666666667,57.21954316971197,56.66919405142811,NaN,NaN,NaN,NaN,54.142728220051715,12.188471874866195,-153888,3.7159732744043126,25.764915125997504,22.04894185159319
2025-09-17T16:15:00-04:00,24507,24508.75,24487.5,24498,24360.294612135425,NaN,NaN,NaN,NaN,NaN,24427.71,24543.911521505022,24311.508478494976,24416.117211507382,24442.922236852683,24505.998016646223,24379.846457059142,2761,21470.733333333334,55.652748141365706,56.4508624486565,NaN,NaN,NaN,NaN,51.793247632905164,11.823385039637628,-156649,2.2283597542121427,24.83439154435837,22.606031790146226
2025-09-17T16:20:00-04:00,24498.5,24501,24486.75,24492.5,24360.294612135425,NaN,NaN,NaN,NaN,NaN,24429.545,24546.877846639625,24312.21215336037,24419.690015364726,24442.977095470458,24506.04054466888,24379.913646272038,1424,21408.8,54.71857718171679,56.5961231625367,NaN,NaN,NaN,NaN,49.11158708769766,11.505416003830115,-158073,0.6220460913990387,23.383589404395025,22.761543312995986
2025-09-17T16:25:00-04:00,24492.75,24509.5,24492.25,24508,24360.457344128252,NaN,NaN,NaN,NaN,NaN,24431.61,24550.745098102387,24312.474901897614,24435.827012291782,24443.048104087946,24506.108298371313,24379.98790980458,1546,21291.733333333334,56.91357407532136,56.66353599017934,NaN,NaN,NaN,NaN,46.835759438576396,10.92448292625583,-156527,0.36429226660537495,23.216908646252705,22.85261637964733
2025-09-17T16:30:00-04:00,24508,24517.75,24505.25,24516.75,24375.76041939515,NaN,NaN,NaN,NaN,NaN,24433.685,24555.044581819577,24312.325418180426,24452.561609833425,24443.12911174236,24506.19796103642,24380.0602624483,1516,20188.166666666668,58.14696801136361,56.551475195017225,NaN,NaN,NaN,NaN,44.38320519296379,10.17998707199214,-155011,0.533701977216321,23.519743851167732,22.98604187395141
2025-09-17T16:35:00-04:00,24516.75,24517.25,24500.5,24502.25,24377.021309422642,NaN,NaN,NaN,NaN,NaN,24435.325,24558.12175280731,24312.52824719269,24456.72428786674,24443.18955564224,24506.258823510423,24380.120287774054,1251,19202.566666666666,55.32082199955069,56.18679011189217,NaN,NaN,NaN,NaN,42.40940482203781,9.580039096245214,-156262,-0.5230083192026456,22.332281474948104,22.85528979415075
2025-09-17T16:40:00-04:00,24502.5,24504,24497,24501.75,24377.021309422642,NaN,NaN,NaN,NaN,NaN,24437.385,24561.110632349162,24313.659367650835,24456.72428786674,24443.22680097749,24506.29275699473,24380.160844960246,849,17789.7,55.221153096535815,56.10155053131337,NaN,NaN,NaN,NaN,39.88016162046368,9.14712788194743,-157111,-1.3981930470638986,21.107548485320876,22.505741532384775
2025-09-17T16:45:00-04:00,24501.5,24503,24491.75,24491.75,24377.021309422642,NaN,NaN,NaN,NaN,NaN,24439.585,24563.187168672015,24315.982831327983,24456.72428786674,24443.25864098844,24506.31857724332,24380.198704733557,802,16502.733333333334,53.15835251304946,55.888606033232705,NaN,NaN,NaN,NaN,37.83515007614484,8.936714038728757,-157913,-2.716803477173606,19.109737185917766,21.82654066309137
2025-09-17T16:50:00-04:00,24491.25,24492.75,24486.75,24487.25,24377.021309422642,NaN,NaN,NaN,NaN,NaN,24441.435,24565.066501243833,24317.80349875617,24456.72428786674,24443.28175859005,24506.334094928854,24380.229422251243,667,15706.766666666666,52.213141451626285,55.56757297039059,NaN,NaN,NaN,NaN,35.56121078499164,8.927059502906538,-158580,-3.8870315135417677,16.96775127116416,20.85478278470593
2025-09-17T16:55:00-04:00,24487,24504,24486.5,24501.25,24380.388766575135,NaN,NaN,NaN,NaN,NaN,24443.76,24567.431175301088,24320.08882469891,24462.666668310216,24443.31250755507,24506.360033298413,24380.264981811728,751,15095.2,54.899937095265535,55.507314444557096,NaN,NaN,NaN,NaN,34.27112430034938,8.428932040032091,-157829,-3.7134249410700555,16.21300160836836,19.926426549438414
2025-09-17T18:00:00-04:00,24504,24509.5,24492.5,24507.75,24389.04154991263,NaN,NaN,NaN,NaN,NaN,24446.025,24570.15192093107,24321.89807906893,24467.933334648173,24503.25,24503.25,24503.25,2064,14185.633333333333,56.133134940064615,55.60445867022627,NaN,NaN,NaN,NaN,33.037472564610134,7.920936403088661,-155765,-3.1767984456265808,15.95542849240519,19.13222693803177
2025-09-17T18:05:00-04:00,24507.5,24516.75,24506,24515.25,24403.039661280236,NaN,NaN,NaN,NaN,NaN,24448.535,24573.083424719378,24323.98657528062,24478.12166771854,24507.341735159822,24512.009519345054,24502.67395097459,1586,13239.5,57.57463218205738,55.87184938829213,NaN,NaN,NaN,NaN,31.445510238566552,7.756211824900454,-154179,-2.3697107128763655,16.170088546936313,18.53979925981268
2025-09-17T18:10:00-04:00,24515.75,24518.25,24509.5,24516.75,24409.270813040224,NaN,NaN,NaN,NaN,NaN,24450.88,24576.060758905627,24325.699241094375,24482.972334174832,24508.886327388722,24514.032363697526,24503.740291079917,948,12227.066666666668,57.87279572120072,55.933085040927736,NaN,NaN,NaN,NaN,29.824402364383225,7.6680456171318845,-153231,-1.8129169217346615,16.27365310764435,18.08657002937901
2025-09-17T18:15:00-04:00,24516.25,24518,24514.75,24517,24416.08236699294,NaN,NaN,NaN,NaN,NaN,24453.275,24578.841446552757,24327.708553447246,24488.152867339864,24509.681844773793,24515.08878028435,24504.274909263237,530,11220.7,57.92586919378387,55.9265177694724,NaN,NaN,NaN,NaN,27.926230766927283,7.586176995632499,-152701,-1.5178306501759877,16.189281716659025,17.707112366835013
2025-09-17T18:20:00-04:00,24517,24524.25,24513.25,24522,24421.516123038717,NaN,NaN,NaN,NaN,NaN,24455.665,24581.82238622661,24329.507613773392,24494.872293871893,24511.332870672763,24517.538891812444,24505.12684953308,996,10291.066666666668,59.03738892558929,56.056363894892215,NaN,NaN,NaN,NaN,26.717214283575334,7.806484202414045,-151705,-1.0956531455269598,16.33754593492631,17.43319908045327
2025-09-17T18:25:00-04:00,24522.75,24532,24522.75,24530.25,24433.19720835514,NaN,NaN,NaN,NaN,NaN,24458.19,24585.161160505257,24331.21883949474,24503.497835097514,24514.45188888889,24523.097408718128,24505.80636905965,1376,9298.666666666666,60.87407635883967,56.42931591042606,NaN,NaN,NaN,NaN,25.52312754903424,8.368048146830317,-150329,-0.40604393799748806,16.925644157956413,17.3316880959539
2025-09-17T18:30:00-04:00,24530.25,24534,24526.75,24534,24439.489380702635,NaN,NaN,NaN,NaN,NaN,24460.74,24588.574618157658,24332.905381842345,24507.57326807801,24516.11429488723,24525.76870877541,24506.45988099905,806,8360.8,61.71439716141735,56.929017337547535,NaN,NaN,NaN,NaN,24.217904152674652,8.981729304551141,-149523,0.1287817947914327,17.492665339443192,17.36388354465176
2025-09-17T18:35:00-04:00,24534,24542,24532,24541,24448.881908852512,NaN,NaN,NaN,NaN,NaN,24463.365,24592.289249462825,24334.44075053718,24515.85861446241,24519.20289554611,24531.007024971237,24507.398766120983,1341,7442.9,63.298963049885884,57.385116550016434,NaN,NaN,NaN,NaN,23.202339570340747,9.918581032176464,-148182,0.7456696832429159,18.295970648705406,17.55030096546249
2025-09-17T18:40:00-04:00,24541.5,24549.25,24538.5,24545.25,24458.296367541036,NaN,NaN,NaN,NaN,NaN,24465.85,24596.194121463734,24335.505878536263,24522.96189156993,24522.70295027361,24536.69004066526,24508.715859881962,1561,6696.533333333334,64.26597604485123,57.822188552408406,NaN,NaN,NaN,NaN,22.312886743887837,11.105399471025056,-146621,1.2044561510451857,19.05587115426897,17.851415003223785
2025-09-17T18:45:00-04:00,24545.25,24563,24542,24562,24467.947669016445,NaN,NaN,NaN,NaN,NaN,24468.25,24601.143303067212,24335.356696932788,24531.469513255943,24529.584256971408,24547.86756638764,24511.300947555177,2957,6122.166666666667,67.86021917111557,58.71785977894876,NaN,NaN,NaN,NaN,22.219109119324422,12.754209638745742,-143664,2.3350729650821513,20.770256209576473,18.435183244494322
2025-09-17T18:50:00-04:00,24562.5,24573.25,24560.5,24571,24484.427320424787,NaN,NaN,NaN,NaN,NaN,24470.955,24606.570142588855,24335.33985741115,24541.650610604753,24536.164455184535,24558.266953736675,24514.061956632395,2905,5552.7,69.62793414584019,59.74691556818478,NaN,NaN,NaN,NaN,21.54274418222982,14.648102156561512,-140759,3.3276022247629626,22.594686025448027,19.267083800685064
2025-09-17T18:55:00-04:00,24571.25,24572.5,24566.25,24567.5,24489.82266949639,NaN,NaN,NaN,NaN,NaN,24473.725,24611.44076707352,24336.009232926477,24544.095488483803,24538.608282757126,24561.533026864392,24515.68353864986,1384,4868.666666666667,68.0601987586292,60.81133315715476,NaN,NaN,NaN,NaN,20.45040531207055,16.40671663739044,-142143,3.376245780408617,23.487391026195837,20.11114524578722
2025-09-17T19:00:00-04:00,24567.25,24575,24567,24573.25,24493.97277542837,NaN,NaN,NaN,NaN,NaN,24476.505,24616.51383864874,24336.49616135126,24548.276390787043,24541.622056650245,24565.46638224262,24517.77773105787,1846,4178.866666666667,69.2838035577198,62.03066616473287,NaN,NaN,NaN,NaN,19.561090646922654,18.132409400563287,-140297,3.413348330540561,24.37783065896292,20.96448232842236
2025-09-17T19:05:00-04:00,24573.75,24576.5,24569,24573.5,24498.201285636173,NaN,NaN,NaN,NaN,NaN,24478.88,24621.33944124382,24336.42055875618,24551.371112629633,24543.402293109055,24567.671323368028,24519.133262850082,1221,3672.7,69.33880257395181,63.06201369892476,NaN,NaN,NaN,NaN,18.699584172142465,19.79265462448238,-139076,3.082495362724252,24.817601531827677,21.735106169103425
2025-09-17T19:10:00-04:00,24574,24577.25,24567.5,24568.5,24499.885318107255,NaN,NaN,NaN,NaN,NaN,24479.995,24624.35733892535,24335.632661074647,24552.271890103708,24545.027099826504,24569.45557094822,24520.59862870479,1342,3330.5666666666666,66.76399670150732,63.82136096759924,NaN,NaN,NaN,NaN,18.060328159846573,21.188344015682112,-140418,2.1962904985214955,24.480469292255293,22.284178793733798
2025-09-17T19:15:00-04:00,24568.75,24578.5,24568.25,24574,24502.782576375106,NaN,NaN,NaN,NaN,NaN,24482.66,24628.93309253507,24336.38690746493,24553.392512082966,24546.28098035936,24570.87328166965,24521.688679049068,1050,2979.5333333333333,68.16441679126676,64.57777415397133,NaN,NaN,NaN,NaN,17.50244757700039,22.53983486661941,-139368,1.6735378277592332,24.37610107843284,22.702563250673606
2025-09-17T19:20:00-04:00,24574,24577,24572.5,24574.25,24506.752686539876,NaN,NaN,NaN,NaN,NaN,24487.665,24628.919649835196,24346.410350164806,24554.664009666372,24546.935383389846,24571.61109043279,24522.2596763469,566,2470.1,68.22994518246821,65.31757054406187,NaN,NaN,NaN,NaN,16.573701321500362,23.794790656775476,-138802,1.0671364431446015,24.03648380460436,22.969347361459757
2025-09-17T19:25:00-04:00,24574.25,24576.25,24573,24574.5,24509.27529169715,NaN,NaN,NaN,NaN,NaN,24491.66,24631.20310301771,24352.11689698229,24556.7562077331,24547.64303532097,24572.389151394313,24522.896919247625,643,1800,68.30021320308227,66.05859511615462,NaN,NaN,NaN,NaN,15.622008369964622,24.960106747634683,-138159,0.4376620080271181,23.516424871493655,23.078762863466537
2025-09-17T19:30:00-04:00,24574.5,24584.75,24574.5,24578.25,24515.84800571092,NaN,NaN,NaN,NaN,NaN,24494.955,24634.740395873974,24355.16960412603,24564.029966186477,24549.940676089605,24575.137653829133,24524.743698350077,1975,1513.8333333333333,69.39373156815059,66.79833387633757,NaN,NaN,NaN,NaN,15.23829348639572,26.461819162742366,-136184,0.049088225017193565,23.140123144738027,23.091034919720833
2025-09-17T19:35:00-04:00,24578.5,24579.75,24571.5,24572,24515.84800571092,NaN,NaN,NaN,NaN,NaN,24497.565,24638.131667813006,24356.99833218699,24564.029966186477,24550.882160557347,24576.034172457894,24525.7301486568,1084,1413.8,65.34766304245125,67.11787578230982,NaN,NaN,NaN,NaN,14.739129665938885,27.481462095347105,-137268,-0.8064125366528678,22.083019248904748,22.889431785557615
2025-09-17T19:40:00-04:00,24572.75,24574.75,24568.5,24572.25,24515.84800571092,NaN,NaN,NaN,NaN,NaN,24501.695,24638.614585525193,24364.775414474807,24564.029966186477,24551.743333673596,24576.721752818095,24526.764914529096,1208,1365.2,65.43447924214284,67.38359593093307,NaN,NaN,NaN,NaN,14.132763261228964,28.053647656313103,-136060,-1.4930745269827952,21.02308862682912,22.516163153811917
2025-09-17T19:45:00-04:00,24572.5,24585.25,24572.5,24584.75,24519.794234211946,NaN,NaN,NaN,NaN,NaN,24506.9,24636.045692921343,24377.75430707866,24564.029966186477,24552.93469085846,24578.06647309872,24527.8029086182,1255,1315,69.54320479486361,67.82961319843147,NaN,NaN,NaN,NaN,14.05185159971261,29.152472798860877,-134805,-1.2527462895739419,20.95023029184449,22.202976581418433
2025-09-17T19:50:00-04:00,24584.5,24584.5,24578.5,24584.5,24524.252450838678,NaN,NaN,NaN,NaN,NaN,24512.21,24631.470444405655,24392.949555594343,24564.029966186477,24553.772771471453,24579.027042733123,24528.518500209782,894,1297.3333333333333,69.36561298375474,68.19387297978173,NaN,NaN,NaN,NaN,13.494576485447423,30.172810431226665,-135699,-1.2548168910025481,20.634455467665248,21.889272358667796
2025-09-17T19:55:00-04:00,24584.75,24588,24581.25,24584,24529.059157618736,NaN,NaN,NaN,NaN,NaN,24517.06,24627.55848686667,24406.561513133332,24567.885859319984,24554.736451487417,24580.159350404694,24529.31355257014,1024,1279.9333333333334,68.98617137095452,68.27429813691307,NaN,NaN,NaN,NaN,13.012821022201178,31.303894408154253,-136723,-1.4218042786604421,20.112017010342242,21.533821289002685
2025-09-17T20:00:00-04:00,24584.25,24584.75,24568,24568.25,24529.059157618736,NaN,NaN,NaN,NaN,NaN,24523.06,24608.634736924567,24437.485263075436,24567.885859319984,24555.88590494322,24580.936190340723,24530.83561954572,2105,1299.5666666666666,58.1884366098668,67.45719117005784,NaN,NaN,NaN,NaN,13.279762377758237,30.72380558752147,-138828,-2.6533833518281043,18.217092099217552,20.870475451045657
2025-09-17T20:05:00-04:00,24568.25,24578,24568.25,24575,24529.059157618736,NaN,NaN,NaN,NaN,NaN,24526.705,24604.981796688637,24448.428203311367,24567.885859319984,24556.516735770998,24581.34069015717,24531.692781384827,1269,1300.1666666666667,61.00541075094662,66.95327774093765,NaN,NaN,NaN,NaN,13.027636493632647,30.18515168264817,-137559,-3.0457214255251586,17.06332366913921,20.109045094664367
2025-09-17T20:10:00-04:00,24575.25,24579.5,24570.25,24574.25,24529.059157618736,NaN,NaN,NaN,NaN,NaN,24529.175,24605.47809626995,24452.871903730047,24567.885859319984,24556.938528897466,24581.624264558664,24532.25279323627,855,1300.3666666666666,60.517534303711095,66.32711565136559,NaN,NaN,NaN,NaN,12.757805315516029,29.79532827892286,-138414,-3.3631631528372274,15.905091153617832,19.26825430645506
2025-09-17T20:15:00-04:00,24573.5,24576,24572,24572.5,24529.059157618736,NaN,NaN,NaN,NaN,NaN,24530.82,24607.241792706696,24454.398207293303,24567.885859319984,24557.109600986325,24581.724531888376,24532.494670084274,384,1286.4333333333334,59.32535033600339,65.6118690629407,NaN,NaN,NaN,NaN,12.13224779297917,29.433349404035074,-138798,-3.6731728160203225,14.676788286429655,18.349961102449978
2025-09-17T20:20:00-04:00,24571.75,24573.25,24561,24563.75,24529.059157618736,NaN,NaN,NaN,NaN,NaN,24533.475,24604.9013431818,24462.0486568182,24567.885859319984,24557.52888418984,24581.630166379062,24533.42760200062,1840,1325.5333333333333,53.635876293741376,64.67414617667171,NaN,NaN,NaN,NaN,12.140658664909228,27.795887851181668,-140638,-4.400624729446324,12.849180190642073,17.249804920088398
2025-09-17T20:25:00-04:00,24564.25,24567.25,24559.75,24562.5,24529.059157618736,NaN,NaN,NaN,NaN,NaN,24535.305,24604.900063761117,24465.709936238884,24567.885859319984,24557.67416826895,24581.479648136115,24533.868688401784,1032,1334.9,52.85602295723687,63.580689474241005,NaN,NaN,NaN,NaN,11.80918304598714,26.14178343326679,-141670,-4.862924734224251,11.171149002308084,16.034073736532335
2025-09-17T20:30:00-04:00,24562.75,24568,24562,24566.25,24529.059157618736,NaN,NaN,NaN,NaN,NaN,24536.215,24606.2137149904,24466.2162850096,24567.885859319984,24557.85468746189,24581.410007778137,24534.299367145646,956,1297.9666666666667,54.97123322089339,62.633638619842806,NaN,NaN,NaN,NaN,11.394241399845201,24.682255814944423,-140714,-4.80462622111305,10.028290960141021,14.832917181254071
2025-09-17T20:35:00-04:00,24566,24568.75,24562.5,24563.25,24529.059157618736,NaN,NaN,NaN,NaN,NaN,24536.87,24607.254390317998,24466.485609682,24567.885859319984,24557.944404988324,24581.36102252148,24534.52778745517,534,1262.9,52.925418498057525,61.53543899805533,NaN,NaN,NaN,NaN,11.026795585570543,23.40739051754063,-141248,-4.842901262785935,8.779290602771653,13.622191865557587
2025-09-17T20:40:00-04:00,24563.5,24570,24562.75,24567,24529.059157618736,NaN,NaN,NaN,NaN,NaN,24538.33,24608.12279618635,24468.537203813652,24567.885859319984,24558.1174444392,24581.32993225949,24534.904956618913,849,1259.6,55.17127450435682,60.519549207784344,NaN,NaN,NaN,NaN,10.757024472315505,22.363198462687897,-140399,-4.497893114359037,7.999825472608791,12.497718586967828
2025-09-17T20:45:00-04:00,24566.75,24570.25,24564,24564.75,24529.059157618736,NaN,NaN,NaN,NaN,NaN,24539.795,24608.663330170428,24470.92666982957,24560.283687455987,24558.26963985242,24581.292790654195,24535.246489050645,800,1268.6,53.52137078378543,59.67481404645107,NaN,NaN,NaN,NaN,10.435094152864398,21.422898430379462,-141199,-4.303390759715233,7.118480137323786,11.42187089703902
2025-09-17T20:50:00-04:00,24565,24568.25,24561,24567.5,24529.059157618736,NaN,NaN,NaN,NaN,NaN,24541.19,24609.417894591686,24472.96210540831,24555.316559971834,24558.470093987642,24581.206920630862,24535.73326734442,1217,1275.9666666666667,55.28159015568743,58.94960768313282,NaN,NaN,NaN,NaN,10.2075874276598,20.121248066681314,-139982,-3.884522038548816,6.566218348852999,10.450740387401815
2025-09-17T20:55:00-04:00,24566.75,24570.75,24563.5,24564.5,24529.059157618736,NaN,NaN,NaN,NaN,NaN,24542.68,24609.612805111294,24475.747194888707,24555.316559971834,24558.578932856642,24581.174640719266,24535.98322499402,630,1251.1,52.92674728382913,57.762717860916084,NaN,NaN,NaN,NaN,9.996331182826955,19.237454659066714,-140612,-3.7050805715236894,5.819389672997204,9.524470244520893
2025-09-17T21:00:00-04:00,24564.5,24569.25,24560.5,24568.25,24529.059157618736,NaN,NaN,NaN,NaN,NaN,24544.395,24609.439683869896,24479.350316130105,24554.653247977465,24558.7194258057,24581.1230646316,24536.315786979798,869,1253.2,55.47965226783706,56.770863524064815,NaN,NaN,NaN,NaN,9.907307526910744,17.976210577638955,-139743,-3.245900228277055,5.467094959174574,8.712995187451629
2025-09-17T21:05:00-04:00,24568.5,24591,24566.25,24585,24535.74209757434,NaN,NaN,NaN,NaN,NaN,24546.585,24609.543765075974,24483.626234924024,24563.289495170684,24560.174862832067,24582.50666967505,24537.843055989084,3247,1316.7333333333333,64.69084709393474,56.46405464713483,NaN,NaN,NaN,NaN,10.967499846417118,18.976578326876776,-136496,-1.7984282763815962,6.464959841974633,8.263388118356229
2025-09-17T21:10:00-04:00,24585,24594.25,24585,24588.25,24547.429956775504,NaN,NaN,NaN,NaN,NaN,24548.28,24611.07081461817,24485.489185381826,24567.456596136548,24561.13751139262,24583.70147798774,24538.5735447975,1688,1320.9666666666667,66.15409136075694,57.033029986484124,NaN,NaN,NaN,NaN,10.844821285958753,20.13555586300657,-134808,-0.6648326418411408,7.432347316054802,8.097179957895943
2025-09-17T21:15:00-04:00,24587.75,24588.5,24577.5,24577.5,24547.429956775504,NaN,NaN,NaN,NaN,NaN,24549.58,24612.04450511866,24487.115494881342,24567.456596136548,24561.674684457033,24584.16798226226,24539.181386651806,1401,1269.1,57.64469650870409,56.792978969181085,NaN,NaN,NaN,NaN,10.855905479818842,20.194915593027005,-136209,-0.6793255639388889,7.248023002972332,7.9273485669112205
2025-09-17T21:20:00-04:00,24578,24578.5,24568.25,24577.25,24547.429956775504,NaN,NaN,NaN,NaN,NaN,24550.975,24612.72953424988,24489.220465750117,24567.456596136548,24562.036157172188,24584.31702681206,24539.755287532316,1495,1222.1,57.459590412776066,56.57455440554287,NaN,NaN,NaN,NaN,10.81262651697464,19.189929402518647,-137704,-0.741024617784058,7.001067794681148,7.742092412465206
2025-09-17T21:25:00-04:00,24577,24580.5,24574.5,24577,24547.429956775504,NaN,NaN,NaN,NaN,NaN,24552.555,24612.831968238843,24492.278031761158,24567.456596136548,24562.228991712454,24584.434661205967,24540.02332221894,686,1198.8333333333333,57.26157030106064,56.4271415459041,NaN,NaN,NaN,NaN,10.46886748004788,18.44296798487332,-138390,-0.8273882491207321,6.707857101064292,7.535245350185024
2025-09-17T21:30:00-04:00,24577,24585.25,24575.5,24582,24547.429956775504,NaN,NaN,NaN,NaN,NaN,24554.345,24612.665913053414,24496.02408694659,24567.456596136548,24562.499400859626,24584.6564980694,24540.342303649853,799,1163.9333333333334,60.21470993992508,56.897058234917225,NaN,NaN,NaN,NaN,10.417519802901603,18.181758008456512,-137591,-0.5877553153037081,6.800551206055388,7.388306521359096
2025-09-17T21:35:00-04:00,24582.25,24588,24582.25,24587.5,24547.429956775504,NaN,NaN,NaN,NaN,NaN,24555.935,24613.444374016137,24498.425625983866,24567.456596136548,24562.773921810774,24584.944507370656,24540.603336250893,655,1145.0666666666666,63.224917524837046,57.63769356117438,NaN,NaN,NaN,NaN,10.101982674122919,18.180920321281757,-136936,-0.12310755925687822,7.234422072287998,7.357529631544876
2025-09-17T21:40:00-04:00,24587.75,24589.5,24584,24588,24549.028468199336,NaN,NaN,NaN,NaN,NaN,24557.36,24614.44433760806,24500.27566239194,24568.76882993762,24563.04845835767,24585.243593976393,24540.853322738945,636,1121.5333333333333,63.495322347568084,58.24655707022257,NaN,NaN,NaN,NaN,9.773269625971281,18.313381936193565,-136300,0.1394097928815894,7.531791872646863,7.392382079765274
2025-09-17T21:45:00-04:00,24588,24593.5,24586.75,24591,24553.19762873573,NaN,NaN,NaN,NaN,NaN,24559.135,24614.754979327496,24503.5150206725,24573.540063950095,24563.41589702853,24585.68541264235,24541.146381414714,769,1112.1666666666667,65.15104092571434,59.1198158150552,NaN,NaN,NaN,NaN,9.557321795544762,18.787322135978823,-135531,0.42070054680163693,7.91825776326732,7.497557216465683
2025-09-17T21:50:00-04:00,24590.75,24593.25,24587.25,24593.25,24554.182963793195,NaN,NaN,NaN,NaN,NaN,24560.965,24614.908026426412,24507.02197357359,24574.282051160077,24563.719188727144,24586.054750574374,24541.383626879913,631,1114.3333333333333,66.38258036966239,59.92062337686275,NaN,NaN,NaN,NaN,9.303227381577281,19.22740946435085,-134900,0.6501902696182666,8.310295053488517,7.66010478387025
2025-09-17T21:55:00-04:00,24593.25,24597.25,24592.5,24593.25,24559.799647257143,NaN,NaN,NaN,NaN,NaN,24562.995,24613.921367436,24512.068632563998,24579.700640928062,24564.235808589267,24586.730422312572,24541.74119486596,994,1126.0333333333333,66.38258036966239,60.83928120442539,NaN,NaN,NaN,NaN,8.977996854321761,19.992652382575777,-134900,0.6901102204749598,8.52274255946395,7.83263233898899
2025-09-17T22:00:00-04:00,24593,24593.5,24589.75,24592.5,24559.799647257143,NaN,NaN,NaN,NaN,NaN,24565.1,24611.85927715764,24518.340722842357,24579.700640928062,24564.548045880547,24587.105648485027,24541.990443276067,672,1082.6,65.48790044043555,61.56830336762169,NaN,NaN,NaN,NaN,8.604568507584492,20.267587829613127,-135572,0.5596826924034959,8.53223570449336,7.972553012089864
2025-09-17T22:05:00-04:00,24592,24593,24587.75,24588.25,24559.799647257143,NaN,NaN,NaN,NaN,NaN,24566.84,24610.32617711173,24523.35382288827,24579.700640928062,24564.80593812127,24587.389837718314,24542.222038524225,618,1067.0666666666666,60.510986320734794,62.11003472740066,NaN,NaN,NaN,NaN,8.364956471328457,20.209224842785027,-136190,0.10468443783074477,8.103408559378295,7.99872412154755
2025-09-17T22:10:00-04:00,24587.75,24598,24587,24597.5,24559.799647257143,NaN,NaN,NaN,NaN,NaN,24568.635,24609.54993737256,24527.720062627435,24580.214728155166,24565.199589691478,24587.884325464904,24542.51485391805,818,1054.0666666666666,66.4816101933643,62.89588886493833,NaN,NaN,NaN,NaN,8.553173866233568,20.656427083362505,-135372,0.3314031647504443,8.412978077485604,8.08157491273516
2025-09-17T22:15:00-04:00,24597,24605.5,24596.75,24604,24568.283132868386,NaN,NaN,NaN,NaN,NaN,24570.41,24609.569770177142,24531.250229822857,24586.896782524134,24566.174257051825,24589.32589216221,24543.02262194144,1656,1067.4333333333334,69.9230027142479,63.26961426638927,NaN,NaN,NaN,NaN,8.567232875788312,21.719811642810523,-133716,0.7972700079705675,9.07816242269837,8.280892414727802
2025-09-17T22:20:00-04:00,24604.25,24606.25,24598.75,24603.25,24570.128217738005,NaN,NaN,NaN,NaN,NaN,24572.14,24609.25390035884,24535.02609964116,24587.617426019307,24566.817596555313,24590.263004248405,24543.37218886222,1122,1075.0333333333333,69.04216068744148,63.47590493258101,NaN,NaN,NaN,NaN,8.491001956089146,22.767622586624963,-134838,0.9241135453926859,9.43603434646866,8.511920801075973
2025-09-17T22:25:00-04:00,24603.25,24605.5,24601.5,24604.5,24572.05420784082,NaN,NaN,NaN,NaN,NaN,24573.89,24608.613646119145,24539.166353880853,24588.593940815445,24567.096339053725,24590.671494439626,24543.521183667825,484,1057.0333333333333,69.72665801594704,64.33890218309837,NaN,NaN,NaN,NaN,8.17021610208278,23.74058989159552,-134354,0.9573435808157686,9.708600277095684,8.751256696279915
2025-09-17T22:30:00-04:00,24604.5,24606.25,24602.5,24603.25,24573.847198393512,NaN,NaN,NaN,NaN,NaN,24575.515,24607.899009944922,24543.130990055077,24590.850152652358,24567.432582017762,24591.16061392078,24543.704550114744,591,1006.5666666666667,68.10497985558555,65.09928714329905,NaN,NaN,NaN,NaN,7.8544863805054375,24.712134945257727,-134945,0.7684303742015981,9.711794664031913,8.943364289830315
2025-09-17T22:35:00-04:00,24603.25,24612,24602.75,24610,24576.9734621029,NaN,NaN,NaN,NaN,NaN,24577.11,24608.251156044207,24545.968843955794,24595.055122121885,24568.250287052426,24592.425653880615,24544.074920224237,1326,1008.4666666666667,71.90490287754099,66.1452394701905,NaN,NaN,NaN,NaN,7.954165924755048,26.10697432875736,-133619,0.9589751318438502,10.142083204635128,9.183108072791278
2025-09-17T22:40:00-04:00,24610.25,24613.5,24608,24611.25,24580.98035018913,NaN,NaN,NaN,NaN,NaN,24578.655,24608.73470910595,24548.57529089405,24597.19409769751,24568.735885410442,24593.195638154473,24544.27613266641,762,1005.3666666666667,72.55694447969313,67.02682765160252,NaN,NaN,NaN,NaN,7.778868358701116,27.521664474356623,-132857,1.0241852697962432,10.463339660036581,9.439154390240338
2025-09-17T22:45:00-04:00,24611.75,24617.5,24610.75,24616.75,24584.788061544168,NaN,NaN,NaN,NaN,NaN,24580.17,24610.141226205047,24550.19877379495,24601.080278158006,24569.476345144838,24594.424540285505,24544.52815000417,1089,1028.8666666666666,75.27590291314954,67.88761232219626,NaN,NaN,NaN,NaN,7.705377761651036,29.141740311044163,-131768,1.2763104189026269,11.034542413868621,9.758231994965994
2025-09-17T22:50:00-04:00,24616.5,24619.75,24612.75,24615.75,24587.29201329216,NaN,NaN,NaN,NaN,NaN,24581.58,24611.480575240927,24551.679424759077,24603.114222526405,24570.19925821963,24595.614381769654,24544.784134669604,1072,1003.2666666666667,73.84337324395074,68.62675881479502,NaN,NaN,NaN,NaN,7.654993635818819,30.80916642860846,-132840,1.2146496744936268,11.276544088083028,10.061894413589402
2025-09-17T22:55:00-04:00,24616,24622.75,24614.25,24620.5,24589.699194506153,NaN,NaN,NaN,NaN,NaN,24582.75,24614.040254072534,24551.459745927466,24605.191378021125,24571.0308551543,24597.011396199334,24545.050314109263,1194,1008.6666666666666,76.1637761479182,69.41338275923816,NaN,NaN,NaN,NaN,7.715351233260331,32.56710862789292,-131646,1.3237295038271082,11.716556293373287,10.392826789546179
2025-09-17T23:00:00-04:00,24620.75,24644.75,24620,24638.75,24601.5083220286,NaN,NaN,NaN,NaN,NaN,24584.105,24618.912627044087,24549.297372955913,24618.3281024169,24574.22844433639,24603.102413938963,24545.354474733816,3730,1101.1333333333334,82.56386313735584,70.56918867121627,NaN,NaN,NaN,NaN,8.932111859456022,35.24345832882598,-127916,2.392629486325358,13.383613647452876,10.990984161127518
2025-09-17T23:05:00-04:00,24639,24643,24634.5,24636.5,24608.12726193639,NaN,NaN,NaN,NaN,NaN,24585.485,24622.92180141351,24548.04819858649,24618.3281024169,24575.534501995546,24605.50473972635,24545.56426426474,1548,1134.9333333333334,79.72182446363028,71.5219918207854,NaN,NaN,NaN,NaN,8.901246726637735,37.72864019397811,-129464,2.6933772478212266,14.35770572090405,11.664328473082824
2025-09-17T23:10:00-04:00,24636.25,24637.25,24629.25,24631,24608.12726193639,NaN,NaN,NaN,NaN,NaN,24586.64,24626.009170680798,24547.2708293192,24618.3281024169,24576.646618670817,24607.3515873101,24545.941650031535,1505,1156.8,73.0979788454994,72.06556884971853,NaN,NaN,NaN,NaN,8.836871960449326,39.02594006558207,-130969,2.2833502251849573,14.51851625456402,12.235166029379062
2025-09-17T23:15:00-04:00,24631.25,24636.75,24628.5,24636.75,24608.12726193639,NaN,NaN,NaN,NaN,NaN,24587.905,24629.505467549272,24546.304532450726,24618.3281024169,24577.514166049175,24608.77977314049,24546.24855895786,1184,1169.6,75.39926630559718,73.12901742006584,NaN,NaN,NaN,NaN,8.794952534702945,40.08986617478535,-129785,2.1620621328298935,14.93774369541643,12.775681562586536
2025-09-17T23:20:00-04:00,24636.75,24642.25,24635.5,24639.25,24609.252847745393,NaN,NaN,NaN,NaN,NaN,24589.32,24632.94763344432,24545.69236655568,24620.01659074996,24578.376192995493,24610.25239928279,24546.499986708197,1113,1166.1333333333334,76.34667005333844,73.83366455292115,NaN,NaN,NaN,NaN,8.648884496509877,41.376459822579456,-128672,2.015772946039686,15.295397745136142,13.279624799096457
2025-09-17T23:25:00-04:00,24639,24643,24637.25,24637.75,24611.065218302418,NaN,NaN,NaN,NaN,NaN,24590.595,24636.045290427628,24545.144709572374,24622.33827259997,24579.079022076126,24611.432160640572,24546.72588351168,926,1176,74.49297499881078,74.16009114467565,NaN,NaN,NaN,NaN,8.441821318187744,42.610509121808946,-129598,1.6016172689523351,15.281646385286876,13.680029116334541
2025-09-17T23:30:00-04:00,24638.5,24642.5,24635.5,24639,24611.065218302418,NaN,NaN,NaN,NaN,NaN,24591.89,24639.060876607724,24544.719123392275,24622.470618079977,24579.788268225162,24612.595765066264,24546.98077138406,962,1179.1,75.03691363534497,74.5882877838116,NaN,NaN,NaN,NaN,8.338834081174333,43.393917267856445,-128636,1.2131269559030873,15.1964378112134,13.983310855310313
2025-09-17T23:35:00-04:00,24638.5,24638.5,24633.5,24638,24611.065218302418,NaN,NaN,NaN,NaN,NaN,24593.16,24641.786511287984,24544.533488712015,24622.470618079977,24580.29390639481,24613.388735030614,24547.199077759007,729,1095.1666666666667,73.68318026965302,74.87089651621918,NaN,NaN,NaN,NaN,8.13606021823331,43.70585007891992,-129365,0.7147337946603862,14.876728098635795,14.161994303975408
2025-09-17T23:40:00-04:00,24638,24638.75,24633.5,24633.75,24611.065218302418,NaN,NaN,NaN,NaN,NaN,24594.27,24644.00558484475,24544.534415155253,24622.470618079977,24580.644034218276,24613.922382908877,24547.365685527675,525,1056.4,68.06308815352762,74.86790425178647,NaN,NaN,NaN,NaN,7.929913059788072,44.01443154335238,-129890,-0.03545417989257871,14.117676579109684,14.153130759002263
2025-09-17T23:45:00-04:00,24634.25,24634.25,24628,24630,24611.065218302418,NaN,NaN,NaN,NaN,NaN,24595.43,24645.73606722728,24545.12393277272,24622.470618079977,24581.166134079955,24614.659367769476,24547.672900390433,869,1038.6666666666667,63.4634292380374,74.26494184896478,NaN,NaN,NaN,NaN,7.80991926980321,43.16648859311262,-130759,-0.8721465329415174,13.062947592825367,13.935094125766884
2025-09-17T23:50:00-04:00,24630.25,24634.75,24626,24633.5,24611.065218302418,NaN,NaN,NaN,NaN,NaN,24596.655,24647.62223359435,24545.68776640565,24622.470618079977,24581.666629074316,24615.36415509092,24547.969103057712,839,1016.8,65.78735419211804,73.78139968556651,NaN,NaN,NaN,NaN,7.877067893388694,41.998501876830844,-129920,-1.2545314978064006,12.366929753508884,13.621461251315285
2025-09-17T23:55:00-04:00,24633,24639.75,24632.5,24635.5,24611.065218302418,NaN,NaN,NaN,NaN,NaN,24597.67,24649.659560496097,24545.6804395039,24622.470618079977,24582.183314324237,24616.13138645458,24548.235242193892,810,1020.9333333333333,67.07605704961492,73.19569640959976,NaN,NaN,NaN,NaN,7.8322773295752155,41.425888772768275,-129110,-1.4249873061092355,11.84022711867874,13.265214424787976
2025-09-18T00:00:00-04:00,24636,24640,24632.5,24638.25,24611.065218302418,NaN,NaN,NaN,NaN,NaN,24598.745,24651.812456129664,24545.677543870333,24622.470618079977,24582.601628316726,24616.75399683716,24548.449259796293,655,1016.1333333333333,68.81543212362197,72.8365577581477,NaN,NaN,NaN,NaN,7.808543234605557,40.91891283837715,-128455,-1.402563367516489,11.512010215392365,12.914573582908854
2025-09-18T00:05:00-04:00,24638,24638,24630,24632,24611.065218302418,NaN,NaN,NaN,NaN,NaN,24599.705,24653.403667579332,24546.00633242067,24622.470618079977,24583.012057152115,24617.32825325399,24548.69586105024,699,1017.6,60.93612157702461,71.74886814594102,NaN,NaN,NaN,NaN,7.840075860705161,39.93510310709646,-129154,-1.8315838889197344,10.625093721759185,12.45667761067892
2025-09-18T00:10:00-04:00,24632.25,24640.25,24631.5,24639.25,24611.065218302418,NaN,NaN,NaN,NaN,NaN,24601.125,24655.175277519043,24547.074722480957,24622.470618079977,24583.358487908095,24617.834971662556,24548.882004153635,558,1015,65.82445182260528,70.55319590917313,NaN,NaN,NaN,NaN,7.905070442083364,39.27797180776601,-128596,-1.655358075547289,10.387480016244808,12.042838091792097
2025-09-18T00:15:00-04:00,24639.25,24641.25,24635,24640.25,24611.896495494166,NaN,NaN,NaN,NaN,NaN,24602.43,24657.042090237286,24547.817909762714,24622.62722602545,24583.650397320187,24618.26949282735,24549.031301813025,460,1004.7,66.44811313480122,69.60507367139961,NaN,NaN,NaN,NaN,7.786851124791696,38.78176772731013,-128136,-1.504101136406204,10.162711671284342,11.666812807690546
2025-09-18T00:20:00-04:00,24640,24646,24636.5,24639.5,24614.918245698977,NaN,NaN,NaN,NaN,NaN,24603.735,24658.708394474215,24548.761605525786,24626.35178082036,24584.377998810454,24619.36575826628,24549.390239354627,1130,1021.3333333333334,65.48293516796551,69.0611419801472,NaN,NaN,NaN,NaN,7.909218901592289,38.83061048900978,-129266,-1.4846761035396163,9.810967678266024,11.29564378180564
2025-09-18T00:25:00-04:00,24639.5,24644,24638.5,24643.75,24615.365143621748,NaN,NaN,NaN,NaN,NaN,24605.16,24660.513388334217,24549.806611665783,24626.35178082036,24584.595487751827,24619.695808813784,24549.49516668987,335,999.3666666666667,68.29345120906646,68.55358375896643,NaN,NaN,NaN,NaN,7.73713183719284,38.8759644820166,-128931,-1.2264268515944217,9.762610217312613,10.989037068907034
2025-09-18T00:30:00-04:00,24643.75,24653.75,24641.5,24642.5,24621.246273457124,NaN,NaN,NaN,NaN,NaN,24606.735,24661.766210232687,24551.703789767314,24632.85013972503,24586.033876626494,24621.940253952165,24550.127499300823,2135,1048.1333333333334,66.57641913039839,67.85570869304215,NaN,NaN,NaN,NaN,8.059479563107638,39.785586844064184,-131066,-1.1802269345649812,9.513753400700807,10.693980335265788
2025-09-18T00:35:00-04:00,24642.25,24643.75,24635.75,24640.5,24621.246273457124,NaN,NaN,NaN,NaN,NaN,24608.295,24662.63988844378,24553.950111556216,24632.85013972503,24586.530277547972,24622.640541676767,24550.420013419178,845,1055.7,63.81198486040826,67.0927808260134,NaN,NaN,NaN,NaN,8.055231022885664,39.406291221930495,-131911,-1.3145305805203833,9.05081710961531,10.365347690135692
2025-09-18T00:40:00-04:00,24639.75,24645.5,24638,24644.75,24621.246273457124,NaN,NaN,NaN,NaN,NaN,24609.865,24663.79460318866,24555.935396811343,24632.85013972503,24586.836431481664,24623.08513420981,24550.58772875352,503,1045.2,66.95228322735336,66.51530722544257,NaN,NaN,NaN,NaN,8.015571664108117,39.22127185660282,-131408,-1.1530734638169058,8.92400586036456,10.077079324181465
2025-09-18T00:45:00-04:00,24644.5,24645.25,24641,24644,24621.246273457124,NaN,NaN,NaN,NaN,NaN,24611.48,24664.558700060534,24558.401299939465,24632.85013972503,24587.077361958567,24623.43595313393,24550.718770783205,395,1003.1666666666666,65.86604581038222,65.9569404783518,NaN,NaN,NaN,NaN,7.746602259528966,39.04946816022712,-131803,-1.131163311189912,8.663125185194076,9.794288496383988
2025-09-18T00:50:00-04:00,24644.5,24647,24644.25,24644.75,24621.246273457124,NaN,NaN,NaN,NaN,NaN,24613.035,24665.360424985804,24560.709575014196,24632.85013972503,24587.289484001252,24623.7510534833,24550.827914519203,339,977.0666666666667,66.45219498807285,65.8418766808193,NaN,NaN,NaN,NaN,7.407559240991183,39.06946625326547,-131464,-1.099562412854656,8.419835480315669,9.519397893170325
2025-09-18T00:55:00-04:00,24645,24648.5,24642,24646,24621.246273457124,NaN,NaN,NaN,NaN,NaN,24614.66,24665.922145878038,24563.397854121962,24632.85013972503,24587.531690555144,24624.109753622073,24550.953627488216,389,973.9,67.45527504804807,66.12700852439148,NaN,NaN,NaN,NaN,7.342733580920384,38.56849795412011,-131075,-1.0291291570924876,8.232986446804716,9.262115603897204
2025-09-18T01:00:00-04:00,24645.75,24650.75,24643.75,24647.5,24622.904828403258,NaN,NaN,NaN,NaN,NaN,24616.26,24666.51852763472,24566.00147236528,24634.276507028077,24587.916195511632,24624.688444174877,24551.143946848388,605,974.3666666666667,68.66602083593986,66.33262757037876,NaN,NaN,NaN,NaN,7.318252610854642,38.361632233791894,-130470,-0.9197487501853203,8.112429666165553,9.032178416350874
2025-09-18T01:05:00-04:00,24647.5,24649.75,24642,24647.5,24622.904828403258,NaN,NaN,NaN,NaN,NaN,24617.92,24666.691348152337,24569.14865184766,24634.276507028077,24588.332252635362,24625.30180538825,24551.362699882473,674,952.6333333333333,68.66602083593986,66.44619641225913,NaN,NaN,NaN,NaN,7.34909171007931,37.755930365634086,-130470,-0.8853211274175585,7.9255270070789265,8.810848134496485
2025-09-18T01:10:00-04:00,24647.25,24648.5,24643.75,24645.25,24622.904828403258,NaN,NaN,NaN,NaN,NaN,24619.46,24666.699216759833,24572.220783240165,24634.276507028077,24588.786130914377,24625.959401515778,24551.612860312976,754,952.3666666666667,64.49214244264238,66.13739000647486,NaN,NaN,NaN,NaN,7.1634423022165015,37.193492916630404,-131224,-1.0412491282094294,7.509286724234698,8.550535852444128
2025-09-18T01:15:00-04:00,24645,24646.75,24635,24636.5,24622.904828403258,NaN,NaN,NaN,NaN,NaN,24620.49,24666.917681394472,24574.06231860553,24634.276507028077,24589.62534274312,24627.05171079654,24552.198974689698,1610,969.7333333333333,51.40575267202637,65.45664937040355,NaN,NaN,NaN,NaN,7.491053566343894,34.830668347908,-132834,-1.7207559400106334,6.399590927430836,8.12034686744147
2025-09-18T01:20:00-04:00,24637,24637,24630.75,24634.25,24622.904828403258,NaN,NaN,NaN,NaN,NaN,24621.41,24667.06235590794,24575.75764409206,24634.276507028077,24590.172214313563,24627.688059173575,24552.65636945355,1212,974.4,48.67085446764847,64.23139241647807,NaN,NaN,NaN,NaN,7.402406883033616,32.74810061883348,-134046,-2.2740741715666903,5.277754152983107,7.551828324549797
2025-09-18T01:25:00-04:00,24634.25,24635,24614.75,24616.75,NaN,NaN,NaN,24650.643380321573,24650.643380321573,24650.643380321573,24622.195,24666.11723696999,24578.27276303001,24634.276507028077,24590.876633783824,24628.273056780938,24553.48021078671,2214,1008.4,33.66768743714516,61.889933438074074,NaN,NaN,NaN,NaN,8.320092105674073,32.6737190868426,-136260,-3.687330287874393,2.9426654647068062,6.629995752581199
2025-09-18T01:30:00-04:00,24617.25,24623.25,24610.75,24616,NaN,NaN,NaN,24643.3016357615,NaN,NaN,24622.97,24665.020284183327,24580.919715816675,24634.276507028077,24591.35784839939,24628.567753568565,24554.14794323022,1912,947.8,33.19540709349019,59.58368143275441,NaN,NaN,NaN,NaN,8.618656955268781,32.94203708547579,-138172,-4.488143549123576,1.0198163161767297,5.507959865300306
2025-09-18T01:35:00-04:00,24616,24618.75,24613.5,24615,NaN,NaN,NaN,24641.94701595416,NaN,NaN,24623.73,24663.754222663178,24583.70577733682,24634.276507028077,24591.533673238715,24628.666603243724,24554.400743233706,744,921,32.539975716174496,57.02986175469069,NaN,NaN,NaN,NaN,8.37803860132101,33.19118951277803,-138916,-4.868834568328178,-0.578083345109917,4.290751223218261
2025-09-18T01:40:00-04:00,24615,24623,24613.75,24615,NaN,NaN,NaN,24641.94701595416,NaN,NaN,24624.39,24662.691195801275,24586.088804198724,24634.276507028077,24591.858402289512,24628.867706554913,24554.84909802411,1320,914.8333333333334,32.539975716174496,54.59868722510327,NaN,NaN,NaN,NaN,8.44032155836951,32.65723379714661,-138916,-4.891329930384071,-1.8234111897618277,3.0679187406222432
2025-09-18T01:45:00-04:00,24615.25,24617.25,24611,24614.75,NaN,NaN,NaN,24639.709212883852,NaN,NaN,24624.935,24661.872218356795,24587.997781643207,24634.276507028077,24592.05278560162,24628.960417285914,24555.145153917325,912,905.7666666666667,32.354751963170656,52.35174201815773,NaN,NaN,NaN,NaN,8.283870018485974,32.43672240602753,-139828,-4.692942035522762,-2.7982588037812093,1.8946832317415527
2025-09-18T01:50:00-04:00,24615.25,24621.75,24614.5,24615,NaN,NaN,NaN,24639.709212883852,NaN,NaN,24625.475,24660.998970785135,24589.951029214863,24632.696205622462,24592.199332817945,24629.048278452694,24555.350387183196,621,889.3666666666667,32.76689437771748,49.90992852889802,NaN,NaN,NaN,NaN,8.21002216002269,31.456628075073347,-139207,-4.3239036196202845,-3.510196292783803,0.8137073268364816
2025-09-18T01:55:00-04:00,24615.5,24618.75,24612,24614.75,NaN,NaN,NaN,24639.709212883852,NaN,NaN,24625.95,24660.23075261829,24591.669247381713,24632.48196449797,24592.335371758832,24629.11726978495,24555.553473732714,632,879.5666666666667,32.55330004664826,47.53044668863131,NaN,NaN,NaN,NaN,8.105734862878213,30.8236585663214,-139839,-3.889304147671819,-4.047922857753292,-0.1586187100814731
2025-09-18T02:00:00-04:00,24614.75,24617.5,24606.25,24608.5,NaN,NaN,NaN,24637.44014326797,NaN,NaN,24626.255,24659.625869027273,24592.88413097273,24628.060571598377,24592.62616838235,24629.188632411693,24556.063704353008,1712,904.5666666666667,27.693132734709067,44.761942241962466,NaN,NaN,NaN,NaN,8.330325229815484,30.820435356041305,-141551,-3.810436170413297,-4.9216639230980945,-1.1112277526847973
2025-09-18T02:05:00-04:00,24608.75,24609.75,24596,24601.25,NaN,NaN,NaN,24629.153091301247,NaN,NaN,24626.415,24659.223323636168,24593.606676363834,24618.923457278703,24592.828088635993,24629.0347980326,24556.621379239386,2303,957.0333333333333,23.3400184706921,41.61085248643703,NaN,NaN,NaN,NaN,8.717444856257234,31.651645110446886,-143854,-4.013801101065235,-6.128479129016341,-2.114678027951106
2025-09-18T02:10:00-04:00,24601.25,24603,24589.25,24593.75,NaN,NaN,NaN,24623.083632605732,NaN,NaN,24626.44,24659.146659875973,24593.733340124025,24610.41376582296,24592.874461081123,24628.746098919222,24557.002823243023,2088,1009.1333333333333,19.861815898213422,38.12483784802801,NaN,NaN,NaN,NaN,9.07691308081029,32.8627225206192,-145942,-4.390209576261505,-7.602439998277987,-3.212230422016482
2025-09-18T02:15:00-04:00,24594,24602.25,24587.25,24599.25,NaN,NaN,NaN,24622.528694760018,NaN,NaN,24626.66,24658.47190972071,24594.84809027929,24600.704582784867,24592.93381567412,24628.49144393515,24557.376187413094,2019,1047.4666666666667,28.30017288755792,35.241562994572156,NaN,NaN,NaN,NaN,9.499990717895269,34.10834493748382,-143923,-4.015710633213945,-8.231868713533913,-4.2161580803199685
2025-09-18T02:20:00-04:00,24598.75,24600.25,24589.75,24592.5,NaN,NaN,NaN,24622.528694760018,NaN,NaN,24626.56,24658.766918506877,24594.353081493126,24600.704582784867,24592.946030329425,24628.327284562452,24557.5647760964,1149,1057.8,24.84281058730464,32.40946786204803,NaN,NaN,NaN,NaN,9.571419952331322,35.2649943245724,-145072,-3.962803086264798,-9.169661938150966,-5.206858851886168
2025-09-18T02:25:00-04:00,24592.5,24597.25,24591,24594.75,NaN,NaN,NaN,24621.654761134647,NaN,NaN,24626.375,24659.198505299886,24593.551494700114,24600.704582784867,24592.95568813651,24628.2137614212,24557.69761485182,813,1057.9,28.000355830795158,30.737653801960086,NaN,NaN,NaN,NaN,9.33417567002194,36.339025898297514,-144259,-3.5308452929826775,-9.620415468114516,-6.089570175131838
2025-09-18T02:30:00-04:00,24595,24605.75,24586,24605.75,NaN,NaN,NaN,24621.654761134647,NaN,NaN,24626.425,24659.11479198378,24593.73520801622,24600.704582784867,24593.073242633247,24628.00631329446,24558.140171972034,2253,1111.1666666666667,41.04161388734213,30.19270804622392,NaN,NaN,NaN,NaN,10.07816312216323,35.73709672917389,-142006,-2.3174980209795546,-8.986442701356282,-6.668944680376727
2025-09-18T02:35:00-04:00,24605.5,24612.25,24602,24609.5,NaN,NaN,NaN,24621.654761134647,NaN,NaN,24626.525,24658.975616319916,24594.074383680087,24600.704582784867,24593.24822343243,24628.011716650803,24558.48473021406,1420,1135.2,44.717801843195744,30.98200193237039,NaN,NaN,NaN,NaN,10.090437184865857,34.179801135264334,-140586,-1.1353926466071345,-8.088185488635645,-6.952792842028511
2025-09-18T02:40:00-04:00,24609.75,24615.5,24606.5,24615,NaN,NaN,NaN,24621.654761134647,NaN,NaN,24626.76,24658.699154662325,24594.820845337672,24598.538666227894,24593.443772732753,24628.082072325713,24558.805473139793,1247,1158.1666666666667,49.67412443491659,32.1590531710437,NaN,NaN,NaN,NaN,10.012548814518297,32.28151183004252,-139339,0.07943169570941855,-6.853503222391737,-6.9329349181011555
2025-09-18T02:45:00-04:00,24614.75,24622.5,24612,24614.5,24588.175371280875,24588.175371280875,24588.175371280875,NaN,NaN,NaN,24626.85,24658.624675460043,24595.075324539954,24595.705932982317,24593.762206188578,24628.263042977538,24559.261369399617,1717,1200.0666666666666,49.24190814206395,33.352048344321524,NaN,NaN,NaN,NaN,10.04736675633842,30.310121944531517,-141056,0.8679935300304136,-5.847943005563138,-6.715936535593552
2025-09-18T02:50:00-04:00,24614,24618.5,24610.5,24618.25,24588.175371280875,NaN,NaN,NaN,NaN,NaN,24626.99,24658.549461337825,24595.430538662178,24594.827224241006,24593.924367450018,24628.349190215526,24559.49954468451,917,1192.9666666666667,52.57483447954142,34.783109684562014,NaN,NaN,NaN,NaN,9.901126273742818,28.287588833009064,-140139,1.617291306418175,-4.694322402570833,-6.311613708989008
2025-09-18T02:55:00-04:00,24618,24626,24617.75,24624.75,24593.217125485262,NaN,NaN,NaN,NaN,NaN,24627.15,24658.581035615258,24595.718964384745,24600.964423514244,24594.197966955056,24628.57364658174,24559.822287328374,1188,1221.4,57.753075903574796,36.597275680305174,NaN,NaN,NaN,NaN,9.783188682761189,27.25968935503148,-138951,2.4745121458369406,-3.218473526692833,-5.692985672529773
2025-09-18T03:00:00-04:00,24624.75,24630.25,24620.25,24629,24596.531119781386,NaN,NaN,NaN,NaN,NaN,24627.415,24658.680093949977,24596.149906050025,24605.221538811395,24594.67936040809,24629.021681932187,24560.33703888399,1899,1213.5333333333333,60.76927515924785,38.59744573612876,NaN,NaN,NaN,NaN,9.798675205421103,26.729571946374257,-137052,3.205210480141,-1.686472572353523,-4.891683052494523
2025-09-18T03:05:00-04:00,24629.5,24635.5,24624,24625.25,24600.768341609506,NaN,NaN,NaN,NaN,NaN,24627.51,24658.719287077958,24596.30071292204,24609.727231049117,24595.132877216074,24629.461893866104,24560.803860566044,1745,1243.5333333333333,56.908545093079304,40.33710609658812,NaN,NaN,NaN,NaN,9.920198405033883,26.71871408606093,-138797,3.300455911708214,-0.7661131628592557,-4.06656907456747
2025-09-18T03:10:00-04:00,24625,24633.5,24622.25,24632.25,24600.768341609506,NaN,NaN,NaN,NaN,NaN,24627.38,24658.454787204228,24596.305212795774,24609.727231049117,24595.409687026462,24629.73654899985,24561.082825053076,1054,1261.9,61.788650604155904,42.772500230120045,NaN,NaN,NaN,NaN,10.015184233245748,26.443757806373654,-137743,3.6709363311043277,0.5221013393129397,-3.148834991791388
2025-09-18T03:15:00-04:00,24632.75,24652.5,24628.5,24651.5,24609.35607159048,NaN,NaN,NaN,NaN,NaN,24627.68,24659.384422406703,24595.975577593297,24619.505427871434,24596.6357015239,24631.37728210687,24561.89412094093,3359,1360.7,71.38571369343542,46.20433560317314,NaN,NaN,NaN,NaN,11.014099645156765,27.59410944221467,-134384,4.967907088222693,3.061048868486978,-1.906858219735715
2025-09-18T03:20:00-04:00,24651.5,24651.75,24625.25,24627,24609.35607159048,NaN,NaN,NaN,NaN,NaN,24627.6,24659.290692650484,24595.909307349513,24619.505427871434,24597.252993659193,24632.04497219614,24562.461015122244,2204,1422.8666666666666,53.10474086985003,48.57883024400433,NaN,NaN,NaN,NaN,12.120235384788426,28.205218976646407,-136588,3.974249032512061,3.060953070904361,-0.9132959616076997
2025-09-18T03:25:00-04:00,24626.5,24631,24619.5,24625.25,24609.35607159048,NaN,NaN,NaN,NaN,NaN,24627.37,24658.95848524893,24595.781514751066,24619.505427871434,24597.614849343954,24632.325603774065,24562.904094913843,1778,1469.1666666666667,52.0788387280129,50.2773063754654,NaN,NaN,NaN,NaN,12.075932857303538,28.00643379036082,-138366,3.039752145397163,2.8863942201387545,-0.15335792525840874
2025-09-18T03:30:00-04:00,24625,24633,24623.75,24628.25,24609.35607159048,NaN,NaN,NaN,NaN,NaN,24627.15,24658.557164785245,24595.742835214758,24619.505427871434,24597.997016587946,24632.65882128279,24563.335211893103,1733,1506.7666666666667,53.729084483749176,52.34061165378286,NaN,NaN,NaN,NaN,11.874080510353284,27.974560074819443,-136633,2.4875298967361035,2.956054445661721,0.46852454892561723
2025-09-18T03:35:00-04:00,24628,24632.75,24624.5,24629.25,24609.35607159048,NaN,NaN,NaN,NaN,NaN,24626.98,24658.247529484415,24595.712470515584,24619.505427871434,24598.28626398895,24632.912940759128,24563.65958721877,1319,1528.2666666666667,54.29409564355332,54.21873592612273,NaN,NaN,NaN,NaN,11.615217616756622,27.94496305324531,-135314,2.070553476903135,3.0567163950545364,0.9861629181514011
2025-09-18T03:40:00-04:00,24630,24642,24629.75,24637,24609.35607159048,NaN,NaN,NaN,NaN,NaN,24626.94,24658.150985243356,24595.729014756642,24619.505427871434,24598.75292085479,24633.419426499324,24564.086415210255,1750,1561.4666666666667,58.521363708092245,55.46728948474773,NaN,NaN,NaN,NaN,11.696273501274007,28.60709078286372,-133564,2.186255135945265,3.718981838082982,1.5327267021377171
2025-09-18T03:45:00-04:00,24637.5,24653.5,24637.5,24652.25,24611.743870643193,NaN,NaN,NaN,NaN,NaN,24627.225,24659.088184088945,24595.361815911052,24619.79571088393,24599.589830112564,24634.540440575583,24564.639219649544,2474,1590.2666666666667,65.31865967072099,56.93877932957097,NaN,NaN,NaN,NaN,12.039396822611577,29.90099778280719,-131090,3.1034133839252305,5.411993432044255,2.308580048119025
2025-09-18T03:50:00-04:00,24652.75,24667.75,24652.75,24667,24625.914603795776,NaN,NaN,NaN,NaN,NaN,24627.89,24661.604264041856,24594.175735958142,24633.036568707143,24600.834290377454,24636.529131014067,24565.13944974084,2923,1647.3,70.37540410835364,58.417442163387896,NaN,NaN,NaN,NaN,12.286582763853607,31.742193010356974,-128167,4.435848005399351,7.853390054868214,3.417542049468863
2025-09-18T03:55:00-04:00,24666.75,24671.75,24661.5,24663.25,24632.45257635051,NaN,NaN,NaN,NaN,NaN,24628.555,24663.691204972045,24593.418795027956,24638.854254965714,24601.69274589544,24637.91405196674,24565.47143982414,1988,1639.7666666666667,67.67381245192578,59.73400675694946,NaN,NaN,NaN,NaN,12.141112566435492,33.60496864396317,-130155,4.767984412426859,9.377522565002437,4.609538152575578
2025-09-18T04:00:00-04:00,24663.5,24679,24656.25,24678.5,24632.45257635051,NaN,NaN,NaN,NaN,NaN,24629.455,24667.256017177864,24591.65398282214,24641.308403972573,24603.428676845615,24640.8047810502,24566.05257264103,3833,1703.8,72.32633735490982,61.14482839090435,NaN,NaN,NaN,NaN,12.898890240261528,35.59453924622546,-126322,5.657410549947272,11.681301340009668,6.023890790062396
2025-09-18T04:05:00-04:00,24678,24683.75,24669.75,24676,24640.743204897884,NaN,NaN,NaN,NaN,NaN,24630.265,24670.22352975462,24590.306470245378,24646.596723178056,24604.738820078994,24643.026459731966,24566.451180426022,2804,1772.4666666666667,70.53412949628661,62.05776079038377,NaN,NaN,NaN,NaN,12.977540937385703,37.59991700896783,-129126,5.703851990423312,13.153705778091535,7.449853787668223
2025-09-18T04:10:00-04:00,24676.5,24696,24674,24686.5,24647.629877402527,NaN,NaN,NaN,NaN,NaN,24631.23,24674.135109254214,24588.324890745786,24655.277378542447,24606.256411141232,24645.736229155205,24566.77659312726,2995,1828.3,73.50380741708562,62.96737023737217,NaN,NaN,NaN,NaN,13.622002299001009,39.81867178824034,-126131,6.0361218142408415,14.995006055469275,8.958884241228434
2025-09-18T04:15:00-04:00,24687,24693,24681.5,24685.25,24650.010337520594,NaN,NaN,NaN,NaN,NaN,24632.295,24677.789141384892,24586.800858615105,24655.277378542447,24607.173650178323,24647.344481289398,24567.00281906725,1841,1859.2666666666667,72.5661812038797,64.08577281671505,NaN,NaN,NaN,NaN,13.470430706215224,41.8789440832791,-127972,5.766510105652683,16.16702187329429,10.400511767641605
2025-09-18T04:20:00-04:00,24685.5,24691.75,24679.75,24691.25,24650.010337520594,NaN,NaN,NaN,NaN,NaN,24633.335,24681.704164767954,24584.965835232044,24655.277378542447,24607.974552289368,24648.73460220694,24567.214502371797,1622,1892.6333333333334,74.2632502978965,64.97681565198225,NaN,NaN,NaN,NaN,13.365399941485565,43.523860352230976,-126350,5.583319223917304,17.379660797538236,11.796341573620932
2025-09-18T04:25:00-04:00,24691,24696,24683.75,24693,24652.711381914425,NaN,NaN,NaN,NaN,NaN,24634.39,24685.537742867287,24583.24225713271,24660.545017813733,24608.894765820147,24650.34867864039,24567.440852999905,1827,1932.4666666666667,74.75379749859256,65.21739306663632,NaN,NaN,NaN,NaN,13.28572851709374,45.18919378100543,-124523,5.179947825802335,18.27127635587385,13.091328530071516
2025-09-18T04:30:00-04:00,24692.75,24699,24688.25,24696.5,24656.68472819104,NaN,NaN,NaN,NaN,NaN,24635.53,24689.543113226628,24581.51688677337,24665.261014250988,24609.87317600775,24652.083208076856,24567.663143938644,1902,1938.8,75.74935219675747,66.83486530427257,NaN,NaN,NaN,NaN,13.104605051587043,46.8306669686575,-122621,4.759591703648532,19.04081815963218,14.28122645598365
2025-09-18T04:35:00-04:00,24696.5,24706.5,24695.25,24704,24664.079740545996,NaN,NaN,NaN,NaN,NaN,24636.735,24694.017231973325,24579.452768026676,24673.88381140079,24611.11815606617,24654.368936987463,24567.86737514488,2284,1938.1666666666667,77.77211563899138,68.67009936934247,NaN,NaN,NaN,NaN,12.972133262187969,48.57666154636435,-120337,4.595048231057984,20.02503674480613,15.429988513748146
2025-09-18T04:40:00-04:00,24704.25,24708,24700,24703.25,24667.78634324845,NaN,NaN,NaN,NaN,NaN,24637.95,24698.171507786792,24577.72849221321,24677.90704912063,24611.883618571617,24655.76405138984,24568.003185753394,1407,1915.4666666666667,77.07973226226294,70.33800278209345,NaN,NaN,NaN,NaN,12.616980886317398,50.240161812699405,-121744,4.062500041126473,20.508113565156236,16.445613524029763
2025-09-18T04:45:00-04:00,24703.75,24719,24699.5,24719,24672.023327646246,NaN,NaN,NaN,NaN,NaN,24639.52,24703.876650005608,24575.163349994393,24685.175639296504,24613.410119632907,24658.659877546514,24568.1603617193,2623,1935.6,80.92105688763334,72.23992858524203,NaN,NaN,NaN,NaN,13.108625108723299,52.06575655977682,-119121,4.3709428735506926,21.909292115968128,17.538349242417436
2025-09-18T04:50:00-04:00,24718.75,24726,24717.5,24723,24685.05635820778,NaN,NaN,NaN,NaN,NaN,24641.085,24709.548903630806,24572.621096369192,24694.690511437202,24615.291819185986,24662.336696842343,24568.24694152963,3044,1998.7666666666667,81.75726686591653,73.89963595365805,NaN,NaN,NaN,NaN,12.77943760095735,53.91207853080794,-116077,4.430513690314278,23.07649135531028,18.645977664996003
2025-09-18T04:55:00-04:00,24723.5,24732.5,24720.25,24728,24689.678796471064,NaN,NaN,NaN,NaN,NaN,24642.765,24715.42636593763,24570.10363406237,24701.327409149762,24617.274837256304,24666.17600623851,24568.373668274096,3182,2077.733333333333,82.773631317468,75.14641964271141,NaN,NaN,NaN,NaN,12.741620629460396,55.75334755198232,-112895,4.384693175380601,24.126844134221756,19.742150958841155
2025-09-18T05:00:00-04:00,24728.25,24731,24720,24722,24689.678796471064,NaN,NaN,NaN,NaN,NaN,24644.31,24720.28411137959,24568.33588862041,24701.327409149762,24618.54932910033,24668.526097160626,24568.572561040033,2158,2074.5666666666666,77.21429197063439,75.6349116328743,NaN,NaN,NaN,NaN,12.617219155927511,57.42049912428534,-115053,3.5632294979448815,24.196187831272255,20.632958333327373
2025-09-18T05:05:00-04:00,24722.75,24730.25,24718.25,24728.25,24689.678796471064,NaN,NaN,NaN,NaN,NaN,24645.955,24725.482900133615,24566.42709986639,24701.327409149762,24619.383001180457,24670.046198444434,24568.71980391648,1423,2074.6666666666665,78.8107592505458,76.43040783277574,NaN,NaN,NaN,NaN,12.573132073361261,58.65632135601302,-113630,3.0723152573051884,24.47335240495886,21.40103714765367
2025-09-18T05:10:00-04:00,24728.25,24733.5,24708.5,24711,24689.678796471064,NaN,NaN,NaN,NaN,NaN,24647.225,24728.812453081253,24565.637546918744,24701.327409149762,24620.793961774867,24672.433043085202,24569.15488046453,2661,2121.8,65.22703396788914,75.92331473370284,NaN,NaN,NaN,NaN,13.4607654966926,58.20960267649492,-116291,1.307600007881895,23.03553715750604,21.727937149624147
2025-09-18T05:15:00-04:00,24711.25,24724.25,24711.25,24717.75,24689.678796471064,NaN,NaN,NaN,NaN,NaN,24648.63,24732.573507191883,24564.68649280812,24701.327409149762,24621.517684772673,24673.636161428836,24569.39920811651,1394,2111.0333333333333,67.58166791947818,75.71242462107367,NaN,NaN,NaN,NaN,13.445710818357414,57.794792474085256,-114897,0.3656438999126337,22.18499202451494,21.819348124602307
2025-09-18T05:20:00-04:00,24717.75,24721,24711.5,24711.75,24689.678796471064,NaN,NaN,NaN,NaN,NaN,24649.96,24735.73443442307,24564.18556557693,24701.327409149762,24622.2138661685,24674.75408132293,24569.673651014065,1405,2127.3,63.46764941697963,74.99555619249466,NaN,NaN,NaN,NaN,13.163874331331884,57.40961157184772,-116302,-0.8257524120830162,20.787157609498536,21.612910021581552
2025-09-18T05:25:00-04:00,24712.25,24723,24709.75,24719,24689.678796471064,NaN,NaN,NaN,NaN,NaN,24651.61,24739.434777824063,24563.78522217594,24701.327409149762,24622.79767677301,24675.700028116913,24569.89532542911,1163,2126.4666666666667,66.14915261331812,74.53719700745458,NaN,NaN,NaN,NaN,13.170026164808178,57.15968767706671,-115139,-1.2635719457767536,20.03344508936061,21.297017035137365
2025-09-18T05:30:00-04:00,24718.75,24729,24717.5,24727.5,24689.678796471064,NaN,NaN,NaN,NaN,NaN,24653.475,24743.674293236596,24563.2757067634,24701.327409149762,24623.511512007663,24676.908661853493,24570.114362161832,1336,2107.7,69.02022755181389,74.16269538273438,NaN,NaN,NaN,NaN,13.050738581607593,57.23337476237036,-113803,-1.1234609147861825,19.892690891654638,21.01615180644082
2025-09-18T05:35:00-04:00,24728.25,24732,24721.25,24727,24689.678796471064,NaN,NaN,NaN,NaN,NaN,24655.68,24747.55513482999,24563.804865170012,24701.327409149762,24624.212285349127,24678.098807302973,24570.32576339528,1303,2092.9666666666667,68.65136892341329,73.72680762736445,NaN,NaN,NaN,NaN,12.886400111492765,57.44403362537106,-115106,-1.2002574336767928,19.51583001434483,20.71608744802162
2025-09-18T05:40:00-04:00,24727,24729,24718.5,24719.75,24689.678796471064,NaN,NaN,NaN,NaN,NaN,24657.755,24750.63263401368,24564.877365986322,24701.327409149762,24624.785482462044,24679.03279185594,24570.538173068147,1127,2095.4,63.36355930354371,72.84210813499203,NaN,NaN,NaN,NaN,12.715942960671853,57.12584127343108,-116233,-1.8370152035031175,18.419818443642725,20.256833647145843
2025-09-18T05:45:00-04:00,24719.75,24724.5,24713.5,24719.75,24689.678796471064,NaN,NaN,NaN,NaN,NaN,24659.85,24753.497904409574,24566.202095590423,24700.58720950026,24625.369905329542,24679.95406269909,24570.785747959995,1202,2023.5,63.36355930354371,71.81292553960292,NaN,NaN,NaN,NaN,12.593375606338148,55.94716512238739,-116233,-2.324500950767085,17.351207458686986,19.67570840945407
2025-09-18T05:50:00-04:00,24720,24730.75,24717.75,24718.25,24689.678796471064,NaN,NaN,NaN,NaN,NaN,24661.915,24756.0680461518,24567.761953848203,24700.58720950026,24626.11655651857,24681.146057975235,24571.087055061904,1509,2000.3333333333333,62.213724551831184,70.75106784600065,NaN,NaN,NaN,NaN,12.622420205885422,55.268833686008,-117742,-2.783299565618492,16.196583952430956,18.979883518049448
2025-09-18T05:55:00-04:00,24718.5,24721.5,24715.25,24717,24689.678796471064,NaN,NaN,NaN,NaN,NaN,24663.96,24758.36791068815,24569.55208931185,24700.58720950026,24626.60715446865,24681.896020836695,24571.318288100603,1052,1976.1333333333334,61.216782754590405,69.34361969364043,NaN,NaN,NaN,NaN,12.167247334036464,54.21472450695924,-118794,-3.1777685414544408,15.007672841231397,18.185441382685838
2025-09-18T06:00:00-04:00,24717.5,24721.25,24713.75,24720.5,24689.678796471064,NaN,NaN,NaN,NaN,NaN,24666.07,24760.72210193148,24571.41789806852,24700.58720950026,24627.133956531838,24682.69892972547,24571.568983338206,1135,1956.2,63.004407289384204,68.00412972388813,NaN,NaN,NaN,NaN,11.833872524462432,52.97962350539983,-117659,-3.200861549847424,14.18436444537656,17.385225995223983
2025-09-18T06:05:00-04:00,24721.25,24729.5,24720.75,24729,24689.817711192136,NaN,NaN,NaN,NaN,NaN,24668.355,24763.45626655449,24573.25373344551,24704.464205447235,24627.749925961245,24683.688165968193,24571.811685954297,1236,1953.4333333333334,66.98444053197841,66.87633038206744,NaN,NaN,NaN,NaN,11.6314530584294,52.42466002339271,-116423,-2.6635889929067,14.05573975409061,16.71932874699731
2025-09-18T06:10:00-04:00,24729.25,24729.25,24724.5,24727.25,24692.524860683403,NaN,NaN,NaN,NaN,NaN,24670.73,24765.664547978628,24575.79545202137,24706.84636435779,24628.10683883584,24684.25958087863,24571.95409679305,719,1919.0666666666666,65.42389335809148,66.03415905260009,NaN,NaN,NaN,NaN,11.139920697113014,51.90933679010038,-117142,-2.4513150669613104,13.65518491329567,16.10649998025698
2025-09-18T06:15:00-04:00,24728,24728,24721.5,24723,24692.524860683403,NaN,NaN,NaN,NaN,NaN,24673.165,24767.086382549278,24579.243617450724,24706.84636435779,24628.46916439125,24684.824384904838,24572.11394387766,757,1861.8333333333333,61.66649047168442,64.80956842553856,NaN,NaN,NaN,NaN,10.808497790176371,50.886313072745324,-117899,-2.607828853278235,12.846713913659187,15.454542766937422
2025-09-18T06:20:00-04:00,24723.25,24724.5,24714.5,24717.25,24692.524860683403,NaN,NaN,NaN,NaN,NaN,24675.635,24767.546708178117,24583.72329182188,24706.84636435779,24628.86953676604,24685.41873819864,24572.32033533344,894,1794.2,56.904772505506756,64.21512117822553,NaN,NaN,NaN,NaN,10.750747948020916,48.79102623778407,-118793,-3.07706964798939,11.608205706950685,14.685275354940075
2025-09-18T06:25:00-04:00,24717.5,24718,24706.5,24710.25,24692.524860683403,NaN,NaN,NaN,NaN,NaN,24677.855,24767.61652238227,24588.093477617727,24706.84636435779,24629.50066005382,24686.291649692117,24572.709670415526,1550,1779.6,51.67361102531583,63.078831400071074,NaN,NaN,NaN,NaN,10.804265951733708,45.75626385951784,-120343,-3.7904821108073072,9.947172716430941,13.737654827238249
2025-09-18T06:30:00-04:00,24709.75,24709.75,24700.75,24701,24692.524860683403,NaN,NaN,NaN,NaN,NaN,24680.025,24766.61779704456,24593.432202955442,24706.84636435779,24630.100281016836,24687.05123768384,24573.14932434983,1652,1706.9,45.695654976212715,61.809403225730584,NaN,NaN,NaN,NaN,10.711104098038444,42.70967770018977,-121995,-4.754488852766773,7.794543761279783,12.549032614046556
2025-09-18T06:35:00-04:00,24701.25,24706,24700.25,24704.25,24692.524860683403,NaN,NaN,NaN,NaN,NaN,24682.215,24765.547647261337,24598.882352738663,24706.84636435779,24630.482142249944,24687.529669291973,24573.434615207916,1071,1649.1333333333334,47.97305109038466,60.51111025980676,NaN,NaN,NaN,NaN,10.356739519607126,39.937596024741076,-120924,-5.016471168166348,6.278443653838622,11.29491482200497
2025-09-18T06:40:00-04:00,24704.5,24707,24701,24702,24692.524860683403,NaN,NaN,NaN,NaN,NaN,24684.14,24764.719597913867,24603.560402086132,24706.84636435779,24630.77117413301,24687.889309955433,24573.653038310586,820,1576.6333333333334,46.51855014988106,58.90384758824013,NaN,NaN,NaN,NaN,10.045543839635188,37.234413062944235,-121744,-5.164268226073148,4.839579539413535,10.003847765486682
2025-09-18T06:45:00-04:00,24702,24708.25,24697,24698.5,24692.524860683403,NaN,NaN,NaN,NaN,NaN,24685.92,24763.709487725137,24608.13051227486,24706.84636435779,24631.466701078996,24688.727695643476,24574.205706514516,2060,1583.9333333333334,44.27003045340259,57.162323411810796,NaN,NaN,NaN,NaN,10.131576422518389,35.21185100476414,-123804,-5.300750078576357,3.3779101672662364,8.678660245842593
2025-09-18T06:50:00-04:00,24698.75,24701.25,24693,24697,24692.524860683403,NaN,NaN,NaN,NaN,NaN,24687.56,24762.712482323375,24612.407517676627,24706.84636435779,24631.835539300915,24689.145719608114,24574.525358993717,1180,1569.2,43.30396601211087,55.72949531956559,NaN,NaN,NaN,NaN,9.997178106624219,33.7880847084361,-124984,-5.283268366015728,2.074574788322934,7.357843154338662
2025-09-18T06:55:00-04:00,24696.75,24708,24695.25,24706.5,24692.524860683403,NaN,NaN,NaN,NaN,NaN,24689.4,24761.76041735461,24617.039582645393,24706.84636435779,24632.393820768164,24689.824981886894,24574.962659649434,1654,1563.4333333333334,50.64922749924729,54.82132876211584,NaN,NaN,NaN,NaN,10.193808241865346,31.538698193193476,-123330,-4.456165754611284,1.7876359610745567,6.243801715685841
2025-09-18T07:00:00-04:00,24706.5,24739.25,24700.25,24725.25,24692.524860683403,NaN,NaN,NaN,NaN,NaN,24691.54,24761.650937802926,24621.429062197076,24706.82709148623,24634.52444426503,24692.87712111076,24576.1717674193,5178,1672.6333333333334,61.3047468730049,54.756401785056816,NaN,NaN,NaN,NaN,12.251393367446394,31.749327190349717,-118152,-2.564496640925296,3.038180914529221,5.602677555454517
2025-09-18T07:05:00-04:00,24725.75,24734.5,24716,24733.25,24692.524860683403,NaN,NaN,NaN,NaN,NaN,24693.71,24762.113315711664,24625.306684288335,24702.561673188986,24635.775075444813,24694.721429352518,24576.82872153711,2942,1694.5666666666666,64.797205035926,55.01214623372364,NaN,NaN,NaN,NaN,12.697722412628794,31.94491125913766,-115210,-0.7849371679140722,4.6215060955619265,5.406443263475999
2025-09-18T07:10:00-04:00,24733.5,24750.75,24731.75,24746.25,24703.590385468222,NaN,NaN,NaN,NaN,NaN,24696.055,24763.455763347163,24628.654236652837,24709.259557199442,24637.637257379432,24697.723281227132,24577.551233531733,3886,1777.2,69.59896015070419,55.483185723817925,NaN,NaN,NaN,NaN,13.147885097441023,32.960453943719784,-111324,1.1519440557581513,6.846373333173688,5.694429277415536
2025-09-18T07:15:00-04:00,24746.25,24753.25,24738.75,24744.5,24708.074913401484,NaN,NaN,NaN,NaN,NaN,24698.44,24764.06618075444,24632.81381924556,24712.807645759556,24638.963819446588,24699.851051811704,24578.076587081472,2784,1782.5666666666666,68.24937308390035,55.57353804895521,NaN,NaN,NaN,NaN,13.244464733338093,34.013744710565504,-114108,2.141960935799239,8.371880447164585,6.229919511365346
2025-09-18T07:20:00-04:00,24744.75,24755.75,24743,24745.25,24711.435144610507,NaN,NaN,NaN,NaN,NaN,24700.7,24764.81840609432,24636.58159390568,24717.021116607644,24640.11149346155,24701.691155052966,24578.531831870136,2408,1761.3666666666666,68.5310095365771,55.79547491884704,NaN,NaN,NaN,NaN,13.209145823813943,35.10370832340605,-111700,2.6412654655819825,9.531501343342825,6.890235877760842
2025-09-18T07:25:00-04:00,24745.5,24747,24734,24741.5,24711.435144610507,NaN,NaN,NaN,NaN,NaN,24702.5,24766.043134955864,24638.956865044136,24717.021116607644,24641.114026109848,24703.196893701566,24579.03115851813,2300,1731.9666666666667,65.40697852905079,56.06265263723035,NaN,NaN,NaN,NaN,13.194206836398662,35.00623681113683,-114000,2.513627166940263,10.032269836436171,7.518642669495908
2025-09-18T07:30:00-04:00,24741.5,24745,24736.5,24739.25,24711.435144610507,NaN,NaN,NaN,NaN,NaN,24704.745,24765.322181352454,24644.167818647544,24717.021116607644,24641.797854707464,24704.207953584886,24579.38775583004,1605,1713.5333333333333,63.535517818909476,56.53627730247341,NaN,NaN,NaN,NaN,12.858906348084473,34.915727549743984,-115605,2.0897216908287835,10.130794783031888,8.041073092203105
2025-09-18T07:35:00-04:00,24739,24742.25,24736,24739.25,24711.435144610507,NaN,NaN,NaN,NaN,NaN,24707.025,24763.932754303158,24650.117245696845,24717.021116607644,24642.425665058287,24705.120491814483,24579.73083830209,1510,1716.4333333333334,63.535517818909476,57.38355635915866,NaN,NaN,NaN,NaN,12.386841608935582,34.768057921783715,-115605,1.641170358205251,10.092536039959668,8.451365681754417
2025-09-18T07:40:00-04:00,24739.25,24739.75,24716,24722.5,24711.435144610507,NaN,NaN,NaN,NaN,NaN,24708.91,24761.321807830664,24656.498192169336,24717.021116607644,24643.52728195296,24706.533846378552,24580.520717527368,3125,1731.9,50.94927061108317,57.758814618792265,NaN,NaN,NaN,NaN,13.198495779725897,32.515380174215316,-118730,0.12799885407437728,8.611364249347389,8.483365395273012
2025-09-18T07:45:00-04:00,24722.25,24732.5,24719.5,24728,24711.435144610507,NaN,NaN,NaN,NaN,NaN,24710.885,24758.349640526754,24663.420359473243,24717.021116607644,24644.22312676021,24707.42098382003,24581.025269700393,2003,1752.2,54.16036724165188,58.200765772454204,NaN,NaN,NaN,NaN,13.184317509745478,30.423607980044665,-116727,-0.5534817131288712,7.791513253861922,8.344994966990793
2025-09-18T07:50:00-04:00,24728,24737.25,24725.5,24733,24711.435144610507,NaN,NaN,NaN,NaN,NaN,24712.805,24755.706665472502,24669.9033345275,24717.021116607644,24644.983057523164,24708.42927018763,24581.5368448587,2092,1775.1,56.92133980531545,58.9438221764138,NaN,NaN,NaN,NaN,13.081866259049374,28.881153142793924,-114635,-0.7085975112994305,7.459248077866505,8.167845589165935
2025-09-18T07:55:00-04:00,24733.5,24743,24730.75,24742.25,24711.435144610507,NaN,NaN,NaN,NaN,NaN,24714.605,24754.64998594951,24674.56001405049,24717.021116607644,24645.5857067109,24709.26947448461,24581.90193893719,1563,1788.4333333333334,61.53687379012459,60.17716812903681,NaN,NaN,NaN,NaN,13.022447240545846,27.905597565527497,-113072,-0.252826534874373,7.851812420572969,8.104638955447342
2025-09-18T08:00:00-04:00,24742.75,24743.75,24737,24743.25,24711.435144610507,NaN,NaN,NaN,NaN,NaN,24716.13,24754.583119506588,24677.676880493415,24717.021116607644,24646.194584055815,24710.130173788722,24582.258994322907,1555,1795.7333333333333,62.01074841513356,61.51336687210985,NaN,NaN,NaN,NaN,12.574415294792571,27.058798324182465,-111517,0.0360246856342652,8.149669812490174,8.113645126855909
2025-09-18T08:05:00-04:00,24743.25,24747.25,24731.75,24731.75,24711.435144610507,NaN,NaN,NaN,NaN,NaN,24717.5,24753.094241104554,24681.905758895446,24717.021116607644,24646.93459723073,24711.129643806275,24582.739550655187,2011,1819.3333333333333,53.80162490543697,61.73853811540912,NaN,NaN,NaN,NaN,12.783385630878815,25.704640131918953,-113528,-0.5926911266448958,7.37278121854979,7.965472345194685
2025-09-18T08:10:00-04:00,24731.75,24736.5,24723.25,24734.25,24711.435144610507,NaN,NaN,NaN,NaN,NaN,24718.615,24752.714004380803,24684.5159956192,24715.3192886231,24647.766405749026,24712.18612565606,24583.346685841992,2454,1863.5666666666666,55.190387023448444,61.30179812615508,NaN,NaN,NaN,NaN,12.816715228673186,24.113841988991,-111074,-0.8687637006498123,6.87951771938242,7.7482814200322325
2025-09-18T08:15:00-04:00,24734.25,24740.75,24728.75,24739.75,24711.435144610507,NaN,NaN,NaN,NaN,NaN,24719.89,24752.242613493283,24687.537386506716,24715.3192886231,24648.303943856317,24712.89574673591,24583.712140976724,1519,1874.1333333333334,58.16959354235124,60.828397305185455,NaN,NaN,NaN,NaN,12.7583784266251,22.54758017449526,-109555,-0.7159010645629147,6.853405089328589,7.569306153891504
2025-09-18T08:20:00-04:00,24739.5,24753,24736.75,24749.75,24711.435144610507,NaN,NaN,NaN,NaN,NaN,24721.155,24753.13044214302,24689.179557856976,24719.48647577503,24649.186906198287,24714.152358319807,24584.221454076767,2273,1899.6,62.987907054044825,60.356179226852646,NaN,NaN,NaN,NaN,13.007779967580449,22.101444126185985,-107282,-0.013392290106379434,7.55256579125853,7.56595808136491
2025-09-18T08:25:00-04:00,24750,24762.75,24749.5,24753.25,24717.915809898688,NaN,NaN,NaN,NaN,NaN,24722.515,24754.047587905792,24690.982412094207,24729.314180620022,24650.33727795408,24715.875744801106,24584.798811107055,2774,1957,64.52798111030299,60.090365514452834,NaN,NaN,NaN,NaN,13.02508139846756,22.345271787564254,-104508,0.5820130735937612,8.293474423357111,7.71146134976335
2025-09-18T08:30:00-04:00,24753.5,24766,24727.75,24730,24717.915809898688,NaN,NaN,NaN,NaN,NaN,24723.29,24753.59154451425,24692.988455485753,24729.314180620022,24652.231147859227,24718.370413028686,24586.09188268977,5437,2100.4,49.72596751007191,58.74714822684532,NaN,NaN,NaN,NaN,14.826861298577018,20.801703930816615,-109945,-0.6293730713063344,6.924745010630431,7.554118081936766
2025-09-18T08:35:00-04:00,24730,24741,24726.25,24729,24717.915809898688,NaN,NaN,NaN,NaN,NaN,24724.01,24753.08438047672,24694.935619523276,24729.314180620022,24653.23564056583,24719.55740897631,24586.913872155346,3325,2170.0333333333333,49.203177121868485,57.58973384061801,NaN,NaN,NaN,NaN,14.821371205821517,19.476840718224004,-113270,-1.4883407785079967,5.69369210880177,7.1820328873097665
2025-09-18T08:40:00-04:00,24729,24738,24726.75,24730.25,24717.915809898688,NaN,NaN,NaN,NaN,NaN,24724.685,24752.72190603429,24696.648093965712,24729.314180620022,24653.962643150397,24720.402812901277,24587.522473399516,2473,2228.5,49.91205635041633,56.61662945001136,NaN,NaN,NaN,NaN,14.56627326254855,18.246610592245148,-110797,-1.9344089565702065,4.764021691597009,6.698430648167215
2025-09-18T08:45:00-04:00,24730.25,24737.25,24729.75,24734,24717.915809898688,NaN,NaN,NaN,NaN,NaN,24725.285,24752.80481285931,24697.76518714069,24729.314180620022,24654.406781803704,24720.926707655624,24587.886855951783,1495,2253.1,52.07289736365134,55.797870846064356,NaN,NaN,NaN,NaN,14.061539458080798,17.104254046693352,-109302,-1.9343430091270282,4.2805018867584295,6.214844895885458
2025-09-18T08:50:00-04:00,24733.25,24733.75,24708.5,24710.5,NaN,NaN,NaN,24763.33561355408,24763.33561355408,24763.33561355408,24725.43,24752.557484212233,24698.302515787767,24729.314180620022,24655.531076941854,24721.98346357632,24589.078690307386,4861,2385.3333333333335,40.33075708088674,55.03940559390747,NaN,NaN,NaN,NaN,14.878572353932169,17.53057889203265,-114163,-3.389274871976802,1.9782513059144549,5.367526177891257
2025-09-18T08:55:00-04:00,24711.25,24715.5,24689,24690,NaN,NaN,NaN,24746.15558566526,NaN,NaN,24724.85,24753.688689300194,24696.011310699803,24729.314180620022,24656.375468746075,24722.434163644688,24590.316773847462,5519,2517.633333333333,33.2806193169275,53.54799502785572,NaN,NaN,NaN,NaN,15.7086743286513,18.881918404386173,-119682,-5.480723407453849,-1.4833780814260535,3.997345326027795
2025-09-18T09:00:00-04:00,24690,24693.25,24658.25,24668,NaN,NaN,NaN,24722.43260449866,NaN,NaN,24723.75,24756.69100787975,24690.80899212025,24729.314180620022,24657.087209568712,24721.819165015615,24592.35525412181,12335,2873.733333333333,27.687024362541067,51.459829639086124,NaN,NaN,NaN,NaN,17.086626162319064,21.171593521523793,-132017,-7.9447258922152155,-5.933562039241224,2.0111638529739917
2025-09-18T09:05:00-04:00,24668,24680,24650.5,24678.75,NaN,NaN,NaN,24713.833395203266,NaN,NaN,24722.765,24758.003957136323,24687.526042863676,24729.314180620022,24657.51882539535,24721.179487050355,24593.858163740344,10269,3180.3333333333335,33.5630013567654,49.461695893846176,NaN,NaN,NaN,NaN,17.973295722153416,23.501931453068213,-121748,-8.404934765607821,-8.495004604035785,-0.09006983842796368
2025-09-18T09:10:00-04:00,24678.5,24687.75,24670.75,24676.5,NaN,NaN,NaN,24713.833395203266,NaN,NaN,24721.855,24759.40045112415,24684.309548875848,24729.314180620022,24657.95960814319,24721.01385314715,24594.905363139227,6518,3370.266666666667,32.959329459329936,47.3865945398602,NaN,NaN,NaN,NaN,17.90377459914246,25.01714296571364,-128266,-8.39555279687669,-10.584510834523826,-2.1889580376471365
2025-09-18T09:15:00-04:00,24676.75,24694,24673.25,24675,NaN,NaN,NaN,24713.833395203266,NaN,NaN,24720.79,24760.507547760903,24681.0724522391,24720.126344496017,24658.449182636672,24720.909956687057,24595.988408586287,6757,3526.8333333333335,32.539145244579814,45.86784599265612,NaN,NaN,NaN,NaN,18.107076413489427,25.919885399377797,-135023,-8.025333793162455,-12.220625279100204,-4.19529148593775
2025-09-18T09:20:00-04:00,24674.75,24686,24673.5,24679.25,NaN,NaN,NaN,24713.833395203266,NaN,NaN,24720.155,24761.461765794644,24678.848234205354,24700.79268838196,24658.69338177914,24720.833309567122,24596.553453991157,3677,3610.0666666666666,35.06507944584115,44.43032402282704,NaN,NaN,NaN,NaN,17.70657095538304,26.75814623063737,-131346,-7.063113692404142,-13.024183601442928,-5.961069909038786
2025-09-18T09:25:00-04:00,24679.25,24691,24672.75,24679.5,NaN,NaN,NaN,24713.833395203266,NaN,NaN,24719.39,24762.234738298477,24676.54526170152,24700.79268838196,24659.138924478833,24720.73689125394,24597.540957703728,6461,3770.3,35.218737512033215,42.790977163518605,NaN,NaN,NaN,NaN,17.745387315712822,27.11078325576396,-124885,-6.019452331106173,-13.485385322921502,-7.465932991815329
2025-09-18T09:30:00-04:00,24679.25,24708.75,24654,24698,NaN,NaN,NaN,24713.833395203266,NaN,NaN,24719.115,24762.327291072157,24675.902708927846,24700.79268838196,24662.06006477549,24720.94898603053,24603.171143520452,38157,4869.6,45.496883636511825,41.541618347980524,NaN,NaN,NaN,NaN,20.38857393601905,28.1644031303765,-86728,-3.801063704460528,-12.21726262239099,-8.416198917930462
2025-09-18T09:35:00-04:00,24697.5,24713.5,24666.5,24668.25,NaN,NaN,NaN,24713.833395203266,NaN,NaN,24718.1,24763.599010981823,24672.600989018174,24691.83415070557,24663.479873255696,24720.552514474075,24606.407232037316,26734,5662.666666666667,35.6903395507138,39.481786808009865,NaN,NaN,NaN,NaN,22.28939008344626,28.747359588830097,-113462,-4.033209269813719,-13.45771050519761,-9.424501235383891
2025-09-18T09:40:00-04:00,24668.25,24677,24624.5,24624.75,NaN,NaN,NaN,24713.485356435736,NaN,NaN,24716.045,24768.421873715735,24663.66812628426,24668.717320564454,24661.659108166674,24716.57492047066,24606.74329586269,36235,6740.966666666666,26.64636583782236,37.83324383142061,NaN,NaN,NaN,NaN,24.44729079177153,30.520821961497152,-149697,-6.657433115567354,-17.746292629843083,-11.088859514275729
2025-09-18T09:45:00-04:00,24624.75,24657.5,24598.75,24656.25,NaN,NaN,NaN,24696.020112961385,NaN,NaN,24714.63,24769.509526234047,24659.750473765955,24642.04956102564,24659.690236191374,24712.734224930882,24606.646247451867,37781,7907.533333333334,38.750113944112144,37.08659646158088,NaN,NaN,NaN,NaN,26.89748430664499,32.670748734015866,-111916,-5.841900711846616,-18.391235404084,-12.549334692237384
2025-09-18T09:50:00-04:00,24656.5,24698.5,24653.25,24660.75,24604.895573991405,24604.895573991405,24604.895573991405,NaN,NaN,NaN,24713.45,24770.338838972824,24656.561161027177,24642.04956102564,24660.35833260673,24711.855582489574,24608.861082723888,29568,8812.866666666667,40.26647638701895,36.397626464195355,NaN,NaN,NaN,NaN,28.208378284741777,32.298438290118234,-82348,-4.622909335972688,-18.327971362203243,-13.705062026230555
2025-09-18T09:55:00-04:00,24660.5,24698,24641.5,24697.25,24604.895573991405,NaN,NaN,NaN,NaN,NaN,24713,24770.038145130296,24655.961854869704,24642.04956102564,24661.31477077636,24711.635023610455,24610.994517942265,26797,9629.433333333332,50.88726747424098,36.31293861495176,NaN,NaN,NaN,NaN,30.22920840726022,32.26310904682772,-55551,-1.1622374472035126,-15.157858835234947,-13.995621388031434
2025-09-18T10:00:00-04:00,24697,24727.25,24694,24722.25,24634.063167624397,NaN,NaN,NaN,NaN,NaN,24713.08,24770.15858091977,24656.001419080232,24642.04956102564,24663.87226226481,24714.26915393423,24613.475370595388,26266,10451.466666666667,56.58161797359964,37.47371439300268,NaN,NaN,NaN,NaN,30.444979235313063,30.927618936479877,-29285,2.790808059917648,-10.507111313134374,-13.297919373052022
2025-09-18T10:05:00-04:00,24721.75,24749.75,24720.75,24749.25,24658.213705459653,NaN,NaN,NaN,NaN,NaN,24713.725,24771.688199536886,24655.76180046311,24651.503920100404,24666.574212747077,24718.03070423413,24615.117721260023,20123,11071.9,61.74094205070974,39.50659458827284,NaN,NaN,NaN,NaN,30.341766432790703,28.853315792384425,-9162,6.966513146124223,-4.589777940396743,-11.556291086520966
2025-09-18T10:10:00-04:00,24749.25,24765.5,24743,24749.5,24677.647173393307,NaN,NaN,NaN,NaN,NaN,24714.305,24773.102133433767,24655.507866566233,24675.653136080324,24669.278400970506,24722.09980633583,24616.456995605182,18366,11579.933333333332,61.786221390303844,41.94225151882733,NaN,NaN,NaN,NaN,29.78164025901994,27.181152465472774,9204,9.339878982458284,0.11855764155188808,-9.221321340906396
2025-09-18T10:15:00-04:00,24749.25,24773.5,24746.25,24770.25,24683.038210966337,NaN,NaN,NaN,NaN,NaN,24715.13,24775.854726427482,24654.40527357252,24687.997508864257,24672.04887801494,24726.462270587537,24617.63548544234,17746,12104.7,65.44197944941888,44.219321382588305,NaN,NaN,NaN,NaN,29.600808811947086,25.884172047553548,26950,11.74613236994305,5.461344121522416,-6.284788248420634
2025-09-18T10:20:00-04:00,24770,24781.75,24754,24769.25,24690.74670137696,NaN,NaN,NaN,NaN,NaN,24715.97,24778.4778906991,24653.4621093009,24699.47300709141,24674.928124781953,24730.974667904437,24618.88158165947,18571,12654,65.11866172621913,46.516416544508964,NaN,NaN,NaN,NaN,29.468608182522296,24.942072817667064,8379,12.632053258931007,9.505278325243125,-3.126774933687882
2025-09-18T10:25:00-04:00,24768.75,24790,24768.5,24786.5,24702.695714950733,NaN,NaN,NaN,NaN,NaN,24717.24,24782.77464426865,24651.705355731352,24713.428405673127,24677.287550309575,24734.890102956368,24619.684997662782,14038,13069.833333333334,68.0509385768049,49.052973211096464,NaN,NaN,NaN,NaN,28.899421883770703,24.326994123036492,22417,13.654499114773612,13.941348959779134,0.2868498450055217
2025-09-18T10:30:00-04:00,24786.25,24809,24781.25,24782.75,24718.266364271156,NaN,NaN,NaN,NaN,NaN,24718.55,24786.60328794408,24650.49671205592,24733.8677245385,24680.85953476171,24740.919887383192,24620.799182140225,20596,13704.533333333333,66.73750340885228,51.315289208454395,NaN,NaN,NaN,NaN,28.817320320644225,24.315393943702958,1821,13.337625567963322,16.958881804959674,3.6212562369963526
2025-09-18T10:35:00-04:00,24782.75,24786.25,24762.5,24764.25,24718.266364271156,NaN,NaN,NaN,NaN,NaN,24719.63,24788.826476789047,24650.433523210955,24733.8677245385,24682.888744774616,24743.756118329326,24622.021371219907,15100,14140.833333333334,60.53060444677377,53.12327970379301,NaN,NaN,NaN,NaN,28.455368869169636,23.502013376485202,-13279,11.22619391352502,17.653998628902627,6.427804715377608
2025-09-18T10:40:00-04:00,24763.75,24776.75,24758.25,24760.75,24718.266364271156,NaN,NaN,NaN,NaN,NaN,24720.825,24790.753123810366,24650.896876189636,24733.8677245385,24684.56578662959,24745.923019155427,24623.208554103756,13942,14523.766666666666,59.404941701142484,54.11671242269521,NaN,NaN,NaN,NaN,27.744271092800375,22.57239380526707,-27221,9.032330930408293,17.718218378387974,8.685887447979681
2025-09-18T10:45:00-04:00,24760,24778.75,24751,24768.75,24718.266364271156,NaN,NaN,NaN,NaN,NaN,24722.115,24793.143530181223,24651.08646981878,24733.8677245385,24686.509215947095,24748.39505621301,24624.62337568118,16705,15029.966666666667,61.18188805478258,55.937537315842974,NaN,NaN,NaN,NaN,27.744680300457492,21.407788203251936,-10516,7.6151241348566945,18.20479261655055,10.589668481693854
2025-09-18T10:50:00-04:00,24769,24769.25,24745,24746.5,24718.266364271156,NaN,NaN,NaN,NaN,NaN,24723.005,24794.11818372779,24651.89181627221,24733.8677245385,24687.830807858463,24749.80897988976,24625.852635827167,14098,15424.133333333333,54.090274748184626,57.897816523725986,NaN,NaN,NaN,NaN,27.495060278996245,20.076520043852735,-24614,4.811161974617125,16.60362094996526,11.792458975348136
2025-09-18T10:55:00-04:00,24746.75,24761.5,24731.75,24734.25,24718.266364271156,NaN,NaN,NaN,NaN,NaN,24723.72,24794.551605938064,24652.888394061938,24733.8677245385,24688.86511236009,24750.704370990446,24627.025853729734,13798,15791.6,50.61198093920407,58.74509273766113,NaN,NaN,NaN,NaN,27.656127401925087,18.97753967586356,-38412,1.91220777431246,14.182718693238712,12.270510918926252
2025-09-18T11:00:00-04:00,24734.75,24771,24733.5,24757,24718.266364271156,NaN,NaN,NaN,NaN,NaN,24724.92,24795.93298754739,24653.907012452608,24733.8677245385,24690.214758785267,24752.105912942476,24628.323604628058,15472,16126.1,56.23998651651434,59.8860577469108,NaN,NaN,NaN,NaN,28.35926115893044,17.68386800814384,-22940,1.3349422983739458,13.939188791893685,12.604246493519739
2025-09-18T11:05:00-04:00,24757.5,24776.75,24745,24774.25,24718.266364271156,NaN,NaN,NaN,NaN,NaN,24726.275,24798.407049047495,24654.142950952508,24733.8677245385,24691.980188688314,24754.18943546066,24629.77094191597,17925,16612.766666666666,59.96529252913646,60.53448810797476,NaN,NaN,NaN,NaN,28.60145679043541,16.719399258115892,-5015,1.8890877918894482,14.96560623338155,13.076518441492102
2025-09-18T11:10:00-04:00,24774,24787.25,24763,24777.75,24718.266364271156,NaN,NaN,NaN,NaN,NaN,24727.325,24800.88118600965,24653.76881399035,24733.8677245385,24693.422659048374,24756.053840703855,24630.791477392893,13323,16974.433333333334,60.69639875055856,60.828401020614685,NaN,NaN,NaN,NaN,28.290638448261454,16.246150100991972,8308,2.241532048839243,15.878433502541156,13.636901453701913
2025-09-18T11:15:00-04:00,24778,24810,24770.75,24808.75,24718.266364271156,NaN,NaN,NaN,NaN,NaN,24728.835,24805.834909741483,24651.835090258515,24733.8677245385,24695.47255947517,24759.12592561201,24631.819193338328,15746,17449.466666666667,66.52703943645842,61.17026511959673,NaN,NaN,NaN,NaN,29.07344998767135,16.614958094295304,24054,4.198955018008789,18.8855952262129,14.68664020820411
2025-09-18T11:20:00-04:00,24808.5,24815.75,24792.25,24797,24724.076303505135,NaN,NaN,NaN,NaN,NaN,24729.85,24809.047979773295,24650.652020226702,24742.55647095047,24697.23443534861,24761.798548352705,24632.67032234452,13358,17732.7,62.728557293399085,61.23757482696068,NaN,NaN,NaN,NaN,28.675346417123396,17.143361965158142,10696,4.321960807810717,20.089091217967507,15.76713041015679
2025-09-18T11:25:00-04:00,24797.25,24801.5,24776.5,24782.75,24724.076303505135,NaN,NaN,NaN,NaN,NaN,24730.615,24811.092836078136,24650.137163921867,24742.55647095047,24698.43582072299,24763.389516715597,24633.48212473038,10932,17913.133333333335,58.375408556215056,60.73281976316041,NaN,NaN,NaN,NaN,28.41282167304315,16.845566270910414,-236,3.1193464989192137,19.666313533805805,16.546967034886592
2025-09-18T11:30:00-04:00,24782.75,24806,24782.75,24790.75,24724.076303505135,NaN,NaN,NaN,NaN,NaN,24731.525,24813.656190785172,24649.39380921483,24742.55647095047,24699.740819517992,24765.18379569211,24634.297843343873,11399,17881.933333333334,60.05150289241784,60.37087984646032,NaN,NaN,NaN,NaN,28.04404869639721,16.734749138073713,11163,2.561735621292634,19.749136561502382,17.18740094020975
2025-09-18T11:35:00-04:00,24790.75,24791.75,24781,24790,24724.076303505135,NaN,NaN,NaN,NaN,NaN,24732.495,24816.204945047666,24648.785054952332,24742.55647095047,24700.424638529217,24766.067948477263,24634.78132858117,6492,17756.033333333333,59.808357351676,59.7821240446654,NaN,NaN,NaN,NaN,26.808759503797408,16.540921164369916,4671,1.873388010129002,19.529135952871002,17.655747942742
2025-09-18T11:40:00-04:00,24790,24793.75,24769.5,24773.25,24724.076303505135,NaN,NaN,NaN,NaN,NaN,24733.175,24817.642345761993,24648.707654238005,24742.55647095047,24701.23536798442,24767.018348189646,24635.452387779194,8713,17829.2,54.500924270843335,58.90808267766476,NaN,NaN,NaN,NaN,26.625990967811877,15.770684417150166,-4042,0.11382901508548926,17.79803421159886,17.68420519651337
2025-09-18T11:45:00-04:00,24773.5,24777.25,24761,24764.5,24724.076303505135,NaN,NaN,NaN,NaN,NaN,24733.68,24818.58736364,24648.77263636,24742.55647095047,24701.81711779852,24767.602500771754,24636.031734825287,7454,17852.433333333334,51.90944941175002,58.292285889448785,NaN,NaN,NaN,NaN,25.884848755825313,14.644964255980216,-11496,-1.714623661312519,15.540925619872723,17.255549281185242
2025-09-18T11:50:00-04:00,24764,24765.75,24725.25,24741.5,24724.076303505135,NaN,NaN,NaN,NaN,NaN,24734.06,24818.933880550325,24649.186119449678,24742.55647095047,24702.729769598332,24768.09237232158,24637.367166875087,18724,18354,45.75128980277407,57.317025039565316,NaN,NaN,NaN,NaN,26.92878813040922,15.014520696582249,-30220,-4.395900787064583,11.760673297354515,16.1565740844191
2025-09-18T11:55:00-04:00,24741.5,24751,24726.75,24736.5,24724.076303505135,NaN,NaN,NaN,NaN,NaN,24734.23,24819.088696668117,24649.37130333188,24742.55647095047,24703.234782691725,24768.26432177108,24638.20524361237,12591,18558.333333333332,44.51495163740703,56.126529581181344,NaN,NaN,NaN,NaN,26.737446121094276,15.35768024856985,-42811,-6.312417682376093,8.266051981448982,14.578469663825075
2025-09-18T12:00:00-04:00,24736.25,24756,24732.5,24755.75,24724.076303505135,NaN,NaN,NaN,NaN,NaN,24734.685,24819.75613552615,24649.613864473853,24742.55647095047,24703.773228515027,24768.59551352051,24638.950943509542,10711,17643.466666666667,50.10524085891634,55.84188430337648,NaN,NaN,NaN,NaN,26.506199969587545,15.409879232254529,-32100,-6.087165074218751,6.969513321051636,13.056678395270387
2025-09-18T12:05:00-04:00,24755.25,24758,24726.75,24729,24724.076303505135,NaN,NaN,NaN,NaN,NaN,24734.42,24819.477770958478,24649.36222904152,24742.55647095047,24704.14428495033,24768.71049368784,24639.57807621282,9802,17079.066666666666,43.54034409258635,55.33676738576093,NaN,NaN,NaN,NaN,26.845042828902724,15.680866891291817,-41902,-7.453039603292909,3.7403788911542506,11.19341849444716
2025-09-18T12:10:00-04:00,24728.75,24757.75,24720.5,24754.25,NaN,NaN,NaN,24816.3670357803,24816.3670357803,24816.3670357803,24734.64,24819.844762778674,24649.435237221325,24737.5311414083,24704.61797527331,24768.9467309063,24640.289219640323,10803,16231.333333333334,50.17629340211903,54.90364644901841,NaN,NaN,NaN,NaN,27.58825405540967,16.172854484147365,-31099,-6.409094893542045,3.182049877519603,9.591144771061648
2025-09-18T12:15:00-04:00,24754,24774,24753,24759.75,NaN,NaN,NaN,24816.3670357803,NaN,NaN,24735.2,24820.689005140342,24649.71099485966,24737.5311414083,24705.192518319098,24769.4553886424,24640.929647995796,9191,15278.333333333334,51.51311995447551,54.29991983654262,NaN,NaN,NaN,NaN,27.11766448002327,15.71537956188213,-21908,-5.1552387142854155,3.1470963782048784,8.302335092490294
2025-09-18T12:20:00-04:00,24759.25,24773.25,24753.25,24767.25,NaN,NaN,NaN,24816.3670357803,NaN,NaN,24735.86,24821.817731471972,24649.90226852803,24733.504930501313,24705.731663583723,24769.949705064304,24641.513622103143,8446,14574.266666666666,53.351193252653424,53.77526230097798,NaN,NaN,NaN,NaN,26.609259874307323,15.290581419778698,-13462,-3.6961581459573143,3.6821374100436515,7.378295556000966
2025-09-18T12:25:00-04:00,24767.25,24776,24760.75,24770.5,NaN,NaN,NaN,24816.3670357803,NaN,NaN,24736.475,24822.97356935266,24649.976430647337,24733.504930501313,24706.071716324033,24770.28423817604,24641.85919447203,5021,13848.4,54.16209846986626,52.89205223193568,NaN,NaN,NaN,NaN,25.797884168999655,14.73864348686695,-8441,-2.4477350999768888,4.318626681029855,6.766361781006744
2025-09-18T12:30:00-04:00,24770.5,24787.75,24770.25,24783,NaN,NaN,NaN,24816.3670357803,NaN,NaN,24737.14,24824.54309834586,24649.736901654138,24731.795540838946,24706.610797735913,24770.899668057213,24642.321927414614,6840,13200.866666666667,57.24081900852089,52.50007092587295,NaN,NaN,NaN,NaN,25.20517815692825,13.795646822965837,-1601,-0.800900233149906,5.765236489569361,6.566136722719267
2025-09-18T12:35:00-04:00,24782.5,24788.75,24779.25,24786.25,NaN,NaN,NaN,24816.3670357803,NaN,NaN,24737.8,24826.172733352814,24649.427266647184,24739.236432671158,24706.978997726514,24771.33906865078,24642.618926802246,4461,12678.8,58.03011759554283,52.47540728582493,NaN,NaN,NaN,NaN,24.08337971714766,12.974122606829761,2860,0.4208336628036111,7.092178801223781,6.67134513842017
2025-09-18T12:40:00-04:00,24786.5,24787,24779.75,24782.75,NaN,NaN,NaN,24816.3670357803,NaN,NaN,24738.855,24828.085381038138,24649.62461896186,24743.764146136928,24707.30050559767,24771.714249137294,24642.886762058042,4012,12200.333333333334,56.8138324572685,52.24414511188569,NaN,NaN,NaN,NaN,22.880995451637116,12.21127869184626,-1152,0.8803488003265629,7.7717811388283735,6.891432338501811
2025-09-18T12:45:00-04:00,24782.75,24792.75,24780.75,24790,NaN,NaN,NaN,24816.3670357803,NaN,NaN,24740.075,24830.394446964438,24649.755553035564,24752.16131690954,24707.797863456926,24772.32159755392,24643.274129359932,5908,11805.733333333334,58.74284848081251,52.16803733539545,NaN,NaN,NaN,NaN,22.103781490805893,11.843546138363216,4756,1.522064836926953,8.794013384660502,7.271948547733549
2025-09-18T12:50:00-04:00,24790,24793.75,24785.75,24786.25,NaN,NaN,NaN,24816.3670357803,NaN,NaN,24741.195,24832.383995498098,24650.0060045019,24757.279053527633,24708.109116804513,24772.70261154318,24643.515622065846,3700,11310.033333333333,57.31674630249988,52.36916748051376,NaN,NaN,NaN,NaN,21.096368527176903,11.56221237836232,1056,1.538877656583038,9.195545618462347,7.656667961879309
2025-09-18T12:55:00-04:00,24786.5,24791.5,24781.25,24787.75,NaN,NaN,NaN,24816.3670357803,NaN,NaN,24742.27,24834.3572325578,24650.182767442202,24757.279053527633,24708.428912911062,24773.085266478443,24643.77255934368,3917,10972.666666666666,57.758499450769385,52.78695676901515,NaN,NaN,NaN,NaN,20.32162791809284,10.976859236886956,4973,1.4946672120376991,9.525001976926433,8.030334764888734
2025-09-18T13:00:00-04:00,24787.5,24796,24785,24790.25,NaN,NaN,NaN,24816.3670357803,NaN,NaN,24743.865,24836.457127633537,24651.272872366466,24763.058594257684,24708.90517600766,24773.673848713413,24644.13650330191,5634,10473.933333333332,58.528873075440686,53.69964128849134,NaN,NaN,NaN,NaN,19.65579735251478,10.732358306671205,10607,1.474937167169255,9.874006223850301,8.399069056681046
2025-09-18T13:05:00-04:00,24790.25,24796.75,24787.75,24791.25,NaN,NaN,NaN,24816.3670357803,NaN,NaN,24745.89,24838.109366730165,24653.670633269834,24765.89687540615,24709.36132846479,24774.24265972367,24644.47999720591,5359,10149.233333333334,58.85213462698331,54.72372578774679,NaN,NaN,NaN,NaN,18.8946689701923,10.556274176230708,15966,1.3724970682302882,10.114690391968907,8.742193323738618
2025-09-18T13:10:00-04:00,24791,24793.25,24782.75,24783.75,NaN,NaN,NaN,24816.3670357803,NaN,NaN,24748.205,24838.273290201356,24658.136709798648,24765.89687540615,24709.676921696995,24774.612693198495,24644.741150195496,4002,9817.9,55.3663537266464,55.09951956401322,NaN,NaN,NaN,NaN,18.295049758035706,9.986838556794755,11964,0.6780076481195803,9.589702883888094,8.911695235768514
2025-09-18T13:15:00-04:00,24784.25,24792.5,24778,24782.5,NaN,NaN,NaN,24816.3670357803,NaN,NaN,24750.28,24838.615985874138,24661.94401412586,24765.89687540615,24710.140907059667,24775.13992514734,24645.141888971993,6124,9465.2,54.783949341577554,55.90263422465545,NaN,NaN,NaN,NaN,18.02397477531887,9.462351771290015,5840,0.04615454867928648,8.969388421617623,8.923233872938336
2025-09-18T13:20:00-04:00,24783.5,24787,24773.75,24774.75,NaN,NaN,NaN,24816.3670357803,NaN,NaN,24752.245,24838.269559866618,24666.22044013338,24765.89687540615,24710.52816771125,24775.545556704732,24645.51077871777,5614,9182.4,51.1886986781076,55.974948887226056,NaN,NaN,NaN,NaN,17.682976577081806,9.30083968975676,226,-0.9282365452413579,7.762938191386638,8.691174736627996
2025-09-18T13:25:00-04:00,24774.5,24777.25,24762,24762.75,NaN,NaN,NaN,24816.3670357803,NaN,NaN,24754,24837.18287083208,24670.81712916792,24765.89687540615,24710.9614036827,24775.918644753787,24646.004162611614,7616,8976.333333333334,46.139599668947156,55.59112600968832,NaN,NaN,NaN,NaN,17.50919253586168,9.961667134283262,-7390,-2.3353540591659083,5.771982162670611,8.107336221836519
2025-09-18T13:30:00-04:00,24763,24766.5,24746.25,24747.75,NaN,NaN,NaN,24815.11745679372,NaN,NaN,24755.37,24835.79389197198,24674.946108028016,24765.89687540615,24711.31071477639,24776.114509872983,24646.5069196798,8268,8736.2,40.731277811762865,54.68970347819613,NaN,NaN,NaN,NaN,17.704964497585845,11.448382469029909,-15658,-4.126062931771446,2.9497575571222114,7.075820488893657
2025-09-18T13:35:00-04:00,24747.75,24748,24730.25,24746.5,NaN,NaN,NaN,24797.617799666732,NaN,NaN,24756.71,24834.21234577259,24679.207654227408,24765.89687540615,24711.666643355933,24776.17094017634,24647.162346535526,11979,8538,40.30726838550939,53.70007275788493,NaN,NaN,NaN,NaN,17.708181319186856,13.52623915052462,-27637,-5.1764305089616665,0.6052823526915745,5.781712861653241
2025-09-18T13:40:00-04:00,24746.5,24747.75,24729,24735,NaN,NaN,NaN,24796.765854227335,NaN,NaN,24757.45,24833.38668414961,24681.513315850392,24765.89687540615,24711.856710944627,24776.15848928633,24647.554932602925,7626,8348.1,36.538726126675094,52.22135183775309,NaN,NaN,NaN,NaN,17.782596939244936,15.505482350114693,-35263,-6.3500374228473735,-2.1558339169059764,4.194203505941397
2025-09-18T13:45:00-04:00,24735.25,24745.25,24727.5,24736,NaN,NaN,NaN,24794.53217903518,NaN,NaN,24758.805,24830.633357214032,24686.97664278597,24765.89687540615,24712.019495593362,24776.137127170554,24647.90186401617,6896,8053.1,37.089533532557844,50.72559583325416,NaN,NaN,NaN,NaN,17.780268586441725,17.406009947369867,-28367,-6.72717213422397,-4.2147616618385655,2.5124104723854046
2025-09-18T13:50:00-04:00,24736.25,24748,24726.5,24745.25,NaN,NaN,NaN,24794.53217903518,NaN,NaN,24761.215,24822.150376424714,24700.279623575287,24765.89687540615,24712.204375428577,24776.149267945108,24648.259482912046,6894,7837.633333333333,42.09594329380001,49.67431803586356,NaN,NaN,NaN,NaN,18.045963687410172,18.880173623113052,-21473,-6.043495161987044,-5.041958480098401,1.0015366818886433
2025-09-18T13:55:00-04:00,24745.75,24747.25,24722.75,24734.75,NaN,NaN,NaN,24794.12978502999,NaN,NaN,24762.785,24816.430876819875,24709.139123180124,24763.31750032492,24712.39457458927,24776.10478524941,24648.684363929133,8785,7766.066666666667,38.363807477706025,48.21867224992737,NaN,NaN,NaN,NaN,18.506966281166587,20.427589555387733,-30258,-5.977385966858678,-6.4701957766847045,-0.4928098098260263
2025-09-18T14:00:00-04:00,24734.75,24747.75,24727.5,24747,NaN,NaN,NaN,24794.12978502999,NaN,NaN,24764.51,24809.820259322965,24719.19974067703,24761.304000259934,24712.559758555788,24776.120768203236,24648.99874890834,6147,7591,44.54137837640563,47.30614596949208,NaN,NaN,NaN,NaN,18.63146868965469,21.806652230137484,-24111,-4.836346319820008,-6.538242709601036,-1.7018963897810284
2025-09-18T14:05:00-04:00,24747.25,24762.25,24745.75,24753.25,NaN,NaN,NaN,24794.12978502999,NaN,NaN,24765.63,24806.815342052003,24724.444657948,24755.418200207947,24712.89770622067,24776.306392219994,24649.489020221343,8729,7665.566666666667,47.43604518083717,46.56882780735406,NaN,NaN,NaN,NaN,18.479220926107928,21.565479979917807,-15382,-3.453259245517084,-6.018470446677384,-2.5652112011602997
2025-09-18T14:10:00-04:00,24753.25,24753.25,24729.25,24739,NaN,NaN,NaN,24794.12978502999,NaN,NaN,24765.965,24805.989618673088,24725.940381326913,24744.35956016636,24713.115358218238,24776.32071965316,24649.909996783317,8456,7657,42.04730543570123,45.391572975944094,NaN,NaN,NaN,NaN,18.87356228852879,22.258753065353204,-23838,-3.2913566748400704,-6.679407044710388,-3.3880503698703173
2025-09-18T14:15:00-04:00,24739,24751.25,24729.25,24733,NaN,NaN,NaN,24794.12978502999,NaN,NaN,24765.64,24806.458275323435,24724.821724676563,24730.062648133087,24713.26849090537,24776.3076065284,24650.229375282343,6685,7631.366666666667,39.987509661678196,44.04409976413659,NaN,NaN,NaN,NaN,19.096879267919594,22.90250664468607,-30523,-3.369358698913717,-7.599748743512464,-4.230390044598747
2025-09-18T14:20:00-04:00,24733.5,24745.5,24728.5,24743.5,NaN,NaN,NaN,24794.12978502999,NaN,NaN,24765.52,24806.562032107875,24724.477967892126,24715.88080546576,24713.400490200595,24776.30578936448,24650.49519103671,5528,7191.5,45.05974500606963,43.30791342695254,NaN,NaN,NaN,NaN,18.94710217735391,23.540683211544618,-24995,-2.5329683772432663,-7.39660051615283,-4.863632138909564
2025-09-18T14:25:00-04:00,24743,24751.5,24736.75,24738.25,NaN,NaN,NaN,24794.12978502999,NaN,NaN,24764.88,24806.599448698104,24723.1605513019,24715.88080546576,24713.523556881646,24776.32222419523,24650.72488956806,4660,6927.133333333333,43.09831538540694,42.473225287226064,NaN,NaN,NaN,NaN,18.64730916468577,23.509741465604144,-29655,-2.1666546685445622,-7.571950474590267,-5.405295806045705
2025-09-18T14:30:00-04:00,24738.25,24749,24737.75,24747.5,NaN,NaN,NaN,24794.12978502999,NaN,NaN,24764.445,24806.425863497432,24722.464136502567,24715.88080546576,24713.631831253504,24776.34839725568,24650.91526525133,3790,6696.433333333333,47.43952165500851,42.205426928433276,NaN,NaN,NaN,NaN,18.118929938636786,23.4810098443737,-25865,-1.18388427425809,-6.885151148868317,-5.701266874610227
2025-09-18T14:35:00-04:00,24747.75,24752,24742.5,24747.25,NaN,NaN,NaN,24794.12978502999,NaN,NaN,24763.66,24805.42921833306,24721.890781666938,24715.88080546576,24713.767776969864,24776.393758778442,24651.141795161286,4438,6517.633333333333,47.33441136425787,42.29077062095547,NaN,NaN,NaN,NaN,17.503292085877014,23.12918045563615,-30303,-0.4698187147470314,-6.288540268044017,-5.818721553296985
2025-09-18T14:40:00-04:00,24748,24752,24727.75,24732.75,NaN,NaN,NaN,24794.12978502999,NaN,NaN,24762.66,24804.944129414765,24720.375870585234,24715.88080546576,24713.892110760433,24776.377319531886,24651.40690198898,5780,6350.2,41.57998611327956,42.35139264249238,NaN,NaN,NaN,NaN,17.985199794028656,23.754978234714766,-36083,-0.8699355340789312,-6.906140970895649,-6.036205436816718
2025-09-18T14:45:00-04:00,24732.5,24761.5,24729.75,24750.75,NaN,NaN,NaN,24794.12978502999,NaN,NaN,24762.39,24804.802281239983,24719.977718760016,24715.88080546576,24714.145817066834,24776.461143712528,24651.83049042114,8434,6324.966666666666,49.747207994452786,43.0256740431312,NaN,NaN,NaN,NaN,18.968399808740894,23.375316625579796,-27649,0.12863133478436062,-5.8754162683362665,-6.004047603120627
2025-09-18T14:50:00-04:00,24750.25,24764,24749.75,24761.75,NaN,NaN,NaN,24794.12978502999,NaN,NaN,24762.41,24804.820112001315,24719.999887998685,24716.490434940424,24714.36378017786,24776.60313569748,24652.12442465824,5490,6226.433333333333,53.98122515770452,44.27156683106187,NaN,NaN,NaN,NaN,18.63137125097369,22.785130148265846,-22159,1.5045026935315047,-4.123419236206246,-5.6279219297377505
2025-09-18T14:55:00-04:00,24761.25,24766.25,24755,24756.25,NaN,NaN,NaN,24794.12978502999,NaN,NaN,24762.16,24804.565042154627,24719.754957845373,24722.61734795234,24714.54761904762,24776.725147581285,24652.370090513952,4603,6212.5,51.63850318336799,45.310778948976875,NaN,NaN,NaN,NaN,18.10413044733271,22.01917179729828,-26762,1.9883152278301726,-3.1425278949500353,-5.130843122780208
2025-09-18T15:00:00-04:00,24756,24759.25,24743.75,24750,NaN,NaN,NaN,24794.12978502999,NaN,NaN,24762.23,24804.542863296232,24719.917136703767,24722.61734795234,24714.730424291985,24776.805278080326,24652.655570503644,5654,6172.966666666666,49.03427073450985,45.80637376617044,NaN,NaN,NaN,NaN,17.918121129666087,22.092409062947954,-32416,1.8352453000402322,-2.8367864977299178,-4.67203179777015
2025-09-18T15:05:00-04:00,24750,24757,24746,24754.25,NaN,NaN,NaN,24794.12978502999,NaN,NaN,24762.63,24804.249735699916,24721.010264300086,24722.61734795234,24714.876398076376,24776.875124312995,24652.877671839757,4384,6170.4,50.84948449081513,46.698207838535374,NaN,NaN,NaN,NaN,17.423969620404225,22.160415095336933,-28032,1.9569165368473396,-2.225886126710975,-4.182802663558315
2025-09-18T15:10:00-04:00,24754.5,24755.25,24744.5,24746.5,NaN,NaN,NaN,24794.12978502999,NaN,NaN,24762.42,24804.256639449697,24720.5833605503,24722.61734795234,24715.003385098964,24776.920405805085,24653.086364392842,4259,6178.633333333333,47.525394893533814,46.9113518754731,NaN,NaN,NaN,NaN,16.947257504661067,22.32771052402707,-32291,1.4741398312695608,-2.3401278744713636,-3.8142677057409244
2025-09-18T15:15:00-04:00,24746.25,24750.25,24736,24748,NaN,NaN,NaN,24794.12978502999,NaN,NaN,24761.895,24803.78343396613,24720.00656603387,24722.61734795234,24715.159323998814,24776.951188536616,24653.367459461013,5987,6181.266666666666,48.23078920180699,46.96811930554237,NaN,NaN,NaN,NaN,16.754596254328135,23.0419558627503,-26304,1.2247683456172185,-2.2833072737194016,-3.50807561933662
2025-09-18T15:20:00-04:00,24748,24748.75,24729,24730.5,NaN,NaN,NaN,24792.84682688738,NaN,NaN,24760.95,24803.49186173574,24718.40813826426,24722.61734795234,24715.275617889707,24776.91515800443,24653.636077774983,6383,6270.7,41.261901269460196,46.91201900795373,NaN,NaN,NaN,NaN,16.968553664733268,24.112086204206552,-32687,-0.08056391199489976,-3.608780509330245,-3.528216597335345
2025-09-18T15:25:00-04:00,24730.25,24734.25,24716.25,24721.25,NaN,NaN,NaN,24779.22310748341,NaN,NaN,24759.2,24800.923614418378,24717.476385581624,24722.61734795234,24715.338516990774,24776.757699601698,24653.91933437985,8421,6420.833333333333,38.12609112165049,46.779060540808885,NaN,NaN,NaN,NaN,17.042228402966607,25.733153345960837,-41108,-1.4526449022563717,-5.34402272515581,-3.8913778228994382
2025-09-18T15:30:00-04:00,24721.25,24731.75,24709,24717,NaN,NaN,NaN,24774.997057143257,NaN,NaN,24757.6,24799.53781110986,24715.662188890135,24722.61734795234,24715.36839887034,24776.553472808242,24654.18332493244,8906,6529.9,36.74436136718146,46.18510456660259,NaN,NaN,NaN,NaN,17.449926374183278,27.541836718752936,-50014,-2.4722367615820344,-6.981673774876981,-4.509437013294947
2025-09-18T15:35:00-04:00,24717.25,24727.75,24711.25,24715.5,NaN,NaN,NaN,24773.889236364015,NaN,NaN,24756.255,24799.182088184476,24713.327911815526,24722.61734795234,24715.384915961815,24776.389523322618,24654.380308601012,6922,6582,36.24508958845507,45.69558843824888,NaN,NaN,NaN,NaN,17.382074490313045,29.22132842205989,-56936,-3.03631326926023,-8.304828599870234,-5.268515330610004
2025-09-18T15:40:00-04:00,24715.25,24722.75,24707,24714.5,NaN,NaN,NaN,24768.939725620196,NaN,NaN,24754.73,24798.062648199728,24711.39735180027,24722.61734795234,24715.381566138305,24776.225047569897,24654.538084706714,6220,6655.933333333333,35.89492454901142,44.8709743592491,NaN,NaN,NaN,NaN,17.26549774100497,30.960885237498353,-63156,-3.2464825526710657,-9.326618521448836,-6.08013596877777
2025-09-18T15:45:00-04:00,24714.25,24716.25,24696.75,24707.25,NaN,NaN,NaN,24760.766329001097,NaN,NaN,24753.075,24797.206536340047,24708.943463659954,24718.175082151596,24715.31274004675,24775.91802243959,24654.70745765391,9476,6767.666666666667,33.37726477955712,43.874035317484754,NaN,NaN,NaN,NaN,17.425105045218903,32.96737644427262,-72632,-3.6152732315340455,-10.599227508195327,-6.983954276661281
2025-09-18T15:50:00-04:00,24707.25,24729,24700.75,24722.5,NaN,NaN,NaN,24760.766329001097,NaN,NaN,24752.06,24796.621144509907,24707.498855490096,24718.175082151596,24715.342360597784,24775.52001947959,24655.164701715978,16970,7146.2,42.51130584403781,43.940558155396054,NaN,NaN,NaN,NaN,18.198311827703268,33.28021146174868,-55662,-2.620014736390293,-10.258972697149147,-7.638957960758854
2025-09-18T15:55:00-04:00,24722.5,24725.5,24696.75,24698.25,NaN,NaN,NaN,24760.766329001097,NaN,NaN,24750.735,24797.617129854287,24703.852870145714,24718.175082151596,24715.210124047662,24774.92762475418,24655.492623341146,19028,7526.6,34.42815274475579,42.84633992327484,NaN,NaN,NaN,NaN,18.95200384001018,33.767937818537284,-74690,-3.336795917145791,-11.809952857191092,-8.473156940045302
2025-09-18T16:00:00-04:00,24698.5,24710.75,24687.75,24700.25,NaN,NaN,NaN,24756.83628126213,NaN,NaN,24749.91,24798.82101716424,24700.99898283576,24713.465065721277,24715.076249721656,24774.554839317138,24655.597660126175,10580,7603.666666666667,35.517141946614615,41.527476836768415,NaN,NaN,NaN,NaN,19.241146422866596,34.633601485103014,-64110,-3.406256637036334,-12.73097773634072,-9.324721099304385
2025-09-18T16:05:00-04:00,24700.75,24712.5,24700.5,24710.75,NaN,NaN,NaN,24756.83628126213,NaN,NaN,24749.395,24799.390208772937,24699.399791227064,24709.447052577023,24715.057111784987,24774.457303797048,24655.656919772926,3310,7314.7,41.0521483021466,40.77130863096688,NaN,NaN,NaN,NaN,18.74177882123327,35.231056908171304,-60800,-2.5161344966870267,-12.469889220163168,-9.953754723476141
2025-09-18T16:10:00-04:00,24711,24711.25,24692.25,24693,NaN,NaN,NaN,24756.83628126213,NaN,NaN,24748.14,24800.527227454233,24695.752772545766,24693.80764206162,24715.012765779244,24774.33776757515,24655.687763983336,3394,7173.633333333333,35.504035234924075,39.80486323813932,NaN,NaN,NaN,NaN,18.76022319114518,36.15781932166867,-64194,-2.868340306568788,-13.539180106687127,-10.670839800118339
2025-09-18T16:15:00-04:00,24693.25,24699.25,24684.75,24694.75,NaN,NaN,NaN,24748.057597743107,NaN,NaN,24747.455,24801.68854035848,24693.221459641525,24688.021113649294,24714.96115555695,24774.22643298099,24655.69587813291,2907,7040.666666666667,36.416421533763135,38.77393016977846,NaN,NaN,NaN,NaN,18.455921534634808,37.3221236040151,-61287,-2.7297680250099496,-14.083049831380777,-11.353281806370827
2025-09-18T16:20:00-04:00,24694.75,24711.75,24694.25,24708.75,NaN,NaN,NaN,24748.057597743107,NaN,NaN,24746.545,24801.809065177717,24691.28093482228,24684.516890919436,24714.945716158767,24774.166735036844,24655.72469728069,1916,6874.733333333334,43.32391842951331,38.47382470806271,NaN,NaN,NaN,NaN,18.38764142501804,37.004632265233134,-59371,-1.5028616563981387,-13.2318588768685,-11.728997220470362
2025-09-18T16:25:00-04:00,24709,24711.25,24707.25,24710,NaN,NaN,NaN,24748.057597743107,NaN,NaN,24745.55,24801.612911092725,24689.487088907274,24680.288512735548,24714.941141504016,24774.137491196867,24655.744791811165,1048,6616.833333333333,43.90982609424792,38.16518448609421,NaN,NaN,NaN,NaN,17.359952751802464,36.70981887922132,-58323,-0.46837491372458473,-12.314465862626093,-11.846090948901509
2025-09-18T16:30:00-04:00,24710.75,24717.5,24708.75,24713.75,NaN,NaN,NaN,24748.057597743107,NaN,NaN,24744.48,24800.88654571963,24688.07345428037,24682.047775913492,24714.939528292296,24774.106194778415,24655.772861806177,1253,6453.7,45.722643201988156,38.48380890984621,NaN,NaN,NaN,NaN,16.744956126673717,35.778185052774866,-57070,0.5518891114546847,-11.156229559583153,-11.708118671037838
2025-09-18T16:35:00-04:00,24714.25,24719.5,24713.5,24717,NaN,NaN,NaN,24748.057597743107,NaN,NaN,24743.41,24799.831339934142,24686.988660065857,24688.138220730794,24714.94098340129,24774.082741993483,24655.7992248091,1053,6197.833333333333,47.311979717878216,39.13994380957676,NaN,NaN,NaN,NaN,15.977459260482737,34.707018580749875,-56017,1.4765879879089994,-9.862383686151588,-11.338971674060588
2025-09-18T16:40:00-04:00,24717,24720,24715.25,24718,NaN,NaN,NaN,24748.057597743107,NaN,NaN,24742.11,24797.813425389748,24686.406574610253,24692.535576584636,24714.943464664368,24774.059155810137,24655.8277735186,1105,5952.8,47.81829006190987,39.930938716343064,NaN,NaN,NaN,NaN,15.17549788473397,33.65851409622875,-54912,2.1459590511544313,-8.656522860117548,-10.802481911271979
2025-09-18T16:45:00-04:00,24718,24722.5,24716.75,24718.75,NaN,NaN,NaN,24748.057597743107,NaN,NaN,24740.76,24795.38023068695,24686.139769313046,24697.653461267706,24714.947734708858,24774.034826280957,24655.86064313676,1218,5770.566666666667,48.22018392069281,40.786302597217194,NaN,NaN,NaN,NaN,14.5022480358244,32.40612144169693,-53694,2.5993605596678755,-7.5532812116871355,-10.152641771355011
2025-09-18T16:50:00-04:00,24719.25,24720.75,24716.75,24717.75,NaN,NaN,NaN,24748.057597743107,NaN,NaN,24739.46,24793.10618905798,24685.813810942018,24698.872769014168,24714.949789066246,24774.019442169363,24655.88013596313,742,5611.033333333334,47.69274904933017,41.62900434723996,NaN,NaN,NaN,NaN,13.752087461836942,31.24318540534596,-54436,2.776023098824343,-6.682612897824583,-9.458635996648926
2025-09-18T16:55:00-04:00,24718.5,24721,24713.75,24713.75,NaN,NaN,NaN,24748.057597743107,NaN,NaN,24737.935,24790.06127072695,24685.808729273052,24699.873215211333,24714.951066836336,24773.98971219971,24655.912421472964,1317,5499.6,45.54669091755158,42.498249071382425,NaN,NaN,NaN,NaN,13.287652643134303,30.422699757536037,-55753,2.572189961461211,-6.243398544822412,-8.815588506283623
2025-09-18T18:00:00-04:00,24715,24735.25,24713.5,24731,NaN,NaN,NaN,24748.057597743107,NaN,NaN,24736.83,24787.1227867535,24686.5372132465,24707.473572169067,24726.583333333332,24726.583333333332,24726.583333333332,3145,5478.1,54.959264616773424,43.3873889837207,NaN,NaN,NaN,NaN,13.892106025767566,28.389451012811833,-52608,3.490817590261069,-4.452066518457286,-7.9428841087183555
2025-09-18T18:05:00-04:00,24731.25,24738.25,24730.5,24737.25,NaN,NaN,NaN,24748.057597743107,NaN,NaN,24735.82,24783.964266532494,24687.675733467506,24712.153857735255,24728.746748843143,24732.52160236477,24724.971895321516,1033,5364.6,57.805160783768656,45.05717527222161,NaN,NaN,NaN,NaN,13.453384166784167,26.777947725032387,-51575,4.354875321951871,-2.499289956278517,-6.854165278230388
2025-09-18T18:10:00-04:00,24737.25,24740.25,24731.5,24739.75,NaN,NaN,NaN,24748.057597743107,NaN,NaN,24734.81,24780.395256385455,24689.224743614548,24714.998086188203,24730.8566367713,24735.754829126756,24725.958444415843,1397,5218.5,58.92319453443131,46.729036171351375,NaN,NaN,NaN,NaN,13.11742815487101,25.466979174130028,-50178,4.890192484169408,-0.7414246730186278,-5.631617157188036
2025-09-18T18:15:00-04:00,24739.75,24741.75,24733.75,24735.5,NaN,NaN,NaN,24748.057597743107,NaN,NaN,24733.695,24776.33585951727,24691.05414048273,24717.54846895056,24731.75750038267,24736.77714510453,24726.737855660813,958,4969.3,56.197086978078595,47.81081750534651,NaN,NaN,NaN,NaN,12.751897572380225,24.392118817836664,-51136,4.749484247367267,0.3052381520210474,-4.4442460953462195
2025-09-18T18:20:00-04:00,24735,24738,24731,24737.25,NaN,NaN,NaN,24748.057597743107,NaN,NaN,24732.765,24772.95646799696,24692.57353200304,24717.54846895056,24732.13206466978,24737.01549555103,24727.248633788528,745,4811.133333333333,57.0776769258544,49.35179191184154,NaN,NaN,NaN,NaN,12.341047745781637,23.068856553051983,-50391,4.564513493113376,1.2613957710454997,-3.3031177220678756
2025-09-18T18:25:00-04:00,24737.75,24742.25,24736.25,24739.75,NaN,NaN,NaN,24748.057597743107,NaN,NaN,24731.91,24769.572283519297,24694.247716480702,24720.96102012836,24732.963729308667,24738.110759762993,24727.81669885434,938,4688.966666666666,58.36536920400739,50.91957388828756,NaN,NaN,NaN,NaN,11.88811576394009,22.27187013735503,-49453,4.398956121322847,2.1955774295856827,-2.203378691737164
2025-09-18T18:30:00-04:00,24740.25,24743,24732,24732.25,NaN,NaN,NaN,24748.057597743107,NaN,NaN,24731.06,24766.67945535444,24695.440544645564,24720.96102012836,24733.215736743052,24738.18911422718,24728.242359258922,817,4527.733333333334,53.20817838145452,51.62559245628336,NaN,NaN,NaN,NaN,11.824678923658656,21.01478453368415,-50270,3.6060427235664116,2.304174712720851,-1.3018680108455607
2025-09-18T18:35:00-04:00,24732.25,24732.25,24720.5,24721.5,NaN,NaN,NaN,24748.057597743107,NaN,NaN,24730.235,24764.774746664054,24695.695253335947,24720.96102012836,24732.035033819186,24737.501867001152,24726.56820063722,1464,4430.4,46.82201599832372,51.8336060208602,NaN,NaN,NaN,NaN,11.819344714825894,20.365668573525753,-51734,2.2458542449736747,1.5054497953715327,-0.740404449602142
2025-09-18T18:40:00-04:00,24721.5,24721.5,24711.5,24715.75,NaN,NaN,NaN,24748.057597743107,NaN,NaN,24729.595,24763.99847219925,24695.19152780075,24720.96102012836,24729.88636737717,24737.310526394944,24722.462208359397,1654,4343.566666666667,43.79424728764291,51.69586345554983,NaN,NaN,NaN,NaN,11.689391520909757,20.5046228452864,-53388,0.9153816262890502,0.40382258325917064,-0.5115590430298795
2025-09-18T18:45:00-04:00,24716.25,24725.25,24716.25,24724.5,NaN,NaN,NaN,24748.057597743107,NaN,NaN,24729.155,24763.24369167185,24695.066308328147,24720.96102012836,24729.20343155679,24736.63744479539,24721.769418318192,1152,4182.4,49.17984000796368,51.82928204769879,NaN,NaN,NaN,NaN,11.533006412273346,20.194677327175942,-52236,0.5965496915402151,0.23412807139538927,-0.36242162014482576
2025-09-18T18:50:00-04:00,24724.25,24732.5,24722.25,24731.5,NaN,NaN,NaN,24748.057597743107,NaN,NaN,24729.085,24763.139751503542,24695.030248496456,24720.96102012836,24729.169500660686,24736.320952653463,24722.01804866791,1076,4005.5,53.05522350101034,52.20334872192025,NaN,NaN,NaN,NaN,11.441363097110965,19.12103650543151,-51160,0.8154676665134702,0.6569129629970121,-0.15855470351645817
2025-09-18T18:55:00-04:00,24732,24739.5,24731.5,24737.25,NaN,NaN,NaN,24748.057597743107,NaN,NaN,24729.11,24763.186848450005,24695.033151549997,24720.96102012836,24729.629136099025,24736.750218239613,24722.508053958438,1024,3758.9333333333334,56.021896264966905,52.7606138893684,NaN,NaN,NaN,NaN,11.195551447317326,18.059814295559303,-50136,1.278330129422045,1.4393579582610982,0.1610278288390531
2025-09-18T19:00:00-04:00,24737.5,24741.25,24732,24736,NaN,NaN,NaN,24748.057597743107,NaN,NaN,24728.925,24762.748845142854,24695.101154857144,24720.96102012836,24730.200212074364,24737.270810051272,24723.129614097455,1415,3509.233333333333,55.20514692809106,53.29721373785132,NaN,NaN,NaN,NaN,11.056583486794661,17.23555151412896,-51551,1.4201910365634376,1.9362666245433502,0.5160755879799125
2025-09-18T19:05:00-04:00,24737.25,24739.5,24733.75,24734.5,NaN,NaN,NaN,24748.057597743107,NaN,NaN,24728.92,24762.740473095815,24695.09952690418,24720.96102012836,24730.408827461088,24737.431499764967,24723.386155157208,637,3299.733333333333,54.184277491857706,53.91418420744461,NaN,NaN,NaN,NaN,10.67754180916647,16.470164645657928,-52188,1.3342264856129988,2.183858694996161,0.8496322093831622
2025-09-18T19:10:00-04:00,24735,24741.5,24731.25,24733,NaN,NaN,NaN,24748.057597743107,NaN,NaN,24728.64,24762.08684738989,24695.193152610107,24720.96102012836,24730.659958355966,24737.581830230152,24723.73808648178,955,3124.233333333333,53.12627980006996,53.783256720537224,NaN,NaN,NaN,NaN,10.647003108511724,15.473528527728192,-53143,1.106930783008429,2.2332956881436985,1.1263649051352695
2025-09-18T19:15:00-04:00,24732.5,24738.75,24732.25,24737.25,NaN,NaN,NaN,24748.057597743107,NaN,NaN,24728.32,24761.118786560153,24695.521213439846,24720.468816102686,24730.8484812737,24737.721159889923,24723.97580265748,663,2830.4666666666667,55.76194253526733,53.63731255992999,NaN,NaN,NaN,NaN,10.350788600760888,14.548080703936298,-52480,1.167395316693699,2.5856090510023932,1.4182137343086942
2025-09-18T19:20:00-04:00,24736.75,24741.75,24736,24738,NaN,NaN,NaN,24748.057597743107,NaN,NaN,24728.3,24761.07392256222,24695.52607743778,24721.93158739852,24731.082096066166,24737.978436935322,24724.18575519701,594,2284.6,56.22967466561624,53.444918283586055,NaN,NaN,NaN,NaN,10.022160843563682,14.034796558342885,-51886,1.1790301874454365,2.89200146861549,1.7129712811700535
2025-09-18T19:25:00-04:00,24737.75,24739.25,24734.75,24736.75,NaN,NaN,NaN,24748.057597743107,NaN,NaN,24728.375,24761.20870980823,24695.54129019177,24721.93158739852,24731.23576662211,24738.104528140128,24724.367005104094,532,1668.0666666666666,55.182460164675504,53.37244493977154,NaN,NaN,NaN,NaN,9.627720783309133,13.390885697399385,-52418,1.0291270763811002,2.999380126646429,1.9702530502653286
2025-09-18T19:30:00-04:00,24736.75,24744.25,24736.75,24743,NaN,NaN,NaN,24748.057597743107,NaN,NaN,24728.365,24761.18057709571,24695.549422904292,24726.016215935055,24731.66052910304,24738.68220042649,24724.638857779588,887,1344.9666666666667,59.26723956433812,53.52884227109182,NaN,NaN,NaN,NaN,9.475740727358481,13.375728387838084,-51531,1.2621201464645413,3.5479032333460054,2.285783086881464
2025-09-18T19:35:00-04:00,24743.5,24747.75,24742,24746.75,NaN,NaN,NaN,24748.057597743107,NaN,NaN,24728.535,24761.64043912903,24695.42956087097,24730.287972748043,24732.358547990036,24739.841202570897,24724.875893409175,1120,1271.9666666666667,61.53265935987929,53.755077282225514,NaN,NaN,NaN,NaN,9.209616389690018,13.738806606447545,-50411,1.560470456566044,4.236371157589019,2.675900701022975
2025-09-18T19:40:00-04:00,24746,24748,24742.25,24745,NaN,NaN,NaN,24748.057597743107,NaN,NaN,24728.485,24761.483092365037,24695.486907634964,24731.155378198433,24732.79302045728,24740.501341094707,24725.084699819854,785,1185,59.85952964467982,54.23017380102733,NaN,NaN,NaN,NaN,8.962500933283588,14.103071166967842,-51196,1.5295916234574465,4.587890230344783,3.0582986068873366
2025-09-18T19:45:00-04:00,24744.5,24748.25,24741.5,24744,24713.272681873263,24713.272681873263,24713.272681873263,NaN,NaN,NaN,24728.42,24761.282507517084,24695.557492482912,24731.399302558748,24733.130270829814,24740.97763706632,24725.282904593307,677,1110.6666666666667,58.87439181643986,55.09105778803563,NaN,NaN,NaN,NaN,8.80446515233476,14.31551147699142,-51873,1.3383540602169752,4.731241182158556,3.3928871219415804
2025-09-18T19:50:00-04:00,24744,24747,24741.75,24743.5,24713.493241788114,NaN,NaN,NaN,NaN,NaN,24728.635,24761.74771810463,24695.522281895366,24731.399302558748,24733.411627284702,24741.34899751635,24725.474257053054,624,1067.6,58.35724581553479,56.13127196859933,NaN,NaN,NaN,NaN,8.550574784310848,14.512777479156167,-52497,1.0854901929457155,4.749749863123725,3.6642596701780095
2025-09-18T19:55:00-04:00,24743.25,24747.5,24739.75,24740,24713.493241788114,NaN,NaN,NaN,NaN,NaN,24728.42,24761.092226745666,24695.74777325433,24731.399302558748,24733.638560058855,24741.601361031884,24725.675759085825,628,1053.6,54.73299164724854,56.52792565711968,NaN,NaN,NaN,NaN,8.493390871145788,14.329440516177616,-53125,0.6133286507979414,4.430920483675436,3.8175918328774947
2025-09-18T20:00:00-04:00,24739.75,24749.25,24739.5,24744.25,24713.898542620987,NaN,NaN,NaN,NaN,NaN,24728.07,24759.663676588687,24696.476323411312,24731.399302558748,24734.27507202073,24742.401246327103,24726.148897714356,1577,1064.4,58.1331541416207,56.89063498859185,NaN,NaN,NaN,NaN,8.583148666063947,14.408648499122458,-51548,0.5216560573146145,4.469661904520763,3.948005847206148
2025-09-18T20:05:00-04:00,24744.25,24747.5,24737.5,24741.25,24713.898542620987,NaN,NaN,NaN,NaN,NaN,24727.77,24758.562343201043,24696.977656798957,24731.399302558748,24734.55630237324,24742.666368017188,24726.44623672929,990,1062.3,54.9930592850629,56.817146632884416,NaN,NaN,NaN,NaN,8.684352332773665,14.098436470489053,-52538,0.20940517204086184,4.209762312257226,4.000357140216364
2025-09-18T20:10:00-04:00,24741.75,24742,24723,24723.75,24713.898542620987,NaN,NaN,NaN,NaN,NaN,24727.245,24757.3917228758,24697.098277124198,24731.399302558748,24734.212253075966,24742.137863356496,24726.286642795436,2043,1093.5666666666666,41.060172043116296,55.806791283957644,NaN,NaN,NaN,NaN,9.421184309004117,14.467839897519738,-54581,-1.1505646079463174,2.562151380283467,3.7127159882297844
2025-09-18T20:15:00-04:00,24723.25,24727.25,24715.75,24717.75,24713.898542620987,NaN,NaN,NaN,NaN,NaN,24726.515,24755.765027346803,24697.264972653196,24731.399302558748,24733.415543740884,24741.765397916814,24725.065689564955,1787,1112.5333333333333,37.5476882391866,54.61846348019542,NaN,NaN,NaN,NaN,9.569671144075253,15.534567096968757,-56368,-2.35940692695768,0.7634573295326845,3.1228642564903644
2025-09-18T20:20:00-04:00,24717.75,24720.25,24703,24707.25,NaN,NaN,NaN,24744.32268077457,24744.32268077457,24744.32268077457,24725.73,24754.89913436986,24696.560865630137,24731.399302558748,24731.312260397302,24741.69916529253,24720.925355502073,3115,1191.6333333333334,32.33471665778717,53.133351827175225,NaN,NaN,NaN,NaN,10.118266062355591,17.493525439805328,-59483,-3.691957890909695,-1.4920831071467546,2.19987478376294
2025-09-18T20:25:00-04:00,24706.75,24712.75,24701.5,24705,NaN,NaN,NaN,24739.870513466634,NaN,NaN,24724.87,24753.897269942623,24695.842730057375,24731.399302558748,24730.048057837565,24741.54954025466,24718.54657542047,1842,1209.1333333333334,31.330903295123434,51.388277595736376,NaN,NaN,NaN,NaN,10.199104200758764,19.409336720027067,-61325,-4.497282068075267,-3.4217278013311443,1.0755542667441234
2025-09-18T20:30:00-04:00,24705.5,24710,24703.5,24705.5,NaN,NaN,NaN,24738.893444672696,NaN,NaN,24724.37,24753.849864320262,24694.890135679736,24731.399302558748,24729.291723380215,24741.351133741882,24717.232313018547,1195,1144.1333333333334,31.837313885229122,49.645966111423014,NaN,NaN,NaN,NaN,9.934882472133138,21.188304337375826,-60130,-4.744185494219167,-4.8546776010298345,-0.11049210681066812
2025-09-18T20:35:00-04:00,24705.25,24711.5,24701,24709.25,NaN,NaN,NaN,24738.364197187573,NaN,NaN,24724.13,24753.90150314642,24694.358496853583,24730.967442910078,24728.505471196328,24741.03359616055,24715.977346232106,1386,1155.9,35.669147957661835,48.25215809663632,NaN,NaN,NaN,NaN,9.975248009837914,23.01480943769321,-58744,-4.409918160649397,-5.622889807622414,-1.2129716469730174
2025-09-18T20:40:00-04:00,24709,24709.75,24694.75,24701.25,NaN,NaN,NaN,24734.94991549723,NaN,NaN,24723.815,24754.20838908435,24693.421610915648,24730.967442910078,24727.097840040296,24740.665834073632,24713.52984600696,2172,1181.7333333333333,31.58930478741317,46.275162755427395,NaN,NaN,NaN,NaN,10.334158866278063,25.112802107345566,-60916,-4.4687135543489145,-6.7988635899091605,-2.330150035560246
2025-09-18T20:45:00-04:00,24700.75,24708.5,24699,24702.75,NaN,NaN,NaN,24734.94991549723,NaN,NaN,24723.56,24754.43823829194,24692.681761708063,24730.967442910078,24726.27116314993,24740.291056282378,24712.25127001748,1484,1199.2666666666667,33.13364972297546,44.24666206707712,NaN,NaN,NaN,NaN,10.274576090115344,27.06093815773704,-59432,-4.154337990530512,-7.5230725237233855,-3.3687345331928737
2025-09-18T20:50:00-04:00,24702.75,24707.5,24699,24706,NaN,NaN,NaN,24734.94991549723,NaN,NaN,24723.39,24754.558118327463,24692.221881672536,24727.873954328064,24725.799934387735,24740.032339854344,24711.567528921125,926,1205.3,36.47953289524171,42.576662299260114,NaN,NaN,NaN,NaN,10.147820655107106,28.869921633100553,-58506,-3.501396698300872,-7.745480406068964,-4.244083707768092
2025-09-18T20:55:00-04:00,24706.25,24714.75,24705,24710.25,NaN,NaN,NaN,24734.94991549723,NaN,NaN,24723.45,24754.504951293595,24692.395048706407,24716.79916346245,24725.318893551485,24739.593459956788,24711.04432714618,1364,1219.5,40.661044474684424,41.27570891770615,NaN,NaN,NaN,NaN,10.119404894028026,29.104216712634006,-57142,-2.598679172933265,-7.4924326739346725,-4.893753501001408
2025-09-18T21:00:00-04:00,24710,24713.75,24705,24708,NaN,NaN,NaN,24734.94991549723,NaN,NaN,24723.16,24754.514387252555,24691.805612747445,24701.33933076996,24724.994825398215,24739.31082339797,24710.67882739846,903,1222.3666666666666,39.1901718666587,39.90663220707214,NaN,NaN,NaN,NaN,10.021590258740309,29.321776429343643,-58045,-1.9956205872756572,-7.388279235095979,-5.392658647820322