time,open,high,low,close,Long Stop,Long Stop Start,Buy Label,Short Stop,Short Stop Start,Sell Label,Basis,Upper,Lower,ATR Trailing Stoploss,VWAP,Upper Band #1,Lower Band #1,Volume,Volume MA,RSI,RSI-based MA,Regular Bullish,Regular Bullish Label,Regular Bearish,Regular Bearish Label,ATR,ADX,OnBalanceVolume,Histogram,MACD,Signal
2025-09-24T18:20:00-04:00,24746,24746,24742.5,24745,24710.815275921235,NaN,NaN,NaN,NaN,NaN,24729.41,24761.794835962042,24697.025164037957,24737.29425366198,24745.85078643718,24748.258620451878,24743.44295242248,420,4263.766666666666,54.56251222083004,57.174417316752454,NaN,NaN,NaN,NaN,9.350527746269591,8.112300722572481,25214,-1.1999449820132702,4.594677982564463,5.794622964577733
2025-09-24T18:25:00-04:00,24744.75,24744.75,24741.5,24743,24710.815275921235,NaN,NaN,NaN,NaN,NaN,24730.01,24762.267861059052,24697.752138940945,24737.29425366198,24745.641063449508,24748.068968108095,24743.21315879092,424,4065.133333333333,52.63771511502525,56.60807046756157,NaN,NaN,NaN,NaN,8.932632907250335,7.69209156192739,24790,-1.353256550474219,4.103052276484959,5.456308826959178
2025-09-24T18:30:00-04:00,24743,24753,24743,24747.25,24714.457308008336,NaN,NaN,NaN,NaN,NaN,24730.475,24763.041739170658,24697.90826082934,24737.29425366198,24745.93273525335,24748.30117558135,24743.564294925352,898,3799.6,56.17564897678577,56.407137760993734,NaN,NaN,NaN,NaN,9.00887341387531,8.376302819176507,25688,-1.1569283817534188,4.010148349767405,5.167076731520824
2025-09-24T18:35:00-04:00,24747.5,24751,24746.5,24749,24716.1183394625,NaN,NaN,NaN,NaN,NaN,24730.815,24763.790719861376,24697.83928013862,24737.29425366198,24746.05428901677,24748.44431795211,24743.66426008143,284,3652.7,57.58076973498757,56.3990645661082,NaN,NaN,NaN,NaN,8.68681102716993,9.011641843764973,25972,-0.9086519321732016,4.031261816304323,4.939913748477524
2025-09-24T18:40:00-04:00,24749,24752.25,24748.75,24749.75,24718.874324032386,NaN,NaN,NaN,NaN,NaN,24730.885,24764.006022025154,24697.763977974842,24738.439080212458,24746.285921743573,24748.79890663021,24743.772936856934,396,3492.6666666666665,58.199340216020474,56.506968588602284,NaN,NaN,NaN,NaN,8.316324525229222,9.757145155769392,26368,-0.7025770305667276,4.061692460269114,4.764269490835842
2025-09-24T18:45:00-04:00,24749.5,24751.25,24748.75,24749.5,24719.47094566728,NaN,NaN,NaN,NaN,NaN,24731.39,24764.85911412886,24697.92088587114,24738.951264169966,24746.425594839515,24748.98340964371,24743.867780035318,294,3291.6,57.896271969765095,56.47237947525287,NaN,NaN,NaN,NaN,7.9008727734271345,10.449398231202066,26074,-0.5959723771611252,4.019304019384435,4.6152763965455605
2025-09-24T18:50:00-04:00,24750,24752,24747.75,24750.25,24720.154084500584,NaN,NaN,NaN,NaN,NaN,24731.915,24765.725739411442,24698.10426058856,24740.036011335975,24746.596086808655,24749.20581787607,24743.98635574124,374,3166.9,58.59290344326853,56.306848169674716,NaN,NaN,NaN,NaN,7.640096146753768,10.888799468449308,26448,-0.49212613493870627,4.000118727872177,4.4922448628108835
2025-09-24T18:55:00-04:00,24750.25,24751,24748,24750.25,24720.720944296012,NaN,NaN,NaN,NaN,NaN,24732.775,24766.21797384931,24699.332026150692,24740.036011335975,24746.706702764786,24749.335098600688,24744.078306928885,285,3069.5,58.59290344326853,56.197540911529266,NaN,NaN,NaN,NaN,7.308660707699928,11.296814903036031,26448,-0.4421941958757589,3.9395021179661853,4.381696313841944
2025-09-24T19:00:00-04:00,24749.75,24750.75,24745.5,24746.75,24720.720944296012,NaN,NaN,NaN,NaN,NaN,24733.37,24766.72764380794,24700.01235619206,24740.036011335975,24746.793815971054,24749.31524089399,24744.272391048118,811,2940.1666666666665,53.77722911367745,55.93009270114294,NaN,NaN,NaN,NaN,7.16161351429279,11.137212086675373,25637,-0.6510261856401156,3.5679135817917995,4.218939767431915
2025-09-24T19:05:00-04:00,24746.75,24748.25,24744,24744.5,24720.720944296012,NaN,NaN,NaN,NaN,NaN,24734.065,24766.868629375487,24701.26137062451,24740.036011335975,24746.729438146696,24749.197888698945,24744.260987594447,502,2721.733333333333,50.882047410299876,55.45584579765822,NaN,NaN,NaN,NaN,6.953641120414733,10.676617985760675,25135,-0.9298431747781897,3.056635798959178,3.9864789737373676
2025-09-24T19:10:00-04:00,24745,24747.5,24744,24745,24720.720944296012,NaN,NaN,NaN,NaN,NaN,24734.785,24766.93014115817,24702.63985884183,24740.036011335975,24746.686207366518,24749.12142229435,24744.250992438687,344,2536.366666666667,51.50683174664192,55.07326597430531,NaN,NaN,NaN,NaN,6.706952468956537,10.248923463482743,25479,-1.0602914822177052,2.661114620965236,3.7214061031829413
2025-09-24T19:15:00-04:00,24744.25,24746,24741.75,24741.75,24720.720944296012,NaN,NaN,NaN,NaN,NaN,24735.56,24766.446333539883,24704.67366646012,24740.036011335975,24746.562629450636,24749.040877689713,24744.08438121156,356,2210.6666666666665,47.29560431602685,54.76831889079614,NaN,NaN,NaN,NaN,6.531455864031069,9.669575757044672,25123,-1.32780647906345,2.0616480043536285,3.3894544834170786
2025-09-24T19:20:00-04:00,24741.75,24745.25,24741.5,24744.25,24720.720944296012,NaN,NaN,NaN,NaN,NaN,24736.43,24765.756445403906,24707.103554596095,24740.036011335975,24746.497846559316,24748.985362524443,24744.01033059419,232,1762.8333333333333,50.638865626756754,54.54320474908217,NaN,NaN,NaN,NaN,6.332780445171707,9.185732598735884,25355,-1.2972307367239941,1.7679160625120858,3.06514679923608
2025-09-24T19:25:00-04:00,24744.75,24747.75,24743.5,24743.5,24720.79580525113,NaN,NaN,NaN,NaN,NaN,24736.985,24765.770310489876,24708.199689510126,24740.036011335975,24746.440399863717,24748.900167996228,24743.980631731207,391,1137.5666666666666,49.621907944575554,54.140039376995,NaN,NaN,NaN,NaN,6.184010413373728,8.888440139248921,24964,-1.2858710811331244,1.4578079478196742,2.7436790289527986
2025-09-24T19:30:00-04:00,24744,24744.75,24739.75,24744,24720.79580525113,NaN,NaN,NaN,NaN,NaN,24737.855,24764.7438620068,24710.9661379932,24740.036011335975,24746.249618645306,24748.77592184771,24743.7233154429,601,867.8666666666667,50.337947480076096,53.83828475265543,NaN,NaN,NaN,NaN,6.09943824098989,8.724259569712975,25565,-1.2044483482828703,1.2381185935992107,2.442566941882081
2025-09-24T19:35:00-04:00,24744.25,24745.75,24742.25,24742.5,24720.79580525113,NaN,NaN,NaN,NaN,NaN,24738.65,24763.62238473612,24713.67761526388,24740.036011335975,24746.155666525,24748.68818282903,24743.623150220967,402,754.7666666666667,48.12791686951503,53.51615630654756,NaN,NaN,NaN,NaN,5.913764080919184,8.337468432801867,25163,-1.2082698963674288,0.9322295714227948,2.1404994677902236
2025-09-24T19:40:00-04:00,24742.25,24745.25,24740.75,24743.25,24720.79580525113,NaN,NaN,NaN,NaN,NaN,24739.4,24762.561822030882,24716.23817796912,24739.928809068777,24746.040787105216,24748.592957391404,24743.488616819028,457,707.6666666666666,49.32588063841699,53.026887139521214,NaN,NaN,NaN,NaN,5.8127809322821,8.30543035616003,25620,-1.1189769413349062,0.7417782911215909,1.860755232456497
2025-09-24T19:45:00-04:00,24743,24754,24742.75,24751.25,24724.61391544313,NaN,NaN,NaN,NaN,NaN,24740.06,24762.64706708661,24717.47293291339,24739.868544949564,24746.32754456727,24748.936801057695,24743.718288076845,1166,688.3,59.95063766144483,53.19616341998244,NaN,NaN,NaN,NaN,6.201153722833378,8.915880412654637,26786,-0.5107740664526881,1.222287649390637,1.733061715843325
2025-09-24T19:50:00-04:00,24751.75,24752.5,24746.75,24750.25,24726.159873832075,NaN,NaN,NaN,NaN,NaN,24740.7,24762.581270528968,24718.818729471033,24739.868544949564,24746.48963453729,24749.142071478876,24743.837197595705,649,677.6,58.305003408494606,53.20371079087346,NaN,NaN,NaN,NaN,6.168928456916708,9.482726893685346,26137,-0.18240632341415175,1.5050538115756353,1.687460134989787
2025-09-24T19:55:00-04:00,24750,24757.25,24749.5,24755.75,24729.919652294255,NaN,NaN,NaN,NaN,NaN,24741.565,24762.308627948638,24720.82137205136,24742.03086876772,24747.090529034514,24750.36722850566,24743.81382956337,1192,676.2333333333333,64.13603259902632,53.649407978677836,NaN,NaN,NaN,NaN,6.281862138565515,10.758368500350938,27329,0.3685831563243631,2.148189080395241,1.779605924070878
2025-09-24T20:00:00-04:00,24756.25,24769,24752.5,24767.5,24736.1108044627,NaN,NaN,NaN,NaN,NaN,24742.195,24764.10488133435,24720.285118665648,24748.574695014177,24749.681764878333,24756.277120137147,24743.08640961952,2963,750.5,72.86633963909571,54.668939135522635,NaN,NaN,NaN,NaN,7.011729128667978,13.24838140779038,30292,1.4282441720170147,3.564911139092146,2.1366669670751315
2025-09-24T20:05:00-04:00,24767.75,24777.5,24765.5,24775.75,24746.34440425985,NaN,NaN,NaN,NaN,NaN,24742.92,24766.740881607497,24719.0991183925,24755.15975601134,24752.643796962428,24762.54340797078,24742.744185954074,2658,814.0333333333333,77.08432121231017,55.98975469045418,NaN,NaN,NaN,NaN,7.36803419090598,16.19701724156131,32950,2.524564389660382,5.292372454150609,2.767808064490227
2025-09-24T20:10:00-04:00,24775.75,24777.5,24767.25,24770.5,24746.965113157126,NaN,NaN,NaN,NaN,NaN,24743.76,24768.434472645513,24719.085527354484,24755.15975601134,24753.93247010764,24764.62607669725,24743.238863518032,1508,833.4666666666667,69.66288763959912,57.12444458516287,NaN,NaN,NaN,NaN,7.573888891555553,18.93503623006289,31442,2.7190985130384875,6.166681205788336,3.4475826927498487
2025-09-24T20:15:00-04:00,24770.75,24775,24766.75,24772.25,24746.965113157126,NaN,NaN,NaN,NaN,NaN,24744.735,24769.97631732316,24719.493682676843,24755.15975601134,24754.77525961866,24765.855405572842,24743.695113664475,1138,844.1,70.67634003960036,58.53832263011291,NaN,NaN,NaN,NaN,7.622182542158727,21.3554604556467,32580,2.7787390540253902,6.921006510281586,4.142267456256196
2025-09-24T20:20:00-04:00,24772.25,24772.5,24766.25,24767,24746.965113157126,NaN,NaN,NaN,NaN,NaN,24745.69,24770.613394633394,24720.766605366603,24755.15975601134,24755.185806904527,24766.34912700078,24744.022486808273,720,839.8333333333334,63.79144257365682,59.415794832042536,NaN,NaN,NaN,NaN,7.524169503433105,23.474570615795237,31860,2.2976475000761267,7.0143268313513545,4.716679331275228
2025-09-24T20:25:00-04:00,24767,24776.25,24765,24772.25,24746.965113157126,NaN,NaN,NaN,NaN,NaN,24746.535,24772.1291419094,24720.9408580906,24755.15975601134,24755.81043080301,24767.18323751267,24744.43762409335,985,840.0333333333333,67.22934273650387,60.839633290648045,NaN,NaN,NaN,NaN,7.790300253187882,25.7459043545051,32845,2.1677038256283847,7.426309113310708,5.2586052876823235
2025-09-24T20:30:00-04:00,24772.5,24775.75,24771.75,24772.75,24748.8897041993,NaN,NaN,NaN,NaN,NaN,24747.52,24773.282538690368,24721.757461309633,24755.718348849798,24756.23650907354,24767.79205858559,24744.68095956149,625,782.2333333333333,67.54539128475741,62.047242266219506,NaN,NaN,NaN,NaN,7.519564520817319,27.854999969021403,33470,1.9565901626926845,7.704342991048179,5.747752828355495
2025-09-24T20:35:00-04:00,24772.75,24777,24770.25,24776.5,24748.97426309933,NaN,NaN,NaN,NaN,NaN,24748.585,24774.647158394822,24722.522841605176,24757.599679079838,24756.729417084287,24768.508364841317,24744.950469327257,713,775.2,69.89077633447019,63.49501857978341,NaN,NaN,NaN,NaN,7.4645956264732245,29.384227562158937,34183,1.9086155932052806,8.133522319862095,6.2249067266568145
2025-09-24T20:40:00-04:00,24776.75,24778.25,24774,24777.75,24752.015205685726,NaN,NaN,NaN,NaN,NaN,24749.515,24776.34379237043,24722.68620762957,24760.60474326387,24757.24890210038,24769.299451637133,24745.198352563624,710,768.1,70.65211521483945,64.94603056083794,NaN,NaN,NaN,NaN,7.234981653153708,30.92586348620833,34893,1.8015140726142231,8.476799317424593,6.67528524481037
2025-09-24T20:45:00-04:00,24777.75,24779,24770.5,24772.5,24752.015205685726,NaN,NaN,NaN,NaN,NaN,24750.625,24776.558424378956,24724.691575621044,24760.633794611094,24757.77987041446,24769.995644622373,24745.564096206544,892,779.6666666666666,63.40094415723734,66.03696108138953,NaN,NaN,NaN,NaN,7.325340106499872,31.36629446286539,34001,1.244046533440586,8.230343411611102,6.986296878170516
2025-09-24T20:50:00-04:00,24772.75,24775.25,24771,24774.25,24752.015205685726,NaN,NaN,NaN,NaN,NaN,24751.895,24776.051591237807,24727.738408762194,24760.633794611094,24757.958803208618,24770.218796237787,24745.69881017945,324,776.4666666666667,64.70142391655028,67.13521417268477,NaN,NaN,NaN,NaN,7.105672956035596,31.775266084046947,34325,0.8774098814642262,8.0830592300008,7.205649348536573
2025-09-24T20:55:00-04:00,24774.5,24777.75,24773,24776,24752.148684715958,NaN,NaN,NaN,NaN,NaN,24752.94,24776.65256207552,24729.227437924477,24761.920628551103,24758.254665929788,24770.620389815176,24745.8889420444,486,778.5333333333333,66.00239234211118,67.56748236416094,NaN,NaN,NaN,NaN,6.9374106020330535,32.472939678110315,34811,0.6476022371087158,8.015152144922467,7.367549907813752
2025-09-24T21:00:00-04:00,24775,24776.75,24772.75,24774,24752.148684715958,NaN,NaN,NaN,NaN,NaN,24753.71,24777.606937043547,24729.81306295645,24762.08650284088,24758.50167811869,24770.933004530925,24746.070351706454,447,763.5,63.138350037685925,67.91272140910318,NaN,NaN,NaN,NaN,6.727595559030692,33.04432917033992,34364,0.27481100455827523,7.711063663511595,7.43625265895332
2025-09-24T21:05:00-04:00,24773.75,24775.25,24772.5,24773.75,24752.148684715958,NaN,NaN,NaN,NaN,NaN,24754.395,24778.585099216747,24730.204900783254,24762.144202272706,24758.659108507552,24771.122651974496,24746.19556504061,305,764.2,62.771677669429494,67.81526748556055,NaN,NaN,NaN,NaN,6.443481590528499,33.493856634558014,34059,-0.05700267679303472,7.364999312962027,7.422001989755062
2025-09-24T21:10:00-04:00,24774,24777,24773.5,24776.25,24753.71690403404,NaN,NaN,NaN,NaN,NaN,24754.905,24779.830266305384,24729.979733694614,24764.765361818165,24758.944241250712,24771.49283317931,24746.395649322116,509,767.9666666666667,64.96295387712763,67.25073993113426,NaN,NaN,NaN,NaN,6.23323290549075,34.159979715547244,34568,-0.1701097053157712,7.209364858110348,7.379474563426119
2025-09-24T21:15:00-04:00,24776.5,24780,24774,24777,24755.62749930522,NaN,NaN,NaN,NaN,NaN,24755.45,24781.082206308256,24729.817793691745,24767.212289454532,24759.348544417113,24772.04018364682,24746.656905187407,692,781.2333333333333,65.6168004972296,66.43163130862851,NaN,NaN,NaN,NaN,6.21657341224141,35.169849046278586,35260,-0.25149958081328005,7.065100087409519,7.316599668222799
2025-09-24T21:20:00-04:00,24777.25,24778.75,24773,24773,24755.62749930522,NaN,NaN,NaN,NaN,NaN,24755.89,24781.953223135817,24729.82677686418,24767.212289454532,24759.588115037008,24772.326687431298,24746.849542642718,483,784.8666666666667,59.26456076977762,65.68889367506983,NaN,NaN,NaN,NaN,6.183246739938452,35.75537213795664,34777,-0.6113038522111243,6.552469852958893,7.163773705170017
2025-09-24T21:25:00-04:00,24772.75,24779.5,24772.5,24778.25,24755.62749930522,NaN,NaN,NaN,NaN,NaN,24756.46,24783.198990264922,24729.721009735076,24767.212289454532,24759.907925043506,24772.738886926018,24747.076963160995,596,795.2333333333333,64.16766310308633,65.22398817960455,NaN,NaN,NaN,NaN,6.2415862585142765,36.404869283327386,35373,-0.5350446632760519,6.494967876074952,7.030012539351004
2025-09-24T21:30:00-04:00,24778.75,24781.5,24777.75,24780,24758.899513623746,NaN,NaN,NaN,NaN,NaN,24757.115,24784.51576823202,24729.714231767983,24768.43769220072,24760.338839099088,24773.355088425953,24747.322589772222,710,791.8666666666667,65.65177380559356,65.35686898188574,NaN,NaN,NaN,NaN,6.0636158114775425,37.28318462856558,36083,-0.4116093263986942,6.5155008813526365,6.927110207751331
2025-09-24T21:35:00-04:00,24780.25,24781.75,24777.5,24778.5,24759.262035731757,NaN,NaN,NaN,NaN,NaN,24757.78,24785.607260016266,24729.95273998373,24769.175153760574,24760.65339940644,24773.785588564213,24747.52121024867,553,793.5666666666667,63.2341927882089,65.0715011284361,NaN,NaN,NaN,NaN,5.934071824943432,38.098763163429616,35530,-0.47154484476225544,6.337679151798511,6.809223996560767
2025-09-24T21:40:00-04:00,24778.75,24783.25,24777.75,24782.25,24760.31262501668,NaN,NaN,NaN,NaN,NaN,24758.55,24786.907362365764,24730.192637634234,24770.440123008462,24761.072326812402,24774.387779329314,24747.75687429549,696,805.3,66.55045928553888,65.00043455706334,NaN,NaN,NaN,NaN,5.90306669459033,39.065991752459,36226,-0.3071542626697399,6.4252811682235915,6.732435430893331
2025-09-24T21:45:00-04:00,24782,24790,24781.25,24790,24765.162051152285,NaN,NaN,NaN,NaN,NaN,24759.41,24788.89961851135,24729.92038148865,24775.377098406767,24762.248858415373,24776.337865377638,24748.159851453107,1608,847.0333333333333,72.1428458477847,65.16129666515724,NaN,NaN,NaN,NaN,6.106419073548163,40.71472035903908,37834,0.2451926692779356,7.038926267490751,6.793733598212816
2025-09-24T21:50:00-04:00,24790,24792.5,24785.75,24786.25,24768.67173064536,NaN,NaN,NaN,NaN,NaN,24760.095,24790.442963686823,24729.74703631318,24777.426678725416,24763.106064933174,24777.7148646247,24748.497265241647,1216,879.8333333333334,66.36139570754334,64.85481670035038,NaN,NaN,NaN,NaN,6.152389139723295,42.461320554332815,36618,0.27728620887830413,7.140341359310696,6.863055150432392
2025-09-24T21:55:00-04:00,24786.5,24786.5,24779.25,24783.5,24768.67173064536,NaN,NaN,NaN,NaN,NaN,24760.745,24791.672575078035,24729.817424921963,24777.426678725416,24763.7334136853,24778.52713578206,24748.939691588537,1192,906.5333333333333,62.41142630310563,64.78413685362668,NaN,NaN,NaN,NaN,6.230789915457345,41.92948634595511,35426,0.04479827721924856,6.919052996956452,6.874254719737204
2025-09-24T22:00:00-04:00,24784,24786.75,24781.5,24783.25,24768.67173064536,NaN,NaN,NaN,NaN,NaN,24761.455,24792.78401051476,24730.125989485245,24777.426678725416,24764.06157138661,24778.953494896174,24749.169647877046,630,907.5,62.049840899480195,64.59473806669311,NaN,NaN,NaN,NaN,6.1607334929246775,41.47047448470998,34796,-0.18189473807659162,6.646886297141464,6.828781035218055
2025-09-24T22:05:00-04:00,24783,24783.75,24780.75,24781,24768.67173064536,NaN,NaN,NaN,NaN,NaN,24762.12,24793.66793812442,24730.572061875577,24777.426678725416,24764.248412311736,24779.172333634677,24749.324490988794,410,907.7666666666667,58.7507995629042,64.0767671538926,NaN,NaN,NaN,NaN,5.934966814858629,40.815136734093386,34386,-0.5202927423426313,6.178415107289766,6.698707849632397
2025-09-24T22:10:00-04:00,24781,24781.75,24776.5,24780,24768.67173064536,NaN,NaN,NaN,NaN,NaN,24762.78,24794.4156823939,24731.144317606097,24777.426678725416,24764.5473392489,24779.473121277613,24749.621557220187,784,918.6666666666666,57.292826505076135,63.65922975870619,NaN,NaN,NaN,NaN,5.886040613797298,39.013836825633824,33602,-0.830007954871097,5.661197906043526,6.491205860914623
2025-09-24T22:15:00-04:00,24780.5,24782,24777.5,24780.25,24768.67173064536,NaN,NaN,NaN,NaN,NaN,24763.57,24794.937346076993,24732.202653923006,24777.426678725416,24764.72528862717,24779.65522106426,24749.795356190083,466,895.3333333333334,57.576271792625754,63.288129338934496,NaN,NaN,NaN,NaN,5.7870377128117765,37.38902528363134,34068,-1.0238457302063386,5.2113986981566995,6.235244428363038
2025-09-24T22:20:00-04:00,24780.5,24782.5,24778.5,24782,24768.67173064536,NaN,NaN,NaN,NaN,NaN,24764.335,24795.597055276652,24733.072944723346,24777.426678725416,24764.85366339643,24779.794125542358,24749.9132012505,320,884.3666666666667,59.59769513518766,62.904896571653076,NaN,NaN,NaN,NaN,5.659392161896649,35.98074370220491,34388,-1.036832429089321,4.939203892001387,5.976036321090708
2025-09-24T22:25:00-04:00,24782.75,24784.5,24780.75,24781.25,24768.67173064536,NaN,NaN,NaN,NaN,NaN,24765.045,24796.198762220654,24733.891237779342,24777.426678725416,24765.06652991827,24780.036932622268,24750.09612721427,505,861.4666666666667,58.315250895372216,62.38335731437754,NaN,NaN,NaN,NaN,5.523007007475461,35.06987062567271,33883,-1.0929654014172723,4.609829569319118,5.70279497073639
2025-09-24T22:30:00-04:00,24781.5,24786.25,24781.25,24783.5,24768.67173064536,NaN,NaN,NaN,NaN,NaN,24765.815,24796.85188290152,24734.778117098478,24777.426678725416,24765.292002389135,24780.30996567604,24750.27403910223,504,779.5,61.024836700831536,62.509091309452835,NaN,NaN,NaN,NaN,5.485649364084357,34.55190445137197,34387,-0.9792549582046588,4.478726272980566,5.457981231185225
2025-09-24T22:35:00-04:00,24783.75,24786.25,24783.25,24784.75,24768.67173064536,NaN,NaN,NaN,NaN,NaN,24766.65,24797.43213766919,24735.86786233081,24777.426678725416,24765.419856478376,24780.47072662353,24750.368986333222,275,700.0666666666667,62.483840001176375,62.388818230744974,NaN,NaN,NaN,NaN,5.308102980935474,34.070935860949845,34662,-0.826636585560717,4.424685499234329,5.251322084795046
2025-09-24T22:40:00-04:00,24784.75,24787.5,24784.25,24785.75,24768.67173064536,NaN,NaN,NaN,NaN,NaN,24767.42,24798.148560013466,24736.69143998653,24777.010392468088,24765.57042904916,24780.66707845792,24750.4737796404,311,660.1666666666666,63.655970790381375,62.24626087251553,NaN,NaN,NaN,NaN,5.161095625154369,33.86762256740475,34973,-0.6717023277692054,4.4116941750835394,5.083396502852745
2025-09-24T22:45:00-04:00,24785.5,24788,24785.5,24787.25,24769.54755866472,NaN,NaN,NaN,NaN,NaN,24768.185,24798.945658308858,24737.424341691145,24778.35831397447,24765.715747589424,24780.862964427615,24750.568530751232,289,631.8666666666667,65.40212678765717,62.40111330104755,NaN,NaN,NaN,NaN,4.971017366214771,33.77670273837784,35262,-0.48999865045949065,4.4708981897783815,4.960896840237872
2025-09-24T22:50:00-04:00,24787.5,24790.25,24786.75,24789.75,24771.60221508905,NaN,NaN,NaN,NaN,NaN,24768.985,24799.86661427002,24738.10338572998,24780.786651179576,24765.961242794314,24781.213976217685,24750.708509370943,454,623,68.1488128510812,62.51528141287201,NaN,NaN,NaN,NaN,4.8659446971994305,34.11619729002916,35716,-0.23610715675950456,4.665762894288491,4.901870051047996
2025-09-24T22:55:00-04:00,24790,24791,24788.5,24789.5,24773.279387130457,NaN,NaN,NaN,NaN,NaN,24769.785,24800.678528448258,24738.891471551742,24782.179320943662,24766.147070952316,24781.483066385856,24750.811075518777,339,601.4666666666667,67.57110888313794,62.188728772540095,NaN,NaN,NaN,NaN,4.696948647399471,34.56596794556518,35377,-0.12523958942489521,4.745320564266876,4.8705601536917715
2025-09-24T23:00:00-04:00,24789.25,24789.75,24784.75,24785.75,24773.279387130457,NaN,NaN,NaN,NaN,NaN,24770.495,24801.191170770613,24739.798829229385,24782.179320943662,24766.385353096684,24781.790715066825,24750.979991126544,506,597.5,59.43255243142723,61.693811395674665,NaN,NaN,NaN,NaN,4.718595172585223,33.563298537363416,34871,-0.3329048863834503,4.454429045712459,4.787333932095909
2025-09-24T23:05:00-04:00,24786,24786.75,24783.75,24784.75,24773.279387130457,NaN,NaN,NaN,NaN,NaN,24771.185,24801.579376116297,24740.790623883706,24782.179320943662,24766.56817290209,24782.008045461473,24751.12830034271,432,588.1333333333333,57.44555998029294,61.3391066583309,NaN,NaN,NaN,NaN,4.595838374543421,32.29580803488802,34439,-0.5530769205841732,4.095987781365693,4.649064701949866
2025-09-24T23:10:00-04:00,24785,24786.5,24780.5,24784.75,24773.279387130457,NaN,NaN,NaN,NaN,NaN,24771.945,24801.75209479573,24742.13790520427,24782.179320943662,24766.78913331694,24782.25321762387,24751.325049010007,570,583.4666666666667,57.44555998029293,61.01022944981752,NaN,NaN,NaN,NaN,4.696135633504604,30.123473988380077,34439,-0.7044679155462958,3.7684798075169965,4.472947723063292
2025-09-24T23:15:00-04:00,24784.75,24786,24782.25,24783.75,24773.279387130457,NaN,NaN,NaN,NaN,NaN,24772.73,24801.659023489876,24743.800976510123,24782.179320943662,24766.90639332741,24782.38260153214,24751.430185122677,307,563.9666666666667,55.30130426711605,60.7638369286898,NaN,NaN,NaN,NaN,4.628554516825703,28.106306659479852,34132,-0.8670241604430142,3.389167522509524,4.256191682952538
2025-09-24T23:20:00-04:00,24784,24785.75,24782.5,24785,24773.279387130457,NaN,NaN,NaN,NaN,NaN,24773.53,24801.545288683377,24745.51471131662,24782.179320943662,24767.047092276636,24782.540070066338,24751.554114486935,365,565.3333333333334,57.43984724683759,60.77433841024419,NaN,NaN,NaN,NaN,4.530086337052439,26.233222711215355,34497,-0.8824912336930124,3.1530776408362726,4.035568874529285
2025-09-24T23:25:00-04:00,24785.5,24786.5,24784,24784,24773.279387130457,NaN,NaN,NaN,NaN,NaN,24774.375,24801.020309152784,24747.729690847216,24782.179320943662,24767.118070325454,24782.620711351465,24751.615429299443,182,555.2,55.1659597153147,60.602173261864834,NaN,NaN,NaN,NaN,4.385080170120122,24.72882909797443,34315,-0.9465332217658977,2.852402347321913,3.798935569087811
2025-09-24T23:30:00-04:00,24784.5,24787.5,24783,24786.75,24773.279387130457,NaN,NaN,NaN,NaN,NaN,24775.225,24800.655935886756,24749.79406411324,24782.179320943662,24767.248695450216,24782.77492133372,24751.722469566714,322,551.0333333333333,59.87069041263935,60.62167292453996,NaN,NaN,NaN,NaN,4.3932887293972565,23.331892171393573,34637,-0.796190258566555,2.8036977458796173,3.5998880044461723
2025-09-24T23:35:00-04:00,24786.75,24786.75,24784.25,24786.25,24773.279387130457,NaN,NaN,NaN,NaN,NaN,24776.08,24800.017719179752,24752.14228082025,24782.179320943662,24767.31652313187,24782.854548294945,24751.778497968797,169,546.5,58.66529334156316,60.64667595641074,NaN,NaN,NaN,NaN,4.258053820154595,22.034736453854205,34468,-0.7249489165521714,2.693701858755958,3.418650775308129
2025-09-24T23:40:00-04:00,24786,24787.75,24785,24785,24773.279387130457,NaN,NaN,NaN,NaN,NaN,24776.9,24799.134207881856,24754.665792118147,24782.179320943662,24767.388869081053,24782.939804271195,24751.83793389091,180,535.5333333333333,55.64883959533861,60.262676163161245,NaN,NaN,NaN,NaN,4.150335690143552,21.188314093031384,34288,-0.7532324697507469,2.4771101881196955,3.2303426578704424
2025-09-24T23:45:00-04:00,24785,24787,24784.75,24785.25,24773.279387130457,NaN,NaN,NaN,NaN,NaN,24777.755,24797.813536827358,24757.696463172644,24780.19345675493,24767.4424257767,24783.001957011787,24751.88289454161,136,517,56.13463328282449,59.80916139756469,NaN,NaN,NaN,NaN,4.01459742656187,20.291904427644255,34424,-0.7449703636705673,2.299129703282233,3.0441000669528004
2025-09-24T23:50:00-04:00,24785.25,24786.75,24782,24782.75,24773.279387130457,NaN,NaN,NaN,NaN,NaN,24778.545,24796.054908623013,24761.035091376983,24779.31067329764,24767.562318205146,24783.127630080064,24751.997006330228,342,512.3,50.211704293508895,58.84885664778808,NaN,NaN,NaN,NaN,4.06712618180745,19.33156109009554,34082,-0.8880358969620312,1.9340551957502612,2.8220910927122924
2025-09-24T23:55:00-04:00,24783,24786.25,24782.75,24786,24773.279387130457,NaN,NaN,NaN,NaN,NaN,24779.24,24795.03587286875,24763.444127131253,24779.31067329764,24767.672753644743,24783.25024019597,24752.09526709352,298,502.3666666666667,56.619751561631304,58.22154413164338,NaN,NaN,NaN,NaN,4.026617168821203,18.43981370522888,34380,-0.7494753508539311,1.8852469041448785,2.6347222549988096
2025-09-25T00:00:00-04:00,24785.25,24786.25,24779,24784.75,24773.279387130457,NaN,NaN,NaN,NaN,NaN,24779.93,24793.450369809303,24766.409630190697,24779.31067329764,24767.902636722156,24783.47965000624,24752.32562343807,701,502.06666666666666,53.75411256771581,57.19335125426014,NaN,NaN,NaN,NaN,4.256858799619688,18.835796512951806,33679,-0.7271318882233713,1.7258073947195953,2.4529392829429666
2025-09-25T00:05:00-04:00,24785,24788,24780.75,24782,24773.279387130457,NaN,NaN,NaN,NaN,NaN,24780.455,24792.08542989686,24768.824570103145,24779.31067329764,24768.077645946356,24783.65483714782,24752.50045474489,539,501.6,47.99853554647445,55.79531030164132,NaN,NaN,NaN,NaN,4.470654599646854,18.454031658056685,33140,-0.8728715383188068,1.3618498600444582,2.234721398363265
2025-09-25T00:10:00-04:00,24782.25,24782.5,24775.75,24777.75,24773.279387130457,NaN,NaN,NaN,NaN,NaN,24780.66,24791.71701588619,24769.602984113808,24779.31067329764,24768.226805351405,24783.744153085227,24752.709457617584,690,501.4,40.738721615710446,54.460036671947265,NaN,NaN,NaN,NaN,4.633464985386364,19.37614307291074,32450,-1.2100595588070082,0.7221469498545048,1.932206508661513
2025-09-25T00:15:00-04:00,24777.5,24778,24773.5,24773.75,24773.279387130457,NaN,NaN,NaN,NaN,NaN,24780.62,24791.761920851663,24769.478079148335,24779.31067329764,24768.310320373206,24783.75120254265,24752.86943820376,604,467.93333333333334,35.32349198294567,52.87988895785104,NaN,NaN,NaN,NaN,4.623931772144481,20.678567333559066,31846,-1.6308553692141154,-0.10636270285613136,1.524492666357984
2025-09-25T00:20:00-04:00,24773.5,24777.5,24773,24774.75,NaN,NaN,NaN,24790.086725280413,24790.086725280413,24790.086725280413,24780.705,24791.598892758477,24769.811107241527,24779.31067329764,24768.393424826703,24783.7573889709,24753.02946068251,616,447.93333333333334,37.55814436035693,51.45935927071275,NaN,NaN,NaN,NaN,4.61507950270559,21.982952368620698,32462,-1.7591907425142137,-0.6744957617847831,1.0846949807294306
2025-09-25T00:25:00-04:00,24774.5,24775.75,24773.75,24775.5,NaN,NaN,NaN,24789.185055949485,NaN,NaN,24780.77,24791.49885829643,24770.041141703572,24779.31067329764,24768.427723615896,24783.759107366404,24753.096339865388,262,416.93333333333334,39.25338532101488,50.313079345991234,NaN,NaN,NaN,NaN,4.42828810965519,23.194167044035076,32724,-1.7094348918051931,-1.052098634027061,0.6573362577781322
2025-09-25T00:30:00-04:00,24775.25,24776,24773,24773.25,NaN,NaN,NaN,24788.688007951783,NaN,NaN,24780.895,24791.112675855453,24770.677324144548,24779.123538638112,24768.47219819394,24783.75135014194,24753.19304624594,400,409.26666666666665,36.08801471129939,48.78794845059565,NaN,NaN,NaN,NaN,4.326267530394105,24.474812032434592,32324,-1.7382200395556127,-1.5154387916663836,0.22278124788922904
2025-09-25T00:35:00-04:00,24773.5,24775.25,24773,24773.5,NaN,NaN,NaN,24787.974916681247,NaN,NaN,24780.92,24791.058757330913,24770.781242669083,24778.07383091049,24768.49702375127,24783.745713494995,24753.24833400755,233,403.3666666666667,36.69881810433942,47.46886690695457,NaN,NaN,NaN,NaN,4.177962706794526,25.66398237880557,32557,-1.6512182839161358,-1.8412416070059408,-0.19002332308980496
2025-09-25T00:40:00-04:00,24773.75,24774.25,24770,24771.25,NaN,NaN,NaN,24785.924920468464,NaN,NaN,24780.89,24791.133612648566,24770.646387351433,24777.559064728393,24768.53695521868,24783.698457885956,24753.3754525514,619,397.8666666666667,33.5876338270092,45.591505722266696,NaN,NaN,NaN,NaN,4.183108227737774,27.366539254927126,31938,-1.651985015256013,-2.255004592159821,-0.6030195769038083
2025-09-25T00:45:00-04:00,24771.5,24772.75,24768,24769,NaN,NaN,NaN,24784.195378628985,NaN,NaN,24780.74,24791.44558730712,24770.034412692883,24775.91280142617,24768.552726062127,24783.62804107217,24753.477411052085,598,402.26666666666665,30.77770942411162,43.59953544244873,NaN,NaN,NaN,NaN,4.2236004971850765,29.28178975206842,31340,-1.7039579325484366,-2.732966992589354,-1.0290090600409174
2025-09-25T00:50:00-04:00,24768.5,24768.75,24757.75,24758.25,NaN,NaN,NaN,24777.976270509487,NaN,NaN,24780.35,24792.749596767637,24767.95040323236,24775.91280142617,24768.320164012162,24783.194579342216,24753.44574868211,1806,451.8,21.516056057416762,41.161479475454314,NaN,NaN,NaN,NaN,4.72548617595757,32.16780597571538,29534,-2.323867866602202,-3.9338438932936697,-1.6099760266914678
2025-09-25T00:55:00-04:00,24758.5,24761.75,24754.5,24760.5,NaN,NaN,NaN,24773.170530940875,NaN,NaN,24780.11,24793.530566304078,24766.689433695923,24769.45524114094,24768.134519367766,24782.91936210982,24753.349676625712,1090,471.3,26.501345235568692,39.044816043507474,NaN,NaN,NaN,NaN,4.905808591960601,35.071969519445034,30624,-2.432326822329289,-4.650384554603079,-2.21805773227379
2025-09-25T01:00:00-04:00,24760.75,24763.25,24749.5,24754,NaN,NaN,NaN,24772.611643170836,NaN,NaN,24779.705,24794.91180438504,24764.498195614964,24765.936893417063,24767.76881370635,24782.488825284436,24753.04880212826,1657,509.73333333333335,22.128391315255868,37.0388651164894,NaN,NaN,NaN,NaN,5.537536549677701,38.05301185172817,28967,-2.767393409186117,-5.677299493756436,-2.909906084570319
2025-09-25T01:05:00-04:00,24754.5,24758,24747.5,24749.5,NaN,NaN,NaN,24769.680432117613,NaN,NaN,24779.175,24796.553506848577,24761.79649315142,24765.936893417063,24767.461085142953,24782.205513966044,24752.716656319863,1108,537.5,19.70428579891417,34.40204613343818,NaN,NaN,NaN,NaN,5.891998224700722,40.919453428836945,27859,-3.092985747957429,-6.776138269517105,-3.683152521559676
2025-09-25T01:10:00-04:00,24750,24754.5,24744,24746.75,NaN,NaN,NaN,24766.842685203177,NaN,NaN,24778.63,24798.19508113664,24759.06491886336,24765.936893417063,24766.992343820093,24781.850154402997,24752.13453323719,1463,575.9,18.379230893623188,31.87526887100299,NaN,NaN,NaN,NaN,6.22114120865067,43.737928349271755,26396,-3.2768412713140727,-7.779204110702267,-4.502362839388194
2025-09-25T01:15:00-04:00,24746.75,24752.5,24746,24751.75,NaN,NaN,NaN,24766.842685203177,NaN,NaN,24778.19,24799.116433052477,24757.26356694752,24765.936893417063,24766.73048171152,24781.61990978113,24751.841053641907,935,597.4333333333333,27.875982522717038,30.437943655020316,NaN,NaN,NaN,NaN,6.241059693747052,46.355083632532654,27331,-2.86016541564467,-8.077569608944032,-5.217404193299362
2025-09-25T01:20:00-04:00,24752.25,24755,24749.75,24754.5,NaN,NaN,NaN,24766.842685203177,NaN,NaN,24777.755,24799.70391567941,24755.806084320593,24765.936893417063,24766.59552762198,24781.47256674244,24751.71848850152,603,602.4,32.52603647736484,29.85132328799563,NaN,NaN,NaN,NaN,6.170269715622262,47.79411007510069,27934,-2.2260018107627477,-7.999906456752797,-5.773904645990049
2025-09-25T01:25:00-04:00,24754.75,24757,24751,24756.25,NaN,NaN,NaN,24766.842685203177,NaN,NaN,24777.34,24800.10000000131,24754.579999998692,24764.67451473365,24766.46355847455,24781.30964753088,24751.617469418215,687,614,35.38117495794383,29.8554435004955,NaN,NaN,NaN,NaN,6.158107593077815,48.391093330882946,28621,-1.547509157602379,-7.708291092993022,-6.160781935390643
2025-09-25T01:30:00-04:00,24756,24757,24748.75,24751.5,NaN,NaN,NaN,24766.842685203177,NaN,NaN,24776.91,24800.76765286309,24753.05234713691,24762.71461178692,24766.276557274745,24781.111111061866,24751.442003487624,832,624.8666666666667,31.48662474257945,29.421763527797104,NaN,NaN,NaN,NaN,6.307528479286542,49.16478201867868,27789,-1.2880873502273307,-7.770891123174806,-6.4828037729474755
2025-09-25T01:35:00-04:00,24751.25,24752,24744.75,24745,NaN,NaN,NaN,24766.4831957794,NaN,NaN,24776.245,24801.715274831608,24750.77472516839,24755.096689429534,24766.024219650437,24780.919952382574,24751.1284869183,840,638.4666666666667,27.09192375014618,28.553087701306477,NaN,NaN,NaN,NaN,6.374847873623217,50.227570312185655,26949,-1.4136754501131703,-8.249898085588939,-6.836222635475768
2025-09-25T01:40:00-04:00,24745.5,24753,24745.25,24749,NaN,NaN,NaN,24766.4831957794,NaN,NaN,24775.625,24802.185355793295,24749.064644206705,24747.20235154363,24765.86602981199,24780.781317872512,24750.95074175147,597,639.3666666666667,33.26482520547458,28.351431308033277,NaN,NaN,NaN,NaN,6.490930168364416,50.852973329024906,27546,-1.1006892428739965,-8.212084189068264,-7.111394946194268
2025-09-25T01:45:00-04:00,24748.75,24750.75,24737.75,24744.25,NaN,NaN,NaN,24763.56345937751,NaN,NaN,24774.94,24802.898283214457,24746.98171678554,24744.7368812349,24765.320916173685,24780.43189604639,24750.20993630098,1654,684.2666666666667,30.014930106956896,27.874010736791668,NaN,NaN,NaN,NaN,6.955863727766959,52.01809374101237,25892,-1.0851162756676214,-8.467790290778794,-7.3826740151111725
2025-09-25T01:50:00-04:00,24744.5,24750,24741.25,24749.5,NaN,NaN,NaN,24763.56345937751,NaN,NaN,24774.285,24803.0504323789,24745.5195676211,24738.915221243053,24765.1375626434,24780.283773687832,24749.991351598965,660,694.1,37.30553668833133,28.13957522688611,NaN,NaN,NaN,NaN,7.084016318640748,53.09999126642931,26552,-0.616122688470595,-8.152827375699417,-7.536704687228822
2025-09-25T01:55:00-04:00,24749.5,24754.25,24749,24753,NaN,NaN,NaN,24763.56345937751,NaN,NaN,24773.545,24802.557874737922,24744.532125262074,24738.915221243053,24765.00743978679,24780.133666174064,24749.881213399516,667,710.2666666666667,41.668250166047436,28.917470994167235,NaN,NaN,NaN,NaN,6.953015153023551,52.72077246961601,27219,0.002204096857146176,-7.533949566157389,-7.536153663014535
2025-09-25T02:00:00-04:00,24752.75,24757.75,24748.75,24756.75,NaN,NaN,NaN,24763.56345937751,NaN,NaN,24772.955,24802.10987780516,24743.800122194843,24738.915221243053,24764.819332110088,24779.875748473358,24749.762915746818,1210,739.8666666666667,46.003748473210536,30.66659188100965,NaN,NaN,NaN,NaN,7.099228356379011,51.38471748628063,28429,0.6976657182583414,-6.664071515191608,-7.36173723344995
2025-09-25T02:05:00-04:00,24757,24758.75,24745.75,24751.25,NaN,NaN,NaN,24763.56345937751,NaN,NaN,24772.31,24801.92647513823,24742.693524861774,24738.915221243053,24764.603859347782,24779.62529839671,24749.582420298855,1157,772.8,41.17052847986982,31.714390684174017,NaN,NaN,NaN,NaN,7.520712045209081,50.51747049018543,27272,0.8131132015592746,-6.345345731500856,-7.158458933060131
2025-09-25T02:10:00-04:00,24751.5,24753,24744,24745.75,NaN,NaN,NaN,24763.56345937751,NaN,NaN,24771.56,24801.920263499298,24741.199736500705,24738.915221243053,24764.41893551104,24779.462385006253,24749.375486015826,761,792.1666666666666,36.98583671397494,32.77563678408252,NaN,NaN,NaN,NaN,7.62637547055129,49.91790577616198,26511,0.5571138625386762,-6.462066604886786,-7.019180467425462
2025-09-25T02:15:00-04:00,24745.25,24746.5,24739,24739.5,NaN,NaN,NaN,24763.56345937751,NaN,NaN,24770.73,24802.25916744678,24739.20083255322,24738.407176994442,24764.087944529638,24779.268010824548,24748.907878234728,1034,822.1,32.89418905967631,33.71777273127982,NaN,NaN,NaN,NaN,7.617348651226197,49.887426329275556,25477,0.03258573672826959,-6.9784482965151255,-7.011034033243395
2025-09-25T02:20:00-04:00,24740,24742.25,24733,24734.75,NaN,NaN,NaN,24758.957036452604,NaN,NaN,24769.825,24802.802302801432,24736.84769719857,24737.32176300603,24763.387929182827,24778.98463188795,24747.791226477704,1862,872.7666666666667,30.163093269847238,34.55947718672439,NaN,NaN,NaN,NaN,7.73396660471004,50.36879250379792,23615,-0.5371021730385985,-7.682411749541643,-7.1453095765030445
2025-09-25T02:25:00-04:00,24735,24741,24733.75,24736.5,NaN,NaN,NaN,24758.726034795665,NaN,NaN,24768.95,24803.07608972144,24734.823910278563,24737.32176300603,24763.031115604117,24778.8176905821,24747.244540626136,1003,896.2666666666667,32.39027691176754,34.881926785942284,NaN,NaN,NaN,NaN,7.699397561516466,50.81577538014012,24618,-0.6891923995890075,-8.006800075989304,-7.317607676400296
2025-09-25T02:30:00-04:00,24736.5,24743.5,24732.25,24735,NaN,NaN,NaN,24758.726034795665,NaN,NaN,24768.01,24803.218516019235,24732.801483980762,24737.32176300603,24762.58845074916,24778.59955619875,24746.57734529957,1275,915.4,31.46403724831856,34.806069698153266,NaN,NaN,NaN,NaN,7.953012021408147,50.51589903935444,23343,-0.7774042660391984,-8.289363008949294,-7.511958742910096
2025-09-25T02:35:00-04:00,24735,24738.25,24734.5,24736.75,NaN,NaN,NaN,24757.804868481177,NaN,NaN,24767.12,24803.184142860795,24731.055857139203,24737.32176300603,24762.37823759033,24778.49437253975,24746.262102640907,611,917.8,33.841035623473985,34.69605974569113,NaN,NaN,NaN,NaN,7.65279687702185,50.237442437196314,23954,-0.6117749331262647,-8.276677409317927,-7.664902476191662
2025-09-25T02:40:00-04:00,24736.5,24736.5,24722.25,24726.75,NaN,NaN,NaN,24751.808056277485,NaN,NaN,24765.985,24803.460113074685,24728.509886925316,24737.32176300603,24761.284387044074,24778.231509098332,24744.337264989816,2530,979.1333333333333,27.888724156886155,34.43906684671304,NaN,NaN,NaN,NaN,8.141882814377432,50.9946988120016,21424,-1.0441886085247187,-8.97013823684756,-7.925949628322842
2025-09-25T02:45:00-04:00,24726,24731.25,24719.25,24730,NaN,NaN,NaN,24748.2997355376,NaN,NaN,24764.89,24803.29587975841,24726.48412024159,24737.32176300603,24760.454561683186,24778.00981060529,24742.89931276108,1934,1023.4666666666667,32.07056998995192,34.79468443527059,NaN,NaN,NaN,NaN,8.417462613350471,51.88149926441127,23358,-0.9808122534829966,-9.151964945176587,-8.17115269169359
2025-09-25T02:50:00-04:00,24730,24732.75,24726.75,24731.75,NaN,NaN,NaN,24748.2997355376,NaN,NaN,24763.81,24802.840700734705,24724.779299265298,24735.907410404823,24760.06280960751,24777.83304745051,24742.29257176451,1061,1038.3,34.280598171320534,34.86723964711673,NaN,NaN,NaN,NaN,8.244786712396866,52.30644118228328,24419,-0.7034976318665844,-9.05052473152682,-8.347027099660236
2025-09-25T02:55:00-04:00,24731.75,24732.5,24726.75,24727.75,NaN,NaN,NaN,24748.2997355376,NaN,NaN,24762.62,24802.34156089723,24722.89843910277,24730.22592832386,24759.784679246655,24777.715548220032,24741.85381027328,735,1054.0666666666666,31.73882217914789,34.99037479513038,NaN,NaN,NaN,NaN,8.066587661511376,52.70103010602158,23684,-0.6719760936904571,-9.186997216773307,-8.51502112308285
2025-09-25T03:00:00-04:00,24728.25,24733.25,24713,24715.5,NaN,NaN,NaN,24747.427601503918,NaN,NaN,24761.135,24802.216895047997,24720.053104952,24724.530742659088,24758.248928034955,24777.40004647091,24739.097809599,3347,1152.3,25.50245528506754,34.14729755204011,NaN,NaN,NaN,NaN,8.936831399974848,53.86958612671398,20337,-1.3211294665759148,-10.166432956302742,-8.845303489726827
2025-09-25T03:05:00-04:00,24716,24722.75,24710,24715.75,NaN,NaN,NaN,24741.31157416283,NaN,NaN,24759.66,24801.843380609655,24717.476619390345,24720.76674024145,24757.172369351487,24777.21052551246,24737.134213190515,2243,1219.3,25.822787020369418,33.01547875592025,NaN,NaN,NaN,NaN,9.209200585690931,55.08481458656858,22580,-1.5621550753608773,-10.797997333927924,-9.235842258567047
2025-09-25T03:10:00-04:00,24716,24716.25,24694.5,24697.5,NaN,NaN,NaN,24732.144002609974,NaN,NaN,24757.895,24802.85754997113,24712.93245002887,24720.76674024145,24754.91280226507,24777.334264973582,24732.491339556556,3798,1325.2666666666667,19.298993464728227,31.107996255314365,NaN,NaN,NaN,NaN,10.104971972427293,56.72652939779411,18782,-2.711805460884772,-12.625599084673013,-9.91379362378824
2025-09-25T03:15:00-04:00,24698,24709.25,24696.5,24707.5,NaN,NaN,NaN,24730.165866127703,NaN,NaN,24756.35,24802.7995425211,24709.900457478896,24720.76674024145,24753.808616068403,24777.180971622183,24730.436260514623,2045,1373.5,29.769016997859595,30.293602578027926,NaN,NaN,NaN,NaN,10.293902545825343,58.25097886536069,20827,-2.561667924526599,-13.11587852944649,-10.554210604919891
2025-09-25T03:20:00-04:00,24707.25,24722,24704,24717.5,NaN,NaN,NaN,24730.165866127703,NaN,NaN,24755.005,24801.97887464819,24708.031125351812,24718.188392193162,24752.893937099427,24776.740822639407,24729.047051559446,2228,1387.5666666666666,38.37864928557793,30.393089190285277,NaN,NaN,NaN,NaN,10.84433807826639,57.24258550952953,23055,-1.598880398184562,-12.552811102650594,-10.953930704466032
2025-09-25T03:25:00-04:00,24717.5,24731.5,24717.5,24730,24695.381669499344,24695.381669499344,24695.381669499344,NaN,NaN,NaN,24753.93,24800.68297209528,24707.17702790472,24713.20071375453,24752.39368204781,24776.28929033151,24728.498073764105,1838,1412.5,47.10728575725467,31.40831038296945,NaN,NaN,NaN,NaN,11.069742501247362,54.940692842019246,24893,-0.014022183440863145,-10.971458433767111,-10.957436250326248
2025-09-25T03:30:00-04:00,24730,24742.5,24726.5,24736.5,24704.523411794828,NaN,NaN,NaN,NaN,NaN,24752.96,24799.10275241266,24706.81724758734,24711.45576544232,24751.923033284158,24775.656691107724,24728.18937546059,2741,1448.6333333333334,50.994579339609984,32.89627367366679,NaN,NaN,NaN,NaN,11.421903751158265,51.53591125397292,27634,1.4947829773009023,-9.08895752870012,-10.583740506001023
2025-09-25T03:35:00-04:00,24736.25,24748.5,24736.25,24741.75,24712.09052944052,NaN,NaN,NaN,NaN,NaN,24752.115,24797.49420338101,24706.735796618992,24713.38710891271,24751.712568266037,24775.23158900124,24728.193547530835,2212,1485.4333333333334,53.939099561935855,34.43547529153595,NaN,NaN,NaN,NaN,11.481053483218389,47.924849623021196,29846,2.7936465049366017,-7.09168237483027,-9.885328879766872
2025-09-25T03:40:00-04:00,24742.25,24745,24737.75,24741.5,24712.09052944052,NaN,NaN,NaN,NaN,NaN,24751.21,24795.583906748023,24706.836093251975,24713.38710891271,24751.579169313794,24774.974322300866,24728.184016326722,1346,1481.5333333333333,53.77340686727398,36.029001692889906,NaN,NaN,NaN,NaN,11.178835377274217,44.571720965708884,28500,3.535469675321348,-5.465991785615188,-9.001461460936536
2025-09-25T03:45:00-04:00,24741.75,24743,24731,24731.75,24712.09052944052,NaN,NaN,NaN,NaN,NaN,24750.12,24793.667243311775,24706.572756688223,24713.38710891271,24751.287097348533,24774.57287166472,24728.001323032346,1892,1513.4333333333334,47.62849300454093,37.01382007725183,NaN,NaN,NaN,NaN,11.237489993183202,41.97605806521891,26608,3.2749372882341135,-4.907789850643894,-8.182727138878008
2025-09-25T03:50:00-04:00,24732.25,24740.25,24728.75,24737.75,24712.09052944052,NaN,NaN,NaN,NaN,NaN,24749.175,24791.692084805327,24706.65791519467,24713.38710891271,24751.02577671798,24774.20420865872,24727.847344777238,1790,1553,51.31547093787602,38.687159133036815,NaN,NaN,NaN,NaN,11.256240707955829,39.77367953639154,28398,3.3974693554210607,-3.9358904446016822,-7.333359800022743
2025-09-25T03:55:00-04:00,24737.25,24740.25,24733,24737,24712.09052944052,NaN,NaN,NaN,NaN,NaN,24748.21,24789.58298152068,24706.837018479317,24713.38710891271,24750.919343304788,24774.043841022267,24727.79484558731,808,1557.0333333333333,50.83372056327437,40.02738417398842,NaN,NaN,NaN,NaN,10.970080657387555,37.72861375962327,27590,3.3151627172469222,-3.1894064034640905,-6.504569120711013
2025-09-25T04:00:00-04:00,24737.25,24755,24733,24750.75,24712.38390900894,NaN,NaN,NaN,NaN,NaN,24747.57,24787.759058217263,24707.380941782736,24721.357407848518,24750.789413606268,24773.602839354415,24727.97598785812,3102,1632.7,58.5218283694144,41.75890061670941,NaN,NaN,NaN,NaN,11.757932039002728,35.78010597061276,30692,4.026581995851645,-1.4713416258964571,-5.497923621748102
2025-09-25T04:05:00-04:00,24750.25,24758.25,24748.25,24755.5,24721.70736769035,NaN,NaN,NaN,NaN,NaN,24746.96,24785.696979752058,24708.22302024794,24726.335926278814,24750.844274617335,24773.465774820303,24728.222774414367,1938,1669.3,60.802119504050516,43.83485042563103,NaN,NaN,NaN,NaN,11.632365464788249,34.252654622821325,32630,4.614663158700843,0.2704053266279516,-4.344257832072891
2025-09-25T04:10:00-04:00,24755.25,24762,24751.25,24760,24725.050214613515,NaN,NaN,NaN,NaN,NaN,24746.465,24783.86727399456,24709.06272600544,24731.09374102305,24750.952692558036,24773.412326773687,24728.493058342385,1809,1709.7,62.883907638094165,46.50495416513293,NaN,NaN,NaN,NaN,11.569339360160516,33.151750679659244,34439,5.068138026988237,1.9909147016624047,-3.077223325325832
2025-09-25T04:15:00-04:00,24759.5,24762.25,24756.5,24757,24728.451341221993,NaN,NaN,NaN,NaN,NaN,24745.965,24782.100717788606,24709.829282211394,24734.649992818442,24751.026279147718,24773.38979213288,24728.662766162557,1122,1691.9666666666667,60.574210014488884,48.98719866471289,NaN,NaN,NaN,NaN,11.153672263006195,32.15101012143405,33317,4.923288585300384,3.0768874062996474,-1.8464011790007362
2025-09-25T04:20:00-04:00,24757,24761.5,24753,24755.25,24728.451341221993,NaN,NaN,NaN,NaN,NaN,24745.515,24780.601380549106,24710.428619450893,24735.169994254753,24751.068606419874,24773.35202501254,24728.78518782721,893,1699.7333333333333,59.208061463750674,51.83784637892878,NaN,NaN,NaN,NaN,10.96412424422004,30.77055429638267,32424,4.479565213881597,3.7530553383512597,-0.726509875530337
2025-09-25T04:25:00-04:00,24755,24759.5,24753.75,24757.5,24728.451341221993,NaN,NaN,NaN,NaN,NaN,24745.19,24779.517038907077,24710.86296109292,24735.5609954038,24751.103907380395,24773.324586589173,24728.883228171617,712,1701.2333333333333,60.44332355765359,54.028868276056926,NaN,NaN,NaN,NaN,10.591686798204323,29.488702458834965,33136,4.116834985831301,4.41953385675879,0.3026988709274885
2025-09-25T04:30:00-04:00,24757.25,24760.25,24755,24755.25,24728.451341221993,NaN,NaN,NaN,NaN,NaN,24744.8,24778.205538467522,24711.394461532476,24738.47379632304,24751.131365311052,24773.30226606328,24728.960464558822,568,1679.8333333333333,58.53443368314211,55.46856716159722,NaN,NaN,NaN,NaN,10.210137741189728,28.379390889438554,32568,3.527322022020642,4.711851398453291,1.184529376432649
2025-09-25T04:35:00-04:00,24755.25,24757.5,24748.25,24752.5,24728.451341221993,NaN,NaN,NaN,NaN,NaN,24744.34,24776.65760510785,24712.022394892152,24738.47379632304,24751.151980996645,24773.18198755963,24729.12197443366,1529,1692.2333333333333,56.19833675064394,56.11792794683931,NaN,NaN,NaN,NaN,10.14155647396189,26.438150377617138,31039,2.7866209643325766,4.66780558184837,1.8811846175157934
2025-09-25T04:40:00-04:00,24751.75,24752.5,24743,24746.75,24728.451341221993,NaN,NaN,NaN,NaN,NaN,24743.81,24775.06548911142,24712.55451088858,24738.47379632304,24751.1174544094,24773.04832309377,24729.186585725027,1120,1704.2,51.56440842550636,56.15863002440334,NaN,NaN,NaN,NaN,10.09573101153604,25.083519220446966,29919,1.7921826474950926,4.121412926884659,2.3292302793895665
2025-09-25T04:45:00-04:00,24746.75,24747.25,24730.5,24730.75,24728.451341221993,NaN,NaN,NaN,NaN,NaN,24742.955,24773.2387728782,24712.671227121802,24738.47379632304,24750.91179726352,24772.760813377696,24729.062781149347,1690,1726.0666666666666,41.34764287258882,55.25924026087855,NaN,NaN,NaN,NaN,10.571035939283465,25.01656596232728,28229,0.03262103121904536,2.3700065684133733,2.337385537194328
2025-09-25T04:50:00-04:00,24731,24732.25,24718.25,24725,NaN,NaN,NaN,24756.038188171522,24756.038188171522,24756.038188171522,24742.03,24771.617605524298,24712.4423944757,24738.47379632304,24750.456470058332,24772.375679181438,24728.537260935227,2212,1737.7333333333333,38.40282080345761,54.161341256320235,NaN,NaN,NaN,NaN,10.815961943620362,25.82014489735423,26017,-1.4602092145772008,0.5121240189728269,1.9723332335500277
2025-09-25T04:55:00-04:00,24724.5,24733.5,24722.25,24729,NaN,NaN,NaN,24756.038188171522,NaN,NaN,24741.23,24770.00947879937,24712.45052120063,24738.47379632304,24750.207351701047,24772.12838878664,24728.286314615452,1419,1751.6,41.52293643278969,53.72523007262372,NaN,NaN,NaN,NaN,10.846964661933194,26.398366237011572,27436,-2.0820504421377644,-0.630229819122178,1.4518206230155863
2025-09-25T05:00:00-04:00,24729.25,24732,24717,24717.5,NaN,NaN,NaN,24756.038188171522,NaN,NaN,24740.415,24769.52644276686,24711.303557233143,24738.47379632304,24749.855576242997,24771.861116146716,24727.850036339278,1607,1762.6666666666667,35.893687273248986,52.62367409657894,NaN,NaN,NaN,NaN,11.14361004322368,27.277037244884035,25829,-3.109803057300912,-2.4354331986105535,0.6743698586903584
2025-09-25T05:05:00-04:00,24718,24724,24713.5,24720.75,NaN,NaN,NaN,24750.30983852897,NaN,NaN,24739.62,24768.665006464653,24710.574993535345,24738.47379632304,24749.451121535632,24771.58609410455,24727.316148966715,1725,1799.8,38.433923440972265,51.737974302128784,NaN,NaN,NaN,NaN,11.09763789727913,28.30929616714074,27554,-3.389698164508232,-3.5627528469449317,-0.17305468243669964
2025-09-25T05:10:00-04:00,24721,24727.5,24719.25,24727.5,NaN,NaN,NaN,24750.30983852897,NaN,NaN,24739.09,24768.033006061705,24710.146993938295,24738.47379632304,24749.282747316633,24771.43557829047,24727.129916342794,891,1745.1666666666667,43.44625468845025,50.661147610631346,NaN,NaN,NaN,NaN,10.89423519033062,28.7563505565613,28445,-2.9550904789617674,-3.866917781138909,-0.9118273021771416
2025-09-25T05:15:00-04:00,24727.25,24733.5,24723.25,24733.5,NaN,NaN,NaN,24750.30983852897,NaN,NaN,24738.77,24767.599124164582,24709.94087583542,24738.47379632304,24749.105928991565,24771.232652356717,24726.979205626412,1215,1721.2,47.535087910583385,49.71350249681227,NaN,NaN,NaN,NaN,10.848218391021291,28.3514139038063,29660,-2.1365571370818452,-3.582523723529448,-1.4459665864476028
2025-09-25T05:20:00-04:00,24733.25,24735.5,24730,24733.75,NaN,NaN,NaN,24750.30983852897,NaN,NaN,24738.51,24767.280985391386,24709.73901460861,24735.454037058433,24749.011035007603,24771.106367481058,24726.91570253415,786,1712.0333333333333,47.704745677358204,48.62927664247398,NaN,NaN,NaN,NaN,10.466202791662628,27.71413816282953,30446,-1.4823774230879572,-3.2989383653075492,-1.816560942219592
2025-09-25T05:25:00-04:00,24734.25,24737.5,24726.75,24729.25,NaN,NaN,NaN,24750.30983852897,NaN,NaN,24738.06,24766.692072924216,24709.427927075787,24730.113229646748,24748.882220343752,24770.949424568884,24726.81501611862,965,1719.7,44.89077792306987,47.50903149308691,NaN,NaN,NaN,NaN,10.486474020829585,27.40686871545048,29481,-1.2652598257131702,-3.3981357243610546,-2.1328758986478844
2025-09-25T05:30:00-04:00,24729.25,24732.5,24721.25,24726,NaN,NaN,NaN,24750.30983852897,NaN,NaN,24737.49,24765.924303221385,24709.055696778618,24720.965583717396,24748.673512200297,24770.741909263757,24726.605115136837,1263,1650.2333333333333,42.92158262870311,46.345711576297795,NaN,NaN,NaN,NaN,10.541011590770328,27.573659286600027,28218,-1.2508100961083732,-3.696388518783351,-2.445578422674978
2025-09-25T05:35:00-04:00,24725.75,24731.25,24717,24717,NaN,NaN,NaN,24750.30983852897,NaN,NaN,24736.705,24765.191433606615,24708.21856639339,24712.572640305927,24748.43815989872,24770.55236409078,24726.32395570666,1190,1615.1333333333334,37.95614443702483,44.739484496252885,NaN,NaN,NaN,NaN,10.805939334286734,28.051466434304977,27028,-1.7282468561248772,-4.605886992831074,-2.877640136706197
2025-09-25T05:40:00-04:00,24717.5,24718.5,24703.25,24703.5,NaN,NaN,NaN,24742.851732511124,NaN,NaN,24735.745,24765.384245941787,24706.10575405821,24712.572640305927,24747.90328692429,24770.344822840423,24725.46175100816,1844,1550,31.979824121382336,42.84272667041291,NaN,NaN,NaN,NaN,11.123372238980538,29.355084368428457,25184,-2.7722009775291503,-6.342891358617635,-3.5706903810884847
2025-09-25T05:45:00-04:00,24704,24706.5,24688.5,24704.25,NaN,NaN,NaN,24730.477790124252,NaN,NaN,24734.93,24765.724973615674,24704.135026384327,24712.572640305927,24746.54926403602,24770.061568063193,24723.03696000885,3992,1614.9,32.61461353819553,41.15817501238088,NaN,NaN,NaN,NaN,11.614559936196214,31.235378126614943,29176,-3.200791289506956,-7.57167949297218,-4.370888203465224
2025-09-25T05:50:00-04:00,24703.75,24709.25,24699,24708.5,NaN,NaN,NaN,24730.477790124252,NaN,NaN,24734.12,24765.516694092235,24702.723305907763,24712.572640305927,24746.16139891854,24769.896037764036,24722.42676007304,1357,1585.8666666666666,36.245519399174896,40.06396865335721,NaN,NaN,NaN,NaN,11.517091369325057,32.604685669803814,30533,-2.990559000778765,-8.10908695443868,-5.118527953659916
2025-09-25T05:55:00-04:00,24708.5,24712.75,24697.5,24706.25,NaN,NaN,NaN,24730.477790124252,NaN,NaN,24733.36,24765.568253595535,24701.151746404466,24712.572640305927,24745.695570606815,24769.6873111682,24721.70383004543,1661,1579.9666666666667,35.165227864390545,39.62236758134305,NaN,NaN,NaN,NaN,11.783727700087553,33.39951760407657,28872,-2.7989445318718413,-8.617208618499717,-5.818264086627876
2025-09-25T06:00:00-04:00,24706.25,24710,24695.75,24705.75,NaN,NaN,NaN,24730.477790124252,NaN,NaN,24732.485,24765.263866662153,24699.706133337848,24712.572640305927,24745.294077464303,24769.516573406672,24721.071581521934,1404,1535.4,34.91617845312622,39.37332169917652,NaN,NaN,NaN,NaN,11.959890007224157,34.23135611496918,27468,-2.5109838263925797,-8.9569938696186,-6.44601004322602
2025-09-25T06:05:00-04:00,24706,24712.25,24701.75,24710.5,NaN,NaN,NaN,24730.477790124252,NaN,NaN,24731.635,24764.446005781756,24698.82399421824,24712.572640305927,24744.954072274148,24769.323398735985,24720.58474581231,1353,1506.7666666666667,39.3133512036914,39.21549418281236,NaN,NaN,NaN,NaN,11.855612149565289,34.67953053315026,28821,-1.8369647672779061,-8.742216002323403,-6.905251235045497
2025-09-25T06:10:00-04:00,24710.25,24714.5,24703.5,24705.5,NaN,NaN,NaN,24730.477790124252,NaN,NaN,24730.61,24763.420693375036,24697.799306624966,24712.572640305927,24744.611539553418,24769.12647199738,24720.096607109455,1376,1507.7666666666667,36.516611597940376,39.25998877743317,NaN,NaN,NaN,NaN,11.79449699602491,34.768460980401656,27445,-1.5743404120766291,-8.873176750141283,-7.298836338064654
2025-09-25T06:15:00-04:00,24706,24711,24698.75,24706.5,NaN,NaN,NaN,24730.477790124252,NaN,NaN,24729.715,24762.6658740383,24696.7641259617,24706.933112244744,24744.242081179942,24768.933401856495,24719.55076050339,1419,1492,37.474649694385604,39.19146922410555,NaN,NaN,NaN,NaN,11.827032924880273,35.16689738597485,28864,-1.1968432667548132,-8.794890421508171,-7.598047154753358
2025-09-25T06:20:00-04:00,24706.25,24710.25,24693.25,24699.5,NaN,NaN,NaN,24730.477790124252,NaN,NaN,24728.79,24762.476846095095,24695.103153904907,24703.671489795794,24743.77241372135,24768.734953285482,24718.80987415722,1653,1487.4333333333334,33.64684515555682,38.491511400327454,NaN,NaN,NaN,NaN,12.196530573103109,35.874501163782355,27211,-1.2749485688242785,-9.191732865783706,-7.9167842969594275
2025-09-25T06:25:00-04:00,24700,24700.25,24681.5,24686.25,NaN,NaN,NaN,24726.511965263733,NaN,NaN,24727.725,24763.303961482743,24692.146038517254,24688.812191836634,24742.730717216633,24768.55374248987,24716.907691943397,2969,1559.4666666666667,27.848362567297173,37.08531673294986,NaN,NaN,NaN,NaN,12.664635532167171,37.1365079422551,24242,-2.0304767826067582,-10.454880275217874,-8.424403492611116
2025-09-25T06:30:00-04:00,24686.25,24707,24684,24705.25,NaN,NaN,NaN,24726.511965263733,NaN,NaN,24727.135,24763.203436343927,24691.06656365607,24683.505199216823,24742.105918087706,24768.26780390312,24715.94403227229,2236,1530.6,43.013997756422526,36.75026331002589,NaN,NaN,NaN,NaN,13.402875851298088,37.353283194720674,26478,-1.108246990745343,-9.809712231042795,-8.701465240297452
2025-09-25T06:35:00-04:00,24706,24709.5,24696.75,24697.25,NaN,NaN,NaN,24726.511965263733,NaN,NaN,24726.35,24763.26747554441,24689.432524455588,24683.505199216823,24741.766460108032,24768.08282295074,24715.450097265326,1316,1509.8666666666666,39.271095396578545,36.348857415276505,NaN,NaN,NaN,NaN,13.356241861919653,37.21847660693336,25162,-0.9033267981258284,-9.830623737954738,-8.92729693982891
2025-09-25T06:40:00-04:00,24697,24697,24682,24683.5,NaN,NaN,NaN,24726.511965263733,NaN,NaN,24725.32,24764.04415783473,24686.59584216527,24683.505199216823,24740.961399713637,24767.89309837044,24714.029701056832,2390,1529.2333333333333,33.82339427775638,35.698986818780305,NaN,NaN,NaN,NaN,13.491510300353964,37.90363871616315,22772,-1.523637323285957,-10.831843593936355,-9.308206270650398
2025-09-25T06:45:00-04:00,24683.5,24683.5,24670,24680,NaN,NaN,NaN,24714.47398632887,NaN,NaN,24724.185,24764.78386820818,24683.586131791824,24683.505199216823,24739.86781961506,24767.806883157686,24711.928756072437,2840,1586.5,32.584315581650074,35.31528475768211,NaN,NaN,NaN,NaN,13.492116707471538,39.046924328596916,19932,-1.9710650404379777,-11.77203757119787,-9.800972530759893
2025-09-25T06:50:00-04:00,24679.25,24684.5,24672,24683.75,NaN,NaN,NaN,24714.47398632887,NaN,NaN,24723.325,24765.462661296093,24681.18733870391,24683.505199216823,24739.149052552068,24767.67379621797,24710.624308886167,1995,1623.2333333333333,35.31839059621018,35.55375379159839,NaN,NaN,NaN,NaN,13.42125122836643,39.97842881670658,21927,-1.8195077439481455,-12.075357210695074,-10.255849466746929
2025-09-25T06:55:00-04:00,24684,24690,24680,24688.75,NaN,NaN,NaN,24714.47398632887,NaN,NaN,24722.5,24765.684835299307,24679.315164700693,24683.505199216823,24738.644797971352,24767.494844440047,24709.794751502657,1597,1652.7333333333333,38.87775300673161,36.001120896493816,NaN,NaN,NaN,NaN,13.17687614062597,40.131713319957385,23524,-1.21654402312085,-11.776529495647992,-10.559985472527142
2025-09-25T07:00:00-04:00,24688.75,24691.5,24665.5,24678.5,NaN,NaN,NaN,24714.47398632887,NaN,NaN,24721.435,24766.250489505666,24676.619510494336,24680.079159373458,24737.21079313934,24767.155275017052,24707.26631126163,4092,1770.2,34.666252713315956,35.888316133218176,NaN,NaN,NaN,NaN,14.092813559152686,40.92237487254832,19432,-1.3327024786200266,-12.225863570802176,-10.89316109218215
2025-09-25T07:05:00-04:00,24678.25,24681.5,24664,24665.75,NaN,NaN,NaN,24712.56438291965,NaN,NaN,24720.195,24767.5991443359,24672.790855664098,24677.013327498767,24736.346460025146,24767.039360394087,24705.653559656206,2250,1794.2333333333333,30.273212391013416,35.53888645654838,NaN,NaN,NaN,NaN,14.336184019213208,41.71641481633884,17182,-2.0500102253664334,-13.455673873890191,-11.405663648523758
2025-09-25T07:10:00-04:00,24665.5,24666.75,24638,24642.75,NaN,NaN,NaN,24694.300092786936,NaN,NaN,24718.74,24770.862352203523,24666.61764779648,24670.90782367937,24733.684674550597,24767.42278374702,24699.946565354174,5476,1939.4333333333334,24.292721902682615,34.7800681315167,NaN,NaN,NaN,NaN,15.365742303555121,43.285288008525875,11706,-3.7559629104464634,-16.100617286581837,-12.344654376135374
2025-09-25T07:15:00-04:00,24642.75,24651.25,24639,24640.25,NaN,NaN,NaN,24686.81486129662,NaN,NaN,24717.23,24773.796406991813,24660.663593008187,24670.90782367937,24731.627328524177,24767.594004238472,24695.660652809882,4187,2022.6666666666667,23.74365813881333,33.667947198311126,NaN,NaN,NaN,NaN,15.143189281872612,44.742098829842405,7519,-4.675327523442155,-18.188813780438068,-13.513486256995913
2025-09-25T07:20:00-04:00,24640.75,24645.25,24626.75,24637.25,NaN,NaN,NaN,24678.31759487405,NaN,NaN,24716.025,24776.643087232864,24655.40691276714,24670.90782367937,24728.67225835629,24767.737252429502,24689.60726428308,5879,2144.9,23.069818263851957,32.70746196016195,NaN,NaN,NaN,NaN,15.382961476024567,46.39864620376297,1640,-5.07473217416978,-19.85690147470814,-14.782169300538358
2025-09-25T07:25:00-04:00,24638,24650.75,24637,24639.25,NaN,NaN,NaN,24678.31759487405,NaN,NaN,24714.66,24778.947149573076,24650.372850426924,24658.501258943495,24727.247150786352,24767.519917770212,24686.97438380249,3179,2203.5666666666666,24.605988520766076,31.78827187633198,NaN,NaN,NaN,NaN,15.266321370594241,47.29407516042761,4819,-4.796643881843668,-20.777974152842944,-15.981330270999276
2025-09-25T07:30:00-04:00,24639,24646.25,24630.75,24639,NaN,NaN,NaN,24678.31759487405,NaN,NaN,24713.09,24780.76782206575,24645.41217793425,24655.96864457907,24725.748292600754,24767.28110966691,24684.2154755346,3315,2260.5,24.540023718000555,31.13778463079225,NaN,NaN,NaN,NaN,15.283012701266083,48.30606496821336,1504,-4.241151207755117,-21.282769280693174,-17.041618072938057
2025-09-25T07:35:00-04:00,24638.75,24642.5,24630,24633.25,NaN,NaN,NaN,24678.31759487405,NaN,NaN,24711.155,24782.23515827416,24640.074841725836,24655.96864457907,24724.630984669362,24767.099138987152,24682.16283035157,2449,2284.633333333333,23.01197281167886,30.792328219676655,NaN,NaN,NaN,NaN,15.084226079747078,49.26749007084645,-945,-3.8822373947761477,-21.894414816408243,-18.012177421632096
2025-09-25T07:40:00-04:00,24633.25,24633.5,24609.25,24609.75,NaN,NaN,NaN,24664.997871639145,NaN,NaN,24708.62,24784.764155391116,24632.47584460888,24655.96864457907,24721.438847803645,24767.06331178589,24675.814383821402,6092,2458,18.061905439457448,29.010035911322007,NaN,NaN,NaN,NaN,15.738924216908002,50.68007740699076,-7037,-4.789265387172911,-23.998759155598236,-19.209493768425325
2025-09-25T07:45:00-04:00,24609.75,24624.25,24603.75,24621.25,NaN,NaN,NaN,24658.43546838282,NaN,NaN,24706.21,24785.56725297849,24626.85274702151,24651.274915663256,24717.845123376013,24766.577743210633,24669.112503541393,7244,2658.9666666666667,26.404880302482354,28.091020547457994,NaN,NaN,NaN,NaN,16.07900105855743,52.105716131451715,207,-4.197679333454101,-24.456592935242952,-20.25891360178885
2025-09-25T07:50:00-04:00,24621.25,24632.75,24612.25,24623.25,NaN,NaN,NaN,24658.43546838282,NaN,NaN,24703.845,24785.85816296659,24621.831837033413,24640.569932530605,24715.68094735805,24765.89986692189,24665.462027794212,4930,2797.1,27.78207990844504,27.659498092507185,NaN,NaN,NaN,NaN,16.3947866972319,52.46669561642866,5137,-3.2945033930560683,-24.37704284310894,-21.08253945005287
2025-09-25T07:55:00-04:00,24623.25,24629.5,24586.75,24594.75,NaN,NaN,NaN,24657.11062305129,NaN,NaN,24701.105,24788.20247929796,24614.007520702038,24619.630946024485,24712.0075199132,24765.273052375658,24658.741987450743,7345,3009.766666666667,21.58375404140027,26.873743696775055,NaN,NaN,NaN,NaN,18.277301933143907,53.42406759963437,-2208,-4.182304830206437,-26.310420487810916,-22.12811565760448
2025-09-25T08:00:00-04:00,24594.25,24609.5,24588,24604.5,NaN,NaN,NaN,24648.440822003504,NaN,NaN,24698.44,24788.97582495341,24607.904175046588,24608.430044364537,24709.375372537903,24764.659015785975,24654.09172928983,5423,3148.4333333333334,27.539743935880438,26.318126078180075,NaN,NaN,NaN,NaN,18.507494652205057,54.31305586975396,3215,-3.69555821252267,-26.747563423257816,-23.052005210735146
2025-09-25T08:05:00-04:00,24604.75,24617.75,24594.75,24613.75,NaN,NaN,NaN,24648.440822003504,NaN,NaN,24695.975,24788.85811202817,24603.091887971827,24608.430044364537,24707.44615199882,24763.9093425966,24650.982961401045,4484,3258.233333333333,32.75783209305773,25.880988870060513,NaN,NaN,NaN,NaN,18.828387891333268,54.298737381794005,7699,-2.396273472707083,-26.047347051619,-23.651073578911916
2025-09-25T08:10:00-04:00,24613.25,24620.75,24607.75,24613.25,NaN,NaN,NaN,24648.440822003504,NaN,NaN,24693.225,24787.588512547616,24598.86148745238,24608.430044364537,24706.000785799475,24763.20148251651,24648.80008908244,3671,3319.133333333333,32.621083494450474,25.734905354427262,NaN,NaN,NaN,NaN,18.41207447052375,53.98813038143652,4028,-1.2725768627079468,-25.24179465729685,-23.969217794588904
2025-09-25T08:15:00-04:00,24613.75,24622.25,24610,24613,NaN,NaN,NaN,24648.440822003504,NaN,NaN,24690.375,24785.646257471446,24595.103742528554,24604.644035491627,24705.124819166092,24762.73791597988,24647.511722352305,2311,3263.1,32.54792147591078,25.897384574777075,NaN,NaN,NaN,NaN,17.971926294057766,53.546175588132336,1717,-0.2989866478471157,-24.342951104397798,-24.043964456550682
2025-09-25T08:20:00-04:00,24613,24630.75,24610.5,24626.25,NaN,NaN,NaN,24648.440822003504,NaN,NaN,24687.7,24782.51107530171,24592.88892469829,24602.965228393303,24703.96563853925,24761.99265640765,24645.938620670855,3413,3331.633333333333,40.20264992747671,27.03380800511951,NaN,NaN,NaN,NaN,18.13464584448221,52.28655757731874,5130,1.3917024913289993,-22.304336342389433,-23.696038833718433
2025-09-25T08:25:00-04:00,24626,24630.25,24605,24614.75,NaN,NaN,NaN,24648.440822003504,NaN,NaN,24684.855,24779.71437433898,24589.99562566102,24589.747182714644,24702.027018128414,24760.83044689053,24643.2235893663,5525,3460.4333333333334,36.347224150709835,27.93406272025498,NaN,NaN,NaN,NaN,18.6428854270192,51.35989292893345,-395,1.8605674743660074,-21.370329490760923,-23.23089696512693
2025-09-25T08:30:00-04:00,24613.25,24615,24587.75,24591.5,NaN,NaN,NaN,24648.440822003504,NaN,NaN,24681.58,24777.78901412993,24585.370985870075,24586.298196937372,24698.233532321537,24759.156151877603,24637.31091276547,9424,3727.766666666667,30.068884778074207,28.433996042699423,NaN,NaN,NaN,NaN,19.257679325089253,51.15841025624215,-9819,0.7849399103457486,-22.249722077194747,-23.034661987540495
2025-09-25T08:35:00-04:00,24591.5,24598,24578.5,24588,NaN,NaN,NaN,24641.039205113208,NaN,NaN,24678.19,24775.39944193096,24580.980558069037,24586.298196937372,24695.048473276212,24757.85442076107,24632.242525791356,7695,3939.1666666666665,29.249804853248605,28.76569720930532,NaN,NaN,NaN,NaN,19.274987944725734,51.267976383902116,-17514,0.056250337481181134,-22.96434906568902,-23.020599403170202
2025-09-25T08:40:00-04:00,24588.5,24592,24569,24574.25,NaN,NaN,NaN,24634.026059426244,NaN,NaN,24674.57,24773.496641508165,24575.643358491834,24582.09257853795,24692.105337387544,24756.75554144026,24627.455133334828,6884,4122.766666666666,26.227207171925954,28.886210313157132,NaN,NaN,NaN,NaN,19.54106023438818,51.64662915333713,-24398,-1.071045372347811,-24.359406118604966,-23.288360746257155
2025-09-25T08:45:00-04:00,24573.5,24579.5,24555.75,24568.75,NaN,NaN,NaN,24621.956693088687,NaN,NaN,24670.895,24771.604686226543,24570.185313773458,24582.09257853795,24688.350585468845,24755.470493492212,24621.230677445477,8511,4359.166666666667,25.109470250625108,29.036031558796147,NaN,NaN,NaN,NaN,19.841698789074737,52.338230881672054,-32909,-1.860148127115167,-25.613545905151113,-23.753397778035946
2025-09-25T08:50:00-04:00,24569,24569.25,24545.75,24552.5,NaN,NaN,NaN,24612.566616130112,NaN,NaN,24667.01,24770.65911770139,24563.360882298606,24582.09257853795,24685.009964898047,24754.458102272187,24615.561827523907,7275,4546.566666666667,22.11117296785548,29.325264953681717,NaN,NaN,NaN,NaN,20.103006018426544,53.20636001087756,-40184,-3.0777122513892223,-27.600538092272473,-24.52282584088325
2025-09-25T08:55:00-04:00,24552,24571,24547.25,24569,NaN,NaN,NaN,24612.566616130112,NaN,NaN,24663.775,24769.343615128157,24558.206384871846,24582.09257853795,24681.653349881355,24753.00613590922,24610.30056385349,8124,4718.4,31.106750899873262,29.661112853495354,NaN,NaN,NaN,NaN,20.363505588538935,53.83411538058952,-32060,-2.402957719261103,-27.52652298995963,-25.123565270698528
2025-09-25T09:00:00-04:00,24567.75,24572.25,24549.5,24556.75,NaN,NaN,NaN,24612.566616130112,NaN,NaN,24660.41,24768.650046193292,24552.169953806708,24582.09257853795,24678.303210807684,24751.444151215073,24605.162270400295,8367,4922.766666666666,28.47716431347581,29.710761739568984,NaN,NaN,NaN,NaN,20.533969475071867,54.28347008902825,-40427,-2.406787269208639,-28.132049357209326,-25.725262088000687
2025-09-25T09:05:00-04:00,24556,24567,24541.5,24544,NaN,NaN,NaN,24611.53312189904,NaN,NaN,24656.71,24767.92548273615,24545.494517263847,24582.09257853795,24675.789578352862,24750.342916749763,24601.23623995596,6137,5083.466666666666,26.012417470096096,30.027094841618684,NaN,NaN,NaN,NaN,20.888685941138164,54.910620881768935,-46564,-2.862162700983859,-29.30296546423051,-26.44080276324665
2025-09-25T09:10:00-04:00,24544.25,24560,24540.25,24557.25,NaN,NaN,NaN,24607.497525449082,NaN,NaN,24653.505,24766.74609192312,24540.263908076882,24578.69906283036,24673.306419814882,24749.110343245608,24597.502496384157,6397,5217.033333333334,32.54630561535808,30.384706390152804,NaN,NaN,NaN,NaN,20.807351231056867,55.52529025791543,-40167,-1.9109041039762928,-28.829432893217017,-26.918528789240725
2025-09-25T09:15:00-04:00,24556.75,24582,24551.5,24581.5,NaN,NaN,NaN,24607.497525449082,NaN,NaN,24650.72,24764.0581947959,24537.381805204102,24560.134250264287,24670.77878966042,24747.289267684828,24594.268311636013,8100,5392.366666666667,42.546528529849915,31.083898992780814,NaN,NaN,NaN,NaN,21.499683285981376,53.8954451862384,-32067,0.578488542690458,-26.195418110877654,-26.773906653568112
2025-09-25T09:20:00-04:00,24581,24587,24576.25,24579.75,NaN,NaN,NaN,24607.497525449082,NaN,NaN,24647.765,24760.645220146755,24534.884779853244,24544.35740021143,24669.021404497867,24745.793494736055,24592.24931425968,6503,5542.633333333333,42.061905693828976,31.758243435593567,NaN,NaN,NaN,NaN,20.731848765554137,51.96415777870133,-38570,2.2408779853484546,-23.972809171882545,-26.213687157231
2025-09-25T09:25:00-04:00,24580.25,24584.5,24565,24577,NaN,NaN,NaN,24607.497525449082,NaN,NaN,24644.635,24756.506945099703,24532.763054900293,24537.585920169146,24666.558930001946,24743.77934701592,24589.33851298797,8984,5788.866666666667,41.266449663227796,32.38099544897336,NaN,NaN,NaN,NaN,20.643859568014555,50.67501373129638,-47554,3.2288475618653187,-22.17762770489935,-25.40647526676467
2025-09-25T09:30:00-04:00,24576.5,24578.75,24516.25,24519.25,NaN,NaN,NaN,24607.497525449082,NaN,NaN,24640.345,24754.64333288404,24526.046667115963,24533.326872292364,24652.25055192093,24735.51182540231,24568.98927843955,42762,7077.866666666667,28.904306568572537,31.57397092333734,NaN,NaN,NaN,NaN,23.633583884584944,50.94367869164444,-90316,0.22498212753206204,-25.125247607349593,-25.350229734881655
2025-09-25T09:35:00-04:00,24518.75,24526,24472.75,24475.25,NaN,NaN,NaN,24567.38844169687,NaN,NaN,24635.265,24755.718576535797,24514.8114234642,24533.326872292364,24637.863595992985,24729.62831021504,24546.09888177093,37699,8259.5,23.201400353876224,30.634983509277795,NaN,NaN,NaN,NaN,25.749042178543164,51.94109973861962,-128015,-4.24644046947121,-30.658280321720667,-26.411839852249457
2025-09-25T09:40:00-04:00,24475.5,24477,24422,24427.5,NaN,NaN,NaN,24521.921921619738,NaN,NaN,24629.295,24760.295675190573,24498.294324809423,24533.326872292364,24620.501706425017,24724.27993480309,24516.723478046944,41051,9445.333333333334,18.853894868636075,29.83391280146079,NaN,NaN,NaN,NaN,27.838396308647223,53.428880616757,-169066,-9.63293784603751,-38.453012159796344,-28.820074313758834
2025-09-25T09:45:00-04:00,24427.75,24497.75,24424.5,24485.5,NaN,NaN,NaN,24521.921921619738,NaN,NaN,24624.665,24759.25406381924,24490.07593618076,24533.326872292364,24608.335981464734,24716.019492657717,24500.65247027175,40473,10654.866666666667,34.82828808528532,30.232375889463412,NaN,NaN,NaN,NaN,31.08208228660099,53.70225963161214,-128593,-8.539943910635877,-39.49500420205368,-30.9550602914178
2025-09-25T09:50:00-04:00,24485.5,24522.5,24445.5,24458.5,24397.977649929122,24397.977649929122,24397.977649929122,NaN,NaN,NaN,24619.765,24760.227963447578,24479.30203655242,24533.326872292364,24597.584598178135,24706.991130560164,24488.178065796106,44313,11936,31.69980549372255,30.62327576959174,NaN,NaN,NaN,NaN,34.36193355184378,52.79449200142551,-172906,-8.84806406255447,-42.01514036961089,-33.16707630705642
2025-09-25T09:55:00-04:00,24459,24474.75,24430,24452.75,24397.977649929122,NaN,NaN,NaN,NaN,NaN,24614.735,24760.642998751653,24468.827001248348,24533.326872292364,24590.827375925055,24701.944489269226,24479.710262580884,26745,12721.533333333333,31.05993667898207,31.048309085902954,NaN,NaN,NaN,NaN,35.10393829814065,52.226364487740696,-199651,-8.641931328903297,-43.96949046818554,-35.32755913928224
2025-09-25T10:00:00-04:00,24452.5,24521.5,24444.5,24518,24397.977649929122,NaN,NaN,NaN,NaN,NaN,24610.925,24756.789123417,24465.060876583,24533.326872292364,24584.61422268338,24694.65105008554,24474.57739528122,39666,13933.233333333334,44.70101901313388,32.66186951770855,NaN,NaN,NaN,NaN,38.09651413398774,49.89073270078775,-159985,-3.5735298271893967,-39.79447142326899,-36.22094159607959
2025-09-25T10:05:00-04:00,24517.5,24569.5,24515.75,24566.5,24444.895451351764,NaN,NaN,NaN,NaN,NaN,24608.13,24751.92162840602,24464.33837159398,24533.326872292364,24582.86063255683,24690.288662681116,24475.432602432542,33353,14963.366666666667,52.262137255078194,34.17296854308033,NaN,NaN,NaN,NaN,39.21462026727433,46.33928255051835,-126632,3.2159524870664598,-32.201000987246516,-35.416953474312976
2025-09-25T10:10:00-04:00,24566.5,24583.75,24550.25,24576.5,24469.144521744867,NaN,NaN,NaN,NaN,NaN,24605.545,24746.849518329556,24464.24048167044,24531.811497833893,24582.33528150421,24687.547205505733,24477.123357502685,27944,15691.766666666666,53.668785569126534,35.972370061341095,NaN,NaN,NaN,NaN,38.806433105326164,43.36938390307846,-98688,8.263949166532782,-25.087017016147,-33.350966182679784
2025-09-25T10:15:00-04:00,24576.75,24612,24576.75,24606,24496.12658893828,NaN,NaN,NaN,NaN,NaN,24603.455,24741.542895557817,24465.367104442186,24505.349198267115,24583.104633277188,24685.79871892143,24480.410547632946,34299,16593.6,57.634668306532326,38.23110226394368,NaN,NaN,NaN,NaN,38.57025931208858,41.25858863208771,-64389,13.18140129360587,-16.874214565672446,-30.055615859278316
2025-09-25T10:20:00-04:00,24605.5,24641.25,24597.75,24634.75,24519.785607622907,NaN,NaN,NaN,NaN,NaN,24602.04,24737.33801772323,24466.741982276773,24523.876564318427,24584.521987493536,24685.727175500484,24483.316799486587,25102,17266,61.126994645773905,40.27258005183053,NaN,NaN,NaN,NaN,38.9223836469394,39.88876744730915,-39287,17.681343330368154,-7.953936696318124,-25.635280026686278
2025-09-25T10:25:00-04:00,24635.5,24641.75,24602,24619.75,24521.272625458227,NaN,NaN,NaN,NaN,NaN,24600.305,24732.386993096028,24468.223006903972,24527.97625145474,24585.90128937907,24685.428197434863,24486.37438132328,28732,17978.9,58.421093161022384,41.406477525485705,NaN,NaN,NaN,NaN,38.981499100729444,38.62659663368183,-68019,18.851381583627816,-2.0710530471515085,-20.922434630779325
2025-09-25T10:30:00-04:00,24620,24636,24610.25,24630,24523.58409702831,NaN,NaN,NaN,NaN,NaN,24598.915,24728.225850666677,24469.604149333325,24532.106001163793,24586.82697999957,24685.36264854189,24488.291311457248,18311,18408.5,59.73283181202162,42.66868653392804,NaN,NaN,NaN,NaN,38.036392022105915,37.454580878170745,-49708,19.44139521723637,3.3793093907661387,-16.06208582647023
2025-09-25T10:35:00-04:00,24630,24636.5,24608.75,24632.75,24523.82459261793,NaN,NaN,NaN,NaN,NaN,24597.845,24725.116791452754,24470.57320854725,24539.509800931035,24587.681109131037,24685.304395336385,24490.05782292569,17423,18839.8,60.096560944646264,44.01369448260078,NaN,NaN,NaN,NaN,37.301649734812635,36.31309150562539,-32285,19.113987815645014,7.830398943086038,-11.283588872558976
2025-09-25T10:40:00-04:00,24632,24647.5,24612.25,24629,24530.75870204439,NaN,NaN,NaN,NaN,NaN,24596.32,24720.189247193237,24472.450752806762,24552.28284074483,24588.6607543125,24685.34365671747,24491.97785190753,19129,19355.066666666666,59.30981086660557,46.18551621817458,NaN,NaN,NaN,NaN,37.15510332518316,35.51063683642024,-51414,17.770342460186278,10.929339202673873,-6.841003257512406
2025-09-25T10:45:00-04:00,24629,24656.75,24616,24654.75,24536.20717013328,NaN,NaN,NaN,NaN,NaN,24595.47,24717.120632550737,24473.819367449265,24560.201272595863,24589.94532814921,24685.820590524923,24494.070065773496,19999,19944.666666666668,62.901314766131755,49.02122439047854,NaN,NaN,NaN,NaN,37.411881659098654,34.97910491789046,-31415,17.70229383043216,15.286864030527795,-2.4154297999043655
2025-09-25T10:50:00-04:00,24654.75,24655.25,24617,24626.75,24536.20717013328,NaN,NaN,NaN,NaN,NaN,24594.335,24713.71697560925,24474.953024390747,24560.201272595863,24590.912898512015,24685.91928928965,24495.90650773438,19270,20473.233333333334,57.00888195765893,51.74658061112302,NaN,NaN,NaN,NaN,37.471747254877315,34.48553956496995,-50685,14.96678519890375,16.29305169872532,1.326266499821572
2025-09-25T10:55:00-04:00,24626.75,24653.75,24626.25,24634.5,24540.00255584458,NaN,NaN,NaN,NaN,NaN,24593.425,24710.858906944817,24475.99109305518,24562.908814461352,24591.746433786855,24686.116390969706,24497.376476604004,15397,20802.3,58.17671670769598,53.414325512723785,NaN,NaN,NaN,NaN,36.75947959381465,34.02722888011518,-35288,12.950133348774692,17.513933185789938,4.563799837015246
2025-09-25T11:00:00-04:00,24634.75,24636.5,24605.5,24613.25,24540.00255584458,NaN,NaN,NaN,NaN,NaN,24592.015,24706.73868587307,24477.291314126927,24562.908814461352,24592.321013626846,24685.749167392878,24498.892859860814,19219,21128.8,53.856710294010725,54.996961569887226,NaN,NaN,NaN,NaN,36.34808819425646,32.68154095218626,-54507,9.609535000842532,16.575718588068412,6.9661835872258795
2025-09-25T11:05:00-04:00,24613.5,24625,24583.75,24598,24540.00255584458,NaN,NaN,NaN,NaN,NaN,24590.2,24701.56696098891,24478.833039011093,24562.908814461352,24592.583500670986,24684.782190088885,24500.384811253087,24224,21679.766666666666,50.93366398628575,56.41651352040891,NaN,NaN,NaN,NaN,36.69822475180957,30.593050012732697,-78731,5.975236231498142,14.435228876598558,8.459992645100415
2025-09-25T11:10:00-04:00,24597.75,24653,24591.75,24650.5,24540.00255584458,NaN,NaN,NaN,NaN,NaN,24589.64,24699.49664112963,24479.78335887037,24562.908814461352,24593.57545207833,24684.806888506137,24502.344015650524,23810,22243.966666666667,59.152896753457746,57.44879050186062,NaN,NaN,NaN,NaN,38.451922983823174,29.507942844682493,-54921,6.657395626427499,16.78173717813479,10.12434155170729
2025-09-25T11:15:00-04:00,24650.75,24655.75,24633.25,24641,24541.638713899367,NaN,NaN,NaN,NaN,NaN,24589.145,24697.84233621357,24480.44766378643,24562.908814461352,24594.35365976028,24685.079167901786,24503.628151618774,14937,22458.166666666668,57.282980139024225,57.8074221364282,NaN,NaN,NaN,NaN,37.31249991355009,28.578478545482216,-69858,6.037398744355686,17.671089982151898,11.633691237796212
2025-09-25T11:20:00-04:00,24640.5,24645.75,24611.25,24612.75,24541.638713899367,NaN,NaN,NaN,NaN,NaN,24588.545,24696.379905760816,24480.71009423918,24562.908814461352,24594.83241491856,24684.87878943723,24504.786040399893,16090,22752,52.01708986868157,57.6894438721107,NaN,NaN,NaN,NaN,37.11160706258223,26.881344310495063,-85948,3.423395146312613,15.912935170686978,12.489540024374366
2025-09-25T11:25:00-04:00,24612.25,24613.5,24587.5,24598.75,24541.638713899367,NaN,NaN,NaN,NaN,NaN,24587.715,24694.57972804582,24480.85027195418,24562.908814461352,24594.93051067369,24684.10671751182,24505.75430383556,19106,23118.066666666666,49.58440649313459,57.11442517115371,NaN,NaN,NaN,NaN,36.31792084382636,25.398477364544497,-105054,0.5982162564575546,13.237310344946309,12.639094088488754
2025-09-25T11:30:00-04:00,24598.5,24650.75,24598,24649,24541.638713899367,NaN,NaN,NaN,NaN,NaN,24587.95,24695.299988355757,24480.600011644245,24562.908814461352,24595.780403133416,24684.121641572958,24507.439164693875,22868,23601.433333333334,57.302871174517115,56.84127349463537,NaN,NaN,NaN,NaN,37.49164078355305,24.283074978918048,-82186,1.8876987750610787,14.998717557315103,13.111018782254025
2025-09-25T11:35:00-04:00,24649,24674.5,24637.5,24673.5,24551.3699530337,NaN,NaN,NaN,NaN,NaN,24588.635,24697.70888367581,24479.56111632419,24579.20687248522,24597.171705296023,24685.090733300753,24509.252677291293,21799,24123.5,60.47974845547109,56.988320301381705,NaN,NaN,NaN,NaN,37.45652358472783,23.84858911112219,-60387,4.040967255200789,18.16222785125501,14.121260596054222
2025-09-25T11:40:00-04:00,24673.5,24694.25,24667,24686.75,24577.034955168532,NaN,NaN,NaN,NaN,NaN,24589.59,24701.217315653143,24477.962684346858,24604.390497988177,24598.849949351563,24686.706009387657,24510.99388931547,20722,24601,62.12121590149814,57.158919164915744,NaN,NaN,NaN,NaN,36.7274861858187,23.89569613387332,-39665,5.895603250149968,21.490764658741682,15.595161408591714
2025-09-25T11:45:00-04:00,24686.75,24697,24683.5,24693.75,24589.527684479053,NaN,NaN,NaN,NaN,NaN,24590.8,24705.561709642196,24476.038290357803,24618.36239839054,24599.93724150198,24687.84337413385,24512.03110887011,12547,24749.233333333334,62.99566006016221,57.36599767316688,NaN,NaN,NaN,NaN,35.06838002968879,24.001077530612612,-27118,7.0535414341355995,24.412088201261213,17.358546767125613
2025-09-25T11:50:00-04:00,24693.75,24693.75,24668.75,24680.25,24589.527684479053,NaN,NaN,NaN,NaN,NaN,24592.21,24709.57129515388,24474.848704846117,24618.36239839054,24601.174591501385,24688.970277512144,24513.378905490626,16575,25084.966666666667,60.11343425119837,57.42339934349494,NaN,NaN,NaN,NaN,34.34921002756816,23.54426907315193,-43693,6.389763338505794,25.345750940257858,18.955987601752064
2025-09-25T11:55:00-04:00,24679.75,24686,24667.5,24677.25,24589.527684479053,NaN,NaN,NaN,NaN,NaN,24593.33,24712.827842657498,24473.832157342506,24618.36239839054,24601.844161854464,24689.53799457588,24514.15032913305,9675,25108,59.46235827482341,57.17775959411578,NaN,NaN,NaN,NaN,33.21712359702758,23.07287099795529,-53368,5.274487022854675,25.549096380320407,20.27460935746573
2025-09-25T12:00:00-04:00,24677.25,24691.75,24670,24671.75,24589.527684479053,NaN,NaN,NaN,NaN,NaN,24594.3,24715.528420759834,24473.071579240164,24625.212547975956,24602.754893703197,24690.312973354732,24515.196814051662,13276,24125.133333333335,58.21744417788083,57.26408546698877,NaN,NaN,NaN,NaN,32.39804334009704,22.795863610458575,-66644,3.763119214856367,24.97850837603619,21.21538916117982
2025-09-25T12:05:00-04:00,24671,24686,24664.5,24667.75,24589.527684479053,NaN,NaN,NaN,NaN,NaN,24595.76,24718.720886464143,24472.799113535853,24625.212547975956,24603.4754586007,24690.86774745923,24516.08316974217,11522,23252.566666666666,57.27822108509476,57.19990720823154,NaN,NaN,NaN,NaN,31.61961167294725,22.307497762894798,-78166,2.1698669167714755,23.927722807144164,21.75785589037269
2025-09-25T12:10:00-04:00,24667.75,24679,24660,24664,24589.527684479053,NaN,NaN,NaN,NaN,NaN,24596.95,24721.369210734785,24472.530789265216,24625.212547975956,24604.161104737053,24691.33551001111,24516.986699462996,12084,22287,56.36021777122645,57.378729170889805,NaN,NaN,NaN,NaN,30.7182108391653,21.660507570198863,-90250,0.6198207751852856,22.532631859354296,21.91281108416901
2025-09-25T12:15:00-04:00,24664,24681.5,24661.25,24662.75,24589.527684479053,NaN,NaN,NaN,NaN,NaN,24597.93,24723.628410490117,24472.231589509884,24625.212547975956,24604.813940299646,24691.784302524764,24517.843578074528,11597,21324.466666666667,56.037814569562244,57.74331135540955,NaN,NaN,NaN,NaN,29.97048149351064,21.145149017021723,-101847,-0.6637571418560739,21.08311465684892,21.746871798704994
2025-09-25T12:20:00-04:00,24662.25,24673.25,24636.5,24648.75,24589.527684479053,NaN,NaN,NaN,NaN,NaN,24598.64,24725.075404852094,24472.204595147905,24625.212547975956,24605.490824606502,24692.031386769228,24518.950262443777,16341,20392.066666666666,52.420934189618166,57.26245688656387,NaN,NaN,NaN,NaN,30.454732815402735,19.650439292285125,-118188,-2.5251930395622324,18.590380499252205,21.115573538814438
2025-09-25T12:25:00-04:00,24649,24658.5,24631.5,24633.25,24589.527684479053,NaN,NaN,NaN,NaN,NaN,24599.045,24725.791151423666,24472.29884857633,24625.212547975956,24605.88169079933,24692.025658317812,24519.73772328085,12872,19929.633333333335,48.67510316437646,56.64760853123188,NaN,NaN,NaN,NaN,30.207966185731113,18.45579440746336,-131060,-4.741210648942577,15.189060227636219,19.930270876578795
2025-09-25T12:30:00-04:00,24633.25,24673,24632.25,24669.75,24589.527684479053,NaN,NaN,NaN,NaN,NaN,24599.915,24727.986410158202,24471.8435898418,24625.212547975956,24606.581193206926,24692.360090899623,24520.80229551423,15843,19135.533333333333,56.54898973887473,56.971315664817105,NaN,NaN,NaN,NaN,30.960968601036033,17.50265459838058,-115217,-3.7339812042917444,15.262794371214113,18.996775575505858
2025-09-25T12:35:00-04:00,24669.75,24670.25,24643.5,24644.25,24589.527684479053,NaN,NaN,NaN,NaN,NaN,24600.505,24729.115010884503,24471.8949891155,24625.212547975956,24606.931452245044,24692.477439923743,24521.385464566345,9098,18327.033333333333,50.697340976808434,57.05081098507952,NaN,NaN,NaN,NaN,30.66018512953346,16.617596204232278,-124315,-4.70746824092916,13.112440274344408,17.819908515273568
2025-09-25T12:40:00-04:00,24643.5,24644.5,24613.5,24628,24589.527684479053,NaN,NaN,NaN,NaN,NaN,24601.235,24730.04646726791,24472.42353273209,24625.212547975956,24607.25220239511,24692.20507199664,24522.29933279358,17930,17993.233333333334,47.3357813568497,56.338875998103276,NaN,NaN,NaN,NaN,30.684457620281073,16.250290270074682,-142245,-6.270355533453291,9.981964098456956,16.252319631910247
2025-09-25T12:45:00-04:00,24628.25,24643.75,24622.25,24627,24589.527684479053,NaN,NaN,NaN,NaN,NaN,24602.015,24730.968689749603,24473.061310250396,24625.212547975956,24607.453327305273,24692.073677841283,24522.832976769263,10378,17195.866666666665,47.12868508654742,55.38522861460873,NaN,NaN,NaN,NaN,30.02842493311814,15.909220474071201,-152623,-7.133227571520166,7.335785167510039,14.469012739030205
2025-09-25T12:50:00-04:00,24626.75,24635,24613,24622.75,24589.527684479053,NaN,NaN,NaN,NaN,NaN,24602.985,24731.818280250387,24474.151719749614,24622.82782456369,24607.579632342065,24691.880014300266,24523.279250383865,9671,16681.5,46.203494585515365,54.248248520609955,NaN,NaN,NaN,NaN,29.454966009323986,15.930270800365385,-162294,-7.703259770449062,4.839938025968877,12.543197796417939
2025-09-25T12:55:00-04:00,24622.75,24634.5,24620.75,24625,24589.527684479053,NaN,NaN,NaN,NaN,NaN,24604.11,24732.71000622202,24475.50999377798,24622.82782456369,24607.702165679668,24691.746586382927,24523.657744976408,7945,15988.6,46.79894331388976,53.0913401815905,NaN,NaN,NaN,NaN,28.3331827229437,15.949817531924268,-154349,-7.627491499611514,3.008833421903546,10.63632492151506
2025-09-25T13:00:00-04:00,24624.75,24633,24614.5,24617.25,24589.527684479053,NaN,NaN,NaN,NaN,NaN,24605.405,24733.20163102145,24477.60836897855,24622.82782456369,24607.78982072317,24691.57568019985,24524.00396124649,7899,15641.533333333333,44.95326742559917,52.00847112261913,NaN,NaN,NaN,NaN,27.630812528447724,16.20843983652568,-162248,-7.771711945686153,0.9216849894073675,8.69339693509352
2025-09-25T13:05:00-04:00,24617.25,24642,24614,24633.5,24589.527684479053,NaN,NaN,NaN,NaN,NaN,24606.695,24734.297675913087,24479.092324086912,24607.937259650953,24607.956472948936,24691.446851456134,24524.466094441737,9529,15378.4,49.45456454066235,51.29362871303619,NaN,NaN,NaN,NaN,27.65718306213003,15.947675373183317,-152719,-6.496919548327836,0.5722474996837263,7.069167048011562
2025-09-25T13:10:00-04:00,24633.5,24645.75,24621.5,24627.25,24589.527684479053,NaN,NaN,NaN,NaN,NaN,24608.105,24735.025175306415,24481.184824693584,24600.02484617661,24608.188876760843,24691.29875585087,24525.07899767082,12566,15159.633333333333,47.83440477009628,50.551983041051585,NaN,NaN,NaN,NaN,27.413812843406454,15.499376200394499,-165285,-5.820633757576909,-0.2066251489595743,5.614008608617334
2025-09-25T13:15:00-04:00,24627.75,24635.75,24606.25,24610.75,24589.527684479053,NaN,NaN,NaN,NaN,NaN,24609.44,24735.032219506415,24483.847780493583,24600.02484617661,24608.301326192246,24690.91862208008,24525.684030304412,15422,15007.066666666668,43.75868483929082,49.586301880637016,NaN,NaN,NaN,NaN,27.562826211734567,15.73451163684488,-180707,-6.195796983908311,-2.1307376212680538,4.065059362640257
2025-09-25T13:20:00-04:00,24610.75,24612,24564.5,24569,NaN,NaN,NaN,24676.708418222697,24676.708418222697,24676.708418222697,24609.675,24734.919211443845,24484.430788556154,24598.494876941288,24607.791140749232,24689.68920702009,24525.893074478376,25323,15208.833333333334,35.513280313467874,48.09723491936855,NaN,NaN,NaN,NaN,28.986910053753526,17.283435992380213,-206030,-8.8075959447325,-6.944435568275367,1.8631603764571323
2025-09-25T13:25:00-04:00,24569,24604.5,24567.25,24595.75,NaN,NaN,NaN,24675.3921264853,NaN,NaN,24609.96,24735.01116392934,24484.90883607066,24585.845468016716,24607.560651684937,24688.97641234994,24526.144891019932,16462,15244.333333333334,42.93295828113928,47.16117375590977,NaN,NaN,NaN,NaN,29.5771307641997,18.721722893948733,-189568,-8.292775771521065,-8.5028093379442,-0.2100335664231343
2025-09-25T13:30:00-04:00,24595.25,24606.25,24572.25,24578,NaN,NaN,NaN,24675.3921264853,NaN,NaN,24609.925,24735.010940456265,24484.839059543734,24585.845468016716,24607.324668614237,24688.335599416376,24526.3137378121,14383,15083.133333333333,39.67121673426137,46.25047965195572,NaN,NaN,NaN,NaN,29.893049995328294,19.949026296373923,-203951,-8.666224148402762,-11.042813751926587,-2.3765896035238248
2025-09-25T13:35:00-04:00,24577.25,24580.75,24558,24568.25,NaN,NaN,NaN,24658.467051198382,NaN,NaN,24609.75,24735.044014223156,24484.455985776844,24585.845468016716,24606.937472944202,24687.629208554976,24526.24573733343,13723,14733.1,37.965004211330964,45.48547258388104,NaN,NaN,NaN,NaN,29.382832138519127,21.49238122718522,-217674,-9.046551874476428,-13.684779446619359,-4.638227572142931
2025-09-25T13:40:00-04:00,24568.5,24571,24541.75,24562.5,NaN,NaN,NaN,24645.406048871184,NaN,NaN,24610.615,24733.980238620978,24487.249761379026,24585.845468016716,24606.389720677656,24686.78828399844,24525.99115735687,15509,14456.4,36.95555325171066,44.08594140622646,NaN,NaN,NaN,NaN,29.373344128624904,23.333396678363076,-233183,-9.135364458562691,-16.057433145346295,-6.922068686783604
2025-09-25T13:45:00-04:00,24561.5,24565,24534.75,24537.25,NaN,NaN,NaN,24638.984183013403,NaN,NaN,24611.855,24730.924437306465,24492.785562693534,24585.845468016716,24605.955224128684,24686.2289575885,24525.681490668867,9901,14288.533333333333,32.82773207941881,42.809540770698625,NaN,NaN,NaN,NaN,29.435962405151695,25.206244902413232,-243084,-10.260428397780402,-19.747604184009106,-9.487175786228704
2025-09-25T13:50:00-04:00,24536.25,24554.75,24535.75,24551,NaN,NaN,NaN,24632.899674694614,NaN,NaN,24614.325,24722.63221351723,24506.01778648277,24585.845468016716,24605.536888052386,24685.676992989724,24525.396783115048,9917,14082.766666666666,36.95727640807508,42.0682189886433,NaN,NaN,NaN,NaN,28.690536519069433,26.945318253316948,-233167,-9.463742419409845,-21.31685381049101,-11.853111391081166
2025-09-25T13:55:00-04:00,24550.75,24556.25,24511.5,24517.25,NaN,NaN,NaN,24623.642871299402,NaN,NaN,24614.96,24720.577487189912,24509.342512810086,24585.845468016716,24604.638342096663,24684.739849073878,24524.53683511945,16411,13992.933333333332,31.79105695516209,40.972674122115784,NaN,NaN,NaN,NaN,29.837641053421613,29.094806045504622,-249578,-10.514073666672703,-24.995703474422044,-14.481629807749341
2025-09-25T14:00:00-04:00,24517.5,24519.5,24454.75,24456.75,NaN,NaN,NaN,24581.642058967613,NaN,NaN,24614.925,24720.75081206852,24509.09918793148,24573.076374413373,24601.807941619816,24683.215720637894,24520.400162601738,31977,14296.566666666668,25.035080034779,39.4606445113489,NaN,NaN,NaN,NaN,32.331380978177215,31.92594022097556,-281555,-14.350178235181431,-32.41935260172613,-18.0691743665447
2025-09-25T14:05:00-04:00,24457,24500.75,24453.5,24494.25,NaN,NaN,NaN,24573.78901083272,NaN,NaN,24615.755,24717.033254821614,24514.47674517839,24538.1110995307,24599.817373265436,24681.970954156466,24517.663792374406,24537,14387.833333333334,34.3481099895744,38.5712992738978,NaN,NaN,NaN,NaN,33.39699662259313,34.56917735951098,-257018,-13.444418598632957,-34.874697614835895,-21.430279016202938
2025-09-25T14:10:00-04:00,24494.5,24532.75,24493.5,24532.25,NaN,NaN,NaN,24573.78901083272,NaN,NaN,24616.04,24716.29130223501,24515.78869776499,24527.06110369965,24598.73183324824,24680.853695943108,24516.60997055337,20093,14366.866666666667,42.1860601361923,38.37364161036874,NaN,NaN,NaN,NaN,33.81506829240791,35.210400343925635,-236925,-9.551480378953311,-33.36962948989458,-23.818149110941267
2025-09-25T14:15:00-04:00,24532.5,24572.5,24530.75,24569.75,NaN,NaN,NaN,24573.78901083272,NaN,NaN,24616.105,24716.231874015597,24515.978125984402,24527.06110369965,24598.190102972207,24679.90293233517,24516.477273609242,19874,14611.1,48.69549279493309,38.319422199959504,NaN,NaN,NaN,NaN,34.381849128664484,34.08968371253198,-217051,-4.0004498249454485,-28.818711392123078,-24.81826156717763
2025-09-25T14:20:00-04:00,24570.25,24576.75,24554,24574,24467.88893178796,24467.88893178796,24467.88893178796,NaN,NaN,NaN,24616.055,24716.263397352286,24515.846602647714,24506.02388295972,24597.84397756641,24679.1461286648,24516.541826468016,17620,14645.933333333332,49.390966889827816,38.43060520851176,NaN,NaN,NaN,NaN,33.55100276233131,32.887601538550605,-199431,0.18602719977353743,-24.585727567460708,-24.771754767234246
2025-09-25T14:25:00-04:00,24573.5,24588,24570.75,24581.5,24483.967843979415,NaN,NaN,NaN,NaN,NaN,24615.565,24716.20394922229,24514.926050777707,24506.199649686874,24597.694825459053,24678.67109429124,24516.718556626867,12908,14753.7,50.662020345754925,38.923700601830625,NaN,NaN,NaN,NaN,32.38664542216479,31.343023608934672,-186523,3.504749878453449,-20.390817419167433,-23.895567297620882
2025-09-25T14:30:00-04:00,24581,24596,24567.75,24582.75,24486.95226016217,NaN,NaN,NaN,NaN,NaN,24614.525,24715.42382308408,24513.626176915925,24516.434719749497,24597.534147135037,24678.1056983557,24516.962595914374,16071,14846.866666666667,50.88343034797427,40.02156846143823,NaN,NaN,NaN,NaN,32.09117074915302,29.609238833289215,-170452,5.698759584718275,-16.77211781672304,-22.470877401441314
2025-09-25T14:35:00-04:00,24582.75,24605.75,24576.25,24604,24496.36920288207,NaN,NaN,NaN,NaN,NaN,24614.21,24715.139944023078,24513.28005597692,24527.347775799597,24597.517744941153,24677.78871657851,24517.246773303796,11662,14851.533333333333,54.61238293603417,40.85581307964501,NaN,NaN,NaN,NaN,31.90608712421352,27.638807354125213,-158790,8.336172025468603,-12.050662369605561,-20.386834395074164
2025-09-25T14:40:00-04:00,24603.5,24640.25,24602.75,24624.25,24526.05696638743,NaN,NaN,NaN,NaN,NaN,24614.095,24714.965803008286,24513.224196991716,24558.77822063968,24597.842545030926,24677.638269705043,24518.04682035681,20682,15138.133333333333,57.893058665146896,42.1573732175654,NaN,NaN,NaN,NaN,32.305652329626845,26.629727348514404,-138108,11.030425705699408,-6.598802262949903,-17.62922796864931
2025-09-25T14:45:00-04:00,24623.5,24626.75,24595,24616,24526.05696638743,NaN,NaN,NaN,NaN,NaN,24613.76,24714.491919471864,24513.028080528133,24558.77822063968,24598.009129319165,24677.36798886544,24518.65026977289,18122,15355.633333333333,56.113521540223346,43.45369588391486,NaN,NaN,NaN,NaN,32.26596287751064,25.40466727828458,-156230,11.775125153464462,-2.910321526818734,-14.685446680283196
2025-09-25T14:50:00-04:00,24616.5,24630.5,24608.75,24628.75,24526.05696638743,NaN,NaN,NaN,NaN,NaN,24613.755,24714.483917890768,24513.026082109234,24558.77822063968,24598.171960153166,24677.29356370328,24519.050356603053,10660,15166.266666666666,58.249435849688936,44.97468749805616,NaN,NaN,NaN,NaN,31.514822671974166,24.38463796052148,-145570,12.572176449934947,1.029773882135487,-11.54240256779946
2025-09-25T14:55:00-04:00,24629,24638.5,24611.5,24628.25,24531.53149095736,NaN,NaN,NaN,NaN,NaN,24613.225,24713.36266774159,24513.08733225841,24564.426448967515,24598.411437841856,24677.234928104,24519.587947579712,13970,15202.866666666667,58.12995519795605,46.78198914938026,NaN,NaN,NaN,NaN,31.192335338261724,23.691942734141236,-159540,12.486019546124638,4.065121864856337,-8.4208976812683
2025-09-25T15:00:00-04:00,24627.75,24634.75,24614.75,24627.75,24532.802786822936,NaN,NaN,NaN,NaN,NaN,24613.245,24713.3938636977,24513.096136302298,24565.491159174013,24598.591199027447,24677.186179773384,24519.99621828151,10777,15034,58.00183068016343,48.285171597386565,NaN,NaN,NaN,NaN,30.392882814100172,23.048725738216728,-170317,11.822343176017204,6.3570312887532054,-5.465311887263999
2025-09-25T15:05:00-04:00,24628.25,24637.75,24611.75,24623.25,24533.436751058256,NaN,NaN,NaN,NaN,NaN,24613.02,24713.02729173302,24513.012708266982,24569.34292733921,24598.765223729184,24677.12153036167,24520.408917096698,11192,15103.8,56.788662287032835,50.07071483537733,NaN,NaN,NaN,NaN,30.079105470235874,22.451452813429682,-181509,10.54926363806092,7.721267660312151,-2.8279959777487687
2025-09-25T15:10:00-04:00,24623.75,24634.5,24612.25,24616,24533.436751058256,NaN,NaN,NaN,NaN,NaN,24613.075,24713.085761919287,24513.064238080715,24569.34292733921,24598.886974050005,24677.044810510975,24520.729137589035,9120,14810.133333333333,54.799959865978565,52.19677768046301,NaN,NaN,NaN,NaN,29.51988365093331,21.896842240413143,-190629,8.7614164524148,8.12377458776973,-0.6376418646450688
2025-09-25T15:15:00-04:00,24616.25,24622.25,24605.75,24608.25,24533.436751058256,NaN,NaN,NaN,NaN,NaN,24613.28,24713.208306299843,24513.351693700155,24569.34292733921,24598.963032413256,24676.90171080089,24521.024354025623,9619,14784.833333333334,52.6763618284997,53.50593852610053,NaN,NaN,NaN,NaN,28.58989196158093,21.03803788899755,-200248,6.6927669093958855,7.728316772099788,1.0355498627039026
2025-09-25T15:20:00-04:00,24608.25,24622,24593,24596.75,24533.436751058256,NaN,NaN,NaN,NaN,NaN,24612.205,24711.6639206658,24512.746079334203,24569.34292733921,24598.99733953561,24676.666747580595,24521.327931490625,11639,14850.433333333332,49.60455131939675,54.03583075347228,NaN,NaN,NaN,NaN,28.619185392896576,19.60145005356963,-211887,4.3019875072344576,6.4130342467469745,2.111046739512517
2025-09-25T15:25:00-04:00,24596.25,24613.5,24596.25,24608,24533.436751058256,NaN,NaN,NaN,NaN,NaN,24611.545,24710.668240971198,24512.4217590288,24569.34292733921,24599.026600173886,24676.53290958092,24521.52029076685,7137,14823.5,52.52141278242991,54.309110752579194,NaN,NaN,NaN,NaN,27.80710072197539,18.267475634957986,-204750,3.2766787090159597,6.2068951257824665,2.930216416766507
2025-09-25T15:30:00-04:00,24608.25,24624.75,24605.5,24610,24533.436751058256,NaN,NaN,NaN,NaN,NaN,24611.49,24710.613557237804,24512.3664427622,24569.34292733921,24599.117881167193,24676.38642168492,24521.849340649464,10774,14919.333333333334,53.041766183009884,54.56988213066363,NaN,NaN,NaN,NaN,27.19587924183429,17.573165726638855,-193976,2.56318720933712,6.134200428437907,3.571013219100787
2025-09-25T15:35:00-04:00,24609.5,24613.5,24596,24598.25,24533.436751058256,NaN,NaN,NaN,NaN,NaN,24611.48,24710.608797025463,24512.351202974536,24569.34292733921,24599.133771513407,24676.225311963317,24522.042231063497,7824,14862.5,49.602270858663026,54.4941857387285,NaN,NaN,NaN,NaN,26.503316438846127,16.421516716021358,-201800,1.1992042552569764,5.0700185381720075,3.870814282915031
2025-09-25T15:40:00-04:00,24597.75,24611,24592.75,24609.5,24533.436751058256,NaN,NaN,NaN,NaN,NaN,24610.69,24709.238037019975,24512.141962980022,24569.34292733921,24599.16092346577,24676.05502691038,24522.26682002116,8815,14737.466666666667,52.76075727068901,54.6282805189224,NaN,NaN,NaN,NaN,25.913793836071402,15.315421913323728,-192985,0.9640811387314923,5.075915706329397,4.111834567597905
2025-09-25T15:45:00-04:00,24609.5,24613.5,24593.5,24599,24533.436751058256,NaN,NaN,NaN,NaN,NaN,24609.2,24706.14410760767,24512.25589239233,24569.34292733921,24599.175933648097,24675.866774723152,24522.485092573042,9116,14527.266666666666,49.634171942407484,54.27269401937764,NaN,NaN,NaN,NaN,25.491379990637732,14.292391579091964,-202101,0.05859951706865285,4.185083963933721,4.126484446865068
2025-09-25T15:50:00-04:00,24599.25,24638.75,24596.25,24626,24533.931176271242,NaN,NaN,NaN,NaN,NaN,24607.985,24702.503326793718,24513.466673206283,24575.83221444834,24599.379380933944,24675.728528928546,24523.03023293934,16741,14241.2,56.7342433558775,54.18992149728698,NaN,NaN,NaN,NaN,26.706281419877893,14.559584375376037,-185360,1.1734458472398126,5.593291755914834,4.419845908675021
2025-09-25T15:55:00-04:00,24626.5,24646.25,24613.25,24632,24545.479759168004,NaN,NaN,NaN,NaN,NaN,24606.75,24698.321283709418,24515.178716290582,24579.41577155867,24599.79455485898,24675.71671509794,24523.872394620023,23540,14477.133333333333,58.14623912911562,54.335115610779276,NaN,NaN,NaN,NaN,27.15583274702947,15.113202632019354,-161820,2.1533070499176636,7.111479721072101,4.958172671154437
2025-09-25T16:00:00-04:00,24632,24644.75,24626.5,24636.25,24552.69658829673,NaN,NaN,NaN,NaN,NaN,24605.87,24695.42245613487,24516.317543865127,24582.157617246936,24600.002108533132,24675.75443141288,24524.249785653385,10221,14338.4,59.16287771054197,54.400361457983074,NaN,NaN,NaN,NaN,26.519701836527364,15.627276727473863,-151599,2.88060751237827,8.558932061627274,5.678324549249004
2025-09-25T16:05:00-04:00,24636,24636,24619.75,24621.25,24552.69658829673,NaN,NaN,NaN,NaN,NaN,24604.75,24692.076628241663,24517.423371758337,24582.157617246936,24600.060772886645,24675.736394052696,24524.385151720595,4066,14016.5,54.16234186365724,54.11696050553316,NaN,NaN,NaN,NaN,25.80400884820398,15.653368160923428,-155665,2.176425988037085,8.39885703429536,6.222431046258276
2025-09-25T16:10:00-04:00,24621.5,24627,24620.25,24624.5,24552.69658829673,NaN,NaN,NaN,NaN,NaN,24603.805,24689.212569336287,24518.397430663714,24582.157617246936,24600.091391623642,24675.723255701443,24524.45952754584,2286,13575.733333333334,55.04885424597079,53.90603361737654,NaN,NaN,NaN,NaN,24.443008216189412,15.67759592055517,-153379,1.771645495490989,8.436987915622012,6.665342420131023
2025-09-25T16:15:00-04:00,24624.25,24629.75,24610.5,24622.5,24552.69658829673,NaN,NaN,NaN,NaN,NaN,24602.9,24686.518299429637,24519.281700570366,24582.157617246936,24600.131908880834,24675.69573577408,24524.56808198759,3472,13361.433333333332,54.35221022817845,53.73200132745837,NaN,NaN,NaN,NaN,24.072079057890168,15.040272762229057,-156851,1.2366623581076528,8.21117036776559,6.974508009657937
2025-09-25T16:20:00-04:00,24622.25,24628,24621,24622,24552.69658829673,NaN,NaN,NaN,NaN,NaN,24602.06,24684.03393244054,24520.086067559463,24584.778160024343,24600.146815074444,24675.689028809255,24524.604601339634,1131,13068.566666666668,54.16765457564877,53.68683666386339,NaN,NaN,NaN,NaN,22.85264483946944,14.448472686640521,-157982,0.7410233175238332,7.900787156562728,7.159763839038895
2025-09-25T16:25:00-04:00,24622.25,24628.25,24618.75,24624.75,24552.69658829673,NaN,NaN,NaN,NaN,NaN,24601.3,24681.69863182951,24520.90136817049,24588.922528019477,24600.167110793667,24675.68025870743,24524.653962879904,1526,12572.4,55.07126596515221,53.85790124505285,NaN,NaN,NaN,NaN,21.89888449379305,13.739806750679525,-156456,0.5017450774805923,7.7869451858896355,7.285200108409043
2025-09-25T16:30:00-04:00,24625,24635.25,24620.75,24634.5,24556.35500174281,NaN,NaN,NaN,NaN,NaN,24601.015,24680.837766804958,24521.19223319504,24596.53802241558,24600.211108513107,24675.677594551886,24524.74462247433,2625,11594,58.21662169678653,54.473049129152116,NaN,NaN,NaN,NaN,21.370392744236405,13.527427931626674,-153831,0.8812722496115608,8.386790420423495,7.505518170811934
2025-09-25T16:35:00-04:00,24634.25,24647.75,24634,24638.25,24570.61159257268,NaN,NaN,NaN,NaN,NaN,24601.115,24681.111388040903,24521.1186119591,24609.905417932463,24600.266052851228,24675.694888200334,24524.83721750212,2475,10858.6,59.39408195510457,54.96395407005745,NaN,NaN,NaN,NaN,20.826078976790946,14.041829603032369,-151356,1.243844643709762,9.060323975449137,7.816479331739375
2025-09-25T16:40:00-04:00,24638.5,24648.75,24638.25,24646.25,24574.99856563756,NaN,NaN,NaN,NaN,NaN,24600.645,24679.2875514584,24522.0024485416,24613.22433434597,24600.305726053724,24675.712268880572,24524.899183226877,1612,10242.566666666668,61.86313862267359,55.594052101462,NaN,NaN,NaN,NaN,20.088501907020166,14.573432629217123,-149744,1.8451735650667835,10.122946288072853,8.27777272300607
2025-09-25T16:45:00-04:00,24646.25,24646.5,24638.75,24641.75,24576.18044901767,NaN,NaN,NaN,NaN,NaN,24600.595,24679.12969869902,24522.060301300982,24614.20446747678,24600.332042329363,24675.722303932125,24524.9417807266,1124,9617.566666666668,59.665422206940164,56.312848626338926,NaN,NaN,NaN,NaN,19.207180342233013,15.067064010674391,-150868,1.7627014750031407,10.481149566759996,8.718448091756855
2025-09-25T16:50:00-04:00,24641.25,24642.5,24633.5,24639.5,24576.18044901767,NaN,NaN,NaN,NaN,NaN,24600.825,24679.745798905158,24521.904201094843,24614.20446747678,24600.353654447925,24675.728037697263,24524.979271198587,1017,9064.133333333333,58.54549986655507,56.726044526043644,NaN,NaN,NaN,NaN,18.478096032073513,15.049672090881286,-151885,1.3955316720180129,10.46286268177937,9.067331009761357
2025-09-25T16:55:00-04:00,24639.25,24640.5,24633,24635.25,24576.18044901767,NaN,NaN,NaN,NaN,NaN,24600.99,24680.163098967063,24521.81690103294,24614.20446747678,24600.372271817247,24675.73153824739,24525.013005387103,932,8664.933333333332,56.39233940296593,57.20877077322639,NaN,NaN,NaN,NaN,17.693946315496834,14.987659441002608,-152817,0.7383504792767699,9.99026910885732,9.25191862958055
2025-09-25T18:00:00-04:00,24640,24646.5,24626.25,24646,24576.18044901767,NaN,NaN,NaN,NaN,NaN,24601.455,24681.403151320985,24521.50684867902,24614.20446747678,24639.583333333332,24639.583333333332,24639.583333333332,2020,8196.566666666668,60.36320864636106,57.4679825796895,NaN,NaN,NaN,NaN,17.876521578675632,14.316878729124777,-150797,0.8894283971187473,10.363704125978984,9.474275728860237
2025-09-25T18:05:00-04:00,24645.25,24664,24644,24663.5,24591.474866301847,NaN,NaN,NaN,NaN,NaN,24602.225,24683.79063308369,24520.65936691631,24627.967749878488,24648.6978222858,24657.48356008742,24639.912084484182,2174,7880.3,65.81969419498088,58.0160865129656,NaN,NaN,NaN,NaN,18.02819860877023,14.86392615074576,-148623,1.9679297563374227,11.934187924282014,9.966258167944591
2025-09-25T18:10:00-04:00,24663.5,24664.25,24652.25,24653.5,24596.930554197217,NaN,NaN,NaN,NaN,NaN,24602.95,24685.67315274387,24520.22684725613,24629.42419990279,24650.631756350063,24659.005972926905,24642.25753977322,1344,7235.7,60.679242264634,58.12439826682931,NaN,NaN,NaN,NaN,17.59761299385807,15.386735106741407,-149967,1.8117142730737292,12.230901009286754,10.419186736213025
2025-09-25T18:15:00-04:00,24654.25,24656.75,24650.5,24652.25,24596.930554197217,NaN,NaN,NaN,NaN,NaN,24603.325,24686.765592636344,24519.884407363657,24629.42419990279,24650.88845612896,24658.864094036227,24642.912818221692,624,6652.433333333333,60.04793869905482,58.54479804078628,NaN,NaN,NaN,NaN,16.787069208582494,15.700504027882895,-150591,1.4440665622535072,12.22426993902991,10.780203376776402
2025-09-25T18:20:00-04:00,24651.5,24654.25,24646.25,24650.25,24596.930554197217,NaN,NaN,NaN,NaN,NaN,24603.785,24687.998123086847,24519.571876913153,24629.42419990279,24650.804498473102,24658.240388929455,24643.36860801675,933,6328.2,58.99042910846517,58.82633910239302,NaN,NaN,NaN,NaN,16.159421407969457,15.5731850231905,-151524,0.9120153601661478,11.920222576984088,11.00820721681794
2025-09-25T18:25:00-04:00,24650.75,24657.25,24650.25,24651.25,24597.645554321978,NaN,NaN,NaN,NaN,NaN,24604.595,24689.833365184837,24519.356634815165,24630.719190350228,24651.024277055185,24658.092161920307,24643.956392190063,824,5890,59.375665369940336,59.18515732680458,NaN,NaN,NaN,NaN,15.505177021685924,15.675487436999061,-150700,0.4941845619330678,11.625937919234275,11.131753357301207
2025-09-25T18:30:00-04:00,24651.5,24654.75,24642.25,24651.75,24597.645554321978,NaN,NaN,NaN,NaN,NaN,24606.25,24691.87213498912,24520.62786501088,24630.719190350228,24650.835894621294,24657.443471175215,24644.228318067373,1191,5570.466666666666,59.580117513780834,59.57176182238544,NaN,NaN,NaN,NaN,15.290521520136931,14.990051682207865,-149509,0.1368131024070287,11.302769735309994,11.165956632902965
2025-09-25T18:35:00-04:00,24651.75,24662,24651.5,24661.75,24602.571155900812,NaN,NaN,NaN,NaN,NaN,24607.57,24694.52849814869,24520.61150185131,24634.770281824145,24651.726670218606,24658.39668480742,24645.056655629793,1213,5237.833333333333,63.53305108093321,60.176175044941225,NaN,NaN,NaN,NaN,14.94834141155572,14.913904825867395,-148296,0.44202636905584747,11.718489594222774,11.276463225166927
2025-09-25T18:40:00-04:00,24661,24665.75,24657.5,24661.75,24608.783830632594,NaN,NaN,NaN,NaN,NaN,24609.245,24697.08260527266,24521.40739472734,24639.841225459317,24652.78417157202,24659.794821827847,24645.773521316194,1229,4974.8,63.53305108093321,60.5559200009517,NaN,NaN,NaN,NaN,14.469888453587455,15.116530420222512,-148296,0.5073510162128585,11.910651995433,11.403300979220141
2025-09-25T18:45:00-04:00,24661.75,24662.5,24642.25,24642.5,24608.783830632594,NaN,NaN,NaN,NaN,NaN,24610.73,24698.255130104615,24523.204869895384,24639.841225459317,24652.276408494534,24658.91170524967,24645.6411117394,1837,4715.4,52.14741378967098,60.03830084627788,NaN,NaN,NaN,NaN,14.882753564045492,14.139562992875613,-150133,-0.8107526859428553,10.389860121791571,11.200612807734426
2025-09-25T18:50:00-04:00,24642.5,24647.25,24628.5,24632,24608.783830632594,NaN,NaN,NaN,NaN,NaN,24612.12,24698.739988454756,24525.500011545242,24639.841225459317,24649.96583499027,24658.348591588594,24641.58307839195,2202,4400.833333333333,47.18074007640132,58.98955809297271,NaN,NaN,NaN,NaN,15.158985452327956,14.194210707001345,-152335,-2.3666128740855434,8.242346715127496,10.60895958921304
2025-09-25T18:55:00-04:00,24631.25,24642.5,24631.25,24636.75,24608.783830632594,NaN,NaN,NaN,NaN,NaN,24614.11,24698.295934690836,24529.924065309166,24639.841225459317,24649.052037954287,24657.80111758292,24640.302958325654,1166,4201.8,49.522898450717726,58.265092110385396,NaN,NaN,NaN,NaN,14.879772205733103,14.244955012975238,-151169,-3.011320096860752,6.8448094681371,9.856129564997852
2025-09-25T19:00:00-04:00,24637.25,24641.25,24631,24641,24608.783830632594,NaN,NaN,NaN,NaN,NaN,24615.91,24698.454094881534,24533.365905118466,24639.841225459317,24648.310879384375,24657.218963629868,24639.40279513888,1176,3881.866666666667,51.59126581623805,57.76836110679132,NaN,NaN,NaN,NaN,14.54907419103788,14.309535246383373,-149993,-3.076183099242879,6.010900690944254,9.087083790187133
2025-09-25T19:05:00-04:00,24640.75,24641.5,24630.75,24631.25,24608.783830632594,NaN,NaN,NaN,NaN,NaN,24618.19,24695.861459368014,24540.518540631983,24639.841225459317,24647.62996342045,24656.81593036164,24638.443996479262,930,3652.0666666666666,46.848523345871314,57.086659959855986,NaN,NaN,NaN,NaN,14.277711748820888,14.369502605976642,-150923,-3.6606468018825105,4.511275287833996,8.171922089716507
2025-09-25T19:10:00-04:00,24632,24636,24622.5,24633.75,24608.783830632594,NaN,NaN,NaN,NaN,NaN,24621.73,24684.316487362554,24559.143512637445,24639.841225459317,24646.1037829106,24656.113045736194,24636.094520085004,1875,3420.733333333333,48.16435976644288,56.215313611290405,NaN,NaN,NaN,NaN,14.222160909619395,15.025517835053096,-149048,-3.750037867732206,3.484374755051249,7.234412622783455
2025-09-25T19:15:00-04:00,24633.75,24639,24633,24636.5,24608.783830632594,NaN,NaN,NaN,NaN,NaN,24624.575,24675.585317581557,24573.564682418444,24639.841225459317,24645.775279370853,24655.77677199818,24635.773786743528,709,3140.5,49.64121914246379,55.059708250396326,NaN,NaN,NaN,NaN,13.634863701789438,15.305129907535697,-148339,-3.4999394577985203,2.859488300535304,6.359427758333824
2025-09-25T19:20:00-04:00,24636.75,24639.25,24630.75,24634.25,24608.783830632594,NaN,NaN,NaN,NaN,NaN,24626.615,24670.32978124769,24582.900218752315,24639.841225459317,24645.310455837916,24655.346459256478,24635.274452419355,944,2613.9333333333334,48.42553811047336,54.18444366795628,NaN,NaN,NaN,NaN,13.268087723090192,15.734283923847823,-149283,-3.3612774424644174,2.157830955253303,5.51910839771772
2025-09-25T19:25:00-04:00,24633.75,24634.25,24625.5,24632.5,24608.783830632594,NaN,NaN,NaN,NaN,NaN,24627.87,24668.474955364465,24587.265044635533,24639.841225459317,24644.625688060383,24654.896332410353,24634.355043710413,1105,1866.1,47.45217795132549,53.2847464716899,NaN,NaN,NaN,NaN,12.945367171440893,16.517937110994183,-150388,-3.2601606292379453,1.4439076111702889,4.704068240408234
2025-09-25T19:30:00-04:00,24633.25,24634.5,24625.5,24628,24608.783830632594,NaN,NaN,NaN,NaN,NaN,24628.95,24666.525790072603,24591.3742099274,24631.647980367452,24644.096025583087,24654.567500453883,24633.62455071229,843,1553.5,44.950165021912724,52.28187046550759,NaN,NaN,NaN,NaN,12.663555230623686,17.21392165808858,-151231,-3.3559451417216346,0.5091368132561911,3.8650819549778257
2025-09-25T19:35:00-04:00,24628,24631.25,24621.75,24625,24608.783830632594,NaN,NaN,NaN,NaN,NaN,24629.82,24664.89193179778,24594.748068202218,24613.19338429396,24643.318306333233,24654.19985138719,24632.436761279274,1093,1454.4,43.31062772078092,51.13436777628191,NaN,NaN,NaN,NaN,12.43758699986485,18.142190288266228,-152324,-3.4667470345836144,-0.46835183825169224,2.998395196331922
2025-09-25T19:40:00-04:00,24624.75,24634.5,24623,24633.75,24608.783830632594,NaN,NaN,NaN,NaN,NaN,24630.84,24663.241660450727,24598.438339549273,24612.657862532356,24642.743919925866,24653.708273742006,24631.779566109726,1185,1417.7,49.137785266639575,50.388486901486104,NaN,NaN,NaN,NaN,12.370616499874503,18.56150988214878,-151139,-2.823394144616505,-0.5308474844387092,2.2925466601777957
2025-09-25T19:45:00-04:00,24633.75,24634,24622.25,24622.5,24608.783830632594,NaN,NaN,NaN,NaN,NaN,24631.21,24662.78932235811,24599.63067764189,24612.657862532356,24642.287211567735,24653.432283729482,24631.142139405987,758,1327.2333333333333,43.01555332940013,48.92295134780517,NaN,NaN,NaN,NaN,12.326286749883467,19.01432471970151,-151897,-3.0109954587449614,-1.471197663253406,1.5397977954915554
2025-09-25T19:50:00-04:00,24622.5,24625.75,24618.75,24621,24608.783830632594,NaN,NaN,NaN,NaN,NaN,24631.145,24662.79465875963,24599.49534124037,24612.657862532356,24641.540672368483,24653.133400246756,24629.94794449021,1037,1324.1,42.25951788153809,47.403413262134094,NaN,NaN,NaN,NaN,11.945837696320362,19.732442474350513,-152934,-3.0805035089250423,-2.3108315906647476,0.7696719182602947
2025-09-25T19:55:00-04:00,24620.5,24624.75,24615.5,24616.75,24608.783830632594,NaN,NaN,NaN,NaN,NaN,24631.16,24662.78163183498,24599.53836816502,24612.657862532356,24640.793560992763,24652.885672114386,24628.70144987114,974,1305.7,40.10854043276002,46.54349373664046,NaN,NaN,NaN,NaN,11.753277860868907,20.66561808825849,-153908,-3.2408267471414387,-3.2813615156665037,-0.0405347685250651
2025-09-25T20:00:00-04:00,24616.75,24621.75,24610.75,24617,24608.783830632594,NaN,NaN,NaN,NaN,NaN,24630.925,24662.78849792893,24599.06150207107,24612.657862532356,24639.37817534077,24652.41970926525,24626.336641416292,1818,1278.8,40.30103297032387,46.05208608620635,NaN,NaN,NaN,NaN,11.699472299378272,21.89897435470012,-152090,-3.1551007898797123,-3.9844107558747055,-0.8293099659949933
2025-09-25T20:05:00-04:00,24617,24619.75,24608.25,24615.25,NaN,NaN,NaN,24655.56886889294,24655.56886889294,24655.56886889294,24630.665,24662.82236462855,24598.50763537145,24612.657862532356,24637.84642592147,24651.829743191654,24623.863108651287,2040,1264.3,39.347686149422415,45.32528520754239,NaN,NaN,NaN,NaN,11.68522427799411,23.228294716571188,-154130,-3.0400940747131138,-4.629427559386386,-1.5893334846732718
2025-09-25T20:10:00-04:00,24615,24633,24613.5,24630.5,NaN,NaN,NaN,24655.56886889294,NaN,NaN,24630.72,24662.86663901878,24598.573360981223,24609.481032020707,24637.13248522777,24650.99818077636,24623.266789679175,2070,1279.5666666666666,50.36631891801759,45.237789000526654,NaN,NaN,NaN,NaN,12.243422543851674,22.539986284896145,-152060,-1.820934315564219,-3.8655013791285455,-2.0445670635643265
2025-09-25T20:15:00-04:00,24630.75,24632,24630.25,24632,NaN,NaN,NaN,24655.56886889294,NaN,NaN,24630.895,24662.972264528027,24598.817735471974,24609.481032020707,24637.12521093168,24650.98357881071,24623.266843052654,45,1243.6,51.30341673197695,45.555995670962766,NaN,NaN,NaN,NaN,11.493892362147983,21.90084274119789,-152015,-0.8469657884322741,-3.103274299104669,-2.256308510672395