time,open,high,low,close,Long Stop,Long Stop Start,Buy Label,Short Stop,Short Stop Start,Sell Label,Basis,Upper,Lower,ATR Trailing Stoploss,VWAP,Upper Band #1,Lower Band #1,Volume,Volume MA,RSI,RSI-based MA,Regular Bullish,Regular Bullish Label,Regular Bearish,Regular Bearish Label,ATR,ADX,OnBalanceVolume,Histogram,MACD,Signal
2024-06-11T10:00:00-04:00,19032,19166.25,19025.75,19164,18841.34892223314,NaN,NaN,NaN,NaN,NaN,18852.37,19312.03125831985,18392.708741680148,18953.149370858435,19090.286563749883,19126.445281783846,19054.12784571592,485627,190657.9,63.5371122134012,59.29819180854655,NaN,NaN,NaN,NaN,83.51386582814844,14.26341845966175,4345047,-7.582917670095583,56.44752984003935,64.03044751013493
2024-06-11T14:00:00-04:00,19164.5,19257.75,19152,19248,18944.055148511983,NaN,NaN,NaN,NaN,NaN,18862.56,19334.108158303927,18391.011841696076,19034.394496686746,19118.010723787433,19179.923199213437,19056.098248361428,226493,187364.23333333334,68.28402400489203,59.79529439687969,NaN,NaN,NaN,NaN,85.10216112613784,14.391994736562157,4571540,1.775855648673172,66.2502670709764,64.47441142230323
2024-06-11T18:00:00-04:00,19250,19269.75,19232,19255.5,18996.762869034166,NaN,NaN,NaN,NaN,NaN,18873.61,19355.46542603578,18391.754573964223,19072.190597349396,19252.416666666668,19252.416666666668,19252.416666666668,31643,187042.93333333332,68.67612883346821,59.94388542144162,NaN,NaN,NaN,NaN,81.71986390284228,14.651939389356011,4603183,7.439491744519799,73.77377610295298,66.33428435843318
2024-06-11T22:00:00-04:00,19256,19268.25,19251.25,19265.5,19014.870238623524,NaN,NaN,NaN,NaN,NaN,18887.045,19374.36742601811,18399.722573981886,19101.702477879517,19255.546739638,19259.92347566202,19251.17000361398,16184,186670.6,69.22249146778775,60.74997414278159,NaN,NaN,NaN,NaN,77.09701648121067,14.893316566950304,4619367,10.63277830588855,79.62525724079387,68.99247893490532
2024-06-12T02:00:00-04:00,19266,19275.75,19240.25,19267.25,19019.410227777,NaN,NaN,NaN,NaN,NaN,18901.285,19390.600307445173,18411.969692554827,19124.761982303615,19258.239918784744,19262.422696601494,19254.057140967994,45300,185801.83333333334,69.32333231252703,61.52494776487414,NaN,NaN,NaN,NaN,74.12580101826704,14.912443063525929,4664667,11.559570300419622,83.44194181042985,71.88237151001023
2024-06-12T06:00:00-04:00,19267.25,19504.75,19260,19490.5,19121.2552174235,NaN,NaN,NaN,NaN,NaN,18920.345,19425.481732875192,18415.20826712481,19261.58458584289,19379.466409466364,19448.212736004192,19310.720082928536,289843,187898.46666666667,78.84562181596627,62.95403237560961,NaN,NaN,NaN,NaN,86.31324380267654,17.068279199065127,4954510,25.12644937858967,103.29043323324731,78.16398385465764
2024-06-12T10:00:00-04:00,19491,19546.5,19479.25,19515,19254.453843904248,NaN,NaN,NaN,NaN,NaN,18939.83,19459.835994580637,18419.824005419367,19318.34266867431,19447.926405169437,19530.440125279347,19365.412685059528,399320,183203.43333333332,79.59421489603294,64.76122830319521,NaN,NaN,NaN,NaN,84.95158353105678,19.324203167825793,5353830,33.163662997668425,119.61856260174318,86.45489960407475
2024-06-12T14:00:00-04:00,19515,19612,19433,19610,19254.453843904248,NaN,NaN,NaN,NaN,NaN,18961.16,19501.484335561472,18420.835664438528,19339.97413493945,19486.368874532927,19568.80508050024,19403.932668565616,460554,191223.5,82.22137172002482,66.79576597315553,NaN,NaN,NaN,NaN,91.66932756455273,21.780844657205428,5814384,41.737224018487254,138.62642962718382,96.88920560869657
2024-06-12T18:00:00-04:00,19603.5,19626.5,19582.5,19621.25,19339.73816149127,NaN,NaN,NaN,NaN,NaN,18986.76,19528.46414397555,18445.055856024446,19386.87930795156,19610.083333333332,19610.083333333332,19610.083333333332,34668,190866.36666666667,82.50856334536417,68.26404264797104,NaN,NaN,NaN,NaN,88.2643755956561,24.137981210978584,5849052,44.75766004325013,152.83628066275924,108.07862061950911
2024-06-12T22:00:00-04:00,19620.75,19641,19611.25,19626.5,19369.340972332575,NaN,NaN,NaN,NaN,NaN,19007.855,19565.193407881543,18450.516592118456,19434.42844636125,19617.21619977112,19625.243458984754,19609.188940557484,27373,190898.13333333333,82.64942051913008,69.71966178766253,NaN,NaN,NaN,NaN,84.08477733882353,26.4047536942912,5876425,43.65425091125273,162.64643425857503,118.9921833473223
2024-06-13T02:00:00-04:00,19627,19672,19583.75,19597,19370.728882681095,NaN,NaN,NaN,NaN,NaN,19027.235,19597.627780546813,18456.84221945319,19462.617757089,19617.422039051286,19622.74580858284,19612.09826951973,79175,191880.3,78.80901753898584,70.99382577724789,NaN,NaN,NaN,NaN,84.38229324319329,28.675638084104328,5797250,37.706777371315866,166.1256550614671,128.41887769015125
2024-06-13T06:00:00-04:00,19597.5,19690,19584.5,19631.25,19377.405978922863,NaN,NaN,NaN,NaN,NaN,19046.91,19631.24752027402,18462.57247972598,19469.7442056712,19629.34452322031,19638.277403932065,19620.411642508552,285099,192883.5,79.97256868762976,72.29647820289009,NaN,NaN,NaN,NaN,85.89070086867947,30.879528649756242,6082349,33.017349191754136,169.69056417984393,136.6732149880898
2024-06-13T10:00:00-04:00,19631,19651.25,19500,19568,19377.405978922863,NaN,NaN,NaN,NaN,NaN,19064.935,19656.806428690394,18473.06357130961,19469.7442056712,19595.54526852256,19623.67096629303,19567.419570752092,641491,197034.86666666667,72.09938171746029,73.50832967378298,NaN,NaN,NaN,NaN,90.55922223520237,31.344063869492,5440858,23.06479160601606,165.50420449560988,142.43941288959383
2024-06-13T14:00:00-04:00,19568.75,19639.5,19548,19608.25,19377.405978922863,NaN,NaN,NaN,NaN,NaN,19083.6,19683.90792931659,18483.29207068341,19469.7442056712,19596.004867050782,19621.938804875113,19570.07092922645,190331,196213.36666666667,73.86281247512716,74.97186153912837,NaN,NaN,NaN,NaN,90.62642064697363,31.775418002103777,5631189,16.887694866242924,163.54903147239747,146.66133660615455
2024-06-13T18:00:00-04:00,19602.5,19629.75,19592.25,19627.75,19377.405978922863,NaN,NaN,NaN,NaN,NaN,19105.01,19705.060372552354,18504.959627447643,19469.7442056712,19616.583333333332,19616.583577473957,19616.583089192707,23469,196322.56666666668,74.69719772081407,75.76901050394359,NaN,NaN,NaN,NaN,86.83167631504693,32.17596112524328,5654658,12.038090463313836,161.70894968529683,149.670859221983
2024-06-13T22:00:00-04:00,19627.75,19647,19624.25,19646.25,19382.610012921323,NaN,NaN,NaN,NaN,NaN,19124.675,19729.917953284075,18519.432046715923,19469.7442056712,19627.736438496988,19639.02725497205,19616.445622021925,22900,196507.96666666667,75.49640488864226,76.2841805670686,NaN,NaN,NaN,NaN,82.25441372111501,32.70079762926526,5677558,8.183501908669825,159.90023660782026,151.71673469915044
2024-06-14T02:00:00-04:00,19645.75,19659.25,19555.75,19556.5,19382.610012921323,NaN,NaN,NaN,NaN,NaN,19142.43,19745.21229104717,18539.64770895283,19469.7442056712,19599.112498212606,19615.7260274098,19582.49896901541,154109,200248.56666666668,64.80263517901,76.007502448893,NaN,NaN,NaN,NaN,83.77195559817822,31.91698577609771,5523449,-1.772280051950986,149.50138463421172,151.2736646861627
2024-06-14T06:00:00-04:00,19556.5,19647,19501.5,19639,19382.610012921323,NaN,NaN,NaN,NaN,NaN,19162.29,19763.771449090254,18560.808550909747,19469.7442056712,19597.23711422208,19608.227552835713,19586.246675608447,267829,198682.73333333334,69.13106497050937,76.0009719848017,NaN,NaN,NaN,NaN,88.18110162687978,30.336086312689552,5791278,-4.033641320830469,146.2316130351246,150.26525435595508
2024-06-14T10:00:00-04:00,19635,19676.25,19563.25,19657.25,19382.610012921323,NaN,NaN,NaN,NaN,NaN,19184.56,19775.142437598573,18593.97756240143,19469.7442056712,19616.559632237408,19635.4622000418,19597.657064433017,576715,200525.63333333333,70.00967273404083,76.04999630062412,NaN,NaN,NaN,NaN,89.95388008210264,29.215427322427225,6367993,-5.444835887182023,143.45920949697756,148.9040453841596
2024-06-14T14:00:00-04:00,19657.5,19700,19629,19696.25,19399.701270396283,NaN,NaN,NaN,NaN,NaN,19206.43,19790.15967236555,18622.70032763445,19470.635209632943,19626.722083686866,19654.77080386962,19598.673363504113,219597,196936.63333333333,71.85335646884789,75.55054877582994,NaN,NaN,NaN,NaN,88.6000315048096,28.449218050160113,6587590,-4.912558877215417,142.76334678764033,147.67590566485575
2024-06-16T18:00:00-04:00,19954.75,19986.25,19930,19961.25,19665.817121741908,NaN,NaN,NaN,NaN,NaN,19233.085,19830.377546496315,18635.792453503684,19657.758167706354,19959.166666666668,19959.166666666668,19959.166666666668,20290,196282.56666666668,80.58656118898035,75.62143065389762,NaN,NaN,NaN,NaN,102.98574354018035,29.884794993873015,6607880,11.243934363254397,161.73082361892375,150.48688925566935
2024-06-16T22:00:00-04:00,19960.5,19967.75,19947.25,19960.25,19675.683388935457,NaN,NaN,NaN,NaN,NaN,19258.165,19869.99787432087,18646.33212567913,19694.70653416508,19958.909525197563,19959.26552308402,19958.553527311105,10586,195979.86666666667,80.48507634283433,75.49740955552686,NaN,NaN,NaN,NaN,97.09390471588176,31.217830727320706,6597294,19.345307796309015,174.66852400105563,155.32321620474661
2024-06-17T02:00:00-04:00,19960.75,20012.75,19934.75,19981.75,19694.106871256572,NaN,NaN,NaN,NaN,NaN,19282.91,19909.542338456922,18656.277661543078,19755.315227332067,19970.44062938764,19978.744457976514,19962.136800798762,59577,195329.16666666666,81.03797610932322,75.39236761009536,NaN,NaN,NaN,NaN,95.73005437903306,32.68718086664621,6656871,23.365006371703544,184.52947416937604,161.1644677976725
2024-06-17T06:00:00-04:00,19981.5,19988,19904,19954.5,19694.106871256572,NaN,NaN,NaN,NaN,NaN,19306.895,19942.64307188062,18671.146928119382,19755.315227332067,19957.029513583104,19968.694663037215,19945.364364128993,148005,193087.96666666667,78.02078649670462,75.06175089420785,NaN,NaN,NaN,NaN,94.89219335195926,33.57120624309822,6508866,21.45130629305814,187.97860066399517,166.52729437093703
2024-06-17T10:00:00-04:00,19954.5,20238.25,19929.25,20233.25,19775.88095087634,NaN,NaN,NaN,NaN,NaN,19335.815,20005.05214638398,18666.577853616018,19885.39174549252,20066.06182903913,20152.166805393597,19979.95685268466,385057,190659.73333333334,84.41360890471762,75.46207884890296,NaN,NaN,NaN,NaN,110.1856081125336,35.48963909684074,6893923,35.398299469465485,210.7751687077689,175.3768692383034
2024-06-17T14:00:00-04:00,20233.75,20271.5,20161.75,20187.5,19907.78408947287,NaN,NaN,NaN,NaN,NaN,19362.425,20058.653606493783,18666.196393506216,19934.338396394018,20099.16756922659,20195.285306313348,20003.04983213983,191574,187808.6,80.28615657553343,75.48447798375322,NaN,NaN,NaN,NaN,110.15449324735263,37.37980835613199,6702349,37.76583168316742,222.5841588422627,184.81832715909528
2024-06-17T18:00:00-04:00,20186,20218.75,20158,20164.25,19907.78408947287,NaN,NaN,NaN,NaN,NaN,19385.22,20109.75724983599,18660.68275016401,19934.338396394018,20180.333333333332,20180.333333333332,20180.333333333332,30240,188056.06666666668,78.19369319534346,75.91978594645916,NaN,NaN,NaN,NaN,106.62560087254174,39.08114971667765,6672109,34.101293612325264,227.44494417450187,193.3436505621766
2024-06-17T22:00:00-04:00,20164.75,20195,20162.75,20190.5,19907.78408947287,NaN,NaN,NaN,NaN,NaN,19407.27,20160.80852482797,18653.73147517203,19938.79157369217,20181.259149513455,20182.433991389702,20180.084307637208,18779,188132.93333333332,78.86348766816951,76.27697703167648,NaN,NaN,NaN,NaN,101.31305795307448,40.660966694327186,6690888,29.92932250164091,230.75530368922773,200.82598118758682
2024-06-18T02:00:00-04:00,20191,20252,20186.75,20237.75,19930.119795042097,NaN,NaN,NaN,NaN,NaN,19430.025,20213.205517185925,18646.84448281408,20014.408258953736,20203.91867853553,20226.047751890863,20181.789605180198,51468,187948.2,80.05125714839211,76.65940984793205,NaN,NaN,NaN,NaN,98.73712524214058,42.338004227059464,6742356,26.929959771779295,234.48843090231094,207.55847113053164
2024-06-18T06:00:00-04:00,20237.75,20270,20164.25,20179,19930.119795042097,NaN,NaN,NaN,NaN,NaN,19451.895,20256.158527023304,18647.631472976696,20027.05160716299,20204.24569565876,20217.2141187167,20191.27727260082,192202,186183.26666666666,74.4491750894448,76.58460771941795,NaN,NaN,NaN,NaN,99.23804486770197,43.52928921728679,6550154,17.996745617966553,230.05440315298983,212.05765753502328
2024-06-18T10:00:00-04:00,20179,20229,20127,20202.5,19930.119795042097,NaN,NaN,NaN,NaN,NaN,19474.315,20298.284919414746,18650.34508058525,20027.05160716299,20193.87870885734,20206.195032957385,20181.562384757297,393450,183110.7,75.19688345236523,77.32705402465761,NaN,NaN,NaN,NaN,99.43532737715182,44.03669334425055,6943604,11.020586822179752,225.83339106274798,214.81280424056823
2024-06-18T14:00:00-04:00,20202.75,20210,20160,20209.25,19930.119795042097,NaN,NaN,NaN,NaN,NaN,19497.82,20337.11533562397,18658.52466437603,20027.05160716299,20193.71940292274,20204.738058826544,20182.700747018935,171846,181289.13333333333,75.41938886623625,77.77622001720954,NaN,NaN,NaN,NaN,95.90423256449812,44.507854319288334,7115450,4.542710166419852,220.49119194859304,215.9484817821732
2024-06-18T18:00:00-04:00,20204,20233,20203,20215.25,19942.043671174193,NaN,NaN,NaN,NaN,NaN,19520.675,20374.508679647333,18666.841320352665,20040.97042286745,20217.083333333332,20217.083333333332,20217.083333333332,18445,180849.2,75.62867747281189,78.17757749855033,NaN,NaN,NaN,NaN,91.19678738131968,45.07363767468076,7133895,-1.3414889020475016,214.2716206546138,215.6131095566613
2024-06-18T22:00:00-04:00,20215,20227.25,20213.5,20222.25,19955.087140666277,NaN,NaN,NaN,NaN,NaN,19543.75,20409.73022494743,18677.76977505257,20066.75133829396,20218.598307291664,20220.50579307189,20216.690821511438,11635,180697.56666666668,75.88663147284754,78.46566857026458,NaN,NaN,NaN,NaN,85.6648739969397,45.59900793325944,7145530,-6.478247733520163,207.51529988976108,213.99354762328124
2024-06-19T02:00:00-04:00,20222.25,20240.5,20218.5,20236.5,19973.2706797269,NaN,NaN,NaN,NaN,NaN,19566.84,20443.83733044064,18689.84266955936,20101.10107063517,20225.32668001416,20232.077084660174,20218.57627536815,31105,180224.4,76.43347149266752,78.16901930624223,NaN,NaN,NaN,NaN,81.1173829971583,46.16747915564699,7176635,-10.39980481905144,200.99379159946693,211.39359641851837
2024-06-19T06:00:00-04:00,20236.25,20252.25,20230.75,20238.5,19993.98564883022,NaN,NaN,NaN,NaN,NaN,19589.755,20475.832420375915,18703.677579624087,20129.980856508133,20231.55857146526,20240.645627376816,20222.4715155537,42644,171984.43333333332,76.51397443443264,77.88536916992783,NaN,NaN,NaN,NaN,76.85899849736128,46.768852258760504,7219279,-14.112185613025162,193.7533644022369,207.86555001526207
2024-06-19T10:00:00-04:00,20238.25,20248,20223.5,20230.75,19996.145392065213,NaN,NaN,NaN,NaN,NaN,19612.8,20504.409970783276,18721.190029216723,20137.934685206506,20232.337897612768,20239.982915148106,20224.69288007743,46359,160219.06666666668,75.438584276227,77.48541261042097,NaN,NaN,NaN,NaN,73.11907003326405,47.167047858215916,7172920,-18.088907320842793,185.25441586420857,203.34332318505136
2024-06-19T18:00:00-04:00,20231,20267.5,20226.5,20261.5,20012.695601516793,NaN,NaN,NaN,NaN,NaN,19637.38,20531.402775101236,18743.357224898766,20158.947748165207,20234.989983854513,20244.745264123714,20225.234703585313,23648,145655.53333333333,76.83006807709623,77.40036129473465,NaN,NaN,NaN,NaN,70.82485074517376,47.67410173576229,7196568,-19.52463813340077,178.9375255183004,198.46216365170116
2024-06-19T22:00:00-04:00,20261.25,20333.5,20256,20327.25,20060.527619629665,NaN,NaN,NaN,NaN,NaN,19661.625,20563.383627627118,18759.866372372882,20207.908198532165,20248.691577577705,20277.95251348595,20219.43064166946,41866,145895.46666666667,79.5038847861275,77.04966671483535,NaN,NaN,NaN,NaN,71.3016471205185,48.56365026974053,7238434,-17.01434286500796,177.1942350704412,194.20857793544917
2024-06-20T02:00:00-04:00,20327,20371.5,20304.75,20322.25,20105.446818737408,NaN,NaN,NaN,NaN,NaN,19687.45,20589.447727269784,18785.452272730217,20237.65155882573,20270.1616033085,20314.695783479165,20225.627423137837,73895,147446.2,78.75954878469794,76.94062330120425,NaN,NaN,NaN,NaN,70.97652946905289,49.599339880197995,7164539,-16.63866930840004,173.41024129994912,190.04891060834916
2024-06-20T06:00:00-04:00,20322.5,20336.5,20200,20234.25,20105.446818737408,NaN,NaN,NaN,NaN,NaN,19711.36,20606.662983129227,18816.057016870775,20237.65155882573,20264.304964480947,20298.210602554915,20230.39932640698,229561,152459.06666666668,66.88988365232501,76.13320833384579,NaN,NaN,NaN,NaN,75.65677736412054,48.47198812920977,6934978,-22.87957191871064,161.44944570996086,184.3290176286715
2024-06-20T10:00:00-04:00,20234.75,20240.75,19958.5,20033,NaN,NaN,NaN,20367.887557720667,20367.887557720667,20367.887557720667,19731.145,20610.1339537986,18852.156046201402,20237.65155882573,20152.206733141036,20246.248664371953,20058.16480191012,778134,168893.56666666668,48.78306260103913,73.98460654333647,NaN,NaN,NaN,NaN,90.41343612382623,45.53926925833734,6156844,-40.11566111351391,134.1844412367791,174.300102350293
2024-06-20T14:00:00-04:00,20033.25,20079.75,19964.25,20053.25,NaN,NaN,NaN,20293.818805097,NaN,NaN,19752.22,20610.311333367194,18894.12866663281,20237.65155882573,20129.56344823002,20226.371991991356,20032.754904468682,302377,157589.76666666666,50.24259360704747,71.85541629038329,NaN,NaN,NaN,NaN,92.20533354355292,42.81603030681295,6459221,-49.11273172858205,112.90918768956544,162.0219194181475
2024-06-20T18:00:00-04:00,20044,20076.25,20032.25,20044.75,NaN,NaN,NaN,20293.818805097,NaN,NaN,19773.235,20607.14645459217,18939.32354540783,20237.65155882573,20051.083333333332,20051.083333333332,20051.083333333332,34229,152386.36666666667,49.60360728485857,70.08073287577,NaN,NaN,NaN,NaN,88.76209543329914,40.28730842325458,6424992,-54.196923790254544,94.2757646803293,148.47268847058385
2024-06-20T22:00:00-04:00,20045.25,20077.5,20037.75,20073.5,NaN,NaN,NaN,20293.818805097,NaN,NaN,19792.67,20608.169107541027,18977.17089245897,20237.65155882573,20056.328992166113,20062.20748626735,20050.450498064874,27256,152512.6,51.8348952719708,68.41201943431325,NaN,NaN,NaN,NaN,85.26123147377777,37.92395767150422,6452248,-54.06134390117265,80.89600859411803,134.95735249529068
2024-06-21T02:00:00-04:00,20073.25,20085.5,19947.5,20008.25,NaN,NaN,NaN,20282.371098234722,NaN,NaN,19810.705,20604.297708446666,19017.112291553338,20237.65155882573,20029.830596385407,20050.786761633597,20008.874431137217,101318,155126.53333333333,46.77336181542444,66.36587464496954,NaN,NaN,NaN,NaN,89.02828636850792,36.616801904493165,6350930,-56.53686305959452,64.28627367079753,120.82313673039205
2024-06-21T06:00:00-04:00,20007.75,20045.75,19914,19952.75,NaN,NaN,NaN,20251.62695740587,NaN,NaN,19827.855,20595.498778650006,19060.211221349993,20237.65155882573,19993.007173363498,20024.3372421093,19961.677104617695,270362,159001.63333333333,42.933193737537636,64.03048294959282,NaN,NaN,NaN,NaN,92.07983734218593,35.69464609877161,6080568,-59.76811654134332,46.1129910537129,105.88110759505622
2024-06-21T10:00:00-04:00,19953.25,20073,19942.75,19961.25,NaN,NaN,NaN,20251.62695740587,NaN,NaN,19844.975,20585.08005504291,19104.86994495709,20237.65155882573,19992.62139581314,20013.10865169777,19972.134139928512,580101,169410.7,43.69563144293881,61.73112580459934,NaN,NaN,NaN,NaN,94.80627753202978,34.46191594092763,6660669,-59.083107897265336,32.02722272347455,91.11033062073989
2024-06-21T14:00:00-04:00,19961.25,20014.5,19956,20009,NaN,NaN,NaN,20251.62695740587,NaN,NaN,19864.185,20569.650759693453,19158.71924030655,20237.65155882573,19992.708948003852,20011.480563804656,19973.937332203048,193817,156647.43333333332,47.90624688368036,59.69346690395739,NaN,NaN,NaN,NaN,92.21297199402765,33.31723793721536,6854486,-53.33986564934257,24.43549855906167,77.77536420840424
2024-06-23T18:00:00-04:00,20014.25,20030,19917,19952.25,NaN,NaN,NaN,20249.060915433485,NaN,NaN,19882.585,20547.099007452118,19218.07099254788,20161.171247060585,19966.416666666668,19966.416666666668,19966.416666666668,56615,151214.7,43.72144267619079,57.351143206940115,NaN,NaN,NaN,NaN,93.69775970873995,32.639088358176984,6797871,-51.27466434727961,13.682033774304728,64.95669812158434
2024-06-23T22:00:00-04:00,19952.75,19997.25,19941.25,19992.25,NaN,NaN,NaN,20239.92178291378,NaN,NaN,19899.15,20531.71164126474,19266.588358735262,19959.36199764847,19970.49412620555,19975.611513125885,19965.376739285217,35943,151736.46666666667,47.221074435649804,55.33560678975603,NaN,NaN,NaN,NaN,91.0050625866871,32.0093780347842,6833814,-45.3318248132196,8.291917105059838,53.623741918279435
2024-06-24T02:00:00-04:00,19992,20030,19939.5,19954.25,NaN,NaN,NaN,20239.92178291378,NaN,NaN,19913.275,20517.97272820785,19308.577271792154,19858.994342796017,19972.35087452838,19976.645287212592,19968.056461844168,76981,153949.63333333333,44.39660155548359,53.01893060964085,NaN,NaN,NaN,NaN,90.96898668763802,30.89014927137758,6756833,-42.14454760547636,0.9430574114339834,43.087605016910345
2024-06-24T06:00:00-04:00,19954.5,19984,19866.75,19946.25,NaN,NaN,NaN,20199.768091456568,NaN,NaN,19927.09,20501.867763661834,19352.312236338166,19858.994342796017,19947.532138664745,19967.133655570775,19927.930621758715,276847,161191.96666666667,43.802593352764646,50.46883836440064,NaN,NaN,NaN,NaN,92.8462019242353,30.60565341819531,6479986,-38.84089995422141,-5.4635199258664215,33.37738002835499
2024-06-24T10:00:00-04:00,19946.75,19995.5,19788,19810.25,NaN,NaN,NaN,20181.966132753994,NaN,NaN,19937.985,20482.01688702493,19393.953112975072,19858.994342796017,19896.551631474114,19938.716041122152,19854.387221826077,711861,179987.16666666666,35.18423684447437,47.3563160829561,NaN,NaN,NaN,NaN,101.03575892964706,31.011562242144926,5768125,-43.71763093330283,-21.26965863827354,22.447972295029285
2024-06-24T14:00:00-04:00,19810.5,19853.75,19728,19753.25,NaN,NaN,NaN,20085.047217628813,NaN,NaN,19947.705,20459.888665201986,19435.521334798017,19841.695474236814,19873.60203481947,19933.760874233747,19813.44319540519,279014,176452.4,32.314496183493105,44.886645549468106,NaN,NaN,NaN,NaN,102.8010618632437,31.822062839888765,5489111,-48.32478169560942,-37.95800482448249,10.366776871126929
2024-06-24T18:00:00-04:00,19758.5,19779.25,19742.75,19775.5,NaN,NaN,NaN,20046.778025918415,NaN,NaN,19953.405,20451.25196333319,19455.558036666807,19799.14010351156,19765.833333333332,19765.833333333332,19765.833333333332,32782,171159.33333333334,34.5583202258569,43.87059252266938,NaN,NaN,NaN,NaN,98.06527173015488,32.57467053779376,5521893,-47.35375853462855,-48.825421297158755,-1.47166276253021
2024-06-24T22:00:00-04:00,19776,19810.75,19773.25,19805,NaN,NaN,NaN,20046.778025918415,NaN,NaN,19959.205,20443.04696479797,19475.363035202034,19799.14010351156,19778.914933277585,19794.00998350024,19763.81988305493,24620,170972,37.515918638419436,42.96154431062451,NaN,NaN,NaN,NaN,93.73918089228667,32.715978236356804,5546513,-42.366739807299076,-54.43008752165406,-12.06334771435498
2024-06-25T02:00:00-04:00,19805.25,19841.25,19725.25,19838.75,NaN,NaN,NaN,20046.778025918415,NaN,NaN,19963.78,20438.568949323875,19488.991050676123,19799.040986398337,19793.49172300171,19807.73197172302,19779.251474280398,101321,173723.4,40.81169053739643,42.333550257234364,NaN,NaN,NaN,NaN,95.32923939998048,33.233098612251496,5647834,-34.75621318292809,-55.50861419301509,-20.752401010087002
2024-06-25T06:00:00-04:00,19838.75,19852.5,19792.25,19831.5,NaN,NaN,NaN,20046.778025918415,NaN,NaN,19967.985,20434.2118912234,19501.7581087766,19799.040986398337,19812.72379501926,19830.744181397753,19794.70340864077,240495,180024.3,40.31970312013838,41.51103653210347,NaN,NaN,NaN,NaN,92.82357944283902,33.50923859374428,5407339,-28.437586792158932,-56.29938450028567,-27.861797708126737
2024-06-25T10:00:00-04:00,19832.25,19968,19828.25,19924.25,NaN,NaN,NaN,20046.778025918415,NaN,NaN,19973.94,20430.064682077435,19517.815317922563,19799.040986398337,19869.667549723905,19917.044796365022,19822.290303082787,611664,194006.36666666667,48.819936106426596,41.6572204100322,NaN,NaN,NaN,NaN,96.17546662549339,31.96260851788693,6019003,-16.813349881590653,-48.878485060115054,-32.0651351785244
2024-06-25T14:00:00-04:00,19924.5,19981,19915.5,19970,NaN,NaN,NaN,20046.778025918415,NaN,NaN,19981.4,20424.639957584885,19538.16004241512,19799.040986398337,19884.084908968198,19937.910482008112,19830.259335928284,204078,187693.96666666667,52.41981464552602,42.33483618917423,NaN,NaN,NaN,NaN,93.98436186652957,30.352033166584803,6223081,-5.434129965016588,-38.85779763479513,-33.423667669778546
2024-06-25T18:00:00-04:00,19972,20003.5,19963.5,19999.5,NaN,NaN,NaN,20046.778025918415,NaN,NaN,19988.765,20420.578031415327,19556.95196858467,19799.21131764261,19988.833333333332,19988.833333333332,19988.833333333332,35450,183147.43333333332,54.635551884775325,43.11625907787684,NaN,NaN,NaN,NaN,90.12833601892031,28.550929268259505,6258531,4.170348979560565,-28.210731445327838,-32.3810804248884
2024-06-25T22:00:00-04:00,19999.25,20017,19981.5,20014.25,NaN,NaN,NaN,20046.778025918415,NaN,NaN,19997.69,20412.457857482153,19582.922142517844,19835.81905411409,19995.77654604277,20003.446812874437,19988.1062792111,29048,183500.86666666667,55.74525463209536,43.676188202763626,NaN,NaN,NaN,NaN,86.22631201756886,26.693425577961357,6287579,11.208156398202568,-18.370884927135194,-29.579041325337762
2024-06-26T02:00:00-04:00,20014.5,20070.5,19991,20022.25,19767.589159172818,19767.589159172818,19767.589159172818,NaN,NaN,NaN,20005.97,20405.561436844953,19606.37856315505,19885.80524329127,20013.25185700036,20030.07791632658,19996.42579767414,76859,185675,56.36866239621057,44.5795610399079,NaN,NaN,NaN,NaN,85.74586115917108,25.30190185213486,6364438,15.811975448386288,-9.8140720148549,-25.62604746324119
2024-06-26T06:00:00-04:00,20022.25,20026.5,19901,19971.75,19767.589159172818,NaN,NaN,NaN,NaN,NaN,20012.85,20397.73131937016,19627.968680629838,19885.80524329127,19981.876666246335,20005.929011736524,19957.824320756146,286876,194200.7,51.44237809178657,44.88108272963195,NaN,NaN,NaN,NaN,88.58544250494458,24.105524390513676,6077562,14.879505917538594,-7.026665066317946,-21.90617098385654
2024-06-26T10:00:00-04:00,19971.25,20028,19912,19984.5,19767.589159172818,NaN,NaN,NaN,NaN,NaN,20019.615,20390.10551553251,19649.124484467495,19885.80524329127,19977.679733166613,19993.355820559,19962.003645774224,631417,213826.46666666667,52.569429133097515,45.464856128032956,NaN,NaN,NaN,NaN,90.54362518316283,22.97419245080798,6708979,14.528433386140012,-3.7456292511815263,-18.27406263732154
2024-06-26T14:00:00-04:00,19984.75,20027.75,19920,19952.75,19767.589159172818,NaN,NaN,NaN,NaN,NaN,20027.54,20374.2554937409,19680.8245062591,19885.80524329127,19975.73456619215,19990.532665292772,19960.936467091527,231563,219999.93333333332,49.4889875807813,45.871027144319854,NaN,NaN,NaN,NaN,91.77265195579405,21.92366993536698,6477416,11.687173754310052,-3.665095444433973,-15.352269198744025
2024-06-26T18:00:00-04:00,19951,19963.25,19873.5,19919,19767.589159172818,NaN,NaN,NaN,NaN,NaN,20033.14,20363.218174983092,19703.061825016906,19885.80524329127,19918.583333333332,19918.583333333332,19918.583333333332,53126,220982.53333333333,46.377945074771645,46.67057773219824,NaN,NaN,NaN,NaN,91.62817681609447,21.514671761631835,6424290,7.279783855034031,-6.252539379951486,-13.532323234985517
2024-06-26T22:00:00-04:00,19919.25,19958.25,19909.5,19953.75,19767.589159172818,NaN,NaN,NaN,NaN,NaN,20039.07,20352.138204070416,19726.001795929584,19885.80524329127,19926.795860158734,19937.404612024526,19916.187108292943,31837,220648.23333333334,49.872103345897656,47.924692529512846,NaN,NaN,NaN,NaN,88.56544990065915,21.134887743163482,6456127,6.476734378047631,-5.436405262425978,-11.91313964047361
2024-06-27T02:00:00-04:00,19953.75,19979.25,19933.5,19973,19767.589159172818,NaN,NaN,NaN,NaN,NaN,20044.605,20342.659241540347,19746.550758459653,19885.80524329127,19941.18486912801,19960.283184536023,19922.086553719997,58969,220150.7,51.74785921614455,49.15251674310482,NaN,NaN,NaN,NaN,85.5072034791835,20.42267771069853,6515096,6.970977253708355,-3.1994180733381654,-10.17039532704652
2024-06-27T06:00:00-04:00,19973,20101.25,19953.25,20060,19767.589159172818,NaN,NaN,NaN,NaN,NaN,20046.58,20343.705973957058,19749.454026042946,19885.80524329127,20005.77248122552,20052.826669666985,19958.71829278405,286972,222064.4,59.181869304854125,50.700084647850154,NaN,NaN,NaN,NaN,89.97097465924183,19.85965382031188,6802068,12.560187271439895,5.529838762253348,-7.030348509186547
2024-06-27T10:00:00-04:00,20059.75,20116.5,19954.25,20034.5,19767.589159172818,NaN,NaN,NaN,NaN,NaN,20048.065,20344.190763992377,19751.93923600762,19885.80524329127,20023.286983134145,20056.41831775814,19990.15564851015,639780,217452.6,56.43727470186929,51.81619780245536,NaN,NaN,NaN,NaN,95.1337621835817,19.51116566483731,6162288,13.841713976097726,10.27179396093561,-3.5699200151621158
2024-06-27T14:00:00-04:00,20034.5,20079.75,19994,20067.25,19767.589159172818,NaN,NaN,NaN,NaN,NaN,20049.775,20345.33616541196,19754.21383458804,19885.80524329127,20027.65781796255,20058.961157550664,19996.354478374436,241947,215438.26666666666,59.06306850969235,53.15500961599493,NaN,NaN,NaN,NaN,94.463493456183,19.187569520468067,6404235,16.041919337676532,16.48247915693355,0.44055981925701726
2024-06-27T18:00:00-04:00,20066.75,20134.5,20060.5,20130,19820.79091671983,NaN,NaN,NaN,NaN,NaN,20053.285,20348.405009656803,19758.164990343197,19894.988685392833,20108.333333333332,20108.333333333332,20108.333333333332,39381,215610,63.59138567976856,54.21011315694793,NaN,NaN,NaN,NaN,93.00181535216993,19.519212641143028,6443616,20.58056341833727,26.166264092178608,5.585700673841336
2024-06-27T22:00:00-04:00,20130,20140.75,20099.5,20109,19850.368602323473,NaN,NaN,NaN,NaN,NaN,20050.8,20341.88153496922,19759.71846503078,19928.515948314267,20112.115610756817,20116.148945179157,20108.082276334477,34631,215855.83333333334,61.15339321271306,54.83394019746129,NaN,NaN,NaN,NaN,89.30525711272922,19.895909456762787,6408985,20.955335750791136,31.779870362330257,10.82453461153912
2024-06-28T02:00:00-04:00,20109.25,20133,20091.75,20126,19850.368602323473,NaN,NaN,NaN,NaN,NaN,20049.57,20338.84471441514,19760.29528558486,19942.587758651414,20114.19113492313,20118.05015497008,20110.332114876182,56361,214357.26666666666,62.40977968600659,55.389242183263526,NaN,NaN,NaN,NaN,85.87273874753429,20.097797183899992,6465346,21.07793753019139,37.17195652427836,16.094018994086966
2024-06-28T06:00:00-04:00,20126.25,20172.75,20039,20148.25,19850.368602323473,NaN,NaN,NaN,NaN,NaN,20049.25,20338.051575480302,19760.448424519698,19953.54520692113,20118.211600647363,20121.643082975057,20114.780118319668,293089,215114.83333333334,64.04867365492314,55.982343542036936,NaN,NaN,NaN,NaN,89.29254312271041,19.33473319759809,6758435,21.323058556204764,42.74784218934292,21.424783633138155
2024-06-28T10:00:00-04:00,20148.5,20273.25,19985.25,20041,19850.368602323473,NaN,NaN,NaN,NaN,NaN,20046.26,20332.23186854699,19760.288131453006,19953.886165536904,20106.231866774535,20115.21809558586,20097.24563796321,792832,222205.86666666667,52.22824141525758,55.686599186254575,NaN,NaN,NaN,NaN,103.48593289965967,19.803737860367132,5965603,13.319135595130255,38.073703127050976,24.75456753192072
2024-06-28T14:00:00-04:00,20040.5,20071.75,19906,19967,19850.368602323473,NaN,NaN,NaN,NaN,NaN,20040.845,20322.326294049406,19759.363705950596,19953.886165536904,20079.506256253022,20131.279688506733,20027.73282399931,331957,226810.53333333333,45.9297517966917,55.29284016517637,NaN,NaN,NaN,NaN,107.93336626396969,19.035424311589377,5633646,2.656030858694379,28.074606105288694,25.418575246594315
2024-06-30T18:00:00-04:00,19971.25,19992.75,19932,19990,19850.368602323473,NaN,NaN,NaN,NaN,NaN,20037.065,20316.08908157738,19758.04091842262,19953.886165536904,19971.583333333332,19971.583333333332,19971.583333333332,63232,227031.1,48.02764887681157,54.96842728972738,NaN,NaN,NaN,NaN,104.56312581654329,18.321990302010033,5696878,-2.930560168671697,21.755375035754696,24.685935204426393
2024-06-30T22:00:00-04:00,19990.25,20008.75,19974.75,20007.75,19850.368602323473,NaN,NaN,NaN,NaN,NaN,20033.17,20308.257266881352,19758.082733118645,19953.886165536904,19981.528480931247,19993.96613758684,19969.090824275652,40428,227180.6,49.65121512301308,54.98001497131536,NaN,NaN,NaN,NaN,99.52290254393306,17.85695549255923,5737306,-5.370795814171817,17.972440436711622,23.34323625088344
2024-07-01T02:00:00-04:00,20008,20020.25,19901,19935.75,19850.368602323473,NaN,NaN,NaN,NaN,NaN,20027.7,20299.420886204964,19755.979113795038,19953.886165536904,19965.799482955783,19982.626890780957,19948.97207513061,121079,228650.53333333333,43.689230303132135,54.78796391619825,NaN,NaN,NaN,NaN,100.93198093365211,16.784690792915598,5616227,-11.426429874092413,9.060198908267921,20.486628782360334
2024-07-01T06:00:00-04:00,19935.5,19992.75,19841.25,19885.25,NaN,NaN,NaN,20218.283969860182,20218.283969860182,20218.283969860182,20021.1,20290.29762257563,19751.90237742437,19953.886165536904,19932.433374954187,19963.931543910618,19900.935205997757,288225,229029.8,40.05615953475822,54.08682507254544,NaN,NaN,NaN,NaN,104.54398229553411,16.501243477769375,5328002,-18.03255635729268,-2.054066664255515,15.978489693037165
2024-07-01T10:00:00-04:00,19887.75,20026.5,19811.5,19999.5,NaN,NaN,NaN,20218.283969860182,NaN,NaN,20016.645,20279.681862245383,19753.608137754618,19953.886165536904,19940.284669180386,19961.60104797042,19918.968290390352,725838,229495.7,50.15498195452517,53.973048125286915,NaN,NaN,NaN,NaN,112.4336978458531,15.764513568092948,6053840,-14.08235680272725,-1.6244563103718974,12.457900492355353
2024-07-01T14:00:00-04:00,19999.75,20074,19982.25,20042.5,NaN,NaN,NaN,20218.283969860182,NaN,NaN,20012.765,20268.33251378077,19757.19748621923,19953.886165536904,19956.27537701951,19996.294087775383,19916.256666263635,258468,228810.83333333334,53.34107071465402,53.55584822598691,NaN,NaN,NaN,NaN,110.95629085686359,14.816838693667433,6312308,-8.237644593042981,2.160844751051627,10.398489344094608
2024-07-01T18:00:00-04:00,20048,20054.25,19968.75,19988,NaN,NaN,NaN,20218.283969860182,NaN,NaN,20007.755,20255.114889432032,19760.39511056797,19953.886165536904,20003.666666666668,20003.666666666668,20003.666666666668,50652,229406.5,49.06068912746218,53.0289492563864,NaN,NaN,NaN,NaN,109.13798436708761,13.758913397435634,6261656,-7.7153249897913,0.7543331068554835,8.469658096646784
2024-07-01T22:00:00-04:00,19988.25,20014,19961.25,20010.5,NaN,NaN,NaN,20218.283969860182,NaN,NaN,20003.35,20242.372509400742,19764.327490599255,19953.886165536904,19999.929292707555,20004.111190215393,19995.747395199716,40456,229934.36666666667,50.815458651824244,52.43983426653868,NaN,NaN,NaN,NaN,105.11027119800993,12.879403207078372,6302112,-5.6248139168036015,1.4386407006422814,7.063454617445883
2024-07-02T02:00:00-04:00,20010.5,20016.5,19934,19956,NaN,NaN,NaN,20218.283969860182,NaN,NaN,19997.24,20224.90308352413,19769.576916475875,19764.741941418397,19983.435764416838,19999.217335003006,19967.65419383067,102907,229987.23333333334,46.625681906740425,51.22799828275095,NaN,NaN,NaN,NaN,103.4952518267235,12.438194234903424,6199205,-7.5621188816162075,-2.3891939845743764,5.172924897041831
2024-07-02T06:00:00-04:00,19956.75,20096.5,19909.75,20063.75,NaN,NaN,NaN,20218.283969860182,NaN,NaN,19991.97,20200.20243359256,19783.737566407443,19801.718553134717,20008.310934141176,20029.93178232528,19986.690085957074,321264,232679.53333333333,54.59629589093784,50.759634188338445,NaN,NaN,NaN,NaN,109.4420195533861,12.170805096535808,6520469,-1.5507726266554247,3.2344591137225507,4.785231740377975
2024-07-02T10:00:00-04:00,20064.25,20216,20015,20208.75,NaN,NaN,NaN,20218.283969860182,NaN,NaN,19989.7,20185.589841492416,19793.810158507586,19879.674842507775,20086.77763270292,20156.741498823372,20016.81376658247,676060,234826.06666666668,62.67428066373909,50.778527115319335,NaN,NaN,NaN,NaN,115.98187529957282,13.151203881493903,7196529,11.508252019650268,19.17054676494081,7.662294745290542
2024-07-02T14:00:00-04:00,20209,20259.5,20203.75,20240.25,19911.36819139582,19911.36819139582,19911.36819139582,NaN,NaN,NaN,19989.82,20186.315344474475,19793.324655525525,19962.564874006217,20107.642198780683,20190.409373864837,20024.875023696528,195942,234554.86666666667,64.16582573626093,50.78689512112918,NaN,NaN,NaN,NaN,111.67959849246049,14.425611449593317,7392471,21.03051481691808,33.95043826643814,12.919923449520063
2024-07-02T18:00:00-04:00,20243.5,20252.75,20231.25,20239.5,19933.368500877827,NaN,NaN,NaN,NaN,NaN,19993.95,20202.229235642946,19785.670764357055,20004.451899204974,20241.166666666668,20241.166666666668,20241.166666666668,27402,234286.6,64.10014732841161,51.63488840064018,NaN,NaN,NaN,NaN,105.23819860014189,15.60898990568563,7365069,25.730778599621324,45.083396699046716,19.352618099425392
2024-07-02T22:00:00-04:00,20239,20249,20231.5,20248.25,19943.26084174702,NaN,NaN,NaN,NaN,NaN,19997.85,20217.421309601643,19778.278690398354,20041.61151936398,20241.896140586094,20242.75895414144,20241.033327030746,19587,233971.23333333334,64.55596738352037,52.96533237112794,NaN,NaN,NaN,NaN,98.97118441441746,16.70784132919992,7384656,27.709933380373336,53.990034824892064,26.280101444518728
2024-07-03T02:00:00-04:00,20247.75,20282.75,20234,20270.25,19968.237621667606,NaN,NaN,NaN,NaN,NaN,20002.36,20234.5029981712,19770.2170018288,20092.464215491185,20253.791052155604,20263.88663739256,20243.69546691865,65431,233590.3,65.73401617927897,54.230072892732764,NaN,NaN,NaN,NaN,95.38395695624479,18.036180524697173,7450087,28.6622266936049,62.107884811524855,33.445658117919955
2024-07-03T06:00:00-04:00,20270.5,20284,20205,20275.75,19968.237621667606,NaN,NaN,NaN,NaN,NaN,20006.405,20250.124959995588,19762.68504000441,20092.464215491185,20254.55089831898,20260.329920487995,20248.771876149964,233541,231812.46666666667,66.03792205619992,55.40055195938896,NaN,NaN,NaN,NaN,94.213674316513,18.741393406217135,7683628,27.8026638781348,68.19898796558846,40.39632408745366
2024-07-03T10:00:00-04:00,20290,20435.5,20235.25,20419,20033.424413544246,NaN,NaN,NaN,NaN,NaN,20014.62,20284.338320475617,19744.90167952438,20181.992097914357,20319.70811006029,20373.097679332106,20266.318540788478,517705,228022.06666666668,72.80350789364473,57.48014321585415,NaN,NaN,NaN,NaN,101.78769757961922,20.607276291590672,8201333,34.58003974183884,83.6213737647522,49.04133402291337
2024-07-03T18:00:00-04:00,20420,20420.5,20390,20406.75,20112.865349292235,NaN,NaN,NaN,NaN,NaN,20023.7,20314.23954980309,19733.160450196912,20202.443678331485,20405.75,20405.75,20405.75,21283,221012.73333333334,71.49192932123869,59.7255553434599,NaN,NaN,NaN,NaN,96.69571918107499,22.339881828008952,8180050,35.78635794665897,93.77428145623708,57.98792350957811
2024-07-03T22:00:00-04:00,20406.75,20410,20396.75,20407.75,20122.473742506223,NaN,NaN,NaN,NaN,NaN,20032.63,20341.793067651804,19723.466932348198,20228.92994266519,20405.39282334385,20405.83985436174,20404.945792325958,13587,219694.76666666666,71.53700799733438,61.252842917946275,NaN,NaN,NaN,NaN,90.73531066814107,23.94872982611164,8193637,34.20162764355598,100.73995806402309,66.5383304204671
2024-07-04T02:00:00-04:00,20407.5,20410,20396,20401.75,20132.957890574122,NaN,NaN,NaN,NaN,NaN,20040.485,20366.353522720143,19714.61647727986,20258.143954132152,20404.25901266876,20405.679960583726,20402.838064753796,23594,219420,70.81348023706758,62.500872169547236,NaN,NaN,NaN,NaN,85.25421704898814,25.427635244510505,8170043,30.42592031401209,104.57073081298222,74.14481049897013
2024-07-04T06:00:00-04:00,20402,20409.75,20382.25,20384.75,20134.48253191166,NaN,NaN,NaN,NaN,NaN,20049.135,20387.882165449886,19710.38783455011,20274.51516330572,20400.542720833724,20406.21832107043,20394.867120597017,26200,218327.7,68.6935444478635,63.90321897814733,NaN,NaN,NaN,NaN,81.12891583120327,26.51294586526216,8143843,24.703538718928968,105.02423389763135,80.32069517870238
2024-07-04T10:00:00-04:00,20384.75,20393.5,20369.5,20381.5,20134.48253191166,NaN,NaN,NaN,NaN,NaN,20056.92,20407.75566580429,19706.084334195708,20274.51516330572,20393.798109146475,20403.98384940102,20383.612368891932,46432,210309.7,68.27274683538771,65.15016813411614,NaN,NaN,NaN,NaN,77.04827898611732,27.248761540548838,8097411,18.8821846222949,103.92342595657101,85.04124133427611
2024-07-04T18:00:00-04:00,20381.5,20411,20361,20406.5,20137.774373084798,NaN,NaN,NaN,NaN,NaN,20065.965,20428.85840046358,19703.07159953642,20289.849704515662,20393.65823093713,20403.082803958867,20384.233657915393,22230,189724.7,69.80501067567691,66.80583447475446,NaN,NaN,NaN,NaN,75.11625905853751,28.105703036407743,8119641,15.063774164805665,103.8709590402832,88.80718487547753
2024-07-04T22:00:00-04:00,20407,20431.5,20401.25,20429.5,20175.3073561264,NaN,NaN,NaN,NaN,NaN,20075.63,20450.788702951,19700.471297049004,20319.454763612528,20396.83814050903,20409.265309708462,20384.410971309597,20390,182339.46666666667,71.18383753124024,67.99065887763321,NaN,NaN,NaN,NaN,71.91152626864196,29.10235721007889,8140031,12.538968646624951,104.48089568375872,91.94192703713377
2024-07-05T02:00:00-04:00,20429,20459.75,20425.75,20432.5,20208.003612666107,NaN,NaN,NaN,NaN,NaN,20088.075,20468.44181308924,19707.70818691076,20353.113810890023,20407.897020998436,20429.38876734795,20386.40527464892,61111,183063.8,71.36749655728944,68.61160287002966,NaN,NaN,NaN,NaN,69.2035601065961,30.293912442663906,8201142,9.652391998143017,104.00741703481253,94.35502503666952
2024-07-05T06:00:00-04:00,20432,20516.5,20380.75,20514,20208.003612666107,NaN,NaN,NaN,NaN,NaN,20103.29,20489.68005370204,19716.899946297963,20363.31604871202,20441.919523245695,20476.271830740967,20407.567215750423,280358,191254.7,75.86738331785651,69.4474284115722,NaN,NaN,NaN,NaN,73.95687724183924,31.873227099214894,8481500,11.678070187462623,108.9526127709978,97.27454258353518
2024-07-05T10:00:00-04:00,20514.5,20638.75,20462.25,20624.25,20294.871060301146,NaN,NaN,NaN,NaN,NaN,20120.265,20521.838049519225,19718.691950480774,20427.952838969613,20510.956660154665,20581.634835521923,20440.278484787406,554635,207863.83333333334,80.36328472778499,70.60908108295601,NaN,NaN,NaN,NaN,81.28138601027929,34.090198821805856,9036135,18.484606295535485,120.38030045295454,101.89569415741906
2024-07-05T14:00:00-04:00,20624.25,20639.75,20590,20590.25,20364.081466651092,NaN,NaN,NaN,NaN,NaN,20135.97,20548.273088030874,19723.66691196913,20446.23727117569,20524.638697267055,20598.147920508356,20451.129474025754,178443,204042.3,75.68073185567457,71.40370711668132,NaN,NaN,NaN,NaN,79.0291441524022,36.1539570682329,8857692,18.68305349392665,125.24951102482737,106.56645753090072
2024-07-07T18:00:00-04:00,20591,20618.25,20579.25,20594,20364.081466651092,NaN,NaN,NaN,NaN,NaN,20151.075,20573.919336014736,19728.230663985265,20446.23727117569,20597.166666666668,20597.166666666668,20597.166666666668,41318,178991.83333333334,75.84788601740108,72.1261263908329,NaN,NaN,NaN,NaN,76.16991957008774,37.81448069782675,8899010,17.095810004633222,127.93622003669225,110.84041003205903
2024-07-07T22:00:00-04:00,20593.75,20602.75,20583.25,20584.5,20364.081466651092,NaN,NaN,NaN,NaN,NaN,20166.135,20595.95873375639,19736.311266243607,20453.551853552442,20594.959779258228,20598.212141458007,20591.70741705845,19024,168560.73333333334,74.45177873790126,72.72711615381156,NaN,NaN,NaN,NaN,72.12206817222433,39.35639549673534,8879986,13.587987258672001,127.82539410539903,114.23740684672703
2024-07-08T02:00:00-04:00,20584.25,20620.5,20583,20611.75,20371.127074347838,NaN,NaN,NaN,NaN,NaN,20179.885,20621.69643274069,19738.073567259307,20482.391482841955,20599.55264579485,20605.136604348867,20593.968687240835,50110,168123.33333333334,75.8262837128444,72.94302871232581,NaN,NaN,NaN,NaN,69.64906330277974,40.90527661688804,8930096,11.37459788095002,128.45565419791455,117.08105631696453
2024-07-08T06:00:00-04:00,20612.25,20654,20600.75,20635,20399.97357096839,NaN,NaN,NaN,NaN,NaN,20193.185,20648.746212242422,19737.62378775758,20516.888186273565,20619.889048934627,20634.525406571785,20605.252691297468,224001,174242.43333333332,76.96499866450273,73.33396223684467,NaN,NaN,NaN,NaN,68.47770163829547,42.554600093908,9154097,9.807368125045315,129.34026647327119,119.53289834822587
2024-07-08T10:00:00-04:00,20635,20671.25,20588,20653.75,20401.20772683346,NaN,NaN,NaN,NaN,NaN,20206.27,20676.184511799827,19736.355488200174,20519.93554901885,20630.770940781058,20643.346038245912,20618.195843316204,527788,187799.4,77.8703339768886,73.7863426639557,NaN,NaN,NaN,NaN,69.53286580698865,44.189919733426315,9681885,8.417763012469393,130.0551021138126,121.63733910134322
2024-07-08T14:00:00-04:00,20653.75,20688.25,20609,20684.75,20419.783511977395,NaN,NaN,NaN,NaN,NaN,20219.68,20704.928441934662,19734.43155806534,20527.57343921508,20636.443891147806,20652.739310077184,20620.14847221843,201936,184923.1,79.31765883530801,74.39378399240145,NaN,NaN,NaN,NaN,70.22694682077518,45.80981078022714,9883821,7.974915578507961,131.60598357447816,123.6310679959702
2024-07-08T18:00:00-04:00,20680.5,20748.75,20672.5,20711.25,20481.787670523878,NaN,NaN,NaN,NaN,NaN,20233.46,20734.37864968289,19732.541350317108,20582.083751372065,20710.833333333332,20710.833333333332,20710.833333333332,58302,162671.9,80.492200197117,75.23654511734813,NaN,NaN,NaN,NaN,70.65716490500553,47.635900541299094,9942123,7.843336377075659,133.43523846731478,125.59190209023912
2024-07-08T22:00:00-04:00,20710.75,20742.25,20704.25,20725.75,20499.63254913643,NaN,NaN,NaN,NaN,NaN,20248.54,20762.269942284787,19734.810057715214,20589.917001097652,20715.28420925738,20721.54230876748,20709.026109747283,29491,155039.33333333334,81.12386756938497,76.15448231263365,NaN,NaN,NaN,NaN,68.32451026893371,49.331555319437335,9971614,7.130063156726223,134.5044810361469,127.37441787942068
2024-07-09T02:00:00-04:00,20725.75,20748,20712.5,20740,20511.95606963023,NaN,NaN,NaN,NaN,NaN,20263.65,20789.720784210444,19737.57921578956,20608.38360087812,20721.02432839003,20730.945741551604,20711.102915228457,40394,154697.4,81.74931507911393,77.00764691287915,NaN,NaN,NaN,NaN,65.9799023925813,50.93629480253025,10012008,6.057381083293677,134.94614423353778,128.8887631502441
2024-07-09T06:00:00-04:00,20740.25,20764.5,20703.5,20749,20517.31033919249,NaN,NaN,NaN,NaN,NaN,20279.575,20815.157404957266,19743.992595042735,20622.306880702497,20732.30182053287,20742.895109487417,20721.708531578322,215824,160543,82.1515598869494,77.79105565257267,NaN,NaN,NaN,NaN,65.62419507882548,52.51435284395001,10227832,4.466811538653417,134.47227757356086,130.00546603490744
2024-07-09T10:00:00-04:00,20749.5,20771.75,20616,20660.5,20517.31033919249,NaN,NaN,NaN,NaN,NaN,20294.405,20830.293009662666,19758.51699033733,20622.306880702497,20699.25869949934,20723.401720479444,20675.115678519236,688558,180064.7,66.60589236088407,77.45094106711515,NaN,NaN,NaN,NaN,72.0617525731951,51.513235587736936,9539274,-3.5973825452314827,125.50873785336807,129.10612039859956
2024-07-09T14:00:00-04:00,20660.75,20690.25,20640.75,20688,20517.31033919249,NaN,NaN,NaN,NaN,NaN,20309.09,20847.070536450923,19771.109463549077,20622.306880702497,20695.01192830501,20719.13859593716,20670.885260672865,199214,175996.36666666667,68.5946045425537,76.93145686887922,NaN,NaN,NaN,NaN,70.45019881796688,50.583626706967664,9738488,-7.885332530696502,119.24945473522894,127.13478726592544
2024-07-09T18:00:00-04:00,20687.75,20711.5,20682,20701.75,20517.31033919249,NaN,NaN,NaN,NaN,NaN,20323.665,20863.916206476984,19783.413793523017,20622.306880702497,20698.416666666668,20698.416666666668,20698.416666666668,23860,154256.36666666667,69.57038743965276,76.16053563401265,NaN,NaN,NaN,NaN,67.52518461668353,49.954199416077536,9762348,-10.441145059152888,114.08335594198434,124.52450100113722
2024-07-09T22:00:00-04:00,20701.75,20717.25,20696,20697,20517.31033919249,NaN,NaN,NaN,NaN,NaN,20336.405,20881.20855991863,19791.60144008137,20622.306880702497,20700.633964670025,20703.117929172287,20698.150000167763,19012,148358.7,68.77540472659405,75.66729798193546,NaN,NaN,NaN,NaN,64.21981428692042,49.43324526975102,9743336,-12.934136769625567,108.35683003910526,121.29096680873083
2024-07-10T02:00:00-04:00,20697,20732.25,20696.75,20727.5,20517.31033919249,NaN,NaN,NaN,NaN,NaN,20350.265,20898.888016378172,19801.641983621827,20622.306880702497,20709.155656574425,20718.415849590143,20699.895463558707,37751,148703.66666666666,71.06201652700173,75.32545016119265,NaN,NaN,NaN,NaN,62.16839898071182,49.11798334025021,9781087,-12.978014699911313,105.0684484338417,118.04646313375301
2024-07-10T06:00:00-04:00,20727.75,20778.25,20721.5,20764,20545.026903078735,NaN,NaN,NaN,NaN,NaN,20364.2,20918.72394898661,19809.67605101339,20648.392246934876,20742.222497750026,20763.00870988944,20721.436285610613,215677,155240,73.55761103074543,75.26158103925295,NaN,NaN,NaN,NaN,61.78137048208954,49.294956948934704,9996764,-11.072049902795953,104.20640075525807,115.27845065805403
2024-07-10T10:00:00-04:00,20764.25,20880.5,20703,20874.25,20572.008634756974,NaN,NaN,NaN,NaN,NaN,20379.085,20947.446386883403,19810.723613116596,20687.8637975479,20793.17868200185,20831.580966534944,20754.776397468755,579116,172362.83333333334,79.35040113751404,75.51330371244363,NaN,NaN,NaN,NaN,70.046986876226,50.228871981173775,10575880,-3.3120871350724173,111.1383417392135,114.45042887428592
2024-07-10T14:00:00-04:00,20874.5,20917.5,20853.25,20896.25,20666.860514995293,NaN,NaN,NaN,NaN,NaN,20394.83,20975.867128245387,19813.792871754616,20731.26603803832,20810.173889506485,20860.699499556395,20759.648279456575,188743,170869.56666666668,80.27882982253644,75.75000593801747,NaN,NaN,NaN,NaN,69.63291638506699,51.31061697077853,10764623,2.085898163466908,117.05780157861955,114.97190341515264
2024-07-10T18:00:00-04:00,20894.75,20899.5,20853.5,20877.5,20666.860514995293,NaN,NaN,NaN,NaN,NaN,20409.86,21001.09311950527,19818.626880494732,20731.26603803832,20876.833333333332,20876.833333333332,20876.833333333332,31055,154647.9,77.09727625036894,75.69478752898034,NaN,NaN,NaN,NaN,67.94485092899077,52.31509446112581,10733568,3.1151464499129133,118.86583647754378,115.75069002763087
2024-07-10T22:00:00-04:00,20877.25,20887.75,20867.25,20869,20669.615934117614,NaN,NaN,NaN,NaN,NaN,20424.275,21024.370836096045,19824.17916390396,20739.910264344526,20876.022361245432,20877.070898532253,20874.97382395861,18577,154557.7,75.63389657331822,75.43166165312392,NaN,NaN,NaN,NaN,64.55593300549143,53.24782355930542,10714991,1.9992311229902953,118.24972893136874,116.25049780837844
2024-07-11T02:00:00-04:00,20869,20891.75,20867.75,20882.75,20678.042482566812,NaN,NaN,NaN,NaN,NaN,20441.11,21044.471675614197,19837.748324385804,20761.47821147562,20877.889207916767,20880.339911539308,20875.438504294227,32388,155184.4,76.41380623760612,75.14034779887315,NaN,NaN,NaN,NaN,61.65908064795632,54.14030069804274,10747379,1.0126532951482687,117.51631442731377,116.5036611321655
2024-07-11T06:00:00-04:00,20882.75,20983.5,20822.25,20869.5,20688.347369722866,NaN,NaN,NaN,NaN,NaN,20459.16,21058.694083768358,19859.625916231642,20798.657569180497,20889.29698478457,20894.686451694997,20883.907517874144,381435,167112.43333333332,73.95719456693217,74.62844258441224,NaN,NaN,NaN,NaN,68.77271774453087,55.479154709026346,10365944,-1.5665252187513374,114.54550460872633,116.11202982747767
2024-07-11T10:00:00-04:00,20869.25,20872,20385.75,20391,NaN,NaN,NaN,20899.958192537266,20899.958192537266,20899.958192537266,20467.18,21051.942011762018,19882.417988237983,20798.657569180497,20653.69641623149,20810.342525182336,20497.050307280646,1048766,201197.96666666667,32.86543198602307,71.13673664919146,NaN,NaN,NaN,NaN,98.59252361992152,52.68809521197283,9317178,-34.69630785260047,72.74164501172709,107.43795286432756
2024-07-11T14:00:00-04:00,20391,20494,20376.25,20433.5,NaN,NaN,NaN,20709.943047421933,NaN,NaN,20475.695,21045.661019074712,19905.728980925287,20798.657569180497,20619.096987135083,20783.557787310456,20454.63618695971,283567,209102.46666666667,36.25327953933433,67.85828805293325,NaN,NaN,NaN,NaN,99.96091478992712,50.167812976674696,9600745,-51.90981658229863,42.55068213645427,94.4604987187529
2024-07-11T18:00:00-04:00,20430.75,20459,20403.5,20429.75,NaN,NaN,NaN,20701.144499811846,NaN,NaN,20485.575,21034.497975015518,19936.652024984483,20798.657569180497,20430.75,20430.75,20430.75,47059,209930.1,36.08026825114076,65.67788633080872,NaN,NaN,NaN,NaN,96.78513516207518,47.82755090104071,9553686,-61.07820658605834,18.112740486179973,79.19094707223832
2024-07-11T22:00:00-04:00,20430,20433,20372,20418,NaN,NaN,NaN,20668.4447498204,NaN,NaN,20496.23,21018.14610283651,19974.31389716349,20798.657569180497,20419.869987268063,20431.392672873168,20408.347301662958,41956,210648.96666666667,35.50846020506812,63.3145903067026,NaN,NaN,NaN,NaN,94.22905407906981,45.913866272613355,9511730,-65.09478160108833,-2.1775299291221017,62.91725167196623
2024-07-12T02:00:00-04:00,20418.25,20448,20380.5,20435.5,NaN,NaN,NaN,20668.4447498204,NaN,NaN,20504.95,21007.59108467146,20002.30891532854,20798.657569180497,20420.474989072445,20429.329285914326,20411.620692230565,62742,210703.33333333334,37.10715876794144,60.995788258723216,NaN,NaN,NaN,NaN,92.31983593056484,43.9462246865428,9574472,-63.656712447802306,-16.653638887786656,47.00307356001565
2024-07-12T06:00:00-04:00,20435.25,20549.5,20332.25,20542.5,NaN,NaN,NaN,20668.4447498204,NaN,NaN,20514.95,20999.97789610465,20029.92210389535,20798.657569180497,20456.21797786643,20482.469811925832,20429.966143807025,292696,211114.6,45.93248311059171,59.36415100043734,NaN,NaN,NaN,NaN,101.24341907838163,40.948577823575874,9867168,-53.018396529368964,-19.269922101695556,33.74847442767341
2024-07-12T10:00:00-04:00,20542.5,20741,20522,20710,20333.668169789,20333.668169789,20333.668169789,NaN,NaN,NaN,20529.39,20993.337692741396,20065.442307258603,20798.657569180497,20576.633246614198,20676.80748242582,20476.459010802577,660455,214641.93333333332,56.27593904596828,58.30800260893495,NaN,NaN,NaN,NaN,109.6546034299258,39.48152550542443,10527623,-33.189413965187775,-7.738293028811313,25.451120936376462
2024-07-12T14:00:00-04:00,20710.25,20723.75,20510,20539.75,20333.668169789,NaN,NaN,NaN,NaN,NaN,20539.975,20979.597716087523,20100.352283912474,20798.657569180497,20579.767972999063,20668.684662030337,20490.85128396779,303858,218822.43333333332,46.53193697059966,56.377597318924536,NaN,NaN,NaN,NaN,117.0899888992168,37.99369796866578,10223765,-30.118138198571337,-12.196551811837708,17.92158638673363
2024-07-14T18:00:00-04:00,20578.75,20592.25,20506.25,20574.25,20333.668169789,NaN,NaN,NaN,NaN,NaN,20552.34,20959.118069221946,20145.561930778054,20798.657569180497,20557.583333333332,20557.583333333332,20557.583333333332,55591,219298.2,48.47872158734251,54.17247735105514,NaN,NaN,NaN,NaN,114.8692754064156,36.570707005387234,10279356,-24.575957756770144,-12.798360809229052,11.777596947541092
2024-07-14T22:00:00-04:00,20575,20613.5,20559.5,20609.25,20333.668169789,NaN,NaN,NaN,NaN,NaN,20563.25,20945.55062777869,20180.94937222131,20481.001055344397,20570.46613610351,20587.9090628623,20553.02320934472,30324,219674.86666666667,50.449793877625595,52.04183192641865,NaN,NaN,NaN,NaN,110.52147002024306,35.4189047544673,10309680,-17.68766997988027,-10.331990527309244,7.3556794525710245
2024-07-15T02:00:00-04:00,20608.75,20632.75,20597.25,20624.5,20333.668169789,NaN,NaN,NaN,NaN,NaN,20571.565,20940.51447906193,20202.615520938067,20374.227412652202,20586.56822813862,20613.22062367184,20559.915832605402,43781,219463.9,51.32361140962405,50.20085586636545,NaN,NaN,NaN,NaN,105.16279359022569,34.505570883482264,10353461,-11.536848714073745,-7.065381440021156,4.471467274052588
2024-07-15T06:00:00-04:00,20624.25,20665.5,20581.5,20627.75,20333.668169789,NaN,NaN,NaN,NaN,NaN,20579.315,20936.18253578898,20222.447464211018,20406.043958577873,20613.63729466682,20636.31451599718,20590.96007333646,311254,222372.33333333334,51.51982886236682,48.47842245844034,NaN,NaN,NaN,NaN,103.65116547663813,33.922443292783875,10664715,-6.910210538749142,-4.16629589938384,2.743914639365302
2024-07-15T10:00:00-04:00,20627.5,20796.5,20556.25,20569.25,20363.735085383578,NaN,NaN,NaN,NaN,NaN,20585.91,20929.349408920927,20242.470591079073,20468.8101668623,20630.65862941818,20649.6523498562,20611.66490898016,749953,229777.83333333334,47.78581863660386,46.4335662012259,NaN,NaN,NaN,NaN,113.40822508544969,34.2816204034013,9914762,-7.40642778764227,-6.514120095187536,0.8923076924547344
2024-07-15T14:00:00-04:00,20569.5,20643.25,20506.25,20626,20363.735085383578,NaN,NaN,NaN,NaN,NaN,20593.465,20923.206944708487,20263.723055291513,20468.8101668623,20623.255869094177,20646.15977891417,20600.351959274183,280562,232398.7,51.46106154669152,44.826699556923,NaN,NaN,NaN,NaN,115.09335186506043,33.96268829925862,10195324,-3.715672540006891,-3.7522829825538793,-0.03661044254698831
2024-07-15T18:00:00-04:00,20625,20647,20618.75,20633.25,20363.735085383578,NaN,NaN,NaN,NaN,NaN,20600.725,20917.40798422901,20284.04201577099,20468.8101668623,20633,20633,20633,29832,231449.7,51.92660390544932,46.18821183688202,NaN,NaN,NaN,NaN,108.8902553032704,33.69301407127785,10225156,-0.7445851250999558,-0.967341848921933,-0.22275672382197725
2024-07-15T22:00:00-04:00,20633.25,20655,20632.75,20640.5,20363.735085383578,NaN,NaN,NaN,NaN,NaN,20608.02,20910.927755595836,20305.112244404165,20468.8101668623,20637.525810043826,20642.388287947215,20632.663332140437,25844,231328.13333333333,52.4180723564165,47.342839895245035,NaN,NaN,NaN,NaN,102.70166563875107,33.50238484697714,10251000,1.6213761828690993,1.803963504764397,0.18258732189529764
2024-07-16T02:00:00-04:00,20640.75,20641.75,20541.5,20600.75,20363.735085383578,NaN,NaN,NaN,NaN,NaN,20611.655,20909.725795114555,20313.584204885443,20468.8101668623,20611.376813421008,20632.499594890174,20590.25403195184,87125,232885.83333333334,49.43405796713263,48.29668201781588,NaN,NaN,NaN,NaN,102.52654666455456,32.12406046933493,10163875,0.480902925203293,0.7837159783994139,0.3028130531961209
2024-07-16T06:00:00-04:00,20600,20684,20566.75,20581.25,20363.735085383578,NaN,NaN,NaN,NaN,NaN,20615.145,20907.570291142853,20322.71970885715,20468.8101668623,20610.909788267825,20623.273537276436,20598.546039259214,274314,234835.5,47.99074820302494,49.18827401766993,NaN,NaN,NaN,NaN,103.57822190280066,31.212823089106234,9889561,-1.5063384773060442,-1.5801100434364344,-0.07377156613039015
2024-07-16T10:00:00-04:00,20580.25,20608.5,20464,20525.5,20363.735085383578,NaN,NaN,NaN,NaN,NaN,20617.5,20905.062601880007,20329.937398119993,20468.8101668623,20560.376253996503,20598.512839349474,20522.23966864353,760686,237239.76666666666,44.03251211394998,49.682942113813404,NaN,NaN,NaN,NaN,106.50120605260062,29.206230387210987,9128875,-6.230100333597795,-7.861396983127634,-1.6312966495298389
2024-07-16T14:00:00-04:00,20525.5,20614.5,20485.5,20587.5,20363.735085383578,NaN,NaN,NaN,NaN,NaN,20621.215,20902.25805737766,20340.17194262234,20468.8101668623,20560.746798688568,20595.406424741035,20526.0871726361,248932,238897.03333333333,49.06404301780045,49.90662496432831,NaN,NaN,NaN,NaN,108.10826276312915,27.401691046424414,9377807,-4.8927032195453,-7.747175673961465,-2.854472454416164
2024-07-16T18:00:00-04:00,20592,20597.75,20546.75,20550.75,20363.735085383578,NaN,NaN,NaN,NaN,NaN,20624.535,20898.14983896174,20350.92016103826,20468.8101668623,20565.083333333332,20565.083333333332,20565.083333333332,34481,239251.06666666668,46.40120976655892,49.20128715865621,NaN,NaN,NaN,NaN,104.02910113719135,25.726047372836884,9343326,-6.117240495370883,-10.501023073629767,-4.383782578258884
2024-07-16T22:00:00-04:00,20551,20563.75,20506.75,20509.25,20363.735085383578,NaN,NaN,NaN,NaN,NaN,20627.09,20893.88006278371,20360.29993721629,20468.8101668623,20544.382304962637,20563.577539179674,20525.1870707456,40103,239954.1,43.52826403241374,48.98673909164294,NaN,NaN,NaN,NaN,100.66987962739196,24.064009670676786,9303223,-9.1725478210592,-15.849467354582885,-6.676919533523685
2024-07-17T02:00:00-04:00,20509.5,20513.75,20307.75,20343.5,NaN,NaN,NaN,20720.744732899355,20720.744732899355,20720.744732899355,20625.83,20897.328903128306,20354.331096871698,20435.487995477437,20437.72586127874,20511.106070951195,20364.345651606287,161054,244064.2,34.3740852045011,47.97926506429712,NaN,NaN,NaN,NaN,108.19345965400682,24.249013716468326,9142169,-21.12362072486576,-33.081445439605886,-11.957824714740125
2024-07-17T06:00:00-04:00,20343,20367.75,20206.5,20209,NaN,NaN,NaN,20605.017699585747,NaN,NaN,20621.42,20912.02282930531,20330.817170694685,20435.487995477437,20330.384311319485,20428.115575669475,20232.653046969495,364984,249041.1,29.037528539769852,46.44981754016457,NaN,NaN,NaN,NaN,111.98321253586347,25.047685692604933,8777185,-35.981445164789335,-56.93463117072679,-20.953186005937457
2024-07-17T10:00:00-04:00,20209,20212.75,20008.25,20031.25,NaN,NaN,NaN,20441.82939505912,NaN,NaN,20613.395,20943.851034745698,20282.938965254303,20435.487995477437,20185.310638345916,20321.732591874217,20048.888684817615,860780,258429.9,23.782654491181503,44.48260633170439,NaN,NaN,NaN,NaN,118.59155449758751,26.718549345373084,7916405,-54.56039841416816,-89.15368402364766,-34.593285609479494
2024-07-17T14:00:00-04:00,20031.75,20074.5,19965.75,20017,NaN,NaN,NaN,20351.223513465528,NaN,NaN,20603.455,20972.874256265506,20234.035743734497,20435.487995477437,20155.587836845618,20294.657803830392,20016.517869860843,318209,262745.43333333335,23.416790249067233,42.47524643075441,NaN,NaN,NaN,NaN,117.8885863191884,28.43375846044807,7598196,-63.939201462863366,-114.5172874380587,-50.578085975195336
2024-07-17T18:00:00-04:00,20024.25,20080.5,20024.25,20070.25,NaN,NaN,NaN,20351.223513465528,NaN,NaN,20592.375,20990.733547667838,20194.016452332162,20435.487995477437,20058.333333333332,20058.333333333332,20058.333333333332,47261,263285.63333333336,27.88152444036413,41.053511131023,NaN,NaN,NaN,NaN,114.00368729638923,29.954185472966486,7645457,-62.60645356735222,-128.8361529343856,-66.22969936703339
2024-07-17T22:00:00-04:00,20070.75,20078.25,20024.5,20076,NaN,NaN,NaN,20351.223513465528,NaN,NaN,20582.09,21005.879449608932,20158.300550391068,20347.17185368445,20058.87437295987,20059.493707779064,20058.255038140673,36067,263868.63333333336,28.367156279116557,39.40394646905336,NaN,NaN,NaN,NaN,109.6998524895043,31.3660105560193,7681524,-57.518424163859166,-138.12772957185734,-80.60930540799818
2024-07-18T02:00:00-04:00,20075.5,20162.75,20035.75,20062.5,NaN,NaN,NaN,20351.223513465528,NaN,NaN,20571.46,21019.491319887686,20123.428680112313,20347.17185368445,20076.69569542393,20090.25212799712,20063.13926285074,144116,267592.9,27.89226412957113,37.687207913633486,NaN,NaN,NaN,NaN,110.93557731168256,31.62038828328764,7537408,-51.4407738769945,-144.9102727542413,-93.4694988772468
2024-07-18T06:00:00-04:00,20061.75,20162.5,20018.5,20068,NaN,NaN,NaN,20351.223513465528,NaN,NaN,20561.13,21030.778147446614,20091.48185255339,20347.17185368445,20080.342774186734,20089.678294298446,20071.007254075023,312170,265284.06666666665,28.418034865965183,35.972919521458394,NaN,NaN,NaN,NaN,113.29732178941951,31.95540967628036,7849578,-43.73166932185657,-148.13408552956753,-104.40241620771096
2024-07-18T10:00:00-04:00,20068,20107,19772.75,19873.25,NaN,NaN,NaN,20295.92735723914,NaN,NaN,20546.36,21053.652905134404,20039.067094865597,20334.78748294756,19973.739825003282,20051.248564036992,19896.23108596957,1025882,264521.26666666666,22.23556308152135,34.03016988677187,NaN,NaN,NaN,NaN,129.07965594731812,33.38536225158191,6823696,-48.083938696450986,-164.5073395782747,-116.42340088182371
2024-07-18T14:00:00-04:00,19873.5,19961,19758.75,19933.25,NaN,NaN,NaN,20227.32270463736,NaN,NaN,20532.325,21067.11646636788,19997.533533632122,20227.579986358047,19954.551844526333,20032.434021951074,19876.669667101592,427789,269328.6666666667,27.470835017543806,32.564461802094655,NaN,NaN,NaN,NaN,134.30610909393826,34.76416646921084,7251485,-43.400747549938544,-170.6743353192469,-127.27358776930835
2024-07-18T18:00:00-04:00,19950,19976.75,19935.25,19947.75,NaN,NaN,NaN,20227.32270463736,NaN,NaN,20518.205,21076.20421765153,19960.205782348472,20058.188989086437,19953.25,19953.25,19953.25,43759,269218.6666666667,28.7197386594503,31.470692269630394,NaN,NaN,NaN,NaN,127.81995844437124,35.851546985966415,7295244,-36.10459003423179,-172.40432531209808,-136.2997352778663
2024-07-18T22:00:00-04:00,19948,19963.25,19936,19963.25,NaN,NaN,NaN,20227.32270463736,NaN,NaN,20503.775,21080.792549559646,19926.757450440356,19886.271447943844,19953.538536120683,19953.964257031195,19953.11281521017,20101,268490.1666666667,30.1052471995674,30.11649256832803,NaN,NaN,NaN,NaN,120.636389984059,36.86125746581088,7315345,-27.407045125471882,-170.55854168470614,-143.15149655923426
2024-07-19T02:00:00-04:00,19963.25,19979.5,19752,19850.75,NaN,NaN,NaN,20225.308808475453,NaN,NaN,20486.565,21088.591725403538,19884.53827459646,19886.271447943844,19885.17427605528,19926.037404501956,19844.311147608605,178746,272356.9666666667,26.134600094868546,28.66887759177872,NaN,NaN,NaN,NaN,128.26950498519764,38.489536268012124,7136599,-26.393272193205405,-176.143086800741,-149.7498146075356
2024-07-19T06:00:00-04:00,19849.75,19976.75,19836,19883.75,NaN,NaN,NaN,20225.308808475453,NaN,NaN,20469.725,21090.849747937435,19848.600252062563,19886.271447943844,19893.255592576632,19920.217497132024,19866.29368802124,351500,274317.1,29.089062190931756,27.63750603167287,NaN,NaN,NaN,NaN,129.16096891482638,40.001509441484714,7488099,-20.90305663708591,-175.87863540389299,-154.97557876680708
2024-07-19T10:00:00-04:00,19883.75,19917,19654,19721,NaN,NaN,NaN,20167.298934995193,NaN,NaN,20449.345,21099.835444895136,19798.854555104866,19886.271447943844,19815.02959118216,19880.442400119988,19749.61678224433,910737,282659.8333333333,23.992235894828042,26.89594536669623,NaN,NaN,NaN,NaN,138.7208997066245,41.92859711959821,6577362,-25.339565137023044,-186.6500351880859,-161.31047005106285
2024-07-19T14:00:00-04:00,19720.5,19784.75,19669.5,19701.5,NaN,NaN,NaN,20107.285347040866,NaN,NaN,20428.395,21105.846497083003,19750.943502916998,19886.271447943844,19799.06055030881,19868.742064945294,19729.37903567233,298605,282484.73333333334,23.461803782413497,26.49767931259935,NaN,NaN,NaN,NaN,137.04440687043703,43.71803567784646,6278757,-26.56574851964848,-194.51765570062344,-167.95190718097496
2024-07-21T18:00:00-04:00,19747.75,19841.25,19727,19745.25,NaN,NaN,NaN,20107.285347040866,NaN,NaN,20410.09,21110.536562986745,19709.643437013256,19869.317158355076,19771.166666666668,19771.166666666668,19771.166666666668,101755,284023.5333333333,27.34299217332125,26.751989147037897,NaN,NaN,NaN,NaN,137.23766352254867,44.64793594497885,6380512,-21.618467802946213,-194.97499193465774,-173.35652413171152
2024-07-21T22:00:00-04:00,19746,19808.25,19718.75,19787.75,NaN,NaN,NaN,20107.285347040866,NaN,NaN,20392.085,21109.116739953097,19675.0532600469,19705.32872668406,19771.348071665852,19771.55465748463,19771.141485847074,78461,285628.1,31.00324210217579,27.293878565117076,NaN,NaN,NaN,NaN,133.8278304137952,45.54094181864883,6458973,-13.091623237502375,-189.7210531785895,-176.62942994108712
2024-07-22T02:00:00-04:00,19787.75,19853,19757.75,19846.75,NaN,NaN,NaN,20107.285347040866,NaN,NaN,20374.985,21102.367089482475,19647.602910517526,19661.84930806224,19788.112650116873,19810.930082317773,19765.295217915973,97290,287411.73333333334,35.8357660074052,27.86203867704858,NaN,NaN,NaN,NaN,131.0722710985241,45.77675790964834,6556263,-1.685338770895271,-178.73610340470623,-177.05076463381096
2024-07-22T06:00:00-04:00,19847,20026.75,19837.25,19970.5,NaN,NaN,NaN,20107.285347040866,NaN,NaN,20360.455,21090.546348325483,19630.36365167452,19669.920746888107,19874.01492531035,19953.50533504294,19794.524515577756,336613,288257.0333333333,44.60033118130301,29.021551170061894,NaN,NaN,NaN,NaN,135.2456803057724,44.0711001779639,6892876,15.063821522171878,-158.2209877310961,-173.28480925326798
2024-07-22T10:00:00-04:00,19970.25,20018.5,19809,19999.5,NaN,NaN,NaN,20107.285347040866,NaN,NaN,20345.895,21075.162249298788,19616.627750701213,19669.920746888107,19913.70296258967,19975.219526526584,19852.186398652753,851305,291635.43333333335,46.44646417746246,30.3468511734827,NaN,NaN,NaN,NaN,140.5495602839315,42.65867528591762,7744181,28.202717072247708,-138.03141291295833,-166.23412998520604
2024-07-22T14:00:00-04:00,19999.75,20044.25,19964.25,19982,NaN,NaN,NaN,20107.285347040866,NaN,NaN,20330.255,21056.520037641105,19603.989962358897,19692.07927800839,19924.991852160914,19988.877701157282,19861.106003164547,230271,289959.06666666665,45.46193527622505,31.56427263135841,NaN,NaN,NaN,NaN,136.2245916922221,41.0872135922855,7513910,35.35820494358853,-122.03637380572036,-157.3945787493089
2024-07-22T18:00:00-04:00,19982,19998.25,19924.5,19955.5,NaN,NaN,NaN,20107.285347040866,NaN,NaN,20311.88,21028.588589595332,19595.17141040467,19692.07927800839,19959.416666666668,19959.416666666668,19959.416666666668,49972,290630.4,43.94293659639381,33.114799310992154,NaN,NaN,NaN,NaN,131.7621208570634,39.891022062155315,7463938,37.733358826009805,-110.22788021679662,-147.96123904280643
2024-07-22T22:00:00-04:00,19955.5,19959.5,19912,19932,NaN,NaN,NaN,20107.285347040866,NaN,NaN,20292.595,20997.158126270446,19588.031873729557,19692.07927800839,19948.642037215817,19960.986072646032,19936.298001785603,38073,291038.0333333333,42.5841109549807,34.194319020809075,NaN,NaN,NaN,NaN,125.74339793870172,38.86389844904973,7425865,37.093233517381265,-101.59469714607985,-138.68793066346112
2024-07-23T02:00:00-04:00,19931.5,19971,19868.25,19958.5,NaN,NaN,NaN,20107.285347040866,NaN,NaN,20274.215,20964.5905138329,19583.8394861671,19696.713590340296,19940.14678296253,19951.80955515221,19928.48401077285,98892,291430.26666666666,44.66217735024581,35.33306464158019,NaN,NaN,NaN,NaN,124.10101237165159,38.20336533286188,7524757,37.70308626241106,-91.5590728354473,-129.26215909785836
2024-07-23T06:00:00-04:00,19959.25,20033.75,19924,20006.5,NaN,NaN,NaN,20107.285347040866,NaN,NaN,20256.965,20929.913935729983,19584.016064270018,19759.445872272237,19969.92114466329,19994.2584184671,19945.583870859482,306457,292501.7,48.311413968932605,36.633505125106275,NaN,NaN,NaN,NaN,123.07594005939076,36.86372256322687,7831214,40.350578358681034,-78.82393614950706,-119.1745145081881
2024-07-23T10:00:00-04:00,20006.5,20085,19915.5,19979.5,NaN,NaN,NaN,20107.285347040866,NaN,NaN,20238.9,20891.88184507685,19585.918154923154,19780.80669781779,19984.41608254986,20003.25359133581,19965.578573763905,802009,293879.13333333336,46.455637796891274,38.0850078181079,NaN,NaN,NaN,NaN,126.39194434086285,35.069064781303524,7029205,39.258145497730894,-70.10183263602448,-109.35997813375538
2024-07-23T14:00:00-04:00,19979,20000,19903,19944.75,NaN,NaN,NaN,20107.285347040866,NaN,NaN,20220.405,20852.960498672022,19587.849501327975,19780.80669781779,19978.49602299745,20000.135157990127,19956.85688800477,262219,294322.0333333333,44.10729240651301,39.15773854779228,NaN,NaN,NaN,NaN,124.29251974508693,33.507698286544404,6766986,35.294803114425406,-65.24147424072362,-100.53627735514902
2024-07-23T18:00:00-04:00,19886.75,19886.75,19786,19814.75,NaN,NaN,NaN,20107.285347040866,NaN,NaN,20208.88,20849.529219463944,19568.230780536058,19780.80669781779,19829.166666666668,19829.166666666668,19829.166666666668,74328,295650.26666666666,36.64443987311051,40.06146740338387,NaN,NaN,NaN,NaN,126.75376833472357,32.94974196002597,6692658,23.58071874378315,-71.06037892542008,-94.64109766920323
2024-07-23T22:00:00-04:00,19815,19823.5,19721.5,19763.5,NaN,NaN,NaN,20107.285347040866,NaN,NaN,20195.48,20844.74567628382,19546.21432371618,19780.80669781779,19804.178844274153,19833.616045254228,19774.741643294077,53557,296098.73333333334,34.1885423198987,40.827663013204244,NaN,NaN,NaN,NaN,124.98564202510046,32.8492893583142,6639101,12.594586909350653,-78.89786403251492,-91.49245094186557
2024-07-24T02:00:00-04:00,19763.5,19775.75,19681.5,19717,NaN,NaN,NaN,20093.080630880086,NaN,NaN,20181.225,20840.51094137908,19521.939058620916,19780.80669781779,19765.34806537092,19810.28545767921,19720.41067306263,122318,294807.5333333333,32.08728655469433,41.16654118330233,NaN,NaN,NaN,NaN,122.79023902330756,33.0001622109745,6516783,2.9150610982603666,-87.84862456904011,-90.76368566730048
2024-07-24T06:00:00-04:00,19717.25,19749,19501,19512.25,NaN,NaN,NaN,20006.707647658266,NaN,NaN,20163.11,20844.771610771782,19481.44838922822,19780.80669781779,19657.52881365675,19748.93533498109,19566.12229233241,384765,295466.9,24.84606814895784,40.726743043786755,NaN,NaN,NaN,NaN,131.7337933787856,34.04738334263972,6132018,-15.543881945935752,-110.19353809972017,-94.64965615378442
2024-07-24T10:00:00-04:00,19512,19523.5,19308,19320,NaN,NaN,NaN,19809.4936636738,NaN,NaN,20140.8,20857.46077051844,19424.13922948156,19780.80669781779,19509.430646425633,19659.213369385383,19359.647923465884,748723,291731.6666666667,20.229745161766502,39.61202726909828,NaN,NaN,NaN,NaN,137.7170938517295,35.70608468018817,5383295,-37.70479688105246,-141.7806522551,-104.07585537404753
2024-07-24T14:00:00-04:00,19320,19331,19166.5,19269.75,NaN,NaN,NaN,19647.028042597718,NaN,NaN,20115.345,20862.874296348746,19367.815703651257,19780.80669781779,19449.91589400194,19619.407095927243,19280.424692076638,424122,295262.1,19.224332862622177,37.799455960621074,NaN,NaN,NaN,NaN,139.63015857660596,37.63269291310171,4959173,-51.876279177113204,-168.92120434543904,-117.04492516832583
2024-07-24T18:00:00-04:00,19258,19304.75,19246,19256.25,NaN,NaN,NaN,19647.028042597718,NaN,NaN,20086.27,20851.88935607714,19320.65064392286,19780.80669781779,19269,19269,19269,66566,295905.6,18.95181994768471,35.83555280135124,NaN,NaN,NaN,NaN,133.8530043925627,39.42168627223569,4892607,-57.83371167778529,-189.33706476555744,-131.50335308777215
2024-07-24T22:00:00-04:00,19256.75,19284,19215.75,19234.75,NaN,NaN,NaN,19629.72286525949,NaN,NaN,20060.17,20850.741650389908,19269.59834961009,19780.80669781779,19256.825597807314,19268.90858795744,19244.742607657186,67577,296955.93333333335,18.50199479007631,33.90984276662633,NaN,NaN,NaN,NaN,129.16707550737965,41.16401936653683,4825030,-58.70916502649021,-204.8898093708849,-146.1806443443947
2024-07-25T02:00:00-04:00,19235.25,19275,19062,19143.75,NaN,NaN,NaN,19560.127507747697,NaN,NaN,20031.56,20848.73390780653,19214.386092193472,19708.14535825423,19193.508473611742,19239.942400547574,19147.07454667591,255380,300664.73333333334,16.695713368508436,31.963612536063092,NaN,NaN,NaN,NaN,135.1551415425668,43.1509595425716,4569650,-60.65495715847214,-221.99934079248487,-161.34438363401273
2024-07-25T06:00:00-04:00,19143.25,19245,19016.5,19031.25,NaN,NaN,NaN,19535.735348304617,NaN,NaN,20000,20846.841549523815,19153.158450476185,19573.891286603386,19139.34216220636,19195.91543336056,19082.768891052165,505259,307101.0333333333,14.775283324323738,29.97726770530188,NaN,NaN,NaN,NaN,141.82263143238347,45.09241151244363,4064391,-64.40345012055712,-241.84869628470915,-177.44524616415202
2024-07-25T10:00:00-04:00,19031.75,19390.5,18883.5,19290,NaN,NaN,NaN,19535.735348304617,NaN,NaN,19973.31,20823.85051379098,19122.76948620902,19522.21302928271,19166.396554905205,19211.17896072426,19121.61414908615,1120552,310256.7,33.67256151307315,29.19229514550383,NaN,NaN,NaN,NaN,167.90672918721322,45.30924384738867,5184943,-45.24624266105542,-234.0030494904713,-188.7568068294159
2024-07-25T14:00:00-04:00,19289.75,19294.75,18940.5,18994.75,NaN,NaN,NaN,19535.735348304617,NaN,NaN,19940.65,20813.28709524622,19068.01290475378,19487.595423426166,19149.95869541487,19203.277000174232,19096.640390655506,451997,311063.63333333336,26.462241372368382,27.63163996003496,NaN,NaN,NaN,NaN,181.216962816698,45.51058815840906,4732946,-47.98829882086207,-248.74218035549347,-200.7538815346314
2024-07-25T18:00:00-04:00,19000.25,19084.75,18994.75,19080.75,NaN,NaN,NaN,19513.360143749913,NaN,NaN,19910.88,20797.160820282137,19024.599179717865,19394.476338740933,19053.416666666668,19053.416666666668,19053.416666666668,58348,311549.93333333335,31.090830562465655,26.53415372900456,NaN,NaN,NaN,NaN,174.70146547264812,45.697550732927986,4791294,-39.87278667254952,-250.5948648753183,-210.72207820276878
2024-07-25T22:00:00-04:00,19080.75,19116.25,19057.25,19066.25,NaN,NaN,NaN,19513.360143749913,NaN,NaN,19879.685,20772.85992021419,18986.510079785814,19132.131070992746,19066.050324039614,19079.28598125173,19052.814666827497,53161,312651.93333333335,30.73952131439961,25.579312936710746,NaN,NaN,NaN,NaN,166.4370750817447,45.5109216886353,4738133,-31.700186679238783,-250.34731155181726,-218.64712487257847
2024-07-26T02:00:00-04:00,19066.25,19221.5,19064.25,19192.75,NaN,NaN,NaN,19513.360143749913,NaN,NaN,19850.875,20737.87157975659,18963.87842024341,18973.354108348285,19115.224792903267,19162.76644807792,19067.683137728614,123848,310822,37.3866129050567,25.63232529613547,NaN,NaN,NaN,NaN,165.78085543304863,44.222173379930275,4861981,-14.849684590864427,-237.209230611159,-222.35954602029457
2024-07-26T06:00:00-04:00,19193,19237.25,19060.5,19134,NaN,NaN,NaN,19513.360143749913,NaN,NaN,19820.745,20700.72445140803,18940.765548591968,18973.354108348285,19132.58601016143,19165.59038972397,19099.581630598892,360622,311126.06666666665,35.6742227484674,25.738445326747517,NaN,NaN,NaN,NaN,166.56436575925946,42.868105460570504,4501359,-5.231749539072581,-228.8992329441353,-223.6674834050627
2024-07-26T10:00:00-04:00,19101.75,19299,19040.75,19194.5,NaN,NaN,NaN,19513.360143749913,NaN,NaN,19792.62,20660.895170899395,18924.344829100603,18973.354108348285,19159.69229737074,19190.33259300264,19129.05200173884,878405,310048.3333333333,38.78368965087457,26.216759833617534,NaN,NaN,NaN,NaN,173.1133396335981,41.002190017592575,5379764,6.970945189725882,-214.95380191790537,-221.92474710763125
2024-07-26T14:00:00-04:00,19194.75,19221.75,19104.5,19175.75,NaN,NaN,NaN,19513.360143749913,NaN,NaN,19764.51,20619.745867816753,18909.274132183244,18919.983286678627,19161.14490961202,19188.881882119767,19133.40793710427,346083,311630.93333333335,38.167903688449385,27.168319515009784,NaN,NaN,NaN,NaN,169.1231010883411,39.269554249113064,5033681,15.080593735565174,-203.07400493817477,-218.15459867373994
2024-07-28T18:00:00-04:00,19172.75,19330.25,19168,19293.5,NaN,NaN,NaN,19513.360143749913,NaN,NaN,19739.87,20576.780653773876,18902.959346226122,18887.539107884782,19263.916666666668,19263.916666666668,19263.916666666668,88838,311200.36666666664,44.16363454768904,28.877883042575682,NaN,NaN,NaN,NaN,168.63216529631674,36.64558148601994,5122519,28.87641843957232,-182.05907562427456,-210.93549406384687
2024-07-28T22:00:00-04:00,19294.75,19328.5,19285,19311.5,NaN,NaN,NaN,19513.360143749913,NaN,NaN,19714.35,20523.680772923028,18905.01922707697,18952.581286307824,19277.238376491354,19297.59121393893,19256.88553904378,38060,309853.6666666667,45.04096564836613,30.72192824155739,NaN,NaN,NaN,NaN,159.69415348943699,34.20903534886204,5160579,39.081401107942696,-162.0837426789185,-201.1651437868612
2024-07-29T02:00:00-04:00,19311.5,19335,19219,19268.75,NaN,NaN,NaN,19513.360143749913,NaN,NaN,19688.71,20471.209976741313,18906.210023258685,18976.265029046262,19275.971523871784,19291.48965388844,19260.45339385513,93383,309723.43333333335,43.30079996058094,32.46114109962141,NaN,NaN,NaN,NaN,156.57314252590575,32.497112982454716,5067196,42.534754004731695,-147.99670128094658,-190.53145528567828
2024-07-29T06:00:00-04:00,19269.25,19368,19222.5,19358.25,NaN,NaN,NaN,19513.360143749913,NaN,NaN,19665.69,20417.394706384264,18913.985293615733,19008.26202323701,19300.458551952444,19322.392492325587,19278.5246115793,341579,309888.9666666667,47.84397040960216,34.55699650101611,NaN,NaN,NaN,NaN,155.78220377405538,30.58583699625182,5408775,49.91822642786593,-128.13367225084585,-178.05189867871178
2024-07-29T10:00:00-04:00,19358.5,19377.25,19113,19255,NaN,NaN,NaN,19513.360143749913,NaN,NaN,19643.92,20378.701208524228,18909.13879147577,19008.26202323701,19268.470224885034,19297.225460264865,19239.714989505203,896248,311387.06666666665,43.512386687405325,36.472473166651596,NaN,NaN,NaN,NaN,163.52990350448,29.668634321372817,4512527,46.963339369716266,-119.34772446656643,-166.3110638362827
2024-07-29T14:00:00-04:00,19255,19267.25,19184,19221.75,NaN,NaN,NaN,19513.360143749913,NaN,NaN,19624.175,20350.161867994266,18898.188132005733,19008.26202323701,19261.600446813758,19292.49027468418,19230.710618943336,268786,312670.9,42.18776372994035,38.4305074813385,NaN,NaN,NaN,NaN,157.79562468273141,28.81694612327088,4243741,42.04366645541555,-113.75648076701327,-155.80014722242882
2024-07-29T18:00:00-04:00,19220,19234.5,19094,19107.75,NaN,NaN,NaN,19513.360143749913,NaN,NaN,19605.705,20336.30143230699,18875.108567693012,19008.26202323701,19145.416666666668,19145.416666666668,19145.416666666668,64452,313153.56666666665,37.92489777762838,38.73424578594959,NaN,NaN,NaN,NaN,156.56022291967915,28.662193439858275,4179289,30.901298840560173,-117.17352367172862,-148.0748225122888
2024-07-29T22:00:00-04:00,19108.25,19208,19076.25,19203,NaN,NaN,NaN,19513.360143749913,NaN,NaN,19589.425,20318.912225727738,18859.93777427226,19008.26202323701,19153.82333626135,19162.322823856328,19145.323848666372,63052,313986.2,43.098398099414595,39.92254269502432,NaN,NaN,NaN,NaN,154.78806413970207,28.636262783996326,4242341,29.726183906384506,-110.91709262930817,-140.64327653569268
2024-07-30T02:00:00-04:00,19202.5,19265.25,19185,19226,NaN,NaN,NaN,19513.360143749913,NaN,NaN,19572.54,20295.784083003713,18849.29591699629,19008.26202323701,19181.63918835534,19217.16216050369,19146.116216206992,81015,313390.3,44.30545361037218,40.86644434130336,NaN,NaN,NaN,NaN,149.4639167011519,27.948492239408278,4323356,30.18137312438745,-102.91656013020838,-133.09793325459583
2024-07-30T06:00:00-04:00,19226.25,19319.25,19206.75,19224.75,NaN,NaN,NaN,19513.360143749913,NaN,NaN,19555.515,20270.582461223144,18840.447538776854,19008.26202323701,19221.1883207458,19262.223220597232,19180.15342089437,283767,312633.9666666667,44.250513702418715,41.83151522616186,NaN,NaN,NaN,NaN,146.8236369367839,26.72735412930441,4039589,30.018175827765702,-95.5752134698887,-125.5933892976544
2024-07-30T10:00:00-04:00,19227.25,19245,18802.5,18937,NaN,NaN,NaN,19502.594194257996,NaN,NaN,19533.005,20253.65528613045,18812.35471386955,19008.26202323701,19065.658610283426,19173.0937378509,18958.223482715952,1081042,321935.06666666665,33.84588443907465,41.57860605002029,NaN,NaN,NaN,NaN,167.94337715558504,27.859398164308598,2958547,11.123762737351967,-111.68868587596444,-122.8124486133164
2024-07-30T14:00:00-04:00,18936.75,19016.5,18726.75,18862,NaN,NaN,NaN,19368.214912700812,NaN,NaN,19508.885,20236.986628964147,18780.78337103585,19008.26202323701,19024.259824619727,19149.04535446685,18899.474294772604,417945,327125.93333333335,31.750383394483507,41.29833181045001,NaN,NaN,NaN,NaN,176.6438502159004,29.18539404007758,2540602,-4.968682501095557,-129.02330173968585,-124.05461923859029
2024-07-30T18:00:00-04:00,18870,19089.5,18862,19078,NaN,NaN,NaN,19368.214912700812,NaN,NaN,19492.98,20223.289597636583,18762.670402363416,19008.26202323701,19009.833333333332,19009.833577473957,19009.833089192707,97364,327893.8,42.74484103363464,41.581271194932874,NaN,NaN,NaN,NaN,180.2764323433361,29.736716516131256,2637966,0.12094880125536633,-123.90343323702109,-124.02438203827646
2024-07-30T22:00:00-04:00,19077.5,19225,19074.75,19217.25,NaN,NaN,NaN,19368.214912700812,NaN,NaN,19478.66,20201.921368800955,18755.398631199045,18998.124527819444,19084.324778147376,19165.29319440853,19003.356361886224,82410,328855.56666666665,48.504168891776516,42.319575852313385,NaN,NaN,NaN,NaN,178.13168717595497,29.12398268322196,2720376,13.32200706648716,-107.3718732051675,-120.69388027165466
2024-07-31T02:00:00-04:00,19217.25,19247.5,19167.25,19201,NaN,NaN,NaN,19368.214912700812,NaN,NaN,19463.725,20178.41287767828,18749.037122321715,18998.124527819444,19132.787171602693,19219.044046795974,19046.53029640941,120231,328786,47.89865606095525,42.586363103260965,NaN,NaN,NaN,NaN,171.14013809195816,28.380613429803258,2600145,20.96111904710463,-94.49248146277387,-115.4536005098785
2024-07-31T06:00:00-04:00,19200.75,19412,19197.75,19390.75,18807.29074682413,18807.29074682413,18807.29074682413,NaN,NaN,NaN,19452.275,20152.787928146023,18751.76207185398,18998.124527819444,19244.575000393812,19359.627616083206,19129.522384704418,377137,328531.73333333334,54.96799309992615,43.29543649265811,NaN,NaN,NaN,NaN,174.21941394253258,26.529110754308537,2977282,37.81232009240523,-68.18820039437196,-106.00052048677719
2024-07-31T10:00:00-04:00,19390.25,19516,19344.25,19431.25,18931.737758332125,NaN,NaN,NaN,NaN,NaN,19443.885,20135.093776058406,18752.67622394159,19060.87210737656,19337.144995081282,19460.791140459645,19213.49884970292,671448,325955.9,56.32997435578788,44.22609180660146,NaN,NaN,NaN,NaN,174.0430272323517,25.08265176456503,3648730,49.94314404062143,-43.571590436000406,-93.51473447662184
2024-07-31T14:00:00-04:00,19427.75,19645.25,19384.5,19582.75,19003.584905680662,NaN,NaN,NaN,NaN,NaN,19437.865,20118.811981856677,18756.918018143326,19150.772685901247,19391.679278484582,19529.807056083806,19253.551500885358,504348,328630.1,61.07287912892576,45.17101385798172,NaN,NaN,NaN,NaN,180.2363824300409,24.425351937779734,4153078,65.44933939271644,-11.703060235726298,-77.15239962844274
2024-07-31T18:00:00-04:00,19588,19716.75,19582.75,19637.75,19143.427637240635,NaN,NaN,NaN,NaN,NaN,19436.2,20114.772612179215,18757.627387820787,19254.168148720997,19645.75,19645.75,19645.75,99265,329720.06666666665,62.65845833693001,46.53859040437634,NaN,NaN,NaN,NaN,176.93378368503798,24.16063301105717,4252343,75.95071492390237,17.78599402643522,-58.16472089746715
2024-07-31T22:00:00-04:00,19638.5,19692.5,19623,19691,19164.96501736606,NaN,NaN,NaN,NaN,NaN,19435.99,20114.24049177993,18757.739508220075,19287.6845189768,19653.620432766784,19664.56264968823,19642.67821584534,51355,329179.3333333333,64.17972779565187,48.109444980498594,NaN,NaN,NaN,NaN,169.25994199324956,23.914822579100502,4303698,82.47987893852611,44.93512777569049,-37.544751162835624
2024-08-01T02:00:00-04:00,19690.5,19693,19504.75,19588.75,19164.96501736606,NaN,NaN,NaN,NaN,NaN,19432.86,20106.80365610189,18758.916343898112,19287.6845189768,19623.133151776477,19653.1229144748,19593.143389078155,166177,326205.9,59.19303199270602,49.62859742443271,NaN,NaN,NaN,NaN,170.61637470801745,22.82972304676216,4137521,76.06543311080478,57.53704022567035,-18.528392885134426
2024-08-01T06:00:00-04:00,19589.25,19681.75,19505,19640.5,19164.96501736606,NaN,NaN,NaN,NaN,NaN,19429.915,20098.89837505497,18760.93162494503,19287.6845189768,19615.395354034277,19636.676782254395,19594.11392581416,388356,322309.13333333336,60.85096796618142,50.896638129201776,NaN,NaN,NaN,NaN,171.05449080030192,21.82213062387656,4525877,71.52899096235589,70.88284581781045,-0.64614514454545
2024-08-01T10:00:00-04:00,19640.5,19667.25,18912,19018.5,NaN,NaN,NaN,19867.60536947529,19867.60536947529,19867.60536947529,19413.35,20081.24372657647,18745.456273423526,19287.6845189768,19362.349483840364,19565.940139809878,19158.75882787085,1094032,321425.13333333336,39.8788982527566,50.5804556036578,NaN,NaN,NaN,NaN,212.7827414574232,22.484661781676333,3431845,25.247272894256987,30.912945973275782,5.665673079018797
2024-08-01T14:00:00-04:00,19019,19065,18852.25,18964.75,NaN,NaN,NaN,19539.344898135507,NaN,NaN,19393.235,20053.333207920572,18733.13679207943,19287.6845189768,19278.42140710895,19522.260010619815,19034.58280359808,475216,322199.1,38.63959072795526,50.17967539119612,NaN,NaN,NaN,NaN,212.78040278189297,23.287990397588494,2956629,-8.566567419389772,-5.042536195218418,3.524031224171354
2024-08-01T18:00:00-04:00,18961,18981.5,18841.25,18897.5,NaN,NaN,NaN,19484.82353912935,NaN,NaN,19371.195,20022.380283080096,18720.009716919903,19287.6845189768,18906.75,18906.75,18906.75,136333,324798.6,37.08665973212431,50.41115934069967,NaN,NaN,NaN,NaN,207.59965972604348,24.069540229542575,2820296,-33.635219637061596,-38.51999332215564,-4.884773685094045
2024-08-01T22:00:00-04:00,18897.75,18903,18685.75,18766.75,NaN,NaN,NaN,19371.38269644165,NaN,NaN,19346.89,19995.782149436443,18697.997850563555,19287.6845189768,18839.328580989975,18899.757656109847,18778.899505870104,169709,328683.5333333333,34.208054512711286,50.58670727771594,NaN,NaN,NaN,NaN,208.2889697456118,25.277918041556546,2650587,-55.88417738855414,-74.73999542078673,-18.855818032232584
2024-08-02T02:00:00-04:00,18767.25,18783.75,18639,18683.5,NaN,NaN,NaN,19281.893710239758,NaN,NaN,19321.45,19972.638651620902,18670.2613483791,19287.6845189768,18793.478827583054,18874.855810455454,18712.101844710654,153530,329672.93333333335,32.47943246180158,49.85346380829929,NaN,NaN,NaN,NaN,203.75047190663955,26.535682828152236,2497057,-72.04076776939611,-108.90677774397773,-36.866009974581615
2024-08-02T06:00:00-04:00,18683.25,18761.25,18508,18574.25,NaN,NaN,NaN,19213.745132501586,NaN,NaN,19294.295,19954.55253074108,18634.037469258918,19287.6845189768,18697.12289948781,18802.090760899213,18592.15503807641,535959,335517.5,30.314501782117105,48.554201871895046,NaN,NaN,NaN,NaN,207.28615248473673,28.064831587731902,1961098,-85.0268889229843,-143.149621128312,-58.122732205327694
2024-08-02T10:00:00-04:00,18574.5,18633.25,18385.75,18491.75,NaN,NaN,NaN,19096.04649011515,NaN,NaN,19264.96,19934.83361016835,18595.08638983165,19287.6845189768,18597.903105170513,18719.262219472977,18476.54399086805,1047250,341145.6666666667,28.7557483467736,47.18685132088207,NaN,NaN,NaN,NaN,210.1585701643984,29.788599829467227,913848,-93.44415147155786,-174.92792154477502,-81.48377007321716
2024-08-02T14:00:00-04:00,18492.5,18588.5,18452.25,18509.75,NaN,NaN,NaN,19096.04649011515,NaN,NaN,19235.025,19903.443343928222,18566.60665607178,19275.02261518144,18585.74223122702,18701.31362777107,18470.170834682973,360505,341626.4,29.606229040342356,45.375296745197524,NaN,NaN,NaN,NaN,204.87938658122712,31.38924176822146,1274353,-91.9298418116579,-196.39607233778952,-104.46623052613162
2024-08-04T18:00:00-04:00,18391.75,18394,18068.75,18129.25,NaN,NaN,NaN,18843.682339133848,NaN,NaN,19198.02,19901.429715883987,18494.610284116014,19258.993092145152,18197.333333333332,18197.333333333332,18197.333333333332,323705,349455.3,23.279776250655374,43.01456830911662,NaN,NaN,NaN,NaN,221.74514468256805,33.658034085382674,950648,-109.49181003901916,-241.33099307490556,-131.8391830358864
2024-08-04T22:00:00-04:00,18129.25,18176.25,17346,17551,NaN,NaN,NaN,18458.816096445946,NaN,NaN,19150.145,19961.330984161512,18338.95901583849,18951.41947371612,17913.93789505105,18165.246403047044,17662.629387055058,411643,361908.06666666665,17.247831640016784,39.88420777419456,NaN,NaN,NaN,NaN,265.2097772052418,36.60031570646552,539005,-150.46018131989297,-319.9144096857526,-169.45422836585965
2024-08-05T02:00:00-04:00,17550.5,17990.5,17461,17813.75,NaN,NaN,NaN,18458.816096445946,NaN,NaN,19110.125,19981.420840974875,18238.829159025125,18385.960578972896,17853.35641897339,18065.545148750134,17641.16768919665,453313,373905.73333333334,26.559470215064138,37.30570862263271,NaN,NaN,NaN,NaN,284.08765026201024,39.33243435461389,992318,-149.9380183989121,-356.8767513644998,-206.9387329655877
2024-08-05T06:00:00-04:00,17814.75,17954,17363.5,17881.25,NaN,NaN,NaN,18443.901391596406,NaN,NaN,19072.48,19989.075138760876,18155.884861239123,18368.143463178316,17804.865161813967,17979.179296112237,17630.551027515696,801124,389223.9,28.77671905176514,34.776922283783655,NaN,NaN,NaN,NaN,305.97424667186664,41.954404378333024,1793442,-135.55642487570563,-376.3842640602197,-240.8278391845141
2024-08-05T10:00:00-04:00,17882.75,18289.25,17850.25,18078.25,NaN,NaN,NaN,18443.901391596406,NaN,NaN,19039.705,19978.692128186416,18100.717871813587,18303.689770542653,17898.565914030794,18088.450493166874,17708.681334894714,1071412,395062.7,34.94944216489728,33.04523729608302,NaN,NaN,NaN,NaN,315.4760861953047,42.51436701102689,2864854,-104.66856767283036,-371.66354877555204,-266.9949811027217
2024-08-05T14:00:00-04:00,18078.5,18169.5,17892.75,18139.5,NaN,NaN,NaN,18443.901391596406,NaN,NaN,19012.25,19974.3556802659,18050.1443197341,18231.926816434123,17915.913914922803,18102.925689790238,17728.90214005537,350912,397800.23333333334,36.78389727521938,31.326160818157167,NaN,NaN,NaN,NaN,312.70993718135435,43.03433231281406,3215766,-73.47878371459382,-358.84346074596397,-285.36467703137015
2024-08-05T18:00:00-04:00,18164.5,18435.5,18164.5,18370.5,NaN,NaN,NaN,18443.901391596406,NaN,NaN,18993.26,19967.721646038553,18018.798353961443,18193.1664531473,18323.5,18323.5,18323.5,161645,401040,43.28040226103985,31.569125390177398,NaN,NaN,NaN,NaN,311.51637023982903,42.22633182279337,3377411,-32.734256484791445,-326.2824976373595,-293.54824115256804
2024-08-05T22:00:00-04:00,18369.5,18425.25,18231.5,18343,NaN,NaN,NaN,18443.901391596406,NaN,NaN,18974.725,19962.607899183997,17986.842100816,18057.801530014272,18327.575039248448,18332.38395676889,18322.766121728007,116073,402807.36666666664,42.71758917072755,31.860410993232563,NaN,NaN,NaN,NaN,303.10448665126984,41.476045653488434,3261338,-4.559154827908856,-299.24718468745414,-294.6880298595453
2024-08-06T02:00:00-04:00,18342.75,18365,18017.75,18088,NaN,NaN,NaN,18443.901391596406,NaN,NaN,18951.36,19966.392473175052,17936.32752682495,18057.801530014272,18258.511277536032,18342.358000466502,18174.664554605562,188792,406399.93333333335,37.807963746433316,31.91193270854035,NaN,NaN,NaN,NaN,306.2577376047506,41.27226630336508,3072546,-0.24743827834089416,-294.9973277074714,-294.7498894291305
2024-08-06T06:00:00-04:00,18088.75,18253.25,17961.25,18141.5,NaN,NaN,NaN,18443.901391596406,NaN,NaN,18929.495,19966.03910176319,17892.95089823681,17748.941224011418,18186.93455397533,18278.139582388758,18095.729525561903,489121,413245.06666666665,39.38209461350046,32.28150700145386,NaN,NaN,NaN,NaN,305.23932777583985,41.20564713307559,3561667,8.569456739891962,-284.03806850426554,-292.6075252441575
2024-08-06T10:00:00-04:00,18141.5,18449.75,18102.25,18418.5,17525.135670851287,17525.135670851287,17525.135670851287,NaN,NaN,NaN,18914.99,19959.40320826565,17870.576791734355,17603.65998683228,18247.314170390157,18343.442402540528,18151.185938239785,757367,402455.9,46.87901423635858,33.310048556779364,NaN,NaN,NaN,NaN,308.25794722042275,40.19335858734158,4319034,33.99163047430238,-250.11798715127952,-284.1096176255819
2024-08-06T14:00:00-04:00,18418.75,18483,18067.25,18096.75,17525.135670851287,NaN,NaN,NaN,NaN,NaN,18896.3,19964.888653318027,17827.711346681972,17603.65998683228,18241.809414004434,18329.998036338136,18153.62079167073,360698,400547.6666666667,40.598247229911244,34.04460180305038,NaN,NaN,NaN,NaN,315.93595099039254,39.34647097124467,3958336,30.200698842521888,-246.35874407242954,-276.55944291495143
2024-08-06T18:00:00-04:00,18040.25,18316.25,18027.5,18289.75,17525.135670851287,NaN,NaN,NaN,NaN,NaN,18876.295,19952.079907358417,17800.51009264158,17603.65998683228,18211.166666666668,18211.166666666668,18211.166666666668,164500,402785.5333333333,45.329846360454454,35.228465946884725,NaN,NaN,NaN,NaN,313.99409734822166,38.66951256278614,4122836,41.07959456797255,-225.20994970498577,-266.2895442729583
2024-08-06T22:00:00-04:00,18289.25,18437,18250.75,18329.5,17525.135670851287,NaN,NaN,NaN,NaN,NaN,18862.99,19948.99245377238,17776.987546227625,17662.136913258128,18274.314902452665,18338.268105223324,18210.361699682006,160385,405384.7,46.278958685416605,36.419375207247164,NaN,NaN,NaN,NaN,304.8695189662058,37.43452086886654,4283221,50.70927850307899,-202.9029461441096,-253.61222464718858
2024-08-07T02:00:00-04:00,18329.5,18446,18220.5,18410.5,17525.135670851287,NaN,NaN,NaN,NaN,NaN,18849.585,19941.03759910825,17758.132400891747,17713.359530606504,18303.548518595406,18369.116588543206,18237.980448647606,171277,407086.23333333334,48.25050071554748,38.20299838331089,NaN,NaN,NaN,NaN,299.2002676114768,36.38506467466797,4454498,61.568078674413044,-176.65212630417227,-238.22020497858531
2024-08-07T06:00:00-04:00,18410.75,18558.5,18378.5,18520.25,17654.655908071694,NaN,NaN,NaN,NaN,NaN,18838.665,19932.151724244854,17745.17827575515,17882.387624485204,18381.64116261831,18484.532636725868,18278.749688510754,372174,406920.8,50.880868577164726,40.60535816453574,NaN,NaN,NaN,NaN,290.6859627820856,34.84153750220536,4826672,74.3224605718953,-145.3171292637162,-219.6395898356115
2024-08-07T10:00:00-04:00,18520.5,18556.75,18094.5,18117.75,17654.655908071694,NaN,NaN,NaN,NaN,NaN,18817.165,19924.148105607244,17710.181894392757,17882.387624485204,18317.399097589117,18412.699377427685,18222.09881775055,913502,414989.26666666666,42.37422649273904,41.73498361294109,NaN,NaN,NaN,NaN,302.9405368690795,34.32128938109451,3913170,54.73635638498976,-151.2191443543743,-205.95550073936406
2024-08-07T14:00:00-04:00,18117.75,18147,17834.25,17857.75,17654.655908071694,NaN,NaN,NaN,NaN,NaN,18791.64,19926.72277742203,17656.55722257797,17882.387624485204,18255.787754875822,18419.005575221847,18092.569934529798,354758,410002.93333333335,37.959386434456775,42.3908884259905,NaN,NaN,NaN,NaN,303.6412128070024,34.50534613743434,3558412,24.875859871494583,-174.86067589999584,-199.73653577149042
2024-08-07T18:00:00-04:00,17881.25,17988.75,17745,17979.25,17654.655908071694,NaN,NaN,NaN,NaN,NaN,18767.335,19918.796890858728,17615.87310914127,17882.387624485204,17904.333333333332,17904.333333333332,17904.333333333332,181552,412745.8333333333,41.05026985901925,42.82666183271349,NaN,NaN,NaN,NaN,299.36326903507364,34.881122980364985,3739964,14.430651495040138,-181.69822140269025,-196.1288728977304
2024-08-07T22:00:00-04:00,17978.75,18080,17925.5,17935.25,17654.655908071694,NaN,NaN,NaN,NaN,NaN,18742.525,19911.048578067523,17574.00142193248,17882.387624485204,17937.301752737727,17974.930675502634,17899.67282997282,139365,415679.5,40.26787438686836,43.075517340688414,NaN,NaN,NaN,NaN,289.0158926754255,34.75424944691369,3600599,6.107410933624294,-188.4946092307,-194.6020201643243
2024-08-08T02:00:00-04:00,17935,18053.75,17875.25,17940.25,17654.655908071694,NaN,NaN,NaN,NaN,NaN,18715.46,19894.32514648627,17536.59485351373,17882.387624485204,17943.75740003164,17975.68635233945,17911.828447723834,163653,415595.36666666664,40.406872371175716,42.87026520569812,NaN,NaN,NaN,NaN,281.1219003414665,34.767781579038186,3764252,2.663642215209393,-191.27246739531256,-193.93610961052195
2024-08-08T06:00:00-04:00,17941.5,18253.5,17919.5,18208.5,17654.655908071694,NaN,NaN,NaN,NaN,NaN,18693.4,19868.098276154233,17518.70172384577,17882.387624485204,18029.880906041173,18124.323173071472,17935.438639010874,428972,416949.23333333334,47.46950240553478,43.209687579612925,NaN,NaN,NaN,NaN,284.8989074599332,33.76553249050922,4193224,19.252688984277313,-169.87024838017533,-189.12293736445264
2024-08-08T10:00:00-04:00,18209,18532.5,18189.75,18514.25,17654.655908071694,NaN,NaN,NaN,NaN,NaN,18678.31,19842.393577583633,17514.22642241637,17882.387624485204,18187.905911078462,18389.57685901416,17986.234963142764,643726,401939.0333333333,54.14077125400015,44.37631668729627,NaN,NaN,NaN,NaN,289.03112835565224,31.655834257288255,4836950,49.877572777581975,-126.77597139247518,-176.65354417005716
2024-08-08T14:00:00-04:00,18514.25,18594.5,18404,18557.5,17683.445046252622,NaN,NaN,NaN,NaN,NaN,18662.295,19810.44428772363,17514.145712276368,17935.10037275715,18239.10576135395,18459.761569940874,18018.449952767023,285204,395605.3,55.01114581659623,45.49267748751739,NaN,NaN,NaN,NaN,281.9931906159628,29.46095906770202,5122154,70.82862245497168,-88.11776610134257,-158.94638855631425
2024-08-08T18:00:00-04:00,18551.75,18617.25,18489,18543,17756.91345324114,NaN,NaN,NaN,NaN,NaN,18648.055,19784.043663191624,17512.066336808377,18025.605298205723,18549.75,18549.75,18549.75,112034,394795.3333333333,54.636750096105985,46.04680147749935,NaN,NaN,NaN,NaN,271.01153414339404,27.37948669892064,5010120,80.77110883455728,-57.98250251311765,-138.75361134767493
2024-08-08T22:00:00-04:00,18544,18595,18430,18513.75,17756.91345324114,NaN,NaN,NaN,NaN,NaN,18633.895,19758.51990231182,17509.270097688182,18039.184238564576,18532.33105115744,18550.720672420644,18513.941429894232,100519,392489,53.84071258032461,46.99269185967173,NaN,NaN,NaN,NaN,263.4392817045802,25.64012184644583,4909601,82.16703520853227,-36.04481733700959,-118.21185254554186
2024-08-09T02:00:00-04:00,18513.25,18652.5,18492,18615.25,17803.41261958542,NaN,NaN,NaN,NaN,NaN,18624.045,19740.493747995293,17507.596252004703,18127.59739085166,18552.409185181456,18582.395440667853,18522.422929695058,124880,391534,56.22417272551631,47.77085802860472,NaN,NaN,NaN,NaN,256.08647586853874,23.841466860039965,5034481,86.28985082842789,-10.349539010006993,-96.63938983843488
2024-08-09T06:00:00-04:00,18615.25,18616.25,18383,18431.25,17803.41261958542,NaN,NaN,NaN,NaN,NaN,18608.61,19713.898800087885,17503.321199912116,18127.59739085166,18513.59361888549,18556.770378233774,18470.416859537207,356299,385545.3333333333,51.07547197094746,48.113466120428356,NaN,NaN,NaN,NaN,254.455299020786,22.56951309388064,4678182,73.48908794699598,-4.778029904689902,-78.26711785168588
2024-08-09T10:00:00-04:00,18431.5,18674.75,18404.25,18609.25,17803.41261958542,NaN,NaN,NaN,NaN,NaN,18596.275,19687.403371228476,17505.146628771527,18127.59739085166,18538.16810656056,18577.364332671048,18498.97188045007,693523,373754.43333333335,55.336498224749334,48.61960879965706,NaN,NaN,NaN,NaN,255.60134909072985,21.11566335930779,5371705,73.6864888728794,13.840993239413365,-59.84549563346603
2024-08-09T14:00:00-04:00,18609.75,18633.75,18563.25,18602.75,17856.006411530856,NaN,NaN,NaN,NaN,NaN,18583.835,19660.100300053822,17507.569699946176,18146.90986411605,18546.629458588955,18588.780402261356,18504.478514916555,220279,369080.23333333334,55.14761545540754,48.92437643381726,NaN,NaN,NaN,NaN,242.3798241556777,19.76566003434728,5151426,70.07823358644217,27.752296349586686,-42.32593723685548
2024-08-11T18:00:00-04:00,18591.75,18658.5,18514.5,18608,17858.119756461274,NaN,NaN,NaN,NaN,NaN,18577.255,19648.815770511872,17505.69422948813,18197.02789129284,18593.666666666668,18593.666666666668,18593.666666666668,102382,361702.8,55.28038831916887,49.846245135705104,NaN,NaN,NaN,NaN,235.3526938588436,18.747004531929942,5253808,64.86395249855397,38.75400338633699,-26.109949112216984
2024-08-11T22:00:00-04:00,18607.75,18667,18607,18645.75,17933.54613116758,NaN,NaN,NaN,NaN,NaN,18572.93,19641.600487287807,17504.259512712193,18267.822313034274,18609.27230024161,18631.140650740872,18587.403949742347,52138,349719.3,56.28251199137035,51.1550398183418,NaN,NaN,NaN,NaN,222.82750144035478,17.753815224850552,5305946,60.84262278872646,49.943329373691085,-10.89929341503537
2024-08-12T02:00:00-04:00,18645.75,18692.5,18602.5,18651,17963.74857975087,NaN,NaN,NaN,NaN,NaN,18564.39,19623.56176208581,17505.21823791419,18328.15785042742,18622.775732635786,18648.542327207637,18597.009138063935,80590,337295.2,56.42874667196307,52.25350244783779,NaN,NaN,NaN,NaN,213.3398227660437,16.68274549770449,5386536,55.5670699210734,58.55954398630638,2.9924740652329813
2024-08-12T06:00:00-04:00,18651.75,18694.5,18524,18540.25,17963.74857975087,NaN,NaN,NaN,NaN,NaN,18550.85,19593.471705126176,17508.22829487382,18328.15785042742,18603.266030118393,18628.58939901278,18577.942661224006,269565,319576.56666666665,52.44349354839381,53.12318953080389,NaN,NaN,NaN,NaN,210.27983542561202,16.11750615438385,5116971,42.252449879933714,55.80803641515013,13.555586535216412
2024-08-12T10:00:00-04:00,18540.75,18765.5,18531.25,18617.75,17971.233726591185,NaN,NaN,NaN,NaN,NaN,18539.185,19565.371229736043,17512.99877026396,18346.996024273547,18624.29505512896,18647.67425359123,18600.915856666692,765075,309365.3333333333,54.846681990562374,54.15460450361722,NaN,NaN,NaN,NaN,211.9919900380683,15.151450309217784,5882046,36.514445994594844,59.19864402845997,22.684198033865123
2024-08-12T14:00:00-04:00,18617.75,18658.75,18581.5,18623.5,17971.233726591185,NaN,NaN,NaN,NaN,NaN,18523.84,19521.17243585068,17526.50756414932,18346.996024273547,18623.86788478205,18645.571068714784,18602.164700849313,207190,304574.6,55.028262144208355,54.69451591352247,NaN,NaN,NaN,NaN,202.3675621782063,14.25439845299215,6089236,31.163972790082205,61.63916402146788,30.475191231385672
2024-08-12T18:00:00-04:00,18644,18687.25,18628.75,18653.25,18022.269521542796,NaN,NaN,NaN,NaN,NaN,18508.28,19472.215608015395,17544.344391984603,18356.63245553507,18656.416666666668,18656.416666666668,18656.416666666668,47057,300755,56.013856939072674,54.82830774817051,NaN,NaN,NaN,NaN,192.46630773690586,13.239770841143198,6136293,27.79747188902566,65.22203109266775,37.42455920364209
2024-08-12T22:00:00-04:00,18653.25,18711.75,18652.25,18706.75,18067.05272510903,NaN,NaN,NaN,NaN,NaN,18490.76,19406.585539936645,17574.934460063352,18417.505964428055,18671.0482347171,18687.809855621737,18654.28661381246,35857,298081.13333333336,57.804766364071,55.027852072990136,NaN,NaN,NaN,NaN,182.9687143271269,12.463881355905002,6172150,27.303277386343836,71.55365593657189,44.25037855022805
2024-08-13T02:00:00-04:00,18706.25,18818.25,18688.75,18743,18148.84578305862,NaN,NaN,NaN,NaN,NaN,18472.865,19331.525941291664,17614.20405870834,18518.104771542447,18710.496007080645,18751.71397062804,18669.27804353325,82796,294547.93333333335,59.022199983205496,55.34109849349725,NaN,NaN,NaN,NaN,179.14952044661783,12.428892311912357,6254946,27.472210987883273,78.59064228508214,51.11843129719887
2024-08-13T06:00:00-04:00,18743.5,18913.25,18646.25,18899.25,18166.170974737775,NaN,NaN,NaN,NaN,NaN,18457.03,19252.097120688795,17661.962879311202,18539.633817233957,18782.614825759745,18839.552254289087,18725.677397230404,323270,289019.56666666665,63.862150268894915,56.05691547125226,NaN,NaN,NaN,NaN,185.42455470043086,12.938932301945394,6578216,35.64342959190053,95.67271828707453,60.029288695174
2024-08-13T10:00:00-04:00,18899.5,19088,18855.75,19057.75,18354.51547588606,NaN,NaN,NaN,NaN,NaN,18446.41,19193.461897527905,17699.358102472095,18672.982053787164,18894.84767744661,19010.734008090792,18778.96134680243,519436,281088.5333333333,67.99208822502567,56.89748086407436,NaN,NaN,NaN,NaN,188.7692293646858,14.251191444083682,7097652,48.464327781555625,120.60969842211853,72.1453706405629
2024-08-13T14:00:00-04:00,19057.5,19121.75,19032,19100.5,18475.338636073055,NaN,NaN,NaN,NaN,NaN,18435.61,19126.825307700816,17744.394692299185,18744.860643029733,18925.451360814142,19052.49668597731,18798.406035650976,193732,275523,69.02045443550759,58.17926532582866,NaN,NaN,NaN,NaN,181.69642726720824,15.614295543805529,7291384,56.0301077943556,142.1830053835074,86.1528975891518
2024-08-13T18:00:00-04:00,19100,19153.25,19087.75,19144,18537.374379887915,NaN,NaN,NaN,NaN,NaN,18438.12,19138.63256405599,17737.607435944006,18818.988514423785,19128.333333333332,19128.333333333332,19128.333333333332,50619,271726.9666666667,70.07405536823055,59.231947978934464,NaN,NaN,NaN,NaN,173.39668246240765,17.01701496706249,7342003,59.82563015080862,160.9349352776626,101.10930512685397
2024-08-13T22:00:00-04:00,19144.25,19148.25,19081.75,19115.5,18549.31190807483,NaN,NaN,NaN,NaN,NaN,18441.135,19151.910528630615,17730.359471369382,18847.590811539027,19121.81249459878,19128.39553129449,19115.22945790307,49667,268036.36666666664,68.43195264110102,60.180829206484,NaN,NaN,NaN,NaN,165.76120514366426,18.262867721998784,7292336,56.32783398909416,171.51909761322167,115.19126362412752
2024-08-14T02:00:00-04:00,19114.5,19132.75,19064,19096.25,18549.31190807483,NaN,NaN,NaN,NaN,NaN,18445.11,19168.166831514547,17722.053168485454,18857.847649231222,19113.188829844064,19125.905619927482,19100.472039760647,55716,264184.3333333333,67.28503531827121,61.03830399213417,NaN,NaN,NaN,NaN,158.83183334768825,19.243530631030996,7236620,48.90401819258784,176.32128636486232,127.41726817227448
2024-08-14T06:00:00-04:00,19096,19175,19004.25,19028.75,18549.31190807483,NaN,NaN,NaN,NaN,NaN,18450.35,19186.33642650542,17714.36357349458,18869.70311938498,19083.099627146472,19104.66301950318,19061.536234789764,340976,263144.4,63.280077860958684,61.5381301256762,NaN,NaN,NaN,NaN,159.68313096571052,19.56621625568305,6895644,36.21795361103386,172.6897101860668,136.47175657503294
2024-08-14T10:00:00-04:00,19029.5,19203.75,18925.5,19071.75,18549.31190807483,NaN,NaN,NaN,NaN,NaN,18458.115,19211.75759573079,17704.472404269214,18869.70311938498,19073.67971289749,19089.674769379508,19057.684656415473,700852,256056.06666666668,64.72069574018911,62.13041220197804,NaN,NaN,NaN,NaN,168.15219303958835,19.147023564094,7596496,27.867941715233258,171.3066837190745,143.43874200384124
2024-08-14T14:00:00-04:00,19072,19161.25,19038.25,19147.5,18549.31190807483,NaN,NaN,NaN,NaN,NaN,18469.58,19247.0068611257,17692.153138874302,18869.70311938498,19079.869624887153,19100.83876834589,19058.900481428416,207125,251134.96666666667,67.16462114157542,63.18192131577673,NaN,NaN,NaN,NaN,164.92703639390348,18.75777320761845,7803621,24.69991687463977,174.31363809714094,149.61372122250117
2024-08-14T18:00:00-04:00,19148.25,19177.75,19100.25,19167,18601.523886325278,NaN,NaN,NaN,NaN,NaN,18483.085,19284.667956467987,17681.50204353201,18869.70311938498,19148.333333333332,19148.333333333332,19148.333333333332,52004,246816.7,67.78332847010854,64.10596749288716,NaN,NaN,NaN,NaN,158.68224808005326,18.515771970706254,7855625,21.29989452895174,176.23858938369085,154.9386948547391
2024-08-14T22:00:00-04:00,19167.25,19223.75,19157,19186,18668.227346037766,NaN,NaN,NaN,NaN,NaN,18496.61,19322.003125486255,17671.216874513746,18923.733397700085,19167.700964032247,19187.97158054155,19147.430347522943,47474,243753.66666666666,68.40796094442263,65.06166026433104,NaN,NaN,NaN,NaN,152.11565893147804,18.623389511386748,7903099,17.852239831176746,177.25399464371003,159.40175481253328
2024-08-15T02:00:00-04:00,19187,19199,19123,19166,18668.227346037766,NaN,NaN,NaN,NaN,NaN,18517.345,19356.75218301655,17677.937816983453,18923.733397700085,19165.759544263357,19181.835748658028,19149.683339868687,62443,240380,66.93676775618397,65.841868179839,NaN,NaN,NaN,NaN,146.67882615065815,18.363889400627755,7840656,12.025884099540917,174.43410993695943,162.4082258374185
2024-08-15T06:00:00-04:00,19166.25,19461.75,19104.5,19460.25,18748.758026038544,NaN,NaN,NaN,NaN,NaN,18555.53,19389.311635921713,17721.748364078285,19060.714374528055,19284.63267146318,19367.840458442806,19201.424884483553,334551,237232.63333333333,75.33972472199025,67.09436520540466,NaN,NaN,NaN,NaN,161.719624282754,19.69358514456783,8175207,25.041323270278923,193.70987992526716,168.66855665498824
2024-08-15T10:00:00-04:00,19461,19586.75,19405.5,19584,18961.331524854973,NaN,NaN,NaN,NaN,NaN,18590.935,19445.791010155954,17736.07898984405,19175.296499622444,19404.96874799535,19538.9747397582,19270.9627562325,496011,232308.8,77.88527560454575,68.44172774978611,NaN,NaN,NaN,NaN,163.11465111970014,21.45504678633125,8671218,38.24615770929188,216.47625379160309,178.2300960823112
2024-08-15T14:00:00-04:00,19584,19603.5,19543,19568,19054.515319179747,NaN,NaN,NaN,NaN,NaN,18624.67,19497.771857975433,17751.568142024564,19244.087199697955,19432.009674318913,19569.172506487594,19294.846842150233,192398,229215.26666666666,76.78170262361809,69.36455291798062,NaN,NaN,NaN,NaN,155.7850331825787,23.156693611638566,8478820,41.87179294367462,230.56983726190447,188.69804431822985
2024-08-15T18:00:00-04:00,19569,19640.75,19561.5,19613.25,19095.16235012612,NaN,NaN,NaN,NaN,NaN,18655.37,19556.943148668626,17753.79685133137,19313.594759758365,19605.166666666668,19605.166666666668,19605.166666666668,72244,227888.93333333332,77.74223187672725,70.06099175024501,NaN,NaN,NaN,NaN,150.3182450981088,24.886299224183734,8551064,43.11670752938031,242.59392872995522,199.47722120057492
2024-08-15T22:00:00-04:00,19613.5,19667,19611.25,19660.5,19148.558379665843,NaN,NaN,NaN,NaN,NaN,18685.79,19617.81242118945,17753.76757881055,19377.40080780669,19620.326352435273,19640.150437559925,19600.50226731062,42247,225946.53333333333,78.73165452114644,70.75464889921922,NaN,NaN,NaN,NaN,143.5633704482439,26.59840383202961,8593311,42.833535684571444,253.01914080628922,210.18560512171777
2024-08-16T02:00:00-04:00,19660.25,19683,19604.75,19620,19164.93640786285,NaN,NaN,NaN,NaN,NaN,18710.78,19674.12575122335,17747.434248776648,19412.195646245353,19626.23247936515,19643.590795117416,19608.874163612883,69825,224111.36666666667,75.62836127804289,71.15138503563439,NaN,NaN,NaN,NaN,138.89812970194075,28.254629193086743,8523486,35.909806912937,255.07286376288903,219.16305684995203
2024-08-16T06:00:00-04:00,19619.5,19619.5,19445.25,19497.25,19164.93640786285,NaN,NaN,NaN,NaN,NaN,18733.865,19715.987803981152,17751.74219601885,19412.195646245353,19559.956586326567,19612.07297272026,19507.840199932874,310912,222598.46666666667,67.00754648426576,71.04964173871758,NaN,NaN,NaN,NaN,141.45897758037356,28.04541269434605,8212574,19.856010448901515,243.98306991107893,224.1270594621774
2024-08-16T10:00:00-04:00,19495.25,19662.5,19490,19628.75,19164.93640786285,NaN,NaN,NaN,NaN,NaN,18764.68,19760.401422085477,17768.958577914524,19412.195646245353,19576.942636625456,19617.394690688434,19536.490582562477,500493,216164.13333333333,70.8420531744153,71.30371444272787,NaN,NaN,NaN,NaN,143.67619346748972,28.09257782068815,8713067,15.101616133724008,243.0040796293324,227.9024634956084
2024-08-16T14:00:00-04:00,19628.75,19630,19572.5,19604.5,19164.93640786285,NaN,NaN,NaN,NaN,NaN,18793.94,19800.613783109562,17787.266216890435,19412.195646245353,19580.144729770924,19618.888136106376,19541.40132343547,143695,213611.33333333334,69.24379684370433,71.72969437006684,NaN,NaN,NaN,NaN,137.52075107695472,28.136374009434377,8569372,7.704680608407358,237.5333142561176,229.82863364771023
2024-08-18T18:00:00-04:00,19628.25,19674.25,19613.75,19657.5,19187.22747512369,NaN,NaN,NaN,NaN,NaN,18818.72,19847.95193032463,17789.48806967537,19412.195646245353,19648.5,19648.5,19648.5,66848,212426.86666666667,70.79463589646001,72.1635472383719,NaN,NaN,NaN,NaN,132.67998314288653,28.438048844426113,8636220,3.9515650345130098,234.7680899408515,230.8165249063385
2024-08-18T22:00:00-04:00,19656.75,19688,19578,19585.75,19187.22747512369,NaN,NaN,NaN,NaN,NaN,18848.5,19878.615779900483,17818.384220099517,19418.01402936168,19633.989452702433,19649.57465786852,19618.404247536346,57947,212620.5,65.94669036519517,72.07655218291617,NaN,NaN,NaN,NaN,131.05998434696605,28.31457315527002,8578273,-5.291190243523943,224.20253710193356,229.4937273454575
2024-08-19T02:00:00-04:00,19585.25,19607.75,19525,19578,19187.22747512369,NaN,NaN,NaN,NaN,NaN,18874.265,19911.60808408557,17836.92191591443,19418.01402936168,19609.120040070367,19642.508678940132,19575.731401200603,79845,212595.66666666666,65.42553270318948,71.90813819956482,NaN,NaN,NaN,NaN,127.6092711793256,27.62241219126515,8498428,-13.393834654330192,212.75143402754475,226.14526868187494
2024-08-19T06:00:00-04:00,19578.75,19639,19545,19587.25,19187.22747512369,NaN,NaN,NaN,NaN,NaN,18899.42,19943.67852852652,17855.161471473475,19418.01402936168,19599.41358108124,19624.38522169413,19574.44194046835,220779,210969.46666666667,65.7732026090683,71.71994117561094,NaN,NaN,NaN,NaN,125.2086089522309,27.206026104491265,8719207,-19.24169810880352,202.09314604587053,221.33484415467404
2024-08-19T10:00:00-04:00,19588,19722.75,19529.25,19721.5,19187.22747512369,NaN,NaN,NaN,NaN,NaN,18925.64,19985.200164219226,17866.079835780773,19423.68718303318,19630.484556696574,19664.273295682236,19596.69581771091,483319,201577.6,70.42197255844545,71.96888437577246,NaN,NaN,NaN,NaN,130.08656545564298,27.38375598100537,9202526,-15.348690177399078,202.1489814329252,217.4976716103243
2024-08-19T14:00:00-04:00,19721.75,19872.75,19719,19852.75,19353.79666784127,NaN,NaN,NaN,NaN,NaN,18952.29,20036.468123557162,17868.11187644284,19556.624746426543,19663.138414604146,19739.903488940952,19586.37334026734,195615,201191.76666666666,74.12250134405,71.88193984877674,NaN,NaN,NaN,NaN,131.7768107802399,28.367790191311894,9398141,-5.710840903837777,210.35912048052705,216.06996138436483
2024-08-19T18:00:00-04:00,19854,19889.75,19845,19887.5,19439.288864757575,NaN,NaN,NaN,NaN,NaN,18987.685,20076.116825196103,17899.2531748039,19614.474797141236,19874.083333333332,19874.083333333332,19874.083333333332,34613,200776.96666666667,75.01382322436459,71.67683610733522,NaN,NaN,NaN,NaN,125.56061001022279,29.363561236664587,9432754,0.8771432454025216,217.16639044111798,216.28924719571546
2024-08-19T22:00:00-04:00,19887.75,19914.75,19869,19889.5,19477.008689086775,NaN,NaN,NaN,NaN,NaN,19028.32,20096.49620288048,17960.14379711952,19671.654837712988,19883.055433146423,19891.542312529513,19874.568553763333,38684,200871.2,75.06705191411757,71.55436105665662,NaN,NaN,NaN,NaN,119.85985215234973,30.411755588143723,9471438,3.1161503282850447,220.18443510607176,217.06828477778672
2024-08-20T02:00:00-04:00,19888.75,19930.75,19849.75,19881.5,19483.195794128285,NaN,NaN,NaN,NaN,NaN,19066.365,20117.74512730867,18014.984872691333,19695.77387017039,19885.028494054575,19891.612886950497,19878.444101158653,62746,200202.86666666667,74.38444175040033,71.31451890477612,NaN,NaN,NaN,NaN,117.08414842718189,31.135493684857167,9408692,1.8666514134845045,219.40159904464235,217.53494763115785
2024-08-20T06:00:00-04:00,19881.75,19924.75,19811.5,19918.5,19483.195794128285,NaN,NaN,NaN,NaN,NaN,19106.03,20133.085965563783,18078.974034436214,19695.77387017039,19884.96095223679,19889.104864913174,19880.817039560407,207485,196343.36666666667,75.49434745150879,71.0832826855163,NaN,NaN,NaN,NaN,116.81028068238318,31.312131446658537,9616177,1.3636657163782502,219.23952977663066,217.8758640602524
2024-08-20T10:00:00-04:00,19918.5,19923.5,19743,19809.5,19483.195794128285,NaN,NaN,NaN,NaN,NaN,19143.415,20133.42488181931,18153.405118180694,19695.77387017039,19846.566669223597,19875.225937252522,19817.907401194672,621170,199734.5,66.37070707026041,70.42202167067468,NaN,NaN,NaN,NaN,121.35954634792724,30.646794266254112,8995007,-7.965539604241087,207.91893955495107,215.88447915919215
2024-08-20T14:00:00-04:00,19809.75,19868,19802,19805.25,19483.195794128285,NaN,NaN,NaN,NaN,NaN,19175.35,20145.482439412415,18205.217560587582,19695.77387017039,19843.274091753698,19870.758012191567,19815.790171315828,174613,199097.2,66.03560354995119,70.3525971753665,NaN,NaN,NaN,NaN,117.405293037361,30.028981170164293,8820394,-15.634740672980342,196.34105331796673,211.97579399094707
2024-08-20T18:00:00-04:00,19805,19834.25,19785.75,19817.5,19483.195794128285,NaN,NaN,NaN,NaN,NaN,19201.415,20169.125538384164,18233.70446161584,19695.77387017039,19812.5,19812.5,19812.5,45211,198916.93333333332,66.55969208070479,70.04671424010147,NaN,NaN,NaN,NaN,112.48348639183521,29.25181397155504,8865605,-20.77282485392078,186.00976292354608,206.78258777746686
2024-08-20T22:00:00-04:00,19817.5,19855.75,19807.5,19832,19483.195794128285,NaN,NaN,NaN,NaN,NaN,19226.905,20192.56829478762,18261.24170521238,19695.77387017039,19820.124297030496,19829.539062703312,19810.70953135768,29650,198249.7,67.204763962872,69.90106903432772,NaN,NaN,NaN,NaN,107.89538022098985,28.716119485953794,8895255,-23.86417192908715,176.9523728661079,200.81654479519506
2024-08-21T02:00:00-04:00,19832.25,19835.25,19790,19795.5,19483.195794128285,NaN,NaN,NaN,NaN,NaN,19251.955,20210.308550053327,18293.601449946676,19695.77387017039,19814.649627848168,19824.356951347167,19804.94230434917,52999,198159.13333333333,63.86503995892417,69.40609789593232,NaN,NaN,NaN,NaN,103.42071020520486,27.97995932435466,8842256,-28.710919895998757,164.9278949251966,193.63881482119535
2024-08-21T06:00:00-04:00,19795.5,19884.5,19795,19879.75,19483.195794128285,NaN,NaN,NaN,NaN,NaN,19279.275,20229.74351210321,18328.806487896793,19695.77387017039,19838.040819387603,19857.757403920183,19818.324234855023,198823,193420.7,67.83800893149797,69.54119207923965,NaN,NaN,NaN,NaN,102.42637376197594,27.744005201081194,9041079,-26.632423696742592,160.34828520026713,186.98070889700972
2024-08-21T10:00:00-04:00,19879.5,19982,19771.25,19893.5,19501.93933758724,NaN,NaN,NaN,NaN,NaN,19304.84,20251.245604167692,18358.434395832308,19718.290687950044,19867.555020242955,19891.28111677003,19843.82892371588,656128,191929.9,68.44773616240549,69.75706375489794,NaN,NaN,NaN,NaN,110.1637756361205,28.28196019744924,9697207,-24.760721442081234,156.02980709440817,180.7905285364894
2024-08-21T14:00:00-04:00,19893.75,19953,19832.5,19915.75,19518.663685878728,NaN,NaN,NaN,NaN,NaN,19334.53,20262.410222011524,18406.649777988474,19718.290687950044,19874.710870839273,19899.69672890852,19849.725012770028,273590,194145.4,69.45680125617893,70.02017794397727,NaN,NaN,NaN,NaN,110.90207737639761,28.781489836933854,9970797,-22.517866515463425,152.64319539216012,175.16106190762355
2024-08-21T18:00:00-04:00,19917.75,19946,19912.75,19926.75,19567.758518338786,NaN,NaN,NaN,NaN,NaN,19360.88,20279.661743614895,18442.098256385107,19718.290687950044,19928.5,19928.5,19928.5,32736,193503.13333333333,69.96815104675161,69.98776212171343,NaN,NaN,NaN,NaN,105.35550042094064,29.245338787883853,10003533,-20.826580391146024,149.127836418691,169.95441680983703
2024-08-21T22:00:00-04:00,19926.75,19927,19865.75,19893,19567.758518338786,NaN,NaN,NaN,NaN,NaN,19386.685,20291.211145614245,18482.158854385758,19718.290687950044,19910.09732168433,19926.627006643314,19893.567636725347,40575,193273.16666666666,66.30051492734603,69.42904880623458,NaN,NaN,NaN,NaN,102.2051075337306,28.921403067793968,9962958,-22.37803938614428,141.98186757715666,164.35990696330094
2024-08-22T02:00:00-04:00,19892.75,19936,19887,19916,19567.758518338786,NaN,NaN,NaN,NaN,NaN,19412.845,20301.29088405814,18524.399115941862,19737.49666578434,19911.149918275794,19924.420052362286,19897.879784189303,41710,192582.06666666668,67.54891506217318,68.89584108036375,NaN,NaN,NaN,NaN,98.4047427098927,28.705847803322314,10004668,-22.208001655310312,136.59990489416305,158.80790654947336
2024-08-22T06:00:00-04:00,19916.25,20025.75,19912.75,19976.5,19625.339971199803,NaN,NaN,NaN,NaN,NaN,19439.46,20314.013848313632,18564.906151686366,19810.44733262747,19952.84440855534,19981.819483446692,19923.869333663984,254791,189923.4,70.63091856175546,68.5789744123379,NaN,NaN,NaN,NaN,99.44726108775751,29.275569051843576,10259459,-18.524097865329793,135.65278421781113,154.17688208314092
2024-08-22T10:00:00-04:00,19976.5,19986.5,19586.75,19607.75,NaN,NaN,NaN,20169.41411840019,20169.41411840019,20169.41411840019,19458.595,20304.71084839188,18612.479151608124,19810.44733262747,19795.713685000195,19900.844401668128,19690.582968332263,845666,201578.56666666668,43.5080790965608,66.37351993706365,NaN,NaN,NaN,NaN,120.89745672434626,28.104931469835204,9413793,-40.18239925606662,103.94888301305764,144.13128226912426
2024-08-22T14:00:00-04:00,19608,19675,19542,19612,NaN,NaN,NaN,19992.025976654728,NaN,NaN,19480.03,20285.31767307101,18674.742326928987,19810.44733262747,19757.82776223532,19877.890262723577,19637.765261747063,310807,205525.53333333333,43.776059578105645,64.10792794610627,NaN,NaN,NaN,NaN,121.76192410117866,27.33452612896779,9724600,-52.69376752646855,78.26407286103858,130.95784038750713
2024-08-22T18:00:00-04:00,19621.25,19659,19610.75,19644.75,NaN,NaN,NaN,19992.025976654728,NaN,NaN,19500.57,20268.351961496992,18732.788038503008,19810.44733262747,19638.166666666668,19638.166666666668,19638.166666666668,40382,204463.46666666667,45.905554231439126,62.646131314761895,NaN,NaN,NaN,NaN,116.51107237966589,26.619149741019477,9764982,-56.87724554995188,59.861283450067276,116.73852900001916
2024-08-22T22:00:00-04:00,19644.75,19700.75,19640,19682.75,NaN,NaN,NaN,19992.025976654728,NaN,NaN,19521.755,20248.947508830915,18794.562491169087,19810.44733262747,19654.867534633948,19672.97496989968,19636.760099368217,34352,204200.3,48.35001165811124,61.38287475105905,NaN,NaN,NaN,NaN,112.52813863826118,25.517577651401513,9799334,-55.15698099110948,47.792302761132305,102.94928375224178
2024-08-23T02:00:00-04:00,19683.25,19720.25,19671.75,19715.5,NaN,NaN,NaN,19992.025976654728,NaN,NaN,19543,20228.319224887247,18857.680775112753,19810.44733262747,19673.214541136724,19700.39702923352,19646.032053039926,46820,203433.46666666667,50.429081870703996,60.23068830748756,NaN,NaN,NaN,NaN,107.95470016409968,24.291543238114286,9846154,-50.035872885198245,40.404442645743984,90.44031553094223
2024-08-23T06:00:00-04:00,19716,19778.5,19706.5,19744.75,NaN,NaN,NaN,19992.025976654728,NaN,NaN,19563.76,20208.15867287283,18919.361327127168,19810.44733262747,19715.36656949767,19753.700871982932,19677.032267012408,183756,199194.93333333332,52.27676729293308,59.16440283106335,NaN,NaN,NaN,NaN,105.38650729523542,22.56469599162716,10029910,-43.160958826257655,36.48911699812015,79.65007582437781
2024-08-23T10:00:00-04:00,19755.25,19903.25,19592,19732.75,NaN,NaN,NaN,19992.025976654728,NaN,NaN,19583.555,20185.28179257284,18981.82820742716,19810.44733262747,19735.71746328981,19758.421791944536,19713.013134635083,894107,212315.4,51.42982048220588,58.27617286844061,NaN,NaN,NaN,NaN,120.09104248843289,22.011485582021265,9135803,-38.08129360479613,32.04845881838264,70.12975242317877
2024-08-23T14:00:00-04:00,19732.75,19812.5,19705.25,19777.75,NaN,NaN,NaN,19992.025976654728,NaN,NaN,19601.125,20172.435233148273,19029.814766851727,19810.44733262747,19739.738195802274,19763.133658360002,19716.342733244546,189651,213847.26666666666,54.41251642985071,57.31720911832296,NaN,NaN,NaN,NaN,119.17382516783053,21.497790201672935,9325454,-30.668738210792924,31.793829659687617,62.46256787048054
2024-08-25T18:00:00-04:00,19788,19832,19716.25,19803.5,NaN,NaN,NaN,19992.025976654728,NaN,NaN,19616.04,20168.454240945735,19063.625759054266,19810.44733262747,19783.916666666668,19783.916666666668,19783.916666666668,79464,214267.8,56.0747900930726,56.433427256227745,NaN,NaN,NaN,NaN,118.92926622727121,21.18100144056682,9404918,-23.341140625111393,33.2861420890913,56.62728271420269
2024-08-25T22:00:00-04:00,19803.75,19811.25,19752.5,19784.75,NaN,NaN,NaN,19992.025976654728,NaN,NaN,19629.725,20163.97859381117,19095.471406188826,19614.382866101976,19783.545364565238,19784.059542341973,19783.031186788503,41438,213717.5,54.51599311802995,55.36622667493139,NaN,NaN,NaN,NaN,114.63074721103756,20.886840448111148,9363480,-19.23760458047964,32.580276988603146,51.817881569082786
2024-08-26T02:00:00-04:00,19785,19846.25,19777.5,19837.5,NaN,NaN,NaN,19992.025976654728,NaN,NaN,19643.595,20162.475264511915,19124.714735488087,19582.68267351867,19794.50471652416,19811.361880530545,19777.647552517774,51135,212760.5,58.049192140878134,54.514872467368996,NaN,NaN,NaN,NaN,111.35355098167773,20.921540348999752,9414615,-12.76315263438606,35.86394077610021,48.62709341048627
2024-08-26T06:00:00-04:00,19837,19844.5,19711,19722.25,NaN,NaN,NaN,19992.025976654728,NaN,NaN,19655.73,20152.55177730056,19158.90822269944,19582.68267351867,19774.42895475348,19795.094776176633,19753.763133330325,227537,212985.76666666666,49.078886523494944,53.2847561528082,NaN,NaN,NaN,NaN,112.93544019727219,20.120535078914127,9187078,-15.834335717863986,28.834173763156286,44.66850948102027
2024-08-26T10:00:00-04:00,19722.25,19729.75,19506.5,19537,NaN,NaN,NaN,19989.395047447837,NaN,NaN,19664.545,20136.357862160618,19192.73213783938,19582.68267351867,19661.33084200958,19751.378005820687,19571.28367819847,643312,218318.86666666667,38.72121748863257,51.22563489755531,NaN,NaN,NaN,NaN,120.81505161175275,19.881971729283112,8543766,-29.158688229246977,8.220149194461555,37.37883742370853
2024-08-26T14:00:00-04:00,19537,19624.25,19514,19549.75,NaN,NaN,NaN,19938.553227109296,NaN,NaN,19674.965,20111.872862254637,19238.057137745363,19582.68267351867,19644.577434278784,19734.599294629814,19554.555573927755,213304,218908.5,39.66500293480277,49.013783781344394,NaN,NaN,NaN,NaN,120.06040506805611,19.660448618911456,8757070,-35.50868814047734,-7.007022751888144,28.501665388589196
2024-08-26T18:00:00-04:00,19555.25,19593,19520.5,19569.75,NaN,NaN,NaN,19919.272398604327,NaN,NaN,19684.925,20087.749803730145,19282.100196269854,19582.68267351867,19561.083333333332,19561.083333333332,19561.083333333332,56074,219623.86666666667,41.1949701230813,48.84856171181014,NaN,NaN,NaN,NaN,116.66323327748067,19.45474858785206,8813144,-36.61081192375174,-17.261849516100483,19.348962407651257
2024-08-26T22:00:00-04:00,19570,19622,19564.75,19618.25,NaN,NaN,NaN,19919.272398604327,NaN,NaN,19694.34,20067.38536935872,19321.29463064128,19582.68267351867,19576.331338647546,19595.986190881245,19556.676486413846,33748,219459.33333333334,44.84734755891731,48.925082281868114,NaN,NaN,NaN,NaN,112.41943090051777,18.921659112014645,8846892,-32.463646603600694,-21.23059584684961,11.233050756751084
2024-08-27T02:00:00-04:00,19617.75,19647,19583.5,19632.5,NaN,NaN,NaN,19919.272398604327,NaN,NaN,19703.65,20045.519975282543,19361.78002471746,19582.68267351867,19592.294681376232,19618.87453105121,19565.714831701254,49951,219032.83333333334,45.91034734658969,48.925424647236014,NaN,NaN,NaN,NaN,108.92518583619507,18.13325856263428,8896843,-27.355493596427415,-22.961316238783184,4.39417735764423
2024-08-27T06:00:00-04:00,19632,19636.5,19441.75,19541.75,NaN,NaN,NaN,19896.361070949915,NaN,NaN,19710.765,20022.746720778636,19398.783279221363,19582.68267351867,19555.727020694285,19583.790672905674,19527.663368482896,324993,222949.76666666666,40.55020546050909,48.368295633121576,NaN,NaN,NaN,NaN,115.05552970503827,18.60509033697104,8571850,-28.551295943412587,-31.294942571621505,-2.743646628208918
2024-08-27T10:00:00-04:00,19542.75,19694.5,19530.75,19686.75,NaN,NaN,NaN,19896.361070949915,NaN,NaN,19721.18,19991.741139855654,19450.618860144346,19582.68267351867,19599.697846296633,19644.62085921769,19554.774833375574,543002,220344.16666666666,50.49547688803454,48.37303813435947,NaN,NaN,NaN,NaN,118.53370615467838,18.378439982283883,9114852,-18.5255210196744,-25.900547902801918,-7.375026883127518
2024-08-27T14:00:00-04:00,19686.75,19692.75,19626.25,19636.25,NaN,NaN,NaN,19896.361070949915,NaN,NaN,19724.7,19986.012188770335,19463.387811229666,19582.68267351867,19606.4008114007,19651.81199084172,19560.98963195968,148956,219488.93333333332,47.51422939121502,48.03285685566532,NaN,NaN,NaN,NaN,114.81701285791564,18.167978938645806,8965896,-14.425976415657136,-25.407497402698937,-10.981520987041801
2024-08-27T18:00:00-04:00,19638,19646.25,19560,19609,NaN,NaN,NaN,19896.361070949915,NaN,NaN,19725.2,19985.527217170988,19464.872782829014,19566.896138814936,19605.083333333332,19605.083333333332,19605.083333333332,58592,219934.96666666667,45.93814727463974,47.640594483696304,NaN,NaN,NaN,NaN,112.77651193949309,18.51589498003877,8907304,-12.739142666111993,-26.905449319681793,-14.1663066535698
2024-08-27T22:00:00-04:00,19608.5,19635.25,19598.5,19633.5,NaN,NaN,NaN,19896.361070949915,NaN,NaN,19726.51,19984.306740864304,19468.713259135693,19407.386453384643,19610.708848732877,19618.82442080301,19602.593276662745,28153,219885.06666666668,47.62043884138698,47.15544608452033,NaN,NaN,NaN,NaN,107.34604680095786,18.83895987561795,8935457,-9.321376765120288,-25.81802760997016,-16.49665084484987
2024-08-28T02:00:00-04:00,19632.5,19690,19624,19667,NaN,NaN,NaN,19896.361070949915,NaN,NaN,19727.585,19983.92779022446,19471.242209775537,19468.593864132938,19628.720355859426,19653.44594346389,19603.994768254965,49423,219765.86666666667,49.91541323213945,46.71549059445367,NaN,NaN,NaN,NaN,104.3927577437466,18.441416558362892,8984880,-4.402256783923654,-21.999471824754437,-17.597215040830783
2024-08-28T06:00:00-04:00,19667.75,19676.75,19530.5,19557.75,NaN,NaN,NaN,19896.361070949915,NaN,NaN,19725.53,19985.611172713725,19465.448827286273,19468.593864132938,19602.287073287695,19626.371644120944,19578.202502454445,257950,221736.76666666666,43.2588205349222,45.91140683851741,NaN,NaN,NaN,NaN,107.38256076205042,18.86133598685717,8726930,-7.899923425467449,-27.472119322665094,-19.572195897197645
2024-08-28T10:00:00-04:00,19557.5,19593.5,19291.25,19297.75,NaN,NaN,NaN,19806.97604603362,NaN,NaN,19719.085,20004.084642280723,19434.085357719276,19468.593864132938,19472.443027744033,19574.33458169668,19370.551473791387,653759,221657.8,32.23973862679976,44.06787444465466,NaN,NaN,NaN,NaN,121.30166356476111,20.655718319404546,8073171,-26.09222269395939,-52.18747426464688,-26.09525157068749
2024-08-28T14:00:00-04:00,19297.5,19481.25,19227,19314,NaN,NaN,NaN,19736.82372575936,NaN,NaN,19715.42,20016.02225281972,19414.817747180277,19468.593864132938,19439.40032682542,19544.45590055923,19334.34475309161,350984,224237.6,33.38190054659897,42.946661160590665,NaN,NaN,NaN,NaN,130.79797331013532,22.60156624779947,8424155,-34.852063538612256,-69.66033099395281,-34.808267455340555
2024-08-28T18:00:00-04:00,19240.75,19266,19139,19230.5,NaN,NaN,NaN,19591.666965497574,NaN,NaN,19707.455,20036.57322632572,19378.336773674284,19468.593864132938,19211.833333333332,19211.833333333332,19211.833333333332,106083,226682.5,30.533824372125707,42.36184736655446,NaN,NaN,NaN,NaN,133.95526093083996,24.756212381359724,8318072,-43.52699391142242,-89.21700984461859,-45.690015933196165
2024-08-28T22:00:00-04:00,19230,19329.25,19218,19323,NaN,NaN,NaN,19591.666965497574,NaN,NaN,19701.825,20047.03289750501,19356.61710249499,19468.593864132938,19237.4344293141,19274.14777355265,19200.72108507555,51584,227049.46666666667,36.95119794775866,42.16800415319416,NaN,NaN,NaN,NaN,132.3334565786371,26.020889496771904,8369656,-40.36283420504486,-96.14355868950224,-55.78072448445738
2024-08-29T02:00:00-04:00,19322.75,19505.5,19308,19488,NaN,NaN,NaN,19591.666965497574,NaN,NaN,19698.435,20048.6107246009,19348.2592753991,19468.593864132938,19317.179126106304,19417.693516548123,19216.664735664486,107781,229251.83333333334,46.45374313614862,42.54363079698469,NaN,NaN,NaN,NaN,136.98820968016304,25.482140749057365,8477437,-25.225256988160027,-87.31229571965741,-62.08703873149739
2024-08-29T06:00:00-04:00,19487.5,19651.5,19418.5,19644,19125.2225753688,19125.2225753688,19125.2225753688,NaN,NaN,NaN,19699.6,20048.654193500322,19350.545806499675,19468.593864132938,19469.800169561244,19609.55798000601,19330.042359116476,399012,234059.2,53.57761203578066,43.16722111676064,NaN,NaN,NaN,NaN,143.84619470300854,23.876871089300607,8876449,-3.8933759618432333,-66.95375868380142,-63.06038272195819
2024-08-29T10:00:00-04:00,19643.75,19692,19530.5,19634,19198.076094670218,NaN,NaN,NaN,NaN,NaN,19700.72,20048.563580362967,19352.876419637036,19468.593864132938,19541.69607442968,19666.81777929862,19416.57436956074,619311,226514.03333333333,53.09001647091083,43.68005462564072,NaN,NaN,NaN,NaN,145.10718079565078,22.232723481791634,8257138,9.617863833594164,-51.03805292996549,-60.65591676355965
2024-08-29T14:00:00-04:00,19633.5,19633.5,19337,19449.5,19198.076094670218,NaN,NaN,NaN,NaN,NaN,19697.965,20051.495310015936,19344.434689984064,19468.593864132938,19525.08922576197,19637.836218051656,19412.342233472285,411922,229884.53333333333,44.960121681214964,43.99504864140543,NaN,NaN,NaN,NaN,155.9566678816757,21.749644537671855,7845216,6.360892306817576,-52.70480138003768,-59.065693686855255
2024-08-29T18:00:00-04:00,19449,19462.5,19393.5,19441.5,19198.076094670218,NaN,NaN,NaN,NaN,NaN,19692.365,20053.025327870808,19331.704672129195,19426.50009130635,19432.5,19432.5,19432.5,55442,230386.53333333333,44.64090662199411,43.57686505097397,NaN,NaN,NaN,NaN,149.7454773186989,21.301071232417776,7789774,4.013986510411506,-54.04821054884087,-58.06219705925238
2024-08-29T22:00:00-04:00,19440.5,19481.75,19433.25,19456.5,19198.076094670218,NaN,NaN,NaN,NaN,NaN,19684.44,20048.05705900591,19320.822940994087,19256.775958348328,19442.63552502488,19454.77145307914,19430.49959697062,38671,230530.5,45.42334254708654,43.427515990679076,NaN,NaN,NaN,NaN,142.5136575102204,20.733303996504755,7828445,3.8191785434271566,-53.28822387996843,-57.107402423395584
2024-08-30T02:00:00-04:00,19456.25,19539.5,19452.75,19529.5,19198.076094670218,NaN,NaN,NaN,NaN,NaN,19677.28,20038.71346054317,19315.846539456827,19256.775958348328,19466.55875723794,19499.21173158111,19433.905782894773,55331,230814.2,49.1873295715654,43.65960044045948,NaN,NaN,NaN,NaN,138.53053911663324,19.75327106421354,7883776,8.67619577938077,-46.26215769916962,-54.93835347855039
2024-08-30T06:00:00-04:00,19529,19603,19498.5,19591,19198.076094670218,NaN,NaN,NaN,NaN,NaN,19671.31,20028.359206132172,19314.26079386783,19279.426186031582,19527.665612149573,19578.941168611706,19476.39005568744,250186,233028.53333333333,52.17953831460976,43.985250402832534,NaN,NaN,NaN,NaN,136.09978632258802,18.368464673497837,8133962,15.691308373968212,-35.324218011090124,-51.01552638505834
2024-08-30T10:00:00-04:00,19591.5,19628,19370,19446.5,19198.076094670218,NaN,NaN,NaN,NaN,NaN,19662.61,20019.94758772327,19305.272412276732,19279.426186031582,19498.60883995261,19536.96891072688,19460.24876917834,678711,225848.66666666666,45.412851788343666,43.66363887113283,NaN,NaN,NaN,NaN,144.80694444240316,17.931050453335267,7455251,10.509127123712801,-37.879117480417335,-48.388244604130136
2024-08-30T14:00:00-04:00,19446.75,19633,19433.5,19594,19198.076094670218,NaN,NaN,NaN,NaN,NaN,19656.12,20006.348328951663,19305.891671048335,19279.426186031582,19508.82111700123,19549.490546509653,19468.151687492806,246477,227742.86666666667,52.223645011433725,44.303983476597935,NaN,NaN,NaN,NaN,148.7135912679458,17.485024847124052,7701728,16.56438230491358,-27.682766722988163,-44.24714902790174
2024-09-01T18:00:00-04:00,19600,19628,19569,19617,19198.076094670218,NaN,NaN,NaN,NaN,NaN,19652.27,19999.89190437276,19304.648095627243,19279.426186031582,19604.666666666668,19604.666666666668,19604.666666666668,36572,226313.13333333333,53.20411753950537,45.80143911321977,NaN,NaN,NaN,NaN,142.30547760594965,17.070858212785065,7738300,21.362565730392454,-17.543941864911176,-38.90650759530363
2024-09-01T22:00:00-04:00,19616.5,19616.5,19565,19584.25,19198.076094670218,NaN,NaN,NaN,NaN,NaN,19647.85,19993.19149765158,19302.508502348417,19304.476165798536,19597.25833284172,19605.275021201705,19589.241644481735,31232,225972.93333333332,51.58089000917274,47.10136693197504,NaN,NaN,NaN,NaN,135.8550863483818,16.715235471567798,7707068,21.514787862787202,-12.013022766819631,-33.52781062960683
2024-09-02T02:00:00-04:00,19585,19593.75,19511.5,19590,19198.076094670218,NaN,NaN,NaN,NaN,NaN,19643.3,19985.56185881583,19301.03814118417,19304.476165798536,19582.907830377007,19599.978087098534,19565.83757365548,54589,226088.06666666668,51.85860164735508,48.62456530877714,NaN,NaN,NaN,NaN,132.02615160921167,16.77448752522396,7761657,21.154975231638296,-7.084091590058961,-28.239066821697257
2024-09-02T06:00:00-04:00,19589.25,19645.25,19579.75,19619.5,19225.750790079983,NaN,NaN,NaN,NaN,NaN,19639.05,19977.08495381412,19301.01504618588,19379.904746111064,19593.266376620413,19613.76638678809,19572.766366452735,58785,220463,53.33732114818545,49.7950026802362,NaN,NaN,NaN,NaN,127.27428363712512,16.322251641995,7820442,21.96054415105288,-0.7883866328811564,-22.748930783934036
2024-09-02T10:00:00-04:00,19619.75,19669.75,19587.75,19646.75,19248.39848143998,NaN,NaN,NaN,NaN,NaN,19636.075,19971.155352303344,19300.994647696658,19416.47379688885,19607.55191099129,19633.32146376133,19581.782358221248,95162,202191.33333333334,54.720869532113554,50.38551170851941,NaN,NaN,NaN,NaN,124.04040623447334,15.665471574977028,7915604,23.260680129401493,6.3269193778178305,-16.933760751583662
2024-09-02T18:00:00-04:00,19646.75,19683,19546,19595,19248.39848143998,NaN,NaN,NaN,NaN,NaN,19630.38,19958.303592319975,19302.456407680027,19416.47379688885,19607.652423237858,19630.349233614335,19584.95561286138,79912,197744.93333333332,51.59235234854141,50.243707445145176,NaN,NaN,NaN,NaN,124.96609150343953,15.402021156023322,7835692,19.708034645811928,7.701282555681246,-12.00675209013068
2024-09-02T22:00:00-04:00,19595,19599,19514,19566.25,19248.39848143998,NaN,NaN,NaN,NaN,NaN,19623.835,19943.448792099472,19304.221207900526,19416.47379688885,19601.411379042365,19628.020384822805,19574.802373261926,53368,197654.73333333334,49.88597074318537,50.01484703602193,NaN,NaN,NaN,NaN,122.11137068176528,15.417199265234025,7782324,14.722882972924324,6.396851626024727,-8.326031346899597
2024-09-03T02:00:00-04:00,19567,19644.75,19445.25,19468.5,19248.39848143998,NaN,NaN,NaN,NaN,NaN,19614.89,19926.251673300005,19303.528326699994,19416.47379688885,19583.360820750877,19624.649248200312,19542.07239330144,115781,200389.16666666666,44.49722869421431,49.981783251236166,NaN,NaN,NaN,NaN,127.63912991878205,15.957287850058982,7666543,4.664218829254662,-2.49575781033127,-7.159976639585932
2024-09-03T06:00:00-04:00,19469,19522,19330.5,19372,19248.39848143998,NaN,NaN,NaN,NaN,NaN,19603.795,19909.39736730147,19298.192632698527,19416.47379688885,19520.217228823458,19610.580870737333,19429.853586909583,296078,208593.4,39.913451657457344,49.6441078966264,NaN,NaN,NaN,NaN,132.20062063886903,17.204750098285295,7370465,-7.977991463676689,-17.132465969181794,-9.154474505505105
2024-09-03T10:00:00-04:00,19367.25,19386,19104.5,19108.75,NaN,NaN,NaN,19660.358828162836,19660.358828162836,19660.358828162836,19588.11,19912.64525478737,19263.57474521263,19416.47379688885,19378.914709122397,19551.777625661332,19206.05179258346,647879,219356.26666666666,30.640596331146,48.58819745263065,NaN,NaN,NaN,NaN,142.86486202180694,19.425280176258603,6722586,-32.20020486280714,-49.40473058401403,-17.204525721206892
2024-09-03T14:00:00-04:00,19108.75,19113.5,18911,18995.5,NaN,NaN,NaN,19436.10388142816,NaN,NaN,19569.7,19921.070744371038,19218.329255628963,19416.47379688885,19313.15266473723,19524.71304806298,19101.592281411482,315277,211765.43333333332,27.663110378038084,47.05075322452155,NaN,NaN,NaN,NaN,147.12451473453504,22.117939308661853,6407309,-52.76473106230969,-83.16043954909401,-30.395708486784315
2024-09-03T18:00:00-04:00,18991,19007,18824.25,18888.25,NaN,NaN,NaN,19345.133250454153,NaN,NaN,19547.935,19929.35021744647,19166.519782553532,19416.47379688885,18906.5,18906.5,18906.5,128146,211071.76666666666,25.168756640946057,45.121411676402715,NaN,NaN,NaN,NaN,149.6691922534968,24.85155095604108,6279163,-69.45549586341004,-117.21507831604686,-47.75958245263682
2024-09-03T22:00:00-04:00,18888,18934.5,18837,18854.5,NaN,NaN,NaN,19309.030602706236,NaN,NaN,19532.87,19960.364669440703,19105.375330559295,19416.47379688885,18893.784156653313,18909.101394622885,18878.466918683742,88315,212062.53333333333,24.422466481056162,43.622098440167896,NaN,NaN,NaN,NaN,145.94282137824703,27.389904628607503,6190848,-77.99440318109643,-145.25258642900735,-67.25818324791092
2024-09-04T02:00:00-04:00,18854.75,18943.25,18830.75,18922,NaN,NaN,NaN,19306.38148440141,NaN,NaN,19519.07,19978.789458365736,19059.350541634263,19416.47379688885,18895.449642087104,18908.09656337908,18882.802720795127,112064,214859.56666666668,28.959447508600903,41.960370047108405,NaN,NaN,NaN,NaN,143.55404842265796,29.645769202089316,6302912,-74.33695704139316,-160.17937954965237,-85.8424225082592
2024-09-04T06:00:00-04:00,18921.75,18991,18843.5,18972.5,NaN,NaN,NaN,19306.38148440141,NaN,NaN,19505.625,19988.58915239637,19022.66084760363,19411.87903751108,18913.631884115977,18935.72882751791,18891.534940714046,271086,222248.33333333334,32.23692445983424,40.46271339856047,NaN,NaN,NaN,NaN,143.83590210675382,31.180216348273298,6573998,-64.1422735305043,-166.02026442138958,-101.87799089088529
2024-09-04T10:00:00-04:00,18971.25,19115,18836,19005.75,NaN,NaN,NaN,19306.38148440141,NaN,NaN,19492.085,19992.086186098837,18992.08381390116,19339.603230008863,18951.23409768682,18990.28159587653,18912.186599497112,656396,235529.86666666667,34.3834289548343,39.23432332325058,NaN,NaN,NaN,NaN,153.4904805277,31.29609772364857,7230394,-51.33925992307357,-166.05206579472724,-114.71280587165367
2024-09-04T14:00:00-04:00,19005.75,19032,18907.5,18962.25,NaN,NaN,NaN,19306.38148440141,NaN,NaN,19477.02,19994.280319761707,18959.759680238294,19337.48258400709,18953.81460901103,18990.059797776426,18917.569420245636,241239,221779.2,32.91447586287744,37.88117148150217,NaN,NaN,NaN,NaN,151.41973191857855,31.403701857925608,6989155,-42.35354381193886,-167.65473563657724,-125.30119182463838
2024-09-04T18:00:00-04:00,18968.5,19008.25,18891.5,18984.25,NaN,NaN,NaN,19306.38148440141,NaN,NaN,19461.81,19991.266604076234,18932.35339592377,19180.436067205672,18961.333333333332,18961.333333333332,18961.333333333332,71992,212479.46666666667,34.43998870943295,36.53136202159128,NaN,NaN,NaN,NaN,148.94332249582294,31.58916457661475,7061147,-31.954892631232383,-165.24480761367886,-133.28991498244648
2024-09-04T22:00:00-04:00,18983.75,18988.75,18882.5,18939.25,NaN,NaN,NaN,19306.38148440141,NaN,NaN,19445.94,19989.345654737102,18902.534345262895,18971.998853764537,18949.178072588224,18961.427706240436,18936.92843893601,70887,211306.26666666666,32.79714010415226,34.96538134816548,NaN,NaN,NaN,NaN,145.89379946040702,31.81173304860317,6990260,-25.418707411533717,-165.0632992468636,-139.6445918353299
2024-09-05T02:00:00-04:00,18938.25,19003,18887.75,18937.75,NaN,NaN,NaN,19306.38148440141,NaN,NaN,19429.14,19982.324853010316,18875.955146989683,18681.049083011632,18946.62403022979,18956.590566520856,18936.65749393872,96267,212795.7,32.74107522256119,33.61886155345261,NaN,NaN,NaN,NaN,143.70495664180652,31.84630169007905,6893993,-18.81207590561047,-163.159686717343,-144.34761081173252
2024-09-05T06:00:00-04:00,18937.5,19062,18828,19051,NaN,NaN,NaN,19306.38148440141,NaN,NaN,19414.09,19966.661287346757,18861.518712653244,18676.40728352125,18966.21306457084,18984.051531286437,18948.37459785524,331767,220261.9,40.948675745991174,32.98048333936731,NaN,NaN,NaN,NaN,150.1546025959632,32.23980573786179,7225760,-5.141667123380046,-150.7746947159576,-145.63302759257755
2024-09-05T10:00:00-04:00,19051,19150.25,18842,19012.25,NaN,NaN,NaN,19306.38148440141,NaN,NaN,19398.64,19952.09021600875,18845.18978399125,18679.162070931394,18985.46893843602,19006.758775770228,18964.179101101814,685758,229820.1,39.18660978372667,32.60115341718962,NaN,NaN,NaN,NaN,161.44713098196584,31.562871931359116,6540002,2.550988989036739,-142.4442913562816,-144.99528034531835
2024-09-05T14:00:00-04:00,19012.25,19040.75,18898.25,18923.75,NaN,NaN,NaN,19306.38148440141,NaN,NaN,19380.365,19934.98652148986,18825.743478510143,18679.162070931394,18980.67144441556,19003.262608786627,18958.08028004449,228181,216782.43333333332,35.4361455781341,32.281345840095106,NaN,NaN,NaN,NaN,160.093764483254,30.93429053960663,6311821,2.9129007965518667,-141.35415434962852,-144.26705514618038
2024-09-05T18:00:00-04:00,18920,18934.25,18790.5,18876,NaN,NaN,NaN,19306.38148440141,NaN,NaN,19363.44,19926.87509439895,18800.004905601047,18679.162070931394,18866.916666666668,18866.916666666668,18866.916666666668,80677,205740.93333333332,33.56931624327703,32.49054011953303,NaN,NaN,NaN,NaN,158.92635273445015,31.072039368178118,6231144,1.25500278932941,-142.69830165951862,-143.95330444884803
2024-09-05T22:00:00-04:00,18875.75,18906.75,18830.75,18872.5,NaN,NaN,NaN,19306.38148440141,NaN,NaN,19350.15,19927.75239784798,18772.547602152023,18679.162070931394,18868.313851720806,18869.84873317153,18866.778970270083,66851,206121.23333333334,33.4302961054925,32.90248195720835,NaN,NaN,NaN,NaN,153.00304182484658,31.19994899470878,6164293,1.2391080922439812,-142.40441933354305,-143.64352742578703
2024-09-06T02:00:00-04:00,18873.25,18886.25,18703.75,18761,NaN,NaN,NaN,19245.143766309404,NaN,NaN,19334.375,19932.04525398632,18736.70474601368,18679.162070931394,18828.972835459357,18871.206135868895,18786.73953504982,128104,209102.33333333334,29.271465830871307,33.195532613631585,NaN,NaN,NaN,NaN,155.1099674087861,32.04594053986352,6036189,-4.641909384941698,-149.44591415696414,-144.80400477202244
2024-09-06T06:00:00-04:00,18760.75,18972.5,18722,18745.75,NaN,NaN,NaN,19245.143766309404,NaN,NaN,19317.895,19933.85734535881,18701.93265464119,18679.162070931394,18819.174175336502,18845.942905450236,18792.40544522277,469096,222894.5,28.744758578175208,33.5042677634258,NaN,NaN,NaN,NaN,161.92354116530137,31.811429692272224,5567093,-7.737749547416712,-154.47619170629332,-146.7384421588766
2024-09-06T10:00:00-04:00,18745.75,18789,18428.75,18478,NaN,NaN,NaN,19100.75805979844,NaN,NaN,19295.09,19948.195028000784,18641.984971999216,18679.162070931394,18687.717928695678,18815.955108721315,18559.48074867004,799386,241201.16666666666,21.44767442162177,32.96771254292729,NaN,NaN,NaN,NaN,176.08971679635127,32.95581544439207,4767707,-25.021929687482157,-178.0158542682293,-152.99392458074715
2024-09-06T14:00:00-04:00,18478,18533.25,18337.25,18377.5,NaN,NaN,NaN,18931.502011625787,NaN,NaN,19269.99,19964.45109293447,18575.528907065534,18679.162070931394,18649.899843430667,18801.56266561607,18498.237021245262,249660,226899.46666666667,19.45163936638282,32.054477893395045,NaN,NaN,NaN,NaN,177.51187988232618,34.32597995893409,4518047,-39.56248685530744,-202.44703314988146,-162.88454629457402
2024-09-08T18:00:00-04:00,18399.5,18526.25,18386.75,18513,NaN,NaN,NaN,18931.502011625787,NaN,NaN,19249.415,19970.88386010408,18527.94613989592,18679.162070931394,18475.333333333332,18475.333333333332,18475.333333333332,91837,221744.8,29.040294073957895,31.67282540190387,NaN,NaN,NaN,NaN,175.45745989073143,35.598275579580246,4609884,-36.47001469189249,-208.47206465943964,-172.00204996754715
2024-09-08T22:00:00-04:00,18513.5,18584.75,18497.25,18553,NaN,NaN,NaN,18931.502011625787,NaN,NaN,19226.74,19962.918816320936,18490.561183679067,18679.162070931394,18502.18698028194,18536.093996022788,18468.27996454109,57603,222445.83333333334,31.627826146853835,31.580921850759328,NaN,NaN,NaN,NaN,169.17478418425063,36.15304398771787,4667487,-28.49907820705363,-207.6258977263642,-179.12681951931057
2024-09-09T02:00:00-04:00,18553.25,18636.25,18546.75,18627,NaN,NaN,NaN,18931.502011625787,NaN,NaN,19206.555,19952.0002916881,18461.109708311902,18592.629656745117,18538.458526473012,18594.05090633009,18482.866146615936,83552,224189.83333333334,36.258583816146476,31.71082150123886,NaN,NaN,NaN,NaN,163.4837281710899,36.13736409262926,4751039,-15.653508725183968,-198.69370542579054,-183.04019670060657
2024-09-09T06:00:00-04:00,18626.25,18697.5,18565.5,18687.5,NaN,NaN,NaN,18931.502011625787,NaN,NaN,19188.125,19938.409287787003,18437.840712212997,18529.5799074028,18597.1376818681,18664.804466170546,18529.47089756565,257817,230964.1,39.84571745050626,32.21429131169272,NaN,NaN,NaN,NaN,161.23489044458347,35.51830068834336,5008856,-1.2518606454227381,-184.605022507385,-183.35316186196226
2024-09-09T10:00:00-04:00,18687.25,18730,18497.25,18639.75,NaN,NaN,NaN,18931.502011625787,NaN,NaN,19168.25,19922.92539379527,18413.57460620473,18529.5799074028,18611.41977382582,18657.67109178817,18565.16845586347,642300,250414.6,38.02677872172757,32.591841561633174,NaN,NaN,NaN,NaN,166.34311255568466,35.303600632452515,4366556,6.464740298687332,-175.27223648860308,-181.73697678729042
2024-09-09T14:00:00-04:00,18639.5,18735,18566.5,18724.25,NaN,NaN,NaN,18931.502011625787,NaN,NaN,19149.395,19900.383455903204,18398.406544096797,18529.5799074028,18623.224219846397,18671.780473325878,18574.667966366917,257098,255812.46666666667,42.98676126485209,32.73741909869467,NaN,NaN,NaN,NaN,166.49717594456433,35.052607085468004,4623654,18.011917825545822,-159.22207950535812,-177.23399733090395
2024-09-09T18:00:00-04:00,18723.75,18742,18637.25,18693.5,NaN,NaN,NaN,18931.502011625787,NaN,NaN,19132.11,19884.48988516443,18379.730114835573,18529.5799074028,18690.916666666668,18690.916666666668,18690.916666666668,63655,255270.56666666668,41.67947291778603,32.91548075112748,NaN,NaN,NaN,NaN,162.08666337709545,34.742756755695844,4559999,23.958665857959886,-147.2856650084541,-171.24433086641397
2024-09-09T22:00:00-04:00,18693,18693.75,18612,18623.5,NaN,NaN,NaN,18931.502011625787,NaN,NaN,19118.625,19882.724412707474,18354.525587292526,18351.570661566053,18669.440712799693,18693.23251528467,18645.648910314714,51866,255220.5,38.787674534473474,33.15487567658029,NaN,NaN,NaN,NaN,156.34833027873148,34.60703587661193,4508133,23.523984872540126,-141.8393497757388,-165.36333464827894
2024-09-10T02:00:00-04:00,18624.25,18693,18582.5,18638.5,NaN,NaN,NaN,18931.502011625787,NaN,NaN,19105.115,19878.74651571002,18331.483484289984,18355.175223402275,18656.218886637205,18680.070400835568,18632.367372438843,83836,254155.66666666666,39.752311901384864,33.596518223588,NaN,NaN,NaN,NaN,153.07344954453635,34.659480207457406,4591969,24.483220007661004,-134.7593096387027,-159.2425296463637
2024-09-10T06:00:00-04:00,18638.5,18821.75,18615.75,18762.5,NaN,NaN,NaN,18931.502011625787,NaN,NaN,19095.755,19874.400217605467,18317.109782394535,18448.49017872182,18703.037943371426,18743.55829754694,18662.51758919591,308090,254556.06666666668,47.16479488790133,34.57755385090291,NaN,NaN,NaN,NaN,156.8539174342123,33.269298172267185,4900059,33.16617321693141,-117.78481312519943,-150.95098634213085
2024-09-10T10:00:00-04:00,18762.5,18816.5,18589.75,18787.25,NaN,NaN,NaN,18931.502011625787,NaN,NaN,19085.04,19865.624353929765,18304.455646070237,18448.49017872182,18719.686024687606,18749.033361039503,18690.33868833571,735849,257488.4,48.52607900203341,35.95288336312878,NaN,NaN,NaN,NaN,161.84649476034,32.16833968704984,5635908,39.82553297517373,-101.16907012316369,-140.99460309833742
2024-09-10T14:00:00-04:00,18786.75,18876.75,18786.75,18837.75,NaN,NaN,NaN,18931.502011625787,NaN,NaN,19072.035,19846.978520587105,18297.091479412895,18502.163714381964,18736.171056443127,18784.600222543388,18687.741890342866,210043,253980.6,51.2840963872637,37.56283606377796,NaN,NaN,NaN,NaN,156.71460227745857,30.535118952396473,5845951,46.41998331701035,-82.96962395207447,-129.38960726908482
2024-09-10T18:00:00-04:00,18841.75,18857.25,18748,18777.75,NaN,NaN,NaN,18931.502011625787,NaN,NaN,19054.71,19816.34876844605,18293.07123155395,18502.955971505573,18794.333333333332,18794.333333333332,18794.333333333332,70273,252051.5,47.993768660251796,39.458985652251535,NaN,NaN,NaN,NaN,153.3242735433544,29.328593770384753,5775678,45.47040532679007,-72.55160061059723,-118.0220059373873
2024-09-10T22:00:00-04:00,18778,18799.75,18704.75,18751.25,NaN,NaN,NaN,18931.502011625787,NaN,NaN,19037.055,19784.963886763577,18289.146113236424,18502.955971505573,18772.91671187356,18794.12402237808,18751.70940136904,71667,251496.56666666668,46.57253452547606,41.396192449329625,NaN,NaN,NaN,NaN,149.15825400454338,28.543773476120993,5704011,41.87641046393652,-65.67649285746666,-107.55290332140318
2024-09-11T02:00:00-04:00,18750.75,18825.25,18746.25,18807.25,NaN,NaN,NaN,18931.502011625787,NaN,NaN,19024.21,19765.373736026115,18283.046263973883,18521.001821763566,18780.930694595154,18800.051116676997,18761.81027251331,94903,250924.53333333333,49.945782649218415,42.8894416332768,NaN,NaN,NaN,NaN,144.14695014707598,27.532810803015543,5798914,41.982861940468695,-55.07432589581731,-97.057187836286
2024-09-11T06:00:00-04:00,18807.25,18929.25,18730.75,18792,NaN,NaN,NaN,18931.502011625787,NaN,NaN,19011.22,19745.407963943777,18277.032036056225,18586.601457410852,18803.38051724147,18824.672908701188,18782.08812578175,381076,254590.86666666667,49.037792520706915,44.13301065998059,NaN,NaN,NaN,NaN,148.0293108508563,25.583181776565965,5417838,39.760405149040025,-47.35668139998597,-87.117086549026
2024-09-11T10:00:00-04:00,18792,19071.5,18547.75,19040.25,18381.498604158252,18381.498604158252,18381.498604158252,NaN,NaN,NaN,19002.895,19726.054886124653,18279.735113875347,18586.601457410852,18852.191124128072,18895.339368402827,18809.042879853318,879102,262014.4,61.35430009077994,45.92556182245441,NaN,NaN,NaN,NaN,174.86650293293798,25.13541937283113,6296940,52.92007104106469,-20.96699774769513,-73.88706878875982
2024-09-11T14:00:00-04:00,19040.25,19293.5,19031.75,19246.25,18650.102550483036,NaN,NaN,NaN,NaN,NaN,18997.23,19708.134043032638,18286.32595696736,18733.829932742945,18908.782909051803,19041.04480771064,18776.521010392964,300724,263997.23333333334,68.21832401752295,47.95217657724131,NaN,NaN,NaN,NaN,181.0724670091567,23.691180376397288,6597664,72.2141901556334,16.38066890578193,-55.83352124985147
2024-09-11T18:00:00-04:00,19246,19289.75,19228,19278.25,18761.228570915624,NaN,NaN,NaN,NaN,NaN,18990.975,19686.20216611208,18295.747833887915,18811.138946194358,19265.333333333332,19265.333333333332,19265.333333333332,45698,263120.76666666666,69.13540079170524,50.17422101081115,NaN,NaN,NaN,NaN,172.54943365135978,22.35010130828015,6643362,83.07297184891219,48.00769356128876,-35.06527828762343
2024-09-11T22:00:00-04:00,19277.75,19329.25,19263.25,19311.25,18812.223863146733,NaN,NaN,NaN,NaN,NaN,18988.27,19677.412502244522,18299.12749775548,18913.361156955485,19283.04103337845,19300.997617658533,19265.084449098365,44440,262239.2,70.0937836017715,52.11043689201968,NaN,NaN,NaN,NaN,164.93875981911978,21.377984410281954,6687802,87.9498897435633,74.8720838918307,-13.077805851732602
2024-09-12T02:00:00-04:00,19310,19342.5,19260,19295,18827.97505118552,NaN,NaN,NaN,NaN,NaN,18982.29,19655.304341303417,18309.275658696584,18968.53892556439,19291.177152384615,19306.1690630889,19276.18524168033,91792,262090.03333333333,68.95827900501342,54.05892304110735,NaN,NaN,NaN,NaN,159.05027697489692,20.568660835201882,6596010,85.47835967024804,93.77014373607744,8.291784065829408
2024-09-12T06:00:00-04:00,19295,19329.25,19185.25,19257.25,18827.97505118552,NaN,NaN,NaN,NaN,NaN,18975.095,19628.211321109622,18321.97867889038,18968.53892556439,19269.394614705547,19287.96865629711,19250.820573113982,326309,261908.1,66.27237669334147,56.02211605245507,NaN,NaN,NaN,NaN,157.97525719097573,19.187941417970027,6269701,76.96362421989966,104.49631434070398,27.53269012080432
2024-09-12T10:00:00-04:00,19257.75,19468.75,19220.5,19465.75,18860.801131348788,NaN,NaN,NaN,NaN,NaN,18972.725,19617.79264180204,18327.657358197957,19047.68991236121,19336.78434321551,19395.034900710176,19278.533785720843,710352,262727.9,72.61643982554472,58.36955376132362,NaN,NaN,NaN,NaN,164.42345310590602,18.883445690424303,6980053,80.64716526517168,128.34164670226892,47.69448143709724
2024-09-12T14:00:00-04:00,19466.5,19483.25,19357.5,19413.25,18941.395398105662,NaN,NaN,NaN,NaN,NaN,18969.19,19602.51849738523,18335.861502614767,19083.526929888965,19351.95563589048,19413.284755637374,19290.626516143588,279927,264452.76666666666,69.09232931116512,59.935806220128185,NaN,NaN,NaN,NaN,161.66106359834131,18.69352562129455,6700126,74.9430309303636,141.37327010005174,66.43023916968814
2024-09-12T18:00:00-04:00,19410,19473.25,19410,19443.5,18975.792198191768,NaN,NaN,NaN,NaN,NaN,18965.67,19586.331561883955,18345.00843811604,19121.846543911175,19442.25,19442.25,19442.25,44978,263262.8,69.99586727141144,61.46936252508375,NaN,NaN,NaN,NaN,154.6317019127455,18.517171271388353,6745104,68.76400503828714,152.38524546754707,83.62124042925993
2024-09-12T22:00:00-04:00,19443,19488.5,19420,19445,19000.250507364868,NaN,NaN,NaN,NaN,NaN,18961.635,19566.96683635122,18356.303163648776,19173.127235128937,19446.182526367244,19450.609744814345,19441.755307920143,35488,262217.36666666664,70.04263371232966,62.80925804830275,NaN,NaN,NaN,NaN,148.47943749040655,18.46286925607773,6780592,60.61975615413988,159.39593562193477,98.77617946779489
2024-09-13T02:00:00-04:00,19445.25,19478.25,19424.5,19462.5,19010.68230248465,NaN,NaN,NaN,NaN,NaN,18958.985,19554.279636377563,18363.690363622438,19199.07678810315,19450.275538870505,19455.77694749467,19444.77413024634,68503,260230.66666666666,70.61802814220434,64.42527658272793,NaN,NaN,NaN,NaN,141.71304909823465,18.412445956146442,6849095,52.553596490192675,164.46817508053573,111.91457859034305
2024-09-13T06:00:00-04:00,19462.5,19503,19396,19466.75,19014.247879644437,NaN,NaN,NaN,NaN,NaN,18956.995,19544.7740612977,18369.2159387023,19226.16143048252,19453.09600660987,19457.47556636641,19448.71644685333,195062,251096.2,70.76488774669807,66.15330181281522,NaN,NaN,NaN,NaN,139.2335455912179,18.044874139457363,7044157,43.99385873242487,166.90690200587414,122.91304327344928
2024-09-13T10:00:00-04:00,19466.75,19577,19412.25,19561.25,19056.69115784242,NaN,NaN,NaN,NaN,NaN,18958.85,19553.61835827096,18364.081641729037,19273.154144386015,19491.01560505767,19522.42845666821,19459.60275344713,505293,241293.1,73.88993719811532,67.86359856630784,NaN,NaN,NaN,NaN,141.05614947755947,18.300505597635038,7549450,41.23274464165141,174.45397407551354,133.22122943386213
2024-09-13T14:00:00-04:00,19561,19573.75,19491.75,19504,19103.540423395036,NaN,NaN,NaN,NaN,NaN,18961.49,19564.682481385316,18358.297518614687,19289.673315508815,19497.137658320356,19528.0928301709,19466.182486469814,199762,239629.83333333334,69.0728151400469,69.29467161054643,NaN,NaN,NaN,NaN,136.83785308630522,18.537877665942883,7349688,32.47252944061057,173.81189123462536,141.3393617940148
2024-09-15T18:00:00-04:00,19498.25,19546.75,19478.5,19526.5,19103.540423395036,NaN,NaN,NaN,NaN,NaN,18969.845,19592.232346352677,18347.457653647325,19289.673315508815,19517.25,19517.25,19517.25,41025,237936.1,69.90326505948272,69.90531196545376,NaN,NaN,NaN,NaN,131.93872072299772,18.58787593997891,7390713,25.426866068313984,173.12294437940727,147.6960783110933
2024-09-15T22:00:00-04:00,19526.25,19532.5,19506.5,19517.5,19115.9934436306,NaN,NaN,NaN,NaN,NaN,18980.285,19621.2775585371,18339.2924414629,19310.390921925642,19517.717073946144,19518.43913741713,19516.99501047516,17166,236588.2,69.10394525330484,69.96857062515247,NaN,NaN,NaN,NaN,124.3716692427836,18.63430290872665,7373547,17.756986500912348,169.89231143723373,152.13532493632138
2024-09-16T02:00:00-04:00,19517.25,19543.5,19481.25,19515,19118.721014374663,NaN,NaN,NaN,NaN,NaN,18992.82,19650.420889902176,18335.219110097823,19334.687737540513,19516.150248806178,19518.359928864316,19513.94056874804,31437,234851.03333333333,68.86837246885639,69.94949717352041,NaN,NaN,NaN,NaN,119.93440715401334,18.32350136205429,7342110,10.47227112700537,165.2256638450781,154.75339271807272
2024-09-16T06:00:00-04:00,19515.25,19516.75,19326.75,19428.75,19118.721014374663,NaN,NaN,NaN,NaN,NaN,19004.305,19671.825421335463,18336.784578664538,19334.687737540513,19460.584299848128,19505.64144842873,19415.527151267524,136442,230805.2,61.12634861538981,69.30896610306458,NaN,NaN,NaN,NaN,124.93909235729811,17.74918044102924,7205668,-1.5577517439194537,152.8062030381734,154.36395478209286
2024-09-16T10:00:00-04:00,19429,19462.25,19299,19428.75,19118.721014374663,NaN,NaN,NaN,NaN,NaN,19014.44,19691.96711798143,18336.91288201857,19334.687737540513,19423.636076774288,19466.6833993308,19380.588754217777,309717,219719.1,61.12634861538981,68.74954250380576,NaN,NaN,NaN,NaN,127.67558576034824,17.47169847662424,7205668,-10.423583808925315,141.33447502093622,151.75805882986154
2024-09-16T14:00:00-04:00,19428.75,19452.25,19394.75,19418.25,19118.721014374663,NaN,NaN,NaN,NaN,NaN,19023.355,19710.107772764637,18336.602227235362,19334.687737540513,19423.37848535489,19463.383581054586,19383.373389655193,84750,213974.16666666666,60.17130397720612,68.31375159551037,NaN,NaN,NaN,NaN,122.66304392032337,17.214036652533885,7120918,-17.487728824518143,129.89839779921385,147.386126623732
2024-09-16T18:00:00-04:00,19658,19696,19632.75,19654,19249.383361457545,NaN,NaN,NaN,NaN,NaN,19036.32,19745.368136870875,18327.271863129125,19347.715497296595,19660.916666666668,19660.916666666668,19660.916666666668,26019,212719.63333333333,71.09218305530851,68.20487611192206,NaN,NaN,NaN,NaN,133.74068364030026,17.345417722016805,7146937,-7.297339360857734,138.26445242265982,145.56179178351755
2024-09-16T22:00:00-04:00,19653.75,19691.5,19637.25,19688,19260.848890482204,NaN,NaN,NaN,NaN,NaN,19050.835,19782.574404501443,18319.095595498555,19385.747397837276,19664.94822954067,19670.37386745613,19659.522591625213,14366,211469.63333333333,72.27298361010718,68.43206570470365,NaN,NaN,NaN,NaN,128.0627776659931,17.467414429393806,7161303,0.31507942130079414,145.95564106014353,145.64056163884274
2024-09-17T02:00:00-04:00,19688.5,19787,19675,19774,19330.54325909665,NaN,NaN,NaN,NaN,NaN,19066.63,19825.528776122235,18307.731223877767,19486.39791826982,19707.469697411492,19747.76713266001,19667.172262162974,45353,210186.86666666667,75.04918062219114,68.79301665833076,NaN,NaN,NaN,NaN,126.91543640413646,18.25203302582941,7206656,9.230420941182217,157.1785878153205,147.94816687413828
2024-09-17T06:00:00-04:00,19774.5,19828.75,19709,19761,19370.291292774073,NaN,NaN,NaN,NaN,NaN,19083.065,19865.4465169725,18300.683483027497,19528.393334615856,19750.31155135917,19783.825031147528,19716.79807157081,230460,207599.2,73.84552865029018,69.06465201104223,NaN,NaN,NaN,NaN,126.4036195181267,19.245494994849103,6976196,12.15606554249021,163.14324880225104,150.98718325976083
2024-09-17T10:00:00-04:00,19760.5,19850.5,19574.5,19661.25,19370.291292774073,NaN,NaN,NaN,NaN,NaN,19097.535,19895.242860121773,18299.827139878227,19528.393334615856,19714.82094708526,19747.77064547602,19681.8712486945,578329,202348.53333333333,65.2041251520206,68.67794465460054,NaN,NaN,NaN,NaN,137.08907526683194,18.729196302302622,6397867,5.6102285620779355,157.99996896235825,152.38974040028032
2024-09-17T14:00:00-04:00,19661.25,19702.25,19609.25,19685,19370.291292774073,NaN,NaN,NaN,NaN,NaN,19110.215,19924.543355210582,18295.886644789418,19528.393334615856,19706.971151682985,19742.162460535063,19671.779842830907,169319,200991.06666666668,66.21776540120055,68.35315020135072,NaN,NaN,NaN,NaN,133.93985560491538,18.249776087795173,6567186,1.3396886460844826,154.06435120788592,152.72466256180144
2024-09-17T18:00:00-04:00,19686.5,19715,19678.75,19710.5,19370.291292774073,NaN,NaN,NaN,NaN,NaN,19124.18,19955.089249196262,18293.27075080374,19528.393334615856,19701.416666666668,19701.416666666668,19701.416666666668,18415,199262.46666666667,67.3185899912483,67.88376825800307,NaN,NaN,NaN,NaN,126.96200877599286,17.90817065739403,6585601,-1.17224290036728,151.25935893634232,152.4316018367096
2024-09-17T22:00:00-04:00,19710.5,19715.75,19669.25,19692.5,19370.291292774073,NaN,NaN,NaN,NaN,NaN,19139.555,19983.409165658846,18295.700834341154,19528.393334615856,19696.76251016735,19701.216540858386,19692.308479476316,20107,197543.8,65.69133780724951,67.64223416280326,NaN,NaN,NaN,NaN,121.21472243485051,17.485185968319797,6565494,-5.2236297856402985,145.90206460465924,151.12569439029954
2024-09-18T02:00:00-04:00,19691.5,19727,19657.75,19710.25,19370.291292774073,NaN,NaN,NaN,NaN,NaN,19156.24,20011.503011944063,18300.97698805594,19528.393334615856,19697.644044934004,19700.695742560365,19694.592347307644,49266,196022.56666666668,66.55000803594788,67.40271580397935,NaN,NaN,NaN,NaN,117.50295654664691,16.958592197808635,6614760,-7.734149867558557,141.45800705585134,149.1921569234099
2024-09-18T06:00:00-04:00,19710,19738.25,19667,19708.5,19370.291292774073,NaN,NaN,NaN,NaN,NaN,19172.96,20038.01213923782,18307.907860762178,19528.393334615856,19702.266225257503,19705.983719264692,19698.548731250314,175120,189157.36666666667,66.37363078408669,67.20769334189234,NaN,NaN,NaN,NaN,114.19917393617213,16.580814178764992,6439640,-10.37409562999008,136.2245373859223,146.59863301591238
2024-09-18T10:00:00-04:00,19708.25,19731.5,19583.5,19693.25,19370.291292774073,NaN,NaN,NaN,NaN,NaN,19191.605,20060.514610316353,18322.695389683646,19528.393334615856,19682.718454297952,19699.016194653497,19666.420713942407,386359,172732.6,64.76284837135391,66.91444162064217,NaN,NaN,NaN,NaN,116.61351865501697,15.53289100135959,6053281,-13.794666381539912,129.35530003898748,143.1499664205274
2024-09-18T14:00:00-04:00,19693.75,19899.75,19560.75,19633.25,19370.291292774073,NaN,NaN,NaN,NaN,NaN,19209.355,20077.366953201123,18341.343046798876,19528.393334615856,19690.400287687276,19704.151721548547,19676.648853826006,663559,184827.1,58.72439212278006,66.74287329974146,NaN,NaN,NaN,NaN,132.49826732251577,15.806781551545576,5389722,-20.34960540281159,117.71295966701291,138.0625650698245
2024-09-18T18:00:00-04:00,19646,19844.5,19635.5,19737.75,19370.291292774073,NaN,NaN,NaN,NaN,NaN,19234.55,20089.214431224304,18379.885568775695,19528.393334615856,19739.25,19739.25,19739.25,88157,186242.4,64.86835028744652,67.01015913345978,NaN,NaN,NaN,NaN,138.12339108519322,16.061108491003992,5477879,-17.981098432702595,115.58619202894624,133.56729046164884
2024-09-18T22:00:00-04:00,19738,19890.5,19731.25,19881,19394.256195547685,NaN,NaN,NaN,NaN,NaN,19264.62,20102.17805912197,18427.06194087803,19523.537719878106,19780.75325774513,19827.873201317772,19733.63331417249,68393,187040.83333333334,71.19753120751207,67.79774679276736,NaN,NaN,NaN,NaN,139.63243457910798,16.654883297867286,5546272,-7.629792406751449,124.03004995320953,131.65984235996098
2024-09-19T02:00:00-04:00,19881,19984.25,19863.5,19979.5,19509.727504840972,NaN,NaN,NaN,NaN,NaN,19293.95,20126.86786509826,18461.032134901743,19599.95431257759,19833.556749653744,19918.664143119204,19748.449356188285,75936,186512.3,74.58768554671,68.04742554215318,NaN,NaN,NaN,NaN,138.28368925202884,17.85411601895659,5622208,4.343894232684221,137.08971015081625,132.74581591813202
2024-09-19T06:00:00-04:00,19979.5,20073.25,19963.25,20009,19607.927390984565,NaN,NaN,NaN,NaN,NaN,19323.07,20152.131783222387,18494.008216777613,19710.813450062073,19930.705910339046,20038.28795246594,19823.12386821215,267412,184549.06666666668,75.51712816679068,68.27915015334486,NaN,NaN,NaN,NaN,136.26342573402678,19.486937597825253,5889620,12.293457753640098,148.11263811018216,135.81918035654206
2024-09-19T10:00:00-04:00,20009.75,20203,19998.75,20193.25,19681.35114593981,NaN,NaN,NaN,NaN,NaN,19354.395,20194.177353291547,18514.612646708454,19810.925760049657,20035.077314999988,20160.153367988667,19910.00126201131,540174,178876.46666666667,80.35094504630098,68.65784761220984,NaN,NaN,NaN,NaN,141.11960961016774,21.623012656991556,6429794,27.151813807210658,169.75894761555537,142.6071338083447
2024-09-19T14:00:00-04:00,20193.25,20201.75,20050,20063.25,19704.727230215274,NaN,NaN,NaN,NaN,NaN,19381.91,20222.63838515189,18541.18161484811,19812.215608039725,20048.732058126432,20164.30595363457,19933.158162618292,252398,177958.83333333334,69.8691884000921,68.37382330862427,NaN,NaN,NaN,NaN,141.87892320944147,23.60651092621741,6177396,25.444982267454236,174.4133616426625,148.96837937520826
2024-09-19T18:00:00-04:00,20070,20074.75,20023.5,20055.25,19704.727230215274,NaN,NaN,NaN,NaN,NaN,19410.22,20244.38138510477,18576.05861489523,19812.215608039725,20051.166666666668,20051.166666666668,20051.166666666668,45403,177973,69.27033340082635,68.66426675496753,NaN,NaN,NaN,NaN,135.40542869448137,25.090739178537962,6131993,21.172647719111467,175.43418902409758,154.2615413049861
2024-09-19T22:00:00-04:00,20055,20071.25,20020.25,20047.5,19704.727230215274,NaN,NaN,NaN,NaN,NaN,19436.685,20266.06386885292,18607.30613114708,19812.215608039725,20048.969881737612,20051.37652459459,20046.563238880633,37830,178051.06666666668,68.65641100479199,68.83845572665264,NaN,NaN,NaN,NaN,129.3764695020184,26.423505887776116,6094163,15.483966092779923,173.61649892096102,158.1325328281811
2024-09-20T02:00:00-04:00,20047.25,20069.75,20007.25,20012,19704.727230215274,NaN,NaN,NaN,NaN,NaN,19463.055,20279.98882406411,18646.121175935892,19812.215608039725,20040.67491258482,20050.401992546227,20030.94783262341,62718,177858.23333333334,65.78050469230607,68.72859249101391,NaN,NaN,NaN,NaN,124.59957882330282,27.46980415873169,6031445,7.399524386367432,167.3819383111404,159.98241392477297
2024-09-20T06:00:00-04:00,20012.25,20082.5,19981.25,20001.5,19704.727230215274,NaN,NaN,NaN,NaN,NaN,19490.615,20285.06342003727,18696.166579962734,19817.881713053073,20028.455566264398,20039.200912407567,20017.71022012123,265962,180221.56666666668,64.91438047268689,68.67309553854516,NaN,NaN,NaN,NaN,122.93175176449549,28.052668584945295,5765483,-0.1841569488991297,159.75221773864905,159.93637468754818
2024-09-20T10:00:00-04:00,20001.25,20036.5,19860,19995.5,19704.727230215274,NaN,NaN,NaN,NaN,NaN,19517.755,20286.199327781662,18749.31067221834,19817.881713053073,19991.230996740156,20023.82612476584,19958.63586871447,563082,182147.86666666667,64.39262650976589,68.51899685810359,NaN,NaN,NaN,NaN,126.75805520988867,27.021671314999345,5202401,-6.768823059722735,151.47534586289476,158.2441689226175
2024-09-20T14:00:00-04:00,19995.75,20084,19934,20014.5,19704.727230215274,NaN,NaN,NaN,NaN,NaN,19542.795,20292.5324986622,18793.057501337797,19817.881713053073,19995.349784718703,20025.399383951615,19965.30018548579,259359,184134.43333333332,65.34259226386592,68.44535124951639,NaN,NaN,NaN,NaN,128.41819412346806,26.45969709198937,5461760,-10.771277591446022,144.78007193330996,155.55134952475598
2024-09-22T18:00:00-04:00,20039,20149,19996.25,20131.25,19704.727230215274,NaN,NaN,NaN,NaN,NaN,19569.675,20305.372398731397,18833.9776012686,19820.660437083174,20092.166666666668,20092.166666666668,20092.166666666668,64714,184924.06666666668,70.54307226339648,68.8582243846623,NaN,NaN,NaN,NaN,130.15618025750604,26.436138405260053,5526474,-6.682710092230963,147.19796190946727,153.88067200169823
2024-09-22T22:00:00-04:00,20131.25,20164,20103.75,20107,19747.408905247186,NaN,NaN,NaN,NaN,NaN,19595.06,20315.416429554047,18874.703570445956,19871.20334966654,20105.52295590003,20121.61730305388,20089.428608746177,44568,185837.46666666667,68.25218636077906,69.53878111594793,NaN,NaN,NaN,NaN,125.16288166768418,26.525033786991774,5481906,-6.720235547731846,145.48037756703343,152.20061311476528
2024-09-23T02:00:00-04:00,20107.25,20108.25,19955,20078.5,19747.408905247186,NaN,NaN,NaN,NaN,NaN,19621.075,20314.950891280147,18927.199108719855,19871.20334966654,20076.29067841698,20107.563883212908,20045.01747362105,110003,188456.33333333334,65.55761293746076,69.58801416237752,NaN,NaN,NaN,NaN,127.16910440570673,24.937329813087512,5371903,-9.597857280210008,140.20329151450278,149.8011487947128
2024-09-23T06:00:00-04:00,20078.25,20106,20031.75,20066,19747.408905247186,NaN,NaN,NaN,NaN,NaN,19647.37,20306.162123814564,18988.577876185434,19871.20334966654,20072.262803975587,20095.177811335678,20049.347796615497,203227,190682.5,64.35749908240734,69.09944043915576,NaN,NaN,NaN,NaN,123.38916837672768,23.463033265890697,5168676,-13.061788571755045,133.47391308001897,146.53570165177402
2024-09-23T10:00:00-04:00,20066.25,20126.75,20018.5,20073.5,19747.408905247186,NaN,NaN,NaN,NaN,NaN,19672.695,20296.797918515793,19048.592081484207,19871.20334966654,20072.628733635167,20087.838459643302,20057.41900762703,536964,198257.4,64.77417312661501,68.39847526629183,NaN,NaN,NaN,NaN,122.3077992069614,22.29075557587678,5705640,-15.405498599406826,127.2788284025155,142.68432700192233
2024-09-23T14:00:00-04:00,20073.5,20089,20053.25,20063.25,19747.408905247186,NaN,NaN,NaN,NaN,NaN,19698.12,20278.698584172864,19117.541415827134,19871.20334966654,20072.110962480732,20086.400621189416,20057.82130377205,137578,200018.33333333334,63.678531303311004,67.5528612046147,NaN,NaN,NaN,NaN,116.12509926360701,21.202212006578144,5568062,-18.021865773936355,120.15699478450188,138.17886055843823
2024-09-23T18:00:00-04:00,20065.25,20095.75,20039,20050,19747.408905247186,NaN,NaN,NaN,NaN,NaN,19718.315,20275.739674821863,19160.890325178134,19872.09779361873,20061.583333333332,20061.583333333332,20061.583333333332,45906,200681.23333333334,62.21356212137736,66.25733385283444,NaN,NaN,NaN,NaN,111.88402074477793,20.020096002457283,5522156,-20.822352389156976,112.150920071992,132.97327246114898
2024-09-23T22:00:00-04:00,20050.5,20109.75,20022.5,20104,19747.408905247186,NaN,NaN,NaN,NaN,NaN,19735.47,20286.48515078982,19184.454849210182,19887.203234894983,20070.004932640877,20078.586742076473,20061.42312320528,44208,201675.96666666667,65.67899877216088,65.9580345936965,NaN,NaN,NaN,NaN,110.12444783443665,18.719243313586524,5566364,-19.252239122104555,108.90797355851828,128.16021268062283
2024-09-24T02:00:00-04:00,20104.75,20179.25,20093,20131.5,19786.57515452828,NaN,NaN,NaN,NaN,NaN,19752.535,20298.681509738813,19206.388490261186,19958.087587915987,20100.189406655278,20133.01297464861,20067.365838661946,79085,202800.36666666667,67.32258798627238,65.81890992122835,NaN,NaN,NaN,NaN,108.41913013197689,18.28112287324075,5645449,-16.67231479725885,107.31981918404927,123.99213398130811
2024-09-24T06:00:00-04:00,20131.25,20155.5,20050.5,20092.25,19786.57515452828,NaN,NaN,NaN,NaN,NaN,19768.155,20307.55650064696,19228.75349935304,19958.087587915987,20099.750361990566,20121.323460343934,20078.177263637197,222616,202538.9,62.7068616664688,65.39394211134812,NaN,NaN,NaN,NaN,108.1749065511214,17.332204528817755,5422833,-17.81653384285744,101.72146667773632,119.53800052059376
2024-09-24T10:00:00-04:00,20092.25,20214.75,19952,20165,19786.57515452828,NaN,NaN,NaN,NaN,NaN,19785.555,20318.876444252783,19252.233555747218,19958.087587915987,20106.262827938288,20120.88307721039,20091.642578666186,590598,202947.86666666667,67.19619169240738,65.49506261135537,NaN,NaN,NaN,NaN,119.21598465461273,16.81740689254939,6013431,-14.046806119177475,101.97949287162191,116.02629899079939
2024-09-24T14:00:00-04:00,20165.5,20189.5,20108.75,20185.5,19786.8488336858,NaN,NaN,NaN,NaN,NaN,19804.12,20327.11245921911,19281.127540780886,19958.087587915987,20114.135957858518,20137.674892368937,20090.5970233481,164169,202776.2,68.35230456841046,65.74062861819276,NaN,NaN,NaN,NaN,116.46841432214039,16.339380516014476,6177600,-10.697184537891516,102.65481831843499,113.35200285632651
2024-09-24T18:00:00-04:00,20184.25,20192.5,20116.75,20125.75,19798.486386700082,NaN,NaN,NaN,NaN,NaN,19817.32,20338.79893572036,19295.84106427964,19958.087587915987,20145,20145,20145,42857,203590.93333333332,61.54412070573115,65.53716391790456,NaN,NaN,NaN,NaN,113.55995615627322,15.855685953518076,6134743,-12.883456520114379,97.24768220618353,110.1311387262979
2024-09-24T22:00:00-04:00,20125.25,20142,20088.25,20098.25,19798.486386700082,NaN,NaN,NaN,NaN,NaN,19831.02,20345.25870760574,19316.781292394262,19958.087587915987,20127.452535192988,20145.2013796463,20109.703690739676,41890,204317.03333333333,58.64867270719983,65.05902680671413,NaN,NaN,NaN,NaN,109.28781643082513,15.724553800755611,6092853,-16.3374276883291,89.70935411588653,106.04678180421563
2024-09-25T02:00:00-04:00,20098.5,20115.75,20063.75,20108.75,19798.486386700082,NaN,NaN,NaN,NaN,NaN,19844.325,20352.154038653505,19336.495961346496,19958.087587915987,20113.469704847485,20133.907690358188,20093.03171933678,68157,204946.73333333334,59.43343605414195,64.26548136319595,NaN,NaN,NaN,NaN,105.19582954290904,15.870500685267732,6161010,-17.942597743359087,83.61853462501676,101.56113236837585
2024-09-25T06:00:00-04:00,20108.75,20233.75,20108,20232.25,19830.532029698486,NaN,NaN,NaN,NaN,NaN,19860.07,20366.213003902885,19353.926996097114,19993.75276051732,20158.176214765263,20198.921956193844,20117.43047333668,206164,205981.53333333333,67.2952451904047,64.19712842245492,NaN,NaN,NaN,NaN,106.66398457555839,15.01897891610439,6367174,-11.052538590103168,87.7454591307469,98.79799772085006
2024-09-25T10:00:00-04:00,20231.5,20272.75,20135.5,20200.5,19860.536255621282,NaN,NaN,NaN,NaN,NaN,19874.83,20376.76203165346,19372.897968346544,20012.127208413855,20184.670241209216,20218.736415531308,20150.604066887125,521371,210481.93333333332,63.868345489628766,64.07646646189549,NaN,NaN,NaN,NaN,108.8486999630185,14.650856115759892,5845803,-9.081523971679701,87.44609275625044,96.52761672793014
2024-09-25T14:00:00-04:00,20200.25,20246,20145.25,20241.5,19860.536255621282,NaN,NaN,NaN,NaN,NaN,19890.325,20388.731252468588,19391.918747531414,20012.127208413855,20188.622108345724,20221.39213687223,20155.85207981922,156064,193565.43333333332,66.25788453569567,64.21220827998751,NaN,NaN,NaN,NaN,108.27022139423147,14.309027801154286,6001867,-5.633561340332605,89.48566505251438,95.11922639284698
2024-09-25T18:00:00-04:00,20241.75,20322.5,20229,20318,19936.822549026827,NaN,NaN,NaN,NaN,NaN,19905.46,20408.909862051933,19402.010137948066,20068.65141338487,20289.833333333332,20289.833333333332,20289.833333333332,53479,192409.5,70.21586411356924,64.60090049334138,NaN,NaN,NaN,NaN,107.21520558035779,14.782862486478315,6055346,0.837742885029698,96.1664049991341,95.3286621141044
2024-09-25T22:00:00-04:00,20317.75,20421.5,20310,20418.25,20027.023796798338,NaN,NaN,NaN,NaN,NaN,19923.745,20433.908772626153,19413.581227373845,20162.671130707895,20337.808164830796,20384.499324436176,20291.117005225417,56460,192011.73333333334,74.4461123439337,65.37001342481445,NaN,NaN,NaN,NaN,107.52126232461795,16.048622377819232,6111806,10.378542719019435,108.3018405128787,97.92329779385926
2024-09-26T02:00:00-04:00,20418,20500,20417.5,20468.5,20124.170442398412,NaN,NaN,NaN,NaN,NaN,19942.585,20462.165259536756,19423.004740463242,20251.686904566315,20394.724348645883,20465.505918393003,20323.942778898763,93010,192580.86666666667,76.2657804044935,66.37374330217988,NaN,NaN,NaN,NaN,105.73402930143095,17.759169255166128,6204816,18.12856045265785,120.58399835968157,102.45543790702372
2024-09-26T06:00:00-04:00,20469,20537.75,20405,20427.25,20133.9013313803,NaN,NaN,NaN,NaN,NaN,19960.78,20483.250713437807,19438.30928656219,20272.72452365305,20429.20906921953,20485.49137828581,20372.926760153252,254889,192163.43333333332,71.74905247221562,66.8073185664695,NaN,NaN,NaN,NaN,107.66374149418587,19.58054036831101,5949927,18.469247027499264,125.5419966913978,107.07274966389853
2024-09-26T10:00:00-04:00,20427.5,20438,20188,20274,20133.9013313803,NaN,NaN,NaN,NaN,NaN,19975.96,20489.77404574029,19462.145954259708,20272.72452365305,20352.393037828755,20425.256585032592,20279.52949062492,671259,196532.93333333332,58.00484513517836,66.14176550567707,NaN,NaN,NaN,NaN,117.83061710174402,18.69517985570598,5278668,6.958375523893309,115.77071906876517,108.81234354487187
2024-09-26T14:00:00-04:00,20274.25,20362.25,20273.5,20346,20133.9013313803,NaN,NaN,NaN,NaN,NaN,19994.305,20493.962865844125,19494.647134155875,20272.72452365305,20349.00460173042,20417.32240973521,20280.68679372563,175865,193981.83333333334,61.715442691271896,66.07094986459158,NaN,NaN,NaN,NaN,115.75343016590516,17.8730593797156,5454533,2.981665154159856,112.53942498757169,109.55775983341184
2024-09-26T18:00:00-04:00,20344.5,20382,20296,20299,20133.9013313803,NaN,NaN,NaN,NaN,NaN,20011.71,20491.59037426029,19531.82962573971,20272.72452365305,20325.666666666668,20325.666666666668,20325.666666666668,53732,194259.46666666667,58.10619138643663,65.42166412845081,NaN,NaN,NaN,NaN,113.62818515405479,17.28130749944842,5400801,-3.6654110613502553,104.97599600672402,108.64140706807427
2024-09-26T22:00:00-04:00,20299,20358.75,20278,20319.25,20133.9013313803,NaN,NaN,NaN,NaN,NaN,20029.73,20486.213491925,19573.246508075,20272.72452365305,20322.02920991385,20325.5265096759,20318.5319101518,58125,194935.96666666667,59.21296119272609,64.76885388733051,NaN,NaN,NaN,NaN,111.27974335733659,16.537836008281307,5458926,-7.3376780314410155,99.46930952877301,106.80698756021403
2024-09-27T02:00:00-04:00,20320,20333,20236.5,20305.5,20133.9013313803,NaN,NaN,NaN,NaN,NaN,20042.76,20492.746821585115,19592.773178414882,20272.72452365305,20307.542766945742,20322.917540946528,20292.167992944956,102066,196247.56666666668,58.090744423067015,64.52218415285449,NaN,NaN,NaN,NaN,110.22404740324112,15.404980013022437,5356860,-11.105962412735906,92.92453454429415,104.03049695703005
2024-09-27T06:00:00-04:00,20306.75,20396,20281.75,20328,20133.9013313803,NaN,NaN,NaN,NaN,NaN,20055.56,20500.83896379672,19610.281036203283,20272.72452365305,20321.92784242198,20339.40061980035,20304.45506504361,230991,195081.86666666667,59.445205961806714,64.57907938532641,NaN,NaN,NaN,NaN,110.51161544586674,14.967142404895467,5587851,-12.398185904910733,88.53276457589163,100.93095048080237
2024-09-27T10:00:00-04:00,20329,20375.75,20210,20280,20133.9013313803,NaN,NaN,NaN,NaN,NaN,20065.68,20507.89203104403,19623.46796895597,20272.72452365305,20303.60694296058,20323.924429017723,20283.28945690344,542561,194397.83333333334,55.336440484483184,64.2864368446365,NaN,NaN,NaN,NaN,114.45721434259055,13.984678340756968,5045290,-16.54160923586886,80.25393893596629,96.79554817183515
2024-09-27T14:00:00-04:00,20279.75,20293.5,20173,20194,20133.9013313803,NaN,NaN,NaN,NaN,NaN,20074.34,20509.245032852214,19639.434967147787,20272.72452365305,20287.43144809506,20325.12517548821,20249.73772070191,237463,193667.96666666667,48.82497895632296,62.96713211363066,NaN,NaN,NaN,NaN,114.88884188954837,13.429459333332847,4807827,-24.64227384276505,65.99270586837883,90.63497971114388
2024-09-29T18:00:00-04:00,20198.25,20286.5,20157.5,20191.5,20133.9013313803,NaN,NaN,NaN,NaN,NaN,20084.945,20504.634376682563,19665.255623317436,20272.72452365305,20211.833333333332,20211.833333333332,20211.833333333332,78321,194121.53333333333,48.64577868631921,61.879805913394264,NaN,NaN,NaN,NaN,115.89678175458063,13.063422996871,4729506,-29.41367073702608,53.86789128986129,83.28156202688737
2024-09-29T22:00:00-04:00,20192.25,20226.25,20152.75,20173.5,20133.9013313803,NaN,NaN,NaN,NaN,NaN,20094.715,20499.175430820997,19690.254569179004,20123.808161528505,20200.159706692055,20213.823409637385,20186.496003746724,57168,194541.53333333333,47.299694836933675,60.52564950633984,NaN,NaN,NaN,NaN,112.86844020068202,12.771424610785557,4672338,-32.77035670187823,42.318616149539594,75.08897285141782
2024-09-30T02:00:00-04:00,20173.25,20247.75,20145.75,20204.25,20133.9013313803,NaN,NaN,NaN,NaN,NaN,20104.59,20494.908226066596,19714.271773933404,20123.808161528505,20199.816414758785,20210.607072670413,20189.025756847157,82117,193612,49.85258876595833,59.07112983865334,NaN,NaN,NaN,NaN,112.09212304349045,12.232385208218147,4754455,-31.87856485594405,35.240766781487764,67.11933163743181
2024-09-30T06:00:00-04:00,20203.5,20264,20118,20203.75,NaN,NaN,NaN,20533.8109215849,20533.8109215849,20533.8109215849,20114.815,20487.818053740866,19741.81194625913,20123.808161528505,20197.571029734652,20205.59569053375,20189.546368935553,210514,193854.9,49.81033662841145,57.3114315732589,NaN,NaN,NaN,NaN,114.5141142546697,12.040913813105723,4543941,-30.292302923706174,29.253952982799092,59.546255906505266
2024-09-30T10:00:00-04:00,20205,20254.5,20127.5,20205.5,NaN,NaN,NaN,20533.8109215849,NaN,NaN,20124.72,20480.11121598559,19769.32878401441,20123.808161528505,20196.63116891218,20202.137154237054,20191.125183587304,504331,192767.13333333333,49.9701609255167,55.43317303904627,NaN,NaN,NaN,NaN,115.40596323647901,11.863118946215614,5048272,-28.141283037702564,24.369652109377057,52.51093514707962
2024-09-30T14:00:00-04:00,20206.25,20286.75,20057.5,20233.5,NaN,NaN,NaN,20533.8109215849,NaN,NaN,20135.22,20471.299509045013,19799.14049095499,20123.808161528505,20195.458455275388,20200.448910488853,20190.468000061923,380331,200858.9,52.57249736579163,54.06341910287313,NaN,NaN,NaN,NaN,123.53768014815908,12.459250810672886,5428603,-24.0096904726215,22.498822056302743,46.50851252892424
2024-09-30T18:00:00-04:00,20232,20331.5,20213.25,20327.75,NaN,NaN,NaN,20533.8109215849,NaN,NaN,20147.91,20463.573931420913,19832.246068579087,20123.808161528505,20290.833333333332,20290.833333333332,20290.833333333332,56094,201198.5,60.09656412422222,54.21282760209054,NaN,NaN,NaN,NaN,123.15998870900486,12.368547520303093,5484697,-14.570655062586582,28.295193700691016,42.8658487632776
2024-09-30T22:00:00-04:00,20328.25,20331,20233.25,20252,NaN,NaN,NaN,20533.8109215849,NaN,NaN,20160.285,20440.834354125425,19879.735645874574,20075.121529222804,20281.71591658424,20291.087377294887,20272.34445587359,53094,201494.7,52.840879717347725,53.57893024681024,NaN,NaN,NaN,NaN,121.34498951550451,12.284323036388285,5431603,-13.115620511827863,26.471323123492766,39.58694363532063
2024-10-01T02:00:00-04:00,20252,20291.75,20215,20278,NaN,NaN,NaN,20533.8109215849,NaN,NaN,20171.09,20426.17160968591,19916.00839031409,20008.72215464017,20273.54652517007,20285.790665549233,20261.302384790906,74562,201343.93333333332,54.85557007899733,53.34674301056458,NaN,NaN,NaN,NaN,118.1596331215399,12.423524412544316,5506165,-10.217737893731211,26.81477126815662,37.03250916188783
2024-10-01T06:00:00-04:00,20278.25,20324.75,19978.5,20043.75,NaN,NaN,NaN,20533.8109215849,NaN,NaN,20174.345,20418.454215106434,19930.235784893568,20008.72215464017,20174.094405439482,20250.68581532781,20097.502995551153,312768,204349,38.78065496510937,51.88729256573482,NaN,NaN,NaN,NaN,134.45180218428703,14.534884311853066,5193397,-23.152676572057622,8.0916634468158,31.244340018873423
2024-10-01T10:00:00-04:00,20040,20079.5,19818,19999.25,NaN,NaN,NaN,20352.358873263303,NaN,NaN,20174.74,20417.647759447413,19931.83224055259,20008.72215464017,20041.06212291104,20151.35552070536,19930.76872511672,875119,213833.03333333333,36.587230959728196,50.35132731835347,NaN,NaN,NaN,NaN,143.52667345683795,17.287956773363263,4318278,-33.171078704156635,-10.219508361322369,22.951570342834266
2024-10-01T14:00:00-04:00,19998.75,20080.5,19952.5,19960,NaN,NaN,NaN,20352.358873263303,NaN,NaN,20173.76,20419.710847935807,19927.80915206419,20008.72215464017,20034.43588120456,20137.15298921175,19931.71877319737,247185,216600.23333333334,34.7218210459788,48.58537125293719,NaN,NaN,NaN,NaN,142.4176253527781,19.83036859020876,4071093,-40.425624704160924,-27.58046053736689,12.845164166794035
2024-10-01T18:00:00-04:00,19972,19990,19891.75,19985.25,NaN,NaN,NaN,20338.684944440323,NaN,NaN,20169.6,20421.06588237801,19918.134117621987,20008.72215464017,19955.666666666668,19955.666666666668,19955.666666666668,75682,217694.4,36.948940601975,47.271978404186605,NaN,NaN,NaN,NaN,139.2627949704368,22.451531423756816,4146775,-41.359166444268816,-38.853793888541986,2.5053725557268294
2024-10-01T22:00:00-04:00,19984.75,19998.5,19880.25,19921.25,NaN,NaN,NaN,20335.22767423849,NaN,NaN,20166.76,20426.051765392192,19907.468234607804,20008.72215464017,19944.879181381624,19956.039408346835,19933.718954416414,70711,218655.1,33.801120708103014,46.19884567217089,NaN,NaN,NaN,NaN,137.761881043977,24.933678126448793,4076064,-43.88334796115852,-52.348812395721325,-8.465464434562803
2024-10-02T02:00:00-04:00,19920,19972.75,19891.5,19912.25,NaN,NaN,NaN,20321.06391631856,NaN,NaN,20163.9,20431.083027155062,19896.71697284494,20008.72215464017,19937.759948055766,19950.647016728664,19924.872879382867,85009,219216.83333333334,33.37057546065134,45.107759727480335,NaN,NaN,NaN,NaN,133.72531811226438,27.238528636091345,3991055,-43.662199371527834,-63.043213648972596,-19.381014277444763
2024-10-02T06:00:00-04:00,19912.25,20011.5,19833.5,19915.75,NaN,NaN,NaN,20318.032601940442,NaN,NaN,20161.265,20435.49365295222,19887.03634704778,20008.72215464017,19927.46088046755,19939.40484783305,19915.516913102052,330504,223361.5,33.724127520321616,44.13807634772233,NaN,NaN,NaN,NaN,136.88779538995976,29.63324807210453,4321559,-40.834688249466716,-70.42437458927816,-29.589686339811443
2024-10-02T10:00:00-04:00,19915.75,20089.5,19905.5,20044.75,NaN,NaN,NaN,20318.032601940442,NaN,NaN,20161.92,20434.8729160871,19888.967083912896,20008.72215464017,19972.73916625138,20016.346807764363,19929.131524738397,628033,226916.9,45.254472545008404,43.809639474797336,NaN,NaN,NaN,NaN,140.2529528621055,30.621354252180623,4949592,-28.419595067328665,-65.11418017397227,-36.69458510664361
2024-10-02T14:00:00-04:00,20044.75,20072.5,19985.75,20059.25,NaN,NaN,NaN,20318.032601940442,NaN,NaN,20163.075,20433.78237429896,19892.36762570104,19995.552723712135,19981.318236534666,20027.711320953455,19934.925152115877,176471,227597.13333333333,46.38361147779316,43.56487339261032,NaN,NaN,NaN,NaN,136.4313133719551,31.538881419394134,5126063,-17.888359393110527,-59.05503434803177,-41.16667495492124
2024-10-02T18:00:00-04:00,20056.5,20068.25,19948.5,19975.5,NaN,NaN,NaN,20318.032601940442,NaN,NaN,20162.675,20434.428716625884,19890.921283374115,19914.66717896971,19997.416666666668,19997.416666666668,19997.416666666668,63876,227943.7,41.109574006436574,42.931974326961736,NaN,NaN,NaN,NaN,135.239790988244,32.617982710168114,5062187,-15.31926816514246,-60.31576016134932,-44.996491996206856
2024-10-02T22:00:00-04:00,19975.5,19987.75,19931,19939.75,NaN,NaN,NaN,20318.032601940442,NaN,NaN,20161.18,20436.970355886497,19885.389644113504,19729.936728749482,19977.189368022533,19999.385241230295,19954.99349481477,53048,227829.96666666667,39.06750577227935,41.967332070282296,NaN,NaN,NaN,NaN,129.63337734622658,33.72544675904373,5009139,-14.777207256938595,-63.4680010673801,-48.690793810441505
2024-10-03T02:00:00-04:00,19938.5,19972.5,19851,19917.75,NaN,NaN,NaN,20295.151025454972,NaN,NaN,20156.91,20440.910664787873,19872.909335212127,19729.936728749482,19946.943941997593,19982.464951110192,19911.422932884994,106538,228280.9,37.822396036459864,40.376320064013555,NaN,NaN,NaN,NaN,129.05242182149613,35.19803190013594,4902601,-14.622892289626087,-66.96940917247412,-52.34651688284803
2024-10-03T06:00:00-04:00,19917.25,20048,19894.5,20023.75,NaN,NaN,NaN,20295.151025454972,NaN,NaN,20155.245,20441.36479117179,19869.12520882821,19731.273605119735,19969.880762109628,20001.53972337433,19938.221800844924,271633,228839.03333333333,46.64566508531952,39.93380473315441,NaN,NaN,NaN,NaN,130.79867740567497,35.36809150618551,5174234,-6.517708913664606,-60.49365302492879,-53.975944111264184
2024-10-03T10:00:00-04:00,20023.5,20115,19879,19962.5,NaN,NaN,NaN,20295.151025454972,NaN,NaN,20152.925,20443.3451654503,19862.504834549698,19743.618884095788,19979.29208555135,20000.664682155562,19957.91948894714,750574,231482.86666666667,42.86087750853017,39.07704097812104,NaN,NaN,NaN,NaN,138.3130575909839,34.601921697356616,4423660,-4.512611455320084,-59.61670843041429,-55.10409697509421
2024-10-03T14:00:00-04:00,19963.25,20017.5,19913.75,19958.5,NaN,NaN,NaN,20295.151025454972,NaN,NaN,20150.775,20445.300028647533,19856.24997135247,19743.618884095788,19977.375616779755,19998.09490719247,19956.65632636704,169004,231254.16666666666,42.61768028724348,39.351114215416324,NaN,NaN,NaN,NaN,135.84426776305648,33.89047830344408,4254656,-2.772193785992286,-58.56933920758456,-55.797145421592276
2024-10-03T18:00:00-04:00,19971.75,20051.5,19941.25,20043.75,NaN,NaN,NaN,20295.151025454972,NaN,NaN,20150.18,20445.446338074402,19854.9136619256,19743.618884095788,20012.166666666668,20012.166666666668,20012.166666666668,57095,231366.26666666666,49.22959519891701,40.25414023250124,NaN,NaN,NaN,NaN,134.01610577998102,32.762975483686034,4311751,4.413137035270566,-50.28072412750407,-54.69386116277464
2024-10-03T22:00:00-04:00,20043.5,20070,19993,20015.25,NaN,NaN,NaN,20295.151025454972,NaN,NaN,20149.22,20445.91928614661,19852.52071385339,19764.052868657043,20019.142020471158,20026.1003329859,20012.183707956414,57375,231341.26666666666,47.26868445344792,41.150344761606185,NaN,NaN,NaN,NaN,129.94352679569667,31.464506310803625,4254376,7.365249328574933,-45.487299502055976,-52.85254883063091
2024-10-04T02:00:00-04:00,20015.5,20043.25,19972,20037.5,NaN,NaN,NaN,20295.151025454972,NaN,NaN,20148.97,20446.024130420647,19851.915869579356,19764.052868657043,20018.610623952834,20024.307731301662,20012.913516604007,59213,229912.83333333334,48.977377977079186,42.00951885982791,NaN,NaN,NaN,NaN,125.75113202457547,30.473318554278663,4313589,10.731267200766538,-39.43846482967274,-50.16973203043928
2024-10-04T06:00:00-04:00,20037.25,20263,20036.75,20085.5,NaN,NaN,NaN,20295.151025454972,NaN,NaN,20148.6,20445.92322479144,19851.276775208557,19925.568835940507,20092.078134318548,20143.851125649013,20040.305142988083,351144,233917.93333333332,52.54954574053935,43.3486920764305,NaN,NaN,NaN,NaN,132.92962259424866,29.424059784186905,4664733,15.799106966819103,-30.4208483219154,-46.2199552887345
2024-10-04T10:00:00-04:00,20086.5,20182.25,20013,20115.5,NaN,NaN,NaN,20295.151025454972,NaN,NaN,20148.28,20445.71057408438,19850.849425915618,19925.568835940507,20098.792794801226,20132.67863874872,20064.906950853732,735624,240353.36666666667,54.68493184427067,44.87114610383188,NaN,NaN,NaN,NaN,135.52393526608805,28.18530073955064,5400357,20.483223882109755,-20.615925436097314,-41.09914931820707
2024-10-04T14:00:00-04:00,20115.5,20245.25,20094,20203.75,NaN,NaN,NaN,20295.151025454972,NaN,NaN,20150.51,20447.898734823822,19853.121265176174,19925.568835940507,20110.12492552923,20152.47030968937,20067.77954136909,201532,239155.66666666666,60.33919144666354,46.77222209857059,NaN,NaN,NaN,NaN,136.64722560422462,27.56064488557186,5601889,28.351975106473205,-5.659180435115559,-34.011155541588764
2024-10-06T18:00:00-04:00,20219,20268,20201.25,20215.25,NaN,NaN,NaN,20295.151025454972,NaN,NaN,20151.515,20449.431975179436,19853.598024820563,19947.20024400154,20228.166666666668,20228.166666666668,20228.166666666668,76801,239105,61.02172426721082,47.898454364442195,NaN,NaN,NaN,NaN,131.6545666324943,27.162002200810274,5678690,32.84167489317987,7.040938074886071,-25.800736818293796
2024-10-06T22:00:00-04:00,20216,20236.5,20183,20190.5,NaN,NaN,NaN,20295.151025454972,NaN,NaN,20151.615,20449.580890832876,19853.649109167127,19953.110195201232,20219.2239603295,20231.144749338717,20207.30317132028,43221,238640.1,58.68114889771875,48.77684989443687,NaN,NaN,NaN,NaN,126.07209758731612,26.56084532712005,5635469,32.589850086510985,14.936575789844937,-17.653274296666048
2024-10-07T02:00:00-04:00,20190,20214.25,20058,20094.5,NaN,NaN,NaN,20295.151025454972,NaN,NaN,20150.99,20449.301179139966,19852.678820860037,19953.110195201232,20175.0437180406,20224.133461717756,20125.953974363445,100440,239250.86666666667,50.57757058731101,49.45313536449934,NaN,NaN,NaN,NaN,128.22766204536498,24.71200195392685,5535029,24.75804318819101,13.294279688572715,-11.463763499618295
2024-10-07T06:00:00-04:00,20095,20163.75,20075.5,20109.25,NaN,NaN,NaN,20295.151025454972,NaN,NaN,20151.21,20449.381466777337,19853.03853322266,19953.110195201232,20144.37562018764,20189.316589821283,20099.434650553994,239681,240223.1,51.68163876425673,50.354144863926294,NaN,NaN,NaN,NaN,125.37211475641034,22.995218821676026,5774710,19.597184301883978,13.032716877736675,-6.564467424147301
2024-10-07T10:00:00-04:00,20110.25,20187.75,20103.5,20148.75,NaN,NaN,NaN,20295.151025454972,NaN,NaN,20152.01,20449.936030417364,19854.083969582633,19953.110195201232,20145.52693074324,20177.245312006446,20113.808549480033,464816,238905.93333333332,54.60618343548546,51.55298682099954,NaN,NaN,NaN,NaN,122.43482084523818,21.557058235796813,6239526,17.915785867737377,15.83026491052442,-2.085520957212956
2024-10-07T14:00:00-04:00,20148.75,20153,19948,20019,NaN,NaN,NaN,20295.151025454972,NaN,NaN,20147.745,20447.05656827009,19848.433431729907,19953.110195201232,20118.49167287874,20172.067356966454,20064.915988791025,318588,236847.83333333334,44.976232203217585,51.43374161513511,NaN,NaN,NaN,NaN,128.3323336420069,21.259729785256397,5920938,7.6614142198335164,7.49124681757894,-0.1701674022545765
2024-10-07T18:00:00-04:00,20032,20034.75,19902.5,19980.25,NaN,NaN,NaN,20295.151025454972,NaN,NaN,20143.34,20445.88176174548,19840.79823825452,19953.110195201232,19972.5,19972.5,19972.5,84474,237793.83333333334,42.56213531659778,51.41240288713995,NaN,NaN,NaN,NaN,128.6121669532921,21.3283792270392,5836464,-1.6388343513831622,-2.218710341483529,-0.5798759901003671
2024-10-07T22:00:00-04:00,19980.5,20012.25,19955.5,19978.75,NaN,NaN,NaN,20295.151025454972,NaN,NaN,20138.085,20442.74450846849,19833.425491531507,19953.110195201232,19976.444939600326,19981.19592556587,19971.69395363478,58242,237965.43333333332,42.46711234839673,51.401648034365174,NaN,NaN,NaN,NaN,123.47915502805697,21.39212513726609,5778222,-7.472579452337614,-9.920600305522385,-2.4480208531847705
2024-10-08T02:00:00-04:00,19978.75,20090,19942.5,20073,NaN,NaN,NaN,20295.151025454972,NaN,NaN,20133.185,20433.968490404382,19832.40150959562,19953.110195201232,20000.128369470392,20029.16791698401,19971.088821956775,96466,238695.56666666668,50.01793337249313,51.45795790390633,NaN,NaN,NaN,NaN,125.19492966891004,20.54536826108995,5874688,-4.700199946799854,-8.323270786684589,-3.6230708398847344
2024-10-08T06:00:00-04:00,20073,20159,20054.75,20155.75,NaN,NaN,NaN,20295.151025454972,NaN,NaN,20127.935,20417.59036090296,19838.279639097043,19953.110195201232,20062.06925476714,20126.901229056606,19997.23728047767,242484,236352.76666666666,55.5356713186594,52.048456965707146,NaN,NaN,NaN,NaN,123.69886326398789,19.102560538937464,6117172,2.5978085914549767,-0.3758101005660137,-2.9736186920209904
2024-10-08T10:00:00-04:00,20155.75,20274.25,20155.5,20232,NaN,NaN,NaN,20295.151025454972,NaN,NaN,20123.205,20397.79257601086,19848.617423989144,19979.335365061546,20142.95425069189,20234.26390690242,20051.644594481364,501868,223911.06666666668,59.92571801985184,52.830481254476624,NaN,NaN,NaN,NaN,123.34537303084589,18.756784695142045,6619040,11.929084318370688,11.93773670594237,0.008652387571681963
2024-10-08T14:00:00-04:00,20231.5,20329.5,20223.25,20286,19904.32491915647,19904.32491915647,19904.32491915647,NaN,NaN,NaN,20120.38,20385.127280250068,19855.632719749934,20040.443292049236,20164.00310870282,20261.39833613893,20066.607881266707,179116,221642.1,62.73200465686073,53.557799748499576,NaN,NaN,NaN,NaN,122.12427495721404,18.847519737099976,6798156,20.59847981928972,25.756752161683835,5.158272342394112
2024-10-08T18:00:00-04:00,20298,20298,20261,20275,19919.315831922082,NaN,NaN,NaN,NaN,NaN,20120.4,20385.193844338824,19855.60615566118,20048.25463363939,20278,20278,20278,33951,220251.06666666668,61.78289123459366,54.06479684780836,NaN,NaN,NaN,NaN,116.04396960312734,18.931773704632334,6764205,24.203461329352525,35.41259900408477,11.209137674732244
2024-10-08T22:00:00-04:00,20275,20275,20221.25,20231.75,19919.315831922082,NaN,NaN,NaN,NaN,NaN,20118.115,20376.987887919593,19859.24211208041,20048.32870691151,20257.998023302876,20275.509660522148,20240.486386083605,44294,219370.5,58.06319086396815,53.90222537761583,NaN,NaN,NaN,NaN,111.5944003457611,18.55452906424047,6719911,22.331902933896245,39.12401634210255,16.792113408206305
2024-10-09T02:00:00-04:00,20230.75,20267.75,20195.5,20263,19919.315831922082,NaN,NaN,NaN,NaN,NaN,20117.395,20374.44534701378,19860.34465298622,20050.28796552921,20250.643600310723,20265.74002849804,20235.547172123406,67223,218777.63333333333,59.93991396940359,53.824953213486744,NaN,NaN,NaN,NaN,108.78408603534959,17.914108343802717,6787134,21.829382637911397,44.07884170559555,22.249459067684153
2024-10-09T06:00:00-04:00,20262.75,20300.75,20238.25,20266.25,19931.627598556574,NaN,NaN,NaN,NaN,NaN,20116.335,20370.467595508846,19862.202404491152,20095.530372423367,20261.359620390565,20274.248189171787,20248.471051609344,220891,215123.86666666667,60.13969921509926,53.92913537901393,NaN,NaN,NaN,NaN,105.47807988996747,17.622992147720456,7008025,20.37464367873553,47.717763666103565,27.343119987368034
2024-10-09T10:00:00-04:00,20265.75,20448.5,20263,20399.25,20007.939980440366,NaN,NaN,NaN,NaN,NaN,20118.21,20379.18876082158,19857.231239178418,20191.574297938692,20324.304701143614,20378.730075161042,20269.879327126186,501912,210919.83333333334,67.32195088531033,55.125162543156726,NaN,NaN,NaN,NaN,111.19393132639837,18.489810477623557,7509937,26.63323627512618,60.634665331275755,34.001429056149576
2024-10-09T14:00:00-04:00,20400,20482.25,20387.75,20449,20090.113163147624,NaN,NaN,NaN,NaN,NaN,20120.63,20391.405372587455,19849.854627412547,20229.459438350954,20346.451958633883,20413.219478387127,20279.68443888064,206296,211914,69.53336778820731,56.400286044867485,NaN,NaN,NaN,NaN,110.00150766022706,19.51284625660423,7716233,32.02478684710426,74.0324126150299,42.00762576792564
2024-10-09T18:00:00-04:00,20447.75,20464,20435.5,20451,20116.65347391364,NaN,NaN,NaN,NaN,NaN,20124.05,20406.84349356038,19841.25650643962,20247.517550680765,20450.166666666668,20450.166666666668,20450.166666666668,31429,210832.43333333332,69.62236779037889,57.47287064164559,NaN,NaN,NaN,NaN,104.17997139878227,20.462808051372,7747662,33.46997387100931,83.84509310668727,50.375119235677964
2024-10-09T22:00:00-04:00,20450.25,20474.5,20439.25,20443.25,20134.112406917564,NaN,NaN,NaN,NaN,NaN,20129.035,20425.062718466063,19833.007281533937,20283.68904054461,20451.10849401636,20452.182545683496,20450.034442349224,24167,209869.73333333334,68.78385733042529,59.173415293588995,NaN,NaN,NaN,NaN,99.25640201315495,21.41903656628992,7723495,31.667390521945805,89.95935738811022,58.291966866164415
2024-10-10T02:00:00-04:00,20443,20455.5,20406,20431.25,20134.112406917564,NaN,NaN,NaN,NaN,NaN,20133.83,20441.295452367867,19826.364547632136,20283.68904054461,20441.578200038624,20451.688425332493,20431.467974744755,49697,207975.03333333333,67.42968158410704,60.94966859841109,NaN,NaN,NaN,NaN,95.7023732979296,21.828591502201675,7673798,27.580260560777177,92.76729256713588,65.1870320063587
2024-10-10T06:00:00-04:00,20431.25,20472,20301.25,20357.25,20134.112406917564,NaN,NaN,NaN,NaN,NaN,20137.505,20451.110492458018,19823.899507541984,20283.68904054461,20393.53531549255,20422.323852009835,20364.746778975266,302873,209016.36666666667,59.63299172023612,62.175802839256754,NaN,NaN,NaN,NaN,101.0629180623632,20.890863054094414,7370925,18.255918998968497,88.00693075506933,69.75101175610084
2024-10-10T10:00:00-04:00,20357.5,20508,20353.5,20445.5,20134.112406917564,NaN,NaN,NaN,NaN,NaN,20142.33,20467.11879968301,19817.541200316995,20283.68904054461,20417.522560047466,20445.667646373066,20389.377473721866,539612,201984.3,64.85241290384405,63.23540852006756,NaN,NaN,NaN,NaN,104.8798524864801,20.352529635200685,7910537,16.450599082162555,90.31426060880403,73.86366152664148
2024-10-10T14:00:00-04:00,20445.75,20446.75,20372,20434,20134.112406917564,NaN,NaN,NaN,NaN,NaN,20146.935,20481.45982433999,19812.410175660014,20283.68904054461,20417.53147354006,20443.530780109864,20391.532166970257,162901,201780.86666666667,63.696620121294536,63.8183334345415,NaN,NaN,NaN,NaN,102.72772016601724,19.852648603370795,7747636,13.049387909244189,90.17539641319672,77.12600850395253
2024-10-10T18:00:00-04:00,20441.5,20464.5,20425.25,20451.25,20134.112406917564,NaN,NaN,NaN,NaN,NaN,20151.85,20496.73324111253,19806.966758887465,20283.68904054461,20447,20447,20447,29350,200856.03333333333,64.71251890405586,64.16024778341321,NaN,NaN,NaN,NaN,98.19359729701601,19.563758868216112,7776986,10.631215764557084,90.41502820964888,79.7838124450918
2024-10-10T22:00:00-04:00,20451.25,20468.5,20414.25,20427.25,20134.112406917564,NaN,NaN,NaN,NaN,NaN,20155.725,20508.45529711152,19802.994702888478,20283.68904054461,20441.935661338895,20447.10131457658,20436.77000810121,28210,199883.86666666667,62.10840151579677,64.11570470190864,NaN,NaN,NaN,NaN,95.05476891865773,19.142047930328445,7748776,6.299248694120635,87.6578733127426,81.35862461862196
2024-10-11T02:00:00-04:00,20426.75,20433.5,20352.25,20368.5,20134.112406917564,NaN,NaN,NaN,NaN,NaN,20156.54,20511.040287164808,19802.039712835194,20283.68904054461,20412.50455253225,20441.310768609274,20383.698336455225,61037,199944.66666666666,56.151568112110894,63.71346733601701,NaN,NaN,NaN,NaN,94.06871399589646,17.928794205789337,7687739,-1.237180166983734,79.8121494098923,81.04932957687603
2024-10-11T06:00:00-04:00,20368.5,20416.25,20313.25,20358.5,20134.112406917564,NaN,NaN,NaN,NaN,NaN,20158.67,20516.701177972234,19800.638822027762,20283.68904054461,20380.67560543969,20410.22308264131,20351.12812823807,209608,195226.8,55.181427147832515,63.50762707057875,NaN,NaN,NaN,NaN,94.70666299618958,16.96231011849263,7478131,-7.2731006485093275,71.95795376623937,79.2310544147487
2024-10-11T10:00:00-04:00,20359.25,20481,20323.5,20437,20134.112406917564,NaN,NaN,NaN,NaN,NaN,20161.85,20526.821382439957,19796.87861756004,20283.68904054461,20400.63736288721,20425.353123352194,20375.921602422226,496481,187255.36666666667,60.89329922603157,63.575726017480754,NaN,NaN,NaN,NaN,99.1919013536046,16.203992615954068,7974612,-6.3876785064328345,71.24645628170765,77.63413478814049
2024-10-11T14:00:00-04:00,20437.25,20494.5,20406,20412.25,20138.75317406164,NaN,NaN,NaN,NaN,NaN,20169.22,20539.20249472081,19799.237505279194,20278.10123243569,20406.80602781681,20433.239535026536,20380.37252060708,165291,186047.33333333334,58.367595072035584,63.44914715011906,NaN,NaN,NaN,NaN,98.42819411406141,15.650927070653168,7809321,-7.78512316611139,67.90273083050124,75.68785399661263
2024-10-13T18:00:00-04:00,20433.75,20450.5,20394,20400.25,20138.75317406164,NaN,NaN,NaN,NaN,NaN,20177.24,20549.514857598344,19804.96514240166,20269.103371844525,20414.916666666668,20414.916666666668,20414.916666666668,45941,185018.66666666666,57.13030858567583,62.721172700145175,NaN,NaN,NaN,NaN,95.43332310591417,14.973414820655432,7763380,-9.708749068280866,63.55191766126154,73.26066672954241
2024-10-13T22:00:00-04:00,20400.25,20433.5,20382.5,20431.5,20138.75317406164,NaN,NaN,NaN,NaN,NaN,20186.67,20560.339993978967,19813.00000602103,20269.103371844525,20415.275587709424,20415.723009892852,20414.828165525996,29564,184563.43333333332,59.53589973553788,62.007067839240214,NaN,NaN,NaN,NaN,92.25951431263458,14.182210998469733,7792944,-9.079093367869945,61.91180001970497,70.99089338757491
2024-10-14T02:00:00-04:00,20431.5,20490,20424,20487.5,20163.42002206845,NaN,NaN,NaN,NaN,NaN,20196.715,20575.159117539097,19818.270882460904,20294.266376247047,20434.28979089223,20459.294878958885,20409.28470282558,43668,182671.03333333333,63.48965748275044,61.569017102981036,NaN,NaN,NaN,NaN,90.38383471887497,14.144956023301678,7836612,-5.281917546733865,64.38849645415758,69.67041400089144
2024-10-14T06:00:00-04:00,20487.75,20671.25,20487.5,20670.75,20274.082748338064,NaN,NaN,NaN,NaN,NaN,20211.705,20604.42297374158,19818.987026258423,20422.78810099764,20541.694063179584,20628.64892798151,20454.739198377658,187846,180943.2,72.84133024871139,61.85883659714433,NaN,NaN,NaN,NaN,97.0528465246696,15.712619228876285,8024458,8.43438056924208,80.21338971244404,71.77900914320196
2024-10-14T10:00:00-04:00,20671.25,20680,20525,20608,20289.94830523179,NaN,NaN,NaN,NaN,NaN,20225.62,20624.17114151154,19827.06885848846,20422.78810099764,20577.62796171731,20642.3057586153,20512.950164819318,413115,179219.83333333334,66.55485028953116,61.796348647531765,NaN,NaN,NaN,NaN,101.19192891576463,17.229143079484377,7611343,11.930392403377937,86.69199964742438,74.76160724404644
2024-10-14T14:00:00-04:00,20608,20666.75,20596,20637.5,20323.3824731758,NaN,NaN,NaN,NaN,NaN,20240.055,20644.900146815173,19835.209853184828,20422.78810099764,20587.345134845757,20649.813346078034,20524.87692361348,151887,173663.13333333333,67.95502606263435,62.39077967198879,NaN,NaN,NaN,NaN,99.01750542178145,18.637343797906176,7763230,14.697247788298768,93.13316697941991,78.43591919112114
2024-10-14T18:00:00-04:00,20637.5,20641.5,20590.25,20629.25,20323.3824731758,NaN,NaN,NaN,NaN,NaN,20251.745,20666.978988132243,19836.511011867755,20422.78810099764,20620.333333333332,20620.333333333332,20620.333333333332,35839,172041.96666666667,67.10887868503616,62.551955799216785,NaN,NaN,NaN,NaN,95.60554074879705,19.846604219599367,7727391,14.419424095897995,96.46019931099363,82.04077521509564
2024-10-14T22:00:00-04:00,20628.5,20637.5,20606.25,20607.5,20330.313110889518,NaN,NaN,NaN,NaN,NaN,20262.71,20685.910807655135,19839.509192344864,20437.285006168633,20619.173652237896,20620.730605416524,20617.61669905927,19883,170763.33333333334,64.81744989083485,62.63201506846967,NaN,NaN,NaN,NaN,91.00871640959726,20.969488896885906,7707508,11.35341527429793,96.23254430796806,84.87912903367013
2024-10-15T02:00:00-04:00,20608.25,20613.75,20563,20585,20330.313110889518,NaN,NaN,NaN,NaN,NaN,20274.9,20699.417420136942,19850.38257986306,20437.285006168633,20603.791438454886,20619.782060918787,20587.800815990984,51817,169275.03333333333,62.44218307012964,62.469848223189224,NaN,NaN,NaN,NaN,88.13309380891174,21.231297918212352,7655691,6.6268113007741505,93.16264315963781,86.53583185886366
2024-10-15T06:00:00-04:00,20585,20659.25,20578.5,20629.5,20335.599084508838,NaN,NaN,NaN,NaN,NaN,20288.695,20713.579787795523,19863.810212204477,20470.437403947926,20616.101635558218,20628.92491087088,20603.278360245557,209631,168179.93333333332,65.16139696148059,62.68791932645235,NaN,NaN,NaN,NaN,87.60572996541805,21.925053549428817,7865322,5.36783448009416,93.24562495898135,87.87779047888719
2024-10-15T10:00:00-04:00,20629,20648,20331.5,20358.75,NaN,NaN,NaN,20803.30882842338,20803.30882842338,20803.30882842338,20297.515,20709.340829811674,19885.689170188325,20470.437403947926,20500.47542953264,20580.110585446066,20420.84027361921,674237,173925.56666666668,44.19547473233031,61.83391265646803,NaN,NaN,NaN,NaN,103.9553206821739,21.22203677320477,7191085,-13.782456074078453,70.64972038628912,84.43217646036757
2024-10-15T14:00:00-04:00,20359.25,20388.75,20254,20334.75,NaN,NaN,NaN,20639.056154404137,NaN,NaN,20303.735,20708.16162387626,19899.30837612374,20470.437403947926,20467.326408013894,20566.464586759943,20368.188229267846,232267,175697.26666666666,42.87846120649542,60.95512937494395,NaN,NaN,NaN,NaN,106.1549406334472,21.196805193635036,6958818,-27.364364036554775,50.2267214146741,77.59108545122888
2024-10-15T18:00:00-04:00,20340,20376,20306.75,20366.5,NaN,NaN,NaN,20639.056154404137,NaN,NaN,20311.815,20704.624875257974,19919.005124742023,20470.437403947926,20349.75,20349.75,20349.75,40980,175931.56666666668,45.20479566672615,59.83452197785069,NaN,NaN,NaN,NaN,103.51887344534383,21.173375869748853,6999798,-33.12392793090211,36.18617553760123,69.31010346850334
2024-10-15T22:00:00-04:00,20367.5,20397.5,20359.75,20392,NaN,NaN,NaN,20639.056154404137,NaN,NaN,20320.485,20700.65177143073,19940.31822856927,20470.437403947926,20364.168119464022,20380.682410644753,20347.65382828329,31237,175496.33333333334,47.06929017252172,59.02750019931399,NaN,NaN,NaN,NaN,98.8210967706764,20.882674478196535,7031035,-34.002036517588635,26.80755782151755,60.809594339106184
2024-10-16T02:00:00-04:00,20392.5,20393.5,20331.25,20364.5,NaN,NaN,NaN,20639.056154404137,NaN,NaN,20326.9,20698.908830539942,19954.89116946006,20470.437403947926,20363.62403803016,20375.29582572331,20351.95225033701,72668,175677.83333333334,45.27991519969036,58.181043528886455,NaN,NaN,NaN,NaN,96.20887557277095,20.864842295070982,6958367,-35.0793502470252,16.96040653032469,52.039756777349886
2024-10-16T06:00:00-04:00,20364,20385.75,20213,20223.5,NaN,NaN,NaN,20607.67927327228,NaN,NaN,20331.065,20693.56527324173,19968.564726758268,20470.437403947926,20308.092238545385,20352.141281039847,20264.043196050923,236577,176200.7,37.42417597215325,56.6016346886447,NaN,NaN,NaN,NaN,101.67609874614446,21.75441180609294,6721790,-43.38839924308639,-2.195742276508099,41.19265696657829
2024-10-16T10:00:00-04:00,20224.5,20349.5,20205.25,20337,NaN,NaN,NaN,20591.33589721445,NaN,NaN,20337.055,20689.718172021217,19984.391827978783,20470.437403947926,20301.735935023986,20330.568438010858,20272.903432037114,540509,177487.26666666666,45.605078861053585,55.32416478709492,NaN,NaN,NaN,NaN,104.71709169284843,22.633573868557473,7262299,-39.45409934381378,-8.124967213188938,31.329132130624842
2024-10-16T14:00:00-04:00,20336.75,20379.5,20318,20324.25,NaN,NaN,NaN,20591.33589721445,NaN,NaN,20341.83,20687.128181865617,19996.531818134386,20470.437403947926,20307.27417264581,20337.22867143365,20277.31967385797,153294,175720.53333333333,44.895024048582066,53.328000058514256,NaN,NaN,NaN,NaN,101.63015657193068,23.024404956759618,7109005,-36.01920423569733,-13.694873163996817,22.32433107170051
2024-10-16T18:00:00-04:00,20332,20337.25,20276.75,20318,NaN,NaN,NaN,20591.33589721445,NaN,NaN,20345.88,20685.16252592758,20006.597474072423,20470.437403947926,20310.666666666668,20310.666666666668,20310.666666666668,40928,176037.16666666666,44.52902800103018,51.754727037907045,NaN,NaN,NaN,NaN,98.69228824536421,23.704374222646397,7068077,-32.58047938586079,-18.401268160625477,14.179211225235312
2024-10-16T22:00:00-04:00,20318.5,20347.75,20279.5,20342,NaN,NaN,NaN,20591.33589721445,NaN,NaN,20348.645,20685.493899211644,20011.796100788357,20338.69992315834,20316.398742502366,20322.588781399438,20310.208703605294,35096,176401.46666666667,46.338117281855475,50.210662124994265,NaN,NaN,NaN,NaN,96.51783908498105,24.17820986442653,7103173,-27.314875933599403,-19.964383691763942,7.35049224183546
2024-10-17T02:00:00-04:00,20342,20507,20339.5,20490,NaN,NaN,NaN,20591.33589721445,NaN,NaN,20354.14,20691.069312468,20017.210687532,20242.81976026887,20393.8162595247,20457.19264568927,20330.439873360134,113877,178540.8,55.89140044607004,49.409413679353825,NaN,NaN,NaN,NaN,101.58799343605382,22.628377404702423,7217050,-13.204605558950691,-9.155264706852904,4.049340852097787
2024-10-17T06:00:00-04:00,20490,20594.5,20402.5,20434,20179.093013475853,20179.093013475853,20179.093013475853,NaN,NaN,NaN,20359.01,20693.366784887356,20024.65321511264,20287.155808215095,20446.308905787653,20501.92356912573,20390.694242449576,324798,179271.63333333333,52.11108650334876,48.5018162945334,NaN,NaN,NaN,NaN,108.04599390490712,21.65670572628159,6892252,-7.27906044789553,-5.049484707771626,2.229575740123904
2024-10-17T10:00:00-04:00,20434.25,20529,20365.25,20477.25,20179.093013475853,NaN,NaN,NaN,NaN,NaN,20366.665,20693.89775523688,20039.43224476312,20287.155808215095,20451.9402090404,20490.905117362177,20412.975300718623,554568,179770.16666666666,54.66162339795119,47.946062032234934,NaN,NaN,NaN,NaN,112.02485148312805,20.373225527793025,7446820,-0.44367584873508426,1.6749809292050486,2.118656777940133
2024-10-17T14:00:00-04:00,20478,20484,20353.75,20384,20179.093013475853,NaN,NaN,NaN,NaN,NaN,20372.16,20691.038562465463,20053.281437534537,20287.155808215095,20443.11526386459,20482.293861245864,20403.936666483318,263102,183110.2,48.645870145838074,46.76638154540333,NaN,NaN,NaN,NaN,113.32664780576177,19.062813995790446,7183718,-2.106443524683426,-0.5143976279141498,1.5920458967692763
2024-10-17T18:00:00-04:00,20385.5,20415.75,20321,20379.25,20179.093013475853,NaN,NaN,NaN,NaN,NaN,20376.77,20689.195332519448,20064.344667480553,20287.155808215095,20372,20372,20372,50731,183822.9,48.35394677214217,47.06341526253275,NaN,NaN,NaN,NaN,111.9997443910645,17.89754238779874,7132987,-3.355859122188768,-2.602778005966684,0.7530811162220843
2024-10-17T22:00:00-04:00,20378.75,20408.75,20352.5,20404.5,20179.093013475853,NaN,NaN,NaN,NaN,NaN,20384.48,20679.76524920803,20089.19475079197,20287.155808215095,20379.016598627077,20387.209640656765,20370.82355659739,37208,184122.83333333334,50.06925967653575,47.57704372467849,NaN,NaN,NaN,NaN,108.01761979170274,16.815504466092154,7170195,-2.3585186184127167,-2.1950671567938116,0.16345146161890511
2024-10-18T02:00:00-04:00,20405,20468,20396.75,20429.75,20179.093013475853,NaN,NaN,NaN,NaN,NaN,20393.47,20665.429365346623,20121.51063465338,20287.155808215095,20400.37941854062,20426.92421847975,20373.834618601486,60366,184100.46666666667,51.793495029654544,48.047665107744805,NaN,NaN,NaN,NaN,105.39136123515254,16.07447724418592,7230561,0.00013838652596404044,0.16362444477636018,0.16348605825039614
2024-10-18T06:00:00-04:00,20429,20511.25,20418.5,20475.25,20179.093013475853,NaN,NaN,NaN,NaN,NaN,20403.4,20649.048325863758,20157.751674136245,20287.155808215095,20442.65910376277,20479.424835953498,20405.89337157204,244225,185254.36666666667,54.82109791438737,48.601365660735205,NaN,NaN,NaN,NaN,104.48840686121308,15.82538953714215,7474786,4.380704880504654,5.639367158881214,1.2586622783765598
2024-10-18T10:00:00-04:00,20475.75,20532,20442.25,20485.5,20179.093013475853,NaN,NaN,NaN,NaN,NaN,20411.65,20639.41512024358,20183.884879756424,20287.155808215095,20466.28472404541,20499.514744281383,20433.054703809437,456867,183933.9,55.499143336550276,49.33131052765378,NaN,NaN,NaN,NaN,103.43566351398358,15.799060763148384,7931653,7.5393713750454046,10.682876497183315,3.1435051221379107
2024-10-18T14:00:00-04:00,20485.5,20509.25,20451.75,20484.25,20179.093013475853,NaN,NaN,NaN,NaN,NaN,20418.22,20634.754446219806,20201.685553780197,20287.155808215095,20468.523783693166,20499.732399694054,20437.31516769228,143794,183217.33333333334,55.389967869208206,50.61458137744341,NaN,NaN,NaN,NaN,100.1545446915562,15.774612615868458,7787859,9.015505218657164,14.412886645459366,5.397381426802202
2024-10-20T18:00:00-04:00,20495.75,20526,20494,20507.5,20212.394377419034,NaN,NaN,NaN,NaN,NaN,20423.73,20634.98616772073,20212.47383227927,20324.788840864632,20509.166666666668,20509.166666666668,20509.166666666668,35906,182882.83333333334,57.0811279077173,51.43429916649082,NaN,NaN,NaN,NaN,95.98279149930218,15.93196683219811,7823765,10.902663420953294,19.02571070299382,8.123047282040526
2024-10-20T22:00:00-04:00,20507.75,20511,20443.75,20448.5,20212.394377419034,NaN,NaN,NaN,NaN,NaN,20426.98,20634.62979749576,20219.33020250424,20324.788840864632,20488.847903602607,20509.55257226523,20468.143234939984,34580,183050.03333333333,51.72259149581059,51.92198255557857,NaN,NaN,NaN,NaN,93.93044924935202,15.337636167191885,7789185,7.674663552739519,17.716376722964924,10.041713170225405
2024-10-21T02:00:00-04:00,20448.75,20461,20395,20424.75,20212.394377419034,NaN,NaN,NaN,NaN,NaN,20429.975,20633.039330940173,20226.910669059824,20324.788840864632,20461.37445698649,20495.801023219778,20426.947890753203,56199,183467.73333333334,49.70000833425448,52.29133829366602,NaN,NaN,NaN,NaN,91.93541716011259,14.344719843358439,7732986,3.641879329028429,14.59406233151094,10.952183002482512
2024-10-21T06:00:00-04:00,20425,20502.75,20342.5,20493.25,20212.394377419034,NaN,NaN,NaN,NaN,NaN,20435.205,20630.91539037258,20239.494609627425,20324.788840864632,20451.459709870593,20473.023147218086,20429.8962725231,237302,185116.26666666666,55.14781130606564,52.92060215253819,NaN,NaN,NaN,NaN,96.81503022010455,14.048254762631181,7970288,5.19495598293711,17.4458779811539,12.25092199821679
2024-10-21T10:00:00-04:00,20493.5,20554.25,20345,20491.75,20212.394377419034,NaN,NaN,NaN,NaN,NaN,20439.78,20629.785937802237,20249.77406219776,20324.788840864632,20458.95446900673,20473.61092391107,20444.29801410239,578922,190643.16666666666,55.00731680989932,52.857453321383126,NaN,NaN,NaN,NaN,104.84609949009709,13.097565837899165,7391366,5.6886503515385645,19.361734937639994,13.67308458610143
2024-10-21T14:00:00-04:00,20492,20549.75,20445.5,20538.75,20212.394377419034,NaN,NaN,NaN,NaN,NaN,20445.23,20630.58921449967,20259.87078550033,20324.788840864632,20466.69538026712,20489.686764474798,20443.70399605944,163515,191030.76666666666,58.568942921336294,53.318728779810804,NaN,NaN,NaN,NaN,104.80352095509015,12.21478326493372,7554881,8.574655263074005,24.391403664943937,15.816748401869932
2024-10-21T18:00:00-04:00,20539,20543.75,20460,20471.25,20212.394377419034,NaN,NaN,NaN,NaN,NaN,20446.67,20631.696415412698,20261.6435845873,20324.788840864632,20491.666666666668,20491.666666666668,20491.666666666668,49924,191500.26666666666,52.18036568528928,53.141496086049244,NaN,NaN,NaN,NaN,103.29969802972656,11.395056590037235,7504957,5.482159048857682,22.669447212942032,17.18728816408435
2024-10-21T22:00:00-04:00,20470.5,20484,20440.5,20452.75,20212.394377419034,NaN,NaN,NaN,NaN,NaN,20446.745,20631.77817243186,20261.71182756814,20324.788840864632,20477.565510411223,20493.70924191547,20461.421778906977,38090,192107.16666666666,50.552814184672954,53.27770637453745,NaN,NaN,NaN,NaN,99.02829102760323,10.910377633725023,7466867,1.9191384911627658,19.58621127803781,17.667072786875043
2024-10-22T02:00:00-04:00,20453,20488.5,20376,20384.5,20212.394377419034,NaN,NaN,NaN,NaN,NaN,20445.415,20631.260920321074,20259.569079678928,20324.788840864632,20448.3064274993,20481.0415648208,20415.571290177802,80543,193064.7,44.9789938174665,53.03663830634633,NaN,NaN,NaN,NaN,99.990555954203,11.291377784482355,7386324,-4.931321063959366,11.502921456925833,16.4342425208852
2024-10-22T06:00:00-04:00,20384.5,20479.5,20360.25,20461.5,20212.394377419034,NaN,NaN,NaN,NaN,NaN,20445.78,20631.679156534174,20259.880843465824,20324.788840864632,20439.118360624532,20460.20208160108,20418.034639647984,288489,195693.3,51.47895192035791,53.13733060947648,NaN,NaN,NaN,NaN,101.36623052890279,11.831087647822928,7674813,-4.202416136945278,11.181222349703603,15.38363848664888
2024-10-22T10:00:00-04:00,20460.75,20577,20425.25,20574.75,20212.394377419034,NaN,NaN,NaN,NaN,NaN,20448.65,20637.962757097073,20259.33724290293,20316.40607269171,20485.06510663114,20530.606784556847,20439.523428705434,517216,190459.26666666666,59.127001539709966,53.66115250305187,NaN,NaN,NaN,NaN,104.96507120540973,11.096727001196864,8192029,3.561845679883241,19.83594558650293,16.27409990661969
2024-10-22T14:00:00-04:00,20574.5,20602,20507.25,20517.5,20243.314983418768,NaN,NaN,NaN,NaN,NaN,20451.855,20640.29369268315,20263.41630731685,20329.96259801127,20494.1991655318,20540.90740372277,20447.490927340834,185199,188890.33333333334,54.45423435413606,53.63494796303392,NaN,NaN,NaN,NaN,104.23542326216617,10.733007975364265,8006830,4.439687615754764,21.823709426313144,17.38402181055838
2024-10-22T18:00:00-04:00,20522.75,20537.5,20490.5,20507.25,20243.314983418768,NaN,NaN,NaN,NaN,NaN,20453.09,20642.15426843809,20264.02573156191,20329.96259801127,20511.75,20511.75,20511.75,45605,189044.5,53.63692732079176,53.50193253333688,NaN,NaN,NaN,NaN,100.14717874344001,10.155882481816324,7961225,3.944548310819279,22.314707199082477,18.370158888263198
2024-10-22T22:00:00-04:00,20508,20529.75,20501.25,20508,20243.314983418768,NaN,NaN,NaN,NaN,NaN,20454.57,20644.171135018278,20264.96886498172,20329.96259801127,20512.203778842395,20512.804868084233,20511.602689600557,25991,188869.63333333333,53.69169628586813,53.38062742024117,NaN,NaN,NaN,NaN,95.02952311890859,9.619980237807521,7987216,3.307810862253227,22.504922466079734,19.197111603826507
2024-10-23T02:00:00-04:00,20508.25,20542.5,20473.25,20485.5,20243.314983418768,NaN,NaN,NaN,NaN,NaN,20455.255,20645.05058714542,20265.459412854583,20342.15185018177,20506.894032487504,20512.775505014935,20501.012559960072,58690,188403.7,51.71787015895731,52.99753758104403,NaN,NaN,NaN,NaN,93.18812861041512,9.166792429632533,7928526,1.1244014158635238,20.602613373655913,19.47821195779239
2024-10-23T06:00:00-04:00,20485.25,20494.25,20407,20432.5,20243.314983418768,NaN,NaN,NaN,NaN,NaN,20455.36,20645.09929903957,20265.62070096043,20342.15185018177,20467.088224096813,20497.226554109122,20436.949894084504,230445,188199.3,47.30624801820844,52.682084475501014,NaN,NaN,NaN,NaN,92.76397656681404,9.63226743196366,7698081,-3.8629756283584413,14.649492422344338,18.51246805070278
2024-10-23T10:00:00-04:00,20432.25,20458,20121.25,20126,NaN,NaN,NaN,20610.91158410795,20610.91158410795,20610.91158410795,20450.51,20660.227857132137,20240.79214286786,20342.15185018177,20311.854885709872,20422.39027164736,20201.319499772384,729404,194495.8,30.893924981201536,51.338792807425804,NaN,NaN,NaN,NaN,110.19154966918447,12.313236493305393,6968677,-26.51535197003934,-14.631721911846398,11.883630058192942
2024-10-23T14:00:00-04:00,20126,20299,20079,20275.25,NaN,NaN,NaN,20525.682648466678,NaN,NaN,20448.845,20662.738685974895,20234.951314025107,20342.15185018177,20291.680417048618,20396.99059731528,20186.370236781953,297481,199302.03333333333,41.53148782946958,50.36619827338323,NaN,NaN,NaN,NaN,118.03501040709986,15.014487686416622,7266158,-29.90699850880448,-25.500118077812658,4.406880430991822
2024-10-23T18:00:00-04:00,20299.5,20339,20268,20325.75,NaN,NaN,NaN,20525.682648466678,NaN,NaN,20446.62,20663.257190712946,20229.982809287052,20342.15185018177,20310.916666666668,20310.916666666668,20310.916666666668,46767,199496.66666666666,44.63682405169003,49.62544879065399,NaN,NaN,NaN,NaN,114.67536680659272,16.94243712282968,7312925,-27.282427236285017,-29.696153614364448,-2.4137263780794322
2024-10-23T22:00:00-04:00,20325,20343.25,20306,20324,NaN,NaN,NaN,20525.682648466678,NaN,NaN,20444.855,20664.006912836674,20225.703087163325,20342.15185018177,20316.637820394353,20323.308950383478,20309.96669040523,34396,199473.33333333334,44.54852596784742,48.62399043683336,NaN,NaN,NaN,NaN,109.14498346326467,18.670250272066244,7278529,-24.29688232029731,-32.78482927845107,-8.48794695815376
2024-10-24T02:00:00-04:00,20324,20402,20314.5,20377,NaN,NaN,NaN,20525.682648466678,NaN,NaN,20444.39,20664.016664137464,20224.763335862535,20342.15185018177,20337.889426820388,20362.184712279715,20313.59414136106,64818,197838.03333333333,47.90931001324691,48.318915031687474,NaN,NaN,NaN,NaN,107.59891321588862,19.428563118516575,7343347,-17.69219871210226,-30.603195348281588,-12.910996636179327
2024-10-24T06:00:00-04:00,20377.25,20428,20296,20338.25,NaN,NaN,NaN,20525.682648466678,NaN,NaN,20442.525,20664.13258673759,20220.917413262414,20342.15185018177,20347.926948130866,20364.84417095943,20331.0097253023,238011,194945.13333333333,45.727171229852374,47.974226249200285,NaN,NaN,NaN,NaN,109.34184798618229,19.77752197554917,7105336,-14.98028407010425,-31.63635172380964,-16.65606765370539
2024-10-24T10:00:00-04:00,20338.25,20388.75,20260.5,20345,NaN,NaN,NaN,20525.682648466678,NaN,NaN,20439.675,20662.557261519523,20216.792738480475,20342.15185018177,20337.901582662063,20351.221659516843,20324.581505807284,593633,196247.3,46.186968784509624,48.060510175417654,NaN,NaN,NaN,NaN,110.69243027288356,20.390935332200648,7698969,-11.912597846111172,-31.546814961344353,-19.63421711523318
2024-10-24T14:00:00-04:00,20345.25,20413.25,20327.75,20391,NaN,NaN,NaN,20525.682648466678,NaN,NaN,20434.08,20647.315021513477,20220.844978486526,20342.15185018177,20344.126599164032,20362.997933270803,20325.25526505726,183268,193586.16666666666,49.3369930804523,47.9075131154244,NaN,NaN,NaN,NaN,108.89297096767758,20.60971677552835,7882237,-6.250739542932255,-27.4476415438985,-21.196902000966244
2024-10-24T18:00:00-04:00,20385,20412.75,20363.25,20397,NaN,NaN,NaN,20525.682648466678,NaN,NaN,20429.86,20637.436688479105,20222.283311520896,20290.346480145414,20391,20391,20391,33263,193003.9,49.750172918627854,47.237739642489956,NaN,NaN,NaN,NaN,104.65061589855775,20.812870972904076,7915500,-1.7981682589112111,-23.44461232460526,-21.646444065694048
2024-10-24T22:00:00-04:00,20397,20410.75,20364.75,20389.75,NaN,NaN,NaN,20525.682648466678,NaN,NaN,20424.905,20624.07685770084,20225.73314229916,20191.113257115132,20389.77084548105,20391.060998592468,20388.48069236963,30192,192770.03333333333,49.22774123481138,46.86441870539534,NaN,NaN,NaN,NaN,100.46128619151791,21.00151415618154,7885308,0.8215485486648682,-20.619508379862964,-21.441056928527832
2024-10-25T02:00:00-04:00,20390,20446.25,20382,20434,NaN,NaN,NaN,20525.682648466678,NaN,NaN,20421,20611.458656931103,20230.541343068897,20238.415605692106,20405.235851439124,20420.752293289133,20389.719409589114,63254,192866.3,52.5059320853185,46.78363333143296,NaN,NaN,NaN,NaN,97.87476574926664,20.60562890257911,7948562,5.439875006052549,-14.641213170962146,-20.081088177014696
2024-10-25T06:00:00-04:00,20433.75,20657.75,20410,20648.25,20213.060559777314,20213.060559777314,20213.060559777314,NaN,NaN,NaN,20421.815,20615.775480768938,20227.85451923106,20367.607484553686,20512.879101708953,20593.186756397794,20432.571447020113,230703,192415.56666666668,64.46827566647858,47.55338900147656,NaN,NaN,NaN,NaN,108.58013962431903,20.45037368980624,8179265,21.905395241607632,7.300655874994845,-14.604739366612787
2024-10-25T10:00:00-04:00,20650.5,20707.5,20483,20510.5,20258.404397969254,NaN,NaN,NaN,NaN,NaN,20420.325,20610.353004514924,20230.296995485078,20367.607484553686,20547.93521151331,20602.15876487562,20493.711658151,657205,199093.5,54.89491388291878,47.78032069604524,NaN,NaN,NaN,NaN,116.8601296511534,20.709452574152262,7522060,22.41961274972757,13.419776570546674,-8.999836179180894
2024-10-25T14:00:00-04:00,20510.75,20560.75,20460,20477.25,20258.404397969254,NaN,NaN,NaN,NaN,NaN,20417.28,20598.477285852066,20236.08271414793,20367.607484553686,20537.071918216203,20588.965838477605,20485.1779979548,292064,204035.83333333334,52.854649989539745,48.176635122568904,NaN,NaN,NaN,NaN,115.70940610464244,20.654804181959772,7229996,19.52675364136559,15.408605872526095,-4.118147768839496
2024-10-27T18:00:00-04:00,20524,20648.75,20522,20625.75,20258.404397969254,NaN,NaN,NaN,NaN,NaN,20422.62,20612.148658519112,20233.091341480886,20367.607484553686,20598.833333333332,20598.833333333332,20598.833333333332,78438,205453.56666666668,60.00433132038348,50.2559498610819,NaN,NaN,NaN,NaN,119.6944485257394,21.294186852512716,7308434,26.204408347972507,28.637362666126137,2.43295431815363
2024-10-27T22:00:00-04:00,20625.25,20658.5,20601,20607.5,20294.09932659591,NaN,NaN,NaN,NaN,NaN,20428.075,20622.80261103586,20233.347388964143,20367.607484553686,20607.764265747715,20619.17107765446,20596.35745384097,48083,205903.66666666666,58.82368145855953,51.49110654887404,NaN,NaN,NaN,NaN,115.25198791675803,21.95927816538175,7260351,27.82930141929119,37.21958109226762,9.390279672976426
2024-10-28T02:00:00-04:00,20607.75,20671.25,20602,20669.75,20306.787993568825,NaN,NaN,NaN,NaN,NaN,20434.14,20639.422565260895,20228.857434739104,20391.90150053855,20621.974335616647,20643.160850393313,20600.78782083998,69977,206362.93333333332,61.599175144958764,52.7027030555361,NaN,NaN,NaN,NaN,111.9661316369896,22.67401537387527,7330328,31.27593513616434,48.48519859318185,17.20926345701751
2024-10-28T06:00:00-04:00,20669.5,20676.75,20528,20556.25,20306.787993568825,NaN,NaN,NaN,NaN,NaN,20437.425,20645.14734473024,20229.702655269757,20391.90150053855,20602.578663057844,20624.986221535284,20580.171104580404,244643,206607.63333333333,54.39926685433428,53.40632740457087,NaN,NaN,NaN,NaN,114.59355080577606,22.30895891097622,7085685,24.396483763354368,47.70486816121047,23.308384397856102
2024-10-28T10:00:00-04:00,20555.75,20617.75,20506.25,20555.25,20306.787993568825,NaN,NaN,NaN,NaN,NaN,20441.24,20650.466025149042,20232.01397485096,20391.90150053855,20579.971203469828,20606.319103384256,20553.6233035554,493199,203750.2,54.33900360282332,53.86559123239776,NaN,NaN,NaN,NaN,114.37258289107777,21.689576858376686,6592486,18.52935717265101,46.470080863669864,27.940723691018853
2024-10-28T14:00:00-04:00,20555.5,20560,20486,20507.25,20306.787993568825,NaN,NaN,NaN,NaN,NaN,20446.915,20647.420451546852,20246.40954845315,20391.90150053855,20570.13796164965,20603.298846551395,20536.977076747902,175376,204145.56666666668,51.395846417484776,54.270496602942934,NaN,NaN,NaN,NaN,111.4888269702865,20.851483112436426,6417110,10.562638261702098,41.144021518146474,30.581383256444376
2024-10-28T18:00:00-04:00,20508,20523.25,20475.25,20506.5,20306.787993568825,NaN,NaN,NaN,NaN,NaN,20450.305,20648.985630409446,20251.624369590554,20391.90150053855,20501.666666666668,20501.666666666668,20501.666666666668,41281,203857.46666666667,51.34904716835346,54.6392164875032,NaN,NaN,NaN,NaN,106.95391075812317,19.930437882832575,6375829,4.688874356161346,36.44247620164606,31.753601845484713
2024-10-28T22:00:00-04:00,20506.75,20518.75,20451,20507,20306.787993568825,NaN,NaN,NaN,NaN,NaN,20453.96,20649.935798506118,20257.98420149388,20391.90150053855,20496.833640890796,20501.540322802866,20492.126958978726,43527,204038.7,51.3808314071337,54.78520493940902,NaN,NaN,NaN,NaN,104.15363141825722,18.748954565636495,6419356,0.5039316972514669,32.38351646704905,31.87958476979758
2024-10-29T02:00:00-04:00,20507,20555,20482,20517.25,20306.787993568825,NaN,NaN,NaN,NaN,NaN,20457.945,20650.778173753893,20265.111826246106,20391.90150053855,20507.29902667736,20518.439250854077,20496.158802500642,82300,204097.26666666666,52.0721009157745,54.95105693920521,NaN,NaN,NaN,NaN,101.92837203123885,18.091870659431333,6501656,-1.7820352527568453,29.652040703851526,31.43407595660837
2024-10-29T06:00:00-04:00,20517.5,20526.75,20432,20514,20306.787993568825,NaN,NaN,NaN,NaN,NaN,20461.385,20651.94525844931,20270.82474155069,20391.90150053855,20497.64663541316,20508.414326933642,20486.878943892676,239673,202470.06666666668,51.820515316044855,55.13625508786475,NaN,NaN,NaN,NaN,101.41563117186465,16.804712211943258,6261983,-3.615403695527416,26.9148213371991,30.530225032726516
2024-10-29T10:00:00-04:00,20515,20686,20495,20671.75,20306.787993568825,NaN,NaN,NaN,NaN,NaN,20465.02,20664.356721152548,20265.683278847453,20412.862442852595,20567.87511517388,20627.36448971073,20508.38574063703,574706,204386.4,61.53495246681877,55.78118511511476,NaN,NaN,NaN,NaN,107.8145146595886,17.242945244908043,6836689,5.213900152005433,37.04760022273331,31.833700070727875
2024-10-29T14:00:00-04:00,20672.25,20760.25,20660.25,20709,20388.86737114099,NaN,NaN,NaN,NaN,NaN,20470.52,20680.99386631117,20260.04613368883,20491.739954282075,20592.275190783228,20668.427176866997,20516.12320469946,203715,205003.6,63.4110155615412,55.70566653619067,NaN,NaN,NaN,NaN,107.25633504104655,18.217171869731448,7040404,12.56160170024743,47.535702196037164,34.974100495789735
2024-10-29T18:00:00-04:00,20725,20789.75,20714.5,20782.25,20434.3393088164,NaN,NaN,NaN,NaN,NaN,20476.62,20704.481432454206,20248.758567545792,20534.56696342566,20762.166666666668,20762.166666666668,20762.166666666668,50284,205159.56666666668,66.8363967830675,56.558629600486995,NaN,NaN,NaN,NaN,105.36302539525751,19.330327144433205,7090688,20.864290440254862,61.05446354610831,40.19017310585345
2024-10-29T22:00:00-04:00,20782.75,20784,20702.75,20712.75,20434.3393088164,NaN,NaN,NaN,NaN,NaN,20483.195,20718.82654054615,20247.56345945385,20539.228570740528,20748.525087680497,20762.999655493717,20734.050519867276,44663,205781.96666666667,61.00115967989308,57.14052314979795,NaN,NaN,NaN,NaN,103.64066643845341,20.19390709313742,7046025,20.172780539293207,65.40614877996995,45.23336824067675
2024-10-30T02:00:00-04:00,20713,20764.75,20707.25,20731.75,20434.3393088164,NaN,NaN,NaN,NaN,NaN,20490.245,20733.969054824924,20246.520945175074,20540.182856592422,20743.114870743826,20756.31968907867,20729.91005240898,60210,205832.63333333333,61.97846136200621,57.28153243848528,NaN,NaN,NaN,NaN,100.34490454999245,20.99580275979133,7106235,19.48201666890985,69.58588907681406,50.103872407904205
2024-10-30T06:00:00-04:00,20730.75,20754.5,20543,20632.25,20434.3393088164,NaN,NaN,NaN,NaN,NaN,20494.8,20740.449099327187,20249.150900672812,20540.182856592422,20676.48110491301,20724.150132853534,20628.81207697249,311115,208521.63333333333,54.30376723781643,56.958681422717916,NaN,NaN,NaN,NaN,108.28455422499299,19.638703055981203,6795120,11.22113476036774,64.13029085836388,52.90915609799614
2024-10-30T10:00:00-04:00,20631.75,20699.5,20558.25,20576.25,20434.3393088164,NaN,NaN,NaN,NaN,NaN,20497.73,20743.70021852272,20251.759781477278,20540.182856592422,20641.851795413542,20687.90946330576,20595.794127521323,529079,201844.13333333333,50.512626834063106,56.1667851147968,NaN,NaN,NaN,NaN,110.63922892320777,18.378539045300364,6266041,1.3989917433193426,54.65789577714531,53.25890403382597
2024-10-30T14:00:00-04:00,20576.5,20623,20471,20505.5,20434.3393088164,NaN,NaN,NaN,NaN,NaN,20498.335,20744.229867982536,20252.440132017462,20540.182856592422,20620.049948786607,20679.966539469766,20560.13335810345,249766,200253.63333333333,46.13081118886701,55.576181138692,NaN,NaN,NaN,NaN,113.59356971440721,17.80628366635278,6016275,-9.831325649087205,40.969746972466965,50.80107262155417
2024-10-30T18:00:00-04:00,20486,20496.5,20400.25,20441.25,NaN,NaN,NaN,20780.825114650575,20780.825114650575,20780.825114650575,20497.45,20743.841294488742,20251.05870551126,20540.182856592422,20446,20446,20446,70344,201039.53333333333,42.523263303399084,54.732199688733125,NaN,NaN,NaN,NaN,112.9976004490924,17.887734921861227,5945931,-20.918325269530627,24.65316603464089,45.571491304171516
2024-10-30T22:00:00-04:00,20441.25,20446.75,20383.5,20392,NaN,NaN,NaN,20741.088745802823,NaN,NaN,20495.605,20743.73942103039,20247.47057896961,20540.182856592422,20431.399647721384,20450.11220959869,20412.687085844078,42824,201320.46666666667,39.944587529831956,53.914252625329354,NaN,NaN,NaN,NaN,109.44420041701437,18.10129402817377,5903107,-30.32935519463605,7.659797310876456,37.98915250551251
2024-10-31T02:00:00-04:00,20392.5,20397,20287,20320.75,NaN,NaN,NaN,20668.147211902695,NaN,NaN,20491.87,20744.75240824571,20238.98759175429,20540.182856592422,20386.99495495109,20437.010203028738,20336.97970687344,96493,202376.3,36.49645351749157,52.85335307883922,NaN,NaN,NaN,NaN,109.48390038722764,19.027381515583805,5806614,-39.531439912466716,-11.425147385070886,28.10629252739583
2024-10-31T06:00:00-04:00,20321,20417.75,20150.25,20166.25,NaN,NaN,NaN,20631.79961136166,NaN,NaN,20486.225,20754.839672905648,20217.61032709435,20540.182856592422,20298.261457428714,20373.688993814158,20222.83392104327,347663,206031.36666666667,30.373636447427828,51.35283915314593,NaN,NaN,NaN,NaN,120.77076464528281,20.69603518221222,5458951,-53.3428937005617,-38.572324598306295,14.770569102255406
2024-10-31T10:00:00-04:00,20166.25,20201.5,20023.75,20036,NaN,NaN,NaN,20468.85417448159,NaN,NaN,20478.45,20774.80436558257,20182.09563441743,20540.182856592422,20185.01807007354,20302.188476316613,20067.847663830467,644442,207725,26.35886154861572,49.51617919834888,NaN,NaN,NaN,NaN,124.84071002776261,22.824141863259896,4814509,-67.65023390118057,-69.7922232742203,-2.1419893730397366
2024-10-31T14:00:00-04:00,20036.25,20132,20007.75,20036,NaN,NaN,NaN,20426.85512109606,NaN,NaN,20469.305,20790.45110833709,20148.15889166291,20540.182856592422,20158.099371260927,20274.22336512426,20041.975377397594,325073,212451.83333333334,26.35886154861572,47.69748964353251,NaN,NaN,NaN,NaN,124.798516454351,24.866702881287015,4814509,-73.05193240363309,-93.45690487758111,-20.404972473948014
2024-10-31T18:00:00-04:00,20065.25,20111.75,20050,20057.75,NaN,NaN,NaN,20426.85512109606,NaN,NaN,20460.625,20801.716413700142,20119.533586299858,20469.09628527394,20073.166666666668,20073.166666666668,20073.166666666668,51666,213065.26666666666,28.196916127042854,45.31620133354853,NaN,NaN,NaN,NaN,121.29505099332593,26.76336668374077,4866175,-71.03404694037522,-109.19753114941705,-38.16348420904182
2024-10-31T22:00:00-04:00,20058.5,20127,20017.75,20120.5,NaN,NaN,NaN,20422.397692982155,NaN,NaN,20452.26,20805.572863621506,20098.94713637849,20400.55202821915,20080.43422910018,20088.050846686565,20072.817611513798,47039,213626.83333333334,33.36444686376484,43.170017855135924,NaN,NaN,NaN,NaN,120.43469020808836,28.670583936759026,4913214,-61.69306570080572,-115.27981633504896,-53.586750634243245
2024-11-01T02:00:00-04:00,20121.5,20123.75,20054,20094,NaN,NaN,NaN,20422.397692982155,NaN,NaN,20444.715,20811.92262532926,20077.50737467074,20307.84162257532,20084.17960441504,20091.96346277502,20076.39574605506,57730,213442.7,32.30701207912483,40.70363323342574,NaN,NaN,NaN,NaN,116.8143551932249,30.44157138599027,4855484,-53.806895092173804,-120.8453694994605,-67.0384744072867
2024-11-01T06:00:00-04:00,20095,20175.5,20057.25,20167.75,NaN,NaN,NaN,20422.397692982155,NaN,NaN,20439.015,20814.305666151246,20063.724333848753,20191.748298060254,20114.624084494408,20139.07517572647,20090.172993262346,252310,214162.93333333332,38.179263876029395,39.07349781886404,NaN,NaN,NaN,NaN,116.91690125085168,31.28991187544275,5107794,-40.7256201015818,-117.94549953426394,-77.21987943268215
2024-11-01T10:00:00-04:00,20165.75,20287.25,20132.25,20157.5,NaN,NaN,NaN,20422.397692982155,NaN,NaN,20434.475,20817.70201170501,20051.24798829499,20171.323638448204,20164.032427533166,20204.232350320137,20123.832504746195,713596,216042.63333333333,37.68989934657702,37.33860053204767,NaN,NaN,NaN,NaN,119.63712259007657,30.608762415530766,4394198,-30.341758215588328,-115.14707720216757,-84.80531898657924
2024-11-01T14:00:00-04:00,20157.75,20203.25,20123,20169.5,NaN,NaN,NaN,20422.397692982155,NaN,NaN,20428.635,20818.87214853945,20038.397851460548,20121.658910758564,20164.245847910286,20200.755901613687,20127.735794206885,238540,214258.5,38.68083001190267,36.2226764444824,NaN,NaN,NaN,NaN,116.8237566907854,30.047340924875726,4632738,-20.7038237801399,-110.68509871175411,-89.98127493161421
2024-11-03T18:00:00-05:00,20141.75,20249,20066.25,20211.75,NaN,NaN,NaN,20422.397692982155,NaN,NaN,20421.375,20813.96812589493,20028.78187410507,20063.72712860685,20175.666666666668,20175.666666666668,20175.666666666668,82029,214378.2,42.16807618023433,35.626637112066064,NaN,NaN,NaN,NaN,121.53277407001501,29.953708257145433,4714767,-10.06098613588334,-102.55750760146839,-92.49652146558505
2024-11-03T22:00:00-05:00,20213,20248,20205.25,20238,NaN,NaN,NaN,20422.397692982155,NaN,NaN,20415.785,20810.69673710067,20020.87326289933,19978.749254721213,20191.980710365213,20217.021594348447,20166.93982638198,34817,213936,44.288009925320544,35.49500845038417,NaN,NaN,NaN,NaN,115.90543306501392,29.86676363711016,4749584,-0.34436136287175145,-92.92697316917474,-92.58261180630299
2024-11-04T02:00:00-05:00,20237,20244.25,20135.25,20198.75,NaN,NaN,NaN,20422.397692982155,NaN,NaN,20409.615,20808.240227625756,20010.989772374247,19978.749254721213,20192.297300745533,20211.510245352474,20173.084356138592,81715,214327.26666666666,41.81953411695273,35.44474207992372,NaN,NaN,NaN,NaN,115.41218784608436,30.29409906785206,4667869,4.103097488752766,-87.45373994536203,-91.5568374341148
2024-11-04T06:00:00-05:00,20198.5,20203.5,20013.25,20131.5,NaN,NaN,NaN,20422.397692982155,NaN,NaN,20402.085,20807.16367890102,19997.00632109898,19978.749254721213,20147.74470309728,20187.29146009922,20108.19794609534,279407,215486.06666666668,37.91970994124847,35.30010796645347,NaN,NaN,NaN,NaN,120.75774585707835,31.413892979801826,4388462,3.2185557034319032,-87.53364280482492,-90.75219850825682
2024-11-04T10:00:00-05:00,20132.5,20226.75,20028.75,20149.5,NaN,NaN,NaN,20422.397692982155,NaN,NaN,20395.365,20805.798176168617,19984.931823831386,19978.749254721213,20141.063510450655,20169.073964419356,20113.053056481953,526658,216601.36666666667,39.54475250304728,35.51784360827888,NaN,NaN,NaN,NaN,126.27504972442989,32.126660727912714,4915120,4.471508459880823,-85.1628129334058,-89.63432139328663
2024-11-04T14:00:00-05:00,20148.75,20168.75,20070,20115,NaN,NaN,NaN,20422.397692982155,NaN,NaN,20389.015,20806.713628319736,19971.316371680263,19978.749254721213,20137.84119848342,20165.036144456597,20110.646252510243,162474,216171.3,37.51764028538843,36.02812959670464,NaN,NaN,NaN,NaN,124.30897474411347,32.78851649401568,4752646,3.6379007083580035,-85.08694550783912,-88.72484621619712
2024-11-04T18:00:00-05:00,20128,20134,20041.75,20103.25,NaN,NaN,NaN,20422.397692982155,NaN,NaN,20388.56,20807.45150814937,19969.668491850633,19978.749254721213,20093,20093,20093,65039,216963.23333333334,36.825270151522304,36.77573021119797,NaN,NaN,NaN,NaN,122.0190479766768,33.5802985625119,4687607,2.98373668990547,-84.99517535381528,-87.97891204372075
2024-11-04T22:00:00-05:00,20103.5,20124.75,20082,20118.25,NaN,NaN,NaN,20422.397692982155,NaN,NaN,20385.42,20809.97732757818,19960.862672421816,19978.749254721213,20097.935520082854,20105.09922137142,20090.77181879429,30872,216541.4,38.38842919648289,37.63498504318848,NaN,NaN,NaN,NaN,116.35697312119989,34.31552476897267,4718479,4.176658853397342,-82.75808847697408,-86.93474733037142
2024-11-05T02:00:00-05:00,20118.25,20167.75,20102,20143,NaN,NaN,NaN,20422.397692982155,NaN,NaN,20381.765,20811.4300370929,19952.099962907098,19969.89261841726,20113.37504960286,20133.50211570033,20093.24798350539,61170,215837.06666666668,40.983228941920416,38.548293101394016,NaN,NaN,NaN,NaN,112.74218932682847,34.28370775051216,4779649,7.077466672551196,-78.08791398968242,-85.16538066223362
2024-11-05T06:00:00-05:00,20142.5,20299.5,20107.25,20290.25,NaN,NaN,NaN,20422.397692982155,NaN,NaN,20381.09,20811.221697971738,19950.958302028263,20004.09007747992,20186.285239673558,20245.56581627462,20127.004663072497,248714,216138.43333333332,53.52424678543515,39.98827881008476,NaN,NaN,NaN,NaN,118.42131866062643,32.4697814926505,5028363,18.698211833685605,-61.79261587012661,-80.49082770381222
2024-11-05T10:00:00-05:00,20290,20373,20232.5,20309,NaN,NaN,NaN,20422.397692982155,NaN,NaN,20379.73,20810.334573129367,19949.125426870633,20066.422061983936,20250.33839564701,20321.79465042329,20178.88214087073,476970,212880.56666666668,54.84019868614975,41.59779213915796,NaN,NaN,NaN,NaN,119.99836732772454,30.29968059761855,5505333,26.932079316198454,-46.82572855856415,-73.7578078747626
2024-11-05T14:00:00-05:00,20308.5,20386,20280,20366,NaN,NaN,NaN,20422.397692982155,NaN,NaN,20380.285,20810.745799725013,19949.824200274987,20087.737649587147,20267.11022832562,20341.145734589016,20193.07472206222,192556,212508.6,58.6712996233016,43.06150897824883,NaN,NaN,NaN,NaN,118.99848394717279,28.41634937134764,5697889,34.99112652968739,-30.018899712653365,-65.01002624234076
2024-11-05T18:00:00-05:00,20365,20590.5,20323.5,20588.75,20084.20278153139,20084.20278153139,20084.20278153139,NaN,NaN,NaN,20385.16,20819.41620041617,19950.90379958383,20218.39011966972,20500.916666666668,20500.916666666668,20500.916666666668,138017,215433.03333333333,69.54463753604556,45.33684742035373,NaN,NaN,NaN,NaN,129.57002080808903,28.327762416991824,5835906,53.016157135944056,1.2601701775893162,-51.75598695835474
2024-11-05T22:00:00-05:00,20588.75,20670,20465.75,20647,20184.170836916328,NaN,NaN,NaN,NaN,NaN,20390.28,20830.68399226186,19949.876007738138,20270.187095735775,20549.808208241193,20596.42180828729,20503.194608195095,151836,219005.46666666667,71.64549283175512,47.691466193200334,NaN,NaN,NaN,NaN,134.90430503608266,28.7239362222888,5987742,65.72393092608985,30.398926699257572,-35.32500422683228
2024-11-06T02:00:00-05:00,20647.75,20731.5,20646.75,20684.75,20311.305117056494,NaN,NaN,NaN,NaN,NaN,20396.035,20844.09369046344,19947.97630953656,20369.27467658862,20591.296609532492,20665.57417288234,20517.019046182642,124785,221157.96666666667,72.94787792096935,49.890023460395696,NaN,NaN,NaN,NaN,131.32185467636248,29.427972517554284,6112527,72.97472841417652,55.89340629088838,-17.081322123288146
2024-11-06T06:00:00-05:00,20684.5,20806.75,20580.75,20676.25,20311.305117056494,NaN,NaN,NaN,NaN,NaN,20401.765,20856.631721249316,19946.898278750683,20403.969741270896,20637.766328052792,20709.836675009115,20565.69598109647,384207,223594.36666666667,72.14434026895377,51.87976134208378,NaN,NaN,NaN,NaN,138.08457934233658,30.457876334458394,5728320,73.30720897073824,74.55268909013466,1.2454801193964151
2024-11-06T10:00:00-05:00,20675.75,20876.5,20665.5,20861,20368.55667690478,NaN,NaN,NaN,NaN,NaN,20410.305,20882.957750864745,19937.652249135255,20448.775793016717,20704.303657178596,20801.827076912734,20606.780237444458,549690,224281.4,77.85430147069957,54.45367329592284,NaN,NaN,NaN,NaN,143.29282367502682,31.73043931311195,6278010,81.45167489951112,103.06007374378532,21.6083988442742
2024-11-06T14:00:00-05:00,20861.75,20935.75,20848.5,20924.25,20496.076827954563,NaN,NaN,NaN,NaN,NaN,20415.825,20905.600941119865,19926.049058880137,20549.945634413372,20728.48206597658,20840.589407822594,20616.374724130565,187010,222189.53333333333,79.41037099152751,57.41729194237134,NaN,NaN,NaN,NaN,139.28976484109634,33.160654848946976,6465020,86.12610455728066,129.26602954087502,43.13992498359436
2024-11-06T18:00:00-05:00,20924.25,20924.25,20860.75,20910,20505.794926683902,NaN,NaN,NaN,NaN,NaN,20423.815,20932.189623776867,19915.44037622313,20583.856507530698,20898.333333333332,20898.333333333332,20898.333333333332,60258,221853.33333333334,78.07925985080766,60.16975675292566,NaN,NaN,NaN,NaN,133.87621020958946,34.48871213222236,6404762,83.23837361969754,147.1878920082163,63.94951838851875
2024-11-06T22:00:00-05:00,20909.25,20965.75,20904.25,20949.75,20557.486066380086,NaN,NaN,NaN,NaN,NaN,20433.265,20962.403671900007,19904.126328099992,20662.68520602456,20915.26514570175,20935.695391114394,20894.834900289105,41388,221805.46666666667,79.13016394213815,63.142079871264926,NaN,NaN,NaN,NaN,128.7064809089045,35.9004710740331,6446150,79.01864330712161,162.72282252242076,83.70417921529915
2024-11-07T02:00:00-05:00,20949.5,20961,20908.25,20945.5,20567.077608817355,NaN,NaN,NaN,NaN,NaN,20439.66,20985.41716907792,19893.90283092208,20692.173164819647,20924.124822401314,20943.66072704839,20904.588917754238,63755,220714.2,78.69575808459766,66.13282900934173,NaN,NaN,NaN,NaN,123.28101798683988,37.21139009142878,6382395,71.19717014727387,172.70064189939148,101.50347175211762
2024-11-07T06:00:00-05:00,20945.25,21110.75,20924.75,21109.25,20641.54567205293,NaN,NaN,NaN,NaN,NaN,20449.695,21025.075328913063,19874.314671086937,20802.688531855718,20998.47214450067,21060.551962374077,20936.39232662726,247040,217360.1,82.64827194618636,69.29424634860626,NaN,NaN,NaN,NaN,127.76094527349417,39.010961243178805,6629435,72.08730366441445,191.61260133263568,119.52529766822123
2024-11-07T10:00:00-05:00,21108.75,21199,21086.5,21186.75,20768.304959686888,NaN,NaN,NaN,NaN,NaN,20460.035,21068.492829352177,19851.577170647823,20896.300825484574,21074.46034506904,21165.64768512092,20983.273005017163,377797,208471.93333333332,84.14731852451116,72.37739560450561,NaN,NaN,NaN,NaN,126.67087775395888,40.95483008949682,7007232,72.72246615389531,210.42838036059038,137.70591420669507
2024-11-07T14:00:00-05:00,21181.75,21253.5,21157.5,21224.75,20834.984279701122,NaN,NaN,NaN,NaN,NaN,20473.405,21118.03546693453,19828.77453306547,20963.34066038766,21107.455403641452,21206.277819249524,21008.63298803338,249604,205956.3,84.83894010476705,74.61415941302933,NaN,NaN,NaN,NaN,124.48010077153324,42.91255240234338,7256836,70.47797454418796,225.80338238693002,155.32540784274207
2024-11-07T18:00:00-05:00,21225,21245,21203.25,21219.25,20864.75772153289,NaN,NaN,NaN,NaN,NaN,20486.685,21164.04007534815,19809.32992465185,20991.997528310127,21222.5,21222.5,21222.5,37761,205492.8,84.26590468571696,76.71599555585554,NaN,NaN,NaN,NaN,118.57080785928088,44.73043740712947,7219075,63.60952955602232,234.83731978776996,171.22779023174763
2024-11-07T22:00:00-05:00,21219.5,21263.5,21219,21231.25,20892.149416008666,NaN,NaN,NaN,NaN,NaN,20501.165,21209.887474668092,19792.44252533191,21038.8480226481,21229.403230720483,21237.069403989506,21221.73705745146,30619,204945.46666666667,84.51171093359845,78.56173922087676,NaN,NaN,NaN,NaN,113.28003586933224,46.473414940192896,7249694,55.174765539017756,240.1962471555198,185.02148161650206
2024-11-08T02:00:00-05:00,21231.5,21250.5,21130.25,21144.25,20892.149416008666,NaN,NaN,NaN,NaN,NaN,20513.92,21245.164948290465,19782.67505170953,21038.8480226481,21201.14701647971,21228.842892587156,21173.451140372264,73896,205484.33333333334,75.32400221303665,78.97455098351897,NaN,NaN,NaN,NaN,113.77789045009422,46.74378583015184,7175798,39.756724197615824,234.71738686352182,194.960662665906
2024-11-08T06:00:00-05:00,21144.75,21232,21121.5,21208.5,20892.149416008666,NaN,NaN,NaN,NaN,NaN,20527.95,21284.602687829578,19771.297312170424,21038.8480226481,21192.433741508426,21210.535188794984,21174.33229422187,243057,205175.9,77.28776389336954,79.37757034506285,NaN,NaN,NaN,NaN,113.54375541794464,46.869170046770044,7418855,30.331747158085676,232.8753466135131,202.54359945542743
2024-11-08T10:00:00-05:00,21207.5,21266.5,21161.5,21250.25,20892.149416008666,NaN,NaN,NaN,NaN,NaN,20542.61,21325.803367949404,19759.416632050597,21038.8480226481,21210.1199793004,21231.043043006353,21189.19691559445,426921,195620.06666666668,78.48589769144543,79.77314318581114,NaN,NaN,NaN,NaN,112.93348717380573,47.15983677924711,7845776,23.65214996531492,232.10878691207108,208.45663694675616
2024-11-08T14:00:00-05:00,21250.25,21265.25,21208.25,21227.25,20897.492873500705,NaN,NaN,NaN,NaN,NaN,20556.875,21363.107573455138,19750.642426544862,21038.8480226481,21213.909191818253,21234.924084736736,21192.89429889977,156439,192883.36666666667,76.10407527700272,80.05598140067177,NaN,NaN,NaN,NaN,108.93823808996247,47.42974160226153,7689337,14.857357429699533,227.02833373388057,212.17097630418104
2024-11-10T18:00:00-05:00,21242,21311.5,21242,21270.25,20941.42501561431,NaN,NaN,NaN,NaN,NaN,20568.845,21398.962129626747,19738.727870373255,21086.44584006133,21274.583333333332,21274.583333333332,21274.583333333332,62231,192223.43333333332,77.48005005073755,80.02924915638879,NaN,NaN,NaN,NaN,107.174792512108,47.9207338294312,7751568,9.375941877805445,223.89090365143784,214.5149617736324
2024-11-10T22:00:00-05:00,21269.75,21300.5,21265.5,21288.25,20958.144333086388,NaN,NaN,NaN,NaN,NaN,20580.43,21433.887444984786,19726.972555015214,21102.956672049066,21277.573644729775,21282.20608868834,21272.94120077121,25931,191927.23333333334,78.04983778676691,79.93206821319158,NaN,NaN,NaN,NaN,102.01945018981458,48.37665518323161,7777499,4.641820425824733,220.3172373059133,215.67541688008856
2024-11-11T02:00:00-05:00,21287.75,21323.5,21271.5,21271.75,20980.31959067337,NaN,NaN,NaN,NaN,NaN,20590.22,21463.708177595887,19716.731822404116,21139.465337639253,21282.077870403296,21288.69161395231,21275.464126854284,58066,191138.93333333332,76.14788537500336,79.79411289349129,NaN,NaN,NaN,NaN,98.44663231911353,48.92421907538066,7719433,-1.5880301419423972,213.69037920266055,215.27840934460295
2024-11-11T06:00:00-05:00,21272.25,21340.5,21162.5,21171.75,20980.31959067337,NaN,NaN,NaN,NaN,NaN,20599.4,21487.373867858554,19711.42613214145,21139.465337639253,21245.826260961072,21273.64724484933,21218.005277072814,253520,190276.03333333333,65.69864347500393,78.83471857441027,NaN,NaN,NaN,NaN,104.12901572489113,47.62002380600529,7465913,-13.753951168153748,198.08597038441076,211.8399215525645
2024-11-11T10:00:00-05:00,21172,21244.25,21098.25,21179.5,20980.31959067337,NaN,NaN,NaN,NaN,NaN,20608.355,21510.40642918807,19706.303570811928,21139.465337639253,21205.894874771355,21246.11065524447,21165.67909429824,500472,189403.16666666666,66.0870432570502,77.93409608672832,NaN,NaN,NaN,NaN,107.11980031597034,45.535623471798026,7966385,-22.095027160289703,184.22113760220236,206.31616476249206
2024-11-11T14:00:00-05:00,21180,21233.5,21156.25,21211,20980.31959067337,NaN,NaN,NaN,NaN,NaN,20619.93,21537.628022445246,19702.231977554755,21139.465337639253,21205.054110136418,21242.208669154774,21167.899551118062,157547,189238.93333333332,67.68851097583172,76.86554173170298,NaN,NaN,NaN,NaN,104.98624315054387,43.60010887574842,8123932,-26.035482846218713,173.7718112047187,199.8072940509374
2024-11-11T18:00:00-05:00,21218,21249.75,21190.75,21206,20980.31959067337,NaN,NaN,NaN,NaN,NaN,20632.525,21564.6519937619,19700.3980062381,21139.465337639253,21215.5,21215.5,21215.5,49771,188730,67.14648518577559,75.65119649322186,NaN,NaN,NaN,NaN,101.70151149693359,41.95848084114054,8074161,-29.281154377549,163.20585107900115,192.48700545655015
2024-11-11T22:00:00-05:00,21206.5,21225.25,21185,21209.25,20980.31959067337,NaN,NaN,NaN,NaN,NaN,20646.6,21591.79120816918,19701.408791830818,21139.465337639253,21211.82411391352,21216.248007694616,21207.400220132426,34363,188846.36666666667,67.32961425704531,74.40053036124175,NaN,NaN,NaN,NaN,97.3121178185812,40.34728928607057,8108524,-31.327971795803194,153.32704071179614,184.65501250759934
2024-11-12T02:00:00-05:00,21209,21240.75,21129.5,21168.75,20980.31959067337,NaN,NaN,NaN,NaN,NaN,20661.15,21615.60134501445,19706.698654985554,21139.465337639253,21195.30188991819,21211.667835263746,21178.935944572637,88907,189770.93333333332,62.643550792797846,72.85607651174753,NaN,NaN,NaN,NaN,98.30768083153968,38.04249773272046,8019617,-35.236693137674735,140.60914608550593,175.84583922318066
2024-11-12T06:00:00-05:00,21169,21252.25,21167.75,21235,20980.31959067337,NaN,NaN,NaN,NaN,NaN,20678.01,21642.57689742087,19713.443102579127,21139.465337639253,21208.897434440434,21224.32536262537,21193.469506255497,249323,189791.23333333334,66.72350391021091,71.58549029579127,NaN,NaN,NaN,NaN,97.32141791500113,36.03837644830273,8268940,-33.21467099235463,134.32750048273738,167.542171475092
2024-11-12T10:00:00-05:00,21234.75,21241.5,21054.75,21182,20980.31959067337,NaN,NaN,NaN,NaN,NaN,20695.235,21664.41619776433,19726.05380223567,21139.465337639253,21180.02864295671,21206.37620731561,21153.68107859781,591556,193610.76666666666,60.985137674165024,70.56128568587187,NaN,NaN,NaN,NaN,103.70917377821534,34.16376144827599,7677384,-35.115924925377556,123.64726531837005,158.7631902437476
2024-11-12T14:00:00-05:00,21181.5,21211,21167,21180.75,20980.31959067337,NaN,NaN,NaN,NaN,NaN,20715.525,21682.03285433947,19749.01714566053,21139.465337639253,21180.928014068315,21205.394860459113,21156.461167677517,171344,192903.7,60.852213300244095,69.3873177863629,NaN,NaN,NaN,NaN,99.44423279405711,32.42304751967974,7506040,-35.99394502628542,113.77075896089082,149.76470398717623
2024-11-12T18:00:00-05:00,21180.5,21182,21132.5,21150.5,20980.31959067337,NaN,NaN,NaN,NaN,NaN,20737.815,21691.935525982066,19783.69447401793,21104.2722701114,21155,21155,21155,40648,189658.06666666668,57.58134919470393,67.89413575088136,NaN,NaN,NaN,NaN,95.8767875944816,31.192389738548904,7465392,-37.95326948917568,102.32311712570663,140.2763866148823
2024-11-12T22:00:00-05:00,21149.5,21161.5,21101.25,21118,20980.31959067337,NaN,NaN,NaN,NaN,NaN,20759.455,21697.875229374782,19821.03477062522,21035.848877976085,21141.667229838866,21155.69099069608,21127.643468981652,36741,185821.56666666668,54.20996742816392,66.33027090453572,NaN,NaN,NaN,NaN,93.33201705201863,30.38385424873245,7428651,-40.54471011710467,89.59549896850149,130.14020908560616
2024-11-13T02:00:00-05:00,21118,21184.5,21114.75,21152.25,20980.31959067337,NaN,NaN,NaN,NaN,NaN,20781.345,21704.203428416713,19858.48657158329,21035.848877976085,21145.292524663848,21156.9039660909,21133.681083236796,53876,183457.93333333332,57.06307985048153,64.8719158902317,NaN,NaN,NaN,NaN,91.64758726258871,29.274316769829706,7482527,-39.04426265574571,81.33488076592403,120.37914342166974
2024-11-13T06:00:00-05:00,21152,21243.5,21114.25,21140.5,20980.31959067337,NaN,NaN,NaN,NaN,NaN,20801.745,21710.252091276852,19893.237908723146,21035.848877976085,21159.878479911356,21171.312698144262,21148.44426167845,308569,180936.66666666666,55.77903294978161,63.281144116161336,NaN,NaN,NaN,NaN,94.33347388668952,27.39298915462888,7173958,-37.90437771154441,72.99867128223923,110.90304899378364
2024-11-13T10:00:00-05:00,21140.75,21268.75,21057.5,21257,20980.31959067337,NaN,NaN,NaN,NaN,NaN,20825.005,21719.28088299131,19930.729117008694,21035.848877976085,21179.78520726121,21198.40376276736,21161.166651755062,598413,182560.76666666666,64.34567530653163,62.4381291112705,NaN,NaN,NaN,NaN,102.68465432335456,26.318785025564907,7772371,-28.77923389149403,74.92900662941611,103.70824052091014
2024-11-13T14:00:00-05:00,21257.75,21258.25,21124,21166,20980.31959067337,NaN,NaN,NaN,NaN,NaN,20844.97,21724.105044461285,19965.834955538718,21035.848877976085,21180.377934142056,21197.073848657194,21163.68201962692,259435,184974.93333333332,55.32919742955031,61.69745439373809,NaN,NaN,NaN,NaN,104.93932187168639,25.321309762862647,7512936,-28.30401117255593,68.32822655521522,96.63223772777116
2024-11-13T18:00:00-05:00,21166,21175.5,21115.75,21120.25,20980.31959067337,NaN,NaN,NaN,NaN,NaN,20864.225,21724.253216107045,20004.196783892952,21035.848877976085,21137.166666666668,21137.166666666668,21137.166666666668,41243,184341.1,51.42755199735185,60.65034787518821,NaN,NaN,NaN,NaN,101.71151316656594,24.495852724837448,7471693,-30.323043528643808,58.7284333169664,89.05147684561021
2024-11-13T22:00:00-05:00,21120.25,21151.5,21099.5,21101.25,20980.31959067337,NaN,NaN,NaN,NaN,NaN,20882.86,21721.992004871707,20043.727995128294,21022.686424268162,21127.856928778947,21137.715737213624,21117.99812034427,36777,184187.4,49.855195433440834,59.376539622160294,NaN,NaN,NaN,NaN,98.1606907975255,23.932726934116346,7434916,-32.023350774567845,49.0222883774004,81.04563915196825
2024-11-14T02:00:00-05:00,21100.75,21191.25,21089.75,21162.5,20980.31959067337,NaN,NaN,NaN,NaN,NaN,20901.875,21722.192641222002,20081.557358777998,21022.686424268162,21137.132912587364,21149.43414475321,21124.831680421517,67634,184316.7,54.66698839914539,58.485146994543854,NaN,NaN,NaN,NaN,98.39921288341654,22.743332292404947,7502550,-28.240399165270304,45.74514019538037,73.98553936065068
2024-11-14T06:00:00-05:00,21162.75,21184,21064.25,21092,20980.31959067337,NaN,NaN,NaN,NaN,NaN,20918.955,21718.572112685553,20119.33788731445,21022.686424268162,21121.290673307427,21134.518734391582,21108.06261222327,293051,185850.4,48.855801544825205,57.16558894367098,NaN,NaN,NaN,NaN,99.92426910602964,21.98582236498863,7209499,-29.56256733412617,37.03233019299296,66.59489752711913
2024-11-14T10:00:00-05:00,21091.75,21140.5,21016.75,21027.25,20980.31959067337,NaN,NaN,NaN,NaN,NaN,20935.525,21708.656212990205,20162.393787009798,21022.686424268162,21087.22744434157,21118.076317870924,21056.378570812216,580847,192618.73333333334,44.20772573140669,55.84874429642876,NaN,NaN,NaN,NaN,101.62610702702752,21.879200416723478,6628652,-33.58088479933116,24.61879152795518,58.19967632728634
2024-11-14T14:00:00-05:00,21026.75,21090.5,20950.5,20981.75,NaN,NaN,NaN,21336.14319365907,21336.14319365907,21336.14319365907,20952.53,21690.7912250418,20214.268774958196,21022.686424268162,21068.90413537431,21111.989064450227,21025.81920629839,304653,194453.7,41.23867211675493,54.02839916832476,NaN,NaN,NaN,NaN,104.36709938223984,22.4899588862388,6323999,-37.77342191125422,10.982898938218568,48.756320849472786
2024-11-14T18:00:00-05:00,20980,20981,20883.5,20914.5,NaN,NaN,NaN,21246.943503038205,NaN,NaN,20967.83,21669.69922172128,20265.960778278724,21022.686424268162,20926.333333333332,20926.333333333332,20926.333333333332,69582,195514.4,37.25594106413411,52.33345655332255,NaN,NaN,NaN,NaN,103.93016371207986,23.65245687650044,6254417,-43.15731771801711,-5.190326298048603,37.96699141996851
2024-11-14T22:00:00-05:00,20914.75,20929.25,20831.25,20869,NaN,NaN,NaN,21194.002889263742,NaN,NaN,20982.91,21641.9294591969,20323.8905408031,20986.47413941453,20902.487626378075,20927.381266589113,20877.593986167038,63847,196622,34.80663984605003,50.47305844945155,NaN,NaN,NaN,NaN,103.50658058978844,25.13178967333732,6190570,-47.5193029146576,-21.432137223353493,26.087165691304108
2024-11-15T02:00:00-05:00,20869,20875.25,20794,20827.75,NaN,NaN,NaN,21145.195939751753,NaN,NaN,20997.4,21608.53716954532,20386.26283045468,20965.304311531625,20874.04749946895,20913.478826729373,20834.616172208527,90970,197191.13333333333,32.707273446495435,48.69633875315094,NaN,NaN,NaN,NaN,101.91682483337499,26.766098697905687,6099600,-50.63258069198637,-37.20356017367885,13.429020518307516
2024-11-15T06:00:00-05:00,20827.5,20866.75,20679.25,20690,NaN,NaN,NaN,21095.02226067213,NaN,NaN,21008.835,21573.363835490385,20444.306164509613,20950.591807504192,20798.52331489332,20866.78493985082,20730.261689935818,318623,199710,26.877327107150506,46.74400730164998,NaN,NaN,NaN,NaN,108.0299087738482,28.947258857825766,5780977,-58.84299234993348,-60.12471991910934,-1.281727569175855
2024-11-15T10:00:00-05:00,20689.75,20698,20405.25,20428.75,NaN,NaN,NaN,20898.930339732487,NaN,NaN,21014.55,21548.87988873922,20480.22011126078,20950.591807504192,20636.139151885563,20785.82488015765,20486.45342361348,702769,208904.93333333332,19.703959386418077,44.07549869707402,NaN,NaN,NaN,NaN,121.22420100428761,31.932844453654592,5078208,-77.56515182938462,-98.23816735590663,-20.673015526522008
2024-11-15T14:00:00-05:00,20429.25,20521.75,20419.5,20503.75,NaN,NaN,NaN,20816.08691519919,NaN,NaN,21018.82,21532.96004940296,20504.67995059704,20950.591807504192,20609.836646581596,20758.032130281146,20461.641162882046,255656,212212.16666666666,25.82446567388793,41.935886748795895,NaN,NaN,NaN,NaN,119.86890093255279,34.70517393549565,5333864,-80.25894853062002,-120.99670118979702,-40.73775265917701
2024-11-17T18:00:00-05:00,20504.75,20630.75,20476.25,20628,NaN,NaN,NaN,20816.08691519919,NaN,NaN,21025.2,21511.089740578987,20539.310259421014,20931.598446003354,20578.333333333332,20578.333333333332,20578.333333333332,82179,212877.1,34.704169580935684,39.818636339824764,NaN,NaN,NaN,NaN,122.34255086594189,35.73259200586177,5416043,-69.43931836765566,-127.53690061874659,-58.09758225109093
2024-11-17T22:00:00-05:00,20628.5,20657.75,20619.25,20648.25,NaN,NaN,NaN,20816.08691519919,NaN,NaN,21030.845,21491.892837973275,20569.797162026727,20876.703756802683,20601.159322621348,20631.59815254302,20570.720492699675,46213,213553.16666666666,36.04788113856575,38.44139946189729,NaN,NaN,NaN,NaN,116.35379723266033,36.33810420681148,5462256,-57.19568772087294,-129.5921919021821,-72.39650418130915
2024-11-18T02:00:00-05:00,20648.5,20649.5,20544.75,20588.5,NaN,NaN,NaN,20816.08691519919,NaN,NaN,21030.84,21491.907020724786,20569.772979275214,20809.463005442147,20597.957456901055,20620.51917670008,20575.39573710203,110883,215313.73333333334,33.83535262853317,37.184813792695955,NaN,NaN,NaN,NaN,115.52495457318459,37.25355745216643,5351373,-49.6764050720498,-134.4920105213714,-84.81560544932161
2024-11-18T06:00:00-05:00,20588.25,20589.75,20481.75,20530.75,NaN,NaN,NaN,20816.08691519919,NaN,NaN,21028.515,21498.389157727484,20558.640842272514,20707.045404353717,20563.45329308695,20598.77245970536,20528.13412646854,281103,216233.16666666666,31.803541303773727,35.89540992629117,NaN,NaN,NaN,NaN,114.98745781795711,38.37486736067941,5070270,-45.27156754069833,-141.4050648751945,-96.13349733449618
2024-11-18T10:00:00-05:00,20530.75,20724.5,20522.25,20660.5,NaN,NaN,NaN,20816.08691519919,NaN,NaN,21028.03,21499.370255441845,20556.689744558153,20661.086323482974,20599.94301084633,20643.811206876835,20556.074814815827,530300,217227.43333333332,40.455151182953635,34.88027869656319,NaN,NaN,NaN,NaN,121.22049654524588,37.81247415777641,5600570,-30.980717708458798,-134.85939447006967,-103.87867676161088
2024-11-18T14:00:00-05:00,20660,20660.5,20590.5,20630.75,NaN,NaN,NaN,20816.08691519919,NaN,NaN,21027.12,21501.340309982876,20552.899690017122,20620.094058786377,20604.14897224014,20645.684161021785,20562.61378345849,191295,218352.36666666667,39.22636187962356,34.192461577620215,NaN,NaN,NaN,NaN,117.5618896491569,37.2902518979379,5409275,-21.350962909125002,-130.56738039801712,-109.21641748889212
2024-11-18T18:00:00-05:00,20634.25,20659.5,20603.5,20656,NaN,NaN,NaN,20816.08691519919,NaN,NaN,21023.02,21506.371216404623,20539.668783595378,20568.875247029104,20639.666666666668,20639.666910807293,20639.666422526043,48602,218313.4,40.86802879594257,33.95391179651563,NaN,NaN,NaN,NaN,113.16461181707426,36.80533122808786,5457877,-11.588865161702444,-123.70249894102017,-112.11363377931772
2024-11-18T22:00:00-05:00,20656.5,20696.75,20653.75,20677,NaN,NaN,NaN,20816.08691519919,NaN,NaN,21018.075,21510.343760434575,20525.806239565427,20457.939059126147,20656.062867651195,20674.06732623341,20638.05840906898,40307,218511.53333333333,42.26488732541275,34.02721288284833,NaN,NaN,NaN,NaN,108.15285383014039,35.905433008819074,5498184,-2.5003744166810264,-115.23910180016901,-112.73872738348798
2024-11-19T02:00:00-05:00,20677.25,20688.5,20491.75,20579.25,NaN,NaN,NaN,20816.08691519919,NaN,NaN,21011.46,21518.041161908088,20504.87883809191,20457.939059126147,20611.182192229106,20646.150343596903,20576.21404086131,161667,220936.86666666667,37.78993542332777,34.06535533707646,NaN,NaN,NaN,NaN,114.48122141370179,36.06744987055156,5336517,-1.8831699129822823,-115.09268977471584,-113.20951986173355
2024-11-19T06:00:00-05:00,20579,20623.5,20382,20554.5,NaN,NaN,NaN,20816.08691519919,NaN,NaN,21003.555,21525.83353000101,20481.27646999899,20457.939059126147,20557.368066492978,20607.488353265235,20507.24777972072,360857,224654.66666666666,36.72954137295777,34.202705446141294,NaN,NaN,NaN,NaN,123.55399131272308,36.74126091672257,4975660,-1.944976805373102,-115.64074086844994,-113.69576406307684
2024-11-19T10:00:00-05:00,20554.25,20792.5,20524,20784.5,NaN,NaN,NaN,20816.08691519919,NaN,NaN,21000.335,21525.97990495044,20474.69009504956,20457.939059126147,20619.794153561903,20700.06183090443,20539.526476219376,473923,220733.56666666668,50.60161036378515,35.480872368804846,NaN,NaN,NaN,NaN,133.9072776475286,35.659910938835374,5449583,13.832847986351155,-96.40470408013789,-110.23755206648904
2024-11-19T14:00:00-05:00,20784.75,20792,20709.25,20754.75,NaN,NaN,NaN,20816.08691519919,NaN,NaN,20993.245,21522.373958667,20464.116041332996,20457.939059126147,20638.899654239245,20726.493341995218,20551.305966483273,183344,221133.56666666668,49.10198383728074,37.068347849528436,NaN,NaN,NaN,NaN,130.25318638699085,34.65580024508297,5266239,22.10338137051943,-82.60832535333975,-104.71170672385918
2024-11-19T18:00:00-05:00,20766,20834.75,20750,20809.75,20426.889549285122,20426.889549285122,20426.889549285122,NaN,NaN,NaN,20985.705,21514.333552860797,20457.076447139207,20492.983030894455,20798.166666666668,20798.166666666668,20798.166666666668,63755,221903.8,51.937829296942844,39.37076712885163,NaN,NaN,NaN,NaN,127.00295878792008,33.32411247117384,5329994,30.593103845776596,-66.47032691663844,-97.06343076241504
2024-11-19T22:00:00-05:00,20809.75,20840,20772.75,20830.75,20448.33206977216,NaN,NaN,NaN,NaN,NaN,20977.825,21503.704503783727,20451.945496216274,20532.961424715566,20804.73516596181,20812.74393025595,20796.72640166767,42886,222108.63333333333,53.014267239981876,41.312895812144056,NaN,NaN,NaN,NaN,122.73489030306864,32.037468577390435,5372880,36.53563607436229,-51.39388566946218,-87.92952174382447
2024-11-20T02:00:00-05:00,20831,20843.5,20753,20782,20448.33206977216,NaN,NaN,NaN,NaN,NaN,20969.08,21493.148950043567,20445.011049956436,20552.61913977245,20799.241222047203,20807.592114767987,20790.89032932642,91431,223360.46666666667,50.2032870917524,42.41997563434525,NaN,NaN,NaN,NaN,120.43239813856373,30.987287255792534,5281449,36.03556728832601,-42.885062633416965,-78.92062992174297
2024-11-20T06:00:00-05:00,20781.5,20829.5,20612.75,20614.25,20448.33206977216,NaN,NaN,NaN,NaN,NaN,20956.74,21484.5779103471,20428.902089652904,20552.61913977245,20732.314572692376,20788.544863489315,20676.084281895437,283166,222513.7,41.95884721036011,42.84218749661628,NaN,NaN,NaN,NaN,127.31222684295203,30.924482112079783,4998283,23.84718109093876,-49.11165355806952,-72.95883464900828
2024-11-20T10:00:00-05:00,20614,20709,20477.25,20590,20448.33206977216,NaN,NaN,NaN,NaN,NaN,20945.655,21480.50863315608,20410.801366843916,20552.61913977245,20649.214750479096,20726.904993070275,20571.524507887916,699979,225899.23333333334,40.91286853738392,43.34772434724847,NaN,NaN,NaN,NaN,134.77206778274117,31.557595002282806,4298304,14.075201533609018,-55.36483273199701,-69.44003426560603
2024-11-20T14:00:00-05:00,20589,20786.5,20558.25,20739.25,20448.33206977216,NaN,NaN,NaN,NaN,NaN,20936.27,21468.808579259876,20403.731420740125,20552.61913977245,20657.798747082386,20729.99527466573,20585.602219499044,275024,226418.86666666667,49.291404596049524,44.59685743955389,NaN,NaN,NaN,NaN,141.4490629411168,31.360637356705183,4573328,17.370326601470666,-47.7271260137677,-65.09745261523837
2024-11-20T18:00:00-05:00,20739.25,20763,20620,20648.25,20448.33206977216,NaN,NaN,NaN,NaN,NaN,20924.23,21455.04753776623,20393.41246223377,20552.61913977245,20677.083333333332,20677.083333333332,20677.083333333332,96931,228275.13333333333,45.092895525917925,44.92812489262276,NaN,NaN,NaN,NaN,141.55984415960845,31.177748114383107,4476397,13.311139575351092,-48.4585281460495,-61.769667721400594
2024-11-20T22:00:00-05:00,20648,20704.5,20638,20689.25,20448.33206977216,NaN,NaN,NaN,NaN,NaN,20913.47,21441.083216665313,20385.85678333469,20552.61913977245,20677.142196115852,20677.22185520251,20677.062537029193,52926,228813.43333333332,47.2720688848825,45.50281825014126,NaN,NaN,NaN,NaN,136.19842671963642,31.007922389369746,4529323,13.248794341093024,-45.20867479503431,-58.45746913612734
2024-11-21T02:00:00-05:00,20689.75,20725,20595.75,20680,20448.33206977216,NaN,NaN,NaN,NaN,NaN,20901.665,21423.196951178328,20380.133048821674,20552.61913977245,20671.860631817697,20676.970909497148,20666.750354138247,160090,231895.3,46.82058460789871,45.92800080813812,NaN,NaN,NaN,NaN,135.70211052537667,31.108590099743267,4369233,12.457826061384296,-42.88518655939697,-55.343012620781266
2024-11-21T06:00:00-05:00,20679.75,20907,20628.25,20667.25,20448.33206977216,NaN,NaN,NaN,NaN,NaN,20889.245,21402.87788923143,20375.61211076857,20552.61913977245,20709.75433712404,20740.337106783125,20679.171567464953,481111,238163.96666666667,46.16607784907807,46.206657274114214,NaN,NaN,NaN,NaN,145.91981691642118,29.39812711439962,3888122,10.999879107882535,-41.5931637359281,-52.593042843810636
2024-11-21T10:00:00-05:00,20669.25,20866.5,20514,20857.5,20448.33206977216,NaN,NaN,NaN,NaN,NaN,20880.96,21382.876321312757,20379.04367868724,20552.61913977245,20727.441474004187,20755.851736674234,20699.03121133414,753915,243932.9,56.04082531315951,47.51029226624506,NaN,NaN,NaN,NaN,160.67554427953397,28.567200899999207,4642037,22.130225637068463,-24.930260797475057,-47.06048643454352
2024-11-21T14:00:00-05:00,20857,20878.75,20790.25,20794,20448.33206977216,NaN,NaN,NaN,NaN,NaN,20873.405,21368.91679491535,20377.89320508465,20552.61913977245,20737.745251025914,20777.44524107446,20698.045260977367,191209,240151.43333333332,52.574428480347954,48.642069916772925,NaN,NaN,NaN,NaN,155.52014825956726,27.686137922087312,4450828,24.32302803390435,-16.656701392163086,-40.979729426067436
2024-11-21T18:00:00-05:00,20804,20825.75,20758.75,20820.25,20448.33206977216,NaN,NaN,NaN,NaN,NaN,20866.22,21354.12977280609,20378.310227193913,20488.42031181796,20801.583333333332,20801.583577473957,20801.583089192707,61406,239878.9,53.84538061936932,48.8737677921718,NaN,NaN,NaN,NaN,149.19728052674103,27.076173840513164,4512234,26.471198819213498,-7.890730902050564,-34.36192972126406
2024-11-21T22:00:00-05:00,20819.75,20844.75,20760,20801.25,20448.33206977216,NaN,NaN,NaN,NaN,NaN,20858.025,21336.162158668605,20379.887841331398,20483.909486221208,20801.810184257836,20802.017693161517,20801.602675354156,73387,240196.9,52.74359940328659,49.13388318974364,NaN,NaN,NaN,NaN,144.59390334625954,26.32170100035897,4438847,25.530702208395496,-2.4485519607696915,-27.979254169165188
2024-11-22T02:00:00-05:00,20801,20831.25,20693,20741.75,20448.33206977216,NaN,NaN,NaN,NaN,NaN,20848.74,21317.424285633446,20380.055714366557,20483.909486221208,20779.57004678598,20802.787503448217,20756.35259012374,123689,241287.53333333333,49.33885857242384,48.948242423706574,NaN,NaN,NaN,NaN,144.1407673929553,26.0828384639948,4315158,20.060786078274578,-2.903271571321966,-22.964057649596544
2024-11-22T06:00:00-05:00,20741.75,20873.25,20720.75,20856,20448.33206977216,NaN,NaN,NaN,NaN,NaN,20841.675,21298.919051355708,20384.43094864429,20510.638960355973,20799.85036159256,20824.04534820904,20775.655374976075,311727,241057.66666666666,55.3050438572981,49.11186932494344,NaN,NaN,NaN,NaN,144.73785543631564,25.424702207531368,4626885,23.081256084005727,5.887512455410615,-17.19374362859511
2024-11-22T10:00:00-05:00,20853.75,20880.5,20722,20846.75,20448.33206977216,NaN,NaN,NaN,NaN,NaN,20835.235,21282.839785608965,20387.630214391036,20511.161168284776,20808.941635844672,20827.165245439857,20790.718026249488,693499,240748.66666666666,54.7429354831103,49.436129924326146,NaN,NaN,NaN,NaN,145.7208657622931,24.737196533842045,3933386,23.330909271829178,11.969892961191363,-11.361016310637815
2024-11-22T14:00:00-05:00,20847,20879.75,20795.25,20878.5,20448.33206977216,NaN,NaN,NaN,NaN,NaN,20828.105,21261.130958690756,20395.079041309244,20542.028934627822,20814.4554325085,20836.617386527585,20792.293478489417,189801,238553.5,56.38167882645318,50.4663321826185,NaN,NaN,NaN,NaN,141.34794677927218,24.09879840827339,4123187,24.394129280131217,19.131645289526205,-5.262483990605011
2024-11-24T18:00:00-05:00,20909,20968,20908,20959.75,20534.370399246003,NaN,NaN,NaN,NaN,NaN,20823.66,21246.506955292374,20400.813044707626,20653.073147702256,20945.25,20945.25,20945.25,52688,237570.46666666667,60.33942459793989,51.853943329801076,NaN,NaN,NaN,NaN,137.64452200932416,22.559826199776566,4175875,29.014916664294475,31.00616183976308,1.9912451754686078
2024-11-24T22:00:00-05:00,20959.25,20974,20951.5,20959.5,20574.399017462096,NaN,NaN,NaN,NaN,NaN,20819.235,21231.54115336177,20406.92884663823,20710.808518161808,20950.834475043102,20958.612142029768,20943.056808056437,27163,236935.46666666667,60.321288206627024,52.64179215912804,NaN,NaN,NaN,NaN,129.41991329437244,21.069937395439624,4148712,30.356018582620457,39.93626840374418,9.580249821123722
2024-11-25T02:00:00-05:00,20959,20981.25,20931.5,20979.5,20578.892243941093,NaN,NaN,NaN,NaN,NaN,20815.815,21219.826693023962,20411.803306976035,20745.821814529445,20955.85594966832,20964.737305216957,20946.97459411968,48736,234863.9,61.32285247101669,53.80107479806367,NaN,NaN,NaN,NaN,123.72920520191725,19.88975819116663,4197448,30.79429459596251,48.07311806607686,17.27882347011435
2024-11-25T06:00:00-05:00,20979.25,21081.25,20918,20944.25,20617.039187398314,NaN,NaN,NaN,NaN,NaN,20812.34,21208.813867486937,20415.866132513063,20811.282451623556,20974.910206848737,20986.687722070346,20963.13269162713,391616,238547.66666666666,58.519142911537415,54.60443722853902,NaN,NaN,NaN,NaN,126.55211911606602,19.151440366375798,3805832,27.047609317515466,51.08833511700868,24.040725799493217
2024-11-25T10:00:00-05:00,20944.75,20962.25,20780.25,20851.5,20617.039187398314,NaN,NaN,NaN,NaN,NaN,20806.325,21190.93698954262,20421.71301045738,20811.282451623556,20915.30852708113,20970.824814767824,20859.79223939444,612240,241279,51.807309163202525,54.96063183963214,NaN,NaN,NaN,NaN,130.51268203634703,18.405744603484194,3193592,17.14311616863032,45.46962101028112,28.326504841650795
2024-11-25T14:00:00-05:00,20851.5,20918.25,20825.5,20901.5,20617.039187398314,NaN,NaN,NaN,NaN,NaN,20801.545,21175.210380922894,20427.879619077103,20811.282451623556,20910.778317919037,20963.66973807797,20857.886897760105,176731,240793.53333333333,54.815942289538015,55.578479299665,NaN,NaN,NaN,NaN,127.81534760517938,17.71331282365628,3370323,12.96913712090739,44.53792624278503,31.568789121877643
2024-11-25T18:00:00-05:00,20910,20934.25,20755.25,20871,20617.039187398314,NaN,NaN,NaN,NaN,NaN,20793.825,21144.792523426124,20442.857476573878,20811.282451623556,20853.5,20853.5,20853.5,128066,243442.33333333334,52.65643808614344,55.33673735487814,NaN,NaN,NaN,NaN,131.47139420480943,17.6556184915001,3242257,7.438858947934229,40.86736280679543,33.4285038588612
2024-11-25T22:00:00-05:00,20871.5,20924.5,20864.5,20906.75,20617.039187398314,NaN,NaN,NaN,NaN,NaN,20788.64,21124.80914135608,20452.47085864392,20811.282451623556,20866.69127719748,20887.20217559027,20846.180378804685,52971,243864.46666666667,54.89924492996016,55.50279567270758,NaN,NaN,NaN,NaN,126.36629461875161,17.602045183069357,3295228,5.559350642962983,40.37769216256493,34.818341519601944
2024-11-26T02:00:00-05:00,20906.5,20909.25,20851.5,20894,20617.039187398314,NaN,NaN,NaN,NaN,NaN,20784.115,21108.180783598993,20460.04921640101,20811.282451623556,20872.249783092753,20891.29706165153,20853.202504533976,79443,241123.66666666666,53.918208312639294,55.507997650798295,NaN,NaN,NaN,NaN,121.46513071741221,17.664474216747937,3215785,2.9587735153660333,38.516808413809486,35.55803489844345
2024-11-26T06:00:00-05:00,20894.25,21025,20880.25,20971.5,20617.039187398314,NaN,NaN,NaN,NaN,NaN,20781.52,21097.359798632067,20465.680201367933,20811.282451623556,20918.564120507745,20963.706367158713,20873.421873856776,298964,239060.56666666668,58.74413524643127,55.936607353880056,NaN,NaN,NaN,NaN,123.12833566616848,16.424107419255773,3514749,5.79537148565332,42.802249255510105,37.006877769856786
2024-11-26T10:00:00-05:00,20971.5,20999.75,20919,20970,20617.039187398314,NaN,NaN,NaN,NaN,NaN,20777.67,21079.209059493467,20476.13094050653,20811.282451623556,20939.650714403593,20979.142198443005,20900.15923036418,507040,240164.46666666667,58.61618439783487,56.59927348426656,NaN,NaN,NaN,NaN,120.10131169001359,15.272338250155906,3007709,6.836382053356864,45.552355336552864,38.715973283196
2024-11-26T14:00:00-05:00,20968.75,21008.5,20903.75,21001,20617.039187398314,NaN,NaN,NaN,NaN,NaN,20775.85,21070.804894857,20480.895105142998,20811.282451623556,20944.997335687545,20982.862471304907,20907.132200070184,218588,241339.26666666666,60.52958315115419,56.97245486239914,NaN,NaN,NaN,NaN,119.00478942644119,14.3659591869635,3226297,8.755874305798379,49.660816165443975,40.9049418596456
2024-11-26T18:00:00-05:00,20998.25,21019.25,20968.75,21005.25,20636.84522642837,NaN,NaN,NaN,NaN,NaN,20775.41,21068.92560026671,20481.89439973329,20811.282451623556,20997.75,20997.75,20997.75,42196,240620.63333333333,60.79719419204823,57.40490191303756,NaN,NaN,NaN,NaN,114.11159018169539,13.399087121991935,3268493,9.398279987731385,52.65279184430983,43.254511856578446
2024-11-26T22:00:00-05:00,21005.75,21006.75,20952,20970,20636.84522642837,NaN,NaN,NaN,NaN,NaN,20775.175,21068.04751919564,20482.30248080436,20790.260817650546,20987.31007851169,20998.055605549966,20976.564551473417,39830,240518.76666666666,57.325548409500165,57.472321168969486,NaN,NaN,NaN,NaN,109.87147659728858,12.698765234089763,3228663,6.664338279213652,51.584934705595515,44.92059642638186
2024-11-27T02:00:00-05:00,20970.25,20990,20904.5,20935.5,20636.84522642837,NaN,NaN,NaN,NaN,NaN,20775.595,21069.324499539423,20481.86550046058,20790.260817650546,20964.787866622257,20988.015760621303,20941.55997262321,86108,240341.33333333334,54.0712106821533,57.02459160355617,NaN,NaN,NaN,NaN,108.1306568403394,12.588768723070384,3142555,1.990159051932359,47.40829524129731,45.41813618936495
2024-11-27T06:00:00-05:00,20935,20971,20839.25,20859.25,20636.84522642837,NaN,NaN,NaN,NaN,NaN,20775.4,21068.894054453838,20481.905945546165,20790.260817650546,20920.1498045442,20959.79184624512,20880.507762843277,247561,239154.5,47.63479427690717,56.11841346571903,NaN,NaN,NaN,NaN,109.81775278031515,13.146605452680415,2894994,-6.324018704088459,37.51311280925438,43.83713151334284
2024-11-27T10:00:00-05:00,20859.5,20861.5,20675,20810.5,20636.84522642837,NaN,NaN,NaN,NaN,NaN,20775.055,21068.34257713212,20481.76742286788,20790.260817650546,20838.082110870968,20910.268431411845,20765.89579033009,611944,236220,44.026425461008245,54.88295439357557,NaN,NaN,NaN,NaN,115.29505615314977,14.915081264374704,2283050,-14.714434610105073,25.444088250711502,40.158522860816575
2024-11-27T14:00:00-05:00,20810.5,20830,20769.25,20806.5,20636.84522642837,NaN,NaN,NaN,NaN,NaN,20777.385,21069.782404400652,20484.987595599345,20790.260817650546,20832.254394335545,20899.693132135115,20764.815656535975,197404,233632.66666666666,43.733691694528304,53.826850735217775,NaN,NaN,NaN,NaN,111.39898071363908,16.557237375233687,2085646,-19.823418016522297,15.379250340163708,35.202668356686004
2024-11-27T18:00:00-05:00,20814.75,20854.5,20806.5,20848.5,20636.84522642837,NaN,NaN,NaN,NaN,NaN,20785.78,21061.2708644586,20510.2891355414,20790.260817650546,20836.5,20836.5,20836.5,27477,231317.53333333333,47.668272325062475,53.53120524677921,NaN,NaN,NaN,NaN,106.8704820912363,17.721060135350733,2113123,-19.627047636606232,10.668858810928214,30.295906447534446
2024-11-27T22:00:00-05:00,20848.75,20864.5,20842.75,20863.5,20636.84522642837,NaN,NaN,NaN,NaN,NaN,20792.975,21057.1872300357,20528.762769964298,20790.260817650546,20844.079982990865,20853.94415268841,20834.21581329332,16225,230094.16666666666,49.03888763679214,53.11855848586878,NaN,NaN,NaN,NaN,100.79044765614799,18.65129590352565,2129348,-17.794021256368442,8.053379877073894,25.847401133442336
2024-11-28T02:00:00-05:00,20863,20870,20843.5,20858.25,20636.84522642837,NaN,NaN,NaN,NaN,NaN,20797.58,21058.130963152566,20537.029036847438,20790.260817650546,20849.057613930207,20859.122658213022,20838.99256964739,26553,225642.93333333332,48.55951026252181,52.82592078418152,NaN,NaN,NaN,NaN,95.48398710928028,19.42819850366852,2102795,-16.283012392714163,5.493635642549634,21.776648035263797
2024-11-28T06:00:00-05:00,20859,20896.25,20848.75,20888.5,20636.84522642837,NaN,NaN,NaN,NaN,NaN,20802.385,21060.593853644506,20544.17614635549,20790.260817650546,20861.073082907067,20877.20958949534,20844.936576318793,50366,211284.76666666666,51.50133927511308,52.58321323740673,NaN,NaN,NaN,NaN,92.0565594586174,19.727364126208823,2153161,-12.75040810691275,5.83863790162286,18.58904600853561
2024-11-28T10:00:00-05:00,20888.25,20909.5,20878.25,20889.5,20636.84522642837,NaN,NaN,NaN,NaN,NaN,20808.405,21060.345923432844,20556.464076567154,20790.260817650546,20871.28496198296,20891.067430608622,20851.5024933573,58290,188097.26666666666,51.59988052582426,52.41761839549138,NaN,NaN,NaN,NaN,87.71323378300187,19.79141130131592,2211451,-9.973497836780695,6.122173712559743,16.095671549340437
2024-11-28T18:00:00-05:00,20887,20901.75,20822.25,20900.75,20636.84522642837,NaN,NaN,NaN,NaN,NaN,20815.805,21056.158932565864,20575.451067434136,20774.05865412044,20872.079805186015,20889.628310229295,20854.531300142735,50128,183394.56666666668,52.76269555712337,51.99037270339795,NaN,NaN,NaN,NaN,87.12657422707316,20.41358767886666,2261579,-7.138949487299509,7.17198469021605,14.31093417751556
2024-11-28T22:00:00-05:00,20900.75,20937.75,20890.75,20906.25,20636.84522642837,NaN,NaN,NaN,NaN,NaN,20820.72,21058.203128663677,20583.236871336325,20790.964852587826,20878.700002120055,20900.472378341852,20856.927625898257,46111,182884.73333333334,53.35274062829547,51.614412434145144,NaN,NaN,NaN,NaN,84.2603903537108,20.401203594625088,2307690,-4.767546871673639,8.35150058792351,13.11904745959715
2024-11-29T02:00:00-05:00,20906,20910,20865.5,20895.5,20636.84522642837,NaN,NaN,NaN,NaN,NaN,20826.015,21058.063193485705,20593.966806514294,20790.964852587826,20880.644993916245,20900.982775248573,20860.307212583917,55238,182279.76666666666,51.98590544110504,51.004149740570206,NaN,NaN,NaN,NaN,81.42036247130288,20.65355799528824,2252452,-3.8369187064150605,8.322899076578324,12.159817782993384
2024-11-29T06:00:00-05:00,20895,20919,20805.75,20915.5,20636.84522642837,NaN,NaN,NaN,NaN,NaN,20831.205,21059.38654373169,20603.023456268314,20790.964852587826,20880.423987518065,20896.265207377965,20864.582767658165,214346,185301.66666666666,54.3301104697415,50.54221518897687,NaN,NaN,NaN,NaN,83.69390800906696,21.461447819540776,2466798,-1.8869868441649356,9.801084227787214,11.68807107195215
2024-11-29T10:00:00-05:00,20915.5,21018,20905.25,20991.5,20675.43116558592,NaN,NaN,NaN,NaN,NaN,20837.495,21065.665517158086,20609.324482841912,20826.931004524966,20914.33672744754,20960.151334462473,20868.522120432604,322699,185667.4,61.93540945887102,50.87149097821764,NaN,NaN,NaN,NaN,85.76934315127646,20.7175387307476,2789497,4.17769617633917,16.910191292376112,12.732495116036942
2024-12-01T18:00:00-05:00,20994.5,21003.5,20941.75,20953.5,20691.01952169565,NaN,NaN,NaN,NaN,NaN,20844.98,21063.106152489687,20626.853847510312,20826.931004524966,20966.25,20966.25,20966.25,71257,164926,56.838750854092034,51.069172419070405,NaN,NaN,NaN,NaN,84.05367578332813,20.026766005439647,2718240,5.2187693116518865,19.2559567556018,14.037187443949914
2024-12-01T22:00:00-05:00,20953.75,20966.75,20939.75,20953,20691.01952169565,NaN,NaN,NaN,NaN,NaN,20852.95,21056.685392114123,20649.21460788588,20826.931004524966,20961.882569206173,20968.05234239917,20955.712796013177,35706,159789.5,56.77255115246433,51.72186933875306,NaN,NaN,NaN,NaN,79.97841322737612,19.408843408803214,2682534,5.437834082632472,20.834480047240504,15.396645964608032
2024-12-02T02:00:00-05:00,20953.25,20973.75,20940,20949.5,20692.1714546855,NaN,NaN,NaN,NaN,NaN,20856.25,21060.78720932884,20651.71279067116,20828.487674316784,20959.730830444147,20965.93806882227,20953.523592066023,43310,159476.9,56.278426889066495,52.59701229790007,NaN,NaN,NaN,NaN,76.67638371113496,18.72563603135458,2639224,4.9263492832244395,21.55458256863858,16.62823328541414
2024-12-02T06:00:00-05:00,20949.75,21170.5,20947.5,21150,20775.919343108886,NaN,NaN,NaN,NaN,NaN,20864.155,21082.47691575793,20645.83308424207,20942.790139453427,21043.430257730743,21105.52460339277,20981.335912068716,274007,167705.03333333333,71.55291251229669,54.58409949916925,NaN,NaN,NaN,NaN,87.12807058891103,18.991302951918975,2913231,16.991358316860886,37.86743118149025,20.87607286462936
2024-12-02T10:00:00-05:00,21151.75,21259.5,21141,21212.5,20913.877554785755,NaN,NaN,NaN,NaN,NaN,20872.21,21110.6962125998,20633.7237874002,21018.08211156274,21130.647794548597,21221.15962786555,21040.135961231645,502197,182820.4,74.5389634912492,56.503434582468294,NaN,NaN,NaN,NaN,89.3689226897031,19.931894952194067,3415428,27.461037978405503,55.20237033763624,27.741332359230736
2024-12-02T14:00:00-05:00,21212.5,21240.75,21176.25,21211,20926.34902956822,NaN,NaN,NaN,NaN,NaN,20879.815,21136.113864804694,20623.516135195303,21018.08211156274,21143.621000640596,21231.33746709531,21055.904534185884,182909,175863.5,74.33728386707804,58.31046288463158,NaN,NaN,NaN,NaN,87.59257106901002,20.80530180959237,3232519,32.23503844332822,68.03513041339102,35.800091970062795
2024-12-02T18:00:00-05:00,21215,21226.75,21203.5,21218.75,20942.628619133302,NaN,NaN,NaN,NaN,NaN,20888.55,21160.22745581867,20616.87254418133,21034.817551400156,21216.333333333332,21216.333333333332,21216.333333333332,28578,156408.1,74.71789978686746,60.17891927922769,NaN,NaN,NaN,NaN,82.99667313550931,21.61632246289079,3261097,33.70567975563881,77.93219166461131,44.2265119089725
2024-12-02T22:00:00-05:00,21218.25,21240.5,21217.75,21227.75,20965.912545536332,NaN,NaN,NaN,NaN,NaN,20900.82,21177.210521545323,20624.429478454676,21075.579041120123,21221.69315896036,21227.80681459498,21215.57950332574,21965,151249.23333333334,75.17830606366101,61.8701311926954,NaN,NaN,NaN,NaN,78.6933393401158,22.48377217528015,3283062,33.03169611773556,85.51613205614194,52.484435938406385
2024-12-03T02:00:00-05:00,21227,21243.75,21201.75,21202.75,20965.912545536332,NaN,NaN,NaN,NaN,NaN,20913.075,21187.58400258439,20638.56599741561,21090.8132328961,21219.159977972613,21224.479053795607,21213.84090214962,41615,148367.53333333333,71.29442568981864,63.276884418695,NaN,NaN,NaN,NaN,76.07238653010752,23.014816462456245,3241447,28.803747958455354,88.48912088647558,59.68537292802022
2024-12-03T06:00:00-05:00,21202.75,21225.75,21134.75,21204,20965.912545536332,NaN,NaN,NaN,NaN,NaN,20922.37,21204.08507307923,20640.654926920768,21090.8132328961,21196.173129463365,21210.006138195808,21182.34012073092,264589,155421.46666666667,71.37405771999596,64.60626743032876,NaN,NaN,NaN,NaN,77.13864463509984,22.443697119262723,3506036,24.179443824985995,89.90967770925272,65.73023388426672
2024-12-03T10:00:00-05:00,21202.25,21262.5,21162,21232,20965.912545536332,NaN,NaN,NaN,NaN,NaN,20934.045,21217.72876213682,20650.361237863177,21090.8132328961,21209.32149436472,21223.652824749635,21194.990163979808,493137,169211.26666666666,73.16954482330782,66.02175344425821,NaN,NaN,NaN,NaN,78.80731287544985,22.298484360966928,3999173,21.20113777321582,92.2316561007865,71.03051832757068
2024-12-03T14:00:00-05:00,21232.25,21328.75,21223.75,21324,21014.041478738865,NaN,NaN,NaN,NaN,NaN,20946.74,21242.041624783287,20651.438375216716,21128.626375242802,21222.56229793938,21255.640669112574,21189.48392676619,161673,164634.9,78.04275209306128,67.88295677654081,NaN,NaN,NaN,NaN,80.678219098632,22.787074905925206,4160846,23.446647958215735,100.33882827534035,76.89218031712461
2024-12-03T18:00:00-05:00,21321.25,21345.5,21305.5,21336,21069.755502432552,NaN,NaN,NaN,NaN,NaN,20959.86,21264.72777724109,20654.992222758912,21165.40110019424,21329,21329,21329,35593,148920,78.58901485369348,69.6157356611088,NaN,NaN,NaN,NaN,77.77263202015828,23.387516230827426,4196439,23.68977884497771,106.50440387334675,82.81462502836904
2024-12-03T22:00:00-05:00,21336,21368.25,21326.25,21353.5,21097.40297959471,NaN,NaN,NaN,NaN,NaN,20973.585,21286.21482279372,20660.955177206277,21203.170880155394,21338.705332667607,21348.86152693473,21328.549138400485,32503,142717.16666666666,79.39412667179552,70.86278689060342,NaN,NaN,NaN,NaN,75.21744401871841,24.14501554172008,4228942,22.96211521036085,111.5172690413201,88.55515383095926
2024-12-04T02:00:00-05:00,21353.5,21413,21343,21406.25,21129.96420779495,NaN,NaN,NaN,NaN,NaN,20984.56,21317.956859013062,20651.16314098694,21245.936704124313,21360.37228907804,21385.734405478517,21335.010172677565,54556,143129.16666666666,81.63574636072207,72.6340008553627,NaN,NaN,NaN,NaN,74.8447694459528,25.222493191900202,4283498,23.861359051542166,118.38185264538697,94.5204935938448
2024-12-04T06:00:00-05:00,21406.25,21456.75,21388.25,21416.75,21176.39765289518,NaN,NaN,NaN,NaN,NaN,20997.015,21347.116362608205,20646.913637391794,21288.84936329945,21399.46678780912,21431.8879174418,21367.04565817644,227074,149370.63333333333,82.05423568639821,74.4398354649294,NaN,NaN,NaN,NaN,74.39157162838475,26.55766148098223,4510572,22.982495971801626,123.24861355859684,100.26611758679522
2024-12-04T10:00:00-05:00,21416.75,21496.5,21391.75,21471.5,21194.925032309035,NaN,NaN,NaN,NaN,NaN,21010.04,21380.71988021987,20639.360119780133,21309.804490639563,21429.64727691919,21463.905548892697,21395.389004945682,447190,161406.7,84.0901383621646,76.4263862844364,NaN,NaN,NaN,NaN,76.56003079778586,28.078463688285243,4957762,23.806771243307566,130.02458164092968,106.21781039762212
2024-12-04T14:00:00-05:00,21472,21550,21463.25,21517.75,21256.92275811317,NaN,NaN,NaN,NaN,NaN,21024.37,21416.436668310558,20632.30333168944,21357.26859251165,21444.298930407145,21488.20821093903,21400.389649875262,176819,159048.63333333333,85.57852894325319,77.42821602950472,NaN,NaN,NaN,NaN,77.28788574080116,29.834413963941692,5134581,25.058620176589443,137.54108561835892,112.48246544176948
2024-12-04T18:00:00-05:00,21511,21523.75,21495,21509,21267.10240547166,NaN,NaN,NaN,NaN,NaN,21039.715,21446.13076015194,20633.29923984806,21357.26859251165,21509.25,21509.25,21509.25,34209,139790.8,83.97787882770585,78.10242426782305,NaN,NaN,NaN,NaN,73.8208939021725,31.464939219908388,5100372,22.94575483373947,141.1646589839438,118.21890415020434
2024-12-04T22:00:00-05:00,21509.5,21519.75,21502.25,21503.75,21277.353432495678,NaN,NaN,NaN,NaN,NaN,21052.67,21475.787742951507,20629.55225704849,21376.151899207456,21509.024523459462,21509.33992499017,21508.709121928754,17483,133793.43333333332,82.97507683013782,78.71940947947019,NaN,NaN,NaN,NaN,69.79797290916018,32.97899838616318,5082889,19.005775467217546,141.97612348422626,122.97034801700872
2024-12-05T02:00:00-05:00,21503.75,21517,21489,21504.75,21277.353432495678,NaN,NaN,NaN,NaN,NaN,21065.83,21503.20140327135,20628.458596728655,21388.121519365963,21506.704211234886,21509.405779003973,21504.0026434658,38432,134158.6,83.01667730912476,79.31217930248856,NaN,NaN,NaN,NaN,66.81240341564873,34.08226414285894,5121321,14.482679048740493,141.07369682793433,126.59101777919383
2024-12-05T06:00:00-05:00,21505,21552,21497.75,21510.25,21300.943933327675,NaN,NaN,NaN,NaN,NaN,21078.465,21529.739306935524,20627.190693064476,21421.772215492772,21515.67747175778,21522.093073143216,21509.261870372342,187091,139854.13333333333,83.25897132247005,79.88936967811777,NaN,NaN,NaN,NaN,65.91508888595953,35.37630102920055,5308412,10.085374879349558,139.1977363783808,129.11236149903124
2024-12-05T10:00:00-05:00,21511,21567.75,21481.25,21493.75,21300.943933327675,NaN,NaN,NaN,NaN,NaN,21089.145,21553.75421310286,20624.53578689714,21421.772215492772,21514.787398463966,21518.784116410778,21510.790680517155,459141,154273.73333333334,79.59048332681077,80.48194522361722,NaN,NaN,NaN,NaN,67.38543967981957,36.18849482698651,4849271,4.570453592046988,134.82542848908997,130.25497489704298
2024-12-05T14:00:00-05:00,21493.75,21517,21437.25,21453,21300.943933327675,NaN,NaN,NaN,NaN,NaN,21099.015,21573.06000218879,20624.969997811208,21421.772215492772,21505.160020789135,21524.131916915045,21486.188124663226,196503,159144.96666666667,71.24177746959214,80.47249663430264,NaN,NaN,NaN,NaN,68.26862255983245,35.964993599615866,4652768,-2.9138625018864275,126.61264676968494,129.52650927157137
2024-12-05T18:00:00-05:00,21449.25,21481.75,21424,21477,21300.943933327675,NaN,NaN,NaN,NaN,NaN,21108.965,21593.330316780513,20624.599683219487,21421.772215492772,21460.916666666668,21460.916666666668,21460.916666666668,36464,158417.43333333332,73.03574568715288,80.46293955314874,NaN,NaN,NaN,NaN,67.51729237698727,35.47840824749478,4689232,-7.101381875959191,120.64978192662238,127.75116380258157
2024-12-05T22:00:00-05:00,21477.25,21483.5,21458.75,21476.5,21300.943933327675,NaN,NaN,NaN,NaN,NaN,21119.61,21612.349861996125,20626.870138003876,21421.772215492772,21464.99157656108,21470.674360032594,21459.308793089564,18749,157371.46666666667,72.93366955258807,80.09800508597208,NaN,NaN,NaN,NaN,64.46248577863103,35.04762421612775,4670483,-10.550363528229994,114.56320939229408,125.11357292052408
2024-12-06T02:00:00-05:00,21477,21495.5,21451.25,21453.5,21300.943933327675,NaN,NaN,NaN,NaN,NaN,21131.65,21627.00915253438,20636.29084746562,21421.772215492772,21465.68616364606,21470.189121951556,21461.183205340563,36049,157036.06666666668,68.21101911242133,79.35671967588121,NaN,NaN,NaN,NaN,63.0187367944431,34.79776376816287,4634434,-14.767493750239879,106.65420573272422,121.4216994829641
2024-12-06T06:00:00-05:00,21454,21614.5,21439,21607.75,21300.943933327675,NaN,NaN,NaN,NaN,NaN,21145.775,21654.18310624908,20637.366893750925,21421.772215492772,21530.54448558958,21569.408527801545,21491.680443377616,255073,163697.23333333334,78.3405157947027,79.28146175608886,NaN,NaN,NaN,NaN,71.05311273769716,35.74598196414107,4889507,-7.899676662443497,111.54710365490973,119.44678031735323
2024-12-06T10:00:00-05:00,21607.25,21669.5,21572.75,21658.75,21390.88298610603,NaN,NaN,NaN,NaN,NaN,21161.53,21683.542726281725,20639.517273718273,21466.88708612651,21590.575032285207,21647.302190812632,21533.847873757783,482476,172634.9,80.54757825946083,79.20373546314161,NaN,NaN,NaN,NaN,72.88860468500451,37.02431216722292,5371983,-1.015220500365345,118.17775469189655,119.1929751922619
2024-12-06T14:00:00-05:00,21658.5,21665,21612,21634,21411.496259464846,NaN,NaN,NaN,NaN,NaN,21176.075,21709.28814921878,20642.86185078122,21476.409668901208,21598.996343674065,21653.349665635084,21544.643021713047,183658,168000.2,76.47494415555602,78.80521463951004,NaN,NaN,NaN,NaN,71.46799006464705,38.21133307008463,5188325,0.6868960017685737,120.05159519447261,119.36469919270404
2024-12-08T18:00:00-05:00,21648.75,21670.75,21626.5,21650,21425.90552039826,NaN,NaN,NaN,NaN,NaN,21191.195,21734.338528821092,20648.051471178907,21497.752735120965,21649.083333333332,21649.083333333332,21649.083333333332,47858,167220.23333333334,77.27488604351225,78.31841090246344,NaN,NaN,NaN,NaN,69.52384791717226,39.35607740156198,5236183,1.6505988696309117,121.42794777974268,119.77734891011177
2024-12-08T22:00:00-05:00,21650,21656.25,21635,21650,21430.131405834705,NaN,NaN,NaN,NaN,NaN,21204.765,21759.063840067458,20650.46615993254,21507.227188096775,21648.54708216727,21649.433048817267,21647.661115517276,17533,166614.46666666667,77.27488604351225,77.72529355248194,NaN,NaN,NaN,NaN,66.07571592308854,40.41905428079096,5236183,1.0761148104190283,121.12249242313555,120.04637761271653
2024-12-09T02:00:00-05:00,21649.5,21706.5,21612.5,21615.25,21440.98338738767,NaN,NaN,NaN,NaN,NaN,21217.67,21779.498901357456,20655.84109864254,21540.281750477418,21646.5950169421,21648.59076172504,21644.59927215916,69185,167476.96666666667,71.17839216287052,76.8110445049937,NaN,NaN,NaN,NaN,68.07030764286793,41.78246030725391,5166998,-2.652476112371602,116.73078247225203,119.38325858462363
2024-12-09T06:00:00-05:00,21614.75,21649,21582.75,21623.5,21440.98338738767,NaN,NaN,NaN,NaN,NaN,21230.12,21799.726769974062,20660.513230025936,21540.281750477418,21629.356817165524,21643.14575785619,21615.56787647486,212049,165411.7,71.748255686375,76.00912870901064,NaN,NaN,NaN,NaN,67.94028566837736,42.269295205461496,5379047,-5.412336140907911,112.61783840848875,118.03017454939666
2024-12-09T10:00:00-05:00,21623.5,21631.75,21437,21529.75,NaN,NaN,NaN,21768.65821521082,21768.65821521082,21768.65821521082,21240.61,21812.579091472515,20668.640908527486,21540.281750477418,21569.740865076485,21617.41663690304,21522.06509324993,559896,167335,57.76989496519962,74.20578711301599,NaN,NaN,NaN,NaN,76.9981224063504,39.90699948684754,4819151,-13.917403889750517,100.63341968720852,114.55082357695903
2024-12-09T14:00:00-05:00,21530,21530.25,21441,21473,NaN,NaN,NaN,21721.429432701236,NaN,NaN,21250.67,21820.93823022188,20680.401769778116,21540.281750477418,21553.338665580366,21608.389149370334,21498.288181790398,206737,168129.26666666666,51.25961707461235,71.92011895245473,NaN,NaN,NaN,NaN,77.87325652018252,37.713439176706004,4612414,-23.184632689237787,85.5700327154118,108.75466540464959
2024-12-09T18:00:00-05:00,21480,21485,21458.5,21467.5,NaN,NaN,NaN,21700.44968576027,NaN,NaN,21261.31,21827.496952869446,20695.123047130557,21540.281750477418,21470.333333333332,21470.333333333332,21470.333333333332,28820,168137.33333333334,50.663712843118354,69.85392106076242,NaN,NaN,NaN,NaN,74.20373819731233,35.6765617458603,4583594,-29.120268084397324,72.35433029915293,101.47459838355026
2024-12-09T22:00:00-05:00,21467.5,21477.25,21451.75,21459.25,NaN,NaN,NaN,21686.281518225715,NaN,NaN,21273.31,21830.260541430383,20716.35945856962,21540.281750477418,21467.466569192366,21471.143700070425,21463.789438314307,17517,167989.06666666668,49.729826555257745,68.31735313830997,NaN,NaN,NaN,NaN,70.72489975464717,33.667356359479164,4566077,-32.765697055933714,60.51747706363312,93.28317411956684
2024-12-10T02:00:00-05:00,21459.5,21498,21447.75,21491.5,NaN,NaN,NaN,21686.281518225715,NaN,NaN,21286.93,21831.103676687726,20742.756323312275,21540.281750477418,21472.466418766646,21478.852756660846,21466.080080872445,35013,167769,53.34984304126274,66.9112172350321,NaN,NaN,NaN,NaN,69.26240691502952,32.11617190895365,4601090,-32.12527456331661,53.12658091542107,85.25185547873768
2024-12-10T06:00:00-05:00,21491.5,21589.75,21490,21546.75,NaN,NaN,NaN,21686.281518225715,NaN,NaN,21301.735,21832.944670563444,20770.525329436558,21540.281750477418,21525.920802783417,21555.55050010708,21496.291105459753,267669,167871.66666666666,58.820822446537,65.90315672745702,NaN,NaN,NaN,NaN,71.44009213538455,31.838416680635095,4868759,-27.291109142210317,51.13796905097479,78.4290781931851
2024-12-10T10:00:00-05:00,21546.5,21606.75,21444,21453.25,NaN,NaN,NaN,21686.281518225715,NaN,NaN,21313.83,21830.551728205515,20797.10827179449,21540.281750477418,21510.358846477997,21531.869754535175,21488.84793842082,601785,171493.26666666666,48.462649926918125,64.49255892849251,NaN,NaN,NaN,NaN,77.96222841142851,30.74928146049179,4266974,-29.51247737400128,41.53848147568351,71.05095884968479
2024-12-10T14:00:00-05:00,21453.25,21460,21352.75,21434.75,NaN,NaN,NaN,21644.662504678876,NaN,NaN,21325.255,21826.6781595168,20823.831840483203,21540.281750477418,21490.277980621937,21533.39796135753,21447.157999886345,256472,174653.23333333334,46.70995512584617,62.233233166431326,NaN,NaN,NaN,NaN,80.05421209632648,28.720245670940297,4010502,-31.186079925652678,32.06835894261894,63.25443886827162
2024-12-10T18:00:00-05:00,21438.25,21442.5,21408.5,21428.25,NaN,NaN,NaN,21644.662504678876,NaN,NaN,21336.655,21820.707155144653,20852.602844855344,21482.900400381935,21426.416666666668,21426.416910807293,21426.416422526043,27902,174396.86666666667,46.07938681188056,59.77121949160416,NaN,NaN,NaN,NaN,76.76462551801744,26.836141009213915,3982600,-31.591729199472184,23.76477736893139,55.356506568403574
2024-12-10T22:00:00-05:00,21427.75,21447.5,21414,21444.5,NaN,NaN,NaN,21644.662504678876,NaN,NaN,21347.775,21815.401862465893,20880.14813753411,21411.10274655772,21430.008828061465,21434.382211461936,21425.635444660995,18824,173940.9,47.970413928376885,57.735181618234215,NaN,NaN,NaN,NaN,73.67429512387334,25.011946312652693,4001424,-29.65752932479827,18.284594912405737,47.942124237204006
2024-12-11T02:00:00-05:00,21444.75,21456.25,21405.75,21447.5,NaN,NaN,NaN,21644.662504678876,NaN,NaN,21358.935,21808.569327092333,20909.30067290767,21411.10274655772,21433.129965222608,21437.651942123175,21428.60798832204,43275,173564.86666666667,48.33068402749708,55.66773861709028,NaN,NaN,NaN,NaN,72.01898832931096,23.269360434804838,4044699,-27.136139824954007,14.021949456011498,41.158089280965505
2024-12-11T06:00:00-05:00,21448,21697,21431.25,21696,21317.6541331869,21317.6541331869,21317.6541331869,NaN,NaN,NaN,21374.84,21814.673488492906,20935.006511507094,21429.039934393626,21567.461969336582,21641.36391110201,21493.560027571155,297627,175916.63333333333,68.05973472224191,55.00951352271386,NaN,NaN,NaN,NaN,85.85691773436018,24.19845975817023,4342326,-8.649801428808367,30.34583749495505,38.995638923763416
2024-12-11T10:00:00-05:00,21695.75,21811.5,21673.75,21793,21486.31684583872,NaN,NaN,NaN,NaN,NaN,21392.575,21826.876591638742,20958.27340836126,21528.256947514903,21677.31862456817,21783.87785989353,21570.759389242812,518691,178300,72.47740133947129,55.10229989247106,NaN,NaN,NaN,NaN,89.56356646762016,25.76783531700005,4861017,9.2253118158811,50.52727869361479,41.30196687773369
2024-12-11T14:00:00-05:00,21792.75,21819.75,21750,21755.25,21530.70585284605,NaN,NaN,NaN,NaN,NaN,21409.77,21831.896957679855,20987.643042320145,21558.28055801192,21693.73597966988,21797.565611367925,21589.906347971835,183099,178509.33333333334,68.50626658128742,54.87072924210766,NaN,NaN,NaN,NaN,88.148311719933,27.27088040959538,4677918,17.15982145237838,62.75174369320666,45.59192224082828
2024-12-11T18:00:00-05:00,21756.75,21767.25,21742.5,21753,21530.70585284605,NaN,NaN,NaN,NaN,NaN,21426.52,21835.11422218135,21017.92577781865,21558.28055801192,21754.25,21754.25,21754.25,29785,178361.86666666667,68.26618001600133,55.6204638885935,NaN,NaN,NaN,NaN,83.61986088279492,28.545769701578365,4648133,20.674229583817997,71.43470922060078,50.76047963678278
2024-12-11T22:00:00-05:00,21753.25,21772.75,21752.75,21761.25,21530.70585284605,NaN,NaN,NaN,NaN,NaN,21441.915,21841.696635521,21042.133364479003,21585.50955712763,21757.076298419317,21760.90022631389,21753.252370524744,16271,178321.46666666667,68.69933885712724,56.86615830163027,NaN,NaN,NaN,NaN,79.07558510545243,29.764935429947535,4664404,21.856937360843922,78.08165133783768,56.22471397699376
2024-12-12T02:00:00-05:00,21761.25,21771.25,21728.5,21744,21530.70585284605,NaN,NaN,NaN,NaN,NaN,21457.725,21841.185587935757,21074.26441206424,21600.082645702103,21753.037832068792,21758.40971033514,21747.665953802443,36319,178251.03333333333,66.65077334773025,58.00809119481683,NaN,NaN,NaN,NaN,76.48090045506297,30.470064880775976,4628085,19.839014223465036,81.02348175632505,61.18446753286002
2024-12-12T06:00:00-05:00,21744,21749.25,21648,21683.5,21530.70585284605,NaN,NaN,NaN,NaN,NaN,21472.335,21832.732525102907,21111.93747489709,21600.082645702103,21707.124112269255,21732.1896211832,21682.05860335531,279315,181325.16666666666,59.903888863390414,58.73480993111202,NaN,NaN,NaN,NaN,78.25012185112989,29.848456545803508,4348770,13.115449414231449,77.57877930064933,64.46332988641788
2024-12-12T10:00:00-05:00,21682.5,21744.5,21624.75,21697.25,21530.70585284605,NaN,NaN,NaN,NaN,NaN,21487.29,21820.7119452881,21153.8680547119,21600.082645702103,21696.131597498403,21714.322756101847,21677.94043889496,544771,184179.5,60.873289772091724,59.27219898331409,NaN,NaN,NaN,NaN,81.21439886176347,28.938306071208146,4893541,8.503508722240369,75.09271578921835,66.58920706697798
2024-12-12T14:00:00-05:00,21697,21715.5,21602.25,21631.75,21530.70585284605,NaN,NaN,NaN,NaN,NaN,21496.925,21818.432686533484,21175.417313466514,21600.082645702103,21686.49750505541,21711.302430015872,21661.692580094947,238187,185568.96666666667,54.156317158927415,58.939020034199125,NaN,NaN,NaN,NaN,83.50265608592323,27.77226355333104,4655354,0.3799275959099191,67.06411656186538,66.68418896595546
2024-12-12T18:00:00-05:00,21700.5,21768.75,21700.5,21727,21530.70585284605,NaN,NaN,NaN,NaN,NaN,21507.215,21824.558047978102,21189.8719520219,21600.082645702103,21732.083333333332,21732.083333333332,21732.083333333332,56560,186238.83333333334,60.91106326503621,59.82819241549328,NaN,NaN,NaN,NaN,87.32389493692871,27.24546966302348,4711914,0.7389933501864618,67.60793065368853,66.86893730350207
2024-12-12T22:00:00-05:00,21726.75,21746.5,21697.5,21746,21530.70585284605,NaN,NaN,NaN,NaN,NaN,21517.915,21830.629959827325,21205.200040172676,21600.082645702103,21731.38388120936,21732.367730124963,21730.400032293757,28587,186566.76666666666,62.11035105407565,60.9282206960811,NaN,NaN,NaN,NaN,84.58647387000522,26.710080487539535,4740501,1.5282138314586717,68.77920459282541,67.25099076136674
2024-12-13T02:00:00-05:00,21745.75,21799.25,21725,21791.75,21530.70585284605,NaN,NaN,NaN,NaN,NaN,21529.375,21839.381762023208,21219.368237976792,21600.082645702103,21745.551998572446,21764.925916454125,21726.178080690766,45613,186885.56666666668,64.90267471358784,62.27274126048876,NaN,NaN,NaN,NaN,83.848154307862,26.742453011023994,4786114,4.249314119053395,72.56263341018348,68.31331929113009
2024-12-13T06:00:00-05:00,21791.75,21908,21775.75,21880.5,21587.703594994833,NaN,NaN,NaN,NaN,NaN,21542.43,21855.491256625555,21229.368743374445,21669.442124059944,21819.4693090827,21871.710335884127,21767.22828228127,273958,187515.06666666668,69.58531170229975,63.81666253005467,NaN,NaN,NaN,NaN,87.30542900015757,27.657949556210003,5060072,10.773109166766474,81.77970574958817,71.0065965828217
2024-12-13T10:00:00-05:00,21880.75,21888.5,21666.75,21774,21587.703594994833,NaN,NaN,NaN,NaN,NaN,21553.855,21858.066441106632,21249.643558893367,21669.442124059944,21791.99011318876,21829.608632962645,21754.371593414875,714121,195236.56666666668,59.35196874217162,64.60389715253142,NaN,NaN,NaN,NaN,96.90861264300347,26.96100040676396,4345951,6.853418547857984,79.57336976764418,72.7199512197862
2024-12-13T14:00:00-05:00,21774,21824.25,21750.25,21760.5,21587.703594994833,NaN,NaN,NaN,NaN,NaN,21564.985,21857.685160744677,21272.284839255324,21669.442124059944,21790.020057901776,21825.14887776551,21754.891238038043,188605,195401.46666666667,58.183891503830466,63.89847977978775,NaN,NaN,NaN,NaN,95.27228316850322,26.313833339421205,4157346,2.5128525041433534,75.86101684996538,73.34816434582203
2024-12-15T18:00:00-05:00,21785.25,21821.75,21762.25,21816.5,21587.703594994833,NaN,NaN,NaN,NaN,NaN,21576.675,21861.836747960846,21291.513252039153,21669.442124059944,21800.166666666668,21800.166666666668,21800.166666666668,35186,194979.06666666668,61.56316250362057,63.118891291512696,NaN,NaN,NaN,NaN,92.8421200850387,25.71289249117436,4192532,2.565629878503131,76.55520169395095,73.98957181544782
2024-12-15T22:00:00-05:00,21816.5,21819.5,21784.5,21808.75,21587.703594994833,NaN,NaN,NaN,NaN,NaN,21586.37,21869.46429948389,21303.275700516107,21669.442124059944,21801.560643780576,21803.49685164399,21799.62443591716,18238,195002.56666666668,60.83050802331561,62.57062282308614,NaN,NaN,NaN,NaN,88.71054007896451,25.154875989230863,4174294,1.295079459086793,75.6084211393063,74.31334168021951
2024-12-16T02:00:00-05:00,21808.5,21866.5,21792.75,21863,21587.703594994833,NaN,NaN,NaN,NaN,NaN,21596.91,21881.172444934156,21312.647555065843,21669.442124059944,21815.3972897317,21834.191484222658,21796.603095240742,29157,193668.3,64.055260276524,62.26984284169491,NaN,NaN,NaN,NaN,87.64193007332419,25.120963668277152,4203451,3.215440576764948,78.33264240117569,75.11720182441074
2024-12-16T06:00:00-05:00,21862.75,21972.5,21837.5,21970.75,21640.7697141315,NaN,NaN,NaN,NaN,NaN,21609.255,21903.595236630703,21314.9147633693,21734.59676416957,21886.965333058586,21941.607614627123,21832.32305149005,147934,191531.13333333333,69.4372521127914,62.32255093138521,NaN,NaN,NaN,NaN,91.02464935380102,25.988234924826298,4351385,10.442051099383264,88.16976569863982,77.72771459925656
2024-12-16T10:00:00-05:00,21971.5,22127.75,21928.75,22117.5,21748.893818034612,NaN,NaN,NaN,NaN,NaN,21623.48,21944.719674386648,21302.24032561335,21837.927411335655,21977.355482453,22070.614765887003,21884.096199018997,258372,181480.33333333334,74.94056786612077,62.91467911127024,NaN,NaN,NaN,NaN,98.73717439995809,27.72809584399215,4609757,23.08077442710278,106.57868263313503,83.49790820603225
2024-12-16T14:00:00-05:00,22116.75,22152.5,22095.5,22111,21849.56909903304,NaN,NaN,NaN,NaN,NaN,21637.365,21980.90369083362,21293.826309166383,21892.141929068526,22000.81339934766,22101.071677493503,21900.555121201814,96491,177805.46666666667,74.30237104734383,63.94314212440976,NaN,NaN,NaN,NaN,95.75594765710393,29.466276315052802,4513266,28.616499715934665,119.26853285095058,90.65203313501591
2024-12-16T18:00:00-05:00,22410.5,22422.75,22377,22417.75,22095.40686725881,NaN,NaN,NaN,NaN,NaN,21656.29,22060.153062930996,21252.426937069005,22058.58854325482,22405.83333333333,22405.833756197295,22405.832910469362,24991,177677.83333333334,82.06482668620399,65.45682333256065,NaN,NaN,NaN,NaN,111.18409425302507,32.06986091801408,4538257,49.33567197444701,152.32162310307467,102.98595112862766
2024-12-16T22:00:00-05:00,22417.75,22426.5,22385,22391.25,22109.462236928866,NaN,NaN,NaN,NaN,NaN,21673.76,22124.93889977288,21222.58110022712,22114.420834603858,22403.962964340317,22406.34995002928,22401.575978651355,15344,177605.4,79.8216033705033,67.29005806195893,NaN,NaN,NaN,NaN,106.20665894923755,34.497943855252494,4522913,57.10571895146205,174.36809981795523,117.26238086649317
2024-12-17T02:00:00-05:00,22391.75,22410.75,22325,22408,22109.462236928866,NaN,NaN,NaN,NaN,NaN,21691.74,22184.919763980302,21198.5602360197,22118.211667683085,22391.50944517858,22402.92609303772,22380.09279731944,48961,178070.33333333334,80.19019817169428,68.66713912672022,NaN,NaN,NaN,NaN,104.745469024292,35.93434965026239,4571874,58.9821448416717,190.9900619185828,132.0079170769111
2024-12-17T06:00:00-05:00,22407.75,22424.5,22279.5,22306.75,22109.462236928866,NaN,NaN,NaN,NaN,NaN,21707.8,22227.055572911973,21188.544427088025,22118.211667683085,22351.8312824749,22376.879098463083,22326.78346648672,237559,177066.66666666666,71.66798051318187,69.3498269452278,NaN,NaN,NaN,NaN,107.620792665414,36.67919876985459,4334315,49.40128129783426,193.7595186992039,144.35823740136965
2024-12-17T10:00:00-05:00,22306.25,22386.25,22244.25,22308.25,22109.462236928866,NaN,NaN,NaN,NaN,NaN,21723.87,22266.21513218076,21181.524867819237,22118.211667683085,22329.329287847373,22354.507173095848,22304.151402598898,448124,171944.63333333333,71.71593773655289,69.8364885897253,NaN,NaN,NaN,NaN,110.07645033217014,36.92548853376762,4782439,39.58612484424799,193.84089345667962,154.25476861243163
2024-12-17T14:00:00-05:00,22308.5,22330.75,22253.75,22304,22109.462236928866,NaN,NaN,NaN,NaN,NaN,21739.745,22302.242613239523,21177.247386760475,22118.211667683085,22323.964335803004,22350.050814775324,22297.877856830684,149571,168381.26666666666,71.34743795448325,69.96235475059557,NaN,NaN,NaN,NaN,107.71384673701513,37.15418617168686,4632868,29.681468500990775,191.35660423867012,161.67513573767934
2024-12-17T18:00:00-05:00,22306,22333.25,22205.5,22323.5,22109.462236928866,NaN,NaN,NaN,NaN,NaN,21756.34,22337.478965824732,21175.20103417527,22118.211667683085,22287.416666666668,22287.416666666668,22287.416666666668,42131,168855.56666666668,72.05689575711446,70.86984953737719,NaN,NaN,NaN,NaN,109.14500054151405,36.73254841375714,4674999,21.687953257984503,188.78507731015998,167.09712405217547
2024-12-17T22:00:00-05:00,22323.75,22348.25,22299.25,22336.75,22109.462236928866,NaN,NaN,NaN,NaN,NaN,21774.015,22370.724078278614,21177.305921721385,22118.211667683085,22302.250643306594,22321.82617702863,22282.675109584558,24193,169034.53333333333,72.55418064171502,71.8962987615118,NaN,NaN,NaN,NaN,104.84892907426305,36.44300323747851,4699192,14.863045877998474,185.67593139967357,170.8128855216751
2024-12-18T02:00:00-05:00,22337,22375.75,22313.75,22368.75,22109.462236928866,NaN,NaN,NaN,NaN,NaN,21791.85,22405.061806801095,21178.6381931989,22135.032431413114,22321.330494058784,22350.27696899777,22292.3840191198,40276,168934.56666666668,73.76833859511511,72.76809705376141,NaN,NaN,NaN,NaN,101.78829128324426,36.3635302435325,4739468,10.291077497877609,183.6767323940221,173.3856548961445
2024-12-18T06:00:00-05:00,22368.75,22387.5,22211.25,22288.25,22109.462236928866,NaN,NaN,NaN,NaN,NaN,21808.085,22429.962645602518,21186.20735439748,22135.032431413114,22303.822560225457,22324.048154133096,22283.59696631782,228834,166641.46666666667,65.87354776751886,73.12831417834737,NaN,NaN,NaN,NaN,107.10698476301253,34.97015666848325,4510634,0.1679351467234369,173.5955738295488,173.42763868282537
2024-12-18T10:00:00-05:00,22288.5,22351.75,22250,22293.75,22109.462236928866,NaN,NaN,NaN,NaN,NaN,21824.89,22452.913384596584,21196.866615403414,22135.032431413114,22301.17919149598,22315.77357487106,22286.5848081209,330949,160383.4,66.14017641459361,73.27723675963804,NaN,NaN,NaN,NaN,106.72434299422592,33.67630977736608,4841583,-7.4159673254655445,164.15767952599344,171.573646851459
2024-12-18T14:00:00-05:00,22293.75,22296.25,21310.25,21459.5,NaN,NaN,NaN,22228.870809212072,22228.870809212072,22228.870809212072,21821.925,22455.397187629453,21188.452812370546,22135.032431413114,21997.708270048774,22304.127275229013,21691.289264868534,654371,176092.46666666667,29.056710298451776,70.39291234432807,NaN,NaN,NaN,NaN,169.5297470660669,35.00895027472786,4187212,-66.58474343662692,88.34271755567534,154.92746099230226
2024-12-18T18:00:00-05:00,21499,21550,21453.25,21462.5,NaN,NaN,NaN,21921.092590611523,NaN,NaN,21818,22457.86733781311,21178.13266218689,22135.032431413114,21488.583333333332,21488.583333333332,21488.583333333332,119164,179071.76666666666,29.21041743962958,67.12647302815012,NaN,NaN,NaN,NaN,164.33119370420496,36.24640216513523,4306376,-101.40109483377091,28.176092450088618,129.57718728385953
2024-12-18T22:00:00-05:00,21463.25,21509,21428,21487.5,NaN,NaN,NaN,21879.94633649282,NaN,NaN,21815.07,22459.60534457003,21170.53465542997,22135.032431413114,21483.620013656804,21490.22388398835,21477.016143325258,67312,180773.13333333333,30.560598855557686,64.00206072873684,NaN,NaN,NaN,NaN,158.37896558247604,37.45714604813251,4373688,-117.49358532305341,-17.289794369957235,100.20379095309617
2024-12-19T02:00:00-05:00,21487.75,21614.25,21482,21564.5,NaN,NaN,NaN,21879.94633649282,NaN,NaN,21813.36,22460.08798887936,21166.63201112064,22135.032431413114,21509.55023040645,21543.744317658122,21475.35614315478,109812,183222.9,34.69224330146025,60.6183047726837,NaN,NaN,NaN,NaN,156.51261089801346,37.7584480988581,4483500,-117.42041742774948,-46.571730831590685,70.8486865961588
2024-12-19T06:00:00-05:00,21564.75,21698,21544,21578.75,NaN,NaN,NaN,21879.94633649282,NaN,NaN,21811.935,22460.408128278777,21163.461871721225,22135.032431413114,21564.04654286937,21617.441994716297,21510.651091022446,376640,186467.06666666668,35.45761222544523,57.44944826232241,NaN,NaN,NaN,NaN,156.3331386910125,37.425530285394295,4860140,-110.95569714133906,-67.84593483051503,43.109762310824024
2024-12-19T10:00:00-05:00,21578.25,21637.5,21430.75,21597.5,NaN,NaN,NaN,21879.94633649282,NaN,NaN,21811.58,22460.502710651745,21162.65728934826,22135.032431413114,21559.671574244283,21597.782388091524,21521.560760397042,665835,190502.53333333333,36.511924618408294,54.32957157994485,NaN,NaN,NaN,NaN,159.93434307022588,37.5035924775033,5525975,-100.28369699599176,-82.24485893416568,18.038838061826084
2024-12-19T14:00:00-05:00,21596.75,21598.75,21345,21408.5,NaN,NaN,NaN,21879.94633649282,NaN,NaN,21807.28,22463.934152808146,21150.62584719185,22135.032431413114,21541.1581839087,21594.81753565115,21487.498832166253,274146,191701.16666666666,31.012618068787845,51.42561711963099,NaN,NaN,NaN,NaN,166.6354614223526,37.8482448622891,5251829,-100.56365205324406,-107.66572700472898,-7.10207495148493
2024-12-19T18:00:00-05:00,21429.75,21436,21221.5,21253.5,NaN,NaN,NaN,21776.01350311133,NaN,NaN,21801.755,22472.16123870901,21131.348761290992,22106.800945130493,21303.666666666668,21303.666666666668,21303.666666666668,118237,193757.06666666668,27.37156203162266,48.25816171213597,NaN,NaN,NaN,NaN,170.0543570350417,38.52952764900547,5133592,-105.29439927538454,-138.7200740457156,-33.425674770331064
2024-12-19T22:00:00-05:00,21254.75,21296,21203.75,21293.5,NaN,NaN,NaN,21689.387889333542,NaN,NaN,21798.165,22477.43846194281,21118.891538057193,22076.31575610439,21290.118369387033,21308.778870692655,21271.457868081412,62327,194881.73333333334,29.66646513763797,45.28094936807559,NaN,NaN,NaN,NaN,164.49690296111015,39.212475059679875,5195919,-99.88239153447074,-158.2786641884195,-58.396272653948756
2024-12-20T02:00:00-05:00,21293.25,21301.5,21095.75,21104,NaN,NaN,NaN,21646.21684890929,NaN,NaN,21790.895,22491.611120051446,21090.178879948555,21582.902604883515,21232.219783530363,21295.113804125347,21169.32576293538,160500,198711.3,25.54789326376391,41.95887776140769,NaN,NaN,NaN,NaN,167.44355274960228,40.14575180642051,5035419,-102.81530954094028,-186.9154095801241,-84.10010003918383
2024-12-20T06:00:00-05:00,21104.75,21309.25,21007,21230.25,NaN,NaN,NaN,21626.587673958868,NaN,NaN,21786.315,22498.541037224382,21074.088962775615,21225.224906960288,21202.336491591435,21249.205947658425,21155.467035524445,505315,206423.2,32.29204595307118,39.08301099793313,NaN,NaN,NaN,NaN,177.07258469605927,41.239501421646416,5540734,-90.44015269120904,-197.15029090319513,-106.71013821198609
2024-12-20T10:00:00-05:00,21232,21812.5,21232,21666.75,20995.683356675625,20995.683356675625,20995.683356675625,NaN,NaN,NaN,21789.82,22497.92110888215,21081.71889111785,21225.224906960288,21389.81919712128,21576.732891665026,21202.905502577534,878647,211907.4,49.36882484082629,37.340188586912504,NaN,NaN,NaN,NaN,206.01382864634076,39.04355677200563,6419381,-49.11335565777061,-168.10183278419936,-118.98847712642875
2024-12-20T14:00:00-05:00,21666.5,21753,21513,21553,21097.64093137219,NaN,NaN,NaN,NaN,NaN,21789.945,22497.87661597728,21082.01338402272,21225.224906960288,21427.66605323802,21616.32382253461,21239.008283941428,365410,217800.9,46.1054260755967,35.92817989463235,NaN,NaN,NaN,NaN,208.44141231445928,37.004465311624905,6053971,-26.810380676959895,-152.5014529726286,-125.69107229566872
2024-12-22T18:00:00-05:00,21566.5,21696.75,21565.25,21674.25,21100.37316176436,NaN,NaN,NaN,NaN,NaN,21794.365,22496.569223926155,21092.160776073848,21225.224906960288,21645.416666666668,21645.416666666668,21645.416666666668,110368,220306.96666666667,49.906560535526005,34.768635903270386,NaN,NaN,NaN,NaN,203.82059714914075,35.11102324127137,6164339,-2.5420703305792927,-128.86866020889283,-126.32658987831354
2024-12-22T22:00:00-05:00,21674.5,21741.5,21657.25,21732,21181.378927138707,NaN,NaN,NaN,NaN,NaN,21800.31,22495.230654175553,21105.38934582445,21199.900083293778,21665.739945799796,21695.81635276268,21635.663538836914,50394,221378.83333333334,51.65548215935677,36.382833893335025,NaN,NaN,NaN,NaN,195.2798402099164,33.10719574501842,6214733,17.63926145830169,-104.27751305543643,-121.91677451373812
2024-12-23T02:00:00-05:00,21732,21735,21613.25,21624,21181.378927138707,NaN,NaN,NaN,NaN,NaN,21804.225,22492.894683157578,21115.55531684242,21240.84506663502,21662.36784926661,21685.92204368621,21638.813654847014,109490,224056.6,48.26195845322915,37.74365825144928,NaN,NaN,NaN,NaN,190.02770876635094,31.458292959198968,6105243,23.583034282133852,-92.43798166107081,-116.02101594320466
2024-12-23T06:00:00-05:00,21624.75,21675.5,21543.75,21629.75,21181.378927138707,NaN,NaN,NaN,NaN,NaN,21807.93,22490.787364608375,21125.072635391625,21240.84506663502,21636.479854428937,21664.126833361068,21608.832875496806,347270,230701.13333333333,48.45610981159161,39.02190903402313,NaN,NaN,NaN,NaN,185.86501528304015,30.257994298951118,6452513,27.49690733475596,-81.6498817747597,-109.14678910951567
2024-12-23T10:00:00-05:00,21629.5,21756.25,21476,21745,21181.378927138707,NaN,NaN,NaN,NaN,NaN,21813.88,22489.2144374455,21138.545562554504,21247.165842646413,21647.88043889451,21670.387209875964,21625.373667913056,628419,243036.03333333333,52.31835179238367,40.28091678337481,NaN,NaN,NaN,NaN,192.60679990568013,28.647879171198593,7080932,36.85867001785617,-63.07345158719545,-99.93212160505162
2024-12-23T14:00:00-05:00,21745,21777,21666.25,21738.75,21209.19043697435,NaN,NaN,NaN,NaN,NaN,21814.735,22489.578377458805,21139.891622541196,21314.35767411713,21659.786763282682,21694.927578894054,21624.64594767131,219620,247140.33333333334,52.090399616081015,41.46897302556308,NaN,NaN,NaN,NaN,186.75988562670298,27.026056809238696,6861312,41.30645079018976,-48.29905811731442,-89.60550890750417
2024-12-23T18:00:00-05:00,21738.75,21761,21708.5,21750.5,21238.448826202788,NaN,NaN,NaN,NaN,NaN,21813.885,22488.94276945402,21138.827230545976,21364.636139293703,21740,21740,21740,45038,247808.56666666668,52.509328717415286,42.611644746920724,NaN,NaN,NaN,NaN,177.1698937962242,25.520078901704508,6906350,43.49565507474384,-35.235940064074384,-78.73159513881822
2024-12-23T22:00:00-05:00,21750.5,21771.25,21726.75,21764.75,21269.189788648117,NaN,NaN,NaN,NaN,NaN,21814.075,22489.07199443766,21139.07800556234,21431.908911434963,21745.482715872302,21752.415862907936,21738.54956883667,28165,248235.93333333332,53.045565105243284,44.185426678096114,NaN,NaN,NaN,NaN,167.6934728107796,24.05093912914793,6934515,44.214874429930234,-23.463002101405436,-67.67787653133567
2024-12-24T02:00:00-05:00,21764.75,21806.75,21738.75,21798.5,21305.476616436838,NaN,NaN,NaN,NaN,NaN,21814.985,22489.772836360415,21140.197163639587,21501.27712914797,21762.118280140672,21780.70367242761,21743.532887853733,63376,248716.43333333332,54.359994482586,46.11317185316493,NaN,NaN,NaN,NaN,160.5725104671525,22.43419094244863,6997891,45.11870284454492,-11.279497975654522,-56.39820082019944
2024-12-24T06:00:00-05:00,21799,21907.75,21765,21903.5,21370.8754065988,NaN,NaN,NaN,NaN,NaN,21817.83,22492.887067513362,21142.77293248664,21591.99670331838,21819.179518161392,21868.163067680718,21770.195968642067,196949,247362.76666666666,58.27355644652182,48.1565355180852,NaN,NaN,NaN,NaN,159.29947400521306,21.408332256248027,7194840,50.53503435879191,6.7705921282904455,-43.764442230501466
2024-12-24T10:00:00-05:00,21903.75,22050,21897,22046.25,21508.29584266249,NaN,NaN,NaN,NaN,NaN,21823.875,22501.587226907523,21146.162773092477,21720.8973626547,21906.039657236153,22001.947177383652,21810.132137088654,315889,242954.93333333332,62.92777411087289,50.826527007164415,NaN,NaN,NaN,NaN,158.8495115762693,21.271764259659065,7510729,60.78971958976136,32.22270725670023,-28.56701233306113
2024-12-25T18:00:00-05:00,22050,22085,22043.5,22072.75,21614.53239526874,NaN,NaN,NaN,NaN,NaN,21831.66,22511.682152286197,21151.637847713802,21800.96789012376,22067.083333333332,22067.083333333332,22067.083333333332,41087,239338.8,63.73642373972905,53.07255399192569,NaN,NaN,NaN,NaN,150.46740360653578,21.328265494684214,7551816,65.98206816476967,53.91057287290096,-12.071495291868711
2024-12-25T22:00:00-05:00,22073,22111,22072,22077,21656.905922756527,NaN,NaN,NaN,NaN,NaN,21839.255,22521.58149435592,21156.928505644082,21864.27431209901,22076.629988482517,22086.418589283658,22066.841387681376,39081,239237.13333333333,63.87252966160663,54.10853290769571,NaN,NaN,NaN,NaN,142.50544620606894,21.519176436051872,7590897,66.1589212052385,70.62715621467942,4.468235009440917
2024-12-26T02:00:00-05:00,22076.5,22084,21894.25,21933.5,21656.905922756527,NaN,NaN,NaN,NaN,NaN,21845.29,22525.502954595817,21165.077045404185,21864.27431209901,22016.216244504918,22069.113180866723,21963.319308143113,106135,241968.53333333333,56.20230364309227,54.82973844823111,NaN,NaN,NaN,NaN,145.88005719134972,20.32569679894913,7484762,53.60303848927426,71.47203312103375,17.868994631759485
2024-12-26T06:00:00-05:00,21933.5,22008.5,21870.5,21957.25,21656.905922756527,NaN,NaN,NaN,NaN,NaN,21849.895,22529.959879919585,21169.830120080416,21864.27431209901,21974.746609163838,22023.485271501737,21926.00794682594,263414,249406.46666666667,57.12009560434091,55.34499095314646,NaN,NaN,NaN,NaN,145.31719596339616,19.054381307920718,7748176,44.2760559008497,73.2140645078216,28.93800860697191
2024-12-26T10:00:00-05:00,21957.5,22075,21927.5,22017,21656.905922756527,NaN,NaN,NaN,NaN,NaN,21855.315,22536.300409608866,21174.32959039113,21864.27431209901,21990.55736689762,22028.566924668194,21952.54780912705,445997,256645.23333333334,59.42378284179696,55.89986957332076,NaN,NaN,NaN,NaN,145.47311053743928,18.303018983039323,8194173,39.65834300748568,78.51093736632902,38.852594358843334
2024-12-26T14:00:00-05:00,22016.75,22061,21979.25,21984,21656.905922756527,NaN,NaN,NaN,NaN,NaN,21859.16,22540.83700386623,21177.48299613377,21864.27431209901,21993.204050442906,22028.78398704041,21957.624113845402,159327,250924.5,57.58373033065115,56.56571042170805,NaN,NaN,NaN,NaN,140.92145978476506,17.60532539564946,8034846,32.22489956068423,79.13371880969862,46.90881924901439
2024-12-26T18:00:00-05:00,21984,22008.75,21950.5,21961.25,21656.905922756527,NaN,NaN,NaN,NaN,NaN,21860.775,22543.028957482005,21178.521042517998,21864.27431209901,21973.5,21973.5,21973.5,46286,230655,56.289680937248235,57.12525121639781,NaN,NaN,NaN,NaN,135.0163555144247,16.72505499101201,7988560,23.996968131030755,76.90502941280283,52.90806128177208
2024-12-26T22:00:00-05:00,21961.25,21967.75,21925,21936.75,21656.905922756527,NaN,NaN,NaN,NaN,NaN,21864.03,22546.149832874067,21181.91016712593,21864.27431209901,21960.99421624024,21975.925642156868,21946.062790323613,32469,227765.16666666666,54.859880960454284,57.306789014117136,NaN,NaN,NaN,NaN,128.42590154910866,15.698314675528366,7956091,15.536013930924256,72.3280786954274,56.79206476450314
2024-12-27T02:00:00-05:00,21936.5,21944.25,21897.75,21925.5,21656.905922756527,NaN,NaN,NaN,NaN,NaN,21867.33,22549.01080096155,21185.649199038453,21864.27431209901,21945.004060453997,21967.144080960257,21922.864039947737,55959,227386.73333333334,54.17934454869969,57.45599936644704,NaN,NaN,NaN,NaN,122.57405143845804,14.636044539851781,7900132,8.182717100159167,67.02046113970209,58.837744039542926
2024-12-27T06:00:00-05:00,21925.75,21955.5,21675.75,21695.75,21656.905922756527,NaN,NaN,NaN,NaN,NaN,21864.915,22548.152781522534,21181.677218477467,21864.27431209901,21828.41839965036,21907.808549864407,21749.028249436313,297729,233650.63333333333,42.566216040494346,56.74577703238126,NaN,NaN,NaN,NaN,133.8009049071396,15.165963737535288,7602403,-12.053659191402758,43.77067005028948,55.82432924169224
2024-12-27T10:00:00-05:00,21694.75,21707.75,21498.25,21668.25,NaN,NaN,NaN,22026.821275342703,22026.821275342703,22026.821275342703,21862.105,22547.396245311033,21176.813754688967,21864.27431209901,21700.62215204758,21810.367964656136,21590.876339439026,728391,245375.66666666666,41.42174262742431,55.91550399825134,NaN,NaN,NaN,NaN,139.2079831280582,16.524487240545245,6874012,-26.369480583409597,22.862478512430243,49.23195909583984
2024-12-27T14:00:00-05:00,21667.25,21733.25,21606.75,21720.25,NaN,NaN,NaN,22026.821275342703,NaN,NaN,21859.25,22545.69100256322,21172.80899743678,21791.74444967921,21698.070716048256,21797.35721069221,21598.7842214043,261626,231902.03333333333,44.46250367928801,55.20854036944434,NaN,NaN,NaN,NaN,138.3002700474826,17.560624062980317,7135638,-31.09034819769463,10.369023848721554,41.459372046416185
2024-12-29T18:00:00-05:00,21710.75,21742.5,21669.75,21690,NaN,NaN,NaN,22026.821275342703,NaN,NaN,21853.635,22540.928388663295,21166.341611336702,21767.330158235753,21700.75,21700.75,21700.75,73452,225212.23333333334,43.0621170926106,54.12200898702211,NaN,NaN,NaN,NaN,133.61810790123383,18.43757086050418,7062186,-34.72795064457303,-1.9505662593001034,32.777384385272924
2024-12-29T22:00:00-05:00,21689.5,21696,21647.5,21656.25,NaN,NaN,NaN,22026.821275342703,NaN,NaN,21844.41,22529.668117500358,21159.151882499642,21767.330158235753,21687.920651385295,21704.46585890935,21671.37544386124,44164,222743.13333333333,41.49193228788182,52.590877428237036,NaN,NaN,NaN,NaN,127.5382430511457,19.367309605818058,7018022,-37.64010413883303,-14.272745788268367,23.367358350564665
2024-12-30T02:00:00-05:00,21655.5,21673,21612.75,21650,NaN,NaN,NaN,22026.821275342703,NaN,NaN,21835.19,22518.254166532184,21152.125833467813,21767.330158235753,21670.77201609677,21695.29544275666,21646.24858943688,79028,223299.83333333334,41.19238646377097,50.980589051382886,NaN,NaN,NaN,NaN,122.73193997606386,20.413240277759872,6938994,-38.1041252194718,-24.26279817377508,13.841327045696715
2024-12-30T06:00:00-05:00,21650.5,21667.5,21282,21289,NaN,NaN,NaN,21900.001829670495,NaN,NaN,21812.615,22491.77177284379,21133.458227156214,21744.689126588604,21499.034266231825,21621.52890507424,21376.53962738941,391773,231008.93333333332,28.42682678587174,48.44875313168753,NaN,NaN,NaN,NaN,141.50108712063073,22.688025881230626,6547221,-59.56184880992366,-60.61098396670786,-1.0491351567842013
2024-12-30T10:00:00-05:00,21288.5,21569.5,21252.75,21542.25,NaN,NaN,NaN,21860.24038286729,NaN,NaN,21795.635,22458.3287015698,21132.941298430196,21735.126301270884,21476.999818891378,21566.516890483937,21387.482747298818,584912,233662.16666666666,42.0049759475736,47.43465829629336,NaN,NaN,NaN,NaN,154.01886661201428,24.887836613343197,7132133,-53.717415588543496,-68.19590464246357,-14.478489053920077
2024-12-30T14:00:00-05:00,21542.5,21548.5,21350.75,21389,NaN,NaN,NaN,21860.24038286729,NaN,NaN,21775.255,22423.89238321175,21126.61761678825,21734.901041016707,21469.438008548965,21553.35751073075,21385.518506367178,221694,211763.73333333334,37.38326059845328,46.02488436730137,NaN,NaN,NaN,NaN,157.14251899687042,26.930518007447724,6910439,-56.8863417409472,-85.58641623010408,-28.70007448915688
2024-12-30T18:00:00-05:00,21391.25,21455,21343.25,21421.5,NaN,NaN,NaN,21849.318458356352,NaN,NaN,21757.55,22395.42854643338,21119.671453566618,21648.145832813363,21406.583333333332,21406.583333333332,21406.583333333332,47554,201168.53333333333,38.91816761548959,44.560197565422264,NaN,NaN,NaN,NaN,153.90019621137967,28.852456972711476,6957993,-53.55476005186114,-95.6435245539833,-42.08876450212216
2024-12-30T22:00:00-05:00,21422,21428.75,21370.25,21379.5,NaN,NaN,NaN,21837.207392067427,NaN,NaN,21738.975,22365.61765933646,21112.332340663535,21431.119666400442,21399.72841511039,21406.603385780505,21392.853444440272,47277,199065.5,37.6342833238775,43.135237064938444,NaN,NaN,NaN,NaN,147.0858964819954,30.637114583313537,6910716,-50.955786824053895,-105.78349803218953,-54.82771120813563
2024-12-31T02:00:00-05:00,21379.5,21511,21360,21496.75,NaN,NaN,NaN,21837.207392067427,NaN,NaN,21722.83,22331.756887564992,21113.90311243501,21431.119666400442,21424.423336150663,21452.782061649505,21396.06461065182,74360,199864.36666666667,43.26157022865098,42.204657728610066,NaN,NaN,NaN,NaN,147.36547530471003,31.328811025754217,6985076,-38.67313934956208,-103.16913539508823,-64.49599604552616
2024-12-31T06:00:00-05:00,21497,21524.75,21367.75,21434.25,NaN,NaN,NaN,21837.207392067427,NaN,NaN,21705.045,22294.387554801684,21115.702445198312,21431.119666400442,21435.66214496388,21454.929699700308,21416.394590227454,288638,205835.96666666667,41.131100724933084,41.22403056892998,NaN,NaN,NaN,NaN,148.0536556400879,31.815022904305145,6696438,-32.347910301798464,-104.93088392277423,-72.58297362097576
2024-12-31T10:00:00-05:00,21434,21468.75,21203,21220,NaN,NaN,NaN,21792.003114006053,NaN,NaN,21682.71,22259.10104226231,21106.318957737687,21424.191586496283,21355.30188917919,21424.73363323586,21285.87014512252,633765,215385.8,34.80371705588195,39.84005717658585,NaN,NaN,NaN,NaN,156.4605373800816,33.00584888390593,6062673,-39.69885772160376,-122.20654577298046,-82.5076880513767
2024-12-31T14:00:00-05:00,21220.25,21316,21181.75,21235,NaN,NaN,NaN,21702.576836096687,NaN,NaN,21660.035,22215.510904158007,21104.559095841993,21424.191586496283,21333.00938650539,21409.375069142247,21256.643703868533,274161,203577.2,35.55123827771544,39.33898733638737,NaN,NaN,NaN,NaN,154.8740704243615,34.195189124817425,6336834,-40.515737631902724,-133.1523600912551,-92.63662245935238
2025-01-01T18:00:00-05:00,21273.25,21333,21121,21322.25,NaN,NaN,NaN,21688.988116274108,NaN,NaN,21640.715,22174.209142516953,21107.220857483047,21275.703269197027,21258.75,21258.75,21258.75,131528,200640.8,39.86992124050614,39.228142951607495,NaN,NaN,NaN,NaN,158.95449396547852,35.53459777437744,6468362,-32.49119864605797,-133.25062076692484,-100.75942212086687
2025-01-01T22:00:00-05:00,21321.75,21396.75,21287.5,21389.25,NaN,NaN,NaN,21688.988116274108,NaN,NaN,21622.625,22126.856496933615,21118.393503066385,21143.419317800384,21291.840328169914,21338.57072724639,21245.109929093436,65951,201337.9,43.02709965688854,39.12561409286468,NaN,NaN,NaN,NaN,155.40417296794433,36.02692563242133,6534313,-20.56394285472092,-126.46435068926803,-105.90040783454711
2025-01-02T02:00:00-05:00,21389.5,21424.5,21318,21397.25,NaN,NaN,NaN,21688.988116274108,NaN,NaN,21621.38,22127.5202299756,21115.239770024404,21143.419317800384,21325.452030015233,21381.85259713242,21269.051462898045,121870,204461.4,43.40917869959719,39.15040420764943,NaN,NaN,NaN,NaN,151.9110177559483,36.166316325951655,6656183,-10.534159015144425,-119.06810660347764,-108.53394758833322
2025-01-02T06:00:00-05:00,21398,21490.75,21166.5,21391.5,NaN,NaN,NaN,21688.988116274108,NaN,NaN,21619.96,22128.26898437893,21111.651015621068,21143.419317800384,21339.451586993775,21377.888830600292,21301.014343387258,441261,217057.56666666668,43.18500718534645,39.27133812889691,NaN,NaN,NaN,NaN,164.22094505909484,36.98309807082819,6214922,-3.072935075348269,-112.37511643251855,-109.30218135717028
2025-01-02T10:00:00-05:00,21392.25,21444,20983.25,21048,NaN,NaN,NaN,21688.988116274108,NaN,NaN,21611.17,22142.993630915716,21079.34636908428,21143.419317800384,21240.25147720927,21333.984471080923,21146.518483337615,922011,241226.3,32.41551245368619,38.64441855674799,NaN,NaN,NaN,NaN,185.40159184058805,38.37079486363984,5292911,-19.160176521258933,-133.25240200874396,-114.09222548748502
2025-01-02T14:00:00-05:00,21048.5,21203.25,21027.75,21183,NaN,NaN,NaN,21630.804243184848,NaN,NaN,21603.54,22148.604788442408,21058.475211557594,21143.419317800384,21224.73495014624,21318.535027471786,21130.934872820697,301014,240730.46666666667,38.86793914691837,39.39021229682276,NaN,NaN,NaN,NaN,184.69433528054606,39.65937045696494,5593925,-18.58339802709881,-137.32147302135854,-118.73807499425973
2025-01-02T18:00:00-05:00,21191.5,21249.75,21144.25,21242.5,NaN,NaN,NaN,21630.804243184848,NaN,NaN,21596.815,22151.15564265597,21042.47435734403,21143.419317800384,21212.166666666668,21212.166666666668,21212.166666666668,58107,241297.8,41.518060152135796,39.355432597148635,NaN,NaN,NaN,NaN,179.03759704622135,40.329186197728816,5652032,-12.368048647055346,-134.1981358030789,-121.83008715602357
2025-01-02T22:00:00-05:00,21242.5,21260,21206,21237.25,NaN,NaN,NaN,21630.804243184848,NaN,NaN,21589.61,22153.018219322334,21026.201780677668,21045.96196205683,21220.771487247144,21231.6072761242,21209.93569837009,36643,241216.53333333333,41.34773631728161,39.638609434207794,NaN,NaN,NaN,NaN,170.1063401143484,40.83333566132026,5615389,-7.048375605416794,-130.64055666279455,-123.59218105737776
2025-01-03T02:00:00-05:00,21237.25,21287.75,21210.5,21238,NaN,NaN,NaN,21630.804243184848,NaN,NaN,21586.2,22155.9794397832,21016.4205602168,21045.96196205683,21232.330082886398,21246.945468741258,21217.714697031537,83687,240468.26666666666,41.38473069963979,39.8147925116471,NaN,NaN,NaN,NaN,163.47374439189494,40.97237670864494,5699076,-2.16999053509241,-126.30466922624328,-124.13467869115087
2025-01-03T06:00:00-05:00,21238,21434.5,21208.25,21383.5,NaN,NaN,NaN,21630.804243184848,NaN,NaN,21588.8,22153.648130031503,21023.951869968496,21045.96196205683,21302.80267346214,21356.138033652893,21249.46731327139,320130,242358.8,48.209493673074455,40.570164679446876,NaN,NaN,NaN,NaN,167.95776264961674,39.560227597883426,6019206,11.418623462425629,-109.86139936311884,-121.28002282554446
2025-01-03T10:00:00-05:00,21386.25,21531.25,21260.75,21508.75,NaN,NaN,NaN,21630.804243184848,NaN,NaN,21593.105,22152.136082230703,21034.073917769296,21058.696034932113,21377.29176188466,21450.895617463844,21303.687906305473,659740,249483.56666666668,53.255069644906854,41.2839860663223,NaN,NaN,NaN,NaN,175.28220817464413,37.41004270213579,6678946,28.435969561534023,-85.73506087362694,-114.17103043516096
2025-01-03T14:00:00-05:00,21509,21559.25,21474.75,21490.25,NaN,NaN,NaN,21630.804243184848,NaN,NaN,21600.83,22143.03428290433,21058.625717095674,21138.95682794569,21395.38028295884,21477.27602803051,21313.48453788717,185905,250369.5,52.4423856440373,42.09193498911545,NaN,NaN,NaN,NaN,168.79776473359811,35.18424113770383,6493041,37.471700613566696,-67.3314046682026,-104.80310528176929
2025-01-05T18:00:00-05:00,21532,21543,21478.75,21510,NaN,NaN,NaN,21630.804243184848,NaN,NaN,21606.425,22138.904025408647,21073.945974591352,21174.64046235655,21510.583333333332,21510.583333333332,21510.583333333332,74767,251318.86666666667,53.262373576146246,43.41041045484862,NaN,NaN,NaN,NaN,161.33006725262683,33.11742539930272,6567808,43.38666208667102,-50.56977767343051,-93.95643976010153
2025-01-05T22:00:00-05:00,21510.25,21555.75,21500.5,21549.75,NaN,NaN,NaN,21630.804243184848,NaN,NaN,21604.085,22136.511376225004,21071.658623774994,21233.437369885243,21517.982992511606,21529.313773986818,21506.652211036395,31887,251299.46666666667,54.94611113526957,44.79575851610249,NaN,NaN,NaN,NaN,153.75291959172492,31.0825363840643,6599695,48.212979889864016,-33.69021489777151,-81.90319478763553
2025-01-06T02:00:00-05:00,21549.25,21692.75,21539.75,21671,21152.889705431342,21152.889705431342,21152.889705431342,NaN,NaN,NaN,21606.445,22138.99077540351,21073.89922459649,21358.399895908195,21569.640554404425,21628.13796896373,21511.14313984512,84945,252265.66666666666,59.71365710626555,46.213168220799595,NaN,NaN,NaN,NaN,153.69913962088745,29.652455978372938,6684640,57.195205844420656,-10.4091874821097,-67.60439332653036
2025-01-06T06:00:00-05:00,21670.75,21848,21641.25,21818.75,21274.133355184462,NaN,NaN,NaN,NaN,NaN,21609.335,22144.881138161807,21073.78886183819,21477.144916726553,21705.86773056586,21804.52516945103,21607.21029168069,411262,256050.1,64.6258860736885,47.755938679142446,NaN,NaN,NaN,NaN,157.48848679082406,29.30729181211308,7095902,69.8722200356179,19.735881717992015,-50.136338317625885
2025-01-06T10:00:00-05:00,21818.5,21897,21701.5,21707,21323.485248130622,NaN,NaN,NaN,NaN,NaN,21608.835,22143.968633870958,21073.70136612904,21502.565933381244,21737.591459892392,21813.64300523247,21661.539914552315,618761,252395.76666666666,58.78728398261256,48.8543747707864,NaN,NaN,NaN,NaN,160.20359487719378,29.255041785573237,6477141,67.48056919807938,34.214373179973336,-33.266196018106044
2025-01-06T14:00:00-05:00,21707.25,21786.5,21646.5,21781,21323.485248130622,NaN,NaN,NaN,NaN,NaN,21611.975,22149.26582674131,21074.684173258687,21502.565933381244,21737.668015949035,21806.224806470465,21669.111225427605,281708,253065.16666666666,61.28180054531605,50.147002867927085,NaN,NaN,NaN,NaN,158.76048095739424,28.683525354380645,6758849,67.46987452501727,51.07114713816554,-16.398727386851725
2025-01-06T18:00:00-05:00,21781,21796.75,21734,21738.25,21323.485248130622,NaN,NaN,NaN,NaN,NaN,21614.145,22152.580651587148,21075.709348412853,21502.565933381244,21756.333333333332,21756.333333333332,21756.333333333332,51250,252325.1,59.057866063422516,52.05002812576539,NaN,NaN,NaN,NaN,151.9025894604375,28.21639113163712,6707599,61.34758793898815,60.285757536883466,-1.0618304021046843
2025-01-06T22:00:00-05:00,21738.25,21753,21659,21690,21323.485248130622,NaN,NaN,NaN,NaN,NaN,21613.045,22150.630887929055,21075.45911207094,21502.565933381244,21726.339245487892,21754.088580336116,21698.58991063967,59877,252848.86666666667,56.56288140997984,53.313952573126926,NaN,NaN,NaN,NaN,147.7666902132634,27.069278956376415,6647722,51.22479360931041,62.96916160953333,11.74436800022292
2025-01-07T02:00:00-05:00,21689.5,21774.75,21688.25,21767.75,21323.485248130622,NaN,NaN,NaN,NaN,NaN,21613.625,22151.814364907947,21075.435635092053,21502.565933381244,21733.690232439676,21756.372719557567,21711.007745321785,82572,252967,59.52984845259207,54.60050888030237,NaN,NaN,NaN,NaN,143.39049805517314,26.160334901416093,6730294,47.0494861091913,70.55622563671204,23.506739527520743
2025-01-07T06:00:00-05:00,21767.75,21806.25,21695,21711.5,21323.485248130622,NaN,NaN,NaN,NaN,NaN,21612.845,22150.351222196317,21075.338777803685,21511.960845050366,21736.09145705728,21750.25980865173,21721.92310546283,311765,250300.06666666668,56.52186784936969,55.68437541830866,NaN,NaN,NaN,NaN,141.09474819408936,25.545037181588597,6418529,38.162022402857275,71.20926753109234,33.04724512823506
2025-01-07T10:00:00-05:00,21712.25,21712.25,21386.75,21439.5,21323.485248130622,NaN,NaN,NaN,NaN,NaN,21606.34,22144.207593000167,21068.472406999834,21511.960845050366,21586.535319974762,21691.83894499117,21481.231694958355,1025688,264992.6,44.74744651068069,55.924569404811585,NaN,NaN,NaN,NaN,154.26655189451157,24.840021699687608,5392841,12.931326072326762,49.21140271864351,36.28007664631675
2025-01-07T14:00:00-05:00,21439.5,21474.75,21279.5,21375.25,NaN,NaN,NaN,21845.59760527321,21845.59760527321,21845.59760527321,21597.875,22136.700660580464,21059.049339419536,21511.960845050366,21552.716310540178,21676.259151984133,21429.173469096222,293855,267397.9666666667,42.495515504575415,55.51642810706165,NaN,NaN,NaN,NaN,157.1939410449036,24.762127726371936,5098986,-7.991710502361656,26.29043851836468,34.28214902072634
2025-01-07T18:00:00-05:00,21386.25,21437,21344.75,21419,NaN,NaN,NaN,21845.59760527321,NaN,NaN,21588.185,22122.080755836167,21054.289244163836,21511.960845050366,21400.25,21400.25,21400.25,57086,267715.7,44.54214623129949,54.89407643466113,NaN,NaN,NaN,NaN,152.55508811312478,24.6897976082931,5156072,-18.207446827301624,11.522840486599307,29.73028731390093
2025-01-07T22:00:00-05:00,21418.75,21434.75,21384.25,21399.5,NaN,NaN,NaN,21845.59760527321,NaN,NaN,21575.25,22095.28624873661,21055.21375126339,21511.960845050366,21402.737399273723,21405.658008325765,21399.81679022168,41407,267520.0333333333,43.79398791619187,54.27633373981503,NaN,NaN,NaN,NaN,145.2654389621873,24.622633927219898,5114665,-25.17149779388228,-1.7340849284519209,23.43741286543036
2025-01-08T02:00:00-05:00,21399.75,21448.25,21360.25,21444.25,NaN,NaN,NaN,21841.735025116002,NaN,NaN,21562.68,22064.05616656559,21061.30383343441,21511.960845050366,21408.970687356676,21416.627947324585,21401.313427388766,71283,267417.4666666667,46.03417505539573,53.76003384547571,NaN,NaN,NaN,NaN,141.1750504648882,24.702232464981787,5185948,-25.57473247880953,-8.53100273308155,17.04372974572798
2025-01-08T06:00:00-05:00,21443.5,21447.75,21221.25,21344.25,NaN,NaN,NaN,21782.985705792547,NaN,NaN,21548.025,22030.90584710403,21065.144152895973,21511.960845050366,21354.628912486223,21385.143268308293,21324.114556664153,546595,276016.0333333333,42.00518603885935,52.83568205287498,NaN,NaN,NaN,NaN,147.26968971739618,25.51792970984087,4639353,-31.023953243082797,-21.736211808125518,9.28774143495728
2025-01-08T10:00:00-05:00,21344,21418.75,21166,21324.5,NaN,NaN,NaN,21754.9409009838,NaN,NaN,21535.845,22009.860082987758,21061.829917012245,21511.960845050366,21327.498042345287,21360.71584954455,21294.280235146023,796068,281426.13333333336,41.23754132146417,51.515959496817736,NaN,NaN,NaN,NaN,154.803997594725,26.533060435937344,3843285,-34.15816578171251,-33.40996579218336,0.7481999895291516
2025-01-08T14:00:00-05:00,21325.5,21431.5,21286.75,21326.5,NaN,NaN,NaN,21754.9409009838,NaN,NaN,21523.23,21985.131719416608,21061.32828058339,21511.960845050366,21331.27981423277,21362.36865114329,21300.19097732225,337044,283522.23333333334,41.35442132287663,49.85371201461688,NaN,NaN,NaN,NaN,154.0858549093875,27.33752987717633,4180329,-34.21118785601952,-42.01578483049525,-7.80459697447573
2025-01-08T18:00:00-05:00,21348.75,21348.75,21271.25,21344.5,NaN,NaN,NaN,21754.9409009838,NaN,NaN,21509.78,21952.13781489669,21067.422185103307,21511.960845050366,21321.5,21321.5,21321.5,52130,280875.63333333336,42.46362158678757,48.687736129200815,NaN,NaN,NaN,NaN,148.6154367015741,28.16362245204578,4232459,-31.231143096699483,-46.84352584535009,-15.612382748650603
2025-01-08T22:00:00-05:00,21344.5,21344.75,21293.75,21315.25,NaN,NaN,NaN,21754.9409009838,NaN,NaN,21496.405,21920.670788038835,21072.139211961163,21314.068676040293,21320.008482642777,21321.774829097692,21318.242136187862,37170,279916.26666666666,41.10315495212308,47.246404301115604,NaN,NaN,NaN,NaN,141.64290550860454,28.93070841442455,4195289,-29.450452199762537,-52.425447998353775,-22.974995798591237
2025-01-09T02:00:00-05:00,21315.25,21335,21217.5,21327.25,NaN,NaN,NaN,21709.733433676105,NaN,NaN,21483.725,21889.139519350407,21078.31048064959,21141.450929706105,21307.166580277688,21320.595579032968,21293.737581522408,82404,278600.73333333334,41.925205652660686,46.022642843204046,NaN,NaN,NaN,NaN,139.91841225798993,30.04532004677083,4277693,-25.815237657432,-55.244042870381236,-29.428805212949236
2025-01-09T06:00:00-05:00,21327,21334.25,21264.75,21301.75,NaN,NaN,NaN,21709.733433676105,NaN,NaN,21471.025,21858.254173099922,21083.79582690008,21141.450929706105,21304.62695840136,21315.817915812935,21293.436000989786,99627,267212.93333333335,40.62751710482527,44.884402535693006,NaN,NaN,NaN,NaN,134.8885256681335,31.08031656252094,4178066,-23.542531820135885,-58.85696998811909,-35.314438167983205
2025-01-09T18:00:00-05:00,21302,21309,21179,21273.25,NaN,NaN,NaN,21665.745236056122,NaN,NaN,21457.98,21826.587024349887,21089.372975650112,21141.450929706105,21253.75,21253.75,21253.75,106158,240017.83333333334,39.16830180083082,43.43000634628148,NaN,NaN,NaN,NaN,134.53934526326682,32.46660928297799,4071908,-22.380753837704745,-63.29038046511414,-40.909626627409395
2025-01-09T22:00:00-05:00,21273.75,21328,21241,21245.5,NaN,NaN,NaN,21665.745236056122,NaN,NaN,21448.975,21815.90255756446,21082.047442435538,21141.450929706105,21260.802902055624,21269.48884380415,21252.1169603071,69993,232317.13333333333,37.74669075916292,42.088922268409576,NaN,NaN,NaN,NaN,131.14367774446205,33.485454346960815,4001915,-21.877312721021518,-68.2562675286863,-46.378954807664776
2025-01-10T02:00:00-05:00,21245.25,21321.75,21233.5,21315.75,NaN,NaN,NaN,21665.745236056122,NaN,NaN,21441.925,21805.257371940494,21078.592628059505,21089.060743764883,21270.50065132712,21286.0891645694,21254.912138084837,86134,233251.36666666667,43.35198912528107,41.98924674088103,NaN,NaN,NaN,NaN,128.07984361985763,34.47149237490059,4088049,-15.508901737769307,-65.76508197987641,-50.256180242107106
2025-01-10T06:00:00-05:00,21316.75,21372.5,21010,21054.75,NaN,NaN,NaN,21629.787578053692,NaN,NaN,21428.615,21798.88106933333,21058.348930666674,21056.332278650112,21184.81048314732,21243.318476362023,21126.30248993262,575396,251209.8,31.870387030308166,41.23030899271908,NaN,NaN,NaN,NaN,144.82414050415352,36.33630285853918,3512653,-26.902537107954245,-83.88435162704991,-56.981814519095664
2025-01-10T10:00:00-05:00,21054,21175.75,20874.75,21168.25,NaN,NaN,NaN,21484.89950632398,NaN,NaN,21418.18,21787.799845787522,21048.56015421248,21056.332278650112,21125.022335271588,21193.647246211116,21056.39742433206,961189,280459.86666666664,39.3881871400265,40.86216905762815,NaN,NaN,NaN,NaN,155.97955903957111,38.46526430309193,4473842,-24.870774407649165,-88.07028252865712,-63.19950812100795
2025-01-10T14:00:00-05:00,21167.75,21171.25,20982,20996.25,NaN,NaN,NaN,21484.89950632398,NaN,NaN,21404.98,21786.594567856468,21023.36543214353,21056.332278650112,21112.707976108406,21181.354486044813,21044.061466172,352319,281532.8333333333,33.37747886170797,40.11813269659359,NaN,NaN,NaN,NaN,158.35601910817317,40.442157073033776,4121523,-32.693998142250365,-104.0670057988209,-71.37300765657054
2025-01-12T18:00:00-05:00,21027.5,21037,20888.75,20925.5,NaN,NaN,NaN,21426.53756671255,NaN,NaN,21390.49,21788.458767115964,20992.52123288404,21056.332278650112,20950.416666666668,20950.416666666668,20950.416666666668,116574,263427.3,31.264050268136288,39.06312378321792,NaN,NaN,NaN,NaN,157.6341606004465,42.52306501736759,4004949,-39.74797543938564,-121.05797695580259,-81.31000151641695
2025-01-12T22:00:00-05:00,20925,20937,20857.25,20906.25,NaN,NaN,NaN,21350.586995498346,NaN,NaN,21382.835,21802.453631736174,20963.216368263824,21056.332278650112,20929.806823625055,20954.522789772538,20905.09085747757,81058,259932.4,30.694562410431047,38.25522209547304,NaN,NaN,NaN,NaN,152.07100627184317,44.53264786318868,3923891,-42.572819463407626,-134.5260258456765,-91.95320638226886
2025-01-13T02:00:00-05:00,20906,20916.25,20693.5,20750.5,NaN,NaN,NaN,21268.100086612056,NaN,NaN,21367,21819.804107755157,20914.195892244843,21056.332278650112,20864.194554773665,20937.760956480786,20790.628153066544,167437,263021.4,26.49014714755785,37.201836797336874,NaN,NaN,NaN,NaN,157.11950582385438,46.74677848124069,3756454,-51.21292073615848,-155.96935730246696,-104.75643656630848
2025-01-13T06:00:00-05:00,20751.25,20845.75,20701.5,20801.5,NaN,NaN,NaN,21235.464855402417,NaN,NaN,21355.25,21834.857975329793,20875.642024670207,21056.332278650112,20819.526574393498,20883.346780259802,20755.706368527193,445423,276805.93333333335,29.877261283526707,36.38203965166902,NaN,NaN,NaN,NaN,156.20025540786477,48.80275691228898,4201877,-49.733957606380045,-166.92388357428354,-117.18992596790349
2025-01-13T10:00:00-05:00,20801.5,20913.75,20714,20892.25,NaN,NaN,NaN,21235.464855402417,NaN,NaN,21344.665,21841.025792266988,20848.304207733014,21056.332278650112,20829.876131039975,20875.906963582525,20783.845298497425,828560,301593.1,35.56653592815974,35.88939067605275,NaN,NaN,NaN,NaN,159.31095145016016,49.7832962741311,5030437,-39.33998475280059,-166.36490690890423,-127.02492215610364
2025-01-13T14:00:00-05:00,20891.75,20996,20834.5,20992.5,NaN,NaN,NaN,21235.464855402417,NaN,NaN,21336.925,21842.848850495422,20831.001149504576,21056.332278650112,20845.638347707914,20903.269978694032,20788.006716721797,270917,296914.93333333335,41.23826016343824,35.89904104828955,NaN,NaN,NaN,NaN,159.467312060863,49.67234901562976,5301354,-23.207194159813525,-156.03391485587053,-132.826720696057
2025-01-13T18:00:00-05:00,21020,21088.75,20997.25,21043.25,NaN,NaN,NaN,21235.464855402417,NaN,NaN,21327.855,21838.233252769518,20817.47674723048,20978.91582292009,21043.083333333332,21043.083333333332,21043.083333333332,77021,278856.93333333335,43.92903883051143,36.04217198956461,NaN,NaN,NaN,NaN,154.95178977080135,48.547229219509376,5378375,-7.429211797348586,-142.11323544274273,-134.68402364539415
2025-01-13T22:00:00-05:00,21042.25,21067.75,21013,21046.5,NaN,NaN,NaN,21235.464855402417,NaN,NaN,21320.1,21835.534438120234,20804.665561879763,20728.687120876468,21042.82817287631,21043.152210124605,21042.504135628016,47758,271058.6,44.10555478987851,36.290603252782695,NaN,NaN,NaN,NaN,147.79451907288697,47.50247512311187,5426133,4.2848693778044264,-129.32793692313862,-133.61280630094305
2025-01-14T02:00:00-05:00,21046,21143.75,21021.25,21095,NaN,NaN,NaN,21235.464855402417,NaN,NaN,21317.6,21836.15535866513,20799.044641334865,20811.249696701176,21061.522569803554,21083.204681124305,21039.840458482802,92772,272442.6666666667,46.79723370034448,36.83552695989081,NaN,NaN,NaN,NaN,145.9877677105379,45.72853529598599,5518905,15.715687731494313,-113.96819663657516,-129.68388436806947
2025-01-14T06:00:00-05:00,21095.5,21139,20944,20980.75,NaN,NaN,NaN,21235.464855402417,NaN,NaN,21312.515,21839.13425914292,20785.89574085708,20811.249696701176,21034.234260963553,21056.726209503762,21011.742312423343,457215,285687.26666666666,41.702558981261404,37.118088975754986,NaN,NaN,NaN,NaN,149.48864144549947,44.5465951360703,5061690,15.947596032151068,-109.74938932788064,-125.6969853600317
2025-01-14T10:00:00-05:00,20980.75,21110.25,20791.5,20997.25,NaN,NaN,NaN,21235.464855402417,NaN,NaN,21306.015,21839.965020226806,20772.064979773193,20811.249696701176,20996.92939642922,21033.933913746554,20959.924879111884,822722,310358.93333333335,42.67321704945048,37.0696052560528,NaN,NaN,NaN,NaN,161.57873848510664,44.21736190999006,5884412,17.455899201109787,-103.87711135864447,-121.33301055975426
2025-01-14T14:00:00-05:00,20997.25,21013,20773.25,20976.75,NaN,NaN,NaN,21235.464855402417,NaN,NaN,21297.765,21839.012969141888,20756.51703085811,20811.249696701176,20982.130017069663,21026.93095471566,20937.329079423667,362537,312051.3333333333,41.743270788816424,37.774811238803395,NaN,NaN,NaN,NaN,167.16240002188474,43.994009282812435,5521875,17.284115114675657,-99.72786666640968,-117.01198178108534
2025-01-14T18:00:00-05:00,20975.75,20975.75,20932,20937.5,NaN,NaN,NaN,21235.464855402417,NaN,NaN,21288.57,21838.29962481583,20738.84037518417,20811.249696701176,20948.416666666668,20948.416666666668,20948.416666666668,41591,279248.1,39.94824514451498,37.814815381981134,NaN,NaN,NaN,NaN,158.4186571631787,43.78661041471892,5480284,14.832314899785558,-98.47158815635339,-113.30390305613895
2025-01-14T22:00:00-05:00,20937.25,20957,20926.75,20948,NaN,NaN,NaN,21235.464855402417,NaN,NaN,21279.7,21836.763210057743,20722.63678994226,20811.249696701176,20946.78031554896,20948.945017625472,20944.615613472448,23766,270245.13333333336,40.683092280944,38.33664491192657,NaN,NaN,NaN,NaN,149.26375308009452,43.62080579862378,5504050,14.221095094507788,-95.52753418800421,-109.748629282512
2025-01-15T02:00:00-05:00,20947.5,20971.5,20908.75,20965,NaN,NaN,NaN,21235.464855402417,NaN,NaN,21278.04,21838.340360163987,20717.739639836014,20811.249696701176,20947.54907627492,20949.324306902043,20945.7738456478,57912,270272.6666666667,41.92224666201388,39.0979446543464,NaN,NaN,NaN,NaN,143.0841992886592,43.56283943778176,5561962,15.177958646657899,-90.77618097418963,-105.95413962084753
2025-01-15T06:00:00-05:00,20965.25,21346.5,20957.5,21327.25,20679.744978608534,20679.744978608534,20679.744978608534,NaN,NaN,NaN,21280.925,21840.72346596788,20721.12653403212,20909.149792393626,21155.542575846102,21262.379423679904,21048.7057280123,467236,284466.9666666667,60.742155656540426,41.244201314782785,NaN,NaN,NaN,NaN,160.64961362518352,40.861482208070214,6029198,39.065960894981714,-57.12168850212038,-96.18764939710209
2025-01-15T10:00:00-05:00,21327.75,21408.5,21246.25,21380.5,20854.461115944512,NaN,NaN,NaN,NaN,NaN,21283.685,21844.058935956924,20723.31106404308,20977.4948339149,21257.77675379272,21376.870429957886,21138.683077627556,691469,305139.8333333333,62.65775230196052,43.8276016829544,NaN,NaN,NaN,NaN,160.76392693767042,38.73737212135718,6720667,56.265810730403544,-25.855385984097666,-82.12119671450121
2025-01-15T14:00:00-05:00,21380.75,21452.75,21369.75,21375.75,20948.514019765214,NaN,NaN,NaN,NaN,NaN,21286.455,21847.25250079643,20725.657499203575,21066.44586713192,21278.255730130375,21399.1435530901,21157.36790717065,216683,294142.76666666666,62.36541775888924,46.14818428833745,NaN,NaN,NaN,NaN,155.2093607278368,37.03179080835482,6503984,64.54234598920617,-1.4432642279934953,-65.98561021719966
2025-01-15T18:00:00-05:00,21386.25,21448,21377,21398.5,20960.94520068498,NaN,NaN,NaN,NaN,NaN,21289.665,21851.153304508505,20728.176695491497,21102.831693705535,21407.833333333332,21407.833333333332,21407.833333333332,57045,269508.6666666667,63.24979501450773,48.125559937362304,NaN,NaN,NaN,NaN,149.2836921044199,35.44803673199547,6561029,68.39993158302522,19.514304261581856,-48.88562732144336
2025-01-15T22:00:00-05:00,21398,21456.75,21352.75,21440.75,20960.94520068498,NaN,NaN,NaN,NaN,NaN,21290.81,21853.29164912278,20728.328350877222,21128.61535496443,21412.621471299633,21417.067589264683,21408.175353334584,66159,260479.16666666666,64.89945456657856,49.81564525187232,NaN,NaN,NaN,NaN,146.04914266838992,33.76395758369938,6627188,70.37413128941195,39.08203679032158,-31.292094499090368
2025-01-16T02:00:00-05:00,21440.75,21566.75,21432,21498.25,21056.025482442303,NaN,NaN,NaN,NaN,NaN,21290.6,21852.76377506927,20728.436224930727,21236.867283971544,21458.916760514046,21502.100534373283,21415.73298665481,142298,263484.76666666666,67.0661734528934,51.46829772489961,NaN,NaN,NaN,NaN,145.24206104921922,32.910002026113894,6769486,71.87719289076868,58.55439661437049,-13.322796276398197
2025-01-16T06:00:00-05:00,21498.25,21519,21369.5,21378,21056.025482442303,NaN,NaN,NaN,NaN,NaN,21288.355,21848.20340885729,20728.50659114271,21236.867283971544,21437.73647214297,21471.20053651457,21404.27240777137,361174,274284.9,58.88037256112258,52.52364185141704,NaN,NaN,NaN,NaN,145.54619954570356,31.555466032473067,6408312,61.4987488770731,63.55063981994317,2.0518909428700773
2025-01-16T10:00:00-05:00,21377.75,21474.5,21262.25,21290.75,21056.025482442303,NaN,NaN,NaN,NaN,NaN,21283.97,21840.228632651862,20727.71136734814,21236.867283971544,21386.124113494618,21438.702626886614,21333.54560010262,741430,296252.43333333335,53.753748860995785,53.02053579146356,NaN,NaN,NaN,NaN,150.31075672101045,29.43032842181458,5666882,46.183077329017465,59.780737604141905,13.597660275124444
2025-01-16T14:00:00-05:00,21290,21395.75,21171.75,21214,21056.025482442303,NaN,NaN,NaN,NaN,NaN,21277.255,21828.602299711947,20725.907700288055,21236.867283971544,21365.023786551053,21432.14792294501,21297.8996501571,276181,302137.56666666665,49.65787429381032,53.58877259950277,NaN,NaN,NaN,NaN,155.57427409808113,27.841360936504767,5390701,29.140544917886196,50.02334142248219,20.882796504595994
2025-01-16T18:00:00-05:00,21225,21283.75,21208.75,21258,21056.025482442303,NaN,NaN,NaN,NaN,NaN,21268.995,21808.75215363503,20729.23784636497,21236.867283971544,21250.166666666668,21250.166666666668,21250.166666666668,48055,300200.8,51.91972436906186,54.24923740804644,NaN,NaN,NaN,NaN,149.81896880536104,26.365891128717085,5438756,19.54861299266682,45.31856274542952,25.7699497527627
2025-01-16T22:00:00-05:00,21258,21309.75,21246,21288,21056.025482442303,NaN,NaN,NaN,NaN,NaN,21258.38,21774.846380706338,20741.913619293664,21236.867283971544,21265.41942660421,21280.958407765982,21249.88044544244,46301,299411.06666666665,53.45524711960209,55.0858071459597,NaN,NaN,NaN,NaN,143.67118531926383,24.777024087372297,5485057,14.191395494596623,43.50919412100848,29.317798626411854
2025-01-17T02:00:00-05:00,21288.75,21356.5,21251.5,21333.75,21056.025482442303,NaN,NaN,NaN,NaN,NaN,21250.915,21751.782523502894,20750.047476497108,21236.867283971544,21286.98108252348,21313.718392149927,21260.243772897036,75531,299057.63333333336,55.7748475081776,56.21627874336417,NaN,NaN,NaN,NaN,140.90895779645925,23.10279801814594,5560588,12.742032297215282,45.24533899793096,32.503306700715676
2025-01-17T06:00:00-05:00,21334.25,21680,21306.75,21506,21056.025482442303,NaN,NaN,NaN,NaN,NaN,21245.415,21728.60599339693,20762.22400660307,21242.34807623155,21443.067240571043,21536.310261192408,21349.824219949678,486407,296091.3333333333,63.20907670774383,57.82527763099273,NaN,NaN,NaN,NaN,157.5047465252836,23.528188050501544,6046995,21.86190728543555,59.83069080751011,37.96878352207456
2025-01-17T10:00:00-05:00,21505.75,21672.5,21481,21632,21106.557859431705,NaN,NaN,NaN,NaN,NaN,21243.29,21718.663961844504,20767.916038155498,21242.34807623155,21516.403729857266,21617.78627365107,21415.021186063463,611078,284420.9666666667,67.51131742482605,59.653068399765026,NaN,NaN,NaN,NaN,159.93297891633478,23.92319308054603,6658073,34.12690243097694,80.62741156079574,46.500509129818795
2025-01-17T14:00:00-05:00,21632,21645,21572,21590.25,21149.72568400299,NaN,NaN,NaN,NaN,NaN,21241.295,21709.943052274113,20772.646947725883,21251.80276878819,21529.848395584097,21628.069872037708,21431.626919130485,234805,280503.8333333333,64.80706641639506,59.94341916832608,NaN,NaN,NaN,NaN,153.72348042231084,24.289983465587344,6423268,36.937051428339466,92.67182341524313,55.73477198690366
2025-01-19T18:00:00-05:00,21601,21618.75,21527.25,21560.75,21149.72568400299,NaN,NaN,NaN,NaN,NaN,21237.155,21690.535821054717,20783.77417894528,21258.442215030555,21568.916666666668,21568.916666666668,21568.916666666668,77847,279212.93333333335,62.890149611083295,59.96001897612056,NaN,NaN,NaN,NaN,149.2789461064315,24.203804916813265,6345421,34.37135274679993,98.69896292040357,64.32761017360365
2025-01-19T22:00:00-05:00,21560.75,21604.75,21546,21595,21149.72568400299,NaN,NaN,NaN,NaN,NaN,21234.825,21679.54563421869,20790.10436578131,21287.128772024444,21572.905955433675,21578.90148119184,21566.91042967551,34465,277659.8333333333,64.21364258530733,60.09203503515039,NaN,NaN,NaN,NaN,142.81259281311497,24.123781978665907,6379886,32.56071185496191,105.02849999230602,72.46778813734412
2025-01-20T02:00:00-05:00,21595,21637.75,21586,21625.5,21186.787477418453,NaN,NaN,NaN,NaN,NaN,21238.545,21693.05561252782,20784.034387472177,21357.778017619556,21587.962337182154,21609.220906323215,21566.703768041094,59429,274059.56666666665,65.39714280807078,60.24541702040489,NaN,NaN,NaN,NaN,136.30812189789248,24.258719407777914,6439315,31.004714657312775,111.22368145898508,80.21896680167231
2025-01-20T06:00:00-05:00,21625,21780,21538,21742.5,21220.234637535796,NaN,NaN,NaN,NaN,NaN,21245.89,21720.42839844641,20771.35160155359,21435.02241409564,21643.300823424554,21694.36945149114,21592.232195357967,218317,266489.36666666664,69.55641504457319,60.578057054547365,NaN,NaN,NaN,NaN,143.85754176232874,25.177999591179006,6657632,35.139453042089286,124.14328310428391,89.00383006219462
2025-01-20T10:00:00-05:00,21742.25,21742.25,21623,21680.5,21247.508063102352,NaN,NaN,NaN,NaN,NaN,21251.12,21738.75796242718,20763.48203757282,21435.02241409564,21657.09146409467,21702.02451848111,21612.158409708227,216681,246093.4,65.09143286700238,60.43700415555515,NaN,NaN,NaN,NaN,142.1177173507338,26.031616904337163,6440951,31.120832678778896,127.90487091066825,96.78403823188935
2025-01-20T18:00:00-05:00,21685.5,21746.5,21370.25,21587.5,21247.508063102352,NaN,NaN,NaN,NaN,NaN,21254.88,21749.880022626163,20759.87997737384,21435.02241409564,21634.243839747898,21689.128583262554,21579.359096233242,209529,244047.13333333333,58.97591589139136,60.443828679145774,NaN,NaN,NaN,NaN,158.8414518256814,24.508710017748456,6231422,20.153229477754735,121.97557507908277,101.82234560132804
2025-01-20T22:00:00-05:00,21587.5,21647.25,21578,21601.5,21247.508063102352,NaN,NaN,NaN,NaN,NaN,21258.025,21759.750236060394,20756.29976393961,21435.02241409564,21632.283132356504,21685.43338581988,21579.132878893128,68494,243762.9,59.59139452036231,60.86080336910053,NaN,NaN,NaN,NaN,152.4420624095613,23.094582194487515,6299916,12.187635083052285,117.05688945514339,104.8692543720911
2025-01-21T02:00:00-05:00,21600.5,21730.5,21583,21688.75,21247.508063102352,NaN,NaN,NaN,NaN,NaN,21264.915,21780.458854681616,20749.371145318386,21435.02241409564,21635.419878116067,21687.12192674866,21583.717829483474,86736,245062.16666666666,63.28800857478877,61.83438438917042,NaN,NaN,NaN,NaN,152.08905795173547,22.345209455252498,6386652,11.16807705925217,118.82935069615633,107.66127363690416
2025-01-21T06:00:00-05:00,21688.25,21737.75,21572.5,21630.75,21247.508063102352,NaN,NaN,NaN,NaN,NaN,21271.04,21796.45240335563,20745.62759664437,21435.02241409564,21638.384370304513,21683.26569291773,21593.503047691298,334276,253112.3,59.398010490936734,62.36854768359005,NaN,NaN,NaN,NaN,153.02912524089723,21.559883991512766,6052376,5.260637005792631,114.23706989414495,108.97643288835232
2025-01-21T10:00:00-05:00,21631,21772,21525.5,21753.25,21247.508063102352,NaN,NaN,NaN,NaN,NaN,21279.575,21821.90595292446,20737.244047075543,21435.02241409564,21652.533884461867,21695.231445265694,21609.83632365804,595053,257706.9,64.37810671164412,63.14875194016448,NaN,NaN,NaN,NaN,159.7056162951189,20.42582561713002,6647429,8.106343222573713,119.10936191656947,111.00301869399576
2025-01-21T14:00:00-05:00,21753,21785,21697.25,21773.25,21281.40487353594,NaN,NaN,NaN,NaN,NaN,21288.15,21847.603948059885,20728.69605194012,21435.02241409564,21661.886465539465,21711.81250058423,21611.9604304947,197646,236871.03333333333,65.13010974106209,63.81698495679909,NaN,NaN,NaN,NaN,154.5659294168961,19.473386275385113,6845075,9.72938878546627,123.16475467582859,113.43536589036232
2025-01-21T18:00:00-05:00,21800,21850,21769,21834.5,21359.630788375216,NaN,NaN,NaN,NaN,NaN,21298.535,21878.51641358167,20718.55358641833,21491.93812206124,21817.833333333332,21817.833333333332,21817.833333333332,68880,227082.46666666667,67.39988327452579,64.1163282829978,NaN,NaN,NaN,NaN,149.3112201728321,19.082936099571786,6913955,13.111314994397674,129.8245096333594,116.71319463896174
2025-01-21T22:00:00-05:00,21834.25,21877,21833.5,21842.25,21419.897570721794,NaN,NaN,NaN,NaN,NaN,21308.835,21908.450039921445,20709.219960078553,21568.800497648994,21829.417930865315,21845.19938205532,21813.636479675308,37116,226933.3,67.68649653991727,64.1288410769329,NaN,NaN,NaN,NaN,141.75327587477267,18.918303579415415,6951071,13.974259003579249,134.1810183934358,120.20675938985656
2025-01-22T02:00:00-05:00,21842.25,21907.25,21839.5,21890.5,21448.57268114353,NaN,NaN,NaN,NaN,NaN,21320.61,21941.936252141313,20699.283747858688,21626.815398119194,21848.9962669791,21876.197931587893,21821.794602370304,68974,228440.23333333334,69.48523280803718,64.46299581919304,NaN,NaN,NaN,NaN,136.4673275980032,18.987896823661483,7020045,15.765882041492176,139.91411194172179,124.14822990022961
2025-01-22T06:00:00-05:00,21890.25,22027.75,21880,22014,21528.234150182463,NaN,NaN,NaN,NaN,NaN,21335.425,21986.156982078788,20684.69301792121,21729.527318495355,21927.675888276546,21990.22267930693,21865.12909724616,297715,236433.66666666666,73.54454945428596,65.2240243794218,NaN,NaN,NaN,NaN,137.2732327695744,19.84407738797295,7317760,22.812008830940954,152.6632409389058,129.85123210796485
2025-01-22T10:00:00-05:00,22014.25,22094,21975.5,22027.5,21612.297370628716,NaN,NaN,NaN,NaN,NaN,21351.065,22029.404279490805,20672.725720509192,21796.171854796285,21982.00518363618,22049.943110606764,21914.0672566656,510264,237867.93333333332,73.95245643356137,65.91965394001137,NaN,NaN,NaN,NaN,135.93228757174765,21.01236426825405,7828024,25.710250963256385,161.98904581203533,136.27879484877894
2025-01-22T14:00:00-05:00,22027.75,22044.5,21967.75,21985.25,21612.297370628716,NaN,NaN,NaN,NaN,NaN,21364.455,22065.52738349535,20663.382616504652,21796.171854796285,21985.00644255293,22047.061862513707,21922.951022592155,208336,221763.5,70.2992493596292,66.26980440797983,NaN,NaN,NaN,NaN,131.70498131662282,22.00529281906924,7619688,22.240315088242284,164.0791887090818,141.8388736208395
2025-01-22T18:00:00-05:00,21982.5,21985,21926.25,21955,21612.297370628716,NaN,NaN,NaN,NaN,NaN,21382.46,22096.90514387058,20668.01485612942,21796.171854796285,21955.416666666668,21955.416666666668,21955.416666666668,53694,216330.53333333333,67.71983607115209,66.13862019559261,NaN,NaN,NaN,NaN,126.51176836543547,22.429412498679426,7565994,15.675950171679432,161.4338113354388,145.75786116375937
2025-01-22T22:00:00-05:00,21954.75,21970,21935,21942.25,21612.297370628716,NaN,NaN,NaN,NaN,NaN,21397.94,22126.549398512198,20669.3306014878,21796.171854796285,21953.005798037586,21956.08094797557,21949.930648099602,33002,215529.1,66.61045152487803,66.24712152829801,NaN,NaN,NaN,NaN,119.97521348219007,22.823237915460318,7532992,8.59725239240123,156.5044266542609,147.90717426185967
2025-01-23T02:00:00-05:00,21942.25,21948.25,21855.5,21881.25,21612.297370628716,NaN,NaN,NaN,NaN,NaN,21415.64,22147.348406129327,20683.93159387067,21796.171854796285,21923.93647889215,21953.020515496,21894.8524422883,87094,216226.93333333332,61.425780215227554,66.42211183714346,NaN,NaN,NaN,NaN,118.03055537631936,22.24793746269006,7445898,-1.5315393828101662,145.99275003334697,147.52428941615713
2025-01-23T06:00:00-05:00,21881.25,21919.25,21866,21898,21612.297370628716,NaN,NaN,NaN,NaN,NaN,21435.09,22165.34933585277,20704.83066414723,21796.171854796285,21906.678019620405,21930.404742465267,21882.951296775544,244618,219637.6,62.29366648071087,66.61513126288264,NaN,NaN,NaN,NaN,113.4033728494394,21.713729899403393,7690516,-8.075788932768518,137.42955325019648,145.505342182965
2025-01-23T10:00:00-05:00,21898,21984.25,21867.25,21954.75,21612.297370628716,NaN,NaN,NaN,NaN,NaN,21456.06,22184.585713753317,20727.534286246686,21796.171854796285,21922.84719989296,21944.04766021992,21901.646739566,538234,225539.6,65.15422922555003,66.74843273793701,NaN,NaN,NaN,NaN,113.66027478876516,21.75921356857725,8228750,-9.459143575539713,133.68141271354034,143.14055628908005
2025-01-23T14:00:00-05:00,21954.75,22051.25,21923.75,22021.75,21613.97448660575,NaN,NaN,NaN,NaN,NaN,21481.485,22198.38053918258,20764.58946081742,21810.562574962973,21936.990331249584,21972.228471826158,21901.75219067301,218484,208108.06666666668,68.21964596577058,67.37854955756801,NaN,NaN,NaN,NaN,114.64882658956765,22.299893109692675,8447234,-6.859541181649945,134.5661298120176,141.42567099366755
2025-01-23T18:00:00-05:00,22018,22059,21994.5,22049.75,21661.407464487307,NaN,NaN,NaN,NaN,NaN,21506.45,22213.761706392525,20799.138293607477,21834.20005997038,22034.416666666668,22034.416666666668,22034.416666666668,73316,201345.9,69.4299742056841,67.73939723571371,NaN,NaN,NaN,NaN,111.06676754745568,22.857838034451802,8520550,-4.373028540000405,135.95938531866705,140.33241385866745
2025-01-23T22:00:00-05:00,22049.75,22058.75,21979.25,22003.75,21661.407464487307,NaN,NaN,NaN,NaN,NaN,21528.68,22227.191567835434,20830.168432164566,21839.160047976304,22025.72668214642,22035.857272045916,22015.596092246928,53947,201542.3,65.04712030472359,67.7334694188324,NaN,NaN,NaN,NaN,108.81199843692313,23.16289460345499,8466603,-6.8002855714779855,131.83205689431998,138.63234246579796
2025-01-24T02:00:00-05:00,22003.25,22023.75,21971.25,22007.5,21661.407464487307,NaN,NaN,NaN,NaN,NaN,21548.98,22242.96301016671,20854.99698983329,21839.160047976304,22016.96303400744,22031.380163189544,22002.545904825336,69145,202303.76666666666,65.23976224678549,67.57917505970809,NaN,NaN,NaN,NaN,104.78971283428577,23.33007082620651,8535748,-8.989729412791633,127.3951806998084,136.38491011260004
2025-01-24T06:00:00-05:00,22008.25,22078,21990,22057.25,21687.535244047423,NaN,NaN,NaN,NaN,NaN,21569.26,22262.205416032397,20876.3145839676,21872.462430704833,22031.339605732846,22046.733214652213,22015.94599681348,271236,208827.26666666666,67.77710394537678,67.58564701724092,NaN,NaN,NaN,NaN,103.59044763183678,23.93968701661123,8806984,-7.959240342289775,126.4358596847378,134.39510002702758
2025-01-24T10:00:00-05:00,22058,22070,21861.5,21867.75,21687.535244047423,NaN,NaN,NaN,NaN,NaN,21585.685,22267.124423646637,20904.245576353365,21872.462430704833,21977.404548630333,22027.378102594314,21927.430994666352,569082,211583.1,52.15905594402452,66.34806295552572,NaN,NaN,NaN,NaN,111.08398708670559,22.821081725385554,8237902,-20.214814992653146,109.12658128621115,129.3413962788643
2025-01-24T14:00:00-05:00,21868,21919.5,21843.25,21908.5,21687.535244047423,NaN,NaN,NaN,NaN,NaN,21601.955,22274.54392118421,20929.366078815794,21872.462430704833,21961.06245531562,22017.47776410059,21904.64714653065,239820,199207.83333333334,54.582696300049456,64.99364487308024,NaN,NaN,NaN,NaN,108.5958451519409,21.576429294139718,8477722,-25.4152887684575,97.57228531829242,122.98757408674992
2025-01-26T18:00:00-05:00,21773.75,21774,21488.5,21522.75,NaN,NaN,NaN,22025.688214207064,22025.688214207064,22025.688214207064,21612.795,22262.0530818906,20963.536918109396,21872.462430704833,21595.083333333332,21595.083577473957,21595.083089192707,204898,198210.93333333332,35.99364380667423,62.28230111401689,NaN,NaN,NaN,NaN,130.83899906965942,22.34430144551926,8272824,-53.08145160154949,56.63575958481306,109.71721118636255
2025-01-26T22:00:00-05:00,21523,21563,21356.75,21388.75,NaN,NaN,NaN,21864.509204470378,NaN,NaN,21620.625,22249.11116730995,20992.13883269005,21872.462430704833,21524.018845228908,21603.03257883531,21445.005111622504,165744,201140.83333333334,31.926104600630993,59.54136220265987,NaN,NaN,NaN,NaN,136.22549913611232,23.66263448525359,8107080,-77.19128689958062,13.228102561886772,90.41938946146739
2025-01-27T02:00:00-05:00,21388.75,21412,20763.75,20889,NaN,NaN,NaN,21562.514467903544,NaN,NaN,21618.87,22254.982059624803,20982.757940375195,21872.462430704833,21266.691601591378,21523.827178197607,21009.556024985148,389119,212962.63333333333,21.959281549582172,56.27275116540488,NaN,NaN,NaN,NaN,172.79867776924715,26.483972484072144,7717961,-120.973583574484,-60.79759000663762,60.17599356784638
2025-01-27T06:00:00-05:00,20887.75,21341,20877.5,21331,NaN,NaN,NaN,21562.514467903544,NaN,NaN,21626.74,22238.196563951857,21015.283436048147,21872.462430704833,21230.678320596726,21428.97477578616,21032.381865407293,575890,230178,39.845962102104416,54.36100192092105,NaN,NaN,NaN,NaN,193.56305792858663,29.10378634011793,8293851,-114.41504941529485,-82.84281820127217,31.572231214022672
2025-01-27T10:00:00-05:00,21331.25,21418,21138.75,21151,NaN,NaN,NaN,21562.514467903544,NaN,NaN,21630.8,22226.672838783627,21034.927161216372,21872.462430704833,21232.78793594882,21386.059986922686,21079.515884974957,900592,252920.5,36.206555174713856,52.559628703741495,NaN,NaN,NaN,NaN,199.68355379083044,30.90923110918759,7393259,-116.08147880453203,-113.52961729164235,2.5518615128896656
2025-01-27T14:00:00-05:00,21151.75,21329.75,21096.75,21303.75,NaN,NaN,NaN,21562.514467903544,NaN,NaN,21637.575,22210.265669122487,21064.884330877514,21872.462430704833,21234.327618427404,21376.11340085999,21092.541835994816,378819,258325.1,41.121267991696655,51.04731452595477,NaN,NaN,NaN,NaN,202.06329994862827,32.685576792385135,7772078,-101.3158982132767,-124.09301125370621,-22.777113040429512
2025-01-27T18:00:00-05:00,21340,21356.5,21218,21292.25,NaN,NaN,NaN,21562.514467903544,NaN,NaN,21636.875,22211.16452846112,21062.58547153888,21872.462430704833,21288.916666666668,21288.916666666668,21288.916666666668,130159,255679.43333333332,40.86600632896578,49.31244146191303,NaN,NaN,NaN,NaN,197.52306423801198,34.105968018334174,7641919,-87.27622009666767,-131.8723881612641,-44.59616806459643
2025-01-27T22:00:00-05:00,21292.25,21332,21247.5,21290.5,NaN,NaN,NaN,21562.514467903544,NaN,NaN,21635.075,22213.119377621657,21057.030622378345,21801.319944563867,21289.28330791973,21289.79591771775,21288.77069812171,66586,255615.83333333334,40.82447607302692,47.35564361243134,NaN,NaN,NaN,NaN,189.44998822101113,35.42490272814399,7575333,-73.60636433245347,-136.60412348016325,-62.99775914770979
2025-01-28T02:00:00-05:00,21290.5,21423.25,21273.75,21391.5,NaN,NaN,NaN,21562.514467903544,NaN,NaN,21635.39,22212.88567236476,21057.89432763524,21666.430955651093,21319.267922444542,21355.412738064613,21283.12310682447,135413,257238.4,44.34017940255327,45.563515412207714,NaN,NaN,NaN,NaN,186.59641763379605,35.828875044491234,7710746,-54.159873730981204,-130.6976013114363,-76.5377275804551
2025-01-28T06:00:00-05:00,21392,21412.25,21160.75,21284.5,NaN,NaN,NaN,21562.514467903544,NaN,NaN,21633.11,22215.21051674928,21051.00948325072,21361.544764520873,21300.64357882014,21329.87605242226,21271.411105218023,417699,260019.16666666666,41.525480994916244,43.883398318650045,NaN,NaN,NaN,NaN,191.23238780281062,36.58810942391625,7293047,-45.26275026308559,-133.1161654093121,-87.8534151462265
2025-01-28T10:00:00-05:00,21284.5,21584,21280,21539.75,20886.768009676052,20886.768009676052,20886.768009676052,NaN,NaN,NaN,21635.09,22215.230006895014,21054.949993104987,21129.9108116167,21388.018574809466,21473.979413666046,21302.057735952887,820029,267518.36666666664,49.72442830836695,42.77516018019158,NaN,NaN,NaN,NaN,199.287217245467,35.93338454060864,8113076,-20.223055971786238,-113.1322351109593,-92.90917913917306
2025-01-28T14:00:00-05:00,21540,21626,21513.25,21558,21033.801281963504,NaN,NaN,NaN,NaN,NaN,21636.285,22215.538079491176,21057.031920508824,21100.567182523064,21412.943177389196,21513.74825323486,21312.138101543533,256067,269465.73333333334,50.26141884393506,41.52403981580289,NaN,NaN,NaN,NaN,193.10598744221937,35.024192380713906,8369143,-1.4568270623508113,-94.73021296711158,-93.27338590476077
2025-01-28T18:00:00-05:00,21558,21586,21531,21578.75,21039.531905510616,NaN,NaN,NaN,NaN,NaN,21640.3,22215.102209460056,21065.497790539943,21138.15374601845,21565.25,21565.25,21565.25,41398,268549.6666666667,50.903514795278355,41.43435830517816,NaN,NaN,NaN,NaN,183.2412740534894,34.179942517954515,8410541,12.556423116905009,-77.57785700862951,-90.13428012553452
2025-01-28T22:00:00-05:00,21578.75,21686,21558.75,21662.75,21109.64409162377,NaN,NaN,NaN,NaN,NaN,21647.74,22213.815674799345,21081.664325200658,21264.097996814762,21608.451907729308,21642.84565458109,21574.058160877525,65317,269489.7,53.51943108684837,41.35841078994951,NaN,NaN,NaN,NaN,179.24189733538302,32.65906758898217,8475858,26.86384918666475,-56.554468642203574,-83.41831782886833
2025-01-29T02:00:00-05:00,21662.75,21697.25,21628,21665.75,21163.756860186328,NaN,NaN,NaN,NaN,NaN,21656.775,22209.125126731138,21104.424873268865,21325.103397451807,21634.05874441189,21671.374827936226,21596.742660887554,92294,270267.0333333333,53.61448772477236,42.61704249838509,NaN,NaN,NaN,NaN,171.38533323999852,31.165842784575933,8568152,35.37518117346244,-39.199341362040286,-74.57452253550272
2025-01-29T06:00:00-05:00,21665.75,21690,21494,21518.25,21163.756860186328,NaN,NaN,NaN,NaN,NaN,21661.98,22204.009250502233,21119.950749497766,21325.103397451807,21592.849236871778,21632.59189313584,21553.106580607717,322463,271091.9666666667,48.37610351790797,43.79204242104773,NaN,NaN,NaN,NaN,173.14352372285575,30.498652052957592,8245689,30.122269992882934,-36.921685044399055,-67.04395503728199
2025-01-29T10:00:00-05:00,21518.5,21565,21368,21467.75,21163.756860186328,NaN,NaN,NaN,NaN,NaN,21665.575,22199.965449483967,21131.184550516035,21325.103397451807,21520.14091195091,21587.50112209676,21452.780701805063,712370,277828.8333333333,46.693971629359986,45.55880599817472,NaN,NaN,NaN,NaN,174.84755774265176,30.457588330194113,7533319,22.639222780698674,-38.74492656140865,-61.38414934210732
2025-01-29T14:00:00-05:00,21464.25,21610,21386.25,21574.5,21163.756860186328,NaN,NaN,NaN,NaN,NaN,21670.39,22197.016396603816,21143.763603396183,21325.103397451807,21521.240486041705,21576.834045657106,21465.646926426303,579082,290187.0333333333,50.60401853188102,46.32723860030161,NaN,NaN,NaN,NaN,178.34058933246234,30.063858251599722,8112401,24.134371475995792,-31.216184997112578,-55.35055647310837
2025-01-29T18:00:00-05:00,21555.75,21677.25,21505.5,21656.75,21163.756860186328,NaN,NaN,NaN,NaN,NaN,21673.405,22197.954291201706,21148.85570879829,21325.103397451807,21613.166666666668,21613.166666666668,21613.166666666668,88887,291360.13333333336,53.43795674368435,47.55805299808522,NaN,NaN,NaN,NaN,177.86983295157216,29.179848012322747,8201288,29.559961386309297,-18.400604740221752,-47.96056612653105
2025-01-29T22:00:00-05:00,21657,21680,21631,21642.25,21163.756860186328,NaN,NaN,NaN,NaN,NaN,21673.61,22198.102413291163,21149.11758670884,21325.103397451807,21624.762950120657,21642.23345739472,21607.292442846596,39162,291565.4666666667,52.862171492259606,48.39668896241115,NaN,NaN,NaN,NaN,168.6648448836027,28.33753297259661,8162126,30.922925210715505,-9.306909613136668,-40.22983482385217
2025-01-30T02:00:00-05:00,21641.75,21709.5,21608.75,21620.5,21170.280287419326,NaN,NaN,NaN,NaN,NaN,21674.215,22198.391086921245,21150.038913078755,21357.270761021606,21633.992048623797,21650.940536276,21617.043560971593,96409,291875.9666666667,51.957819393764815,49.188961324182515,NaN,NaN,NaN,NaN,163.81378453477396,27.31531045144961,8065717,29.13490723045347,-3.8112007857853314,-32.9461080162388
2025-01-30T06:00:00-05:00,21620.25,21748.75,21574.75,21672.5,21171.398228900267,NaN,NaN,NaN,NaN,NaN,21676.45,22199.62385255752,21153.27614744248,21379.966608817285,21654.294696100722,21672.330372269033,21636.25901993241,412831,297483.06666666665,53.984679471545,50.12897585264809,NaN,NaN,NaN,NaN,164.54137135371866,26.045131243465498,8478548,30.10579411636474,4.686134629217122,-25.41965948714762
2025-01-30T10:00:00-05:00,21673.5,21677,21419,21606.25,21171.398228900267,NaN,NaN,NaN,NaN,NaN,21676.675,22199.71820328259,21153.631796717407,21379.966608817285,21605.330790781325,21650.034037786136,21560.627543776514,823022,306976,51.03074930020512,50.606873702480364,NaN,NaN,NaN,NaN,171.2169876855959,25.79707010479137,7655526,25.13995768764094,6.005287622403557,-19.134670065237383
2025-01-30T14:00:00-05:00,21606.5,21700,21523,21607,21171.398228900267,NaN,NaN,NaN,NaN,NaN,21676.305,22199.51863026982,21153.09136973018,21379.966608817285,21606.233694111157,21646.42506451359,21566.042323708723,350083,311362.63333333336,51.06339482090091,51.28815326147926,NaN,NaN,NaN,NaN,171.63005999376765,25.370538434889067,8005609,20.93189987692011,7.030204780912754,-13.901695096007355
2025-01-30T18:00:00-05:00,21684,21787,21660.5,21740.5,21217.63018856549,NaN,NaN,NaN,NaN,NaN,21676.265,22199.458686984275,21153.071313015724,21379.966608817285,21729.333333333332,21729.333333333332,21729.333333333332,99140,312223.43333333335,56.60849662868166,51.77987242721603,NaN,NaN,NaN,NaN,172.22791285135568,24.25854179920525,8104749,25.843483205160506,18.40265891044328,-7.440824294717228
2025-01-30T22:00:00-05:00,21740.5,21773.75,21722,21761.5,21257.70381635797,NaN,NaN,NaN,NaN,NaN,21677.885,22201.622436221933,21154.147563778064,21402.13332297156,21735.90442097845,21746.320918164052,21725.48792379285,39453,311740.3,57.42572910613703,52.29160887451617,NaN,NaN,NaN,NaN,163.6223476476874,23.225973494641707,8144202,28.975217903114203,28.77819808417553,-0.19701981893867515
2025-01-31T02:00:00-05:00,21761.5,21807.25,21742.75,21781.25,21298.31387015988,NaN,NaN,NaN,NaN,NaN,21681.76,22205.632150052035,21157.88784994796,21477.706658377247,21750.672292461095,21772.111182657693,21729.233402264497,77495,312018.63333333336,58.22264835064348,52.81440412847082,NaN,NaN,NaN,NaN,156.5421799585669,21.98473580992342,8221697,30.681394790730987,38.15472366947506,7.473328878744073
2025-01-31T06:00:00-05:00,21781.25,21870.5,21750,21867.75,21338.79960333443,NaN,NaN,NaN,NaN,NaN,21687.085,22212.994361107285,21161.175638892713,21546.615326701798,21795.875013223573,21837.250785588836,21754.49924085831,291213,312684.5333333333,61.61185401778274,53.39243433782327,NaN,NaN,NaN,NaN,153.96773853295494,20.512444072652297,8512910,35.59451900359324,51.96647763323563,16.371958629642386
2025-01-31T10:00:00-05:00,21867.75,21965.75,21720,21752.25,21359.342803182866,NaN,NaN,NaN,NaN,NaN,21688.355,22214.580902916303,21162.129097083696,21583.767261361438,21805.961612557145,21833.370180879414,21778.553044234875,763147,319153.36666666664,55.17531508822199,53.503922006641105,NaN,NaN,NaN,NaN,160.5236143520296,19.847117683968012,7749763,29.287846381223478,52.98176660617173,23.693920224948254
2025-01-31T14:00:00-05:00,21752,21781,21531.5,21571.25,21359.342803182866,NaN,NaN,NaN,NaN,NaN,21687.165,22214.175110054635,21160.154889945366,21583.767261361438,21753.53300913462,21837.888836827173,21669.177181442064,530248,328834.3,46.90554261520538,53.39888194216235,NaN,NaN,NaN,NaN,166.87907046974175,19.02062706960749,7219515,12.032618759980291,38.73469367492362,26.702074914943328
2025-02-02T18:00:00-05:00,21280.25,21280.25,20940.25,21029.25,NaN,NaN,NaN,21669.345452058587,21669.345452058587,21669.345452058587,21672.685,22230.519893225395,21114.850106774607,21583.767261361438,21083.25,21083.25,21083.25,292282,331747.1,31.621538876109057,52.32227960264442,NaN,NaN,NaN,NaN,200.03056543618877,20.688368101137296,6927233,-34.24600489125735,-16.10543119912836,18.14057369212899
2025-02-02T22:00:00-05:00,21029.25,21101.75,20981,21066.25,NaN,NaN,NaN,21591.52293151047,NaN,NaN,21658.545,22240.775209539406,21076.31479046059,21583.767261361438,21074.049577008333,21089.027330138066,21059.0718238786,110287,329898.5333333333,33.221238533595795,51.080652459909764,NaN,NaN,NaN,NaN,194.36766790503242,22.236984773272116,7037520,-59.261448051052305,-55.93623637168639,3.325211679365914
2025-02-03T02:00:00-05:00,21066.75,21252.5,21066.75,21233.5,NaN,NaN,NaN,21591.52293151047,NaN,NaN,21646.525,22238.46278600435,21054.587213995652,21583.767261361438,21106.89819017214,21158.84396397078,21054.952416373504,170957,322626.4666666667,40.04880672862103,50.12428460169095,NaN,NaN,NaN,NaN,193.78783448324438,22.667971822069198,7208477,-61.19087120885916,-73.16337733170803,-11.972506122848875
2025-02-03T06:00:00-05:00,21232.75,21314.75,21156.5,21215.25,NaN,NaN,NaN,21591.52293151047,NaN,NaN,21633.985,22235.297334897452,21032.67266510255,21583.767261361438,21157.972219548312,21229.995017535206,21085.949421561418,413376,317209.3333333333,39.57334899328384,49.17508299462126,NaN,NaN,NaN,NaN,191.2494177344412,22.681719112872806,6795101,-60.24799099484248,-87.28249486640198,-27.034503871559497
2025-02-03T10:00:00-05:00,21215.25,21473,21113.25,21467.75,NaN,NaN,NaN,21591.52293151047,NaN,NaN,21625.53,22224.0592861676,21027.000713832396,21583.767261361438,21257.66751143938,21366.528923839338,21148.806099039422,1050431,322203.9666666667,48.65569092019588,48.93921667508062,NaN,NaN,NaN,NaN,203.28517361055256,21.786010856384245,7845532,-40.13828417496191,-77.20735909026189,-37.06907491529998
2025-02-03T14:00:00-05:00,21467.25,21577.75,21386.75,21554.25,NaN,NaN,NaN,21591.52293151047,NaN,NaN,21616.335,22204.750555623807,21027.91944437619,21583.767261361438,21286.617882471477,21416.34479464906,21156.890970293894,268547,318528.23333333334,51.353200549777135,48.751253894954345,NaN,NaN,NaN,NaN,202.40766120979882,20.4136191739124,8114079,-19.571614747835,-61.533593350093724,-41.961978602258725
2025-02-03T18:00:00-05:00,21592.25,21600,21462.25,21467.75,20966.950917822647,20966.950917822647,20966.950917822647,NaN,NaN,NaN,21605.14,22183.04416298924,21027.235837010758,21583.767261361438,21510,21510,21510,78794,316816.06666666665,48.60327517452342,48.57786288597708,NaN,NaN,NaN,NaN,197.78925683767034,19.0258610459669,8035285,-10.792516979016966,-55.45262482602993,-44.660107847012966
2025-02-03T22:00:00-05:00,21468.5,21476.5,21240.75,21400.5,20966.950917822647,NaN,NaN,NaN,NaN,NaN,21593.445,22163.723566053668,21023.16643394633,21583.767261361438,21419.975359530905,21485.293428390563,21354.657290671246,149675,319585.7,46.51766947128163,48.25316821814714,NaN,NaN,NaN,NaN,200.50073849212245,18.743739772876346,7885610,-8.608767216439489,-55.42106686756233,-46.81229965112284
2025-02-04T02:00:00-05:00,21400.25,21425.5,21312.75,21390,20966.950917822647,NaN,NaN,NaN,NaN,NaN,21582.145,22145.669898207678,21018.620101792323,21350.66380908915,21405.20409525358,21462.30737752515,21348.100812982007,115889,318934.9,46.18443951095178,47.50859270973786,NaN,NaN,NaN,NaN,194.232828599828,18.48177001929226,7769721,-7.032056038567717,-55.602369699332485,-48.57031366076477
2025-02-04T06:00:00-05:00,21389.75,21576.25,21375.25,21559.25,20966.950917822647,NaN,NaN,NaN,NaN,NaN,21574.485,22128.554936109023,21020.415063890978,21082.93395399982,21450.64284441805,21515.142959086195,21386.142729749903,295562,314863.6666666667,52.1363448494083,47.13077954854295,NaN,NaN,NaN,NaN,194.71619798555457,17.408428354372045,8065283,5.568773858739846,-41.60934633733996,-47.1781201960798
2025-02-04T10:00:00-05:00,21558.5,21694.75,21550.25,21622.75,21066.28166012425,NaN,NaN,NaN,NaN,NaN,21569.315,22116.62163991973,21022.008360080268,21227.847163199855,21530.885484042126,21628.746583337404,21433.02438474685,559979,306195.3333333333,54.18372124219495,46.842284755082346,NaN,NaN,NaN,NaN,191.1293267008721,16.50016486050344,8625262,17.65734116083148,-25.10644374504045,-42.76378490587193
2025-02-04T14:00:00-05:00,21622.75,21693,21571,21584.5,21084.42794830042,NaN,NaN,NaN,NaN,NaN,21563.045,22102.269486554786,21023.82051344521,21258.477730559884,21543.907960284196,21639.06783118671,21448.748089381683,216246,304867.9666666667,52.720815490433026,46.20721057455737,NaN,NaN,NaN,NaN,186.1915176508098,15.65677733048259,8409016,22.257437573366033,-14.941987939164392,-37.199425512530425
2025-02-04T18:00:00-05:00,21566,21624.5,21548.75,21564.75,21084.42794830042,NaN,NaN,NaN,NaN,NaN,21555.245,22082.734615916917,21027.75538408308,21258.477730559884,21579.333333333332,21579.333333333332,21579.333333333332,71403,305868.13333333336,51.941024214484685,45.97618979786184,NaN,NaN,NaN,NaN,178.3028378186091,14.747544997044862,8337613,23.05265843105327,-8.383602473713836,-31.436260904767106
2025-02-04T22:00:00-05:00,21565.5,21576,21507.75,21518.5,21084.42794830042,NaN,NaN,NaN,NaN,NaN,21545.18,22055.60917275552,21034.75082724448,21258.477730559884,21560.597466470812,21582.885698082704,21538.30923485892,50456,305372.76666666666,50.07322106872864,46.20245254454208,NaN,NaN,NaN,NaN,170.4419208315656,13.723068841630367,8287157,19.677660449445476,-6.839185342960263,-26.51684579240574
2025-02-05T02:00:00-05:00,21518.5,21540.75,21429,21479.25,21084.42794830042,NaN,NaN,NaN,NaN,NaN,21533.77,22023.665558665132,21043.87444133487,21258.477730559884,21523.290032112323,21565.254867326035,21481.32519689861,112838,306057.56666666665,48.479929775739414,47.4066233230871,NaN,NaN,NaN,NaN,166.24964077216805,13.218283924329194,8174319,14.267647339224066,-8.682286618375656,-22.949933957599722
2025-02-05T06:00:00-05:00,21479.5,21590.75,21471.25,21563.5,21084.42794830042,NaN,NaN,NaN,NaN,NaN,21524.965,21996.22688059308,21053.70311940692,21267.08767843733,21533.226714775028,21563.274796186015,21503.17863336404,270967,304341.0333333333,52.009787935278915,48.74866256606447,NaN,NaN,NaN,NaN,162.9103807170132,12.436055202934302,8445286,15.71469062518748,-3.3065706761153706,-19.02126130130285
2025-02-05T10:00:00-05:00,21564.5,21742,21501,21710.25,21108.591976557833,NaN,NaN,NaN,NaN,NaN,21519.02,21972.964521279955,21065.075478720046,21362.57014274986,21598.593597141986,21660.506509980234,21536.680684303738,629717,301585.93333333335,57.4751226153906,49.993399415119434,NaN,NaN,NaN,NaN,168.488210665798,12.249331936847579,9075003,25.336534646764726,12.649407007153059,-12.687127639611667
2025-02-05T14:00:00-05:00,21710.25,21795.5,21689.75,21771.25,21238.61052307793,NaN,NaN,NaN,NaN,NaN,21513.3,21946.715539638313,21079.884460361685,21439.08111419989,21621.030460437913,21699.868688181443,21542.192232694382,194259,288758.5,59.53788444951508,51.41943766199309,NaN,NaN,NaN,NaN,164.0069099039553,12.353496740600136,9269262,34.0476806743793,29.87247320336246,-4.175207471016842
2025-02-05T18:00:00-05:00,21768,21798.25,21749.5,21780.75,21286.122544756206,NaN,NaN,NaN,NaN,NaN,21511.56,21939.93891591411,21083.181084085893,21488.739891359914,21776.166666666668,21776.166666666668,21776.166666666668,46551,287347.3,59.864407727015916,52.22006029105166,NaN,NaN,NaN,NaN,155.77427348224418,12.464888247391857,9315813,38.36715493527317,43.78373619807462,5.416581262801451
2025-02-05T22:00:00-05:00,21780.5,21833,21769,21810.5,21326.69083817638,NaN,NaN,NaN,NaN,NaN,21509.6,21931.544818667164,21087.655181332833,21553.39191308793,21788.877547349817,21802.81806999216,21774.937024707473,38701,287331.93333333335,60.92777133506534,52.90395820428654,NaN,NaN,NaN,NaN,149.21896823351244,12.761197499834603,9354514,40.91244162059171,56.55713328854108,15.644691667949377
2025-02-06T02:00:00-05:00,21810.5,21830.75,21770.75,21779,21339.81852735018,NaN,NaN,NaN,NaN,NaN,21514.725,21943.3561263781,21086.093873621896,21577.063530470343,21791.046075177423,21801.461921354952,21780.630228999893,75337,286629.5333333333,59.14107958464786,53.656658519295426,NaN,NaN,NaN,NaN,142.84618478826155,13.036341805674295,9279177,38.210194132313596,63.40743433334137,25.197240201027775
2025-02-06T06:00:00-05:00,21778.75,21822.75,21706,21789.75,21339.81852735018,NaN,NaN,NaN,NaN,NaN,21522.745,21956.621577957478,21088.86842204252,21577.063530470343,21779.410260302244,21790.166905322407,21768.65361528208,284112,282338.9,59.57674016608726,54.589449283210115,NaN,NaN,NaN,NaN,140.9821715891,12.763076278504753,9563289,34.9697576989806,68.90943732475353,33.939679625772925
2025-02-06T10:00:00-05:00,21789.5,21849.5,21740.25,21816,21344.799525953367,NaN,NaN,NaN,NaN,NaN,21541.285,21943.308904886468,21139.261095113532,21585.81565950102,21791.688936588536,21805.0367355367,21778.34113764037,533876,272700.7,60.679265377600395,55.624793987970726,NaN,NaN,NaN,NaN,138.7155879041643,12.687451161825287,10097165,32.47133453146851,74.52884779010856,42.05751325864005
2025-02-06T14:00:00-05:00,21815.25,21882,21711.75,21844.25,21344.799525953367,NaN,NaN,NaN,NaN,NaN,21551.55,21957.76075810479,21145.33924189521,21585.927527600816,21796.207876998255,21810.842107158867,21781.57364683764,268679,269987.23333333334,61.88412625718398,56.321064088526136,NaN,NaN,NaN,NaN,140.9680459110097,12.836019679074559,10365844,30.62258896263809,80.33574946193767,49.713160499299576
2025-02-06T18:00:00-05:00,21819.75,21899.25,21806,21891.25,21407.659020548417,NaN,NaN,NaN,NaN,NaN,21566.355,21967.013072301226,21165.696927698773,21615.767022080654,21865.5,21865.5,21865.5,43966,268148.1,63.867815286088764,57.0127850916614,NaN,NaN,NaN,NaN,137.5596140602233,13.092351230849875,10409810,30.4047491459624,87.71909693175257,57.314347785790176
2025-02-06T22:00:00-05:00,21891,21893.75,21826.75,21861,21426.373383250764,NaN,NaN,NaN,NaN,NaN,21577.5,21979.31885222088,21175.68114777912,21633.46361766452,21863.160607087528,21865.655442840503,21860.665771334552,38658,268121.6,61.64413829565105,57.65016529203412,NaN,NaN,NaN,NaN,132.5196416273502,13.33037338606981,10371152,26.22133587853027,90.09101763395302,63.86968175542275
2025-02-07T02:00:00-05:00,21861,21881.75,21833,21854,21436.57232037573,NaN,NaN,NaN,NaN,NaN,21588.735,21989.43471811799,21188.03528188201,21649.145894131616,21860.290233789023,21864.19355462071,21856.386912957336,58700,267495.1,61.113880760720505,58.30536933105096,NaN,NaN,NaN,NaN,126.5360957968252,13.551393958774035,10312452,21.195676389592734,90.36427724241366,69.16860085282093
2025-02-07T06:00:00-05:00,21853.75,21967.75,21790,21905,21452.96107854047,NaN,NaN,NaN,NaN,NaN,21601.025,22002.076670610706,21199.973329389297,21692.791715305295,21878.704335140363,21891.683369147395,21865.72530113333,293091,267557.7,63.57244682492074,59.26959974220755,NaN,NaN,NaN,NaN,130.1942318113377,14.401334315648185,10605543,19.55868192844096,93.61695326337212,74.05827133493116
2025-02-07T10:00:00-05:00,21905.25,21905.5,21584.5,21624.5,21452.96107854047,NaN,NaN,NaN,NaN,NaN,21605.685,22002.280017744422,21209.08998225558,21692.791715305295,21760.94156439633,21842.56154565947,21679.321583133187,911772,272511.86666666664,46.25182365641943,59.11044930511326,NaN,NaN,NaN,NaN,143.823215253385,13.503507706098514,9693771,-1.0686827359712652,72.72241791496708,73.79110065093835
2025-02-07T14:00:00-05:00,21624.5,21637.25,21553,21575.5,21452.96107854047,NaN,NaN,NaN,NaN,NaN,21611.505,21997.474202009395,21225.535797990608,21692.791715305295,21736.009614286944,21832.828004763138,21639.19122381075,227660,262425.6,43.9967383979103,58.53808862387264,NaN,NaN,NaN,NaN,139.56798559242893,12.912817754796855,9466111,-17.74129808044809,51.61447805037824,69.35577613082633
2025-02-09T18:00:00-05:00,21464.75,21702,21415,21675.5,NaN,NaN,NaN,22018.92133045048,22018.92133045048,22018.92133045048,21614.22,22000.041806537254,21228.398193462748,21692.791715305295,21597.5,21597.5,21597.5,107314,256260,49.417079400541894,57.96251410852631,NaN,NaN,NaN,NaN,150.09884376439828,13.31554881662246,9573425,-21.511879205017394,42.46592712455458,63.977806329571976
2025-02-09T22:00:00-05:00,21676,21731.5,21669.25,21694.5,NaN,NaN,NaN,22018.92133045048,NaN,NaN,21616.95,22003.073542405622,21230.82645759438,21692.791715305295,21626.642616107863,21672.37754369933,21580.907688516396,43573,254036.2,50.399367289540976,57.30976288281387,NaN,NaN,NaN,NaN,143.82392635265555,13.424152167418338,9616998,-22.11825598646054,36.3299863464963,58.44824233295684
2025-02-10T02:00:00-05:00,21694.5,21736.5,21683,21726,NaN,NaN,NaN,22018.92133045048,NaN,NaN,21619.895,22007.052992168537,21232.737007831463,21692.791715305295,21650.39823731548,21705.796703347965,21594.999771282994,55342,250182.36666666667,52.0614824992157,56.752411080828146,NaN,NaN,NaN,NaN,137.37221732746588,13.47834663055888,9672340,-19.86145073641054,33.62142891244366,53.4828796488542
2025-02-10T06:00:00-05:00,21726.25,21809,21695,21792.75,NaN,NaN,NaN,22018.92133045048,NaN,NaN,21622.495,22012.504813851283,21232.485186148715,21692.791715305295,21711.7672945146,21780.589626119097,21642.944962910104,235173,244242.26666666666,55.466986473577876,56.362355019293325,NaN,NaN,NaN,NaN,135.70277323264688,12.863414287887254,9907513,-13.633523005115848,36.44097589245939,50.07449889757524
2025-02-10T10:00:00-05:00,21792.5,21893.75,21782.5,21878.25,NaN,NaN,NaN,22018.92133045048,NaN,NaN,21626.745,22023.126854908103,21230.363145091895,21692.791715305295,21779.4197282346,21864.97501788267,21693.86443858653,414287,223037.46666666667,59.44145187188075,56.383810182667105,NaN,NaN,NaN,NaN,133.9561465731721,12.294335940925617,10321800,-4.015396145554021,45.055253715632716,49.07064986118674
2025-02-10T14:00:00-05:00,21878.75,21882.25,21821.25,21837,NaN,NaN,NaN,22018.92133045048,NaN,NaN,21633.12,22032.558221005784,21233.681778994214,21692.791715305295,21789.744093397218,21872.134066207644,21707.35412058679,154748,219244.16666666666,56.807285538364546,56.18599199497262,NaN,NaN,NaN,NaN,128.74499324651694,11.76590604731838,10167052,-0.8562932434837975,48.00028330683199,48.856576550315786
2025-02-10T18:00:00-05:00,21832,21832,21750,21763,NaN,NaN,NaN,22018.92133045048,NaN,NaN,21639.025,22037.237433883834,21240.81256611617,21692.791715305295,21781.666666666668,21781.666666666668,21781.666666666668,70899,218981,52.327319471188005,55.58942443022888,NaN,NaN,NaN,NaN,125.76320801462286,11.1994165444436,10096153,-3.999263644696086,43.85749699444568,47.85676063914177
2025-02-10T22:00:00-05:00,21763.25,21798,21752.5,21771.25,NaN,NaN,NaN,22018.92133045048,NaN,NaN,21642.96,22042.430654241423,21243.489345758575,21606.470669066875,21779.10810712925,21782.752638575505,21775.463575682996,34942,215156.56666666668,52.77447070480536,54.93873474791612,NaN,NaN,NaN,NaN,120.03012172786408,10.673390577488451,10131095,-5.669373819195002,40.77004336514801,46.439417184343014
2025-02-11T02:00:00-05:00,21771.25,21788.25,21719,21734,NaN,NaN,NaN,22018.92133045048,NaN,NaN,21644.505,22044.773790814226,21244.236209185776,21606.470669066875,21765.60335345864,21781.659183602653,21749.547523314624,77179,213866.23333333334,50.47251572797013,53.98192763662194,NaN,NaN,NaN,NaN,116.40297017587379,10.483175410769798,10053916,-9.219555856536125,34.91497236367286,44.134528220208985
2025-02-11T06:00:00-05:00,21734.25,21806.25,21669.5,21777.5,NaN,NaN,NaN,22018.92133045048,NaN,NaN,21647.21,22049.205576592798,21245.2144234072,21606.470669066875,21757.32805567827,21770.07741929515,21744.57869206139,242532,212098.56666666668,53.04808880782785,53.367924101777426,NaN,NaN,NaN,NaN,117.85632944902567,10.7311811737681,10296448,-8.587734519666839,33.39986007062544,41.987594590292275
2025-02-11T10:00:00-05:00,21777.5,21871.25,21715.75,21802,NaN,NaN,NaN,22018.92133045048,NaN,NaN,21650.84,22055.07688302761,21246.60311697239,21606.470669066875,21779.03728658818,21800.192935988816,21757.881637187544,534134,211237.06666666668,54.483761640478974,52.89434416461732,NaN,NaN,NaN,NaN,120.54516305980954,10.279881871825056,10830582,-6.560798033675404,33.78659704819802,40.34739508187342
2025-02-11T14:00:00-05:00,21802.75,21840.5,21765.75,21792.25,NaN,NaN,NaN,22018.92133045048,NaN,NaN,21653.235,22059.371336837612,21247.09866316239,21606.470669066875,21782.129181689463,21802.95330625036,21761.305057128564,170818,209722.8,53.77900658883346,52.19481271918251,NaN,NaN,NaN,NaN,117.27407998410887,9.860818234306514,10659764,-5.936487359955223,32.92678588192939,38.86327324188461
2025-02-11T18:00:00-05:00,21802,21831.25,21779.5,21811,NaN,NaN,NaN,22018.92133045048,NaN,NaN,21657.33,22065.61204026115,21249.047959738855,21606.470669066875,21807.25,21807.25,21807.25,56664,209231.5,54.984904732475705,52.8186042246151,NaN,NaN,NaN,NaN,112.59378855667252,9.471687713753582,10716428,-4.391708894804481,33.37363712337901,37.76534601818349
2025-02-11T22:00:00-05:00,21810.75,21812.25,21766,21783.5,NaN,NaN,NaN,22018.92133045048,NaN,NaN,21660.86,22070.390513637016,21251.329486362985,21606.470669066875,21800.012162162162,21809.623117380674,21790.40120694365,32136,208620.83333333334,52.80873280953101,53.44803239687372,NaN,NaN,NaN,NaN,107.8549465169102,9.255506510908372,10684292,-5.292536248823168,31.14967570715453,36.4422119559777
2025-02-12T02:00:00-05:00,21783.75,21814,21735.75,21791.25,NaN,NaN,NaN,22018.92133045048,NaN,NaN,21661.875,22072.440271911753,21251.309728088247,21608.267159012797,21791.559162994272,21803.707613670304,21779.41071231824,66866,207088.43333333332,53.36885081829136,53.73030178385583,NaN,NaN,NaN,NaN,105.74030747998805,9.380863243043045,10751158,-5.417363682342,29.670507353050198,35.0878710353922
2025-02-12T06:00:00-05:00,21791,21848.5,21510,21676.75,NaN,NaN,NaN,22018.92133045048,NaN,NaN,21660.18,22069.784736788763,21250.575263211238,21608.267159012797,21708.716960738944,21759.211190811307,21658.22273066658,425597,212242.76666666666,44.89133045962415,53.33687058171891,NaN,NaN,NaN,NaN,122.36599980284605,11.287902785532264,10325561,-12.8386278730311,19.03958619410332,31.878214067134422
2025-02-12T10:00:00-05:00,21677.25,21828.5,21580.5,21792.75,NaN,NaN,NaN,22018.92133045048,NaN,NaN,21660.41,22070.299226011302,21250.520773988697,21608.267159012797,21721.994927566902,21758.93433172627,21685.055523407536,647388,212831.8,53.0313628786882,53.406147751681225,NaN,NaN,NaN,NaN,131.33985695978564,13.058725217843678,10972949,-9.704888995831972,19.74710282234446,29.45199181817643
2025-02-12T14:00:00-05:00,21793,21862.75,21759,21859,NaN,NaN,NaN,22018.92133045048,NaN,NaN,21660.235,22069.77731051253,21250.69268948747,21608.267159012797,21736.099914804243,21785.718980541897,21686.48084906659,190825,212717.33333333334,56.94303297113371,53.511579644363785,NaN,NaN,NaN,NaN,129.3691528912295,14.2440178146695,11163774,-3.2725638200795224,25.361287043077027,28.63385086315655
2025-02-12T18:00:00-05:00,21865,21914.5,21845.25,21887,NaN,NaN,NaN,22018.92133045048,NaN,NaN,21662.93,22076.611399630223,21249.248600369778,21608.267159012797,21882.25,21882.25,21882.25,58968,213131.23333333334,58.51555374185225,53.445444063647464,NaN,NaN,NaN,NaN,125.0749276847131,14.683765773909126,11222742,2.456491422635388,31.704465141450783,29.247973718815395
2025-02-12T22:00:00-05:00,21887.5,21927,21885,21889.5,NaN,NaN,NaN,22018.92133045048,NaN,NaN,21669.295,22086.912704246683,21251.677295753314,21644.87266266531,21889.356796719683,21898.255812420586,21880.45778101878,37608,213094.8,58.660725610189154,53.57783264020636,NaN,NaN,NaN,NaN,119.14100427866217,14.935368227428558,11260350,5.811474885086948,36.51231732517408,30.700842440087133
2025-02-13T02:00:00-05:00,21889.25,21893,21752.75,21834.5,NaN,NaN,NaN,22018.92133045048,NaN,NaN,21685.4,22063.25959032377,21307.540409676232,21644.87266266531,21855.609860815443,21887.397236266985,21823.8224853639,112930,214347.9,54.16955263641351,53.70942072343676,NaN,NaN,NaN,NaN,120.64878968732914,16.17358369120676,11147420,3.8198011758135486,35.47559390985407,31.65579273404052
2025-02-13T06:00:00-05:00,21834.25,21951,21787.25,21920,NaN,NaN,NaN,22018.92133045048,NaN,NaN,21702.475,22042.102564399844,21362.847435600153,21644.87266266531,21875.21864161899,21899.162200975523,21851.27508226246,378120,217481.5,59.3764427243894,54.180990153407045,NaN,NaN,NaN,NaN,123.72744756680562,16.613719302649738,11525540,7.5390288270278205,41.079578767825296,33.540549940797476
2025-02-13T10:00:00-05:00,21919.5,22058,21868.75,21996,21569.58110421283,21569.58110421283,21569.58110421283,NaN,NaN,NaN,21717.725,22039.77186382631,21395.678136173687,21708.54580328464,21927.44873011022,21979.557920553467,21875.339539666973,655789,221545.26666666666,63.361165604412314,55.101608001724344,NaN,NaN,NaN,NaN,128.40762988346236,15.887769541307836,12181329,14.01931997528849,51.064699909908086,37.045379934619596
2025-02-13T14:00:00-05:00,21996.5,22123.75,21987.75,22074.25,21661.310372203156,NaN,NaN,NaN,NaN,NaN,21734.905,22039.049519760392,21430.760480239605,21776.186642627712,21946.755458122025,22014.200880219916,21879.310036024133,208458,219537.9,66.9551739433974,56.0949712256936,NaN,NaN,NaN,NaN,128.9499420346436,14.893844920091892,12389787,22.002121540192483,64.5480318598602,42.54591031966772
2025-02-13T18:00:00-05:00,22072.5,22149.25,22068,22134,21721.034900739374,NaN,NaN,NaN,NaN,NaN,21748.23,22062.596137489243,21433.863862510756,21830.57431410217,22117.083333333332,22117.083333333332,22117.083333333332,58511,220022.73333333334,69.42171738395231,57.161968064513125,NaN,NaN,NaN,NaN,125.54280331788335,14.194920431156142,12448298,29.277421810610704,79.1426875829311,49.8652657723204
2025-02-13T22:00:00-05:00,22135,22148.5,22112.75,22132.75,21755.77763252395,NaN,NaN,NaN,NaN,NaN,21759.8,22087.074808074485,21432.525191925513,21875.684451281737,22121.937550709936,22128.691006960697,22115.184094459175,30229,219741.76666666666,69.30516860989167,58.27097963744585,NaN,NaN,NaN,NaN,119.12903165232025,13.545919120001518,12418069,31.76828405478237,89.57562084079836,57.807336786015995
2025-02-14T02:00:00-05:00,22132,22162,22094.25,22105.25,21761.07751286377,NaN,NaN,NaN,NaN,NaN,21772.55,22102.976920816156,21442.123079183842,21909.87256102539,22121.28263690352,22126.316847931383,22116.24842587566,74258,220260.36666666667,66.65394957464565,59.10448284045799,NaN,NaN,NaN,NaN,115.45910082001167,12.746478751139623,12343811,29.382158098643487,94.53503440932036,65.15287631067687
2025-02-14T06:00:00-05:00,22105,22142,22042.5,22127.25,21761.07751286377,NaN,NaN,NaN,NaN,NaN,21787.085,22114.69476191236,21459.475238087638,21909.87256102539,22110.795731941947,22119.861004542938,22101.730459340957,248485,218773.5,67.7178882392341,60.16942251400821,NaN,NaN,NaN,NaN,114.31916504715369,12.202944650421207,12592296,27.156321564284212,99.09827826603214,71.94195670174793
2025-02-14T10:00:00-05:00,22127.25,22198.75,22091.75,22185.5,21783.26974829116,NaN,NaN,NaN,NaN,NaN,21802.995,22129.185565314492,21476.804434685506,21944.08843905625,22137.838958421227,22162.313495822516,22113.364421019938,534280,206190.43333333332,70.40989773600353,61.38664015098765,NaN,NaN,NaN,NaN,113.79636754378556,11.561808456913322,13126576,27.39912892671319,106.1908678601394,78.79173893342622
2025-02-14T14:00:00-05:00,22184.75,22224,22155.75,22203,21835.041577914293,NaN,NaN,NaN,NaN,NaN,21815.87,22153.18974801374,21478.550251986257,21986.145751245,22147.291294425435,22177.991496755512,22116.591092095357,190373,204947.53333333333,71.18726446013602,63.26492115102422,NaN,NaN,NaN,NaN,110.54305557637231,11.220284039577583,13316949,26.51348813724391,111.93359910498111,85.4201109677372
2025-02-16T18:00:00-05:00,22238,22269.75,22196,22268,21884.11355164546,NaN,NaN,NaN,NaN,NaN,21828.775,22184.427291571097,21473.122708428906,22042.591600996,22244.583333333332,22244.583333333332,22244.583333333332,66561,203589.1,73.92712463749369,64.75747556236746,NaN,NaN,NaN,NaN,107.91498017806,11.348332986325413,13383510,27.937894090221903,120.34247858051458,92.40458449029268
2025-02-16T22:00:00-05:00,22268,22281.75,22250,22275.75,21928.63679929794,NaN,NaN,NaN,NaN,NaN,21842.6,22212.64505131185,21472.554948688146,22084.1482807968,22252.760606227715,22264.34321530824,22241.17799714719,33176,203242.53333333333,74.24163519322866,65.99309000680282,NaN,NaN,NaN,NaN,102.47462445105573,11.582403476107968,13416686,27.018285509098035,126.17744137666523,99.1591558675672
2025-02-17T02:00:00-05:00,22275.75,22276.5,22226,22256.5,21928.63679929794,NaN,NaN,NaN,NaN,NaN,21856.435,22235.50849960111,21477.361500398893,22093.16862463744,22252.833619618366,22262.490332580655,22243.176906656077,43768,202856.73333333334,71.92095416110014,66.95061860817766,NaN,NaN,NaN,NaN,98.76215127598032,11.48543529424206,13372918,22.89304436952304,127.775461329471,104.88241695994796
2025-02-17T06:00:00-05:00,22256.75,22269.75,22192,22212.75,21928.63679929794,NaN,NaN,NaN,NaN,NaN,21870.32,22249.72264943718,21490.91735056282,22093.16862463744,22242.368107103637,22257.92150463067,22226.814709576603,85650,197872.63333333333,66.8095690771815,67.53267885581997,NaN,NaN,NaN,NaN,97.261283327696,10.959778152241828,13287268,15.359116160469767,124.08131216053516,108.7221960000654
2025-02-17T10:00:00-05:00,22213.25,22252.25,22201.25,22235.25,21928.63679929794,NaN,NaN,NaN,NaN,NaN,21885.44,22261.539675086606,21509.34032491339,22093.16862463744,22238.930420226694,22253.38704675443,22224.47379369896,84279,186872.36666666667,68.06652064827914,68.52531942809608,NaN,NaN,NaN,NaN,93.9569059471463,10.471667948955899,13371547,10.276543594817326,121.56787549358705,111.29133189876973
2025-02-17T18:00:00-05:00,22229.5,22257.5,22198.5,22256,21928.63679929794,NaN,NaN,NaN,NaN,NaN,21899.29,22277.94185012081,21520.638149879192,22093.16862463744,22238.71407214533,22252.167010897316,22225.261133393342,49112,183351.16666666666,69.22406380889367,69.2287209341321,NaN,NaN,NaN,NaN,91.45998409377871,10.085610671891143,13420659,6.861766874973995,119.86854049248723,113.00677361751323
2025-02-17T22:00:00-05:00,22256,22303,22249,22298,21972.430287275947,NaN,NaN,NaN,NaN,NaN,21911.045,22301.79196019339,21520.298039806607,22141.083468651494,22242.811865463955,22260.989020785986,22224.634710141923,36663,182209.96666666667,71.47773636231153,69.80847598826776,NaN,NaN,NaN,NaN,88.7842709442231,10.295974139282164,13457322,6.01182652044379,120.52155676806797,114.50973024762418
2025-02-18T02:00:00-05:00,22297.75,22320,22262,22281.5,21993.319819672495,NaN,NaN,NaN,NaN,NaN,21921.25,22323.347202178884,21519.152797821116,22161.466774921195,22249.465284834354,22272.63549796736,22226.29507170135,69227,183352.8,69.3298123906169,69.97809302021201,NaN,NaN,NaN,NaN,86.58539444820715,10.69414867328876,13388095,3.0669956863538204,118.34347485556646,115.27647916921264
2025-02-18T06:00:00-05:00,22281.5,22318.25,22164.75,22202,21993.319819672495,NaN,NaN,NaN,NaN,NaN,21929.675,22337.25893307409,21522.09106692591,22161.466774921195,22241.775747399275,22262.86772361621,22220.68377118234,267962,189712.23333333334,59.97777316371264,69.30352557590918,NaN,NaN,NaN,NaN,91.36500913047807,10.182731607051194,13120133,-5.064002141198685,108.94647649271428,114.01047863391297
2025-02-18T10:00:00-05:00,22202.25,22215.75,22125,22159,21993.319819672495,NaN,NaN,NaN,NaN,NaN,21936.645,22347.742702377094,21525.547297622907,22161.466774921195,22211.11222510656,22251.471427454588,22170.753022758534,507099,198531.13333333333,55.60846000040192,68.3251892466599,NaN,NaN,NaN,NaN,91.32107990687248,10.180910862150446,12613034,-13.678462010973107,96.91240112019659,110.5908631311697
2025-02-18T14:00:00-05:00,22159.25,22249,22103,22225,21993.319819672495,NaN,NaN,NaN,NaN,NaN,21945.565,22361.91435823205,21529.215641767947,22161.466774921195,22208.35876896622,22246.229048711277,22170.488489221163,213655,187848.5,60.37940090566521,67.87700719887559,NaN,NaN,NaN,NaN,95.2267170563816,9.72093081197587,12826689,-15.157060963591519,91.6445369266803,106.80159789027182
2025-02-18T18:00:00-05:00,22227,22291.5,22221.5,22286,21993.319819672495,NaN,NaN,NaN,NaN,NaN,21955.49,22380.086490329068,21530.893509670936,22161.466774921195,22266.333333333332,22266.333333333332,22266.333333333332,50848,183849.5,64.20816312608582,67.62631254793642,NaN,NaN,NaN,NaN,93.42480869521148,9.309354881036814,12877537,-12.370072248760394,91.33900757932133,103.70907982808173
2025-02-18T22:00:00-05:00,22286.25,22290.25,22252.75,22255.25,21993.319819672495,NaN,NaN,NaN,NaN,NaN,21964.275,22395.094408220793,21533.45559177921,22161.466774921195,22266.238824196163,22266.36004855987,22266.117599832458,30906,182990.9,61.00763592547752,66.95472241861314,NaN,NaN,NaN,NaN,89.43017950269639,8.927177230879117,12846631,-12.882671134259198,87.60574091025774,100.48841204451693
2025-02-19T02:00:00-05:00,22255.5,22275.75,22203,22220.5,21993.319819672495,NaN,NaN,NaN,NaN,NaN,21971.8,22407.09125881444,21536.50874118556,22161.466774921195,22251.80044918139,22268.23982367005,22235.361074692733,63065,184021.86666666667,57.51838401502416,65.97837381539087,NaN,NaN,NaN,NaN,88.23873810964665,8.686503838814755,12783566,-15.662424765262557,80.91038108793873,96.57280585320129
2025-02-19T06:00:00-05:00,22220.5,22255.75,22154.5,22167.75,21993.319819672495,NaN,NaN,NaN,NaN,NaN,21977.33,22415.403971378957,21539.256028621046,22161.466774921195,22213.91294583048,22243.94739527807,22183.87849638289,258249,190401.3,52.600375134375575,64.45503456516815,NaN,NaN,NaN,NaN,89.1681139589576,9.05450104887702,12525317,-20.830487904494632,70.534695972583,91.36518387707763
2025-02-19T10:00:00-05:00,22168.25,22264.25,22118,22232.5,21993.319819672495,NaN,NaN,NaN,NaN,NaN,21984.76,22427.269106799075,21542.250893200922,22161.466774921195,22208.920045309867,22229.44837331092,22188.391717308816,502695,192971.23333333334,57.41379319876804,63.25304585127811,NaN,NaN,NaN,NaN,93.24539153331777,9.804539756156384,13028012,-19.67852637057598,66.76702591385765,86.44555228443363
2025-02-19T14:00:00-05:00,22233,22299.75,22205.5,22222.25,21993.319819672495,NaN,NaN,NaN,NaN,NaN,21992.125,22437.92944423532,21546.32055576468,22161.466774921195,22215.868741446655,22238.656062169353,22193.081420723956,236334,179269.43333333332,56.43675954168749,62.14703194989149,NaN,NaN,NaN,NaN,93.31714928093793,9.946117092896666,12791678,-19.367156982055846,62.23660605686382,81.60376303891967
2025-02-19T18:00:00-05:00,22215,22235,22157.5,22184.75,21993.319819672495,NaN,NaN,NaN,NaN,NaN,21997.72,22446.025115294997,21549.414884705006,22114.673419936957,22192.416666666668,22192.416666666668,22192.416666666668,64659,175063.9,52.890557201796874,61.15281681593545,NaN,NaN,NaN,NaN,92.18735290372807,10.6222188418486,12727019,-21.293866633851977,54.9864297466047,76.28029638045668
2025-02-19T22:00:00-05:00,22185,22191.25,22144,22159.5,21993.319819672495,NaN,NaN,NaN,NaN,NaN,22008.42,22445.992718985504,21570.847281014492,22090.163032806176,22182.193578607126,22195.483551976726,22168.903605237527,38260,174373.63333333333,50.58570009727293,59.904186776577866,NaN,NaN,NaN,NaN,88.97754198203322,11.396886098399065,12688759,-23.692060154507374,46.66522118732246,70.35728134182983
2025-02-20T02:00:00-05:00,22159.5,22219.75,22140.5,22204,21993.319819672495,NaN,NaN,NaN,NaN,NaN,22020.99,22443.960932334343,21598.01906766566,22090.163032806176,22184.290233697106,22195.32206096295,22173.25840643126,56889,175016.33333333334,54.360468833225205,58.842501421172976,NaN,NaN,NaN,NaN,88.28271755474512,11.64056130849477,12745648,-21.754772314034426,43.1638159492868,64.91858826332123
2025-02-20T06:00:00-05:00,22204.25,22227,22000.5,22010.25,21993.319819672495,NaN,NaN,NaN,NaN,NaN,22027.685,22439.006380552695,21616.363619447307,22090.163032806176,22116.43342138393,22167.091389401725,22065.775453366132,291637,180973.23333333334,40.024428219506795,56.59583655382978,NaN,NaN,NaN,NaN,98.15538058654904,13.234884147765671,12454011,-32.35661945637567,24.472813942851644,56.82943339922731
2025-02-20T10:00:00-05:00,22011,22108,21950.75,22068,NaN,NaN,NaN,22341.614924051977,22341.614924051977,22341.614924051977,22035.155,22435.418811629654,21634.891188370344,22090.163032806176,22072.831942417706,22121.73327303834,22023.930611797074,643637,189823.8,44.70527765110744,54.83694121529339,NaN,NaN,NaN,NaN,102.37642483036697,15.089016404664054,13097648,-34.13809740564626,14.156811642169487,48.29490904781575
2025-02-20T14:00:00-05:00,22067.25,22149.75,22055,22137.5,NaN,NaN,NaN,22341.614924051977,NaN,NaN,22043.385,22434.70584291597,21652.064157084027,22079.30542624494,22079.912640695915,22127.05948508505,22032.76579630678,226918,175528.1,49.784588582046815,54.10885660231725,NaN,NaN,NaN,NaN,101.83168019962648,16.146440474461603,13324566,-29.470085626527556,11.457302014656307,40.92738764118386
2025-02-20T18:00:00-05:00,22134.75,22173.75,22125,22150.75,NaN,NaN,NaN,22341.614924051977,NaN,NaN,22050.545,22436.321731932312,21664.768268067684,22061.145378237412,22149.833333333332,22149.833333333332,22149.833333333332,51472,170295.23333333334,50.71411016099802,53.75926018521698,NaN,NaN,NaN,NaN,98.04013161393888,16.75982217870837,13376038,-24.526938827432907,10.26871410689273,34.79565293432564
2025-02-20T22:00:00-05:00,22151,22155.25,22111.75,22152.25,NaN,NaN,NaN,22341.614924051977,NaN,NaN,22056.025,22439.634479157645,21672.415520842358,22061.145378237412,22145.927505871896,22150.839559623288,22141.015452120504,32544,169429.66666666666,50.82508541037288,53.076809078410385,NaN,NaN,NaN,NaN,94.14440792722895,17.453418690669615,13408582,-20.364426346417993,9.340120001303148,29.70454634772114
2025-02-21T02:00:00-05:00,22152.75,22178,22104.25,22169.25,NaN,NaN,NaN,22341.614924051977,NaN,NaN,22062.67,22442.36388248997,21682.976117510025,22061.145378237412,22147.89083738578,22152.237187305003,22143.54448746656,63220,170529.36666666667,52.14035667216677,52.21482290313045,NaN,NaN,NaN,NaN,92.68766450385546,17.727886613648465,13471802,-15.873817678938583,9.862274249047914,25.736091927986497
2025-02-21T06:00:00-05:00,22169.25,22245.75,22073,22095.75,NaN,NaN,NaN,22341.614924051977,NaN,NaN,22069.325,22439.316435711244,21699.333564288758,22014.259433657553,22141.557385545068,22146.8547404325,22136.260030657635,275019,177221.4,46.36610827001572,51.1689994991689,NaN,NaN,NaN,NaN,98.40640275358007,16.977803121101168,13196783,-17.15228873886023,4.295731004411209,21.448019743271438
2025-02-21T10:00:00-05:00,22093.5,22111.5,21756,21772.25,NaN,NaN,NaN,22270.987474870526,NaN,NaN,22069.345,22439.27208592323,21699.417914076774,22014.259433657553,21966.03691463856,22089.021072988184,21843.052756288937,860592,197624.96666666667,30.40560109037075,49.23237214740794,NaN,NaN,NaN,NaN,116.77023112832434,18.72569115128469,12336191,-37.89501005956275,-25.920742831181997,11.97426722838075
2025-02-21T14:00:00-05:00,21772.5,21784.5,21652.25,21659.5,NaN,NaN,NaN,22058.317589649138,NaN,NaN,22067.855,22443.725324580206,21691.984675419793,22014.259433657553,21907.51910073582,22062.53663754525,21752.501563926387,359581,191801.66666666666,26.926600384568502,47.39853109385029,NaN,NaN,NaN,NaN,117.8759289048726,20.829921626216034,11976610,-56.214235588307005,-58.29352725700301,-2.079291668696003
2025-02-23T18:00:00-05:00,21700.75,21792.75,21677.75,21777.5,NaN,NaN,NaN,22058.317589649138,NaN,NaN,22067.855,22443.725324580206,21691.984675419793,21985.52405678138,21749.333333333332,21749.333333333332,21749.333333333332,106918,189019.83333333334,35.273636139903516,45.8170913039314,NaN,NaN,NaN,NaN,118.97407684023884,22.680579841113683,12083528,-57.20008729246254,-73.57940078427418,-16.37931349181164
2025-02-23T22:00:00-05:00,21778,21802.25,21765.5,21785,NaN,NaN,NaN,22058.317589649138,NaN,NaN,22067.515,22444.376093906038,21690.65390609396,21985.52405678138,21759.7972868674,21775.793288060187,21743.801285674614,45753,188326.23333333334,35.77578869903549,44.34130767231339,NaN,NaN,NaN,NaN,113.10092849450749,24.273749131139176,12129281,-54.19151739377178,-84.11871023402637,-29.927192840254584
2025-02-24T02:00:00-05:00,21785.25,21813,21701,21763.25,NaN,NaN,NaN,22058.317589649138,NaN,NaN,22066.935,22445.57394160513,21688.296058394873,21985.52405678138,21759.507513964232,21771.84217937709,21747.172848551374,104295,190696.86666666667,34.92947911210332,43.05837352304957,NaN,NaN,NaN,NaN,113.0222907448998,26.06899299361772,12024986,-50.58018886144668,-93.15242891706293,-42.572240055616255
2025-02-24T06:00:00-05:00,21763.5,21805.75,21561,21568,NaN,NaN,NaN,22033.92099680501,NaN,NaN,22062.075,22459.501273036803,21664.648726963198,21985.52405678138,21695.946770190858,21753.4903602906,21638.403180091114,320065,199906.76666666666,28.428113996199457,41.47568880154432,NaN,NaN,NaN,NaN,122.43141283454982,28.307608494142166,11704921,-57.73745689466504,-114.74406117394756,-57.00660427928252
2025-02-24T10:00:00-05:00,21567.75,21661.25,21436.75,21608.25,NaN,NaN,NaN,21914.225724222964,NaN,NaN,22058.57,22468.651394847493,21648.488605152506,21985.52405678138,21619.8869669029,21692.141355704614,21547.632578101187,858261,225660.46666666667,31.268188689804035,39.82624021987139,NaN,NaN,NaN,NaN,129.72202620351055,30.785833337466794,12563182,-56.10842164324988,-127.14213133334488,-71.033709690095
2025-02-24T14:00:00-05:00,21608.25,21639.75,21407.25,21427,NaN,NaN,NaN,21903.829100394647,NaN,NaN,22051.285,22491.907423510223,21610.662576489776,21985.52405678138,21597.31143137326,21679.14292318297,21515.479939563545,305747,233042.73333333334,26.222132112632977,38.84036192652326,NaN,NaN,NaN,NaN,137.06331004611692,33.17289461951634,12257435,-63.06542852485714,-149.86549534616643,-86.80006682130929
2025-02-24T18:00:00-05:00,21440.25,21453.25,21366.5,21438,NaN,NaN,NaN,21784.74595946762,NaN,NaN,22046.51,22507.947189225553,21585.072810774443,21985.52405678138,21419.25,21419.25,21419.25,117256,235314.2,26.99218068740862,37.57514071483048,NaN,NaN,NaN,NaN,133.46950218568,35.507321348699115,12374691,-62.62661774214405,-165.08333899898935,-102.4567212568453
2025-02-24T22:00:00-05:00,21438,21445.25,21409.5,21422.5,NaN,NaN,NaN,21784.74595946762,NaN,NaN,22039.105,22527.67893596061,21550.53106403939,21725.569245425104,21420.887678709274,21423.709543353387,21418.06581406516,39493,235408.53333333333,26.57132907501844,35.91705075004274,NaN,NaN,NaN,NaN,126.48953774384572,37.67500331151169,12335198,-59.123684275835785,-176.36132660164003,-117.23764232580425
2025-02-25T02:00:00-05:00,21421.75,21425.25,21286.5,21296.5,NaN,NaN,NaN,21721.01517174632,NaN,NaN,22027.855,22556.740801378794,21498.969198621206,21507.726762926122,21376.31686017183,21418.708121694217,21333.925598649446,173647,238889.2,23.380081007306543,33.96462009620764,NaN,NaN,NaN,NaN,127.36528504785674,40.026755550048776,12161551,-60.8009446498927,-193.23882313817012,-132.43787848827742
2025-02-25T06:00:00-05:00,21296.5,21451.75,21211,21260.75,NaN,NaN,NaN,21712.74743666694,NaN,NaN,22015.33,22585.050531839566,21445.609468160437,21507.726762926122,21337.33845782374,21381.205096090853,21293.471819556624,436477,244506.36666666667,22.552460208208842,31.945146867481636,NaN,NaN,NaN,NaN,135.46419325872412,42.3871961824914,11725074,-59.73900359454419,-207.11163298145766,-147.37262938691347
2025-02-25T10:00:00-05:00,21262,21281.75,20990.5,21199.5,NaN,NaN,NaN,21539.878235000262,NaN,NaN,22001.53,22614.55476002218,21388.505239977818,21507.726762926122,21234.035946129825,21327.59156923739,21140.48032302226,1031698,261993,21.169795798610224,29.732963947941887,NaN,NaN,NaN,NaN,146.59175088310096,44.98146705028235,10693376,-58.50704600948782,-220.50643689877325,-161.99939088928542
2025-02-25T14:00:00-05:00,21199.25,21263,21121.25,21195.5,NaN,NaN,NaN,21539.878235000262,NaN,NaN,21988.75,22640.58500212852,21336.91499787148,21507.726762926122,21227.007059677657,21313.502907820617,21140.511211534696,374498,267354.43333333335,21.07890717391635,27.926735298220503,NaN,NaN,NaN,NaN,146.24591153430802,47.390432856088225,10318878,-53.446195963526606,-228.8071358436937,-175.36093988016708
2025-02-25T18:00:00-05:00,21225,21251,21198.5,21242.5,NaN,NaN,NaN,21539.878235000262,NaN,NaN,21975.2,22659.54454772417,21290.85545227583,21439.1564103409,21230.666666666668,21230.666666666668,21230.666666666668,56964,267558.3,25.14552341559768,27.551015464308136,NaN,NaN,NaN,NaN,139.76406071042888,49.62732967576512,10375842,-42.87425287675302,-228.95375597610837,-186.07950309935535
2025-02-25T22:00:00-05:00,21243.25,21282.75,21232.25,21276.5,NaN,NaN,NaN,21539.878235000262,NaN,NaN,21960.81,22672.511549527364,21249.10845047264,21255.72512827272,21244.663849374647,21261.044287996825,21228.28341075247,41594,267914.56666666665,28.0344115422255,27.630144832712208,NaN,NaN,NaN,NaN,133.38805637396968,51.24154173655591,10417436,-30.134172700286257,-223.74721897471318,-193.61304627442692
2025-02-26T02:00:00-05:00,21276.75,21328,21262,21320.25,NaN,NaN,NaN,21539.878235000262,NaN,NaN,21945.73,22678.809360233336,21212.650639766664,21199.080102618176,21270.2401654654,21301.863681131672,21238.616649799125,75980,268345.06666666665,31.687793527068493,27.37401321750971,NaN,NaN,NaN,NaN,128.574623775829,52.09183819982385,10493416,-16.01209815730607,-213.6281689710595,-197.61607081375342
2025-02-26T06:00:00-05:00,21320.5,21332.5,21188.5,21300.5,NaN,NaN,NaN,21539.878235000262,NaN,NaN,21929.06,22681.89722384033,21176.222776159673,21110.64626567563,21272.703353723537,21290.515655711206,21254.891051735867,380467,272419,30.924577120776064,27.027498104776893,NaN,NaN,NaN,NaN,129.6764363632698,53.103686795883235,10112949,-5.78004564404597,-204.84112786881087,-199.0610822247649
2025-02-26T10:00:00-05:00,21300.75,21409.75,21079.75,21101.75,NaN,NaN,NaN,21539.878235000262,NaN,NaN,21908.44,22693.614710239795,21123.265289760202,21110.64626567563,21226.776464788178,21265.354908264642,21188.198021311713,858436,284277.0333333333,24.523385316215737,26.284205690784923,NaN,NaN,NaN,NaN,143.98526233732196,54.3290883989999,9254513,-9.932752607329576,-211.47702298392687,-201.5442703765973
2025-02-26T14:00:00-05:00,21101.25,21327.25,21064.75,21275,NaN,NaN,NaN,21539.878235000262,NaN,NaN,21891.835,22694.578661513617,21089.09133848638,21088.192012540505,21225.868544219047,21260.326980220303,21191.41010821779,363003,288499.3333333333,36.803463636994984,26.88244495084175,NaN,NaN,NaN,NaN,152.45060074179895,55.50373558344105,9617516,0.8789533221793988,-200.44557872387304,-201.32453204605244
2025-02-26T18:00:00-05:00,21250.75,21262.5,21107.75,21184.5,NaN,NaN,NaN,21539.878235000262,NaN,NaN,21872.98,22696.73211586977,21049.22788413023,21061.728610032405,21184.916666666668,21184.916666666668,21184.916666666668,132497,290760.6,33.7174133841355,27.05738957186543,NaN,NaN,NaN,NaN,153.50770068881334,56.59447939756497,9485019,3.6693837093892228,-196.73780240931592,-200.40718611870514
2025-02-26T22:00:00-05:00,21184.75,21295.25,21147,21281,NaN,NaN,NaN,21539.878235000262,NaN,NaN,21854.89,22690.04284924392,21019.73715075608,21033.301790935417,21204.5058186209,21231.273756414463,21177.737880827335,70959,291850.56666666665,39.539142829475814,28.008604623068486,NaN,NaN,NaN,NaN,153.13215063961238,57.09507338795966,9555978,13.211494878942375,-183.89281752002717,-197.10431239896954
2025-02-27T02:00:00-05:00,21280.75,21348.5,21250,21321.5,NaN,NaN,NaN,21539.878235000262,NaN,NaN,21837.26,22679.46125837026,20995.05874162974,21033.301790935417,21237.29744875937,21289.84516566187,21184.74973185687,96176,293160.13333333336,41.84765514119172,29.06970994119585,NaN,NaN,NaN,NaN,149.22985416535434,56.75948686320932,9652154,22.88131468294904,-168.50266904528326,-191.3839837282323
2025-02-27T06:00:00-05:00,21322,21386.5,20996,21008,NaN,NaN,NaN,21539.878235000262,NaN,NaN,21812.06,22676.3132126639,20947.806787336103,21033.301790935417,21168.91410370775,21229.315945419003,21108.512261996497,528805,301065.73333333334,31.743854646236827,29.43917605342574,NaN,NaN,NaN,NaN,166.46343601068617,57.3328550073556,9123349,9.480667716125168,-179.53314908307584,-189.013816799201
2025-02-27T10:00:00-05:00,21008.25,21167.25,20896.5,21051.5,NaN,NaN,NaN,21503.074063484208,NaN,NaN,21787.575,22667.126591721633,20908.023408278368,21033.301790935417,21094.35747119062,21170.085426488207,21018.62951589303,1104122,316415.23333333334,34.120689854730315,30.206362399670297,NaN,NaN,NaN,NaN,173.91247629563716,58.11411777180358,10227471,5.0836808075227395,-182.6592157897976,-187.74289659732034
2025-02-27T14:00:00-05:00,21051.75,21056.75,20582.5,20633.25,NaN,NaN,NaN,21334.07637878038,NaN,NaN,21755.11,22681.609401834612,20828.61059816539,21033.301790935417,21015.492121361756,21172.777670523094,20858.20657220042,590762,328543.36666666664,25.07824558865869,30.386775641131003,NaN,NaN,NaN,NaN,195.3651565602345,59.40987037163655,9636709,-22.91888209173561,-216.39149921198987,-193.47261712025426
2025-02-27T18:00:00-05:00,20649.5,20687.75,20538.25,20587.5,NaN,NaN,NaN,21124.453588835815,NaN,NaN,21722.605,22695.47967892845,20749.73032107155,21024.741432748335,20604.5,20604.5,20604.5,150296,331837.5,24.319048645053826,30.61172227301983,NaN,NaN,NaN,NaN,192.0890739487892,60.67545804884985,9486413,-40.4247055463336,-244.00349905317125,-203.57879350683766
2025-02-27T22:00:00-05:00,20588,20646.75,20516.5,20595.25,NaN,NaN,NaN,21087.59206207055,NaN,NaN,21689.805,22701.15643886777,20678.45356113223,20998.543146198666,20596.323573645524,20605.436597399002,20587.210549892046,120990,334785.7,24.73471730809335,30.87285156831819,NaN,NaN,NaN,NaN,187.6719972381614,61.88184889660261,9607403,-46.92731078490232,-262.23793198796557,-215.31062120306325
2025-02-28T02:00:00-05:00,20595.5,20683.75,20553,20657,NaN,NaN,NaN,21087.59206207055,NaN,NaN,21657.825,22696.299651833142,20619.35034816686,20950.799672682973,20606.61048779473,20624.27547508406,20588.945500505397,113261,336453.73333333334,28.122187602779007,31.08547043883114,NaN,NaN,NaN,NaN,183.60614029257843,62.57329093353802,9720664,-42.639324021917275,-268.60977623045983,-225.97045220854255
2025-02-28T06:00:00-05:00,20657.75,20677.25,20460.25,20594.25,NaN,NaN,NaN,21076.375463580815,NaN,NaN,21623.75,22687.467349675142,20560.032650324858,20950.799672682973,20590.38828171728,20609.170437624147,20571.606125810416,474811,343113.4666666667,26.80207589546376,30.997446464062445,NaN,NaN,NaN,NaN,185.9914159859657,63.38522368598735,9245853,-39.660902093352746,-275.5465798252335,-235.88567773188075
2025-02-28T10:00:00-05:00,20593.25,20777.75,20483.75,20542.25,NaN,NaN,NaN,21076.375463580815,NaN,NaN,21588.965,22677.824582361267,20500.105417638733,20950.799672682973,20596.444038646005,20610.052596621503,20582.835480670507,1082835,350521.56666666665,25.724416758909953,30.571490980622546,NaN,NaN,NaN,NaN,193.70631484411098,63.034474401780685,8163018,-36.88298872712974,-281.9894136407929,-245.10642491366318
2025-02-28T14:00:00-05:00,20541.75,20944.25,20537.25,20910,NaN,NaN,NaN,21076.375463580815,NaN,NaN,21563.125,22653.885694423814,20472.364305576186,20950.799672682973,20637.594328773583,20719.531343190425,20555.65731435674,500850,355230.5333333333,43.137416432010475,31.443836645710718,NaN,NaN,NaN,NaN,208.94157806953163,61.158945332367786,8663868,-7.504844872794848,-254.48748100465673,-246.98263613186188
2025-03-02T18:00:00-05:00,21000,21036,20836.5,20928.75,NaN,NaN,NaN,21076.375463580815,NaN,NaN,21538.52,22629.907391534187,20447.132608465814,20873.08973814638,20933.75,20933.75,20933.75,170589,357352.9,43.8600741245937,32.825028703452,NaN,NaN,NaN,NaN,208.26717963599367,58.68322691122378,8834457,14.750497660639638,-228.54451405606233,-243.29501171670196
2025-03-02T22:00:00-05:00,20928.5,21021.75,20883.75,21007.5,NaN,NaN,NaN,21076.375463580815,NaN,NaN,21514.17,22597.50417946648,20430.835820533517,20621.146790517105,20945.82961355795,20963.26660129572,20928.392625820183,81868,358556.73333333334,46.91175013797871,33.547049167807984,NaN,NaN,NaN,NaN,203.24809537627985,56.38434552016148,8916325,35.17018494808579,-199.33228053159473,-234.50246547968052
2025-03-03T02:00:00-05:00,21008,21020.75,20888.25,21003.5,NaN,NaN,NaN,21076.375463580815,NaN,NaN,21488.52,22558.186414542397,20418.853585457604,20501.70342026376,20954.491827776885,20972.938195765826,20936.045459787943,133821,359540.93333333335,46.77267391106894,34.47956777687465,NaN,NaN,NaN,NaN,198.19465999225986,54.2496699427465,8782504,48.00781369374948,-174.49269836249368,-222.50051205624317
2025-03-03T06:00:00-05:00,21003.5,21120.75,20824.25,20859.75,20412.173902650746,20412.173902650746,20412.173902650746,NaN,NaN,NaN,21460.61,22521.585264367543,20399.63473563246,20557.262736211007,20944.272678707533,20960.342616988237,20928.20274042683,421914,362935.9,41.958480223672105,34.65237759074582,NaN,NaN,NaN,NaN,205.21646999281273,51.428953818464606,8360590,46.39224728537479,-164.51020294952468,-210.90245023489948
2025-03-03T10:00:00-05:00,20838,20989.25,20652.75,20747.25,20412.173902650746,NaN,NaN,NaN,NaN,NaN,21431.145,22487.890826062274,20374.399173937727,20557.262736211007,20860.61901664893,20934.66559978135,20786.572433516507,1053049,369428.8333333333,38.60919978070783,34.42105935071125,NaN,NaN,NaN,NaN,214.59386499332612,49.700589730411146,7307541,37.69095349864594,-163.78875836159204,-201.47971186023798
2025-03-03T14:00:00-05:00,20747.25,20819.75,20317.5,20531,NaN,NaN,NaN,21191.459315973185,21191.459315973185,21191.459315973185,21398.41,22463.228927142067,20333.591072857933,20557.262736211007,20785.88546026702,20931.86941449567,20639.90150603837,605291,379413.63333333336,33.13406557756359,34.52036013152031,NaN,NaN,NaN,NaN,235.14073177951713,49.319688685270066,6702250,18.29761133482222,-178.6076976917102,-196.90530902653242
2025-03-03T18:00:00-05:00,20525,20570.75,20466.25,20523,NaN,NaN,NaN,21127.273665247132,NaN,NaN,21364.22,22429.496699454037,20298.943300545965,20557.262736211007,20520,20520,20520,140740,380196.43333333335,32.947920936531204,34.43659092307751,NaN,NaN,NaN,NaN,225.80925093812306,48.96599485763905,6561510,6.467655962408003,-188.82073907352242,-195.28839503593042
2025-03-03T22:00:00-05:00,20522.25,20591.75,20480,20559.25,NaN,NaN,NaN,21127.273665247132,NaN,NaN,21330.96,22390.83283841043,20271.087161589567,20557.262736211007,20530.135550301566,20541.846455925006,20518.424644678125,105422,382394.06666666665,34.73706422512788,35.12650653996817,NaN,NaN,NaN,NaN,217.66216158539996,48.46411781809855,6666932,2.807621240116987,-191.7788684857842,-194.58648972590117
2025-03-04T02:00:00-05:00,20559.5,20568.5,20443.5,20462.75,NaN,NaN,NaN,21092.279827218976,NaN,NaN,21296.52,22355.090960493435,20237.949039506566,20557.262736211007,20514.309680636812,20535.298027741177,20493.321333532447,171419,382319.8,32.26865202202438,35.69433535260892,NaN,NaN,NaN,NaN,211.04343575787138,48.12467092209814,6495513,-4.017994436805395,-199.6089827719079,-195.5909883351025
2025-03-04T06:00:00-05:00,20462.75,20494,20227.75,20231,NaN,NaN,NaN,20956.812562345385,NaN,NaN,21257.95,22328.403067630592,20187.49693236941,20557.262736211007,20397.779579187623,20495.374930194263,20300.184228180984,606771,387996.26666666666,27.258960579394397,35.87463844341614,NaN,NaN,NaN,NaN,214.9867617751663,48.463563647870735,5888742,-21.09210608527269,-221.95612094169337,-200.86401485642068
2025-03-04T10:00:00-05:00,20230.75,20523,20075.75,20501.75,NaN,NaN,NaN,20929.213127693325,NaN,NaN,21223.905,22280.020405105035,20167.789594894963,20557.262736211007,20381.490989351798,20450.41260202146,20312.569376682135,1138330,391550.6666666667,39.14551884853301,36.66201924668428,NaN,NaN,NaN,NaN,231.57699307694014,49.148127829205016,7027072,-11.578274071465614,-215.33685744575268,-203.75858337428707
2025-03-04T14:00:00-05:00,20500.25,20733,20324,20536.25,NaN,NaN,NaN,20929.213127693325,NaN,NaN,21194.425,22243.360623620494,20145.489376379504,20557.262736211007,20409.18001865422,20494.305393990056,20324.054643318384,491230,395441.73333333334,40.48018758643498,37.6390272246108,NaN,NaN,NaN,NaN,244.25006500001584,48.19763936028381,7518302,-0.9488987075061743,-204.94470675866978,-203.9958080511636
2025-03-04T18:00:00-05:00,20553.25,20594.75,20440.5,20479.25,NaN,NaN,NaN,20929.213127693325,NaN,NaN,21162.65,22199.999844555736,20125.300155444267,20557.262736211007,20504.833333333332,20504.833333333332,20504.833333333332,151796,398602.8,38.95985467733914,38.58441564735574,NaN,NaN,NaN,NaN,237.82148892858615,47.31504292485697,7366506,3.985314688656473,-199.01416469034302,-202.9994793789995
2025-03-04T22:00:00-05:00,20479.5,20568.5,20458.5,20549.25,NaN,NaN,NaN,20929.213127693325,NaN,NaN,21130.885,22143.86713315952,20117.902866840475,20370.210188968806,20512.83038999264,20522.862995226784,20502.797784758495,96448,400431.26666666666,41.84831465014925,38.492336948651364,NaN,NaN,NaN,NaN,228.6913825765443,46.49548909196062,7462954,13.187011243921205,-186.51571532409798,-199.7027265680192
2025-03-05T02:00:00-05:00,20547.75,20631.25,20513,20545.5,NaN,NaN,NaN,20929.213127693325,NaN,NaN,21098.78,22081.741828557137,20115.81817144286,20101.799547313476,20531.500624856257,20557.116047619307,20505.885202093206,145980,402764.6,41.73437820814383,38.340501526047795,NaN,NaN,NaN,NaN,220.8027123925054,45.251034925763946,7316974,19.84450685727367,-174.8970929964271,-194.74159985370076
2025-03-05T06:00:00-05:00,20546.25,20557.75,20270.25,20314.75,NaN,NaN,NaN,20929.213127693325,NaN,NaN,21062.03,22021.8237415926,20102.236258407396,20101.799547313476,20448.869746260683,20525.75355026431,20371.985942257055,479376,406061.56666666665,35.3555935783688,37.515061771789945,NaN,NaN,NaN,NaN,225.5668043644693,44.96631083038281,6837598,10.026510356693308,-182.20846190783413,-192.23497226452744
2025-03-05T10:00:00-05:00,20318.75,20597,20215,20590.5,NaN,NaN,NaN,20929.213127693325,NaN,NaN,21030.455,21945.292940238403,20115.6170597616,20101.799547313476,20459.250549865694,20511.241618677494,20407.259481053894,1099306,414090.56666666665,45.981071063652834,37.45851871126023,NaN,NaN,NaN,NaN,236.7406040527215,44.871537698063065,7936904,22.6974644608394,-163.8631416884782,-186.5606061493176
2025-03-05T14:00:00-05:00,20590.5,20725.5,20558,20610.25,NaN,NaN,NaN,20929.213127693325,NaN,NaN,21000.745,21870.650296512216,20130.83970348778,20125.8713682245,20491.482487945585,20573.345210883785,20409.619765007385,454974,417156.26666666666,46.65735383161253,37.794152540398834,NaN,NaN,NaN,NaN,231.79484662038425,43.8401218639889,8391878,32.410770718704896,-146.04714275093647,-178.45791346964137
2025-03-05T18:00:00-05:00,20608,20643.5,20582.25,20605.75,NaN,NaN,NaN,20929.213127693325,NaN,NaN,20977.415,21825.602571295287,20129.227428704715,20133.1720945796,20610.5,20610.5,20610.5,67753,414998.13333333336,46.514464280073014,38.35881429035349,NaN,NaN,NaN,NaN,219.61307186178536,42.88237858949145,8324125,38.13964399109386,-130.78335848077404,-168.9230024718679
2025-03-05T22:00:00-05:00,20606.25,20648.5,20592.5,20634.25,NaN,NaN,NaN,20929.213127693325,NaN,NaN,20956.91,21787.53754445056,20126.28245554944,20212.23767566368,20616.28270108902,20623.41652373958,20609.148878438464,44519,414116.8,47.60881275937966,39.39272480334035,NaN,NaN,NaN,NaN,207.92642387165782,41.954546611823744,8368644,43.089889798500195,-115.06064022374267,-158.15053002224286
2025-03-06T02:00:00-05:00,20635,20642.5,20364.75,20380,NaN,NaN,NaN,20929.213127693325,NaN,NaN,20928.96,21741.10154160466,20116.818458395337,20212.23767566368,20518.939314916548,20593.241407271304,20444.637222561792,193355,417356.1,39.78769456687965,39.88128006265095,NaN,NaN,NaN,NaN,212.9138221665394,41.93698779698262,8175289,29.149951910775712,-121.71309013377322,-150.86304204454893
2025-03-06T06:00:00-05:00,20379,20430.75,20228.25,20282.25,NaN,NaN,NaN,20929.213127693325,NaN,NaN,20898.905,21693.131050252796,20104.678949747202,20212.23767566368,20392.288073085998,20502.10647392543,20282.469672246567,492857,416157.8333333333,37.25377801827891,40.061045333590314,NaN,NaN,NaN,NaN,212.16997772607232,42.32918554786514,7682432,14.021793175975574,-133.33580057457948,-147.35759375055505
2025-03-06T10:00:00-05:00,20282.25,20513.25,20042,20119,NaN,NaN,NaN,20929.213127693325,NaN,NaN,20866.02,21650.47018222965,20081.569817770353,20212.23767566368,20295.171826578124,20404.29724458381,20186.046408572438,1101161,416059.13333333336,33.4251908823656,40.143655252186115,NaN,NaN,NaN,NaN,230.67569360278142,43.166527216247445,6581271,-5.270091770156199,-153.9452084632503,-148.6751166930941
2025-03-06T14:00:00-05:00,20118.75,20216.5,20002.75,20175.25,NaN,NaN,NaN,20761.65926721525,NaN,NaN,20838.165,21619.835944899285,20056.494055100717,20212.23767566368,20260.02811019446,20377.79203725905,20142.26418312987,519424,413681.2,35.87075124041003,40.758783156544375,NaN,NaN,NaN,NaN,229.46671548829704,44.03530182463572,7100695,-12.140418340415152,-163.85063961861306,-151.7102212781979
2025-03-06T18:00:00-05:00,20212,20225,20141.25,20196.25,NaN,NaN,NaN,20761.65926721525,NaN,NaN,20809.925,21580.21156518218,20039.638434817818,20212.23767566368,20187.5,20187.5,20187.5,90502,411688.06666666665,36.80408910578065,40.59153817491921,NaN,NaN,NaN,NaN,219.0583786677044,44.770547824931874,7191197,-13.086901075180123,-168.06884762217305,-154.98194654699293
2025-03-06T22:00:00-05:00,20197,20199.5,20113.5,20128.75,NaN,NaN,NaN,20761.65926721525,NaN,NaN,20783.96,21556.81321607681,20011.106783923187,20212.23767566368,20171.56323085754,20191.247598952385,20151.878862762696,59322,409632.4666666667,35.03885697134454,40.20287170241274,NaN,NaN,NaN,NaN,209.5542087628684,45.52552582147334,7131875,-15.88885262194583,-174.84301232442522,-158.9541597024794
2025-03-07T02:00:00-05:00,20128,20228,20119.5,20178.25,NaN,NaN,NaN,20761.65926721525,NaN,NaN,20758.765,21526.809428467583,19990.720571532416,20212.23767566368,20173.14361219369,20188.133853904834,20158.153370482545,112410,409604.1,37.40967945115363,40.09214490054235,NaN,NaN,NaN,NaN,202.3360509940921,45.961279553352846,7244285,-12.204012567806501,-174.20917541223753,-162.00516284443103
2025-03-07T06:00:00-05:00,20178.25,20270.75,20024.25,20140,NaN,NaN,NaN,20757.178286030194,NaN,NaN,20733.115,21496.427931961636,19969.802068038367,20212.23767566368,20154.19204723929,20169.927225735315,20138.456868743262,540657,411798.9666666667,36.30700644065905,39.69633717129305,NaN,NaN,NaN,NaN,205.49061878022835,46.639694909929055,6703628,-10.21872719954385,-174.77857184386085,-164.559844644317
2025-03-07T10:00:00-05:00,20139.5,20193,19766,20169.5,NaN,NaN,NaN,20619.69290939246,NaN,NaN,20710.575,21472.569201093203,19948.580798906798,20212.23767566368,20084.17524364173,20138.82456517199,20029.52592211147,1359779,421030.43333333335,37.82904466213296,39.417384775149415,NaN,NaN,NaN,NaN,221.31271743878347,47.86742347238579,8063407,-5.055824452101177,-170.87962520944347,-165.8238007573423
2025-03-07T14:00:00-05:00,20169.5,20286.75,20099,20207,NaN,NaN,NaN,20619.69290939246,NaN,NaN,20689.5,21447.741491874513,19931.258508125487,20154.615140530943,20105.86911453657,20172.238436873424,20039.499792199716,511553,421387.2,39.798451734480345,39.734731786300244,NaN,NaN,NaN,NaN,218.9153804788704,48.20670912579296,8574960,2.350163971769888,-162.88609579262993,-165.23625976439982
2025-03-09T18:00:00-04:00,20149.5,20149.5,19933,20133.75,NaN,NaN,NaN,20619.69290939246,NaN,NaN,20668.185,21427.799038903846,19908.570961096157,19939.192112424756,20072.083333333332,20072.083333333332,20072.083333333332,165648,421222.5,37.31212080906473,39.11552105382966,NaN,NaN,NaN,NaN,222.8499961589511,48.91240641258729,8409312,3.7006781239566067,-160.61041210945405,-164.31109023341065
2025-03-09T22:00:00-04:00,20133.25,20156,20077,20091,NaN,NaN,NaN,20619.69290939246,NaN,NaN,20646.095,21407.323040011543,19884.86695998846,19884.378689939804,20083.74671841114,20100.565617379725,20066.927819442557,79660,421148.9,35.902411560116306,38.34731089157993,NaN,NaN,NaN,NaN,212.57499643331172,49.51300258135262,8329652,3.12294628562708,-160.4074073763768,-163.53035366200388
2025-03-10T02:00:00-04:00,20091.25,20141.25,19947.5,20003,NaN,NaN,NaN,20619.69290939246,NaN,NaN,20621.305,21383.958088173058,19858.651911826943,19805.295449119476,20063.196137149087,20092.243348791606,20034.148925506568,154578,421840.8,33.12779260260052,37.39112005747476,NaN,NaN,NaN,NaN,211.2303538309323,50.35768787856166,8175074,-1.5279542396406498,-165.44029646155468,-163.91234222191403
2025-03-10T06:00:00-04:00,20003.75,20024.5,19744.5,19790.5,NaN,NaN,NaN,20518.802811433306,NaN,NaN,20591.585,21365.525008075594,19817.644991924404,19805.295449119476,19947.02136173817,20053.231463529413,19840.811259946928,494985,424276.5,27.58409626166815,35.96078316478108,NaN,NaN,NaN,NaN,216.14247141443713,51.52072707912313,7680089,-16.429846725221807,-184.4496506284413,-168.0198039032195
2025-03-10T10:00:00-04:00,19791,19791.5,19422.5,19441.75,NaN,NaN,NaN,20262.789047277245,NaN,NaN,20554.015,21364.342430178865,19743.687569821133,19805.295449119476,19723.584072268084,19931.57002096346,19515.59812357271,1164738,427999.4666666667,21.287883614594207,34.63936809676069,NaN,NaN,NaN,NaN,227.0608663134059,53.052932486694246,6515351,-45.63339029956464,-225.0615417776753,-179.42815147811066
2025-03-10T14:00:00-04:00,19441.75,19551,19271.75,19472,NaN,NaN,NaN,20075.434999673736,NaN,NaN,20517.445,21354.321581641503,19680.568418358496,19805.295449119476,19661.15817840529,19881.025294421215,19441.291062389366,560048,426491.36666666664,22.931103249861522,33.616319899016595,NaN,NaN,NaN,NaN,230.78866157673406,54.64429779826714,7075399,-57.97913138250868,-251.9020657062465,-193.92293432373782
2025-03-10T18:00:00-04:00,19439,19461.5,19140,19257.25,NaN,NaN,NaN,19979.898181506745,NaN,NaN,20480.555,21371.98825768107,19589.12174231893,19805.295449119476,19286.25,19286.25,19286.25,231872,429529.1,19.77492609470309,32.641300985612126,NaN,NaN,NaN,NaN,238.01804289268162,56.25582324345806,6843527,-74.61472577274594,-287.19134153967025,-212.5766157669243
2025-03-10T22:00:00-04:00,19256.75,19495,19246.75,19477.5,NaN,NaN,NaN,19979.898181506745,NaN,NaN,20444.605,21349.857318914466,19539.352681085533,19724.184087436464,19336.23472056052,19395.463302887398,19277.00613823364,165143,431519.8,30.361453965356844,32.24777975167975,NaN,NaN,NaN,NaN,238.7488969717758,57.49435004597202,7008670,-65.13630594704574,-293.99699820073147,-228.86069225368573
2025-03-11T02:00:00-04:00,19476.75,19582,19404.5,19543.75,NaN,NaN,NaN,19979.898181506745,NaN,NaN,20411.79,21326.285529567976,19497.294470432025,19724.184087436464,19387.09268497317,19480.56372584681,19293.62164409953,164170,431278.1666666667,33.21621082154998,31.99150273137756,NaN,NaN,NaN,NaN,234.3739757595061,57.975935413730596,7172840,-49.46646376388077,-290.6937719585367,-241.2273081946559
2025-03-11T06:00:00-04:00,19543.25,19599,19386.5,19522,NaN,NaN,NaN,19979.898181506745,NaN,NaN,20376.61,21289.981535356765,19463.238464643237,19646.857815959338,19440.53888631109,19529.994528057356,19351.083244564823,484065,427187.9666666667,32.7416648937612,31.82741758297875,NaN,NaN,NaN,NaN,232.81154891954137,58.453442537129305,6688775,-36.24060735426542,-286.5280673874877,-250.28746003322226
2025-03-11T10:00:00-04:00,19520,19613.5,19201,19325,NaN,NaN,NaN,19979.898181506745,NaN,NaN,20336.68,21255.872722120916,19417.487277879085,19646.857815959338,19405.91728760084,19471.807351564767,19340.027223636916,1387375,435489.4666666667,28.737039994550102,31.207943336078504,NaN,NaN,NaN,NaN,245.64643828243126,59.1906523464487,5301400,-36.341361036488706,-295.71416132883314,-259.37280029234444
2025-03-11T14:00:00-04:00,19325.75,19687.5,19318.75,19399.75,NaN,NaN,NaN,19979.898181506745,NaN,NaN,20304.515,21239.902777395047,19369.12722260495,19637.06125276747,19417.998936412452,19482.168600662102,19353.829272162802,580056,438450.3333333333,32.12918048900282,30.909527196674485,NaN,NaN,NaN,NaN,254.4395498336862,59.301086693620334,5881456,-27.36441461506837,-293.5783185611799,-266.21390394611154
2025-03-11T18:00:00-04:00,19412,19500.25,19402.25,19472,NaN,NaN,NaN,19979.898181506745,NaN,NaN,20272.925,21211.949042557033,19333.900957442966,19481.149002213977,19458.166666666668,19458.166666666668,19458.166666666668,89706,436380.6666666667,35.33325293343765,30.73125635891054,NaN,NaN,NaN,NaN,243.4438677027086,59.403632873136836,5971162,-13.265503121457868,-282.7957828479339,-269.530279726476
2025-03-11T22:00:00-04:00,19472,19492.5,19435,19480,NaN,NaN,NaN,19979.898181506745,NaN,NaN,20249.86,21208.791619877004,19290.928380122998,19172.31920177118,19461.951196891812,19467.176822545927,19456.725571237697,47051,434734.1,35.695245072989465,30.438170168804042,NaN,NaN,NaN,NaN,230.16216286680083,59.498854325545025,6018213,-0.7653815227311611,-270.48700662988995,-269.7216251071588
2025-03-12T02:00:00-04:00,19480.5,19564,19387,19559.75,NaN,NaN,NaN,19979.898181506745,NaN,NaN,20229.305,21202.36198851608,19256.24801148392,19044.2734600004,19481.99239944937,19503.131701886574,19460.853097012165,126941,434099.4666666667,39.34061428350611,30.58306255983557,NaN,NaN,NaN,NaN,226.36486551917218,58.96329623047066,6145154,14.658034352143432,-251.3990821669795,-266.0571165191229
2025-03-12T06:00:00-04:00,19560,19788.75,19524.25,19643.25,NaN,NaN,NaN,19979.898181506745,NaN,NaN,20210.265,21191.159180888128,19229.37081911187,19240.718768000323,19595.3512875161,19676.46929085608,19514.23328417612,526907,435683.8333333333,42.98502913325644,31.088963815059863,NaN,NaN,NaN,NaN,229.08880369637419,56.77891003568962,6672061,31.311101113552127,-226.9182401271828,-258.2293412407349
2025-03-12T10:00:00-04:00,19643.75,19727.75,19395,19540.5,NaN,NaN,NaN,19979.898181506745,NaN,NaN,20187.935,21177.92485757413,19197.945142425873,19240.718768000323,19570.94668569104,19626.269056730605,19515.624314651475,1167234,437948.1,39.8150452672066,31.566624719674586,NaN,NaN,NaN,NaN,236.4931748609189,55.199632140471664,5504827,35.90450373175889,-213.3487115760363,-249.2532153077952
2025-03-12T14:00:00-04:00,19540.5,19706.25,19531.25,19571,NaN,NaN,NaN,19979.898181506745,NaN,NaN,20167.47,21165.290628369585,19169.649371630418,19240.718768000323,19576.7822382824,19628.28442763252,19525.280048932284,438564,437401.1,41.20119772149346,32.53927482394782,NaN,NaN,NaN,NaN,232.10080522799612,53.73315980919785,5943391,41.12021882100939,-197.85294178153345,-238.97316060254283
2025-03-12T18:00:00-04:00,19575,19693.75,19567,19638,NaN,NaN,NaN,19979.898181506745,NaN,NaN,20149.385,21152.145196707297,19146.6248032927,19240.718768000323,19632.916666666668,19632.916666666668,19632.916666666668,90612,438163.06666666665,44.23935661174153,34.17866575231549,NaN,NaN,NaN,NaN,224.57574771171068,52.37143550158645,6034003,48.68819434025596,-178.11291767722287,-226.80111201747883
2025-03-12T22:00:00-04:00,19637.75,19645,19436.75,19465,NaN,NaN,NaN,19979.898181506745,NaN,NaN,20120.485,21117.1669874464,19123.803012553602,19240.718768000323,19569.354830688204,19627.816913231043,19510.892748145365,107110,440249.43333333335,38.681567631723034,35.303698922448454,NaN,NaN,NaN,NaN,223.4096228751599,51.57128559422388,5926893,41.906585784216475,-174.41787978720822,-216.3244655714247
2025-03-13T02:00:00-04:00,19465,19609.25,19400.5,19605.5,NaN,NaN,NaN,19979.898181506745,NaN,NaN,20094.02,21073.574377459438,19114.465622540563,19240.718768000323,19554.899714286737,19600.277982160704,19509.52144641277,173396,439584.13333333336,44.75206412390587,37.087780210248646,NaN,NaN,NaN,NaN,222.3625069555056,50.94997622001445,6100289,46.397763075014836,-158.32726172765615,-204.725024802671
2025-03-13T06:00:00-04:00,19606,19632.75,19338.75,19367.25,NaN,NaN,NaN,19979.898181506745,NaN,NaN,20061.215,21025.954353452464,19096.475646547537,19240.718768000323,19491.537910491625,19552.593985333664,19430.481835649585,519227,440463.13333333336,37.90010383465028,37.62625520091246,NaN,NaN,NaN,NaN,227.47947074439804,50.57887987111048,5581062,33.44237915126632,-162.92205086358808,-196.3644300148544
2025-03-13T10:00:00-04:00,19367.25,19570.5,19165.5,19191.75,NaN,NaN,NaN,19979.898181506745,NaN,NaN,20024.98,20981.492199817592,19068.467800182407,19240.718768000323,19385.810851894603,19484.09740656043,19287.524297228774,1229526,444741.9666666667,33.795345851922534,37.66762198879621,NaN,NaN,NaN,NaN,240.15950854836962,50.74673882366329,4351536,14.15930774510997,-178.66529533346693,-192.8246030785769
2025-03-13T14:00:00-04:00,19191,19396.25,19184.5,19294.75,NaN,NaN,NaN,19979.898181506745,NaN,NaN,19993.68,20941.260297600107,19046.099702399893,19240.718768000323,19367.470878039243,19463.19032962432,19271.751426454164,514009,444561.4666666667,38.03690059661981,38.04585311042898,NaN,NaN,NaN,NaN,238.1302579377718,50.902607851033764,4865545,9.661962326269133,-180.7471501707405,-190.40911249700963
2025-03-13T18:00:00-04:00,19310,19432.75,19298.25,19402.75,NaN,NaN,NaN,19979.898181506745,NaN,NaN,19966.79,20903.551748578484,19030.028251421518,19240.718768000323,19377.916666666668,19377.916666666668,19377.916666666668,116708,445435,42.217190703748464,39.00872101822886,NaN,NaN,NaN,NaN,230.9780966565024,50.70540032719434,4982253,14.964848540064537,-171.70305182192897,-186.6679003619935
2025-03-13T22:00:00-04:00,19403,19459.25,19400.75,19410.75,NaN,NaN,NaN,19979.898181506745,NaN,NaN,19944.385,20879.683049875162,19009.086950124834,19173.303009216164,19393.551297149876,19415.220163951915,19371.882430347836,60758,445482.86666666664,42.526499204249326,39.75138664074647,NaN,NaN,NaN,NaN,218.65823260960937,50.269478695442935,5043011,19.716469722561044,-162.02231320879218,-181.73878293135323
2025-03-14T02:00:00-04:00,19410.5,19461.25,19370,19441.25,NaN,NaN,NaN,19979.898181506745,NaN,NaN,19922.75,20853.544343558176,18991.955656441824,19173.303009216164,19404.89396298832,19427.569592495005,19382.218333481636,104445,445217.36666666664,43.762486060722935,40.35347472126684,NaN,NaN,NaN,NaN,209.55764456606585,49.97940359610962,5147456,25.264440442319994,-150.15823237845325,-175.42267282077324
2025-03-14T06:00:00-04:00,19443,19620.75,19398.75,19545,NaN,NaN,NaN,19979.898181506745,NaN,NaN,19902.465,20821.016691577657,18983.913308422343,19173.303009216164,19472.172888227975,19531.63873668552,19412.70703977043,384508,440012.4,47.869367317641085,41.223054881599104,NaN,NaN,NaN,NaN,210.44638423991827,48.25458995410133,5531964,35.63777493586318,-130.87545415094428,-166.51322908680746
2025-03-14T10:00:00-04:00,19546,19707.75,19426.25,19630,NaN,NaN,NaN,19979.898181506745,NaN,NaN,19885.81,20793.253158329986,18978.366841670017,19199.786975354044,19542.758809618004,19610.394591210574,19475.123028025435,1039756,429344.9666666667,51.02492856664329,42.05764875896604,NaN,NaN,NaN,NaN,215.52164250849552,45.97285246691589,6571720,47.21395973027222,-107.49577942396718,-154.7097391542394
2025-03-14T14:00:00-04:00,19630,19742.75,19612.25,19666.75,NaN,NaN,NaN,19979.898181506745,NaN,NaN,19874.525,20778.54390052139,18970.506099478614,19271.129580283236,19565.432529892594,19644.448420097717,19486.41663968747,356599,424179.8333333333,52.36741790136196,42.727819385259295,NaN,NaN,NaN,NaN,209.448668043603,43.59037833775247,6928319,55.75041261068992,-85.02172339087701,-140.77213600156693
2025-03-16T18:00:00-04:00,19669.5,19687.5,19551,19610,NaN,NaN,NaN,19979.898181506745,NaN,NaN,19856.69,20745.567272518634,18967.812727481363,19271.129580283236,19616.166666666668,19616.166666666668,19616.166666666668,91512,421708.63333333336,50.084288733093054,43.461336775679754,NaN,NaN,NaN,NaN,204.23804889763136,41.73039632719407,6836807,55.84010741655898,-70.97200173086821,-126.8121091474272
2025-03-16T22:00:00-04:00,19608.75,19612.5,19584,19593,NaN,NaN,NaN,19979.898181506745,NaN,NaN,19837.825,20708.05353463896,18967.596465361043,19271.129580283236,19611.319716407834,19619.794999780246,19602.84443303542,29930,420050.9666666667,49.38962789655769,44.0462246453272,NaN,NaN,NaN,NaN,191.68533111922912,40.0032701745327,6806877,53.04031718891889,-60.51171266127858,-113.55202985019747
2025-03-17T02:00:00-04:00,19593.5,19637,19554.5,19624.5,NaN,NaN,NaN,19979.898181506745,NaN,NaN,19820.73,20673.28807333002,18968.17192666998,19299.20034510502,19609.49726985654,19617.083540312196,19601.910999400883,53152,416670.1,50.75264263283624,44.511459361119684,NaN,NaN,NaN,NaN,183.88637889642703,38.57952218197499,6860029,51.55049043440053,-49.1139168071968,-100.66440724159733
2025-03-17T06:00:00-04:00,19624.25,19848,19616,19788.75,NaN,NaN,NaN,19979.898181506745,NaN,NaN,19805.52,20632.292277232267,18978.747722767734,19461.760276084013,19687.804702536905,19758.287464167028,19617.321940906782,216631,407391.63333333336,57.2219982219889,45.835775831852956,NaN,NaN,NaN,NaN,187.3230661181108,36.02467115279086,7076660,59.314123463417374,-26.52175291232561,-85.83587637574298
2025-03-17T10:00:00-04:00,19790,19834,19628.5,19816.25,NaN,NaN,NaN,19979.898181506745,NaN,NaN,19790.935,20590.250387128235,18991.619612871767,19461.760276084013,19727.246465371118,19786.52097094857,19667.971959793664,477183,384473.13333333336,58.21179003875118,46.79718482577048,NaN,NaN,NaN,NaN,188.62141853824573,33.65230948283417,7553843,63.60840893082545,-6.325365212211182,-69.93377414303663
2025-03-17T14:00:00-04:00,19815.5,19959.25,19800.5,19830.5,NaN,NaN,NaN,19979.898181506745,NaN,NaN,19781.25,20566.555386458003,18995.944613541997,19550.481576693768,19749.769668964887,19823.877814295105,19675.66152363467,172106,371541.73333333334,58.74447730167228,48.286068644843475,NaN,NaN,NaN,NaN,186.4877457855139,32.254551610651724,7725949,64.51250054267682,10.706851535309397,-53.80564900736742
2025-03-17T18:00:00-04:00,20038.75,20066.5,19953.5,19959,19415.105012476106,19415.105012476106,19415.105012476106,NaN,NaN,NaN,19768.62,20521.08477817913,19016.155221820867,19621.485261355014,19993,19993,19993,51926,365543.5333333333,63.28899468240244,50.39275784702061,NaN,NaN,NaN,NaN,190.0243353722629,31.54957608030327,7777875,70.38842140149694,34.179877744503756,-36.208543656993186
2025-03-17T22:00:00-04:00,19959.5,19977.25,19920.25,19951.5,19415.105012476106,NaN,NaN,NaN,NaN,NaN,19755.445,20470.649336466253,19040.240663533747,19621.485261355014,19976.849988724593,19997.80257705439,19955.897400394795,30850,361067.1,62.853803529796714,52.165393770818966,NaN,NaN,NaN,NaN,180.52259713138696,30.621771862881797,7747025,70.23293130136949,51.58262046971868,-18.650310831650813
2025-03-18T02:00:00-04:00,19951,20038.25,19941.5,19982,19427.219649797444,NaN,NaN,NaN,NaN,NaN,19742.97,20419.105656802472,19066.83434319753,19682.265567267208,19981.233118529082,19997.977092378052,19964.489144680112,60300,357604.76666666666,63.93973891921949,53.71700435763832,NaN,NaN,NaN,NaN,174.53884019343076,30.098512619153322,7807325,68.5702168759808,67.06246026332519,-1.5077566126556121
2025-03-18T06:00:00-04:00,19981.25,19997.75,19657,19673,19427.219649797444,NaN,NaN,NaN,NaN,NaN,19723.745,20350.260989341205,19097.229010658793,19682.265567267208,19838.099504633326,19932.89067142752,19743.30833783913,329335,352447.1,48.477478568109134,54.14207431219974,NaN,NaN,NaN,NaN,186.4110658939,28.275419213638127,7477990,44.22758342030211,53.77672266272202,9.549139242419916
2025-03-18T10:00:00-04:00,19673,19753,19604.25,19711.25,19427.219649797444,NaN,NaN,NaN,NaN,NaN,19710.37,20308.170604215236,19112.56939578476,19682.265567267208,19754.12098761739,19850.734711051377,19657.5072641834,613924,326665.4,50.086557291060565,54.59379368579528,NaN,NaN,NaN,NaN,183.72098975862144,26.876916598122236,8091914,29.00557732127432,45.80611089401282,16.800533572738498
2025-03-18T14:00:00-04:00,19711,19783.5,19658.25,19703,19427.219649797444,NaN,NaN,NaN,NaN,NaN,19698.785,20273.82353792579,19123.74646207421,19682.265567267208,19745.78351365377,19832.99866292688,19658.56836438066,293431,317111.23333333334,49.725837902682954,54.726398727584,NaN,NaN,NaN,NaN,179.5444904901485,25.374984981741832,7798483,17.26453552090458,38.38120297386922,21.11666745296464
2025-03-18T18:00:00-04:00,19701.75,19797.25,19666.75,19770.5,19427.219649797444,NaN,NaN,NaN,NaN,NaN,19691.815,20254.629346032554,19129.000653967443,19682.265567267208,19744.833333333332,19744.833333333332,19744.833333333332,67035,316355.5333333333,52.72574305258222,54.847885476579634,NaN,NaN,NaN,NaN,176.04131259799505,23.88541360775506,7865518,13.115618183253076,37.51119018203099,24.39557199877791
2025-03-18T22:00:00-04:00,19770.5,19780,19723,19737.5,19427.219649797444,NaN,NaN,NaN,NaN,NaN,19683.06,20228.88378621665,19137.23621378335,19682.265567267208,19745.55314770785,19746.5130934951,19744.5932019206,37692,316043.56666666665,51.1197407072217,54.75876567699819,NaN,NaN,NaN,NaN,167.53836169813826,22.50224018905306,7827826,7.49922211700839,33.7695996450384,26.270377528030007
2025-03-19T02:00:00-04:00,19737.25,19767,19658.75,19763.75,19427.219649797444,NaN,NaN,NaN,NaN,NaN,19674.41,20200.790155021077,19148.029844978922,19682.265567267208,19738.386950317024,19746.24814112689,19730.52575950716,87740,314736.86666666664,52.36273835365771,54.921512078467096,NaN,NaN,NaN,NaN,163.3034787196998,21.652307029684756,7915566,5.021563912972979,32.54733241924623,27.525768506273252
2025-03-19T06:00:00-04:00,19763.25,19845,19706.5,19823.75,19427.219649797444,NaN,NaN,NaN,NaN,NaN,19668.31,20180.36218054394,19156.257819456063,19682.265567267208,19769.914514964297,19796.629805668803,19743.19922425979,277897,306436.5333333333,55.16896167123792,55.334321633801395,NaN,NaN,NaN,NaN,161.53180166829267,20.2557100538009,8193463,6.783489724634375,36.00513066206622,29.221640937431847
2025-03-19T10:00:00-04:00,19823.5,19937.25,19785.5,19806,19427.219649797444,NaN,NaN,NaN,NaN,NaN,19660.865,20153.500059754893,19168.22994024511,19682.265567267208,19809.99384219647,19850.507977995436,19769.479706397502,572608,286615.6666666667,54.15264992752951,55.577179297708064,NaN,NaN,NaN,NaN,160.8331015491289,19.309305340188384,7620855,6.13305729339082,36.88796255417037,30.75490526077955
2025-03-19T14:00:00-04:00,19813.5,20142.25,19765.5,19945.75,19427.219649797444,NaN,NaN,NaN,NaN,NaN,19656.98,20137.35075098319,19176.60924901681,19682.265567267208,19858.39774762543,19933.023401756083,19783.772093494776,544190,290136.5333333333,60.34639038823961,55.80035016672597,NaN,NaN,NaN,NaN,176.25573715276255,19.598877101553132,8165045,14.042005766590307,48.307412469017436,34.26540670242713
2025-03-19T18:00:00-04:00,19954,20058,19944.5,20028.25,19459.339302932243,NaN,NaN,NaN,NaN,NaN,19654.155,20123.981892482876,19184.32810751712,19679.710340475234,20010.25,20010.25,20010.25,59269,289091.76666666666,63.48273531194748,56.17684625766856,NaN,NaN,NaN,NaN,171.7731844989938,19.867765165677543,8224314,23.21564239494014,63.284959696102305,40.069317301162165
2025-03-19T22:00:00-04:00,20028.25,20093.25,20027.25,20087.25,19533.971607344414,NaN,NaN,NaN,NaN,NaN,19651.76,20111.400141415383,19192.119858584614,19718.824617904153,20033.77542252521,20062.664078152087,20004.886766898333,39305,286831.6,65.57946049641075,56.66505934300702,NaN,NaN,NaN,NaN,164.21795703477997,20.30295653840915,8263619,31.148435622309734,79.00486182904933,47.8564262067396
2025-03-20T02:00:00-04:00,20087.75,20089.25,19935.5,19954,19533.971607344414,NaN,NaN,NaN,NaN,NaN,19648.165,20095.31166061575,19201.018339384253,19718.824617904153,20014.29918418631,20043.508710543778,19985.089657828845,89786,284044.6,57.543473336572156,56.254664961162,NaN,NaN,NaN,NaN,163.47024581800997,19.926542298907695,8173833,25.54770266136454,79.79105453344528,54.24335187208074
2025-03-20T06:00:00-04:00,19954.25,19956.5,19734.5,19934,19533.971607344414,NaN,NaN,NaN,NaN,NaN,19645.025,20081.772756147326,19208.277243852677,19718.824617904153,19920.282956987765,19987.623043743653,19852.942870231876,391072,279772.76666666666,56.425846203551465,55.795525152144485,NaN,NaN,NaN,NaN,167.65094254529498,18.82540342349934,7782761,18.927139395360555,77.90227611628143,58.97513672092087
2025-03-20T10:00:00-04:00,19934,20105,19826,19848.25,19533.971607344414,NaN,NaN,NaN,NaN,NaN,19641.93,20070.60543713185,19213.25456286815,19718.824617904153,19923.981007439565,19966.52162615696,19881.44038872217,879749,268113.5333333333,51.782091524401494,54.92712176680034,NaN,NaN,NaN,NaN,175.60444664920246,18.047479313664212,6903012,7.775276942647281,68.69423289922997,60.91895595658269
2025-03-20T14:00:00-04:00,19848.5,19921.25,19795.5,19894.25,19533.971607344414,NaN,NaN,NaN,NaN,NaN,19644.005,20076.524126629032,19211.48587337097,19718.824617904153,19913.853370442437,19957.543442900438,19870.163297984436,339569,262298.86666666664,53.97053580569287,55.31948299805633,NaN,NaN,NaN,NaN,172.043414745688,17.127271117942787,7242581,2.7581387819542655,64.36662943402553,61.60849065207126
2025-03-20T18:00:00-04:00,19898.5,19933,19847.5,19925,19533.971607344414,NaN,NaN,NaN,NaN,NaN,19653.67,20089.26526443738,19218.074735562615,19718.824617904153,19901.833333333332,19901.833333333332,19901.833333333332,59829,260402.9,55.42690631299271,55.700936499622905,NaN,NaN,NaN,NaN,165.86174226385316,16.344154566527788,7302410,0.8696279015353099,62.6955255289904,61.82589762745509
2025-03-20T22:00:00-04:00,19925,19928.75,19822.75,19850.5,19533.971607344414,NaN,NaN,NaN,NaN,NaN,19661.24,20097.098990500228,19225.381009499775,19718.824617904153,19885.15264960216,19902.393252232614,19867.91204697171,56006,260244.5,51.20018762099714,55.8062471937882,NaN,NaN,NaN,NaN,161.5859035307208,15.439988165626502,7246404,-5.677712324924855,54.72875722129902,60.406469546223875
2025-03-21T02:00:00-04:00,19850,19897,19762.25,19796.25,19533.971607344414,NaN,NaN,NaN,NaN,NaN,19672.02,20093.81356135427,19250.226438645732,19718.824617904153,19851.731651817096,19887.211673743663,19816.25162989053,116495,260646.16666666666,48.31111838280167,55.49091686023245,NaN,NaN,NaN,NaN,159.66905327852646,14.502558530228837,7129909,-13.496645788148442,43.53566231103832,57.032308099186764
2025-03-21T06:00:00-04:00,19796.75,19845,19602.5,19718.75,19533.971607344414,NaN,NaN,NaN,NaN,NaN,19676.845,20095.132387928265,19258.557612071738,19718.824617904153,19768.53683514904,19834.231089098994,19702.842581199086,416086,261698.76666666666,44.452194216036055,55.01466353943348,NaN,NaN,NaN,NaN,165.58554947291742,14.618255412525851,6713823,-23.15570694291614,28.08767442054159,51.24338136345773
2025-03-21T10:00:00-04:00,19719.25,19900.75,19663,19857.75,19533.971607344414,NaN,NaN,NaN,NaN,NaN,19683.125,20102.657564290294,19263.592435709706,19718.824617904153,19790.523111618168,19837.696750211733,19743.349473024602,856563,255592.33333333334,51.876770868213306,54.979951576187446,NaN,NaN,NaN,NaN,170.74015308199475,14.307324276588604,7570386,-19.5924797824131,26.75278163544135,46.34526141785445
2025-03-21T14:00:00-04:00,19857.75,19977.75,19812.5,19971,19533.971607344414,NaN,NaN,NaN,NaN,NaN,19692.105,20116.64930970149,19267.56069029851,19712.83469432332,19811.42642760637,19875.81191846945,19747.040936743288,288641,253327.06666666668,56.92811294709308,55.10560523874853,NaN,NaN,NaN,NaN,170.3479992904237,13.468948102801551,7859027,-9.527218338621168,34.43623849457799,43.96345683319916
2025-03-23T18:00:00-04:00,20052.25,20139,20048,20109.5,19568.078138980607,NaN,NaN,NaN,NaN,NaN,19707.795,20134.889096072755,19280.70090392724,19702.66399098212,20098.833333333332,20098.833333333332,20098.833333333332,102900,253706.66666666666,62.159375949557905,55.67751424032199,NaN,NaN,NaN,NaN,170.18028505539343,13.319596035495342,7961927,5.718865060804298,51.11203815920453,45.39317309840023
2025-03-23T22:00:00-04:00,20109.5,20126.5,20096.25,20117.25,19605.710950845125,NaN,NaN,NaN,NaN,NaN,19722.145,20155.049852017077,19289.240147982924,19762.306192785698,20102.245300872943,20108.396073735934,20096.09452800995,31664,253764.46666666667,62.434317609413704,55.826651898977275,NaN,NaN,NaN,NaN,160.1852646942939,13.18091197299672,7993591,15.05576841362361,64.21288361542975,49.157115201806135
2025-03-24T02:00:00-04:00,20116.5,20228,20110,20189,19670.229771261256,NaN,NaN,NaN,NaN,NaN,19736.485,20182.595472977042,19290.37452702296,19877.644954228555,20131.719205614198,20168.022761864395,20095.415649364,90247,255000.96666666667,64.97181051594532,55.933014413548555,NaN,NaN,NaN,NaN,157.17203150184432,13.62379342605796,8083838,24.24947163346353,79.46895474363555,55.21948311017202
2025-03-24T06:00:00-04:00,20189,20338.5,20182.5,20315.25,19763.12841802211,NaN,NaN,NaN,NaN,NaN,19753.19,20221.626842701495,19284.753157298503,19980.215963382845,20215.541595354967,20292.123997112452,20138.959193597482,298128,257717.53333333333,68.94662226947152,56.17352596876718,NaN,NaN,NaN,NaN,157.0883149659983,14.58636310144554,8381966,36.294263896585775,100.58731298090424,64.29304908431847
2025-03-24T10:00:00-04:00,20315.25,20380.5,20274.5,20342.5,19838.281671748377,NaN,NaN,NaN,NaN,NaN,19768.845,20262.04084233832,19275.649157661683,20040.872770706275,20275.62860788299,20354.80588203887,20196.451333727113,552507,260228.33333333334,69.74465515013821,57.045038955450465,NaN,NaN,NaN,NaN,153.43914961128414,15.676548015675081,8934473,43.09398493681418,118.1605302553362,75.06654531852202
2025-03-24T14:00:00-04:00,20342.75,20409.25,20308.25,20356.5,19877.996141214357,NaN,NaN,NaN,NaN,NaN,19783.11,20301.56281521076,19264.65718478924,20087.04821656502,20290.791648331917,20369.112207297123,20212.47108936671,242634,262579.26666666666,70.16881413401504,58.02667952191215,NaN,NaN,NaN,NaN,149.693496067621,16.824395693333884,9177107,45.3059403812389,131.69897079507064,86.39303041383174
2025-03-24T18:00:00-04:00,20358.25,20375,20334.25,20360.75,19890.16677115916,NaN,NaN,NaN,NaN,NaN,19799.515,20337.75425358533,19261.275746414667,20096.863573252016,20356.666666666668,20356.666666666668,20356.666666666668,51037,262549.63333333336,70.30491369745918,59.34973824855912,NaN,NaN,NaN,NaN,141.91181777707664,17.890254251159917,9228144,43.80093524572614,141.1441994709894,97.34326422526327
2025-03-24T22:00:00-04:00,20360.5,20360.5,20328.25,20341,19896.596690651924,NaN,NaN,NaN,NaN,NaN,19814.915,20369.921131587653,19259.90886841235,20121.740858601614,20351.839177600497,20358.278444710904,20345.39991049009,28685,262477.4666666667,68.73552570302722,60.40438038408301,NaN,NaN,NaN,NaN,134.09668793585686,18.818773363521114,9199459,38.41365096124028,145.36032792681362,106.94667696557335
2025-03-25T02:00:00-04:00,20341,20372,20292,20344,19896.596690651924,NaN,NaN,NaN,NaN,NaN,19829.035,20400.98331068902,19257.08668931098,20140.99268688129,20344.088518112832,20353.246337570014,20334.93069865565,76392,263013.86666666664,68.84927576263081,61.363121059057164,NaN,NaN,NaN,NaN,130.2326387975814,19.301387338980057,9275851,32.239739033708176,147.24635075770857,115.0066117240004
2025-03-25T06:00:00-04:00,20343,20447.25,20321,20412.75,19948.49951565599,NaN,NaN,NaN,NaN,NaN,19847.99,20433.0915634912,19262.8884365088,20199.319149505034,20376.472555695018,20400.677927778626,20352.26718361141,294031,261837.06666666668,71.41589384466221,62.80710007503324,NaN,NaN,NaN,NaN,129.94816459775413,20.191883234900622,9569882,30.018961313496348,152.53031336587082,122.51135205237448
2025-03-25T10:00:00-04:00,20413.25,20496.5,20371,20414.5,20000.812037671625,NaN,NaN,NaN,NaN,NaN,19864.17,20466.056404897354,19262.283595102643,20235.405319604026,20404.79281036132,20434.75967591322,20374.825944809418,565569,260225.23333333334,71.48030898346514,64.46204226079492,NaN,NaN,NaN,NaN,129.6304385550574,21.28877723472411,10135451,26.048145606426374,155.07153406040743,129.02338845398106
2025-03-25T14:00:00-04:00,20414,20524.75,20402.5,20517.25,20033.695581413827,NaN,NaN,NaN,NaN,NaN,19887.17,20499.14872871554,19275.191271284457,20254.749255683222,20419.614335446695,20460.132689156493,20379.095981736897,243262,258552.93333333332,75.03730419525075,66.64669297359596,NaN,NaN,NaN,NaN,129.1032643725533,22.45965760871068,10378713,27.574811766634326,163.49190316227396,135.91709139563963
2025-03-25T18:00:00-04:00,20513,20536.75,20503.75,20510.75,20105.362827713197,NaN,NaN,NaN,NaN,NaN,19913.55,20517.00156392224,19310.09843607776,20304.249404546576,20517.083333333332,20517.083333333332,20517.083333333332,44350,257796.76666666666,74.40509999242398,68.25585933961102,NaN,NaN,NaN,NaN,122.2387454887995,23.61327968914855,10334363,25.432234348610592,167.70738433140286,142.27514998279227
2025-03-25T22:00:00-04:00,20510.25,20513,20458.5,20460,20105.362827713197,NaN,NaN,NaN,NaN,NaN,19936.855,20532.872475331013,19340.837524668987,20304.249404546576,20498.478429059272,20518.390819654986,20478.56603846356,38717,257830.93333333332,69.48283427599802,69.15262514881852,NaN,NaN,NaN,NaN,117.40026366817096,24.11920347627608,10295646,18.220266759082392,165.05048343164526,146.83021667256287
2025-03-26T02:00:00-04:00,20460,20498.75,20432.5,20433,20105.362827713197,NaN,NaN,NaN,NaN,NaN,19957.46,20549.4143087099,19365.5056912901,20304.249404546576,20478.68335628458,20504.965972623955,20452.400739945202,68704,257196.4,66.94539611948963,69.49448373238506,NaN,NaN,NaN,NaN,113.74667340615875,24.270420312237714,10226942,9.683108720861213,158.9341025736394,149.25099385277818
2025-03-26T06:00:00-04:00,20432.5,20493,20305.75,20316,20105.362827713197,NaN,NaN,NaN,NaN,NaN,19975.565,20554.76398834517,19396.366011654827,20304.249404546576,20407.044551197443,20459.666958630547,20354.42214376434,306608,258153.43333333332,57.19767496402269,69.12043782914284,NaN,NaN,NaN,NaN,118.99691102000455,23.040857450136183,9920334,-5.0027805931036085,142.99751811139868,148.00029870450228
2025-03-26T10:00:00-04:00,20316.5,20356.75,20076.5,20083.75,NaN,NaN,NaN,20638.35187638101,20638.35187638101,20638.35187638101,19988.415,20547.796708764065,19429.033291235937,20304.249404546576,20256.42958803372,20373.29840363155,20139.56077243589,820949,266431.4666666667,43.620067254104484,67.59531331043993,NaN,NaN,NaN,NaN,130.51498880428994,22.637283771837897,9099385,-30.116300370920754,110.35492324085135,140.4712236117721
2025-03-26T14:00:00-04:00,20083.5,20146.25,20041.25,20090.5,NaN,NaN,NaN,20510.625654727326,NaN,NaN,19999.325,20544.793736500716,19453.856263499285,20304.249404546576,20223.1592472981,20346.54889930614,20099.769595290058,326177,259164.36666666667,44.03587001759015,65.81597386387698,NaN,NaN,NaN,NaN,128.69248960398352,22.47753459049693,9425562,-45.12810190896127,84.06109622557051,129.18919813453178
2025-03-26T18:00:00-04:00,20057.5,20101.5,20003,20088,NaN,NaN,NaN,20463.60857951245,NaN,NaN,20008.485,20544.131809100778,19472.838190899223,20304.249404546576,20064.166666666668,20064.166666666668,20064.166666666668,106500,260738.73333333334,43.90671399194601,63.97040663829181,NaN,NaN,NaN,NaN,126.53588320369899,22.56139632179642,9319062,-53.50885603224977,62.30312809421957,115.81198412646934
2025-03-26T22:00:00-04:00,20088.5,20148,20088.25,20114.25,NaN,NaN,NaN,20463.60857951245,NaN,NaN,20017.435,20544.83368041163,19490.036319588373,20304.249404546576,20080.91343425999,20105.43979154674,20056.38707697324,49653,261083.66666666666,45.70733869574082,62.223158392700796,NaN,NaN,NaN,NaN,121.78332011772048,22.19099878829421,9368715,-55.33734977964092,46.64029690191819,101.97764668155911
2025-03-27T02:00:00-04:00,20114.75,20140,20020.5,20116.5,NaN,NaN,NaN,20463.60857951245,NaN,NaN,20027.565,20542.583201717454,19512.546798282543,20304.249404546576,20085.62224032837,20105.246395915117,20065.99808474162,109564,261742.93333333332,45.867739440077465,60.47764594574496,NaN,NaN,NaN,NaN,121.6202258235976,22.28237958222682,9478279,-54.368659916001235,34.01682178655756,88.38548170255879
2025-03-27T06:00:00-04:00,20117.25,20138,19937.75,20076.75,NaN,NaN,NaN,20445.966829908415,NaN,NaN,20037.24,20537.19511758539,19537.284882414613,20304.249404546576,20064.444831539866,20085.395566841384,20043.494096238348,413415,262487.7,43.42677141799917,58.66987778252867,NaN,NaN,NaN,NaN,127.2366382647692,22.850693015414254,9064864,-54.25395458549485,20.568038470690226,74.82199305618508
2025-03-27T10:00:00-04:00,20076,20199,20001.75,20015,NaN,NaN,NaN,20445.966829908415,NaN,NaN,20045.05,20530.974232776978,19559.12576722302,20299.74952363726,20068.61193947714,20083.030937736974,20054.19294121731,856354,261707.86666666667,39.87653946681349,56.60039661854172,NaN,NaN,NaN,NaN,132.23759267442853,22.768106198095055,8208510,-55.96085612593934,4.8709228987609094,60.831779024700246
2025-03-27T14:00:00-04:00,20015.25,20129.75,19975,19997.25,NaN,NaN,NaN,20445.966829908415,NaN,NaN,20049.22,20529.824220122668,19568.615779877335,20295.02461890981,20062.01785707696,20080.807485522,20043.22822863192,361381,262434.93333333335,38.89228206137906,54.277281491164366,NaN,NaN,NaN,NaN,133.8456217691122,22.85950286163562,7847129,-55.78450364462777,-8.898850531084463,46.885653113543306
2025-03-27T18:00:00-04:00,19998.25,20011.25,19930,19965.25,NaN,NaN,NaN,20381.289790268766,NaN,NaN,20052.2,20528.82036255262,19575.579637447383,20236.39469512785,19968.833333333332,19968.833333333332,19968.833333333332,64256,262582.5,37.113747373487804,51.822527090451686,NaN,NaN,NaN,NaN,130.08879164274705,23.224480038151228,7782873,-55.2192662572029,-22.138429707960313,33.08083654924258
2025-03-27T22:00:00-04:00,19965.5,19997.75,19963.5,19975.5,NaN,NaN,NaN,20377.293663438366,NaN,NaN,20055.1,20528.039626168436,19582.16037383156,20011.34075610228,19972.3311641341,19977.130640518222,19967.531687749975,34129,261853.26666666666,38.09034544941937,49.18345860860659,NaN,NaN,NaN,NaN,123.24316366826511,23.563387416344295,7817002,-51.617761848629385,-31.441365761544148,20.176396087085237
2025-03-28T02:00:00-04:00,19975.25,20008.75,19845.75,19909.25,NaN,NaN,NaN,20328.115542372987,NaN,NaN,20054.105,20528.057414172705,19580.152585827294,19868.150467124367,19943.6479085981,19969.19287363494,19918.10294356126,125994,262169.9,34.3746112151029,46.324137981655085,NaN,NaN,NaN,NaN,126.08293769196045,24.575044340513934,7691008,-51.06638486736949,-43.65658499712663,7.409799870242864
2025-03-28T06:00:00-04:00,19909.5,19971.75,19839.5,19855.75,NaN,NaN,NaN,20306.303472265125,NaN,NaN,20052.19,20528.552861272943,19575.827138727054,19868.150467124367,19909.056140711007,19939.60553914512,19878.506742276895,386997,261200.26666666666,31.686446633620747,43.624396007199564,NaN,NaN,NaN,NaN,126.5234421425347,25.548617877727924,7304011,-51.525606924770635,-56.99720878572043,-5.4716018609497965
2025-03-28T10:00:00-04:00,19857,19879,19439.5,19482.75,NaN,NaN,NaN,20101.64763261671,NaN,NaN,20042.205,20544.270331306343,19540.13966869366,19868.150467124367,19718.11256190589,19869.205794531066,19567.019329280716,991864,265710.3,19.964219552650377,40.26859768099677,NaN,NaN,NaN,NaN,148.87891056092508,27.98087087331312,6312147,-72.8664860109747,-96.55470937466816,-23.68822336369347
2025-03-28T14:00:00-04:00,19482.75,19518.5,19360.75,19362.25,NaN,NaN,NaN,19883.425012952313,NaN,NaN,20035.99,20563.244406904043,19508.73559309596,19856.370373699494,19665.86936743428,19844.969007550997,19486.76972731756,332327,267166.5,17.68770247045525,37.4464567885991,NaN,NaN,NaN,NaN,149.51255980657328,30.436735422454586,5979820,-89.89682145712425,-136.0592501850988,-46.162428727974536
2025-03-30T18:00:00-04:00,19317.75,19365,19160,19242,NaN,NaN,NaN,19714.08183054539,NaN,NaN,20026.605,20591.973924597038,19461.23607540296,19838.752039167677,19255.666666666668,19255.666666666668,19255.666666666668,170029,269404.13333333336,15.756764424444242,35.45622087219479,NaN,NaN,NaN,NaN,153.47594839181804,33.142120357623526,5809791,-103.11178587710248,-175.05216107435263,-71.94037519725015
2025-03-30T22:00:00-04:00,19242.25,19260,19179.25,19238.75,NaN,NaN,NaN,19661.69174733878,NaN,NaN,20017.32,20617.800474620133,19416.839525379866,19838.752039167677,19246.51786363168,19260.21873561327,19232.816991650092,75815,270875.8333333333,15.706856541032536,33.43271990958353,NaN,NaN,NaN,NaN,148.28123779240246,35.65426351170897,5733976,-105.5409200982593,-203.8665253200743,-98.32560522181498
2025-03-31T02:00:00-04:00,19238,19272.25,19163.25,19196,NaN,NaN,NaN,19654.586440641564,NaN,NaN,20005.83,20645.470863610077,19366.189136389927,19764.17663133414,19234.180682883867,19254.566197653836,19213.7951681139,128080,272136.93333333335,15.032379334292699,31.370267434036872,NaN,NaN,NaN,NaN,145.47543509294513,38.01956197205521,5605896,-103.36261429237918,-227.52887308728896,-124.16625879490978
2025-03-31T06:00:00-04:00,19196,19236.75,18976.75,19089.25,NaN,NaN,NaN,19559.184784248766,NaN,NaN,19992.865,20678.37028962201,19307.359710377994,19714.15804405385,19166.60158331257,19234.746713203476,19098.456453421666,384707,275022.9,13.476192763855707,29.068042724616504,NaN,NaN,NaN,NaN,153.65576115773476,40.55743290480351,5221189,-102.25939090657678,-251.99049742813077,-149.73110652155398
2025-03-31T10:00:00-04:00,19090,19308,19055.75,19223,NaN,NaN,NaN,19559.184784248766,NaN,NaN,19982.05,20698.056648013815,19266.043351986184,19714.15804405385,19182.401168279677,19230.572289513482,19134.230047045872,909263,286914.76666666666,24.080833465872587,27.51183515503044,NaN,NaN,NaN,NaN,160.69820678932516,42.179492064176785,6130452,-86.3066231617737,-257.6143854737711,-171.3077623119974
2025-03-31T14:00:00-04:00,19223,19489.5,19218,19412.5,NaN,NaN,NaN,19559.184784248766,NaN,NaN,19973.825,20706.178181531894,19241.471818468108,19700.37643524308,19226.436611373043,19317.287824744417,19135.58539800167,499987,295493.2,36.0415773092051,26.984321290116572,NaN,NaN,NaN,NaN,168.61262059008763,42.05508382689977,6630439,-58.12817413205312,-243.9679799770638,-185.8398058450107
2025-03-31T18:00:00-04:00,19413,19413.25,19283.75,19341,NaN,NaN,NaN,19559.184784248766,NaN,NaN,19964.525,20716.708091075514,19212.34190892449,19658.926148194463,19346,19346,19346,110211,297465.6666666667,33.873154759022626,26.55550809670294,NaN,NaN,NaN,NaN,165.81886197650994,41.93956189228539,6520228,-40.28799017400925,-236.19979356252225,-195.911803388513
2025-03-31T22:00:00-04:00,19340,19399.75,19334.25,19360,NaN,NaN,NaN,19559.184784248766,NaN,NaN,19952.81,20723.808233201427,19181.811766798575,19408.99091855557,19352.187687660364,19360.974952562392,19343.400422758335,54648,298331.1,34.99242848947682,26.276947127281353,NaN,NaN,NaN,NaN,158.6532289781878,41.83229152442918,6574876,-23.995519345481,-225.90620257036426,-201.91068322488326
2025-04-01T02:00:00-04:00,19359.25,19511.5,19349.5,19487,NaN,NaN,NaN,19559.184784248766,NaN,NaN,19941.985,20723.56837629457,19160.40162370543,19098.09279026333,19392.298464975538,19440.600089754636,19343.99684019644,115940,299649.36666666664,42.052774092143586,26.62973475004248,NaN,NaN,NaN,NaN,158.89228405117439,40.75879685768213,6690816,-2.5802050305154296,-205.13593951302755,-202.55573448251212
2025-04-01T06:00:00-04:00,19488,19491.75,19311.5,19367.5,NaN,NaN,NaN,19559.184784248766,NaN,NaN,19927.59,20724.307137759624,19130.872862240376,19098.09279026333,19391.066444105996,19421.576673124426,19360.556215087567,423728,303972.6,37.88349537735908,26.61495974489532,NaN,NaN,NaN,NaN,160.41783519037622,39.94148020157189,6267088,5.198208850390927,-196.05797341952348,-201.2561822699144
2025-04-01T10:00:00-04:00,19400.25,19643.25,19261.25,19506,18964.49445429259,18964.49445429259,18964.49445429259,NaN,NaN,NaN,19918.63,20723.987263827585,19113.272736172417,19115.56938576853,19439.468438990236,19482.44658453964,19396.49029344083,1110830,322147.9666666667,44.72373786178938,27.354183076801498,NaN,NaN,NaN,NaN,176.24513267677793,37.99589216991849,7377918,20.4746299165337,-175.66289487424729,-196.137524790781
2025-04-01T14:00:00-04:00,19505.75,19629.75,19384.75,19597.5,18996.417908640466,NaN,NaN,NaN,NaN,NaN,19911.9,20722.239564626954,19101.56043537305,19115.56938576853,19458.46319402517,19513.114170962766,19403.812217087576,437203,328612.6666666667,48.73980312794375,28.572279969253145,NaN,NaN,NaN,NaN,181.15619462843665,36.189274711954624,7815121,36.60374536786634,-150.38284308094808,-186.98658844881442
2025-04-01T18:00:00-04:00,19597.75,19693.25,19557.25,19594,19119.092094611355,NaN,NaN,NaN,NaN,NaN,19906.815,20721.8656168946,19091.764383105397,19189.53440689186,19614.833333333332,19614.833333333332,19614.833333333332,100489,330483.9666666667,48.59436454470543,30.6172903258285,NaN,NaN,NaN,NaN,177.9307521549769,34.0385193508475,7714632,46.27569285379499,-129.14197238157067,-175.41766523536566
2025-04-01T22:00:00-04:00,19594.5,19599.25,19547.5,19557.5,19119.092094611355,NaN,NaN,NaN,NaN,NaN,19900.08,20720.978967230385,19079.18103276962,19189.53440689186,19601.849555688124,19622.787872788875,19580.911238587374,38640,330481.4,47.018657091886716,32.7123585130736,NaN,NaN,NaN,NaN,168.91784128676426,32.10596532209303,7675992,49.18193851518325,-113.94024209138661,-163.12218060656986
2025-04-02T02:00:00-04:00,19557,19589.75,19498.5,19516.25,19119.092094611355,NaN,NaN,NaN,NaN,NaN,19891.905,20719.76014970934,19064.04985029066,19201.04702041079,19575.327133685114,19611.918114425294,19538.736152944934,91126,331228.8,45.233542678808455,34.81784267409962,NaN,NaN,NaN,NaN,163.37013833770968,30.640446849234277,7584866,47.27999365697053,-104.02218853535669,-151.30218219232722
2025-04-02T06:00:00-04:00,19516,19580.75,19317,19531.25,19119.092094611355,NaN,NaN,NaN,NaN,NaN,19885.52,20719.45626159305,19051.58373840695,19201.04702041079,19510.095649552823,19561.66118354834,19458.530115557303,444871,335837.56666666665,46.03587259156252,36.98420096342319,NaN,NaN,NaN,NaN,170.5401284564447,30.32124387561993,8029737,45.94605414392328,-93.86961451242314,-139.81566865634642
2025-04-02T10:00:00-04:00,19531,19890,19491.5,19745,19164.386801841196,NaN,NaN,NaN,NaN,NaN,19884.495,20718.99342714058,19049.996572859418,19336.480093062906,19630.72706558561,19733.035862455108,19528.41826871611,1042700,343229.26666666666,55.94123188594793,39.906261859969995,NaN,NaN,NaN,NaN,186.8229764238415,28.379943834597114,9072437,57.617097023072205,-67.79429737750615,-125.41139440057836
2025-04-02T14:00:00-04:00,19745,20045.25,19076.25,19137,NaN,NaN,NaN,19943.374540928275,19943.374540928275,19943.374540928275,19872.86,20732.131971845913,19013.58802815409,19336.480093062906,19570.637177636305,19699.366458048506,19441.907897224104,682982,355122.76666666666,35.80759100822367,41.5013617345677,NaN,NaN,NaN,NaN,242.69276382213852,27.981070033630445,8389455,24.254109303043407,-95.09375777177411,-119.34786707481751
2025-04-02T18:00:00-04:00,19023.5,19125.25,18817.5,19079.75,NaN,NaN,NaN,19620.672872702547,NaN,NaN,19857.3,20744.81534071263,18969.78465928737,19336.480093062906,19007.5,19007.5,19007.5,333528,362690.36666666664,34.54676748124088,42.24892844995116,NaN,NaN,NaN,NaN,248.17899497770006,28.406944354219892,8055927,-0.4940950700123494,-119.96548591233295,-119.4713908423206
2025-04-02T22:00:00-04:00,19080,19149.75,19038.5,19042.75,NaN,NaN,NaN,19620.672872702547,NaN,NaN,19838.735,20754.349528117527,18923.120471882474,19336.480093062906,19023.216519602498,19052.29037596681,18994.142663238184,97463,364284.0333333333,33.72038214190208,42.08312879514379,NaN,NaN,NaN,NaN,238.39835247929292,28.663577930617084,7958464,-17.251944534650377,-141.03632151063357,-123.78437697598319
2025-04-03T02:00:00-04:00,19043,19176.75,19016.75,19033.25,NaN,NaN,NaN,19620.672872702547,NaN,NaN,19817.21,20756.643900601885,18877.776099398114,19336.480093062906,19038.279153912183,19072.397358600414,19004.16094922395,174025,366432.73333333334,33.49881203993657,42.056390029494786,NaN,NaN,NaN,NaN,232.79847015934342,28.742264986339798,7784439,-26.328813755336682,-156.69539417015403,-130.36658041481735
2025-04-03T06:00:00-04:00,19033.75,19074,18830.25,18988.25,NaN,NaN,NaN,19584.73359777407,NaN,NaN,19794.63,20758.097011578368,18831.162988421635,19336.480093062906,19004.909574548637,19049.625393230253,18960.19375586702,495525,369169.73333333334,32.41237850239487,41.872100744703225,NaN,NaN,NaN,NaN,233.58072229081887,29.376434502414156,7288914,-32.32108725427051,-170.7679394826555,-138.44685222838498
2025-04-03T10:00:00-04:00,18988.25,19003.5,18720.25,18813.75,NaN,NaN,NaN,19504.353661511614,NaN,NaN,19767.125,20761.997058357207,18772.252941642793,19336.480093062906,18929.354757603138,19015.146751214197,18843.56276399208,995567,373810.1666666667,28.546139150795696,40.90734110603552,NaN,NaN,NaN,NaN,237.12852784147466,30.26085080751369,6293347,-44.2565922034301,-193.76759248267263,-149.51100027924252
2025-04-03T14:00:00-04:00,18814,18866.25,18614,18648.5,NaN,NaN,NaN,19387.797813261084,NaN,NaN,19733.79,20764.030745457047,18703.549254542955,19336.480093062906,18893.14102399609,19006.25493814603,18780.02710984615,413537,375548.7,25.45015335885205,40.01924524757072,NaN,NaN,NaN,NaN,238.20863299565505,31.35060474694193,5879810,-58.600337478015035,-222.76142212676132,-164.16108464874628
2025-04-03T18:00:00-04:00,18656.5,18713.25,18591.25,18639.5,NaN,NaN,NaN,19287.1195035674,NaN,NaN,19699.73,20759.40498715403,18640.05501284597,19336.480093062906,18648,18648,18648,112638,377161.43333333335,25.289283813086826,38.63106995837769,NaN,NaN,NaN,NaN,229.90801635310825,32.419588799511175,5767172,-63.5965263097425,-243.65674253592442,-180.06021622618192
2025-04-03T22:00:00-04:00,18640,18680,18461.25,18641.75,NaN,NaN,NaN,19206.466344314336,NaN,NaN,19665.435,20748.599104879693,18582.27089512031,19336.480093062906,18617.764745480643,18644.38155802584,18591.147932935444,145345,380868.63333333336,25.41621039067958,36.9650990485731,NaN,NaN,NaN,NaN,229.1110151850291,33.72962059017395,5912517,-61.609041315317285,-257.07151787032853,-195.46247655501125
2025-04-04T02:00:00-04:00,18641.5,18675.5,18519.25,18572,NaN,NaN,NaN,19206.466344314336,NaN,NaN,19629.66,20736.5005700913,18522.8194299087,19117.934074450324,18605.250282201312,18629.857789084053,18580.64277531857,197661,383257.5333333333,24.052041943728256,35.21207600564616,NaN,NaN,NaN,NaN,223.90665695752702,34.946078681503664,5714856,-59.80296443796493,-270.2161821024674,-210.4132176645025
2025-04-04T06:00:00-04:00,18573,18602,17819.5,18195,NaN,NaN,NaN,18917.144179426905,NaN,NaN,19586.74,20745.147147595275,18428.33285240473,18475.224246118567,18334.16107945,18521.440339612847,18146.881819287155,960043,402359.06666666665,18.326480355661104,33.162634810201475,NaN,NaN,NaN,NaN,263.8061814605608,37.273896927533954,4754813,-77.67694234337037,-307.50939559371545,-229.83245325034508
2025-04-04T10:00:00-04:00,18194.75,18200.5,17615.5,17866.5,NaN,NaN,NaN,18662.058080362047,NaN,NaN,19537.19,20771.268176454,18303.111823545998,18475.224246118567,18127.409945930558,18385.897788294056,17868.92210356706,1254891,411126.63333333336,14.980199163088116,31.001681701935734,NaN,NaN,NaN,NaN,286.74859707052076,39.65950906845993,3499922,-103.67681570425168,-359.4284728806597,-255.751657176408
2025-04-04T14:00:00-04:00,17867,17913,17387,17486.25,NaN,NaN,NaN,18441.509985800134,NaN,NaN,19478.66,20814.484040658037,18142.835959341963,18475.224246118567,18024.42429508017,18337.574514047195,17711.274076113146,641087,421418.63333333336,12.202679699620958,28.585025066797048,NaN,NaN,NaN,NaN,303.837982994055,42.093397963673326,2858835,-136.47315025545402,-426.34309499572555,-289.86994474027154
2025-04-06T18:00:00-04:00,17126.25,17126.25,16452.5,16983,NaN,NaN,NaN,17685.873168263766,NaN,NaN,19410.03,20891.173931696125,17928.886068303873,18390.904396894854,16853.916666666668,16853.916666666668,16853.916666666668,386366,428629.86666666664,9.651999278609836,25.278651309130044,NaN,NaN,NaN,NaN,355.9745556373368,44.944344136618355,2472469,-179.34865969532467,-514.0557693594274,-334.7071096641027
2025-04-06T22:00:00-04:00,16982.5,17025.75,16667.5,16760.75,NaN,NaN,NaN,17685.873168263766,NaN,NaN,19334.9,20958.054074633663,17711.74592536634,18315.39851751588,16841.456176306696,16858.552241901234,16824.360110712158,205247,432944.26666666666,8.779229118452008,23.348054031289212,NaN,NaN,NaN,NaN,356.13708737752705,47.59165129721016,2267222,-207.95246022937812,-594.6476849508254,-386.69522472144723
2025-04-07T02:00:00-04:00,16758.75,16957,16480.25,16887.5,NaN,NaN,NaN,17647.118682240332,NaN,NaN,19262.435,20989.338566531624,17535.53143346838,18189.643814012707,16818.23468488345,16852.820575286943,16783.648794479956,317146,439246.4666666667,13.578709675476716,21.850335616591767,NaN,NaN,NaN,NaN,364.7522954219894,50.13751886900306,2584368,-203.36524122699296,-640.9017762551885,-437.5365350281955
2025-04-07T06:00:00-04:00,16888.75,17297,16673.5,17274.25,NaN,NaN,NaN,17647.118682240332,NaN,NaN,19198.72,20978.454512897904,17418.985487102098,18124.412632774507,16934.339743593686,17067.62341232459,16801.056074862783,716578,450308.8333333333,26.317592526526354,21.32156492977921,NaN,NaN,NaN,NaN,383.2342743204187,50.961478755087896,3300946,-161.15890068228612,-638.9851608810532,-477.82626019876705
2025-04-07T10:00:00-04:00,17273,18360.25,17150.75,17783.25,16663.406582917385,16663.406582917385,16663.406582917385,NaN,NaN,NaN,19145.725,20933.07771071502,17358.372289284976,18124.412632774507,17308.87140212613,17733.716482112566,16884.026322139693,1335312,464510.4666666667,39.05111370767565,21.71815790604629,NaN,NaN,NaN,NaN,442.2532547261031,48.44911728311694,4636258,-89.41712653691292,-589.5976683699082,-500.1805418329953
2025-04-07T14:00:00-04:00,17783.5,17821.75,17405.25,17629.5,16663.406582917385,NaN,NaN,NaN,NaN,NaN,19091.995,20896.83117951882,17287.158820481178,18124.412632774507,17352.215723431236,17760.63946432662,16943.79198253585,481316,463888.1,36.97262794666285,22.043890009208287,NaN,NaN,NaN,NaN,440.4137365313814,46.11621020200105,4154942,-45.0152941319958,-556.4496594979901,-511.43436536599427
2025-04-07T18:00:00-04:00,17650.25,17885,17644,17866.75,16680.376659228445,NaN,NaN,NaN,NaN,NaN,19047.655,20861.761192839986,17233.548807160012,17769.880106219603,17798.583333333332,17798.583333333332,17798.583333333332,178296,466157.6,42.09428871998368,23.011614978436,NaN,NaN,NaN,NaN,427.2056124934256,43.791106952571305,4333238,4.978080541170414,-505.21176468953126,-510.1898452307017
2025-04-07T22:00:00-04:00,17867,17874.75,17668.5,17752.75,16708.65499289988,NaN,NaN,NaN,NaN,NaN,19000.9,20825.558165246257,17176.241834753746,17242.304084975684,17786.859551466165,17802.74566760075,17770.97343533158,97105,467572.8333333333,40.3956556094735,24.07915085348039,NaN,NaN,NaN,NaN,411.4230687438952,41.63208250667226,4236133,33.42808980293216,-468.4047329770365,-501.83282277996864
2025-04-08T02:00:00-04:00,17752.5,17893,17702.75,17725,16757.278629586246,NaN,NaN,NaN,NaN,NaN,18953.64,20785.61547516339,17121.664524836608,16883.443267980547,17781.398059507857,17795.226682545333,17767.56943647038,192470,470123.8333333333,39.972807993136264,25.1279740091982,NaN,NaN,NaN,NaN,395.6249924050456,39.57547678351779,4043663,52.31182261805827,-436.4430445073958,-488.7548671254541
2025-04-08T06:00:00-04:00,17724.75,18265.25,17694,18248.5,16908.430737332328,NaN,NaN,NaN,NaN,NaN,18916.325,20728.114461416535,17104.535538583466,17146.965278544994,17936.057520892053,18079.890624964442,17792.224416819663,543279,474108.86666666664,50.499605477030315,26.919645086794684,NaN,NaN,NaN,NaN,408.1696358046852,36.82300441382594,4586942,99.26994016209403,-364.6674419228366,-463.9373820849306
2025-04-08T10:00:00-04:00,18248,18357.25,17487.25,17671.5,16908.430737332328,NaN,NaN,NaN,NaN,NaN,18867.425,20678.9850328171,17055.864967182897,17146.965278544994,17881.81099736867,17989.073459395666,17774.548535341673,1271346,479459.4,41.79885961535651,28.18727492048242,NaN,NaN,NaN,NaN,441.15751896149334,34.61306516402402,3315596,90.90532074151713,-350.3057311580342,-441.2110518995513
2025-04-08T14:00:00-04:00,17671,17704,16972,17232.5,16908.430737332328,NaN,NaN,NaN,NaN,NaN,18810.54,20645.110021449094,16975.969978550907,17146.965278544994,17761.451179240783,18015.050566654205,17507.85179182736,599019,484853.26666666666,36.62807984492488,29.4945320268584,NaN,NaN,NaN,NaN,461.93198189281526,33.60538820469296,2716577,56.90361473555447,-370.0815334801082,-426.98514821566266
2025-04-08T18:00:00-04:00,17226,17243,16838.75,17117.5,NaN,NaN,NaN,18231.038698963686,18231.038698963686,18231.038698963686,18752.59,20614.166535520333,16891.013464479667,17146.965278544994,17066.416666666668,17066.416666666668,17066.416666666668,271586,490556.5,35.39291219120368,30.95258295743809,NaN,NaN,NaN,NaN,457.81184032904275,32.905182915837585,2444991,29.16273337328738,-390.5317314990534,-419.6944648723408
2025-04-08T22:00:00-04:00,17117.25,17204,16735,16896.25,NaN,NaN,NaN,18169.519894465335,NaN,NaN,18690.57,20588.417952392385,16792.722047607615,17146.965278544994,17010.867423077896,17071.31786910967,16950.416977046123,229332,496912.9,33.08155136822485,32.443930933766936,NaN,NaN,NaN,NaN,458.610994591254,32.43790527245768,2215659,-0.046856102998788174,-419.7530350010893,-419.7061788980905
2025-04-09T02:00:00-04:00,16894.75,17426,16888.5,17271,NaN,NaN,NaN,18169.519894465335,NaN,NaN,18636.685,20539.69368839313,16733.676311606872,17146.965278544994,17080.03669669662,17181.260386304606,16978.813007088636,300948,503906.9666666667,40.20454666405384,34.626255747012934,NaN,NaN,NaN,NaN,464.24592354902154,31.355250479965076,2516607,9.389646005226382,-407.96912139155756,-417.35876739678395
2025-04-09T06:00:00-04:00,17270,17553.75,16857.25,17446.25,NaN,NaN,NaN,18169.519894465335,NaN,NaN,18586.1,20478.501513949996,16693.69848605,17146.965278544994,17165.353074204184,17292.901492222605,17037.804656185763,568223,508018.7,43.246885368928865,37.08823119347557,NaN,NaN,NaN,NaN,480.83550043837715,29.992694691374027,3084830,29.80106775161613,-380.1074327072638,-409.9085004588799
2025-04-09T10:00:00-04:00,17447.5,18900,17214.5,18882.25,16626.259039947083,16626.259039947083,16626.259039947083,NaN,NaN,NaN,18565.56,20422.022829037996,16709.097170962006,17146.965278544994,17675.850327402106,18262.571383540806,17089.129271263406,1065550,508780.36666666664,60.83218692066685,40.46347956813201,NaN,NaN,NaN,NaN,566.8829646927787,29.588757411915946,4150380,136.41155304804147,-239.3940591488281,-375.80561219686956
2025-04-09T14:00:00-04:00,18880.25,19388,18716.5,19351,17594.735901767668,NaN,NaN,NaN,NaN,NaN,18555.465,20389.10418481799,16721.825815182012,17480.498620786497,17972.43113992266,18762.91105818332,17181.951221662002,612483,506430.4,64.67950764783544,43.203616362511234,NaN,NaN,NaN,NaN,574.355610071866,29.824011152871936,4762863,229.42269876929367,-89.02723873525247,-318.44993750454614
2025-04-09T18:00:00-04:00,19266,19384.5,19115.25,19148.25,17821.8956335055,NaN,NaN,NaN,NaN,NaN,18548.775,20371.239420091588,16726.310579908415,17723.873896629197,19216,19216,19216,176119,501183.43333333335,61.849612669912524,44.83208057409958,NaN,NaN,NaN,NaN,552.5623522095898,30.042461055188213,4586744,265.6577819639795,13.62228995042824,-252.03549201355128
2025-04-09T22:00:00-04:00,19147.75,19187.25,18969.5,19152.25,17821.8956335055,NaN,NaN,NaN,NaN,NaN,18544.575,20360.477321849892,16728.67267815011,17749.874117303356,19171.00588771985,19226.321930128805,19115.689845310895,116524,501818.8,61.88504362438873,46.61153883679429,NaN,NaN,NaN,NaN,528.6471841946192,29.88799275507984,4703268,276.9960403375886,94.20955840843453,-182.7864819291541
2025-04-10T02:00:00-04:00,19153.25,19186,18706,18851.75,17821.8956335055,NaN,NaN,NaN,NaN,NaN,18536.77,20343.94845228405,16729.59154771595,17796.099293842686,19064.369684107078,19197.636458871955,18931.1029093422,208339,502962.6,57.56015411417847,47.7162435078082,NaN,NaN,NaN,NaN,525.172385323575,29.12078862456046,4494929,252.0712723665235,132.30260852900028,-119.7686638375232
2025-04-10T06:00:00-04:00,18851.5,19006,18659,18661.75,17821.8956335055,NaN,NaN,NaN,NaN,NaN,18525.23,20321.66780810808,16728.79219189192,17796.099293842686,18925.03461707847,19098.282673914524,18751.786560242414,467071,502014.13333333336,54.94549420775406,48.75551769339967,NaN,NaN,NaN,NaN,512.445786371891,28.29819347073438,4027858,212.20146997079988,145.48317362597663,-66.71829634482324
2025-04-10T10:00:00-04:00,18661.25,18801.25,17918.25,18460.25,17821.8956335055,NaN,NaN,NaN,NaN,NaN,18510.515,20296.75850918344,16724.271490816558,17796.099293842686,18618.459251643988,18904.38726292103,18332.531240366945,1317802,512755.3,52.23551906761953,49.63142562729133,NaN,NaN,NaN,NaN,538.9139444881845,26.532894183481208,2710056,163.83689724653243,138.0778252133423,-25.759072033190137
2025-04-10T14:00:00-04:00,18460.5,18670.5,18240.5,18502.5,17821.8956335055,NaN,NaN,NaN,NaN,NaN,18498.78,20277.353989577092,16720.206010422906,17796.099293842686,18589.184153510945,18851.787737553936,18326.580569467955,567023,517871.5,52.7616146004746,49.792997707537346,NaN,NaN,NaN,NaN,531.1343770247428,24.893687702460408,3277079,127.86545599818646,134.07274796454294,6.207291966356479
2025-04-10T18:00:00-04:00,18470,18598.5,18071.75,18365,17821.8956335055,NaN,NaN,NaN,NaN,NaN,18481.62,20248.43062154384,16714.809378456157,17796.099293842686,18345.083333333332,18345.083333333332,18345.083333333332,238847,522078.4666666667,50.80056419982703,50.4359766064281,NaN,NaN,NaN,NaN,530.8212072372611,23.68449380174531,3038232,89.78481554435457,118.43831139679969,28.653495852445122
2025-04-10T22:00:00-04:00,18365.75,18710,18259.75,18698,17821.8956335055,NaN,NaN,NaN,NaN,NaN,18467.33,20215.250356995693,16719.40964300431,17796.099293842686,18428.94321480742,18532.132257943165,18325.754171671673,157747,522491.86666666664,55.148415543473995,51.75885772775303,NaN,NaN,NaN,NaN,525.0661210060282,22.32014025072015,3195979,82.19999305835023,131.4034871753829,49.203494117032676
2025-04-11T02:00:00-04:00,18698.5,18793.25,18315.25,18640.25,17821.8956335055,NaN,NaN,NaN,NaN,NaN,18453.315,20184.14372003564,16722.486279964356,17796.099293842686,18489.328676152425,18599.434978288347,18379.222374016503,255893,524432.9333333333,54.25298756263016,53.106005968569214,NaN,NaN,NaN,NaN,521.7042552198833,20.869736634218093,2940086,69.00286485217407,135.45707518225026,66.4542103300762
2025-04-11T06:00:00-04:00,18639.75,18702.5,18353.5,18550.25,17821.8956335055,NaN,NaN,NaN,NaN,NaN,18437.12,20148.75794138837,16725.48205861163,17796.099293842686,18507.581414510732,18596.06928702962,18419.093541991846,427863,506693.6,52.81379082045784,54.51545164372872,NaN,NaN,NaN,NaN,509.3682369898916,19.52293327603761,2512223,50.7644762718448,129.9098056698822,79.14532939803739
2025-04-11T10:00:00-04:00,18550,18873.25,18270,18822.5,17821.8956335055,NaN,NaN,NaN,NaN,NaN,18423.83,20112.823642498326,16734.836357501677,17796.099293842686,18579.714685677023,18676.945634991254,18482.483736362792,1031692,499253.63333333336,56.56718796667444,55.68421173677304,NaN,NaN,NaN,NaN,516.0740772048994,18.386824016389603,3543915,53.32465602925819,145.80114943461012,92.47649340535193
2025-04-11T14:00:00-04:00,18822.5,18867,18710.75,18819,17821.8956335055,NaN,NaN,NaN,NaN,NaN,18412.86,20084.227662006157,16741.492337993845,17796.099293842686,18613.009608057462,18732.20548798464,18493.813728130284,378255,490492.56666666665,56.50496068250157,56.63121711631395,NaN,NaN,NaN,NaN,490.3723574045494,17.33186541814503,3165660,51.06750815687772,156.31087860144908,105.24337044457135
2025-04-13T18:00:00-04:00,19163.75,19253,18924.75,19006,17821.8956335055,NaN,NaN,NaN,NaN,NaN,18402.86,20053.80477848295,16751.91522151705,18158.724059611177,19061.25,19061.25,19061.25,180736,483638.23333333334,59.094128232863405,56.50707006718513,NaN,NaN,NaN,NaN,486.34576044708155,17.22272787686533,3346396,57.95014785080332,177.6810552580755,119.73090740727218
2025-04-13T22:00:00-04:00,19006.5,19134.25,19004,19087.5,17821.8956335055,NaN,NaN,NaN,NaN,NaN,18392.66,20020.089837996155,16765.230162003845,18193.70424768894,19065.951479867264,19072.563348374733,19059.339611359796,91383,479842.76666666666,60.20596016662285,56.18753096138424,NaN,NaN,NaN,NaN,460.9103489865757,17.12138587424847,3437779,63.335786336573534,198.9006403279891,135.56485399141556
2025-04-14T02:00:00-04:00,19087.5,19182.5,19024,19067,17821.8956335055,NaN,NaN,NaN,NaN,NaN,18382.12,19984.93154300812,16779.30845699188,18350.813398151153,19073.960747203826,19086.908239418364,19061.013254989288,126670,473493.56666666665,59.76592430954787,56.03869607850105,NaN,NaN,NaN,NaN,439.30960977324884,17.135534669360172,3311109,60.847052620062385,211.62366976649355,150.77661714643116
2025-04-14T06:00:00-04:00,19066.5,19255.75,18987,19046.25,17842.93036227699,NaN,NaN,NaN,NaN,NaN,18371.895,19950.929730745294,16792.860269254707,18456.025718520923,19084.705093742057,19099.2676523704,19070.142535113715,368476,461890.1666666667,59.29352983525573,55.85358795070584,NaN,NaN,NaN,NaN,427.126780503731,17.31750165216361,2942633,53.398641335988,217.52491881641618,164.12627748042817
2025-04-14T10:00:00-04:00,19046.5,19193,18738.5,18940,17842.93036227699,NaN,NaN,NaN,NaN,NaN,18360.37,19914.03501292909,16806.70498707091,18456.025718520923,19011.59457396614,19075.389198580197,18947.799949352084,1030632,451734.1666666667,56.81710150247,55.80051276415522,NaN,NaN,NaN,NaN,429.0820104677502,16.678051798773165,1912001,37.65394170346187,211.1937046097555,173.53976290629365
2025-04-14T14:00:00-04:00,18940.25,19095.25,18790.75,18903.75,17842.93036227699,NaN,NaN,NaN,NaN,NaN,18347.82,19873.332736885524,16822.307263114475,18456.025718520923,18997.012396162732,19062.75105883511,18931.273733490354,390744,448715.1,55.95838971807875,55.872862443464136,NaN,NaN,NaN,NaN,420.18329543433947,16.08427693491061,1521257,21.916067949048,200.93484784260363,179.01877989355563
2025-04-14T18:00:00-04:00,18903.75,18950,18809.75,18901,17842.93036227699,NaN,NaN,NaN,NaN,NaN,18330.94,19812.277593393264,16849.602406606733,18456.025718520923,18886.916666666668,18886.916666666668,18886.916666666668,94130,445909.56666666665,55.88938051527568,56.13385254686814,NaN,NaN,NaN,NaN,400.1880600461723,15.532914561323949,1427127,9.095418456475585,190.38805296415012,181.29263450767453
2025-04-14T22:00:00-04:00,18900.75,18938,18860.5,18890,17842.93036227699,NaN,NaN,NaN,NaN,NaN,18326,19798.17141664959,16853.82858335041,18456.025718520923,18890.811562203377,18895.378571338064,18886.24455306869,68463,444954.8333333333,55.59404562563188,56.33616904866509,NaN,NaN,NaN,NaN,377.13891290001715,15.020935214422051,1358664,-1.7719177782511224,179.07773728486063,180.84965506311175
2025-04-15T02:00:00-04:00,18890.5,19040.5,18876.75,18980,17842.93036227699,NaN,NaN,NaN,NaN,NaN,18324.005,19792.350638771684,16855.659361228318,18456.025718520923,18922.670082392266,18959.878318491985,18885.461846292546,120241,442547.2,57.56963523298749,56.819674122462274,NaN,NaN,NaN,NaN,361.89684769287305,14.871807678750255,1478905,-4.395648777460252,175.35509409128645,179.7507428687467
2025-04-15T06:00:00-04:00,18980,19117.75,18835.25,19067.5,17842.93036227699,NaN,NaN,NaN,NaN,NaN,18324.5,19793.8308579078,16855.1691420922,18503.82619795595,18968.58137983066,19017.42220919781,18919.740550463506,339467,435753.4666666667,59.45810400075076,57.12750901226775,NaN,NaN,NaN,NaN,356.2256442862393,14.975167298334316,1818372,-1.8644329925627403,177.4202016280433,179.28463462060603
2025-04-15T10:00:00-04:00,19067.75,19144.75,18906.5,18952,17908.04134025161,NaN,NaN,NaN,NaN,NaN,18322.875,19789.243637996624,16856.506362003376,18534.48595836476,18987.710012161573,19022.885656056787,18952.53436826636,890113,423045.7,55.92009022639056,57.24658777396491,NaN,NaN,NaN,NaN,347.7988125515079,15.157369188678674,928259,-9.18562328044203,167.80260552005348,176.9882288004955
2025-04-15T14:00:00-04:00,18951.5,19001,18884.5,18940,17908.04134025161,NaN,NaN,NaN,NaN,NaN,18321.91,19786.58839732824,16857.23160267176,18534.48595836476,18980.03402711863,19016.41434081109,18943.653713426167,303902,413208.4666666667,55.55024637946787,57.44204888532278,NaN,NaN,NaN,NaN,331.2774687978288,15.221621600070309,624357,-15.672257830682753,157.39790651214207,173.07016434282482
2025-04-15T18:00:00-04:00,18810,18810,18636.75,18707.25,17908.04134025161,NaN,NaN,NaN,NaN,NaN,18319.78,19781.898697780733,16857.661302219265,18534.48595836476,18718,18718,18718,121707,408212.5,48.80759003537513,56.88779189022997,NaN,NaN,NaN,NaN,329.2755067408411,14.190013026928852,502650,-35.34779795280713,128.88541690181592,164.23321485462304
2025-04-15T22:00:00-04:00,18707.25,18724.75,18504.5,18525.75,17908.04134025161,NaN,NaN,NaN,NaN,NaN,18317.325,19777.638775357802,16857.0112246422,18534.48595836476,18656.229745963716,18722.56133348483,18589.8981584426,105544,404086.23333333334,44.292684558637006,56.01548645281108,NaN,NaN,NaN,NaN,321.48797054506673,13.627218500721577,397106,-58.90724419802146,90.59915960709623,149.50640380511769
2025-04-16T02:00:00-04:00,18525,18861,18512,18678.75,17908.04134025161,NaN,NaN,NaN,NaN,NaN,18318.11,19779.157693129804,16857.062306870197,18534.48595836476,18669.01088282675,18719.600132985637,18618.421632667865,194859,400549.93333333335,48.608401105590495,55.266505943720155,NaN,NaN,NaN,NaN,323.45311550613343,12.752873985164573,591965,-62.1847523828655,71.77546332653583,133.96021570940133
2025-04-16T06:00:00-04:00,18678.25,18730,18523,18524,17908.04134025161,NaN,NaN,NaN,NaN,NaN,18315.755,19775.087040660983,16856.42295933902,18534.48595836476,18633.766517424716,18687.088227121305,18580.444807728127,359060,393577.8333333333,44.825783157993335,54.16792187167518,NaN,NaN,NaN,NaN,315.1350358271239,11.940982649290211,232905,-72.0762767335516,43.86486979246183,115.94114652601343
2025-04-16T10:00:00-04:00,18523,18735.25,18288.75,18293.25,17908.04134025161,NaN,NaN,NaN,NaN,NaN,18310.18,19767.682411798964,16852.677588201037,18534.48595836476,18531.83976515184,18635.806112193004,18427.873418110674,858400,386672.8333333333,39.846497610261224,52.745105678868995,NaN,NaN,NaN,NaN,324.51824755375793,11.902631184629316,-625495,-90.28067426670513,3.0903036926320055,93.37097795933714
2025-04-16T14:00:00-04:00,18292.25,18441.25,18116.25,18372.75,17908.04134025161,NaN,NaN,NaN,NaN,NaN,18313.735,19770.963401486788,16856.506598513213,18534.48595836476,18476.731525368206,18608.285951037764,18345.17709969865,542183,384329.5,42.22755570330981,51.526107526587154,NaN,NaN,NaN,NaN,324.5526584427752,12.44255899872689,-83312,-92.73591694549818,-22.548918222535576,70.1869987229626
2025-04-16T18:00:00-04:00,18381,18499.5,18346,18475.25,17908.04134025161,NaN,NaN,NaN,NaN,NaN,18325.91,19778.152103645323,16873.667896354676,18534.48595836476,18440.25,18440.25,18440.25,114280,382268.2,45.23733773881769,50.69898154346913,NaN,NaN,NaN,NaN,312.3346114111484,12.67073967256103,30968,-83.51201641401904,-34.20302179456121,49.308994619457835
2025-04-16T22:00:00-04:00,18474.75,18574.25,18455.75,18551.5,17908.04134025161,NaN,NaN,NaN,NaN,NaN,18347.215,19780.693451215757,16913.736548784243,18534.48595836476,18473.86347439709,18516.192016642508,18431.534932151673,72066,380786.26666666666,47.43136330251723,50.08990822807187,NaN,NaN,NaN,NaN,298.48928202463776,12.532662716111941,103034,-68.93626018563963,-36.8613306125917,32.074929573047925
2025-04-17T02:00:00-04:00,18550.75,18652,18524.25,18577.75,17908.04134025161,NaN,NaN,NaN,NaN,NaN,18379.11,19759.746234349903,16998.4737656501,18454.538766691807,18518.380111420734,18581.805018262887,18454.955204578582,125146,378013.1666666667,48.20076758241069,49.540721590010094,NaN,NaN,NaN,NaN,286.2936190228779,12.046061536391091,228180,-54.80391322545364,-36.42996195876913,18.373951266684514
2025-04-17T06:00:00-04:00,18576.5,18624.75,18376,18467.25,17908.04134025161,NaN,NaN,NaN,NaN,NaN,18413.24,19714.2362911553,17112.243708844704,18221.571848546206,18501.521305982646,18545.03451999979,18458.0080919655,430866,376806.3333333333,45.20160899049968,48.79840468750064,NaN,NaN,NaN,NaN,283.6119319498152,12.167433986187467,-202686,-50.29248390768858,-44.491653617926204,5.80083028976237
2025-04-17T10:00:00-04:00,18466.75,18488.5,18261.25,18453.75,17908.04134025161,NaN,NaN,NaN,NaN,NaN,18444.565,19670.357400082605,17218.772599917393,18221.571848546206,18445.566718715698,18503.204260897706,18387.92917653369,935547,364064.5,44.83456793949742,47.88875702367992,NaN,NaN,NaN,NaN,279.5860796676855,12.688320353833857,-1138233,-45.74281582539912,-51.37768949198653,-5.634873666587412
2025-04-17T14:00:00-04:00,18453.25,18526,18329.75,18430,17908.04134025161,NaN,NaN,NaN,NaN,NaN,18467.68,19647.033971630142,17288.32602836986,18221.571848546206,18442.574306944596,18495.286860498483,18389.86175339071,358873,357126.1666666667,44.1552738173047,46.79569772486234,NaN,NaN,NaN,NaN,273.6335025485651,12.977577553567363,-1497106,-41.9575554692058,-58.08181800309467,-16.124262533888864
2025-04-20T18:00:00-04:00,18307.5,18384.75,18220,18285.75,17908.04134025161,NaN,NaN,NaN,NaN,NaN,18477.73,19642.05130805895,17313.408691941047,18115.424666665298,18296.833333333332,18296.833333333332,18296.833333333332,122784,353257.4,40.173960077200086,45.670974142777304,NaN,NaN,NaN,NaN,269.0882523665247,13.644657897810186,-1619890,-46.44423940338041,-74.17956178811437,-27.735322384733966
2025-04-20T22:00:00-04:00,18285.75,18306.75,18189.75,18245.75,17908.04134025161,NaN,NaN,NaN,NaN,NaN,18490.055,19631.011674418343,17349.098325581657,18115.424666665298,18277.570307918617,18301.671145202225,18253.46947063501,78438,350613.76666666666,39.12059686830221,44.497427749122615,NaN,NaN,NaN,NaN,258.2248057689158,14.37229397162128,-1698328,-49.121571109552335,-89.13728627167438,-40.01571516212205
2025-04-21T02:00:00-04:00,18245.5,18256.25,18135,18172.25,17908.04134025161,NaN,NaN,NaN,NaN,NaN,18496.165,19626.931145628652,17365.39885437135,18115.424666665298,18252.629202012373,18297.745628611578,18207.512775413168,77454,344665.8,37.19092902290684,43.667666248232024,NaN,NaN,NaN,NaN,248.44089107113612,15.247176642933589,-1775782,-52.55041948112661,-105.70373951353031,-53.1533200324037
2025-04-21T06:00:00-04:00,18172.5,18213.75,17994,17994.5,17908.04134025161,NaN,NaN,NaN,NaN,NaN,18501,19621.026213978952,17380.973786021048,18115.424666665298,18157.498046450044,18255.270962565646,18059.725130334442,294298,340213.63333333336,32.95710245656265,42.857981812369566,NaN,NaN,NaN,NaN,246.39154170891211,16.54278894851222,-2070080,-62.80377645887576,-131.6580406059984,-68.85426414712263
2025-04-21T10:00:00-04:00,17995,17999,17703,17712.5,NaN,NaN,NaN,18704.79013483526,18704.79013483526,18704.79013483526,18500.75,19621.47430597361,17380.02569402639,18115.424666665298,17963.825340236417,18151.181006803854,17776.46967366898,697956,329089.1,27.590703121975835,41.356717670682805,NaN,NaN,NaN,NaN,249.9350030154184,18.555035433485045,-2768036,-83.30695424517509,-172.9879569535915,-89.6810027084164
2025-04-21T14:00:00-04:00,17712.75,17952,17700,17912,NaN,NaN,NaN,18675.345128706387,NaN,NaN,18494.02,19624.719570354548,17363.320429645453,18115.424666665298,17940.568835195445,18112.677340427206,17768.460329963684,344082,327950,35.58203948427382,40.69645026541712,NaN,NaN,NaN,NaN,250.08250280003136,20.43099192791074,-2423954,-78.24163215459646,-187.48304290166197,-109.24141074706552
2025-04-21T18:00:00-04:00,17912,18068.75,17863.75,18030.25,NaN,NaN,NaN,18675.345128706387,NaN,NaN,18501.195,19615.357947194017,17387.032052805982,18071.114733332237,17987.583333333332,17987.583333333332,17987.583333333332,97291,325168.5,39.82148884600417,40.69466392511305,NaN,NaN,NaN,NaN,246.86232402860057,21.415767878405237,-2326663,-62.422858918236585,-187.26998439486124,-124.84712547662465
2025-04-21T22:00:00-04:00,18030,18048.5,17949.25,17998,NaN,NaN,NaN,18675.345128706387,NaN,NaN,18516.505,19580.41803446278,17452.591965537224,17982.648429332632,17992.086754020143,17997.495712289514,17986.677795750773,67442,324370.4666666667,39.06636405737102,40.46886452183171,NaN,NaN,NaN,NaN,236.31858659798624,22.3302026895787,-2394105,-50.1555611472387,-187.54157691067303,-137.38601576343433
2025-04-22T02:00:00-04:00,17997.25,18170.75,17984.25,18093.5,NaN,NaN,NaN,18675.345128706387,NaN,NaN,18536.025,19530.069406704144,17541.98059329586,17982.648429332632,18027.818111085755,18072.354675145914,17983.281547025596,106991,323714.5,42.541062810389406,40.2762734555154,NaN,NaN,NaN,NaN,232.7601161267015,22.396677374049663,-2287114,-32.49031019233453,-177.9989035038525,-145.50859331151796
2025-04-22T06:00:00-04:00,18093,18254.75,18043.75,18253.75,NaN,NaN,NaN,18675.345128706387,NaN,NaN,18563.175,19444.33398820809,17682.016011791908,17845.068743466105,18111.381226375088,18195.03549611337,18027.726956636805,312317,321842.5333333333,47.90894043383858,40.31038610775264,NaN,NaN,NaN,NaN,231.2058221176514,21.956846359441414,-1974797,-8.161522681749858,-155.71049666370527,-147.5489739819554
2025-04-22T10:00:00-04:00,18253.75,18513.5,18210.5,18223.5,NaN,NaN,NaN,18675.345128706387,NaN,NaN,18582.225,19388.849189136563,17775.600810863434,17971.42979243507,18236.549563914657,18348.966475057103,18124.132652772212,922048,318223.06666666665,47.01603988903698,40.22576270108309,NaN,NaN,NaN,NaN,236.3339776806763,20.548221824360184,-2896845,6.929822008889801,-138.88669647084316,-145.81651847973296
2025-04-22T14:00:00-04:00,18223.5,18436.5,18218,18359.25,NaN,NaN,NaN,18675.345128706387,NaN,NaN,18600.485,19342.139342736515,17858.830657263487,17971.42979243507,18256.637369927535,18365.108163545246,18148.166576309824,372223,317605.7,51.394034650267955,40.66807881963796,NaN,NaN,NaN,NaN,235.06012213205653,19.24021332749904,-2524622,26.018141000662865,-113.2938422289044,-139.31198322956726
2025-04-22T18:00:00-04:00,18618.25,18801.25,18618.25,18641.25,17892.096363037723,17892.096363037723,17892.096363037723,NaN,NaN,NaN,18595.665,19333.052181947234,17858.277818052768,18145.925067158445,18686.916666666668,18686.916666666668,18686.916666666668,169876,320130.56666666665,58.97719336524471,41.67826635004849,NaN,NaN,NaN,NaN,249.8415419797668,19.46593188284165,-2354746,55.885077553687964,-69.45563628745731,-125.34071384114527
2025-04-22T22:00:00-04:00,18641.5,18752,18627,18741.25,17892.096363037723,NaN,NaN,NaN,NaN,NaN,18583.47,19290.00952925493,17876.930470745072,18165.240053726757,18692.615165868163,18701.589982913047,18683.64034882328,68486,320131.3333333333,61.28387687176706,42.9017379967958,NaN,NaN,NaN,NaN,240.92428898121202,19.675527684231216,-2286260,79.19998039975722,-26.34073834144874,-105.54071874120596
2025-04-23T02:00:00-04:00,18739.75,18859,18713.75,18846.25,18005.286665495118,NaN,NaN,NaN,NaN,NaN,18577.43,19269.57039789626,17885.28960210374,18316.967042981403,18726.764932112972,18779.42992176073,18674.099942465215,102302,319533.36666666664,63.59837780736235,44.57491069180738,NaN,NaN,NaN,NaN,234.09041119683974,20.233597224122477,-2183958,97.32456526229534,16.114987836663204,-81.20957742563213
2025-04-23T06:00:00-04:00,18845.5,19122.25,18838.75,19066.75,18196.25658979079,NaN,NaN,NaN,NaN,NaN,18575.72,19262.573635354518,17888.866364645484,18546.873634385123,18874.107378350684,19019.843964625612,18728.370792075755,371417,320598.36666666664,67.93367316940827,46.63298757045782,NaN,NaN,NaN,NaN,237.6196675399226,21.518435313181097,-1812541,118.39495647794821,66.78411817180313,-51.610838306145084
2025-04-23T10:00:00-04:00,19067,19165.75,18747,18927.5,18196.25658979079,NaN,NaN,NaN,NaN,NaN,18577.235,19266.845951261534,17887.624048738468,18546.873634385123,18916.05159246379,19017.35894621293,18814.74423871465,972939,323359.23333333334,62.84353194311275,48.46531635047253,NaN,NaN,NaN,NaN,250.55754842992812,22.19186767573848,-2785480,116.97892670823022,94.6128200791427,-22.36610662908753
2025-04-23T14:00:00-04:00,18927.5,18959.75,18729.75,18850,18196.25658979079,NaN,NaN,NaN,NaN,NaN,18581,19274.460308885842,17887.539691114158,18546.873634385123,18902.01591820932,18996.73259848155,18807.299237937088,426011,327429.5333333333,60.14257336913144,50.407135701370294,NaN,NaN,NaN,NaN,249.0891521135047,22.71857467396651,-3211491,105.21719662402728,109.15538915094658,3.938192526919295
2025-04-23T18:00:00-04:00,18832,18876.5,18740.25,18771,18196.25658979079,NaN,NaN,NaN,NaN,NaN,18587.215,19281.804267193307,17892.625732806693,18546.873634385123,18795.916666666668,18795.916666666668,18795.916666666668,99237,326680.5333333333,57.432833190842324,52.53871642057504,NaN,NaN,NaN,NaN,241.0292126768258,23.20765974374968,-3310728,87.2520135684897,113.00320948753142,25.75119591904172
2025-04-23T22:00:00-04:00,18771,18807.25,18678,18711.5,18196.25658979079,NaN,NaN,NaN,NaN,NaN,18591.395,19286.41008681454,17896.37991318546,18546.873634385123,18768.34284722738,18799.889917653963,18736.7957768008,75814,325689.5333333333,55.4079845941617,53.95485535699561,NaN,NaN,NaN,NaN,233.04498319990967,23.270663195246385,-3386542,67.38597040946169,109.98365893086884,42.59768852140715
2025-04-24T02:00:00-04:00,18710.75,18779,18595,18694,18196.25658979079,NaN,NaN,NaN,NaN,NaN,18597.975,19290.517152147007,17905.43284785299,18546.873634385123,18733.36064104319,18779.12905834701,18687.592223739368,139088,323830.5,54.796074624041104,55.02446862685539,NaN,NaN,NaN,NaN,229.54177011420182,22.822034035618223,-3525630,49.89667139581623,104.96852776617743,55.0718563703612
2025-04-24T06:00:00-04:00,18694.5,19062.25,18693.75,19051.25,18196.25658979079,NaN,NaN,NaN,NaN,NaN,18605.04,19308.638773165432,17901.44122683457,18546.873634385123,18843.56024084302,18948.980574947924,18738.139906738117,375508,324378.76666666666,63.62711380909941,56.77880789483599,NaN,NaN,NaN,NaN,239.4673579631874,23.43561947738955,-3150122,58.61583242980565,128.34164690761827,69.72581447781262
2025-04-24T10:00:00-04:00,19051.25,19278.75,19045.25,19264.75,18394.252934537268,NaN,NaN,NaN,NaN,NaN,18617.53,19344.953835463326,17890.10616453667,18681.493230409804,19038.389720526495,19227.41379225815,18849.36564879484,851155,324137.26666666666,67.68957029064325,58.57512985771126,NaN,NaN,NaN,NaN,239.041118108674,24.618356130172177,-2298967,73.99748913761348,162.22267589982948,88.225186762216
2025-04-24T14:00:00-04:00,19265.25,19417,19221,19346.25,18559.423255694666,NaN,NaN,NaN,NaN,NaN,18633.45,19388.60041548016,17878.299584519842,18841.19458432784,19092.219008538857,19296.63851838284,18887.799498694876,351644,317785.9666666667,69.10797994570443,60.08934696570168,NaN,NaN,NaN,NaN,235.96675252948302,26.056188814933584,-1947323,84.15615032834341,193.42037467264527,109.26422434430185
2025-04-24T18:00:00-04:00,19396.75,19467,19353,19411.25,18668.483562253998,NaN,NaN,NaN,NaN,NaN,18645.225,19429.594927075308,17860.85507292469,18945.980667462274,19410.416666666668,19410.416666666668,19410.416666666668,105996,317509.8333333333,70.23044223534029,61.74751856186621,NaN,NaN,NaN,NaN,227.73698449166278,27.50945514450484,-1841327,89.2638049665683,220.84398055251222,131.58017558594392
2025-04-24T22:00:00-04:00,19410.75,19497.25,19362,19411.25,18703.370673060635,NaN,NaN,NaN,NaN,NaN,18657.07,19468.982982036945,17845.157017963054,19012.80953396982,19416.635902867834,19423.169618613294,19410.102187122375,96038,318308.9,70.23044223534029,63.092976246514226,NaN,NaN,NaN,NaN,221.13077131368686,28.932154500143483,-1841327,86.5862364399297,239.81297113585606,153.22673469592635
2025-04-25T02:00:00-04:00,19411.5,19475,19345,19395.25,18703.370673060635,NaN,NaN,NaN,NaN,NaN,18664.855,19497.20881353133,17832.501186468668,19022.447627175854,19412.415499620405,19420.0338173294,19404.79718191141,116291,318013.73333333334,69.50942583210337,63.84527856557556,NaN,NaN,NaN,NaN,214.62143050556637,30.132708745162507,-1957618,77.95097325650619,250.6654512665591,172.71447801005291
2025-04-25T06:00:00-04:00,19396,19417.25,19215.25,19259.25,18703.370673060635,NaN,NaN,NaN,NaN,NaN,18668.29,19508.96818075651,17827.61181924349,19022.447627175854,19348.778070057073,19406.26791261085,19291.288227503297,393133,316755.9666666667,63.538265833175615,64.00630634853331,NaN,NaN,NaN,NaN,213.71989975516877,30.352412207856837,-2350751,58.19843155307211,245.46251745139307,187.26408589832096
2025-04-25T10:00:00-04:00,19263.25,19554.5,19234.5,19428.25,18703.370673060635,NaN,NaN,NaN,NaN,NaN,18675.515,19535.757154337967,17815.27284566203,19024.066481392547,19380.92878992744,19428.235864568847,19333.62171528603,921546,316289.26666666666,67.29772562916206,64.27054547866186,NaN,NaN,NaN,NaN,221.31133548694243,30.982039648586994,-1429205,51.84499739293855,252.07033263949415,200.2253352465556
2025-04-25T14:00:00-04:00,19428.25,19590,19414,19554.75,18792.889224790422,NaN,NaN,NaN,NaN,NaN,18685.685,19574.758466086983,17796.61153391302,19077.65318511404,19405.30015943646,19473.3430112848,19337.257307588123,348245,315935,69.80718535184897,64.40436777740763,NaN,NaN,NaN,NaN,218.0748115235894,31.67205386092981,-1080960,51.39250582584961,264.4659675288676,213.073461703018
2025-04-27T18:00:00-04:00,19524.5,19526.75,19392,19429.25,18792.889224790422,NaN,NaN,NaN,NaN,NaN,18695.47,19606.033378573793,17784.90662142621,19077.65318511404,19449.333333333332,19449.333333333332,19449.333333333332,105877,315371.43333333335,64.51763681286992,64.52394669667599,NaN,NaN,NaN,NaN,214.12303927190445,32.152802829295936,-1186837,38.4631459130145,261.15239409428614,222.68924818127164
2025-04-27T22:00:00-04:00,19429.25,19453.25,19395.25,19416.5,18792.889224790422,NaN,NaN,NaN,NaN,NaN,18705.725,19636.759533462773,17774.690466537224,19077.65318511404,19440.59383796939,19453.455172503775,19427.732503435007,48888,314386.43333333335,63.987164784061285,64.79856036917099,NaN,NaN,NaN,NaN,202.97139360962555,32.599212585635904,-1235725,25.49908135517353,254.56309987523855,229.06401852006502
2025-04-28T02:00:00-04:00,19416.75,19540,19416.75,19514.5,18817.020460253956,NaN,NaN,NaN,NaN,NaN,18717.995,19674.81361651,17761.176383489998,19140.648430778387,19458.604474199554,19484.653959187865,19432.554989211243,87621,314725.3333333333,66.28197482972766,65.43064191480568,NaN,NaN,NaN,NaN,197.29486549465227,33.312408494622666,-1148104,20.202550987866914,254.31720725489868,234.11465626703176
2025-04-28T06:00:00-04:00,19515.5,19622.75,19453.75,19464.75,18883.91157569696,NaN,NaN,NaN,NaN,NaN,18729.49,19707.865137459954,17751.11486254005,19218.76874462271,19490.013869527822,19522.225899638328,19457.801839417316,320743,315606.8333333333,64.05064074292383,66.04797449686012,NaN,NaN,NaN,NaN,195.27380367360567,34.242007566891246,-1468847,10.514429851005247,247.25769358078833,236.74326372978308
2025-04-28T10:00:00-04:00,19465.25,19539.5,19257.75,19371.75,18883.91157569696,NaN,NaN,NaN,NaN,NaN,18737.325,19729.772365102956,17744.877634897046,19218.76874462271,19430.49261509637,19483.89825209176,19377.08697810098,821001,319708.3333333333,59.98537372700208,66.41863871850019,NaN,NaN,NaN,NaN,201.4506748397767,33.615044113755474,-2289848,-4.2024664547037105,231.49018066140343,235.69264711610714
2025-04-28T14:00:00-04:00,19371.5,19579,19356.75,19483.75,18883.91157569696,NaN,NaN,NaN,NaN,NaN,18745.65,19755.86053746221,17735.439462537794,19218.76874462271,19438.379735492646,19489.363922798206,19387.395548187087,313819,318699.56666666665,63.028710110362006,66.3758955971618,NaN,NaN,NaN,NaN,202.9363409226498,33.192659016801606,-1976029,-8.207618236074126,225.43312432101447,233.6407425570886
2025-04-28T18:00:00-04:00,19479.75,19600.25,19455.25,19593.75,18883.91157569696,NaN,NaN,NaN,NaN,NaN,18758.485,19794.825602360055,17722.144397639946,19218.76874462271,19549.75,19549.75,19549.75,71599,317843.1666666667,65.78137353234362,66.23959582871183,NaN,NaN,NaN,NaN,198.79803085674624,32.88870931033393,-1904430,-5.397827901430617,226.89345768030034,232.29128558173096
2025-04-28T22:00:00-04:00,19593.5,19631.5,19530,19532.25,18943.768595694964,NaN,NaN,NaN,NaN,NaN,18770.33,19828.017002094544,17712.64299790546,19218.76874462271,19557.075597396688,19564.49170493151,19549.659489861864,69862,317923.8333333333,62.95900650865853,65.8003834403514,NaN,NaN,NaN,NaN,191.8481715098358,32.740246223927485,-1974292,-9.396284331215924,220.54593016771105,229.94221449892697
2025-04-29T02:00:00-04:00,19532.75,19621.25,19525.5,19567,18952.29047770883,NaN,NaN,NaN,NaN,NaN,18787.525,19868.254125405456,17706.795874594547,19239.40002223797,19562.094469963668,19571.120829517644,19553.06811040969,77546,316942.3333333333,63.90146980873803,65.34831398130838,NaN,NaN,NaN,NaN,184.98401640199037,32.56435520727807,-1896746,-11.28854606698249,215.83153191519887,227.12007798218136
2025-04-29T06:00:00-04:00,19567,19581,19379.25,19503.75,18952.29047770883,NaN,NaN,NaN,NaN,NaN,18807.085,19903.4431696235,17710.726830376498,19239.40002223797,19517.510828106366,19554.227999177336,19480.793657035396,330866,317560.63333333336,60.86585972965029,64.67941523090197,NaN,NaN,NaN,NaN,186.18158665899108,31.240627431854445,-2227612,-17.98989245951836,204.6327124077834,222.62260486730176
2025-04-29T10:00:00-04:00,19504,19667.75,19469.25,19656,18952.29047770883,NaN,NaN,NaN,NaN,NaN,18826.63,19947.704552560972,17705.55544743903,19243.4160142323,19564.420531758256,19610.450272818107,19518.390790698406,775861,312687.73333333334,65.15664304769498,64.36850217487277,NaN,NaN,NaN,NaN,187.061473326206,30.464501524317473,-1451751,-13.560475139512135,205.67201094291158,219.23248608242372
2025-04-29T14:00:00-04:00,19656,19692.5,19567.25,19614.25,19021.707925343864,NaN,NaN,NaN,NaN,NaN,18848.435,19987.38502001829,17709.484979981713,19290.40781138584,19575.576342945664,19623.263361026475,19527.889324864853,301274,310322.76666666666,63.11309831440783,64.33813306638936,NaN,NaN,NaN,NaN,182.64636808861988,29.86988430465754,-1753025,-14.736427853172756,200.81195126595776,215.54837911913052
2025-04-29T18:00:00-04:00,19595,19611,19506.25,19513.25,19021.707925343864,NaN,NaN,NaN,NaN,NaN,18872.835,20015.430989884477,17730.23901011552,19290.40781138584,19543.5,19543.5,19543.5,76860,307222.23333333334,58.345675223798686,63.6987008945777,NaN,NaN,NaN,NaN,177.31448465371847,28.83297162580526,-1829885,-23.111681806701796,186.65877686075328,209.77045866745507
2025-04-29T22:00:00-04:00,19513,19540.5,19485,19537,19021.707925343864,NaN,NaN,NaN,NaN,NaN,18896.12,20044.44018287591,17747.799817124087,19290.40781138584,19533.602210039233,19544.84425877512,19522.360161303346,59578,306925.3,59.12752277244849,62.935867853191944,NaN,NaN,NaN,NaN,168.61345003559572,27.701872398153178,-1770307,-27.546343892937614,175.33752880128304,202.88387269422066
2025-04-30T02:00:00-04:00,19536.75,19623.25,19533.75,19589.75,19021.707925343864,NaN,NaN,NaN,NaN,NaN,18918.41,20076.413086178934,17760.406913821065,19315.86879942955,19551.0701659816,19576.083183821822,19526.05714814138,76437,306063.13333333336,60.8836804190043,62.67629953934439,NaN,NaN,NaN,NaN,162.96248931876744,27.141763871120183,-1693870,-27.365151083717734,168.6774338395735,196.04258492329123
2025-04-30T06:00:00-04:00,19589.75,19601,19106,19117.5,19021.707925343864,NaN,NaN,NaN,NaN,NaN,18929.73,20084.22542588961,17775.23457411039,19315.86879942955,19365.25471156783,19495.66362845822,19234.845794677443,437457,308264.4666666667,43.05003192486538,61.18079004940183,NaN,NaN,NaN,NaN,186.6794543674269,26.396799084964933,-2131327,-57.74223106601178,123.86479609077651,181.6070271567883
2025-04-30T10:00:00-04:00,19124.5,19512.75,19102.25,19477.75,19021.707925343864,NaN,NaN,NaN,NaN,NaN,18947.73,20107.763865195386,17787.696134804613,19315.86879942955,19364.67405297081,19449.397592389418,19279.950513552205,890504,305516.63333333336,54.09605654488719,60.31036731477037,NaN,NaN,NaN,NaN,202.666636198325,25.722134811321535,-1240823,-52.42041634063392,116.0815067309959,168.50192307162982
2025-04-30T14:00:00-04:00,19478.5,19878.5,19446.25,19848.25,19021.707925343864,NaN,NaN,NaN,NaN,NaN,18975.35,20153.92249670952,17796.777503290476,19315.86879942955,19449.71540086855,19619.523240694714,19279.907561042386,477153,307221.36666666664,62.21348189076014,60.17914168247296,NaN,NaN,NaN,NaN,219.06544789844466,24.610248898738057,-763670,-24.22859655025971,138.2161773838052,162.4447739340649
2025-04-30T18:00:00-04:00,19835,19956,19812,19928.75,19231.981646783777,NaN,NaN,NaN,NaN,NaN,19004.85,20203.3926692447,17806.3073307553,19327.116660246345,19898.916666666668,19898.916666666668,19898.916666666668,113116,307684,63.71485794975801,60.44553341266981,NaN,NaN,NaN,NaN,213.7036301914129,23.90015767149392,-650554,-1.6320630635979114,160.4046951045675,162.03675816816542
2025-04-30T22:00:00-04:00,19928.75,19973.75,19907,19921.75,19308.89157192997,NaN,NaN,NaN,NaN,NaN,19034.685,20248.671930778,17820.698069222002,19437.268328197075,19910.66167957651,19927.276924889335,19894.046434263688,56522,307040.93333333335,63.47866483262655,60.4776730356887,NaN,NaN,NaN,NaN,203.20694232059773,23.31538235640118,-707076,10.69257996004481,175.40248311822143,164.70990315817662
2025-05-01T02:00:00-04:00,19921.75,20023.75,19901,20016.75,19342.856727751336,NaN,NaN,NaN,NaN,NaN,19069.305,20294.561680414336,17844.048319585665,19533.18966255766,19934.607174123572,19970.388982251076,19898.82536599607,88512,305355.06666666665,65.35568420898562,60.44726665544886,NaN,NaN,NaN,NaN,197.46001786912646,22.987896360053956,-618564,22.41795404503202,192.73234571446665,170.31439166943463
2025-05-01T06:00:00-04:00,20016.25,20035.75,19858,19884.75,19342.856727751336,NaN,NaN,NaN,NaN,NaN,19102.085,20325.151815877303,17879.018184122695,19554.42673004613,19929.737350546686,19953.381048668005,19906.093652425367,352074,304573.93333333335,60.68841437964443,60.285081503376425,NaN,NaN,NaN,NaN,196.05215944990314,22.411652179768566,-970638,18.615349745675275,193.58357885152873,174.96822910585345
2025-05-01T10:00:00-04:00,19906,20125.25,19864.75,19982.25,19371.861966814748,NaN,NaN,NaN,NaN,NaN,19138.285,20356.25809498196,17920.31190501804,19609.9413840369,19964.328236173267,19998.32882316088,19930.327649185656,798894,302831.9,62.80151493899504,60.20651329839478,NaN,NaN,NaN,NaN,200.65557663205294,22.28436479858033,-171744,19.883173921409593,199.82219650761544,179.93902258620585
2025-05-01T14:00:00-04:00,19982,20049.75,19756,19797,19371.861966814748,NaN,NaN,NaN,NaN,NaN,19174.335,20361.058622458062,17987.611377541936,19609.9413840369,19945.008420825256,19994.212270591197,19895.804571059314,351616,302830.9666666667,56.57864879225296,59.90028394572355,NaN,NaN,NaN,NaN,207.305178301192,21.470647421307625,-523360,6.17282077676964,187.6550485571679,181.48222778039826
2025-05-01T18:00:00-04:00,19781.75,19982,19748.25,19928.75,19371.861966814748,NaN,NaN,NaN,NaN,NaN,19218.66,20347.83162893867,18089.48837106133,19609.9413840369,19886.333333333332,19886.333333333332,19886.333333333332,131420,303678.43333333335,59.641542915294984,59.506348221980694,NaN,NaN,NaN,NaN,209.19409413682115,20.666284900101026,-391940,4.0092859533757235,186.49383522211792,182.4845492687422
2025-05-01T22:00:00-04:00,19929.25,20005.75,19906.75,19950,19371.861966814748,NaN,NaN,NaN,NaN,NaN,19259.42,20343.201751276578,18175.63824872342,19609.9413840369,19910.057849181452,19942.406888417365,19877.70880994554,70686,302833.36666666664,60.13004607625045,59.2932730621123,NaN,NaN,NaN,NaN,201.3230874127625,20.047100809426034,-321254,2.1354993996760356,185.15392351833725,183.01842411866122
2025-05-02T02:00:00-04:00,19950,19959.5,19864,19918.5,19371.861966814748,NaN,NaN,NaN,NaN,NaN,19297.185,20337.74269090425,18256.62730909575,19609.9413840369,19911.4145581909,19937.679058557307,19885.150057824492,106055,302492.1666666667,58.99019282551688,59.3393100336636,NaN,NaN,NaN,NaN,193.76429545470802,19.1748003744117,-427309,-2.8297005659867978,179.4812984111777,182.3109989771645
2025-05-02T06:00:00-04:00,19919,20141.5,19901.25,20072.75,19409.085318621914,NaN,NaN,NaN,NaN,NaN,19338.68,20333.14594733043,18344.21405266957,19662.638672721212,19979.13907473651,20045.03598687903,19913.242162593993,351579,301107.0333333333,62.717239010516586,59.59571833638275,NaN,NaN,NaN,NaN,197.08470292222887,19.32331963780949,-75730,2.388325933277656,185.29640639376157,182.90808046048392
2025-05-02T10:00:00-04:00,20069.25,20266,20061.25,20225,19551.246213230006,NaN,NaN,NaN,NaN,NaN,19381.31,20340.73714449811,18421.88285550189,19780.53593817697,20083.552293927118,20195.921518974432,19971.183068879804,685217,293229.4,66.0016100223596,59.96128473662241,NaN,NaN,NaN,NaN,197.63222414206965,20.006099279104856,609487,13.58238512186054,199.88606186280958,186.30367674094904
2025-05-02T14:00:00-04:00,20225.5,20277,20152.5,20200.5,19613.229339901372,NaN,NaN,NaN,NaN,NaN,19420.245,20351.05709967429,18489.432900325708,19826.378750541575,20106.534141946508,20219.271682047074,19993.79660184594,298742,291579.3,65.00915208004585,61.52979331913531,NaN,NaN,NaN,NaN,192.4084938462075,20.686503325266322,310745,16.62456566224384,207.08438381875385,190.45981815651
2025-05-04T18:00:00-04:00,20182,20200,19991,20003.75,19613.229339901372,NaN,NaN,NaN,NaN,NaN,19455.85,20335.62420966978,18576.07579033022,19826.378750541575,20064.916666666668,20064.916666666668,20064.916666666668,118811,292010.43333333335,57.527973867586745,61.774930270756705,NaN,NaN,NaN,NaN,193.62931571433552,20.150829364120455,191934,3.367347122637682,194.6690020598071,191.30165493716942
2025-05-04T22:00:00-04:00,20003.75,20073.75,19994.25,20062,19613.229339901372,NaN,NaN,NaN,NaN,NaN,19489.905,20328.090295087004,18651.719704912994,19826.378750541575,20056.30156139375,20066.87145495669,20045.73166783081,78929,293011.8,59.031167604846104,61.54762210747713,NaN,NaN,NaN,NaN,185.47722173474014,19.65341782877072,270863,-3.145224277842374,187.37012458986646,190.51534886770884
2025-05-05T02:00:00-04:00,20062,20099,19976.25,20011,19613.229339901372,NaN,NaN,NaN,NaN,NaN,19517.3,20331.952453504022,18702.647546495977,19826.378750541575,20047.77702369976,20063.248025598252,20032.30602180127,88592,293044.1666666667,57.124846933072554,61.07690703485674,NaN,NaN,NaN,NaN,180.99670589654443,19.33024009272048,182271,-12.053892932459036,175.44798270213505,187.5018756345941
2025-05-05T06:00:00-04:00,20011.5,20071.25,19966.25,20059.75,19613.229339901372,NaN,NaN,NaN,NaN,NaN,19543.67,20341.314647948115,18746.02535205188,19826.378750541575,20040.69689979617,20054.395488909773,20026.998310682568,244832,290513.8,58.50429962281375,60.72159523415582,NaN,NaN,NaN,NaN,175.56836976107698,18.95243414202942,427103,-15.604096568039438,167.9967549245448,183.60085149258424
2025-05-05T10:00:00-04:00,20059.75,20155,20009,20143.5,19613.229339901372,NaN,NaN,NaN,NaN,NaN,19569.615,20359.18230055137,18780.047699448634,19826.378750541575,20072.40432306173,20104.740605849438,20040.068040274025,559610,281800.76666666666,60.835545533635546,60.39872818591653,NaN,NaN,NaN,NaN,173.45634334957148,19.083832937406196,986713,-13.340427473314719,166.92531715094083,180.26574462425555
2025-05-05T14:00:00-04:00,20143.75,20191.25,20002,20041,19613.229339901372,NaN,NaN,NaN,NaN,NaN,19589.1,20376.147844797368,18802.05215520263,19826.378750541575,20073.45452491669,20102.73131227343,20044.177737559952,247479,279589.43333333335,56.64140715338029,60.10965624118338,NaN,NaN,NaN,NaN,174.58446168174493,19.40565472980596,739234,-19.407035212486477,156.00695060864746,175.41398582113393
2025-05-05T18:00:00-04:00,20009.75,20037.5,19952.25,19959,19613.229339901372,NaN,NaN,NaN,NaN,NaN,19609.73,20380.230381829966,18839.229618170033,19826.378750541575,19982.916666666668,19982.916666666668,19982.916666666668,67037,279437.36666666664,53.465735693665465,59.44281486651698,NaN,NaN,NaN,NaN,168.45342870447743,19.26656488929616,672197,-29.024382817433178,139.13350729934245,168.15789011677563
2025-05-05T22:00:00-04:00,19958.75,19992.25,19913.25,19922.75,19613.229339901372,NaN,NaN,NaN,NaN,NaN,19631.185,20375.1560465466,18887.213953453404,19826.378750541575,19963.65844935538,19983.724825739773,19943.592072970983,61746,279166.8333333333,52.07573261477906,59.12117799669742,NaN,NaN,NaN,NaN,162.06389808272905,18.80016866545757,610451,-37.37729756849129,121.43626815616153,158.81356572465282
2025-05-06T02:00:00-04:00,19922.75,19974.75,19823.75,19866.5,19613.229339901372,NaN,NaN,NaN,NaN,NaN,19653.095,20357.94187620775,18948.24812379225,19826.378750541575,19927.323174154673,19967.636093628727,19887.01025468062,120015,280582.4666666667,49.90750307681127,58.425889436805726,NaN,NaN,NaN,NaN,161.2736196482484,17.639417143736186,490436,-45.69097956362222,101.69984127012503,147.39082083374726
2025-05-06T06:00:00-04:00,19866.5,19907.75,19746.75,19756.5,19613.229339901372,NaN,NaN,NaN,NaN,NaN,19673.995,20325.90695333422,19022.08304666578,19804.46726318197,19858.203420554113,19925.183310205335,19791.22353090289,315326,280064.4666666667,45.88415635254893,57.40832588511275,NaN,NaN,NaN,NaN,161.2540753876592,16.763235681491576,175110,-56.87031472494871,76.30292742756137,133.17324215251008
2025-05-06T10:00:00-04:00,19757,20027,19738.25,19846.5,19613.229339901372,NaN,NaN,NaN,NaN,NaN,19697.045,20287.310539312948,19106.77946068705,19804.46726318197,19865.34173115027,19909.351943797352,19821.33151850319,768256,279810.9666666667,49.473193675869275,56.7285402315665,NaN,NaN,NaN,NaN,170.36092714568355,16.041190517096496,943366,-56.366594837316214,62.71499860586482,119.08159344318103
2025-05-06T14:00:00-04:00,19847.25,19972.75,19808.75,19846.25,19613.229339901372,NaN,NaN,NaN,NaN,NaN,19712.945,20274.922795735816,19150.967204264183,19804.46726318197,19867.332617479704,19907.199134043338,19827.46610091607,309017,280069.06666666665,49.463380275532,55.78183603621046,NaN,NaN,NaN,NaN,169.90657520670615,15.370720007301063,634349,-54.19764150037359,51.33454156771404,105.53218306808763
2025-05-06T18:00:00-04:00,19812.5,20136.25,19801.25,20052.5,19613.229339901372,NaN,NaN,NaN,NaN,NaN,19728.7,20283.65916065945,19173.740839340553,19804.46726318197,19996.666666666668,19996.666666666668,19996.666666666668,165300,283017.06666666665,57.03521083054475,55.141378951080824,NaN,NaN,NaN,NaN,181.69896269194143,15.772390333528366,799649,-37.79677724989878,58.286211505714164,96.08298875561294
2025-05-06T22:00:00-04:00,20052.25,20055.75,19971.25,19979.25,19613.229339901372,NaN,NaN,NaN,NaN,NaN,19741.36,20289.68394768046,19193.03605231954,19804.46726318197,19998.344550204674,20000.849194457103,19995.839905952245,74183,283503.9,53.94394902164168,54.35100730405196,NaN,NaN,NaN,NaN,174.75617964251705,16.145369922168,725466,-31.086277898091865,57.22514138299812,88.31141928108998
2025-05-07T02:00:00-04:00,19979,20025.5,19952.5,19990.5,19613.229339901372,NaN,NaN,NaN,NaN,NaN,19752.945,20297.343891347125,19208.546108652874,19804.46726318197,19996.184695865588,20000.564110846186,19991.80528088499,77378,283535.26666666666,54.353146697597005,54.12423393476697,NaN,NaN,NaN,NaN,167.48788109662297,16.318668128763843,802844,-25.337842487770885,56.63911617137637,81.97695865914726
2025-05-07T06:00:00-04:00,19990.25,20030.25,19858,19936.25,19613.229339901372,NaN,NaN,NaN,NaN,NaN,19763.445,20301.289562025224,19225.600437974776,19683.698810545575,19970.864224964567,19998.319912240328,19943.408537688807,273226,278060.9,51.95589731975979,53.61885748583224,NaN,NaN,NaN,NaN,167.8280324468642,15.649404381993289,529618,-24.616059512453546,51.206884268580325,75.82294378103387
2025-05-07T10:00:00-04:00,19937,19977.75,19784.75,19819,19613.229339901372,NaN,NaN,NaN,NaN,NaN,19771.92,20299.54768539973,19244.292314600265,19669.70904843646,19912.668583267845,19970.9121100924,19854.42505644329,658260,270319.43333333335,47.118843321761304,52.90414294216714,NaN,NaN,NaN,NaN,169.62603012923105,14.613029719055154,-128642,-31.047129798777092,37.01403153256251,68.0611613313396
2025-05-07T14:00:00-04:00,19817.75,20055,19678.5,19957.25,19613.229339901372,NaN,NaN,NaN,NaN,NaN,19785.88,20295.127270390225,19276.632729609777,19641.21723874917,19907.617031873324,19956.18108812643,19859.05297562022,589334,274058.8,52.709432545348164,52.49022386520532,NaN,NaN,NaN,NaN,184.4027422628574,14.39682724282491,460692,-25.24816681004461,36.500952818783844,61.74911962882845
2025-05-07T18:00:00-04:00,19935.5,20123.5,19910.25,20066.5,19613.229339901372,NaN,NaN,NaN,NaN,NaN,19798.645,20303.371530806453,19293.918469193548,19633.068147834663,20033.416666666668,20033.416666666668,20033.416666666668,119664,274277.06666666665,56.612963381551594,52.18861085434218,NaN,NaN,NaN,NaN,186.46326067265332,13.651297177395652,580356,-13.880813693194156,44.398102512335754,58.27891620552991
2025-05-07T22:00:00-04:00,20066.5,20199,20066.5,20157,19613.229339901372,NaN,NaN,NaN,NaN,NaN,19810.69,20320.281233833786,19301.09876616621,19713.693130682463,20078.410267617215,20131.40685721537,20025.41367801906,86252,275268.06666666665,59.58872066724395,52.39913324818958,NaN,NaN,NaN,NaN,182.60874205317808,12.950615094423998,666608,-0.7841409701063071,57.298739992897026,58.08288096300333
2025-05-08T02:00:00-04:00,20156.5,20262.25,20123.75,20246,19643.099385330665,NaN,NaN,NaN,NaN,NaN,19827.025,20339.016955503022,19315.03304449698,19804.75450454597,20118.959870691833,20194.23396021678,20043.685781166885,91049,275352.63333333336,62.32533165217051,53.031961530939945,NaN,NaN,NaN,NaN,179.45811762080822,12.73549593826901,757657,12.615947274474138,73.852815056096,61.23686778162187
2025-05-08T06:00:00-04:00,20246,20257.5,20061,20090,19643.099385330665,NaN,NaN,NaN,NaN,NaN,19840.495,20343.9431154004,19337.046884599597,19804.75450454597,20127.85250675787,20180.878756232334,20074.826257283406,317627,274204.4,55.261325926561085,53.259503910352954,NaN,NaN,NaN,NaN,180.67539493360763,12.037503808392303,440030,9.839673790304552,73.53646001950256,63.696786229198004
2025-05-08T10:00:00-04:00,20089.5,20337.5,19978,20250,19643.099385330665,NaN,NaN,NaN,NaN,NaN,19855.205,20362.65765483579,19347.752345164212,19804.75450454597,20162.74271913652,20208.49044874057,20116.99498953247,832512,275325,60.2389730464758,53.99746605104327,NaN,NaN,NaN,NaN,193.4485810097785,11.575591126305953,1272542,17.213862165822206,85.21411393647577,68.00025177065356
2025-05-08T14:00:00-04:00,20250.25,20331.25,20141.25,20155.75,19660.8606224218,NaN,NaN,NaN,NaN,NaN,19869.025,20370.79586653155,19367.254133468454,19804.75450454597,20171.389912407132,20216.48913907044,20126.290685743825,329068,274573.4,56.26755931345718,54.73913769110815,NaN,NaN,NaN,NaN,193.20225379479433,11.146672207225771,943474,14.298721348435265,85.87365345619764,71.57493210776238
2025-05-08T18:00:00-04:00,20164,20182.5,20080.5,20159.75,19660.8606224218,NaN,NaN,NaN,NaN,NaN,19884.785,20372.390968072643,19397.179031927357,19804.75450454597,20140.916666666668,20140.916666666668,20140.916666666668,78633,272813.8333333333,56.39893891734435,55.23383377978494,NaN,NaN,NaN,NaN,186.68780709516616,11.191766444721253,1022107,11.32474062085494,85.73085788383105,74.40611726297611
2025-05-08T22:00:00-04:00,20159.25,20203.5,20124.25,20192.25,19660.8606224218,NaN,NaN,NaN,NaN,NaN,19898.955,20380.258310709287,19417.651689290717,19804.75450454597,20156.880295773706,20173.086781802445,20140.673809744967,76294,273000.76666666666,57.51570120569865,55.80899956051113,NaN,NaN,NaN,NaN,179.01367801694002,11.04292681463625,1098401,10.26277320566092,87.23458377005227,76.97181056439135
2025-05-09T02:00:00-04:00,20192.5,20232.25,20165.5,20197.5,19666.34414671753,NaN,NaN,NaN,NaN,NaN,19911.03,20391.39233865712,19430.66766134288,19860.145140839697,20170.7204492438,20194.352071320198,20147.0888271674,77419,272046.23333333334,57.70416239922158,55.85678181541662,NaN,NaN,NaN,NaN,170.99484387287288,10.639592749987248,1175820,8.692466504426676,87.83739369492469,79.14492719049801
2025-05-09T06:00:00-04:00,20198.75,20290,20140.25,20254.25,19686.37964004855,NaN,NaN,NaN,NaN,NaN,19925.47,20402.81680935318,19448.123190646824,19917.44111267176,20201.28336327663,20234.19192628213,20168.374800271133,264148,269131.86666666664,59.78106120066169,56.27371839963233,NaN,NaN,NaN,NaN,169.47735502481052,10.010212245258112,1439968,10.15265845610304,91.83575026062681,81.68309180452377
2025-05-09T10:00:00-04:00,20254,20275,20057.5,20155.75,19686.37964004855,NaN,NaN,NaN,NaN,NaN,19937.245,20407.635927740004,19466.854072259994,19917.44111267176,20178.610183016724,20206.98884564593,20150.23152038752,709771,269950.3333333333,54.755331083877806,56.30244585579525,NaN,NaN,NaN,NaN,172.90754395160977,9.860363860006117,730197,3.5049303079603362,86.06425468947418,82.55932438151385
2025-05-09T14:00:00-04:00,20155.25,20187,20110.25,20146.5,19686.37964004855,NaN,NaN,NaN,NaN,NaN,19950.1,20407.3485101127,19492.851489887296,19917.44111267176,20173.59829800748,20201.927753978376,20145.268842036585,235408,267839.2,54.29372094931709,56.46943325790647,NaN,NaN,NaN,NaN,166.03914795506623,9.721218930843554,494789,-2.188462137280368,79.8237467099134,82.01220884719376
2025-05-11T18:00:00-04:00,20373.75,20548,20373.75,20516.5,19909.239314565144,NaN,NaN,NaN,NaN,NaN,19967.31,20443.37364658509,19491.246353414914,20056.199849687942,20479.416666666668,20479.416666666668,20479.416666666668,159389,269191.8,66.47025836229167,57.851677189372936,NaN,NaN,NaN,NaN,182.85778024399005,10.975541386711104,654178,17.222598538111725,103.54045701983341,86.31785848172169
2025-05-11T22:00:00-04:00,20516,20563.25,20503.5,20552.5,19998.665936630365,NaN,NaN,NaN,NaN,NaN,19986.075,20478.67196761125,19493.47803238875,20139.93487975035,20494.3743114865,20520.426440616244,20468.322182356755,52541,268312.2,67.3808140658513,58.89963301226602,NaN,NaN,NaN,NaN,174.06436736941933,12.216208386442933,706719,29.996730698636227,123.81377185501697,93.81704115638074
2025-05-12T02:00:00-04:00,20552.75,20930.75,20541.5,20906.75,20172.64134860171,NaN,NaN,NaN,NaN,NaN,20013.945,20551.97022515212,19475.91977484788,20397.47290380028,20648.645859753968,20798.971583894745,20498.32013561319,226490,272908.8,74.67031951710923,60.189444164805856,NaN,NaN,NaN,NaN,189.4347697001751,14.776065840790778,933209,58.18292642159783,166.54569918337802,108.36277276178019
2025-05-12T06:00:00-04:00,20907,20991.5,20746.5,20786.75,20297.720150937996,NaN,NaN,NaN,NaN,NaN,20038.94,20601.56974112665,19476.31025887335,20442.378323040226,20740.51098894096,20885.84898708099,20595.172990800933,398482,278030.4666666667,69.04181262641569,60.86466501903241,NaN,NaN,NaN,NaN,193.40371472159117,17.326280781239838,534727,64.15340032489203,188.55452316789524,124.40112284300321
2025-05-12T10:00:00-04:00,20788.5,20934.75,20690,20908.5,20297.720150937996,NaN,NaN,NaN,NaN,NaN,20065.315,20663.745194843214,19466.884805156784,20442.378323040226,20785.91263638896,20906.53414057765,20665.29113220027,649472,281025.86666666664,71.3975197439199,61.51267845415736,NaN,NaN,NaN,NaN,197.0713065271918,19.214242908953967,1184199,71.16820972560046,213.3613850000038,142.19317527440333
2025-05-12T14:00:00-04:00,20908.75,20996,20857.5,20958,20355.48003422243,NaN,NaN,NaN,NaN,NaN,20102.125,20689.13560680375,19515.11439319625,20477.412126745745,20809.95822526107,20933.632542962798,20686.283907559344,280962,282141.9666666667,72.31974450081255,62.73113692374675,NaN,NaN,NaN,NaN,192.88764177524953,21.166454472502775,1465161,73.69682752709974,234.31420968327802,160.61738215617828
2025-05-12T18:00:00-04:00,20957.5,20966.75,20864,20874.75,20356.06048721232,NaN,NaN,NaN,NaN,NaN,20130.065,20728.41882350264,19531.711176497356,20500.504701396596,20901.833333333332,20901.833333333332,20901.833333333332,76278,282450,68.3294518748253,63.309028268628865,NaN,NaN,NaN,NaN,186.44923879130312,22.979222352940948,1388883,64.6412681736289,241.4189673732144,176.7776991995855
2025-05-12T22:00:00-04:00,20875,20894.25,20818.25,20861.25,20356.06048721232,NaN,NaN,NaN,NaN,NaN,20150.325,20777.064477374726,19523.585522625275,20500.504701396596,20882.7320297993,20904.50370367567,20860.96035592293,58714,282348.93333333335,67.677335175092,64.12401225874564,NaN,NaN,NaN,NaN,178.56000744906717,24.231597119236284,1330169,53.103629912668595,243.15723659042123,190.05360667775264
2025-05-13T02:00:00-04:00,20861.25,20882.5,20825.25,20881.5,20356.06048721232,NaN,NaN,NaN,NaN,NaN,20169.38,20825.270015474944,19513.48998452506,20525.078008893823,20875.787574280035,20895.65467149916,20855.92047706091,73790,280808.1,68.16808048260108,64.96466522769254,NaN,NaN,NaN,NaN,169.89500691699095,25.394516545081952,1403959,42.64790698055333,243.3634904034443,200.71558342289097
2025-05-13T06:00:00-04:00,20881.5,21132,20860.5,21125,20455.873760055718,NaN,NaN,NaN,NaN,NaN,20193.445,20897.736369321,19489.153630679,20710.312407115056,20972.68435078747,21053.94033081402,20891.428370760917,304296,280440.43333333335,73.39827073913654,66.09913448008096,NaN,NaN,NaN,NaN,177.15250642292017,27.352161533632703,1708255,47.568504130237585,260.17621358568795,212.60770945545036
2025-05-13T10:00:00-04:00,21125,21347,21114.5,21296.5,20683.231770962277,NaN,NaN,NaN,NaN,NaN,20219.04,20986.01239428807,19452.06760571193,20893.399925692047,21126.33653967355,21275.969469444226,20976.703609902874,624044,275633.36666666664,76.34612976955539,67.43070357796195,NaN,NaN,NaN,NaN,181.105898821283,29.712318799957337,2332299,57.16544494697803,284.0645156391729,226.89907069219487
2025-05-13T14:00:00-04:00,21296.5,21343,21247,21254.75,20759.278054100356,NaN,NaN,NaN,NaN,NaN,20246.44,21060.1471006205,19432.732899379498,20932.119940553635,21155.50425079519,21303.358315011956,21007.650186578427,263067,274101.7,74.19075077087744,68.45996711869165,NaN,NaN,NaN,NaN,175.0269060483342,31.90389340440164,2069232,55.45093146106166,296.2127350185219,240.76180355746027
2025-05-13T18:00:00-04:00,21248.25,21302.25,21245,21284,20759.278054100356,NaN,NaN,NaN,NaN,NaN,20272.475,21132.676553416462,19412.273446583535,20944.92095244291,21277.083333333332,21277.083333333332,21277.083333333332,61557,270643.6,74.72903604989762,69.8866603305502,NaN,NaN,NaN,NaN,166.61426990202463,33.91907771849584,2130789,51.14116542924552,304.6882603440172,253.54709491477166
2025-05-13T22:00:00-04:00,21283.25,21323.75,21262,21316.75,20788.875768302183,NaN,NaN,NaN,NaN,NaN,20302.87,21200.314144445863,19405.425855554135,21007.011761954327,21287.4240058273,21299.19946608218,21275.648545572418,47470,269753.1666666667,75.34896568105034,71.39060638281687,NaN,NaN,NaN,NaN,159.12396490902287,35.8463369279636,2178259,45.53747119954164,310.4689339141987,264.9314627146571
2025-05-14T02:00:00-04:00,21317,21355.5,21237,21260.75,20799.00073337936,NaN,NaN,NaN,NaN,NaN,20329.51,21259.441556406287,19399.57844359371,21042.85940956346,21285.973054759146,21294.57652521732,21277.369584300974,101641,270561.93333333335,72.09231652576473,71.79218196592208,NaN,NaN,NaN,NaN,156.22225312980694,37.72062035424103,2076618,33.64891598218145,306.9926076923839,273.34369171020245
2025-05-14T06:00:00-04:00,21260.25,21404.75,21254,21330.75,20834.171154589385,NaN,NaN,NaN,NaN,NaN,20357.125,21321.696740463052,19392.553259536948,21079.262527650768,21312.75897978417,21334.80818521934,21290.709774348998,330492,272470.8,73.62676323011743,72.2383211919411,NaN,NaN,NaN,NaN,155.83137790624932,39.59159058533917,2407110,26.408682320175444,306.3545446104217,279.9458622902463
2025-05-14T10:00:00-04:00,21331.25,21419.75,21281.25,21365.25,20858.919056653504,NaN,NaN,NaN,NaN,NaN,20386.06,21382.535607127367,19389.584392872635,21090.110022120614,21335.661524914038,21361.692109975877,21309.6309398522,627378,271441.4,74.3745959793805,72.21719808210332,NaN,NaN,NaN,NaN,154.59342234151723,41.36904554628161,3034488,20.13575377413315,305.11555450791275,284.9798007337796
2025-05-14T14:00:00-04:00,21365.5,21414,21331.25,21403.5,20892.104554078345,NaN,NaN,NaN,NaN,NaN,20412.675,21444.70788828417,19380.642111715828,21108.913017696494,21344.222615722476,21373.990000273174,21314.455231171778,258540,260414.93333333332,75.21376349400562,72.6580517155026,NaN,NaN,NaN,NaN,149.46174931712312,43.019539438585305,3293028,14.991373398290193,303.71901748164237,288.7276440833522
2025-05-14T18:00:00-04:00,21382,21397.5,21357,21372.5,20912.23048343842,NaN,NaN,NaN,NaN,NaN,20435.625,21500.457588954767,19370.792411045233,21130.180414157196,21375.66666666667,21375.66666666667,21375.66666666667,51575,258145.3,73.12373949737305,72.78135312646354,NaN,NaN,NaN,NaN,142.10733865161433,44.552140910010166,3241453,6.370480480108995,296.69074468348845,290.32026420337945
2025-05-14T22:00:00-04:00,21373.5,21412.5,21316.75,21330.25,20912.23048343842,NaN,NaN,NaN,NaN,NaN,20458.22,21549.74733195278,19366.69266804722,21150.769331325755,21364.936645265556,21376.174622046346,21353.698668484765,47018,256837.5,70.25823629215272,72.6341025401307,NaN,NaN,NaN,NaN,138.796100176499,45.39272789192599,3194435,-4.709970027822521,284.4328016686013,289.14277169642384
2025-05-15T02:00:00-04:00,21330.75,21368.5,21192.25,21259.25,20912.23048343842,NaN,NaN,NaN,NaN,NaN,20483.33,21589.548041074944,19377.11195892506,21150.769331325755,21316.213616940462,21362.564190629266,21269.86304325166,112027,257536.76666666666,65.60559367496944,72.439541240141,NaN,NaN,NaN,NaN,141.4713787353205,44.590427798269204,3082408,-18.57519091859524,265.92378304817976,284.498973966775
2025-05-15T06:00:00-04:00,21259,21339.5,21223.5,21298.75,20912.23048343842,NaN,NaN,NaN,NaN,NaN,20508.065,21630.679064627926,19385.45093537207,21150.769331325755,21300.084693529756,21334.129119114517,21266.040267944994,264679,255771.83333333334,66.91814337305215,72.385313254281,NaN,NaN,NaN,NaN,139.6519945399405,43.84543485415933,3347087,-26.364825675754844,251.54294187208143,277.9077675478363
2025-05-15T10:00:00-04:00,21298.75,21529.75,21256.75,21475.5,20921.606160139283,NaN,NaN,NaN,NaN,NaN,20537.355,21682.754175353297,19391.955824646702,21156.443897638786,21365.96638725975,21430.22773757725,21301.705036942247,572456,247103.3,72.05681488951468,72.66307999763198,NaN,NaN,NaN,NaN,149.1768520728019,44.09792515065739,3919543,-21.118990092546824,251.50902993215277,272.6280200246996
2025-05-15T14:00:00-04:00,21475.25,21475.5,21303.5,21396.25,20921.606160139283,NaN,NaN,NaN,NaN,NaN,20564.085,21725.91494715238,19402.255052847617,21156.443897638786,21372.091226826065,21429.26612918881,21314.91632446332,326436,247015.56666666668,67.0293341149298,72.20815595304579,NaN,NaN,NaN,NaN,150.80707692474462,44.33238042597701,3593107,-24.266957095595274,242.29432365520552,266.5612807508008
2025-05-15T18:00:00-04:00,21397.25,21436.25,21348.75,21371,20928.438154176496,NaN,NaN,NaN,NaN,NaN,20588.635,21765.654805313552,19411.615194686445,21156.443897638786,21385.333333333332,21385.333333333332,21385.333333333332,58377,246340.36666666667,65.46217679717049,71.43073074073257,NaN,NaN,NaN,NaN,146.28514285869144,44.55008889591666,3534730,-29.009512162587157,230.29939054756687,259.30890271015403
2025-05-15T22:00:00-04:00,21370.25,21419,21360.75,21386,20938.963692623016,NaN,NaN,NaN,NaN,NaN,20615.535,21802.696374919185,19428.373625080814,21156.443897638786,21386.657345088723,21388.254226758083,21385.060463419362,40131,245134.93333333332,65.9711668641288,70.84361760453625,NaN,NaN,NaN,NaN,139.99691836878492,44.75224676086062,3574861,-31.868132047539888,219.47373765072916,251.34186969826905
2025-05-16T02:00:00-04:00,21386.5,21479,21361,21439.5,20973.493752049242,NaN,NaN,NaN,NaN,NaN,20645.145,21839.161553863472,19451.12844613653,21171.761820472846,21403.81173513923,21423.57674086997,21384.04672940849,74481,245037,67.7942042922769,70.3482724789919,NaN,NaN,NaN,NaN,138.4257099138717,45.23496628249785,3649342,-30.866470304093014,212.75878181815278,243.6252521222458
2025-05-16T06:00:00-04:00,21439.75,21504.5,21388.75,21441.25,21004.63039968337,NaN,NaN,NaN,NaN,NaN,20675.515,21871.73424165268,19479.295758347318,21200.834456378278,21428.019722698722,21451.834475832926,21404.20496956452,249067,244534.3,67.8548685215531,69.8129798247421,NaN,NaN,NaN,NaN,136.80601634859516,45.80331361828417,3898409,-30.729980758901263,205.2127761736192,235.94275693252047
2025-05-16T10:00:00-04:00,21436.5,21478,21320,21444.75,21004.63039968337,NaN,NaN,NaN,NaN,NaN,20707.08,21899.528092958277,19514.631907041727,21200.834456378278,21420.459810608205,21437.858462987217,21403.061158229193,513817,238002.5,67.98475685190745,69.51958270518087,NaN,NaN,NaN,NaN,138.3198723236955,45.33011704891647,4412226,-30.96119864003316,197.241258632479,228.20245727251216
2025-05-16T14:00:00-04:00,21445.25,21513,21384,21404.25,21007.61649020737,NaN,NaN,NaN,NaN,NaN,20740.035,21916.548416880603,19563.521583119396,21200.834456378278,21422.756622388268,21439.359270269695,21406.15397450684,195529,236673.2,64.72561848367752,68.88378665186373,NaN,NaN,NaN,NaN,137.65416715771727,45.09819272943035,4216697,-34.148177962382704,185.51723481953377,219.66541278191647
2025-05-18T18:00:00-04:00,21313.5,21417.5,21264,21274.75,21007.61649020737,NaN,NaN,NaN,NaN,NaN,20768.6,21926.14965768224,19611.050342317758,21200.834456378278,21318.75,21318.75,21318.75,133661,235815.6,55.55472442354994,67.53951011216155,NaN,NaN,NaN,NaN,138.78601236073746,43.36153508113011,4083036,-44.6226460458914,163.88710522455222,208.50975127044362
2025-05-18T22:00:00-04:00,21274.5,21300.25,21196,21246.75,21007.61649020737,NaN,NaN,NaN,NaN,NaN,20796.61,21931.076747683677,19662.143252316324,21200.834456378278,21291.62704855456,21326.157257118735,21257.096839990387,82467,236813.13333333333,53.78040232840937,66.00855574319039,NaN,NaN,NaN,NaN,136.3191543349705,41.025850493391324,4000569,-52.536485063536645,142.83914494102282,195.37563000455947
2025-05-19T02:00:00-04:00,21247.25,21288.75,21112.25,21165,21007.61649020737,NaN,NaN,NaN,NaN,NaN,20818.86,21937.607277806663,19700.11272219334,21200.834456378278,21254.22758522652,21310.894798348505,21197.560372104534,123291,233373.16666666666,48.87255627242841,64.27632836998005,NaN,NaN,NaN,NaN,139.18921473961547,38.12463629193638,3877278,-61.74097302572241,118.19941372240646,179.94038674812887
2025-05-19T06:00:00-04:00,21164.75,21375,21130.5,21356.25,21007.61649020737,NaN,NaN,NaN,NaN,NaN,20846.4,21948.79244826872,19744.007551731283,21200.834456378278,21268.98117608324,21314.21425927192,21223.748092894562,274109,229227.4,58.43006308501307,63.43145885518437,NaN,NaN,NaN,NaN,146.7114136867858,36.08853276653692,4151387,-53.70895788498612,112.80418939189622,166.51314727688234
2025-05-19T10:00:00-04:00,21356.25,21545.5,21347.25,21499.25,21007.61649020737,NaN,NaN,NaN,NaN,NaN,20876.575,21966.124839383203,19787.0251606168,21200.834456378278,21360.720676838406,21463.474480826626,21257.966872850186,544976,225744.2,63.86873630475971,63.3073976144551,NaN,NaN,NaN,NaN,150.3927412805868,35.32979429865057,4696363,-38.251276731824134,118.69905136210218,156.95032809392632
2025-05-19T14:00:00-04:00,21499.25,21533.75,21443.75,21517.5,21037.46421146397,NaN,NaN,NaN,NaN,NaN,20908.2,21978.360824362422,19838.03917563758,21200.834456378278,21383.54615480801,21490.443907206758,21276.64840240926,230369,224057.76666666666,64.50695334334442,63.13516975519026,NaN,NaN,NaN,NaN,146.07897404625916,34.625251435613244,4926732,-26.823720333930538,123.42067767651315,150.2443980104437
2025-05-19T18:00:00-04:00,21516.75,21562.25,21437.25,21458.25,21051.931747306517,NaN,NaN,NaN,NaN,NaN,20940.985,21975.50935162239,19906.46064837761,21200.834456378278,21485.916666666668,21485.916666666668,21485.916666666668,84335,224326.33333333334,60.75483719413168,62.32788563409148,NaN,NaN,NaN,NaN,144.57333304295494,34.14604572109063,4842397,-23.40595170701573,120.98695837667401,144.39291008368974
2025-05-19T22:00:00-04:00,21458.5,21487,21415.5,21418.5,21051.931747306517,NaN,NaN,NaN,NaN,NaN,20970.21,21974.02627482336,19966.393725176637,21196.83299762321,21466.636568435602,21489.156092332796,21444.11704453841,61817,224429.76666666666,58.30461138689997,61.70469115351791,NaN,NaN,NaN,NaN,139.35380925417243,33.46070821675465,4780580,-23.889936615668773,114.53048931410376,138.42042592977253
2025-05-20T02:00:00-04:00,21418.25,21479.5,21393.5,21426.25,21051.931747306517,NaN,NaN,NaN,NaN,NaN,20997.405,21975.15307537531,20019.656924624687,21196.83299762321,21454.683631167372,21478.86332012053,21430.503942214214,80876,224665.96666666667,58.65471811634651,61.21844410488763,NaN,NaN,NaN,NaN,135.5428228788744,32.576487736958505,4861456,-23.708304732906583,108.78504501363932,132.4933497465459
2025-05-20T06:00:00-04:00,21426.25,21486.25,21354,21394.5,21051.931747306517,NaN,NaN,NaN,NaN,NaN,21022.155,21975.912494806762,20068.397505193236,21196.83299762321,21432.440058694552,21459.768623260174,21405.11149412893,242124,222593.56666666668,56.55942805902271,60.546177047380056,NaN,NaN,NaN,NaN,135.3076212446691,31.3133793160891,4619332,-25.585760282465756,100.51114939346371,126.09690967592947
2025-05-20T10:00:00-04:00,21394.25,21473.75,21362.5,21431.25,21051.931747306517,NaN,NaN,NaN,NaN,NaN,21045.86,21979.991158670862,20111.72884132914,21196.83299762321,21427.532963924692,21447.604114047317,21407.461813802067,457419,217039.4,58.41131588469314,59.87597073255264,NaN,NaN,NaN,NaN,133.58921972719273,30.14049292528181,5076751,-24.22556752653942,95.8149502677552,120.04051779429462
2025-05-20T14:00:00-04:00,21431,21452,21298,21419,21051.931747306517,NaN,NaN,NaN,NaN,NaN,21072.44,21971.228209535606,20173.65179046439,21196.83299762321,21418.374044677796,21442.213925778422,21394.53416357717,295617,218124.4,57.53090824783009,59.13854499871528,NaN,NaN,NaN,NaN,135.0471326038218,28.327131589708245,4781134,-23.97923364662185,90.06647573601731,114.04570938263916
2025-05-20T18:00:00-04:00,21413.75,21444,21342.75,21401,21051.931747306517,NaN,NaN,NaN,NaN,NaN,21095.46,21967.36830572947,20223.55169427053,21196.83299762321,21395.916666666668,21395.916666666668,21395.916666666668,77616,218659.7,56.19069979860969,58.296112352051146,NaN,NaN,NaN,NaN,132.63305170354883,26.6432960638185,4703518,-24.75625620316002,83.10038912868913,107.85664533184915
2025-05-20T22:00:00-04:00,21402.25,21405.75,21327.25,21331.25,21051.931747306517,NaN,NaN,NaN,NaN,NaN,21118.97,21950.72511804846,20287.214881951542,21196.83299762321,21378.575336107195,21398.90174821543,21358.24892399896,56493,218960.46666666667,51.21217439839703,57.33086634595969,NaN,NaN,NaN,NaN,128.76640515329535,24.90011499609071,4647025,-29.380105528977708,71.13151342062702,100.51161894960472
2025-05-21T02:00:00-04:00,21331.5,21348.75,21263.25,21269.5,21051.931747306517,NaN,NaN,NaN,NaN,NaN,21141.165,21927.326946484212,20355.00305351579,21196.83299762321,21344.20750611319,21388.669313359012,21299.74569886737,91496,218622.3,47.22313322793959,56.735752689130386,NaN,NaN,NaN,NaN,125.67594764234569,23.66597029229816,4555529,-35.59517701212967,56.017647684442636,91.6128246965723
2025-05-21T06:00:00-04:00,21269.75,21405,21229.5,21374,21051.931747306517,NaN,NaN,NaN,NaN,NaN,21164.8,21905.149883501068,20424.45011649893,21196.83299762321,21339.89766737075,21370.448478620325,21309.346856121178,260606,216292.76666666666,53.783873670065375,56.73600064210581,NaN,NaN,NaN,NaN,129.23480852503528,22.07418000520855,4816135,-31.790976181071557,51.87410447023285,83.66508065130441
2025-05-21T10:00:00-04:00,21374.25,21558.5,21160.25,21270.75,21051.931747306517,NaN,NaN,NaN,NaN,NaN,21186.265,21873.52001387777,20499.00998612223,21175.751494783082,21333.582528785213,21352.853537034338,21314.31152053609,818973,222679.26666666666,47.50084500060132,56.63802126554673,NaN,NaN,NaN,NaN,148.45017934467563,21.986125311496227,3997162,-35.091973655489,39.80011358194315,74.89208723743215
2025-05-21T14:00:00-04:00,21271.25,21283,21071.75,21145.25,21051.931747306517,NaN,NaN,NaN,NaN,NaN,21204.085,21837.87650049525,20570.293499504747,21175.751494783082,21295.28924835519,21367.480338377427,21223.098158332956,388577,227013.83333333334,41.200582203246576,55.40734405970626,NaN,NaN,NaN,NaN,152.93588082005596,20.96224118149595,3608585,-44.01328934856517,19.875475551725685,63.88876490029086
2025-05-21T18:00:00-04:00,21147.5,21208.5,21113,21155.5,21051.931747306517,NaN,NaN,NaN,NaN,NaN,21224.08,21782.972480178192,20665.18751982181,21175.751494783082,21159,21159,21159,76420,227842,41.87862642928152,53.83662192574354,NaN,NaN,NaN,NaN,148.8333179043377,20.011491632209985,3685005,-47.226078454388315,4.856166832305462,52.08224528669378
2025-05-21T22:00:00-04:00,21155.5,21202.5,21145,21197.25,21051.931747306517,NaN,NaN,NaN,NaN,NaN,21245.095,21711.740024509916,20778.449975490086,21169.726195826464,21167.27460762936,21178.155742261653,21156.393472997064,44193,227747.83333333334,44.67701426608249,52.42019770593912,NaN,NaN,NaN,NaN,142.30950948259928,19.128652765015875,3729198,-44.574559778142124,-3.6359544359838765,40.93860534215825
2025-05-22T02:00:00-04:00,21197.5,21227.5,21164,21205,21051.931747306517,NaN,NaN,NaN,NaN,NaN,21258.865,21676.788057631213,20840.94194236879,21137.199765328936,21179.459223639475,21197.030565911333,21161.887881367617,75855,226542.1,45.20442315416525,51.30945384594151,NaN,NaN,NaN,NaN,136.68025880527077,18.553475223925116,3805053,-40.45460971661353,-9.629656803608668,30.824952913004864
2025-05-22T06:00:00-04:00,21204.5,21293,21039.25,21286.5,NaN,NaN,NaN,21604.359541746842,21604.359541746842,21604.359541746842,21273.545,21639.52675760605,20907.563242393946,21137.199765328936,21197.032473491116,21213.40958827659,21180.65535870564,374567,230205.03333333333,50.54393974504942,50.75512015723791,NaN,NaN,NaN,NaN,145.04238317632286,17.75538704925228,4179620,-30.831492955927775,-7.714413281904854,23.11707967402292
2025-05-22T10:00:00-04:00,21286.5,21330.25,21166.5,21293,NaN,NaN,NaN,21604.359541746842,NaN,NaN,21281.27,21631.94240895183,20930.597591048172,21121.05981226315,21231.83715154088,21266.773519788367,21196.900783293393,632693,232212.93333333332,50.95442419144852,50.20509916260234,NaN,NaN,NaN,NaN,146.37864152087124,16.62527187650922,4812313,-22.979611181616512,-5.607434302997717,17.372176878618795
2025-05-22T14:00:00-04:00,21292.5,21337.75,21166.25,21214.25,NaN,NaN,NaN,21604.359541746842,NaN,NaN,21289.82,21611.49384164711,20968.14615835289,21116.05362387873,21233.11421952281,21265.097789800715,21201.130649244904,243912,229462.13333333333,45.97560317629126,49.44911167097866,NaN,NaN,NaN,NaN,148.17302426938042,15.496674704828056,4568401,-22.03759445774685,-10.174816193564766,11.862778264182083
2025-05-22T18:00:00-04:00,21222,21236.25,21133.5,21162.25,NaN,NaN,NaN,21604.359541746842,NaN,NaN,21294.895,21599.92052499744,20989.86947500256,21116.05362387873,21177.333333333332,21177.333333333332,21177.333333333332,70016,229850.1,42.98860194424553,48.34748924666097,NaN,NaN,NaN,NaN,144.92852253585323,14.793439856427323,4498385,-23.718578711795704,-17.785445125562546,5.933133586233157
2025-05-22T22:00:00-04:00,21162.75,21208.5,21137,21152.5,NaN,NaN,NaN,21600.42948809622,NaN,NaN,21298.785,21591.226943126938,21006.343056873062,21116.05362387873,21172.63806815013,21178.22085332453,21167.05528297573,49524,230163.2,42.4319459744946,47.26899194142272,NaN,NaN,NaN,NaN,139.68362806900657,14.140436068626643,4448861,-24.205133455584054,-24.32328323324691,-0.1181497776628575
2025-05-23T02:00:00-04:00,21152.5,21231.5,21094,21181.25,NaN,NaN,NaN,21589.739511364573,NaN,NaN,21304.915,21573.415812103067,21036.414187896935,20941.680737178067,21170.87313690479,21175.32722149223,21166.41905231735,107837,231275.06666666668,44.70564141469215,46.448630628285756,NaN,NaN,NaN,NaN,139.5276546355061,13.999034037880733,4556698,-21.405388466301183,-26.874885360539338,-5.469496894238154
2025-05-23T06:00:00-04:00,21181.25,21190.75,20727.5,20887.25,NaN,NaN,NaN,21429.87635175709,NaN,NaN,21305.435,21570.576543519244,21040.29345648076,20941.680737178067,21006.997243629266,21115.52072393675,20898.473763321785,518743,240264.26666666666,31.154721476947742,45.015955419610805,NaN,NaN,NaN,NaN,162.65067930439855,16.300474970429605,4037955,-37.24098551620586,-52.02072878949548,-14.779743273289618
2025-05-23T10:00:00-04:00,20888,21074.75,20881,21052.25,NaN,NaN,NaN,21429.87635175709,NaN,NaN,21308.85,21555.83973662949,21061.86026337051,20941.680737178067,21005.04418284971,21085.483515917942,20924.604849781477,612916,243567.56666666668,41.81438249058979,44.629616081228676,NaN,NaN,NaN,NaN,164.87205935408437,18.43752726493927,4650871,-34.549538333887135,-57.96666619064854,-23.417127856761404
2025-05-23T14:00:00-04:00,21051.75,21083.75,20930.75,20953.25,NaN,NaN,NaN,21429.87635175709,NaN,NaN,21305.415,21566.88923601556,21043.940763984443,20941.680737178067,21002.567662928104,21076.654765490563,20928.480560365646,252723,245474.03333333333,38.01144214142243,43.503013829182756,NaN,NaN,NaN,NaN,164.0240551145069,20.307860533813457,4398148,-37.155906725355855,-69.86201126345622,-32.70610453810037
2025-05-25T18:00:00-04:00,20978.75,21226.75,20955.25,21206,NaN,NaN,NaN,21429.87635175709,NaN,NaN,21303.605,21566.549824820813,21040.660175179186,20941.680737178067,21129.333333333332,21129.333333333332,21129.333333333332,113151,244790.36666666667,50.411311309516705,43.710904279819566,NaN,NaN,NaN,NaN,171.84376546347067,20.418003239759365,4511299,-20.41366406967081,-58.22318462518888,-37.80952055551807
2025-05-25T22:00:00-04:00,21206.25,21233.5,21189.25,21201.75,NaN,NaN,NaN,21429.87635175709,NaN,NaN,21302.545,21566.693626534987,21038.39637346501,20941.680737178067,21153.406360821726,21189.71402320647,21117.09869843698,49742,243699.53333333333,50.22936397473969,44.35581726349765,NaN,NaN,NaN,NaN,162.72992507322277,20.451165628213083,4461557,-8.776355611236212,-48.77996506956333,-40.00360945832712
2025-05-26T02:00:00-04:00,21202,21285.75,21189.25,21250.75,NaN,NaN,NaN,21429.87635175709,NaN,NaN,21301.88,21566.379210584542,21037.38078941546,20941.144589742453,21181.10118261745,21231.993636347182,21130.20872888772,74180,242062.5,52.36409874289286,45.104779571612745,NaN,NaN,NaN,NaN,157.99921613942115,19.945881867293224,4535737,2.469525740240819,-36.9167022830261,-39.386228023266916
2025-05-26T06:00:00-04:00,21250.75,21307.75,21245.5,21279.25,NaN,NaN,NaN,21429.87635175709,NaN,NaN,21301.13,21565.668961969342,21036.59103803066,20960.15510384218,21203.21983074775,21263.541761233773,21142.897900261723,70594,235278.66666666666,53.61040500466143,45.742878910082666,NaN,NaN,NaN,NaN,151.15998641517677,19.25494462308578,4606331,11.566649823940615,-24.927915743341146,-36.49456556728176
2025-05-26T10:00:00-04:00,21279.75,21296.25,21215.5,21284.5,NaN,NaN,NaN,21429.87635175709,NaN,NaN,21301.605,21565.93744390331,21037.27255609669,20977.799083073744,21217.054815693748,21276.202301978665,21157.90732940883,88015,220046.63333333333,53.84993605812918,46.36041554608009,NaN,NaN,NaN,NaN,146.13070167123558,18.861110692307697,4694346,17.329964785391297,-14.83210958554264,-32.16207437093394
2025-05-26T18:00:00-04:00,21284.5,21292.5,21173,21176,NaN,NaN,NaN,21429.87635175709,NaN,NaN,21298.51,21565.019848974498,21032.0001510255,20977.989266458993,21216.484966695512,21270.16083347395,21162.809099917074,85034,215202.13333333333,48.29936367063206,46.20008868362171,NaN,NaN,NaN,NaN,144.22850869471876,18.83853883087348,4609312,13.402832527428359,-15.408533711648488,-28.811366239076847
2025-05-26T22:00:00-04:00,21175.75,21218.5,21142,21208.25,NaN,NaN,NaN,21429.87635175709,NaN,NaN,21295.37,21562.35964848883,21028.38035151117,20977.989266458993,21213.508836666897,21264.827136399308,21162.190536934486,59797,214384.2,49.95069895209577,46.128394023667944,NaN,NaN,NaN,NaN,139.39075807366743,19.06143703245779,4669109,12.559570865631304,-13.111902657037717,-25.67147352266902
2025-05-27T02:00:00-04:00,21208.25,21360,21204.5,21332.75,NaN,NaN,NaN,21429.87635175709,NaN,NaN,21293.955,21559.38272443684,21028.527275563163,21050.363130533755,21227.7301536309,21284.392671430945,21171.067635830852,107729,215914.6,55.8176504101289,46.83139739751348,NaN,NaN,NaN,NaN,140.54141821126262,17.780233383460857,4776838,19.55197840337809,-1.2315005184464098,-20.7834789218245
2025-05-27T06:00:00-04:00,21333.25,21351.5,21193.25,21295.25,NaN,NaN,NaN,21429.87635175709,NaN,NaN,21292.41,21556.88857682602,21027.93142317398,21050.363130533755,21242.504180494678,21295.956217763553,21189.052143225803,255419,221732.7,53.772971515233266,47.601709509726895,NaN,NaN,NaN,NaN,141.80631691045815,16.692357484762653,4521419,20.706053583527275,5.099088057584595,-15.60696552594268
2025-05-27T10:00:00-04:00,21294.25,21480.25,21292,21476.5,20946.27661051336,20946.27661051336,20946.27661051336,NaN,NaN,NaN,21295.335,21564.61417873493,21026.05582126507,21124.657403541605,21298.02399932381,21390.26295235065,21205.78504629697,424366,227807.43333333332,61.17565429292304,48.940545818186074,NaN,NaN,NaN,NaN,145.12372284542542,16.423016054793234,4945785,32.05319729685518,24.459531095126295,-7.593666201728885
2025-05-27T14:00:00-04:00,21477,21488.25,21413,21477.5,21020.508355490023,NaN,NaN,NaN,NaN,NaN,21299.7,21573.53502332588,21025.864976674122,21166.150922833283,21321.23589412339,21423.690507253505,21218.781280993277,222816,219987.33333333334,61.21255978064767,50.11961141575432,NaN,NaN,NaN,NaN,140.13274264218074,16.23507827445872,5168601,37.61813324704309,39.42900035707498,1.8108671100318894
2025-05-27T18:00:00-04:00,21478.5,21484.75,21452.25,21463,21053.50229387684,NaN,NaN,NaN,NaN,NaN,21302.985,21580.6101683473,21025.359831652702,21210.820738266626,21466.666666666668,21466.666666666668,21466.666666666668,50332,211811.16666666666,60.31723437203068,52.202648051117386,NaN,NaN,NaN,NaN,132.4446895963107,16.060564621290947,5118269,38.19225712893444,49.55118852119995,11.3589313922655
2025-05-27T22:00:00-04:00,21462.75,21477,21434.5,21452.25,21053.820371427893,NaN,NaN,NaN,NaN,NaN,21302.52,21579.063592223483,21025.976407776518,21236.6065906133,21461.438209613552,21467.424897023713,21455.45152220339,38390,210503.63333333333,59.62098524706142,53.47454824800822,NaN,NaN,NaN,NaN,126.02006891085992,15.694719981770714,5079879,35.76040853175091,56.05944205695414,20.299033525203228
2025-05-28T02:00:00-04:00,21452.5,21462.25,21407,21430.25,21053.820371427893,NaN,NaN,NaN,NaN,NaN,21303.2,21580.82723209346,21025.572767906542,21242.310272490642,21449.601546750888,21464.27700162691,21434.926091874866,63899,210750.5,58.14183969672535,54.912433787672725,NaN,NaN,NaN,NaN,120.96506398865564,15.03681565517996,5015980,30.77250221937153,58.76466129941764,27.99215908004611
2025-05-28T06:00:00-04:00,21429.75,21564.75,21424,21466.75,21101.769181404343,NaN,NaN,NaN,NaN,NaN,21305.115,21585.889557429793,21024.34044257021,21318.423217992513,21472.41234511334,21491.60014400714,21453.224546219535,272959,216799.26666666666,59.91852427597458,55.591520428134004,NaN,NaN,NaN,NaN,122.37827370375167,15.35309185826501,5288939,28.10717931733071,63.1261332267095,35.01895390937879
2025-05-28T10:00:00-04:00,21467,21491.25,21426.25,21469.75,21101.769181404343,NaN,NaN,NaN,NaN,NaN,21306.79,21590.45902121976,21023.12097878024,21318.423217992513,21467.56941650082,21482.22363254652,21452.91520045512,399991,221445.43333333332,60.06854745982084,56.29431924849694,NaN,NaN,NaN,NaN,118.27982558205512,15.646776903986845,5688930,24.835373646683152,66.06317096773273,41.22779732104958
2025-05-28T14:00:00-04:00,21469.75,21528.75,21320,21525,21101.769181404343,NaN,NaN,NaN,NaN,NaN,21308.5,21596.34841496878,21020.65158503122,21318.423217992513,21464.743908993296,21477.82737259111,21451.660445395482,341669,205535.3,62.828020023863814,57.041742197137715,NaN,NaN,NaN,NaN,124.74198089762261,14.699167931110994,6030599,24.632817880103367,72.01881967117879,47.38600179107542
2025-05-28T18:00:00-04:00,21518,21833.25,21490,21794.25,21238.104715813824,NaN,NaN,NaN,NaN,NaN,21315.56,21631.983411902027,20999.136588097976,21431.205687612168,21705.833333333332,21705.833333333332,21705.833333333332,228609,200203.03333333333,72.72134104345326,58.40680905705141,NaN,NaN,NaN,NaN,140.34969654779243,15.954441719731019,6259208,39.965463682460694,97.34283139415129,57.377367711690596
2025-05-28T22:00:00-04:00,21794.25,21825,21775.75,21805.25,21389.389728731378,NaN,NaN,NaN,NaN,NaN,21322.77,21665.938090591022,20979.60190940898,21478.739550089733,21728.61856084755,21769.508813799177,21687.728307895923,70984,200021.83333333334,73.03707052692317,59.77731866196526,NaN,NaN,NaN,NaN,133.84257536580725,17.120053094878187,6330192,47.659509175577085,116.95175418116196,69.29224500558487
2025-05-29T02:00:00-04:00,21804.75,21858.75,21746.25,21785,21394.854968334497,NaN,NaN,NaN,NaN,NaN,21330.385,21696.57319219143,20964.196807808567,21525.491640071785,21744.78066574365,21790.753266678723,21698.808064808574,93321,201659.43333333332,71.39874673816071,61.427274595360174,NaN,NaN,NaN,NaN,132.31810569682102,18.385617170395278,6236871,48.05956574434529,129.36670218601648,81.30713644167119
2025-05-29T06:00:00-04:00,21785.75,21788,21485.5,21518,21394.854968334497,NaN,NaN,NaN,NaN,NaN,21335.25,21704.800334866643,20965.699665133357,21525.491640071785,21675.715516708224,21756.645239498677,21594.78579391777,345475,210646.76666666666,54.15095712142168,61.72729303602631,NaN,NaN,NaN,NaN,144.47395528990523,17.25309850625403,5891396,28.01037371818731,116.32010358940533,88.30972987121802
2025-05-29T10:00:00-04:00,21517.75,21534,21301,21372.25,NaN,NaN,NaN,21860.076361496875,21860.076361496875,21860.076361496875,21337.76,21706.57592915739,20968.94407084261,21525.491640071785,21544.435539038368,21692.920297421573,21395.950780655163,682555,220913.03333333333,47.41715519262171,61.12725766334722,NaN,NaN,NaN,NaN,150.79724419776917,16.970685088362785,5208841,3.869051046513931,93.14604367936045,89.27699263284651
2025-05-29T14:00:00-04:00,21372.5,21447.75,21317,21384.5,NaN,NaN,NaN,21822.66379961065,NaN,NaN,21342.15,21707.848222582255,20976.451777417748,21525.491640071785,21518.328005529595,21666.689741176055,21369.966269883134,274298,208966.53333333333,48.00241617619372,60.715075139130114,NaN,NaN,NaN,NaN,149.3652981836428,16.708444057463772,5483139,-11.497239276702047,74.90544353696896,86.402682813671
2025-05-29T18:00:00-04:00,21370.75,21397,21268.25,21342.25,NaN,NaN,NaN,21770.45749053744,NaN,NaN,21341.87,21707.54604843625,20976.19395156375,21525.491640071785,21335.833333333332,21335.833333333332,21335.833333333332,102420,204250.13333333333,46.096731949299176,59.6380092574427,NaN,NaN,NaN,NaN,147.89277688481116,16.744694484755097,5380719,-24.00984113829678,56.39038139080003,80.40022252909681
2025-05-29T22:00:00-04:00,21343,21412.5,21330.75,21387.25,NaN,NaN,NaN,21770.45749053744,NaN,NaN,21339.63,21702.785851391327,20976.474148608675,21525.491640071785,21350.587880265168,21370.266288968647,21330.90947156169,57578,203835.53333333333,48.44438697686625,58.725996914315445,NaN,NaN,NaN,NaN,143.16829282161035,16.650821809817078,5438297,-28.45506063886559,44.831396730514825,73.28645736938041
2025-05-30T02:00:00-04:00,21386.5,21398,21319.25,21363,NaN,NaN,NaN,21770.45749053744,NaN,NaN,21336.54,21696.20186008491,20976.87813991509,21525.491640071785,21353.647127561624,21370.44500583785,21336.8492492854,76050,204719.73333333334,47.2501076921225,57.792630722893435,NaN,NaN,NaN,NaN,138.56698619149532,16.636289915094736,5362247,-31.965293795423264,33.32984012510133,65.29513392052459
2025-05-30T06:00:00-04:00,21363.25,21421.5,21226,21260,NaN,NaN,NaN,21751.617716460107,NaN,NaN,21332.575,21691.15187111684,20973.998128883162,21525.491640071785,21324.51772474084,21352.13711395965,21296.89833552203,312291,211534.86666666667,42.461909481334466,56.56698245391294,NaN,NaN,NaN,NaN,142.63363003495994,17.189907096085268,5049956,-39.65826905796705,15.72229759806578,55.380566656032826
2025-05-30T10:00:00-04:00,21258.75,21399.5,21071.5,21176.25,NaN,NaN,NaN,21688.646456621012,NaN,NaN,21327.73,21688.074041715878,20967.38595828412,21525.491640071785,21263.38164674347,21320.3559520733,21206.40734141364,703803,217703.53333333333,39.001094466601266,55.19978636604694,NaN,NaN,NaN,NaN,155.87408503246277,18.486959098723784,4346153,-48.25074831834348,-4.932868741896527,43.317879576446956
2025-05-30T14:00:00-04:00,21176.5,21433.25,21174.75,21369,NaN,NaN,NaN,21688.646456621012,NaN,NaN,21326.585,21686.03227860994,20967.13772139006,21525.491640071785,21276.982718190666,21333.545836472786,21220.419599908546,349817,208933.56666666668,49.252585595392894,54.437933603148245,NaN,NaN,NaN,NaN,163.20450753014399,19.37252464864497,4695970,-39.20103003592226,-5.683407968455867,33.51762206746639
2025-06-01T18:00:00-04:00,21304.5,21348.5,21267,21278.75,NaN,NaN,NaN,21688.646456621012,NaN,NaN,21324.27,21683.428695286308,20965.111304713693,21370.14331205743,21298.083333333332,21298.083333333332,21298.083333333332,89465,203491.63333333333,45.40485384765795,53.39052691656518,NaN,NaN,NaN,NaN,158.83275699227656,20.194835516428927,4606505,-37.538977089545185,-13.406099294465093,24.13287779508009
2025-06-01T22:00:00-04:00,21278.25,21285,21213,21231.25,NaN,NaN,NaN,21688.646456621012,NaN,NaN,21320.27,21679.028426242323,20961.511573757678,21083.214649645943,21275.007755257397,21302.149503370416,21247.866007144377,64667,201875.5,43.47958142875236,52.00849558834294,NaN,NaN,NaN,NaN,152.63041720711394,21.243108167243793,4541838,-37.780733164455015,-23.093038660488673,14.687694503966338
2025-06-02T02:00:00-04:00,21231.25,21268,21163,21225.25,NaN,NaN,NaN,21658.727228033054,NaN,NaN,21316.395,21674.98953551296,20957.80046448704,21066.61132049498,21253.420890344318,21288.097082575343,21218.744698113293,95966,203416.3,43.23022548078553,49.901987333866664,NaN,NaN,NaN,NaN,149.22824454946294,22.469473161813116,4445872,-36.4685436164994,-30.897985016657913,5.570558599841487
2025-06-02T06:00:00-04:00,21225.5,21458,21214.5,21308,NaN,NaN,NaN,21658.727228033054,NaN,NaN,21314.535,21672.31873369982,20956.75126630018,21066.61132049498,21290.45475439914,21334.53527132116,21246.374237477117,254603,209430.4,47.68628870592028,48.09121720379504,NaN,NaN,NaN,NaN,155.96194136735843,21.808648831126668,4700475,-28.50422134990608,-30.059718087541114,-1.5554967376350346
2025-06-02T10:00:00-04:00,21308,21475.25,21234.5,21445.5,NaN,NaN,NaN,21658.727228033054,NaN,NaN,21316.82,21676.456080503558,20957.18391949644,21066.61132049498,21336.513417308463,21393.3851524847,21279.641682132224,478606,223030.8,54.129300377844466,46.8576853209153,NaN,NaN,NaN,NaN,162.01823126968998,21.05361829649759,5179081,-13.22899012184545,-18.09173438994185,-4.862744268096398
2025-06-02T14:00:00-04:00,21445.5,21576.75,21426.75,21554.75,NaN,NaN,NaN,21658.727228033054,NaN,NaN,21322.525,21687.980390574125,20957.06960942588,21140.039350911917,21367.642299087835,21453.714877943843,21281.569720231826,201676,226819.5,58.50249498376253,47.16850945393965,NaN,NaN,NaN,NaN,161.15978617899782,19.559948702772225,5380757,4.055126886911664,0.20616434054318233,-3.8489625463684813
2025-06-02T18:00:00-04:00,21551.75,21554.75,21466,21486.75,NaN,NaN,NaN,21658.727228033054,NaN,NaN,21324.78,21692.86004075227,20956.699959247726,21161.00648072953,21502.5,21502.5,21502.5,64259,226127,54.98845188957892,47.70931636086516,NaN,NaN,NaN,NaN,155.98765859478368,18.172969794312955,5316498,10.371389244047508,9.115274008690903,-1.2561152353566043
2025-06-02T22:00:00-04:00,21487,21490.75,21437.25,21464.25,NaN,NaN,NaN,21658.727228033054,NaN,NaN,21328.65,21698.4413195302,20958.858680469802,21161.00648072953,21486.706907875643,21505.609188080358,21467.80462767093,44858,225629.03333333333,53.83615336577546,48.12601187440671,NaN,NaN,NaN,NaN,148.6671115522991,17.111370735414287,5271640,12.362169088016651,14.196596124664211,1.834427036647559
2025-06-03T02:00:00-04:00,21464.5,21481,21398.25,21450.25,NaN,NaN,NaN,21658.727228033054,NaN,NaN,21334.75,21702.294364668942,20967.205635331058,21166.2291476669,21468.45303826236,21494.319560760254,21442.586515764466,78770,224663.73333333334,53.090663292784875,48.6255783989414,NaN,NaN,NaN,NaN,143.9587464414206,16.431539077523187,5192870,12.051734580713191,16.89909526253905,4.847360681825857
2025-06-03T06:00:00-04:00,21451,21606,21437.25,21589.25,NaN,NaN,NaN,21658.727228033054,NaN,NaN,21343.425,21714.09872782549,20972.751272174508,21269.80831813352,21511.001101197486,21552.283213114424,21469.718989280547,241040,224184.43333333332,59.14036272327275,49.38957666654187,NaN,NaN,NaN,NaN,145.7295502670334,15.734697644294377,5433910,20.051851212981468,29.912174698052695,9.860323485071225
2025-06-03T10:00:00-04:00,21593.25,21759.75,21557.5,21717.5,21211.894945138025,21211.894945138025,21211.894945138025,NaN,NaN,NaN,21353.83,21736.519370638427,20971.140629361576,21389.671654506816,21596.78409962404,21685.206385626552,21508.36181362153,451657,225094.13333333333,63.78157396744826,50.570395686207995,NaN,NaN,NaN,NaN,149.76672524795958,16.08370126795076,5885567,32.10973885294764,49.99749705125578,17.887758198308134
2025-06-03T14:00:00-04:00,21718.25,21726,21635,21688,21241.66676581357,NaN,NaN,NaN,NaN,NaN,21363.49,21754.94808153559,20972.031918464414,21389.671654506816,21616.305975539195,21702.038986433065,21530.572964645326,257754,226258.73333333334,62.036032505046386,51.968547330758845,NaN,NaN,NaN,NaN,145.56910201596247,16.40777606134598,5627813,35.93844329643379,62.81081231885037,26.87236902241658
2025-06-03T18:00:00-04:00,21685.75,21727,21671.5,21681.25,21272.79554918568,NaN,NaN,NaN,NaN,NaN,21371.385,21772.126340643004,20970.643659356992,21425.999858884363,21693.25,21693.25,21693.25,52787,226340.56666666668,61.62047947782346,53.58421768870328,NaN,NaN,NaN,NaN,139.13559472910802,16.71508628499906,5575026,35.778488994556675,71.59548026561242,35.81699127105575
2025-06-03T22:00:00-04:00,21682,21696.25,21667,21694.75,21272.79554918568,NaN,NaN,NaN,NaN,NaN,21379.42,21789.552947226217,20969.28705277378,21440.82488710749,21690.451464413247,21693.9809943423,21686.921934484195,33186,226167.1,62.166332299473645,54.5066281675662,NaN,NaN,NaN,NaN,131.28662367702887,16.953657352391,5608212,34.337667011704404,78.73907503568626,44.40140802398185
2025-06-04T02:00:00-04:00,21695,21748.75,21674.5,21736.75,21309.125696675383,NaN,NaN,NaN,NaN,NaN,21389.87,21809.16048689441,20970.57951310559,21507.284909685994,21703.153891935624,21718.022945018252,21688.284838852996,64826,226198,63.88716179838239,55.82679302118937,NaN,NaN,NaN,NaN,127.21257912866966,17.539666894900705,5673038,33.910093180027154,86.7890244990158,52.87893131898864
2025-06-04T06:00:00-04:00,21736.75,21793.5,21655.25,21749.5,21321.3188468265,NaN,NaN,NaN,NaN,NaN,21401.615,21827.589837402043,20975.64016259796,21531.202927748793,21721.68377592641,21738.646167132763,21704.721384720055,252506,225516.23333333334,64.41628434779267,57.32227180112083,NaN,NaN,NaN,NaN,128.0009663337647,18.379700867839777,5925544,32.19606315808159,93.12401026659063,60.92794710850904
2025-06-04T10:00:00-04:00,21712,21791,21641,21786.25,21321.3188468265,NaN,NaN,NaN,NaN,NaN,21414.29,21847.513733883356,20981.066266116646,21531.202927748793,21731.693830309396,21745.928010649634,21717.459649969158,522749,229608.16666666666,65.96425168799738,58.94613081592166,NaN,NaN,NaN,NaN,129.57232588135292,18.987699330035422,6448293,31.22380219601996,99.957699853534,68.73389765751404
2025-06-04T14:00:00-04:00,21786,21802.75,21740.75,21747.5,21376.523215806792,NaN,NaN,NaN,NaN,NaN,21425.615,21863.4591299133,20987.770870086704,21543.87987375923,21737.278763621263,21755.015585259818,21719.54194198271,195997,224752.43333333332,62.859134861950764,60.02990554135241,NaN,NaN,NaN,NaN,124.745731175542,19.637238775002526,6252296,25.878036257090386,101.08144297887702,75.20340672178664
2025-06-04T18:00:00-04:00,21745.25,21774.25,21712,21756,21376.523215806792,NaN,NaN,NaN,NaN,NaN,21442.99,21862.56753705321,21023.41246294679,21543.87987375923,21747.416666666668,21747.416666666668,21747.416666666668,45091,218635.16666666666,63.26759582881661,60.68264093070757,NaN,NaN,NaN,NaN,120.281750377289,19.864256198799257,6297387,21.027679347677477,101.48800590638348,80.460326558706
2025-06-04T22:00:00-04:00,21756.75,21759.75,21723.25,21734.25,21376.523215806792,NaN,NaN,NaN,NaN,NaN,21456.63,21868.787108879253,21044.47289112075,21550.923119205905,21744.18507166488,21748.245459820417,21740.124683509344,28562,217221.1,61.40662821365239,60.89007901855684,NaN,NaN,NaN,NaN,114.29733963605408,20.075058092324795,6268825,14.763688279138762,98.91493690762945,84.15124862849069
2025-06-05T02:00:00-04:00,21734,21842.5,21723.5,21776.5,21410.542355520913,NaN,NaN,NaN,NaN,NaN,21473.095,21868.952460331133,21077.23753966887,21615.938495364724,21763.58658290098,21782.089872420845,21745.083293381118,82855,216872.23333333334,63.64374550288082,61.508314276649834,NaN,NaN,NaN,NaN,114.6332439477645,20.936116271369556,6351680,11.992708521229588,99.14213428002768,87.14942575879809
2025-06-05T06:00:00-04:00,21775.75,21899,21691.75,21723.75,21411.585884815417,NaN,NaN,NaN,NaN,NaN,21483.45,21877.90314043619,21088.996859563813,21615.938495364724,21768.890538440257,21780.14833905142,21757.632737829095,318116,215960.26666666666,59.04204984750047,61.88016402534448,NaN,NaN,NaN,NaN,121.24872652292417,22.130780502884278,6033564,5.466328048412294,93.98233581931345,88.51600777090115
2025-06-05T10:00:00-04:00,21724,21936.25,21660,21729.5,21411.585884815417,NaN,NaN,NaN,NaN,NaN,21494.005,21885.977581821713,21102.03241817829,21615.938495364724,21772.666653971126,21780.49216765322,21764.84114028903,693765,216333.93333333332,59.386764556071384,62.329885544150656,NaN,NaN,NaN,NaN,132.32024605700101,23.483683938963356,6727329,0.6491332763976345,89.32742436639819,88.67829109000056
2025-06-05T14:00:00-04:00,21729.75,21740.25,21503.5,21513.5,21411.585884815417,NaN,NaN,NaN,NaN,NaN,21499.26,21885.04311212429,21113.476887875706,21615.938495364724,21721.405571798845,21805.06138832763,21637.74975527006,441507,221907.56666666668,44.30259626009207,61.27004508249489,NaN,NaN,NaN,NaN,139.77951419578667,22.74081239329428,6285822,-16.99729815840871,67.43166839198966,84.42896655039837
2025-06-05T18:00:00-04:00,21487.5,21600.75,21471,21584.5,21411.585884815417,NaN,NaN,NaN,NaN,NaN,21505.365,21886.663363620683,21124.06663637932,21615.938495364724,21552.083333333332,21552.083333333332,21552.083333333332,76633,221048,48.8973710327511,60.206887730016525,NaN,NaN,NaN,NaN,139.06312032465905,21.707838422579133,6362455,-23.405381698305405,55.172239427516615,78.57762112582202
2025-06-05T22:00:00-04:00,21584.5,21669.75,21572,21657.5,21411.585884815417,NaN,NaN,NaN,NaN,NaN,21512.825,21891.130342943878,21134.519657056124,21615.938495364724,21581.3788944605,21620.298176951994,21542.459611969007,43420,220576.06666666668,53.17457714761597,59.57392663305721,NaN,NaN,NaN,NaN,136.11218315861197,21.328692592129777,6405875,-22.252583245687404,50.76189206871277,73.01447531440017
2025-06-06T02:00:00-04:00,21657.75,21691.25,21629.25,21685.5,21411.585884815417,NaN,NaN,NaN,NaN,NaN,21523.015,21891.808755506037,21154.22124449396,21615.938495364724,21612.860560963833,21665.064739853802,21560.656382073863,67725,220298.56666666668,54.73937185203229,59.0824189455007,NaN,NaN,NaN,NaN,130.8184557901397,21.148918529307657,6473600,-19.24227877192513,48.96162684949377,68.2039056214189
2025-06-06T06:00:00-04:00,21685.25,21863.5,21642.25,21840,21411.585884815417,NaN,NaN,NaN,NaN,NaN,21535.65,21903.729420777367,21167.570579222636,21615.938495364724,21715.480034315282,21804.29831419221,21626.661754438355,290046,219557.06666666668,62.23805712885984,59.08754214759971,NaN,NaN,NaN,NaN,137.27785180512973,22.137860180058574,6763646,-7.108739126219717,59.31798171364426,66.42672083986398
2025-06-06T10:00:00-04:00,21840,21870.25,21721.5,21821.5,21411.585884815417,NaN,NaN,NaN,NaN,NaN,21545.425,21917.370698321945,21173.479301678053,21615.938495364724,21762.09965253678,21837.77214284306,21686.427162230502,526407,213643.86666666667,60.93618673442184,58.87675821445968,NaN,NaN,NaN,NaN,138.09729096190617,23.094894464328732,6237239,-0.9172462051652701,65.28016308340739,66.19740928857266
2025-06-06T14:00:00-04:00,21822.25,21880,21780.25,21809.75,21421.08366732243,NaN,NaN,NaN,NaN,NaN,21555.715,21927.874213375024,21183.555786624976,21615.938495364724,21772.869039588357,21845.413411163434,21700.32466801328,214309,209126.93333333332,60.07664256379188,58.56678380131676,NaN,NaN,NaN,NaN,135.35819875034144,24.04255001969045,6022930,1.6581784759847267,68.27013238355357,66.61195390756885
2025-06-08T18:00:00-04:00,21799.25,21821,21726.75,21742.75,21421.08366732243,NaN,NaN,NaN,NaN,NaN,21561.04,21936.12082275692,21185.959177243083,21614.12579629178,21763.5,21763.5,21763.5,82535,208895.93333333332,55.287665087101864,57.804170472681356,NaN,NaN,NaN,NaN,132.42189883960276,24.237130098190857,5940395,-1.6975916283139014,64.48996437217647,66.18755600049037
2025-06-08T22:00:00-04:00,21742,21755.75,21716.5,21746.25,21421.08366732243,NaN,NaN,NaN,NaN,NaN,21566.415,21944.245605033495,21188.584394966507,21570.225637033425,21754.997711536205,21766.47664937818,21743.51877369423,45280,208249.7,55.48728284402318,57.27760961425796,NaN,NaN,NaN,NaN,125.76676320820256,24.288230592387787,5985675,-4.0919902499287275,61.07256818807946,65.16455843800819
2025-06-09T02:00:00-04:00,21746.75,21800.5,21732,21780,21421.08366732243,NaN,NaN,NaN,NaN,NaN,21572.755,21954.05421964239,21191.455780357614,21543.69029645598,21760.33029507357,21772.305379815993,21748.35521033115,64894,207213.96666666667,57.45954381461946,56.86274875610103,NaN,NaN,NaN,NaN,121.67628012190237,24.6736258284269,6050569,-3.818490714768018,60.39144504454816,64.20993575931618
2025-06-09T06:00:00-04:00,21779.5,21824,21750.25,21787,21421.08366732243,NaN,NaN,NaN,NaN,NaN,21579.45,21963.793804424953,21195.10619557505,21581.677237164786,21774.014331693226,21789.790568804092,21758.23809458236,201778,205453.13333333333,57.87642704225047,56.61059152957232,NaN,NaN,NaN,NaN,118.25297439890934,25.204399021633932,6252347,-3.585560992664341,59.727984518485755,63.313545511150096
2025-06-09T10:00:00-04:00,21787.25,21892.5,21787.25,21867.25,21467.899609619042,NaN,NaN,NaN,NaN,NaN,21588.19,21978.395158346422,21197.984841653575,21645.891789731828,21812.919386558187,21851.951113187042,21773.887659929333,425368,203678.53333333333,62.42283101075605,56.523383351563396,NaN,NaN,NaN,NaN,117.3420476561301,26.170234497576512,6677715,1.292545889077516,64.929227872497,63.63668198341948
2025-06-09T14:00:00-04:00,21867,21878.75,21796.5,21821.5,21471.341672818176,NaN,NaN,NaN,NaN,NaN,21595.285,21989.281929049022,21201.288070950977,21645.891789731828,21816.236100178612,21852.501701633,21779.970498724226,169804,202616.13333333333,58.543538482186484,56.48777539689812,NaN,NaN,NaN,NaN,114.83547282354938,27.06708172523748,6507911,0.7824697844529851,64.61476921398571,63.832299429532725
2025-06-09T18:00:00-04:00,21822,21973.5,21815,21966.5,21523.002278599168,NaN,NaN,NaN,NaN,NaN,21605.22,22010.9318267931,21199.5081732069,21703.52074542837,21918.333333333332,21918.333333333332,21918.333333333332,78361,203086.2,65.7982339708589,56.94573749795437,NaN,NaN,NaN,NaN,117.95436762186728,28.49197832677111,6586272,9.09335996899567,75.19899939077732,66.10563942178165
2025-06-09T22:00:00-04:00,21966.5,21968.5,21756.5,21828.75,21523.002278599168,NaN,NaN,NaN,NaN,NaN,21611.295,22021.096045508886,21201.49395449111,21703.52074542837,21879.684821864852,21912.83544084858,21846.534202881125,106508,205141.2,55.80690646216872,57.767473940959846,NaN,NaN,NaN,NaN,124.6719127917339,28.948446476108984,6479764,4.432220285292388,71.64591477839713,67.21369449310474
2025-06-10T02:00:00-04:00,21829,21841.75,21732,21829.5,21523.002278599168,NaN,NaN,NaN,NaN,NaN,21612,22023.17658007244,21200.82341992756,21703.52074542837,21852.557596459035,21898.55802330924,21806.55716960883,97427,205763.1,55.846219010450916,58.263820225081254,NaN,NaN,NaN,NaN,123.60606187803863,29.02656225754398,6577191,0.7134527467130454,68.10551042649604,67.392057679783
2025-06-10T06:00:00-04:00,21828.25,21893.25,21804.5,21857.75,21523.002278599168,NaN,NaN,NaN,NaN,NaN,21613.05,22026.457268925173,21199.642731074826,21703.52074542837,21852.240349803247,21886.726383136032,21817.754316470462,220034,205062.9,57.38398927199437,58.56449251967972,NaN,NaN,NaN,NaN,121.11634317246444,29.474542180570516,6797225,-0.46635059688435376,66.80911943367755,67.2754700305619
2025-06-10T10:00:00-04:00,21857,21930.5,21743,21873.75,21523.002278599168,NaN,NaN,NaN,NaN,NaN,21614.825,22031.91585640876,21197.734143591242,21703.52074542837,21850.741746352604,21875.786299753043,21825.697192952164,453924,205138.46666666667,58.27043795571343,58.81671152708551,NaN,NaN,NaN,NaN,125.85803294585983,29.039003637630156,7251149,-0.7736366045971437,66.30842427481548,67.08206087941262
2025-06-10T14:00:00-04:00,21873,21992.25,21821,21951.5,21523.002278599168,NaN,NaN,NaN,NaN,NaN,21623.495,22050.0886062579,21196.901393742097,21703.52074542837,21866.706048452314,21903.610786282283,21829.801310622344,278183,205819.43333333332,62.36695923972549,58.82591882071877,NaN,NaN,NaN,NaN,129.10031630686984,29.110660734506816,7529332,3.4245668056976086,71.36276938653464,67.93820258083703
2025-06-10T18:00:00-04:00,21950.75,22002,21881.75,21907.75,21553.199606668055,NaN,NaN,NaN,NaN,NaN,21634.205,22061.91686200486,21206.493137995145,21703.52074542837,21930.5,21930.5,21930.5,91671,207115.56666666668,58.86515378530562,58.6779878957819,NaN,NaN,NaN,NaN,128.46815085637914,29.25003407170869,7437661,2.464995503082349,71.01944695968996,68.55445145660761
2025-06-10T22:00:00-04:00,21908.25,21917.5,21866.25,21881.5,21553.199606668055,NaN,NaN,NaN,NaN,NaN,21644.145,22071.28244965775,21217.007550342252,21703.52074542837,21916.853673713595,21936.552929451675,21897.154417975515,43991,207475.73333333334,56.80426606550845,58.44424671733308,NaN,NaN,NaN,NaN,122.95256865235206,29.15153060518364,7393670,-0.5658758601445868,67.84710663142687,68.41298249157146
2025-06-11T02:00:00-04:00,21881,21959.75,21874,21916.75,21553.199606668055,NaN,NaN,NaN,NaN,NaN,21655.635,22080.572821451944,21230.697178548053,21703.52074542837,21916.847378024573,21933.21654030426,21900.478215744886,60812,207341.93333333332,58.88588619591253,58.701262510819554,NaN,NaN,NaN,NaN,120.2952423200412,29.403715319036962,7454482,-0.810038618140041,67.40043421889641,68.21047283703645
2025-06-11T06:00:00-04:00,21916.75,22094,21881.5,21980.25,21603.1964624674,NaN,NaN,NaN,NaN,NaN,21667.495,22094.90237581394,21240.087624186057,21763.313387284263,21960.471502399614,21994.79355913061,21926.14944566862,345905,210455.23333333334,62.40097641199797,59.195097765674895,NaN,NaN,NaN,NaN,126.88129644003826,30.531450184477126,7800387,2.5099482500543076,71.34790814960434,68.83795989955003
2025-06-11T10:00:00-04:00,21980.75,22066.75,21907.25,21917.5,21603.1964624674,NaN,NaN,NaN,NaN,NaN,21678.585,22102.575490577612,21254.594509422386,21763.313387284263,21962.15209394258,21986.481926878416,21937.822261006742,542170,211102.6,57.196910358841905,59.17633823311936,NaN,NaN,NaN,NaN,129.21120383717837,31.578632559528714,7258217,-0.17286487950860874,68.62187880016427,68.79474367967288
2025-06-11T14:00:00-04:00,21917.25,21930.5,21790.25,21882.75,21603.1964624674,NaN,NaN,NaN,NaN,NaN,21691.04,22101.48490933603,21280.59509066397,21763.313387284263,21934.937012009697,21982.34346850771,21887.530555511683,439858,219231.3,54.486909951888656,58.934229869522085,NaN,NaN,NaN,NaN,129.99968927737993,30.911089600070174,6818359,-4.690190675794881,62.93200533492927,67.62219601072415
2025-06-11T18:00:00-04:00,21871,21895,21753.5,21786.5,21603.1964624674,NaN,NaN,NaN,NaN,NaN,21703.245,22087.168800903557,21319.32119909644,21763.313387284263,21811.666666666668,21811.666666666668,21811.666666666668,101657,221116.83333333334,47.73993330718275,57.88545146212399,NaN,NaN,NaN,NaN,130.82114004328136,29.847929660749767,6716702,-14.034644219904322,50.07889073584374,64.11353495574807
2025-06-11T22:00:00-04:00,21786.75,21840,21772.75,21827,21603.1964624674,NaN,NaN,NaN,NaN,NaN,21712.405,22085.700471309476,21339.109528690522,21763.313387284263,21812.1986742783,21812.9465467525,21811.4508018041,51442,221879.5,50.51655022446031,57.3120951580007,NaN,NaN,NaN,NaN,126.28034432590412,28.860709717095105,6768144,-17.155742903426315,42.668856326465175,59.82459922989149
2025-06-12T02:00:00-04:00,21826.5,21858.75,21716.5,21810.25,21603.1964624674,NaN,NaN,NaN,NaN,NaN,21723.035,22076.048994198547,21370.021005801453,21763.313387284263,21804.976434111446,21813.412703361493,21796.5401648614,112716,222874.86666666667,49.34875504501978,56.13713237758362,NaN,NaN,NaN,NaN,127.42103401691098,27.258797402829543,6655428,-19.827010021624176,35.04083670286127,54.867846724485446
2025-06-12T06:00:00-04:00,21810,21892,21720,21857.25,21603.1964624674,NaN,NaN,NaN,NaN,NaN,21735.555,22061.261574849,21409.848425151,21763.313387284263,21814.10933859371,21824.936695257245,21803.281981930173,270522,221288.4,52.65599507706762,55.91206727864783,NaN,NaN,NaN,NaN,130.60524587284593,26.1054714790382,6925950,-17.962733358161543,32.41443002678352,50.377163384945064
2025-06-12T10:00:00-04:00,21857,21977.5,21839.75,21936.5,21603.1964624674,NaN,NaN,NaN,NaN,NaN,21749.78,22045.875907435948,21453.68409256405,21763.313387284263,21865.33397484815,21917.80217404864,21812.865775647657,522485,215579.06666666668,57.67439081528208,56.04265097899291,NaN,NaN,NaN,NaN,131.11558545335694,25.80671612441331,7448435,-11.254333822774392,36.309246106477076,47.56357992925147
2025-06-12T14:00:00-04:00,21936.5,21953,21892,21908.25,21603.1964624674,NaN,NaN,NaN,NaN,NaN,21761.785,22032.878637144302,21490.691362855698,21763.313387284263,21873.031964701007,21924.924634791587,21821.139294610428,182271,206937.86666666667,55.419296122394755,55.90231575402151,NaN,NaN,NaN,NaN,126.10732934954572,25.52930043797591,7266164,-8.696145263373303,36.69339835003484,45.389543613408144
2025-06-12T18:00:00-04:00,21911,21920,21489,21612.75,NaN,NaN,NaN,22128.498849988762,22128.498849988762,22128.498849988762,21765.13,22024.400172599748,21505.859827400254,21763.313387284263,21673.916666666668,21673.916666666668,21673.916666666668,264691,213206.46666666667,38.47335906234119,54.4882386902092,NaN,NaN,NaN,NaN,147.88537725314958,25.617642970452792,7001473,-25.90878339342317,13.003564371629182,38.91234776505235
2025-06-12T22:00:00-04:00,21612.75,21614.5,21470.5,21569.75,NaN,NaN,NaN,21966.862538625635,NaN,NaN,21765.43,22023.758764174312,21507.10123582569,21722.45070982741,21636.321396358086,21692.76384833235,21579.87894438382,117434,215673.6,36.714087139546876,52.65589068305359,NaN,NaN,NaN,NaN,147.60785030649603,25.80094760833384,6884039,-38.43806626242768,-9.135235062982247,29.302831199445432
2025-06-13T02:00:00-04:00,21569.5,21664,21563,21621.5,NaN,NaN,NaN,21966.862538625635,NaN,NaN,21768.125,22017.42193640335,21518.82806359665,21648.400197501596,21631.506167866348,21681.49112720682,21581.521208525875,119953,217414.53333333333,40.2548905039492,51.3265861629567,NaN,NaN,NaN,NaN,144.2787181417463,25.487372026450238,7003992,-41.24077529886825,-22.248137924139883,18.992637374728368
2025-06-13T06:00:00-04:00,21621.75,21796.25,21593,21731.25,NaN,NaN,NaN,21966.862538625635,NaN,NaN,21773.465,22007.466025852274,21539.463974147726,21648.400197501596,21657.45279147642,21711.48187135217,21603.423711600666,263813,216540.1,47.02429358990319,50.62801670041347,NaN,NaN,NaN,NaN,148.490952560193,24.05176151718224,7267805,-34.004713082676524,-23.513253978617286,10.491459104059237
2025-06-13T10:00:00-04:00,21731.25,21855.75,21617.5,21788,NaN,NaN,NaN,21966.862538625635,NaN,NaN,21780.22,21995.23959538597,21565.200404614032,21648.400197501596,21697.651613865455,21760.54556019391,21634.757667537,548820,217287.2,50.16841109838571,50.00533990773298,NaN,NaN,NaN,NaN,154.9023130916078,22.401256183843067,7816625,-24.16070242982642,-19.709418933223787,4.451283496602631
2025-06-13T14:00:00-04:00,21788,21805,21601.25,21654,NaN,NaN,NaN,21966.862538625635,NaN,NaN,21781.515,21992.66346459286,21570.366535407138,21648.400197501596,21695.33930295813,21751.34366044852,21639.33494546774,353931,221941.26666666666,43.589848811336715,48.661687936257174,NaN,NaN,NaN,NaN,158.3914335850644,20.85892137372695,7462694,-25.316271771288307,-27.19405621750775,-1.8777844462194455
2025-06-15T18:00:00-04:00,21784,21921.5,21722,21904.75,NaN,NaN,NaN,21966.862538625635,NaN,NaN,21785.26,21998.36722559366,21572.152774406335,21648.400197501596,21849.416666666668,21849.416666666668,21849.416666666668,59774,221182.56666666668,55.38067993486645,48.5319571916875,NaN,NaN,NaN,NaN,166.18490261470265,20.162652529207257,7522468,-8.694040843376426,-12.745335500439978,-4.051294657063552
2025-06-15T22:00:00-04:00,21905.25,21958.75,21888.5,21935,NaN,NaN,NaN,21966.862538625635,NaN,NaN,21790.2,22005.499976776413,21574.90002322359,21648.400197501596,21871.185246158675,21906.172074353202,21836.198417964148,23140,220444.56666666668,56.56030249148603,48.680056658801604,NaN,NaN,NaN,NaN,159.33240957079533,19.764511284742056,7545608,4.14762667389307,1.1332386853027856,-3.0143879885902845
2025-06-16T02:00:00-04:00,21934.5,22013.25,21925.75,21969.5,21525.250548580138,21525.250548580138,21525.250548580138,NaN,NaN,NaN,21795.965,22014.696365149088,21577.233634850912,21648.400197501596,21907.83182409635,21962.85667032278,21852.806977869917,49272,219923.83333333334,57.92648072116188,49.40766718837154,NaN,NaN,NaN,NaN,154.2015231728814,19.749039488446773,7594880,14.208300647008091,14.74598782016983,0.5376871731617392
2025-06-16T06:00:00-04:00,21968.75,22168,21963.25,22151.5,21613.648250917406,NaN,NaN,NaN,NaN,NaN,21805.1,22043.43268764537,21566.767312354626,21747.96144774353,22008.639785226413,22108.742932141075,21908.53663831175,155652,218386.3,64.30431542962242,50.39250756016884,NaN,NaN,NaN,NaN,157.8121286605327,20.601132037013357,7750532,31.379226411185417,39.76172018714351,8.382493775958093
2025-06-16T10:00:00-04:00,22152,22224.5,22143.5,22165,21741.522194057525,NaN,NaN,NaN,NaN,NaN,21813.665,22071.536161822474,21555.793838177528,21847.969158194825,22091.740770405013,22202.350820030468,21981.130720779558,278375,213486.53333333333,64.73138622434661,51.49126693012075,NaN,NaN,NaN,NaN,152.3255480419232,21.665484328697474,8028907,41.281795989732295,59.98473876312346,18.702942773391165
2025-06-16T14:00:00-04:00,22165.5,22186.75,22136.5,22163.25,21741.522194057525,NaN,NaN,NaN,NaN,NaN,21821.94,22097.02368835717,21546.856311642827,21860.40032655586,22105.65682323198,22208.62983689683,22002.68380956713,139435,212474.23333333334,64.6234509828119,52.34608520910249,NaN,NaN,NaN,NaN,145.03443746750014,22.58207335905514,7889472,45.042282725328775,75.00579618005213,29.96351345472336
2025-06-16T18:00:00-04:00,22163.5,22177.5,22006.75,22081,21741.522194057525,NaN,NaN,NaN,NaN,NaN,21827.835,22112.0868181122,21543.5831818878,21860.40032655586,22088.416666666668,22088.416666666668,22088.416666666668,133598,214315.46666666667,59.59386267944866,52.48319034225724,NaN,NaN,NaN,NaN,146.8712633626787,22.19499824694486,7755874,39.515917587522594,79.3584104391266,39.84249285160401
2025-06-16T22:00:00-04:00,22081.25,22117.25,22021.25,22081.75,21741.522194057525,NaN,NaN,NaN,NaN,NaN,21834.52,22126.516349977355,21542.523650022646,21860.40032655586,22083.512029984282,22090.548654838993,22076.47540512957,64906,212928.73333333334,59.62472068629371,52.78357781110717,NaN,NaN,NaN,NaN,143.23760169391593,21.835571357128174,7820780,33.665236131532026,81.92403801601904,48.25880188448701
2025-06-17T02:00:00-04:00,22082,22123.25,22003.5,22034,21741.522194057525,NaN,NaN,NaN,NaN,NaN,21840.08,22136.438506541777,21543.721493458226,21860.40032655586,22074.628349592746,22089.520431747813,22059.736267437678,83794,212474.3,56.657987590739644,54.082479848849914,NaN,NaN,NaN,NaN,141.55991585863623,21.33411769321362,7736986,24.746095301990998,79.19142101197576,54.445325709984765
2025-06-17T06:00:00-04:00,22033.5,22110,21995.75,22095.5,21741.522194057525,NaN,NaN,NaN,NaN,NaN,21847.305,22150.525568069123,21544.084431930878,21860.40032655586,22071.531882294785,22083.554070908587,22059.509693680982,196497,211689.73333333334,59.456093410030945,55.70690886817021,NaN,NaN,NaN,NaN,139.60920758301936,20.791929997570932,7933483,21.28693809878034,81.05399833346019,59.767060234679846
2025-06-17T10:00:00-04:00,22095.25,22136.5,21941.5,21962.25,21741.522194057525,NaN,NaN,NaN,NaN,NaN,21851.02,22155.229513986334,21546.810486013666,21860.40032655586,22041.434225841953,22071.649168680215,22011.21928300369,514342,213703.66666666666,51.6723258562332,56.52243996476192,NaN,NaN,NaN,NaN,143.56569275566082,19.754355310784224,7419141,8.954320325345122,70.95996064136125,62.00564031601613
2025-06-17T14:00:00-04:00,21962,22001.5,21908,21953.25,21741.522194057525,NaN,NaN,NaN,NaN,NaN,21855.61,22158.924064296178,21552.295935703823,21860.40032655586,22024.801442507087,22068.530617482775,21981.0722675314,234136,212235.43333333332,51.18491472066151,56.81962718838752,NaN,NaN,NaN,NaN,139.98957184454218,18.472950901898617,7185005,-0.38457840158666556,61.52491731403279,61.90949571561946
2025-06-17T18:00:00-04:00,21937.5,22011,21862.75,21974,21741.522194057525,NaN,NaN,NaN,NaN,NaN,21860.5,22163.40719700922,21557.59280299078,21860.40032655586,21949.25,21949.25,21949.25,97429,212427.36666666667,52.30202903455298,56.972028469542316,NaN,NaN,NaN,NaN,140.5796024270749,17.441506002957656,7282434,-5.45805949453792,55.08692134744706,60.54498084198498
2025-06-17T22:00:00-04:00,21974.5,22003,21944.5,21988.25,21741.522194057525,NaN,NaN,NaN,NaN,NaN,21869.995,22158.205053433583,21581.784946566415,21860.40032655586,21957.935879420584,21971.327716299962,21944.544042541205,40986,212327.2,53.09587465408912,57.65103031545321,NaN,NaN,NaN,NaN,134.71677368228384,16.483735739655334,7323420,-7.994473980132639,50.551888366819185,58.546362346951824
2025-06-18T02:00:00-04:00,21988.5,22065.25,21981.25,22031.75,21741.522194057525,NaN,NaN,NaN,NaN,NaN,21878.94,22158.79275699981,21599.087243000187,21860.40032655586,21978.97200662604,22012.363938420785,21945.580074831298,61805,212360.3,55.52904056331778,57.66162750319973,NaN,NaN,NaN,NaN,131.09414699069214,15.642023113702397,7385225,-6.9228535388396395,49.892795423402276,56.815648962241916
2025-06-18T06:00:00-04:00,22031.25,22035.5,21926.5,22001,21741.522194057525,NaN,NaN,NaN,NaN,NaN,21885.81,22160.39662676773,21611.22337323227,21831.04526124469,21983.29481567611,22007.368740393664,21959.220890958553,197974,207429.26666666666,53.41943847682883,57.43728007358136,NaN,NaN,NaN,NaN,129.5159936342141,14.73983361671212,7187251,-8.368645773828334,46.3548417449565,54.723487518784836
2025-06-18T10:00:00-04:00,22001.25,22098.75,21940,22031.75,21741.522194057525,NaN,NaN,NaN,NaN,NaN,21892.735,22164.21233625462,21621.257663745382,21803.243967196602,22003.40883605805,22029.747519966324,21977.070152149776,398647,202645.16666666666,55.250298745879284,57.24612421820404,NaN,NaN,NaN,NaN,131.60413694605595,14.089502042195049,7585898,-7.372652524595274,45.50767186304074,52.880324387636016
2025-06-18T14:00:00-04:00,22032,22083,21883,21961.25,21741.522194057525,NaN,NaN,NaN,NaN,NaN,21895.16,22166.87582140186,21623.44417859814,21803.243967196602,21993.713710668857,22018.708070006185,21968.71935133153,430060,202318.56666666668,50.36277569409979,56.250299951380995,NaN,NaN,NaN,NaN,136.48955573562338,13.248959207271682,7155838,-11.34314174612561,38.701397204979,50.04453895110461
2025-06-18T18:00:00-04:00,21960.25,21971.25,21790,21840,21741.522194057525,NaN,NaN,NaN,NaN,NaN,21895.53,22166.893752922748,21624.16624707725,21797.01123586354,21867.083333333332,21867.083333333332,21867.083333333332,89525,201914.16666666666,43.27277541234252,54.71754203623784,NaN,NaN,NaN,NaN,139.686730325936,13.283957825424569,7066313,-21.43127948188082,23.255439598753583,44.686719080634404
2025-06-18T22:00:00-04:00,21839.75,21903.75,21822.25,21852.25,21741.522194057525,NaN,NaN,NaN,NaN,NaN,21896.38,22166.928687669773,21625.83131233023,21797.01123586354,21864.577876536525,21868.17387269956,21860.98188037349,43459,201648.06666666668,44.12856198633173,53.25362139363211,NaN,NaN,NaN,NaN,135.53053530265487,13.316456542280825,7109772,-26.256499597148775,11.866094584198436,38.12259418134721
2025-06-19T02:00:00-04:00,21851.75,21874.5,21783,21832.5,21741.522194057525,NaN,NaN,NaN,NaN,NaN,21898.175,22165.797836282847,21630.55216371715,21797.01123586354,21852.563381502652,21869.282404442012,21835.844358563292,70811,200251.23333333334,43.002194143755226,52.06850221251115,NaN,NaN,NaN,NaN,132.38549706675096,13.68006589847239,7038961,-29.51240026424416,1.2320938510420092,30.74449411528617
2025-06-19T06:00:00-04:00,21832.5,21856.5,21650.25,21684.75,NaN,NaN,NaN,22167.240810759387,22167.240810759387,22167.240810759387,21896.945,22167.894170325675,21625.995829674324,21797.01123586354,21805.335238616684,21866.20971928789,21744.46075794548,128614,195520.96666666667,35.66755320235646,50.357275963658495,NaN,NaN,NaN,NaN,137.66153299055446,14.977307788305549,6910347,-39.715398449622406,-18.89975394674184,20.815644502880566
2025-06-19T10:00:00-04:00,21685.25,21742,21671.25,21704.25,NaN,NaN,NaN,22111.32645572487,NaN,NaN,21895.43,22169.803268377014,21621.056731622986,21797.01123586354,21775.941305602715,21844.291485506667,21707.591125698764,139368,182750.4,37.19022836016212,48.96672173290296,NaN,NaN,NaN,NaN,132.88213777694344,16.181889543150625,7049715,-42.973821047114875,-32.90163180601303,10.072189241101846
2025-06-19T18:00:00-04:00,21736.25,21928.25,21736,21875.5,NaN,NaN,NaN,22111.32645572487,NaN,NaN,21897.2,22169.889145364985,21624.510854635017,21797.01123586354,21790.564877644687,21857.82438185059,21723.305373438783,123157,180779.93333333332,48.67855382731872,48.19689747699494,NaN,NaN,NaN,NaN,139.39055650716176,15.310526275336796,7172872,-31.926429792848506,-29.835847999958787,2.0905817928897186
2025-06-19T22:00:00-04:00,21875.75,21924,21867.5,21922.75,NaN,NaN,NaN,22111.32645572487,NaN,NaN,21898.31,22170.954284003157,21625.665715996845,21797.01123586354,21798.66447023561,21869.813587837547,21727.515352633673,45423,173471,51.32400800460267,48.1720176304499,NaN,NaN,NaN,NaN,133.46980247093592,14.50140324093824,7218295,-20.332177592306866,-23.324640197493864,-2.992462605186998
2025-06-20T02:00:00-04:00,21922.25,21949.5,21858.5,21900,NaN,NaN,NaN,22111.32645572487,NaN,NaN,21899.88,22171.63962246008,21628.120377539923,21797.01123586354,21811.324685599284,21886.173757017117,21736.47561418145,88755,172515.03333333333,49.98793309298157,48.086518942758474,NaN,NaN,NaN,NaN,130.43624515158336,13.508960728152433,7129540,-13.423848725773883,-19.772273512404354,-6.34842478663047
2025-06-20T06:00:00-04:00,21899.75,22130.75,21882.75,22018.5,21591.514066615888,21591.514066615888,21591.514066615888,NaN,NaN,NaN,21900.92,22174.085818506697,21627.7541814933,21765.08033970246,21869.634952571414,21980.03063312604,21759.239272016788,301455,178565.1,56.36046465945341,48.37640720167993,NaN,NaN,NaN,NaN,138.83365621218454,13.930962230390346,7430995,-0.769871157371691,-7.310763733345084,-6.540892575973393
2025-06-20T10:00:00-04:00,22018.25,22030,21760,21838.75,21591.514066615888,NaN,NaN,NaN,NaN,NaN,21901.12,22174.088738869905,21628.151261130093,21765.08033970246,21872.444365733165,21956.241661240067,21788.647070226263,760790,195131,46.65029499447082,47.916008654564344,NaN,NaN,NaN,NaN,148.2026807684571,13.24157352187703,6670205,-4.2098382497173885,-11.803190388120129,-7.59335213840274
2025-06-20T14:00:00-04:00,21838.75,21911,21798,21874,21591.514066615888,NaN,NaN,NaN,NaN,NaN,21902.01,22174.328287304415,21629.69171269558,21765.08033970246,21870.98853304282,21949.36751331369,21792.609552771948,261091,185540.03333333333,48.523295501551786,47.41559829300963,NaN,NaN,NaN,NaN,145.68820357071016,12.601426863971804,6931296,-3.8264565109074695,-12.376422777037078,-8.549966266129609
2025-06-22T18:00:00-04:00,21648.25,21786,21562,21739.25,NaN,NaN,NaN,22125.948908627935,22125.948908627935,22125.948908627935,21899.64,22175.497447968966,21623.782552031033,21765.08033970246,21695.75,21695.75,21695.75,134762,178234.4,42.39579948061934,46.62819550756609,NaN,NaN,NaN,NaN,157.5676176013737,13.037028669153766,6796534,-11.907052880166116,-23.433782366337255,-11.526729486171138
2025-06-22T22:00:00-04:00,21739.5,21817.5,21737.25,21808.75,NaN,NaN,NaN,22125.948908627935,NaN,NaN,21898.34,22175.283726413443,21621.396273586557,21765.08033970246,21720.997544016504,21762.075999836776,21679.91908819623,50907,177938.83333333334,46.171404149550284,45.979703036399734,NaN,NaN,NaN,NaN,152.04493062984702,13.181199717757961,6847441,-11.80721212200468,-26.285744638676988,-14.478532516672308
2025-06-23T02:00:00-04:00,21809.5,21944.75,21798,21883.5,NaN,NaN,NaN,22125.948908627935,NaN,NaN,21896.98,22173.53373510448,21620.42626489552,21765.08033970246,21776.74392878243,21857.854411799282,21695.63344576558,104896,180664.03333333333,49.96960046273564,45.9516190913023,NaN,NaN,NaN,NaN,151.66672129914363,12.34670209730437,6952337,-6.223311911483968,-22.257672406027268,-16.0343604945433
2025-06-23T06:00:00-04:00,21883.75,21929.25,21758.5,21925.25,NaN,NaN,NaN,22125.948908627935,NaN,NaN,21897.33,22173.981648106226,21620.678351893777,21765.08033970246,21822.47645210309,21897.349436904027,21747.60346730215,273852,188150.03333333333,52.00653210685249,46.57545885519586,NaN,NaN,NaN,NaN,153.0298126349191,11.838450660031826,7226189,0.41337452460902036,-15.517642338782025,-15.931016863391045
2025-06-23T10:00:00-04:00,21925.25,22082.75,21738.5,22051.25,NaN,NaN,NaN,22125.948908627935,NaN,NaN,21900.725,22180.663015461025,21620.786984538972,21765.08033970246,21901.007361774762,21983.359672813687,21818.655050735837,784601,209115,57.61510472150682,47.5387833362798,NaN,NaN,NaN,NaN,166.68839744671058,11.648123422309958,8010790,12.73771691392612,-0.008870720983395586,-12.746587634909515
2025-06-23T14:00:00-04:00,22051.75,22093,22021.5,22072,NaN,NaN,NaN,22125.948908627935,NaN,NaN,21903.83,22187.824708401033,21619.83529159897,21765.08033970246,21923.428984887596,22018.028566189383,21828.82940358581,218017,207103.06666666668,58.475711289463014,48.64403456097322,NaN,NaN,NaN,NaN,159.88922620051696,11.534632030915349,8228807,21.23506852322956,13.797248019127437,-7.437820504102124
2025-06-23T18:00:00-04:00,22077.25,22272,22064.5,22265.5,21700.461945007013,21700.461945007013,21700.461945007013,NaN,NaN,NaN,21909.535,22210.400451821704,21608.669548178295,21818.103474596333,22200.666666666668,22200.666666666668,22200.666666666668,133630,206909.56666666668,65.50884442264524,50.775555362422416,NaN,NaN,NaN,NaN,163.28999575762288,12.424545453043391,8362437,37.86439364810579,39.89267155603011,2.0282779079243216
2025-06-23T22:00:00-04:00,22265,22303,22215.25,22294.5,21800.634129324877,NaN,NaN,NaN,NaN,NaN,21917.075,22236.673783633378,21597.476216366624,21896.007779677067,22222.040199723015,22254.361443229027,22189.718956217002,58436,204404.16666666666,66.42663423022302,52.86387006742677,NaN,NaN,NaN,NaN,157.89428177493554,13.40335869187618,8420873,48.134639218030514,62.19657693046247,14.061937712431952
2025-06-24T02:00:00-04:00,22294.5,22383.25,22262.25,22314.25,21868.599623446473,NaN,NaN,NaN,NaN,NaN,21925.705,22263.89290176437,21587.517098235632,21997.15622374165,22262.52556746195,22316.710906222906,22208.340228700996,135489,206756.93333333332,67.06930735102284,54.17749531911992,NaN,NaN,NaN,NaN,155.2589759338687,14.695373511532148,8556362,53.18073170547084,80.5378523442705,27.357120638799664
2025-06-24T06:00:00-04:00,22314,22333.25,22251.25,22293.25,21868.599623446473,NaN,NaN,NaN,NaN,NaN,21935.84,22286.862916060694,21584.817083939306,21997.15622374165,22275.300121914614,22318.992389277057,22231.60785455217,242106,212034,65.63071006884937,55.19940260942326,NaN,NaN,NaN,NaN,150.02619193859235,15.795503425309992,8314256,51.966122297527164,92.31477351070862,40.348651213181455
2025-06-24T10:00:00-04:00,22288.75,22426.25,22265.75,22417.5,21899.63777673532,NaN,NaN,NaN,NaN,NaN,21947.65,22322.177969582794,21573.12203041721,22066.099983194657,22314.111652873835,22371.451809513397,22256.771496234272,396783,218710.2,69.76321024237654,56.61192240580861,NaN,NaN,NaN,NaN,150.77432108583577,17.25668946766939,8711039,56.042172428855544,110.40136674925088,54.35919432039534
2025-06-24T14:00:00-04:00,22417.5,22447.75,22394,22409.5,21987.47242324735,NaN,NaN,NaN,NaN,NaN,21959.635,22353.65374587411,21565.616254125885,22132.754986555727,22329.79532258508,22394.26321483277,22265.32743033739,173648,207353.73333333334,69.18638898357906,57.52805985753188,NaN,NaN,NaN,NaN,143.8440124368475,18.711181107725647,8537391,54.65301469203422,122.6754626854381,68.02244799340389
2025-06-24T18:00:00-04:00,22410.75,22434.75,22385,22399.25,21989.38844946338,NaN,NaN,NaN,NaN,NaN,21970.475,22382.061008630342,21558.888991369655,22157.878989244582,22406.333333333332,22406.333333333332,22406.333333333332,52778,201308.46666666667,68.40597081136035,59.08203670159541,NaN,NaN,NaN,NaN,137.12301154850124,19.96763239346922,8484613,49.643037466926174,130.0762448270616,80.43320736013543
2025-06-24T22:00:00-04:00,22399.75,22438.75,22393.75,22426.5,22008.74011085141,NaN,NaN,NaN,NaN,NaN,21980.275,22411.045521855696,21549.504478144307,22194.753191395666,22410.724350013978,22416.990597820346,22404.45810220761,25916,198924.7,69.39437656388914,60.57282820604809,NaN,NaN,NaN,NaN,130.542796437894,21.155099502319693,8510529,44.906247887245954,136.56601721919287,91.65976933194692
2025-06-25T02:00:00-04:00,22426.5,22453.75,22405.25,22425.5,22033.899651267253,NaN,NaN,NaN,NaN,NaN,21990.62,22438.47955655762,21542.760443442377,22234.302553116533,22417.740810508356,22427.570516846066,22407.911104170646,52960,199323.83333333334,69.30868539094367,62.495177199642676,NaN,NaN,NaN,NaN,124.68259669233014,22.339702526192216,8457569,38.68379794275269,140.01451676038778,101.33071881763509
2025-06-25T06:00:00-04:00,22425.25,22548.25,22414.25,22522.5,22085.358758027833,NaN,NaN,NaN,NaN,NaN,22008.815,22467.57724572237,21550.05275427763,22305.692042493225,22465.909201497136,22503.825411188787,22427.992991805484,217992,204530.06666666668,72.8153338534878,64.39831503563822,NaN,NaN,NaN,NaN,125.34812550002084,23.92596386880893,8675561,38.022318825511235,148.85861734952414,110.8362985240129
2025-06-25T10:00:00-04:00,22522.75,22529.25,22388.25,22412.5,22085.358758027833,NaN,NaN,NaN,NaN,NaN,22025.67,22480.577808682578,21570.76219131742,22305.692042493225,22452.493084356232,22479.067213709943,22425.918955002522,512120,215001.6,63.89917811071916,65.39328486763704,NaN,NaN,NaN,NaN,126.46611653573363,25.07491203202629,8163441,27.584107351268102,145.31643271309804,117.73232536182994
2025-06-25T14:00:00-04:00,22412.75,22481,22401.25,22472.75,22085.358758027833,NaN,NaN,NaN,NaN,NaN,22042.695,22499.536200965937,21585.853799034063,22305.692042493225,22452.352281198302,22476.55894993547,22428.145612461136,176979,207612.66666666666,66.33101203545797,66.41646200539456,NaN,NaN,NaN,NaN,123.12925106889551,26.141792469299563,8340420,22.36730524085631,145.69145691290032,123.32415167204401
2025-06-25T18:00:00-04:00,22466,22488,22438,22468,22085.358758027833,NaN,NaN,NaN,NaN,NaN,22057.43,22520.621440335428,21594.238559664573,22305.692042493225,22464.66666666667,22464.66666666667,22464.66666666667,48413,194891.1,65.95380660927385,67.0120835688065,NaN,NaN,NaN,NaN,117.90573313540298,27.174046327806533,8292007,16.497526989938763,143.94606040946746,127.4485334195287
2025-06-25T22:00:00-04:00,22467.75,22512.25,22467.25,22511.25,22121.802066414566,NaN,NaN,NaN,NaN,NaN,22071.895,22545.58073009947,21598.20926990053,22308.782260605225,22477.58048592707,22493.382509310613,22461.778462543523,32333,192984.7,67.75201914484924,67.67467698704839,NaN,NaN,NaN,NaN,112.69818076858849,28.2808178494547,8324340,13.551826081790239,144.3883160217665,130.83648993997627
2025-06-26T02:00:00-04:00,22511,22577.25,22508.25,22550,22182.117881577542,NaN,NaN,NaN,NaN,NaN,22089.815,22566.689740472026,21612.94025952797,22379.97580848418,22507.33486017525,22542.90781539901,22471.761904951494,63506,193652.93333333332,69.31573713334332,67.94659789495537,NaN,NaN,NaN,NaN,109.57688214226073,29.683687614703615,8387846,12.2752318723727,146.18052978044216,133.90529790806946
2025-06-26T06:00:00-04:00,22550.5,22585,22476.25,22544,22182.117881577542,NaN,NaN,NaN,NaN,NaN,22102.6,22593.026844697808,21612.17315530219,22379.97580848418,22524.89792768791,22550.262862549687,22499.532992826134,248739,199583.86666666667,68.75976310624343,68.11324995752827,NaN,NaN,NaN,NaN,109.51781913209925,30.496943473745418,8139107,9.227904391376313,145.44017839728986,136.21227400591354
2025-06-26T10:00:00-04:00,22544,22651.5,22537.5,22640,22236.20658218119,NaN,NaN,NaN,NaN,NaN,22116.7,22627.17034193946,21606.22965806054,22424.744517429874,22568.41123130524,22614.32726153672,22522.495201073758,414499,209113.36666666667,72.55309392639545,68.5049489986263,NaN,NaN,NaN,NaN,109.83797490837787,31.64747943877066,8553606,11.718830991265321,150.8608127449952,139.14198175372988
2025-06-26T14:00:00-04:00,22640.5,22692.75,22634.5,22672.75,22313.67446480932,NaN,NaN,NaN,NaN,NaN,22130.765,22662.54556950236,21598.98443049764,22482.2206139439,22588.30334075086,22645.22667223872,22531.380009262997,204977,211300.33333333334,73.72520945185312,69.08312752598371,NaN,NaN,NaN,NaN,106.15311955777945,32.94101168027499,8758583,13.487272644041497,156.00107255878174,142.51379991474025
2025-06-26T18:00:00-04:00,22676.5,22711.25,22660,22680.75,22344.59267095435,NaN,NaN,NaN,NaN,NaN,22141.35,22694.9804633962,21587.719536603796,22517.20149115512,22684,22684,22684,53982,208994.5,74.0171053026349,69.38697717314503,NaN,NaN,NaN,NaN,102.2314681607952,34.24164749311824,8812565,13.099942693138132,158.8887282811629,145.78878558802478
2025-06-26T22:00:00-04:00,22680.75,22718.25,22675.75,22708.75,22365.67368591097,NaN,NaN,NaN,NaN,NaN,22152.225,22728.197484152017,21576.25251584798,22541.761192924096,22690.68719124912,22698.958010944738,22682.4163715535,35289,208656.7,75.06137780564906,69.80661923186432,NaN,NaN,NaN,NaN,97.9649347207384,35.48836047610878,8847854,12.628217198455701,161.5740570860944,148.9458398876387
2025-06-27T02:00:00-04:00,22709,22759.5,22705.75,22744.75,22409.02942746047,NaN,NaN,NaN,NaN,NaN,22163.855,22763.255050800886,21564.454949199113,22591.433954339278,22708.52941764522,22731.850924063783,22685.207911226655,56608,207585.13333333333,76.37602275666538,70.37590865652895,NaN,NaN,NaN,NaN,94.8067250978285,36.874437117145874,8904462,12.610081890984219,164.70844225136898,152.09836036038476
2025-06-27T06:00:00-04:00,22744.75,22787.5,22682,22764.5,22411.476953484995,NaN,NaN,NaN,NaN,NaN,22177.525,22799.494213466092,21555.55578653391,22600.297163471423,22730.081773860806,22753.187019257428,22706.976528464184,215568,204722.23333333334,77.08956332727351,70.92556485391356,NaN,NaN,NaN,NaN,95.57053044798361,38.31022909537658,9120030,11.811420843715837,166.86263641502956,155.05121557131372
2025-06-27T10:00:00-04:00,22764.5,22823.75,22697,22736,22434.512091962948,NaN,NaN,NaN,NaN,NaN,22190.61,22831.217954680535,21550.002045319467,22610.61273077714,22742.912076353077,22761.47771824336,22724.346434462794,496628,195916.83333333334,73.63333389949844,71.23446831881031,NaN,NaN,NaN,NaN,97.79763541598479,39.82928557840208,8623402,7.459285619352443,164.37532259550426,156.91603697615182
2025-06-27T14:00:00-04:00,22736.25,22760,22600,22740.25,22434.512091962948,NaN,NaN,NaN,NaN,NaN,22204.735,22861.839774065684,21547.630225934317,22610.61273077714,22730.215646958502,22755.217162464374,22705.21413145263,361555,199265.63333333333,73.82181821235825,71.30636005872964,NaN,NaN,NaN,NaN,102.24066145770016,39.548462312448436,8984957,3.1810750122882894,160.89238074151217,157.71130572922388
2025-06-29T18:00:00-04:00,22751.25,22847,22750,22823,22466.204457759628,NaN,NaN,NaN,NaN,NaN,22219.285,22897.93470352898,21540.63529647102,22610.61273077714,22806.666666666668,22806.666666666668,22806.666666666668,82601,197526.93333333332,77.23426182473094,72.2588660383019,NaN,NaN,NaN,NaN,102.56275706786444,39.86168800504667,9067558,4.1759060888890644,162.9311883403352,158.75528225144615
2025-06-29T22:00:00-04:00,22822.25,22886.5,22819,22876,22526.354255134192,NaN,NaN,NaN,NaN,NaN,22237.56,22936.44920838704,21538.670791612964,22649.723718157893,22827.009352985777,22853.11088027316,22800.907825698392,50173,197502.46666666667,79.11231888731815,73.17181652772048,NaN,NaN,NaN,NaN,100.05827442015983,40.383832285258364,9117731,6.5155336148470155,166.89969927000493,160.38416565515791
2025-06-30T02:00:00-04:00,22876.75,22916,22849.5,22880.75,22562.122243537182,NaN,NaN,NaN,NaN,NaN,22256.11,22972.837710919513,21539.382289080488,22693.328974526314,22845.998234580024,22879.637563509445,22812.358905650603,69869,196334.9,79.27731567218805,74.12349574650007,NaN,NaN,NaN,NaN,97.66125481871984,41.03618065312348,9187600,6.481353862998134,168.4858579839056,162.00450412090746
2025-06-30T06:00:00-04:00,22881.25,22909,22795,22827,22562.122243537182,NaN,NaN,NaN,NaN,NaN,22273.17,23002.71834274396,21543.621657256037,22693.328974526314,22844.81746950928,22868.479466695702,22821.155472322855,207919,194137.13333333333,72.31603123938974,74.44949661039583,NaN,NaN,NaN,NaN,98.82830804595415,40.775284779386176,8979681,1.2130038069512636,163.52075887959654,162.30775507264528
2025-06-30T10:00:00-04:00,22826.5,22867.25,22785,22821,22562.122243537182,NaN,NaN,NaN,NaN,NaN,22289.825,23030.531617021734,21549.118382978268,22693.328974526314,22834.316407367307,22853.698134860773,22814.93467987384,435500,182500.43333333332,71.56063969035279,74.60984679303934,NaN,NaN,NaN,NaN,97.64414318552885,40.378154254673916,8544181,-4.015318411315491,157.28860705850093,161.30392546981642
2025-06-30T14:00:00-04:00,22821.25,22934,22780,22865.75,22562.122243537182,NaN,NaN,NaN,NaN,NaN,22306.505,23060.6537617837,21552.356238216304,22693.328974526314,22840.848323727005,22860.956943454632,22820.739703999378,289821,184893.9,73.76201686616167,74.96715063303351,NaN,NaN,NaN,NaN,101.66956152941964,40.48087742182433,8834002,-5.696576504630826,154.1832048390279,159.87978134365872
2025-06-30T18:00:00-04:00,22866.75,22915,22845.5,22912,22562.122243537182,NaN,NaN,NaN,NaN,NaN,22324.725,23092.367985052486,21557.08201494751,22693.328974526314,22890.833333333332,22890.833333333332,22890.833333333332,56163,182311.66666666666,75.84323142524474,75.20216045437988,NaN,NaN,NaN,NaN,99.37173570588968,40.57626321989258,8890165,-4.957759049198046,153.68258253216118,158.64034158135922
2025-06-30T22:00:00-04:00,22911.75,22914,22835.75,22842.25,22562.122243537182,NaN,NaN,NaN,NaN,NaN,22340.935,23117.326987400556,21564.543012599446,22693.328974526314,22879.031323558745,22892.350476219464,22865.712170898027,44097,181833.7,67.18770702861103,74.73519599557689,NaN,NaN,NaN,NaN,97.86304029832613,40.49295975398778,8846068,-10.132364423442738,145.9748860520558,156.10725047549855
2025-07-01T02:00:00-04:00,22841.75,22866,22812.75,22831.25,22562.122243537182,NaN,NaN,NaN,NaN,NaN,22358.335,23138.894623667602,21577.775376332396,22693.328974526314,22861.593780566054,22884.811201417917,22838.37635971419,70136,179655.26666666666,65.91020275834282,74.15613152812746,NaN,NaN,NaN,NaN,94.6763945627314,40.004112930337044,8775932,-14.969745843568774,137.39506817103756,152.36481401460634
2025-07-01T06:00:00-04:00,22831,22848.25,22756,22782.25,22562.122243537182,NaN,NaN,NaN,NaN,NaN,22377.18,23152.251229242782,21602.10877075722,22693.328974526314,22826.4718715853,22863.083237335875,22789.860505834728,193228,178026,60.40081409406786,73.10894840587164,NaN,NaN,NaN,NaN,94.50308066539344,38.60566314947333,8582704,-21.73313044115443,125.1984009631633,146.93153140431772
2025-07-01T10:00:00-04:00,22788.75,22845,22593.75,22742.75,22562.122243537182,NaN,NaN,NaN,NaN,NaN,22394.99,23161.875793061543,21628.10420693846,22693.328974526314,22761.64662388233,22813.613651585645,22709.679596179016,683644,187588.03333333333,56.31428112571192,71.67596686080354,NaN,NaN,NaN,NaN,105.69928918929392,36.397667330225694,7899060,-28.69334671421808,111.06484801154511,139.7581947257632
2025-07-01T14:00:00-04:00,22742.75,22753.75,22647.75,22691.5,22562.122243537182,NaN,NaN,NaN,NaN,NaN,22412.17,23166.262212133366,21658.07778786663,22693.328974526314,22749.322966866213,22802.39828292372,22696.247650808706,249847,190128,51.450405365234474,69.8445984349436,NaN,NaN,NaN,NaN,105.72076853291578,34.347385498067176,7649213,-36.09652683859099,94.63753617752445,130.73406301611544
2025-07-01T18:00:00-04:00,22696.5,22728.5,22681.25,22690,22562.122243537182,NaN,NaN,NaN,NaN,NaN,22432.275,23160.891629304904,21703.6583706951,22680.426958372784,22699.916666666668,22699.916666666668,22699.916666666668,43804,189828.86666666667,51.310718972798725,68.25012594017934,NaN,NaN,NaN,NaN,101.54428506627895,32.443552368205694,7605409,-40.13206112686548,80.56898660753359,120.70104773439907
2025-07-01T22:00:00-04:00,22690,22781,22675.25,22769.25,22562.122243537182,NaN,NaN,NaN,NaN,NaN,22453.575,23157.670144493874,21749.479855506128,22680.426958372784,22722.67997371276,22743.560438412187,22701.79950901333,52060,190700.33333333334,57.82560544850815,67.10753931419005,NaN,NaN,NaN,NaN,101.84469327583045,30.239914672189176,7657469,-36.60052543294863,74.95039094321328,111.55091637616191
2025-07-02T02:00:00-04:00,22768.75,22779,22693.5,22713.75,22562.122243537182,NaN,NaN,NaN,NaN,NaN,22470.34,23158.313355298003,21782.366644701997,22680.426958372784,22725.060171651774,22741.607469177234,22708.512874126314,61839,190996.3,52.52508349206789,65.34259800471412,NaN,NaN,NaN,NaN,100.6772151846997,28.19367966874527,7595630,-37.027236007810444,65.26687136639885,102.29410737420929
2025-07-02T06:00:00-04:00,22713.5,22728.75,22584.75,22706.75,22562.122243537182,NaN,NaN,NaN,NaN,NaN,22486.02,23158.929116003077,21813.110883996924,22680.426958372784,22693.284049707072,22720.42525344011,22666.142845974035,252232,192137.63333333333,51.87915993381425,63.39737236517812,NaN,NaN,NaN,NaN,103.771699814364,27.311361307843978,7343398,-36.732980530666666,56.377881710875954,93.11086224154262
2025-07-02T10:00:00-04:00,22706.5,22850,22702.75,22825.5,22562.122243537182,NaN,NaN,NaN,NaN,NaN,22504.53,23162.695918595175,21846.364081404823,22680.426958372784,22744.39317170342,22797.58721048266,22691.199132924183,433267,189509.2,60.70692309443145,62.07091575248122,NaN,NaN,NaN,NaN,106.87729268476656,25.642673659338737,7776665,-27.89346973988971,58.24402506668048,86.13749480657019
2025-07-02T14:00:00-04:00,22825.5,22858.75,22813.25,22853.25,22562.122243537182,NaN,NaN,NaN,NaN,NaN,22521.225,23171.53102219273,21870.91897780727,22652.516566698225,22760.19459136761,22820.68459195865,22699.70459077657,163371,189055.6,62.44091295023291,61.365550160398584,NaN,NaN,NaN,NaN,102.49320035014037,24.183077388418244,7940036,-19.9051727774864,61.2560288347122,81.1612016121986
2025-07-02T18:00:00-04:00,22846.75,22871.5,22831,22850,22562.122243537182,NaN,NaN,NaN,NaN,NaN,22541.45,23168.065823291967,21914.834176708035,22646.731682989277,22850.833333333332,22850.833333333332,22850.833333333332,34013,188575.6,62.09529660216921,60.68945422552833,NaN,NaN,NaN,NaN,98.06511461084463,22.964157255612115,7906023,-14.80213954194376,62.6585271847689,77.46066672671266
2025-07-02T22:00:00-04:00,22850.25,22882.25,22827,22873.25,22562.122243537182,NaN,NaN,NaN,NaN,NaN,22561.435,23164.939704289565,21957.930295710437,22674.810346391423,22856.01323838541,22861.01000076922,22851.0164760016,36552,188716.23333333334,63.64556437593021,59.96685047622609,NaN,NaN,NaN,NaN,95.00689213864145,21.951494483064042,7942575,-10.050137986771063,64.89799424324883,74.9481322300199
2025-07-03T02:00:00-04:00,22873,22901.25,22845,22849.75,22576.82528629636,NaN,NaN,NaN,NaN,NaN,22583.645,23144.729468596095,22022.560531403906,22707.173277113136,22859.79583133362,22865.77751579452,22853.81414687272,48202,188206.1,60.932906045325645,58.9018272348033,NaN,NaN,NaN,NaN,92.23854270016706,21.22659145147588,7894373,-8.727833548141689,64.03834029484278,72.76617384298447
2025-07-03T06:00:00-04:00,22850.25,23004.75,22830,22997.5,22610.713909646525,NaN,NaN,NaN,NaN,NaN,22607.42,23134.88551963151,22079.954480368488,22762.11362169051,22915.27053741467,22955.40297553273,22875.138099296615,228668,187537.06666666668,69.68213653480186,59.08000077095978,NaN,NaN,NaN,NaN,98.1322182215837,21.57693360812707,8123041,1.3241532253252473,74.42136537464103,73.09721214931578
2025-07-03T10:00:00-04:00,22995.25,23101.25,22995,23059,22740.9144137535,NaN,NaN,NaN,NaN,NaN,22630.93,23131.327982010254,22130.532017989746,22854.01589735241,22979.992893054827,23054.0948789641,22905.890907145553,313374,184166.23333333334,72.44807785865989,59.54699184955386,NaN,NaN,NaN,NaN,98.71205977718486,22.642239078131325,8436415,10.81350249010589,86.61409026194815,75.80058777184226
2025-07-03T18:00:00-04:00,23059,23062.25,23016.5,23027.25,22740.9144137535,NaN,NaN,NaN,NaN,NaN,22652.97,23123.269815436874,22182.67018456313,22854.01589735241,23035.333333333332,23035.333333333332,23035.333333333332,37617,178587.56666666668,68.95074759044785,60.15770138500957,NaN,NaN,NaN,NaN,94.92905550738594,23.63145130027813,8398798,13.477110785161614,92.64697625329427,79.16986546813266
2025-07-03T22:00:00-04:00,23027.5,23030.5,22987.25,23005.5,22740.9144137535,NaN,NaN,NaN,NaN,NaN,22672.055,23120.052547872572,22224.05745212743,22854.01589735241,23022.662792118197,23036.4088150766,23008.916769159794,31961,177853.53333333333,66.57963907311736,60.890941238395676,NaN,NaN,NaN,NaN,91.23769439971552,24.09193022975729,8366837,12.330305705294109,94.58274759975029,82.25244189445618
2025-07-04T02:00:00-04:00,23005,23007,22909.5,22946,22740.9144137535,NaN,NaN,NaN,NaN,NaN,22689.535,23109.865810315096,22269.204189684904,22854.01589735241,22988.161155850703,23023.75107812451,22952.571233576895,70616,179031.1,60.45491594760107,61.534120565707575,NaN,NaN,NaN,NaN,91.68500194259299,23.417999824163523,8296221,6.418104689311889,90.27507275609605,83.85696806678416
2025-07-04T06:00:00-04:00,22945.5,22950.5,22881.25,22923.5,22740.9144137535,NaN,NaN,NaN,NaN,NaN,22702.695,23110.10138544353,22295.28861455647,22854.01589735241,22962.72668545818,23006.678071188286,22918.775299728073,80473,179826.6,58.271911965231624,62.03134863659564,NaN,NaN,NaN,NaN,90.08250180383634,22.429131865175233,8215748,0.17559857075545438,84.07646628022849,83.90086770947303
2025-07-04T10:00:00-04:00,22924.25,22946,22895.5,22904.5,22740.9144137535,NaN,NaN,NaN,NaN,NaN,22714.895,23108.992412957472,22320.79758704253,22854.01589735241,22952.836556575578,22996.42004381824,22909.253069332914,58193,174580.76666666666,56.41920954135909,61.930891786085,NaN,NaN,NaN,NaN,87.25518024641944,21.510897331828964,8157555,-5.723732302333175,76.74620233155656,82.46993463388974
2025-07-06T18:00:00-04:00,22968.5,23027.25,22914.5,22943,22740.9144137535,NaN,NaN,NaN,NaN,NaN,22727.47,23109.571408529056,22345.368591470946,22854.01589735241,22955.028815500355,22992.947161822944,22917.110469177765,93269,161135.46666666667,59.24669906888512,62.41100718442909,NaN,NaN,NaN,NaN,89.79052451453234,21.490340112898494,8250824,-7.416153694200631,73.19974251613894,80.61589621033957
2025-07-06T22:00:00-04:00,22942.5,22990.75,22931.75,22949.5,22740.9144137535,NaN,NaN,NaN,NaN,NaN,22740.595,23106.89057586734,22374.299424132663,22854.01589735241,22955.296379539675,22990.953235398556,22919.639523680795,48881,150713,59.72182960969108,62.97119787556314,NaN,NaN,NaN,NaN,87.59120133492289,21.471251266748773,8299705,-8.408308526425046,70.10551055230826,78.5138190787333
2025-07-07T02:00:00-04:00,22949.5,22965.75,22908.25,22964.5,22740.9144137535,NaN,NaN,NaN,NaN,NaN,22751.535,23111.19200340739,22391.87799659261,22854.01589735241,22954.260422610932,22987.958017973804,22920.56282724806,53887,149755.86666666667,60.85599908460927,62.98184616057585,NaN,NaN,NaN,NaN,85.44182981099982,21.09485024825345,8353592,-8.347925071310911,68.07891273959467,76.42683781090558
2025-07-07T06:00:00-04:00,22964.25,23002.75,22900.25,22945.25,22740.9144137535,NaN,NaN,NaN,NaN,NaN,22762.25,23112.302738883838,22412.197261116162,22854.01589735241,22952.7574094783,22980.832234723053,22924.68258423355,213658,155205.36666666667,58.57641727308674,62.70581075506541,NaN,NaN,NaN,NaN,86.66027053878555,21.138152528359857,8139934,-9.797724785150166,64.17968182946788,73.97740661461805
2025-07-07T10:00:00-04:00,22945,22963,22833.25,22871,22740.9144137535,NaN,NaN,NaN,NaN,NaN,22771.685,23107.22255095347,22436.147449046533,22841.587717881925,22923.041726016065,22960.849848828722,22885.233603203407,602528,172960.66666666666,50.68929702365477,61.89109649945725,NaN,NaN,NaN,NaN,89.73810835744372,20.192068172934803,7537406,-15.60571766881165,54.47025952860349,70.07597719741514
2025-07-07T14:00:00-04:00,22871.25,22892.75,22780.25,22838,22740.9144137535,NaN,NaN,NaN,NaN,NaN,22779.915,23101.060007901156,22458.769992098845,22832.34517430554,22909.190017604466,22956.086540689786,22862.293494519145,247731,174287.73333333334,47.62034327086148,60.74643784909519,NaN,NaN,NaN,NaN,91.36395776048346,18.86522968512236,7289675,-21.172829795110573,43.60993995352692,64.78276974863749
2025-07-07T18:00:00-04:00,22840.25,22923,22809.5,22893.5,22740.9144137535,NaN,NaN,NaN,NaN,NaN,22789.275,23095.48898155509,22483.061018444914,22817.39078339555,22875.333333333332,22875.333333333332,22875.333333333332,65050,161939.4,52.79654925539785,60.16526950695749,NaN,NaN,NaN,NaN,92.94510363473465,17.775264642919083,7354725,-20.601004902662112,39.03151362030985,59.632518522971964
2025-07-07T22:00:00-04:00,22893.5,22938.75,22885.5,22933.25,22740.9144137535,NaN,NaN,NaN,NaN,NaN,22797.49,23096.59173787459,22498.388262125412,22817.39078339555,22891.888250038268,22913.138942144913,22870.637557931623,39478,153594.63333333333,56.13965260724217,59.197949226417514,NaN,NaN,NaN,NaN,90.10973908939647,16.955996962091156,7394203,-17.169563571398157,38.17056405872427,55.340127630122424
2025-07-08T02:00:00-04:00,22934,22972,22915.75,22924.25,22740.9144137535,NaN,NaN,NaN,NaN,NaN,22807.725,23087.85156514583,22527.598434854168,22817.39078339555,22908.116281024606,22935.765290576684,22880.467271472528,58058,153657.8,55.186636933037214,57.964989160301606,NaN,NaN,NaN,NaN,87.69118629729671,16.59588664497313,7336145,-15.19763008371774,36.34309002547525,51.54072010919299
2025-07-08T06:00:00-04:00,22924.75,22957,22880,22881.25,22740.9144137535,NaN,NaN,NaN,NaN,NaN,22815.895,23079.826261695292,22551.96373830471,22817.39078339555,22907.02621168078,22925.883223266104,22888.169200095454,187967,158453.46666666667,50.75353940169774,56.66518857539088,NaN,NaN,NaN,NaN,86.92753013320409,15.743310383274316,7148178,-16.379021945597195,31.066942677196494,47.44596462279369
2025-07-08T10:00:00-04:00,22881.75,22962.75,22841,22934,22740.9144137535,NaN,NaN,NaN,NaN,NaN,22825.215,23071.681407650118,22578.748592349883,22802.17208109852,22910.474980113097,22922.398892547295,22898.551067678898,573422,175229.66666666666,55.47833914484511,55.87223858051429,NaN,NaN,NaN,NaN,89.4148494094038,14.814972870185574,7721600,-13.327054118267839,30.787146974958887,44.114201093226725
2025-07-08T14:00:00-04:00,22934,22942.5,22870,22903.5,22740.9144137535,NaN,NaN,NaN,NaN,NaN,22833.06,23063.502781618045,22602.617218381958,22802.17208109852,22909.686115862783,22920.812630470416,22898.55960125515,167454,174370.53333333333,52.35086108575578,55.2933775189539,NaN,NaN,NaN,NaN,88.20664588016066,13.952945179460313,7554146,-13.064133108892939,27.78403470711055,40.84816781600349
2025-07-08T18:00:00-04:00,22909,22924,22853,22889.75,22740.9144137535,NaN,NaN,NaN,NaN,NaN,22839.855,23056.11052224181,22623.59947775819,22802.17208109852,22888.916666666668,22888.916666666668,22888.916666666668,52168,153321.33333333334,50.956241531855035,54.77082963085559,NaN,NaN,NaN,NaN,86.97759974586347,13.39242526244261,7501978,-13.464393695063492,24.017675697174127,37.48206939223762
2025-07-08T22:00:00-04:00,22890.5,22900.75,22868.25,22874,22740.9144137535,NaN,NaN,NaN,NaN,NaN,22846.455,23045.66109152277,22647.248908477235,22765.156827534363,22885.88568431679,22889.733855682967,22882.03751295061,32364,146071.9,49.33499322022489,54.264814179346,NaN,NaN,NaN,NaN,83.08634262115893,12.871942482354742,7469614,-14.356288586868445,19.53670865865206,33.892997245520505
2025-07-09T02:00:00-04:00,22874.25,22942.5,22843.25,22924,22740.9144137535,NaN,NaN,NaN,NaN,NaN,22852.135,23043.512067853742,22660.757932146254,22765.156827534363,22893.14153335308,22902.19504573487,22884.08802097129,60677,146634.33333333334,54.305392009471944,53.9118636751022,NaN,NaN,NaN,NaN,84.24088957679044,12.195214513891427,7530291,-11.280843451210046,19.791942931507947,31.072786382717993
2025-07-09T06:00:00-04:00,22924.5,23097,22910,23085.5,22740.9144137535,NaN,NaN,NaN,NaN,NaN,22860.39,23055.671902899394,22665.108097100605,22846.957778717733,22973.66146510961,23041.76072043576,22905.56220978346,204510,151716,65.93128035769642,54.3553958713883,NaN,NaN,NaN,NaN,91.58082603559112,13.381904202493303,7734801,1.261414477341031,32.64955447939428,31.38814000205325
2025-07-09T10:00:00-04:00,23085.75,23111.25,22917,22983.5,22740.9144137535,NaN,NaN,NaN,NaN,NaN,22866.445,23057.806471827334,22675.083528172665,22846.957778717733,22992.713524488478,23036.652770438828,22948.774278538127,594732,169479.1,56.20496776052537,54.02317934823946,NaN,NaN,NaN,NaN,98.91433846162032,14.613310700841332,7140069,2.26097194142163,34.21435492883029,31.95338298740866
2025-07-09T14:00:00-04:00,22983.5,23060.5,22981.75,23043.25,22740.9144137535,NaN,NaN,NaN,NaN,NaN,22873.135,23065.362917067636,22680.90708293236,22846.957778717733,22998.440097704737,23040.79399510102,22956.086200308455,179923,167068.8,59.93367781621885,54.12012652989175,NaN,NaN,NaN,NaN,97.47402857150459,15.7567595921645,7319992,6.290743829787502,39.81681277464304,33.52606894485554
2025-07-09T18:00:00-04:00,23043.25,23066,22988.25,22990.75,22740.9144137535,NaN,NaN,NaN,NaN,NaN,22878.055,23069.478073060294,22686.631926939706,22846.957778717733,23015,23015,23015,53341,154404.6,55.465192212500895,54.46126190052361,NaN,NaN,NaN,NaN,96.06516938782569,16.874380258317927,7266651,4.830677471807199,39.56441578461454,34.73373831280734
2025-07-09T22:00:00-04:00,22990.25,23021.5,22978,22992.5,22740.9144137535,NaN,NaN,NaN,NaN,NaN,22882.615,23073.863142735187,22691.366857264817,22846.957778717733,23007.655111101372,23016.36213763477,22998.948084567975,37957,150224.13333333333,55.58406751828874,55.03009934676842,NaN,NaN,NaN,NaN,92.31051443155242,17.70457796538367,7304608,3.457324118990499,39.055393461545464,35.598069342554965
2025-07-10T02:00:00-04:00,22992,23050,22980.5,23024.5,22740.9144137535,NaN,NaN,NaN,NaN,NaN,22888.385,23078.998514998857,22697.77148500114,22846.957778717733,23011.710189135574,23020.305524394884,23003.114853876265,55898,150953.63333333333,57.802156356874235,55.38764271115959,NaN,NaN,NaN,NaN,90.68119197215582,18.79271357746352,7360506,4.132918639490143,40.76421764191764,36.6312990024275
2025-07-10T06:00:00-04:00,23024.5,23089.75,22939,22960,22740.9144137535,NaN,NaN,NaN,NaN,NaN,22892.78,23079.624926075314,22705.935073924684,22846.957778717733,23002.23974545244,23011.478187650617,22993.001303254263,232733,157493,52.149122612311444,55.10260485437883,NaN,NaN,NaN,NaN,94.97182111700182,18.960307791348967,7127773,-0.11048610485189414,36.49319137136263,36.60367747621452
2025-07-10T10:00:00-04:00,22960,23041,22901,23036.5,22740.9144137535,NaN,NaN,NaN,NaN,NaN,22897.05,23087.05260524532,22707.047394754678,22846.957778717733,22996.869105131467,23004.504099568516,22989.23411069442,505594,172739.4,57.462774518875676,55.26518611051015,NaN,NaN,NaN,NaN,98.18811960864456,18.419548356936836,7633367,1.7839644155171612,38.83363299561097,37.04966858009381
2025-07-10T14:00:00-04:00,23036.75,23050,22990.5,23009.75,22740.9144137535,NaN,NaN,NaN,NaN,NaN,22899.725,23092.216616701287,22707.23338329871,22846.957778717733,22999.87405131646,23009.883726606044,22989.864376026875,157677,170373.03333333333,55.15631685301218,55.579670214175465,NaN,NaN,NaN,NaN,95.42468249374137,18.044725925736866,7475690,0.8329536741481078,38.090860672778945,37.25790699863084
2025-07-10T18:00:00-04:00,23010.75,23048.75,22830.75,22926.5,22740.9144137535,NaN,NaN,NaN,NaN,NaN,22900.64,23093.197060634127,22708.08293936587,22846.957778717733,22935.333333333332,22935.333333333332,22935.333333333332,148042,164861.96666666667,48.61620614093927,55.089517856753616,NaN,NaN,NaN,NaN,104.18006231561698,18.0599381611383,7327648,-5.459279981412266,30.433807021865505,35.89308700327777
2025-07-10T22:00:00-04:00,22927,22978,22918.25,22942,22740.9144137535,NaN,NaN,NaN,NaN,NaN,22902.94,23094.669198611937,22711.21080138806,22839.250011944183,22937.735742485278,22942.21394843865,22933.257536531906,42606,165028.26666666666,49.809489528371515,54.90799131694046,NaN,NaN,NaN,NaN,101.00648643593004,18.074063808296774,7370254,-8.455002291881485,25.32433413842591,33.779336430307396
2025-07-11T02:00:00-04:00,22942.25,22969.75,22858.75,22864.75,22740.9144137535,NaN,NaN,NaN,NaN,NaN,22903.815,23094.436531050964,22713.193468949034,22839.250011944183,22925.223076641236,22944.13180985081,22906.314343431663,86831,166857.26666666666,44.28914483871861,54.431770124573575,NaN,NaN,NaN,NaN,101.7203088333636,18.7125867122717,7283423,-15.127312100172581,14.870196305091667,29.99750840526425
2025-07-11T06:00:00-04:00,22864.25,22967.75,22852.75,22964,22740.9144137535,NaN,NaN,NaN,NaN,NaN,22905.78,23096.81661010426,22714.74338989574,22839.250011944183,22926.590045393714,22940.506147711923,22912.673943075504,240581,172522.76666666666,51.69629662793916,54.60043465369603,NaN,NaN,NaN,NaN,102.66885820240906,19.36544610174199,7524004,-12.455966351105843,14.427550466381945,26.883516817487788
2025-07-11T10:00:00-04:00,22963.75,23021.75,22908.75,22998.5,22740.9144137535,NaN,NaN,NaN,NaN,NaN,22907.51,23100.299210279616,22714.72078972038,22839.250011944183,22950.645757015736,22977.440130010265,22923.851384021207,485149,186011.96666666667,53.986479412767665,54.57765518250286,NaN,NaN,NaN,NaN,103.40679690223699,19.05595865353957,8009153,-8.1720387390287,16.668468393701914,24.840507132730615
2025-07-11T14:00:00-04:00,22998.25,23018.5,22924.25,22937.25,22740.9144137535,NaN,NaN,NaN,NaN,NaN,22909.41,23101.460221556863,22717.359778443137,22839.250011944183,22952.189370256343,22976.918354343783,22927.460386168903,198264,190681,49.499422950340204,53.40395108197742,NaN,NaN,NaN,NaN,102.75273998064863,18.76857745163732,7810889,-9.193862201618305,13.348179380707734,22.54204158232604
2025-07-13T18:00:00-04:00,22864.5,22889.25,22802.25,22857.25,22740.9144137535,NaN,NaN,NaN,NaN,NaN,22909.93,23101.27037838348,22718.58962161652,22839.250011944183,22849.583333333332,22849.583333333332,22849.583333333332,100946,190936.9,44.31825407718064,52.55490010459565,NaN,NaN,NaN,NaN,105.05611569631658,19.76450016110314,7709943,-14.663288498839815,4.212930958776269,18.876219457616084
2025-07-13T22:00:00-04:00,22856.75,22879.5,22827,22831.25,22740.9144137535,NaN,NaN,NaN,NaN,NaN,22910.91,23100.114565483935,22721.705434516065,22803.930007644278,22848.59407279882,22850.221540812738,22846.966604784902,37298,190550.8,42.75203521402202,51.32763991872445,NaN,NaN,NaN,NaN,101.30210743229397,20.689285534178545,7672645,-19.154095277400096,-5.066399639134033,14.08769563826606
2025-07-14T02:00:00-04:00,22830.25,22903.5,22805,22899.5,22740.9144137535,NaN,NaN,NaN,NaN,NaN,22914.045,23097.094848129735,22730.995151870262,22803.930007644278,22855.78009882986,22865.736242995274,22845.823954664444,73298,191197.83333333334,47.951863294141,50.790973567413026,NaN,NaN,NaN,NaN,101.10195690141583,21.11841716998974,7745943,-16.737635916205743,-6.834349256991118,9.903286659214626
2025-07-14T06:00:00-04:00,22899,22979,22842.5,22911.75,22740.9144137535,NaN,NaN,NaN,NaN,NaN,22918.45,23090.112313860118,22746.787686139884,22748.499307923903,22885.37636868832,22913.7824788724,22856.970258504243,243547,192194.13333333333,48.84989887936292,50.30996152177547,NaN,NaN,NaN,NaN,103.6303885513147,20.312386350868312,7989490,-13.654151463183675,-7.164402669764968,6.489748793418707
2025-07-14T10:00:00-04:00,22912,23067.75,22905.5,23044.75,22740.9144137535,NaN,NaN,NaN,NaN,NaN,22925.545,23087.92596224768,22763.164037752318,22770.943173220505,22942.99890999465,23006.652081599976,22879.345738389326,416237,185984.43333333332,57.43657632686551,50.28384866248913,NaN,NaN,NaN,NaN,107.81750365479222,19.290330362133982,8405727,-2.5771264761490853,3.2683406982323504,5.845467174381436
2025-07-14T14:00:00-04:00,23045,23060,23016,23036.25,22740.9144137535,NaN,NaN,NaN,NaN,NaN,22930.885,23089.880949949256,22771.88905005074,22800.5545385764,22956.454825495017,23024.010073373793,22888.89957761624,144815,182553.9,56.78053663870183,50.61466395008845,NaN,NaN,NaN,NaN,103.25911053659277,18.341278372594957,8260912,3.90509326559018,10.72683375636916,6.82174049077898
2025-07-14T18:00:00-04:00,23036.5,23173.75,22996.25,23143,22769.726935311177,NaN,NaN,NaN,NaN,NaN,22939.47,23096.98989207672,22781.950107923283,22877.443630861122,23104.333333333332,23104.333333333332,23104.333333333332,80799,183078.86666666667,62.56373078308511,50.97901796896055,NaN,NaN,NaN,NaN,108.56203121255044,18.645094868861758,8341711,14.513654683042953,24.963808844582672,10.45015416153972
2025-07-14T22:00:00-04:00,23143,23170,23039.25,23147,22785.852983706125,NaN,NaN,NaN,NaN,NaN,22948.275,23101.947419450782,22794.60258054922,22877.443630861122,23112.372000865107,23119.532351035625,23105.21165069459,101837,185157.5,62.764787703966896,51.522480172600176,NaN,NaN,NaN,NaN,110.14688612593969,18.92721018682379,8443548,20.56206429089021,36.15273452515248,15.590670234262273
2025-07-15T02:00:00-04:00,23147.25,23181,23132,23174,22845.535802628572,NaN,NaN,NaN,NaN,NaN,22955.245,23117.3904128247,22793.099587175297,22914.563923751117,23124.867462471462,23147.37526220725,23102.359662735675,60912,185252.63333333333,64.16384756503905,52.6330259886073,NaN,NaN,NaN,NaN,105.77925140265828,19.29650021553313,8504460,24.856132627141385,46.660836018189,21.804703391047617
2025-07-15T06:00:00-04:00,23174,23222.75,23122.75,23138,22862.284175236367,NaN,NaN,NaN,NaN,NaN,22960.94,23128.27533876653,22793.60466123347,22959.601139000893,23144.298385696515,23168.029891106,23120.566880287028,280548,188338.66666666666,60.879300162909104,53.42372674821713,NaN,NaN,NaN,NaN,105.36644773103983,20.037959616742977,8223912,23.748346709148876,51.49013677748371,27.741790068334836
2025-07-15T10:00:00-04:00,23138.75,23198.25,23082.5,23170,22862.284175236367,NaN,NaN,NaN,NaN,NaN,22967.34,23141.550067447137,22793.129932552863,22959.601139000893,23147.419034489267,23164.053957716013,23130.78411126252,577725,188482.1,62.706758281108826,54.73927056553072,NaN,NaN,NaN,NaN,106.10813003596556,20.069651239687914,8801637,23.59832901790876,57.239701340720785,33.641372322812025
2025-07-15T14:00:00-04:00,23169.75,23180,23010.5,23018,22862.284175236367,NaN,NaN,NaN,NaN,NaN,22970.235,23142.898557532833,22797.571442467168,22959.601139000893,23132.65057550824,23166.663938130034,23098.637212886446,257673,191489.4,50.612552574743994,54.66186027601678,NaN,NaN,NaN,NaN,110.6361207476823,19.064797636034207,8543964,12.260250563676877,48.96668552740812,36.70643496373124
2025-07-15T18:00:00-04:00,23018.75,23033.5,22973.75,23030.5,22862.284175236367,NaN,NaN,NaN,NaN,NaN,22973.85,23143.819556098537,22803.88044390146,22959.601139000893,23012.583333333332,23012.583333333332,23012.583333333332,77256,192325.66666666666,51.441973780898834,54.48010987374043,NaN,NaN,NaN,NaN,107.00139783713357,17.743532987012728,8621220,4.974135286793157,42.92410407222269,37.94996878542953
2025-07-15T22:00:00-04:00,23030.5,23045.75,22993.75,23007,22862.284175236367,NaN,NaN,NaN,NaN,NaN,22974.04,23144.136071676334,22803.943928323668,22959.601139000893,23013.606422850997,23014.998291700394,23012.2145540016,41741,192638.23333333334,49.75037468966822,54.49803499797815,NaN,NaN,NaN,NaN,103.0727265630526,16.59194915774897,8579479,-1.699110725472579,35.82608037858881,37.52519110406139
2025-07-16T02:00:00-04:00,23006.5,23014.5,22928.5,23000.75,22862.284175236367,NaN,NaN,NaN,NaN,NaN,22972.875,23141.41835495638,22804.33164504362,22959.601139000893,23001.43906550681,23017.150728964294,22985.727402049324,71716,193006.2,49.28617825409387,54.85288672490052,NaN,NaN,NaN,NaN,101.85324609426313,16.096527716800324,8507763,-6.5336722550535455,29.35810078524446,35.891773040298006
2025-07-16T06:00:00-04:00,23001,23090,22957.5,22967.75,22862.284175236367,NaN,NaN,NaN,NaN,NaN,22971.685,23139.51458052604,22803.855419473963,22959.601139000893,23003.537463309243,23013.927766424116,22993.14716019437,258878,194818.46666666667,46.803055129397436,55.142245290284485,NaN,NaN,NaN,NaN,104.0422999446729,15.208602068574164,8248885,-11.654577214434404,21.323551522255002,32.978128736689406
2025-07-16T10:00:00-04:00,22968.25,23068,22835.75,23028,NaN,NaN,NaN,23276.66165155622,23276.66165155622,23276.66165155622,22972.135,23140.44480987538,22803.82519012462,22959.601139000893,22986.999057493773,23001.18608275768,22972.812032229867,762691,200417.1,51.59780506644573,55.40266970259196,NaN,NaN,NaN,NaN,113.19999280576769,15.150484650459608,9011576,-10.708950098414682,19.591941113671055,30.300891212085737
2025-07-16T14:00:00-04:00,23028.5,23100,23016.25,23063,NaN,NaN,NaN,23276.66165155622,NaN,NaN,22974.475,23144.51076829709,22804.43923170291,22959.601139000893,22995.513687763963,23022.433265841846,22968.59410968608,160690,199776,54.18135685365876,55.78348812932738,NaN,NaN,NaN,NaN,111.09642189107,14.712514819131956,9172266,-7.597497689706422,20.80401909995271,28.401516789659134
2025-07-16T18:00:00-04:00,23069.25,23071,23024.75,23034,NaN,NaN,NaN,23276.66165155622,NaN,NaN,22976.685,23146.88549382961,22806.484506170393,22959.601139000893,23043.25,23043.25,23043.25,52823,199758.73333333334,51.71810209173659,55.37502568396103,NaN,NaN,NaN,NaN,106.46453461313642,14.305828547184849,9119443,-7.358669673524496,19.203179697753512,26.561849371278008
2025-07-16T22:00:00-04:00,23033.75,23100,23017,23087.25,NaN,NaN,NaN,23276.66165155622,NaN,NaN,22980.34,23152.025432113343,22808.654567886657,22929.855911200717,23053.754553167008,23066.023107813213,23041.485998520802,38725,199784.33333333334,55.70066764253403,55.29789218423475,NaN,NaN,NaN,NaN,104.78849642648382,13.561661634688557,9158168,-3.667091988154283,21.977984386085154,25.645076374239437
2025-07-17T02:00:00-04:00,23087,23151.75,23086.5,23109,NaN,NaN,NaN,23276.66165155622,NaN,NaN,22983.66,23158.715784251905,22808.604215748095,22918.480871226184,23082.778633367412,23114.98133624646,23050.575930488365,80588,200607.33333333334,57.25170317872647,54.91846164106628,NaN,NaN,NaN,NaN,101.96431811030641,12.930838621432441,9238756,-0.006814669162736209,25.636558037786017,25.643372706948753
2025-07-17T06:00:00-04:00,23109,23158.5,23065.75,23150,NaN,NaN,NaN,23276.66165155622,NaN,NaN,22987.67,23168.502448416693,22806.837551583303,22925.509696980946,23107.34121952669,23136.628329712712,23078.05410934067,242872,200945.3,60.08852234894496,54.72729982999328,NaN,NaN,NaN,NaN,101.30615253099882,12.08638613311415,9481628,4.670471961685781,31.48146265905598,26.810990697370197
2025-07-17T10:00:00-04:00,23150.5,23276,23114.5,23275.75,NaN,NaN,NaN,23276.66165155622,NaN,NaN,22993.895,23191.737439582375,22796.052560417626,23008.85775758476,23165.283073817795,23226.239721322465,23104.326426313124,423349,198203.8,67.26395193405526,54.948735856351576,NaN,NaN,NaN,NaN,105.6057130644989,12.532426858429984,9904977,15.137911290634147,45.73337981066288,30.595468520028735
2025-07-17T14:00:00-04:00,23275.75,23281,23234.25,23265.5,22951.840312778233,22951.840312778233,22951.840312778233,NaN,NaN,NaN,23000.3,23211.699550614987,22788.90044938501,23043.911206067805,23183.26545244044,23249.571505107066,23116.959399773812,195827,199475.46666666667,66.2189124516931,55.330136734121865,NaN,NaN,NaN,NaN,101.40173355989184,12.992795620825499,9709150,19.972081049483563,55.560569831883186,35.58848878239962
2025-07-17T18:00:00-04:00,23260,23288.5,23245.5,23267,22969.25098037922,NaN,NaN,NaN,NaN,NaN,23008.22,23229.108425228504,22787.3315747715,23077.328964854245,23267,23267,23267,44661,196029.43333333332,66.30142385004038,55.58689856047412,NaN,NaN,NaN,NaN,97.23018116275671,13.493366891982353,9753811,21.72634854672642,62.74642446580765,41.02007591908123
2025-07-17T22:00:00-04:00,23266.25,23309,23260,23303.5,22993.603208543802,NaN,NaN,NaN,NaN,NaN,23017.53,23247.969203262757,22787.09079673724,23115.563171883397,23276.84932844612,23288.58530122818,23265.113355664056,31456,195657.76666666666,68.32861045074783,56.85233126590297,NaN,NaN,NaN,NaN,93.7851682225598,14.162988048103736,9785267,23.642330863515888,70.57298949847609,46.9306586349602
2025-07-18T02:00:00-04:00,23303,23309.5,23260.5,23278.5,23000.64397179181,NaN,NaN,NaN,NaN,NaN,23025.23,23264.150108823313,22786.309891176687,23130.250537506716,23279.094398658148,23288.81307865636,23269.375718659936,45705,194286.9,65.42551603691668,57.85115571276138,NaN,NaN,NaN,NaN,90.5862276352341,14.78996092856382,9739562,21.580561958025733,73.90636108249237,52.325799124466634
2025-07-18T06:00:00-04:00,23277.75,23320.5,23251,23259.5,23004.841973074002,NaN,NaN,NaN,NaN,NaN,23031.755,23277.97905426755,22785.53094573245,23142.350430005372,23277.752912077965,23283.666006754927,23271.839817401004,217054,193502.66666666666,63.226854283150765,58.81376139801013,NaN,NaN,NaN,NaN,89.08006851843166,15.49212996075584,9522508,17.46741649810115,74.16006974709308,56.692653248991924
2025-07-18T10:00:00-04:00,23257.5,23293.25,23170,23198.5,23004.841973074002,NaN,NaN,NaN,NaN,NaN,23037.24,23285.84746086908,22788.632539130922,23142.350430005372,23242.526644308124,23270.56949349349,23214.483795122756,544008,195464.63333333333,56.64519686668515,59.339405584623805,NaN,NaN,NaN,NaN,91.52077790997225,14.832235090500795,8978500,9.563972181448882,68.64761847580303,59.083646294354146
2025-07-18T14:00:00-04:00,23199.25,23231.5,23193,23228.75,23004.841973074002,NaN,NaN,NaN,NaN,NaN,23044.19,23294.389751399354,22793.990248600643,23142.350430005372,23238.833979509975,23266.166261973834,23211.501697046115,154629,194010.13333333333,58.92845476172476,60.20550555836147,NaN,NaN,NaN,NaN,87.73357948783139,14.219475568121112,9133129,5.500717178759253,65.95954276780321,60.45882558904396
2025-07-20T18:00:00-04:00,23240,23278,23204.5,23264.75,23004.841973074002,NaN,NaN,NaN,NaN,NaN,23050.805,23306.43221470897,22795.17778529103,23142.350430005372,23249.083333333332,23249.083333333332,23249.083333333332,54055,192447.1,61.52534889319526,60.914615831700715,NaN,NaN,NaN,NaN,86.71689523870057,14.248834016420412,9187184,4.411835302503455,65.97361971717328,61.56178441466982
2025-07-20T22:00:00-04:00,23264.5,23276,23242.25,23268.25,23004.841973074002,NaN,NaN,NaN,NaN,NaN,23058.1,23317.289293760663,22798.910706239334,23142.350430005372,23253.619896592423,23259.84669055457,23247.393102630278,28692,192160.23333333334,61.77837919228164,61.457260284459494,NaN,NaN,NaN,NaN,82.9335455787934,14.27609543269833,9215876,3.1601843268051724,65.51201482317629,62.351830496371115
2025-07-21T02:00:00-04:00,23268.5,23309,23265.75,23289.5,23026.82132980653,NaN,NaN,NaN,NaN,NaN,23066.095,23328.658799674857,22803.531200325146,23156.88134890416,23265.973175865838,23283.23608122473,23248.710270506945,46232,191258.03333333333,63.35416795384104,62.28840784603839,NaN,NaN,NaN,NaN,80.09900660887958,14.71915606999204,9262108,2.9976872787852784,66.09893959485271,63.10125231606743
2025-07-21T06:00:00-04:00,23289.25,23396,23223.5,23375.5,23037.516951178965,NaN,NaN,NaN,NaN,NaN,23076.125,23346.76095936237,22805.48904063763,23188.05507912333,23307.56837241602,23340.910407479587,23274.22633735245,222626,190560.66666666666,68.93593149577168,63.233783835555364,NaN,NaN,NaN,NaN,86.69907756538818,16.055469176786907,9484734,7.651730572502572,72.66591553169565,65.01418495919307
2025-07-21T10:00:00-04:00,23376.25,23425,23358.75,23411.75,23122.98208976174,NaN,NaN,NaN,NaN,NaN,23085.88,23368.76399106317,22802.996008936832,23225.519063298663,23354.87429381615,23405.83607859647,23303.91250903583,381266,189394.96666666667,70.94485819314937,64.21186633658557,NaN,NaN,NaN,NaN,85.23842916786045,17.55893399394457,9866000,11.888346783941728,79.87461843912024,67.98627165517851
2025-07-21T14:00:00-04:00,23411.5,23417.5,23328.25,23346.75,23122.98208976174,NaN,NaN,NaN,NaN,NaN,23091.105,23383.26658354605,22798.94341645395,23225.519063298663,23356.99925336272,23401.926238662443,23312.072268062995,217278,191810.4,63.06877685445051,64.4247416584074,NaN,NaN,NaN,NaN,85.5249699415847,18.37851793709152,9648722,9.152602956005538,79.42702535018543,70.2744223941799
2025-07-21T18:00:00-04:00,23338,23367.75,23333.25,23365.25,23122.98208976174,NaN,NaN,NaN,NaN,NaN,23098.74,23399.092042776207,22798.387957223797,23225.519063298663,23355.416666666668,23355.416666666668,23355.416666666668,41557,190502.33333333334,64.28410582411084,64.21189550769708,NaN,NaN,NaN,NaN,81.8803292314715,19.139560170013684,9690279,7.4980454397744865,79.646979193898,72.14893375412352
2025-07-21T22:00:00-04:00,23365.5,23366.25,23297.25,23314,23122.98208976174,NaN,NaN,NaN,NaN,NaN,23104.155,23410.022093522664,22798.287906477333,23225.519063298663,23340.32903062889,23355.117735941556,23325.540325316226,43254,188549.56666666668,58.537141580399805,63.663197588318994,NaN,NaN,NaN,NaN,80.96030571493783,19.158924938957515,9647025,2.1395175831456896,74.82333073305563,72.68381314990994
2025-07-22T02:00:00-04:00,23314.5,23347.75,23267.25,23282,23122.98208976174,NaN,NaN,NaN,NaN,NaN,23109.98,23418.071558469328,22801.88844153067,23225.519063298663,23321.16055039588,23344.442597630918,23297.878503160846,73360,188964.5,55.217779576295904,62.87150871162296,NaN,NaN,NaN,NaN,80.9274267352994,18.641887965856423,9573665,-4.036070605082287,67.63872489355708,71.67479549863937
2025-07-22T06:00:00-04:00,23282.25,23349.75,23112,23142.5,NaN,NaN,NaN,23489.4941939553,23489.4941939553,23489.4941939553,23112.98,23419.35377237629,22806.60622762371,23225.519063298663,23241.77896785651,23299.974624348084,23183.583311364935,311079,189982.2,43.6085443776863,61.10578970640427,NaN,NaN,NaN,NaN,92.12903911134946,18.52963192091732,9262586,-17.25124168163812,50.110743396591715,67.36198507822984
2025-07-22T10:00:00-04:00,23142.25,23250.5,23105,23217.75,NaN,NaN,NaN,23463.677455850437,NaN,NaN,23116.845,23423.53210259761,22810.15789740239,23225.519063298663,23214.76052715569,23261.893123744467,23167.627930566912,535469,188573.66666666666,49.74630127476457,59.98584579482198,NaN,NaN,NaN,NaN,95.94125060339593,18.498973249942978,9798055,-20.441763454148244,41.80978076054453,62.25154421469277
2025-07-22T14:00:00-04:00,23217.25,23257,23171,23198.5,NaN,NaN,NaN,23463.677455850437,NaN,NaN,23121.615,23425.804648245412,22817.42535175459,23225.519063298663,23213.703892291232,23256.48948295827,23170.918301624195,217967,187250.13333333333,48.29807924149355,58.91950472041789,NaN,NaN,NaN,NaN,95.23116127458194,18.36700590792633,9580088,-23.165955146121618,33.294100282040745,56.46005542816236
2025-07-22T18:00:00-04:00,23190,23267,23170.25,23251.75,NaN,NaN,NaN,23463.677455850437,NaN,NaN,23125.92,23431.259899784323,22820.580100215673,23225.519063298663,23229.666666666668,23229.666666666668,23229.666666666668,94970,187840.6,52.42413077740551,58.617999999755064,NaN,NaN,NaN,NaN,95.33964975496895,18.078466059896446,9675058,-20.775473023376243,30.49071414894206,51.266187172318304
2025-07-22T22:00:00-04:00,23251.5,23259.75,23226.25,23250.75,NaN,NaN,NaN,23463.677455850437,NaN,NaN,23130.74,23436.201109799113,22825.27889020089,23225.519063298663,23234.050960010172,23241.16160749607,23226.940312524275,36105,187652.73333333334,52.33965661179685,58.147371560474504,NaN,NaN,NaN,NaN,90.92253191532829,17.810536201011548,9638953,-18.71928222086047,27.867084396242717,46.58636661710319
2025-07-23T02:00:00-04:00,23251,23283.25,23243,23271.75,NaN,NaN,NaN,23463.677455850437,NaN,NaN,23137.645,23439.918652341592,22835.37134765841,23213.29025063893,23243.476897667584,23259.223184333525,23227.730611001643,54855,187090.7,54.01540576703003,57.6109470514627,NaN,NaN,NaN,NaN,87.3030653499477,17.14117322277681,9693808,-15.533754026439155,27.169174084054248,42.7029281104934
2025-07-23T06:00:00-04:00,23272,23281.5,23157.75,23165.75,NaN,NaN,NaN,23463.677455850437,NaN,NaN,23142.12,23439.256824376178,22844.98317562382,23187.255760408916,23219.38297929315,23242.44632102589,23196.31963756041,252862,186890.16666666666,45.348132275656496,56.43735798598948,NaN,NaN,NaN,NaN,89.90641782495143,17.615073066383165,9440946,-19.876808422715193,17.856917582099413,37.733726004814606
2025-07-23T10:00:00-04:00,23165.5,23294,23142.5,23263,NaN,NaN,NaN,23463.677455850437,NaN,NaN,23150.085,23438.270280852747,22861.89971914725,23187.255760408916,23227.10141516845,23243.86072941813,23210.34210091877,558392,180080.2,52.82686518647939,55.685407788320795,NaN,NaN,NaN,NaN,94.30595940888348,18.225317352720843,9999338,-15.694719007954184,18.115327244871878,33.81004625282606
2025-07-23T14:00:00-04:00,23263.5,23416.5,23263.5,23410.75,NaN,NaN,NaN,23463.677455850437,NaN,NaN,23159.02,23451.247494257164,22866.792505742837,23164.304608327133,23254.397098036166,23311.00994097515,23197.784255097184,249288,183033.46666666667,61.4565699586234,55.15116767852449,NaN,NaN,NaN,NaN,98.53410516539181,16.97315739055408,10248626,-3.129903187485347,29.897667268469377,33.027570455954724
2025-07-23T18:00:00-04:00,23401,23422.5,23380.25,23408.75,NaN,NaN,NaN,23463.677455850437,NaN,NaN,23167.225,23463.96645733332,22870.483542666676,23176.526334398077,23403.83333333333,23403.83382161458,23403.83284505208,51302,182982.76666666666,61.293114255360344,54.46175739725384,NaN,NaN,NaN,NaN,94.5138119392924,15.889192625919172,10197324,4.480813261784128,38.628587033184886,34.14777377140076
2025-07-23T22:00:00-04:00,23408.25,23415.25,23372.25,23373.5,NaN,NaN,NaN,23463.677455850437,NaN,NaN,23175.95,23470.7785264347,22881.1214735653,23196.97106751846,23397.843728156637,23405.902862758197,23389.784593555076,28337,182636.5,58.34755197688096,54.12452704885602,NaN,NaN,NaN,NaN,90.83425394362864,14.768550024252667,10168987,6.455279867921895,42.216873606303125,35.76159373838123
2025-07-24T02:00:00-04:00,23373.25,23397,23347.25,23390.25,NaN,NaN,NaN,23463.677455850437,NaN,NaN,23186.61,23472.997327931243,22900.222672068758,23197.50185401477,23389.876885617494,23401.36367484393,23378.390096391056,54181,181756.26666666666,59.347290419722256,53.77189737711397,NaN,NaN,NaN,NaN,87.8996643762266,14.058371277071336,10223168,8.097355092474352,45.88328760397417,37.785932511499816
2025-07-24T06:00:00-04:00,23390.25,23403,23326.75,23363.25,NaN,NaN,NaN,23463.677455850437,NaN,NaN,23197.25,23469.20319450222,22925.29680549778,23205.276483211816,23373.434922050776,23387.458567838075,23359.411276263476,241745,181718.7,56.973447398684534,53.66020493556288,NaN,NaN,NaN,NaN,87.06754549221041,13.687282616163321,9981423,6.634535239662185,46.07910156107755,39.444566321415365
2025-07-24T10:00:00-04:00,23363.25,23421.75,23298.5,23384,NaN,NaN,NaN,23463.677455850437,NaN,NaN,23206.94,23470.152073431535,22943.727926568463,23205.276483211816,23370.48758976175,23380.256871328158,23360.71830819534,460398,182953.66666666666,58.35218722101595,53.884091195900034,NaN,NaN,NaN,NaN,89.65200652848111,13.728224666578987,10441821,6.334482737507059,47.36266974329919,41.028187005792134
2025-07-24T14:00:00-04:00,23384.25,23425,23366.75,23395,NaN,NaN,NaN,23463.677455850437,NaN,NaN,23216.605,23471.09527663151,22962.11472336849,23220.03194925556,23375.267019667048,23388.47168306063,23362.062356273465,196661,182981.46666666667,59.10039826680863,54.990652187980196,NaN,NaN,NaN,NaN,87.40900606216103,13.706795491731933,10638482,6.142299742454895,48.70606168386075,42.56376194140586
2025-07-24T18:00:00-04:00,23391.25,23438.25,23385,23427,NaN,NaN,NaN,23463.677455850437,NaN,NaN,23224.25,23480.58975501309,22967.91024498691,23247.65055940445,23416.75,23416.75,23416.75,45077,182995.33333333334,61.27967739984713,55.814464768343235,NaN,NaN,NaN,NaN,84.96907705772095,13.435824287061942,10683559,7.353973211443147,51.75622845570979,44.40225524426664
2025-07-24T22:00:00-04:00,23427,23442,23392.75,23408,NaN,NaN,NaN,23463.677455850437,NaN,NaN,23231.685,23487.346021862442,22976.02397813756,23264.89544752356,23415.692279388237,23416.92740232518,23414.457156451295,33058,183048.73333333334,59.26062174168675,56.59750351835704,NaN,NaN,NaN,NaN,82.41771441074089,13.110749072206312,10650501,6.110576742228986,52.04047617205288,45.92989942982389
2025-07-25T02:00:00-04:00,23408,23413,23348.75,23374,NaN,NaN,NaN,23463.677455850437,NaN,NaN,23236.305,23493.731228072967,22978.878771927033,23264.89544752356,23399.62414129246,23418.034779096164,23381.213503488758,59669,183514.2,55.72250275167667,56.833101516519264,NaN,NaN,NaN,NaN,81.1200205242594,13.497009152571554,10590832,2.422378698182264,48.95787280255172,46.535494104369455
2025-07-25T06:00:00-04:00,23374,23408,23330.25,23389.75,NaN,NaN,NaN,23463.677455850437,NaN,NaN,23241.16,23500.812802026096,22981.507197973904,23264.89544752356,23385.615586864165,23402.128061569325,23369.103112159006,200761,182971.1,57.003149067849684,57.16620812052304,NaN,NaN,NaN,NaN,80.87930477252658,14.12158306999556,10791593,0.5645755105159225,47.24121349251436,46.67663798199844
2025-07-25T10:00:00-04:00,23389.5,23477,23383.5,23439,23174.78797273797,23174.78797273797,23174.78797273797,NaN,NaN,NaN,23246.46,23511.18180416474,22981.73819583526,23287.91246913206,23411.206348329448,23437.434263767787,23384.97843289111,394536,177988.7,60.81932520347457,57.652202365983364,NaN,NaN,NaN,NaN,81.78078300306039,13.347687246440215,11186129,2.088022427262203,49.2866660160762,47.198643588813994
2025-07-25T14:00:00-04:00,23439.25,23460,23406.75,23447.25,23182.263519431697,NaN,NaN,NaN,NaN,NaN,23252.645,23521.362064772457,22983.927935227544,23287.91246913206,23416.21204351575,23442.066454666416,23390.35763236508,168427,178448.63333333333,61.436769197982436,58.801390717578066,NaN,NaN,NaN,NaN,79.74286993141322,12.629069695995968,11354556,3.029626557000924,50.98567678506515,47.95605022806423
2025-07-27T18:00:00-04:00,23516,23557.5,23504.75,23542.25,23276.393586730257,NaN,NaN,NaN,NaN,NaN,23260.09,23539.643961875263,22980.536038124737,23360.05898024452,23534.833333333332,23534.833333333332,23534.833333333332,68904,178943.6,67.740985373628,59.86668501666012,NaN,NaN,NaN,NaN,81.92195065059799,12.987040702626087,11423460,9.086459660033498,59.3141248031061,50.2276651430726
2025-07-27T22:00:00-04:00,23541.75,23578,23537.25,23574,23308.91546915161,NaN,NaN,NaN,NaN,NaN,23271.21,23555.551965949497,22986.8680340505,23399.672184195617,23543.964013030807,23557.176597547194,23530.75142851442,32906,179084.06666666668,69.53358712459882,60.443614814229804,NaN,NaN,NaN,NaN,78.98109703269813,13.57749792748591,11456366,13.974732869331191,67.69608122973659,53.7213483604054
2025-07-28T02:00:00-04:00,23574,23585,23522.75,23526.75,23308.91546915161,NaN,NaN,NaN,NaN,NaN,23281.135,23565.819179575174,22996.450820424823,23411.212747356494,23544.25794228677,23555.01508720789,23533.500797365654,52008,179276.6,63.84742940147181,60.62606589609491,NaN,NaN,NaN,NaN,77.78601867321969,13.845740320835413,11404358,12.800877332286554,69.72244502576359,56.92156769347704
2025-07-28T06:00:00-04:00,23526.5,23527.25,23462.5,23520,23308.91546915161,NaN,NaN,NaN,NaN,NaN,23291.395,23572.778245592202,23010.0117544078,23411.212747356494,23519.906085899525,23541.180641994015,23498.631529805036,224888,179352,63.05415286995735,60.96225167417179,NaN,NaN,NaN,NaN,76.85487448227543,13.035490662940965,11179470,10.444371982759392,69.97703267192628,59.53266068916689
2025-07-28T10:00:00-04:00,23520.25,23527.75,23437,23461.25,23308.91546915161,NaN,NaN,NaN,NaN,NaN,23300.605,23573.345409364276,23027.864590635723,23411.212747356494,23497.075027660176,23523.854840464464,23470.295214855887,397681,179899.16666666666,56.4769504288125,60.7572273891068,NaN,NaN,NaN,NaN,77.84738344782718,12.32448196619029,10781789,4.127813191922783,64.69242717907036,60.56461398714758
2025-07-28T14:00:00-04:00,23461,23516.5,23440,23509,23308.91546915161,NaN,NaN,NaN,NaN,NaN,23311.43,23573.21137901752,23049.64862098248,23411.212747356494,23495.529617662898,23519.99948045007,23471.059754875725,170683,178346,60.11821542013435,60.981853676353225,NaN,NaN,NaN,NaN,77.75114177298238,11.664259604921803,10952472,2.4474671478370595,63.62394792194391,61.17648077410685
2025-07-28T18:00:00-04:00,23505.25,23545.5,23503,23528,23308.91546915161,NaN,NaN,NaN,NaN,NaN,23321.43,23577.27192463359,23065.58807536641,23411.212747356494,23525.5,23525.5,23525.5,38809,178254.4,61.49852113937838,61.20659181337911,NaN,NaN,NaN,NaN,75.23320307491221,11.1045474100111,10991281,1.9207598438592726,63.577430578930944,61.65667073507167
2025-07-28T22:00:00-04:00,23527.25,23553,23521.25,23547.25,23308.91546915161,NaN,NaN,NaN,NaN,NaN,23331.115,23583.734441254855,23078.495558745148,23411.212747356494,23531.343478671195,23538.65825393901,23524.02870340338,24767,177638.16666666666,62.899533263518265,61.47795859885838,NaN,NaN,NaN,NaN,72.12725999813277,10.710710233279666,11016048,2.15631843544287,64.35206877937526,62.19575034393239
2025-07-29T02:00:00-04:00,23547.75,23606.75,23541.5,23598.75,23343.46434133602,NaN,NaN,NaN,NaN,NaN,23342.41,23591.356515541876,23093.463484458123,23453.48947444302,23554.521162568562,23580.478940946552,23528.563384190573,52982,176958.9,66.4200448108678,61.84512769964556,NaN,NaN,NaN,NaN,71.63602714112328,11.18065259834614,11069030,4.9105071244333445,68.33388424947407,63.42337712504072
2025-07-29T06:00:00-04:00,23598,23652.25,23556,23589.75,23370.823916729838,NaN,NaN,NaN,NaN,NaN,23352.46,23599.95948201944,23104.96051798056,23481.516579554416,23584.62025323587,23610.389995922273,23558.850510549466,238447,174537.83333333334,65.25469020783393,62.273275447227505,NaN,NaN,NaN,NaN,73.39416805961447,12.216684579310813,10830583,5.226784542348,69.95685780297572,64.73007326062772
2025-07-29T10:00:00-04:00,23583.25,23592.75,23438,23491.75,23370.823916729838,NaN,NaN,NaN,NaN,NaN,23360.115,23600.597664863475,23119.632335136528,23481.516579554416,23536.81679516421,23577.48484187598,23496.14874845244,578865,175984.36666666667,54.119854752374366,62.15880059013448,NaN,NaN,NaN,NaN,79.20529891249916,11.492279268889254,10251718,-1.6932383581417696,62.613525312950514,64.30676367109228
2025-07-29T14:00:00-04:00,23491.75,23506,23422,23451.5,23370.823916729838,NaN,NaN,NaN,NaN,NaN,23366.145,23600.287479912557,23132.002520087444,23481.516579554416,23523.293988502337,23570.427163631768,23476.160813372906,198998,175352.06666666668,50.32186903718897,61.681566302230145,NaN,NaN,NaN,NaN,79.54777756160637,11.038161610703046,10052720,-9.096745754339807,52.93583147816753,62.032577232507336
2025-07-29T18:00:00-04:00,23451.5,23492.25,23448.25,23485.75,23370.823916729838,NaN,NaN,NaN,NaN,NaN,23370.345,23605.383015860887,23135.306984139115,23481.516579554416,23475.416666666668,23475.416666666668,23475.416666666668,38732,173477.46666666667,53.32361082592587,61.14615813240524,NaN,NaN,NaN,NaN,77.00865059292019,10.616480928101568,10091452,-11.640038496301408,47.48252911213058,59.122567608431986
2025-07-29T22:00:00-04:00,23485.75,23510,23480.5,23503.5,23370.823916729838,NaN,NaN,NaN,NaN,NaN,23375.105,23611.09495932035,23139.115040679648,23481.516579554416,23483.860272762056,23494.786859004907,23472.933686519205,23129,173044.93333333332,54.846342842975325,60.675413392761875,NaN,NaN,NaN,NaN,73.61517555056875,9.934703173894352,10114581,-12.030180693583432,44.08484174145269,56.115022435036124
2025-07-30T02:00:00-04:00,23503,23512,23463,23492.25,23370.823916729838,NaN,NaN,NaN,NaN,NaN,23379.61,23615.773040291675,23143.446959708326,23481.516579554416,23486.166023349044,23494.734064951346,23477.59798174674,48893,172846.2,53.651671806407,59.669033852246095,NaN,NaN,NaN,NaN,71.85694872552813,9.580145038181513,10065688,-12.873610979715394,40.02300871039188,52.89661969010727
2025-07-30T06:00:00-04:00,23492.75,23526.5,23450.25,23483.25,23370.823916729838,NaN,NaN,NaN,NaN,NaN,23383.205,23620.095622228237,23146.314377771767,23481.516579554416,23486.491386668185,23491.566722969117,23481.416050367254,205587,171270.36666666667,52.663382534054946,58.46401923863582,NaN,NaN,NaN,NaN,72.17073810227612,8.99616562924852,9860101,-13.78400814191108,35.66660951271842,49.450617654629504
2025-07-30T10:00:00-04:00,23483.25,23551.25,23463.75,23540.25,23370.823916729838,NaN,NaN,NaN,NaN,NaN,23388.44,23627.403481728772,23149.476518271225,23481.516579554416,23503.074613053734,23519.408612714884,23486.740613392583,341933,164055.06666666668,57.94682131949184,58.04254723278011,NaN,NaN,NaN,NaN,73.26568538068497,8.67903924351127,10202034,-10.445271966317009,36.39402769673325,46.839299663050255
2025-07-30T14:00:00-04:00,23541.75,23688,23355,23662.25,NaN,NaN,NaN,23684.486480568303,23684.486480568303,23684.486480568303,23396.495,23644.51057390569,23148.47942609431,23481.516579554416,23532.969032164932,23567.67383646362,23498.264227866246,555149,174250.43333333332,66.55199021372225,58.292392757334746,NaN,NaN,NaN,NaN,91.81813642492178,10.151190492411684,10757183,-0.44632836549443766,46.28138920618221,46.72771757167665
2025-07-30T18:00:00-04:00,23698,23780,23688.25,23769.75,23465.226445345015,23465.226445345015,23465.226445345015,NaN,NaN,NaN,23407.92,23670.596577563116,23145.24342243688,23481.516579554416,23746,23746,23746,74048,175008.63333333333,71.99070269736485,59.4005179193742,NaN,NaN,NaN,NaN,93.67041239457022,12.316560093277754,10831231,12.27860422104758,62.07597284798612,49.79736862693854
2025-07-30T22:00:00-04:00,23769.75,23809.75,23767.75,23799.75,23526.34683419297,NaN,NaN,NaN,NaN,NaN,23419.34,23698.967658860343,23139.712341139657,23544.8015927473,23763.19716013908,23785.613505357884,23740.780814920276,43581,175516.76666666666,73.29568532351064,60.34176576961537,NaN,NaN,NaN,NaN,89.97966865210093,14.54912801301275,10874812,21.071217530923086,76.1363905405924,55.065173009669316
2025-07-31T02:00:00-04:00,23799.75,23848,23777.25,23783.25,23552.501523547835,NaN,NaN,NaN,NaN,NaN,23429.71,23723.723730292128,23135.69626970787,23600.66627419784,23777.813002992687,23803.94519726265,23751.680808722725,68714,176001.2,71.32731960220627,61.043822802674505,NaN,NaN,NaN,NaN,88.60612089123659,16.89378227926538,10806098,23.922659046513893,84.96849681781168,61.04583777129779
2025-07-31T06:00:00-04:00,23783.5,23809.5,23608.25,23671,23552.501523547835,NaN,NaN,NaN,NaN,NaN,23437.765,23735.685566762637,23139.844433237362,23600.66627419784,23726.58102505052,23769.100043118484,23684.062006982556,314751,178434.73333333334,59.600858041181674,60.808203143936176,NaN,NaN,NaN,NaN,96.65211225614826,16.51552560413509,10491347,16.735746015479336,81.96552029064696,65.22977427516763
2025-07-31T10:00:00-04:00,23671.25,23700,23364.75,23389.25,NaN,NaN,NaN,23841.300006436788,23841.300006436788,23841.300006436788,23439.76,23735.006404889187,23144.51359511081,23600.66627419784,23580.001251630896,23701.189424871944,23458.81307838985,770447,188769.7,41.263422935278975,59.011301581394115,NaN,NaN,NaN,NaN,113.69481852356624,16.68845256599634,9720900,-7.221501480798622,56.20289742416935,63.42439890496797
2025-07-31T14:00:00-04:00,23389.5,23465.25,23286.5,23329.25,NaN,NaN,NaN,23695.13296068966,NaN,NaN,23438.835,23735.16870733014,23142.50129266986,23600.66627419784,23520.38089463108,23662.657259493903,23378.104529768254,473670,198003.33333333334,38.543777064293096,57.10337921399834,NaN,NaN,NaN,NaN,118.34161720045437,17.349883053571862,9247230,-26.266165009088354,30.59169264360753,56.857857652695884
2025-07-31T18:00:00-04:00,23323.5,23347.5,23231.5,23322.5,NaN,NaN,NaN,23610.06441702195,NaN,NaN,23437.05,23735.085132157365,23139.014867842634,23600.66627419784,23300.5,23300.5,23300.5,119414,200481.23333333334,38.23843654551922,55.968992199222974,NaN,NaN,NaN,NaN,118.17435882899335,18.289111383039458,9127816,-37.775206845401954,9.638849095943442,47.414055941345396
2025-07-31T22:00:00-04:00,23321.75,23343,23290.25,23292.75,NaN,NaN,NaN,23610.06441702195,NaN,NaN,23435.97,23735.692782583974,23136.24721741603,23600.66627419784,23302.73127618352,23306.370437551792,23299.09211481525,44891,200875.66666666666,36.85274092898871,55.00691162006582,NaN,NaN,NaN,NaN,113.50119034120812,19.161251974687943,9082925,-45.339452933851135,-9.260260225968523,36.07919270788261
2025-08-01T02:00:00-04:00,23293.25,23296.75,23062.25,23126.5,NaN,NaN,NaN,23510.428012203884,NaN,NaN,23431.195,23742.649929163435,23119.740070836564,23600.66627419784,23228.38913182226,23298.774901647692,23158.003361996827,183527,205004.26666666666,30.25463852137628,53.35912788402656,NaN,NaN,NaN,NaN,122.14396245969326,21.10328824919013,8899398,-58.64242051829933,-37.22383293999155,21.41858757830778
2025-08-01T06:00:00-04:00,23126.75,23167.25,22858,22882,NaN,NaN,NaN,23370.681284376435,NaN,NaN,23422.555,23768.58391916768,23076.526080832322,23600.66627419784,23083.366292924016,23220.322737699044,22946.40984814899,441392,213025.3,23.570805701860834,51.12516094537552,NaN,NaN,NaN,NaN,135.508679426858,23.597713633380607,8458006,-79.70501827127009,-78.21268526077984,1.4923330104902561
2025-08-01T10:00:00-04:00,22879.75,23045.5,22799.25,22845,NaN,NaN,NaN,23297.735544177503,NaN,NaN,23413.815,23793.99336353537,23033.636636464627,23600.66627419784,22989.57449904105,23123.96252639782,22855.18647168428,796019,226408.06666666668,22.751672587062032,48.918018143993734,NaN,NaN,NaN,NaN,143.418773753511,26.080153507586996,7661987,-91.10323660487484,-112.38671274560329,-21.283476140728453
2025-08-01T14:00:00-04:00,22844.75,22945,22788.25,22869,NaN,NaN,NaN,23246.298701260344,NaN,NaN,23408.345,23811.176017797614,23005.51398220239,23600.66627419784,22968.508896192754,23099.181446389463,22837.836345996046,330333,231804.93333333332,24.582495809922833,46.91224052084145,NaN,NaN,NaN,NaN,144.3710041996888,28.416677855460915,7992320,-91.7459755114658,-135.9659455300607,-44.21997001859491
2025-08-03T18:00:00-04:00,22850.5,22973,22822,22959,NaN,NaN,NaN,23246.298701260344,NaN,NaN,23403.17,23821.992712373973,22984.347287626024,23511.008019358273,22918,22918,22918,120182,233514.2,31.17041730576689,44.9996402341468,NaN,NaN,NaN,NaN,144.84450389971101,30.267340858702408,8112502,-81.1926213974459,-145.7107467654023,-64.51812536795639
2025-08-03T22:00:00-04:00,22958.75,22995.75,22949.75,22983.25,NaN,NaN,NaN,23246.298701260344,NaN,NaN,23398.865,23830.250873783523,22967.47912621648,23293.581415486617,22936.754141067086,22963.970145733867,22909.538136400304,57067,234319.56666666668,32.871926727385514,42.59392141369418,NaN,NaN,NaN,NaN,137.78418219258882,31.721080695448446,8169569,-68.1859543319895,-149.75056828294328,-81.56461395095377
2025-08-04T02:00:00-04:00,22983.75,23077.75,22947.5,23055,NaN,NaN,NaN,23246.298701260344,NaN,NaN,23394.93,23835.111622060398,22954.748377939603,23050.740132389295,22969.465070638005,23017.893645844062,22921.03649543195,101213,235959.73333333334,37.77343662734791,40.149830980121536,NaN,NaN,NaN,NaN,137.2460263216896,32.153579466223086,8270782,-51.13668060335169,-145.4854647051434,-94.3487841017917
2025-08-04T06:00:00-04:00,23055.5,23258,23031.5,23246.5,22758.07760273029,22758.07760273029,22758.07760273029,NaN,NaN,NaN,23394.845,23835.1395819558,22954.550418044204,23004.93868472915,23071.42529115451,23181.59162381533,22961.258958493694,264749,237288.43333333332,48.56770398347794,38.383546598690636,NaN,NaN,NaN,NaN,143.62131015585464,30.902296031681143,8535531,-24.688614356835473,-125.20955204783604,-100.52093769100057
2025-08-04T10:00:00-04:00,23246.5,23286.5,23187.5,23268,22854.403620788005,NaN,NaN,NaN,NaN,NaN,23394.77,23835.149697987934,22954.390302012067,23004.93868472915,23150.772468425315,23270.455232933527,23031.089703917103,446374,238911.53333333333,49.62426150212766,36.83332816297074,NaN,NaN,NaN,NaN,140.43407371615075,29.512724227993832,8981905,-4.5287508838708845,-106.18187629583917,-101.65312541196829
2025-08-04T14:00:00-04:00,23268.25,23353.75,23252.5,23351.5,22924.112547115823,NaN,NaN,NaN,NaN,NaN,23398.485,23834.18311119627,22962.78688880373,22999.195783823725,23182.18624976604,23308.514608785823,23055.857890746258,226804,240782.23333333334,53.61004650429143,36.40541305319285,NaN,NaN,NaN,NaN,137.63521130785426,27.69707484623507,9208709,14.599992653546451,-83.40313459503523,-98.00312724858168
2025-08-04T18:00:00-04:00,23352.5,23374.75,23314,23340.5,22974.306294974194,NaN,NaN,NaN,NaN,NaN,23400.035,23834.343323774625,22965.726676225375,23060.73162705898,23343.083333333332,23343.083333333332,23343.083333333332,80147,242160.16666666666,53.014957733440625,37.24480839591869,NaN,NaN,NaN,NaN,132.1434105001504,25.849692115689166,9128562,26.01564427919402,-65.48357189958915,-91.49921617878317
2025-08-04T22:00:00-04:00,23340.75,23368,23324.25,23363.25,22986.911690657183,NaN,NaN,NaN,NaN,NaN,23399.085,23833.503204153847,22964.66679584615,23094.91030164718,23345.733176324928,23349.75368106862,23341.712671581234,34815,242495.1,54.14856317023851,38.35943597491479,NaN,NaN,NaN,NaN,125.82959546442537,24.13426529446797,9163377,34.0930032383898,-48.88296213079593,-82.97596536918573
2025-08-05T02:00:00-04:00,23363.25,23397.25,23312.25,23348.5,23000.273659263676,NaN,NaN,NaN,NaN,NaN,23397.88,23832.518473216336,22963.241526783666,23136.27824131775,23348.57813475108,23353.17851963482,23343.977749867336,79995,243395.53333333333,53.25148695896089,39.43179671873205,NaN,NaN,NaN,NaN,122.91319578839499,22.5258644692445,9083382,37.18368928003649,-36.496353769140114,-73.6800430491766
2025-08-05T06:00:00-04:00,23348,23404.25,23303.5,23378,23001.7725838426,NaN,NaN,NaN,NaN,NaN,23397.97,23832.59010583928,22963.34989416072,23145.097593054197,23356.25133076548,23363.49426668934,23349.00839484162,264052,244249.03333333333,54.86212585686738,40.71818135643766,NaN,NaN,NaN,NaN,121.3301103749382,20.95397704137046,9347434,39.725988950028785,-24.022556861640624,-63.74854581166941
2025-08-05T10:00:00-04:00,23345,23362.25,23113.5,23241,23001.7725838426,NaN,NaN,NaN,NaN,NaN,23394.985,23831.820660288526,22958.149339711475,23145.097593054197,23282.665223278123,23339.576082447147,23225.7543641091,772064,250689,46.79825956209927,41.89986857363216,NaN,NaN,NaN,NaN,131.55653106244262,20.867605233074976,8575370,31.07511452642614,-24.90465265363673,-55.97976718006287
2025-08-05T14:00:00-04:00,23241,23248.75,23082,23090.75,23001.7725838426,NaN,NaN,NaN,NaN,NaN,23389.535,23834.541438268207,22944.528561731793,23145.097593054197,23255.278888828412,23331.16232694404,23179.395450712786,293735,253846.9,39.87582356938783,43.06451270702695,NaN,NaN,NaN,NaN,134.07035027226814,20.98656629992762,8281635,14.945658043510363,-37.29769462567492,-52.243352669185285
2025-08-05T18:00:00-04:00,23092,23140.5,23045.25,23136.75,23001.7725838426,NaN,NaN,NaN,NaN,NaN,23384.59,23835.192360846377,22933.987639153624,23145.097593054197,23107.5,23107.5,23107.5,90273,255564.93333333332,42.67175138990087,44.4873754786583,NaN,NaN,NaN,NaN,131.2974681099633,21.328465042144508,8371908,7.464456317867402,-42.91278227185103,-50.37723858971843
2025-08-05T22:00:00-04:00,23137,23202.5,23123,23184.75,23001.7725838426,NaN,NaN,NaN,NaN,NaN,23380.385,23834.43122242703,22926.338777572968,23145.097593054197,23131.675079711476,23162.146748401967,23101.203411020986,56820,256687.96666666667,45.51877935688571,45.98282430344136,NaN,NaN,NaN,NaN,127.59764895925163,21.01147265113875,8428728,5.906612407888488,-42.993973079857824,-48.90058548774631
2025-08-06T02:00:00-04:00,23185,23227.25,23132,23146.25,23001.7725838426,NaN,NaN,NaN,NaN,NaN,23374.77,23833.29323648827,22916.246763511732,23145.097593054197,23144.599613477116,23174.791302138758,23114.407924815474,79543,257709.63333333333,43.64647515926068,46.87397129297664,NaN,NaN,NaN,NaN,125.28710260501937,20.471096468495883,8349185,2.6093888895407105,-45.63884937582043,-48.24823826536114
2025-08-06T06:00:00-04:00,23147,23245,23107.5,23200.75,23001.7725838426,NaN,NaN,NaN,NaN,NaN,23370.625,23831.612128345438,22909.637871654562,23145.097593054197,23168.180884406127,23195.64993423145,23140.711834580805,329172,261829.13333333333,46.97164919267914,47.8810943262119,NaN,NaN,NaN,NaN,126.15945241894656,20.1576101677048,8678357,4.323897245226192,-42.8433667088284,-47.16726395405459
2025-08-06T10:00:00-04:00,23201.5,23396.5,23164.25,23373.25,23001.7725838426,NaN,NaN,NaN,NaN,NaN,23370.61,23831.596736902753,22909.623263097248,23145.097593054197,23242.75398805773,23316.75164063655,23168.756335478913,604385,270577.5333333333,55.851174163070404,49.17236129304922,NaN,NaN,NaN,NaN,133.7373486747361,18.967159662289426,9282742,16.610413979103626,-26.40424648017506,-43.01466045927869
2025-08-06T14:00:00-04:00,23373,23444.75,23370.5,23413,23033.666236902714,NaN,NaN,NaN,NaN,NaN,23371.075,23832.18491368649,22909.96508631351,23145.097593054197,23266.698484290442,23356.733356905526,23176.663611675358,194651,258560.93333333332,57.61254838545828,49.81842160747639,NaN,NaN,NaN,NaN,129.48825234082636,18.23861459887535,9477393,26.369527875705863,-10.052750614646357,-36.42227849035222
2025-08-06T18:00:00-04:00,23416.75,23511,23385.25,23495.75,23074.016635225318,NaN,NaN,NaN,NaN,NaN,23372.21,23834.26151617544,22910.158483824558,23189.432191774,23464,23464,23464,92986,259192.2,61.09255995755106,50.637585782863766,NaN,NaN,NaN,NaN,129.22123431648163,18.049513340770265,9570379,36.71698381732419,9.473951281303016,-27.243032536021172
2025-08-06T22:00:00-04:00,23495.75,23505.75,23454.5,23483,23116.032924533258,NaN,NaN,NaN,NaN,NaN,23372.925,23835.549072547317,22910.30092745268,23222.870753419204,23469.31536603796,23477.22428844517,23461.406443630753,42000,259139.5,60.27148624555306,51.1134029072396,NaN,NaN,NaN,NaN,123.65186043673293,17.873919315386974,9528379,40.712498088075634,23.647590074073378,-17.06490801400226
2025-08-07T02:00:00-04:00,23482.5,23607,23467.25,23602,23170.525746145384,NaN,NaN,NaN,NaN,NaN,23374.12,23838.791574770825,22909.448425229173,23310.821602735363,23507.454600787758,23552.089156285256,23462.82004529026,100365,260194.53333333333,64.99960359582866,51.969449040267314,NaN,NaN,NaN,NaN,124.80172754839487,18.41660235231467,9628744,48.83247210627839,43.975682118845725,-4.856789987432663
2025-08-07T06:00:00-04:00,23601.5,23659,23569.5,23654.5,23252.109803138774,NaN,NaN,NaN,NaN,NaN,23375.73,23843.706685744106,22907.753314255893,23377.30728218829,23574.956881465212,23641.5269677073,23508.386795223123,301400,259749.5,66.87273618695032,52.87831854146101,NaN,NaN,NaN,NaN,122.28017558065237,19.244209478459634,9930144,54.75674140886714,63.58913677365126,8.832395364784123
2025-08-07T10:00:00-04:00,23654.25,23671.25,23381.25,23419.75,23252.109803138774,NaN,NaN,NaN,NaN,NaN,23373.59,23839.759837719874,22907.420162280127,23377.30728218829,23524.43442189946,23583.37963584924,23465.48920794968,805060,260903.26666666666,53.17035366745316,52.87252330635333,NaN,NaN,NaN,NaN,134.2601630391772,18.233257664962917,9125084,40.537799925899165,59.504645272158086,18.966845346258918
2025-08-07T14:00:00-04:00,23419,23535.25,23330,23521.5,23252.109803138774,NaN,NaN,NaN,NaN,NaN,23373.62,23839.827713792936,22907.41228620706,23377.30728218829,23513.474940025586,23571.986296845036,23454.963583206136,287078,254683.53333333333,57.25836100049767,53.04368295946978,NaN,NaN,NaN,NaN,139.33086567923598,16.96654838369919,9412162,35.82111459827226,63.74323859409924,27.92212399582698
2025-08-07T18:00:00-04:00,23519.5,23583.25,23515.5,23562.5,23252.109803138774,NaN,NaN,NaN,NaN,NaN,23375.645,23844.231129649426,22907.058870350575,23377.30728218829,23553.75,23553.75,23553.75,63177,252808.96666666667,58.818374634278925,53.90226260748261,NaN,NaN,NaN,NaN,134.21794670214769,16.08452396158409,9475339,33.348949135386626,69.60831041506026,36.259361279673634
2025-08-07T22:00:00-04:00,23562.75,23579.75,23503.25,23509.25,23252.109803138774,NaN,NaN,NaN,NaN,NaN,23375.65,23844.2418266463,22907.058173353704,23377.30728218829,23545.081078082312,23556.227153486456,23533.93500267817,38216,252586.46666666667,55.961526132425746,55.05124136198532,NaN,NaN,NaN,NaN,130.09523622342286,15.162362858996744,9437123,26.322376423078808,69.16233180852214,42.83995538544333
2025-08-08T02:00:00-04:00,23510,23578,23508,23562.5,23252.109803138774,NaN,NaN,NaN,NaN,NaN,23376.34,23845.92767828783,22906.75232171217,23377.30728218829,23546.61927533064,23555.86160976142,23537.376940899856,54140,248273.56666666668,58.15054105489741,56.156869195199356,NaN,NaN,NaN,NaN,125.80271935032123,14.306070406594209,9491263,23.54612120904202,72.27260689674586,48.726485687703835
2025-08-08T06:00:00-04:00,23563.25,23649,23516,23643.75,23252.109803138774,NaN,NaN,NaN,NaN,NaN,23378.27,23851.431197056263,22905.108802943738,23377.30728218829,23579.10058320074,23607.556056922465,23550.645109479014,212122,240631.23333333334,61.31061152849794,57.28485720745737,NaN,NaN,NaN,NaN,126.31681082529828,14.098112870551024,9703385,25.3126467602275,80.36729413798821,55.05464737776071
2025-08-08T10:00:00-04:00,23643.5,23706.75,23612,23700.25,23290.11914285584,NaN,NaN,NaN,NaN,NaN,23380.3,23858.07589935075,22902.524100649247,23419.601515345574,23634.58039402367,23684.207127103098,23584.95366094424,530912,231794.33333333334,63.381321836476815,58.69448911297281,NaN,NaN,NaN,NaN,124.06203862349126,14.343095540487452,10234297,28.19671527664805,90.30054147357077,62.103826196922725
2025-08-08T14:00:00-04:00,23700.25,23768.5,23676,23767.25,23357.16486363512,NaN,NaN,NaN,NaN,NaN,23383.85,23870.356197288595,22897.343802711403,23492.53121227646,23653.901741821668,23713.982834510418,23593.82064913292,208301,227726.6,65.72408090397082,60.033948520922216,NaN,NaN,NaN,NaN,121.80760729324189,15.005460500847946,10442598,32.23586988830627,102.39866355730555,70.16279366899929
2025-08-10T18:00:00-04:00,23767.25,23770,23701.25,23757.25,23377.759642560795,NaN,NaN,NaN,NaN,NaN,23389.16,23885.947990595607,22892.372009404393,23514.849969821167,23742.833333333332,23742.833333333332,23742.833333333332,71057,226089.1,65.05509623013607,60.691371525712626,NaN,NaN,NaN,NaN,118.01777820086747,15.631030041654906,10371541,31.799838745511778,109.91259210088901,78.11275335537724
2025-08-10T22:00:00-04:00,23757.75,23773.5,23731.25,23738.75,23405.01488608076,NaN,NaN,NaN,NaN,NaN,23394.905,23901.000286384362,22888.809713615636,23548.254975856933,23744.709866340796,23747.130876234445,23742.288856447147,42690,225609.86666666667,63.76206086240392,61.130622416923025,NaN,NaN,NaN,NaN,112.60579404366264,16.238163712970177,10328851,27.966776936195657,113.0712245256218,85.10444758942614
2025-08-11T02:00:00-04:00,23739,23765,23667.75,23723.25,23405.01488608076,NaN,NaN,NaN,NaN,NaN,23399.655,23913.47091927472,22885.839080725276,23548.254975856933,23734.449629357314,23747.3138842925,23721.585374422128,73945,224700.93333333332,62.63870716496137,61.24106150316663,NaN,NaN,NaN,NaN,111.50895161197245,16.038780486068248,10254906,22.333168600124765,113.02090833958209,90.68773973945733
2025-08-11T06:00:00-04:00,23723,23756.25,23681,23745,23405.01488608076,NaN,NaN,NaN,NaN,NaN,23404.485,23926.58827915056,22882.38172084944,23548.254975856933,23730.86119881706,23740.52618676086,23721.19621087326,195533,222393.73333333334,63.60760298385051,61.47935555590215,NaN,NaN,NaN,NaN,108.91902649683155,15.853638918230741,10450439,18.19264180996909,113.42854200191869,95.2359001919496
2025-08-11T10:00:00-04:00,23744.75,23804.5,23688.25,23697.75,23406.531342505063,NaN,NaN,NaN,NaN,NaN,23408.595,23936.599165608146,22880.590834391856,23569.82954763875,23730.486006112547,23737.04876330893,23723.923248916166,450252,222523,59.96920097247968,61.120041082805805,NaN,NaN,NaN,NaN,109.44266746134359,16.117589565712134,10000187,10.76011934913464,108.6860493783679,97.92593002923326
2025-08-11T14:00:00-04:00,23698,23701.25,23587,23630,23406.531342505063,NaN,NaN,NaN,NaN,NaN,23411.53,23942.78294013298,22880.277059867018,23569.82954763875,23709.207150339756,23748.169541502204,23670.24475917731,254124,223433.66666666666,55.102186313430465,60.27928752041152,NaN,NaN,NaN,NaN,109.78604835696191,15.189154765172702,9746063,0.3210762907307583,98.3272753926467,98.00619910191594
2025-08-11T18:00:00-04:00,23632,23666.25,23614.25,23658.25,23406.531342505063,NaN,NaN,NaN,NaN,NaN,23413.89,23948.447351086117,22879.33264891388,23569.82954763875,23646.25,23646.25,23646.25,57574,222681.23333333334,56.680915007743934,60.530041901860855,NaN,NaN,NaN,NaN,105.65847347432178,14.327036736100371,9803637,-5.329399816748875,91.34444933097984,96.67384914772872
2025-08-11T22:00:00-04:00,23658.5,23676.75,23596,23629.25,23406.531342505063,NaN,NaN,NaN,NaN,NaN,23413.23,23946.63940974088,22879.820590259118,23569.82954763875,23640.46501576651,23646.580570874696,23634.349460658323,51518,223238,54.560011118725285,60.33730262459141,NaN,NaN,NaN,NaN,103.87929679758452,13.320802343746617,9752119,-11.3237021081722,82.51922151251347,93.84292362068567
2025-08-12T02:00:00-04:00,23630,23675.75,23627.75,23635.5,23406.531342505063,NaN,NaN,NaN,NaN,NaN,23410.545,23938.06803921253,22883.021960787468,23569.82954763875,23642.371219294826,23648.098694865843,23636.64374372381,52485,222321,54.95124247581767,60.061078898987034,NaN,NaN,NaN,NaN,99.88791845489992,12.38644183656099,9804604,-14.943895102215862,75.16305474291585,90.10694984513171
2025-08-12T06:00:00-04:00,23635.5,23822.25,23608.5,23653.5,23406.531342505063,NaN,NaN,NaN,NaN,NaN,23407.62,23928.05257238603,22887.187427613968,23569.82954763875,23679.107001656124,23703.282500359233,23654.931502953015,379445,226167.43333333332,56.12292585838395,60.07260745084119,NaN,NaN,NaN,NaN,108.02092427954993,12.98916832271844,10184049,-16.10234817433168,69.97901462721711,86.08136280154879
2025-08-12T10:00:00-04:00,23654,23917,23622,23914,23410.601262349424,NaN,NaN,NaN,NaN,NaN,23410.235,23939.4311206392,22881.0388793608,23569.82954763875,23744.43877986779,23815.803957706863,23673.073602028715,482684,216521.43333333332,68.77889959844194,60.83177591823722,NaN,NaN,NaN,NaN,121.37657254529636,14.259498466564171,10666733,-0.14461834647759986,85.90058986845179,86.04520821492939
2025-08-12T14:00:00-04:00,23914.25,23952.5,23901,23948.75,23577.142114060814,NaN,NaN,NaN,NaN,NaN,23415.79,23961.395263537685,22870.184736462317,23638.81578314897,23769.746809392243,23862.33387030492,23677.159748479567,157652,211985.33333333334,70.02113762192756,61.45395635348219,NaN,NaN,NaN,NaN,116.3853887920609,15.677703408034718,10824385,11.298164768667007,100.16791417576314,88.86974940709614
2025-08-12T18:00:00-04:00,23947.25,23967.75,23925.5,23928.75,23607.14701796714,NaN,NaN,NaN,NaN,NaN,23426.58,23990.683974812924,22862.47602518708,23695.677626519177,23940.666666666668,23940.666666666668,23940.666666666668,57826,210903.76666666666,68.33588388540909,61.80785364269165,NaN,NaN,NaN,NaN,111.09000387834226,17.0973744010311,10766559,15.791449257226859,108.60906097862971,92.81761172140286
2025-08-12T22:00:00-04:00,23928.25,23962.5,23921,23945.25,23612.043744423183,NaN,NaN,NaN,NaN,NaN,23438.9,24020.59562487586,22857.204375124144,23724.09210121534,23941.451810778355,23942.52424859983,23940.37937295688,30994,210042.9,68.99879207475499,62.04176158346195,NaN,NaN,NaN,NaN,106.11928931560352,18.348914498446426,10797553,17.986730065327436,115.30102430306215,97.31429423773471
2025-08-13T02:00:00-04:00,23945.25,24017,23933.25,24006,23648.98493785849,NaN,NaN,NaN,NaN,NaN,23452.57,24054.455869912203,22850.684130087797,23784.398680972274,23958.638094552338,23980.107250761004,23937.16893834367,57004,209291.6,71.37497015004115,62.49318114916945,NaN,NaN,NaN,NaN,104.52148293591756,19.89620451127852,10854557,21.409522666519976,124.07619757088469,102.66667490436471
2025-08-13T06:00:00-04:00,24006,24069,23984,24017.25,23703.59357704674,NaN,NaN,NaN,NaN,NaN,23467.06,24087.457006439876,22846.662993560127,23840.41894477782,23996.387473627787,24031.210719416566,23961.564227839008,203660,205107.86666666667,71.80594197732573,63.067744085949585,NaN,NaN,NaN,NaN,103.12709129763773,21.66771592084267,11058217,22.214496442885533,130.43479545797163,108.2202990150861
2025-08-13T10:00:00-04:00,24017.5,24017.75,23886,23938.75,23703.59357704674,NaN,NaN,NaN,NaN,NaN,23483.305,24109.689604616207,22856.920395383793,23840.41894477782,23966.28229506311,23998.396792839296,23934.167797286922,560170,203634.03333333333,64.50772944452125,63.20124567734672,NaN,NaN,NaN,NaN,105.1715847763779,21.898230576198266,10498047,15.55820738135752,127.668058241783,112.10985086042548
2025-08-13T14:00:00-04:00,23939,23960.5,23887.25,23927.75,23703.59357704674,NaN,NaN,NaN,NaN,NaN,23504.22,24118.618092770364,22889.821907229638,23840.41894477782,23958.858161532306,23991.952644196423,23925.76367886819,200448,203827.26666666666,63.533267184941124,63.19593597742462,NaN,NaN,NaN,NaN,102.8914715780652,22.11227989902846,10297599,8.846508999288915,123.16798710953663,114.32147811024771
2025-08-13T18:00:00-04:00,23930,23964.25,23912.25,23931.25,23703.59357704674,NaN,NaN,NaN,NaN,NaN,23525.945,24122.115951070107,22929.774048929892,23840.41894477782,23935.916666666668,23935.916666666668,23935.916666666668,44119,202198.36666666667,63.721055236964915,63.463925567744994,NaN,NaN,NaN,NaN,99.25636646534625,22.34342501521239,10341718,3.3571125901851246,118.51786884797912,115.16075625779399
2025-08-13T22:00:00-04:00,23931.25,23945.25,23897.5,23909.75,23703.59357704674,NaN,NaN,NaN,NaN,NaN,23546.76,24122.038288830776,22971.48171116922,23840.41894477782,23928.85842478041,23937.812223391993,23919.904626168827,27416,201712.23333333334,61.621821803473814,63.9296138170338,NaN,NaN,NaN,NaN,95.57734028925009,22.334819166691542,10314302,-2.681498525732792,111.80888310062801,114.4903816263608
2025-08-14T02:00:00-04:00,23909.5,23941.75,23899.5,23926.75,23703.59357704674,NaN,NaN,NaN,NaN,NaN,23566.115,24125.90164873295,23006.328351267053,23840.41894477782,23926.757921369765,23934.604386356423,23918.911456383106,36727,199590.96666666667,62.66905148975585,64.35733785146321,NaN,NaN,NaN,NaN,91.76824455430366,22.326828021636466,10351029,-6.284701072264141,106.63450528603062,112.91920635829476
2025-08-14T06:00:00-04:00,23926.25,23965,23793.25,23936.5,23703.59357704674,NaN,NaN,NaN,NaN,NaN,23585.18,24128.966235941898,23041.393764058103,23840.41894477782,23905.86530842539,23919.114838993384,23892.615777857394,297017,199444.86666666667,63.28779189024588,64.9807507637147,NaN,NaN,NaN,NaN,97.48122708613911,20.814399068416066,10648046,-8.620904835382476,102.14307531406666,110.76398014944914
2025-08-14T10:00:00-04:00,23936,24005.5,23862.75,23962.5,23703.59357704674,NaN,NaN,NaN,NaN,NaN,23603.33,24135.5781981178,23071.081801882203,23840.41894477782,23927.698418677697,23948.21060662065,23907.186230734744,557038,191177.46666666667,64.95583980633873,65.69536485875184,NaN,NaN,NaN,NaN,100.7147108657006,19.87662434015322,11205084,-8.983824822255244,99.53419912163008,108.51802394388532
2025-08-14T14:00:00-04:00,23963,23963,23870.25,23891,23703.59357704674,NaN,NaN,NaN,NaN,NaN,23616.22,24144.479071289814,23087.96092871019,23840.41894477782,23923.990654961697,23943.995597516157,23903.985712407237,224302,189084.93333333332,57.252018578835674,65.77601433878411,NaN,NaN,NaN,NaN,100.14580294672199,19.005833521052008,10980782,-14.292650169841579,90.65221123158335,104.94486140142493
2025-08-14T18:00:00-04:00,23891.25,23914,23872,23903.5,23703.59357704674,NaN,NaN,NaN,NaN,NaN,23628.93,24153.633040204455,23104.226959795546,23840.41894477782,23896.5,23896.5,23896.5,46602,188532.43333333332,58.18570580897111,65.0193576395362,NaN,NaN,NaN,NaN,95.99253130767042,18.19724204617231,11027384,-17.029916180751343,83.65746617548575,100.6873823562371
2025-08-14T22:00:00-04:00,23904,23946.5,23902.75,23942,23703.59357704674,NaN,NaN,NaN,NaN,NaN,23640.74,24166.514675692626,23114.965324307377,23769.010155822256,23911.35832509385,23928.186130499234,23894.530519688466,36332,188469.63333333333,61.010391205510246,64.37573289550639,NaN,NaN,NaN,NaN,92.2609219285511,17.856044852508585,11063716,-16.31381272837079,80.2951164457736,96.6089291741444
2025-08-15T02:00:00-04:00,23941,23962.75,23877.25,23879.25,23703.59357704674,NaN,NaN,NaN,NaN,NaN,23651.515,24174.309456837298,23128.7205431627,23764.249159824794,23909.38108981314,23922.637545236506,23896.124634389776,55316,188508.83333333334,54.54309468221142,63.39053366670657,NaN,NaN,NaN,NaN,91.77799893365459,17.13516048056179,11008400,-19.895099507947307,71.74005478921026,91.63515429715757
2025-08-15T06:00:00-04:00,23879.75,23927.25,23770.5,23806.75,23703.59357704674,NaN,NaN,NaN,NaN,NaN,23660.385,24178.341979005298,23142.4280209947,23764.249159824794,23861.389478096255,23897.95549738288,23824.823458809627,249842,189766.16666666666,48.18742079489443,61.90400714671653,NaN,NaN,NaN,NaN,96.41885615267925,16.769713034670378,10758558,-26.559047525929515,58.43634488974567,84.99539241567518
2025-08-15T10:00:00-04:00,23803.75,23883.25,23734.75,23839.75,23703.59357704674,NaN,NaN,NaN,NaN,NaN,23670.21,24182.7383149257,23157.681685074298,23764.249159824794,23836.591451250435,23867.900765128943,23805.282137371927,554966,190567.96666666667,50.987005934858935,60.44772398848922,NaN,NaN,NaN,NaN,100.13893785605931,16.820600982809385,11313524,-28.01251574589908,49.97974773330134,77.99226347920042
2025-08-15T14:00:00-04:00,23839.75,23847.75,23775.75,23796.5,23703.59357704674,NaN,NaN,NaN,NaN,NaN,23678.58,24185.383753340226,23171.776246659778,23764.249159824794,23831.380441268077,23862.01302378796,23800.747858748193,198848,190252.86666666667,47.374102774096016,58.70259261682996,NaN,NaN,NaN,NaN,98.12901372348365,16.86785407750989,11114676,-30.92621364277025,39.3344964257376,70.26071006850785
2025-08-17T18:00:00-04:00,23795,23882,23792,23881.75,23703.59357704674,NaN,NaN,NaN,NaN,NaN,23691.395,24185.537986290157,23197.252013709844,23761.41049975311,23851.916666666668,23851.916666666668,23851.916666666668,49884,189547.1,54.25483929255174,57.97024332026071,NaN,NaN,NaN,NaN,97.54836988609198,16.37012564916413,11164560,-26.331357456172306,37.34651324829247,63.67787070446477
2025-08-17T22:00:00-04:00,23881.25,23881.75,23841,23852.25,23703.59357704674,NaN,NaN,NaN,NaN,NaN,23706.625,24171.874903277632,23241.375096722368,23761.41049975311,23854.31166002856,23857.41518719606,23851.208132861062,29707,189114.33333333334,51.73411830022834,57.127446971352654,NaN,NaN,NaN,NaN,93.49134346565684,15.907949251414497,11134853,-24.53421742201006,33.010098926952196,57.544316348962255
2025-08-18T02:00:00-04:00,23852.25,23855,23738.75,23759,23703.59357704674,NaN,NaN,NaN,NaN,NaN,23719.07,24155.047993022596,23283.092006977404,23761.41049975311,23818.544871913142,23853.63521503289,23783.454528793394,83007,189416.4,44.66921636022104,55.76660133729952,NaN,NaN,NaN,NaN,95.11696178953851,16.65427399090177,11051846,-28.597298345758887,21.79769341676365,50.39499176252254
2025-08-18T06:00:00-04:00,23759,23818.25,23735,23748.75,23703.59357704674,NaN,NaN,NaN,NaN,NaN,23730.35,24138.759720746213,23321.940279253784,23761.41049975311,23789.82246605791,23824.270565562136,23755.374366553686,207665,189820.8,43.95860411353633,54.504942930875416,NaN,NaN,NaN,NaN,94.26932166171433,17.38496517101482,10844181,-30.75841369420033,11.946974644772126,42.705388338972455
2025-08-18T10:00:00-04:00,23749,23824.5,23718.75,23760,23703.59357704674,NaN,NaN,NaN,NaN,NaN,23742.625,24115.414890554683,23369.835109445317,23761.41049975311,23777.39935475111,23802.67085463844,23752.12785486378,476697,190702.3,44.992927225315775,53.24236262627255,NaN,NaN,NaN,NaN,95.08937011444903,18.232377419739773,11320878,-30.171940210919864,4.990463075322623,35.16240328624249
2025-08-18T14:00:00-04:00,23760.25,23816,23747,23789.5,23703.59357704674,NaN,NaN,NaN,NaN,NaN,23754.4,24093.668625133258,23415.131374866745,23761.41049975311,23778.48121843356,23801.77716907135,23755.185267795772,161165,187603.66666666666,47.7178541850818,52.13022421876083,NaN,NaN,NaN,NaN,93.22584367770267,19.01926022212723,11482043,-26.660634867084916,1.8366097023863404,28.497244569471256
2025-08-18T18:00:00-04:00,23799,23839.75,23762.5,23771.5,23703.59357704674,NaN,NaN,NaN,NaN,NaN,23762.365,24083.691628370114,23441.03837162989,23687.803399802488,23791.25,23791.25,23791.25,54488,187500.8,46.21353265257415,50.791487993491934,NaN,NaN,NaN,NaN,92.0847119864382,19.270117870261913,11427555,-24.470744056326016,-2.0911855009362625,22.379558555389753
2025-08-18T22:00:00-04:00,23771,23786.75,23730.75,23736.25,23703.59357704674,NaN,NaN,NaN,NaN,NaN,23768.83,24074.401111853833,23463.25888814617,23666.2416725591,23773.119775935942,23793.03218256999,23753.207369301894,45171,187289.23333333334,43.332520955677595,49.79723816326636,NaN,NaN,NaN,NaN,89.50723255883545,19.88827373776781,11382384,-24.268968894996867,-7.956652563356329,16.312316331640538
2025-08-19T02:00:00-04:00,23735.75,23805,23734.25,23787.75,23703.59357704674,NaN,NaN,NaN,NaN,NaN,23774.67,24070.13591072433,23479.204089275667,23666.2416725591,23773.97984854426,23790.229687717292,23757.730009371226,50814,187233.53333333333,48.39433326845363,49.09785441037225,NaN,NaN,NaN,NaN,88.16743023320434,20.084779699964024,11433198,-19.732387268507676,-8.353167753994057,11.379219514513618
2025-08-19T06:00:00-04:00,23787.75,23790.25,23639.25,23678.75,NaN,NaN,NaN,24002.785249256995,24002.785249256995,24002.785249256995,23778.585,24063.486976301134,23493.683023698864,23666.2416725591,23727.363893150105,23762.5583059069,23692.16948039331,284979,184084.66666666666,40.20801334687071,47.61197027761228,NaN,NaN,NaN,NaN,92.6554709308326,21.306346601608066,11148219,-22.91440897471278,-17.26379170387736,5.650617270835422
2025-08-19T10:00:00-04:00,23678.25,23728,23445.25,23506.75,NaN,NaN,NaN,23900.12455610895,NaN,NaN,23776.68,24067.491933042627,23485.868066957373,23666.2416725591,23622.98244710409,23706.889103102687,23539.07579110549,721679,192051.16666666666,31.23044039740188,45.94678068584017,NaN,NaN,NaN,NaN,106.23365157863029,23.753280228751596,10426540,-34.7357811271238,-37.769109138069325,-3.033328010945528
2025-08-19T14:00:00-04:00,23506.75,23508,23425.25,23473.25,NaN,NaN,NaN,23777.158667194908,NaN,NaN,23773.055,24074.203406769455,23471.906593230546,23624.468338047278,23596.681334209687,23692.606525467105,23500.75614295227,238047,194731,29.83327352165894,44.63577016632335,NaN,NaN,NaN,NaN,104.55624789444241,26.125285525038468,10188493,-42.434518594809006,-56.07647625445679,-13.641957659647783
2025-08-19T18:00:00-04:00,23456,23489,23367.75,23379,NaN,NaN,NaN,23741.32759141332,NaN,NaN,23772.24,24077.40241511667,23467.077584883333,23623.947231264166,23411.916666666668,23411.916666666668,23411.916666666668,91436,195851.33333333334,26.27215011135233,42.87042332178716,NaN,NaN,NaN,NaN,105.74865875912509,28.60071827426473,10097057,-50.92589419661773,-77.29932540541995,-26.373431208802216
2025-08-19T22:00:00-04:00,23379.25,23395.5,23334.25,23365.75,NaN,NaN,NaN,23671.954746349078,NaN,NaN,23769.125,24087.36134691836,23450.88865308164,23623.947231264166,23393.324449421427,23416.204913015314,23370.44398582754,60374,196830.66666666666,25.805788862221448,41.329829470938975,NaN,NaN,NaN,NaN,102.5701831334733,31.047107071673725,10036683,-54.183646901207624,-94.10298983531175,-39.91934293410412
2025-08-20T02:00:00-04:00,23365.25,23439.5,23344.75,23432.25,NaN,NaN,NaN,23671.954746349078,NaN,NaN,23766.52,24093.491708867503,23439.548291132498,23623.947231264166,23397.837757861416,23416.917529046274,23378.75798667656,89421,197911.23333333334,32.301085576823496,39.76170420552982,NaN,NaN,NaN,NaN,102.01159862393948,32.51109198356178,10126104,-48.77733520502429,-100.89101194038449,-52.113676735360194
2025-08-20T06:00:00-04:00,23432.75,23452,23146,23173.75,NaN,NaN,NaN,23632.858301942033,NaN,NaN,23759.81,24119.734263699695,23399.885736300308,23623.947231264166,23315.05232240717,23385.300907108835,23244.803737705504,345495,202639.06666666668,23.63813600891443,37.75484832757882,NaN,NaN,NaN,NaN,116.5821987222295,34.74440239356577,9780609,-58.85353091304121,-125.68059037666171,-66.8270594636205
2025-08-20T10:00:00-04:00,23174.25,23315.5,23035.25,23265.25,NaN,NaN,NaN,23532.27383367194,NaN,NaN,23753.865,24135.776995229233,23371.95300477077,23609.111228009067,23249.527555633817,23319.409976951614,23179.64513431602,869912,212963.8,30.72080181820236,36.75853300314891,NaN,NaN,NaN,NaN,128.27275595635598,37.158625164295614,10650521,-55.63533004888092,-136.37122202472165,-80.73589197584073
2025-08-20T14:00:00-04:00,23264.75,23368.5,23191,23318.75,NaN,NaN,NaN,23532.27383367194,NaN,NaN,23747.365,24147.194653852726,23347.535346147277,23609.111228009067,23256.85856971374,23322.572858501513,23191.144280925964,297526,216199.73333333334,34.54366941173066,36.08603766730565,NaN,NaN,NaN,NaN,131.78898767375912,38.63588321650323,10948047,-46.55142942968527,-138.92517876294733,-92.37374933326205
2025-08-20T18:00:00-04:00,23322,23355.75,23267.5,23353,NaN,NaN,NaN,23532.27383367194,NaN,NaN,23740.42,24155.07061726698,23325.769382733015,23558.03898240725,23325.416666666668,23325.416666666668,23325.416666666668,76283,217271.86666666667,36.94258009108435,35.511012872003406,NaN,NaN,NaN,NaN,128.67905998277632,40.007622836410306,11024330,-35.38960482685131,-136.6107553668262,-101.22115053997489
2025-08-20T22:00:00-04:00,23353,23369.5,23311.5,23341.25,NaN,NaN,NaN,23532.27383367194,NaN,NaN,23731.9,24161.24149578149,23302.558504218512,23400.8561859258,23331.42685326149,23338.912429492106,23323.941277030877,49176,217997.2,36.44905339433988,34.706098529807555,NaN,NaN,NaN,NaN,123.6305556982923,41.06999764616781,10975154,-26.365451484497072,-134.17796489559623,-107.81251341109916
2025-08-21T02:00:00-04:00,23341.25,23368.25,23289.75,23304.5,NaN,NaN,NaN,23532.27383367194,NaN,NaN,23722.845,24168.455142276358,23277.234857723644,23204.909948740642,23327.610997077918,23335.46673869828,23319.755255457556,70634,219127.43333333332,34.87956313843644,33.89652927879772,NaN,NaN,NaN,NaN,120.4069445769857,42.15623582297063,10904520,-20.68955950287966,-133.67446278969874,-112.98490328681908
2025-08-21T06:00:00-04:00,23304.5,23335,23175,23186.5,NaN,NaN,NaN,23532.27383367194,NaN,NaN,23711.8,24181.98450633745,23241.61549366255,23185.902958992512,23266.363257385434,23312.369504993436,23220.35700977743,351212,220933.93333333332,30.359211636618312,32.96986432743634,NaN,NaN,NaN,NaN,123.23501996434386,43.63194546050176,10553308,-22.547862006223028,-141.16973079459785,-118.62186878837483
2025-08-21T10:00:00-04:00,23186,23348.25,23119.5,23215.25,NaN,NaN,NaN,23532.27383367194,NaN,NaN,23701.64,24191.92056416709,23211.35943583291,23173.64289375521,23243.276287956567,23278.121276423066,23208.43129949007,809476,229348.53333333333,32.64946099829238,31.84523059385339,NaN,NaN,NaN,NaN,130.77180425260502,45.194188323168554,11362784,-19.614403059495743,-143.1398726127445,-123.52546955324877
2025-08-21T14:00:00-04:00,23214.5,23254.75,23179.25,23222.5,NaN,NaN,NaN,23532.27383367194,NaN,NaN,23691.19,24199.27840333169,23183.101596668308,23173.64289375521,23239.671056431864,23272.990910383316,23206.35120248041,234743,229696.56666666668,33.24564937984495,31.347918881922983,NaN,NaN,NaN,NaN,126.82381823456181,46.644842409930575,11597527,-15.158712212925252,-142.47385981940533,-127.31514760648008
2025-08-21T18:00:00-04:00,23228,23253,23180.25,23206,NaN,NaN,NaN,23532.27383367194,NaN,NaN,23681.355,24207.279158886107,23155.43084111389,23086.314315004165,23213.083333333332,23213.083333333332,23213.083333333332,70931,230507.53333333333,32.53967925761788,31.441435943366976,NaN,NaN,NaN,NaN,122.96140264637883,47.99187834763817,11526596,-11.463610323170258,-141.64466051044292,-130.18105018727266
2025-08-21T22:00:00-04:00,23206.5,23234,23180.75,23191,NaN,NaN,NaN,23532.27383367194,NaN,NaN,23672.575,24216.001832701375,23129.148167298627,23054.896914740566,23208.87019787899,23214.282791416674,23203.457604341307,42977,230729.03333333333,31.876973743814602,31.58741453066381,NaN,NaN,NaN,NaN,117.98201674306605,49.242697432652356,11483619,-8.317079820916604,-140.57739996341843,-132.26032014250183
2025-08-22T02:00:00-04:00,23190.75,23256.75,23074.25,23252.25,NaN,NaN,NaN,23520.66128782529,NaN,NaN,23664.455,24220.48235265424,23108.427647345765,23054.896914740566,23201.938231827382,23210.147059648545,23193.72940400622,104979,232384.46666666667,37.476486149223916,32.38772424765464,NaN,NaN,NaN,NaN,122.59044411856134,50.79152732228277,11588598,-0.7942763916936713,-133.2531656321189,-132.45888924042524
2025-08-22T06:00:00-04:00,23252.75,23343,23206.25,23265.25,NaN,NaN,NaN,23520.66128782529,NaN,NaN,23657.175,24224.27679200926,23090.07320799074,23054.896914740566,23239.811036383842,23274.89446827301,23204.727604494674,261601,232776.43333333332,38.62950875202172,33.30370423978322,NaN,NaN,NaN,NaN,123.60184096723552,50.757635630445094,11850199,5.999740376411381,-124.959213769911,-130.95895414632238
2025-08-22T10:00:00-04:00,23269.5,23650,23269.5,23605.5,23065.87628526663,23065.87628526663,23065.87628526663,NaN,NaN,NaN,23656.575,24223.83071173856,23089.319288261442,23204.292020043362,23410.733254194773,23541.612585247767,23279.853923141778,841455,242326.06666666668,59.61928829882858,35.25500443421216,NaN,NaN,NaN,NaN,142.25528089814728,47.33229662726289,12691654,32.85147006110162,-89.89461656994536,-122.74608663104698
2025-08-22T14:00:00-04:00,23606.25,23617,23531.25,23582.75,23186.461454118144,NaN,NaN,NaN,NaN,NaN,23655.16,24222.792176325514,23087.527823674485,23217.558616034687,23432.97912060802,23567.29747087891,23298.660770337126,204191,242504.16666666666,58.18631827258893,37.72273173876034,NaN,NaN,NaN,NaN,138.21918940542247,44.151624695736565,12487463,47.62668646772826,-63.21272854638664,-110.8394150141149
2025-08-24T18:00:00-04:00,23600,23610,23534.25,23535.25,23191.752978930956,NaN,NaN,NaN,NaN,NaN,23647.585,24211.293422945768,23083.87657705423,23252.57189282775,23559.833333333332,23559.833333333332,23559.833333333332,79415,243488.53333333333,55.20293285451425,39.47145538421119,NaN,NaN,NaN,NaN,133.7571044478923,41.19814361646211,12408048,52.36999902185423,-45.376916236797115,-97.74691525865134
2025-08-24T22:00:00-04:00,23534.75,23568.5,23518.5,23565.5,23191.752978930956,NaN,NaN,NaN,NaN,NaN,23639.92,24197.428012857712,23082.411987142284,23257.5575142622,23556.704377123737,23560.990428805577,23552.418325441897,42324,243909.1,56.72468923898964,41.05581394330112,NaN,NaN,NaN,NaN,127.7744541301857,38.59345047631753,12450372,55.4193178501522,-28.472767945961095,-83.89208579611329
2025-08-25T02:00:00-04:00,23565.5,23568.5,23486.25,23504,23191.752978930956,NaN,NaN,NaN,NaN,NaN,23631.425,24183.99231942807,23078.857680571928,23278.62101140976,23543.78045559119,23561.799785095252,23525.761126087127,65022,243309.6,52.797824022502475,42.18833136697384,NaN,NaN,NaN,NaN,124.52270740660101,36.46020175690933,12385350,51.265441406646545,-19.810284037805104,-71.07572544445165
2025-08-25T06:00:00-04:00,23504,23520.5,23445,23519.5,23191.752978930956,NaN,NaN,NaN,NaN,NaN,23622.91,24168.953869666097,23076.866130333903,23278.62101140976,23515.582357716597,23542.366405512912,23488.798309920283,255865,244916.26666666666,53.66837197110971,43.41828269388596,NaN,NaN,NaN,NaN,121.02108544898667,34.835390460812164,12641215,47.61161058604855,-11.561212211890961,-59.17282279793951
2025-08-25T10:00:00-04:00,23519,23616.75,23504.5,23578,23203.553635639946,NaN,NaN,NaN,NaN,NaN,23614.35,24149.41217395758,23079.28782604242,23344.902447302247,23542.577789084764,23573.882108162998,23511.27347000653,501235,245734.2,56.89927624660049,44.99111934446911,NaN,NaN,NaN,NaN,120.39457934548761,32.34784370909267,13142450,47.09838157646829,-0.29984582735414733,-47.39822740382244
2025-08-25T14:00:00-04:00,23578.25,23584.75,23485.5,23502.25,23203.553635639946,NaN,NaN,NaN,NaN,NaN,23604.05,24127.391389535085,23080.708610464913,23344.902447302247,23539.44169155729,23568.78348311411,23510.09990000047,193783,246821.46666666667,51.856590084474966,46.52664637645888,NaN,NaN,NaN,NaN,118.88425224938136,30.215268426879323,12948667,39.90565714506798,2.483844027512532,-37.421813117555445
2025-08-25T18:00:00-04:00,23510.25,23520.5,23371.25,23424.75,23203.553635639946,NaN,NaN,NaN,NaN,NaN,23593.77,24110.561494124606,23076.978505875395,23344.902447302247,23438.833333333332,23438.833333333332,23438.833333333332,132493,249421.63333333333,47.24341217442224,47.56907146046815,NaN,NaN,NaN,NaN,121.0532342315684,29.205901094410997,12816174,28.700774910307267,-1.5458444796713593,-30.246619389978626
2025-08-25T22:00:00-04:00,23425,23484.25,23423.25,23476.25,23203.553635639946,NaN,NaN,NaN,NaN,NaN,23584.74,24093.590419671105,23075.889580328898,23344.902447302247,23444.590056560555,23454.383252327298,23434.796860793813,45782,249442,50.40102692901191,48.79445557112293,NaN,NaN,NaN,NaN,116.76371750074209,28.268631428547547,12861956,23.73559209563866,-0.577129270430305,-24.312721366068963
2025-08-26T02:00:00-04:00,23476.5,23484.25,23415.25,23474.25,23203.553635639946,NaN,NaN,NaN,NaN,NaN,23575.6,24075.565698823713,23075.634301176284,23344.902447302247,23448.43326234822,23458.66533091455,23438.201193781886,72247,250156.43333333332,50.275179738075025,50.06127703401273,NaN,NaN,NaN,NaN,113.35202339354623,27.465403559123665,12789709,19.47327185228847,0.0288684492916218,-19.444403402996848
2025-08-26T06:00:00-04:00,23474.25,23518.5,23426.75,23494.5,23203.553635639946,NaN,NaN,NaN,NaN,NaN,23567.295,24058.50115519385,23076.088844806145,23344.902447302247,23465.014611181963,23482.238188755775,23447.79103360815,278753,249948.9,51.59310588498435,51.46957218695343,NaN,NaN,NaN,NaN,111.80902172257865,26.30933244009982,13068462,17.25048961659068,2.118708617741504,-15.131780998849177
2025-08-26T10:00:00-04:00,23493.5,23556.25,23479,23502.25,23203.553635639946,NaN,NaN,NaN,NaN,NaN,23558.805,24039.426475695425,23078.183524304575,23344.902447302247,23488.06769391345,23514.82351460401,23461.31187322289,499397,242539.5,52.116185684488414,52.5152650109009,NaN,NaN,NaN,NaN,109.34052017096589,24.798304456414087,13567859,15.585534056470063,4.350136571738403,-11.23539748473166
2025-08-26T14:00:00-04:00,23502.75,23611,23498.75,23607.25,23218.828651122425,NaN,NaN,NaN,NaN,NaN,23552.22,24020.83394174695,23083.60605825305,23369.98562011648,23503.617952874713,23544.266563703688,23462.969342045737,232788,242364.2,58.63756041164498,53.94441155801684,NaN,NaN,NaN,NaN,109.54834015875404,23.253427013227228,13800647,20.528238392894625,14.42490050638662,-6.103337886508004
2025-08-26T18:00:00-04:00,23607.25,23629,23594.5,23627.5,23286.27393970777,NaN,NaN,NaN,NaN,NaN,23545.52,23999.839775488337,23091.200224511664,23418.938496093186,23617,23617,23617,42256,240724.86666666667,59.77535292620303,53.95555903140073,NaN,NaN,NaN,NaN,104.18774443312876,22.007480522255005,13842903,23.898056195802454,23.769232358245063,-0.12882383755739024
2025-08-26T22:00:00-04:00,23627.5,23628.75,23592.25,23600.5,23294.841033357417,NaN,NaN,NaN,NaN,NaN,23539.71,23983.517101791273,23095.902898208726,23442.450796874546,23612.79119064378,23617.65663503546,23607.9257462521,31620,239766.4,57.50403128909231,53.906824246865256,NaN,NaN,NaN,NaN,99.35290554504813,20.822891184920067,13811283,23.035514654257767,28.66556948026482,5.630054826007052
2025-08-27T02:00:00-04:00,23600.25,23619.75,23567.5,23596.75,23294.841033357417,NaN,NaN,NaN,NaN,NaN,23533.575,23965.41643212531,23101.733567874693,23444.585637499637,23605.349604133924,23615.01661254977,23595.682595718077,51461,238501.06666666668,57.17905948334736,54.04797614892476,NaN,NaN,NaN,NaN,95.9884122918304,19.410241986412338,13759822,20.996686209182997,31.8759125874858,10.879226378302802
2025-08-27T06:00:00-04:00,23596.25,23621,23488.5,23534.75,23294.841033357417,NaN,NaN,NaN,NaN,NaN,23525.43,23941.214668307926,23109.645331692074,23444.585637499637,23566.25985843028,23593.46606087771,23539.05365598285,269545,235969.4,51.951591807844984,53.707040618128715,NaN,NaN,NaN,NaN,98.59638284241395,18.850595116817185,13490277,14.562228065092269,29.082011459668138,14.51978339457587
2025-08-27T10:00:00-04:00,23534.75,23631.75,23526.25,23621.25,23294.841033357417,NaN,NaN,NaN,NaN,NaN,23520.27,23924.608742145625,23115.931257854376,23444.585637499637,23580.835729562576,23603.562028428616,23558.109430696535,469949,222637.3,57.754478909663895,54.061087395783105,NaN,NaN,NaN,NaN,99.0894983536701,18.187670143759686,13960226,15.15371212503156,33.46192355086532,18.30821142583376
2025-08-27T14:00:00-04:00,23621.25,23685,23429,23542.25,23294.841033357417,NaN,NaN,NaN,NaN,NaN,23514.98,23911.024023310663,23118.935976689336,23444.585637499637,23573.53785615227,23596.8179762064,23550.25773609814,294177,222525.66666666666,51.62251054423673,53.91495443672075,NaN,NaN,NaN,NaN,110.29739132840794,18.53467178727934,13666049,9.521552334503475,30.210151843963104,20.688599509459628
2025-08-27T18:00:00-04:00,23543,23552.5,23486.75,23547.5,23294.841033357417,NaN,NaN,NaN,NaN,NaN,23509.135,23894.31128704328,23123.958712956715,23444.585637499637,23528.916666666668,23528.916666666668,23528.916666666668,75411,222496.6,51.98733750177448,53.564101669233175,NaN,NaN,NaN,NaN,107.11543480495024,18.856887599119016,13741460,5.6387169062947855,27.73699564232811,22.098278736033325
2025-08-27T22:00:00-04:00,23548,23584.5,23539,23542.75,23294.841033357417,NaN,NaN,NaN,NaN,NaN,23504.06,23880.546195762716,23127.573804237287,23444.585637499637,23539.373061175338,23552.32521421475,23526.420908135926,49149,222495.7,51.60812671777291,53.546354285897316,NaN,NaN,NaN,NaN,102.71433231888237,18.683159883912893,13692311,2.4048403329683268,25.104329152243736,22.69948881927541
2025-08-28T02:00:00-04:00,23542.75,23662,23540,23614.25,23294.841033357417,NaN,NaN,NaN,NaN,NaN,23498.71,23860.907092202768,23136.51290779723,23444.585637499637,23565.068868621674,23598.821753605127,23531.315983638222,79327,222785.46666666667,56.72513311178,54.22362006713716,NaN,NaN,NaN,NaN,104.09188001039078,17.498372862847532,13771638,4.607859499693866,28.45931319389274,23.851453694198874
2025-08-28T06:00:00-04:00,23614.75,23743.25,23572.5,23609.25,23328.49848841634,NaN,NaN,NaN,NaN,NaN,23493.85,23843.235947055633,23144.464052944364,23453.867410685365,23614.536538931472,23656.31664242945,23572.756435433494,371757,223470.3,56.276983543474095,54.643331253884455,NaN,NaN,NaN,NaN,108.85317429536288,16.988456750191887,13399881,5.210580155142459,30.364678888126946,25.154098732984487
2025-08-28T10:00:00-04:00,23609.5,23774.5,23593.25,23766.25,23344.75423894287,NaN,NaN,NaN,NaN,NaN,23493.995,23843.826723690116,23144.163276309882,23453.867410685365,23663.93966923111,23720.47342123125,23607.405917230968,600051,216489.46666666667,65.49510624492403,55.73046886151652,NaN,NaN,NaN,NaN,114.02437613140839,16.8229530071106,13999932,15.105254666252591,44.035667065800226,28.930412399547635
2025-08-28T14:00:00-04:00,23766.25,23803.75,23751.25,23761.25,23446.63472808183,NaN,NaN,NaN,NaN,NaN,23494.245,23844.821660518388,23143.66833948161,23519.795142838633,23678.727400771113,23743.066756588192,23614.388044954034,186232,214872.43333333332,65.02492289108312,56.689884361952146,NaN,NaN,NaN,NaN,109.62977783630778,16.951125195336086,13813700,19.932361181655438,53.84586387661693,33.913502694961494
2025-08-28T18:00:00-04:00,23761,23762.75,23729.5,23733,23446.63472808183,NaN,NaN,NaN,NaN,NaN,23493.705,23842.722316045038,23144.687683954966,23519.795142838633,23741.75,23741.75,23741.75,42956,213939.93333333332,62.30345232301348,57.417546264703944,NaN,NaN,NaN,NaN,104.17407941942865,16.767587327904817,13770744,19.800978785704594,58.664726177092234,38.86374739138764
2025-08-28T22:00:00-04:00,23732.75,23741,23713.5,23724.5,23446.63472808183,NaN,NaN,NaN,NaN,NaN,23492.405,23837.467398560544,23147.342601439454,23532.218891416724,23735.146843405775,23742.77553839714,23727.51814841441,32183,213580.13333333333,61.46982691456451,57.61985101491248,NaN,NaN,NaN,NaN,98.69735946089803,16.372387436371824,13738561,17.783867308730336,61.09358152730056,43.30971421857022
2025-08-29T02:00:00-04:00,23724.25,23737,23612,23645.5,23446.63472808183,NaN,NaN,NaN,NaN,NaN,23489.885,23828.53848381538,23151.231516184616,23532.218891416724,23697.496217460473,23732.947767533864,23662.044667387083,86613,212967.93333333332,54.20992893292698,57.22232072967848,NaN,NaN,NaN,NaN,100.57611949940531,15.65751398523669,13651948,10.150879363103364,55.99831342244943,45.847434059346064
2025-08-29T06:00:00-04:00,23646.25,23680.75,23507,23519.25,23446.63472808183,NaN,NaN,NaN,NaN,NaN,23485.545,23816.942294648215,23154.14770535178,23532.218891416724,23612.462619750626,23676.656760675236,23548.268478826016,316464,214796.7,45.052450146336575,56.332922076624506,NaN,NaN,NaN,NaN,105.80282524944778,15.99592675705994,13335484,-3.6404178372063427,41.296911762838135,44.93732960004448
2025-08-29T10:00:00-04:00,23519.5,23551.75,23401.5,23459.75,NaN,NaN,NaN,23804.487650002226,23804.487650002226,23804.487650002226,23478.985,23798.983490777035,23158.986509222967,23532.218891416724,23528.140421790886,23608.65588248779,23447.62496109398,705704,210271.66666666666,41.49481672459776,55.21261902242811,NaN,NaN,NaN,NaN,108.9776234459158,17.10348936326045,12629780,-16.30053507533414,24.5616607558768,40.86219583121094
2025-08-29T14:00:00-04:00,23459.5,23495,23425.5,23454.5,NaN,NaN,NaN,23782.687075002123,NaN,NaN,23474.5,23789.419116600104,23159.580883399896,23532.218891416724,23516.638464973606,23594.646260344332,23438.63066960288,233554,211250.43333333332,41.185775051874955,54.443632111287386,NaN,NaN,NaN,NaN,106.15779319977896,18.131940354732357,12396226,-24.088725883487804,10.751288476851187,34.84001436033899
2025-08-31T18:00:00-04:00,23478.5,23555.25,23464.25,23517.5,NaN,NaN,NaN,23782.687075002123,NaN,NaN,23474.715,23789.736554976895,23159.693445023106,23532.218891416724,23512.333333333332,23512.333333333332,23512.333333333332,54111,210406.96666666667,46.34949780110999,53.62899060353353,NaN,NaN,NaN,NaN,105.77152225693762,18.292362026226993,12450337,-24.004559124202597,4.8343154550857435,28.83887457928834
2025-08-31T22:00:00-04:00,23517.75,23518.25,23407.5,23430.25,NaN,NaN,NaN,23782.687075002123,NaN,NaN,23473.855,23789.12253860757,23158.587461392428,23532.218891416724,23478.539231307004,23508.48701070087,23448.59145191314,68903,211292.93333333332,40.982968339900275,52.869023303223784,NaN,NaN,NaN,NaN,106.12712781001349,18.890767955352114,12381434,-28.524456057893424,-6.816695493078441,21.707760564814983
2025-09-01T02:00:00-04:00,23429.75,23502.5,23371.5,23485.25,NaN,NaN,NaN,23762.23417558177,NaN,NaN,23475.98,23790.091681412567,23161.868318587432,23532.218891416724,23468.79990112626,23495.38560145932,23442.214200793198,76230,211666.53333333333,45.283744053663916,52.39019519978732,NaN,NaN,NaN,NaN,107.90376153786967,19.714722823132988,12457664,-26.55007476944548,-11.479832896991866,15.070241872453613
2025-09-01T06:00:00-04:00,23485.5,23501.75,23443.25,23488.75,NaN,NaN,NaN,23762.23417558177,NaN,NaN,23478.44,23790.982694043996,23165.897305956,23532.218891416724,23471.05090499733,23494.45474567555,23447.64706431911,65324,205315.16666666666,45.555646002049635,51.957875148664236,NaN,NaN,NaN,NaN,104.37492142802184,20.479823771786656,12522988,-23.834802731766473,-14.723261542254477,9.111541189511994
2025-09-01T10:00:00-04:00,23488.5,23507,23476,23502.75,NaN,NaN,NaN,23762.23417558177,NaN,NaN,23479.85,23792.18248310158,23167.517516898417,23532.218891416724,23475.365641282868,23498.514565048023,23452.216717517713,57409,190520.96666666667,46.69667047533808,51.241556388918376,NaN,NaN,NaN,NaN,99.13385561173456,21.110259680336796,12580397,-20.073083966106353,-15.979813768120948,4.093270197985405
2025-09-01T18:00:00-04:00,23502.75,23511,23428.25,23438.5,NaN,NaN,NaN,23762.23417558177,NaN,NaN,23485.145,23785.279038222674,23185.010961777327,23507.47511313338,23472.339479039223,23494.130726861356,23450.54823121709,74438,186542.8,42.31384313817164,50.24418921711106,NaN,NaN,NaN,NaN,97.96358021089637,22.08750410907869,12505959,-20.800649753033884,-21.90754199330695,-1.1068922402730657
2025-09-01T22:00:00-04:00,23439,23450.75,23404.75,23413.25,NaN,NaN,NaN,23725.59550321579,NaN,NaN,23488.105,23782.367809237207,23193.842190762793,23410.255090506704,23466.408219324556,23492.40495258994,23440.411486059173,54062,183928.43333333332,40.6972295479383,48.4729123101835,NaN,NaN,NaN,NaN,94.25189591011805,23.178939347412136,12451897,-21.76757414761868,-28.316359924796416,-6.548785777177736
2025-09-02T02:00:00-04:00,23413,23452.25,23267.5,23292.5,NaN,NaN,NaN,23669.37525306962,NaN,NaN,23487.58,23783.14033969331,23192.019660306694,23295.534646365304,23436.78858230013,23495.64436339824,23377.93280120202,134273,186878.13333333333,34.00620835551332,46.25728984335709,NaN,NaN,NaN,NaN,100.71604620225249,25.082750990302188,12317624,-28.878810295782017,-42.647298646905256,-13.76848835112324
2025-09-02T06:00:00-04:00,23292,23311.5,23025,23233.25,NaN,NaN,NaN,23502.750241566453,NaN,NaN,23485.185,23786.944387757572,23183.42561224243,23295.534646365304,23331.09180237342,23461.102061289275,23201.081543457563,437798,199063.16666666666,31.287950947056657,44.04189688793161,NaN,NaN,NaN,NaN,113.98632861637732,27.834816370397554,11879826,-35.47779229130944,-58.11572871526005,-22.637936423950602
2025-09-02T10:00:00-04:00,23230.25,23280.25,23026.5,23189,NaN,NaN,NaN,23502.750241566453,NaN,NaN,23482.14,23792.59499126279,23171.685008737208,23295.534646365304,23260.91897760688,23389.231040615192,23132.60691459857,750035,214772.56666666668,29.397962276008215,41.751049413749016,NaN,NaN,NaN,NaN,123.9694480009218,30.39030565191468,11129791,-40.37164774515584,-73.1024961053954,-32.73084836023956
2025-09-02T14:00:00-04:00,23189.25,23386.5,23157.5,23379.25,NaN,NaN,NaN,23502.750241566453,NaN,NaN,23483.635,23791.361814074477,23175.90818592552,23295.534646365304,23267.81116303219,23387.461587958263,23148.16073810612,305892,208322.4,44.82882995125197,41.08097091505794,NaN,NaN,NaN,NaN,131.47163028657025,31.331939617295113,11435683,-28.88296161006116,-68.83455037281601,-39.95158876275485
2025-09-02T18:00:00-04:00,23381.5,23387.5,23311.75,23336.75,NaN,NaN,NaN,23502.750241566453,NaN,NaN,23486.64,23785.508786594477,23187.771213405522,23295.534646365304,23345.333333333332,23345.333333333332,23345.333333333332,67257,202804.7,42.58946810068859,40.90504362608309,NaN,NaN,NaN,NaN,127.49151383752951,32.19359911634527,11368426,-22.51600284257588,-68.0965923159747,-45.580589473398824
2025-09-02T22:00:00-04:00,23336.5,23339.25,23299.75,23317.25,NaN,NaN,NaN,23502.750241566453,NaN,NaN,23488.68,23781.441234455542,23195.91876554446,23295.534646365304,23335.23653489723,23348.13852000758,23322.334549786883,41190,202769.16666666666,41.56355650544274,40.909953610429156,NaN,NaN,NaN,NaN,121.20640570627741,33.057472572886006,11327236,-18.173885271454964,-68.29794606271753,-50.124060791262565
2025-09-03T02:00:00-04:00,23316.5,23444.5,23309.25,23438.25,NaN,NaN,NaN,23502.750241566453,NaN,NaN,23492.995,23776.138029051122,23209.851970948876,23295.534646365304,23363.872576688842,23396.243566438803,23331.50158693888,92810,204808.83333333334,49.66581677922563,41.51567087666849,NaN,NaN,NaN,NaN,122.20951958440045,32.52349381421943,11420046,-6.320716185489232,-58.024956023124105,-51.70423983763487
2025-09-03T06:00:00-04:00,23437.75,23458.5,23369.75,23381.75,NaN,NaN,NaN,23502.750241566453,NaN,NaN,23496.51,23769.495896339213,23223.524103660784,23295.534646365304,23387.05808100991,23415.51048863458,23358.60567338524,286708,212650.4,46.428711626991806,41.521329007088625,NaN,NaN,NaN,NaN,119.81955389980043,31.864106489269155,11133338,-1.6943573700885253,-53.82218655024553,-52.12782918015701
2025-09-03T10:00:00-04:00,23382.5,23526,23346.25,23365.25,23077.543964352993,23077.543964352993,23077.543964352993,NaN,NaN,NaN,23499.995,23761.49862311127,23238.491376888727,23255.377717092244,23402.440846362268,23424.23100531463,23380.650687409907,746211,228539.26666666666,45.496115258091514,41.84369664410228,NaN,NaN,NaN,NaN,124.10030004981468,30.49020223679045,10387127,0.7164237363902117,-51.23229950966925,-51.94872324605946
2025-09-03T14:00:00-04:00,23365.5,23480,23318.25,23455.5,23077.543964352993,NaN,NaN,NaN,NaN,NaN,23504.06,23756.183433261896,23251.936566738106,23203.577173673795,23405.35881737228,23425.899720270252,23384.817914474304,286776,222433.5,51.26267417617021,42.27076308142416,NaN,NaN,NaN,NaN,126.78956433197077,29.446569993682463,10673903,8.42304926648486,-41.41991166295338,-49.84296092943824
2025-09-03T18:00:00-04:00,23456,23515.25,23430.5,23497.5,23113.540316693532,NaN,NaN,NaN,NaN,NaN,23508.705,23751.441373251753,23265.96862674825,23192.609201852127,23481.083333333332,23481.083333333332,23481.083333333332,63249,214735.9,53.71681391041078,42.853703646307096,NaN,NaN,NaN,NaN,123.78673830825856,28.080106576920716,10737152,15.946613326574308,-29.90969427122036,-45.85630759779467
2025-09-03T22:00:00-04:00,23498.25,23532.5,23458.5,23468.5,23142.407802298374,NaN,NaN,NaN,NaN,NaN,23505.965,23747.35822712064,23264.57177287936,23237.387361481702,23483.595463871203,23486.29668098157,23480.894246760836,54704,214045.66666666666,51.778085519268934,43.21666186373073,NaN,NaN,NaN,NaN,120.23054271481153,26.616802129559176,10682448,18.393640655133765,-22.86425677887746,-41.25789743401123
2025-09-04T02:00:00-04:00,23468.5,23518,23450.5,23516.25,23142.407802298374,NaN,NaN,NaN,NaN,NaN,23504.635,23745.052141860895,23264.2178581391,23248.15988918536,23487.393032471315,23493.174082381825,23481.611982560804,59537,214391.93333333332,54.67856902344069,44.09985656982138,NaN,NaN,NaN,NaN,116.46407537803928,25.338376830139392,10741985,22.38659876344677,-13.27464897970276,-35.66124774314953
2025-09-04T06:00:00-04:00,23516,23548.25,23457.25,23479.25,23159.832315730542,NaN,NaN,NaN,NaN,NaN,23503.515,23743.872970743912,23263.157029256086,23286.87791134829,23491.95490422221,23497.118967322403,23486.790841122016,273380,220860.36666666667,52.06528145033026,44.91186027713509,NaN,NaN,NaN,NaN,114.64521285103648,23.78446204473237,10468605,21.679628277288828,-8.561712396538496,-30.241340673827324
2025-09-04T10:00:00-04:00,23479.25,23604.25,23410,23583.25,23159.832315730542,NaN,NaN,NaN,NaN,NaN,23503.87,23744.645190582374,23263.094809417624,23298.02732907863,23515.42220471107,23535.720043435187,23495.124365986954,619559,229120.43333333332,58.123643824671824,46.63453423921784,NaN,NaN,NaN,NaN,120.33126907596245,22.466376180085216,11088164,27.01277250207236,3.524624953763123,-23.488147548309236
2025-09-04T14:00:00-04:00,23583.5,23709,23582.5,23683.75,23290.763535613987,NaN,NaN,NaN,NaN,NaN,23507.465,23753.451869771736,23261.478130228264,23400.771863262904,23539.805069925103,23596.671930170407,23482.9382096798,220047,216453.63333333333,62.991363456311745,48.89906370416463,NaN,NaN,NaN,NaN,120.77189271339371,22.241556906254768,11308211,35.567241982330124,20.97090492960342,-14.596337052726705
2025-09-04T18:00:00-04:00,23694,23739.5,23691.75,23735,23369.172011267896,NaN,NaN,NaN,NaN,NaN,23511.775,23765.872269760337,23257.677730239666,23465.042490610325,23722.08333333333,23722.083678600313,23722.082988066344,47627,211833.46666666667,65.21210161562377,51.45721651413718,NaN,NaN,NaN,NaN,116.12747180529416,22.287974209045032,11355838,42.46825141751519,38.48897721916728,-3.979274198347907
2025-09-04T22:00:00-04:00,23734.75,23770.25,23718,23761.25,23406.294874392082,NaN,NaN,NaN,NaN,NaN,23515.44,23778.384586557473,23252.495413442524,23524.55899248826,23733.473453527426,23747.12413106879,23719.82277598606,33159,211506.9,66.32665444415319,52.99277540648727,NaN,NaN,NaN,NaN,111.56479524777316,22.583721453772494,11388997,46.27890648045908,53.86935890222594,7.590452421766864
2025-09-05T02:00:00-04:00,23761.5,23792,23743.5,23783.75,23438.662152828805,NaN,NaN,NaN,NaN,NaN,23521.07,23794.489769585067,23247.650230414933,23571.197193990607,23749.926356042182,23772.0609293811,23727.791782703265,57398,212347.4,67.29390514104163,54.75737805222677,NaN,NaN,NaN,NaN,107.06016701578936,23.035763618573554,11446395,47.60803122934218,67.1004914584446,19.492460229102413
2025-09-05T06:00:00-04:00,23784,23902.5,23725,23852.75,23475.41614588204,NaN,NaN,NaN,NaN,NaN,23529.63,23816.899912103447,23242.360087896555,23637.107755192486,23806.968505409142,23842.387914805568,23771.549096012717,398469,222742.6,70.12772559263252,56.79767584416889,NaN,NaN,NaN,NaN,112.09158365751868,24.247214526953805,11844864,50.17111897122571,82.20635894313455,32.03523997190884
2025-09-05T10:00:00-04:00,23852.75,23854,23505,23614,23475.41614588204,NaN,NaN,NaN,NaN,NaN,23532.385,23820.19596591354,23244.574034086458,23637.107755192486,23708.767782826166,23782.575319785814,23634.960245866518,1031283,246569.9,53.01195574805614,57.036685770513934,NaN,NaN,NaN,NaN,129.01361339626735,22.866762920054384,10813581,33.6190333479606,74.05903165685959,40.439998308898986
2025-09-05T14:00:00-04:00,23614,23696.25,23602.75,23673,23475.41614588204,NaN,NaN,NaN,NaN,NaN,23536.36,23826.33134617045,23246.388653829552,23637.107755192486,23701.586460291623,23772.330763767284,23630.84215681596,254442,231527.83333333334,55.87782833751838,57.71162267840869,NaN,NaN,NaN,NaN,126.47692672510539,21.584914999362066,11068023,24.87869988553851,71.53837316582212,46.65967328028361
2025-09-07T18:00:00-04:00,23676.5,23792,23650.5,23768,23475.41614588204,NaN,NaN,NaN,NaN,NaN,23541.83,23838.673535216283,23244.98646478372,23637.107755192486,23736.833333333332,23736.833333333332,23736.833333333332,92133,226813.8,60.09791505670662,58.754608378309776,NaN,NaN,NaN,NaN,127.55000338759785,21.157073511458055,11160156,23.733536369518717,76.32659374218201,52.593057372663296
2025-09-07T22:00:00-04:00,23768.75,23771.25,23726.25,23731.25,23475.41614588204,NaN,NaN,NaN,NaN,NaN,23546.41,23847.70262785551,23245.11737214449,23637.107755192486,23738.817044462652,23741.668792361364,23735.96529656394,44581,226496.13333333333,57.795024141835626,59.22120480442873,NaN,NaN,NaN,NaN,121.65357457419802,20.759792129832903,11115575,18.946838858643915,76.27660594596819,57.32976708732427
2025-09-08T02:00:00-04:00,23730.75,23785.25,23730.25,23781.5,23475.41614588204,NaN,NaN,NaN,NaN,NaN,23549.895,23857.87865362405,23241.91134637595,23637.107755192486,23746.490208601073,23758.857603490665,23734.12281371148,54704,226022.83333333334,60.04927395987814,59.67352337939068,NaN,NaN,NaN,NaN,116.8926049617553,20.503519482850912,11170279,17.637578055024747,79.3767396561052,61.739161601080454
2025-09-08T06:00:00-04:00,23781.25,23876.5,23744,23845.5,23475.41614588204,NaN,NaN,NaN,NaN,NaN,23554.255,23872.510675361147,23235.999324638855,23637.107755192486,23790.186057069026,23828.3250066847,23752.047107453353,262909,232245.46666666667,62.77628381008731,60.459108971591995,NaN,NaN,NaN,NaN,118.00741889305849,20.951428255721947,11433188,19.413834094531566,86.00645421924492,66.59262012471335
2025-09-08T10:00:00-04:00,23846.25,23888,23762.25,23782.5,23475.41614588204,NaN,NaN,NaN,NaN,NaN,23557.895,23882.287125212362,23233.50287478764,23637.107755192486,23801.76005186996,23829.11804282531,23774.402060914606,574271,249210.36666666667,58.540227768634175,60.734941739105814,NaN,NaN,NaN,NaN,118.56046040069717,21.448365342248284,10858917,14.881826678444924,85.19490347276951,70.31307679432459
2025-09-08T14:00:00-04:00,23782.75,23819.75,23758.5,23798.5,23475.41614588204,NaN,NaN,NaN,NaN,NaN,23561.93,23893.103082239068,23230.756917760933,23637.107755192486,23800.05956604653,23825.117661898366,23775.001470194693,223971,254762.43333333332,59.29153052977575,61.25110238763763,NaN,NaN,NaN,NaN,114.46685608636166,21.860375899647224,11082888,11.641174005613195,84.86454430134108,73.22337029572789
2025-09-08T18:00:00-04:00,23799.75,23831.25,23790.75,23813.75,23475.877419261866,NaN,NaN,NaN,NaN,NaN,23567.51,23905.98456270766,23229.035437292336,23637.107755192486,23811.91666666667,23811.91666666667,23811.91666666667,46019,253815.13333333333,60.03489798445455,61.387620541907836,NaN,NaN,NaN,NaN,109.18350922305011,22.334219686707705,11128907,9.305401998001201,84.85512279322938,75.54972079522818
2025-09-08T22:00:00-04:00,23814.25,23847.5,23814.25,23834.5,23506.382991113598,NaN,NaN,NaN,NaN,NaN,23571.775,23918.13308421294,23225.416915787064,23645.98959228249,23821.000156246893,23831.03379583446,23810.966516659326,37716,253270.26666666666,61.076410734329684,61.2508382046234,NaN,NaN,NaN,NaN,103.79540142140367,22.9071074309839,11166623,7.989024946766108,85.53600197868582,77.54697703191971
2025-09-09T02:00:00-04:00,23834.75,23885.25,23830.25,23844.5,23540.50762788116,NaN,NaN,NaN,NaN,NaN,23577.82,23932.35960342956,23223.28039657044,23696.541673825996,23834.107375675503,23851.766978904714,23816.447772446292,57086,250697.36666666667,61.59584248126704,60.99253398074078,NaN,NaN,NaN,NaN,100.31001560558911,23.743095980823853,11223709,6.676343075557,85.89240587636596,79.21606280080896
2025-09-09T06:00:00-04:00,23844.5,23860,23800.25,23815,23540.50762788116,NaN,NaN,NaN,NaN,NaN,23583.17,23943.739888371336,23222.60011162866,23696.541673825996,23828.52976361595,23840.291052806217,23816.76847442568,227901,243700.8,59.09065013561016,60.47567653013056,NaN,NaN,NaN,NaN,97.41287163376133,24.041467361596894,10995808,2.8987757672415313,82.83953250986087,79.94075674261934
2025-09-09T10:00:00-04:00,23816,23855.25,23726.5,23839.5,23540.50762788116,NaN,NaN,NaN,NaN,NaN,23589.105,23956.522270824436,23221.687729175563,23696.541673825996,23815.283709834308,23827.99254389047,23802.574875778148,595596,238552.83333333334,60.526547955978025,59.992293874054596,NaN,NaN,NaN,NaN,99.65123794563553,23.256006996541775,11591404,1.2138392899690018,81.4580558550806,80.2442165651116
2025-09-09T14:00:00-04:00,23839,23918,23822,23889,23556.80781760025,NaN,NaN,NaN,NaN,NaN,23594.6,23971.454149506397,23217.7458504936,23702.76133699891,23826.390510725985,23852.598047999305,23800.182973452665,214455,235504.93333333332,63.32725794457506,59.50654618490763,NaN,NaN,NaN,NaN,99.39043523523299,23.124727033713643,11805859,2.5215254411278067,83.39612336652135,80.87459792539354
2025-09-09T18:00:00-04:00,23900.25,23911.75,23874,23902.5,23588.771098618417,NaN,NaN,NaN,NaN,NaN,23600.465,23987.05066980642,23213.87933019358,23720.684069599127,23896.08333333333,23896.083678600313,23896.082988066344,45122,234767.1,64.0758796718506,60.296826465178654,NaN,NaN,NaN,NaN,94.9875470041449,23.002824211087518,11850981,3.333195446187915,85.04109223312844,81.70789678694052
2025-09-09T22:00:00-04:00,23903.25,23930,23897.25,23918.75,23618.87809413576,NaN,NaN,NaN,NaN,NaN,23603.515,23997.617682178035,23209.412317821963,23760.7722556793,23903.84302325581,23913.28554639952,23894.4005001121,30472,234409.83333333334,65.00199820036832,60.94855288395365,NaN,NaN,NaN,NaN,90.54200793242026,23.066200669356114,11881453,3.959324606258903,86.65705254476416,82.69772793850525
2025-09-10T02:00:00-04:00,23918.75,23953.75,23881,23908.75,23626.1052262205,NaN,NaN,NaN,NaN,NaN,23606.465,24007.395368143876,23205.534631856124,23781.992804543443,23908.626970182984,23917.41518801078,23899.83875235519,61576,233368.7,63.91010223560314,61.22085196816055,NaN,NaN,NaN,NaN,89.27115022296167,23.354606382914223,11819877,2.752099857133942,86.13785275992268,83.38575290278874
2025-09-10T06:00:00-04:00,23909,24041,23894.25,23930.75,23669.583397755934,NaN,NaN,NaN,NaN,NaN,23610.42,24020.07175991346,23200.768240086538,23830.219243634754,23941.291717623782,23963.24359192133,23919.339843326234,319096,234448.3,65.29143580508276,61.756309944106775,NaN,NaN,NaN,NaN,93.37678234989298,24.36773881936947,12138973,2.4949417617866345,86.50443010502204,84.0094883432354
2025-09-10T10:00:00-04:00,23930.5,23990.75,23875.5,23898,23669.583397755934,NaN,NaN,NaN,NaN,NaN,23613.89,24030.232937493027,23197.547062506972,23830.219243634754,23930.25073257504,23947.906468690708,23912.594996459375,570250,228582.93333333332,61.51675985520929,61.86113036520186,NaN,NaN,NaN,NaN,94.93915503918633,24.99348822657701,11568723,-0.6529558795036081,83.19329349385589,83.8462493733595
2025-09-10T14:00:00-04:00,23897.5,23899.75,23785,23859,23669.583397755934,NaN,NaN,NaN,NaN,NaN,23618.16,24040.05440337651,23196.26559662349,23830.219243634754,23911.593447463558,23949.397184348596,23873.78971057852,300769,229049.36666666667,57.27062881772664,61.46786929431895,NaN,NaN,NaN,NaN,96.35421539353015,24.21603543876518,11267954,-5.845067249572395,76.539915311394,82.38498256096639
2025-09-10T18:00:00-04:00,23856.75,23916.75,23851.5,23907.5,23669.583397755934,NaN,NaN,NaN,NaN,NaN,23625.925,24054.49058716324,23197.35941283676,23830.219243634754,23891.916666666668,23891.916666666668,23891.916666666668,53052,228709.46666666667,60.886313164348664,61.635446822584264,NaN,NaN,NaN,NaN,94.13248572256371,23.666440640427666,11321006,-6.448905449626565,74.32385074893318,80.77275619855975
2025-09-10T22:00:00-04:00,23907.5,23919,23871.5,23885.5,23669.583397755934,NaN,NaN,NaN,NaN,NaN,23634.44,24066.365509318814,23202.514490681184,23830.219243634754,23891.948844044342,23891.9894154859,23891.908272602785,33370,227998.33333333334,58.46941484091933,61.576724273380236,NaN,NaN,NaN,NaN,90.80159388523774,23.179879751650976,11287636,-8.629695659238806,69.98563662451124,78.61533228375005
2025-09-11T02:00:00-04:00,23885,23942,23878.25,23920.25,23669.583397755934,NaN,NaN,NaN,NaN,NaN,23643.755,24079.82527518476,23207.68472481524,23830.219243634754,23899.423149596776,23909.680622789387,23889.165676404165,45887,227543.33333333334,61.09633023111174,61.65254086242719,NaN,NaN,NaN,NaN,88.86933717914933,22.97781791299633,11333523,-8.043246967765398,68.5612735740433,76.6045205418087
2025-09-11T06:00:00-04:00,23920,23997.75,23845,23979.25,23669.583397755934,NaN,NaN,NaN,NaN,NaN,23652.99,24097.450875218197,23208.529124781806,23830.219243634754,23928.931624473844,23948.32802359549,23909.535225352196,332699,229520.63333333333,65.12926354040474,61.94203034857539,NaN,NaN,NaN,NaN,93.43224166635295,23.352927498896683,11666222,-4.187178618487167,71.37054726869974,75.5577258871869
2025-09-11T10:00:00-04:00,23978.75,24048.75,23946.75,24032.5,23703.522745729853,NaN,NaN,NaN,NaN,NaN,23665.035,24117.27201761389,23212.79798238611,23830.219243634754,23971.295757249572,24013.59725293149,23928.994261567655,517900,226132,68.32118156287856,62.422411711547646,NaN,NaN,NaN,NaN,94.0442244044706,24.156441173666508,12184122,1.1586743746260737,77.0060688554695,75.84739448084342
2025-09-11T14:00:00-04:00,24032.75,24044.25,24003.75,24006.5,23737.623984560316,NaN,NaN,NaN,NaN,NaN,23675.46,24134.61754768948,23216.30245231052,23835.092946818168,23978.431941073544,24020.864579699406,23935.999302447683,176526,224681.3,65.18379060402488,62.85763603072013,NaN,NaN,NaN,NaN,90.21963694700841,24.902561014524206,12007596,2.0978663622426836,78.46972743364677,76.37186107140408
2025-09-11T18:00:00-04:00,24028,24029.5,24001,24004.75,23738.004712534846,NaN,NaN,NaN,NaN,NaN,23685.78,24150.84488407561,23220.715115924388,23847.924357454536,24011.75,24011.75,24011.75,40857,224455.63333333333,64.96753913173498,63.17484968613134,NaN,NaN,NaN,NaN,85.81109145079351,25.542294222056366,11966739,1.7686114926749497,78.58262543724777,76.81401394457282
2025-09-11T22:00:00-04:00,24004.5,24039.5,23992,24035,23744.62949832872,NaN,NaN,NaN,NaN,NaN,23696.425,24168.556816868833,23224.293183131165,23870.48948596363,24016.005249201342,24021.12563655221,24010.884861850474,28217,224290.9,67.00522240156886,63.437561433059464,NaN,NaN,NaN,NaN,83.07458491859397,26.236335059757792,11994956,2.699713010074902,80.18865520716645,77.48894219709155
2025-09-12T02:00:00-04:00,24035,24036.25,23968.75,24010.75,23744.62949832872,NaN,NaN,NaN,NaN,NaN,23707.87,24182.176327598703,23233.563672401295,23870.48948596363,24011.14544085049,24017.70457118989,24004.58631051109,56940,224275.63333333333,63.801408033163604,63.4179563160104,NaN,NaN,NaN,NaN,81.96211456726583,26.394522554526418,11938016,0.8877557434429093,78.59863687639518,77.71088113295227
2025-09-12T06:00:00-04:00,24010.75,24063.5,24002,24046,23768.544129675545,NaN,NaN,NaN,NaN,NaN,23720.525,24196.474968483522,23244.57503151648,23897.583271016723,24027.41757496564,24040.637150875904,24014.197999055374,210329,218004.3,66.32218628813641,63.51225546513668,NaN,NaN,NaN,NaN,80.50053495531827,26.846693673331544,12148345,1.246615789129578,79.26915086936424,78.02253508023466
2025-09-12T10:00:00-04:00,24044.75,24129,24018,24124,23806.167123781204,NaN,NaN,NaN,NaN,NaN,23737.155,24210.218504087832,23264.091495912166,23940.766616813376,24063.52515743787,24095.81202511186,24031.23828976388,453016,198728.73333333334,71.1154255140264,64.02692141359549,NaN,NaN,NaN,NaN,82.67906817279554,27.910099151557006,12601361,5.672653872532194,85.1133524208999,79.4406985483677
2025-09-12T14:00:00-04:00,24124,24159,24087.5,24114.5,23858.318618154786,NaN,NaN,NaN,NaN,NaN,23754.78,24216.974803518864,23292.585196481134,23972.663293450703,24076.75230545823,24113.84911957965,24039.655491336813,239576,198233.2,69.81216862464095,64.34983090070679,NaN,NaN,NaN,NaN,81.88056330331014,29.155424560504233,12361785,6.81892541594695,87.96435531830139,81.14542990235444
2025-09-14T18:00:00-04:00,24112.25,24129.75,24091.5,24114.75,23858.318618154786,NaN,NaN,NaN,NaN,NaN,23773.295,24217.15367897425,23329.436321025747,23972.663293450703,24112,24112,24112,29606,196148.96666666667,69.8278387951687,64.94347939641818,NaN,NaN,NaN,NaN,78.76409449593085,30.311798154526663,12391391,6.456093895181382,89.21554727133116,82.75945337614978
2025-09-14T22:00:00-04:00,24114,24144.75,24108.25,24140,23875.14981530219,NaN,NaN,NaN,NaN,NaN,23788.51,24229.441547522427,23347.57845247757,23991.94450780845,24118.79822563502,24127.905937491112,24109.690513778925,16495,195212.76666666666,71.44034298539376,65.95560183696583,NaN,NaN,NaN,NaN,75.74523060336436,31.52098096132195,12407886,6.747132889357147,91.19336948784621,84.44623659848907
2025-09-15T02:00:00-04:00,24140,24159.25,24075.5,24095.5,23875.14981530219,NaN,NaN,NaN,NaN,NaN,23803.685,24233.46630264077,23373.903697359234,23995.13060624676,24114.756489440482,24122.716883535344,24106.79609534562,39872,194718.36666666667,64.86129079487895,66.23952881057514,NaN,NaN,NaN,NaN,76.3169998459812,31.85075714990701,12368014,2.9660883777906264,88.15384707072735,85.18775869293673
2025-09-15T06:00:00-04:00,24095.75,24262.25,24091.25,24260.75,23913.510988736085,NaN,NaN,NaN,NaN,NaN,23822.555,24248.07916253377,23397.03083746623,24045.454484997408,24166.74410492826,24211.494493354396,24121.993716502126,117601,189874.76666666666,74.31918964343177,67.37165558218317,NaN,NaN,NaN,NaN,83.08007128555398,33.0849641683618,12485615,10.209944085727358,97.95018880009593,87.74024471436857
2025-09-15T10:00:00-04:00,24260.5,24294.25,24221,24287.25,23996.362761975357,NaN,NaN,NaN,NaN,NaN,23839.535,24270.090014022622,23408.979985977378,24084.188587997927,24217.624181858264,24277.029601699287,24158.21876201724,207673,177654.83333333334,75.45989722336563,68.39762465305844,NaN,NaN,NaN,NaN,82.37792333658584,34.462572964489134,12693288,15.106287394795828,106.62310395786335,91.51681656306752
2025-09-15T14:00:00-04:00,24286.75,24315.75,24245.25,24295.75,24021.499681885565,NaN,NaN,NaN,NaN,NaN,23857.815,24286.681165721122,23428.948834278875,24112.45087039834,24230.285988059928,24290.049371282363,24170.522604837493,94166,173328,75.83073736628734,69.16201564062149,NaN,NaN,NaN,NaN,81.52950024111543,35.89173595522928,12787454,17.091432770661797,112.88110752639477,95.78967475573297
2025-09-15T18:00:00-04:00,24536,24562.75,24525,24556.25,24260.23833270895,NaN,NaN,NaN,NaN,NaN,23881.635,24330.268382730614,23433.001617269383,24266.610696318672,24548,24548,24548,25235,172635.2,83.87373128161076,70.27291204910236,NaN,NaN,NaN,NaN,94.77739308103575,38.36644881805008,12812689,33.19092752989849,137.27833416810608,104.0874066382076
2025-09-15T22:00:00-04:00,24556.5,24602,24553.75,24594.5,24300.551363040362,NaN,NaN,NaN,NaN,NaN,23904.415,24379.097036841413,23429.73296315859,24340.96355705494,24564.481506002827,24582.14729113004,24546.815720875613,21965,172110.16666666666,84.6798971647235,71.66549108915225,NaN,NaN,NaN,NaN,91.45400786096177,40.78424742234098,12834654,43.03393630265923,157.87982701653164,114.84589071387241
2025-09-16T02:00:00-04:00,24594.75,24646.75,24582,24626.5,24340.827437447617,NaN,NaN,NaN,NaN,NaN,23926.995,24428.74171389079,23425.248286109207,24405.545845643952,24590.04302827995,24619.866661754215,24560.219394805685,42522,171624.7,85.34016890718463,73.1206789302558,NaN,NaN,NaN,NaN,89.54657872803593,43.15905204067952,12877176,47.9425706381426,174.77410401155066,126.83153337340806
2025-09-16T06:00:00-04:00,24626.5,24632.25,24523.5,24538,24340.827437447617,NaN,NaN,NaN,NaN,NaN,23948.385,24461.189438456156,23435.58056154384,24405.545845643952,24573.25172567547,24594.42692060943,24552.07653074151,173798,169821.26666666666,75.6318560193316,73.73686704581029,NaN,NaN,NaN,NaN,90.91825167603336,44.3168387171538,12703378,41.70181664175908,178.95880417560693,137.25698753384785
2025-09-16T10:00:00-04:00,24538,24561,24499,24534.25,24340.827437447617,NaN,NaN,NaN,NaN,NaN,23968.745,24492.032726686204,23445.457273313794,24405.545845643952,24549.34854403332,24574.264865815425,24524.432222251216,351272,161677.13333333333,75.24126787919562,74.55399989195543,NaN,NaN,NaN,NaN,88.85266227060241,44.975173793261405,12352106,34.11349280836643,179.8988535443059,145.78536073593946
2025-09-16T14:00:00-04:00,24534.25,24561.25,24516.75,24531,24340.827437447617,NaN,NaN,NaN,NaN,NaN,23989.78,24517.209792863858,23462.35020713614,24405.545845643952,24546.865308957706,24569.85501575444,24523.87560216097,144956,159360.5,74.88034128306369,75.16529667730738,NaN,NaN,NaN,NaN,85.68461496555938,45.587819687331645,12207150,26.032488063705273,178.32597081557105,152.29348275186578
2025-09-16T18:00:00-04:00,24531,24551.5,24525.25,24530.75,24340.827437447617,NaN,NaN,NaN,NaN,NaN,24008.73,24544.39438037276,23473.06561962724,24405.545845643952,24535.833333333332,24535.833333333332,24535.833333333332,29497,158839.66666666666,74.85059728241848,75.43209466076395,NaN,NaN,NaN,NaN,81.43928532516227,46.15670516039687,12177653,18.1984197759476,175.0415074718003,156.8430876958527
2025-09-16T22:00:00-04:00,24530.75,24533.5,24499.75,24518.25,24340.827437447617,NaN,NaN,NaN,NaN,NaN,24025.42,24571.443803876737,23479.39619612326,24405.545845643952,24528.035627101468,24537.241764209044,24518.829489993892,21162,158529.33333333334,73.28315904611895,75.68002254801239,NaN,NaN,NaN,NaN,78.0329078019364,46.18687227536474,12156491,10.106557018652609,169.47628396916843,159.36972695051583
2025-09-17T02:00:00-04:00,24518.25,24553,24456,24511.75,24340.827437447617,NaN,NaN,NaN,NaN,NaN,24040.955,24597.1478594468,23484.762140553205,24405.545845643952,24516.465540888308,24528.663987234766,24504.26709454185,61382,158522.86666666667,72.43373592342337,75.86615805717342,NaN,NaN,NaN,NaN,79.38770010179807,45.40439255098818,12095109,2.6371735941805525,162.66619394324152,160.02902034906097
2025-09-17T06:00:00-04:00,24511.75,24540.75,24462,24477.75,24340.827437447617,NaN,NaN,NaN,NaN,NaN,24055.285,24618.78610922707,23491.78389077293,24405.545845643952,24501.762364786904,24514.991796799648,24488.53293277416,199381,154532.36666666667,67.99415744914906,75.62000194744166,NaN,NaN,NaN,NaN,79.34215009452679,44.67780423549565,11895728,-5.811490829279251,152.7646568124619,158.57614764174116
2025-09-17T10:00:00-04:00,24477.5,24480.75,24374.75,24454.75,24340.827437447617,NaN,NaN,NaN,NaN,NaN,24068.705,24637.63416685621,23499.775833143794,24405.545845643952,24466.810846411587,24500.450081606985,24433.17161121619,362088,147593.63333333333,65.08789596307932,75.63618803088454,NaN,NaN,NaN,NaN,81.24628223063202,42.536273245076075,11533640,-13.71581679610398,141.43137664661117,155.14719344271515
2025-09-17T14:00:00-04:00,24459.25,24550.75,24241.75,24501.25,NaN,NaN,NaN,24681.017401263012,24681.017401263012,24681.017401263012,24081.675,24659.813566868135,23503.536433131863,24405.545845643952,24449.42056521341,24479.32382925057,24419.517301176253,644588,159054.26666666666,68.06027420568054,75.18912264247375,NaN,NaN,NaN,NaN,97.51440492844402,40.0830141337704,12178228,-16.39801537920843,134.6496742187046,151.04768959791303
2025-09-17T18:00:00-04:00,24504,24597.25,24492.5,24593.25,NaN,NaN,NaN,24681.017401263012,NaN,NaN,24101.26,24681.04361446351,23521.476385536487,24384.91167651516,24561,24561,24561,58903,159249.3,72.96461046943304,75.0108878743357,NaN,NaN,NaN,NaN,98.03123314784088,37.264948541100516,12237131,-12.725402308038127,135.14093671286537,147.8663390209035
2025-09-17T22:00:00-04:00,24593,24653.75,24587,24614.75,NaN,NaN,NaN,24681.017401263012,NaN,NaN,24120.095,24704.176534462193,23536.01346553781,24378.810897611627,24586.757521087162,24615.35135905853,24558.163683115792,47797,159730.2,73.97049979973598,74.87801376243917,NaN,NaN,NaN,NaN,95.79685935156654,35.160363041717076,12284928,-9.732382384224536,135.70086104062284,145.43324342484738
2025-09-18T02:00:00-04:00,24614.75,24733.5,24586,24717,24370.258954442455,24370.258954442455,24370.258954442455,NaN,NaN,NaN,24139.075,24737.653526594513,23540.49647340549,24439.798718089303,24628.924575012654,24679.399134724383,24578.450015300925,90149,161205.6,78.13672166604039,74.468227361327,NaN,NaN,NaN,NaN,99.48994082645466,33.95006504457836,12375077,-2.146758908013851,142.74979478983005,144.8965536978439
2025-09-18T06:00:00-04:00,24717.5,24766,24598.75,24697.25,24383.235820149617,NaN,NaN,NaN,NaN,NaN,24158.395,24765.37296574527,23551.41703425473,24447.41397447144,24665.220574866944,24707.257724976927,24623.18342475696,323109,160885.93333333332,75.61906595516999,73.82102513207316,NaN,NaN,NaN,NaN,104.32994505313647,33.10215535380091,12051968,0.13890649608734407,145.07018681795307,144.93128032186573
2025-09-18T10:00:00-04:00,24697,24815.75,24694,24734.75,24452.730782870087,NaN,NaN,NaN,NaN,NaN,24177.46,24795.666416660482,23559.253583339516,24500.006179577154,24707.0545275306,24758.003083468324,24656.105971592875,529087,161258.83333333334,77.12612331054368,73.23430758945597,NaN,NaN,NaN,NaN,105.57423469219815,32.71690297804792,12581055,2.636087158038322,148.22638926941363,145.5903021113753
2025-09-18T14:00:00-04:00,24734.75,24766.25,24684.75,24713.75,24452.730782870087,NaN,NaN,NaN,NaN,NaN,24194.825,24823.44711423103,23566.202885768973,24500.006179577154,24709.43143625851,24756.335321213654,24662.527551303367,205193,162214.4,74.35434492702191,73.14305679714812,NaN,NaN,NaN,NaN,103.85464649989828,32.22909496682281,12375862,1.3955936399915174,147.3347941613647,145.93920052137318
2025-09-18T18:00:00-04:00,24715,24749.25,24694.75,24716.25,24452.730782870087,NaN,NaN,NaN,NaN,NaN,24213.5,24847.472010423353,23579.527989576647,24500.006179577154,24720.083333333332,24720.083333333332,24720.083333333332,55840,162713.83333333334,74.47196455261239,73.08810655953503,NaN,NaN,NaN,NaN,100.3293146070484,31.776130384970923,12431702,-0.6260386637550823,145.1566521916793,145.7826908554344
2025-09-18T22:00:00-04:00,24716.5,24736.75,24682,24707,24452.730782870087,NaN,NaN,NaN,NaN,NaN,24231.67,24869.09081421947,23594.249185780525,24500.006179577154,24714.911903354026,24720.632721202714,24709.19108550534,45630,163294.26666666666,73.13542990448283,72.96347003249355,NaN,NaN,NaN,NaN,97.07364927797353,31.155118718422997,12386072,-3.7797270003619303,141.05803210498198,144.8377591053439
2025-09-19T02:00:00-04:00,24705.75,24730,24655,24707,24452.730782870087,NaN,NaN,NaN,NaN,NaN,24249.535,24889.168629588035,23609.901370411964,24502.967331154803,24707.975221395573,24717.651607335505,24698.29883545564,66141,163600.96666666667,73.13542990448283,72.84095807692671,NaN,NaN,NaN,NaN,95.49696004383257,30.15323844026106,12386072,-6.878716420257717,136.23936358002175,143.11808000027946
2025-09-19T06:00:00-04:00,24707.25,24816,24700.5,24790.5,24470.804252646583,NaN,NaN,NaN,NaN,NaN,24268.655,24914.64262286917,23622.667377130827,24576.62386492384,24744.47011073326,24775.01274746277,24713.927474003747,249367,164902.23333333334,77.38461382013163,73.13391913221334,NaN,NaN,NaN,NaN,96.92574861213025,30.065254132526732,12635439,-4.436514557708193,137.57243680314423,142.00895136085242
2025-09-19T10:00:00-04:00,24790.75,24834.5,24708,24816.5,24479.619968435374,NaN,NaN,NaN,NaN,NaN,24288.095,24940.32692876475,23635.863071235253,24579.749091939073,24767.29545197589,24796.6002950716,24737.99060888018,499933,166466.13333333333,78.52370017146437,73.56891657850198,NaN,NaN,NaN,NaN,99.03819513983524,30.145582635537288,13135372,-2.3086295626429205,139.12316440754876,141.43179397019168
2025-09-19T14:00:00-04:00,24816.5,24888,24804.5,24861.25,24556.489515324676,NaN,NaN,NaN,NaN,NaN,24309.02,24966.309957628964,23651.730042371037,24642.449273551258,24782.576766918475,24824.432209329076,24740.721324507875,204033,165281.36666666667,80.35750714095118,74.45201298505927,NaN,NaN,NaN,NaN,97.92832405841844,30.664517266375352,13339405,0.7125434919512941,142.32247333513078,141.6099298431795