time,open,high,low,close,Long Stop,Long Stop Start,Buy Label,Short Stop,Short Stop Start,Sell Label,Basis,Upper,Lower,ATR Trailing Stoploss,VWAP,Upper Band #1,Lower Band #1,Volume,Volume MA,RSI,RSI-based MA,Regular Bullish,Regular Bullish Label,Regular Bearish,Regular Bearish Label,ATR,ADX,OnBalanceVolume
2025-09-08T13:20:00-04:00,23802,23815.25,23797.5,23813.5,NaN,NaN,NaN,23855.214479545164,NaN,NaN,23837.83,23896.05924007441,23779.600759925594,23768.5976530696,23816.616009366568,23860.994351190893,23772.237667542242,7483,10651.7,46.550376858834305,40.30083589190366,NaN,NaN,NaN,NaN,20.372324477933596,27.06742034706969,-148870
2025-09-08T13:25:00-04:00,23813.25,23817,23800,23805.25,NaN,NaN,NaN,23855.214479545164,NaN,NaN,23838.215,23895.311935995538,23781.118064004462,23769.383787605133,23816.53773631038,23860.734954597978,23772.340518022782,8352,10535.733333333334,43.81938104727527,40.239088502062586,NaN,NaN,NaN,NaN,20.131444158081194,26.42697551132096,-157222
2025-09-08T13:30:00-04:00,23806,23812.5,23800.25,23804.5,NaN,NaN,NaN,23855.214479545164,NaN,NaN,23838.615,23894.467771638694,23782.76222836131,23769.383787605133,23816.481509641817,23860.570240997597,23772.392778286037,5143,10348.533333333333,43.5691341163148,40.25910921180168,NaN,NaN,NaN,NaN,19.568483861075396,25.83227673526857,-162365
2025-09-08T13:35:00-04:00,23804.5,23808.75,23797.75,23799.25,NaN,NaN,NaN,23855.214479545164,NaN,NaN,23838.93,23893.703080977266,23784.156919022735,23769.383787605133,23816.42042225923,23860.426666581232,23772.41417793723,4156,10249.7,41.77084901112481,40.11320014536585,NaN,NaN,NaN,NaN,18.95644929957001,25.43909411323523,-166521
2025-09-08T13:40:00-04:00,23799.5,23804.5,23792.25,23803,NaN,NaN,NaN,23855.214479545164,NaN,NaN,23838.585,23894.037467032296,23783.132532967702,23769.383787605133,23816.31216136328,23860.19406200737,23772.43026071919,6543,10116.033333333333,43.56270241453802,40.52097056830884,NaN,NaN,NaN,NaN,18.47741720674358,25.41836795140402,-159978
2025-09-08T13:45:00-04:00,23803.25,23805,23787.5,23788.75,NaN,NaN,NaN,23852.893910970703,NaN,NaN,23838.305,23894.613195671503,23781.996804328497,23769.383787605133,23816.169589351386,23859.949144667236,23772.390034035536,6343,9810.9,38.69040716029782,40.64913483149225,NaN,NaN,NaN,NaN,18.40760169197618,25.683997404134455,-166321
2025-09-08T13:50:00-04:00,23789,23793,23762.25,23785.75,NaN,NaN,NaN,23835.887369562945,NaN,NaN,23837.39,23895.56664136272,23779.21335863728,23769.383787605133,23815.583966951577,23859.24140470299,23771.926529200166,16676,10036.466666666667,37.7335705995594,40.52387078363121,NaN,NaN,NaN,NaN,19.28920157112074,27.11371735592632,-182997
2025-09-08T13:55:00-04:00,23785.75,23790.25,23775,23782.5,NaN,NaN,NaN,23835.887369562945,NaN,NaN,23836.055,23896.114744423365,23775.995255576636,23769.383787605133,23815.322938682886,23858.905526782815,23771.740350582957,8136,9894.2,36.67539900709434,40.64004394171917,NaN,NaN,NaN,NaN,19.00068717318354,28.441314454018762,-191133
2025-09-08T14:00:00-04:00,23782.75,23785,23772.25,23776.5,NaN,NaN,NaN,23835.434824333177,NaN,NaN,23834.28,23896.00622133254,23772.553778667458,23769.383787605133,23815.100076378203,23858.64789041323,23771.552262343175,6165,9712.1,34.73856398330359,40.00648437328142,NaN,NaN,NaN,NaN,18.554209517956142,29.78530596076827,-197298
2025-09-08T14:05:00-04:00,23775.75,23788.25,23772.5,23782,NaN,NaN,NaN,23835.434824333177,NaN,NaN,23833.01,23896.352399703217,23769.66760029678,23769.383787605133,23814.89944993237,23858.397722159458,23771.401177705284,6109,9677.733333333334,37.97226474892983,39.73265047606459,NaN,NaN,NaN,NaN,18.353908838102136,30.662925940907698,-191189
2025-09-08T14:10:00-04:00,23782.5,23804.75,23781.5,23799.5,NaN,NaN,NaN,23835.434824333177,NaN,NaN,23831.86,23895.505593720365,23768.214406279636,23769.383787605133,23814.719025994804,23858.057679028545,23771.380372961063,9646,9750.2,46.97516736870363,40.445015617231775,NaN,NaN,NaN,NaN,18.703629635380555,29.839571918836423,-181543
2025-09-08T14:15:00-04:00,23799.5,23814.25,23797.25,23811.75,NaN,NaN,NaN,23835.434824333177,NaN,NaN,23831.01,23894.571935152228,23767.44806484777,23769.548872061117,23814.663691088903,23857.83437526841,23771.493006909397,8408,9389.866666666667,52.20471808370168,41.558660188986,NaN,NaN,NaN,NaN,18.581941804281943,28.300715811406878,-173135
2025-09-08T14:20:00-04:00,23811.5,23819.75,23808,23809,NaN,NaN,NaN,23835.434824333177,NaN,NaN,23830.36,23894.143866297858,23766.576133702143,23778.114097648893,23814.64476456838,23857.646385111897,23771.643144024863,8369,9275.533333333333,50.98897271614903,42.66662124991088,NaN,NaN,NaN,NaN,18.093945961118948,26.456495621094938,-181504
2025-09-08T14:25:00-04:00,23809.5,23814.25,23802.25,23812.5,NaN,NaN,NaN,23835.434824333177,NaN,NaN,23830.265,23894.140770836675,23766.389229163324,23778.114097648893,23814.611618916617,23857.471753716083,23771.75148411715,7154,9231.1,52.504978949485675,43.41117757609374,NaN,NaN,NaN,NaN,17.65866410675331,25.141033694377068,-174350
2025-09-08T14:30:00-04:00,23812.5,23816.75,23804,23810.25,NaN,NaN,NaN,23835.434824333177,NaN,NaN,23830,23894.095397649053,23765.904602350947,23778.928022495293,23814.59255161798,23857.358020577485,23771.827082658478,4810,9065.5,51.40418802077373,43.757878373375135,NaN,NaN,NaN,NaN,17.308045241985216,23.718930094344454,-179160
2025-09-08T14:35:00-04:00,23810,23813.75,23797.25,23798,NaN,NaN,NaN,23835.434824333177,NaN,NaN,23828.705,23892.717708892214,23764.69229110779,23778.928022495293,23814.530203039063,23857.188940438402,23771.871465639724,5836,8971.866666666667,45.777017209005564,43.89770952778444,NaN,NaN,NaN,NaN,17.250327724700558,22.87409201349264,-184996
2025-09-08T14:40:00-04:00,23798.25,23802.25,23787.25,23801.5,NaN,NaN,NaN,23835.434824333177,NaN,NaN,23827.58,23891.488406328976,23763.671593671028,23778.928022495293,23814.386460841186,23856.89934730505,23771.87357437732,8971,9039.9,47.543886191634776,44.181620390307295,NaN,NaN,NaN,NaN,17.08959003007909,22.724064447408516,-176025
2025-09-08T14:45:00-04:00,23801,23811.5,23799.25,23805.25,NaN,NaN,NaN,23835.434824333177,NaN,NaN,23826.23,23889.10812338213,23763.351876617868,23778.928022495293,23814.339743933655,23856.747759817797,23771.931728049512,5675,8845.9,49.44468297065247,44.729751387416414,NaN,NaN,NaN,NaN,16.743905027930584,21.797477881615492,-170350
2025-09-08T14:50:00-04:00,23805.5,23809,23792,23795,NaN,NaN,NaN,23835.434824333177,NaN,NaN,23824.505,23885.96722335617,23763.042776643833,23778.928022495293,23814.25553007104,23856.564977184622,23771.94608295746,5941,8734.833333333334,44.6790480762303,44.80949036325158,NaN,NaN,NaN,NaN,16.76219752593554,21.398123307859958,-176291
2025-09-08T14:55:00-04:00,23795,23801.5,23789.75,23793.5,NaN,NaN,NaN,23835.434824333177,NaN,NaN,23822.835,23883.025498419967,23762.64450158003,23778.928022495293,23814.17549411844,23856.415549016907,23771.935439219975,4595,8554.133333333333,44.01053501689707,45.18949949586581,NaN,NaN,NaN,NaN,16.404183416940146,21.167023362245168,-180886
2025-09-08T15:00:00-04:00,23793.75,23794.25,23784.75,23791.25,NaN,NaN,NaN,23835.434824333177,NaN,NaN,23821.22,23880.37146997307,23762.068530026932,23778.928022495293,23814.045998514113,23856.209194376952,23771.882802651275,6000,8137.2,42.9718917747501,45.563665294093724,NaN,NaN,NaN,NaN,15.911027458587279,21.26173786128355,-186886
2025-09-08T15:05:00-04:00,23791.75,23796.75,23786.25,23787.25,NaN,NaN,NaN,23835.434824333177,NaN,NaN,23819.77,23878.626082096045,23760.913917903956,23778.928022495293,23813.93384772177,23856.030043865674,23771.83765157787,5249,7775.5,41.1142405398115,45.88072540357352,NaN,NaN,NaN,NaN,15.524525497259617,21.10730290924252,-192135
2025-09-08T15:10:00-04:00,23787,23789.75,23763.5,23770.25,NaN,NaN,NaN,23827.84299818257,NaN,NaN,23817.93,23877.110321053617,23758.749678946384,23778.928022495293,23813.493713988464,23855.55882210483,23771.428605872097,12659,7791.633333333333,34.323137749123674,45.851052101132105,NaN,NaN,NaN,NaN,16.29063081888393,22.197736130582474,-204794
2025-09-08T15:15:00-04:00,23770.5,23776,23763,23769,NaN,NaN,NaN,23820.162634628814,NaN,NaN,23816,23875.143131468052,23756.856868531948,23778.928022495293,23813.12100042052,23855.202578637993,23771.039422203048,9654,7732.1,33.88000155018058,45.55874758693572,NaN,NaN,NaN,NaN,16.055585760392223,23.23313358889412,-214448
2025-09-08T15:20:00-04:00,23768.5,23773,23758.5,23769,NaN,NaN,NaN,23816.087060327503,NaN,NaN,23813.91,23872.156524359194,23755.663475640806,23775.242417996233,23812.8174384874,23854.926875325084,23770.708001649717,7551,7689.433333333333,33.880001550180566,44.623378599898366,NaN,NaN,NaN,NaN,15.944472491792778,24.40471096573946,-214448
2025-09-08T15:25:00-04:00,23768.75,23772.25,23763.5,23770.5,NaN,NaN,NaN,23816.087060327503,NaN,NaN,23812.33,23870.91407974808,23753.745920251924,23774.73014751759,23812.632098468075,23854.749553137557,23770.514643798593,4863,7516.333333333333,35.04707864745933,43.397832925881055,NaN,NaN,NaN,NaN,15.430581599521867,25.49260424423871,-209585
2025-09-08T15:30:00-04:00,23770.5,23790.25,23770.25,23771,NaN,NaN,NaN,23816.087060327503,NaN,NaN,23810.745,23869.42774789325,23752.06225210675,23774.73014751759,23812.2473271967,23854.296499056607,23770.19815533679,12682,7620.833333333333,35.45604325582448,42.28833796442931,NaN,NaN,NaN,NaN,15.75696862812745,24.733932283842023,-196903
2025-09-08T15:35:00-04:00,23771,23793.75,23771,23791.25,NaN,NaN,NaN,23816.087060327503,NaN,NaN,23809.045,23864.895128919543,23753.194871080454,23771.08411801407,23812.07122244471,23854.038736115213,23770.103708774204,7699,7502.933333333333,49.362060641607954,42.06384379958089,NaN,NaN,NaN,NaN,16.256470868975487,23.735650087644018,-189204
2025-09-08T15:40:00-04:00,23791,23803,23790,23799.5,NaN,NaN,NaN,23816.087060327503,NaN,NaN,23807.62,23860.66528631379,23754.57471368621,23765.292294411258,23811.967850268476,23853.804112501603,23770.13158803535,8407,7518.3,53.735367062303624,42.2303565882616,NaN,NaN,NaN,NaN,16.02386580690581,22.07698153833863,-180797
2025-09-08T15:45:00-04:00,23799.5,23811.25,23799.25,23811,NaN,NaN,NaN,23816.087060327503,NaN,NaN,23806.43,23856.357351219922,23756.50264878008,23773.61976116783,23811.932935041274,23853.618794717775,23770.247075364772,8681,7598.533333333334,59.04505292465312,43.178073425093565,NaN,NaN,NaN,NaN,15.736446820698252,21.049074946109926,-172116
2025-09-08T15:50:00-04:00,23810.75,23812.5,23785,23795.75,NaN,NaN,NaN,23816.087060327503,NaN,NaN,23805.115,23852.573741027492,23757.65625897251,23773.61976116783,23811.747339161953,23853.19090689847,23770.303771425435,15828,7876.7,50.73039087398126,43.40568090240403,NaN,NaN,NaN,NaN,16.576700619219803,20.010068322875068,-187944
2025-09-08T15:55:00-04:00,23795.75,23805,23784.75,23803.5,NaN,NaN,NaN,23816.087060327503,NaN,NaN,23804.31,23850.46772524409,23758.152274755914,23773.61976116783,23811.524731842434,23852.674704156205,23770.374759528662,19547,8249.866666666667,54.25583120517667,43.749334347727185,NaN,NaN,NaN,NaN,16.83907914641839,19.061860844940174,-168397
2025-09-08T16:00:00-04:00,23803.75,23807,23795.25,23798.5,NaN,NaN,NaN,23816.087060327503,NaN,NaN,23803.04,23846.17390313725,23759.906096862753,23773.61976116783,23811.453967371683,23852.484262856793,23770.423671886572,7763,8337.2,51.68625048622736,44.249848805584115,NaN,NaN,NaN,NaN,16.47557349310279,18.021687854169482,-176160
2025-09-08T16:05:00-04:00,23798.5,23810.25,23796.5,23809.25,NaN,NaN,NaN,23816.087060327503,NaN,NaN,23801.77,23840.0898173281,23763.450182671902,23773.61976116783,23811.43818772041,23852.416734238246,23770.459641202575,3197,8305.233333333334,56.46067150595004,45.13914426908791,NaN,NaN,NaN,NaN,16.280889672166875,16.79187612064931,-172963
2025-09-08T16:10:00-04:00,23809.25,23809.25,23800.25,23804.5,NaN,NaN,NaN,23816.087060327503,NaN,NaN,23800.75,23835.876770416115,23765.623229583885,23773.61976116783,23811.422078981686,23852.353183986703,23770.49097397667,2957,8185.7,53.92490541016695,45.921502385903395,NaN,NaN,NaN,NaN,15.760826124154956,15.64990808238058,-175920
2025-09-08T16:15:00-04:00,23804.25,23804.5,23798.25,23799.75,NaN,NaN,NaN,23816.087060327503,NaN,NaN,23799.83,23832.51920922415,23767.140790775855,23773.61976116783,23811.407217864853,23852.311510611682,23770.502925118024,1747,8032.5,51.43705681943223,46.658846405876304,NaN,NaN,NaN,NaN,15.08148140100103,14.76391890489888,-177667
2025-09-08T16:20:00-04:00,23799.5,23802.25,23796.25,23799,NaN,NaN,NaN,23816.087060327503,NaN,NaN,23798.945,23829.18872497608,23768.70127502392,23773.61976116783,23811.395261995,23852.281361351845,23770.509162638155,1217,7517.2,51.03667965146965,47.852670827472444,NaN,NaN,NaN,NaN,14.432804158072384,14.119686048920391,-178884
2025-09-08T16:25:00-04:00,23798.75,23803.5,23798.5,23801.25,NaN,NaN,NaN,23816.087060327503,NaN,NaN,23798.285,23826.809552577637,23769.760447422363,23777.70378154981,23811.388033690717,23852.260711866737,23770.515355514697,874,7275.133333333333,52.23779171495764,49.16394155352795,NaN,NaN,NaN,NaN,13.759032432495786,13.392425433982485,-178010
2025-09-08T16:30:00-04:00,23801.5,23803.25,23799.75,23801,NaN,NaN,NaN,23816.087060327503,NaN,NaN,23797.71,23824.797148247068,23770.62285175293,23780.863025239847,23811.382021492504,23852.243217225176,23770.52082575983,746,7094.5,52.084906063868196,50.464291875934215,NaN,NaN,NaN,NaN,13.02624440160323,12.717112005825859,-178756
2025-09-08T16:35:00-04:00,23801,23801,23797.25,23798,NaN,NaN,NaN,23816.087060327503,NaN,NaN,23797.05,23822.4137536688,23771.6862463312,23781.21542019188,23811.372773950112,23852.220439153723,23770.5251087465,914,6921.333333333333,50.186728930641785,51.54569546759011,NaN,NaN,NaN,NaN,12.363655515774429,12.35158440348818,-179670
2025-09-08T16:40:00-04:00,23798.25,23799.25,23793.75,23794.75,NaN,NaN,NaN,23816.087060327503,NaN,NaN,23796.72,23821.763490166264,23771.67650983374,23781.21542019188,23811.357809110083,23852.188524616115,23770.52709360405,1210,6640.133333333333,48.139921344162104,52.45168675961422,NaN,NaN,NaN,NaN,11.873394407504827,12.370856279242874,-180880
2025-09-08T16:45:00-04:00,23794.75,23798,23794.25,23794.5,NaN,NaN,NaN,23816.087060327503,NaN,NaN,23796.455,23821.305692134178,23771.604307865826,23781.262868922804,23811.345108599337,23852.161836055147,23770.528381143526,1007,6393.433333333333,47.9778261922716,52.3528128703759,NaN,NaN,NaN,NaN,11.293151949825912,12.388751592443661,-181887
2025-09-08T16:50:00-04:00,23794.25,23796.25,23792.75,23793.25,NaN,NaN,NaN,23816.087060327503,NaN,NaN,23796.055,23820.451165686434,23771.658834313566,23781.262868922804,23811.33523247127,23852.142369545432,23770.528095397105,716,6138.333333333333,47.123435937802306,51.88053207576866,NaN,NaN,NaN,NaN,10.736498239124062,12.56952905647259,-182603
2025-09-08T16:55:00-04:00,23793.25,23799.5,23791.75,23798.5,NaN,NaN,NaN,23816.087060327503,NaN,NaN,23796.075,23820.477510118355,23771.672489881646,23783.513236110593,23811.32199476969,23852.11321006552,23770.53077947386,1124,5937.333333333333,51.065005846281295,51.310528713027814,NaN,NaN,NaN,NaN,10.523176936329486,12.262751184532187,-181479
2025-09-08T18:00:00-04:00,23799.75,23818.75,23798.5,23813.75,23770.104797570202,23770.104797570202,23770.104797570202,NaN,NaN,NaN,23796.005,23820.183190583713,23771.82680941629,23795.835588888476,23810.333333333332,23810.333333333332,23810.333333333332,3129,5881.3,60.31821588968734,51.99537335700683,NaN,NaN,NaN,NaN,11.217950012305952,12.879710196795118,-178350
2025-09-08T18:05:00-04:00,23813.5,23820,23809.25,23813.25,23776.389806771556,NaN,NaN,NaN,NaN,NaN,23796.045,23820.330322733935,23771.75967726606,23796.29347111078,23811.56086610182,23813.349358605243,23809.772373598396,1474,5735.9,59.91816409611896,52.39982570635984,NaN,NaN,NaN,NaN,11.184525011426956,13.557093333934118,-179824
2025-09-08T18:10:00-04:00,23813.5,23817.5,23809,23814.75,23776.389806771556,NaN,NaN,NaN,NaN,NaN,23796.465,23821.297239125826,23771.632760874174,23796.29347111078,23811.92221416047,23813.747366202482,23810.097062118457,910,5467.2,60.75900472146359,53.04787958030529,NaN,NaN,NaN,NaN,10.992773224896458,14.151414390797123,-178914
2025-09-08T18:15:00-04:00,23814.5,23817.75,23808.75,23817.25,23776.389806771556,NaN,NaN,NaN,NaN,NaN,23796.965,23822.436162122463,23771.493837877537,23796.29347111078,23812.36988282036,23814.309388497575,23810.430377143144,1115,5315.2,62.182930604377894,53.45661237305014,NaN,NaN,NaN,NaN,10.850432280260998,14.703283943598485,-177799
2025-09-08T18:20:00-04:00,23817.25,23821,23813.75,23820,23780.904054800092,NaN,NaN,NaN,NaN,NaN,23797.605,23823.742346845385,23771.467653154614,23798.91725720872,23813.136049512315,23815.81740766258,23810.45469136205,993,5150.266666666666,63.741529000791346,54.15779977238045,NaN,NaN,NaN,NaN,10.593258545956642,15.530693915586694,-176806
2025-09-08T18:25:00-04:00,23819.25,23821.75,23815.25,23815.5,23782.80046140009,NaN,NaN,NaN,NaN,NaN,23797.865,23824.446800158505,23771.2831998415,23800.833805766975,23813.561851194,23816.419304003604,23810.704398384398,824,5024.566666666667,59.42550603872632,54.72840328804432,NaN,NaN,NaN,NaN,10.300882935531167,16.37183752580065,-177630
2025-09-08T18:30:00-04:00,23815.5,23822.25,23814.25,23822,23783.082258609174,NaN,NaN,NaN,NaN,NaN,23798.035,23825.118576206194,23770.951423793806,23801.51704461358,23814.065116867165,23817.260148876674,23810.870084857655,782,4850.633333333333,63.29192092675278,55.603777664850256,NaN,NaN,NaN,NaN,10.136534154421797,16.97579674854608,-176848
2025-09-08T18:35:00-04:00,23822.25,23826.75,23819,23819.75,23788.24897412694,NaN,NaN,NaN,NaN,NaN,23798.325,23826.015115561844,23770.634884438157,23806.288635690864,23814.877745431022,23818.723868401663,23811.03162246038,1078,4711.6,61.12073142719773,56.23827335858169,NaN,NaN,NaN,NaN,9.966067429105953,17.99970202204621,-177926
2025-09-08T18:40:00-04:00,23819.5,23823.75,23819.5,23822.75,23788.24897412694,NaN,NaN,NaN,NaN,NaN,23798.69,23827.166053098874,23770.213946901124,23806.288635690864,23815.163033690424,23819.181818925495,23811.14424845535,430,4303.966666666666,62.945924673731426,57.01406040214335,NaN,NaN,NaN,NaN,9.557776898455527,18.950471204582044,-177496
2025-09-08T18:45:00-04:00,23822.75,23829,23820.25,23828.25,23791.328868987563,NaN,NaN,NaN,NaN,NaN,23799.27,23828.924989466996,23769.615010533005,23809.829726842152,23816.209264549376,23821.172736199376,23811.245792899375,1167,4021.0666666666666,66.0890178350557,58.14993818103006,NaN,NaN,NaN,NaN,9.500078548565847,20.346041075242848,-176329
2025-09-08T18:50:00-04:00,23828.25,23828.5,23818.25,23820.75,23791.328868987563,NaN,NaN,NaN,NaN,NaN,23799.625,23829.86921432432,23769.38078567568,23809.829726842152,23816.759137146655,23821.822669423294,23811.695604870016,1140,3807.366666666667,58.76839007206031,58.90911451873707,NaN,NaN,NaN,NaN,9.55364436652543,21.23527643160106,-177469
2025-09-08T18:55:00-04:00,23820.75,23826.25,23820.25,23825.25,23791.328868987563,NaN,NaN,NaN,NaN,NaN,23800.355,23831.26860380745,23769.44139619255,23809.829726842152,23817.04876643124,23822.205413387226,23811.89211947525,550,3663.6,61.522384818387714,59.87658299203109,NaN,NaN,NaN,NaN,9.29981262605933,22.06099497679083,-176919
2025-09-08T19:00:00-04:00,23825.75,23831.25,23824.5,23824.5,23795.94100119213,NaN,NaN,NaN,NaN,NaN,23801.13,23832.479998398983,23769.78000160102,23812.379820143182,23817.833367144533,23823.440186193213,23812.226548095852,1196,3280.733333333333,60.79355888781612,60.8530203456035,NaN,NaN,NaN,NaN,9.117683152769377,23.338959219361577,-178115
2025-09-08T19:05:00-04:00,23824.75,23826.5,23820.25,23821.5,23795.94100119213,NaN,NaN,NaN,NaN,NaN,23801.91,23833.30773239859,23770.51226760141,23812.379820143182,23817.992611616395,23823.576142361566,23812.409080871224,495,3040.6,57.841824259451876,61.337078803687106,NaN,NaN,NaN,NaN,8.912848641857279,23.637670473430354,-178610
2025-09-08T19:10:00-04:00,23821,23827.5,23820.75,23823.75,23795.94100119213,NaN,NaN,NaN,NaN,NaN,23802.855,23833.97976345723,23771.730236542768,23812.379820143182,23818.21882018345,23823.81432201664,23812.623318350263,598,2780.3,59.43271950516425,61.27382906193545,NaN,NaN,NaN,NaN,8.758359453153187,24.02900698262737,-178012
2025-09-08T19:15:00-04:00,23824,23827.5,23821.25,23822.25,23795.94100119213,NaN,NaN,NaN,NaN,NaN,23803.66,23834.66737976864,23772.652620231358,23812.379820143182,23818.390902900584,23823.97915144766,23812.80265435351,518,2508.2,57.86499720912188,61.1271742842928,NaN,NaN,NaN,NaN,8.579190920785102,24.392390884024596,-178530
2025-09-08T19:20:00-04:00,23822.75,23823.75,23818.5,23819,23795.94100119213,NaN,NaN,NaN,NaN,NaN,23804.05,23835.327627794297,23772.7723722057,23812.379820143182,23818.490282207404,23823.957270896026,23813.02329351878,846,2008.8,54.50996844602971,60.680814550333245,NaN,NaN,NaN,NaN,8.341391569300452,24.124809037501763,-179376
2025-09-08T19:25:00-04:00,23818.5,23820.75,23815.25,23818.25,23795.94100119213,NaN,NaN,NaN,NaN,NaN,23804.18,23835.63807368106,23772.72192631894,23812.379820143182,23818.473885580723,23823.83020284583,23813.117568315614,724,1381.3666666666666,53.73567496050287,60.077439147199314,NaN,NaN,NaN,NaN,8.138435028636135,23.212284469209205,-180100
2025-09-08T19:30:00-04:00,23818.75,23821.5,23813.25,23814.25,23795.94100119213,NaN,NaN,NaN,NaN,NaN,23804.285,23835.841617369904,23772.728382630095,23812.379820143182,23818.39439770657,23823.665884863087,23813.12291055005,693,1145.7,49.682317270165704,59.07320973786891,NaN,NaN,NaN,NaN,8.146403955162125,21.97850270701017,-180793
2025-09-08T19:35:00-04:00,23814.5,23818.75,23813.25,23816.5,23795.94100119213,NaN,NaN,NaN,NaN,NaN,23804.365,23836.02462886571,23772.705371134292,23812.379820143182,23818.321760579198,23823.521668817953,23813.121852340442,629,1060.1,51.88106516655231,58.53432110414219,NaN,NaN,NaN,NaN,7.957375101221973,20.83284821353964,-180164
2025-09-08T19:40:00-04:00,23816.25,23817.25,23804.5,23805.5,23795.94100119213,NaN,NaN,NaN,NaN,NaN,23804.27,23835.886900541467,23772.653099458534,23812.379820143182,23817.673832706707,23823.21537699099,23812.132288422425,1455,1010.0333333333333,42.17751521727203,57.02614926775071,NaN,NaN,NaN,NaN,8.299705451134688,20.41710767526718,-181619
2025-09-08T19:45:00-04:00,23805.25,23811.25,23803.75,23809,23795.94100119213,NaN,NaN,NaN,NaN,NaN,23804.49,23836.082397809925,23772.897602190078,23812.379820143182,23817.36506455125,23823.076473321737,23811.653655780763,684,974.6,45.660092020723155,55.92181788157394,NaN,NaN,NaN,NaN,8.242583633196496,20.139898895043874,-180935
2025-09-08T19:50:00-04:00,23809,23812.75,23805.75,23811.25,23795.94100119213,NaN,NaN,NaN,NaN,NaN,23804.685,23836.3214994854,23773.048500514604,23810.013467913308,23817.154974605477,23822.91872327547,23811.391225935484,622,954.7666666666667,47.83519920502604,54.84248034809499,NaN,NaN,NaN,NaN,8.153827659396745,19.57300676327016,-180313
2025-09-08T19:55:00-04:00,23811.25,23814,23806,23807.25,23795.94100119213,NaN,NaN,NaN,NaN,NaN,23804.725,23836.36931228816,23773.080687711838,23810.013467913308,23816.918691581926,23822.75818477752,23811.079198386335,665,947.8,44.43030796340534,53.29542964297711,NaN,NaN,NaN,NaN,8.142839969439835,18.787825832218637,-180978
2025-09-08T20:00:00-04:00,23807.5,23818,23802.25,23815,23795.94100119213,NaN,NaN,NaN,NaN,NaN,23805.125,23836.773104208023,23773.476895791977,23810.013467913308,23816.501615339996,23822.2748178829,23810.728412797092,1994,989.4,51.61621928095976,52.78456030075564,NaN,NaN,NaN,NaN,8.686208543051276,17.609537991322217,-178984
2025-09-08T20:05:00-04:00,23815,23820,23811.25,23820,23795.94100119213,NaN,NaN,NaN,NaN,NaN,23805.655,23837.394075290547,23773.91592470945,23807.135774330647,23816.522889131476,23822.190595573564,23810.85518268939,938,990.2,55.60492202171909,52.36188438670789,NaN,NaN,NaN,NaN,8.69076507569047,16.87245604806748,-178046
2025-09-08T20:10:00-04:00,23819.5,23827,23817.5,23827,23795.94100119213,NaN,NaN,NaN,NaN,NaN,23806.37,23838.38831350958,23774.35168649042,23804.708619464516,23816.90996504572,23822.66339109516,23811.15653899628,1434,997.6666666666666,60.51287209250401,52.34183532989988,NaN,NaN,NaN,NaN,8.748567570284008,17.25852754443063,-176612
2025-09-08T20:15:00-04:00,23826.5,23826.75,23810.25,23817.25,23795.94100119213,NaN,NaN,NaN,NaN,NaN,23806.97,23838.655271024843,23775.28472897516,23804.541895571616,23816.98628036501,23822.556980559584,23811.415580170436,1884,1026.9,51.90551065819255,51.91781292980993,NaN,NaN,NaN,NaN,9.320098458120864,16.282766078008464,-178496
2025-09-08T20:20:00-04:00,23816.75,23817.5,23810.5,23811.75,23795.94100119213,NaN,NaN,NaN,NaN,NaN,23807.8,23837.7192245943,23777.880775405698,23803.906617390545,23816.910460423216,23822.44945791695,23811.37146292948,600,1023.0333333333333,47.77708315135267,51.08526747596624,NaN,NaN,NaN,NaN,9.154377139683659,15.376701859187882,-179096
2025-09-08T20:25:00-04:00,23812.5,23816.25,23811,23815,23795.94100119213,NaN,NaN,NaN,NaN,NaN,23808.72,23836.56755643949,23780.87244356051,23803.906617390545,23816.871514342893,23822.382088911007,23811.36093977478,413,999.3333333333334,50.29298797343421,50.54440967341712,NaN,NaN,NaN,NaN,8.875493058277682,14.535356513140199,-178683
2025-09-08T20:30:00-04:00,23814.5,23815,23811,23813,23795.94100119213,NaN,NaN,NaN,NaN,NaN,23809.6,23835.04877207928,23784.151227920716,23803.906617390545,23816.816394305064,23822.306790906117,23811.32599770401,433,909.4666666666667,48.736941124327835,50.13205057900985,NaN,NaN,NaN,NaN,8.52724355411499,13.75410726323878,-179116
2025-09-08T20:35:00-04:00,23812.75,23815.25,23811.5,23813,23795.94100119213,NaN,NaN,NaN,NaN,NaN,23810.45,23833.327281304508,23787.572718695494,23803.906617390545,23816.763142126056,23822.22953314254,23811.29675110957,461,875.7,48.736941124327835,49.7749981621402,NaN,NaN,NaN,NaN,8.186011871678206,13.077107093728763,-179116
2025-09-08T20:40:00-04:00,23812.25,23814.5,23807.75,23812.5,23795.94100119213,NaN,NaN,NaN,NaN,NaN,23811.28,23831.190961809152,23791.369038190845,23803.906617390545,23816.636781373105,23822.094897756993,23811.178664989216,772,871.1,48.30362551468159,49.676520179605625,NaN,NaN,NaN,NaN,8.083439595129763,12.597706750216004,-179888
2025-09-08T20:45:00-04:00,23812.5,23813.25,23807,23812.75,23795.94100119213,NaN,NaN,NaN,NaN,NaN,23811.71,23830.783111972887,23792.63688802711,23803.906617390545,23816.506624169084,23821.96738103827,23811.045867299898,748,858.8666666666667,48.5499381298058,49.43858253412373,NaN,NaN,NaN,NaN,7.952479624049066,12.296396799580906,-179140
2025-09-08T20:50:00-04:00,23813.25,23815.5,23811.25,23812.75,23795.94100119213,NaN,NaN,NaN,NaN,NaN,23811.975,23830.727666487233,23793.222333512764,23803.906617390545,23816.449468515482,23821.880600830576,23811.018336200388,564,844.5666666666667,48.5499381298058,49.89375559930471,NaN,NaN,NaN,NaN,7.688016793759847,11.51363710287759,-179140
2025-09-08T20:55:00-04:00,23813,23813.75,23805.25,23807.5,23795.94100119213,NaN,NaN,NaN,NaN,NaN,23811.905,23830.69778852352,23793.112211476477,23803.906617390545,23816.313295885728,23821.789459651,23810.837132120454,600,837.1,43.501891365313575,49.7395984096326,NaN,NaN,NaN,NaN,7.746015594205573,11.894948481428349,-179740
2025-09-08T21:00:00-04:00,23807,23808.5,23803.75,23806,23795.94100119213,NaN,NaN,NaN,NaN,NaN,23812.11,23830.410590144475,23793.809409855527,23799.900293912437,23816.126545647803,23821.72266015381,23810.530431141797,624,831.8333333333334,42.15329238006048,49.33374792213506,NaN,NaN,NaN,NaN,7.532014480333745,12.490247261542324,-180364
2025-09-08T21:05:00-04:00,23805.75,23812,23805.25,23809.75,23795.94100119213,NaN,NaN,NaN,NaN,NaN,23812.235,23830.383391112697,23794.086608887304,23799.527344517905,23816.00220136633,23821.627214219727,23810.37718851293,607,816.1333333333333,46.60948060646384,49.489403110924954,NaN,NaN,NaN,NaN,7.476156303167049,12.247718685414059,-179757
2025-09-08T21:10:00-04:00,23809,23811,23805.5,23807.75,23795.94100119213,NaN,NaN,NaN,NaN,NaN,23812.42,23830.18919808267,23794.650801917327,23799.527344517905,23815.865302769223,23821.5362035611,23810.194401977347,612,822.2,44.63460394347658,48.990716301104726,NaN,NaN,NaN,NaN,7.33500228151226,12.02251357900924,-180369
2025-09-08T21:15:00-04:00,23808.5,23808.5,23803.5,23806,23795.94100119213,NaN,NaN,NaN,NaN,NaN,23812.355,23830.193747154965,23794.516252845035,23799.527344517905,23815.683670687184,23821.456528995204,23809.910812379163,664,805.4333333333333,42.92093234840183,48.08471703872492,NaN,NaN,NaN,NaN,7.1682164042613845,12.188865173444304,-181033
2025-09-08T21:20:00-04:00,23805.75,23806.25,23794.75,23796.25,NaN,NaN,NaN,23825.197821068352,23825.197821068352,23825.197821068352,23812.19,23830.46363127711,23793.916368722887,23799.527344517905,23814.981024898872,23821.54499834193,23808.417051455814,1594,820.5666666666667,34.88485534660266,46.254144414017674,NaN,NaN,NaN,NaN,7.477629518242714,13.653214169419917,-182627
2025-09-08T21:25:00-04:00,23796.25,23799.25,23790.75,23797,NaN,NaN,NaN,23819.73428374706,NaN,NaN,23812.135,23830.57387470099,23793.696125299008,23799.527344517905,23813.97699333736,23821.67310515501,23806.280881519713,2065,871.0666666666667,35.87937646613581,45.10942054315648,NaN,NaN,NaN,NaN,7.550655981225377,15.471431925988869,-180562
2025-09-08T21:30:00-04:00,23796.75,23800,23793.25,23795.25,NaN,NaN,NaN,23819.73428374706,NaN,NaN,23812.06,23830.74088862356,23793.379111376442,23799.527344517905,23813.591423868515,23821.632962233667,23805.549885503362,879,860.5,34.553257560455165,44.16486157237808,NaN,NaN,NaN,NaN,7.493466268280708,16.972069662270666,-181441
2025-09-08T21:35:00-04:00,23795.5,23801,23794.5,23796.25,NaN,NaN,NaN,23819.73428374706,NaN,NaN,23811.96,23830.922689683804,23792.997310316194,23799.527344517905,23813.292719440346,23821.555669068093,23805.029769812598,756,869.2,36.00873313775109,43.14455765554357,NaN,NaN,NaN,NaN,7.422504391974942,18.108065781854084,-180685
2025-09-08T21:40:00-04:00,23796,23804.75,23794.5,23803.75,NaN,NaN,NaN,23819.73428374706,NaN,NaN,23812.015,23830.86583818368,23793.16416181632,23796.721875614323,23813.01897315272,23821.388324478114,23804.649621827328,942,880.6666666666666,45.75279820864449,42.93140459013762,NaN,NaN,NaN,NaN,7.624468363976732,18.248217975188695,-179743
2025-09-08T21:45:00-04:00,23803.75,23810.75,23803,23808.25,NaN,NaN,NaN,23819.73428374706,NaN,NaN,23812.22,23830.67552491838,23793.76447508162,23795.82700039317,23812.835192005612,23821.129348340546,23804.541035670678,1413,910.5,50.612121280761805,43.0653460298829,NaN,NaN,NaN,NaN,7.633434909406965,17.15697690136821,-178330
2025-09-08T21:50:00-04:00,23808.25,23815,23804.25,23813.25,NaN,NaN,NaN,23819.73428374706,NaN,NaN,23812.59,23830.358725336886,23794.821274663114,23795.82700039317,23812.78287885876,23820.974172839105,23804.591584878417,1173,921.4,55.393356920557366,43.57175541601689,NaN,NaN,NaN,NaN,7.856046701592182,16.439992487415502,-177157
2025-09-08T21:55:00-04:00,23814,23818.75,23812.5,23813.75,NaN,NaN,NaN,23819.73428374706,NaN,NaN,23812.975,23829.97683814994,23795.973161850055,23798.93881383826,23812.83741679161,23820.934622773362,23804.74021080986,1132,935,55.85361309532796,44.093446484982756,NaN,NaN,NaN,NaN,7.741329080049883,16.33933885217465,-176025
2025-09-08T22:00:00-04:00,23814.25,23821.75,23814.25,23817.75,23793.421868793623,23793.421868793623,23793.421868793623,NaN,NaN,NaN,23813.465,23829.55226514513,23797.377734854872,23801.90105107061,23812.934528376954,23820.9840636182,23804.884993135707,897,941.8,59.457607642157534,44.87256573586502,NaN,NaN,NaN,NaN,7.7598055743320336,16.660821894170947,-175128
2025-09-08T22:05:00-04:00,23817.75,23824.75,23816.75,23823.5,23796.19814748482,NaN,NaN,NaN,NaN,NaN,23813.965,23829.7111138124,23798.218886187602,23804.870840856485,23813.099423520634,23821.160697867264,23805.038149174005,903,950.9333333333333,64.00649921944029,46.33718058258836,NaN,NaN,NaN,NaN,7.776962319022602,17.34710583206816,-174225
2025-09-08T22:10:00-04:00,23823.5,23830.75,23821.75,23828.75,23801.586868053695,NaN,NaN,NaN,NaN,NaN,23814.265,23830.54578930106,23797.984210698938,23810.34667268519,23813.570489633432,23821.886769554894,23805.25420971197,1667,958,67.58290248503495,48.15358130437225,NaN,NaN,NaN,NaN,7.864322153378131,18.66216189025375,-172558
2025-09-08T22:15:00-04:00,23829.25,23834.75,23828,23834.5,23806.912464960344,NaN,NaN,NaN,NaN,NaN,23814.69,23831.92414054151,23797.45585945849,23815.05233814815,23814.096195274953,23822.863320539756,23805.32907001015,1420,982.5333333333333,70.98353792947572,49.8945853988731,NaN,NaN,NaN,NaN,7.7847277138511215,20.271415483072754,-171138
2025-09-08T22:20:00-04:00,23834.25,23834.5,23828.25,23830,23807.172125643963,NaN,NaN,NaN,NaN,NaN,23814.995,23832.75436092099,23797.23563907901,23815.616870518523,23814.386175408792,23823.34892678504,23805.423424032546,893,991.5666666666667,65.21747616304687,51.364790557413826,NaN,NaN,NaN,NaN,7.675104305718898,21.765722390690403,-172031
2025-09-08T22:25:00-04:00,23830.25,23833,23829,23832.5,23807.351801751058,NaN,NaN,NaN,NaN,NaN,23815.3,23833.715482619646,23796.884517380353,23815.893496414817,23814.53486881136,23823.598839271013,23805.470898351705,454,984.5333333333333,66.82955092291759,53.0725490270221,NaN,NaN,NaN,NaN,7.412596855310405,23.153293090621077,-171577
2025-09-08T22:30:00-04:00,23832.75,23847.5,23831.25,23833.25,23814.58581076237,NaN,NaN,NaN,NaN,NaN,23815.565,23834.613834620897,23796.5161653791,23825.689797131854,23815.842738080206,23826.116465174015,23805.569010986397,3180,1024.0666666666666,67.31890878938098,55.3892671300777,NaN,NaN,NaN,NaN,8.043839937073948,25.604940150467982,-168397
2025-09-08T22:35:00-04:00,23833.25,23834.75,23828.25,23831.75,23814.58581076237,NaN,NaN,NaN,NaN,NaN,23815.89,23835.470388150698,23796.3096118493,23825.689797131854,23816.12193742543,23826.51395805199,23805.729916798868,1001,1026.1666666666667,65.24570575864657,57.486862079542746,NaN,NaN,NaN,NaN,7.93356565585438,27.227792132596402,-169398
2025-09-08T22:40:00-04:00,23832,23836,23830,23834.25,23814.58581076237,NaN,NaN,NaN,NaN,NaN,23816.135,23836.31251472759,23795.957485272407,23825.689797131854,23816.325454709957,23826.823150624103,23805.82775879581,672,1000.7666666666667,67.0661631961003,59.80921248208883,NaN,NaN,NaN,NaN,7.795453823293353,28.82853056413414,-168726
2025-09-08T22:45:00-04:00,23834,23835,23830.25,23832.5,23814.58581076237,NaN,NaN,NaN,NaN,NaN,23816.39,23837.060065318365,23795.719934681634,23825.689797131854,23816.464328911887,23827.023627901483,23805.90502992229,492,954.3666666666667,64.51851677291768,61.84562559888644,NaN,NaN,NaN,NaN,7.577921407343828,30.314930536276336,-169218
2025-09-08T22:50:00-04:00,23832.25,23833,23824.25,23828,23814.58581076237,NaN,NaN,NaN,NaN,NaN,23816.495,23837.345776963426,23795.644223036572,23825.689797131854,23816.749337626756,23827.340151956738,23806.158523296774,1407,981.2666666666667,58.37749936027419,62.74738996686,NaN,NaN,NaN,NaN,7.661641306819269,30.370426512220227,-170625
2025-09-08T22:55:00-04:00,23828.5,23830,23826.75,23827.25,23814.58581076237,NaN,NaN,NaN,NaN,NaN,23816.475,23837.28251067147,23795.667489328527,23825.689797131854,23816.859786317615,23827.456702555188,23806.26287008004,585,987,57.396930594738606,63.23201920357263,NaN,NaN,NaN,NaN,7.346524070617893,30.421958489882417,-171210
2025-09-08T23:00:00-04:00,23828,23829.75,23826,23828.25,23814.58581076237,NaN,NaN,NaN,NaN,NaN,23816.625,23837.660505694617,23795.589494305383,23825.689797131854,23816.93941363013,23827.540012944188,23806.338814316074,429,986.8666666666667,58.400266910291386,63.446798488553625,NaN,NaN,NaN,NaN,7.0896294941451865,30.304534644656783,-170781
2025-09-08T23:05:00-04:00,23829,23830.75,23826.5,23829.5,23814.58581076237,NaN,NaN,NaN,NaN,NaN,23816.71,23837.917866467455,23795.502133532544,23825.689797131854,23817.0428806999,23827.655632720118,23806.430128679684,523,988.9333333333333,59.6785769206923,63.72001019036537,NaN,NaN,NaN,NaN,6.886798815991959,30.32124560119452,-170258
2025-09-08T23:10:00-04:00,23829.5,23836.75,23828.25,23832.25,23814.58581076237,NaN,NaN,NaN,NaN,NaN,23816.865,23838.40895738618,23795.321042613825,23825.689797131854,23817.297358175903,23828.003136584313,23806.591579767493,1019,997.1666666666666,62.41490790824038,63.931245923656995,NaN,NaN,NaN,NaN,7.002027471992534,31.020066023972742,-169239
2025-09-08T23:15:00-04:00,23832,23835,23830,23833.25,23814.58581076237,NaN,NaN,NaN,NaN,NaN,23817.1,23839.092726077164,23795.107273922833,23825.689797131854,23817.4519268396,23828.21444716403,23806.68940651517,622,992.9666666666667,63.387900209952306,63.887060280122135,NaN,NaN,NaN,NaN,6.859025509707353,31.66897070226681,-168617
2025-09-08T23:20:00-04:00,23833.75,23838.5,23832,23834.25,23814.58581076237,NaN,NaN,NaN,NaN,NaN,23817.31,23839.748707622024,23794.87129237798,23823.215189603055,23817.69071827002,23828.57012588981,23806.811310650228,862,1002.9,64.3809272587027,63.65834776395555,NaN,NaN,NaN,NaN,6.833380830442542,32.63616102257046,-167755
2025-09-08T23:25:00-04:00,23834.25,23837,23832.75,23837,23814.58581076237,NaN,NaN,NaN,NaN,NaN,23817.605,23840.674696569957,23794.535303430042,23823.215189603055,23817.794553167336,23828.727152466803,23806.86195386787,368,995.1666666666666,67.02931623754029,63.37590335738873,NaN,NaN,NaN,NaN,6.648853628268076,33.53426631999529,-167387
2025-09-08T23:30:00-04:00,23836.5,23843.25,23836.5,23841.5,23818.39387551153,NaN,NaN,NaN,NaN,NaN,23818.055,23842.074219391976,23794.035780608025,23828.392721345954,23818.12776370784,23829.31651428857,23806.939013127107,948,1005.9666666666667,70.84892002037829,63.77814934719812,NaN,NaN,NaN,NaN,6.65607836910607,34.95538041071796,-166439
2025-09-08T23:35:00-04:00,23841,23841.75,23836,23838.75,23818.39387551153,NaN,NaN,NaN,NaN,NaN,23818.465,23843.173502582875,23793.756497417126,23828.392721345954,23818.343609219086,23829.67082110161,23807.016397336563,678,1008.3333333333334,65.82990545830606,63.70674609972586,NaN,NaN,NaN,NaN,6.5913584855984935,36.135137588106076,-167117
2025-09-08T23:40:00-04:00,23838.5,23841.5,23837.5,23839,23818.633417563193,NaN,NaN,NaN,NaN,NaN,23818.96,23844.29463242822,23793.625367571778,23828.392721345954,23818.443179441667,23829.835155329532,23807.0512035538,310,998.2666666666667,66.06525954905896,63.617199725417144,NaN,NaN,NaN,NaN,6.406261450912886,37.23062639568076,-166807
2025-09-08T23:45:00-04:00,23839,23843,23839,23840.75,23820.536444037592,NaN,NaN,NaN,NaN,NaN,23819.445,23845.4911686284,23793.3988313716,23829.95307332913,23818.570725936523,23830.05509450603,23807.086357367014,373,988.5666666666667,67.74027550487065,63.795383278718866,NaN,NaN,NaN,NaN,6.234385632990538,38.39522128814971,-166434
2025-09-08T23:50:00-04:00,23840.75,23841.25,23836,23836.25,23820.536444037592,NaN,NaN,NaN,NaN,NaN,23820.06,23846.21197123689,23793.90802876311,23829.95307332913,23818.682040169027,23830.225885561264,23807.13819477679,382,948.1666666666666,59.59437940276697,63.261684436337916,NaN,NaN,NaN,NaN,6.164072373491214,38.556718076849414,-166816
2025-09-08T23:55:00-04:00,23836.5,23839.5,23836.25,23838.75,23820.536444037592,NaN,NaN,NaN,NaN,NaN,23820.655,23847.12515111428,23794.184848885718,23829.95307332913,23818.78057771423,23830.377848962507,23807.183306465955,336,890.5333333333333,62.306276036466556,63.10366724087712,NaN,NaN,NaN,NaN,5.95592434681327,38.706679380641994,-166480
2025-09-09T00:00:00-04:00,23839,23840.75,23833,23833.25,23820.536444037592,NaN,NaN,NaN,NaN,NaN,23821.095,23847.656417501497,23794.533582498505,23829.95307332913,23818.96310013003,23830.62893466631,23807.29726559375,726,885.4333333333333,53.75794429914517,62.773699022225045,NaN,NaN,NaN,NaN,6.084072607755179,37.88804239708169,-167206
2025-09-09T00:05:00-04:00,23833.75,23839,23833.25,23834.5,23820.536444037592,NaN,NaN,NaN,NaN,NaN,23821.64,23848.160965290164,23795.119034709835,23829.95307332913,23819.060026889678,23830.76043625883,23807.359617520524,394,873.3666666666667,55.26030628545019,62.62108300013301,NaN,NaN,NaN,NaN,6.0602102786298095,37.127879483775686,-166812
2025-09-09T00:10:00-04:00,23834.75,23836.75,23834,23836.25,23820.536444037592,NaN,NaN,NaN,NaN,NaN,23822.065,23848.826690909544,23795.303309090454,23829.95307332913,23819.11563795418,23830.835772795654,23807.395503112704,227,849.5333333333333,57.349479772126436,62.54602677597837,NaN,NaN,NaN,NaN,5.823766687299108,36.42201392142011,-166585
2025-09-09T00:15:00-04:00,23836.25,23838,23836,23836.5,23820.536444037592,NaN,NaN,NaN,NaN,NaN,23822.395,23849.451993545394,23795.338006454607,23829.95307332913,23819.178924739084,23830.925762710787,23807.43208676738,243,810.5333333333333,57.65369688767721,62.401392487905866,NaN,NaN,NaN,NaN,5.550640495349172,35.99415345704395,-166342
2025-09-09T00:20:00-04:00,23836.75,23839.75,23835,23839.25,23820.536444037592,NaN,NaN,NaN,NaN,NaN,23822.64,23850.07850579297,23795.201494207027,23829.95307332913,23819.262106333783,23831.049260258802,23807.474952408764,302,781.5,60.953014960414684,62.29697156306117,NaN,NaN,NaN,NaN,5.493451888538517,35.90463510471376,-166040
2025-09-09T00:25:00-04:00,23839,23840.25,23834.5,23834.75,23820.536444037592,NaN,NaN,NaN,NaN,NaN,23822.99,23850.590536216147,23795.389463783857,23829.95307332913,23819.372144508587,23831.201549005757,23807.542740011417,439,758.4,53.59445182097958,61.59743953527741,NaN,NaN,NaN,NaN,5.511776753642908,35.82151092040715,-166479
2025-09-09T00:30:00-04:00,23834.5,23837.75,23832.5,23835.75,23820.536444037592,NaN,NaN,NaN,NaN,NaN,23823.47,23851.106685760802,23795.8333142392,23829.95307332913,23819.455721821225,23831.310218026112,23807.601225616338,362,740.5666666666667,54.897529568394475,60.92005398596967,NaN,NaN,NaN,NaN,5.493078414096986,35.01414973764437,-166117
2025-09-09T00:35:00-04:00,23835.25,23836,23833,23834.5,23820.536444037592,NaN,NaN,NaN,NaN,NaN,23823.86,23851.557862730995,23796.162137269006,23828.679053163833,23819.50668776189,23831.37332815288,23807.640047370896,235,718.3,52.897970989833546,59.91067218256205,NaN,NaN,NaN,NaN,5.31500138451863,34.26445721079322,-166352
2025-09-09T00:40:00-04:00,23834.5,23834.5,23831.25,23832.5,23820.536444037592,NaN,NaN,NaN,NaN,NaN,23824.25,23851.874264694372,23796.625735305628,23828.679053163833,23819.57808437524,23831.452359876876,23807.703808873604,376,675.2666666666667,49.77412489098646,58.40532967331978,NaN,NaN,NaN,NaN,5.167501285624442,32.932504986079266,-166728
2025-09-09T00:45:00-04:00,23832.25,23835,23830.5,23834.75,23820.536444037592,NaN,NaN,NaN,NaN,NaN,23824.685,23852.27191899734,23797.098081002663,23828.679053163833,23819.655037737284,23831.540884808906,23807.769190665662,390,640.9333333333333,53.127671523408374,57.49802724939851,NaN,NaN,NaN,NaN,5.119822622365553,31.43192213167019,-166338
2025-09-09T00:50:00-04:00,23835,23839.25,23834.25,23836.25,23820.536444037592,NaN,NaN,NaN,NaN,NaN,23825.16,23852.709185108033,23797.610814891967,23828.679053163833,23819.78818432593,23831.721265074906,23807.855103576956,556,629.7,55.271804136644164,56.727066148511746,NaN,NaN,NaN,NaN,5.111263863625156,31.064730404061606,-165782
2025-09-09T00:55:00-04:00,23836.25,23841,23835.25,23838,23820.90320927119,NaN,NaN,NaN,NaN,NaN,23825.665,23853.211435330453,23798.11856466955,23829.303030170064,23819.88754173936,23831.86389195816,23807.91119152056,386,627.4333333333333,57.702768166811026,56.01010133865034,NaN,NaN,NaN,NaN,5.156887873366217,31.078908542332258,-165396
2025-09-09T01:00:00-04:00,23837,23837.25,23832.75,23835.25,23820.90320927119,NaN,NaN,NaN,NaN,NaN,23826.115,23853.537656682278,23798.692343317725,23829.303030170064,23819.976808725896,23831.974262130356,23807.979355321437,420,535.4333333333333,52.842504056816,55.527824528225274,NaN,NaN,NaN,NaN,5.163538739554345,30.21055532988911,-165816
2025-09-09T01:05:00-04:00,23835.5,23835.75,23832.25,23833.75,23820.90320927119,NaN,NaN,NaN,NaN,NaN,23826.64,23853.618539618394,23799.661460381605,23829.303030170064,23820.36444296379,23832.41390753341,23808.31497839417,2045,570.2333333333333,50.35125706153933,54.67389460144476,NaN,NaN,NaN,NaN,5.044714543871891,29.23562700498176,-167861
2025-09-09T01:10:00-04:00,23834,23837.25,23832.75,23834,23820.90320927119,NaN,NaN,NaN,NaN,NaN,23827.2,23853.59772716875,23800.80227283125,23829.303030170064,23820.749736471855,23832.85925243271,23808.640220511,2036,615.7,50.76785354748453,54.460316690611855,NaN,NaN,NaN,NaN,5.005806362166757,28.689486254950435,-165825
2025-09-09T01:15:00-04:00,23833.5,23834,23823,23828.5,23820.90320927119,NaN,NaN,NaN,NaN,NaN,23827.575,23853.498975385173,23801.65102461483,23829.303030170064,23820.887527887884,23832.932535189037,23808.84252058673,1368,644.9,42.34892053115503,53.538074851019346,NaN,NaN,NaN,NaN,5.433963050583417,27.674778540874783,-167193
2025-09-09T01:20:00-04:00,23828,23828.75,23815.5,23822,NaN,NaN,NaN,23840.579971850402,23840.579971850402,23840.579971850402,23827.86,23853.2129406533,23802.507059346703,23829.303030170064,23820.90796639543,23832.850600218546,23808.965332572312,1338,642.6,34.96850704786017,51.93943394214318,NaN,NaN,NaN,NaN,5.992251404113174,27.937622580159598,-168531
2025-09-09T01:25:00-04:00,23821.75,23822,23815,23818.5,NaN,NaN,NaN,23837.07065494811,NaN,NaN,23828.11,23852.83451414088,23803.385485859122,23829.303030170064,23820.88553807734,23832.7746739689,23808.996402185778,736,647.6333333333333,31.75895834883721,50.08980976079747,NaN,NaN,NaN,NaN,6.064233446676519,28.25017151960904,-169267
2025-09-09T01:30:00-04:00,23819,23830,23818.5,23825,NaN,NaN,NaN,23837.07065494811,NaN,NaN,23828.685,23851.696912122155,23805.673087877847,23829.303030170064,23820.932847906544,23832.751060875948,23809.11463493714,1048,668.2666666666667,42.34294596463295,48.76051911824163,NaN,NaN,NaN,NaN,6.4525024861996245,26.707200475927916,-168219
2025-09-09T01:35:00-04:00,23825.25,23826.75,23821,23824.75,NaN,NaN,NaN,23837.07065494811,NaN,NaN,23829.24,23850.43527305096,23808.044726949043,23829.303030170064,23820.950881398312,23832.738556095996,23809.16320670063,449,665.8,42.07266526400212,47.93753436417181,NaN,NaN,NaN,NaN,6.402323737185365,25.27444164965259,-168668
2025-09-09T01:40:00-04:00,23825.25,23827.25,23819.25,23826,NaN,NaN,NaN,23837.07065494811,NaN,NaN,23829.855,23848.726695740846,23810.983304259153,23829.303030170064,23820.977930762692,23832.719598675725,23809.23626284966,683,654.6,43.99751122939842,47.15896162567209,NaN,NaN,NaN,NaN,6.516443470243553,24.25676115435315,-167985
2025-09-09T01:45:00-04:00,23825.75,23828.75,23824,23826.25,NaN,NaN,NaN,23837.07065494811,NaN,NaN,23830.455,23846.7460067123,23814.163993287704,23825.931151447072,23821.00379117489,23832.722957203478,23809.284625146305,394,647,44.39546927843698,46.551640074858064,NaN,NaN,NaN,NaN,6.390268936654728,22.982678243621304,-167591
2025-09-09T01:50:00-04:00,23825.75,23836.5,23825,23835.75,NaN,NaN,NaN,23837.07065494811,NaN,NaN,23831.095,23845.550064847517,23816.639935152485,23825.931151447072,23821.131862560942,23832.846935897753,23809.41678922413,926,649.1333333333333,56.922513274964004,47.06223924514217,NaN,NaN,NaN,NaN,6.755249726893676,22.308409495418573,-166665
2025-09-09T01:55:00-04:00,23836,23842.5,23833.5,23834.5,23817.79538711438,23817.79538711438,23817.79538711438,NaN,NaN,NaN,23831.62,23844.54371465095,23818.696285349048,23825.931151447072,23821.359879381376,23833.14029144877,23809.579467313983,1216,677.4,55.16156698956842,47.207517492725025,NaN,NaN,NaN,NaN,6.915589032115556,22.517508699318693,-167881
2025-09-09T02:00:00-04:00,23834.75,23843.5,23830.25,23841,23817.79538711438,NaN,NaN,NaN,NaN,NaN,23832.175,23844.251112804115,23820.098887195883,23822.02143578365,23821.60321449169,23833.470374502733,23809.736054480647,1224,686.6,61.782410980356964,47.67256083870451,NaN,NaN,NaN,NaN,7.368046958393016,22.0575484856985,-166657
2025-09-09T02:05:00-04:00,23841.5,23845.25,23839.25,23843.75,23821.29755313521,NaN,NaN,NaN,NaN,NaN,23832.775,23844.08660907504,23821.463390924964,23823.843718901535,23821.84971091541,23833.86385930865,23809.835562522167,1002,697.4,64.19150119172053,48.13604176905519,NaN,NaN,NaN,NaN,7.270329318507801,21.87428571617069,-165655
2025-09-09T02:10:00-04:00,23844.25,23853.5,23843.25,23851.5,23826.97720981088,NaN,NaN,NaN,NaN,NaN,23833.45,23845.117047607924,23821.782952392077,23831.249975121227,23822.522678522782,23835.128824088533,23809.91653295703,2151,758.7666666666667,69.94197812120981,49.35743277365475,NaN,NaN,NaN,NaN,7.483162938614386,22.688442853466988,-163504
2025-09-09T02:15:00-04:00,23851,23855.25,23841.75,23846.5,23826.97720981088,NaN,NaN,NaN,NaN,NaN,23833.91,23845.783398843534,23822.036601156466,23831.249975121227,23823.092949535734,23836.109982183654,23810.075916887814,2031,814.0333333333333,62.921454726445425,50.25530403543376,NaN,NaN,NaN,NaN,7.912937014427645,23.623802133290244,-165535
2025-09-09T02:20:00-04:00,23846.5,23851.25,23843.75,23850.25,23826.97720981088,NaN,NaN,NaN,NaN,NaN,23834.34,23846.968048141687,23821.711951858313,23831.249975121227,23823.30024921055,23836.463178386522,23810.13732003458,744,826.1,65.70209684277282,51.32203569938292,NaN,NaN,NaN,NaN,7.883441513397099,24.49235003598327,-164791
2025-09-09T02:25:00-04:00,23850.5,23852.5,23848.5,23849,23828.690417454785,NaN,NaN,NaN,NaN,NaN,23834.63,23847.908644494688,23821.351355505314,23831.78798726207,23823.476803982856,23836.77341198723,23810.180195978483,605,835.0666666666667,63.979720017274445,52.86709280553431,NaN,NaN,NaN,NaN,7.606052833868736,25.437524183715166,-165396
2025-09-09T02:30:00-04:00,23848.5,23850.75,23844,23849,23828.690417454785,NaN,NaN,NaN,NaN,NaN,23835.01,23848.81397044782,23821.206029552177,23831.78798726207,23823.727180446924,23837.182477553368,23810.27188334048,947,842.4333333333333,63.979720017274445,54.93932230334962,NaN,NaN,NaN,NaN,7.544906202878112,25.283164556487353,-165396
2025-09-09T02:35:00-04:00,23850,23854.25,23841.25,23852.5,23828.690417454785,NaN,NaN,NaN,NaN,NaN,23835.41,23850.03455468437,23820.78544531563,23831.794311847723,23824.13980926633,23837.870182729963,23810.409435802696,1514,879.7666666666667,66.80552475537476,57.44264847524516,NaN,NaN,NaN,NaN,7.93455575981539,25.582488196300407,-163882
2025-09-09T02:40:00-04:00,23852.5,23853.75,23843.25,23845.75,23828.690417454785,NaN,NaN,NaN,NaN,NaN,23835.66,23850.553206505698,23820.766793494302,23831.794311847723,23824.322768378883,23838.15416765237,23810.491369105395,739,896.8333333333334,57.44560205684184,58.52140962468865,NaN,NaN,NaN,NaN,8.117801776971433,25.860431576126818,-164621
2025-09-09T02:45:00-04:00,23845,23853.25,23844,23847.25,23828.690417454785,NaN,NaN,NaN,NaN,NaN,23835.97,23851.166920730488,23820.773079269515,23831.794311847723,23824.508402752308,23838.44432703931,23810.572478465307,743,913.5,58.82615626415679,59.71808755327112,NaN,NaN,NaN,NaN,8.19867307861633,26.1185218573942,-163878
2025-09-09T02:50:00-04:00,23847.25,23855.75,23846.5,23852.25,23828.690417454785,NaN,NaN,NaN,NaN,NaN,23836.33,23852.185421774364,23820.47457822564,23832.567687666036,23824.79660412239,23838.932808499754,23810.66039974503,1030,937.7666666666667,63.12103730235921,61.084053701339755,NaN,NaN,NaN,NaN,8.273767858715164,26.696785372396047,-162848
2025-09-09T02:55:00-04:00,23851.75,23853,23847.25,23850,23828.690417454785,NaN,NaN,NaN,NaN,NaN,23836.68,23852.949001195364,23820.410998804637,23832.567687666036,23824.943847263734,23839.16953807975,23810.718156447718,565,941.9666666666667,60.08376278092091,62.20464609437432,NaN,NaN,NaN,NaN,8.093498725949795,27.23374435061205,-163413
2025-09-09T03:00:00-04:00,23850.5,23855,23846.75,23850.5,23828.690417454785,NaN,NaN,NaN,NaN,NaN,23837.13,23853.656415213438,23820.603584786564,23833.738320106262,23825.246638895114,23839.659064439344,23810.834213350885,1152,968.3,60.5381845732488,62.46290832996608,NaN,NaN,NaN,NaN,8.104677388381953,28.008193735693567,-162261
2025-09-09T03:05:00-04:00,23850.75,23857,23847,23855.25,23828.690417454785,NaN,NaN,NaN,NaN,NaN,23837.69,23854.72894363355,23820.65105636645,23834.99065608501,23825.46939095116,23840.036713694008,23810.90206820831,792,986.8666666666667,64.65486783813145,63.14100124772059,NaN,NaN,NaN,NaN,8.2400575749261,28.990323814389875,-161469
2025-09-09T03:10:00-04:00,23855.25,23864,23854.5,23863.5,23835.552716289305,NaN,NaN,NaN,NaN,NaN,23838.395,23856.684365756955,23820.105634243046,23841.642524868006,23826.00865716882,23841.096583170463,23810.920731167174,1540,1025.6666666666667,70.42560489208158,63.75837224141521,NaN,NaN,NaN,NaN,8.330053462431378,30.663960447493526,-159929
2025-09-09T03:15:00-04:00,23863.75,23866.5,23860.25,23863,23839.90259282161,NaN,NaN,NaN,NaN,NaN,23839.065,23858.424961266064,23819.705038733933,23845.489019894405,23826.43318203128,23841.947052232772,23810.919311829788,1159,1051.3,69.68304830336574,64.15062560653273,NaN,NaN,NaN,NaN,8.18147821511485,32.44162028058962,-161088
2025-09-09T03:20:00-04:00,23862.75,23864.25,23859,23862.75,23839.90259282161,NaN,NaN,NaN,NaN,NaN,23839.675,23860.03384330096,23819.31615669904,23845.489019894405,23826.736659092978,23842.526787603492,23810.946530582463,875,1061.9333333333334,69.289659418881,64.10403141350925,NaN,NaN,NaN,NaN,7.972086914035218,33.71219536450917,-161963
2025-09-09T03:25:00-04:00,23863,23870.5,23862.75,23867.25,23843.497765360185,NaN,NaN,NaN,NaN,NaN,23840.355,23862.038193955595,23818.671806044404,23851.07797273242,23827.47283565945,23844.01752542126,23810.92814589764,1918,1113,72.31891075219454,64.77527827249132,NaN,NaN,NaN,NaN,7.956223563032703,35.445022096661525,-160045
2025-09-09T03:30:00-04:00,23867,23872.75,23862,23871.75,23843.83309420745,NaN,NaN,NaN,NaN,NaN,23841.105,23864.424110188887,23817.78588981111,23851.837378185937,23827.993565568348,23845.06831358521,23810.918817551486,1332,1143.4,74.97702863472412,65.43777340048784,NaN,NaN,NaN,NaN,8.15577902281608,37.224823778083525,-158713
2025-09-09T03:35:00-04:00,23871.5,23885.25,23871.5,23871.75,23854.028180834383,NaN,NaN,NaN,NaN,NaN,23841.8,23866.611892312245,23816.988107687754,23861.64490254875,23829.33910873653,23847.951260625752,23810.72695684731,3040,1176.5666666666666,74.97702863472412,66.22329544459139,NaN,NaN,NaN,NaN,8.555366235472075,39.59634316548908,-158713
2025-09-09T03:40:00-04:00,23871.75,23874.75,23855.25,23855.75,23854.028180834383,NaN,NaN,NaN,NaN,NaN,23842.085,23867.20204800153,23816.967951998467,23861.64490254875,23830.01186566246,23849.004565288473,23811.01916603645,2295,1185.2,53.7094305272509,65.48970333816114,NaN,NaN,NaN,NaN,9.337125790081213,38.60614788548444,-161008
2025-09-09T03:45:00-04:00,23855.75,23859,23850,23853,NaN,NaN,NaN,23880.449271181893,23880.449271181893,23880.449271181893,23842.37,23867.652056882827,23817.08794311717,23861.64490254875,23830.371189089692,23849.44498479187,23811.297393387515,1690,1195.9333333333334,51.03017185476881,64.36289241668928,NaN,NaN,NaN,NaN,9.313045376503984,36.93576408370098,-162698
2025-09-09T03:50:00-04:00,23852.5,23855.75,23850.25,23855.25,NaN,NaN,NaN,23878.519758855444,NaN,NaN,23842.695,23868.212109946253,23817.177890053747,23861.64490254875,23830.570679619897,23849.684270664777,23811.457088575018,971,1183.7,53.091968430142394,64.05191858621075,NaN,NaN,NaN,NaN,9.040684992467986,35.38469341061634,-161727
2025-09-09T03:55:00-04:00,23855,23857.5,23854,23855.5,NaN,NaN,NaN,23878.519758855444,NaN,NaN,23842.99,23868.75023291062,23817.229767089382,23861.64490254875,23830.724330756802,23849.879618221647,23811.56904329196,701,1182.5333333333333,53.32710713834244,63.6591293629383,NaN,NaN,NaN,NaN,8.644921778720272,34.13402392507935,-161026
2025-09-09T04:00:00-04:00,23855,23857.25,23853,23853.5,NaN,NaN,NaN,23878.519758855444,NaN,NaN,23843.335,23869.18681038381,23817.48318961619,23861.64490254875,23830.943805996412,23850.146359022303,23811.74125297052,1063,1183.0333333333333,51.11942009887159,62.80187099126061,NaN,NaN,NaN,NaN,8.330998794525966,32.813520730419185,-162089
2025-09-09T04:05:00-04:00,23853.5,23854.5,23838.75,23839.25,NaN,NaN,NaN,23871.956375540973,NaN,NaN,23843.345,23869.190094306792,23817.49990569321,23861.64490254875,23831.186321148747,23850.294515658425,23812.07812663907,2159,1240.0333333333333,38.79568273616678,61.28129384520674,NaN,NaN,NaN,NaN,8.860927452059824,31.20959945255289,-164248
2025-09-09T04:10:00-04:00,23839,23852.5,23838.75,23847,NaN,NaN,NaN,23871.67994938002,NaN,NaN,23843.62,23869.321797608765,23817.918202391233,23861.64490254875,23831.379676909964,23850.43819256758,23812.32116125235,1548,1268.8666666666666,46.36835490424083,60.26916315456332,NaN,NaN,NaN,NaN,9.210146919769837,29.720243980248473,-162700
2025-09-09T04:15:00-04:00,23846.25,23850.5,23836.25,23843.25,NaN,NaN,NaN,23870.18881531729,NaN,NaN,23843.795,23869.36484357115,23818.225156428845,23861.64490254875,23831.675842566474,23850.58827758137,23812.763407551578,3030,1356.7333333333333,43.55989534531744,58.76237940507661,NaN,NaN,NaN,NaN,9.570136425500563,28.617413003023106,-165730
2025-09-09T04:20:00-04:00,23844,23853.25,23840.75,23852.5,NaN,NaN,NaN,23870.18881531729,NaN,NaN,23844.12,23869.711060939648,23818.52893906035,23861.64490254875,23831.87154220491,23850.76386569745,23812.97921871237,1411,1372.9,51.382234309835496,57.40213864920189,NaN,NaN,NaN,NaN,9.779412395107666,27.191125800807963,-164319
2025-09-09T04:25:00-04:00,23853,23854.25,23846,23849.5,NaN,NaN,NaN,23870.18881531729,NaN,NaN,23844.38,23869.920211425033,23818.83978857497,23846.115922039,23831.993535290283,23850.87986493873,23813.107205641834,842,1360.4333333333334,49.0097908276502,55.92547740093649,NaN,NaN,NaN,NaN,9.670168652599974,25.71979641149362,-165161
2025-09-09T04:30:00-04:00,23849.5,23855.75,23845.75,23850,NaN,NaN,NaN,23870.18881531729,NaN,NaN,23844.595,23870.139840964443,23819.05015903556,23837.932481667172,23832.136113877496,23851.019007882736,23813.253219872255,967,1351.8666666666666,49.42889191986172,54.506851151006536,NaN,NaN,NaN,NaN,9.69372803455712,24.127632180333745,-164194
2025-09-09T04:35:00-04:00,23849.75,23852.5,23838.25,23841,NaN,NaN,NaN,23870.18881531729,NaN,NaN,23844.72,23870.13173743827,23819.30826256173,23837.932481667172,23832.253751219298,23851.07860538154,23813.428897057056,1266,1360.6666666666667,42.63585244784807,52.386632700696076,NaN,NaN,NaN,NaN,10.019176032088755,23.599512923082752,-165460
2025-09-09T04:40:00-04:00,23840.25,23849.25,23838,23845.75,NaN,NaN,NaN,23870.18881531729,NaN,NaN,23844.92,23870.203283015155,23819.63671698484,23837.932481667172,23832.34481332457,23851.12766113871,23813.561965510427,963,1321.0666666666666,46.79204459827528,50.373419555235444,NaN,NaN,NaN,NaN,10.107092029796702,23.138385860903355,-164497
2025-09-09T04:45:00-04:00,23845.75,23846.25,23834.5,23835.75,NaN,NaN,NaN,23868.96625626861,NaN,NaN,23844.945,23870.189462756345,23819.700537243654,23837.932481667172,23832.4122690816,23851.108813919345,23813.715724243855,1342,1298.1,40.190186714814686,47.888645132384774,NaN,NaN,NaN,NaN,10.224442599096937,23.118986119201452,-165839
2025-09-09T04:50:00-04:00,23835.5,23840.5,23834,23837.25,NaN,NaN,NaN,23865.42801734731,NaN,NaN,23845.04,23870.131703804174,23819.948296195827,23831.170985333738,23832.444988394316,23851.08241848583,23813.807558302804,879,1302.6,41.52295758069859,47.01818277905961,NaN,NaN,NaN,NaN,9.958410984875727,23.15890319527473,-164960
2025-09-09T04:55:00-04:00,23837,23843.75,23836.25,23843.25,NaN,NaN,NaN,23865.42801734731,NaN,NaN,23845.21,23870.135159986436,23820.284840013563,23829.34154847416,23832.492580760358,23851.08959484174,23813.895566678977,720,1306.4333333333334,46.64456605140224,46.70492522167628,NaN,NaN,NaN,NaN,9.782810200241746,22.59032616645293,-164240
2025-09-09T05:00:00-04:00,23843.25,23848.25,23839.5,23845,NaN,NaN,NaN,23865.42801734731,NaN,NaN,23845.385,23870.17858990259,23820.591410097408,23829.34154847416,23832.590365201868,23851.14064005815,23814.040090345585,1096,1311.4,48.07308171477448,46.34643331343572,NaN,NaN,NaN,NaN,9.709038043081621,21.299201915977957,-163144
2025-09-09T05:05:00-04:00,23845,23848.25,23836,23836.25,NaN,NaN,NaN,23865.42801734731,NaN,NaN,23845.35,23870.190088570893,23820.509911429104,23829.34154847416,23832.64277738843,23851.139439233597,23814.146115543266,918,1291.5333333333333,42.01584994739792,45.538486371225396,NaN,NaN,NaN,NaN,9.890535325718648,20.591947366426737,-164062
2025-09-09T05:10:00-04:00,23836.5,23850.75,23835.75,23849.75,NaN,NaN,NaN,23865.42801734731,NaN,NaN,23845.64,23870.33982996276,23820.94017003724,23829.34154847416,23832.744575063236,23851.202365142246,23814.286784984226,1066,1302.4333333333334,52.053643074504656,45.60521658377062,NaN,NaN,NaN,NaN,10.255497088167317,19.5171776113288,-162996
2025-09-09T05:15:00-04:00,23850,23855,23847.75,23851.25,NaN,NaN,NaN,23865.42801734731,NaN,NaN,23845.99,23870.501213753047,23821.478786246957,23829.34154847416,23832.904799226257,23851.363026758845,23814.44657169367,1163,1316.4333333333334,53.02666475409587,46.62171529933698,NaN,NaN,NaN,NaN,10.040818724726794,18.388501026695018,-161833
2025-09-09T05:20:00-04:00,23851,23853.25,23844,23847.5,NaN,NaN,NaN,23865.42801734731,NaN,NaN,23846.26,23870.533228050484,23821.986771949512,23829.154436996203,23832.9951336138,23851.43635178962,23814.55391543798,799,1308.7333333333333,50.27951296091153,46.90108373195631,NaN,NaN,NaN,NaN,9.984331672960595,17.37976457714547,-162632
2025-09-09T05:25:00-04:00,23847.5,23853.75,23845,23847.5,NaN,NaN,NaN,23865.42801734731,NaN,NaN,23846.64,23870.37818863748,23822.901811362517,23829.154436996203,23833.08274658207,23851.50990052203,23814.65559264211,759,1315.2,50.27951296091153,47.38105641878446,NaN,NaN,NaN,NaN,9.896165124891981,16.36168014013595,-162632
2025-09-09T05:30:00-04:00,23847.25,23851,23846.75,23847.5,NaN,NaN,NaN,23865.42801734731,NaN,NaN,23847.15,23869.82046536376,23824.479534636244,23829.182071742056,23833.134476224557,23851.551995713435,23814.71695673568,462,1292.2,50.27951296091153,47.30229060814703,NaN,NaN,NaN,NaN,9.492867615971125,15.416316020055673,-162632
2025-09-09T05:35:00-04:00,23847.75,23852.25,23847.5,23851.75,NaN,NaN,NaN,23865.42801734731,NaN,NaN,23847.815,23868.985925814475,23826.644074185522,23832.420657393646,23833.192358776185,23851.606380623798,23814.77833692857,458,1281.0666666666666,53.676554896068794,47.63563089874835,NaN,NaN,NaN,NaN,9.154091357687474,14.318086955981377,-162174
2025-09-09T05:40:00-04:00,23851.5,23856.5,23846,23849.75,NaN,NaN,NaN,23865.42801734731,NaN,NaN,23848.31,23868.456602681676,23828.163397318327,23835.386525914917,23833.33267996506,23851.73948068188,23814.92587924824,1107,1266.6333333333334,51.880196871401274,47.81072410957261,NaN,NaN,NaN,NaN,9.250227689281227,14.020142973734206,-163281
2025-09-09T05:45:00-04:00,23849.25,23853.25,23845.75,23852,NaN,NaN,NaN,23865.42801734731,NaN,NaN,23848.855,23867.865021039077,23829.844978960922,23835.386525914917,23833.43345964399,23851.831965361343,23815.03495392664,826,1255.5333333333333,53.755226468090015,48.604965111018466,NaN,NaN,NaN,NaN,9.125211425761139,13.69341331200244,-162455
2025-09-09T05:50:00-04:00,23852.25,23852.25,23844.25,23846,NaN,NaN,NaN,23865.42801734731,NaN,NaN,23849.255,23867.132497011786,23831.377502988216,23835.386525914917,23833.50347291649,23851.882812329382,23815.1241335036,697,1249.6,48.34529329574461,48.71591144655199,NaN,NaN,NaN,NaN,9.044839181063915,13.081263774128086,-163152
2025-09-09T05:55:00-04:00,23845.5,23849,23842.25,23844.5,NaN,NaN,NaN,23865.42801734731,NaN,NaN,23849.62,23866.30958956605,23832.930410433946,23835.386525914917,23833.5689533758,23851.91784835271,23815.220058398892,785,1211.8333333333333,47.06991417456275,49.2073205508197,NaN,NaN,NaN,NaN,8.880922096702207,12.183917159800915,-163937
2025-09-09T06:00:00-04:00,23844.5,23847,23841.25,23843.75,NaN,NaN,NaN,23865.42801734731,NaN,NaN,23849.78,23866.083570170336,23833.47642982966,23835.386525914917,23833.619887948258,23851.93836612635,23815.301409770167,691,1190.4666666666667,46.41065304408297,49.55644165534716,NaN,NaN,NaN,NaN,8.657284804080621,11.550243663306818,-164628
2025-09-09T06:05:00-04:00,23843.75,23851.75,23843.5,23851,NaN,NaN,NaN,23865.42801734731,NaN,NaN,23850.11,23865.82023870628,23834.39976129372,23835.386525914917,23833.67814663861,23851.985320243904,23815.370973033314,547,1107.3666666666666,53.23000101062215,50.026829866720014,NaN,NaN,NaN,NaN,8.628193032360576,11.415656865421035,-164081
2025-09-09T06:10:00-04:00,23851,23856.5,23848.75,23854,NaN,NaN,NaN,23865.42801734731,NaN,NaN,23850.37,23865.897794436263,23834.842205563735,23837.355029449438,23833.790190527518,23852.10355018452,23815.476830870513,825,1058.3666666666666,55.73983691669944,50.574455238286085,NaN,NaN,NaN,NaN,8.565464958620534,12.059591135164624,-163256
2025-09-09T06:15:00-04:00,23853.25,23856.25,23851.25,23851.75,NaN,NaN,NaN,23865.42801734731,NaN,NaN,23850.53,23865.94610846497,23835.113891535028,23838.434023559552,23833.866983839303,23852.184186278802,23815.549781399804,571,1021.0666666666667,53.424243554631374,51.389340495945625,NaN,NaN,NaN,NaN,8.31078889014764,12.657530099926529,-163827
2025-09-09T06:20:00-04:00,23852,23855.25,23851.25,23852,NaN,NaN,NaN,23865.42801734731,NaN,NaN,23850.54,23865.959260686577,23835.120739313425,23838.997218847642,23833.916959828697,23852.235834813033,23815.59808484436,379,1001.3333333333334,53.65462377438405,51.50369626022272,NaN,NaN,NaN,NaN,8.002875397994236,13.21275913863401,-163448
2025-09-09T06:25:00-04:00,23852.5,23855.5,23846.5,23847.25,NaN,NaN,NaN,23865.42801734731,NaN,NaN,23850.555,23865.959963487992,23835.15003651201,23838.997218847642,23833.9949497046,23852.30224115349,23815.68765825571,712,1001.7,48.72333368895745,51.19631546985568,NaN,NaN,NaN,NaN,8.074098583851791,12.61388858647833,-164160
2025-09-09T06:30:00-04:00,23847.25,23849.25,23840,23848.5,NaN,NaN,NaN,23865.42801734731,NaN,NaN,23850.52,23865.935524629444,23835.104475370557,23838.997218847642,23834.100403878336,23852.360698132994,23815.840109623678,1290,1009.2666666666667,50.02502226377879,51.178137562917634,NaN,NaN,NaN,NaN,8.15809154214809,12.568384575863387,-162870
2025-09-09T06:35:00-04:00,23848,23854.5,23845.75,23854.25,NaN,NaN,NaN,23865.42801734731,NaN,NaN,23850.625,23866.069173659933,23835.180826340067,23838.997218847642,23834.253315118032,23852.505581642316,23816.00104859375,1293,980.4,55.60764192326262,51.55871820308556,NaN,NaN,NaN,NaN,8.20037071770894,11.793984318101232,-161577
2025-09-09T06:40:00-04:00,23854.25,23860,23853.25,23856,NaN,NaN,NaN,23865.42801734731,NaN,NaN,23850.765,23866.274484204336,23835.255515795663,23841.203860839993,23834.441212280508,23852.729186733257,23816.15323782776,1258,970.7333333333333,57.1755901054327,52.051295141979935,NaN,NaN,NaN,NaN,8.096772809301159,11.926494508790157,-160319
2025-09-09T06:45:00-04:00,23856.25,23857.25,23843.25,23843.25,NaN,NaN,NaN,23865.42801734731,NaN,NaN,23850.58,23866.222391124174,23834.93760887583,23841.203860839993,23834.565825054087,23852.814685446283,23816.31696466189,1385,915.9,44.76888211497608,51.415032800473305,NaN,NaN,NaN,NaN,8.518431894351076,11.657871203157736,-161704
2025-09-09T06:50:00-04:00,23843.25,23846.5,23837.75,23840.75,NaN,NaN,NaN,23865.42801734731,NaN,NaN,23850.48,23866.307457154053,23834.652542845946,23841.203860839993,23834.631864975952,23852.808451303546,23816.45527864836,1406,915.7333333333333,42.8074219792003,50.76697745103038,NaN,NaN,NaN,NaN,8.534972473325999,12.078081467779663,-163110
2025-09-09T06:55:00-04:00,23840.75,23845.5,23838.5,23845.5,NaN,NaN,NaN,23865.42801734731,NaN,NaN,23850.445,23866.308571483714,23834.581428516285,23841.203860839993,23834.66482004956,23852.814000610444,23816.515639488673,586,907.2,47.51280403788897,50.32109013458745,NaN,NaN,NaN,NaN,8.425331582374142,12.468276713500023,-162524
2025-09-09T07:00:00-04:00,23845.5,23845.5,23836,23836,NaN,NaN,NaN,23865.42801734731,NaN,NaN,23850.12,23866.480391186302,23833.759608813696,23841.203860839993,23834.69870570797,23852.78363856842,23816.613772847522,1151,913.3333333333334,40.3607732406949,49.750767273512466,NaN,NaN,NaN,NaN,8.50209361220456,13.131389580880576,-163675
2025-09-09T07:05:00-04:00,23836,23843.25,23834.75,23840.25,NaN,NaN,NaN,23864.69904821436,NaN,NaN,23849.925,23866.517242156235,23833.332757843764,23841.203860839993,23834.73686879171,23852.753466688595,23816.720270894828,1247,912.7,44.39346091667818,49.559592040806436,NaN,NaN,NaN,NaN,8.501944068475662,13.896716071571316,-162428
2025-09-09T07:10:00-04:00,23840.5,23842.5,23829,23831.5,NaN,NaN,NaN,23862.12181875007,NaN,NaN,23849.545,23866.919029475488,23832.17097052451,23841.203860839993,23834.731912471685,23852.637581589723,23816.826243353647,1917,944.5,38.60561610398279,49.00208940222785,NaN,NaN,NaN,NaN,8.858948063584544,15.244119106762774,-164345
2025-09-09T07:15:00-04:00,23831.5,23831.5,23812.5,23814.5,NaN,NaN,NaN,23849.764008806884,NaN,NaN,23848.73,23868.600792639347,23828.859207360652,23841.203860839993,23834.388878451027,23852.23544492839,23816.542311973666,3596,1019.6333333333333,30.331564314974216,47.36648678111015,NaN,NaN,NaN,NaN,9.583308916185647,17.771136469611417,-167941
2025-09-09T07:20:00-04:00,23814.25,23825.75,23811,23823,NaN,NaN,NaN,23846.888372042937,NaN,NaN,23847.92,23868.6017407457,23827.238259254296,23841.203860839993,23834.113085181983,23851.899193225847,23816.32697713812,3102,1093.7333333333333,37.53975278866512,46.066480771964834,NaN,NaN,NaN,NaN,9.952358279315243,20.20705486665544,-164839
2025-09-09T07:25:00-04:00,23822.25,23825.5,23819.5,23820.75,NaN,NaN,NaN,23846.888372042937,NaN,NaN,23847.075,23868.65606808822,23825.49393191178,23841.203860839993,23834.02641533795,23851.778800609296,23816.274030066605,1165,1108.5666666666666,36.464264204518905,44.855053675528225,NaN,NaN,NaN,NaN,9.67004697364987,22.468979092482037,-166004
2025-09-09T07:30:00-04:00,23821,23833,23820.75,23831.25,NaN,NaN,NaN,23846.888372042937,NaN,NaN,23846.445,23867.99802530636,23824.89197469364,23835.213088671997,23833.965164680452,23851.63156031522,23816.298769045683,1783,1131.4666666666667,44.46085786324854,44.198356110447115,NaN,NaN,NaN,NaN,9.854329332674878,23.17912321847291,-164221
2025-09-09T07:35:00-04:00,23831.25,23833.75,23826,23832.75,NaN,NaN,NaN,23846.888372042937,NaN,NaN,23845.755,23866.802681582034,23824.707318417968,23824.495470937596,23833.940472555812,23851.539267162723,23816.3416779489,1317,1144.7666666666667,45.51583704817697,43.969249207534226,NaN,NaN,NaN,NaN,9.704020094626673,23.709790674223765,-162904
2025-09-09T07:40:00-04:00,23833.5,23837,23830.5,23836.25,NaN,NaN,NaN,23846.888372042937,NaN,NaN,23845.045,23864.8983851,23825.191614899995,23824.396376750075,23833.944001393163,23851.494491524925,23816.3935112614,922,1139.9666666666667,47.997977907864936,43.824460324968946,NaN,NaN,NaN,NaN,9.475161516439053,23.645291315279586,-161982
2025-09-09T07:45:00-04:00,23835.75,23849.75,23835.75,23847.75,23814.303780174076,23814.303780174076,23814.303780174076,NaN,NaN,NaN,23844.565,23862.916242471878,23826.21375752812,23823.86710140006,23834.13492768618,23851.58105265507,23816.68880271729,3119,1205.1666666666667,55.217077766996475,43.796562885235645,NaN,NaN,NaN,NaN,9.798364265264835,22.09491493059652,-158863
2025-09-09T07:50:00-04:00,23847.75,23850.75,23845.5,23847.75,23820.255881075253,NaN,NaN,NaN,NaN,NaN,23844.405,23862.50110179579,23826.308898204206,23827.01785137589,23834.25479839684,23851.672706173173,23816.836890620507,1492,1228.2666666666667,55.21707776699648,43.656669146775926,NaN,NaN,NaN,NaN,9.473481103460204,20.772500757396177,-158863
2025-09-09T07:55:00-04:00,23848,23853.25,23844.5,23849.5,23821.079477390012,NaN,NaN,NaN,NaN,NaN,23844.335,23862.32433295904,23826.345667040958,23829.88928110071,23834.408287934406,23851.800690506196,23817.015885362616,1805,1263.1333333333334,56.28803643104116,44.479465883637715,NaN,NaN,NaN,NaN,9.421803881784475,19.841479069532465,-157058
2025-09-09T08:00:00-04:00,23849.5,23849.75,23838.25,23849,23821.079477390012,NaN,NaN,NaN,NaN,NaN,23844.21,23861.97973833092,23826.44026166908,23829.88928110071,23834.55579152401,23851.881245692995,23817.230337355024,2315,1324.9,55.87687813999276,45.412998466551464,NaN,NaN,NaN,NaN,9.570246461657012,18.671885546919924,-159373
2025-09-09T08:05:00-04:00,23848.25,23849.5,23844.75,23847.5,23821.079477390012,NaN,NaN,NaN,NaN,NaN,23844.05,23861.552285576476,23826.547714423523,23829.88928110071,23834.62509826547,23851.92849398326,23817.32170254768,970,1341.9666666666667,54.588625472132534,45.91841428328314,NaN,NaN,NaN,NaN,9.225943142967225,17.585834418779715,-160343
2025-09-09T08:10:00-04:00,23846.75,23856.75,23845.75,23853.5,23823.527955025256,NaN,NaN,NaN,NaN,NaN,23844.05,23861.552285576476,23826.547714423523,23833.709311923565,23834.806167472456,23852.109362529638,23817.502972415274,1871,1367.4333333333334,58.69119734608843,47.22773029081126,NaN,NaN,NaN,NaN,9.352661489898138,16.989207398782558,-158472
2025-09-09T08:15:00-04:00,23853.75,23857.75,23847.25,23849.75,23824.606229796835,NaN,NaN,NaN,NaN,NaN,23844.26,23861.7788355851,23826.741164414896,23834.067449538852,23834.950689597423,23852.248817909225,23817.65256128562,1560,1391.9,55.32691303022335,48.00869115606448,NaN,NaN,NaN,NaN,9.434614240619698,16.551290148951928,-160032
2025-09-09T08:20:00-04:00,23850,23855,23845.5,23846,23824.606229796835,NaN,NaN,NaN,NaN,NaN,23844.24,23861.748557911043,23826.73144208896,23834.067449538852,23835.056434009555,23852.33077532244,23817.78209269667,1390,1415,52.110096567246174,48.973296903440435,NaN,NaN,NaN,NaN,9.439284652004005,15.886154535217296,-161422
2025-09-09T08:25:00-04:00,23845.5,23852.75,23841.75,23852.25,23824.606229796835,NaN,NaN,NaN,NaN,NaN,23844.42,23862.068637355904,23826.771362644093,23834.067449538852,23835.173168564852,23852.421182385733,23817.92515474397,1550,1440.5,56.6355029970451,50.8521496664455,NaN,NaN,NaN,NaN,9.550764319718004,14.770963077023563,-159872
2025-09-09T08:30:00-04:00,23852.25,23852.25,23834.75,23842.75,23824.606229796835,NaN,NaN,NaN,NaN,NaN,23844.225,23861.72707131253,23826.722928687468,23834.067449538852,23835.313623573766,23852.443577000537,23818.183670146995,3257,1526.0333333333333,49.04853972542829,51.674205876214295,NaN,NaN,NaN,NaN,10.118566868309575,14.614781712427144,-163129
2025-09-09T08:35:00-04:00,23843,23852.5,23841.25,23850,23824.606229796835,NaN,NaN,NaN,NaN,NaN,23844.235,23861.749682400718,23826.720317599284,23834.067449538852,23835.481599525177,23852.55828335341,23818.404915696945,2530,1592.1333333333334,54.10182401008139,52.934031576611616,NaN,NaN,NaN,NaN,10.199383520573177,14.431754666245636,-160599
2025-09-09T08:40:00-04:00,23850.25,23851.75,23839.75,23842.75,23824.606229796835,NaN,NaN,NaN,NaN,NaN,23844.09,23861.531261419055,23826.648738580945,23834.067449538852,23835.606215460048,23852.60126713011,23818.611163789985,2587,1650.8666666666666,48.88096950723637,53.24975383689646,NaN,NaN,NaN,NaN,10.327998983389378,14.447932473898714,-163186
2025-09-09T08:45:00-04:00,23842.75,23845.75,23835.25,23839.25,23824.606229796835,NaN,NaN,NaN,NaN,NaN,23844.055,23861.527919055337,23826.582080944663,23834.067449538852,23835.645997201267,23852.570590886335,23818.7214035162,1725,1689.3333333333333,46.545766759375724,53.32332024483923,NaN,NaN,NaN,NaN,10.340284770290136,14.995506006657836,-164911
2025-09-09T08:50:00-04:00,23839,23841.5,23833.75,23839.25,23824.606229796835,NaN,NaN,NaN,NaN,NaN,23843.925,23861.442205826326,23826.407794173672,23834.067449538852,23835.67359455348,23852.50732815773,23818.839860949225,2149,1748.3333333333333,46.545766759375724,53.219590877090006,NaN,NaN,NaN,NaN,10.155264429555126,15.673132783136486,-164911
2025-09-09T08:55:00-04:00,23839,23843.75,23837.75,23839,23824.606229796835,NaN,NaN,NaN,NaN,NaN,23843.99,23861.409230745416,23826.570769254588,23834.067449538852,23835.714535722163,23852.476836721227,23818.9522347231,1805,1784.7666666666667,46.362285820826536,52.58710573807786,NaN,NaN,NaN,NaN,9.858459827444047,15.886053305278198,-166716
2025-09-09T09:00:00-04:00,23839.25,23840.25,23800.5,23807,NaN,NaN,NaN,23853.491789553245,23853.491789553245,23853.491789553245,23843.385,23863.578862927945,23823.19113707205,23834.067449538852,23834.884629305405,23851.764741719406,23818.004516891404,8667,2030.6666666666667,30.03940661741386,50.788700655964824,NaN,NaN,NaN,NaN,11.993569839769473,18.727327051217966,-175383
2025-09-09T09:05:00-04:00,23807.5,23828.25,23800.25,23828,NaN,NaN,NaN,23849.67966275537,NaN,NaN,23843.08,23863.72835101603,23822.431648983973,23831.30395963108,23834.05694535552,23850.874962973412,23817.23892773763,11241,2362.266666666667,43.97865759707429,49.90945931068147,NaN,NaN,NaN,NaN,13.136886279785939,21.376032344812515,-164142
2025-09-09T09:10:00-04:00,23827.5,23828.5,23815.75,23822.5,NaN,NaN,NaN,23849.67966275537,NaN,NaN,23842.63,23864.057375015058,23821.202624984944,23828.293167704865,23833.78636621697,23850.5041787627,23817.068553671237,5113,2490.766666666667,41.63868364555378,48.89244541822154,NaN,NaN,NaN,NaN,13.109251545515516,23.796399649127444,-169255
2025-09-09T09:15:00-04:00,23822.75,23825.5,23816.25,23819.75,NaN,NaN,NaN,23849.67966275537,NaN,NaN,23842.3,23864.600672639444,23819.999327360554,23824.222627331113,23833.607707534647,23850.283105237402,23816.932309831893,3041,2545.9666666666667,40.47896369766076,47.88461243433071,NaN,NaN,NaN,NaN,12.833590720835835,26.043883574562738,-172296
2025-09-09T09:20:00-04:00,23819.5,23826,23810,23817.75,NaN,NaN,NaN,23849.67966275537,NaN,NaN,23841.66,23864.886226547587,23818.433773452412,23824.222627331113,23833.32301661385,23849.97863982153,23816.66739340617,4179,2638.4,39.614800836142535,46.52201268362029,NaN,NaN,NaN,NaN,13.059762812204704,28.426566378831808,-176475
2025-09-09T09:25:00-04:00,23818,23837.75,23814,23835.25,NaN,NaN,NaN,23849.67966275537,NaN,NaN,23841.34,23864.46958279126,23818.210417208742,23823.12810186489,23833.191995152876,23849.610013422163,23816.77397688359,7199,2858.8333333333335,49.72793315736144,46.12208554984443,NaN,NaN,NaN,NaN,13.823351182761511,28.842394143597268,-169276
2025-09-09T09:30:00-04:00,23835,23857.75,23823,23842.5,23799.9395110402,23799.9395110402,23799.9395110402,NaN,NaN,NaN,23841.24,23864.305333287983,23818.17466671202,23819.635588154822,23834.057975522977,23849.744119046893,23818.371831999062,29279,3796.4333333333334,53.22312510841051,46.20158758849903,NaN,NaN,NaN,NaN,15.31811181256426,27.07712005783639,-139997
2025-09-09T09:35:00-04:00,23843.25,23848,23824,23834.25,23799.9395110402,NaN,NaN,NaN,NaN,NaN,23840.975,23864.05101568853,23817.89898431147,23819.635588154822,23834.14300470804,23849.333951143224,23818.952058272855,17812,4348.6,49.0444838816106,45.65937193739656,NaN,NaN,NaN,NaN,15.938246683095384,25.437936978201286,-157809
2025-09-09T09:40:00-04:00,23834.5,23844.5,23815,23842,23799.9395110402,NaN,NaN,NaN,NaN,NaN,23840.865,23863.867871562165,23817.86212843784,23819.635588154822,23834.120843907738,23848.758369592095,23819.48331822338,21938,5015.966666666666,52.79391304154128,45.926898602833205,NaN,NaN,NaN,NaN,16.906943348588573,24.633625234939625,-135871
2025-09-09T09:45:00-04:00,23841.25,23848.5,23824.25,23829,23799.9395110402,NaN,NaN,NaN,NaN,NaN,23840.41,23863.43363134328,23817.38636865672,23805.921009297006,23834.109304774604,23848.327271524417,23819.89133802479,18363,5508.2,46.59973445009022,45.391035062833836,NaN,NaN,NaN,NaN,17.43144739511796,23.497154459371345,-154234
2025-09-09T09:50:00-04:00,23829.5,23831.5,23804.5,23807.5,23799.9395110402,NaN,NaN,NaN,NaN,NaN,23839.565,23864.20030191364,23814.92969808636,23805.921009297006,23832.906847139133,23847.46322043703,23818.350473841238,21226,6112.333333333333,38.54505393868505,44.65275537936588,NaN,NaN,NaN,NaN,18.11491543832382,23.76253972054783,-175460
2025-09-09T09:55:00-04:00,23807.5,23841.25,23801.25,23815,23799.9395110402,NaN,NaN,NaN,NaN,NaN,23838.825,23864.135323984312,23813.51467601569,23805.921009297006,23832.065604755528,23846.548915732772,23817.582293778283,22575,6826,42.292250717803135,44.34893280496784,NaN,NaN,NaN,NaN,19.678135764157833,23.12554509239999,-152885
2025-09-09T10:00:00-04:00,23816,23833.25,23781,23795.5,NaN,NaN,NaN,23862.208024526288,23862.208024526288,23862.208024526288,23837.815,23865.789597409155,23809.840402590842,23805.921009297006,23829.25043415842,23845.451317377607,23813.049550939235,39923,8097.333333333333,36.12470959219405,43.60457157874058,NaN,NaN,NaN,NaN,22.004697495289413,23.620483019185333,-192808
2025-09-09T10:05:00-04:00,23795.25,23834,23788.5,23831.75,NaN,NaN,NaN,23862.208024526288,NaN,NaN,23837.56,23865.518640870527,23809.601359129476,23805.921009297006,23828.496445772504,23844.389791461505,23812.603100083503,29589,9039.733333333334,50.55902949116247,43.90433898376457,NaN,NaN,NaN,NaN,23.68293338848303,24.01435473065758,-163219
2025-09-09T10:10:00-04:00,23831.75,23850.75,23826.75,23835.5,NaN,NaN,NaN,23862.208024526288,NaN,NaN,23837.395,23865.302900309704,23809.487099690297,23805.921009297006,23828.951254744967,23844.572853198257,23813.329656291677,22869,9771.3,51.773145854184285,45.45674892924818,NaN,NaN,NaN,NaN,23.705581003591384,23.038954156660367,-140350
2025-09-09T10:15:00-04:00,23836,23842,23810,23817.25,NaN,NaN,NaN,23862.208024526288,NaN,NaN,23836.72,23864.910182678726,23808.529817321276,23805.921009297006,23828.684325650658,23843.995380290962,23813.373271010354,21975,10399.833333333334,45.86958047061896,45.59181484878708,NaN,NaN,NaN,NaN,24.298039503334856,23.000080532791163,-162325
2025-09-09T10:20:00-04:00,23817,23828.75,23815,23818,NaN,NaN,NaN,23862.208024526288,NaN,NaN,23836,23864.226937492913,23807.773062507087,23794.536807437606,23828.484250467554,23843.657231375164,23813.311269559945,12233,10757.866666666667,46.141379640094826,45.913435991254296,NaN,NaN,NaN,NaN,23.544608110239512,22.96398359634119,-150092
2025-09-09T10:25:00-04:00,23818,23823,23798,23810.75,NaN,NaN,NaN,23862.208024526288,NaN,NaN,23835.18,23863.906823703386,23806.453176296614,23790.358556760068,23827.854947229807,23843.119124778364,23812.59076968125,18047,11299.266666666666,43.8492943816717,46.15417389725508,NaN,NaN,NaN,NaN,23.64856467379383,23.691415597500164,-168139
2025-09-09T10:30:00-04:00,23810.5,23812.25,23753,23753.75,NaN,NaN,NaN,23848.76379174803,NaN,NaN,23833.215,23869.514037177607,23796.915962822393,23790.358556760068,23824.940995060482,23844.227564144712,23805.654425976252,28800,12182.1,30.866901232245752,45.52932392554817,NaN,NaN,NaN,NaN,26.191524339951417,25.711201154329977,-196939
2025-09-09T10:35:00-04:00,23754,23761.75,23733.5,23743,NaN,NaN,NaN,23814.609755759484,NaN,NaN,23831.13,23875.125140641816,23787.134859358186,23773.239476326442,23820.869770602723,23846.506465898397,23795.23307530705,29514,13133.566666666668,29.11607414762146,44.057048281995314,NaN,NaN,NaN,NaN,26.33855831566917,27.985109928242856,-226453
2025-09-09T10:40:00-04:00,23743,23758,23726.5,23744.25,NaN,NaN,NaN,23810.48544867951,NaN,NaN,23829.045,23879.023964576878,23779.06603542312,23773.239476326442,23818.209309051053,23847.10779303484,23789.310825067267,20200,13744.533333333333,29.616005492249016,42.3708254522695,NaN,NaN,NaN,NaN,26.7072327216928,30.226877877837044,-206253
2025-09-09T10:45:00-04:00,23743.75,23764.75,23736.5,23760.75,NaN,NaN,NaN,23810.48544867951,NaN,NaN,23827.175,23880.14879069242,23774.20120930758,23769.00861187914,23815.9559082533,23846.703681728897,23785.208134777706,21527,14410.1,36.02958371281831,41.44118972592719,NaN,NaN,NaN,NaN,26.81743038442903,31.82233313833312,-184726
2025-09-09T10:50:00-04:00,23760.75,23789,23740.75,23787.75,NaN,NaN,NaN,23810.48544867951,NaN,NaN,23825.81,23879.257596763953,23772.36240323605,23769.00861187914,23814.45215296948,23845.68988153427,23783.21442440469,21987,15096.666666666666,44.880640913832586,40.87595600251943,NaN,NaN,NaN,NaN,28.348328214112673,31.758489172776507,-162739
2025-09-09T10:55:00-04:00,23787.5,23802.5,23785.25,23785.75,NaN,NaN,NaN,23810.48544867951,NaN,NaN,23824.66,23879.023660656047,23770.296339343953,23769.00861187914,23813.870362413578,23844.928760861596,23782.81196396556,16282,15587.733333333334,44.39068307165547,40.71816661834553,NaN,NaN,NaN,NaN,27.555590484533194,30.966418411399715,-179021
2025-09-09T11:00:00-04:00,23785.75,23806.75,23765.25,23772,NaN,NaN,NaN,23810.48544867951,NaN,NaN,23823.285,23879.400774071808,23767.16922592819,23760.60688950331,23812.82579737396,23843.915214536366,23781.736380211554,21615,16199.666666666666,41.071030393634274,40.89859350798475,NaN,NaN,NaN,NaN,28.551619735637964,30.860586038261705,-200636
2025-09-09T11:05:00-04:00,23772,23778.5,23752,23772.75,NaN,NaN,NaN,23810.48544867951,NaN,NaN,23821.83,23879.322037706977,23764.337962293026,23756.76051160265,23811.713333067753,23843.203095453064,23780.223570682443,17037,16683.233333333334,41.32876296894702,40.82977295449503,NaN,NaN,NaN,NaN,28.40507546880668,31.132300109865547,-183599
2025-09-09T11:10:00-04:00,23772.75,23785.25,23762.75,23776.25,NaN,NaN,NaN,23810.48544867951,NaN,NaN,23820.635,23879.369675450023,23761.900324549973,23752.908409282118,23811.164312091612,23842.737543191935,23779.59108099129,10408,16943.933333333334,42.59063317762839,41.291624639168916,NaN,NaN,NaN,NaN,27.98328436389192,31.01198196573045,-173191
2025-09-09T11:15:00-04:00,23776.25,23790.25,23776.25,23782.5,NaN,NaN,NaN,23810.48544867951,NaN,NaN,23819.48,23878.893705489412,23760.066294510587,23726.551727425696,23810.822608366907,23842.354837774274,23779.29037895954,8606,17173.3,44.870805882533695,40.885322952838294,NaN,NaN,NaN,NaN,26.98447833789964,30.623088386267973,-164585
2025-09-09T11:20:00-04:00,23782.75,23790.5,23773,23779,NaN,NaN,NaN,23810.48544867951,NaN,NaN,23818.43,23878.804749686627,23758.055250313373,23727.81408992124,23810.520809230402,23842.03644226642,23779.005176194383,7211,17342.033333333333,43.82116292880252,40.31732417245388,NaN,NaN,NaN,NaN,26.307015599478234,30.371240885407442,-171796
2025-09-09T11:25:00-04:00,23779.5,23787.5,23774,23784.25,NaN,NaN,NaN,23810.48544867951,NaN,NaN,23817.825,23878.94678416852,23756.703215831483,23730.601271936994,23810.249793106337,23841.73793752856,23778.761648684114,6854,17510.333333333332,45.86674908796641,40.317121930835846,NaN,NaN,NaN,NaN,25.392228770944076,30.13738249175123,-164942
2025-09-09T11:30:00-04:00,23784,23786.25,23770.25,23774,NaN,NaN,NaN,23810.48544867951,NaN,NaN,23816.845,23879.163046338293,23754.52695366171,23732.731017549595,23809.852368259057,23841.361633407312,23778.3431031108,8707,17511.666666666668,42.60497002225132,40.06452124384702,NaN,NaN,NaN,NaN,24.721355287305215,30.059610835587947,-173649
2025-09-09T11:35:00-04:00,23774,23778,23764,23770,NaN,NaN,NaN,23810.48544867951,NaN,NaN,23815.83,23879.499100824316,23752.160899175688,23732.731017549595,23809.38820025771,23840.995899194066,23777.78050132135,8776,17429.5,41.3686006962196,39.88732883774329,NaN,NaN,NaN,NaN,23.95554419535484,30.219710773245662,-182425
2025-09-09T11:40:00-04:00,23769.5,23771.25,23754,23761,NaN,NaN,NaN,23810.48544867951,NaN,NaN,23814.425,23879.749899542287,23749.100100457712,23732.731017549595,23808.800828093597,23840.64548678719,23776.956169400004,9315,17569.566666666666,38.65082314693144,40.44332326022084,NaN,NaN,NaN,NaN,23.476576752829494,30.722364069741907,-191740
2025-09-09T11:45:00-04:00,23761.25,23775.75,23758,23759.25,NaN,NaN,NaN,23810.48544867951,NaN,NaN,23812.955,23879.853257822753,23746.05674217725,23732.731017549595,23808.22621635277,23840.260566956113,23776.191865749428,9821,17795.566666666666,38.12631989424938,41.086912242122835,NaN,NaN,NaN,NaN,23.067535556198816,30.85322212358542,-201561
2025-09-09T11:50:00-04:00,23759.5,23810,23759.5,23805.25,NaN,NaN,NaN,23810.48544867951,NaN,NaN,23812.335,23878.93211780383,23745.73788219617,23746.499624788314,23807.874653698582,23839.6590790785,23776.090228318662,16401,18202.966666666667,55.29823051483526,42.92135688659328,NaN,NaN,NaN,NaN,25.044854445041757,28.89884421665365,-185160
2025-09-09T11:55:00-04:00,23805.75,23812.75,23783.75,23784.75,23727.10478603008,23727.10478603008,23727.10478603008,NaN,NaN,NaN,23811.075,23877.327264113694,23744.822735886308,23747.44969983065,23807.624089906774,23839.180464107678,23776.06771570587,14022,18430.4,48.79844048519378,43.8334180846201,NaN,NaN,NaN,NaN,25.327364841824487,26.94652853438095,-199182
2025-09-09T12:00:00-04:00,23784.5,23801.75,23781.75,23798,23727.10478603008,NaN,NaN,NaN,NaN,NaN,23810.08,23875.58934589482,23744.570654105184,23747.44969983065,23807.478615678687,23838.89971316889,23776.057518188485,8427,17735.333333333332,52.67070345417026,44.38985112321564,NaN,NaN,NaN,NaN,24.946838781694165,25.234648042937124,-190755
2025-09-09T12:05:00-04:00,23797.5,23807.5,23794.75,23806.25,23731.958596362118,NaN,NaN,NaN,NaN,NaN,23809.215,23873.75444607981,23744.67555392019,23751.332807891617,23807.436980079634,23838.720010920933,23776.153949238334,7225,17382.433333333334,54.9549925700358,45.14444465881424,NaN,NaN,NaN,NaN,24.075636011573152,23.5324788879066,-183530
2025-09-09T12:10:00-04:00,23806.5,23821.25,23806,23819.75,23745.52297834566,NaN,NaN,NaN,NaN,NaN,23808.63,23872.239923751815,23745.020076248187,23768.691246313294,23807.547214610026,23838.634424079897,23776.460005140154,10944,17015.966666666667,58.48586118312108,46.38836114377757,NaN,NaN,NaN,NaN,23.445233439317924,22.647767041318165,-172586
2025-09-09T12:15:00-04:00,23819.75,23833.75,23815,23816.75,23756.811706602675,NaN,NaN,NaN,NaN,NaN,23808.015,23870.697645923567,23745.332354076432,23782.327997050634,23807.770471790634,23838.66467068124,23776.87627290003,12971,16836.233333333334,57.408933494915345,47.53694475277531,NaN,NaN,NaN,NaN,23.109859622223787,22.386053434404154,-185557
2025-09-09T12:20:00-04:00,23817.25,23818.25,23795.5,23812.25,23756.811706602675,NaN,NaN,NaN,NaN,NaN,23807.19,23868.52771759626,23745.85228240374,23782.327997050634,23807.784566133425,23838.435070534542,23777.134061732308,13262,16570.766666666666,55.750639790535224,48.4769452251258,NaN,NaN,NaN,NaN,23.08415536349352,21.046182383627162,-198819
2025-09-09T12:25:00-04:00,23812,23821.5,23809.25,23818,23756.811706602675,NaN,NaN,NaN,NaN,NaN,23806.555,23866.76415960209,23746.34584039791,23782.327997050634,23807.855641494494,23838.386977004895,23777.324305984093,7140,16056.266666666666,57.44225130656326,49.37490561255648,NaN,NaN,NaN,NaN,22.310287123243985,19.957863787963877,-191679
2025-09-09T12:30:00-04:00,23818.5,23820.5,23811,23820,23756.811706602675,NaN,NaN,NaN,NaN,NaN,23806.035,23865.314423920332,23746.755576079668,23782.327997050634,23807.911818545563,23838.359449948624,23777.4641871425,5162,14897.566666666668,58.04307100707368,50.390756189575846,NaN,NaN,NaN,NaN,21.395266614440846,18.94728223484797,-186517
2025-09-09T12:35:00-04:00,23819.75,23821,23813.75,23818.75,23756.811706602675,NaN,NaN,NaN,NaN,NaN,23805.365,23863.281509733286,23747.448490266717,23782.76854759194,23807.954206881328,23838.34361763795,23777.564796124705,3671,14033.633333333333,57.49671807854631,51.221468260331555,NaN,NaN,NaN,NaN,20.384890427695073,18.0359532716812,-190188
2025-09-09T12:40:00-04:00,23819.25,23822.25,23809.5,23811.5,23756.811706602675,NaN,NaN,NaN,NaN,NaN,23804.74,23861.695768799087,23747.784231200916,23785.289838073553,23807.994894009815,23838.2928012859,23777.69698673373,5444,13452.8,54.303952653837996,52.05710987687346,NaN,NaN,NaN,NaN,19.83954111143114,16.920300337515194,-195632
2025-09-09T12:45:00-04:00,23811.75,23823.5,23807.25,23817.5,23756.811706602675,NaN,NaN,NaN,NaN,NaN,23804.09,23859.690517980303,23748.489482019697,23785.80687045884,23808.059055787377,23838.245083477752,23777.873028097,6914,12950.766666666666,56.458827269310625,53.13498320352282,NaN,NaN,NaN,NaN,19.583145317757488,15.739128361968053,-188718
2025-09-09T12:50:00-04:00,23817,23819.25,23806,23810.75,23756.811706602675,NaN,NaN,NaN,NaN,NaN,23803.45,23857.982192324827,23748.917807675174,23785.80687045884,23808.08309823848,23838.17847197226,23777.9877245047,5350,12721.333333333334,53.40753965023029,54.189034382329886,NaN,NaN,NaN,NaN,19.130777795060528,14.671637062740722,-194068
2025-09-09T12:55:00-04:00,23811.25,23829.75,23811.25,23821.25,23760.73457229718,NaN,NaN,NaN,NaN,NaN,23803.09,23856.90503135762,23749.27496864238,23790.826397093657,23808.185155692092,23838.180428007647,23778.189883376537,7123,12357.2,57.27563458405752,55.55684257445903,NaN,NaN,NaN,NaN,19.121436523984777,14.257940483195766,-186945
2025-09-09T13:00:00-04:00,23821,23837.5,23821,23834.75,23769.95118264731,NaN,NaN,NaN,NaN,NaN,23803,23856.587405237926,23749.412594762074,23798.111117674925,23808.38304761296,23838.323538339533,23778.442556886384,7707,11654.1,61.68048019421281,56.01271755155743,NaN,NaN,NaN,NaN,18.934191057985863,14.335143080903883,-179238
2025-09-09T13:05:00-04:00,23835.25,23846,23834.5,23843,23782.078401617888,NaN,NaN,NaN,NaN,NaN,23803.08,23856.89360793884,23749.266392061163,23808.73889413994,23808.687487224208,23838.65407458873,23778.720899859687,8359,10948.933333333332,64.1153127450902,57.10677985583574,NaN,NaN,NaN,NaN,18.40317741098687,14.874010739719152,-170879
2025-09-09T13:10:00-04:00,23843,23855.25,23839,23839,23789.3816560898,NaN,NaN,NaN,NaN,NaN,23803.72,23858.458070847522,23748.98192915248,23817.316115311954,23809.13068857983,23839.17225956565,23779.08911759401,11306,10652.466666666667,62.05645321342412,57.77719055292531,NaN,NaN,NaN,NaN,18.24937902448781,15.837655328669634,-182185
2025-09-09T13:15:00-04:00,23839.25,23852.25,23839.25,23840.25,23789.3816560898,NaN,NaN,NaN,NaN,NaN,23803.965,23859.24257320824,23748.68742679176,23817.316115311954,23809.358561881985,23839.432784324297,23779.284339439673,6010,10135.233333333334,62.46211995112079,58.31341393728852,NaN,NaN,NaN,NaN,17.89228052273868,16.73246816126651,-176175
2025-09-09T13:20:00-04:00,23840.25,23850,23838.25,23849.75,23789.3816560898,NaN,NaN,NaN,NaN,NaN,23804.51,23861.031142949138,23747.98885705086,23817.316115311954,23809.572689302368,23839.68868855466,23779.456690050076,5393,9582.1,65.48254790965368,58.81317727489799,NaN,NaN,NaN,NaN,17.453546199685917,17.468906936436255,-170782
2025-09-09T13:25:00-04:00,23849.75,23854.25,23841.5,23842,23792.738884489823,NaN,NaN,NaN,NaN,NaN,23804.955,23862.29352892814,23747.616471071862,23819.51285103972,23809.816784775194,23839.9779147716,23779.655654778788,6240,9247.366666666667,61.15917089490314,59.081051374897115,NaN,NaN,NaN,NaN,17.117578613994066,18.38739762064619,-177022
2025-09-09T13:30:00-04:00,23842.25,23847.5,23832.75,23834.75,23792.738884489823,NaN,NaN,NaN,NaN,NaN,23805.295,23863.132417820627,23747.45758217937,23819.51285103972,23810.03655868903,23840.18455606129,23779.88856131677,7216,8767.4,57.344885233893166,59.19492604942268,NaN,NaN,NaN,NaN,16.948465855851634,18.395251339363263,-184238
2025-09-09T13:35:00-04:00,23833.75,23839.5,23827,23837.25,23792.738884489823,NaN,NaN,NaN,NaN,NaN,23805.335,23863.2579324199,23747.4120675801,23819.51285103972,23810.228705093043,23840.33629101022,23780.121119175867,7387,8445.733333333334,58.3104154701187,59.25693777539092,NaN,NaN,NaN,NaN,16.630718294719376,17.89162892547365,-176851
2025-09-09T13:40:00-04:00,23837.25,23838.25,23826,23833.25,23792.738884489823,NaN,NaN,NaN,NaN,NaN,23805.15,23862.654521561188,23747.645478438815,23819.51285103972,23810.368432755924,23840.432897643463,23780.303967868385,5958,8297.4,56.12150140984393,59.11968280416023,NaN,NaN,NaN,NaN,16.317809845096566,17.33507097943736,-182809
2025-09-09T13:45:00-04:00,23833,23844.25,23831.75,23839,23792.738884489823,NaN,NaN,NaN,NaN,NaN,23805.245,23862.956826349116,23747.53317365088,23819.51285103972,23810.56318784355,23840.612906945636,23780.51346874146,6660,8232.533333333333,58.53137754330609,59.19358705164307,NaN,NaN,NaN,NaN,16.045109141875383,17.250862480293527,-176149
2025-09-09T13:50:00-04:00,23839,23845.75,23836.5,23842.5,23792.738884489823,NaN,NaN,NaN,NaN,NaN,23805.255,23862.992465303178,23747.517534696824,23819.51285103972,23810.697607009883,23840.751298241597,23780.643915778168,4162,8130.9,59.97245331837983,59.59847995625319,NaN,NaN,NaN,NaN,15.559744203169998,17.279355689984644,-171987
2025-09-09T13:55:00-04:00,23843.25,23846,23837.5,23839.5,23792.738884489823,NaN,NaN,NaN,NaN,NaN,23805.465,23863.621255895254,23747.308744104746,23819.51285103972,23810.818462374442,23840.87290660346,23780.764018145423,3846,8030.633333333333,58.10845951286953,59.71631083079312,NaN,NaN,NaN,NaN,15.055476760086426,17.3245615175789,-175833
2025-09-09T14:00:00-04:00,23839,23845,23836,23841,23792.738884489823,NaN,NaN,NaN,NaN,NaN,23806.135,23865.13535677818,23747.134643221816,23819.51285103972,23810.929569665288,23840.983043428456,23780.87609590212,3603,7860.5,58.79800915697369,60.101344366989075,NaN,NaN,NaN,NaN,14.62294270579454,17.196585614393236,-172230
2025-09-09T14:05:00-04:00,23841.75,23848.75,23840.75,23846.75,23796.851551811105,NaN,NaN,NaN,NaN,NaN,23806.77,23866.812554907898,23746.727445092103,23822.481983886693,23811.056938227022,23841.12771927999,23780.986157174055,3588,7687.566666666667,61.419612950964016,60.39734282176811,NaN,NaN,NaN,NaN,14.149875369666358,17.38864025620061,-168642
2025-09-09T14:10:00-04:00,23846.75,23849,23822,23843,23796.851551811105,NaN,NaN,NaN,NaN,NaN,23807.72,23868.5175854766,23746.922414523404,23822.481983886693,23811.422184879066,23841.45052273453,23781.393847023603,13351,7822.1,58.792267537140994,60.19104191769155,NaN,NaN,NaN,NaN,15.06774141469019,16.586121292123998,-181993
2025-09-09T14:15:00-04:00,23842.5,23847,23834,23841.5,23796.851551811105,NaN,NaN,NaN,NaN,NaN,23807.915,23869.08105349302,23746.74894650698,23822.481983886693,23811.628339174487,23841.651687295493,23781.604991053482,6952,7726.466666666666,57.72850405914895,59.734841297267174,NaN,NaN,NaN,NaN,14.920045599355177,15.840925111195716,-188945
2025-09-09T14:20:00-04:00,23841.25,23846.75,23837.5,23840.5,23796.851551811105,NaN,NaN,NaN,NaN,NaN,23808.015,23869.37715527722,23746.65284472278,23822.481983886693,23811.753036607293,23841.7758415458,23781.730231668786,4146,7317.966666666666,56.98821161348182,59.372824040128435,NaN,NaN,NaN,NaN,14.51504234225838,15.148957228905168,-193091
2025-09-09T14:25:00-04:00,23840.75,23841.5,23831.5,23833.5,23796.851551811105,NaN,NaN,NaN,NaN,NaN,23808.34,23870.065421017694,23746.614578982306,23822.481983886693,23811.869202534363,23841.864278357425,23781.8741267113,4896,7013.766666666666,51.964734266487625,58.623010776940355,NaN,NaN,NaN,NaN,14.192539317811352,15.041836867577144,-197987
2025-09-09T14:30:00-04:00,23833.75,23838.5,23827,23828.5,23796.851551811105,NaN,NaN,NaN,NaN,NaN,23808.55,23870.47656941972,23746.62343058028,23822.481983886693,23811.955438034907,23841.91189827763,23781.998977792184,4454,6881.333333333333,48.66490160242249,57.42175032642384,NaN,NaN,NaN,NaN,14.000215080824827,15.31616658191844,-202441
2025-09-09T14:35:00-04:00,23828.5,23832.5,23824.5,23824.75,23796.851551811105,NaN,NaN,NaN,NaN,NaN,23808.83,23870.920211787638,23746.739788212366,23822.481983886693,23812.02768026065,23841.93170141381,23782.12365910749,4771,6799.533333333334,46.290672400009775,56.359714719645744,NaN,NaN,NaN,NaN,13.571628289337339,15.773637143364644,-207212
2025-09-09T14:40:00-04:00,23824.5,23834.75,23824,23829,23796.851551811105,NaN,NaN,NaN,NaN,NaN,23810.335,23870.634055547893,23750.035944452105,23822.481983886693,23812.101041502363,23841.962376807147,23782.23970619758,4321,6578.766666666666,49.30908935519612,55.78572929973881,NaN,NaN,NaN,NaN,13.37008341152753,15.913248408811171,-202891
2025-09-09T14:45:00-04:00,23829.5,23845.5,23829.5,23844.75,23796.851551811105,NaN,NaN,NaN,NaN,NaN,23812.37,23870.26164361508,23754.47835638492,23822.481983886693,23812.28103814828,23842.129043517172,23782.43303277939,6607,6366.633333333333,58.59559585185328,55.80609932700556,NaN,NaN,NaN,NaN,13.593648882132706,14.828602851803312,-196284
2025-09-09T14:50:00-04:00,23844.5,23848,23840.5,23846,23800.12756600147,NaN,NaN,NaN,NaN,NaN,23814.405,23869.669173748018,23759.14082625198,23822.481983886693,23812.401774202255,23842.26001817799,23782.54353022652,3801,6051.266666666666,59.23391144744585,56.028414329691415,NaN,NaN,NaN,NaN,13.158388247694656,13.968520312134764,-192483
2025-09-09T14:55:00-04:00,23846.25,23848.75,23840.5,23844,23801.383131183222,NaN,NaN,NaN,NaN,NaN,23816.07,23869.761716309473,23762.378283690527,23822.066822078563,23812.52510098619,23842.391696907896,23782.658505064483,3963,5945.366666666667,57.70113802586304,55.96911150701691,NaN,NaN,NaN,NaN,12.807789087145037,13.247298087226818,-196446
2025-09-09T15:00:00-04:00,23844.25,23848,23838.25,23846,23801.383131183222,NaN,NaN,NaN,NaN,NaN,23817.235,23870.946024005614,23763.523975994387,23822.066822078563,23812.657887014517,23842.531506319574,23782.78426770946,4347,5918.2,58.847928133627654,55.888788279534616,NaN,NaN,NaN,NaN,12.589375580920391,12.319606073646042,-192099
2025-09-09T15:05:00-04:00,23846,23847.25,23838.25,23840.5,23801.383131183222,NaN,NaN,NaN,NaN,NaN,23818.33,23871.659864053345,23765.00013594666,23822.066822078563,23812.7624002028,23842.63396029303,23782.890840112566,3693,5918.933333333333,54.47409084389235,55.629190517464814,NaN,NaN,NaN,NaN,12.332991610854648,11.458177775321035,-195792
2025-09-09T15:10:00-04:00,23840.25,23842.75,23835,23838.5,23801.383131183222,NaN,NaN,NaN,NaN,NaN,23819.66,23871.600616091862,23767.719383908137,23822.066822078563,23812.875351031093,23842.730909746522,23783.019792315663,4526,5888.333333333333,52.933407846000726,55.21029042382389,NaN,NaN,NaN,NaN,12.005635067222174,11.015384560874567,-200318
2025-09-09T15:15:00-04:00,23838.25,23850,23838.25,23848.75,23803.339640652295,NaN,NaN,NaN,NaN,NaN,23821.18,23871.976066779964,23770.383933220037,23824.71957032338,23813.052525372634,23842.924196059717,23783.18085468555,5657,5846.433333333333,59.2884633427418,55.05806545180802,NaN,NaN,NaN,NaN,11.987375419563447,10.731022152370716,-194661
2025-09-09T15:20:00-04:00,23848.25,23860,23847,23855,23812.79579334992,NaN,NaN,NaN,NaN,NaN,23822.755,23872.758248895952,23772.75175110405,23833.275656258702,23813.35147042649,23843.31734858558,23783.385592267397,7700,5924.766666666666,62.60413145666477,55.33034144605972,NaN,NaN,NaN,NaN,12.059705746737487,11.448665447552251,-186961
2025-09-09T15:25:00-04:00,23854.75,23861.25,23854.25,23856.5,23817.94143910674,NaN,NaN,NaN,NaN,NaN,23824.235,23873.763013283664,23774.706986716337,23836.37052500696,23813.573280017732,23843.625429475716,23783.521130559748,5346,5865.533333333334,63.375081347859606,55.73366839525334,NaN,NaN,NaN,NaN,11.698298193399095,12.225465468206274,-181615
2025-09-09T15:30:00-04:00,23856.5,23861,23848.5,23858.75,23817.94143910674,NaN,NaN,NaN,NaN,NaN,23825.83,23874.558373660384,23777.10162633962,23836.37052500696,23813.801830835917,23843.93386639362,23783.669795278212,5730,5799.633333333333,64.55547701170731,56.27418735226944,NaN,NaN,NaN,NaN,11.755562608156302,12.176638096447824,-175885
2025-09-09T15:35:00-04:00,23858.75,23861.25,23845.5,23848.75,23817.94143910674,NaN,NaN,NaN,NaN,NaN,23827.12,23874.780386067992,23779.459613932006,23836.37052500696,23814.031140328378,23844.21612966745,23783.846150989306,6465,5736.5,55.928024433403145,56.557279507049124,NaN,NaN,NaN,NaN,12.040879564716565,11.755337518570876,-182350
2025-09-09T15:40:00-04:00,23849,23849.25,23835.25,23845.75,23817.94143910674,NaN,NaN,NaN,NaN,NaN,23828.555,23874.00060374599,23783.10939625401,23836.37052500696,23814.253056138157,23844.43127148263,23784.074840793684,8159,5631.6,53.61315352260033,56.910726072776114,NaN,NaN,NaN,NaN,12.180816738665383,11.590280703221609,-190509
2025-09-09T15:45:00-04:00,23845.75,23854.75,23844.25,23851,23817.94143910674,NaN,NaN,NaN,NaN,NaN,23830.175,23872.845979599722,23787.504020400276,23836.37052500696,23814.44946701363,23844.660445710753,23784.238488316507,5969,5630.233333333334,56.969712471318445,57.67351464929816,NaN,NaN,NaN,NaN,12.060758400189284,10.82133592562548,-184540
2025-09-09T15:50:00-04:00,23850.75,23875,23850.5,23870.5,23821.47267434836,NaN,NaN,NaN,NaN,NaN,23832.365,23871.721093551183,23793.00890644882,23839.325493634282,23815.198242377624,23845.805633333868,23784.59085142138,16225,5991.3,66.62871623326069,58.91063085487419,NaN,NaN,NaN,NaN,12.949275657318621,11.70321345943237,-168315
2025-09-09T15:55:00-04:00,23870.5,23887.75,23865,23867.25,23833.87164369616,NaN,NaN,NaN,NaN,NaN,23834.525,23869.165041857446,23799.884958142557,23847.835394907426,23816.344087063542,23847.707259751507,23784.980914375577,22169,6522.266666666666,64.04824652946758,59.30010590327522,NaN,NaN,NaN,NaN,13.649327396081576,13.28458531555204,-190484
2025-09-09T16:00:00-04:00,23867.5,23871.5,23853,23858,23833.87164369616,NaN,NaN,NaN,NaN,NaN,23835.58,23869.799941551333,23801.36005844867,23847.835394907426,23816.734669993184,23848.23446480873,23785.234875177637,9962,6613.8,57.25197324744972,59.15853888898978,NaN,NaN,NaN,NaN,13.995804010647177,13.572901763463216,-200446
2025-09-09T16:05:00-04:00,23858,23865.5,23847.75,23862.25,23833.87164369616,NaN,NaN,NaN,NaN,NaN,23837.13,23868.935697600056,23805.324302399946,23847.835394907426,23817.00741872107,23848.583902254377,23785.430935187764,7459,6616.2,59.38446634410341,59.27877662600695,NaN,NaN,NaN,NaN,14.263960867029523,13.380035972774435,-192987
2025-09-09T16:10:00-04:00,23862,23880.5,23860.5,23877,23833.87164369616,NaN,NaN,NaN,NaN,NaN,23838.71,23870.43213107725,23806.987868922748,23847.835394907426,23817.266913022308,23848.997051331302,23785.536774713313,5350,6595.933333333333,65.76713850600751,59.7730059383198,NaN,NaN,NaN,NaN,14.673677947955985,14.121834342765476,-187637
2025-09-09T16:15:00-04:00,23877.25,23891,23870.75,23887,23835.824208398815,NaN,NaN,NaN,NaN,NaN,23840.325,23873.462931437294,23807.187068562707,23847.835394907426,23817.673260080395,23849.721371150525,23785.625149010266,7147,6612.166666666667,69.29063521675872,60.831330536381685,NaN,NaN,NaN,NaN,15.071986665959129,15.346052916285174,-180490
2025-09-09T16:20:00-04:00,23886.75,23895,23882.75,23891,23844.201517107962,NaN,NaN,NaN,NaN,NaN,23841.75,23877.268586686012,23806.231413313988,23852.962982203266,23817.97502984658,23850.29190638221,23785.658153310953,4866,6635.633333333333,70.59441765458662,62.09283123699497,NaN,NaN,NaN,NaN,14.870416189819192,16.673204409276174,-175624
2025-09-09T16:25:00-04:00,23891.25,23902.5,23886.75,23896.75,23849.834402693963,NaN,NaN,NaN,NaN,NaN,23843.35,23881.341183186676,23805.35881681332,23860.995385762613,23818.218105475487,23850.77334598014,23785.662864970836,3655,6629.266666666666,72.40789315712685,63.0299333665939,NaN,NaN,NaN,NaN,14.933243604832105,18.248239814929025,-171969
2025-09-09T16:30:00-04:00,23897.75,23906,23892.25,23900.75,23854.495338935147,NaN,NaN,NaN,NaN,NaN,23845.12,23885.33196837259,23804.90803162741,23865.92130861009,23818.426514560357,23851.19941436277,23785.653614757943,2984,6608.633333333333,73.62640048643102,63.81723829729149,NaN,NaN,NaN,NaN,14.848726204486955,19.86486414679924,-168985
2025-09-09T16:35:00-04:00,23900,23909.25,23899,23904,23860.12623261991,NaN,NaN,NaN,NaN,NaN,23846.84,23889.544538399412,23804.13546160059,23872.062046888073,23818.646082244173,23851.66227570319,23785.629888785155,2997,6588.933333333333,74.60759513256122,64.61956071048446,NaN,NaN,NaN,NaN,14.520245761309315,21.5096259314272,-165988
2025-09-09T16:40:00-04:00,23904,23918,23903.75,23908.75,23866.932994773553,NaN,NaN,NaN,NaN,NaN,23848.615,23894.00301713763,23803.226982862372,23881.124637510457,23818.885142733972,23852.187447039403,23785.58283842854,3062,6245.966666666666,76.01225177298926,65.43790176486173,NaN,NaN,NaN,NaN,14.500942492644365,23.40302845028557,-162926
2025-09-09T16:45:00-04:00,23908.25,23912,23899,23905,23866.932994773553,NaN,NaN,NaN,NaN,NaN,23850.34,23897.575130993002,23803.104869007,23881.124637510457,23819.100533654644,23852.63937658624,23785.561690723047,2928,6111.833333333333,72.59786636934287,66.628604760286,NaN,NaN,NaN,NaN,14.393732314598338,24.634080078679187,-165854
2025-09-09T16:50:00-04:00,23905.25,23906,23888,23890,23866.932994773553,NaN,NaN,NaN,NaN,NaN,23851.91,23899.095247693404,23804.724752306596,23881.124637510457,23819.238787750604,23852.902183163307,23785.5753923379,2154,6045.433333333333,60.82787231836243,67.14394181712616,NaN,NaN,NaN,NaN,14.6513228635556,24.666295641890176,-168008
2025-09-09T16:55:00-04:00,23890,23891.5,23885,23889,23866.932994773553,NaN,NaN,NaN,NaN,NaN,23853.34,23900.600952169665,23806.079047830335,23881.124637510457,23819.324102972605,23853.054357261277,23785.593848683933,1452,5930.633333333333,60.127994022317395,67.36953335648323,NaN,NaN,NaN,NaN,14.069085516158774,24.41514188507656,-169460
2025-09-09T18:00:00-04:00,23900.25,23907.5,23891.25,23892.5,23866.932994773553,NaN,NaN,NaN,NaN,NaN,23854.975,23901.884194198195,23808.0658058018,23881.124637510457,23897.08333333333,23897.083678600313,23897.082988066344,3074,5884.633333333333,61.785301410370984,67.02357515484825,NaN,NaN,NaN,NaN,14.385579407861718,25.043828150022453,-166386
2025-09-09T18:05:00-04:00,23892.5,23904.75,23890,23904.75,23866.932994773553,NaN,NaN,NaN,NaN,NaN,23856.645,23904.56713371712,23808.722866282882,23881.124637510457,23897.90198766278,23899.15940749569,23896.64456782987,1303,5769.033333333334,66.96147011475175,67.23166255379714,NaN,NaN,NaN,NaN,14.411609450157309,25.506650488511085,-165083
2025-09-09T18:10:00-04:00,23904.25,23911.75,23902.75,23907.5,23866.932994773553,NaN,NaN,NaN,NaN,NaN,23858.1,23907.664200796644,23808.535799203353,23881.124637510457,23900.162758381102,23904.335662236677,23895.989854525527,1380,5671,68.0090482687687,68.00002505531992,NaN,NaN,NaN,NaN,14.025065918003216,26.284680128004744,-163703
2025-09-09T18:15:00-04:00,23907.5,23910.5,23899,23900.5,23866.932994773553,NaN,NaN,NaN,NaN,NaN,23859.25,23910.013175630524,23808.486824369476,23881.124637510457,23900.613470421697,23904.633873923063,23896.59306692033,954,5482.566666666667,62.57047250459053,68.22759692392614,NaN,NaN,NaN,NaN,13.844704066717272,26.62270876876355,-164657
2025-09-09T18:20:00-04:00,23900.25,23901.75,23893.75,23895,23866.932994773553,NaN,NaN,NaN,NaN,NaN,23860.37,23911.763797292017,23808.97620270798,23881.124637510457,23900.230293697554,23904.20858973076,23896.25199766435,757,5381.1,58.604935465730364,67.71601099247776,NaN,NaN,NaN,NaN,13.427225204808895,26.41112388359162,-165414
2025-09-09T18:25:00-04:00,23895.5,23900.5,23891.5,23897.5,23866.932994773553,NaN,NaN,NaN,NaN,NaN,23861.515,23913.61091250631,23809.41908749369,23881.124637510457,23899.751381108,23903.6695494038,23895.8332128122,1100,5285.666666666667,59.85052360579937,67.04171730598067,NaN,NaN,NaN,NaN,13.11099483303683,25.991528163861016,-164314
2025-09-09T18:30:00-04:00,23896.75,23905.25,23896.25,23901.75,23866.932994773553,NaN,NaN,NaN,NaN,NaN,23862.555,23915.734816658198,23809.375183341803,23878.283024975543,23899.866554714434,23903.630156178213,23896.102953250655,811,5167.8,61.946809813122705,66.42403103159039,NaN,NaN,NaN,NaN,12.81735234496277,25.91016952410186,-163503
2025-09-09T18:35:00-04:00,23901.5,23903.25,23893.25,23899,23866.932994773553,NaN,NaN,NaN,NaN,NaN,23863.695,23917.503483532135,23809.886516467865,23878.283024975543,23899.751285430702,23903.372629715755,23896.12994114565,864,5073.5,59.77211769170759,65.5214756412033,NaN,NaN,NaN,NaN,12.616112891751145,25.516923621312326,-164367
2025-09-09T18:40:00-04:00,23898.5,23900,23895.25,23897,23866.932994773553,NaN,NaN,NaN,NaN,NaN,23864.94,23918.892438314768,23810.98756168523,23878.283024975543,23899.643042236912,23903.213349728554,23896.07273474527,498,4939.233333333334,58.17263495724299,64.4176352462613,NaN,NaN,NaN,NaN,12.054247685197492,25.15176671157919,-164865
2025-09-09T18:45:00-04:00,23897.25,23900,23894.5,23900,23866.932994773553,NaN,NaN,NaN,NaN,NaN,23866.195,23920.431177041402,23811.958822958597,23878.283024975543,23899.599423262258,23903.12546673391,23896.073379790607,327,4761.566666666667,59.90579421410949,63.36750660922904,NaN,NaN,NaN,NaN,11.586087136254815,24.724768294457846,-164538
2025-09-09T18:50:00-04:00,23900,23902.25,23894,23896,23866.932994773553,NaN,NaN,NaN,NaN,NaN,23867.45,23921.482397688796,23813.417602311205,23880.65797491148,23899.511598161636,23902.992505860995,23896.030690462278,464,4520.366666666667,56.54168467319771,61.976751816386795,NaN,NaN,NaN,NaN,11.3477951979509,24.512860608227303,-165002
2025-09-09T18:55:00-04:00,23896,23900.25,23895.25,23895.5,23866.932994773553,NaN,NaN,NaN,NaN,NaN,23868.58,23922.548364804767,23814.611635195237,23880.65797491148,23899.451853889783,23902.912342001324,23895.99136577824,281,4351.533333333334,56.117461864629206,60.7995800660501,NaN,NaN,NaN,NaN,10.894381255240122,24.316089185298942,-165283
2025-09-09T19:00:00-04:00,23896,23898.25,23887.5,23888.75,23866.932994773553,NaN,NaN,NaN,NaN,NaN,23869.505,23923.238554688516,23815.771445311486,23880.65797491148,23898.482995093666,23902.64009449406,23894.32589569327,1639,4215.166666666667,50.59822532427803,60.06889099504407,NaN,NaN,NaN,NaN,10.884068308437255,23.148361690300597,-166922
2025-09-09T19:05:00-04:00,23889.25,23894,23883.75,23894,23866.932994773553,NaN,NaN,NaN,NaN,NaN,23870.595,23924.06011853459,23817.12988146541,23880.65797491148,23897.97525389538,23902.4388748658,23893.51163292496,924,4030.4666666666667,54.35819235942861,59.656762304837734,NaN,NaN,NaN,NaN,10.838777714977452,21.63426058768907,-165998
2025-09-09T19:10:00-04:00,23893.75,23894.25,23891,23892.25,23866.932994773553,NaN,NaN,NaN,NaN,NaN,23871.62,23924.740263554977,23818.49973644502,23880.65797491148,23897.835700244035,23902.325767798015,23893.345632690056,376,3771.0333333333333,52.91254111484961,59.02299371230049,NaN,NaN,NaN,NaN,10.296722163907633,20.256219377053334,-166374
2025-09-09T19:15:00-04:00,23892,23894,23886.25,23889,23866.932994773553,NaN,NaN,NaN,NaN,NaN,23872.465,23925.319423654142,23819.610576345858,23880.65797491148,23897.499496491684,23902.182212938227,23892.81678004514,640,3593.4,50.240270167522354,57.82862228749838,NaN,NaN,NaN,NaN,10.114813437914231,19.19322237898929,-167014
2025-09-09T19:20:00-04:00,23889,23890,23877,23882.75,23866.932994773553,NaN,NaN,NaN,NaN,NaN,23873.26,23925.510067943545,23821.00993205645,23880.65797491148,23896.243379739335,23902.269660561124,23890.217098917547,1488,3102.1666666666665,45.48305456730225,56.21962273739364,NaN,NaN,NaN,NaN,10.32089819234893,19.12893642895514,-168502
2025-09-09T19:25:00-04:00,23882.5,23882.75,23874.5,23877.25,23866.932994773553,NaN,NaN,NaN,NaN,NaN,23873.975,23925.43957519461,23822.510424805387,23880.65797491148,23895.248619119593,23902.411722023764,23888.085516215422,983,2395.9666666666667,41.73766993623137,54.73156541108227,NaN,NaN,NaN,NaN,10.172976892895434,19.29229503315406,-169485
2025-09-09T19:30:00-04:00,23877.25,23880,23874,23876.25,23866.932994773553,NaN,NaN,NaN,NaN,NaN,23874.69,23925.260006922552,23824.119993077446,23880.65797491148,23894.345358537452,23902.388855436162,23886.30186163874,917,2094.4666666666667,41.07537665545811,53.4794540674914,NaN,NaN,NaN,NaN,9.874907114831474,19.489813921207162,-170402
2025-09-09T19:35:00-04:00,23876.25,23881,23875,23880.5,23866.932994773553,NaN,NaN,NaN,NaN,NaN,23875.63,23924.831243883396,23826.428756116606,23880.65797491148,23893.82025757108,23902.20938088803,23885.431134254126,658,1867.7666666666667,45.06511129257334,52.42335318797525,NaN,NaN,NaN,NaN,9.598128035200656,19.52255934699606,-169744
2025-09-09T19:40:00-04:00,23880.25,23886.75,23879.25,23885,23866.932994773553,NaN,NaN,NaN,NaN,NaN,23876.76,23924.141215691765,23829.378784308232,23880.476379929183,23893.201231884053,23901.685858573062,23884.716605195044,1262,1731.5,49.002466825531016,51.49875726029013,NaN,NaN,NaN,NaN,9.448261746972037,18.724752629281088,-168482
2025-09-09T19:45:00-04:00,23885.25,23889,23880.25,23883.5,23866.932994773553,NaN,NaN,NaN,NaN,NaN,23877.935,23922.953752757727,23832.916247242276,23877.05610394335,23892.70341940782,23901.200096879405,23884.206741936232,1219,1533.9,47.77331593960531,50.64169999228283,NaN,NaN,NaN,NaN,9.398385907902606,17.680997341255438,-169701
2025-09-09T19:50:00-04:00,23884,23891.25,23881.5,23888.75,23866.932994773553,NaN,NaN,NaN,NaN,NaN,23879.13,23922.01079289931,23836.249207100693,23874.960906523742,23892.509865862427,23900.918432050155,23884.101299674698,794,1398.1666666666667,52.28458460446501,50.2211249670844,NaN,NaN,NaN,NaN,9.423501200195277,16.425131087995883,-168907
2025-09-09T19:55:00-04:00,23888.75,23889,23879.25,23885.75,23866.932994773553,NaN,NaN,NaN,NaN,NaN,23879.95,23921.723436535445,23838.176563464556,23874.960906523742,23892.191804305887,23900.57215137388,23883.811457237895,960,1308.3333333333333,49.64561857286163,49.488255278423836,NaN,NaN,NaN,NaN,9.44682254303847,15.543285770269275,-169867
2025-09-09T20:00:00-04:00,23885.5,23887.5,23881,23883.5,23866.932994773553,NaN,NaN,NaN,NaN,NaN,23880.7,23921.339512794468,23840.060487205534,23874.693725218993,23891.848020369616,23900.21347922358,23883.48256151565,1037,1243.4333333333334,47.70100370334509,48.856778066291504,NaN,NaN,NaN,NaN,9.236335218535723,14.72442940380885,-170904
2025-09-09T20:05:00-04:00,23883.5,23892.25,23883.5,23888.75,23866.932994773553,NaN,NaN,NaN,NaN,NaN,23881.595,23920.91164914067,23842.27835085933,23871.5851515382,23891.710208016822,23899.947288445008,23883.473127588637,961,1175.5666666666666,52.38737083617112,48.59034299283021,NaN,NaN,NaN,NaN,9.201596988640315,14.070615534245595,-169943
2025-09-09T20:10:00-04:00,23889,23896.5,23887.25,23893.75,23866.932994773553,NaN,NaN,NaN,NaN,NaN,23882.55,23920.66312110197,23844.43687889803,23875.34312123056,23891.748443118206,23899.785452922966,23883.711433313445,1306,1117.0333333333333,56.394890990826,49.00439054044079,NaN,NaN,NaN,NaN,9.20505434659458,14.016687999058504,-168637
2025-09-09T20:15:00-04:00,23893.25,23896.5,23889.75,23894.25,23866.932994773553,NaN,NaN,NaN,NaN,NaN,23883.625,23919.922141761803,23847.327858238197,23876.19949698445,23891.798521839326,23899.725182064154,23883.871861614498,794,1045.9,56.78659384334741,49.17784778929212,NaN,NaN,NaN,NaN,9.029693321837824,13.96661243067049,-167843
2025-09-09T20:20:00-04:00,23894.25,23897.5,23893.5,23895.25,23866.932994773553,NaN,NaN,NaN,NaN,NaN,23884.76,23918.822290002016,23850.69770999798,23879.25959758756,23891.87316617294,23899.734475653764,23884.011856692116,585,993.6,57.606813361913936,49.51315294979672,NaN,NaN,NaN,NaN,8.670429513135122,14.05565573008789,-167258
2025-09-09T20:25:00-04:00,23895.25,23899,23895.25,23896.5,23868.648526262434,NaN,NaN,NaN,NaN,NaN,23885.715,23918.33217492018,23853.09782507982,23882.532678070045,23891.975113161254,23899.788867889903,23884.161358432604,585,964.7,58.66301086735232,50.11477728549886,NaN,NaN,NaN,NaN,8.318970262196899,14.345183820201173,-166673
2025-09-09T20:30:00-04:00,23895.75,23898.75,23895.5,23895.75,23869.49972961414,NaN,NaN,NaN,NaN,NaN,23886.53,23918.054695086536,23855.005304913462,23883.951142456037,23892.05040004986,23899.823593842473,23884.277206257244,472,877.9666666666667,57.733587572135114,50.98981535727263,NaN,NaN,NaN,NaN,7.9569009577542635,14.614031332449223,-167145
2025-09-09T20:35:00-04:00,23896,23898.75,23894,23897.5,23869.49972961414,NaN,NaN,NaN,NaN,NaN,23887.35,23917.822938820886,23856.87706117911,23884.535913964828,23892.134509221225,23899.862986369455,23884.406032072995,536,852.4,59.35185898190566,52.24797171767795,NaN,NaN,NaN,NaN,7.727836603628959,14.542236381028358,-166609
2025-09-09T20:40:00-04:00,23897.75,23898.5,23889,23895.25,23869.49972961414,NaN,NaN,NaN,NaN,NaN,23888.08,23917.50829250496,23858.651707495043,23884.535913964828,23892.208930661593,23899.810247809477,23884.60761351371,1092,842.8,56.36382465154999,53.340003717398794,NaN,NaN,NaN,NaN,7.854419703369748,13.507815981117496,-167701
2025-09-09T20:45:00-04:00,23895.5,23896,23886,23887.75,23869.49972961414,NaN,NaN,NaN,NaN,NaN,23888.86,23916.060213228822,23861.65978677118,23884.535913964828,23892.134205441453,23899.62167263021,23884.646738252697,1046,845.8666666666667,47.73668308308903,53.5308302738642,NaN,NaN,NaN,NaN,8.007675438843338,13.062229610112079,-168747
2025-09-09T20:50:00-04:00,23887.25,23892.25,23884,23885,23869.49972961414,NaN,NaN,NaN,NaN,NaN,23889.645,23913.932875573773,23865.357124426228,23884.535913964828,23892.00281285413,23899.435857716482,23884.56976799178,857,849.2,45.015931889087945,53.24607777840398,NaN,NaN,NaN,NaN,8.024984336068814,12.974616098269129,-169604
2025-09-09T20:55:00-04:00,23885.25,23886,23881.25,23886,23869.49972961414,NaN,NaN,NaN,NaN,NaN,23890.345,23912.013615556756,23868.676384443246,23884.535913964828,23891.82911179657,23899.26366859201,23884.39455500113,772,838.2666666666667,46.216367064880885,53.1348671444951,NaN,NaN,NaN,NaN,7.7910568834924705,13.321222431729677,-168832
2025-09-09T21:00:00-04:00,23886.25,23891.75,23879,23880.75,23869.49972961414,NaN,NaN,NaN,NaN,NaN,23890.55,23911.650236960522,23869.449763039476,23884.535913964828,23891.51843458099,23898.969111982824,23884.067757179157,1363,856.6666666666666,41.13836515855189,52.338708612644155,NaN,NaN,NaN,NaN,8.145267106100151,12.526108776904113,-170195
2025-09-09T21:05:00-04:00,23881.25,23884.75,23878.75,23881.5,23869.49972961414,NaN,NaN,NaN,NaN,NaN,23890.835,23911.034408417243,23870.635591582755,23884.535913964828,23891.348419479848,23898.845128048753,23883.85171091094,616,848.4,42.116809576152555,51.80093654145065,NaN,NaN,NaN,NaN,7.992033741378712,11.830935366899999,-169579
2025-09-09T21:10:00-04:00,23881.25,23882,23877.5,23881.5,23869.49972961414,NaN,NaN,NaN,NaN,NaN,23891.305,23909.411708702253,23873.198291297747,23884.535913964828,23891.1532100498,23898.723995565357,23883.582424534245,644,853.2666666666667,42.116809576152555,51.40206553236546,NaN,NaN,NaN,NaN,7.742602759851662,11.40887829805993,-169579
2025-09-09T21:15:00-04:00,23881,23885,23879,23883.5,23869.49972961414,NaN,NaN,NaN,NaN,NaN,23891.73,23907.99248443509,23875.46751556491,23884.535913964828,23891.010121786192,23898.598712523617,23883.421531048767,611,862.7333333333333,44.94704506930436,50.870613691874986,NaN,NaN,NaN,NaN,7.618131134147972,10.751965217396577,-168968
2025-09-09T21:20:00-04:00,23883.25,23887.5,23879,23887.25,23869.49972961414,NaN,NaN,NaN,NaN,NaN,23891.935,23907.700408320685,23876.169591679318,23884.535913964828,23890.901372851586,23898.471006509746,23883.331739193425,636,868.4666666666667,49.89408136370505,50.406270147080626,NaN,NaN,NaN,NaN,7.681121767423116,10.592320091338234,-168332
2025-09-09T21:25:00-04:00,23887.5,23899,23886.5,23897.25,23869.49972961414,NaN,NaN,NaN,NaN,NaN,23892.14,23907.909958777556,23876.370041222443,23882.378731171862,23891.007400489496,23898.479273634635,23883.535527344357,1229,900.0666666666667,60.172022592218156,50.64808648628567,NaN,NaN,NaN,NaN,8.025327355464322,12.025939455357571,-167103
2025-09-09T21:30:00-04:00,23897.25,23904.75,23895.75,23903,23874.005219121736,NaN,NaN,NaN,NaN,NaN,23892.38,23908.435914794347,23876.324085205655,23883.82596154033,23891.495742898012,23899.102844194575,23883.88864160145,1960,910.7666666666667,64.66078416311433,51.151941543514276,NaN,NaN,NaN,NaN,8.094946830074013,13.928286949082786,-165143
2025-09-09T21:35:00-04:00,23903.5,23904.75,23897.5,23898.75,23875.084527343475,NaN,NaN,NaN,NaN,NaN,23892.42,23908.529140270457,23876.31085972954,23884.385769232264,23891.700475540216,23899.335581402476,23884.065369677955,967,912.2,59.337571436375775,51.20012444130167,NaN,NaN,NaN,NaN,8.034593485068728,15.694752478970484,-166110
2025-09-09T21:40:00-04:00,23899.25,23899.75,23892.75,23896.25,23875.084527343475,NaN,NaN,NaN,NaN,NaN,23892.33,23908.301674910676,23876.358325089328,23884.385769232264,23891.80785244789,23899.38386479429,23884.231840101493,1009,933.3,56.39640219323089,51.104611199951364,NaN,NaN,NaN,NaN,7.9606939504209615,16.349669380216387,-167119
2025-09-09T21:45:00-04:00,23896.5,23902.5,23895.5,23899.25,23875.084527343475,NaN,NaN,NaN,NaN,NaN,23892.235,23907.9828284247,23876.4871715753,23884.385769232264,23891.955409524242,23899.52400694836,23884.386812100125,885,941.4666666666667,59.021311101467965,51.08100063706296,NaN,NaN,NaN,NaN,7.892072953962321,17.271272362526997,-166234
2025-09-09T21:50:00-04:00,23899,23901,23896.5,23900.25,23875.084527343475,NaN,NaN,NaN,NaN,NaN,23892.065,23907.270199771458,23876.85980022854,23884.385769232264,23892.052886245954,23899.6172595426,23884.48851294931,591,911.5666666666667,59.88812976178614,51.33273671636554,NaN,NaN,NaN,NaN,7.649782028679298,18.127046560386848,-165643
2025-09-09T21:55:00-04:00,23900,23906.75,23899,23902.5,23877.91350418895,NaN,NaN,NaN,NaN,NaN,23892.015,23907.06538537961,23876.96461462039,23888.701811077535,23892.26506471344,23899.901127884943,23884.629001541936,895,908.6333333333333,61.84382948892606,52.34039003106818,NaN,NaN,NaN,NaN,7.656940455202205,19.548640281430824,-164748
2025-09-09T22:00:00-04:00,23903.25,23906.5,23900.75,23902.75,23879.014026725814,NaN,NaN,NaN,NaN,NaN,23892.27,23907.604549221607,23876.935450778394,23889.186448862027,23892.44792756466,23900.150955896683,23884.744899232635,758,903.3333333333334,62.065143993272365,53.55819089565278,NaN,NaN,NaN,NaN,7.5207304226877625,20.868691593828803,-163990
2025-09-09T22:05:00-04:00,23902.5,23903,23897.25,23899.25,23879.014026725814,NaN,NaN,NaN,NaN,NaN,23892.475,23907.902977849186,23877.04702215081,23889.186448862027,23892.57014168738,23900.267050424223,23884.87323295054,772,907.1333333333333,57.07404198707115,54.333739104380655,NaN,NaN,NaN,NaN,7.394249678210065,21.30049853199915,-164762
2025-09-09T22:10:00-04:00,23899.25,23905.25,23899,23903.5,23879.014026725814,NaN,NaN,NaN,NaN,NaN,23892.695,23908.428813915078,23876.96118608492,23889.186448862027,23892.687444832816,23900.41461807681,23884.96027158882,553,883.5,61.15863450168995,55.76375834317623,NaN,NaN,NaN,NaN,7.312517558337918,21.97713648506951,-164209
2025-09-09T22:15:00-04:00,23902.5,23905.75,23897.5,23905.25,23879.014026725814,NaN,NaN,NaN,NaN,NaN,23892.705,23908.4700531253,23876.939946874703,23889.186448862027,23892.852991025527,23900.623908860423,23885.08207319063,783,868.9666666666667,62.73119725148603,57.236214605700056,NaN,NaN,NaN,NaN,7.37948058988521,22.264239024991188,-163426
2025-09-09T22:20:00-04:00,23904.75,23906.25,23901.75,23905,23880.42178452916,NaN,NaN,NaN,NaN,NaN,23892.655,23908.246949863536,23877.06305013646,23890.136369453885,23892.973014400104,23900.790900238953,23885.155128561255,507,859.4,62.34287972095,58.68093390175701,NaN,NaN,NaN,NaN,7.17380340489341,22.599249400910846,-163933
2025-09-09T22:25:00-04:00,23904.75,23906.75,23901.25,23905,23880.743521596018,NaN,NaN,NaN,NaN,NaN,23892.745,23908.56729125658,23876.92270874342,23891.109095563108,23893.103616733588,23900.970211686887,23885.23702178029,564,846.2,62.34287972095,59.92349351973171,NaN,NaN,NaN,NaN,7.054246018829595,22.91033046426481,-163933
2025-09-09T22:30:00-04:00,23905.5,23916.5,23903.5,23913.25,23886.027906978015,NaN,NaN,NaN,NaN,NaN,23893.11,23909.933840220074,23876.286159779927,23897.487276450487,23893.627031796284,23901.946809218538,23885.30725437403,1471,860.6666666666666,69.5555336305835,61.32788296736588,NaN,NaN,NaN,NaN,7.478942731770338,24.3805960997274,-162462
2025-09-09T22:35:00-04:00,23914,23915.25,23905,23907,23886.027906978015,NaN,NaN,NaN,NaN,NaN,23893.3,23910.527594143172,23876.072405856827,23897.487276450487,23893.947833698305,23902.470599148724,23885.425068247885,1071,864.3333333333334,60.15541250998474,61.32669653292063,NaN,NaN,NaN,NaN,7.676875393786743,25.74584276122837,-163533
2025-09-09T22:40:00-04:00,23907,23909.75,23905.25,23907.25,23886.027906978015,NaN,NaN,NaN,NaN,NaN,23893.41,23910.919928611598,23875.9000713884,23897.487276450487,23894.108253706854,23902.705190371886,23885.511317041823,622,841.5333333333333,60.38603135397873,61.02135704655381,NaN,NaN,NaN,NaN,7.449955722801975,27.013571804050702,-162911
2025-09-09T22:45:00-04:00,23907.5,23910.5,23906.25,23910,23886.027906978015,NaN,NaN,NaN,NaN,NaN,23893.63,23911.68332102406,23875.576678975944,23897.487276450487,23894.226678253926,23902.890160811097,23885.563195696755,421,829.1,62.927883065502584,61.277807877205724,NaN,NaN,NaN,NaN,7.221387456887548,28.276682365280543,-162490
2025-09-09T22:50:00-04:00,23909.75,23911.75,23907.25,23908,23886.65657924233,NaN,NaN,NaN,NaN,NaN,23893.85,23912.325389052177,23875.37461094782,23897.487276450487,23894.35299352141,23903.085938336415,23885.620048706405,454,824.7333333333333,59.91673585337529,61.52926028150175,NaN,NaN,NaN,NaN,7.0270026385384385,29.594970206460303,-162944
2025-09-09T22:55:00-04:00,23908.25,23913.5,23906.75,23910.75,23887.399462004043,NaN,NaN,NaN,NaN,NaN,23894.065,23913.064423683358,23875.06557631664,23897.487276450487,23894.505613069698,23903.334632581016,23885.67659355838,512,822.3,62.56894812085022,61.78266292574334,NaN,NaN,NaN,NaN,7.0072167357856925,31.019141643879877,-162432
2025-09-09T23:00:00-04:00,23911.5,23916.75,23910.75,23915.25,23891.239259185677,NaN,NaN,NaN,NaN,NaN,23894.45,23914.34949747534,23874.55050252466,23900.936968597838,23894.721623649366,23903.739223295943,23885.70402400279,593,826.3333333333334,66.47774358634625,62.253349627497634,NaN,NaN,NaN,NaN,6.935272683229571,32.68457747624769,-161839
2025-09-09T23:05:00-04:00,23915,23915.75,23912.25,23912.25,23892.035201949966,NaN,NaN,NaN,NaN,NaN,23894.785,23915.2984126817,23874.2715873183,23901.34957487827,23894.842247884397,23903.954489862,23885.730005906793,352,820.2,61.841320169812356,62.253170390418084,NaN,NaN,NaN,NaN,6.689896062998888,34.23105360630352,-162191
2025-09-09T23:10:00-04:00,23912.75,23915.75,23912.25,23914.5,23892.55632913406,NaN,NaN,NaN,NaN,NaN,23895.3,23916.464120594843,23874.135879405156,23902.479659902616,23894.96473477466,23904.176609639475,23885.752859909848,348,795.4,63.876232954247776,62.38253388763061,NaN,NaN,NaN,NaN,6.462046344213253,35.66706715564108,-161843
2025-09-09T23:15:00-04:00,23914.75,23916,23911.25,23912.75,23892.55632913406,NaN,NaN,NaN,NaN,NaN,23895.675,23917.390950369663,23873.959049630335,23903.008727922093,23895.11636861753,23904.4394815032,23885.793255731864,457,775.7666666666667,61.14503083061464,62.673318805026575,NaN,NaN,NaN,NaN,6.339757319626592,36.61162689792521,-162300
2025-09-09T23:20:00-04:00,23912.25,23915.5,23911.5,23914,23892.79770898372,NaN,NaN,NaN,NaN,NaN,23896.11,23918.397924987883,23873.822075012118,23903.106982337675,23895.238204189543,23904.650685049673,23885.825723329413,366,759.4,62.38229790519802,62.76072333384859,NaN,NaN,NaN,NaN,6.172631796796121,37.48871808718906,-161934
2025-09-09T23:25:00-04:00,23914,23915.25,23912.5,23913,23893.738722211732,NaN,NaN,NaN,NaN,NaN,23896.59,23919.27496417752,23873.90503582248,23903.96058587014,23895.322746975322,23904.795355447888,23885.850138502756,258,742.2666666666667,60.716589689417454,62.61682279370083,NaN,NaN,NaN,NaN,5.928158097024969,38.3031599057912,-162192
2025-09-09T23:30:00-04:00,23913.5,23916,23913.25,23913.75,23894.99491665665,NaN,NaN,NaN,NaN,NaN,23897.21,23920.04207393802,23874.377926061978,23905.46846869611,23895.466981020585,23905.046683221375,23885.887278819795,428,711.1,61.545916996716784,62.559896884827026,NaN,NaN,NaN,NaN,5.719003947237472,39.176201449393076,-161764
2025-09-09T23:35:00-04:00,23913.75,23915.5,23911.75,23915.5,23894.99491665665,NaN,NaN,NaN,NaN,NaN,23897.975,23920.643314900728,23875.30668509927,23905.46846869611,23895.561727632954,23905.20944387184,23885.914011394067,286,700.1,63.48310636837649,62.64134164535749,NaN,NaN,NaN,NaN,5.578360808149081,39.293874224420996,-161478
2025-09-09T23:40:00-04:00,23915,23919.75,23914,23914.5,23897.716700920628,NaN,NaN,NaN,NaN,NaN,23898.74,23921.00206637672,23876.477933623282,23908.63481996551,23895.85182979488,23905.732712098754,23885.970947491005,813,705.7333333333333,61.57424090932033,62.071249308124415,NaN,NaN,NaN,NaN,5.590620750424146,40.09782085256237,-162291
2025-09-09T23:45:00-04:00,23915,23915.75,23913,23914.25,23897.716700920628,NaN,NaN,NaN,NaN,NaN,23899.415,23921.469616292205,23877.360383707797,23908.63481996551,23895.967750342697,23905.92507993377,23886.010420751623,363,697.4666666666667,61.07977170695599,62.137274965050935,NaN,NaN,NaN,NaN,5.387719268250993,40.41442019419599,-162654
2025-09-09T23:50:00-04:00,23914.75,23918,23914.25,23916.5,23897.799463028918,NaN,NaN,NaN,NaN,NaN,23900.045,23922.21585700356,23877.874142996436,23908.63481996551,23896.054639872913,23906.078532545456,23886.03074720037,249,684.5666666666667,63.89031976609005,62.38758128020174,NaN,NaN,NaN,NaN,5.2707393205187785,41.05833348832781,-162405
2025-09-09T23:55:00-04:00,23916.5,23918,23913,23917.5,23897.799463028918,NaN,NaN,NaN,NaN,NaN,23900.725,23922.9099611361,23878.540038863895,23908.63481996551,23896.176391287743,23906.290935578956,23886.06184699653,354,655.4,65.09670021331729,62.54249679075992,NaN,NaN,NaN,NaN,5.251400797624579,41.12057014978367,-162051
2025-09-10T00:00:00-04:00,23917.5,23921.25,23917,23920.75,23901.19718635486,NaN,NaN,NaN,NaN,NaN,23901.365,23923.97345194569,23878.756548054313,23910.668222257875,23896.43580528778,23906.789578826567,23886.082031748992,653,611.8333333333334,68.75070351858211,63.17349448113184,NaN,NaN,NaN,NaN,5.179872169222824,41.689430105620595,-161398
2025-09-10T00:05:00-04:00,23920.25,23922.75,23918.25,23918.5,23902.773450611458,NaN,NaN,NaN,NaN,NaN,23902.02,23924.678517163724,23879.361482836277,23912.0345778063,23896.713029963732,23907.312085711677,23886.113974215787,709,603.2333333333333,63.77306261263513,63.25950265911647,NaN,NaN,NaN,NaN,5.131309871421194,42.42752815809873,-162107
2025-09-10T00:10:00-04:00,23918.75,23920,23917.5,23919.5,23902.773450611458,NaN,NaN,NaN,NaN,NaN,23902.74,23925.286387728625,23880.193612271378,23912.0345778063,23896.836000731244,23907.533928506462,23886.138072956026,332,580.6666666666666,64.98641017298965,63.15297884387671,NaN,NaN,NaN,NaN,4.94335916631968,42.78565678959381,-161775
2025-09-10T00:15:00-04:00,23919.5,23921.25,23919.5,23920,23903.659280412507,NaN,NaN,NaN,NaN,NaN,23903.365,23926.057556043783,23880.67244395622,23912.51712979603,23896.907381327143,23907.666701305396,23886.14806134889,184,557.3,65.60668243194094,63.42193329117161,NaN,NaN,NaN,NaN,4.715262083011131,43.310854306986876,-161591
2025-09-10T00:20:00-04:00,23920.5,23921.75,23916.25,23917.75,23903.659280412507,NaN,NaN,NaN,NaN,NaN,23903.845,23926.718322878784,23880.97167712122,23912.51712979603,23897.027739789974,23907.87737462281,23886.178104957136,337,548.8333333333334,60.41962627147026,63.175032813830356,NaN,NaN,NaN,NaN,4.771314791367479,42.45122874323739,-161928
2025-09-10T00:25:00-04:00,23917.75,23919.5,23917.75,23919.25,23903.659280412507,NaN,NaN,NaN,NaN,NaN,23904.345,23927.44930478077,23881.240695219232,23912.51712979603,23897.11255860646,23908.025808510192,23886.199308702726,237,526.9,62.54565210543928,63.275077190603554,NaN,NaN,NaN,NaN,4.555506591984088,41.65300500546999,-161691
2025-09-10T00:30:00-04:00,23918.75,23924.5,23918.5,23919,23905.232317890706,NaN,NaN,NaN,NaN,NaN,23904.82,23928.13245161568,23881.50754838432,23914.568770455568,23897.382359860465,23908.518648969053,23886.246070751877,706,525.1666666666666,61.9484075127731,63.24408501971606,NaN,NaN,NaN,NaN,4.658684692556653,41.81067527844396,-162397
2025-09-10T00:35:00-04:00,23919,23921,23916.5,23921,23905.232317890706,NaN,NaN,NaN,NaN,NaN,23905.31,23928.930237072185,23881.689762927817,23914.568770455568,23897.51079522542,23908.741154536197,23886.28043591464,360,511.43333333333334,64.84087096471575,63.53867653938022,NaN,NaN,NaN,NaN,4.64735007165975,41.20579651915927,-162037
2025-09-10T00:40:00-04:00,23920.75,23921,23918,23920,23905.232317890706,NaN,NaN,NaN,NaN,NaN,23905.795,23929.605226802505,23881.98477319749,23914.568770455568,23897.60899535899,23908.91067833422,23886.30731238376,276,502.2,62.29124348497274,63.591914145684214,NaN,NaN,NaN,NaN,4.529682209398339,40.64412338553778,-162313
2025-09-10T00:45:00-04:00,23920.25,23921,23917,23920.25,23905.232317890706,NaN,NaN,NaN,NaN,NaN,23906.25,23930.2772761657,23882.2227238343,23914.568770455568,23897.758896579584,23909.164885766273,23886.352907392895,431,490.46666666666664,62.6862655004998,63.53499694083588,NaN,NaN,NaN,NaN,4.4918477658698865,39.73518806741198,-161882
2025-09-10T00:50:00-04:00,23920.5,23921.25,23918.75,23919.5,23905.232317890706,NaN,NaN,NaN,NaN,NaN,23906.735,23930.833425256955,23882.636574743046,23914.568770455568,23897.862963433276,23909.342059848605,23886.383867017947,297,483.46666666666664,60.63414762184836,63.46784742030217,NaN,NaN,NaN,NaN,4.349572925450609,38.94694487866377,-162179
2025-09-10T00:55:00-04:00,23920.5,23923,23920,23922,23906.443413835088,NaN,NaN,NaN,NaN,NaN,23907.42,23931.26668530636,23883.573314693636,23914.568770455568,23897.947300296826,23909.493001218885,23886.401599374767,224,472.1333333333333,64.7737595544025,63.73170369511978,NaN,NaN,NaN,NaN,4.28888914506128,38.59946472539805,-161955
2025-09-10T01:00:00-04:00,23921.5,23923,23917.5,23918.25,23906.443413835088,NaN,NaN,NaN,NaN,NaN,23908.085,23931.238101306746,23884.931898693252,23914.568770455568,23898.081299023837,23909.71568197148,23886.446916076195,394,436.23333333333335,55.36835401496008,63.122991855753355,NaN,NaN,NaN,NaN,4.375397063271188,37.280252170557155,-162349
2025-09-10T01:05:00-04:00,23918,23919,23915.25,23916,23906.443413835088,NaN,NaN,NaN,NaN,NaN,23908.685,23931.059496635444,23886.31050336456,23914.568770455568,23898.56718771529,23910.42765632701,23886.706719103568,1700,457.2,50.61906625144568,62.08887514419109,NaN,NaN,NaN,NaN,4.330725844466103,35.26916423122963,-164049
2025-09-10T01:10:00-04:00,23916.25,23918.75,23911.5,23917.75,23906.443413835088,NaN,NaN,NaN,NaN,NaN,23909.425,23930.46240716507,23888.38759283493,23914.568770455568,23899.310482807134,23911.438057813215,23887.182907801052,2909,533.4333333333333,53.92910967136142,61.03018986938962,NaN,NaN,NaN,NaN,4.539245427004238,33.198854988096144,-161140
2025-09-10T01:15:00-04:00,23918,23920,23912.75,23916.5,23906.443413835088,NaN,NaN,NaN,NaN,NaN,23910.125,23929.675767250323,23890.574232749677,23914.568770455568,23899.67224055475,23911.9207150431,23887.423766066404,1474,568.5333333333333,51.28475719026928,60.138168053506355,NaN,NaN,NaN,NaN,4.732870753646793,30.91015139931149,-162614
2025-09-10T01:20:00-04:00,23916.75,23921.25,23916.5,23919.25,23906.443413835088,NaN,NaN,NaN,NaN,NaN,23910.88,23928.798214192946,23892.961785807056,23914.02613470288,23899.948312355624,23912.323361768376,23887.57326294287,1010,587.0666666666667,56.35509620816513,59.521645627447455,NaN,NaN,NaN,NaN,4.734094271243451,28.976515800208492,-161604
2025-09-10T01:25:00-04:00,23919.5,23922.25,23917.25,23920,23906.443413835088,NaN,NaN,NaN,NaN,NaN,23911.61,23927.9075949122,23895.3124050878,23914.02613470288,23900.07433847191,23912.510633098558,23887.63804384526,451,585.0333333333333,57.64971445204182,58.95329077174038,NaN,NaN,NaN,NaN,4.7530875375832045,27.461343740876377,-161153
2025-09-10T01:30:00-04:00,23920,23930,23913.5,23915.5,23906.443413835088,NaN,NaN,NaN,NaN,NaN,23912.175,23926.942278023686,23897.407721976313,23914.02613470288,23900.741856813846,23913.47074938178,23888.01296424591,2510,648.9333333333333,48.377427079636576,58.0931336866094,NaN,NaN,NaN,NaN,5.592152713470118,27.728445216347687,-163663
2025-09-10T01:35:00-04:00,23915,23918.5,23913,23918,23906.443413835088,NaN,NaN,NaN,NaN,NaN,23912.59,23926.812432977924,23898.367567022076,23914.02613470288,23900.834145244353,23913.58254030581,23888.085750182894,434,651.6666666666666,52.908912821448276,57.40479516632433,NaN,NaN,NaN,NaN,5.585570376793681,27.813891882062215,-163229
2025-09-10T01:40:00-04:00,23918.25,23919,23913.5,23916.25,23906.443413835088,NaN,NaN,NaN,NaN,NaN,23912.855,23926.844671200808,23898.86532879919,23914.02613470288,23900.927603489046,23913.69350721104,23888.161699767054,452,655.1333333333333,49.625052515261004,56.52455552364489,NaN,NaN,NaN,NaN,5.579458207022704,27.986342787476726,-163681
2025-09-10T01:45:00-04:00,23917,23919.75,23915.5,23919,23906.443413835088,NaN,NaN,NaN,NaN,NaN,23913.26,23926.75665144611,23899.763348553886,23913.070907762303,23901.00548308565,23913.79448259289,23888.21648357841,340,651.2333333333333,54.41326738162629,55.77972669628135,NaN,NaN,NaN,NaN,5.484496906521081,28.289873645906116,-163341
2025-09-10T01:50:00-04:00,23919,23920.25,23914.75,23919,23906.443413835088,NaN,NaN,NaN,NaN,NaN,23913.715,23926.39648649925,23901.03351350075,23911.67194804444,23901.09621199041,23913.911007269595,23888.281416711226,402,652.4333333333333,54.41326738162629,55.217014117470896,NaN,NaN,NaN,NaN,5.485604270341004,28.28783810838068,-163341
2025-09-10T01:55:00-04:00,23918.75,23920.5,23915.5,23918.75,23906.443413835088,NaN,NaN,NaN,NaN,NaN,23914.105,23926.167375379322,23902.042624620677,23911.67194804444,23901.16315338077,23913.99755803785,23888.328748723692,295,653.6666666666666,53.87337168877735,54.58752170234787,NaN,NaN,NaN,NaN,5.450918251030933,28.340643308564296,-163636
2025-09-10T02:00:00-04:00,23918.75,23920.5,23915.25,23917,23906.443413835088,NaN,NaN,NaN,NaN,NaN,23914.44,23925.857775620017,23903.02222437998,23911.67194804444,23901.271261799935,23914.13209016845,23888.41043343142,501,656.1,50.12420075093026,53.836811211568,NaN,NaN,NaN,NaN,5.436566947385866,28.284939931582592,-164137
2025-09-10T02:05:00-04:00,23917.75,23921.75,23912.25,23920.5,23906.443413835088,NaN,NaN,NaN,NaN,NaN,23914.8,23925.817259192485,23903.782740807514,23911.67194804444,23901.51028886556,23914.434770627624,23888.585807103496,1092,682.9666666666667,56.625631342151195,53.25480205355005,NaN,NaN,NaN,NaN,5.726812165429733,27.066432974521103,-163045
2025-09-10T02:10:00-04:00,23921,23928.25,23915.75,23926.5,23906.443413835088,NaN,NaN,NaN,NaN,NaN,23915.275,23926.220889617714,23904.32911038229,23911.67194804444,23901.777920687324,23914.84783710037,23888.70800427428,951,687.5666666666667,65.03901372064507,53.94556346109898,NaN,NaN,NaN,NaN,6.210611296470466,27.393757778498024,-162094
2025-09-10T02:15:00-04:00,23926.5,23928.75,23921.5,23927.75,23906.85389093316,NaN,NaN,NaN,NaN,NaN,23915.845,23926.35303977976,23905.336960220244,23911.67194804444,23902.0252225206,23915.254268630768,23888.79617641043,806,702.3333333333334,66.49703592770308,55.07970415226022,NaN,NaN,NaN,NaN,6.284853346722576,27.78900739452367,-161288
2025-09-10T02:20:00-04:00,23928,23936,23927.5,23934.25,23913.15030498165,NaN,NaN,NaN,NaN,NaN,23916.46,23927.58715597371,23905.33284402629,23916.558627414288,23902.765162190106,23916.651617507814,23888.878706872398,1959,759.3333333333334,72.84007108725669,56.43048711053846,NaN,NaN,NaN,NaN,6.443078107670964,29.2388933003832,-159329
2025-09-10T02:25:00-04:00,23934.5,23938.5,23933,23936.25,23917.245745664302,NaN,NaN,NaN,NaN,NaN,23917.08,23929.06141892642,23905.098581073584,23920.19690193143,23903.300546630824,23917.694351308102,23888.906741953546,1328,791.8,74.44338492655335,58.08467480598732,NaN,NaN,NaN,NaN,6.375715385694467,30.872350596623537,-158001
2025-09-10T02:30:00-04:00,23936.5,23942.75,23935.75,23937.5,23920.63230267956,NaN,NaN,NaN,NaN,NaN,23917.73,23930.518604299345,23904.941395700655,23924.607521545146,23903.937431583043,23918.956391083866,23888.91847208222,1508,820.3,75.4200282651854,59.44645566720305,NaN,NaN,NaN,NaN,6.420307143859148,32.81388736106413,-156493
2025-09-10T02:35:00-04:00,23938,23944.75,23937.5,23943.5,23922.364925285037,NaN,NaN,NaN,NaN,NaN,23918.5,23932.68943269312,23904.31056730688,23926.611017236115,23904.616713970718,23920.32887168258,23888.904556258854,1525,847.5,79.47464071164052,61.0053789714601,NaN,NaN,NaN,NaN,6.47957091929778,34.79411458336472,-154968
2025-09-10T02:40:00-04:00,23943.5,23948.25,23939.75,23946.25,23924.93356504481,NaN,NaN,NaN,NaN,NaN,23919.16,23935.253402377326,23903.066597622674,23929.488813788892,23905.306003181402,23921.73220774576,23888.879798617043,1490,886.1,81.02000275787492,63.33699151990569,NaN,NaN,NaN,NaN,6.623887282205081,36.91581981985733,-153478
2025-09-10T02:45:00-04:00,23946.75,23946.75,23936.75,23937.75,23924.93356504481,NaN,NaN,NaN,NaN,NaN,23919.775,23936.306863166963,23903.24313683304,23929.488813788892,23905.794876239397,23922.617151374343,23888.97260110445,1225,920.8,64.78402893313353,64.18521409931178,NaN,NaN,NaN,NaN,6.865038190619004,37.88966095284699,-154703
2025-09-10T02:50:00-04:00,23938,23942.75,23931,23939.75,23924.93356504481,NaN,NaN,NaN,NaN,NaN,23920.425,23937.48320916967,23903.36679083033,23929.488813788892,23906.364666599675,23923.56602251475,23889.1633106846,1593,962.6666666666666,66.48583566416727,65.38955575280508,NaN,NaN,NaN,NaN,7.213964034146218,37.19217232969089,-153110
2025-09-10T02:55:00-04:00,23940.25,23944.75,23936,23943.75,23924.93356504481,NaN,NaN,NaN,NaN,NaN,23921.1,23939.099722226965,23903.100277773032,23929.488813788892,23906.795891455764,23924.323596033133,23889.268186878395,1113,991.8666666666667,69.64528507791782,66.47755701682591,NaN,NaN,NaN,NaN,7.323680888850059,36.81581485129954,-151997
2025-09-10T03:00:00-04:00,23943.75,23945.75,23936.5,23942.25,23924.93356504481,NaN,NaN,NaN,NaN,NaN,23921.785,23940.33682200581,23903.23317799419,23929.488813788892,23907.28933089111,23925.17041350805,23889.408248274172,1308,1011.9333333333333,67.09103477992623,67.38311183099019,NaN,NaN,NaN,NaN,7.461275111075055,36.600881501800224,-153305
2025-09-10T03:05:00-04:00,23942.75,23946,23940,23945.25,23924.93356504481,NaN,NaN,NaN,NaN,NaN,23922.475,23941.88047603716,23903.069523962837,23929.488813788892,23907.5193343559,23925.57617056302,23889.46249814878,584,1019.4,69.50028646621166,68.49932002937835,NaN,NaN,NaN,NaN,7.356898317426837,36.43626058280833,-152721
2025-09-10T03:10:00-04:00,23945.25,23953.75,23944.75,23950.5,23928.221029893397,NaN,NaN,NaN,NaN,NaN,23923.18,23943.9944276846,23902.3655723154,23932.687067601877,23908.357765343997,23927.177912609397,23889.537618078597,1879,1072.8333333333333,73.19818418977805,70.14746170358177,NaN,NaN,NaN,NaN,7.47426272332492,37.2125382193629,-150842
2025-09-10T03:15:00-04:00,23951.25,23951.75,23940.75,23942.75,23928.221029893397,NaN,NaN,NaN,NaN,NaN,23923.79,23945.069887218786,23902.510112781216,23932.687067601877,23908.889997739396,23928.08187413634,23889.69812134245,1389,1104.7666666666667,61.369445982383475,70.4863056064555,NaN,NaN,NaN,NaN,7.726101100230283,36.89030866691665,-152231
2025-09-10T03:20:00-04:00,23941.75,23947,23941,23946.5,23928.221029893397,NaN,NaN,NaN,NaN,NaN,23924.43,23946.465208185546,23902.394791814455,23932.687067601877,23909.165013528804,23928.53817165004,23889.791855407566,739,1119.5,64.36978802146677,70.4385037707999,NaN,NaN,NaN,NaN,7.602808164499549,36.59109551107372,-151492
2025-09-10T03:25:00-04:00,23947,23948.5,23942.5,23944.25,23928.221029893397,NaN,NaN,NaN,NaN,NaN,23925.06,23947.520534260988,23902.599465739015,23932.687067601877,23909.407692399975,23928.93821132245,23889.8771734775,657,1133.9333333333334,61.2937482622736,70.06684036612637,NaN,NaN,NaN,NaN,7.488321867035295,36.51194152387269,-152149
2025-09-10T03:30:00-04:00,23943.5,23946.75,23938.25,23940.25,23928.221029893397,NaN,NaN,NaN,NaN,NaN,23925.585,23948.21343565383,23902.95656434617,23932.687067601877,23909.680432624973,23929.352015324275,23890.00884992567,827,1148.3666666666666,56.15605021882479,68.87512458980981,NaN,NaN,NaN,NaN,7.560584590818488,35.35464916300063,-152976
2025-09-10T03:35:00-04:00,23940.5,23942.5,23935.25,23938,23928.221029893397,NaN,NaN,NaN,NaN,NaN,23926.085,23948.683807490375,23903.486192509623,23932.687067601877,23909.934297414846,23929.704103622633,23890.16449120706,869,1120.6666666666667,53.442449406404684,67.37505776694205,NaN,NaN,NaN,NaN,7.538399977188596,33.605809331667125,-153845
2025-09-10T03:40:00-04:00,23938.25,23944.25,23935,23939,23928.221029893397,NaN,NaN,NaN,NaN,NaN,23926.59,23949.192159183036,23903.987840816964,23932.687067601877,23910.239525400437,23930.13184895597,23890.347201844903,1035,1058.2,54.49492351502889,65.88040742764517,NaN,NaN,NaN,NaN,7.660657121675125,32.28092155840865,-152810
2025-09-10T03:45:00-04:00,23939,23946.25,23936.25,23940,23928.221029893397,NaN,NaN,NaN,NaN,NaN,23927.08,23949.761366798182,23904.39863320182,23932.687067601877,23910.5712902864,23930.607590514268,23890.53499005853,1096,1045.6,55.5764064408619,64.17339069401811,NaN,NaN,NaN,NaN,7.827753041555473,31.382255052957714,-151714
2025-09-10T03:50:00-04:00,23939.75,23943,23935.5,23942,23928.221029893397,NaN,NaN,NaN,NaN,NaN,23927.63,23950.398012650116,23904.861987349886,23932.687067601877,23910.800540627213,23930.927035645724,23890.674045608703,789,1038.2333333333333,57.73966027265943,62.51050908793129,NaN,NaN,NaN,NaN,7.804342110015797,30.363150489580715,-150925
2025-09-10T03:55:00-04:00,23942.25,23946.25,23936.75,23938,23928.221029893397,NaN,NaN,NaN,NaN,NaN,23928.105,23950.72713296797,23905.482867032028,23932.687067601877,23911.052935546137,23931.27678637932,23890.829084712954,878,1052.4666666666667,52.25858096202824,61.61583423285234,NaN,NaN,NaN,NaN,7.925460530728954,29.958830608618403,-151803
2025-09-10T04:00:00-04:00,23938.25,23940.75,23927.25,23930,NaN,NaN,NaN,23954.254254335698,23954.254254335698,23954.254254335698,23928.375,23950.75763836272,23905.99236163728,23929.3996540815,23911.42794925505,23931.673255821115,23891.182642688982,1814,1029.2666666666667,43.38759115557759,59.965959625095934,NaN,NaN,NaN,NaN,8.323641921391172,28.047122101309014,-153617
2025-09-10T04:05:00-04:00,23929.75,23930,23917.75,23918.75,NaN,NaN,NaN,23947.73937704076,NaN,NaN,23928.4,23950.736741029712,23906.06325897029,23928.79577861216,23911.631203510806,23931.737323542926,23891.525083478686,2017,1082.0333333333333,34.51468967596486,57.456631382099296,NaN,NaN,NaN,NaN,8.60409606986323,27.61442422775997,-155634
2025-09-10T04:10:00-04:00,23918.5,23929.75,23917.75,23928.25,NaN,NaN,NaN,23947.73937704076,NaN,NaN,23928.55,23950.77970985695,23906.32029014305,23928.79577861216,23911.79408965039,23931.83436867322,23891.75381062756,1290,1109.9666666666667,44.783592289298376,55.86324263276874,NaN,NaN,NaN,NaN,8.84666063630157,27.212633345178716,-154344
2025-09-10T04:15:00-04:00,23928.5,23932,23921.5,23921.5,NaN,NaN,NaN,23947.73937704076,NaN,NaN,23928.61,23950.74688324382,23906.47311675618,23926.73662288973,23911.92069176614,23931.906148455568,23891.93523507671,1044,1133.4333333333334,39.985707837204124,53.75505844498248,NaN,NaN,NaN,NaN,8.964756305137172,26.398388504939092,-155388
2025-09-10T04:20:00-04:00,23921.5,23921.75,23908.5,23917,NaN,NaN,NaN,23940.545360234268,NaN,NaN,23928.56,23950.790060719104,23906.3299392809,23924.98315091954,23911.998309387352,23931.787541817605,23892.2090769571,2253,1195.1333333333334,37.129783493051846,51.17874410950204,NaN,NaN,NaN,NaN,9.270845140484516,27.08283968841061,-157641
2025-09-10T04:25:00-04:00,23916.75,23920.25,23909.75,23910,NaN,NaN,NaN,23940.545360234268,NaN,NaN,23928.36,23951.069284441102,23905.6507155589,23924.98315091954,23912.01198023798,23931.700088306472,23892.32387216949,1150,1223.6333333333334,33.16196027548176,49.16392370186621,NaN,NaN,NaN,NaN,9.358641916164194,27.718401501634162,-158791
2025-09-10T04:30:00-04:00,23910,23912,23892.75,23895.5,NaN,NaN,NaN,23929.52867533742,NaN,NaN,23927.915,23952.252134171114,23903.577865828887,23924.98315091954,23911.69506997896,23931.214380242458,23892.17575971546,3065,1309.1,26.77832636107435,46.478819297552455,NaN,NaN,NaN,NaN,10.065167493581038,29.52719007401687,-161856
2025-09-10T04:35:00-04:00,23895.75,23900.25,23888.5,23899,NaN,NaN,NaN,23921.89669009481,NaN,NaN,23927.51,23953.05446319488,23901.965536805117,23924.889216588504,23911.396523744323,23930.849438318968,23891.943609169677,2225,1346.8666666666666,30.26769248764589,44.26267245650763,NaN,NaN,NaN,NaN,10.185512672610965,31.431325553779537,-159631
2025-09-10T04:40:00-04:00,23898.75,23899.25,23890.75,23891.5,NaN,NaN,NaN,23921.89669009481,NaN,NaN,23926.96,23954.332497148058,23899.58750285194,23924.889216588504,23911.25709571374,23930.6952318133,23891.81895961418,941,1346.5333333333333,27.26886269400012,42.19930191902015,NaN,NaN,NaN,NaN,10.06511891028161,33.19945135641631,-160572
2025-09-10T04:45:00-04:00,23891.5,23904,23887,23902.25,NaN,NaN,NaN,23921.89669009481,NaN,NaN,23926.585,23954.775354737656,23898.394645262342,23916.911373270807,23910.97329476315,23930.30345266168,23891.64313686462,2544,1404.4666666666667,36.91648460208124,41.018875861568475,NaN,NaN,NaN,NaN,10.56046755954721,33.95051394747414,-158028
2025-09-10T04:50:00-04:00,23902.75,23904.75,23892,23892.5,NaN,NaN,NaN,23921.89669009481,NaN,NaN,23926.035,23955.74964453257,23896.32035546743,23905.82462311465,23910.80725590256,23930.088914009022,23891.5255977961,1397,1385.7333333333333,32.68209668613419,39.460816802361705,NaN,NaN,NaN,NaN,10.716862733865266,34.510423439497025,-159425
2025-09-10T04:55:00-04:00,23892.25,23898.75,23892.25,23895.75,NaN,NaN,NaN,23921.89669009481,NaN,NaN,23925.545,23956.41078851038,23894.679211489616,23905.82462311465,23910.735623520293,23930.00005719032,23891.47118985027,579,1360.7666666666667,35.344296056612265,38.01566606062959,NaN,NaN,NaN,NaN,10.41565825287489,35.03033939637542,-158846
2025-09-10T05:00:00-04:00,23896,23901.5,23887.5,23889.5,NaN,NaN,NaN,23921.89669009481,NaN,NaN,23924.945,23957.383756142994,23892.506243857006,23905.82462311465,23910.379437072548,23929.61441213893,23891.144462006167,2498,1393.7666666666667,32.66868496259373,36.22488210991062,NaN,NaN,NaN,NaN,10.671682663383825,35.885569590603346,-161344
2025-09-10T05:05:00-04:00,23889.25,23895.75,23887.25,23889.25,NaN,NaN,NaN,23920.46305713309,NaN,NaN,23924.29,23958.22808479578,23890.35191520422,23894.18469849172,23910.21171710072,23929.449365727964,23890.974068473475,1082,1379,32.562499257032854,34.81801913098237,NaN,NaN,NaN,NaN,10.516562473142121,36.698834400594905,-162426
2025-09-10T05:10:00-04:00,23889.5,23895,23885.25,23894,NaN,NaN,NaN,23919.101099990676,NaN,NaN,23923.805,23958.75257359313,23888.85742640687,23892.947758793376,23910.06708994169,23929.30082792938,23890.833351954003,982,1362.0666666666666,36.767926393033065,34.34518593365776,NaN,NaN,NaN,NaN,10.461808010774828,37.611087949901226,-161444
2025-09-10T05:15:00-04:00,23893.75,23893.75,23881.25,23884.25,NaN,NaN,NaN,23916.89764090019,NaN,NaN,23923.17,23959.776207124,23886.563792875997,23880.533207034703,23909.847863131738,23929.125941556016,23890.56978470746,1194,1361.0333333333333,32.31353110601631,34.18796032151858,NaN,NaN,NaN,NaN,10.625250295719482,38.75567140374286,-162638
2025-09-10T05:20:00-04:00,23883.75,23889.5,23881,23888.25,NaN,NaN,NaN,23914.470475404727,NaN,NaN,23922.58,23960.44587381101,23884.714126188992,23872.958201601414,23909.694249695334,23929.002962533286,23890.385536857382,844,1336.0666666666666,35.75240725870552,33.54287567647623,NaN,NaN,NaN,NaN,10.47344670316809,39.83677053509876,-161794
2025-09-10T05:25:00-04:00,23889,23894.5,23888.5,23888.5,NaN,NaN,NaN,23914.470475404727,NaN,NaN,23922.02,23961.039589951,23883.000410049,23872.958201601414,23909.559448499276,23928.866889251734,23890.252007746818,917,1329.5333333333333,35.971361642162364,33.25613666254468,NaN,NaN,NaN,NaN,10.171771938656082,39.673158937014236,-160877
2025-09-10T05:30:00-04:00,23889,23894.5,23885.75,23889,NaN,NaN,NaN,23914.470475404727,NaN,NaN,23921.415,23961.510836439425,23881.319163560576,23872.958201601414,23909.44316364909,23928.753239225938,23890.133088072245,771,1311.6333333333334,36.43792382874993,33.20671811509454,NaN,NaN,NaN,NaN,10.070216800180647,39.78526159524184,-160106
2025-09-10T05:35:00-04:00,23889.25,23896.75,23888.75,23894,NaN,NaN,NaN,23914.470475404727,NaN,NaN,23920.895,23961.718533656596,23880.071466343405,23873.470959129907,23909.312367516068,23928.599523846362,23890.025211185774,1064,1327.6333333333334,41.06289227765976,33.7710704009644,NaN,NaN,NaN,NaN,9.922344171596317,39.389307076801494,-159042
2025-09-10T05:40:00-04:00,23893.75,23901.75,23891.25,23900.5,NaN,NaN,NaN,23914.470475404727,NaN,NaN,23920.595,23961.79146707614,23879.398532923864,23877.876767303926,23909.212418300645,23928.445013905326,23889.979822695965,1163,1303.7666666666667,46.51165500023855,35.18059387519042,NaN,NaN,NaN,NaN,9.96360530219658,38.00485653153109,-157879
2025-09-10T05:45:00-04:00,23900.75,23907.25,23900.5,23907.25,NaN,NaN,NaN,23914.470475404727,NaN,NaN,23920.38,23961.740275627682,23879.01972437232,23884.77641384314,23909.165915148817,23928.29712046758,23890.03470983005,1491,1307.1666666666667,51.52368618399246,36.69887913921517,NaN,NaN,NaN,NaN,9.734062066325395,35.762691518988525,-156388
2025-09-10T05:50:00-04:00,23907.25,23910.5,23905,23907.75,NaN,NaN,NaN,23914.470475404727,NaN,NaN,23920.21,23961.7064287669,23878.713571233096,23889.771131074514,23909.151974296747,23928.189278733396,23890.114669860097,1343,1327.3,51.883353414735446,38.45705704783912,NaN,NaN,NaN,NaN,9.431629061587866,33.240699240407025,-155045
2025-09-10T05:55:00-04:00,23907.5,23909.75,23905.5,23908.75,NaN,NaN,NaN,23914.470475404727,NaN,NaN,23920.005,23961.62440532466,23878.385594675343,23891.04190485961,23909.145532915354,23928.129732573478,23890.16133325723,767,1330.9666666666667,52.64017935799833,39.580178101833205,NaN,NaN,NaN,NaN,9.061512700045876,30.898849267438482,-154278
2025-09-10T06:00:00-04:00,23909,23909.25,23903.25,23907.75,NaN,NaN,NaN,23914.470475404727,NaN,NaN,23919.78,23961.54010536629,23878.019894633708,23891.283523887687,23909.128918466922,23928.048214792114,23890.20962214173,958,1335.3333333333333,51.76336462271544,40.943125811589006,NaN,NaN,NaN,NaN,8.842833221471171,29.022002412625707,-155236
2025-09-10T06:05:00-04:00,23907.5,23910.75,23905.5,23910.5,NaN,NaN,NaN,23914.470475404727,NaN,NaN,23919.615,23961.455197172323,23877.77480282768,23893.75181911015,23909.127994382445,23928.006066315327,23890.249922449562,604,1326.5,54.03099845292245,42.2778902684683,NaN,NaN,NaN,NaN,8.586202277080373,27.01750916741593,-154632
2025-09-10T06:10:00-04:00,23910.5,23915.5,23910.25,23914,23887.269434627364,23887.269434627364,23887.269434627364,NaN,NaN,NaN,23919.555,23961.418622634294,23877.691377365707,23899.27645528812,23909.169204731686,23927.957147520436,23890.381261942937,1401,1338.7,56.81367184156642,44.00253218839492,NaN,NaN,NaN,NaN,8.347902114431774,25.788531390183206,-153231
2025-09-10T06:15:00-04:00,23914,23914.5,23905.25,23912.25,23887.269434627364,NaN,NaN,NaN,NaN,NaN,23919.39,23961.302427749823,23877.477572250176,23899.27645528812,23909.18027842117,23927.89906381057,23890.461493031766,1044,1336.9666666666667,55.02028216743429,45.60665953913788,NaN,NaN,NaN,NaN,8.412337677686647,24.091915681549775,-154275
2025-09-10T06:20:00-04:00,23911.75,23917,23907.5,23916.5,23887.269434627364,NaN,NaN,NaN,NaN,NaN,23919.19,23961.060223310953,23877.319776689044,23899.27645528812,23909.215214768472,23927.86514421408,23890.565285322864,1108,1347.6,58.45051074515884,47.15541556428972,NaN,NaN,NaN,NaN,8.490027843566173,22.625809107335375,-153167
2025-09-10T06:25:00-04:00,23916.75,23920.25,23915.75,23919.5,23892.730288231032,NaN,NaN,NaN,NaN,NaN,23919.025,23960.8239533323,23877.226046667703,23902.933545107517,23909.29953431901,23927.885467973843,23890.713600664174,1304,1361.8,60.72725673669438,49.184967395052446,NaN,NaN,NaN,NaN,8.205025854740018,21.75610375370617,-151863
2025-09-10T06:30:00-04:00,23919.75,23924.5,23916.75,23918.5,23895.44709331144,NaN,NaN,NaN,NaN,NaN,23918.71,23960.282029059686,23877.13797094031,23906.771836086013,23909.405822031924,23927.928671360944,23890.882972702904,1452,1349.7333333333333,59.555773206960914,50.88520781992783,NaN,NaN,NaN,NaN,8.172524007972873,21.532785538315487,-153315
2025-09-10T06:35:00-04:00,23918.5,23926.5,23917.5,23923.25,23896.739270888193,NaN,NaN,NaN,NaN,NaN,23918.45,23959.741645644124,23877.158354355877,23907.817468868812,23909.49862749258,23927.987746786705,23891.009508198455,1042,1317.2333333333333,63.188359875616555,52.829279122317416,NaN,NaN,NaN,NaN,8.231629435974812,21.58256688505778,-152273
2025-09-10T06:40:00-04:00,23923.25,23926.5,23919.75,23925.25,23898.092031302363,NaN,NaN,NaN,NaN,NaN,23918.205,23959.185811356456,23877.224188643548,23908.17897509505,23909.57281813455,23928.042692642088,23891.102943627015,760,1299.5666666666666,64.62891186814869,54.84292112513161,NaN,NaN,NaN,NaN,8.125798761976611,21.628792421318483,-151513
2025-09-10T06:45:00-04:00,23925.25,23926.25,23920.5,23921.5,23898.695802606802,NaN,NaN,NaN,NaN,NaN,23917.765,23958.117621974867,23877.412378025132,23908.71818007604,23909.654861726765,23928.096300346315,23891.213423107216,920,1295.4333333333334,59.89600880829189,56.18814373446247,NaN,NaN,NaN,NaN,7.956098850406853,21.67171613356056,-152433
2025-09-10T06:50:00-04:00,23921.75,23926,23921.75,23925,23899.703947942857,NaN,NaN,NaN,NaN,NaN,23917.34,23956.92393108251,23877.75606891749,23909.72454406083,23909.710652486563,23928.13883250338,23891.282472469746,567,1239.2333333333333,62.64557560060073,57.34056663448835,NaN,NaN,NaN,NaN,7.7092346468063635,21.71157386635678,-151866
2025-09-10T06:55:00-04:00,23925,23927.5,23921.5,23924.5,23900.60945030909,NaN,NaN,NaN,NaN,NaN,23917.075,23956.2844695156,23877.8655304844,23911.479635248666,23909.798467210836,23928.20695436892,23891.38998005275,886,1230.4333333333334,61.99169741447401,58.088281722379875,NaN,NaN,NaN,NaN,7.587146457748766,21.9859228757934,-152752
2025-09-10T07:00:00-04:00,23924.75,23928.75,23921.75,23926,23901.490838931404,NaN,NaN,NaN,NaN,NaN,23916.8,23955.559772963366,23878.040227036632,23912.433708198932,23909.923007156034,23928.31116968025,23891.534844631817,1193,1168.0333333333333,63.231598755466166,58.898870675289224,NaN,NaN,NaN,NaN,7.545207425052425,22.43704188293447,-151559
2025-09-10T07:05:00-04:00,23926,23927.75,23925,23927,23903.32080079816,NaN,NaN,NaN,NaN,NaN,23916.465,23954.571300001597,23878.358699998404,23913.321966559146,23910.00215988318,23928.38232707885,23891.621992687513,718,1117.8,64.07303764074442,59.71550340977108,NaN,NaN,NaN,NaN,7.202692608977252,22.855938103851177,-150841
2025-09-10T07:10:00-04:00,23927,23930,23923.5,23928,23903.857355307333,NaN,NaN,NaN,NaN,NaN,23916.18,23953.71958443905,23878.64041556095,23915.207573247317,23910.106579218504,23928.47929746293,23891.733860974076,925,1117.2666666666667,64.93716847108273,60.656489398940174,NaN,NaN,NaN,NaN,7.152500279764591,23.611449434228053,-149916
2025-09-10T07:15:00-04:00,23928,23931,23922.5,23930,23903.857355307333,NaN,NaN,NaN,NaN,NaN,23915.875,23952.705999172413,23879.044000827587,23915.207573247317,23910.287630488878,23928.652973640237,23891.92228733752,1569,1084.7666666666667,66.66414062737925,61.558856697115665,NaN,NaN,NaN,NaN,7.2487502597814055,24.312995669578005,-148347
2025-09-10T07:20:00-04:00,23930.25,23935.5,23925.5,23926.5,23907.171164649862,NaN,NaN,NaN,NaN,NaN,23915.395,23951.014108629806,23879.775891370195,23917.63284687828,23910.49666700999,23928.86658732066,23892.12674669932,1720,1095.5333333333333,61.00170764243571,61.85800211146346,NaN,NaN,NaN,NaN,7.445268098368447,25.641391108216272,-150067
2025-09-10T07:25:00-04:00,23926.75,23929.75,23923.25,23927.75,23907.171164649862,NaN,NaN,NaN,NaN,NaN,23915.095,23950.03364479305,23880.156355206953,23917.63284687828,23910.61754040116,23928.973465480372,23892.261615321946,1152,1114.6333333333334,62.23544251978737,62.373370708060115,NaN,NaN,NaN,NaN,7.377748948484986,26.148053379382336,-148915
2025-09-10T07:30:00-04:00,23927.75,23937.25,23927.25,23935.25,23908.784057046672,NaN,NaN,NaN,NaN,NaN,23914.87,23949.13517766338,23880.60482233662,23918.2150220021,23910.8410669771,23929.24273084496,23892.43940310924,1561,1083.4,68.6448890296407,63.101540585523104,NaN,NaN,NaN,NaN,7.565052595021773,27.596619663029948,-147354
2025-09-10T07:35:00-04:00,23935.75,23947.5,23934.75,23944.75,23916.987054453642,NaN,NaN,NaN,NaN,NaN,23914.88,23949.17974343507,23880.580256564932,23925.89701760168,23911.38694702461,23930.085734727178,23892.688159322042,2788,1140.2666666666667,74.5394441540723,64.0881254010501,NaN,NaN,NaN,NaN,7.935405981091646,29.823901934420583,-144566
2025-09-10T07:40:00-04:00,23945,23955,23944.25,23954.25,23925.11832470575,NaN,NaN,NaN,NaN,NaN,23915.16,23950.49649104931,23879.82350895069,23932.342614081346,23911.976593859352,23931.14871557572,23892.804472142983,2420,1188.2,78.82617892406553,65.46458295227185,NaN,NaN,NaN,NaN,8.13644841101367,32.344752834636,-142146
2025-09-10T07:45:00-04:00,23954.5,23957.5,23950.5,23952.25,23929.652719037305,NaN,NaN,NaN,NaN,NaN,23915.445,23951.73084985874,23879.15915014126,23935.874091265076,23912.50607457797,23932.115642849945,23892.896506305995,2113,1218.8333333333333,75.92782918512444,66.37454504580813,NaN,NaN,NaN,NaN,8.055273524512694,34.81586313511186,-144259
2025-09-10T07:50:00-04:00,23952.5,23954.75,23948.25,23950.75,23929.652719037305,NaN,NaN,NaN,NaN,NaN,23915.68,23952.71741891075,23878.64258108925,23935.874091265076,23912.82486091703,23932.664735127502,23892.984986706557,1372,1236.4333333333334,73.73796387895769,67.02519161800878,NaN,NaN,NaN,NaN,7.944182558476073,36.535163292290534,-145631
2025-09-10T07:55:00-04:00,23950.5,23954,23947.25,23949,23929.652719037305,NaN,NaN,NaN,NaN,NaN,23915.86,23953.451775698042,23878.26822430196,23935.874091265076,23913.059993881816,23933.05604179578,23893.063945967853,1059,1241.1666666666667,71.15938696098141,67.82971862891516,NaN,NaN,NaN,NaN,7.858883804299211,37.875498186533605,-146690
2025-09-10T08:00:00-04:00,23948.5,23962.75,23942,23962.75,23929.652719037305,NaN,NaN,NaN,NaN,NaN,23916.275,23955.437258615733,23877.11274138427,23936.52253472772,23914.040277470463,23934.816402280278,23893.26415266065,3936,1346.6666666666667,77.74464513289611,68.90822359550769,NaN,NaN,NaN,NaN,8.779677818277838,39.68007795122573,-142754
2025-09-10T08:05:00-04:00,23962.5,23964.75,23952,23959.25,23932.11256254309,NaN,NaN,NaN,NaN,NaN,23916.7,23957.23331963072,23876.166680369282,23937.393027782175,23914.653542749395,23935.93046201677,23893.376623482018,2393,1390.9666666666667,73.1651002483963,69.70632379793071,NaN,NaN,NaN,NaN,9.063272259829422,41.46472154047726,-145147
2025-09-10T08:10:00-04:00,23959.5,23959.75,23947.25,23948.5,23932.11256254309,NaN,NaN,NaN,NaN,NaN,23917.07,23958.411872238226,23875.728127761773,23937.393027782175,23914.95175541035,23936.401108782407,23893.502402038295,1408,1399.1333333333334,61.23425124234806,69.56365611842229,NaN,NaN,NaN,NaN,9.308752812698748,41.99606761401435,-146555
2025-09-10T08:15:00-04:00,23948.25,23950.75,23941.5,23949.5,23932.11256254309,NaN,NaN,NaN,NaN,NaN,23917.685,23960.011683073386,23875.358316926617,23937.393027782175,23915.33967536597,23936.94818427166,23893.73116646028,2134,1420.5666666666666,61.857346575296496,69.40539247089029,NaN,NaN,NaN,NaN,9.304556183220265,41.30950976108571,-144421
2025-09-10T08:20:00-04:00,23949,23950.5,23938,23938,23932.11256254309,NaN,NaN,NaN,NaN,NaN,23917.88,23960.488478028914,23875.271521971088,23937.393027782175,23915.56039970006,23937.215850949375,23893.90494845075,1474,1424.9333333333334,51.588104013142804,68.45188786675172,NaN,NaN,NaN,NaN,9.532802170133104,40.03094104953848,-145895
2025-09-10T08:25:00-04:00,23938.5,23945.25,23934.25,23945.25,23932.11256254309,NaN,NaN,NaN,NaN,NaN,23918.355,23961.63849454823,23875.071505451768,23937.393027782175,23915.90582228562,23937.62225178285,23894.189392788387,2410,1479.7,56.491998425664846,67.72530628091498,NaN,NaN,NaN,NaN,9.637602015123596,38.204193159296665,-143485
2025-09-10T08:30:00-04:00,23940,24041,23930,24021,NaN,NaN,NaN,23965.262945546358,23965.262945546358,23965.262945546358,23920.435,23972.3858238594,23868.484176140602,23963.207667343664,23924.62400552137,23957.104822852547,23892.143188190195,21770,2173.4333333333334,79.66700053458743,69.05854148749724,NaN,NaN,NaN,NaN,16.877773299757624,40.57794350743723,-121715
2025-09-10T08:35:00-04:00,24020.5,24024.25,23991.75,24002.75,23964.006395554152,23964.006395554152,23964.006395554152,NaN,NaN,NaN,23922.29,23979.021592608624,23865.558407391378,23963.207667343664,23928.30997227792,23964.29117972066,23892.328764835176,9616,2473.8333333333335,69.99370327473642,69.6127029699936,NaN,NaN,NaN,NaN,17.993646635489224,42.78214025928204,-131331
2025-09-10T08:40:00-04:00,24002.75,24010.75,23996.25,24010.5,23964.006395554152,NaN,NaN,NaN,NaN,NaN,23924.59,23985.92822299507,23863.25177700493,23963.207667343664,23930.232417575706,23967.754156608236,23892.710678543175,5415,2607.633333333333,71.57226594541615,69.82180132112042,NaN,NaN,NaN,NaN,17.744100447239994,44.82889438599507,-125916
2025-09-10T08:45:00-04:00,24010.75,24014.25,23996.75,24002,23964.006395554152,NaN,NaN,NaN,NaN,NaN,23926.65,23991.244117376264,23862.05588262374,23963.207667343664,23932.10718430567,23970.93589065504,23893.2784779563,5668,2761.766666666667,67.385145026852,69.31077995489039,NaN,NaN,NaN,NaN,17.726664701008566,46.78966482477827,-131584
2025-09-10T08:50:00-04:00,24002,24007.5,23995,23999.25,23964.006395554152,NaN,NaN,NaN,NaN,NaN,23928.805,23995.712719285522,23861.89728071448,23963.207667343664,23933.56464556884,23973.228937256572,23893.90035388111,4872,2887.233333333333,66.0390673603219,68.39741484319443,NaN,NaN,NaN,NaN,17.353331508079382,48.4178834254429,-136456
2025-09-10T08:55:00-04:00,23999.25,24006.75,23997,24004.5,23964.006395554152,NaN,NaN,NaN,NaN,NaN,23930.85,24000.577182648623,23861.122817351374,23963.207667343664,23934.361459219494,23974.48164906585,23894.24126937314,2667,2932.6666666666665,67.37879715248522,67.7867696980059,NaN,NaN,NaN,NaN,16.810236400359425,49.92980069748863,-133789
2025-09-10T09:00:00-04:00,24004,24005.75,23977.75,23984.75,23964.006395554152,NaN,NaN,NaN,NaN,NaN,23932.695,24003.14372532633,23862.24627467367,23963.207667343664,23935.90576504429,23976.490448203982,23895.321081884595,6683,3107.0333333333333,58.0942037386119,66.66935825940978,NaN,NaN,NaN,NaN,17.60950522890518,49.31853725625281,-140472
2025-09-10T09:05:00-04:00,23985,23991.5,23979,23989,23964.006395554152,NaN,NaN,NaN,NaN,NaN,23934.56,24005.929010079366,23863.190989920637,23963.207667343664,23936.576504882243,23977.304455577632,23895.848554186854,3201,3179,59.39099043722818,65.82875850771312,NaN,NaN,NaN,NaN,17.24454056969767,48.750935489390976,-137271
2025-09-10T09:10:00-04:00,23989,24002,23985.5,23998.75,23964.006395554152,NaN,NaN,NaN,NaN,NaN,23936.745,24009.14413604521,23864.345863954786,23963.207667343664,23937.661743363547,23978.781687675964,23896.54179905113,4537,3304.9,62.27516886056182,64.7237959168321,NaN,NaN,NaN,NaN,17.19135910043355,48.62262953156641,-132734
2025-09-10T09:15:00-04:00,23998.5,24010,23996.75,24008,23964.006395554152,NaN,NaN,NaN,NaN,NaN,23939.12,24012.908836556486,23865.331163443512,23964.580597055046,23938.987614421145,23980.759969400624,23897.215259441666,4947,3439.133333333333,64.82743285608029,64.12824824595239,NaN,NaN,NaN,NaN,16.909833450402584,48.7780635585743,-127787
2025-09-10T09:20:00-04:00,24007.5,24013,24004,24006.75,23964.472544634857,NaN,NaN,NaN,NaN,NaN,23941.375,24016.391614825174,23866.358385174826,23972.164477644037,23939.955558567865,23982.21912233302,23897.69199480271,3574,3539.366666666667,64.19537765238869,64.339757275241,NaN,NaN,NaN,NaN,16.344845346802398,49.02232129752258,-131361
2025-09-10T09:25:00-04:00,24007,24015,23996,23998,23964.472544634857,NaN,NaN,NaN,NaN,NaN,23943.65,24018.498112867135,23868.801887132868,23972.83158211523,23941.71457881362,23984.658421406566,23898.77073622067,7305,3753.3333333333335,59.8001517960309,64.19281479100775,NaN,NaN,NaN,NaN,16.534499250602227,48.42844957209264,-138666
2025-09-10T09:30:00-04:00,23998.5,24000.75,23932,23962.75,NaN,NaN,NaN,24018.339065735596,24018.339065735596,24018.339065735596,23945.14,24018.46810920798,23871.811890792018,23972.83158211523,23945.19538100752,23985.691974161495,23904.698787853547,45632,5234.633333333333,46.10513696113761,63.80117428729309,NaN,NaN,NaN,NaN,20.26417787555921,46.0222886011056,-184298
2025-09-10T09:35:00-04:00,23962,23975.75,23926.25,23940.25,NaN,NaN,NaN,24007.352062747614,NaN,NaN,23946.175,24017.71514607078,23874.63485392922,23972.83158211523,23945.40957843878,23983.90973580401,23906.90942107355,32811,6304.4,39.83430023548309,62.6113387022801,NaN,NaN,NaN,NaN,22.352450884447837,44.01166852566586,-217109
2025-09-10T09:40:00-04:00,23940.75,23952,23918,23930.75,NaN,NaN,NaN,23993.426968986358,NaN,NaN,23947.01,24016.814868026522,23877.205131973475,23972.83158211523,23944.551579643623,23981.755533090196,23907.34762619705,26617,7160.8,37.51424584020082,59.600427652681056,NaN,NaN,NaN,NaN,23.18441867841585,42.459699066285964,-243726
2025-09-10T09:45:00-04:00,23931,23945.5,23912,23944.5,NaN,NaN,NaN,23989.089379486977,NaN,NaN,23948.02,24016.169382975102,23879.8706170249,23972.83158211523,23943.707118832208,23979.505957221863,23907.908280442552,31916,8172.366666666667,42.71477322813281,57.65193264935224,NaN,NaN,NaN,NaN,23.921245915671857,41.242649766135116,-211810
2025-09-10T09:50:00-04:00,23944.75,23955.5,23894.25,23916,NaN,NaN,NaN,23989.089379486977,NaN,NaN,23948.33,24015.74902105097,23880.910978949032,23972.83158211523,23941.83437698646,23976.60097627392,23907.067777698998,37496,9364.9,36.02258572244249,55.112669776282694,NaN,NaN,NaN,NaN,26.587585493123868,40.71951293210784,-249306
2025-09-10T09:55:00-04:00,23915.75,23936,23905.25,23930.75,NaN,NaN,NaN,23987.769455276357,NaN,NaN,23948.8,24015.389488662433,23882.210511337566,23972.83158211523,23941.053483421223,23975.245714866618,23906.861251975828,19978,9992.433333333332,41.160543074448235,53.239483922539556,NaN,NaN,NaN,NaN,26.88490081504359,40.233743014796794,-229328
2025-09-10T10:00:00-04:00,23930.5,23970,23923.75,23962.75,NaN,NaN,NaN,23987.769455276357,NaN,NaN,23949.9,24015.55119952786,23884.24880047214,23972.83158211523,23941.71848002429,23974.97654594217,23908.460414106412,29040,10908.4,50.456482594085244,52.12644215352265,NaN,NaN,NaN,NaN,28.26812218539762,37.85045885343315,-200288
2025-09-10T10:05:00-04:00,23963,23976.75,23945.25,23954.25,NaN,NaN,NaN,23987.769455276357,NaN,NaN,23950.81,24015.407334309697,23886.212665690306,23972.83158211523,23942.4803578646,23975.176150540763,23909.784565188434,22726,11573,48.274765485422584,50.76186846301818,NaN,NaN,NaN,NaN,28.49897060072636,35.321394314966156,-223014
2025-09-10T10:10:00-04:00,23953.75,23972.5,23946.25,23958.5,NaN,NaN,NaN,23987.769455276357,NaN,NaN,23951.825,24015.268616698082,23888.38138330192,23972.83158211523,23943.083919768134,23975.330004625335,23910.837834910933,19165,12131.166666666666,49.45167459861078,50.1445449530181,NaN,NaN,NaN,NaN,28.33832984353162,32.972977243532526,-203849
2025-09-10T10:15:00-04:00,23958.5,23976.5,23949,23969.75,NaN,NaN,NaN,23987.769455276357,NaN,NaN,23953.01,24015.528474072493,23890.491525927504,23932.640265692185,23943.814378580966,23975.76466327551,23911.864093886423,18106,12664.266666666666,52.53062202982388,49.654518638203506,NaN,NaN,NaN,NaN,28.27844914042222,30.64566060177149,-185743
2025-09-10T10:20:00-04:00,23969.75,23984,23960.75,23982.5,NaN,NaN,NaN,23987.769455276357,NaN,NaN,23954.38,24016.41936169529,23892.34063830471,23905.37278787722,23944.80888071591,23976.743227203435,23912.874534228387,17527,13202.766666666666,55.81541939866068,49.193107962353416,NaN,NaN,NaN,NaN,27.919274201820635,28.861008752329774,-168216
2025-09-10T10:25:00-04:00,23982,23986.75,23960,23964.5,NaN,NaN,NaN,23987.769455276357,NaN,NaN,23955.425,24016.340617866812,23894.509382133187,23910.473230301774,23945.490461819612,23977.26542810882,23913.715495530403,15390,13680.466666666667,50.50225983181036,48.16988131776271,NaN,NaN,NaN,NaN,27.835754615976303,27.34172790165289,-183606
2025-09-10T10:30:00-04:00,23963.5,23981.75,23960.75,23969,NaN,NaN,NaN,23987.769455276357,NaN,NaN,23956.475,24016.47360415027,23896.476395849728,23910.473230301774,23946.11737963121,23977.734232305153,23914.50052695727,14867,14044.833333333334,51.73911442303636,47.28014822995183,NaN,NaN,NaN,NaN,27.347486429120853,25.93096711173864,-168739
2025-09-10T10:35:00-04:00,23969.25,23982.25,23955.25,23971.25,NaN,NaN,NaN,23987.769455276357,NaN,NaN,23957.51,24016.701550074962,23898.318449925035,23911.532867393136,23946.714729448988,23978.14464266295,23915.284816235024,15492,14481.466666666667,52.379849827903264,46.750126660799864,NaN,NaN,NaN,NaN,27.322665969897937,24.27272312379926,-153247
2025-09-10T10:40:00-04:00,23971,23981.5,23962.5,23977.25,NaN,NaN,NaN,23987.769455276357,NaN,NaN,23958.685,24017.059207485137,23900.310792514865,23915.42629391451,23947.241989616836,23978.587651969305,23915.896327264367,12105,14838.033333333333,54.128798122732825,47.32324531519952,NaN,NaN,NaN,NaN,26.728189829190942,22.732925134998403,-141142
2025-09-10T10:45:00-04:00,23976.5,23990.75,23972,23977.75,23910.26018428002,23910.26018428002,23910.26018428002,NaN,NaN,NaN,23959.775,24017.49347624164,23902.05652375836,23928.516035131608,23947.94565810365,23979.318007683283,23916.573308524017,13555,15218.733333333334,54.27949375935298,48.355044852618796,NaN,NaN,NaN,NaN,26.158319127105873,21.867432417513708,-127587
2025-09-10T10:50:00-04:00,23978,23987.25,23959,23969.75,23910.26018428002,NaN,NaN,NaN,NaN,NaN,23960.665,24017.593517454836,23903.736482545166,23928.516035131608,23948.475646772386,23979.700741979555,23917.250551565216,14289,15645.9,51.37153801645792,49.34485143663716,NaN,NaN,NaN,NaN,26.307724903741168,20.412034183614512,-141876
2025-09-10T10:55:00-04:00,23969.5,23983.5,23958.25,23966.75,23910.26018428002,NaN,NaN,NaN,NaN,NaN,23961.57,24017.407535762155,23905.732464237844,23928.516035131608,23948.902008378253,23979.950618650328,23917.853398106177,13424,16013.033333333333,50.28362411465326,49.885483642817185,NaN,NaN,NaN,NaN,26.232173124902513,19.108121387904433,-155300
2025-09-10T11:00:00-04:00,23966.75,23979,23960,23970.5,23910.26018428002,NaN,NaN,NaN,NaN,NaN,23962.48,24017.379074673976,23907.580925326023,23928.516035131608,23949.214030334737,23980.13456308346,23918.293497586015,10017,15621.266666666666,51.661653396108555,51.00255990522191,NaN,NaN,NaN,NaN,25.71558933026662,17.897345220459364,-145283
2025-09-10T11:05:00-04:00,23970.75,23975.5,23956.25,23967.5,23910.26018428002,NaN,NaN,NaN,NaN,NaN,23963.34,24017.169059064538,23909.510940935463,23928.516035131608,23949.490206335522,23980.237642955643,23918.7427697154,10964,15666.2,50.45674810757963,51.66657455044558,NaN,NaN,NaN,NaN,25.253761520961863,17.036481615890548,-156247
2025-09-10T11:10:00-04:00,23967.5,23978.5,23966.25,23969,23910.26018428002,NaN,NaN,NaN,NaN,NaN,23964.2,24016.979067821576,23911.420932178426,23928.516035131608,23949.774850731355,23980.42041487213,23919.12928659058,9052,15787.433333333332,51.071222322554895,51.710484531050554,NaN,NaN,NaN,NaN,24.324921412321732,15.999314145273225,-147195
2025-09-10T11:15:00-04:00,23968.75,23970,23936,23938.5,23910.26018428002,NaN,NaN,NaN,NaN,NaN,23964.43,24016.655955230905,23912.204044769096,23928.516035131608,23949.72941706935,23979.940162853323,23919.518671285376,20118,16269.1,40.16330453212754,51.13109446295805,NaN,NaN,NaN,NaN,25.01599845429875,16.808975459449474,-167313
2025-09-10T11:20:00-04:00,23938.25,23941.5,23926,23935,23910.26018428002,NaN,NaN,NaN,NaN,NaN,23964.57,24016.440901285972,23912.699098714027,23928.516035131608,23949.37368412507,23979.32759159741,23919.419776652725,16658,16661.966666666667,39.13046349674444,50.39386509853903,NaN,NaN,NaN,NaN,24.336284278991695,17.992145003460823,-183971
2025-09-10T11:25:00-04:00,23934.25,23949,23920.75,23942.5,23910.26018428002,NaN,NaN,NaN,NaN,NaN,23964.82,24016.13959079996,23913.500409200038,23928.516035131608,23949.118770781966,23978.801952587986,23919.435588975946,15875,17102.233333333334,42.540387065640516,49.68027688681165,NaN,NaN,NaN,NaN,24.615835401920858,18.491571975001502,-168096
2025-09-10T11:30:00-04:00,23943.5,23947.25,23923.25,23933.25,23910.26018428002,NaN,NaN,NaN,NaN,NaN,23964.955,24015.90484690332,23914.005153096685,23928.516035131608,23948.875833065933,23978.368838502483,23919.382827629383,12657,17301.366666666665,39.594319607094214,48.521626901699754,NaN,NaN,NaN,NaN,24.571847158926513,18.955325591432135,-180753
2025-09-10T11:35:00-04:00,23933.25,23953,23927.75,23948.5,23910.26018428002,NaN,NaN,NaN,NaN,NaN,23965.37,24015.43118656488,23915.308813435116,23925.952574391926,23948.79026225268,23978.07295128235,23919.507573223014,11355,17573.166666666668,46.208386941699395,48.214921695263264,NaN,NaN,NaN,NaN,24.62028664757462,18.913106186114245,-169398
2025-09-10T11:40:00-04:00,23948.5,23956.5,23944,23955.25,23910.26018428002,NaN,NaN,NaN,NaN,NaN,23965.77,24015.177473115302,23916.3625268847,23925.952574391926,23948.82527651495,23977.94538626827,23919.705166761625,8706,17712.133333333335,48.87665061267004,48.01045999452281,NaN,NaN,NaN,NaN,23.75455188703358,18.590209133771246,-160692
2025-09-10T11:45:00-04:00,23955,23961.5,23946.5,23960,23910.26018428002,NaN,NaN,NaN,NaN,NaN,23966.075,24015.146809626498,23917.003190373503,23925.952574391926,23948.92275597955,23977.856293216148,23919.989218742954,10707,17904.133333333335,50.72882393399052,47.89252957352904,NaN,NaN,NaN,NaN,23.129226752245465,17.88927598956354,-149985
2025-09-10T11:50:00-04:00,23960.25,23969.25,23958,23968,23910.26018428002,NaN,NaN,NaN,NaN,NaN,23966.35,24015.307634750683,23917.392365249314,23925.952574391926,23949.10164376072,23977.924235049475,23920.279052471968,8821,18079.033333333333,53.76688527697474,47.866678655974894,NaN,NaN,NaN,NaN,22.2807105556565,16.6499647360005,-141164
2025-09-10T11:55:00-04:00,23968,23968.25,23949.5,23949.75,23910.26018428002,NaN,NaN,NaN,NaN,NaN,23966.3,24015.320199918187,23917.27980008181,23925.952574391926,23949.161954587773,23977.86215161779,23920.461757557758,7204,18075.666666666668,46.69363734717904,47.32483176939104,NaN,NaN,NaN,NaN,22.02851694453818,16.08250580256038,-148368
2025-09-10T12:00:00-04:00,23950.25,23950.75,23928,23932.5,23910.26018428002,NaN,NaN,NaN,NaN,NaN,23965.935,24015.67932731281,23916.190672687193,23923.204550503295,23948.962671926118,23977.46668180479,23920.458662047444,13489,17004.233333333334,41.179293893228966,46.59681433201754,NaN,NaN,NaN,NaN,22.080051448499738,16.747502488857577,-161857
2025-09-10T12:05:00-04:00,23932,23938,23923.5,23932.25,23910.26018428002,NaN,NaN,NaN,NaN,NaN,23965.6,24016.017060610386,23915.18293938961,23923.204550503295,23948.76436537289,23977.169567180496,23920.35916356528,9257,16219.1,41.103531996155816,45.94109346641058,NaN,NaN,NaN,NaN,21.538619202178328,17.57586770544698,-171114
2025-09-10T12:10:00-04:00,23932.25,23941.75,23930.5,23932.75,23910.26018428002,NaN,NaN,NaN,NaN,NaN,23965,24016.245682743873,23913.754317256127,23923.204550503295,23948.633836499153,23976.935490279386,23920.33218271892,7916,15595.733333333334,41.33599739283442,45.20354660903386,NaN,NaN,NaN,NaN,20.803717830594163,18.03068388930324,-163198
2025-09-10T12:15:00-04:00,23932.75,23941.25,23918.25,23919.5,23910.26018428002,NaN,NaN,NaN,NaN,NaN,23964.205,24016.992942749996,23911.417057250008,23923.204550503295,23948.356420131953,23976.589893231918,23920.12294703199,10515,14882.366666666667,37.1512170461788,44.25315153321951,NaN,NaN,NaN,NaN,20.960595128408865,19.037854305569812,-173713
2025-09-10T12:20:00-04:00,23919.75,23923.5,23904.25,23920.5,NaN,NaN,NaN,23977.417056897357,23977.417056897357,23977.417056897357,23963.645,24017.667133428207,23909.622866571794,23923.204550503295,23947.80951090559,23976.110958919962,23919.50806289122,14571,14118.2,37.66413867891697,43.295502701531085,NaN,NaN,NaN,NaN,20.83840976209395,20.540251126884222,-159142
2025-09-10T12:25:00-04:00,23920.25,23925.5,23914,23917.25,NaN,NaN,NaN,23977.417056897357,NaN,NaN,23963,24018.43392463173,23907.56607536827,23923.204550503295,23947.56881967775,23975.874222019615,23919.263417335882,7223,13693.033333333333,36.61816966080002,43.042278782150554,NaN,NaN,NaN,NaN,20.171380493372954,21.758433518744276,-166365
2025-09-10T12:30:00-04:00,23917,23926.75,23916.75,23924.75,NaN,NaN,NaN,23977.417056897357,NaN,NaN,23962.735,24018.767884096316,23906.702115903685,23923.204550503295,23947.401812495293,23975.684696744473,23919.118928246113,5874,12920.833333333334,40.71015158274596,43.15511364543637,NaN,NaN,NaN,NaN,19.444853315274887,22.774016122720163,-160491
2025-09-10T12:35:00-04:00,23924.5,23926.5,23911,23913.25,NaN,NaN,NaN,23977.417056897357,NaN,NaN,23962.095,24019.62315745101,23904.566842548993,23923.204550503295,23947.207215900486,23975.504032327655,23918.910399473316,5608,12350.233333333334,36.788228553354344,42.744245180273076,NaN,NaN,NaN,NaN,19.16307807846954,23.968821705026805,-166099
2025-09-10T12:40:00-04:00,23914,23918,23900.75,23902.25,NaN,NaN,NaN,23969.10430156519,NaN,NaN,23959.72,24017.129549724206,23902.310450275796,23922.038640402636,23946.722831379626,23975.18868162863,23918.25698113062,10713,12068.5,33.46704246881504,42.30658252753884,NaN,NaN,NaN,NaN,19.02642964429314,25.49134118364324,-176812
2025-09-10T12:45:00-04:00,23902.5,23910.25,23897,23901,NaN,NaN,NaN,23962.446151494045,NaN,NaN,23957.685,24016.054581971744,23899.315418028258,23902.40591232211,23946.280696583704,23974.94083745013,23917.62055571728,9032,11766.033333333333,33.10133664540864,41.370364649232364,NaN,NaN,NaN,NaN,18.613827526843632,27.04695443170631,-185844
2025-09-10T12:50:00-04:00,23901,23915,23898,23911,NaN,NaN,NaN,23962.446151494045,NaN,NaN,23955.695,24013.50825885996,23897.881741140038,23899.384783886147,23945.965110996283,23974.71599402087,23917.214227971697,7467,11430.7,38.85749144101659,40.65471042268569,NaN,NaN,NaN,NaN,18.498554132069085,27.995230183699395,-178377
2025-09-10T12:55:00-04:00,23911.5,23927.25,23911.5,23924.25,NaN,NaN,NaN,23962.446151494045,NaN,NaN,23954.14,24011.06338359801,23897.216616401987,23899.384783886147,23945.71843182588,23974.433289778113,23917.003573873648,9039,11219,45.54347782214545,40.2843285575539,NaN,NaN,NaN,NaN,18.33794312263558,27.714725265430474,-169338
2025-09-10T13:00:00-04:00,23924,23940.5,23920,23928.5,NaN,NaN,NaN,23962.446151494045,NaN,NaN,23952.725,24008.600419461513,23896.849580538485,23898.621856245576,23945.519797618064,23974.111556028674,23916.928039207454,11462,11105.5,47.52558694010873,39.838521533492035,NaN,NaN,NaN,NaN,18.492375756733036,26.40065462577918,-157876
2025-09-10T13:05:00-04:00,23928.75,23932.75,23920,23930.5,NaN,NaN,NaN,23962.446151494045,NaN,NaN,23951.245,24005.451686857916,23897.038313142082,23898.621856245576,23945.38090162737,23973.903658953826,23916.858144300913,7297,10832.333333333334,48.47600125150425,39.96583324094384,NaN,NaN,NaN,NaN,18.082206059823534,25.180446174674415,-150579
2025-09-10T13:10:00-04:00,23930.75,23932.25,23923,23924.5,NaN,NaN,NaN,23962.446151494045,NaN,NaN,23950.04,24003.89140295211,23896.18859704789,23898.621856245576,23945.289828720073,23973.77332848157,23916.806328958577,4545,10580.333333333334,45.796210646937865,40.295613009065896,NaN,NaN,NaN,NaN,17.45133419840757,24.047395470077127,-155124
2025-09-10T13:15:00-04:00,23924.5,23926.25,23908.5,23911.75,NaN,NaN,NaN,23962.446151494045,NaN,NaN,23948.495,24002.21915564891,23894.77084435109,23898.621856245576,23945.053081224192,23973.546215268016,23916.55994718037,7515,10379,40.6532525289653,40.26345018998086,NaN,NaN,NaN,NaN,17.472667469949887,23.900701241073232,-162639
2025-09-10T13:20:00-04:00,23912,23916.75,23889.25,23897.75,NaN,NaN,NaN,23960.025027411724,NaN,NaN,23946.475,24000.083977794147,23892.86602220585,23898.621856245576,23944.427659509405,23973.18998192127,23915.66533709754,13697,10359.266666666666,35.88752231813561,39.874273398930946,NaN,NaN,NaN,NaN,18.18890550781061,24.69255333418522,-176336
2025-09-10T13:25:00-04:00,23897.25,23897.5,23875.5,23884.25,NaN,NaN,NaN,23943.96707162028,NaN,NaN,23944,23997.44483136754,23890.55516863246,23898.621856245576,23943.58714805525,23972.981602721236,23914.19269338926,13941,10376.5,31.992797414062835,39.5058148537798,NaN,NaN,NaN,NaN,18.478983685824137,25.955259061492686,-190277
2025-09-10T13:30:00-04:00,23884.25,23898,23877.5,23896.25,NaN,NaN,NaN,23943.96707162028,NaN,NaN,23941.79,23993.792053802536,23889.787946197466,23898.621856245576,23943.03863609863,23972.768500513444,23913.308771683816,10177,10381.833333333334,38.393024203566675,39.557878105540496,NaN,NaN,NaN,NaN,18.623341993979555,27.082742358542568,-180100
2025-09-10T13:35:00-04:00,23896.25,23906.25,23888.5,23891.25,NaN,NaN,NaN,23943.96707162028,NaN,NaN,23939.655,23991.01216990213,23888.29783009787,23898.621856245576,23942.547779159882,23972.513525852177,23912.582032467588,10224,10357.166666666666,36.83740628124412,39.573537864143645,NaN,NaN,NaN,NaN,18.560960422981015,27.391205387595193,-190324
2025-09-10T13:40:00-04:00,23890.75,23907.25,23887.75,23899.5,NaN,NaN,NaN,23943.96707162028,NaN,NaN,23938.39,23990.519469595274,23886.260530404725,23898.621856245576,23942.177057364897,23972.289528441277,23912.064586288518,8370,10334.433333333332,41.07954927288537,39.59992341343932,NaN,NaN,NaN,NaN,18.628034678482372,27.5891107052682,-181954
2025-09-10T13:45:00-04:00,23899.25,23905.5,23893.25,23902.5,NaN,NaN,NaN,23943.96707162028,NaN,NaN,23937.635,23990.719574974824,23884.550425025172,23898.621856245576,23941.92647024784,23972.121198808272,23911.731741687407,6049,9865.466666666667,42.58951995680224,40.01430137082845,NaN,NaN,NaN,NaN,18.172460772876487,27.77287992882171,-175905
2025-09-10T13:50:00-04:00,23903,23909.75,23881.5,23891.5,NaN,NaN,NaN,23943.96707162028,NaN,NaN,23936.85,23991.457600205904,23882.242399794093,23895.722987997167,23941.43332493948,23971.856332746327,23911.010317132634,10536,9661.4,38.67573348484093,40.386350729116025,NaN,NaN,NaN,NaN,18.892285003385307,28.511658274113337,-186441
2025-09-10T13:55:00-04:00,23891.5,23898.75,23881.5,23898,NaN,NaN,NaN,23943.96707162028,NaN,NaN,23935.92,23991.549078730513,23880.290921269483,23895.722987997167,23941.058044719546,23971.661209451737,23910.454879987356,7913,9396,42.0637839064126,41.026525533473446,NaN,NaN,NaN,NaN,18.77497893171493,29.19766673759842,-178528
2025-09-10T14:00:00-04:00,23897.5,23899.75,23890.25,23892.75,NaN,NaN,NaN,23943.96707162028,NaN,NaN,23935.455,23992.12136479896,23878.788635201043,23888.153390397736,23940.820229485333,23971.526425949236,23910.11403302143,5242,9148.833333333334,40.13505158588002,41.11777982953512,NaN,NaN,NaN,NaN,18.112480436592435,29.725006741887245,-183770
2025-09-10T14:05:00-04:00,23892.25,23892.25,23880.25,23882,NaN,NaN,NaN,23941.637235670252,NaN,NaN,23934.48,23993.081180876463,23875.878819123536,23872.522712318187,23940.464580480257,23971.39460221685,23909.534558743664,6596,8990.2,36.449603691599584,40.46821739163899,NaN,NaN,NaN,NaN,17.71158897683583,30.699004213306303,-190366
2025-09-10T14:10:00-04:00,23882.25,23890.25,23877,23887.75,NaN,NaN,NaN,23938.301452230695,NaN,NaN,23932.98,23992.4430843454,23873.5169156546,23861.597802372424,23940.128190180814,23971.263518883636,23908.992861477993,6336,8911.2,39.64219935935466,39.90511827872798,NaN,NaN,NaN,NaN,17.392904049918986,31.749359652463717,-184030
2025-09-10T14:15:00-04:00,23888,23888.25,23857.25,23861.75,NaN,NaN,NaN,23929.168431674756,NaN,NaN,23931.13,23993.514873164953,23868.74512683505,23861.597802372424,23939.28232688091,23971.176615108776,23907.388038653047,12588,8973.9,31.850501285870166,38.71758256689698,NaN,NaN,NaN,NaN,18.36483947492477,33.469449467694226,-196618
2025-09-10T14:20:00-04:00,23861.25,23871.25,23856,23862.75,NaN,NaN,NaN,23919.558502962267,NaN,NaN,23929.215,23993.95555993184,23864.47444006816,23861.597802372424,23938.50056571004,23971.143140555585,23905.857990864497,10996,9046.4,32.40083615886459,37.76077010346317,NaN,NaN,NaN,NaN,18.142350941001574,35.1072160678202,-185622
2025-09-10T14:25:00-04:00,23863.25,23865.25,23845.5,23858,NaN,NaN,NaN,23911.45925282762,NaN,NaN,23926.98,23993.655620732603,23860.304379267396,23861.597802372424,23937.476972970602,23971.172975958227,23903.780969982978,13462,9255,31.115492269741154,37.07950151351859,NaN,NaN,NaN,NaN,18.25718301664432,36.95232164286056,-199084
2025-09-10T14:30:00-04:00,23857.75,23879,23854.5,23878,NaN,NaN,NaN,23911.45925282762,NaN,NaN,23924.89,23991.022379361675,23858.757620638324,23861.597802372424,23936.84992965242,23971.002455276997,23902.697404027844,10223,9146.133333333333,41.617388156041734,37.4887776447976,NaN,NaN,NaN,NaN,18.70309851545544,37.19358915020591,-188861
2025-09-10T14:35:00-04:00,23877.75,23880,23858.25,23866.5,NaN,NaN,NaN,23911.45925282762,NaN,NaN,23922.93,23990.051981494315,23855.808018505686,23860.50324189794,23936.255605603375,23970.84906112093,23901.66215008582,9543,9155.666666666666,38.02738266877722,37.919819448705766,NaN,NaN,NaN,NaN,18.92073433578005,37.31809204977354,-198404
2025-09-10T14:40:00-04:00,23867.25,23877,23860.5,23861,NaN,NaN,NaN,23911.45925282762,NaN,NaN,23920.77,23988.768002913544,23852.771997086456,23856.58207481468,23935.87532546704,23970.756882674108,23900.993768259974,6009,9092.1,36.40972285428466,37.77815506661419,NaN,NaN,NaN,NaN,18.74782474036719,37.43370188508635,-204413
2025-09-10T14:45:00-04:00,23861.5,23867.25,23840.5,23848.25,NaN,NaN,NaN,23911.45925282762,NaN,NaN,23918.31,23987.71025648254,23848.909743517463,23856.58207481468,23935.037609891024,23970.732606107886,23899.342613674162,11173,9114.033333333333,32.914242939780536,37.4979291136525,NaN,NaN,NaN,NaN,19.31940868748382,38.35757948734138,-215586
2025-09-10T14:50:00-04:00,23848,23848.5,23835.75,23844.75,NaN,NaN,NaN,23899.19399213167,NaN,NaN,23915.66,23985.968446148465,23845.351553851535,23851.465659851743,23934.27643172847,23970.787702975456,23897.765160481486,9329,8939.3,32.00587522817638,36.84980953903043,NaN,NaN,NaN,NaN,18.850165209806402,39.37745543955241,-224915
2025-09-10T14:55:00-04:00,23845.25,23867.75,23843.75,23862.5,NaN,NaN,NaN,23899.19399213167,NaN,NaN,23913.355,23982.922886987093,23843.787113012906,23850.997527881394,23933.560291861035,23970.636817931485,23896.483765790585,10691,9054.9,40.91205934100109,36.729990923616064,NaN,NaN,NaN,NaN,19.218010551963086,38.51176088438275,-214224
2025-09-10T15:00:00-04:00,23862.25,23866.5,23838.75,23842,NaN,NaN,NaN,23899.19399213167,NaN,NaN,23910.8,23981.27318639218,23840.32681360782,23841.348022305116,23932.86061751845,23970.56870691656,23895.15252812034,9510,9176.1,35.18061708892374,36.48033975247912,NaN,NaN,NaN,NaN,19.82743836968001,37.93881179914159,-223734
2025-09-10T15:05:00-04:00,23842,23850.25,23824.25,23829.25,NaN,NaN,NaN,23897.024740433077,NaN,NaN,23908.05,23980.284479302973,23835.815520697026,23829.95618742022,23931.79102424836,23970.654857804624,23892.927190692095,12634,9410.3,32.162707731249284,35.77312002568174,NaN,NaN,NaN,NaN,20.26833562898858,38.011903426218055,-236368
2025-09-10T15:10:00-04:00,23828.75,23833.75,23805,23806.75,NaN,NaN,NaN,23880.35316132248,NaN,NaN,23904.775,23980.16632907361,23829.383670926392,23829.95618742022,23930.37323225833,23971.059528910104,23889.686935606558,14286,9529.4,27.654306788804078,34.88163825446203,NaN,NaN,NaN,NaN,20.87416879834654,38.72673967347801,-250654
2025-09-10T15:15:00-04:00,23806.75,23823.25,23801.25,23819.25,NaN,NaN,NaN,23873.456426716915,NaN,NaN,23901.81,23978.745658830296,23824.874341169707,23829.95618742022,23929.04485083486,23971.334710876028,23886.754990793692,13638,9682.933333333332,33.25213402877593,34.65324756426035,NaN,NaN,NaN,NaN,20.954585312750357,39.502612757005984,-237016
2025-09-10T15:20:00-04:00,23819.25,23819.25,23785,23805,NaN,NaN,NaN,23865.219770957054,NaN,NaN,23898.53,23977.679708781427,23819.38029121857,23829.889949936176,23927.310561103877,23971.79937318481,23882.821749022944,16596,9987.233333333334,30.367411064939347,33.99076268608783,NaN,NaN,NaN,NaN,21.904257790411044,40.66773908066289,-253612
2025-09-10T15:25:00-04:00,23805.25,23815.5,23801.25,23810,NaN,NaN,NaN,23865.219770957054,NaN,NaN,23895.96,23978.04199315276,23813.878006847237,23828.661959948942,23926.46563716332,23971.901848401783,23881.02942592486,8664,9974.733333333334,32.5775961576293,34.042698034070625,NaN,NaN,NaN,NaN,21.35752509109597,41.74964209548716,-244948
2025-09-10T15:30:00-04:00,23810.5,23839.75,23809.5,23830,NaN,NaN,NaN,23865.219770957054,NaN,NaN,23893.86,23977.202315781637,23810.517684218365,23817.34092349386,23925.257997284752,23971.721909239983,23878.794085329522,14833,10087.1,40.687357120751045,34.63459238849108,NaN,NaN,NaN,NaN,21.9927018703034,40.7943967715461,-230115
2025-09-10T15:35:00-04:00,23830,23840.5,23812,23814.5,NaN,NaN,NaN,23865.219770957054,NaN,NaN,23891.3,23976.35468829048,23806.245311709517,23817.34092349386,23924.460173548166,23971.615656671493,23877.30469042484,9600,10163.866666666667,36.97539893640787,35.05315715039585,NaN,NaN,NaN,NaN,22.457508879567445,39.8539146833434,-239715
2025-09-10T15:40:00-04:00,23814.75,23863.75,23808.25,23863,NaN,NaN,NaN,23865.219770957054,NaN,NaN,23889.895,23974.450844861996,23805.339155138005,23817.34092349386,23923.450643281285,23971.143272282152,23875.758014280418,15937,10543.6,51.79484059871075,35.78011803915792,NaN,NaN,NaN,NaN,24.8176868167412,37.49515674271388,-223778
2025-09-10T15:45:00-04:00,23863,23867.75,23852.25,23863,23791.91943770714,23791.91943770714,23791.91943770714,NaN,NaN,NaN,23888.185,23971.378137335414,23804.99186266459,23812.297738795085,23922.85282562958,23970.704573417006,23875.001077842153,12124,10697.233333333334,51.79484059871075,36.76350789129602,NaN,NaN,NaN,NaN,24.152137758402546,35.08125819576921,-223778
2025-09-10T15:50:00-04:00,23863.5,23882.5,23863.5,23870,23805.35491781136,NaN,NaN,NaN,NaN,NaN,23886.48,23967.573208099493,23805.386791900506,23816.19151805489,23922.21356241635,23970.09993675262,23874.32718808008,16124,10778.133333333333,53.620312782868965,37.992835743337764,NaN,NaN,NaN,NaN,23.819842204230934,33.0832847269566,-207654
2025-09-10T15:55:00-04:00,23869.25,23892.75,23869,23873.75,23813.066057910844,NaN,NaN,NaN,NaN,NaN,23884.755,23963.143487037185,23806.366512962817,23827.828214443914,23921.58835877916,23969.413532241488,23873.763185316835,18611,10933.8,54.61192388836189,39.54267009680786,NaN,NaN,NaN,NaN,23.814853475357296,31.708185710481278,-189043
2025-09-10T16:00:00-04:00,23874.5,23885.5,23866.25,23880.75,23813.066057910844,NaN,NaN,NaN,NaN,NaN,23883.01,23957.705914215097,23808.3140857849,23827.828214443914,23921.271224015254,23969.06950903451,23873.472938995998,9428,10908.833333333334,56.48230829591606,41.29098674450355,NaN,NaN,NaN,NaN,23.488792512831772,30.26477996437653,-179615
2025-09-10T16:05:00-04:00,23880.75,23881.5,23872.5,23878.5,23813.066057910844,NaN,NaN,NaN,NaN,NaN,23881.585,23953.811353224042,23809.358646775956,23827.828214443914,23921.1687064769,23968.95784613762,23873.37956681618,3077,10670.6,55.687944489497816,42.34640711225332,NaN,NaN,NaN,NaN,22.453878761915217,28.924474628707834,-182692
2025-09-10T16:10:00-04:00,23878.75,23879,23870,23871,23813.066057910844,NaN,NaN,NaN,NaN,NaN,23880.355,23951.15168706845,23809.55831293155,23831.500045795285,23921.088772751045,23968.87792285617,23873.29962264592,2199,10464.9,53.011603879597004,43.62004902587284,NaN,NaN,NaN,NaN,21.492887421778416,27.511560938604447,-184891
2025-09-10T16:15:00-04:00,23871.25,23876,23867,23869.75,23813.066057910844,NaN,NaN,NaN,NaN,NaN,23879.105,23948.383213747606,23809.826786252394,23833.500036636226,23921.003934233755,23968.79713878291,23873.2107296846,2229,10337.566666666668,52.558232209852996,45.07687220291596,NaN,NaN,NaN,NaN,20.600538320222817,25.992277684233045,-187120
2025-09-10T16:20:00-04:00,23870,23870.5,23865,23868.75,23813.066057910844,NaN,NaN,NaN,NaN,NaN,23877.825,23945.436186204934,23810.213813795068,23833.75002930898,23920.94694778401,23968.745935512197,23873.147960055823,1421,10033.733333333334,52.17380807909418,46.82826515222239,NaN,NaN,NaN,NaN,19.5219284402069,24.439360573874346,-188541
2025-09-10T16:25:00-04:00,23868.5,23875.5,23868.5,23874.5,23813.750762649695,NaN,NaN,NaN,NaN,NaN,23876.925,23943.483038585313,23810.366961414686,23842.600023447187,23920.902580038502,23968.70183826202,23873.103321814986,1218,9810.566666666668,54.24609819478793,48.32783402122325,NaN,NaN,NaN,NaN,18.62750498019212,23.32572837449948,-187323
2025-09-10T16:30:00-04:00,23873.75,23875,23869.25,23871,23815.73936434744,NaN,NaN,NaN,NaN,NaN,23875.935,23941.333456402597,23810.536543597405,23845.805018757746,23920.864800366755,23968.66509856397,23873.064502169538,1016,9669.7,52.74788141286693,49.92643904607521,NaN,NaN,NaN,NaN,17.707683195892685,22.291641332222817,-188339
2025-09-10T16:35:00-04:00,23871.25,23874,23869.5,23870.5,23817.313711422554,NaN,NaN,NaN,NaN,NaN,23875,23939.337158780763,23810.662841219237,23848.394015006197,23920.835589950013,23968.63691862791,23873.034261272114,780,9475.833333333334,52.52470084281571,51.35123223787424,NaN,NaN,NaN,NaN,16.76427725332892,21.331417650108772,-189119
2025-09-10T16:40:00-04:00,23871.25,23871.25,23866.5,23867.75,23817.313711422554,NaN,NaN,NaN,NaN,NaN,23873.86,23936.631582740676,23811.088417259325,23848.394015006197,23920.78822874892,23968.593831673985,23872.982625823854,1198,9304.566666666668,51.24056016581636,52.10503245537891,NaN,NaN,NaN,NaN,15.906114592376854,20.169760317835763,-190317
2025-09-10T16:45:00-04:00,23867.75,23868,23857.5,23857.75,23817.313711422554,NaN,NaN,NaN,NaN,NaN,23872.75,23934.652988619444,23810.847011380556,23848.394015006197,23920.72673035303,23968.546073901383,23872.90738680468,1365,8930.466666666667,46.76335809875226,52.80417239554636,NaN,NaN,NaN,NaN,15.51996355006422,19.124173349933358,-191682
2025-09-10T16:50:00-04:00,23858,23863.5,23857.5,23859.5,23817.313711422554,NaN,NaN,NaN,NaN,NaN,23871.895,23933.32366513128,23810.46633486872,23848.394015006197,23920.679058063568,23968.509741959093,23872.848374168043,1044,8598.733333333334,47.62580608145544,52.50638421574241,NaN,NaN,NaN,NaN,14.839966153631062,18.153271165452548,-190638
2025-09-10T16:55:00-04:00,23859.25,23863,23856.75,23859,23817.313711422554,NaN,NaN,NaN,NaN,NaN,23871.055,23932.01558480839,23810.094415191612,23848.394015006197,23920.630771964323,23968.473367587125,23872.78817634152,1049,8184.966666666666,47.389583295766464,52.19172297981782,NaN,NaN,NaN,NaN,14.226397142657415,17.31687560805903,-191687
2025-09-10T18:00:00-04:00,23856.75,23878.5,23851.5,23875,23817.313711422554,NaN,NaN,NaN,NaN,NaN,23870.335,23930.232546696137,23810.43745330386,23848.52863083723,23868.33333333333,23868.333678600313,23868.332988066344,3182,7950.266666666666,55.069482646054205,52.29523511290248,NaN,NaN,NaN,NaN,15.138797346753313,16.964627443113407,-188505
2025-09-10T18:05:00-04:00,23875,23879.25,23870,23871,23825.480723857607,NaN,NaN,NaN,NaN,NaN,23869.27,23927.154958320887,23811.385041679114,23850.647904669786,23869.777709036367,23872.070310636227,23867.485107436507,1263,7674.266666666666,52.98701652073775,52.17917030092933,NaN,NaN,NaN,NaN,14.718168964842361,16.69469931589295,-189768
2025-09-10T18:10:00-04:00,23871.75,23880,23869.25,23871.25,23826.248645500444,NaN,NaN,NaN,NaN,NaN,23868.125,23923.48818722744,23812.76181277256,23851.743323735827,23870.382896885203,23872.890466587578,23867.87532718283,863,7502.733333333334,53.10637285604673,51.938032055224376,NaN,NaN,NaN,NaN,14.434728324496477,16.444051769188242,-188905
2025-09-10T18:15:00-04:00,23872,23874.25,23867.75,23873.5,23826.248645500444,NaN,NaN,NaN,NaN,NaN,23866.985,23919.434443275437,23814.535556724564,23851.743323735827,23870.556776101253,23872.955958159324,23868.157594043183,723,7154.4,54.23256230684195,51.834076185034675,NaN,NaN,NaN,NaN,13.86796201560387,16.0435826872147,-188182
2025-09-10T18:20:00-04:00,23873.75,23879,23869.75,23871.5,23828.189106747304,NaN,NaN,NaN,NaN,NaN,23865.925,23915.759149938716,23816.090850061282,23853.69072719093,23870.880569033965,23873.31481431807,23868.44632374986,770,6869.1,53.013800792736106,51.83423310740175,NaN,NaN,NaN,NaN,13.53810758591788,16.092530343692786,-188952
2025-09-10T18:25:00-04:00,23871.75,23876,23869.75,23873.75,23828.189106747304,NaN,NaN,NaN,NaN,NaN,23865.165,23913.310987370816,23817.019012629185,23853.69072719093,23871.019483957098,23873.44100396735,23868.597963946846,440,6527.4,54.25917483302257,51.95572900905672,NaN,NaN,NaN,NaN,13.017528472638032,16.137981738993865,-188512
2025-09-10T18:30:00-04:00,23874,23879,23874,23877.5,23832.88795676769,NaN,NaN,NaN,NaN,NaN,23864.76,23912.137311026134,23817.382688973863,23857.677065402197,23871.521942551943,23874.354916406726,23868.68896869716,685,6233.233333333334,56.33639493233492,52.25305664143106,NaN,NaN,NaN,NaN,12.462705010306745,16.45476783435853,-187827
2025-09-10T18:35:00-04:00,23878,23880,23876.5,23878.75,23836.143049641883,NaN,NaN,NaN,NaN,NaN,23864.65,23911.87107580227,23817.42892419773,23861.191652321755,23872.03334890784,23875.3036565867,23868.76304122898,635,5833.266666666666,57.03678300686008,52.45239127086479,NaN,NaN,NaN,NaN,11.822511795284836,16.84141105582824,-187192
2025-09-10T18:40:00-04:00,23879,23887,23878.75,23886.25,23841.55700193089,NaN,NaN,NaN,NaN,NaN,23864.45,23911.216547874883,23817.68345212512,23867.828321857403,23873.794132297273,23878.99908917504,23868.589175419507,1477,5406.3,61.071581473494106,53.0469412751953,NaN,NaN,NaN,NaN,11.567332381335918,17.811207111291136,-185715
2025-09-10T18:45:00-04:00,23886.5,23899,23886,23898.75,23851.287365479486,NaN,NaN,NaN,NaN,NaN,23864.6,23911.75591161567,23817.444088384327,23877.162657485926,23877.085261892786,23886.05137257795,23868.119151207622,1888,5014.633333333333,66.68689047531959,54.05852624894562,NaN,NaN,NaN,NaN,11.669665782669068,19.547121506834074,-183827
2025-09-10T18:50:00-04:00,23898.5,23899.5,23890.25,23892.5,23854.274303412236,NaN,NaN,NaN,NaN,NaN,23864.46,23911.240696878365,23817.679303121633,23877.40512598874,23878.680324443434,23888.550287529095,23868.810361357773,1235,4502.6,61.88053747779664,54.81852462837279,NaN,NaN,NaN,NaN,11.49683251247842,21.18999334204976,-185062
2025-09-10T18:55:00-04:00,23892.75,23908.5,23892.5,23897.25,23859.562971438954,NaN,NaN,NaN,NaN,NaN,23864.355,23910.816176267235,23817.893823732764,23882.824100790993,23882.254611579257,23894.16959494411,23870.339628214406,2741,4305.166666666667,64.00392204223752,56.049993481478886,NaN,NaN,NaN,NaN,11.818487333015677,23.235545268216438,-182321
2025-09-10T19:00:00-04:00,23897.25,23899,23892,23897.25,23859.562971438954,NaN,NaN,NaN,NaN,NaN,23864.47,23911.226886122986,23817.713113877016,23882.824100790993,23883.262418376868,23895.284964027553,23871.239872726183,1250,3852.4,64.00392204223752,57.21985890724903,NaN,NaN,NaN,NaN,11.474309666371699,25.054459492829107,-182321
2025-09-10T19:05:00-04:00,23897.5,23909.75,23896.75,23908.5,23863.26605455491,NaN,NaN,NaN,NaN,NaN,23864.68,23912.12660577844,23817.23339422156,23884.017424506234,23885.035180722894,23898.002319951967,23872.06804149382,1523,3583.1666666666665,68.78068353480272,58.74779463860876,NaN,NaN,NaN,NaN,11.583287547345149,27.287122568118257,-180798
2025-09-10T19:10:00-04:00,23908,23909.75,23900,23902.25,23865.378961166054,NaN,NaN,NaN,NaN,NaN,23864.87,23912.837930953894,23816.902069046104,23884.288939604987,23886.20976491863,23899.57496898562,23872.844560851638,1233,3093.0333333333333,63.721542010119386,59.36579887889913,NaN,NaN,NaN,NaN,11.452338436820495,29.36030970945818,-182031
2025-09-10T19:15:00-04:00,23902.75,23913.5,23901.25,23905.25,23868.00378111305,NaN,NaN,NaN,NaN,NaN,23865.335,23914.396452283425,23816.273547716573,23887.00615168399,23887.845333826295,23901.814247801845,23873.876419850745,1730,2746.5666666666666,65.05039970353819,60.227469106242,NaN,NaN,NaN,NaN,11.509314262761889,31.462122480926247,-180301
2025-09-10T19:20:00-04:00,23906,23908.5,23903.75,23904.5,23868.00378111305,NaN,NaN,NaN,NaN,NaN,23865.67,23915.56082481184,23815.779175188156,23887.00615168399,23888.34717232501,23902.427646322078,23874.266698327945,630,2230.1,64.41515304259963,61.03523911956721,NaN,NaN,NaN,NaN,11.02650610113604,33.41380576871803,-180931
2025-09-10T19:25:00-04:00,23904.75,23906,23898.25,23901,23868.00378111305,NaN,NaN,NaN,NaN,NaN,23866.455,23917.300421616474,23815.60957838353,23887.00615168399,23888.82319097944,23902.87209486997,23874.774287088912,820,1637.0666666666666,61.40170097346908,61.54732045289772,NaN,NaN,NaN,NaN,10.792469951054894,34.229596656902366,-181751
2025-09-10T19:30:00-04:00,23901.25,23903.5,23898.75,23901.5,23868.00378111305,NaN,NaN,NaN,NaN,NaN,23867.23,23918.998797551838,23815.46120244816,23887.00615168399,23889.16244663521,23903.16545216632,23875.159441104104,648,1344.4,61.67751512797983,62.166157191129415,NaN,NaN,NaN,NaN,10.360864954550973,34.98711676735926,-181103
2025-09-10T19:35:00-04:00,23901.5,23904.25,23900.5,23901,23868.00378111305,NaN,NaN,NaN,NaN,NaN,23868.09,23920.639667933003,23815.540332066998,23887.00615168399,23889.380052178236,23903.36099348226,23875.399110874212,412,1255.5666666666666,61.206504566797726,62.66239502925621,NaN,NaN,NaN,NaN,9.888660314940187,35.744529026746186,-181515
2025-09-10T19:40:00-04:00,23901.25,23901.25,23893.5,23898.25,23868.00378111305,NaN,NaN,NaN,NaN,NaN,23868.495,23921.652547914153,23815.337452085845,23887.00615168399,23889.73228257996,23903.51462465597,23875.94994050395,1072,1218,58.557786105546036,62.821065827342714,NaN,NaN,NaN,NaN,9.73589886387303,35.18878540470769,-182587
2025-09-10T19:45:00-04:00,23898,23899.5,23893.75,23896,23868.00378111305,NaN,NaN,NaN,NaN,NaN,23869.085,23922.79287745189,23815.377122548107,23887.00615168399,23889.850995741806,23903.53890510583,23876.163086377783,456,1158.9,56.406959411153494,62.776078427649395,NaN,NaN,NaN,NaN,9.451191802167813,34.67273775567193,-183043
2025-09-10T19:50:00-04:00,23897.25,23899,23892.25,23897.5,23868.00378111305,NaN,NaN,NaN,NaN,NaN,23869.815,23924.053068736466,23815.57693126353,23887.00615168399,23890.041065175217,23903.567848859224,23876.51428149121,786,1137.7333333333333,57.52698333999267,62.522892846685004,NaN,NaN,NaN,NaN,9.258249530584397,33.92656572412028,-182257
2025-09-10T19:55:00-04:00,23896.75,23901.5,23895,23900.75,23868.00378111305,NaN,NaN,NaN,NaN,NaN,23870.865,23925.42425310662,23816.305746893384,23887.00615168399,23890.194574464134,23903.656820277512,23876.732328650756,457,1112.3666666666666,59.9292144196771,62.0402016998534,NaN,NaN,NaN,NaN,9.061231706971226,33.50331539626042,-181800
2025-09-10T20:00:00-04:00,23900.5,23905.75,23892.25,23895,23868.00378111305,NaN,NaN,NaN,NaN,NaN,23871.87,23926.319172633164,23817.420827366834,23887.00615168399,23890.658260743323,23903.8201478666,23877.496373620044,1781,1137.8666666666666,54.09929628279062,61.48439875735296,NaN,NaN,NaN,NaN,9.378286585044709,33.54012507003499,-183581
2025-09-10T20:05:00-04:00,23895.25,23897.75,23887.25,23887.25,23868.00378111305,NaN,NaN,NaN,NaN,NaN,23872.365,23926.91435471759,23817.81564528241,23885.927119729764,23890.662463705477,23903.519329669194,23877.80559774176,1378,1157.8,47.40551818677993,60.29879848196314,NaN,NaN,NaN,NaN,9.458408971827229,32.65769079478339,-184959
2025-09-10T20:10:00-04:00,23887.75,23892,23882,23883,23868.00378111305,NaN,NaN,NaN,NaN,NaN,23873.185,23927.11298994792,23819.257010052082,23885.927119729764,23890.458540616964,23903.08901359208,23877.828067641847,1280,1160.5333333333333,44.177383846662764,58.88261718227922,NaN,NaN,NaN,NaN,9.497094045268142,30.992617239092446,-186239
2025-09-10T20:15:00-04:00,23883.75,23883.75,23870.75,23877,23868.00378111305,NaN,NaN,NaN,NaN,NaN,23874.14,23926.59304186067,23821.68695813933,23885.927119729764,23889.58455980933,23902.229414289806,23876.939705328852,2207,1188.6,40.03275899007908,56.829194000513255,NaN,NaN,NaN,NaN,9.747301613463275,29.5481699554549,-188446
2025-09-10T20:20:00-04:00,23877,23889.25,23875.75,23885.5,23868.00378111305,NaN,NaN,NaN,NaN,NaN,23875.715,23924.58636278009,23826.84363721991,23885.927119729764,23889.325106959503,23901.758356176324,23876.89185774268,1495,1203.6333333333334,47.54129333200943,55.67346195207683,NaN,NaN,NaN,NaN,10.015351498215898,27.508188278086454,-186951
2025-09-10T20:25:00-04:00,23884.5,23892,23884,23884.75,23868.00378111305,NaN,NaN,NaN,NaN,NaN,23877.025,23923.209548279803,23830.8404517202,23885.17675859305,23889.243732660903,23901.472879882564,23877.014585439243,1226,1209.5333333333333,46.98230537973226,54.382883786090694,NaN,NaN,NaN,NaN,9.871397819771904,25.80015012696071,-188177
2025-09-10T20:30:00-04:00,23884.5,23897.75,23881.5,23893.75,23868.00378111305,NaN,NaN,NaN,NaN,NaN,23878.8,23920.366573111212,23837.233426888786,23885.17675859305,23889.301087236636,23901.33294280211,23877.269231671162,1225,1144.3,53.975651656839396,53.637205115679244,NaN,NaN,NaN,NaN,10.327012261216767,24.85267813971806,-186952
2025-09-10T20:35:00-04:00,23893.25,23900,23890.75,23899.25,23868.00378111305,NaN,NaN,NaN,NaN,NaN,23880.585,23917.596026736912,23843.573973263086,23885.17675859305,23889.465794869127,23901.412106768024,23877.51948297023,858,1130.8,57.65188555394385,53.369361157141725,NaN,NaN,NaN,NaN,10.250082813986998,24.207840680327934,-186094
2025-09-10T20:40:00-04:00,23899.25,23902,23895.25,23901.5,23868.00378111305,NaN,NaN,NaN,NaN,NaN,23882.015,23916.5392537924,23847.490746207597,23885.17675859305,23889.686840360988,23901.594147150434,23877.779533571542,857,1130.6,59.09145952073818,53.18464289948161,NaN,NaN,NaN,NaN,10.000076898702213,23.817999269899,-185237
2025-09-10T20:45:00-04:00,23900.75,23908.25,23899,23908,23870.95929071437,NaN,NaN,NaN,NaN,NaN,23883.885,23913.334823436304,23854.435176563693,23885.17675859305,23890.188082671535,23902.214479511727,23878.161685831343,1320,1150.5,63.00409251446779,53.3130420386009,NaN,NaN,NaN,NaN,9.946499977366342,24.063655980644437,-183917
2025-09-10T20:50:00-04:00,23908.25,23912.75,23900,23902.25,23873.455459318262,NaN,NaN,NaN,NaN,NaN,23884.67,23913.943100281667,23855.39689971833,23886.62312035261,23890.63518943743,23902.74679348721,23878.52358538765,1262,1166.9,57.742803438088686,53.25482899092537,NaN,NaN,NaN,NaN,10.146749978983033,24.6819226136156,-185179
2025-09-10T20:55:00-04:00,23902.5,23907.25,23900.25,23904.75,23873.455459318262,NaN,NaN,NaN,NaN,NaN,23885.505,23914.639428086397,23856.370571913605,23886.62312035261,23890.868460019745,23903.002260031724,23878.734660007765,738,1176.8333333333333,59.332899845849624,53.463824736260804,NaN,NaN,NaN,NaN,9.921982123341389,25.25602734423168,-184441
2025-09-10T21:00:00-04:00,23904.5,23908.75,23898.75,23905.75,23873.455459318262,NaN,NaN,NaN,NaN,NaN,23886.22,23915.551321139752,23856.88867886025,23886.62312035261,23891.247627805322,23903.417341888664,23879.07791372198,1225,1194.8333333333333,59.98157526165233,53.63915273066507,NaN,NaN,NaN,NaN,9.927554828817005,25.78912459408947,-183216
2025-09-10T21:05:00-04:00,23906.25,23909.75,23904.75,23909.25,23875.765320599778,NaN,NaN,NaN,NaN,NaN,23886.93,23916.734368803587,23857.125631196413,23887.633037620537,23891.55342685416,23903.816739001395,23879.290114706924,818,1200.9333333333334,62.25113125821704,53.80500393341792,NaN,NaN,NaN,NaN,9.575586626758648,26.382255556439926,-182398
2025-09-10T21:10:00-04:00,23909.5,23911.75,23905,23906.5,23877.40098784524,NaN,NaN,NaN,NaN,NaN,23887.445,23917.691039415025,23857.198960584974,23890.68143009643,23891.841001211586,23904.1817326492,23879.500269773973,806,1178.5666666666666,59.40062962346684,54.183670600609084,NaN,NaN,NaN,NaN,9.373759010561601,27.131305210218308,-183204
2025-09-10T21:15:00-04:00,23906.75,23909,23902.75,23907.25,23877.40098784524,NaN,NaN,NaN,NaN,NaN,23888.02,23918.65459481948,23857.38540518052,23890.68143009643,23892.06139180551,23904.435682270745,23879.687101340274,701,1139,59.93940127327213,55.07894796392994,NaN,NaN,NaN,NaN,9.150633366950059,27.35218810154941,-182503
2025-09-10T21:20:00-04:00,23907,23910,23902,23904,23877.40098784524,NaN,NaN,NaN,NaN,NaN,23888.68,23919.241256516012,23858.11874348399,23890.68143009643,23892.266622170013,23904.65358852279,23879.879655817236,724,1121.9666666666667,56.4439017689177,55.95512781551958,NaN,NaN,NaN,NaN,9.068445269310768,27.670485196867805,-183227
2025-09-10T21:25:00-04:00,23904.25,23913.25,23904,23911.5,23878.606397768104,NaN,NaN,NaN,NaN,NaN,23889.515,23920.242741535996,23858.787258464003,23892.63789220937,23892.62307024517,23905.126031282092,23880.120109208245,984,1063.4,61.957426406388734,57.52117548811314,NaN,NaN,NaN,NaN,9.081413464359999,28.32471036827462,-182243
2025-09-10T21:30:00-04:00,23910.75,23915.75,23909.25,23913.75,23882.959516051375,NaN,NaN,NaN,NaN,NaN,23890.415,23921.29292252983,23859.537077470173,23896.010313767496,23893.162342951393,23905.922551384232,23880.402134518554,1305,1065.2333333333333,63.452107786989615,58.65766223489744,NaN,NaN,NaN,NaN,8.897026788334285,29.1916204996907,-180938
2025-09-10T21:35:00-04:00,23913.25,23916.75,23905.75,23907.25,23882.959516051375,NaN,NaN,NaN,NaN,NaN,23891.07,23921.959163147178,23860.18083685282,23896.010313767496,23893.464195494234,23906.30380831313,23880.62458267534,901,1044.5,56.540857121176906,59.34041593071491,NaN,NaN,NaN,NaN,9.047239160596122,29.1963134153426,-181839
2025-09-10T21:40:00-04:00,23907.25,23914.75,23907.25,23911.75,23882.959516051375,NaN,NaN,NaN,NaN,NaN,23891.885,23922.76334355555,23861.006656444446,23896.010313767496,23893.69205208683,23906.605005313842,23880.779098859817,649,1025.0333333333333,59.80498126203732,59.75679661680048,NaN,NaN,NaN,NaN,8.9367220776964,29.200671122733652,-181190
2025-09-10T21:45:00-04:00,23911.5,23912,23904,23905.25,23882.959516051375,NaN,NaN,NaN,NaN,NaN,23892.58,23923.063510289132,23862.09648971087,23896.010313767496,23893.924530589284,23906.843847320906,23881.00521385766,895,997.2,53.54865222390929,59.463708521798004,NaN,NaN,NaN,NaN,8.869813357860943,28.474349133589982,-182085
2025-09-10T21:50:00-04:00,23905.25,23910.75,23902.75,23909.5,23882.959516051375,NaN,NaN,NaN,NaN,NaN,23893.415,23923.415601659148,23863.414398340854,23896.010313767496,23894.171379634394,23907.10358257998,23881.239176688807,943,1007.6333333333333,56.73558782007391,59.29543197175055,NaN,NaN,NaN,NaN,8.807683832299448,27.530157888810674,-181142
2025-09-10T21:55:00-04:00,23909.5,23910.5,23904,23907.5,23882.959516051375,NaN,NaN,NaN,NaN,NaN,23894.41,23922.873794540767,23865.946205459233,23896.010313767496,23894.319130268275,23907.253091062754,23881.385169473797,596,1000.1666666666666,54.82919418341305,58.7115106623895,NaN,NaN,NaN,NaN,8.642849272849487,26.653408875801315,-181738
2025-09-10T22:00:00-04:00,23907.5,23909.5,23902.75,23902.75,23882.959516051375,NaN,NaN,NaN,NaN,NaN,23895.275,23922.019391931943,23868.53060806806,23896.010313767496,23894.42864089133,23907.341031301035,23881.51625048162,550,996.9,50.489985249175895,58.193452220324296,NaN,NaN,NaN,NaN,8.507645753360238,25.547115366320327,-182288
2025-09-10T22:05:00-04:00,23903,23905,23900,23901.75,23882.959516051375,NaN,NaN,NaN,NaN,NaN,23896.13,23920.836727818976,23871.423272181026,23896.010313767496,23894.522421139234,23907.385367293893,23881.659474984575,651,1004.8666666666667,49.600022868011116,57.49824672190726,NaN,NaN,NaN,NaN,8.257099628120221,23.903976350945968,-182939
2025-09-10T22:10:00-04:00,23902.25,23907.25,23901.75,23904.75,23882.959516051375,NaN,NaN,NaN,NaN,NaN,23896.725,23920.792249542752,23872.657750457245,23896.010313767496,23894.636193814687,23907.470369407292,23881.802018222083,621,989.8333333333334,52.315520273224614,56.950671365591,NaN,NaN,NaN,NaN,8.060163940397349,22.82350606178524,-182318
2025-09-10T22:15:00-04:00,23905,23905.25,23900.5,23903.5,23882.959516051375,NaN,NaN,NaN,NaN,NaN,23897.375,23920.359179342282,23874.390820657718,23896.010313767496,23894.703337548555,23907.50839317668,23881.898281920432,440,989.3,51.08057344641594,56.15277437903377,NaN,NaN,NaN,NaN,7.823723658940395,21.533806517912375,-182758
2025-09-10T22:20:00-04:00,23903.75,23907.5,23902.25,23904.25,23882.959516051375,NaN,NaN,NaN,NaN,NaN,23898.035,23919.845779449024,23876.224220550976,23895.458251014,23894.806120229332,23907.584673280267,23882.027567178397,577,982.3333333333334,51.81552843836312,55.610981437240646,NaN,NaN,NaN,NaN,7.639886254730366,20.78986778413277,-182181
2025-09-10T22:25:00-04:00,23903.75,23912.25,23903.75,23910.75,23882.959516051375,NaN,NaN,NaN,NaN,NaN,23898.78,23919.714813107843,23877.845186892155,23895.690661940764,23895.017348514208,23907.81511984352,23882.219577184896,850,995.4333333333333,57.741149109665244,55.45396342555444,NaN,NaN,NaN,NaN,7.701322950821054,20.934910163938714,-181331
2025-09-10T22:30:00-04:00,23910.75,23916.5,23910,23915.25,23887.627687689852,NaN,NaN,NaN,NaN,NaN,23899.655,23919.589113971335,23879.720886028663,23900.00252955261,23895.27085432812,23908.16708911563,23882.37461954061,772,961.8,61.29034438194316,55.80013789791341,NaN,NaN,NaN,NaN,7.6155141686195496,21.69021338228773,-180559
2025-09-10T22:35:00-04:00,23915,23915.5,23906.75,23910.75,23887.627687689852,NaN,NaN,NaN,NaN,NaN,23900.395,23919.139089733682,23881.65091026632,23900.00252955261,23895.44250201929,23908.371862225646,23882.513141812935,635,937.0333333333333,56.20659459070791,55.38936419679335,NaN,NaN,NaN,NaN,7.69654887086101,21.594574181282304,-181194
2025-09-10T22:40:00-04:00,23911,23913,23905.75,23906.75,23887.627687689852,NaN,NaN,NaN,NaN,NaN,23900.98,23918.622800236702,23883.337199763297,23900.00252955261,23895.533418946372,23908.463356102646,23882.603481790098,408,907.9666666666667,52.07203886643255,54.57650213103927,NaN,NaN,NaN,NaN,7.664652522942367,21.27069015625476,-181602
2025-09-10T22:45:00-04:00,23907.25,23908.5,23900.5,23904,23887.627687689852,NaN,NaN,NaN,NaN,NaN,23901.485,23917.960560685548,23885.009439314454,23900.00252955261,23895.637155120083,23908.525699411643,23882.748610828523,699,857.7,49.38253400519371,54.06519333704047,NaN,NaN,NaN,NaN,7.688605914160769,19.850304497954173,-182301
2025-09-10T22:50:00-04:00,23903.75,23905.25,23901.25,23903,23887.627687689852,NaN,NaN,NaN,NaN,NaN,23901.82,23917.71372203733,23885.92627796267,23900.00252955261,23895.690362760535,23908.548765235522,23882.831960285548,422,821.9333333333333,48.403502806304886,53.25080201877387,NaN,NaN,NaN,NaN,7.425134063149286,18.531374958103626,-182723
2025-09-10T22:55:00-04:00,23903.25,23910,23903.25,23907.25,23887.627687689852,NaN,NaN,NaN,NaN,NaN,23901.99,23917.930501869087,23886.049498130917,23900.00252955261,23895.79626450604,23908.63900554395,23882.953523468128,573,800.1666666666666,52.69586063309178,53.18988833371548,NaN,NaN,NaN,NaN,7.394767344352908,18.174445228253546,-182150
2025-09-10T23:00:00-04:00,23907.5,23911,23904.75,23909,23887.627687689852,NaN,NaN,NaN,NaN,NaN,23902.32,23918.14372901477,23886.49627098523,23900.00252955261,23895.8769170347,23908.716923412558,23883.036910656843,393,772.4333333333333,54.378828916353584,53.021548412021176,NaN,NaN,NaN,NaN,7.3129982483277,18.010830488203133,-181757
2025-09-10T23:05:00-04:00,23909.25,23910.5,23906,23908.75,23887.627687689852,NaN,NaN,NaN,NaN,NaN,23902.55,23918.406544399873,23886.693455600125,23900.00252955261,23895.93348671512,23908.772029707,23883.094943723238,275,753,54.0828078217876,52.9682351004765,NaN,NaN,NaN,NaN,7.112069802018579,17.858902515299178,-182032
2025-09-10T23:10:00-04:00,23909,23909.75,23906.5,23908.75,23887.627687689852,NaN,NaN,NaN,NaN,NaN,23902.78,23918.655969263957,23886.90403073604,23900.00252955261,23895.984737469782,23908.821395799627,23883.148079139937,253,732.8666666666667,54.0828078217876,53.224865284234475,NaN,NaN,NaN,NaN,6.836207673302966,17.71782654045979,-182032
2025-09-10T23:15:00-04:00,23908.75,23912,23908.25,23910.75,23887.627687689852,NaN,NaN,NaN,NaN,NaN,23902.825,23918.77813449004,23886.871865509962,23900.00252955261,23896.049376040162,23908.893081892624,23883.2056701877,277,698.1,56.29044910857576,53.70275287284624,NaN,NaN,NaN,NaN,6.61576426806704,18.013071851218545,-181755
2025-09-10T23:20:00-04:00,23910.25,23912,23909.75,23911.75,23888.920745300013,NaN,NaN,NaN,NaN,NaN,23903.015,23919.161333953314,23886.868666046685,23900.426192159044,23896.087876747886,23908.937826246278,23883.237927249495,157,661.2666666666667,57.39347074101088,54.06546362054526,NaN,NaN,NaN,NaN,6.303923963205109,18.287228211208824,-181598
2025-09-10T23:25:00-04:00,23911.5,23915,23910.25,23914,23891.020938695467,NaN,NaN,NaN,NaN,NaN,23903.19,23919.616673442182,23886.763326557815,23903.365953727236,23896.189819891002,23909.06821033547,23883.311429446534,372,649.0666666666667,59.84860648881246,54.691751695002154,NaN,NaN,NaN,NaN,6.192929394404744,19.0936289118759,-181226
2025-09-10T23:30:00-04:00,23913.5,23914,23908.75,23911,23891.020938695467,NaN,NaN,NaN,NaN,NaN,23903.32,23919.88835537458,23886.75164462542,23903.365953727236,23896.29495708842,23909.18942991483,23883.40048426201,436,622.7666666666667,55.27507073090437,54.9388618587551,NaN,NaN,NaN,NaN,6.125577294804406,19.374651981599584,-181662
2025-09-10T23:35:00-04:00,23910.75,23916.75,23910.25,23914.25,23892.24557637335,NaN,NaN,NaN,NaN,NaN,23903.585,23920.418184490238,23886.75181550976,23903.95421038543,23896.424233153215,23909.357748585895,23883.490717720535,466,611.0333333333333,58.936114074542154,55.024216499103446,NaN,NaN,NaN,NaN,6.152321773746948,20.13444431880154,-181196
2025-09-10T23:40:00-04:00,23914.75,23916.75,23913.25,23914.5,23894.234413810922,NaN,NaN,NaN,NaN,NaN,23903.845,23920.940873768766,23886.749126231236,23904.763368308344,23896.532433008913,23909.504433987415,23883.560432030412,372,596.5666666666667,59.212694572545765,54.87581294128935,NaN,NaN,NaN,NaN,5.962870218479309,20.839965774774782,-180824
2025-09-10T23:45:00-04:00,23914.75,23918,23911.25,23916.25,23894.234413810922,NaN,NaN,NaN,NaN,NaN,23904.15,23921.57297332449,23886.72702667551,23905.035694646675,23896.70164417377,23909.73503471093,23883.668253636606,580,592.5333333333333,61.18357279977065,55.231311384793834,NaN,NaN,NaN,NaN,6.019093774302215,20.834925758356754,-180244
2025-09-10T23:50:00-04:00,23916,23919,23915.25,23917.25,23896.814310931026,NaN,NaN,NaN,NaN,NaN,23904.53,23922.24796829948,23886.812031700516,23906.75355571734,23896.83976223059,23909.93672129966,23883.74280316152,434,582.8666666666667,62.304483737614056,55.962200304163936,NaN,NaN,NaN,NaN,5.857015647566342,21.038889336536304,-179810
2025-09-10T23:55:00-04:00,23917.5,23918.75,23910.25,23913.5,23896.814310931026,NaN,NaN,NaN,NaN,NaN,23904.88,23922.60152362624,23887.158476373763,23906.75355571734,23896.99331982142,23910.132850551945,23883.853789090896,575,569.2333333333333,55.797412530336,56.42040591310267,NaN,NaN,NaN,NaN,6.045800244168746,19.764897235430524,-180385
2025-09-11T00:00:00-04:00,23913.5,23915.5,23909.5,23913,23896.814310931026,NaN,NaN,NaN,NaN,NaN,23905.19,23922.926561120355,23887.453438879642,23906.75355571734,23897.10913627277,23910.268670009238,23883.949602536304,483,541.8333333333334,54.9730102273299,56.88965644317589,NaN,NaN,NaN,NaN,6.0425287981566935,18.389806076025287,-180868
2025-09-11T00:05:00-04:00,23912.25,23915.5,23909.75,23913,23896.814310931026,NaN,NaN,NaN,NaN,NaN,23905.435,23923.257684966706,23887.612315033297,23906.75355571734,23897.201195926045,23910.376379975216,23884.026011876875,387,524.7,54.9730102273299,57.052309985621456,NaN,NaN,NaN,NaN,6.021633884002644,17.11293571372042,-180868
2025-09-11T00:10:00-04:00,23913,23913.25,23907.5,23908.75,23896.814310931026,NaN,NaN,NaN,NaN,NaN,23905.71,23923.30299860378,23888.11700139622,23906.75355571734,23897.297666661638,23910.468435045237,23884.12689827804,506,519.9333333333333,47.9840814549767,56.59554230980882,NaN,NaN,NaN,NaN,6.002231463716741,16.45073182115339,-181374
2025-09-11T00:15:00-04:00,23908.5,23909,23896.75,23898.5,NaN,NaN,NaN,23923.777847164347,23923.777847164347,23923.777847164347,23905.935,23922.852686007314,23889.01731399269,23906.75355571734,23897.389150015253,23910.42697289685,23884.351327133656,1505,540.2666666666667,36.07275708564658,55.309110114370185,NaN,NaN,NaN,NaN,6.4485006448798305,17.80792177282117,-182879
2025-09-11T00:20:00-04:00,23898.25,23900.5,23885,23888,NaN,NaN,NaN,23914.816354111423,NaN,NaN,23906.035,23922.461201639682,23889.608798360317,23906.75355571734,23897.245613592462,23910.165995557316,23884.32523162761,1600,562.1666666666666,28.317896802649457,53.468759327288886,NaN,NaN,NaN,NaN,7.0950363131027006,20.270190971550967,-184479
2025-09-11T00:25:00-04:00,23888,23890.75,23882,23887.5,NaN,NaN,NaN,23908.63151983363,NaN,NaN,23906.245,23921.400358797593,23891.089641202405,23906.75355571734,23897.048877445643,23909.9265044439,23884.171250447383,1325,586.4666666666667,28.009109572680785,51.448663646153534,NaN,NaN,NaN,NaN,7.213248005023936,22.784581221965897,-185804
2025-09-11T00:30:00-04:00,23887.5,23889.5,23880.25,23883,NaN,NaN,NaN,23907.381223477554,NaN,NaN,23906.195,23921.637567804308,23890.75243219569,23906.75355571734,23896.846266568282,23909.721056531373,23883.97147660519,1137,606.0333333333333,25.33183908726815,49.15854709945763,NaN,NaN,NaN,NaN,7.358730290379369,25.24763140891248,-186941
2025-09-11T00:35:00-04:00,23883,23886.5,23880.25,23883.75,NaN,NaN,NaN,23905.71048604676,NaN,NaN,23906.175,23921.730786707085,23890.619213292914,23906.75355571734,23896.70233930613,23909.581501583758,23883.823177028506,783,610.4333333333333,26.59126926602319,46.78302301211553,NaN,NaN,NaN,NaN,7.279535269637985,27.534749439648593,-186158
2025-09-11T00:40:00-04:00,23884.5,23885,23879.75,23882.5,NaN,NaN,NaN,23904.411145771905,NaN,NaN,23905.95,23922.511098996772,23889.38890100323,23904.702844573872,23896.58080477036,23909.472007177752,23883.68960236297,623,610.5,25.809896383421318,44.67836770158103,NaN,NaN,NaN,NaN,7.134568464663843,29.69875034840625,-186781
2025-09-11T00:45:00-04:00,23882.25,23884.5,23880,23881,NaN,NaN,NaN,23903.89813914591,NaN,NaN,23905.585,23923.47203721232,23887.69796278768,23901.262275659097,23896.445913277228,23909.35459935961,23883.537227194847,676,618.3666666666667,24.865650664045134,42.244763172259816,NaN,NaN,NaN,NaN,6.94638500290214,31.708179763681215,-187457
2025-09-11T00:50:00-04:00,23880.5,23885.25,23878,23879.75,NaN,NaN,NaN,23903.27776918473,NaN,NaN,23905.15,23924.417848868,23885.882151132002,23901.23482052728,23896.252333743076,23909.19444849181,23883.310218994342,938,630.4,24.075204694595612,39.73494246669195,NaN,NaN,NaN,NaN,6.968071788409129,33.74770995480974,-188395
2025-09-11T00:55:00-04:00,23880.75,23882.75,23879,23879,NaN,NaN,NaN,23902.05491603997,NaN,NaN,23904.57,23925.160298689054,23883.979701310946,23898.962856421822,23896.159652851577,23909.121240452583,23883.19806525057,436,616.6,23.59064409981015,37.049733273837624,NaN,NaN,NaN,NaN,6.738209517808477,35.64155941800052,-188831
2025-09-11T01:00:00-04:00,23880,23884.5,23877,23878.5,NaN,NaN,NaN,23901.989919856336,NaN,NaN,23904.095,23925.935304472692,23882.25469552731,23891.44528513746,23895.95282557001,23908.958669124804,23882.946982015215,976,623.4,23.254612105476212,34.26045672868492,NaN,NaN,NaN,NaN,6.7926231236793,37.578005759656996,-189807
2025-09-11T01:05:00-04:00,23878.5,23888,23878.25,23884.75,NaN,NaN,NaN,23901.989919856336,NaN,NaN,23903.695,23926.195286662078,23881.19471333792,23878.706228109968,23895.801490365728,23908.797830505915,23882.80515022554,951,633.9333333333333,35.60278288242681,32.81798318240569,NaN,NaN,NaN,NaN,7.003864329130779,38.14822886133091,-188856
2025-09-11T01:10:00-04:00,23884.75,23884.75,23872.25,23873.75,NaN,NaN,NaN,23900.82655920794,NaN,NaN,23903.055,23927.05547708077,23879.054522919232,23869.83899345237,23895.493035117448,23908.603184932766,23882.38288530213,1282,663.0666666666667,27.28259154123623,30.840096133399005,NaN,NaN,NaN,NaN,7.39644544847858,39.312245935758575,-190138
2025-09-11T01:15:00-04:00,23873.75,23884.25,23871.5,23882.5,NaN,NaN,NaN,23900.82655920794,NaN,NaN,23902.52,23927.129112140523,23877.910887859478,23869.83899345237,23895.222783129364,23908.385546458216,23882.060019800512,1342,684.5,39.41191657425752,29.728589443893835,NaN,NaN,NaN,NaN,7.778842202158681,40.4630609609633,-188796
2025-09-11T01:20:00-04:00,23882.5,23888.75,23877.25,23887.75,NaN,NaN,NaN,23900.82655920794,NaN,NaN,23902.145,23927.06950401287,23877.22049598713,23869.83899345237,23895.097270705424,23908.23249276109,23881.96204864976,953,702.2,45.306705504007375,29.53734830453888,NaN,NaN,NaN,NaN,8.044639187718776,40.17782793879114,-187843
2025-09-11T01:25:00-04:00,23887.5,23893.75,23887,23889.25,NaN,NaN,NaN,23900.82655920794,NaN,NaN,23901.785,23926.923219913926,23876.646780086074,23871.05625171809,23895.028550174226,23908.08816534678,23881.96893500167,1104,719.9,46.89642834969412,30.310467680542274,NaN,NaN,NaN,NaN,7.952164960024577,38.671671195762514,-186739
2025-09-11T01:30:00-04:00,23889,23892,23884.5,23891.75,NaN,NaN,NaN,23900.82655920794,NaN,NaN,23901.54,23926.825442452628,23876.254557547374,23871.05625171809,23894.970024531427,23907.973865524615,23881.96618353824,863,735.5666666666667,49.529475189381934,31.82558042245174,NaN,NaN,NaN,NaN,7.919867462879965,37.64393594987159,-185876
2025-09-11T01:35:00-04:00,23892.25,23894.5,23886,23893.25,NaN,NaN,NaN,23900.82655920794,NaN,NaN,23901.175,23926.401622845155,23875.948377154844,23872.726001099578,23894.931409129505,23907.873074886855,23881.989743372156,868,755.3333333333334,51.09627226279911,33.474663471745906,NaN,NaN,NaN,NaN,7.961305501245682,36.115798519718275,-185008
2025-09-11T01:40:00-04:00,23893,23896.25,23892.25,23894.75,NaN,NaN,NaN,23900.82655920794,NaN,NaN,23900.795,23925.824121051217,23875.76587894878,23876.830800879663,23894.927911930416,23907.825608743275,23882.030215117557,572,765.9666666666667,52.67832065161499,35.42798358348496,NaN,NaN,NaN,NaN,7.678355108299562,34.31100698350646,-184436
2025-09-11T01:45:00-04:00,23894.5,23894.75,23887.25,23890.5,NaN,NaN,NaN,23900.82655920794,NaN,NaN,23900.46,23925.582770552148,23875.33722944785,23876.830800879663,23894.89285742324,23907.74076491888,23882.044949927604,727,780.9666666666667,47.945619449899894,36.953294310904724,NaN,NaN,NaN,NaN,7.665615457706736,33.431635364252834,-185163
2025-09-11T01:50:00-04:00,23891.25,23892.5,23883.75,23887.75,NaN,NaN,NaN,23900.82655920794,NaN,NaN,23899.98,23925.138664516413,23874.821335483586,23876.830800879663,23894.833389759933,23907.641628262343,23882.025151257523,739,800.3666666666667,45.120850755078614,38.33264819459453,NaN,NaN,NaN,NaN,7.74307149644197,33.095148681469325,-185902
2025-09-11T01:55:00-04:00,23887.75,23888.25,23882.25,23885.5,NaN,NaN,NaN,23900.82655920794,NaN,NaN,23899.585,23925.018955646246,23874.15104435375,23876.830800879663,23894.74483112237,23907.52587861537,23881.96378362937,806,814.8333333333334,42.89412721337454,39.62039651954664,NaN,NaN,NaN,NaN,7.618566389553258,32.97743216608621,-186708
2025-09-11T02:00:00-04:00,23885,23886.75,23878.25,23884,NaN,NaN,NaN,23900.82655920794,NaN,NaN,23899.075,23924.71505655034,23873.43494344966,23876.830800879663,23894.591463391436,23907.358600416137,23881.824326366735,1144,838.4333333333333,41.42635334823852,40.85976428052113,NaN,NaN,NaN,NaN,7.681525933156597,33.35274324791319,-187852
2025-09-11T02:05:00-04:00,23883.5,23892.75,23883.5,23892,NaN,NaN,NaN,23900.82655920794,NaN,NaN,23898.765,23924.364884769806,23873.165115230193,23876.830800879663,23894.51361890307,23907.20001125361,23881.82722655253,1338,867.5,51.04736610135058,42.82095870920259,NaN,NaN,NaN,NaN,7.793559795073983,32.340278553619086,-186514
2025-09-11T02:10:00-04:00,23891.75,23895.5,23889,23894.25,NaN,NaN,NaN,23900.82655920794,NaN,NaN,23898.595,23924.199665587377,23872.990334412625,23876.830800879663,23894.500742554017,23907.13669284143,23881.864792266602,723,879.2,53.36735441163703,44.971868873928365,NaN,NaN,NaN,NaN,7.701162666854413,30.85786045282583,-185791
2025-09-11T02:15:00-04:00,23894.75,23898.75,23891,23894.75,NaN,NaN,NaN,23900.82655920794,NaN,NaN,23898.455,23924.065679402396,23872.844320597607,23879.421058772637,23894.504928734772,23907.061160249523,23881.94869722002,1143,897.9666666666667,53.890321068788346,46.27812160152562,NaN,NaN,NaN,NaN,7.704651047793384,28.883590355082305,-184648
2025-09-11T02:20:00-04:00,23894.5,23903,23894.25,23901.5,23875.446474883902,23875.446474883902,23875.446474883902,NaN,NaN,NaN,23898.39,23923.952894981336,23872.827105018663,23883.16184701811,23894.55476533168,23907.059259743874,23882.050270919484,900,913.5,60.35428151521469,48.6403851710955,NaN,NaN,NaN,NaN,7.779318830093857,27.29489016392558,-183748
2025-09-11T02:25:00-04:00,23902,23907.5,23901.75,23905.5,23881.681862389178,NaN,NaN,NaN,NaN,NaN,23898.43,23924.03098435439,23872.82901564561,23888.62947761449,23894.686283058818,23907.165194808975,23882.20737130866,1179,933.6333333333333,63.60988099096637,50.36881120086043,NaN,NaN,NaN,NaN,7.652224627944295,26.474676028617715,-182569
2025-09-11T02:30:00-04:00,23905,23922,23904,23912,23888.645186826034,NaN,NaN,NaN,NaN,NaN,23898.585,23924.41784924474,23872.75215075526,23897.903582091592,23895.177867247465,23907.82946707312,23882.52626742181,2611,1004.5666666666667,68.18225845430264,52.00277926873867,NaN,NaN,NaN,NaN,8.391351440233988,27.241687129393,-179958
2025-09-11T02:35:00-04:00,23912,23923.25,23911.75,23918.25,23892.684041970308,NaN,NaN,NaN,NaN,NaN,23898.735,23924.933169783373,23872.536830216628,23898.222865673273,23895.473177839554,23908.30078323102,23882.645572448087,1266,1033.8666666666666,71.84544183313145,53.78485166041277,NaN,NaN,NaN,NaN,8.61339776593156,28.057311937226366,-178692
2025-09-11T02:40:00-04:00,23918.5,23920.25,23913,23915,23892.684041970308,NaN,NaN,NaN,NaN,NaN,23898.73,23924.915652556156,23872.544347443843,23898.222865673273,23895.673548785435,23908.59783853994,23882.74925903093,950,1048.6666666666667,67.49391225560356,55.06802573657145,NaN,NaN,NaN,NaN,8.516012211222163,28.814677830214485,-179642
2025-09-11T02:45:00-04:00,23914.75,23919.5,23914.5,23915.5,23892.763248985342,NaN,NaN,NaN,NaN,NaN,23898.825,23925.218038849915,23872.431961150087,23898.222865673273,23895.853985113943,23908.86610939052,23882.841860837365,854,1026.9666666666667,67.81686751361762,56.26235396877278,NaN,NaN,NaN,NaN,8.264868481849152,29.517946159417747,-178788
2025-09-11T02:50:00-04:00,23915.75,23917.75,23913.75,23915.25,23892.763248985342,NaN,NaN,NaN,NaN,NaN,23898.995,23925.697713348804,23872.292286651194,23898.616107224716,23895.94126459884,23908.990429458885,23882.892099738798,438,988.2333333333333,67.45599575042351,57.31790219011624,NaN,NaN,NaN,NaN,7.960235018859927,30.002764414504323,-179226
2025-09-11T02:55:00-04:00,23914.75,23919.25,23911.75,23917.75,23892.763248985342,NaN,NaN,NaN,NaN,NaN,23899.27,23926.452133840023,23872.087866159978,23900.192885779772,23896.104045393367,23909.22636323727,23882.981727549464,800,970.7333333333333,69.21988032890312,58.83749225290219,NaN,NaN,NaN,NaN,7.92736108894136,30.000158982218434,-178426
2025-09-11T03:00:00-04:00,23918.25,23922,23909.25,23912.5,23892.763248985342,NaN,NaN,NaN,NaN,NaN,23899.46,23926.875572221896,23872.044427778103,23900.37930862382,23896.377832889153,23909.592538132103,23883.163127646203,1501,982.8666666666667,61.661678327976496,60.018979936680616,NaN,NaN,NaN,NaN,8.27183529687412,30.320038541614842,-179927
2025-09-11T03:05:00-04:00,23912.75,23919.75,23906.25,23908.5,23892.763248985342,NaN,NaN,NaN,NaN,NaN,23899.485,23926.93120374128,23872.038796258723,23900.37930862382,23896.571602923264,23909.811069848292,23883.332135998236,1315,1000.6,56.591489363741246,60.99736294742109,NaN,NaN,NaN,NaN,8.645275632811682,29.941158535655482,-181242
2025-09-11T03:10:00-04:00,23908.75,23917.5,23907.25,23917,23892.763248985342,NaN,NaN,NaN,NaN,NaN,23899.645,23927.402717846388,23871.887282153613,23900.37930862382,23896.74842949274,23910.034976602103,23883.46188238338,1057,1015.0666666666667,63.46610469109281,62.571630900482106,NaN,NaN,NaN,NaN,8.759898801896563,29.589341387264646,-180185
2025-09-11T03:15:00-04:00,23917,23919.75,23908.75,23913.75,23892.763248985342,NaN,NaN,NaN,NaN,NaN,23899.745,23927.668733632836,23871.821266367162,23900.37930862382,23896.90532819135,23910.23310901893,23883.577547363773,947,1024.1,59.58076738684041,63.181159563731384,NaN,NaN,NaN,NaN,8.919906030332523,29.57156821780481,-181132
2025-09-11T03:20:00-04:00,23913.5,23924.75,23912,23922.5,23892.763248985342,NaN,NaN,NaN,NaN,NaN,23900.02,23928.557140705056,23871.482859294945,23900.37930862382,23897.15881480991,23910.626751121912,23883.69087849791,1174,1031.9666666666667,65.67366280686585,64.060181591962,NaN,NaN,NaN,NaN,9.193484171023057,30.16721365988591,-179958
2025-09-11T03:25:00-04:00,23922.25,23923,23910.75,23911.75,23892.763248985342,NaN,NaN,NaN,NaN,NaN,23900.04,23928.60857714287,23871.471422857132,23900.37930862382,23897.370246435017,23910.898674850643,23883.84181801939,1257,1059.3333333333333,54.75342605971068,64.12183194845646,NaN,NaN,NaN,NaN,9.411806730235696,30.40881577273118,-181215
2025-09-11T03:30:00-04:00,23911.25,23916.25,23909,23914.25,23892.763248985342,NaN,NaN,NaN,NaN,NaN,23900.09,23928.74898811463,23871.431011885372,23900.37930862382,23897.46994539323,23911.013512246387,23883.926378540073,680,1049.4666666666667,56.56236222794722,63.850980570794505,NaN,NaN,NaN,NaN,9.257391963790289,30.1990652822434,-180535
2025-09-11T03:35:00-04:00,23914.25,23924,23914.25,23923,23892.763248985342,NaN,NaN,NaN,NaN,NaN,23900.27,23929.385604063827,23871.154395936173,23900.37930862382,23897.65941315267,23911.305856968538,23884.0129693368,897,1047.6666666666667,62.250857034682724,63.753907431059964,NaN,NaN,NaN,NaN,9.292578252090982,30.92812992664632,-179638
2025-09-11T03:40:00-04:00,23923.5,23929,23920.25,23920.75,23898.047531626886,NaN,NaN,NaN,NaN,NaN,23900.465,23929.99312388187,23870.93687611813,23904.469144307124,23897.982376091837,23911.841316932063,23884.12343525161,1384,1051.0666666666666,60.07232110114958,63.174626191549024,NaN,NaN,NaN,NaN,9.253822662655912,32.07438306933718,-181022
2025-09-11T03:45:00-04:00,23921,23930,23918.25,23929,23898.047531626886,NaN,NaN,NaN,NaN,NaN,23900.76,23931.116211891644,23870.403788108353,23904.5003154457,23898.229512922375,23912.270955426153,23884.188070418597,988,1039.2666666666667,64.92001221999098,62.679952647753275,NaN,NaN,NaN,NaN,9.432121043894776,32.662816945873615,-180034
2025-09-11T03:50:00-04:00,23929.25,23934,23927,23932.75,23903.799765387306,NaN,NaN,NaN,NaN,NaN,23901.125,23932.553211849805,23869.696788150195,23910.10025235656,23898.558171683388,23912.90892685694,23884.207416509835,1116,1044.7,66.88793966741974,62.63666889145444,NaN,NaN,NaN,NaN,9.258398112188006,33.58848820519987,-178918
2025-09-11T03:55:00-04:00,23933,23935.25,23928.75,23930.75,23905.627048778795,NaN,NaN,NaN,NaN,NaN,23901.415,23933.653270733583,23869.17672926642,23912.880201885248,23898.862544329375,23913.491468620996,23884.233620037754,1043,1042.6666666666667,64.80004600919021,62.4211816411382,NaN,NaN,NaN,NaN,9.06136967560315,34.560943739908716,-179961
2025-09-11T04:00:00-04:00,23931.25,23938.25,23927,23933.25,23905.916728379758,NaN,NaN,NaN,NaN,NaN,23901.735,23934.899952882424,23868.570047117577,23914.7291615082,23899.399062043416,23914.517382377344,23884.28074170949,1816,1074.4333333333334,66.219500019268,62.33286051748423,NaN,NaN,NaN,NaN,9.217700413060069,35.727469323862906,-178145
2025-09-11T04:05:00-04:00,23933.75,23935,23928.75,23931.75,23905.916728379758,NaN,NaN,NaN,NaN,NaN,23902.1,23936.164350868825,23868.035649131172,23914.7291615082,23899.654291347415,23914.983285082184,23884.325297612646,912,1075.9,64.53787248904837,61.99843138606603,NaN,NaN,NaN,NaN,9.005721812127208,36.810671651820364,-179057
2025-09-11T04:10:00-04:00,23931.5,23939.75,23931,23939.25,23909.03285581709,NaN,NaN,NaN,NaN,NaN,23902.625,23938.124049281432,23867.125950718568,23917.82166336525,23899.94358668139,23915.55656955565,23884.33060380713,913,1087.2666666666667,68.80368614321529,62.508574801440226,NaN,NaN,NaN,NaN,8.987455968403836,38.21541794028959,-178144
2025-09-11T04:15:00-04:00,23938.75,23942,23931,23933,23909.855226007225,NaN,NaN,NaN,NaN,NaN,23903.025,23939.42201223111,23866.627987768894,23918.957330692196,23900.333706569807,23916.294036507486,23884.373376632127,1302,1106.4333333333334,62.099742849853115,62.902021479019645,NaN,NaN,NaN,NaN,9.131209113517848,39.690288624907346,-179446
2025-09-11T04:20:00-04:00,23932.75,23937.75,23927.5,23929.75,23909.855226007225,NaN,NaN,NaN,NaN,NaN,23903.445,23940.573868826214,23866.316131173786,23918.957330692196,23900.56516864162,23916.691209628552,23884.43912765469,879,1111.1,58.88664841619034,62.574917459383755,NaN,NaN,NaN,NaN,9.211122748266574,40.10516516527391,-180325
2025-09-11T04:25:00-04:00,23929.5,23931,23922.75,23924.75,23909.855226007225,NaN,NaN,NaN,NaN,NaN,23903.97,23941.54401229337,23866.395987706634,23918.957330692196,23900.774934776993,23916.999755499633,23884.550114054353,983,1117,54.237191698530644,62.19323348164734,NaN,NaN,NaN,NaN,9.14247112339039,39.35245675947824,-181308
2025-09-11T04:30:00-04:00,23925,23928.25,23920.75,23922,23909.855226007225,NaN,NaN,NaN,NaN,NaN,23904.65,23942.273928555413,23867.02607144459,23918.957330692196,23900.949517487625,23917.234578282987,23884.664456692262,922,1109.6,51.81404214372284,61.20326057713714,NaN,NaN,NaN,NaN,9.025151757433933,38.21575243476193,-182230
2025-09-11T04:35:00-04:00,23922.25,23923.5,23917.25,23921.5,23909.855226007225,NaN,NaN,NaN,NaN,NaN,23905.33,23942.918487594518,23867.741512405486,23918.957330692196,23901.108250185986,23917.423732491425,23884.792767880546,977,1097.5666666666666,51.364707567701196,60.96120925627931,NaN,NaN,NaN,NaN,8.82692663190294,36.43858561870471,-183207
2025-09-11T04:40:00-04:00,23921.25,23926,23917.5,23925,23909.855226007225,NaN,NaN,NaN,NaN,NaN,23906.17,23943.601729860744,23868.738270139253,23918.957330692196,23901.2530958785,23917.609928995964,23884.896262761034,818,1100.7333333333333,54.34909033700963,60.80311840692663,NaN,NaN,NaN,NaN,8.803574729624158,35.15501671307831,-182389
2025-09-11T04:45:00-04:00,23924.5,23927,23922.25,23923,23909.855226007225,NaN,NaN,NaN,NaN,NaN,23906.955,23944.118381163324,23869.79161883668,23918.957330692196,23901.350002975876,23917.73943136458,23884.960574587174,523,1080.0666666666666,52.371463542424436,60.09744744319389,NaN,NaN,NaN,NaN,8.514033677508147,34.10802395786982,-182912
2025-09-11T04:50:00-04:00,23923,23925,23920.25,23924.5,23909.855226007225,NaN,NaN,NaN,NaN,NaN,23907.795,23944.60636917424,23870.983630825758,23918.957330692196,23901.422635081388,23917.833237291678,23885.0120328711,410,1063.7333333333333,53.73129580773114,59.64451706509258,NaN,NaN,NaN,NaN,8.245174129114707,32.698050148095845,-182502
2025-09-11T04:55:00-04:00,23924.5,23925.25,23921.5,23922.25,23909.855226007225,NaN,NaN,NaN,NaN,NaN,23908.62,23944.836465868935,23872.403534131063,23918.957330692196,23901.48841071174,23917.917100715214,23885.059720708265,378,1037.0333333333333,51.36243442935749,58.6761186514759,NaN,NaN,NaN,NaN,7.924090262749371,31.43038278525293,-182880
2025-09-11T05:00:00-04:00,23922.5,23927.25,23922.5,23923.5,23909.855226007225,NaN,NaN,NaN,NaN,NaN,23909.495,23944.985912919834,23874.004087080164,23918.957330692196,23901.585992644403,23918.04749386988,23885.124491418926,530,967.6666666666666,52.6123752513353,57.65643547889844,NaN,NaN,NaN,NaN,7.715226672552988,30.589477116988135,-182350
2025-09-11T05:05:00-04:00,23923.5,23928.25,23922.5,23926,23909.855226007225,NaN,NaN,NaN,NaN,NaN,23910.435,23945.126037748545,23875.743962251458,23914.19086455376,23901.701250146514,23918.20676768932,23885.195732603708,601,945.5,55.0977962210428,56.96341763688791,NaN,NaN,NaN,NaN,7.574853338799203,29.97470600195311,-181749
2025-09-11T05:10:00-04:00,23926,23928,23920,23925.25,23909.855226007225,NaN,NaN,NaN,NaN,NaN,23911.37,23945.073744605837,23877.66625539416,23913.13381420676,23901.8150421696,23918.357087256074,23885.272997083128,630,934.8333333333334,54.179722135058796,56.103433502301534,NaN,NaN,NaN,NaN,7.605220957456403,28.774070523393885,-182379
2025-09-11T05:15:00-04:00,23925.75,23929.5,23925,23928.25,23909.855226007225,NaN,NaN,NaN,NaN,NaN,23912.24,23945.391464514225,23879.08853548578,23914.375641092327,23901.935976019944,23918.532863247226,23885.33908879266,593,926.1333333333333,57.24832911345179,55.58275183261606,NaN,NaN,NaN,NaN,7.383419460495231,27.935947012587174,-181786
2025-09-11T05:20:00-04:00,23928.5,23929.75,23923.25,23926,23909.855226007225,NaN,NaN,NaN,NaN,NaN,23913.285,23944.769600995864,23881.800399004136,23914.40051287386,23902.029647777024,23918.6632174548,23885.39607809925,487,927.7666666666667,54.31058491891188,54.5475303165944,NaN,NaN,NaN,NaN,7.320318070459857,26.713898398283547,-182273
2025-09-11T05:25:00-04:00,23926.25,23927.5,23922.5,23925.5,23909.855226007225,NaN,NaN,NaN,NaN,NaN,23914.145,23944.54961971229,23883.740380287712,23914.40051287386,23902.108180644384,23918.767934018128,23885.44842727064,432,915.5,53.65170411995419,53.94409897874447,NaN,NaN,NaN,NaN,7.15458106542701,25.389823882666633,-182705
2025-09-11T05:30:00-04:00,23924.75,23925.25,23922,23922.5,23909.855226007225,NaN,NaN,NaN,NaN,NaN,23914.84,23944.37570043544,23885.30429956456,23914.40051287386,23902.183492655022,23918.861180025953,23885.50580528409,455,880.6333333333333,49.75169030345418,53.291601970691886,NaN,NaN,NaN,NaN,6.893539560753652,24.02989746416088,-183160
2025-09-11T05:35:00-04:00,23922.25,23923.25,23914,23917,23909.855226007225,NaN,NaN,NaN,NaN,NaN,23915.395,23944.015113555422,23886.77488644458,23914.40051287386,23902.312029846496,23918.983078956597,23885.640980736396,1041,871.5,43.50754097358254,52.52519834748131,NaN,NaN,NaN,NaN,7.061858163556963,23.571466387098372,-184201
2025-09-11T05:40:00-04:00,23917.25,23918.5,23912.75,23914,23909.855226007225,NaN,NaN,NaN,NaN,NaN,23915.84,23943.656318952704,23888.023681047296,23914.40051287386,23902.382649475618,23919.0344962427,23885.730802708535,716,860.1333333333333,40.52022899709667,51.718497408436576,NaN,NaN,NaN,NaN,6.968154009017179,23.360748997578934,-184917
2025-09-11T05:45:00-04:00,23914,23915.75,23907.75,23913.25,NaN,NaN,NaN,23934.031138980637,23934.031138980637,23934.031138980637,23916.24,23943.310640916472,23889.16935908353,23914.40051287386,23902.47609658517,23919.076439098364,23885.875754071978,1238,869.8333333333334,39.78477146201298,50.89135911517313,NaN,NaN,NaN,NaN,7.0418572940873805,23.93597107547525,-186155
2025-09-11T05:50:00-04:00,23912.25,23920.5,23911.75,23919.25,NaN,NaN,NaN,23934.031138980637,NaN,NaN,23916.73,23943.104957821346,23890.355042178653,23914.40051287386,23902.572332289656,23919.16060046882,23885.984064110493,862,859.4333333333333,47.9274814068018,50.43267276301543,NaN,NaN,NaN,NaN,7.163867487366853,23.323864607416997,-185293
2025-09-11T05:55:00-04:00,23919,23921.75,23918,23920.25,NaN,NaN,NaN,23934.031138980637,NaN,NaN,23917.325,23942.62663038489,23892.02336961511,23914.40051287386,23902.672934768918,23919.26586532513,23886.080004212705,764,843,49.16140869014488,50.203383130709746,NaN,NaN,NaN,NaN,6.920019809697792,22.479841334101383,-184529
2025-09-11T06:00:00-04:00,23920,23928,23918.25,23927.25,NaN,NaN,NaN,23934.031138980637,NaN,NaN,23918.115,23942.106292168508,23894.123707831495,23914.40051287386,23902.86808779628,23919.513965020455,23886.222210572105,1194,860.1333333333333,56.866509282522834,50.42732695033772,NaN,NaN,NaN,NaN,7.122161251862236,21.267786575681964,-183335
2025-09-11T06:05:00-04:00,23927.25,23933.5,23924,23931.75,NaN,NaN,NaN,23934.031138980637,NaN,NaN,23919.04,23941.443874663746,23896.636125336256,23914.770498711965,23903.129421724567,23919.90286472896,23886.355978720174,1311,873.9333333333333,60.96255971144976,51.11305018477288,NaN,NaN,NaN,NaN,7.292006876729219,20.995154688186556,-182024
2025-09-11T06:10:00-04:00,23931.5,23935.75,23930,23935,23910.55042836936,23910.55042836936,23910.55042836936,NaN,NaN,NaN,23920.06,23940.552086267024,23899.56791373298,23917.891398969572,23903.299865181078,23920.179893841723,23886.419836520432,759,853.1,63.647533797771736,51.90127579523263,NaN,NaN,NaN,NaN,7.181863528391418,21.05293812559033,-181265
2025-09-11T06:15:00-04:00,23935.5,23938.75,23931.25,23935,23912.66745435257,NaN,NaN,NaN,NaN,NaN,23920.92,23940.203008068685,23901.63699193131,23920.713119175656,23903.487387694466,23920.49206803084,23886.482707358093,807,847.0666666666667,63.647533797771736,52.51197133642756,NaN,NaN,NaN,NaN,7.204587562077745,21.499758607517077,-181265
2025-09-11T06:20:00-04:00,23935.5,23939.25,23934.5,23935.25,23914.90984279109,NaN,NaN,NaN,NaN,NaN,23921.74,23939.869247075738,23903.610752924265,23922.445495340526,23903.615934806785,23920.71076491779,23886.52110469578,536,827.7333333333333,63.86923189938916,53.20407917673686,NaN,NaN,NaN,NaN,7.0292598790721925,21.979445472913035,-180729
2025-09-11T06:25:00-04:00,23935.75,23938,23933.25,23937.75,23914.90984279109,NaN,NaN,NaN,NaN,NaN,23922.6,23939.56879490518,23905.631205094818,23922.445495340526,23903.810893248556,23921.039716880037,23886.582069617074,821,820.3333333333334,66.09594576004241,53.836051794350475,NaN,NaN,NaN,NaN,6.8664556019956065,22.127231793493245,-179908
2025-09-11T06:30:00-04:00,23937.75,23941.5,23935.75,23938.25,23917.20891667535,NaN,NaN,NaN,NaN,NaN,23923.335,23939.7592534131,23906.9107465869,23925.970117017936,23904.058868991855,23921.47297295546,23886.64476502825,992,792.8666666666667,66.54009265595697,54.70958806128227,NaN,NaN,NaN,NaN,6.786708773281634,22.74866199577251,-178916
2025-09-11T06:35:00-04:00,23938.5,23941.75,23935,23941.25,23917.20891667535,NaN,NaN,NaN,NaN,NaN,23924.05,23940.418872915812,23907.681127084186,23925.970117017936,23904.194592599502,23921.711823295664,23886.67736190334,536,780.3333333333334,69.15133569568656,55.816704602406006,NaN,NaN,NaN,NaN,6.784086718047232,23.137117978550787,-178380
2025-09-11T06:40:00-04:00,23941.75,23946.75,23938.5,23941.25,23921.107969532706,NaN,NaN,NaN,NaN,NaN,23924.635,23941.32697712535,23907.943022874646,23929.985874891478,23904.63855288486,23922.525048020056,23886.75205774966,1648,804.8333333333334,69.15133569568656,57.20239355899404,NaN,NaN,NaN,NaN,6.888794809615287,24.14697716543801,-178380
2025-09-11T06:45:00-04:00,23941.25,23945.25,23938.5,23944,23921.107969532706,NaN,NaN,NaN,NaN,NaN,23925.15,23942.594196734557,23907.705803265446,23929.985874891478,23904.85828601657,23922.923819452648,23886.79275258049,821,788.8,71.51466730378073,59.20290258257962,NaN,NaN,NaN,NaN,6.878880894642767,25.08470355326186,-177559
2025-09-11T06:50:00-04:00,23944,23948.5,23943.75,23947.5,23924.993263561824,NaN,NaN,NaN,NaN,NaN,23925.8,23944.084693049754,23907.515306950245,23932.69595993055,23905.140950689583,23923.467621402946,23886.81427997622,967,791.7333333333333,74.22152573202085,61.610138063645635,NaN,NaN,NaN,NaN,6.726817973596854,26.345653327116896,-176592
2025-09-11T06:55:00-04:00,23948,23950,23945.25,23945.5,23926.80606976356,NaN,NaN,NaN,NaN,NaN,23926.4,23945.253381654475,23907.54661834553,23934.98176794444,23905.41281253552,23923.986031665136,23886.839593405904,935,790.1333333333333,70.12100499383698,63.77701188734734,NaN,NaN,NaN,NaN,6.585616689768507,27.68624491820236,-177527
2025-09-11T07:00:00-04:00,23946,23950.25,23944,23947,23926.80606976356,NaN,NaN,NaN,NaN,NaN,23927.035,23946.473109483395,23907.596890516605,23935.11041435555,23905.75282976319,23924.626164384892,23886.87949514149,1182,798.8,71.39733106657636,65.45342972018838,NaN,NaN,NaN,NaN,6.5616440690707565,28.55896707190669,-176345
2025-09-11T07:05:00-04:00,23947.5,23948.5,23943.5,23945.75,23926.80606976356,NaN,NaN,NaN,NaN,NaN,23927.595,23947.537640245835,23907.652359754167,23935.11041435555,23905.943507958313,23924.973318613593,23886.913697303033,691,789.2666666666667,68.7613429805467,66.85342502664567,NaN,NaN,NaN,NaN,6.450098064137131,29.217165219851992,-177036
2025-09-11T07:10:00-04:00,23945.5,23946,23943,23944.5,23926.80606976356,NaN,NaN,NaN,NaN,NaN,23928.235,23948.252594763908,23908.217405236093,23935.11041435555,23906.079714535434,23925.213127654686,23886.94630141618,516,779.2,66.13193848008773,67.5152413979003,NaN,NaN,NaN,NaN,6.2036624881273355,29.669556073588627,-177552
2025-09-11T07:15:00-04:00,23944.25,23945.75,23940.25,23942.25,23926.80606976356,NaN,NaN,NaN,NaN,NaN,23928.91,23948.491562760304,23909.328437239696,23935.11041435555,23906.284676883133,23925.55940987078,23887.009943895486,821,789.1333333333333,61.568141817077105,67.55849726258796,NaN,NaN,NaN,NaN,6.153400881832526,29.244991777294295,-178373
2025-09-11T07:20:00-04:00,23942.5,23945.5,23940,23940.5,23926.80606976356,NaN,NaN,NaN,NaN,NaN,23929.38,23948.92360252693,23909.83639747307,23935.11041435555,23906.47910389484,23925.880111577728,23887.07809621195,804,802.2666666666667,58.203752592640015,67.1696557479357,NaN,NaN,NaN,NaN,6.10672939027306,28.77591428819696,-179177
2025-09-11T07:25:00-04:00,23940.25,23945.5,23939,23943,23926.80606976356,NaN,NaN,NaN,NaN,NaN,23929.965,23949.352627504424,23910.577372495576,23935.11041435555,23906.6531307836,23926.16771328665,23887.138548280553,717,813.5666666666667,61.44503686920399,67.0123345387523,NaN,NaN,NaN,NaN,6.134820148110698,28.03193833246204,-178460
2025-09-11T07:30:00-04:00,23943,23945,23939.75,23944.25,23926.80606976356,NaN,NaN,NaN,NaN,NaN,23930.4,23950.072061401163,23910.72793859884,23935.11041435555,23906.87004489871,23926.526680979885,23887.213408817537,891,825.6,62.990462725574176,66.94956531205123,NaN,NaN,NaN,NaN,6.071618708959933,27.34110351642247,-177569
2025-09-11T07:35:00-04:00,23944.75,23948.5,23941.75,23946.5,23926.80606976356,NaN,NaN,NaN,NaN,NaN,23931.095,23950.53642226605,23911.653577733952,23935.11041435555,23907.156510672903,23927.019345319983,23887.293676025824,1113,842.6666666666666,65.65879894121048,66.91834053927752,NaN,NaN,NaN,NaN,6.120074515462796,27.428565538508398,-176456
2025-09-11T07:40:00-04:00,23946.5,23952.5,23945.75,23949,23929.599433943917,NaN,NaN,NaN,NaN,NaN,23931.79,23951.257501127253,23912.32249887275,23937.595975014927,23907.505087699632,23927.64820823303,23887.361967166235,1261,863.7,68.38618130385817,67.0502040141276,NaN,NaN,NaN,NaN,6.16506919292974,28.190128514508643,-175195
2025-09-11T07:45:00-04:00,23949,23956,23946.75,23954,23931.475596037373,NaN,NaN,NaN,NaN,NaN,23932.41,23952.67641557103,23912.14358442897,23939.45178001194,23907.959460458962,23928.4960006522,23887.422920265722,1556,895.8,73.00407053425639,67.32539935973973,NaN,NaN,NaN,NaN,6.385421393434759,29.390891387608047,-173639
2025-09-11T07:50:00-04:00,23953.75,23954.25,23944,23947.25,23931.475596037373,NaN,NaN,NaN,NaN,NaN,23932.94,23953.344548515666,23912.53545148433,23939.45178001194,23908.32287402041,23929.121185211505,23887.524562829316,1386,925.7666666666667,60.21619709718365,66.68717517413238,NaN,NaN,NaN,NaN,6.661462722475133,29.612086779912044,-175025
2025-09-11T07:55:00-04:00,23947.75,23950.25,23945.75,23945.75,23931.475596037373,NaN,NaN,NaN,NaN,NaN,23933.275,23953.957903562852,23912.59209643715,23939.45178001194,23908.588676092102,23929.562286581586,23887.61506560262,1063,946.8,57.793482329981444,65.70709053314673,NaN,NaN,NaN,NaN,6.507072528012624,29.81748250133719,-176088
2025-09-11T08:00:00-04:00,23946,23952,23943.25,23946.25,23931.475596037373,NaN,NaN,NaN,NaN,NaN,23933.545,23954.54349757996,23912.546502420035,23939.45178001194,23908.891332449588,23930.057945734206,23887.72471916497,1231,972.6666666666666,58.39438527665042,64.57658050062027,NaN,NaN,NaN,NaN,6.6672816331545794,29.21897967539363,-174857
2025-09-11T08:05:00-04:00,23946.75,23951.25,23939.25,23944.75,23931.475596037373,NaN,NaN,NaN,NaN,NaN,23933.825,23955.039205147,23912.610794853,23939.45178001194,23909.28353338208,23930.66602916648,23887.90103759768,1719,995.2666666666667,55.826525244085964,63.555546232780905,NaN,NaN,NaN,NaN,7.048190087929252,27.573355710535864,-176576
2025-09-11T08:10:00-04:00,23944.25,23947.5,23939.5,23944.25,23931.475596037373,NaN,NaN,NaN,NaN,NaN,23934.045,23955.45800773041,23912.631992269587,23939.45178001194,23909.524107994293,23931.02419382481,23888.024022163776,1115,1008.5666666666667,54.958959909265644,62.38137686440156,NaN,NaN,NaN,NaN,7.11617651022002,26.045276314596506,-177691
2025-09-11T08:15:00-04:00,23944.75,23950.25,23939.25,23943.5,23931.475596037373,NaN,NaN,NaN,NaN,NaN,23934.28,23955.844470781572,23912.715529218425,23939.45178001194,23909.980870611875,23931.703646037055,23888.258095186695,2124,1038.1,53.61307400477701,61.29935765184659,NaN,NaN,NaN,NaN,7.393592473775733,25.236571752025522,-179815
2025-09-11T08:20:00-04:00,23943,23957.75,23940.5,23942.25,23931.475596037373,NaN,NaN,NaN,NaN,NaN,23934.34,23955.97602551219,23912.70397448781,23939.45178001194,23910.679963373066,23932.775256253626,23888.584670492506,3130,1113.7,51.35575822170837,60.24391620481949,NaN,NaN,NaN,NaN,8.097621582791751,25.77094760044461,-182945
2025-09-11T08:25:00-04:00,23942.75,23967,23931.5,23956.75,23931.475596037373,NaN,NaN,NaN,NaN,NaN,23934.815,23957.33716908472,23912.292830915278,23939.45178001194,23911.857185467758,23934.686354550806,23889.02801638471,4869,1250.5333333333333,68.12249646483025,60.71208439394473,NaN,NaN,NaN,NaN,10.054934326878055,27.319222991806296,-178076
2025-09-11T08:30:00-04:00,23958.5,23976.25,23845,23882.75,NaN,NaN,NaN,23954.195096344487,23954.195096344487,23954.195096344487,23933.875,23960.68027000495,23907.06972999505,23939.45178001194,23910.375953719016,23931.851763052186,23888.900144385847,27825,2138.233333333333,23.536182505953406,58.235829387752815,NaN,NaN,NaN,NaN,18.711724732101054,29.22421671210037,-205901
2025-09-11T08:35:00-04:00,23882.75,23914.25,23881.25,23898.5,NaN,NaN,NaN,23943.83963741974,NaN,NaN,23933.35,23961.825779187973,23904.874220812024,23935.886424009554,23909.731437083636,23930.82059340254,23888.642280764732,10861,2456.5666666666666,33.51078789151212,56.24052588934626,NaN,NaN,NaN,NaN,19.732315822665264,30.993139452373438,-195040
2025-09-11T08:40:00-04:00,23898.25,23925,23897.5,23924.75,NaN,NaN,NaN,23943.83963741974,NaN,NaN,23933.405,23961.803396085055,23905.006603914942,23934.072311366115,23909.991300893573,23930.656389546177,23889.32621224097,9411,2744.9666666666667,46.125007845259965,55.035850540752385,NaN,NaN,NaN,NaN,20.2871504067606,31.643460830140164,-185629
2025-09-11T08:45:00-04:00,23924.5,23947.5,23915,23931.75,23881.24373945846,23881.24373945846,23881.24373945846,NaN,NaN,NaN,23933.61,23961.80896452166,23905.41103547834,23934.072311366115,23911.29430641554,23931.965402253987,23890.623210577094,14114,3188.5333333333333,48.908629346356996,53.83940985540571,NaN,NaN,NaN,NaN,21.159496806277698,30.556372059702834,-171515
2025-09-11T08:50:00-04:00,23932.25,23959,23928.25,23949.5,23891.698569483076,NaN,NaN,NaN,NaN,NaN,23934.1,23962.533958575055,23905.66604142494,23931.74981873556,23912.79392416694,23934.18967681234,23891.39817152154,10614,3524.4666666666667,55.22596812467962,52.89939462832153,NaN,NaN,NaN,NaN,21.844532748686436,28.839277915189516,-160901
2025-09-11T08:55:00-04:00,23949.25,23961.25,23939.5,23959.25,23897.842952688392,NaN,NaN,NaN,NaN,NaN,23934.825,23963.93054071258,23905.719459287422,23931.74981873556,23913.96385897728,23936.113956886154,23891.813761068406,7212,3737.5,58.277696219972285,51.84751074872981,NaN,NaN,NaN,NaN,21.83778040949455,27.110819816118177,-153689
2025-09-11T09:00:00-04:00,23959.25,23965,23952.25,23954,23906.7421366571,NaN,NaN,NaN,NaN,NaN,23935.415,23964.8535138821,23905.976486117903,23931.74981873556,23915.117690394403,23938.050624370968,23892.18475641784,6871,3933.4666666666667,56.0619147330562,51.55077629414927,NaN,NaN,NaN,NaN,21.188653237387797,25.276764362415776,-160560
2025-09-11T09:05:00-04:00,23953.5,23955.5,23941,23950,23906.7421366571,NaN,NaN,NaN,NaN,NaN,23935.97,23965.441111271775,23906.498888728227,23931.74981873556,23915.91859426207,23939.151931541193,23892.68525698295,6248,4123.866666666667,54.36587391891464,51.30594712193022,NaN,NaN,NaN,NaN,20.710892291860098,24.2079863915848,-166808
2025-09-11T09:10:00-04:00,23950.75,23954.75,23940,23949.5,23906.7421366571,NaN,NaN,NaN,NaN,NaN,23936.49,23965.980161063195,23906.99983893681,23928.44985498845,23916.409912692525,23939.800175647688,23893.01964973736,4080,4204.933333333333,54.145365912977,51.00244573881069,NaN,NaN,NaN,NaN,20.28511427101295,23.270324121629173,-170888
2025-09-11T09:15:00-04:00,23949.25,23953.5,23939,23951.25,23906.7421366571,NaN,NaN,NaN,NaN,NaN,23936.995,23966.613826790344,23907.376173209654,23900.094526657984,23916.877415398798,23940.403938825748,23893.350891971848,4023,4311.666666666667,54.83583572320715,50.93168220160506,NaN,NaN,NaN,NaN,19.871891823083452,22.45758759705872,-166865
2025-09-11T09:20:00-04:00,23951.75,23961.25,23950.5,23953.25,23906.7421366571,NaN,NaN,NaN,NaN,NaN,23937.555,23967.322816513966,23907.787183486034,23913.150621326386,23917.388748085043,23941.164895547972,23893.612600622113,3686,4402.3,55.65761863333639,50.98158639618155,NaN,NaN,NaN,NaN,19.220328121434637,21.137356183598683,-163179
2025-09-11T09:25:00-04:00,23953.5,23978.25,23952.5,23977,23914.156207299708,NaN,NaN,NaN,NaN,NaN,23938.53,23970.15066413347,23906.909335866527,23926.89549706111,23919.059859452525,23944.17883282944,23893.940886075612,9150,4676.133333333333,64.0280120058944,51.7255105391185,NaN,NaN,NaN,NaN,19.686733255617874,20.407311360501364,-154029
2025-09-11T09:30:00-04:00,23977,23997.75,23967.5,23985,23929.609334240628,NaN,NaN,NaN,NaN,NaN,23939.71,23973.687839842587,23905.73216015741,23941.54139764889,23926.310520600593,23957.51843109704,23895.102610104146,36054,5838.533333333334,66.33336593863544,52.79533966175615,NaN,NaN,NaN,NaN,20.441252308788023,20.68592904515925,-117975
2025-09-11T09:35:00-04:00,23985.25,23987.25,23926.75,23934.75,NaN,NaN,NaN,24015.85586277031,24015.85586277031,24015.85586277031,23939.895,23973.66141674605,23906.12858325395,23941.54139764889,23928.617151152423,23959.043550037222,23898.190752267623,35207,6989.066666666667,46.27323396307649,51.23467805448802,NaN,NaN,NaN,NaN,23.30259142958888,19.716578955941085,-153182
2025-09-11T09:40:00-04:00,23935,23946,23911.5,23924.75,NaN,NaN,NaN,23989.635141735296,NaN,NaN,23939.94,23973.61945367975,23906.26054632025,23941.54139764889,23928.526801984735,23957.787567090712,23899.26603687876,28910,7935.533333333334,43.45674799670173,52.65757558954148,NaN,NaN,NaN,NaN,24.10240632747539,19.42989080867378,-182092
2025-09-11T09:45:00-04:00,23925,23965.5,23909.75,23950,NaN,NaN,NaN,23989.635141735296,NaN,NaN,23940.6,23973.744531983713,23907.455468016284,23941.54139764889,23929.557243708532,23957.877482999924,23901.23700441714,32464,8990.3,51.48625063176163,53.94153721384502,NaN,NaN,NaN,NaN,26.36294873265572,18.230293821579902,-149628
2025-09-11T09:50:00-04:00,23950,23978.25,23940,23971,NaN,NaN,NaN,23989.635141735296,NaN,NaN,23941.74,23975.06701005962,23908.41298994038,23941.54139764889,23931.578886673327,23960.16845567624,23902.989317670414,26733,9854.6,56.96042282252702,54.71549542650695,NaN,NaN,NaN,NaN,27.212023823180314,17.279937976514667,-122895
2025-09-11T09:55:00-04:00,23970.75,23988,23960,23979.25,NaN,NaN,NaN,23989.635141735296,NaN,NaN,23943.06,23976.991483899932,23909.12851610007,23941.54139764889,23933.64188773656,23963.070747304977,23904.213028168146,21720,10554.7,58.92146915195866,55.43069826976421,NaN,NaN,NaN,NaN,27.268307835810294,16.785891833365554,-101175
2025-09-11T10:00:00-04:00,23978.75,23983.25,23961.5,23980.5,NaN,NaN,NaN,23989.635141735296,NaN,NaN,23944.285,23979.100658836942,23909.469341163058,23941.54139764889,23935.175971059747,23965.096184735878,23905.255757383617,17877,11120.9,59.22461988581607,55.716316252702526,NaN,NaN,NaN,NaN,26.874142990395274,16.327134700441377,-83298
2025-09-11T10:05:00-04:00,23980,24003.25,23977.25,23986,23921.29686248528,23921.29686248528,23921.29686248528,NaN,NaN,NaN,23945.6,23981.630681377334,23909.569318622664,23941.54139764889,23937.572744273395,23968.84719774333,23906.29829080346,22580,11836.466666666667,60.602310911633666,55.88236015924978,NaN,NaN,NaN,NaN,26.811704205367043,16.66801215383932,-60718
2025-09-11T10:10:00-04:00,23986.5,23991.5,23954.75,23959,23921.29686248528,NaN,NaN,NaN,NaN,NaN,23946.235,23982.06828201305,23910.40171798695,23941.54139764889,23939.045525386136,23970.26483589913,23907.826214873145,25348,12639.366666666667,51.41785337315276,55.55064149068524,NaN,NaN,NaN,NaN,27.521582476412252,15.888402385214178,-86066
2025-09-11T10:15:00-04:00,23959.25,23979.75,23948.25,23952.75,23921.29686248528,NaN,NaN,NaN,NaN,NaN,23946.655,23982.291061794785,23911.018938205212,23941.54139764889,23939.901545471745,23970.767672720656,23909.035418222833,22332,13331.9,49.545991552465374,55.206364178796,NaN,NaN,NaN,NaN,27.805755156668518,14.877968429894656,-108398
2025-09-11T10:20:00-04:00,23952.5,23969.5,23946.75,23968.75,23921.29686248528,NaN,NaN,NaN,NaN,NaN,23947.33,23983.334088653075,23911.32591134693,23926.010265716217,23940.47393980571,23971.12998604148,23909.81789356994,14941,13783.733333333334,54.14795537231205,55.20654914017708,NaN,NaN,NaN,NaN,27.444629788335053,13.871844911550571,-93457
2025-09-11T10:25:00-04:00,23968.5,23971.5,23951,23965.75,23921.29686248528,NaN,NaN,NaN,NaN,NaN,23947.945,23984.13564658655,23911.75435341345,23926.010265716217,23940.969489013907,23971.46014359455,23910.478834433263,12926,14179.166666666666,53.16871426109837,55.087469035740746,NaN,NaN,NaN,NaN,26.948584803453976,13.031347555764878,-106383
2025-09-11T10:30:00-04:00,23965,23999.25,23961.5,23997.75,23921.29686248528,NaN,NaN,NaN,NaN,NaN,23949.195,23987.78337778485,23910.60662221515,23926.010265716217,23942.32842596379,23973.33327829811,23911.323573629474,18012,14738.533333333333,61.224046672091966,55.485071038509,NaN,NaN,NaN,NaN,27.72011446035012,13.405140177880295,-88371
2025-09-11T10:35:00-04:00,23998,24012.75,23996.25,24012.25,23932.39397907175,NaN,NaN,NaN,NaN,NaN,23950.685,23992.967125065017,23908.402874934985,23944.29574709591,23944.27516313625,23976.75087907443,23911.799447198075,18568,15300.166666666666,64.22672489984558,55.49926481664837,NaN,NaN,NaN,NaN,26.918677713182255,14.216946098208675,-69803
2025-09-11T10:40:00-04:00,24012.25,24018,24006,24014.25,23941.535161841213,NaN,NaN,NaN,NaN,NaN,23952.205,23997.915030621873,23906.49496937813,23957.23659767673,23945.72965267224,23979.341406419797,23912.11789892468,13404,15709.8,64.63352843759844,55.37784785228859,NaN,NaN,NaN,NaN,25.85305787652638,15.144118704648344,-56399
2025-09-11T10:45:00-04:00,24014.25,24022,23996.5,24006.25,23941.535161841213,NaN,NaN,NaN,NaN,NaN,23953.505,24001.533271882476,23905.476728117526,23960.639278141385,23947.324814161075,23981.93855052846,23912.71107779369,16522,16189.733333333334,61.61525260201123,56.47370632649821,NaN,NaN,NaN,NaN,25.82783945677449,15.467673348313529,-72921
2025-09-11T10:50:00-04:00,24006.5,24009.75,23975.5,23991.25,23941.535161841213,NaN,NaN,NaN,NaN,NaN,23954.505,24003.542484642414,23905.467515357588,23960.639278141385,23948.730345807286,23983.681855865554,23913.778835749017,20954,16783.866666666665,56.30590722707489,57.39150341438201,NaN,NaN,NaN,NaN,26.429422352719172,14.713048709947781,-93875
2025-09-11T10:55:00-04:00,23991.5,24005.25,23975.25,24004,23941.535161841213,NaN,NaN,NaN,NaN,NaN,23955.705,24006.558386315726,23904.851613684277,23960.639278141385,23949.780787652875,23985.010025300435,23914.551550005315,15587,17141.133333333335,59.500435296091574,57.963945176119864,NaN,NaN,NaN,NaN,26.684463613239227,14.000487581917747,-78288
2025-09-11T11:00:00-04:00,24003.5,24012.25,24001.25,24006.25,23941.535161841213,NaN,NaN,NaN,NaN,NaN,23956.88,24009.60136568682,23904.158634313182,23960.639278141385,23950.625673874983,23986.261566158708,23914.98978159126,10329,16557.933333333334,60.055442491109766,58.18501800959006,NaN,NaN,NaN,NaN,25.56414478372214,13.648247642506142,-67959
2025-09-11T11:05:00-04:00,24006.25,24017.75,24000.25,24006.5,23941.535161841213,NaN,NaN,NaN,NaN,NaN,23958.1,24012.50772004308,23903.69227995692,23961.09864832671,23951.524054742902,23987.59310509555,23915.455004390253,11014,16563.033333333333,60.12083627599021,58.27068708987803,NaN,NaN,NaN,NaN,24.9881344420277,13.561822276535512,-56945
2025-09-11T11:10:00-04:00,24006.75,24019,24005.5,24016.75,23943.27029171967,NaN,NaN,NaN,NaN,NaN,23959.495,24016.220169896173,23902.769830103825,23966.928918661368,23952.23344890117,23988.699657367804,23915.767240434536,8135,16520.5,62.809170522315945,58.526726421056594,NaN,NaN,NaN,NaN,24.167553410454293,13.537779465253951,-48810
2025-09-11T11:15:00-04:00,24016.5,24048.75,24013.5,24039.75,23960.47391482332,NaN,NaN,NaN,NaN,NaN,23961.375,24022.2335450024,23900.5164549976,23989.468134929095,23954.954167169057,23993.691723403612,23916.2166109345,24561,16868.733333333334,68.01894230211465,59.05648580609091,NaN,NaN,NaN,NaN,24.959156738278985,14.675890487148111,-24249
2025-09-11T11:20:00-04:00,24040,24044,24025.5,24029.25,23964.78760051317,NaN,NaN,NaN,NaN,NaN,23963.07,24026.615656026042,23899.524343973957,23989.468134929095,23956.43552884675,23996.252380741313,23916.618676952185,14297,16991.5,63.63632006298155,59.92923342679297,NaN,NaN,NaN,NaN,24.497788399830487,15.73270786462126,-38546
2025-09-11T11:25:00-04:00,24029,24039.5,24024.5,24038,23964.78760051317,NaN,NaN,NaN,NaN,NaN,23964.985,24031.602295802062,23898.36770419794,23989.468134929095,23957.354437063856,23997.81466291584,23916.89421121187,9021,17051.8,65.62407133743045,61.07766769714762,NaN,NaN,NaN,NaN,23.81937494269974,16.647030439046897,-29525
2025-09-11T11:30:00-04:00,24037.75,24045.75,24035,24037.25,23973.20987980642,NaN,NaN,NaN,NaN,NaN,23966.92,24036.149360823732,23897.690639176264,23998.102685083697,23958.351584476357,23999.556786361038,23917.146382591676,9376,17135.3,65.29460623888887,61.87385704476025,NaN,NaN,NaN,NaN,22.885848161078325,17.733422578369353,-38901
2025-09-11T11:35:00-04:00,24037.5,24039,24022.75,24024.25,23973.20987980642,NaN,NaN,NaN,NaN,NaN,23968.545,24039.25077699187,23897.839223008126,23998.102685083697,23959.224884703966,24000.90731473735,23917.542454670584,9694,17250.166666666668,59.69979007898568,62.340362460323625,NaN,NaN,NaN,NaN,22.411859006715588,17.90040119241321,-48595
2025-09-11T11:40:00-04:00,24024.5,24028.5,24018.5,24019,23973.20987980642,NaN,NaN,NaN,NaN,NaN,23970.04,24041.78122664016,23898.298773359842,23998.102685083697,23959.867600451093,24001.814829451287,23917.9203714509,8074,17383.3,57.554964700400895,62.07828517663141,NaN,NaN,NaN,NaN,21.525297649093044,17.778296713135205,-56669
2025-09-11T11:45:00-04:00,24019.25,24024,24003,24011.75,23973.20987980642,NaN,NaN,NaN,NaN,NaN,23971.345,24043.697186560526,23898.992813439476,23998.102685083697,23960.715553047477,24002.854710396,23918.576395698954,12810,17676.2,54.63579215093292,61.393218551709076,NaN,NaN,NaN,NaN,21.48777638844354,16.730173287051677,-69479
2025-09-11T11:50:00-04:00,24011.5,24029.5,24010.5,24026.75,23973.20987980642,NaN,NaN,NaN,NaN,NaN,23972.9,24046.593961758845,23899.20603824116,23998.102685083697,23961.512915285188,24003.952618870157,23919.07321170022,10521,17904.033333333333,59.241849862862836,61.008098653513684,NaN,NaN,NaN,NaN,21.310078074983288,16.042502074588423,-58958
2025-09-11T11:55:00-04:00,24026.5,24030,24021.75,24024.25,23973.20987980642,NaN,NaN,NaN,NaN,NaN,23974.305,24049.173370491848,23899.436629508153,23998.102685083697,23961.88713852915,24004.481859091266,23919.292417967034,4789,17758.666666666668,58.18153547367464,60.76283314434678,NaN,NaN,NaN,NaN,20.377215355341626,15.430648179129914,-63747
2025-09-11T12:00:00-04:00,24024,24043.5,24021.25,24041.25,23973.20987980642,NaN,NaN,NaN,NaN,NaN,23976.185,24052.938554311582,23899.43144568842,24000.41814227858,23962.78624801403,24005.88297262142,23919.689523406636,10122,16894.266666666666,63.02748250871208,61.24294566446372,NaN,NaN,NaN,NaN,20.510985687102938,15.554688880037142,-53625
2025-09-11T12:05:00-04:00,24041.5,24042.75,24033,24037,23976.738947872145,NaN,NaN,NaN,NaN,NaN,23978.01,24056.10967733834,23899.910322661657,24003.409513822866,23963.30155777009,24006.692914683026,23919.910200857154,5736,15911.9,61.12060448604351,61.35867203517457,NaN,NaN,NaN,NaN,19.74234385230987,15.669869530879568,-59361
2025-09-11T12:10:00-04:00,24037,24040.5,24032.25,24034,23976.892859332504,NaN,NaN,NaN,NaN,NaN,23979.765,24058.868312827253,23900.661687172746,24004.902611058293,23963.652667067472,24007.229261894274,23920.07607224067,4064,15083.7,59.74649173442148,61.33660412398255,NaN,NaN,NaN,NaN,18.92146214857345,15.720723878113036,-63425
2025-09-11T12:15:00-04:00,24033.75,24038.75,24025,24037.75,23976.892859332504,NaN,NaN,NaN,NaN,NaN,23981.625,24061.71490260903,23901.53509739097,24004.902611058293,23964.243394232457,24008.107327382164,23920.37946108275,7102,14238.3,60.92894652925025,61.3943262849297,NaN,NaN,NaN,NaN,18.552071995103915,15.22569338204006,-56323
2025-09-11T12:20:00-04:00,24037,24041.75,24030,24032,23978.285384226518,NaN,NaN,NaN,NaN,NaN,23983.38,24063.961216172538,23902.798783827464,24007.592671077306,23964.756741686942,24008.868509691216,23920.64497368267,6203,13553.966666666667,58.11020980683194,61.058686233823686,NaN,NaN,NaN,NaN,18.06620970973935,14.95004909134227,-62526
2025-09-11T12:25:00-04:00,24032.5,24037.5,24022.75,24024.5,23978.285384226518,NaN,NaN,NaN,NaN,NaN,23985,24065.565935728977,23904.434064271023,24007.592671077306,23965.135230699358,24009.386071914276,23920.88438948444,5097,12999.866666666667,54.56437781700488,60.09764591345871,NaN,NaN,NaN,NaN,17.82933758761511,14.149353730819895,-67623
2025-09-11T12:30:00-04:00,24024.75,24033.25,24022.5,24025.25,23978.285384226518,NaN,NaN,NaN,NaN,NaN,23986.66,24067.0543256709,23906.2656743291,24007.592671077306,23965.563253434175,24009.957910133664,23921.168596734686,5957,12602.533333333333,54.860999118263926,59.470837274550306,NaN,NaN,NaN,NaN,17.323670617071176,13.38705490597993,-61666
2025-09-11T12:35:00-04:00,24025,24026.5,24016.25,24017,23978.285384226518,NaN,NaN,NaN,NaN,NaN,23987.865,24068.23608994995,23907.493910050052,24007.592671077306,23965.933734739396,24010.402278100544,23921.465191378247,5909,12046.833333333334,50.92281826858628,58.42074776963286,NaN,NaN,NaN,NaN,16.81840843013752,12.65496202529493,-67575
2025-09-11T12:40:00-04:00,24016.5,24019,24006.25,24014.75,23978.285384226518,NaN,NaN,NaN,NaN,NaN,23990.505,24065.37505342565,23915.63494657435,24007.592671077306,23966.385659262356,24010.88076499111,23921.8905535336,8345,11480.066666666668,49.87134964463518,57.319086584329035,NaN,NaN,NaN,NaN,16.52780782798484,12.661644533375568,-75920
2025-09-11T12:45:00-04:00,24014.5,24017.75,24007.25,24016.5,23978.285384226518,NaN,NaN,NaN,NaN,NaN,23992.865,24063.293063296158,23922.436936703845,24007.592671077306,23966.694904623317,24011.208813899026,23922.180995347608,5742,10927.066666666668,50.72359205531423,56.677929582638214,NaN,NaN,NaN,NaN,16.097250125985923,12.667849719450446,-70178
2025-09-11T12:50:00-04:00,24016.25,24016.25,23994.75,24008.25,23978.285384226518,NaN,NaN,NaN,NaN,NaN,23994.535,24062.3341157754,23926.7358842246,24007.592671077306,23967.147680185437,24011.607570109365,23922.68779026151,10158,10767.633333333333,46.69333619039397,55.90209897478058,NaN,NaN,NaN,NaN,16.501017974129784,13.457333278224807,-80336
2025-09-11T12:55:00-04:00,24008,24017.25,24002.25,24008.5,23978.285384226518,NaN,NaN,NaN,NaN,NaN,23996.07,24061.549312763866,23930.590687236134,24007.592671077306,23967.528083583074,24011.966357754656,23923.089809411493,8109,10607.066666666668,46.83119998239342,55.34462810559919,NaN,NaN,NaN,NaN,16.393802404549085,14.09570860125426,-72227
2025-09-11T13:00:00-04:00,24008.75,24011.25,23998.25,24001.5,23978.285384226518,NaN,NaN,NaN,NaN,NaN,23997.11,24061.235436450446,23932.984563549555,24007.592671077306,23967.775892423928,24012.161847099906,23923.38993774795,6209,10213.633333333333,43.44327352791442,54.21615836738859,NaN,NaN,NaN,NaN,16.151387947081293,14.933120561699306,-78436
2025-09-11T13:05:00-04:00,24001.25,24013.75,23997.25,24012.75,23978.285384226518,NaN,NaN,NaN,NaN,NaN,23998.18,24061.523432176768,23934.836567823233,24007.592671077306,23968.087191473864,24012.44069486979,23923.733688077937,7077,9830.6,49.73672176043021,53.61295738787113,NaN,NaN,NaN,NaN,16.176288808004056,15.451462816853809,-71359
2025-09-11T13:10:00-04:00,24012.5,24026.25,24011,24024.75,23978.285384226518,NaN,NaN,NaN,NaN,NaN,23999.595,24062.08266997975,23937.10733002025,24002.799136861846,23968.61955377659,24013.060786099926,23924.17832145325,9334,9694.933333333332,55.43346535669866,53.07052759129874,NaN,NaN,NaN,NaN,16.11012532171805,14.759338340600289,-62025
2025-09-11T13:15:00-04:00,24024.5,24027.5,24012,24016.75,23978.285384226518,NaN,NaN,NaN,NaN,NaN,24000.93,24061.95745611584,23939.90254388416,24000.114309489476,23969.035974162558,24013.525513025008,23924.546435300108,7722,9401.6,51.26221146814223,52.36635666144865,NaN,NaN,NaN,NaN,16.066544941595332,14.008832028558693,-69747
2025-09-11T13:20:00-04:00,24016,24027,24013.75,24025,23978.285384226518,NaN,NaN,NaN,NaN,NaN,24002.44,24062.021671680497,23942.8583283195,23994.86644759158,23969.354421169348,24013.898084221622,23924.810758117073,5632,8890.866666666667,55.021041081056936,52.02882447192261,NaN,NaN,NaN,NaN,15.865363160052809,13.311933310234354,-64115
2025-09-11T13:25:00-04:00,24024.75,24030.25,24012.25,24014,23978.285384226518,NaN,NaN,NaN,NaN,NaN,24003.695,24061.52866579827,23945.86133420173,23992.19707851774,23969.76710175431,24014.35227673613,23925.181926772493,7866,8633.5,49.53541676386467,51.21500091725221,NaN,NaN,NaN,NaN,16.01783722004904,12.364602097350174,-71981
2025-09-11T13:30:00-04:00,24014,24030,24013.5,24026.5,23978.285384226518,NaN,NaN,NaN,NaN,NaN,24005.16,24061.49984025454,23948.82015974546,23992.19707851774,23970.114369032406,24014.762235464234,23925.46650260058,6154,8494.333333333334,55.0230972200623,50.99449287534009,NaN,NaN,NaN,NaN,16.052277418616963,11.484937399672006,-65827
2025-09-11T13:35:00-04:00,24026.75,24030.5,24020.25,24024,23978.285384226518,NaN,NaN,NaN,NaN,NaN,24006.1,24062.09642846094,23950.103571539057,23994.421130251354,23970.366873135892,24015.066103490997,23925.667642780787,4394,8273.666666666666,53.76386087133011,50.937313093506184,NaN,NaN,NaN,NaN,15.637829031572894,10.720281492779135,-70221
2025-09-11T13:40:00-04:00,24024.25,24034.5,24021,24029.5,23978.285384226518,NaN,NaN,NaN,NaN,NaN,24006.99,24063.031231248246,23950.948768751758,23998.88690420108,23970.79309134046,24015.602183715277,23925.983998965643,7064,8237.966666666667,56.141902076618194,51.02880616196006,NaN,NaN,NaN,NaN,15.485126957889117,10.430040029082956,-63157
2025-09-11T13:45:00-04:00,24029.75,24032,24006.25,24009.75,23978.285384226518,NaN,NaN,NaN,NaN,NaN,24008.49,24060.593163048943,23956.38683695106,23998.88690420108,23971.182017032417,24015.99285920987,23926.371174854965,8337,7697.166666666667,46.82798480245451,50.73631805723637,NaN,NaN,NaN,NaN,16.218332175182752,10.660311936256603,-71494
2025-09-11T13:50:00-04:00,24010,24024.75,24003.5,24024.25,23978.285384226518,NaN,NaN,NaN,NaN,NaN,24010.48,24056.93189339461,23964.02810660539,23998.88690420108,23971.555808386336,24016.377457598297,23926.734159174375,7884,7483.4,52.99374326613009,50.95934617305743,NaN,NaN,NaN,NaN,16.577737019812556,11.101269540304557,-63610
2025-09-11T13:55:00-04:00,24023.75,24033,24018,24032.5,23978.285384226518,NaN,NaN,NaN,NaN,NaN,24012.13,24055.639222006783,23968.62077799322,23998.88690420108,23971.899960730414,24016.79922998602,23927.00069147481,6011,7383.066666666667,56.11205321887753,51.3442362561691,NaN,NaN,NaN,NaN,16.465041518397374,10.623389216887121,-57599
2025-09-11T14:00:00-04:00,24032.75,24035.75,24023.25,24026.25,23978.718665137723,NaN,NaN,NaN,NaN,NaN,24013.235,24055.29191500878,23971.17808499122,23998.88690420108,23972.269818011962,24017.253347596084,23927.28628842784,6475,7286.366666666667,53.23107734904904,51.8112177675016,NaN,NaN,NaN,NaN,16.181824267083275,9.905445623177965,-64074
2025-09-11T14:05:00-04:00,24026.5,24032.75,24024.25,24029.25,23978.86781672237,NaN,NaN,NaN,NaN,NaN,24014.235,24055.3799158456,23973.090084154403,23998.88690420108,23972.52287372247,24017.563747285214,23927.48200015973,4453,7111.666666666667,54.440256503001876,52.35472180468792,NaN,NaN,NaN,NaN,15.633122533720185,9.238783714733747,-59621
2025-09-11T14:10:00-04:00,24029.25,24034.75,24021,24026.75,23978.86781672237,NaN,NaN,NaN,NaN,NaN,24015.16,24055.296860862163,23975.023139137837,23998.88690420108,23972.8156418114,24017.914276537653,23927.71700708515,5321,7019.9,53.20574469269294,53.05204117360067,NaN,NaN,NaN,NaN,15.498613781311601,8.960457625536126,-64942
2025-09-11T14:15:00-04:00,24026.75,24030,24021.25,24022.5,23978.86781672237,NaN,NaN,NaN,NaN,NaN,24015.89,24055.19803480398,23976.58196519602,23998.88690420108,23973.056362768206,24018.187647430008,23927.925078106404,4668,6748.5,51.08493576607819,53.14834217400409,NaN,NaN,NaN,NaN,15.016569939789344,8.70201197128119,-69610
2025-09-11T14:20:00-04:00,24022.5,24025.75,24015,24021,23978.86781672237,NaN,NaN,NaN,NaN,NaN,24017.13,24052.93701606931,23981.32298393069,23998.88690420108,23973.29997053299,24018.44320156545,23928.15673950053,5172,6570.2,50.32251906355025,52.783274581636356,NaN,NaN,NaN,NaN,14.711814944090106,9.115550063476196,-74782
2025-09-11T14:25:00-04:00,24021,24028.75,24014,24021.5,23978.86781672237,NaN,NaN,NaN,NaN,NaN,24018.505,24049.23812381589,23987.771876184113,23998.88690420108,23973.58919968346,24018.74996289421,23928.428436472714,6102,6613.966666666666,50.587248367627595,52.735062931599586,NaN,NaN,NaN,NaN,14.714542448083671,9.110388426986384,-68680
2025-09-11T14:30:00-04:00,24021.25,24025.5,24017.25,24020,23978.86781672237,NaN,NaN,NaN,NaN,NaN,24019.53,24046.77805313995,23992.281946860046,23998.72836061489,23973.748480710172,24018.91642944942,23928.580531970925,3428,6390.833333333333,49.7310468524559,52.35720620098523,NaN,NaN,NaN,NaN,14.252789416077695,9.10559547881727,-72108
2025-09-11T14:35:00-04:00,24019.75,24029.75,24017,24029.5,23978.86781672237,NaN,NaN,NaN,NaN,NaN,24020.805,24043.44396861839,23998.16603138161,23999.007429206285,23973.961109068743,24019.157223605518,23928.764994531968,4209,6339.933333333333,54.93347441434618,52.7427817474482,NaN,NaN,NaN,NaN,14.145447314929287,8.536339187730745,-67899
2025-09-11T14:40:00-04:00,24029,24034.25,24025.75,24032.75,23984.988310859462,NaN,NaN,NaN,NaN,NaN,24021.505,24043.401458612934,23999.608541387068,24005.40594336503,23974.19812558805,24019.448887967843,23928.947363208255,4274,6346.933333333333,56.58868619751223,52.854609531551766,NaN,NaN,NaN,NaN,13.742201078148623,8.39716790840697,-63625
2025-09-11T14:45:00-04:00,24032.75,24038.25,24030,24035.5,23990.03429672949,NaN,NaN,NaN,NaN,NaN,24021.97,24044.047282435276,23999.892717564726,24011.049754692023,23974.452454281174,24019.77684449135,23929.128064071,4344,6255,57.99453716013856,53.15680069503808,NaN,NaN,NaN,NaN,13.349901001138008,8.722503649973861,-59281
2025-09-11T14:50:00-04:00,24036,24042.25,24032.5,24034.75,23993.958874150874,NaN,NaN,NaN,NaN,NaN,24022.38,24044.629323577457,24000.130676422545,24015.61480375362,23974.791630587246,24020.222905613835,23929.360355560657,5669,6237.2,57.44811863273009,53.2501018776175,NaN,NaN,NaN,NaN,13.092765215342435,9.449601865900876,-64950
2025-09-11T14:55:00-04:00,24034.75,24041.5,24030.75,24033.5,23993.958874150874,NaN,NaN,NaN,NaN,NaN,24022.925,24044.900497722087,24000.949502277912,24015.61480375362,23975.06445103582,24020.573864626145,23929.555037445498,4701,6224,56.49276405922605,53.940443253101186,NaN,NaN,NaN,NaN,12.925424842817975,9.859782842618959,-69651
2025-09-11T15:00:00-04:00,24033.5,24035,24027.75,24031,23993.958874150874,NaN,NaN,NaN,NaN,NaN,24023.72,24043.85321632984,24003.586783670162,24015.61480375362,23975.300865285688,24020.85982946441,23929.741901106965,4402,6172.166666666667,54.539267041237295,54.050837808465985,NaN,NaN,NaN,NaN,12.520037354045261,9.792543106041052,-74053
2025-09-11T15:05:00-04:00,24030.25,24037.5,24023.75,24025,23993.958874150874,NaN,NaN,NaN,NaN,NaN,24024.14,24043.470328505042,24004.809671494957,24015.61480375362,23975.578926953316,24021.181623527733,23929.9762303789,5471,6157.566666666667,50.06473355468211,53.618886403880595,NaN,NaN,NaN,NaN,12.607891828756314,9.165822337560341,-79524
2025-09-11T15:10:00-04:00,24025,24031.75,24021.75,24023.5,23993.958874150874,NaN,NaN,NaN,NaN,NaN,24024.485,24043.12941203094,24005.84058796906,24015.61480375362,23975.84517520794,24021.472101350333,23930.21824906555,5620,6066.733333333334,48.982784950070645,53.31543694681071,NaN,NaN,NaN,NaN,12.421613840988005,8.709588737033354,-85144
2025-09-11T15:15:00-04:00,24023.5,24033.75,24021,24031,23993.958874150874,NaN,NaN,NaN,NaN,NaN,24024.975,24042.979791046004,24006.970208953993,24015.61480375362,23976.11973552028,24021.78572570112,23930.453745339437,5533,6059.766666666666,54.30067325838915,53.30546671505266,NaN,NaN,NaN,NaN,12.445069995203147,8.17461263957001,-79611
2025-09-11T15:20:00-04:00,24030.75,24036.5,24027.5,24033.25,23993.958874150874,NaN,NaN,NaN,NaN,NaN,24025.305,24043.299524175825,24007.310475824175,24015.61480375362,23976.33734286861,24022.048667484094,23930.626018253126,4124,5858.633333333333,55.78953206404992,53.49002295586387,NaN,NaN,NaN,NaN,12.19899356697435,8.0621718683991,-75487
2025-09-11T15:25:00-04:00,24033.25,24038.75,24030,24032.75,23994.441895543572,NaN,NaN,NaN,NaN,NaN,24025.165,24042.813402186574,24007.51659781343,24015.61480375362,23976.5317112768,24022.287575017035,23930.775847536563,3619,5708.966666666666,55.35791795867715,53.79523596962094,NaN,NaN,NaN,NaN,11.95263688361904,8.263287866479397,-79106
2025-09-11T15:30:00-04:00,24033,24041.5,24025.5,24036.25,23994.441895543572,NaN,NaN,NaN,NaN,NaN,24025.305,24043.190270482664,24007.419729517336,24015.61480375362,23976.906095621074,24022.7491898408,23931.063001401348,6969,5734.3,57.81801718411878,54.330628692518694,NaN,NaN,NaN,NaN,12.241734249074822,7.738977349370001,-72137
2025-09-11T15:35:00-04:00,24036.25,24039.75,24029.75,24035.75,23994.91839036098,NaN,NaN,NaN,NaN,NaN,24025.26,24043.028218831627,24007.49178116837,24015.61480375362,23977.20555521701,24023.11964556163,23931.29146487239,5575,5684.233333333334,57.331955284538196,54.81239347229802,NaN,NaN,NaN,NaN,12.081610374140906,7.252117583482705,-77712
2025-09-11T15:40:00-04:00,24036,24037.5,24024.75,24025.75,23994.91839036098,NaN,NaN,NaN,NaN,NaN,24025.03,24042.46606607974,24007.593933920256,24014.816843002896,23977.45639543698,24023.40171364119,23931.51107723277,5237,5547.666666666667,48.542444424569595,54.72749329887756,NaN,NaN,NaN,NaN,12.1293524902737,7.415722936719786,-82949
2025-09-11T15:45:00-04:00,24026.25,24037.25,24023.5,24036.75,23994.91839036098,NaN,NaN,NaN,NaN,NaN,24025.28,24043.01996618921,24007.540033810787,24013.13633049215,23977.761194288974,24023.76083860336,23931.761549974588,6060,5492.266666666666,56.451405916409485,54.83591697759637,NaN,NaN,NaN,NaN,12.24511302668272,7.743132632827521,-76889
2025-09-11T15:50:00-04:00,24036.25,24044.25,24027.25,24036.25,23995.414698829172,NaN,NaN,NaN,NaN,NaN,24025.625,24043.53316852351,24007.71683147649,24013.13633049215,23978.41327162306,24024.562359625426,23932.264183620693,12410,5718.2,56.029853292273714,54.796000341507906,NaN,NaN,NaN,NaN,12.584747810491097,7.4589002339547035,-89299
2025-09-11T15:55:00-04:00,24035.75,24040.5,24007.5,24011.75,23995.414698829172,NaN,NaN,NaN,NaN,NaN,24025.625,24043.53316852351,24007.71683147649,24013.13633049215,23979.151315690215,24025.215969893074,23933.086661487356,20038,6123.933333333333,40.19197122348693,53.524388488889926,NaN,NaN,NaN,NaN,14.042980109741732,8.87742742448225,-109337
2025-09-11T16:00:00-04:00,24011.75,24015.25,24003.75,24010,23995.414698829172,NaN,NaN,NaN,NaN,NaN,24025.29,24043.720507316644,24006.859492683358,24013.13633049215,23979.460767046126,24025.393122084708,23933.528412007545,11544,6303.6,39.336645392562716,52.23071182887797,NaN,NaN,NaN,NaN,13.861338673331607,10.494266455780165,-120881
2025-09-11T16:05:00-04:00,24010.25,24024,24009.25,24020.5,23995.414698829172,NaN,NaN,NaN,NaN,NaN,24025.215,24043.692286055673,24006.737713944327,24013.13633049215,23979.64232662771,24025.541885736293,23933.742767519125,5400,6337.133333333333,46.66995713873807,51.529082763128834,NaN,NaN,NaN,NaN,13.924814482379348,10.805796049891725,-115481
2025-09-11T16:10:00-04:00,24019.75,24021.75,24004.5,24007.5,23995.414698829172,NaN,NaN,NaN,NaN,NaN,24024.54,24043.09056871175,24005.989431288253,24013.13633049215,23979.752068608894,24025.609581173485,23933.894556044303,3985,6234.5,40.1918200402415,50.504265120200564,NaN,NaN,NaN,NaN,14.162327733637966,11.514363777300966,-119466
2025-09-11T16:15:00-04:00,24007.5,24016,24005.75,24011.25,23995.414698829172,NaN,NaN,NaN,NaN,NaN,24024.025,24042.593050505136,24005.456949494866,24013.009064393722,23979.824998022486,24025.65377781391,23933.996218231063,2685,6046.1,42.66417813433137,49.97565401874694,NaN,NaN,NaN,NaN,13.882875752663825,12.172319524180976,-116781
2025-09-11T16:20:00-04:00,24011,24013.25,24009.5,24011.25,23995.414698829172,NaN,NaN,NaN,NaN,NaN,24023.57,24042.252622942942,24004.887377057057,24011.957251514978,23979.848069322838,24025.667994904885,23934.02814374079,843,5811.4,42.66417813433137,49.52432496047985,NaN,NaN,NaN,NaN,13.159098913187837,12.783278431998127,-116781
2025-09-11T16:25:00-04:00,24010.75,24013.25,24008.75,24012,23995.414698829172,NaN,NaN,NaN,NaN,NaN,24023.055,24041.56453538121,24004.54546461879,24011.94011277567,23979.87995218001,24025.68761995014,23934.072284409882,1167,5649.933333333333,43.20872066068513,48.73204263207242,NaN,NaN,NaN,NaN,12.540591847960133,13.426550972507181,-115614
2025-09-11T16:30:00-04:00,24011.75,24014.5,24010.25,24012.5,23995.414698829172,NaN,NaN,NaN,NaN,NaN,24022.665,24041.22587551009,24004.104124489913,24011.94011277567,23979.912218383,24025.708619168512,23934.11581759749,1144,5472.233333333334,43.59333863762784,47.860885958756555,NaN,NaN,NaN,NaN,11.94840671596298,13.81936020530721,-114470
2025-09-11T16:35:00-04:00,24012.5,24013.25,24007.5,24008.75,23995.414698829172,NaN,NaN,NaN,NaN,NaN,24022.35,24041.306001698682,24003.393998301315,24011.94011277567,23979.947839806537,24025.728600146515,23934.16707946656,1375,5369.633333333333,41.33242111703256,46.859064755781944,NaN,NaN,NaN,NaN,11.505663379108482,14.489650565274662,-115845
2025-09-11T16:40:00-04:00,24007.75,24008.75,24005,24006.75,23995.414698829172,NaN,NaN,NaN,NaN,NaN,24021.98,24041.411376691707,24002.548623308292,23998.152090220534,23979.973653764973,24025.740006321852,23934.207301208095,1110,5229.266666666666,40.13680757375612,45.5961212121846,NaN,NaN,NaN,NaN,10.951687423457875,15.381492614872746,-116955
2025-09-11T16:45:00-04:00,24006.5,24012,24004.25,24011.25,23995.414698829172,NaN,NaN,NaN,NaN,NaN,24021.865,24041.480098763812,24002.24990123619,23992.45257459508,23980.009920758337,24025.759394483426,23934.260447033248,1438,5121.6,44.05789044559136,44.647973723688395,NaN,NaN,NaN,NaN,10.722995464639455,15.626093233490948,-115517
2025-09-11T16:50:00-04:00,24011,24011.75,24007,24010,23995.414698829172,NaN,NaN,NaN,NaN,NaN,24021.77,24041.567181606555,24001.972818393446,23993.737059676063,23980.032565435744,24025.771835986434,23934.293294885054,887,4978.766666666666,43.21120000314755,44.26717055072968,NaN,NaN,NaN,NaN,10.296352931450922,15.8532223793507,-116404
2025-09-11T16:55:00-04:00,24009.75,24010.75,24006,24006.5,23995.414698829172,NaN,NaN,NaN,NaN,NaN,24021.57,24041.77396991565,24001.36603008435,23993.964647740853,23980.058239576818,24025.784096346513,23934.332382807122,1074,4811.166666666667,40.844324620581034,43.15237902959908,NaN,NaN,NaN,NaN,9.900184864918714,16.194295267170425,-117478
2025-09-11T18:00:00-04:00,24028,24029.5,24010.75,24018.75,23995.414698829172,NaN,NaN,NaN,NaN,NaN,24021.78,24041.641178216472,24001.918821783525,24004.57171819268,24019.666666666668,24019.666666666668,24019.666666666668,3695,4820.066666666667,50.96748202030725,42.79078108160148,NaN,NaN,NaN,NaN,10.83588594599595,16.25122997811452,-113783
2025-09-11T18:05:00-04:00,24018.25,24025,24014,24023.25,23995.414698829172,NaN,NaN,NaN,NaN,NaN,24022.075,24041.57326915102,24002.57673084898,24004.57171819268,24020.014034442607,24020.519653508243,24019.50841537697,1744,4737.9,54.076449225437656,43.782529510312244,NaN,NaN,NaN,NaN,10.84760837842481,16.304097923991183,-112039
2025-09-11T18:10:00-04:00,24024,24024.5,24014.5,24015.25,23995.414698829172,NaN,NaN,NaN,NaN,NaN,24022.35,24041.05133685724,24003.648663142758,24004.57171819268,24019.744897151897,24020.56172163382,24018.928072669973,881,4624.8,48.22256164117225,44.417237813784354,NaN,NaN,NaN,NaN,10.787064922823038,16.35318958801951,-112920
2025-09-11T18:15:00-04:00,24014.5,24017,24010,24010.25,23995.414698829172,NaN,NaN,NaN,NaN,NaN,24022.3,24041.11674786385,24003.48325213615,24004.57171819268,24018.833183245588,24021.369760116366,24016.29660637481,898,4509.933333333333,44.94759155533805,44.29421170068435,NaN,NaN,NaN,NaN,10.516560285478535,15.684369350500216,-113818
2025-09-11T18:20:00-04:00,24010,24017.5,24003.5,24014.5,23995.414698829172,NaN,NaN,NaN,NaN,NaN,24022.095,24041.02352080588,24003.166479194122,24004.57171819268,24017.763487871674,24021.19778883451,24014.32918690884,1302,4364.366666666667,48.169729609795226,44.86406238422391,NaN,NaN,NaN,NaN,10.765377407944355,14.961795715714917,-112516
2025-09-11T18:25:00-04:00,24014.5,24016.75,24010.25,24014,23995.414698829172,NaN,NaN,NaN,NaN,NaN,24022.04,24041.04614637794,24003.033853622062,24004.57171819268,24017.48391477107,24020.9561984738,24014.01163106834,624,4228.466666666666,47.81516187825877,45.23198979450443,NaN,NaN,NaN,NaN,10.460707593091186,14.290834483414283,-113140
2025-09-11T18:30:00-04:00,24014.5,24016.5,24006,24007.75,23995.414698829172,NaN,NaN,NaN,NaN,NaN,24021.695,24041.095847919358,24002.29415208064,24004.57171819268,24016.660988530326,24020.677080929705,24012.644896130947,1144,4119.866666666667,43.50441041715633,45.29200638613479,NaN,NaN,NaN,NaN,10.463514193584672,14.219093767852206,-114284
2025-09-11T18:35:00-04:00,24008,24010.75,24005.25,24006.5,23995.414698829172,NaN,NaN,NaN,NaN,NaN,24021.545,24041.2943518892,24001.795648110798,24004.57171819268,24015.996191291804,24020.535661414284,24011.456721169325,805,3964.3333333333335,42.675737645225404,45.25393617074481,NaN,NaN,NaN,NaN,10.108977465471481,14.247213626110014,-115089
2025-09-11T18:40:00-04:00,24006.75,24007.5,24001,24005.25,23995.414698829172,NaN,NaN,NaN,NaN,NaN,24021.12,24041.333668644605,24000.906331355392,24004.57171819268,24015.06543577855,24020.421041555397,24009.709830001702,985,3809.8333333333335,41.81791628898209,45.127120288698684,NaN,NaN,NaN,NaN,9.851193360794948,14.794014770027422,-116074
2025-09-11T18:45:00-04:00,24004.75,24010.5,24003,24008,23995.414698829172,NaN,NaN,NaN,NaN,NaN,24020.8,24041.325350178788,24000.27464982121,24004.57171819268,24014.73219666931,24020.2088347553,24009.255558583318,532,3643.133333333333,44.462803372582634,45.35071902123798,NaN,NaN,NaN,NaN,9.683250977881022,14.771109437499295,-115542
2025-09-11T18:50:00-04:00,24008,24014.25,24007.75,24012.25,23995.414698829172,NaN,NaN,NaN,NaN,NaN,24020.455,24040.96370302429,23999.946296975715,23999.557374554144,24014.57086005281,24019.96001011118,24009.18170999444,645,3527.1666666666665,48.369127270737174,45.93874185673662,NaN,NaN,NaN,NaN,9.455875908032377,14.129897549440054,-114897
2025-09-11T18:55:00-04:00,24012.25,24014.5,24011.25,24013,23995.414698829172,NaN,NaN,NaN,NaN,NaN,24020.52,24040.91285169114,24000.12714830886,23999.145899643318,24014.517830193272,24019.827895533155,24009.20776485339,439,3421.1666666666665,49.0501849979954,46.295334324765484,NaN,NaN,NaN,NaN,9.012599057458635,13.493575086983201,-114458
2025-09-11T19:00:00-04:00,24013.5,24014,24009.75,24011.5,23995.414698829172,NaN,NaN,NaN,NaN,NaN,24020.265,24040.78338443557,23999.74661556443,23997.918306635715,24014.43299473821,24019.682771902935,24009.183217573485,433,3203.3,47.69511103115928,46.61561368390918,NaN,NaN,NaN,NaN,8.672413410497304,13.131525499472357,-114891
2025-09-11T19:05:00-04:00,24011.75,24012,24005.25,24006.5,23995.414698829172,NaN,NaN,NaN,NaN,NaN,24019.745,24040.314513858135,23999.175486141863,23997.918306635715,24014.183253914227,24019.48126572956,24008.885242098895,563,3036.233333333333,43.39188374482442,46.79758219278371,NaN,NaN,NaN,NaN,8.535098166890354,13.43929802520285,-115454
2025-09-11T19:10:00-04:00,24007,24018,24006.25,24016.5,23995.414698829172,NaN,NaN,NaN,NaN,NaN,24019.55,24040.053902063933,23999.046097936065,23999.132716246855,24014.14577084264,24019.277657721883,24009.013883963395,979,2894.3,52.60253279298648,46.91437153368937,NaN,NaN,NaN,NaN,8.764734012112472,12.68612510507472,-114475
2025-09-11T19:15:00-04:00,24015.75,24018.5,24014,24018.25,23995.414698829172,NaN,NaN,NaN,NaN,NaN,24019.33,24039.648080616735,23999.01191938327,24001.156172997486,24014.245827181756,24019.3106570489,24009.180997314612,587,2711.866666666667,54.01270492946944,46.90981836969164,NaN,NaN,NaN,NaN,8.460110154104438,11.905956304057362,-113888
2025-09-11T19:20:00-04:00,24017.5,24024,24016.75,24022.25,23995.414698829172,NaN,NaN,NaN,NaN,NaN,24019.24,24039.465469094815,23999.014530905188,24006.49993839799,24014.600149607522,24019.75518476076,24009.445114454284,900,2328.2,57.15080162797112,47.54754979732013,NaN,NaN,NaN,NaN,8.37367371452555,11.76706003954629,-112988
2025-09-11T19:25:00-04:00,24022.25,24022.5,24015.75,24018.25,23995.414698829172,NaN,NaN,NaN,NaN,NaN,24019.155,24039.360665056967,23998.94933494303,24006.49993839799,24014.78830158553,24019.902430892762,24009.674172278297,798,1686.8666666666666,53.23844444512896,48.13975357516234,NaN,NaN,NaN,NaN,8.257697020630868,11.464795827625387,-113786
2025-09-11T19:30:00-04:00,24018.5,24023,24018,24021.5,23995.414698829172,NaN,NaN,NaN,NaN,NaN,24019.165,24039.37480207736,23998.95519792264,24006.599960574713,24015.05448769146,24020.20627293257,24009.902702450352,827,1329.6333333333334,55.88114787543958,48.69056916556551,NaN,NaN,NaN,NaN,8.025004376300092,11.26166308849339,-112959
2025-09-11T19:35:00-04:00,24021.5,24025.5,24017.5,24019,23995.414698829172,NaN,NaN,NaN,NaN,NaN,24019.115,24039.31381431575,23998.916185684255,24008.37996845977,24015.289545284493,24020.45609148428,24010.122999084706,821,1177,53.3819796803911,49.08819900857496,NaN,NaN,NaN,NaN,8.023218349421514,11.461132847212172,-113780
2025-09-11T19:40:00-04:00,24019.25,24021.5,24017.5,24020.75,23995.414698829172,NaN,NaN,NaN,NaN,NaN,24019.13,24039.332534489215,23998.927465510787,24008.37996845977,24015.365696604782,24020.52325958357,24010.208133625994,328,1055.1,54.902408992839845,49.90234176398092,NaN,NaN,NaN,NaN,7.735845610177121,11.646354766022467,-113452
2025-09-11T19:45:00-04:00,24020.5,24020.5,24016.75,24016.75,23995.414698829172,NaN,NaN,NaN,NaN,NaN,24018.875,24038.868311383467,23998.881688616533,24008.37996845977,24015.420952661654,24020.53808114125,24010.303824182058,427,979.8333333333334,50.822286226223085,50.48423809119504,NaN,NaN,NaN,NaN,7.468999495164469,11.653227036920768,-113879
2025-09-11T19:50:00-04:00,24017.5,24022.5,24015.75,24020.75,23995.414698829172,NaN,NaN,NaN,NaN,NaN,24018.635,24038.240665000332,23999.029334999665,24008.37996845977,24015.525315444815,24020.62174164124,24010.42888924839,513,968.8333333333334,54.466451072469106,51.38770486144411,NaN,NaN,NaN,NaN,7.417642388367007,12.006362378424788,-113366
2025-09-11T19:55:00-04:00,24020.75,24025.5,24018,24019.25,23996.111442213278,NaN,NaN,NaN,NaN,NaN,24018.31,24037.31619898861,23999.303801011392,24009.73363508112,24015.72267229839,24020.826380461967,24010.618964134814,793,956.3666666666667,52.88385976696697,51.98920888961442,NaN,NaN,NaN,NaN,7.42352507491222,12.82040965664307,-114159
2025-09-11T20:00:00-04:00,24019.75,24020.5,24008.25,24010.25,23996.111442213278,NaN,NaN,NaN,NaN,NaN,24017.82,24036.36320360593,23999.276796394068,24009.73363508112,24015.506427417986,24020.458297969824,24010.554556866147,1869,980.5333333333333,44.52447301289946,51.71459072834029,NaN,NaN,NaN,NaN,7.768273283847061,12.191241167117418,-116028
2025-09-11T20:05:00-04:00,24010.25,24011.75,24006,24009.5,23996.111442213278,NaN,NaN,NaN,NaN,NaN,24017.34,24035.472776946528,23999.207223053472,24009.73363508112,24015.26299112801,24020.272584352497,24010.25339790352,927,965.6,43.90169114294114,51.34684116726499,NaN,NaN,NaN,NaN,7.624110906429414,11.965749776615258,-116955
2025-09-11T20:10:00-04:00,24009.75,24016,24008.25,24013,23996.111442213278,NaN,NaN,NaN,NaN,NaN,24016.98,24034.724249769093,23999.235750230906,24009.73363508112,24015.14818665725,24020.087557544597,24010.208815769904,1028,962.8666666666667,47.5861578298348,51.33905879574181,NaN,NaN,NaN,NaN,7.633102984541599,11.214925038719336,-115927
2025-09-11T20:15:00-04:00,24012.75,24016,24011.25,24013,23996.111442213278,NaN,NaN,NaN,NaN,NaN,24016.74,24034.368091202876,23999.111908797127,24009.73363508112,24015.10823207738,24019.997199682297,24010.21926447246,602,935,47.5861578298348,51.63864980181398,NaN,NaN,NaN,NaN,7.427167057074342,10.517730639244553,-115927
2025-09-11T20:20:00-04:00,24012.75,24023.75,24012,24018.5,23996.111442213278,NaN,NaN,NaN,NaN,NaN,24016.64,24034.170019978774,23999.109980021225,24009.73363508112,24015.23331436195,24020.05551078114,24010.41111794276,1145,943.6,53.18932731256081,51.68056369606929,NaN,NaN,NaN,NaN,7.7359408387118895,11.06026392662758,-114782
2025-09-11T20:25:00-04:00,24018.5,24023,24016,24018.5,23996.111442213278,NaN,NaN,NaN,NaN,NaN,24016.39,24033.443785509065,23999.336214490933,24009.73363508112,24015.36818729832,24020.160737290058,24010.575637306585,967,940.0333333333333,53.18932731256081,51.621751009147246,NaN,NaN,NaN,NaN,7.683373635946755,11.564044836340393,-114782
2025-09-11T20:30:00-04:00,24018,24019.5,24009,24009.75,23996.111442213278,NaN,NaN,NaN,NaN,NaN,24015.92,24032.37400863839,23999.465991361605,24009.73363508112,24015.242758271437,24019.952413276573,24010.5331032663,1419,864.1666666666666,44.426494276920636,50.71287191264364,NaN,NaN,NaN,NaN,7.88456123337913,10.762613145286478,-116201
2025-09-11T20:35:00-04:00,24010.25,24015.5,24009.25,24014.25,23996.111442213278,NaN,NaN,NaN,NaN,NaN,24015.55,24031.290076238696,23999.809923761302,24009.73363508112,24015.205161825725,24019.88404290948,24010.526280741968,505,822.8666666666667,49.07330198873656,50.415361737187034,NaN,NaN,NaN,NaN,7.767806859566335,10.018426575022124,-115696
2025-09-11T20:40:00-04:00,24014,24014.5,24009.25,24013,23996.111442213278,NaN,NaN,NaN,NaN,NaN,24015.085,24029.6838389971,24000.486161002897,24009.73363508112,24015.153217127576,24019.80702491444,24010.49940934071,539,811.4666666666667,47.875776083282446,49.84354946631867,NaN,NaN,NaN,NaN,7.587963512454453,9.327396188348082,-116235
2025-09-11T20:45:00-04:00,24012.75,24015,24010.75,24014,23996.111442213278,NaN,NaN,NaN,NaN,NaN,24014.65,24028.002902295528,24001.297097704475,24004.347877543383,24015.127863762147,24019.755716920023,24010.50001060427,414,795.3333333333334,48.94906829690241,49.52691293892662,NaN,NaN,NaN,NaN,7.349537547279135,8.779996682624017,-115821
2025-09-11T20:50:00-04:00,24014.25,24016,24007.25,24009.5,23996.111442213278,NaN,NaN,NaN,NaN,NaN,24014.325,24027.368868288348,24001.281131711654,24004.347877543383,24014.982893701195,24019.594750922304,24010.371036480086,1108,788.8666666666667,44.507756368892004,48.78443775150178,NaN,NaN,NaN,NaN,7.449570579616339,8.693182371253357,-116929
2025-09-11T20:55:00-04:00,24010,24011,24008.25,24009.25,23996.111442213278,NaN,NaN,NaN,NaN,NaN,24013.775,24025.210143191463,24002.33985680854,24004.347877543383,24014.908121622586,24019.53235646763,24010.283886777543,445,782.9,44.267450963685505,48.316235232749094,NaN,NaN,NaN,NaN,7.113886966786601,8.612569082123457,-117374
2025-09-11T21:00:00-04:00,24010,24011.25,24006,24010.75,23996.111442213278,NaN,NaN,NaN,NaN,NaN,24013.265,24022.754156984927,24003.77584301507,24004.347877543383,24014.81472413897,24019.455547948513,24010.173900329428,556,763.3,46.14624745994032,47.72193497471132,NaN,NaN,NaN,NaN,6.980752183444701,8.956231860461969,-116818
2025-09-11T21:05:00-04:00,24011,24011.5,24008,24010.5,23996.111442213278,NaN,NaN,NaN,NaN,NaN,24013.24,24022.751550857975,24003.72844914203,24004.347877543383,24014.754269689667,24019.396923806282,24010.111615573052,422,750.5333333333333,45.86871051779623,47.22085288548484,NaN,NaN,NaN,NaN,6.732127027484365,9.21435981545625,-117240
2025-09-11T21:10:00-04:00,24011,24015.25,24010.25,24014.5,23996.111442213278,NaN,NaN,NaN,NaN,NaN,24013.33,24022.80229642519,24003.857703574813,24003.978302034706,24014.726090485772,24019.32674617721,24010.125434794336,680,740.3666666666667,50.9516344908515,47.679935848195704,NaN,NaN,NaN,NaN,6.6084036683783385,8.582291351478206,-116560
2025-09-11T21:15:00-04:00,24015,24017.25,24011,24015,23996.111442213278,NaN,NaN,NaN,NaN,NaN,24013.22,24022.48209478689,24003.957905213112,24003.285271261117,24014.720603682057,24019.280469630954,24010.16073773316,619,743.2666666666667,51.56388511726612,48.22723541779035,NaN,NaN,NaN,NaN,6.582803406351315,8.363418489659638,-115941
2025-09-11T21:20:00-04:00,24015.25,24016,24008.75,24009.25,23996.111442213278,NaN,NaN,NaN,NaN,NaN,24013.255,24022.44330232296,24004.06669767704,24003.285271261117,24014.668156734446,24019.21187097847,24010.12444249042,549,740.0666666666667,44.659829475342164,48.01821196389802,NaN,NaN,NaN,NaN,6.63046030589765,7.871673698064131,-116490
2025-09-11T21:25:00-04:00,24009.25,24009.5,24003.75,24008.75,23996.111442213278,NaN,NaN,NaN,NaN,NaN,24013.205,24022.463342151543,24003.94665784846,24003.285271261117,24014.377505417116,24019.054538689008,24009.700472145225,1463,774.2,44.10679652247978,47.7696861562298,NaN,NaN,NaN,NaN,6.567570284047818,8.37886716949776,-117953
2025-09-11T21:30:00-04:00,24008.5,24009.5,24003,24007.25,23996.111442213278,NaN,NaN,NaN,NaN,NaN,24013.125,24022.51768331455,24003.73231668545,24003.285271261117,24014.180377351848,24018.95729931433,24009.403455389365,958,791.7,42.41008116397975,46.99974000275973,NaN,NaN,NaN,NaN,6.56274383518726,8.98129340100545,-118911
2025-09-11T21:35:00-04:00,24007,24007.75,24003,24006,23996.111442213278,NaN,NaN,NaN,NaN,NaN,24013.005,24022.60317169383,24003.40682830617,24003.285271261117,24014.05667082997,24018.90835491962,24009.204986740322,553,791.3666666666667,40.994822183863235,46.12870392213847,NaN,NaN,NaN,NaN,6.433262132673884,9.54068918740545,-119464
2025-09-11T21:40:00-04:00,24006,24006.75,24002.75,24005.75,23996.111442213278,NaN,NaN,NaN,NaN,NaN,24012.87,24022.680321104293,24003.059678895705,24003.285271261117,24013.947799655554,24018.86901216154,24009.02658714957,472,774.4666666666667,40.70227215282487,45.86268805613163,NaN,NaN,NaN,NaN,6.25945769462575,10.10943664812292,-119936
2025-09-11T21:45:00-04:00,24005.75,24006,24001,24003,23996.111442213278,NaN,NaN,NaN,NaN,NaN,24012.755,24022.885394852336,24002.624605147666,24003.285271261117,24013.733922289666,24018.828506996393,24008.63933758294,800,781.5666666666667,37.529618530706465,45.03813923770092,NaN,NaN,NaN,NaN,6.16949643072391,10.984482546322996,-120736
2025-09-11T21:50:00-04:00,24002.75,24006.5,24001.5,24004.75,23996.111442213278,NaN,NaN,NaN,NaN,NaN,24012.715,24022.955122082734,24002.474877917266,24003.285271261117,24013.624832980622,24018.78999909716,24008.459666864084,462,766.9666666666667,40.697487004324834,44.52540430348966,NaN,NaN,NaN,NaN,6.085960971386489,11.641516148872503,-120274
2025-09-11T21:55:00-04:00,24004.75,24008.25,24001.75,24004.75,23996.111442213278,NaN,NaN,NaN,NaN,NaN,24012.585,24023.058590608525,24002.111409391473,24003.285271261117,24013.47734170399,24018.72040393035,24008.23427947763,692,763.4333333333333,40.69748700432485,43.93600563973411,NaN,NaN,NaN,NaN,6.115535187716025,11.712082679110825,-120274
2025-09-11T22:00:00-04:00,24004.5,24006.5,24003,24005.75,23996.111442213278,NaN,NaN,NaN,NaN,NaN,24012.5,24023.124029362043,24001.875970637957,24003.285271261117,24013.381276715863,24018.670155453576,24008.09239797815,473,751.6333333333333,42.62564285483121,43.80156896015835,NaN,NaN,NaN,NaN,5.928711245736309,11.777608742903553,-119801
2025-09-11T22:05:00-04:00,24005.25,24005.5,23999.5,24003,23996.111442213278,NaN,NaN,NaN,NaN,NaN,24012.43,24023.255451497447,24001.604548502553,24001.203217008893,24013.14052743614,24018.6054425715,24007.675612300776,950,755.9333333333333,38.881680749526716,43.416871087718434,NaN,NaN,NaN,NaN,5.95166044246943,12.632489916493322,-120751
2025-09-11T22:10:00-04:00,24003.75,24004,23996,23997.5,NaN,NaN,NaN,24020.170671127627,24020.170671127627,24020.170671127627,24012.005,24023.45510479792,24000.554895202084,23994.787573607115,24012.82175792174,24018.612858130764,24007.03065771272,987,777.9,32.69621193849672,42.45615426475818,NaN,NaN,NaN,NaN,6.097970410864471,14.082686044635958,-121738
2025-09-11T22:15:00-04:00,23997.75,23998.75,23993,23993.75,NaN,NaN,NaN,24015.912913349097,NaN,NaN,24011.415,24023.50863883113,23999.321361168873,23994.481465695662,24012.209633876977,24018.75230057797,24005.666967175985,1554,815.4666666666667,29.27642607995037,41.27099109062633,NaN,NaN,NaN,NaN,6.073115381517008,15.908826798995987,-123292
2025-09-11T22:20:00-04:00,23994.25,23996,23992,23992.5,NaN,NaN,NaN,24013.672553651413,NaN,NaN,24010.96,24024.10814057131,23997.81185942869,23994.481465695662,24011.949486282534,24018.80593400306,24005.09303856201,632,819.4333333333333,28.21698805778304,39.64708777397858,NaN,NaN,NaN,NaN,5.92503571140865,17.75406276130123,-123924
2025-09-11T22:25:00-04:00,23992.5,23996.5,23992.25,23995.25,NaN,NaN,NaN,24013.672553651413,NaN,NaN,24010.66,24024.52425621321,23996.795743786788,23994.481465695662,24011.720244297787,24018.812261785137,24004.628226810437,611,813.3666666666667,33.885409986922866,38.38433955038263,NaN,NaN,NaN,NaN,5.805390303450889,19.28185718422844,-123313
2025-09-11T22:30:00-04:00,23994.5,23996.5,23992,23995,NaN,NaN,NaN,24013.341624298086,NaN,NaN,24010.27,24024.763046606055,23995.776953393946,23994.481465695662,24011.501743255598,24018.807454385427,24004.19603212577,592,770.8,33.625453510788134,37.596169838628775,NaN,NaN,NaN,NaN,5.712148138918684,20.743021318151424,-123905
2025-09-11T22:35:00-04:00,23995.5,24001,23995.5,24000,NaN,NaN,NaN,24013.341624298086,NaN,NaN,24009.99,24024.722942675395,23995.25705732461,23994.481465695662,24011.25337437923,24018.697282033456,24003.809466725004,933,771,43.0376404890585,37.519801550527255,NaN,NaN,NaN,NaN,5.732708986138777,20.509584905971032,-122972
2025-09-11T22:40:00-04:00,23999.75,24004.5,23999.25,24003.75,NaN,NaN,NaN,24013.341624298086,NaN,NaN,24009.91,24024.733886132813,23995.086113867186,23994.481465695662,24011.087184772896,24018.556242727536,24003.618126818255,921,767.4333333333333,48.8913278539254,37.98274774266623,NaN,NaN,NaN,NaN,5.69822977284315,19.304886206557505,-122051
2025-09-11T22:45:00-04:00,24003.75,24004.5,24000.75,24003.25,NaN,NaN,NaN,24013.341624298086,NaN,NaN,24009.845,24024.756368141163,23994.93363185884,23993.73517255653,24011.006314213784,24018.483023743607,24003.52960468396,480,763.3666666666667,48.18038411900168,38.49600216660469,NaN,NaN,NaN,NaN,5.559070503354354,18.186237414244946,-122531
2025-09-11T22:50:00-04:00,24003,24007,24003,24006,NaN,NaN,NaN,24013.341624298086,NaN,NaN,24009.86,24024.754347903297,23994.965652096704,23995.07772884978,24010.95263321067,24018.414125414936,24003.4911410064,468,740.8,52.28964243848801,39.32367147272348,NaN,NaN,NaN,NaN,5.447708324543329,17.284834988030166,-122063
2025-09-11T22:55:00-04:00,24006,24007,24003,24003.75,NaN,NaN,NaN,24013.341624298086,NaN,NaN,24009.775,24024.759074865047,23994.790925134956,23995.462183079824,24010.88132272382,24018.33113182234,24003.431513625303,560,727.2333333333333,48.874667086005516,40.13403208381628,NaN,NaN,NaN,NaN,5.344300587075948,16.447818449402156,-122623
2025-09-11T23:00:00-04:00,24004,24005.75,24002.25,24003.5,NaN,NaN,NaN,24013.341624298086,NaN,NaN,24009.6,24024.668510209798,23994.5314897902,23995.462183079824,24010.801220854006,24018.246154116205,24003.356287591807,575,699.1,48.49568630612312,40.69104631965901,NaN,NaN,NaN,NaN,5.212564830856238,15.444437015289022,-123198
2025-09-11T23:05:00-04:00,24003.25,24004.5,24001.25,24002.5,NaN,NaN,NaN,24013.341624298086,NaN,NaN,24009.39,24024.55547394698,23994.224526053018,23995.462183079824,24010.747161414878,24018.196133947804,24003.298188881952,342,693.6666666666666,46.928171399548326,41.13609520503212,NaN,NaN,NaN,NaN,5.072381628652221,14.471786678862122,-123540
2025-09-11T23:10:00-04:00,24002.75,24005.75,24002.5,24003,NaN,NaN,NaN,24013.341624298086,NaN,NaN,24009.22,24024.47733921237,23993.96266078763,23995.79763773687,24010.69846012374,24018.14422345687,24003.252696790605,357,687.6,47.836062221271725,41.508268016920724,NaN,NaN,NaN,NaN,4.94221151231992,13.690524376966154,-123183
2025-09-11T23:15:00-04:00,24003,24004.75,24002,24004.75,NaN,NaN,NaN,24013.341624298086,NaN,NaN,24009.185,24024.47513079623,23993.894869203774,23995.79763773687,24010.677244692364,24018.121253196234,24003.233236188495,159,679.1,50.995831185534556,42.37356447663557,NaN,NaN,NaN,NaN,4.78562497572564,12.801053796605649,-123024
2025-09-11T23:20:00-04:00,24004.25,24007,24003.25,24006,NaN,NaN,NaN,24013.341624298086,NaN,NaN,24008.975,24024.14544824399,23993.804551756006,23997.6554881516,24010.642608897128,24018.074259114506,24003.21095867975,341,653.5333333333333,53.17753543818249,43.836516155184555,NaN,NaN,NaN,NaN,4.711651763173809,12.659731737038161,-122683
2025-09-11T23:25:00-04:00,24005.75,24005.75,24000.25,24002.5,NaN,NaN,NaN,24013.341624298086,NaN,NaN,24008.66,24023.700531901126,23993.619468098874,23997.6554881516,24010.572378911384,24018.007178945983,24003.137578876784,470,654.3666666666667,46.88354590331879,45.094167571139444,NaN,NaN,NaN,NaN,4.78581949437568,11.950593747724126,-123153
2025-09-11T23:30:00-04:00,24002.5,24003.25,24001,24003,NaN,NaN,NaN,24013.341624298086,NaN,NaN,24008.275,24022.883644697737,23993.666355302266,23997.6554881516,24010.541441896523,24017.979044243504,24003.10383954954,199,642.4666666666667,47.83344314615462,46.495342934594554,NaN,NaN,NaN,NaN,4.6046895304917035,11.29210847193252,-122954
2025-09-11T23:35:00-04:00,24003,24003.5,24000.5,24002.75,NaN,NaN,NaN,24013.341624298086,NaN,NaN,24007.965,24022.370210858848,23993.559789141153,23997.6554881516,24010.49164108783,24017.934497638515,24003.048784537143,317,638.9666666666667,47.37722572441123,47.45904405870086,NaN,NaN,NaN,NaN,4.490068849742296,10.841116694696003,-123271
2025-09-11T23:40:00-04:00,24002.75,24003.75,24000.75,24002.75,NaN,NaN,NaN,24013.341624298086,NaN,NaN,24007.59,24021.53516403162,23993.64483596838,23997.6554881516,24010.46389098691,24017.908960030793,24003.018821943027,182,622.3666666666667,47.37722572441123,48.44131350253109,NaN,NaN,NaN,NaN,4.383635360474989,10.330234476220761,-123271
2025-09-11T23:45:00-04:00,24003,24003,24000.25,24002,NaN,NaN,NaN,24013.341624298086,NaN,NaN,24007.25,24020.891480863622,23993.608519136378,23997.6554881516,24010.427679371707,24017.878380261198,24002.976978482217,221,609.1,45.85554783487999,48.6425925986612,NaN,NaN,NaN,NaN,4.266947120441062,10.033153040744795,-123492
2025-09-11T23:50:00-04:00,24002,24004.25,24001.5,24003.5,NaN,NaN,NaN,24013.341624298086,NaN,NaN,24006.905,24020.025933665747,23993.78406633425,23997.6554881516,24010.40029973773,24017.85055665316,24002.950042822296,199,597.4333333333333,49.35880280898568,48.67598366687979,NaN,NaN,NaN,NaN,4.158593754695271,9.367801306641956,-123293
2025-09-11T23:55:00-04:00,24003.75,24010,24003.25,24008.5,NaN,NaN,NaN,24013.341624298086,NaN,NaN,24006.74,24019.56573974216,23993.914260257843,24000.18060982881,24010.356076837827,24017.763134809407,24002.949018866246,760,574,58.90392616022666,49.44195095553872,NaN,NaN,NaN,NaN,4.343694200788467,10.47503261642176,-122533
2025-09-12T00:00:00-04:00,24008.75,24011.5,24007.5,24010.5,NaN,NaN,NaN,24013.341624298086,NaN,NaN,24006.535,24018.772650913794,23994.297349086206,24001.644487863046,24010.347557097954,24017.6943046759,24003.000809520006,897,571.9666666666667,61.99009077951689,50.134840122755065,NaN,NaN,NaN,NaN,4.319144615017862,11.84645875081948,-121636
2025-09-12T00:05:00-04:00,24010.5,24014.5,24010.25,24013.75,23997.68534257696,23997.68534257696,23997.68534257696,NaN,NaN,NaN,24006.425,24018.29692065819,23994.553079341807,24004.49059029044,24010.378996089126,24017.68441968661,24003.07357249164,705,577.0333333333333,66.40508689517549,51.3870129662672,NaN,NaN,NaN,NaN,4.3142057139451575,13.72820157216432,-120931
2025-09-12T00:10:00-04:00,24013.5,24018.75,24013.5,24015.75,24001.3871451871,NaN,NaN,NaN,NaN,NaN,24006.535,24018.646156012706,23994.423843987293,24008.117472232352,24010.474650395896,24017.754041688902,24003.19525910289,965,593.4666666666667,68.80630512199498,52.83777145311519,NaN,NaN,NaN,NaN,4.381048162949075,16.163982202267995,-119966
2025-09-12T00:15:00-04:00,24015.75,24016.5,24012.25,24013.25,24001.3871451871,NaN,NaN,NaN,NaN,NaN,24006.61,24018.839538001554,23994.380461998448,24008.117472232352,24010.507538302965,24017.760817502203,24003.254259103727,534,584.6,62.767035451274474,53.96911888538135,NaN,NaN,NaN,NaN,4.371687579881284,17.928789610696665,-120500
2025-09-12T00:20:00-04:00,24013.25,24021.75,24012.5,24018,24001.88193394114,NaN,NaN,NaN,NaN,NaN,24006.71,24019.225334603398,23994.1946653966,24008.620182228704,24010.61647724016,24017.863638146657,24003.369316333665,917,599.7666666666667,68.43580926622712,55.440529388592445,NaN,NaN,NaN,NaN,4.72013846703262,20.308847555148454,-119583
2025-09-12T00:25:00-04:00,24018,24018.75,24015.75,24018.25,24002.290709671084,NaN,NaN,NaN,NaN,NaN,24006.815,24019.6242974126,23994.005702587398,24008.620182228704,24010.661702654685,24017.90693778165,24003.41646752772,380,589.3666666666667,68.70586632158997,56.70553189831069,NaN,NaN,NaN,NaN,4.597271433673147,22.51890136071083,-119203
2025-09-12T00:30:00-04:00,24018.5,24021.5,24017.5,24020.5,24004.675222867856,NaN,NaN,NaN,NaN,NaN,24006.855,24019.82152998709,23993.88847001291,24009.89691662637,24010.718226345904,24017.97667938292,24003.45977330889,363,585.7,71.1022282851811,57.98586710166773,NaN,NaN,NaN,NaN,4.5546091884107796,24.906615145420012,-118840
2025-09-12T00:35:00-04:00,24020.75,24023.5,24018.5,24022.75,24006.167258192043,NaN,NaN,NaN,NaN,NaN,24006.94,24020.261621523437,23993.61837847656,24011.717533301096,24010.825438183612,24018.127399669636,24003.52347669759,587,573.6,73.30375681257831,59.87302502375769,NaN,NaN,NaN,NaN,4.58642281781001,27.34458009910452,-118253
2025-09-12T00:40:00-04:00,24022.75,24024.5,24021.25,24023.5,24008.273291910587,NaN,NaN,NaN,NaN,NaN,24007.215,24021.302941649723,23993.127058350277,24013.449026640876,24010.920511345,24018.273160941182,24003.56786174882,465,556.2,74.01440723453152,61.743093887213185,NaN,NaN,NaN,NaN,4.490964045109295,29.714930367281855,-117788
2025-09-12T00:45:00-04:00,24023.5,24024.25,24020.5,24022.75,24008.273291910587,NaN,NaN,NaN,NaN,NaN,24007.385,24022.003553289465,23992.76644671053,24013.5342213127,24010.986764348185,24018.37018668208,24003.60334201429,345,515.9,71.95172761324011,63.49841545070096,NaN,NaN,NaN,NaN,4.438038041887203,31.588411956050983,-118133
2025-09-12T00:50:00-04:00,24022.5,24025.5,24022.25,24023.5,24009.639249447457,NaN,NaN,NaN,NaN,NaN,24007.595,24022.819286507736,23992.370713492266,24015.30237705016,24011.07880691298,24018.51440225362,24003.643211572344,438,509.43333333333334,72.76899444680717,65.31211321658638,NaN,NaN,NaN,NaN,4.353178181752402,33.48155606649394,-117695
2025-09-12T00:55:00-04:00,24023.5,24023.5,24018.25,24020.25,24009.639249447457,NaN,NaN,NaN,NaN,NaN,24007.72,24023.2521086746,23992.187891325404,24015.30237705016,24011.160197912588,24018.61623443741,24003.704161387766,520,506.4,64.05852655383381,66.61232598222594,NaN,NaN,NaN,NaN,4.417236883055802,33.61458379828168,-118215
2025-09-12T01:00:00-04:00,24020.25,24025.75,24018,24024,24009.639249447457,NaN,NaN,NaN,NaN,NaN,24008.01,24024.192076521384,23991.827923478613,24015.30237705016,24011.290900777323,24018.803047459496,24003.77875409515,709,510.3,68.71226364064793,67.99471604163038,NaN,NaN,NaN,NaN,4.655291391408959,34.108392578753495,-117506
2025-09-12T01:05:00-04:00,24024.25,24027.75,24021.75,24023.25,24009.889318569956,NaN,NaN,NaN,NaN,NaN,24008.29,24025.02330810451,23991.55669189549,24015.30237705016,24011.443426417663,24019.040891973556,24003.84596086177,738,503.8,66.84799275573337,68.56214936988087,NaN,NaN,NaN,NaN,4.7513420063083185,34.86972845185745,-118244
2025-09-12T01:10:00-04:00,24023.25,24028,24020.75,24024.75,24009.889318569956,NaN,NaN,NaN,NaN,NaN,24008.57,24025.915904407208,23991.224095592792,24015.30237705016,24011.594497953352,24019.275856450462,24003.913139456243,734,497.56666666666666,68.67834287195913,69.03988166219817,NaN,NaN,NaN,NaN,4.929817577286296,35.194467116775016,-117510
2025-09-12T01:15:00-04:00,24024.5,24027.75,24022.75,24027.25,24010.08406919287,NaN,NaN,NaN,NaN,NaN,24008.905,24027.017120254885,23990.792879745113,24015.30237705016,24011.678217886438,24019.41452243559,24003.941913337287,373,494,71.50235612459728,69.40397232144258,NaN,NaN,NaN,NaN,4.934830607480132,35.496010162769906,-117137
2025-09-12T01:20:00-04:00,24027.5,24029,24022.5,24025,24010.38706604774,NaN,NaN,NaN,NaN,NaN,24009.115,24027.718550727393,23990.51144927261,24015.30237705016,24011.79974032766,24019.60929130763,24003.99018934769,566,497.26666666666665,65.75609683929295,69.18610030124958,NaN,NaN,NaN,NaN,5.046628421231551,35.99610738775515,-117703
2025-09-12T01:25:00-04:00,24025,24029.5,24022.75,24027.75,24010.539926681937,NaN,NaN,NaN,NaN,NaN,24009.37,24028.627268771837,23990.11273122816,24015.30237705016,24011.92953949361,24019.826974128664,24004.032104858554,567,497.5,69.03187604336172,69.63358891497009,NaN,NaN,NaN,NaN,5.168297819715012,36.54854139843159,-117136
2025-09-12T01:30:00-04:00,24027.5,24034,24026.5,24028.75,24014.350611832757,NaN,NaN,NaN,NaN,NaN,24009.76,24029.766988782507,23989.75301121749,24018.44497237084,24012.301123742327,24020.520168766878,24004.082078717776,1383,524.4333333333333,70.15009364427542,69.7560377991164,NaN,NaN,NaN,NaN,5.334847975449654,37.7530130476124,-115753
2025-09-12T01:35:00-04:00,24028.75,24033.5,24024.5,24033.25,24014.350611832757,NaN,NaN,NaN,NaN,NaN,24010.25,24031.306590419972,23989.193409580028,24018.44497237084,24012.498337210694,24020.88588927518,24004.110785146207,730,537.3666666666667,74.59556803721514,70.17673077880393,NaN,NaN,NaN,NaN,5.596644548631822,38.03775505547127,-115023
2025-09-12T01:40:00-04:00,24033.25,24035.25,24032,24033.75,24017.52349136001,NaN,NaN,NaN,NaN,NaN,24010.78,24032.818974581936,23988.74102541806,24020.069782317336,24012.648476098817,24021.192930703786,24004.104021493848,479,541.4333333333333,75.04035869173995,70.45802580784384,NaN,NaN,NaN,NaN,5.429027080872406,38.58054500648729,-114544
2025-09-12T01:45:00-04:00,24033.5,24039.5,24032.5,24037,24019.67583266183,NaN,NaN,NaN,NaN,NaN,24011.4,24034.58081102776,23988.21918897224,24023.85582585387,24012.91855988524,24021.778533463006,24004.05858630747,779,562.1,77.76540243699739,70.77671478101664,NaN,NaN,NaN,NaN,5.541239432238663,39.66278158027974,-113765
2025-09-12T01:50:00-04:00,24037,24037.25,24033.75,24034.5,24019.67583266183,NaN,NaN,NaN,NaN,NaN,24011.975,24035.978385185874,23987.971614814123,24023.85582585387,24013.040020964057,24022.02657206824,24004.053469859875,375,563.2333333333333,71.31540118014296,70.58392863427459,NaN,NaN,NaN,NaN,5.395436615650186,40.66771554165845,-114140
2025-09-12T01:55:00-04:00,24034.25,24036.5,24032.75,24035,24019.67583266183,NaN,NaN,NaN,NaN,NaN,24012.615,24037.323138330557,23987.906861669446,24023.85582585387,24013.161026580194,24022.267088492208,24004.05496466818,385,560.4,71.81884024995209,70.57443667975402,NaN,NaN,NaN,NaN,5.27790542881803,41.17209068954687,-113755
2025-09-12T02:00:00-04:00,24035,24036.25,24025.5,24028.5,24019.67583266183,NaN,NaN,NaN,NaN,NaN,24013.09,24038.0865517527,23988.0934482473,24023.85582585387,24013.423440276318,24022.697398662298,24004.149481890337,1088,590.0333333333333,57.65284962902511,69.49471204991244,NaN,NaN,NaN,NaN,5.668769326759599,39.17503276776377,-114843
2025-09-12T02:05:00-04:00,24028,24031.75,24024.75,24029.25,24019.67583266183,NaN,NaN,NaN,NaN,NaN,24013.58,24038.86229419641,23988.297705803594,24023.85582585387,24013.590755749763,24022.94840326485,24004.233108234675,783,605.5666666666667,58.665942345861765,69.10952746362872,NaN,NaN,NaN,NaN,5.763857231991056,37.1154732786528,-114060
2025-09-12T02:10:00-04:00,24029.5,24029.5,24025.5,24029,24019.67583266183,NaN,NaN,NaN,NaN,NaN,24014.045,24039.58804015515,23988.501959844845,24023.85582585387,24013.667725186708,24023.059262204166,24004.27618816925,381,612.2,58.166413334621005,68.35625244176967,NaN,NaN,NaN,NaN,5.63786742970598,35.203025181621186,-114441
2025-09-12T02:15:00-04:00,24028.5,24030.5,24028,24028.75,24019.67583266183,NaN,NaN,NaN,NaN,NaN,24014.56,24040.229546159837,23988.890453840166,24023.85582585387,24013.777594495026,24023.225026807497,24004.330162182556,512,621.9,57.63788607403866,67.69838767879148,NaN,NaN,NaN,NaN,5.413734041869838,33.668927397208215,-114953
2025-09-12T02:20:00-04:00,24028.25,24032,24024.5,24025.75,24019.67583266183,NaN,NaN,NaN,NaN,NaN,24015.125,24040.509690271338,23989.740309728662,24023.85582585387,24013.910330282317,24023.406546873877,24004.414113690756,706,638.8,51.58098265971362,66.47714766363107,NaN,NaN,NaN,NaN,5.562753038879135,31.295426269100872,-115659
2025-09-12T02:25:00-04:00,24025.25,24025.25,24013.25,24018.75,NaN,NaN,NaN,24036.652745679257,24036.652745679257,24036.652745679257,24015.625,24040.280273273107,23990.969726726893,24023.85582585387,24014.04635048254,24023.453374194254,24004.639326770823,1959,678.7666666666667,40.80577392757305,64.28453464955791,NaN,NaN,NaN,NaN,6.058270678959197,31.233916718927368,-117618
2025-09-12T02:30:00-04:00,24019,24024.5,24014.25,24014.75,NaN,NaN,NaN,24036.652745679257,NaN,NaN,24016.07,24039.82648121991,23992.31351878009,24023.85582585387,24014.11634675345,24023.449976085853,24004.782717421047,1403,695.6333333333333,36.15760056269408,62.170356344086564,NaN,NaN,NaN,NaN,6.357679916176396,31.17680070805197,-119021
2025-09-12T02:35:00-04:00,24014.25,24015,24008.25,24009,NaN,NaN,NaN,24029.736282736678,NaN,NaN,24016.345,24039.440213785612,23993.24978621439,24023.212728546478,24014.066580137158,24023.339864167436,24004.79329610688,1139,710.1,30.737346875435833,59.435032832091856,NaN,NaN,NaN,NaN,6.385702779306654,31.9042737589478,-120160
2025-09-12T02:40:00-04:00,24008.75,24014.25,24007.25,24008.5,NaN,NaN,NaN,24028.99258806683,NaN,NaN,24016.615,24039.01080540382,23994.219194596182,24023.212728546478,24014.01282921561,24023.236323568708,24004.789334862515,1032,712.3333333333334,30.311827852946777,56.58944241842553,NaN,NaN,NaN,NaN,6.429581152213322,32.69463286973872,-121192
2025-09-12T02:45:00-04:00,24008.25,24012.75,24006,24010.5,NaN,NaN,NaN,24027.708834063793,NaN,NaN,24016.825,24038.78638656304,23994.863613436963,24020.24518283718,24013.93947833275,24023.100062046615,24004.77889461889,1367,740.1,34.23376181875612,53.70645625996417,NaN,NaN,NaN,NaN,6.452468212769513,33.573549514205105,-119825
2025-09-12T02:50:00-04:00,24010.5,24018.75,24010.5,24018,NaN,NaN,NaN,24027.708834063793,NaN,NaN,24017.11,24038.752818673012,23995.46718132699,24017.62242689011,24013.96365040136,24023.06525008558,24004.862050717144,1075,745.3666666666667,46.41291945743399,51.66163917179946,NaN,NaN,NaN,NaN,6.5808633404288335,32.78004039280772,-118750
2025-09-12T02:55:00-04:00,24017.75,24024.25,24015,24023.5,NaN,NaN,NaN,24027.708834063793,NaN,NaN,24017.515,24038.861055851565,23996.168944148434,24017.62242689011,24014.03915703353,24023.1198408686,24004.95847319846,884,762.1666666666666,53.25015491635407,49.910550063182086,NaN,NaN,NaN,NaN,6.771515958969631,30.87966937336473,-117866
2025-09-12T03:00:00-04:00,24023,24027.75,24017.5,24027.5,24003.05250870917,24003.05250870917,24003.05250870917,NaN,NaN,NaN,24017.945,24039.211943829723,23996.678056170276,24017.62242689011,24014.250802997864,24023.353875979545,24005.147730016182,1723,807.5,57.49749424688679,48.923556710806636,NaN,NaN,NaN,NaN,7.019979104757515,28.86649066351933,-116143
2025-09-12T03:05:00-04:00,24027.5,24031.5,24019.5,24023.25,24005.180803767842,NaN,NaN,NaN,NaN,NaN,24018.335,24039.258816570877,23997.41118342912,24017.62242689011,24014.442382870173,24023.57083327777,24005.313932462577,1545,839.4333333333333,52.08312986616819,47.51386311196494,NaN,NaN,NaN,NaN,7.375694882989121,27.608179395706017,-117688
2025-09-12T03:10:00-04:00,24023.5,24026.5,24020,24022.25,24005.180803767842,NaN,NaN,NaN,NaN,NaN,24018.71,24039.224960400985,23998.195039599013,24008.860892403038,24014.5322956956,24023.653608437635,24005.410982953566,908,854.2,50.86932113614765,47.029325362473685,NaN,NaN,NaN,NaN,7.3131452484898976,26.439747504165084,-118596
2025-09-12T03:15:00-04:00,24022,24024.25,24016,24023,24005.180803767842,NaN,NaN,NaN,NaN,NaN,24019.12,24039.136053563696,23999.103946436302,24008.860892403038,24014.629801125033,24023.71766550868,24005.541936741385,1293,885.8,51.7770433489448,46.537261148408184,NaN,NaN,NaN,NaN,7.380063445026333,24.575275884995104,-117303
2025-09-12T03:20:00-04:00,24023.25,24027.75,24019.75,24023.5,24005.180803767842,NaN,NaN,NaN,NaN,NaN,24019.53,24039.041955313256,24000.01804468674,24008.860892403038,24014.703162523932,24023.79031793611,24005.616007111756,711,894.9,52.408327074883914,46.12596927271267,NaN,NaN,NaN,NaN,7.4243446275244525,23.446326226427164,-116592
2025-09-12T03:25:00-04:00,24023,24024.75,24017.5,24022.75,24005.180803767842,NaN,NaN,NaN,NaN,NaN,24019.89,24038.957029133544,24000.822970866455,24008.860892403038,24014.74661874667,24023.821958353987,24005.671279139355,550,895.9,51.32300465246822,45.674906314029066,NaN,NaN,NaN,NaN,7.411891439844134,21.968086219635236,-117142
2025-09-12T03:30:00-04:00,24022.25,24023,24015,24018,24005.180803767842,NaN,NaN,NaN,NaN,NaN,24020.13,24038.789378338995,24001.470621661007,24008.860892403038,24014.79672039639,24023.824622900538,24005.76881789224,1141,910.3,44.97103529924903,45.202767216853026,NaN,NaN,NaN,NaN,7.453899194140981,20.658236633815733,-118283
2025-09-12T03:35:00-04:00,24017.75,24021.5,24015.75,24017.75,24005.180803767842,NaN,NaN,NaN,NaN,NaN,24020.435,24038.417994735875,24002.452005264127,24008.860892403038,24014.81782745055,24023.82287064356,24005.812784257545,536,903.5666666666667,44.657761300409085,45.4779091720556,NaN,NaN,NaN,NaN,7.332192108845197,19.441947732697624,-118819
2025-09-12T03:40:00-04:00,24017.5,24018.25,24006.75,24009,24005.180803767842,NaN,NaN,NaN,NaN,NaN,24020.555,24038.146841856775,24002.963158143226,24008.860892403038,24014.758372642806,24023.6976573828,24005.81908790281,1559,931.0666666666667,35.370538498538195,45.42169045318732,NaN,NaN,NaN,NaN,7.629892672499111,19.729872315712687,-120378
2025-09-12T03:45:00-04:00,24008.75,24017,24007.75,24015.5,24005.180803767842,NaN,NaN,NaN,NaN,NaN,24020.81,24037.718447588177,24003.901552411826,24008.860892403038,24014.74166675674,24023.626370427286,24005.856963086197,1152,957.0333333333333,44.58929928175567,46.41111562506732,NaN,NaN,NaN,NaN,7.745614624463461,19.99723085708382,-119226
2025-09-12T03:50:00-04:00,24015.75,24019.25,24014.5,24017.5,24005.180803767842,NaN,NaN,NaN,NaN,NaN,24021.105,24037.23977299857,24004.970227001428,24008.860892403038,24014.7611685138,24023.61135710439,24005.91097992321,777,964.0666666666667,47.090106521120525,47.609564101365436,NaN,NaN,NaN,NaN,7.5316421512875,19.74863687589555,-118449
2025-09-12T03:55:00-04:00,24017.25,24019,24008,24010.5,24005.180803767842,NaN,NaN,NaN,NaN,NaN,24021.275,24036.76733680919,24005.782663190814,24006.778776910356,24014.740468351745,24023.552685565865,24005.928251137626,862,973.9,40.2440432248958,48.0388699160897,NaN,NaN,NaN,NaN,7.779381997624107,20.407073735241728,-119311
2025-09-12T04:00:00-04:00,24010.25,24019,24002.25,24004.75,NaN,NaN,NaN,24033.719828943602,24033.719828943602,24033.719828943602,24021.3,24036.68115731668,24005.918842683317,24006.778776910356,24014.577750330747,24023.32627127486,24005.829229386636,2592,1014.2,35.658144440247185,47.27067170057636,NaN,NaN,NaN,NaN,8.420140426365242,21.6496474827639,-121903
2025-09-12T04:05:00-04:00,24004.5,24012.5,24002.25,24004.75,NaN,NaN,NaN,24030.817791264348,NaN,NaN,24021.225,24036.889051206206,24005.56094879379,24006.778776910356,24014.485312448916,24023.22595979371,24005.74466510412,1120,1027.2,35.658144440247185,46.01409952371158,NaN,NaN,NaN,NaN,8.550844681624868,22.803465962605916,-121903
2025-09-12T04:10:00-04:00,24003.5,24004.75,23984.5,23984.75,NaN,NaN,NaN,24019.763573479606,NaN,NaN,24020.71,24039.190627703905,24002.229372296093,24004.348021528283,24013.64348446808,24023.256095355828,24004.030873580334,3693,1134.3333333333333,24.428762680464317,43.65204726896712,NaN,NaN,NaN,NaN,9.386498632937377,25.24378196596107,-125596
2025-09-12T04:15:00-04:00,23985,23985.25,23968.75,23978.25,NaN,NaN,NaN,24003.245911048714,NaN,NaN,24020,24041.905935266168,23998.094064733832,24002.678417222625,24012.106823081667,24024.01437578959,24000.199270373745,4499,1258.3333333333333,22.003509382099068,41.50350294867646,NaN,NaN,NaN,NaN,9.894605873441849,28.208960974228976,-130095
2025-09-12T04:20:00-04:00,23978.5,23987,23973.25,23986.5,NaN,NaN,NaN,24003.245911048714,NaN,NaN,24019.415,24043.223319966448,23995.606680033554,24002.3677337781,24011.424658049582,24024.01243572826,23998.836880370905,2480,1328.5,31.323000925550332,40.10733721934809,NaN,NaN,NaN,NaN,10.169991168196002,30.64673015065261,-127615
2025-09-12T04:25:00-04:00,23986.5,23992.5,23985.5,23991,NaN,NaN,NaN,24003.245911048714,NaN,NaN,24018.97,24044.021874177077,23993.918125822926,23999.69927969439,24011.09225196865,24023.86540353814,23998.31910039916,1684,1371.8,35.82714007704307,38.968058414212244,NaN,NaN,NaN,NaN,9.943563227610573,31.95604162825602,-125931
2025-09-12T04:30:00-04:00,23991,23994,23989.5,23991.25,NaN,NaN,NaN,24003.245911048714,NaN,NaN,24018.435,24044.661858365205,23992.208141634797,23999.69927969439,24010.94104726841,24023.77910985484,23998.10298468198,861,1364.2333333333333,36.07796072716994,37.80160367508982,NaN,NaN,NaN,NaN,9.554737282781247,32.92067728559031,-125070
2025-09-12T04:35:00-04:00,23991,24000.5,23985,23995.25,NaN,NaN,NaN,24003.245911048714,NaN,NaN,24017.975,24044.99355844663,23990.956441553368,23999.69927969439,24010.668064366557,24023.586564639332,23997.74956409378,1775,1397.3,40.111271213503066,37.0007655723066,NaN,NaN,NaN,NaN,9.979398905439728,32.78556309580679,-123295
2025-09-12T04:40:00-04:00,23995.5,23998.75,23992.5,23998.5,NaN,NaN,NaN,24003.245911048714,NaN,NaN,24017.535,24045.086045353644,23989.983954646355,23997.85942375551,24010.581493662787,24023.5071935646,23997.655793760972,698,1407.8666666666666,43.244738848320445,36.877458682954554,NaN,NaN,NaN,NaN,9.713013269336889,32.66009991957924,-122597
2025-09-12T04:45:00-04:00,23998.75,24001,23996,23998.5,NaN,NaN,NaN,24003.245911048714,NaN,NaN,24017.05,24045.06660221776,23989.033397782237,23993.71253900441,24010.485765432855,24023.40463838327,23997.566892482442,907,1421.0333333333333,43.244738848320445,36.776528507805374,NaN,NaN,NaN,NaN,9.376369464384254,32.185096337647536,-122597
2025-09-12T04:50:00-04:00,23998.75,24000,23994,23997,NaN,NaN,NaN,24003.245911048714,NaN,NaN,24016.52,24045.026813222066,23988.013186777935,23987.145031203527,24010.396702970873,24023.31909444842,23997.474311493326,761,1422.8666666666666,42.06660443721791,37.25481893199678,NaN,NaN,NaN,NaN,9.135200216928236,31.93095600568226,-123358
2025-09-12T04:55:00-04:00,23997.75,24002.75,23996.25,24002.75,NaN,NaN,NaN,24003.245911048714,NaN,NaN,24016.12,24044.82648707768,23987.413512922318,23982.1634801397,24010.32769835525,24023.230659168305,23997.424737542195,816,1384.7666666666667,47.92346532308458,37.49297364923456,NaN,NaN,NaN,NaN,8.946971630004791,31.23770604490737,-122542
2025-09-12T05:00:00-04:00,24002.5,24005,23998.5,24002.25,23976.583178680685,23976.583178680685,23976.583178680685,NaN,NaN,NaN,24015.695,24044.58051367051,23986.80948632949,23985.28078411176,24010.25776156009,24023.12964686264,23997.38587625754,973,1370.4333333333334,47.4740180412316,37.52039590067106,NaN,NaN,NaN,NaN,8.772187942147307,30.227207151850894,-123515
2025-09-12T05:05:00-04:00,24002.25,24005.5,24000.25,24002.75,23978.13621601338,NaN,NaN,NaN,NaN,NaN,24015.345,24044.42469910524,23986.265300894764,23987.099627289408,24010.217188500395,24023.06551827675,23997.36885872404,643,1353.9,47.99921850148857,38.07433699185626,NaN,NaN,NaN,NaN,8.520603089136785,29.205637853012647,-122872
2025-09-12T05:10:00-04:00,24002.5,24004.5,24001.25,24004.25,23978.81752437641,NaN,NaN,NaN,NaN,NaN,24014.95,24044.08520206995,23985.814797930052,23988.15470183153,24010.196132674708,24023.030428398608,23997.361836950808,361,1331.5333333333333,49.62648655679379,39.072075714466735,NaN,NaN,NaN,NaN,8.144131439912728,28.257037789805693,-122511
2025-09-12T05:15:00-04:00,24004.25,24005.25,24000.25,24002.5,23979.104227813845,NaN,NaN,NaN,NaN,NaN,24014.535,24043.77641070603,23985.29358929397,23989.673761465223,24010.166900174147,24022.98481301196,23997.348987336332,460,1301.3,47.74913249274156,39.93571771821633,NaN,NaN,NaN,NaN,7.919550622776105,27.511716343055408,-122971
2025-09-12T05:20:00-04:00,24002.25,24002.75,23996.75,24001.25,23979.104227813845,NaN,NaN,NaN,NaN,NaN,24014.065,24043.389871697756,23984.74012830224,23989.673761465223,24010.101133384756,24022.901804120975,23997.300462648538,791,1291.8333333333333,46.398934937482885,41.505015736574805,NaN,NaN,NaN,NaN,7.782439864006384,27.279776731469536,-123762
2025-09-12T05:25:00-04:00,24001.5,24003.75,23999.75,24002.25,23979.104227813845,NaN,NaN,NaN,NaN,NaN,24013.565,24042.82603382177,23984.303966178228,23989.673761465223,24010.062274531403,24022.84490831021,23997.279640752597,569,1281.3333333333333,47.67368961704729,43.3386000390711,NaN,NaN,NaN,NaN,7.512265588005929,26.85535216816039,-123193
2025-09-12T05:30:00-04:00,24002,24007.5,24001.25,24001.5,23981.690881271978,NaN,NaN,NaN,NaN,NaN,24013.095,24042.361173309226,23983.828826690777,23992.879965870194,24010.01448777107,24022.76345166935,23997.26552387279,868,1252.8333333333333,46.7751964827567,44.442328293157274,NaN,NaN,NaN,NaN,7.42210376029122,25.708478600560674,-124061
2025-09-12T05:35:00-04:00,24001.25,24003.5,23995.75,24002.75,23981.690881271978,NaN,NaN,NaN,NaN,NaN,24012.595,24041.696355635147,23983.493644364855,23992.879965870194,24009.933572865764,24022.65674057241,23997.21040515912,1054,1236.4666666666667,48.51674442007727,45.348728603374006,NaN,NaN,NaN,NaN,7.445524920270418,25.41215440049453,-123007
2025-09-12T05:40:00-04:00,24002.5,24009.25,24000.75,24007.75,23982.16333396889,NaN,NaN,NaN,NaN,NaN,24012.175,24040.935780593758,23983.41421940624,23992.879965870194,24009.890494373805,24022.552016581318,23997.228972166293,1320,1250.2,54.876864447186435,46.69150744051804,NaN,NaN,NaN,NaN,7.520844568822531,24.09870629147351,-121687
2025-09-12T05:45:00-04:00,24007.75,24015,24006.75,24014.75,23987.95136424303,NaN,NaN,NaN,NaN,NaN,24011.805,24039.940971641976,23983.669028358025,23997.50954252554,24009.912688962726,24022.514314787015,23997.311063138437,1212,1247.5,61.96174612120286,48.252255648210884,NaN,NaN,NaN,NaN,7.572927099620921,22.747802122166007,-120475
2025-09-12T05:50:00-04:00,24014.5,24019.5,24012.75,24015.5,23993.322893141074,NaN,NaN,NaN,NaN,NaN,24011.44,24038.892970700814,23983.987029299184,24002.132634020432,24009.95937075088,24022.5229836917,23997.39575781006,974,1256.2666666666667,62.638614477001795,49.63753247883097,NaN,NaN,NaN,NaN,7.514146592505141,22.08745740924709,-119501
2025-09-12T05:55:00-04:00,24016,24017.25,24008.5,24010.75,23993.322893141074,NaN,NaN,NaN,NaN,NaN,24010.915,24037.378864043287,23984.451135956715,24002.132634020432,24009.97238534343,24022.50004476606,23997.4447259208,743,1262.7,55.85915555209448,50.53856224338626,NaN,NaN,NaN,NaN,7.602421835897631,20.810206502897465,-120244
2025-09-12T06:00:00-04:00,24010.75,24011.5,24005.25,24007.25,23993.322893141074,NaN,NaN,NaN,NaN,NaN,24010.37,24035.977077150437,23984.76292284956,24002.132634020432,24009.959695392787,24022.44798520527,23997.471405580305,816,1251.8666666666666,51.44118353189654,51.208175035863306,NaN,NaN,NaN,NaN,7.505820276190657,19.4936991414443,-121060
2025-09-12T06:05:00-04:00,24007.25,24013.5,24006.25,24011.5,23993.322893141074,NaN,NaN,NaN,NaN,NaN,24009.9,24034.525393385095,23985.27460661491,24002.132634020432,24009.962460097282,24022.41296557022,23997.511954624344,772,1259.7333333333333,55.99272630605155,51.78455082036095,NaN,NaN,NaN,NaN,7.4875473993198955,18.22529950499235,-120288
2025-09-12T06:10:00-04:00,24011.25,24014.25,24008.75,24012,23993.322893141074,NaN,NaN,NaN,NaN,NaN,24009.57,24033.625153287496,23985.514846712504,24002.132634020432,24009.969707965593,24022.394204652723,23997.545211278462,545,1225.9333333333334,56.509206444539366,52.42992142059722,NaN,NaN,NaN,NaN,7.345579727939904,17.159616224185033,-119743
2025-09-12T06:15:00-04:00,24012.25,24014.75,24010.25,24011.75,23993.322893141074,NaN,NaN,NaN,NaN,NaN,24009.22,24032.619923072998,23985.820076927004,24002.132634020432,24009.97726324086,24022.381851992326,23997.572674489395,426,1201.7333333333333,56.15433818076107,53.01242996911668,NaN,NaN,NaN,NaN,7.142324033087054,16.248363136285843,-120169
2025-09-12T06:20:00-04:00,24012,24015.25,24010.25,24010.25,23993.322893141074,NaN,NaN,NaN,NaN,NaN,24008.845,24031.5557661726,23986.1342338274,24002.132634020432,24009.98423707929,24022.367047288066,23997.601426870515,464,1191.3,53.964596810271615,53.322294987222236,NaN,NaN,NaN,NaN,6.98930088786655,15.48457137151608,-120633
2025-09-12T06:25:00-04:00,24010.25,24016.5,24010.25,24015.5,23993.322893141074,NaN,NaN,NaN,NaN,NaN,24008.58,24030.65587822607,23986.504121773934,24002.132634020432,24010.00002766284,24022.361572528735,23997.63848279695,499,1179.2,59.86386081454897,54.1876327244942,NaN,NaN,NaN,NaN,6.936493681590369,14.987539370355204,-120134
2025-09-12T06:30:00-04:00,24016,24022.25,24012,24018,23995.130203157038,NaN,NaN,NaN,NaN,NaN,24008.425,24030.122062019684,23986.727937980315,24004.908295496098,24010.072765933597,24022.395238098325,23997.75029376887,1283,1135.5666666666666,62.33880476790024,55.32619485523829,NaN,NaN,NaN,NaN,7.173172704333914,15.40689774509801,-118851
2025-09-12T06:35:00-04:00,24018.25,24020.25,24016.5,24016.75,23996.868603013536,NaN,NaN,NaN,NaN,NaN,24008.385,24030.01303968113,23986.756960318868,24004.908295496098,24010.108255973224,24022.41366474231,23997.802847204137,601,1118.2666666666667,60.33545377555024,56.230606580845645,NaN,NaN,NaN,NaN,6.928660368310063,15.796301950216332,-119452
2025-09-12T06:40:00-04:00,24016.75,24021,24016.5,24019.25,23997.607530149286,NaN,NaN,NaN,NaN,NaN,24008.475,24030.245220488418,23986.70477951158,24006.151309117504,24010.141308797338,24022.435410345075,23997.8472072496,495,1011.6666666666666,62.90318674327556,57.382605885168424,NaN,NaN,NaN,NaN,6.7551846277164875,16.270876953850742,-118957
2025-09-12T06:45:00-04:00,24019.5,24022,24018,24021.25,23999.273096960682,NaN,NaN,NaN,NaN,NaN,24008.72,24030.782103246303,23986.6578967537,24008.121047294,24010.21086130479,24022.492216790906,23997.929505818673,899,891.6666666666666,64.86288043144,58.55018702883718,NaN,NaN,NaN,NaN,6.558385725736739,16.866110910359396,-118058
2025-09-12T06:50:00-04:00,24021.75,24023,24017.25,24018.25,23999.556138007923,NaN,NaN,NaN,NaN,NaN,24008.915,24031.13764835373,23986.69235164627,24009.0218378352,24010.259494081733,24022.52698823816,23997.991999925303,699,832.3,59.763000772539556,58.89919676636241,NaN,NaN,NaN,NaN,6.500643888184115,17.575911237690974,-118757
2025-09-12T06:55:00-04:00,24018,24024.25,24017.75,24022.75,24000.479722643926,NaN,NaN,NaN,NaN,NaN,24009.16,24031.714768904727,23986.605231095273,24009.81747026816,24010.317379414162,24022.58009781958,23998.054661008744,686,799.0333333333333,64.29758278125948,59.06604224208075,NaN,NaN,NaN,NaN,6.500597896170964,18.43254552589096,-118071
2025-09-12T07:00:00-04:00,24023,24024,24015.75,24019,24000.479722643926,NaN,NaN,NaN,NaN,NaN,24009.18,24031.767837437535,23986.592162562465,24009.81747026816,24010.400924900317,24022.639616742686,23998.16223305795,1221,811.0333333333333,58.39192958121273,58.76270760666724,NaN,NaN,NaN,NaN,6.625555189301609,18.662319272841764,-119292
2025-09-12T07:05:00-04:00,24019.5,24022,24009.5,24013.5,24000.479722643926,NaN,NaN,NaN,NaN,NaN,24008.98,24031.231705554357,23986.728294445642,24009.81747026816,24010.458341233272,24022.631112987085,23998.28556947946,1712,808.9333333333333,50.99402550427315,58.41519831753715,NaN,NaN,NaN,NaN,7.04515839006578,17.39326119630538,-121004
2025-09-12T07:10:00-04:00,24014,24018.25,24012.5,24013.75,24000.479722643926,NaN,NaN,NaN,NaN,NaN,24008.705,24030.366414990604,23987.0435850094,24009.81747026816,24010.480718167117,24022.626330019157,23998.335106315077,705,809.1666666666666,51.296077570244016,58.40483360599054,NaN,NaN,NaN,NaN,6.9526470764896535,16.214850125235888,-120299
2025-09-12T07:15:00-04:00,24014,24015.25,24011.5,24012,24000.479722643926,NaN,NaN,NaN,NaN,NaN,24008.48,24029.762819356765,23987.197180643234,24009.81747026816,24010.490609879173,24022.61252655302,23998.368693205324,562,797.6666666666666,49.018488250660496,57.90667374489118,NaN,NaN,NaN,NaN,6.723886571026107,15.213831729633458,-120861
2025-09-12T07:20:00-04:00,24012.5,24021.5,24009.5,24021,24000.479722643926,NaN,NaN,NaN,NaN,NaN,24008.455,24029.675907132558,23987.234092867446,24009.81747026816,24010.542814820663,24022.63307172428,23998.452557917044,1064,807.7666666666667,59.08098169108648,58.0903719767874,NaN,NaN,NaN,NaN,7.100751815952813,15.219601026868427,-119797
2025-09-12T07:25:00-04:00,24020.75,24026.5,24019.75,24025.5,24001.665474170586,NaN,NaN,NaN,NaN,NaN,24008.505,24029.87401728242,23987.135982717584,24009.81747026816,24010.638027452074,24022.73752932295,23998.5385255812,1000,813.9,63.012027580967626,58.58020693394501,NaN,NaN,NaN,NaN,7.075698114813326,16.002595509308776,-118797
2025-09-12T07:30:00-04:00,24025.25,24028,24022,24023.25,24003.69772534465,NaN,NaN,NaN,NaN,NaN,24008.5,24029.855093068443,23987.144906931557,24010.16633514078,24010.769194291075,24022.88506795877,23998.65332062338,1350,826.4666666666667,59.91277459774651,59.005076775907504,NaN,NaN,NaN,NaN,6.998862535183803,16.939878742219015,-120147
2025-09-12T07:35:00-04:00,24023,24029,24020.75,24028,24003.69772534465,NaN,NaN,NaN,NaN,NaN,24008.605,24030.288424541985,23986.921575458015,24010.608068112626,24010.887572004947,24023.02949542017,23998.745648589724,1117,842.2666666666667,63.94458287937554,59.29655692339511,NaN,NaN,NaN,NaN,7.088229496956388,17.491611832548813,-119030
2025-09-12T07:40:00-04:00,24028.25,24028.75,24024.25,24028.75,24005.4027828037,NaN,NaN,NaN,NaN,NaN,24008.82,24031.0773673181,23986.5626326819,24011.7864544901,24010.978192301092,24023.14718432663,23998.809200275555,796,856.7666666666667,64.5508335600777,59.45455897997922,NaN,NaN,NaN,NaN,6.9033559614595035,18.00393541642648,-118234
2025-09-12T07:45:00-04:00,24028.75,24035.5,24027.25,24032,24010.111747221712,NaN,NaN,NaN,NaN,NaN,24009.105,24032.162989945893,23986.047010054106,24017.80416359208,24011.241722074166,24023.552329679143,23998.93111446919,1862,903.5,67.13004862938611,59.93988718382464,NaN,NaN,NaN,NaN,6.999544821355253,19.436748001634925,-116372
2025-09-12T07:50:00-04:00,24032,24035.25,24029.75,24035,24011.453258711634,NaN,NaN,NaN,NaN,NaN,24009.625,24033.79590192931,23985.45409807069,24018.343330873664,24011.411420100194,24023.82540482238,23998.99743537801,1127,914.7,69.34709961617736,60.400166674746195,NaN,NaN,NaN,NaN,6.892434476972736,20.767216830757057,-115245
2025-09-12T07:55:00-04:00,24034.75,24048,24034.5,24044.5,24019.31901967929,NaN,NaN,NaN,NaN,NaN,24010.205,24036.232425908707,23984.177574091296,24027.72466469893,24012.088005093436,24025.172294258,23999.00371592887,3282,1005.1333333333333,75.07932711154754,61.12991286618245,NaN,NaN,NaN,NaN,7.364403442903255,23.24308376350292,-111963
2025-09-12T08:00:00-04:00,24044.5,24047,24029,24029.75,24019.31901967929,NaN,NaN,NaN,NaN,NaN,24010.45,24036.97338591221,23983.92661408779,24027.72466469893,24012.509620167824,24025.838911278264,23999.180329057384,2781,1068.9,57.19530109074798,60.94650574605448,NaN,NaN,NaN,NaN,8.12408891126731,24.262665396127108,-114744
2025-09-12T08:05:00-04:00,24030,24037,24024.5,24031.5,24019.31901967929,NaN,NaN,NaN,NaN,NaN,24010.87,24038.04043246651,23983.699567533487,24027.72466469893,24012.839013751294,24026.273560380872,23999.404467121716,2771,1126.1333333333334,58.459590236321404,60.529506278558905,NaN,NaN,NaN,NaN,8.43665398903393,24.30394496131363,-111973
2025-09-12T08:10:00-04:00,24031.25,24034.25,24028.75,24032.5,24019.31901967929,NaN,NaN,NaN,NaN,NaN,24011.425,24039.199673713396,23983.650326286603,24027.72466469893,24012.962153389883,24026.439569351063,23999.484737428702,1015,1115.9666666666667,59.20115563801008,60.58730813975871,NaN,NaN,NaN,NaN,8.226892989817221,24.342275986129682,-110958
2025-09-12T08:15:00-04:00,24032.5,24044,24032.25,24043.25,24019.31901967929,NaN,NaN,NaN,NaN,NaN,24012.195,24041.290066593916,23983.099933406083,24027.72466469893,24013.301587026304,24027.02572792438,23999.577446128227,2003,1142.3333333333333,66.18882162796727,61.67265072002258,NaN,NaN,NaN,NaN,8.478543490544563,25.387543316430623,-108955
2025-09-12T08:20:00-04:00,24042.75,24044,24035.75,24038.75,24019.31901967929,NaN,NaN,NaN,NaN,NaN,24013.275,24042.22344555083,23984.326554449173,24027.72466469893,24013.567021973908,24027.471238312963,23999.662805634853,1623,1163.9666666666667,61.444683550947744,62.3975511472157,NaN,NaN,NaN,NaN,8.462218955505666,26.358148694567213,-110578
2025-09-12T08:25:00-04:00,24038.75,24042,24027.25,24037,24019.31901967929,NaN,NaN,NaN,NaN,NaN,24014.45,24042.367378102437,23986.532621897564,24027.72466469893,24013.962778509915,24028.04525223245,23999.88030478738,2955,1237.7,59.65398552828625,63.15722952418896,NaN,NaN,NaN,NaN,8.911346172969546,25.673372548022915,-113533
2025-09-12T08:30:00-04:00,24036.5,24038.75,24014.75,24027.25,NaN,NaN,NaN,24053.546741288366,24053.546741288366,24053.546741288366,24015.265,24042.23413235991,23988.29586764009,24027.72466469893,24014.34969742559,24028.394446387803,24000.304948463378,5023,1377.9333333333334,50.77541977986992,62.563975101959215,NaN,NaN,NaN,NaN,9.989107160614578,24.32593743425769,-118556
2025-09-12T08:35:00-04:00,24027.5,24032.5,24020,24029,NaN,NaN,NaN,24053.546741288366,NaN,NaN,24016.025,24042.350130575353,23989.69986942465,24027.72466469893,24014.59226065464,24028.612673608743,24000.57184770054,3244,1460.3333333333333,52.151949876517214,61.78825526592704,NaN,NaN,NaN,NaN,10.16845664914211,23.074747685761405,-115312
2025-09-12T08:40:00-04:00,24028.75,24036.75,24024.5,24031.75,NaN,NaN,NaN,24053.546741288366,NaN,NaN,24016.835,24042.546205730585,23991.123794269413,24027.72466469893,24014.77176231526,24028.819340958646,24000.724183671875,1896,1505.3666666666666,54.314001881871405,61.38834292907882,NaN,NaN,NaN,NaN,10.31713831706053,21.502869379288672,-113416
2025-09-12T08:45:00-04:00,24032,24039.75,24031.5,24038.75,NaN,NaN,NaN,24053.546741288366,NaN,NaN,24017.705,24043.379635336496,23992.030364663507,24021.779731759147,24014.983826467735,24029.126716078485,24000.840936856985,1695,1547.6666666666667,59.3492459579591,61.060104577549076,NaN,NaN,NaN,NaN,10.169485580127636,20.41843492646671,-111721
2025-09-12T08:50:00-04:00,24038.75,24043.25,24036.5,24042.5,NaN,NaN,NaN,24053.546741288366,NaN,NaN,24018.585,24044.580501532568,23992.58949846743,24019.884778128544,24015.31921642387,24029.670068064323,24000.96836478342,2308,1609.1333333333334,61.77950005681577,60.862152184458935,NaN,NaN,NaN,NaN,9.92523661011852,19.829887927127647,-109413
2025-09-12T08:55:00-04:00,24042.5,24044.5,24040.5,24042,NaN,NaN,NaN,24053.546741288366,NaN,NaN,24019.455,24045.614642572647,23993.295357427356,24020.541199422183,24015.563197561016,24030.075892598343,24001.05050252369,1616,1646.3666666666666,61.25367815609425,60.44241143636666,NaN,NaN,NaN,NaN,9.502005423681481,19.43070685559121,-111029
2025-09-12T09:00:00-04:00,24041.75,24053.75,24038.5,24043.25,24018.33631887525,24018.33631887525,24018.33631887525,NaN,NaN,NaN,24020.38,24046.56897477142,23994.19102522858,24026.957959537747,24016.259671847543,24031.28618591616,24001.233157778926,4311,1747.3,62.121658574441526,59.926308504814095,NaN,NaN,NaN,NaN,9.91257646484709,20.02579007589304,-106718
2025-09-12T09:05:00-04:00,24043.5,24051,24042.75,24050.75,24019.224440744554,NaN,NaN,NaN,NaN,NaN,24021.34,24048.378816541837,23994.301183458163,24026.957959537747,24016.75053286477,24032.169462981292,24001.33160274825,2863,1822.7,66.91122372983928,59.3428725489778,NaN,NaN,NaN,NaN,9.793821003072297,20.578367351887593,-103855
2025-09-12T09:10:00-04:00,24050.75,24051.75,24046.25,24048.25,24021.856284347075,NaN,NaN,NaN,NaN,NaN,24022.26,24049.764356021937,23994.75564397806,24028.553094104158,24017.121876648645,24032.82949821409,24001.4142550832,2185,1879.0333333333333,64.00593815694114,59.829346625134455,NaN,NaN,NaN,NaN,9.487119502852847,21.166854016408262,-106040
2025-09-12T09:15:00-04:00,24048.25,24050,24045.75,24047.75,24021.856284347075,NaN,NaN,NaN,NaN,NaN,24023.16,24050.994827110804,23995.325172889196,24029.317475283326,24017.43028945579,24033.356002619334,24001.50457629225,1910,1912.7333333333333,63.41290066126361,60.18315451263033,NaN,NaN,NaN,NaN,9.113039538363358,21.61780206106851,-107950
2025-09-12T09:20:00-04:00,24048.25,24049.25,24044.5,24046.75,24021.856284347075,NaN,NaN,NaN,NaN,NaN,24024.01,24052.077767993273,23995.942232006724,24030.328980226663,24017.68347858722,24033.771510680966,24001.595446493473,1652,1944.5,62.17218379283186,60.39537080940331,NaN,NaN,NaN,NaN,8.80139385705169,21.78900001241765,-109602
2025-09-12T09:25:00-04:00,24046.5,24049,24037.75,24040.25,24021.856284347075,NaN,NaN,NaN,NaN,NaN,24024.765,24052.50673930651,23997.023260693488,24030.328980226663,24018.39302263577,24034.774757332823,24002.011287938716,5686,2111.1666666666665,54.68283389636494,59.57351454286029,NaN,NaN,NaN,NaN,8.976294295833712,20.738735547138678,-115288
2025-09-12T09:30:00-04:00,24040.5,24063.5,24026.25,24034.5,24021.856284347075,NaN,NaN,NaN,NaN,NaN,24025.43,24052.470347628954,23998.389652371046,24030.328980226663,24021.79744022789,24038.986731353405,24004.608149102372,34277,3213.0333333333333,49.05349812581831,58.688429869636764,NaN,NaN,NaN,NaN,10.99584470327416,21.356360612580296,-149565
2025-09-12T09:35:00-04:00,24034.5,24035.5,24002,24013.5,NaN,NaN,NaN,24052.119726338984,24052.119726338984,24052.119726338984,24025.655,24052.100772820075,23999.209227179923,24030.328980226663,24021.214940540038,24037.402932772104,24005.026948307972,32036,4223.833333333333,34.91613443660577,56.921440505945306,NaN,NaN,NaN,NaN,12.603284367326006,20.52118328075638,-181601
2025-09-12T09:40:00-04:00,24013.25,24034,24007.25,24030.5,NaN,NaN,NaN,24052.119726338984,NaN,NaN,24026.235,24051.793444785726,24000.676555214275,24030.328980226663,24021.39797606303,24037.042743995822,24005.753208130234,19174,4839.466666666666,47.98508343939084,56.72213076733965,NaN,NaN,NaN,NaN,13.61376405537415,19.745661472634165,-162427
2025-09-12T09:45:00-04:00,24030,24039.25,24020,24026.75,NaN,NaN,NaN,24052.119726338984,NaN,NaN,24026.715,24051.37691597782,24002.05308402218,24030.328980226663,24021.85357667626,24037.102227867075,24006.604925485448,18926,5451.6,45.800327459322254,56.268443451825725,NaN,NaN,NaN,NaN,14.016352337133139,18.47376407878313,-181353
2025-09-12T09:50:00-04:00,24026.5,24034.25,24011,24025.5,NaN,NaN,NaN,24052.119726338984,NaN,NaN,24027.07,24051.133466089843,24003.006533910157,24030.328980226663,24021.942264308043,24036.799758418903,24007.084770197183,16318,5960.066666666667,45.063801703762046,55.60771486767506,NaN,NaN,NaN,NaN,14.675898598766485,18.09876819110897,-197671
2025-09-12T09:55:00-04:00,24025.75,24049.75,24025.25,24046,NaN,NaN,NaN,24052.119726338984,NaN,NaN,24027.695,24052.067379856624,24003.322620143375,24030.328980226663,24022.93076041422,24037.966808505862,24007.894712322577,18078,6529.333333333333,57.21544267434528,55.45530034741693,NaN,NaN,NaN,NaN,15.377620127426022,17.283970880720993,-179593
2025-09-12T10:00:00-04:00,24044.75,24055.25,24018,24049,23997.8645989937,23997.8645989937,23997.8645989937,NaN,NaN,NaN,24028.365,24053.197078046458,24003.532921953545,24030.328980226663,24023.872478950183,24039.039169507596,24008.70578839277,18767,7109.9,58.65667439561477,55.23224137161686,NaN,NaN,NaN,NaN,16.93993297546702,16.191692809066733,-160826
2025-09-12T10:05:00-04:00,24049.5,24058.25,24046.25,24057.5,24009.65090528145,NaN,NaN,NaN,NaN,NaN,24029.3,24054.916791364067,24003.68320863593,24030.328980226663,24024.967837875975,24040.888450224753,24009.047225527196,13398,7519.266666666666,62.510071252494726,55.32198373564546,NaN,NaN,NaN,NaN,16.587080620076517,15.147832776322026,-147428
2025-09-12T10:10:00-04:00,24057.5,24061,24028.25,24031.25,24009.65090528145,NaN,NaN,NaN,NaN,NaN,24029.78,24054.61357404639,24004.946425953607,24028.26554734506,24025.824349470146,24041.68204459145,24009.966654348842,22007,8226.3,47.71834738289177,54.29317579339191,NaN,NaN,NaN,NaN,17.741574861499622,15.291382592017651,-169435
2025-09-12T10:15:00-04:00,24031.25,24056.25,24026.5,24054,24009.65090528145,NaN,NaN,NaN,NaN,NaN,24030.63,24055.809602859266,24005.450397140736,24028.26554734506,24026.781955223094,24042.822019104682,24010.741891341506,19890,8827.233333333334,57.17616849069907,53.59781470488189,NaN,NaN,NaN,NaN,18.59931951424965,15.536784673997515,-149545
2025-09-12T10:20:00-04:00,24053.75,24074,24050.5,24071.5,24014.05372218365,NaN,NaN,NaN,NaN,NaN,24031.82,24058.91631709485,24004.72368290515,24011.813817069866,24028.830921630422,24046.674730116785,24010.98711314406,23037,9557.566666666668,62.7573225961799,53.508627879113234,NaN,NaN,NaN,NaN,18.94936812037468,14.54343406569488,-126508
2025-09-12T10:25:00-04:00,24071,24076.5,24065.75,24071.75,24023.653552993484,NaN,NaN,NaN,NaN,NaN,24033.02,24061.721540027396,24004.318459972605,24021.37605365589,24030.02071275065,24048.958551037627,24011.082874463675,12483,9864.266666666666,62.83184658997794,53.46712401687854,NaN,NaN,NaN,NaN,18.363698968919348,13.799140834644108,-114025
2025-09-12T10:30:00-04:00,24071.75,24084.5,24064.5,24079.75,24026.459073311962,NaN,NaN,NaN,NaN,NaN,24034.41,24065.220186628118,24003.599813371882,24030.400842924715,24031.821371176888,24052.428971577934,24011.21377077584,18073,10374,65.22957447058783,53.68550906528968,NaN,NaN,NaN,NaN,18.480577613996534,13.65816930027769,-95952
2025-09-12T10:35:00-04:00,24080,24088.25,24076.75,24081.5,24035.0745699796,NaN,NaN,NaN,NaN,NaN,24035.73,24068.761627266715,24002.698372733284,24039.22067433977,24033.03650094432,24054.810863048722,24011.262138839917,11476,10664.166666666666,65.7500751210846,54.476026295626795,NaN,NaN,NaN,NaN,17.981964927282498,13.772726048724063,-84476
2025-09-12T10:40:00-04:00,24082,24087.25,24075.25,24081.5,24035.0745699796,NaN,NaN,NaN,NaN,NaN,24037,24072.029701681913,24001.970298318087,24042.026539471815,24033.82780351018,24056.27654496061,24011.37906205975,7920,10894.333333333334,65.7500751210846,55.66863893814582,NaN,NaN,NaN,NaN,17.55468171819089,13.743163677612888,-84476
2025-09-12T10:45:00-04:00,24081.75,24096.5,24079.25,24095,24040.748730084717,NaN,NaN,NaN,NaN,NaN,24038.565,24076.691081632685,24000.438918367312,24051.696231577454,24035.31672510957,24059.242417051268,24011.39103316787,13102,11264.3,69.79536747676703,58.160012726728766,NaN,NaN,NaN,NaN,17.53291873832011,14.327250174368409,-71374
2025-09-12T10:50:00-04:00,24094.75,24107.25,24091,24107,24051.924924171777,NaN,NaN,NaN,NaN,NaN,24040.32,24082.58228105499,23998.05771894501,24063.28198526196,24037.100619663815,24063.031200913938,24011.170038413693,13700,11666.866666666667,72.86351377161371,59.93704346474469,NaN,NaN,NaN,NaN,17.441281685582958,15.48344543556792,-57674
2025-09-12T10:55:00-04:00,24107,24115.75,24100.25,24106,24060.831745800333,NaN,NaN,NaN,NaN,NaN,24042.015,24087.73834305591,23996.29165694409,24072.82558820957,24039.13275094944,24067.266935334097,24010.998566564784,15202,12075.1,72.2052878994281,61.82311206760939,NaN,NaN,NaN,NaN,17.30261870804132,16.98235610537191,-72876
2025-09-12T11:00:00-04:00,24106.25,24111.25,24085.25,24086.25,24060.831745800333,NaN,NaN,NaN,NaN,NaN,24043.375,24090.221371257343,23996.528628742657,24072.82558820957,24040.681393250918,24069.87473275794,24011.488053743895,15189,12413.966666666667,60.56781848028606,62.930541837361105,NaN,NaN,NaN,NaN,17.92386022889551,17.009102915376804,-88065
2025-09-12T11:05:00-04:00,24086.75,24096,24083,24092.25,24060.831745800333,NaN,NaN,NaN,NaN,NaN,24044.765,24093.17908989539,23996.350910104607,24072.82558820957,24041.683043833164,24071.413518132544,24011.952569533783,11111,12676.2,62.542932432999955,63.31107682012215,NaN,NaN,NaN,NaN,17.572155926831545,16.848500002812266,-76954
2025-09-12T11:10:00-04:00,24092.75,24099,24080.75,24095.5,24060.831745800333,NaN,NaN,NaN,NaN,NaN,24046.295,24096.168609255757,23996.42139074424,24072.82558820957,24042.621362360343,24072.844432695187,24012.3982920255,10537,12964.233333333334,63.6063022536134,63.664621667122056,NaN,NaN,NaN,NaN,17.62057336062929,16.886814715022826,-66417
2025-09-12T11:15:00-04:00,24095,24105.5,24087.5,24088.25,24060.831745800333,NaN,NaN,NaN,NaN,NaN,24047.79,24098.1210401212,23997.4589598788,24072.82558820957,24043.713430175958,24074.512246234426,24012.91461411749,12271,13316.766666666666,59.545263739743156,63.452849701925516,NaN,NaN,NaN,NaN,17.64767526344148,17.317890407804338,-78688
2025-09-12T11:20:00-04:00,24088.5,24093,24079,24092.25,24060.831745800333,NaN,NaN,NaN,NaN,NaN,24049.36,24100.240169022425,23998.479830977576,24072.82558820957,24044.607012482506,24075.724743599414,24013.489281365597,11808,13633.433333333332,61.02383654998093,64.40324178528903,NaN,NaN,NaN,NaN,17.38712703033852,16.960934341757568,-66880
2025-09-12T11:25:00-04:00,24092.25,24098.75,24086,24087,24060.831745800333,NaN,NaN,NaN,NaN,NaN,24050.86,24101.668184375932,24000.05181562407,24072.82558820957,24045.226658214488,24076.585354325976,24013.867962103,8010,13846.566666666668,58.02618364434838,64.46395715340684,NaN,NaN,NaN,NaN,17.055903671028624,16.99970599611529,-74890
2025-09-12T11:30:00-04:00,24087,24097,24077.25,24093.25,24060.831745800333,NaN,NaN,NaN,NaN,NaN,24052.305,24103.739841305145,24000.870158694855,24072.82558820957,24045.953894779752,24077.553235491785,24014.35455406772,10002,14036.266666666666,60.51298738893323,64.30364749574635,NaN,NaN,NaN,NaN,17.24833912309801,16.294410608282725,-64888
2025-09-12T11:35:00-04:00,24092.75,24096.25,24082,24086,24060.831745800333,NaN,NaN,NaN,NaN,NaN,24053.515,24105.216393598777,24001.81360640122,24072.82558820957,24046.353566300728,24078.0667155845,24014.640417016955,5788,14133.766666666666,56.34290207784417,63.84015145916538,NaN,NaN,NaN,NaN,17.034172042876722,15.639493462438203,-70676
2025-09-12T11:40:00-04:00,24085.5,24091.75,24076.5,24080.25,24060.831745800333,NaN,NaN,NaN,NaN,NaN,24054.655,24106.15003762679,24003.159962373207,24072.82558820957,24046.804317274444,24078.57752982188,24015.031104727008,7633,14315.366666666667,53.21097198433924,62.981679853004756,NaN,NaN,NaN,NaN,16.906731182671244,14.568486318158588,-78309
2025-09-12T11:45:00-04:00,24080.5,24083.5,24072,24080.5,24060.831745800333,NaN,NaN,NaN,NaN,NaN,24055.705,24107.12412970319,24004.285870296815,24063.910470567655,24047.3258632458,24079.096256276425,24015.55547021517,10280,14594.366666666667,53.3324352164877,62.09470557410497,NaN,NaN,NaN,NaN,16.52053609819473,13.84556325765459,-68029
2025-09-12T11:50:00-04:00,24080.25,24090.25,24079.25,24089,24060.831745800333,NaN,NaN,NaN,NaN,NaN,24056.91,24108.56924505746,24005.25075494254,24060.80216093064,24047.80354904561,24079.666846822685,24015.940251268534,7820,14799.966666666667,57.383270027009765,61.49707663881391,NaN,NaN,NaN,NaN,16.12621209118082,13.102676355347226,-60209
2025-09-12T11:55:00-04:00,24088.75,24099.75,24087.75,24090.75,24060.831745800333,NaN,NaN,NaN,NaN,NaN,24058.085,24110.09582675812,24006.07417324188,24064.973532592,24048.391165970796,24080.454578192846,24016.327753748745,8423,14891.2,58.18797084948517,60.667976879722346,NaN,NaN,NaN,NaN,15.831482656096478,13.121590149805657,-51786
2025-09-12T12:00:00-04:00,24090.75,24092.25,24074.25,24080.5,24060.831745800333,NaN,NaN,NaN,NaN,NaN,24058.995,24110.950508850015,24007.039491149982,24064.973532592,24048.82051209356,24080.90550373904,24016.73552044808,8254,14023.766666666666,51.99516094084929,59.17738024895346,NaN,NaN,NaN,NaN,15.986376752089587,12.329941915896347,-60040
2025-09-12T12:05:00-04:00,24080.25,24091.5,24071.25,24091.25,24060.831745800333,NaN,NaN,NaN,NaN,NaN,24059.93,24112.487591266916,24007.372408733085,24064.973532592,24049.260830549418,24081.391676478946,24017.12998461989,8115,13226.4,57.146393915782156,58.101744964407324,NaN,NaN,NaN,NaN,16.290921269797472,11.815234766690978,-51925
2025-09-12T12:10:00-04:00,24091.25,24101.75,24090,24097.75,24060.831745800333,NaN,NaN,NaN,NaN,NaN,24061.29,24114.171599826015,24008.408400173987,24064.973532592,24049.813879310568,24082.157724534118,24017.47003408702,7826,12848.133333333333,59.94518499018433,58.057271143685774,NaN,NaN,NaN,NaN,15.966569750526224,11.38513866480771,-44099
2025-09-12T12:15:00-04:00,24097.5,24107.25,24097.5,24101,24060.831745800333,NaN,NaN,NaN,NaN,NaN,24062.68,24116.008138913083,24009.351861086918,24072.342558949684,24050.360625624802,24082.969440064204,24017.7518111854,7089,12453.566666666668,61.30594651849699,57.96891500693556,NaN,NaN,NaN,NaN,15.522529054060064,11.366742437541841,-37010
2025-09-12T12:20:00-04:00,24101,24106.75,24091.5,24104.25,24060.831745800333,NaN,NaN,NaN,NaN,NaN,24064.115,24117.97623002424,24010.253769975763,24072.342558949684,24050.97197809323,24083.849599071953,24018.094357114504,8283,12185.733333333334,62.67163286713173,57.902152907901154,NaN,NaN,NaN,NaN,15.503062693055773,10.854609594269217,-28727
2025-09-12T12:25:00-04:00,24104.5,24106.5,24101,24105.25,24060.831745800333,NaN,NaN,NaN,NaN,NaN,24065.355,24120.085438517744,24010.624561482255,24075.309237727797,24051.236951471197,24084.246178385496,24018.2277245569,3418,11697.066666666668,63.10314932249917,58.15628759238372,NaN,NaN,NaN,NaN,14.788558214980359,10.379057668373209,-25309
2025-09-12T12:30:00-04:00,24105,24112.5,24102,24110.25,24063.24061819566,NaN,NaN,NaN,NaN,NaN,24066.785,24122.38949711842,24011.18050288158,24082.297390182237,24051.77543835375,24085.08802667318,24018.46285003432,6553,11289.933333333332,65.265256191536,58.45924613820908,NaN,NaN,NaN,NaN,14.482232628196048,10.399054627304652,-18756
2025-09-12T12:35:00-04:00,24110.5,24111,24097,24098.5,24063.24061819566,NaN,NaN,NaN,NaN,NaN,24068.015,24123.650457219625,24012.379542780374,24082.297390182237,24052.221684211734,24085.720772879904,24018.722595543564,6199,11049.966666666667,56.836428371212364,58.37426361869937,NaN,NaN,NaN,NaN,14.44778744046776,9.966459890107673,-24955
2025-09-12T12:40:00-04:00,24098.25,24102,24096.25,24100.75,24063.24061819566,NaN,NaN,NaN,NaN,NaN,24069.485,24124.61615362391,24014.353846376092,24082.297390182237,24052.505323169804,24086.103790194407,24018.9068561452,4210,10456.733333333334,57.95616728062982,58.191633610963414,NaN,NaN,NaN,NaN,13.826516909005777,9.496672304605369,-20745
2025-09-12T12:45:00-04:00,24101,24110.25,24096.75,24104.75,24063.24061819566,NaN,NaN,NaN,NaN,NaN,24071,24125.7597479917,24016.2402520083,24082.297390182237,24053.02592534285,24086.84780837426,24019.204042311438,7204,10033.866666666667,59.94552374623768,58.44896373013438,NaN,NaN,NaN,NaN,13.803194272648222,9.734362814554943,-13541
2025-09-12T12:50:00-04:00,24105.25,24114.25,24102,24111.5,24065.7855675727,NaN,NaN,NaN,NaN,NaN,24072.595,24127.33464650749,24017.855353492512,24084.930011018645,24053.409980934808,24087.43279022939,24019.387171640225,4893,9429.066666666668,63.117023869925255,59.15653886481909,NaN,NaN,NaN,NaN,13.692251824601922,10.257189803712413,-8648
2025-09-12T12:55:00-04:00,24111.75,24124.75,24107.25,24110.5,24073.198723592122,NaN,NaN,NaN,NaN,NaN,24074.03,24128.907102696445,24019.152897303553,24092.544008814915,24054.33060132768,24088.900790286443,24019.76041236892,11021,9380.333333333334,62.32963518262912,59.79919600525777,NaN,NaN,NaN,NaN,13.964233837130354,11.45727599875911,-19669
2025-09-12T13:00:00-04:00,24110.5,24112.25,24101.25,24101.75,24073.198723592122,NaN,NaN,NaN,NaN,NaN,24075.215,24129.87595590371,24020.55404409629,24092.544008814915,24054.730881632808,24089.45590826654,24020.005854999075,5782,8970.633333333333,55.773292054771,59.684197578669284,NaN,NaN,NaN,NaN,13.7525028487639,11.944559031197608,-25451
2025-09-12T13:05:00-04:00,24102.25,24104.75,24098,24098.75,24073.198723592122,NaN,NaN,NaN,NaN,NaN,24076.35,24130.559962190946,24022.14003780905,24092.544008814915,24055.01399150038,24089.81695452611,24020.211028474645,4563,8740.2,53.68811410677397,59.36277923990419,NaN,NaN,NaN,NaN,13.252324073852193,12.06970613645973,-30014
2025-09-12T13:10:00-04:00,24098.75,24106.25,24097.5,24105,24073.198723592122,NaN,NaN,NaN,NaN,NaN,24077.585,24131.535311396834,24023.634688603164,24092.544008814915,24055.28364163665,24090.173070277197,24020.394212996107,4176,8615.4,57.272142230490985,59.739706474878595,NaN,NaN,NaN,NaN,12.930729497148466,12.302384089376707,-25838
2025-09-12T13:15:00-04:00,24105,24111,24098.75,24100.75,24073.198723592122,NaN,NaN,NaN,NaN,NaN,24078.585,24132.361910472682,24024.808089527316,24092.544008814915,24055.647379246682,24090.654451299386,24020.64030719398,5639,8366.633333333333,54.20046518395496,59.5292829940338,NaN,NaN,NaN,NaN,12.882105961637862,12.884541632248245,-31477
2025-09-12T13:20:00-04:00,24101.25,24106.75,24099.25,24105.5,24073.198723592122,NaN,NaN,NaN,NaN,NaN,24079.73,24133.312164942497,24026.1478350575,24092.544008814915,24055.832064960756,24090.898618831623,24020.76551108989,2876,8005.833333333333,56.977715082038806,59.31732085773769,NaN,NaN,NaN,NaN,12.497669821520873,13.425116493486103,-28601
2025-09-12T13:25:00-04:00,24105.5,24106,24099.75,24100.75,24073.198723592122,NaN,NaN,NaN,NaN,NaN,24080.79,24133.89445931904,24027.685540680963,24092.544008814915,24055.982612086784,24091.09131103511,24020.873913138457,2446,7580.633333333333,53.484944009884934,58.758677821408256,NaN,NaN,NaN,NaN,12.051407691412239,13.927078864635542,-31047
2025-09-12T13:30:00-04:00,24101,24107.5,24098.25,24099.5,24073.198723592122,NaN,NaN,NaN,NaN,NaN,24081.845,24134.29439370473,24029.39560629527,24092.544008814915,24056.191337219094,24091.355360499136,24021.027313939052,3449,7189.3,52.571635163365194,58.03724941399637,NaN,NaN,NaN,NaN,11.85130714202565,14.393186780702877,-34496
2025-09-12T13:35:00-04:00,24099.5,24104,24091.5,24098.5,24073.198723592122,NaN,NaN,NaN,NaN,NaN,24083.01,24134.286598954808,24031.73340104519,24092.544008814915,24056.580033134087,24091.80945921745,24021.350607050725,7097,7055.5,51.80943394864718,57.23055545872122,NaN,NaN,NaN,NaN,11.897642346166675,13.933779384852516,-41593
2025-09-12T13:40:00-04:00,24098,24105.25,24097.75,24103.5,24073.198723592122,NaN,NaN,NaN,NaN,NaN,24084.39,24134.058919862076,24034.721080137922,24092.544008814915,24056.755167967935,24092.029769151923,24021.480566783946,2944,6802.4,55.29913903865811,56.51868994780137,NaN,NaN,NaN,NaN,11.583525035726199,13.640393835125872,-38649
2025-09-12T13:45:00-04:00,24103,24114.5,24102.75,24113.5,24073.198723592122,NaN,NaN,NaN,NaN,NaN,24086.39,24132.398277516306,24040.381722483693,24089.46254348412,24057.16698532345,24092.6152442986,24021.7187263483,5945,6591.533333333334,61.330435297502795,56.8396904425364,NaN,NaN,NaN,NaN,11.595416104602899,14.26341995122677,-32704
2025-09-12T13:50:00-04:00,24113.75,24121.75,24110.75,24117.75,24079.07597686768,NaN,NaN,NaN,NaN,NaN,24088.135,24132.105013647077,24044.16498635292,24096.220034787297,24057.69092533337,24093.418685084365,24021.963165582372,6851,6426.3,63.57956019446659,57.24136136495332,NaN,NaN,NaN,NaN,11.552886382845548,15.424352236320562,-25853
2025-09-12T13:55:00-04:00,24118,24129,24116.75,24124,24085.720250646424,NaN,NaN,NaN,NaN,NaN,24090.08,24131.54907763147,24048.610922368534,24102.451027829837,24058.542722639515,24094.80572470444,24022.27972057459,10256,6501.166666666667,66.65139419222069,57.72035211109496,NaN,NaN,NaN,NaN,11.602680212642294,17.006660683418936,-15597
2025-09-12T14:00:00-04:00,24124,24124.75,24113,24113.75,24085.720250646424,NaN,NaN,NaN,NaN,NaN,24091.845,24129.506636973918,24054.183363026084,24102.451027829837,24059.00098356164,24095.48907801555,24022.51288910773,6219,6375.066666666667,58.00999762858587,57.35556452242787,NaN,NaN,NaN,NaN,11.613203054596415,17.949542912431195,-21816
2025-09-12T14:05:00-04:00,24113.5,24121.25,24113,24120.25,24085.720250646424,NaN,NaN,NaN,NaN,NaN,24093.33,24129.468406160147,24057.191593839856,24102.451027829837,24059.2773034109,24095.902915005598,24022.651691816205,3733,6306.566666666667,61.42546088873688,57.29098064429271,NaN,NaN,NaN,NaN,11.372974264982386,18.82507641079972,-18083
2025-09-12T14:10:00-04:00,24120.75,24125,24115.75,24123.75,24085.720250646424,NaN,NaN,NaN,NaN,NaN,24094.825,24129.665529562433,24059.98447043757,24102.451027829837,24059.598616193303,24096.40076382865,24022.796468557957,4149,6190.433333333333,63.16297231932508,57.818814948903714,NaN,NaN,NaN,NaN,11.221333246055071,19.9296665809781,-13934
2025-09-12T14:15:00-04:00,24124,24124,24116.5,24120.5,24085.720250646424,NaN,NaN,NaN,NaN,NaN,24096.085,24129.978894732525,24062.191105267473,24102.451027829837,24059.84577306528,24096.77592784539,24022.915618285173,3283,5957.2,60.44055098576337,58.30113186883154,NaN,NaN,NaN,NaN,10.955523728479708,20.9553574532866,-17217
2025-09-12T14:20:00-04:00,24120.5,24124.5,24118.5,24121.75,24086.803561111912,NaN,NaN,NaN,NaN,NaN,24097.895,24127.085767370805,24068.704232629196,24102.451027829837,24060.05117441857,24097.09085080054,24023.0114980366,2693,5786.3,61.13440708995871,58.57700793022209,NaN,NaN,NaN,NaN,10.601557747874015,21.949857490024222,-14524
2025-09-12T14:25:00-04:00,24122,24126.25,24120.5,24122.25,24089.47158106137,NaN,NaN,NaN,NaN,NaN,24099.26,24126.425411840217,24072.09458815978,24105.632626239425,24060.344005017923,24097.54485346319,24023.143156572656,3783,5631.633333333333,61.4258544786472,59.09310716555725,NaN,NaN,NaN,NaN,10.255017908740157,23.025345990581737,-10741
2025-09-12T14:30:00-04:00,24122,24137.5,24119.5,24132,24093.683100104034,NaN,NaN,NaN,NaN,NaN,24100.47,24127.969207259805,24072.970792740198,24112.00610099154,24061.1190670595,24098.822635037628,24023.41549908137,9195,5663,66.67391112384905,59.78569259711513,NaN,NaN,NaN,NaN,10.808230915258719,24.85424128892969,-1546
2025-09-12T14:35:00-04:00,24132,24141,24128.75,24139.25,24099.970231917487,NaN,NaN,NaN,NaN,NaN,24101.82,24130.161496076205,24073.478503923794,24114.47988079323,24061.679055387336,24099.79441597964,24023.563694795033,6169,5598.133333333333,69.94802168342746,60.96162671665388,NaN,NaN,NaN,NaN,10.911214421311668,26.76613131267925,4623
2025-09-12T14:40:00-04:00,24139,24143,24135.5,24139.25,24104.909085012147,NaN,NaN,NaN,NaN,NaN,24103.01,24132.517449906605,24073.50255009339,24118.033904634587,24062.280628973527,24100.85285907425,24023.708398872805,6476,5553.133333333333,69.94802168342746,62.202797182372606,NaN,NaN,NaN,NaN,10.667556248360835,28.660985938455248,4623
2025-09-12T14:45:00-04:00,24139,24141.75,24118,24129.25,24104.909085012147,NaN,NaN,NaN,NaN,NaN,24103.965,24133.715799985755,24074.214200014245,24118.033904634587,24062.956866767676,24101.918360098836,24023.995373436515,8465,5599,60.448043626317606,62.819840730777635,NaN,NaN,NaN,NaN,11.60201651633506,27.728918518743644,-3842
2025-09-12T14:50:00-04:00,24129.25,24158.5,24129.25,24153.5,24105.504972087514,NaN,NaN,NaN,NaN,NaN,24105.405,24137.54125522964,24073.268744770357,24118.396698966135,24064.189769041477,24104.164146393043,24024.21539168991,12546,5741.1,70.80359049948407,63.927301549408064,NaN,NaN,NaN,NaN,12.86258676516827,28.081969671218243,8704
2025-09-12T14:55:00-04:00,24153.75,24159,24150,24154,24116.64679153808,NaN,NaN,NaN,NaN,NaN,24106.585,24141.3330373583,24071.836962641697,24122.41735917291,24065.026947943614,24105.74396919912,24024.309926688107,8025,5894.666666666667,70.97234677803898,64.6160095123035,NaN,NaN,NaN,NaN,12.586687710513393,28.44085454695421,16729
2025-09-12T15:00:00-04:00,24154,24157.5,24151,24153,24117.23102828635,NaN,NaN,NaN,NaN,NaN,24107.505,24144.604526949333,24070.40547305067,24124.983887338327,24065.44836695596,24106.524585062212,24024.372148849707,4120,5813.566666666667,70.09965466532019,65.08173054593591,NaN,NaN,NaN,NaN,12.151924302619578,28.77410478870903,12609
2025-09-12T15:05:00-04:00,24153.5,24157.25,24147,24150,24117.23102828635,NaN,NaN,NaN,NaN,NaN,24108.385,24147.340899430128,24069.42910056987,24126.11210987066,24066.014459115686,24107.541448094096,24024.487470137276,5755,5798.766666666666,67.42125930992614,65.1367209114863,NaN,NaN,NaN,NaN,12.01607256671818,28.54617654419835,6854
2025-09-12T15:10:00-04:00,24150.5,24150.75,24136.5,24138.75,24117.23102828635,NaN,NaN,NaN,NaN,NaN,24109.435,24148.776048531963,24070.09395146804,24126.11210987066,24066.593829613696,24108.48690921481,24024.70075001258,6715,5882.266666666666,58.40862520460209,65.16519430977317,NaN,NaN,NaN,NaN,12.175638811952595,27.098728200645883,139
2025-09-12T15:15:00-04:00,24139.5,24142,24133.5,24137.75,24117.23102828635,NaN,NaN,NaN,NaN,NaN,24110.345,24150.156039920308,24070.533960079694,24126.11210987066,24067.151047370022,24109.348507257568,24024.953587482476,6951,5873.833333333333,57.67064980373699,64.89699351798745,NaN,NaN,NaN,NaN,11.913093182527408,25.44014086560575,-6812
2025-09-12T15:20:00-04:00,24137.5,24140.25,24124.75,24128.5,24117.23102828635,NaN,NaN,NaN,NaN,NaN,24111.005,24150.9038082507,24071.106191749303,24126.11210987066,24067.68045909783,24110.101092269942,24025.25982592572,7402,5957.466666666666,51.22359485926456,64.04418084226884,NaN,NaN,NaN,NaN,12.16930081234688,24.186368286968648,-14214
2025-09-12T15:25:00-04:00,24128,24133.5,24119.5,24124.5,24117.23102828635,NaN,NaN,NaN,NaN,NaN,24111.73,24151.264268676336,24072.195731323663,24126.11210987066,24068.2399597927,24110.835971300985,24025.643948284414,8695,5879.933333333333,48.68882373423227,63.204771752873775,NaN,NaN,NaN,NaN,12.300065040036388,23.47084343745542,-22909
2025-09-12T15:30:00-04:00,24124.75,24126.5,24104.5,24111,NaN,NaN,NaN,24153.9801443432,24153.9801443432,24153.9801443432,24112.105,24151.246805019597,24072.963194980402,24126.11210987066,24069.100652384528,24111.749657298627,24026.45164747043,17324,6264.666666666667,41.26671870830416,61.785651154184166,NaN,NaN,NaN,NaN,12.992917537176647,23.86974921435716,-40233
2025-09-12T15:35:00-04:00,24110.75,24115.5,24097.5,24100.25,NaN,NaN,NaN,24145.6855923276,NaN,NaN,24112.37,24151.00447165788,24073.735528342117,24126.11210987066,24069.556493795062,24112.116456150303,24026.99653143982,12044,6514.033333333334,36.495818815704745,60.00493432111684,NaN,NaN,NaN,NaN,13.350566284521173,24.64645099704354,-52277
2025-09-12T15:40:00-04:00,24100.25,24114.25,24087.5,24113.5,NaN,NaN,NaN,24141.92715631271,NaN,NaN,24112.775,24151.02186261319,24074.528137386813,24126.11210987066,24070.213639764694,24112.649002599774,24027.778276929614,17585,6961,44.94457172468398,58.45283864974791,NaN,NaN,NaN,NaN,14.307668692769662,25.879488430459112,-34692
2025-09-12T15:45:00-04:00,24113.25,24123.5,24108,24119.25,NaN,NaN,NaN,24141.92715631271,NaN,NaN,24113.44,24150.950739803997,24075.929260196,24126.11210987066,24070.79508012949,24113.282230938872,24028.307929320108,11985,7172.533333333334,48.16734946823896,56.89707634866302,NaN,NaN,NaN,NaN,14.392835214714685,26.02503976271527,-22707
2025-09-12T15:50:00-04:00,24119,24134.5,24118,24132.75,NaN,NaN,NaN,24141.92715631271,NaN,NaN,24114.49,24151.15537330832,24077.824626691683,24126.11210987066,24071.69585287659,24114.451335701968,24028.940370051212,15288,7586.266666666666,54.849863578465296,55.81863648402287,NaN,NaN,NaN,NaN,14.543346985092208,25.1358242499937,-7419
2025-09-12T15:55:00-04:00,24132.75,24133.25,24108.5,24109.5,NaN,NaN,NaN,24141.92715631271,NaN,NaN,24115.07,24150.461671333254,24079.678328666745,24118.71468789653,24072.728262694338,24115.532964155333,24029.923561233343,22763,8263.5,44.26528436551435,54.6627251082512,NaN,NaN,NaN,NaN,15.272393629014193,24.893034040197552,-30182
2025-09-12T16:00:00-04:00,24109.75,24112.25,24096.75,24106,NaN,NaN,NaN,24141.92715631271,NaN,NaN,24115.41,24150.113279387548,24080.706720612452,24112.121750317223,24073.11213860219,24115.805097281842,24030.41917992254,12047,8550.1,42.92248036384463,52.67121724141981,NaN,NaN,NaN,NaN,15.28865122694175,25.292143400038448,-42229
2025-09-12T16:05:00-04:00,24105.5,24112.5,24105,24108.5,NaN,NaN,NaN,24141.92715631271,NaN,NaN,24115.765,24149.8088555446,24081.721144455398,24108.597400253777,24073.227926891443,24115.899419380774,24030.55643440211,3309,8423.833333333334,44.22400778014935,50.760621598713406,NaN,NaN,NaN,NaN,14.732318996445912,25.63894714580882,-38920
2025-09-12T16:10:00-04:00,24108.5,24113,24108,24111,NaN,NaN,NaN,24141.92715631271,NaN,NaN,24116.375,24148.929915147008,24083.820084852992,24101.177920203023,24073.291379078273,24115.954498732,24030.628259424546,1725,8383.2,45.56086230251842,49.00785071565614,NaN,NaN,NaN,NaN,14.037153353842632,25.91013290488965,-37195
2025-09-12T16:15:00-04:00,24111.75,24119.25,24109.75,24114.75,NaN,NaN,NaN,24141.92715631271,NaN,NaN,24116.845,24148.604233296086,24085.085766703916,24091.785100892128,24073.376117189076,24116.036383946044,24030.71585043211,2093,8254.8,47.59006939584692,47.59133715036477,NaN,NaN,NaN,NaN,13.7130709714253,25.527906315775212,-35102
2025-09-12T16:20:00-04:00,24114.75,24116.75,24111.5,24113,NaN,NaN,NaN,24141.92715631271,NaN,NaN,24117.15,24148.459583196873,24085.84041680313,24091.785100892128,24073.42249854483,24116.080183809612,24030.76481328005,1173,8065.533333333334,46.7149595388048,46.75607531709353,NaN,NaN,NaN,NaN,13.108565902037778,25.172981625883235,-36275
2025-09-12T16:25:00-04:00,24112.75,24115,24112,24113.5,NaN,NaN,NaN,24141.92715631271,NaN,NaN,24117.4,24148.38773950728,24086.41226049272,24091.785100892128,24073.45301220894,24116.108781462153,24030.79724295573,778,7749.6,47.01475003717458,45.99493961948194,NaN,NaN,NaN,NaN,12.38652548046365,24.84340869955497,-35497
2025-09-12T16:30:00-04:00,24113.25,24115,24110.5,24113.5,NaN,NaN,NaN,24141.92715631271,NaN,NaN,24117.585,24148.366262160554,24086.803737839444,24093.39198751249,24073.49310495293,24116.145818418474,24030.840391487385,1037,7576.866666666667,47.01475003717458,45.69430784647551,NaN,NaN,NaN,NaN,11.823202231859103,24.65167437292016,-35497
2025-09-12T16:35:00-04:00,24114,24115,24110,24111.5,NaN,NaN,NaN,24141.92715631271,NaN,NaN,24117.71,24148.34027260993,24087.079727390068,24095.213590009993,24073.532536630184,24116.181363789354,24030.883709471014,1044,7487.233333333334,45.818873541548335,45.48931140414094,NaN,NaN,NaN,NaN,11.335830643869167,24.513550216590545,-36541
2025-09-12T16:40:00-04:00,24111.25,24115,24110.75,24113,NaN,NaN,NaN,24141.92715631271,NaN,NaN,24117.765,24148.351338458593,24087.178661541406,24097.045872007995,24073.580327496267,24116.2253177696,24030.935337222934,1244,7390.4,46.90959580335017,45.89237405378708,NaN,NaN,NaN,NaN,10.829699883592799,24.38529207142733,-35297
2025-09-12T16:45:00-04:00,24113,24117.25,24113,24113.5,NaN,NaN,NaN,24141.92715631271,NaN,NaN,24118.065,24148.180246970747,24087.94975302925,24100.761697606395,24073.632416312386,24116.2753289595,24030.989503665274,1304,7324.433333333333,47.290502363997284,46.663422878665116,NaN,NaN,NaN,NaN,10.359721320479027,23.94964472495873,-33993
2025-09-12T16:50:00-04:00,24113.25,24114.75,24111.75,24113,NaN,NaN,NaN,24141.92715631271,NaN,NaN,24118.31,24148.05484156918,24088.56515843082,24100.761697606395,24073.661511875285,24116.30221008414,24031.02081366643,756,7259.866666666667,46.927910278892064,46.805089918251404,NaN,NaN,NaN,NaN,9.834026940444812,23.66855590525466,-34749
2025-09-12T16:55:00-04:00,24113.25,24115.75,24108,24114.5,NaN,NaN,NaN,24141.92715631271,NaN,NaN,24118.505,24148.01863921465,24088.991360785352,24100.761697606395,24073.72620759977,24116.361221944615,24031.091193254928,1703,7190.533333333334,48.210800597662605,46.80819357035309,NaN,NaN,NaN,NaN,9.685167873270183,23.77295187142349,-33046
2025-09-14T18:00:00-04:00,24112.25,24119.75,24099.25,24105.25,NaN,NaN,NaN,24141.92715631271,NaN,NaN,24118.38,24148.06370596484,24088.696294035162,24100.761697606395,24108.083333333332,24108.083333333332,24108.083333333332,2787,6976.933333333333,41.542024266555195,45.85763361950238,NaN,NaN,NaN,NaN,10.457655882322314,24.610362673831762,-35833
2025-09-14T18:05:00-04:00,24104.5,24121.75,24100.25,24119,NaN,NaN,NaN,24141.92715631271,NaN,NaN,24118.55,24148.148479693587,24088.95152030641,24100.761697606395,24109.83868388684,24112.430874401805,24107.246493371873,1278,6813.9,52.1399446659522,46.42010935524794,NaN,NaN,NaN,NaN,11.24639474787072,25.068965367393947,-34555
2025-09-14T18:10:00-04:00,24118,24122.75,24113.25,24120.5,NaN,NaN,NaN,24141.92715631271,NaN,NaN,24118.925,24148.135143787327,24089.71485621267,24100.761697606395,24111.750177579746,24116.089633552394,24107.4107216071,1097,6634.6,53.13803673371958,47.14979195309615,NaN,NaN,NaN,NaN,11.121652265879955,25.331603054984676,-33458
2025-09-14T18:15:00-04:00,24120.75,24129.75,24119.75,24124.25,NaN,NaN,NaN,24141.92715631271,NaN,NaN,24119.435,24148.10376523151,24090.766234768493,24102.42097045733,24114.25035095929,24120.65319933731,24107.84750258127,1249,6394.066666666667,55.62929324136824,47.96445520032607,NaN,NaN,NaN,NaN,11.04153424688853,24.50705133912435,-32209
2025-09-14T18:20:00-04:00,24124,24124.75,24115.75,24119,NaN,NaN,NaN,24141.92715631271,NaN,NaN,24119.715,24148.086290065206,24091.343709934794,24102.42097045733,24114.775037686075,24121.08357589951,24108.46649947264,665,5998.033333333334,51.50138887576659,48.38877852698665,NaN,NaN,NaN,NaN,10.895710372110779,24.152296572322104,-32874
2025-09-14T18:25:00-04:00,24117.75,24125.75,24117,24123,NaN,NaN,NaN,24141.92715631271,NaN,NaN,24120.16,24148.020861429985,24092.299138570015,24102.42097045733,24115.121700058266,24121.463733860663,24108.77966625587,361,5742.566666666667,54.28476811177352,48.86697129240997,NaN,NaN,NaN,NaN,10.742445345531438,23.67219463505333,-32513
2025-09-14T18:30:00-04:00,24122.5,24124,24118.5,24120.5,NaN,NaN,NaN,24141.92715631271,NaN,NaN,24120.46,24148.004211740867,24092.91578825913,24102.42097045733,24115.407455972025,24121.721270432725,24109.093641511325,380,5617.9,52.26581824056108,49.263461199678275,NaN,NaN,NaN,NaN,10.367984963707764,23.226385693303754,-32893
2025-09-14T18:35:00-04:00,24120.5,24124,24118,24123,NaN,NaN,NaN,24141.92715631271,NaN,NaN,24120.905,24147.87403595491,24093.93596404509,24102.502029499323,24115.591641834282,24121.901168465072,24109.282115203492,237,5433.966666666666,54.10407576466954,49.769841608785065,NaN,NaN,NaN,NaN,10.055986037728639,22.872164408968473,-32656
2025-09-14T18:40:00-04:00,24122.75,24126.25,24121.75,24124,NaN,NaN,NaN,24141.92715631271,NaN,NaN,24121.395,24147.67200325927,24095.11799674073,24106.80162359946,24115.94278207416,24122.344097165078,24109.54146698324,351,5221.833333333333,54.85302130056086,50.329718127598376,NaN,NaN,NaN,NaN,9.659129892176594,22.147945040229665,-32305
2025-09-14T18:45:00-04:00,24124,24128.75,24124,24125.25,NaN,NaN,NaN,24141.92715631271,NaN,NaN,24121.93,24147.39743802863,24096.46256197137,24110.816298879567,24116.524502111122,24123.16669893043,24109.882305291816,516,5007.333333333333,55.82344776407934,51.04433057206487,NaN,NaN,NaN,NaN,9.308477757021123,21.048488541966844,-31789
2025-09-14T18:50:00-04:00,24125.5,24127.25,24121.25,24124.75,NaN,NaN,NaN,24141.92715631271,NaN,NaN,24122.355,24147.281509988206,24097.428490011793,24110.816298879567,24116.797794250262,24123.48159547555,24110.113993024974,320,4771.266666666666,55.31130327298575,51.6444525341817,NaN,NaN,NaN,NaN,9.0721579172339,20.421193140592944,-32109
2025-09-14T18:55:00-04:00,24124,24125.75,24121.25,24124.75,NaN,NaN,NaN,24141.92715631271,NaN,NaN,24122.58,24147.385531625878,24097.774468374126,24110.816298879567,24116.965536066495,24123.65781226924,24110.27325986375,223,4488.866666666667,55.31130327298575,52.21736688482373,NaN,NaN,NaN,NaN,8.74557520886005,19.838704553602895,-32109
2025-09-14T19:00:00-04:00,24124.5,24129.25,24123.75,24125.75,NaN,NaN,NaN,24141.92715631271,NaN,NaN,24122.74,24147.52204187617,24097.957958123832,24113.597945026337,24117.32937394247,24124.132103883963,24110.526644000976,386,3924.266666666667,56.242471180326106,52.88269266349759,NaN,NaN,NaN,NaN,8.513748408227189,18.65440309776694,-31723
2025-09-14T19:05:00-04:00,24125.5,24126.25,24119.25,24120,NaN,NaN,NaN,24141.92715631271,NaN,NaN,24122.66,24147.451079040315,24097.868920959685,24113.597945026337,24117.494980116044,24124.225063904923,24110.764896327164,376,3535.3333333333335,49.81496283786197,52.99727568065469,NaN,NaN,NaN,NaN,8.405623521925246,18.245625382123226,-32099
2025-09-14T19:10:00-04:00,24119,24122.25,24117.5,24120.25,NaN,NaN,NaN,24141.92715631271,NaN,NaN,24122.79,24147.46070326339,24098.11929673661,24113.597945026337,24117.58950472068,24124.208624814495,24110.970384626864,401,2962.5333333333333,50.08207375403165,53.607279215474435,NaN,NaN,NaN,NaN,8.144507556073444,18.11600982727449,-31698
2025-09-14T19:15:00-04:00,24120.25,24123,24118.5,24119.75,NaN,NaN,NaN,24141.92715631271,NaN,NaN,24122.78,24147.455218342333,24098.104781657665,24113.597945026337,24117.682139498193,24124.211342720162,24111.152936276223,360,2575.0333333333333,49.51444552434557,53.41974356250254,NaN,NaN,NaN,NaN,7.884185587782484,17.84418828900713,-32058
2025-09-14T19:20:00-04:00,24119.5,24122.75,24116.25,24118.25,NaN,NaN,NaN,24141.92715631271,NaN,NaN,24122.67,24147.37595880284,24097.964041197156,24113.597945026337,24117.7257569077,24124.15713892045,24111.29437489495,353,2077.2,47.765400287103446,53.035983816315664,NaN,NaN,NaN,NaN,7.785315188655163,17.931912198703717,-32411
2025-09-14T19:25:00-04:00,24118.25,24118.25,24110.25,24111.25,NaN,NaN,NaN,24140.91598176176,NaN,NaN,24122.485,24147.390904923064,24097.579095076937,24113.597945026337,24117.416399879603,24123.72454216115,24111.108257598054,842,1346.5,40.56421955007212,51.959907124080225,NaN,NaN,NaN,NaN,7.800649818036938,18.808913610620532,-33253
2025-09-14T19:30:00-04:00,24111,24114.75,24102,24102.75,NaN,NaN,NaN,24135.567528045314,NaN,NaN,24122.105,24147.616583642422,24096.593416357577,24113.597945026337,24116.34480184582,24123.159207239376,24109.53039645226,1326,989.1333333333333,33.884002627228256,50.701522392041774,NaN,NaN,NaN,NaN,8.154174831034299,20.467184192460124,-34579
2025-09-14T19:35:00-04:00,24102.75,24109.25,24100,24108.75,NaN,NaN,NaN,24131.84286767962,NaN,NaN,24121.835,24147.61902801343,24096.05097198657,24113.597945026337,24115.71344246721,24122.76572756622,24108.661157368202,878,908.1,41.240070304956056,49.76975826298338,NaN,NaN,NaN,NaN,8.232448057388991,22.182283864985923,-33701
2025-09-14T19:40:00-04:00,24108.5,24109.5,24100.75,24108,NaN,NaN,NaN,24131.84286767962,NaN,NaN,24121.355,24147.25752691005,24095.45247308995,24113.597945026337,24115.25201301566,24122.434099771053,24108.069926260265,724,874.7333333333333,40.63151938734584,48.93873691632515,NaN,NaN,NaN,NaN,8.269416053289778,23.716409178764586,-34425
2025-09-14T19:45:00-04:00,24108.25,24111,24100.5,24109.75,NaN,NaN,NaN,24131.84286767962,NaN,NaN,24120.765,24146.352186248823,24095.177813751176,24113.597945026337,24114.933037607054,24122.149131701106,24107.716943513,614,825.4333333333333,42.75419042767942,48.128030820825856,NaN,NaN,NaN,NaN,8.428743478054793,24.778572142315706,-33811
2025-09-14T19:50:00-04:00,24108.75,24111.25,24105.25,24106.25,NaN,NaN,NaN,24131.84286767962,NaN,NaN,24120.105,24145.45220694299,24094.757793057008,24110.22835602107,24114.77032027363,24121.987565119558,24107.553075427702,356,798.2,39.69715270736603,47.04546877845479,NaN,NaN,NaN,NaN,8.25526180105088,25.70251560765388,-34167
2025-09-14T19:55:00-04:00,24105.75,24112.5,24101.75,24111,NaN,NaN,NaN,24131.84286767962,NaN,NaN,24119.74,24145.075540250804,24094.4044597492,24108.596147853485,24114.54324078516,24121.727821210723,24107.358660359594,596,792.1333333333333,45.40277392918514,46.30113493310521,NaN,NaN,NaN,NaN,8.433457386690103,26.946318543355375,-33571
2025-09-14T20:00:00-04:00,24110.25,24113.5,24104,24105.75,NaN,NaN,NaN,24131.84286767962,NaN,NaN,24118.785,24142.506722111306,24095.063277888694,24108.596147853485,24114.28951875156,24121.455376563426,24107.123660939695,647,779.1333333333333,40.80708078272614,45.265119040943794,NaN,NaN,NaN,NaN,8.509639001926525,27.83557369899331,-34218
2025-09-14T20:05:00-04:00,24105.75,24110.5,24100,24110.5,NaN,NaN,NaN,24131.84286767962,NaN,NaN,24117.915,24139.50147955298,24096.328520447023,24107.976918282788,24114.03293418732,24121.19858860784,24106.867279766797,632,765.4,46.12091317545801,44.6086626054061,NaN,NaN,NaN,NaN,8.651807644646059,29.09719089983085,-33586
2025-09-14T20:10:00-04:00,24110.5,24115.5,24106.5,24113.75,NaN,NaN,NaN,24131.84286767962,NaN,NaN,24117.13,24136.27216288714,24097.98783711286,24102.43153462623,24113.932239726993,24120.93983770759,24106.9246417464,897,753.8333333333334,49.46375261828585,44.12446842240322,NaN,NaN,NaN,NaN,8.67667852717134,29.02814728376018,-32689
2025-09-14T20:15:00-04:00,24113.25,24113.75,24095,24107.75,NaN,NaN,NaN,24131.84286767962,NaN,NaN,24116.285,24133.142345572043,24099.427654427956,24095.720227700986,24113.26535505512,24120.36474386058,24106.165966249657,1619,764.3333333333334,44.032263927865706,43.71141850026063,NaN,NaN,NaN,NaN,9.396201489516244,30.135474947924035,-34308
2025-09-14T20:20:00-04:00,24108,24109,24101,24101.75,NaN,NaN,NaN,24131.84286767962,NaN,NaN,24115.545,24131.62314977883,24099.466850221168,24092.749401197085,24113.03333015752,24120.193337480854,24105.873322834184,521,756.5,39.37589924516484,42.94669174962729,NaN,NaN,NaN,NaN,9.296472811693656,31.16370777893333,-34829
2025-09-14T20:25:00-04:00,24101.25,24104.25,24091.5,24096.75,NaN,NaN,NaN,24126.831971961063,NaN,NaN,24114.725,24130.36573208554,24099.08426791446,24092.749401197085,24112.37978765477,24120.050077612508,24104.70949769703,922,730.4666666666667,35.96291491717561,41.97872527768658,NaN,NaN,NaN,NaN,9.54315332514411,32.82930516971259,-35751
2025-09-14T20:30:00-04:00,24096.25,24103.5,24095,24101.75,NaN,NaN,NaN,24126.831971961063,NaN,NaN,24114.19,24129.739135022774,24098.640864977224,24092.749401197085,24112.04199396441,24119.868660403517,24104.2153275253,619,658.2,41.43009077024843,41.526203169339794,NaN,NaN,NaN,NaN,9.468642373348102,34.37593131829333,-35132
2025-09-14T20:35:00-04:00,24101,24101.75,24095.75,24099,NaN,NaN,NaN,24126.831971961063,NaN,NaN,24113.68,24129.513205617422,24097.846794382578,24092.749401197085,24111.846220269326,24119.77694312708,24103.915497411574,339,626.9,39.43588288389617,41.445607693184364,NaN,NaN,NaN,NaN,9.220882203823237,35.81208417054688,-35471
2025-09-14T20:40:00-04:00,24099,24099.5,24094.5,24099,NaN,NaN,NaN,24124.70398359611,NaN,NaN,24113.44,24129.783977494415,24097.096022505582,24092.749401197085,24111.60250157557,24119.67787918693,24103.52712396421,400,603.6666666666666,39.43588288389617,41.84217056866065,NaN,NaN,NaN,NaN,8.919390617835862,37.23876649338203,-35471
2025-09-14T20:45:00-04:00,24099.5,24106.25,24097,24104.75,NaN,NaN,NaN,24124.70398359611,NaN,NaN,24113.53,24129.630198761086,24097.42980123891,24092.749401197085,24111.391064636122,24119.485097264907,24103.297032007336,564,580.8333333333334,45.76624739325157,42.16546893211033,NaN,NaN,NaN,NaN,8.94300557370473,36.97489716122242,-34907
2025-09-14T20:50:00-04:00,24104.5,24109.5,24100.75,24107.25,NaN,NaN,NaN,24124.70398359611,NaN,NaN,24113.405,24129.60095320925,24097.209046790747,24092.749401197085,24111.24375127629,24119.27953948384,24103.207963068744,649,580.3,48.29664573105345,42.71297795666087,NaN,NaN,NaN,NaN,8.929219461297249,36.072407178635316,-34258
2025-09-14T20:55:00-04:00,24108,24114.5,24107,24109.5,NaN,NaN,NaN,24124.70398359611,NaN,NaN,24113.21,24129.354460349823,24097.065539650175,24093.25213351803,24111.216728091727,24119.13386588291,24103.299590300543,749,593.2333333333333,50.533598176816355,43.26864993874208,NaN,NaN,NaN,NaN,8.827132356918874,34.32411202205823,-33509
2025-09-14T21:00:00-04:00,24109.5,24113,24105.75,24107,NaN,NaN,NaN,24124.70398359611,NaN,NaN,24112.695,24127.930580068023,24097.459419931976,24093.25213351803,24111.15596528584,24118.991212025157,24103.320718546525,596,600.4333333333333,48.04623300070971,43.86501281683805,NaN,NaN,NaN,NaN,8.714480045710383,32.87025861060178,-34105
2025-09-14T21:05:00-04:00,24107,24113.75,24106.75,24110.25,NaN,NaN,NaN,24124.70398359611,NaN,NaN,24112.71,24127.934440887282,24097.485559112716,24093.751365451542,24111.1464215029,24118.940838074235,24103.352004931567,275,601.7,51.39560153034461,44.29307193120659,NaN,NaN,NaN,NaN,8.592017185302499,31.381410745473065,-33830
2025-09-14T21:10:00-04:00,24110.25,24111.5,24105.75,24107.5,NaN,NaN,NaN,24124.70398359611,NaN,NaN,24112.74,24127.91727247691,24097.562727523095,24093.751365451542,24111.1222158911,24118.88847217865,24103.355959603552,220,597.3333333333334,48.543834847220495,44.84569722152762,NaN,NaN,NaN,NaN,8.389015957780892,30.149117936193097,-34050
2025-09-14T21:15:00-04:00,24107.5,24110.5,24105.25,24107.5,NaN,NaN,NaN,24124.70398359611,NaN,NaN,24112.72,24127.922184054045,24097.517815945957,24093.751365451542,24111.08509592506,24118.816500424,24103.35369142612,293,589.9,48.5438348472205,45.018763055224944,NaN,NaN,NaN,NaN,8.164800532225113,29.082791035157157,-34050
2025-09-14T21:20:00-04:00,24108,24111,24105.25,24110.25,NaN,NaN,NaN,24124.70398359611,NaN,NaN,24112.705,24127.915420761386,24097.494579238617,24093.945699111187,24111.06613830527,24118.76767716417,24103.364599446366,226,586.7666666666667,51.65490512070141,45.17527394825462,NaN,NaN,NaN,NaN,7.992314779923319,27.981519943659773,-33824
2025-09-14T21:25:00-04:00,24110.75,24113.25,24108,24113.25,NaN,NaN,NaN,24124.70398359611,NaN,NaN,24112.675,24127.875082237246,24097.474917762753,24096.98155928895,24111.070870179316,24118.73042837193,24103.4113119867,296,589.2,54.86114621100743,45.9487655399076,NaN,NaN,NaN,NaN,7.796435152785939,26.46034185847652,-33528
2025-09-14T21:30:00-04:00,24113.5,24114.5,24108,24111,NaN,NaN,NaN,24124.70398359611,NaN,NaN,24112.635,24127.84197537286,24097.428024627137,24098.235247431163,24111.07217921694,24118.67923245887,24103.465125975006,376,588.8666666666667,52.07186172818357,46.855620002980366,NaN,NaN,NaN,NaN,7.7038326418726575,24.77776914054651,-33904
2025-09-14T21:35:00-04:00,24111.75,24118,24109.25,24114.75,NaN,NaN,NaN,24124.70398359611,NaN,NaN,24112.66,24127.87668821621,24097.44331178379,24100.613197944927,24111.143498327598,24118.670874186708,24103.616122468487,687,599.2333333333333,56.0798393390256,48.29254317596966,NaN,NaN,NaN,NaN,7.778558881738896,23.51009543473983,-33217
2025-09-14T21:40:00-04:00,24114.5,24114.75,24108.5,24111,NaN,NaN,NaN,24124.70398359611,NaN,NaN,24112.61,24127.83174760252,24097.388252397483,24100.613197944927,24111.147365538774,24118.62133906531,24103.67339201224,405,599.3666666666667,51.446684617909476,49.008014165088305,NaN,NaN,NaN,NaN,7.669376104471832,22.166357682070423,-33622
2025-09-14T21:45:00-04:00,24111.25,24118.75,24111.25,24115.5,NaN,NaN,NaN,24124.70398359611,NaN,NaN,24112.69,24127.92960630146,24097.45039369854,24101.247446684756,24111.221150876707,24118.64583487369,24103.796466879725,535,605.2,56.130489165435385,50.2004860423411,NaN,NaN,NaN,NaN,7.675134954152415,21.67589942768831,-33087
2025-09-14T21:50:00-04:00,24116,24118,24113.75,24116,NaN,NaN,NaN,24124.70398359611,NaN,NaN,24112.75,24128.017612776875,24097.482387223125,24101.872957347805,24111.253314135764,24118.6626542168,24103.843974054726,201,600.1333333333333,56.631100239051236,51.42871585342361,NaN,NaN,NaN,NaN,7.4304824574272414,21.220473905762066,-32886
2025-09-14T21:55:00-04:00,24116,24117.5,24114,24114.75,NaN,NaN,NaN,24124.70398359611,NaN,NaN,24112.775,24128.051534290957,24097.498465709046,24102.848365878242,24111.29015796347,24118.67693878929,24103.903377137653,262,580.8,54.943088657046545,52.08420451512325,NaN,NaN,NaN,NaN,7.149733710468153,20.797578778259123,-33148
2025-09-14T22:00:00-04:00,24114,24116.25,24108.25,24115,NaN,NaN,NaN,24124.70398359611,NaN,NaN,24112.815,24128.104149764116,24097.52585023588,24102.848365878242,24111.3224868603,24118.649430412694,24103.995543307905,519,553.9,55.230508839170746,52.57948045141734,NaN,NaN,NaN,NaN,7.2104670168632845,19.5902858793015,-32629
2025-09-14T22:05:00-04:00,24114.25,24121.75,24114.25,24120,NaN,NaN,NaN,24124.70398359611,NaN,NaN,24112.925,24128.339684563452,24097.510315436546,24105.422954162077,24111.45910162018,24118.785092486527,24104.133110753835,571,543.6666666666666,60.638567758698095,53.30126399298032,NaN,NaN,NaN,NaN,7.231147944230193,18.999098725116212,-32058
2025-09-14T22:10:00-04:00,24119.5,24123,24119.25,24119.75,NaN,NaN,NaN,24124.70398359611,NaN,NaN,24113.215,24128.586730549865,24097.843269450135,24108.06336332966,24111.597665650563,24118.95423422339,24104.241097077735,469,535.1666666666666,60.246693119972285,54.17272543007051,NaN,NaN,NaN,NaN,6.982494519642322,18.669258480753882,-32527
2025-09-14T22:15:00-04:00,24119.5,24125,24115,24122.75,24098.2748866647,24098.2748866647,24098.2748866647,NaN,NaN,NaN,24113.29,24128.809780919113,24097.77021908089,24108.06336332966,24111.778292585706,24119.17564117738,24104.380943994034,616,535.2333333333333,63.31079013101964,55.02381033011873,NaN,NaN,NaN,NaN,7.198030625382157,17.444534793892256,-31911
2025-09-14T22:20:00-04:00,24122.5,24123.25,24114,24119.25,24098.2748866647,NaN,NaN,NaN,NaN,NaN,24113.265,24128.74221229048,24097.78778770952,24108.06336332966,24111.871176835888,24119.26353814987,24104.478815521907,424,537.5,57.72101095035995,55.6793229089144,NaN,NaN,NaN,NaN,7.344599866426289,16.290546301273736,-32335
2025-09-14T22:25:00-04:00,24118.75,24121,24115.5,24119.5,24098.2748866647,NaN,NaN,NaN,NaN,NaN,24113.17,24128.43317138632,24097.906828613675,24108.06336332966,24111.948775209497,24119.334185396376,24104.56336502262,372,530.0333333333333,58.00621689059457,56.355207340583966,NaN,NaN,NaN,NaN,7.212842733110125,15.21898555812797,-31963
2025-09-14T22:30:00-04:00,24119.25,24119.25,24115,24115.5,24098.2748866647,NaN,NaN,NaN,NaN,NaN,24113.1,24128.28749486664,24097.912505133358,24108.06336332966,24111.97508622531,24119.347729982397,24104.602442468222,186,514.6666666666666,51.965932789787246,56.37742360266153,NaN,NaN,NaN,NaN,7.019068252173687,14.335415250219688,-32149
2025-09-14T22:35:00-04:00,24116.25,24116.25,24112.25,24112.25,24098.2748866647,NaN,NaN,NaN,NaN,NaN,24112.885,24127.80787170916,24097.962128290837,24108.06336332966,24111.99611159642,24119.322681596623,24104.66954159622,434,508.06666666666666,47.62643976597592,55.860658856587854,NaN,NaN,NaN,NaN,6.803420519875567,14.109031776916057,-32583
2025-09-14T22:40:00-04:00,24112.5,24118.75,24112.25,24118.5,24098.2748866647,NaN,NaN,NaN,NaN,NaN,24112.845,24127.696562194986,24097.993437805017,24108.06336332966,24112.031379200405,24119.339997147494,24104.722761253317,262,486.9,55.34856783727296,56.09470929295138,NaN,NaN,NaN,NaN,6.78174762559874,13.284769051205632,-32321
2025-09-14T22:45:00-04:00,24118.75,24120.75,24115.25,24116.25,24098.2748866647,NaN,NaN,NaN,NaN,NaN,24112.71,24127.310465752736,24098.10953424726,24108.06336332966,24112.086656214866,24119.37790016631,24104.795412263422,347,444.5,52.35577484439375,55.828704686191955,NaN,NaN,NaN,NaN,6.690194223770258,12.609959052278702,-32668
2025-09-14T22:50:00-04:00,24117.25,24119,24115.25,24118,24098.2748866647,NaN,NaN,NaN,NaN,NaN,24112.59,24126.91332363406,24098.26667636594,24108.06336332966,24112.127336151385,24119.405499447963,24104.849172854807,260,435.8,54.42012622752141,56.041093372592805,NaN,NaN,NaN,NaN,6.480180350643812,11.983349767560837,-32408
2025-09-14T22:55:00-04:00,24118.25,24119.5,24114.75,24118.5,24098.2748866647,NaN,NaN,NaN,NaN,NaN,24112.455,24126.42127722579,24098.488722774215,24108.06336332966,24112.156488753924,24119.426071150614,24104.886906357235,183,411.1666666666667,55.019794986343335,55.96175807408623,NaN,NaN,NaN,NaN,6.35659603988354,11.401498288894249,-32225
2025-09-14T23:00:00-04:00,24118.25,24121,24116.25,24120.25,24098.2748866647,NaN,NaN,NaN,NaN,NaN,24112.365,24126.06872575163,24098.661274248374,24108.050690663727,24112.203453692957,24119.471177260933,24104.93573012498,231,398.23333333333335,57.144961308477434,55.998462436188106,NaN,NaN,NaN,NaN,6.2418391798918575,11.24088991399916,-31994
2025-09-14T23:05:00-04:00,24121,24124,24119.75,24122.25,24101.560480043245,NaN,NaN,NaN,NaN,NaN,24112.315,24125.854870760257,24098.77512923974,24111.405444135773,24112.276492798675,24119.565950863464,24104.987034733887,259,395.56666666666666,59.500026142687595,56.32395797087675,NaN,NaN,NaN,NaN,6.099564952756724,11.782131976089124,-31735
2025-09-14T23:10:00-04:00,24122.5,24123.5,24119.5,24123.5,24101.56341276855,NaN,NaN,NaN,NaN,NaN,24112.27,24125.644916807254,24098.895083192747,24111.42435530862,24112.347159107143,24119.658140137446,24105.03617807684,250,390.56666666666666,60.94462250428907,56.73210894695662,NaN,NaN,NaN,NaN,5.949596027559815,12.204447029085339,-31485
2025-09-14T23:15:00-04:00,24123,24132.5,24120.25,24126.25,24105.674166733617,NaN,NaN,NaN,NaN,NaN,24112.395,24126.167468900676,24098.622531099325,24116.714484246895,24112.766693927708,24120.352127383772,24105.181260471643,1082,407.8333333333333,63.98793896840758,56.971349747650166,NaN,NaN,NaN,NaN,6.3996248827341145,14.173870542857667,-30403
2025-09-14T23:20:00-04:00,24126,24130.75,24124.5,24128.75,24107.012840973,NaN,NaN,NaN,NaN,NaN,24112.565,24126.918678988,24098.211321011997,24116.714484246895,24112.894419855576,24120.574636800233,24105.21420291092,305,396.3666666666667,66.54050865991421,57.42090800050316,NaN,NaN,NaN,NaN,6.3889373911102485,16.002620948503402,-30098
2025-09-14T23:25:00-04:00,24128.75,24129,24120.5,24121.75,24107.012840973,NaN,NaN,NaN,NaN,NaN,24112.605,24127.04940722685,24098.16059277315,24116.714484246895,24113.04102936124,24120.771432989324,24105.310625733156,498,388,54.82300312494203,56.81463750006905,NaN,NaN,NaN,NaN,6.539727577459517,16.48778806634594,-30596
2025-09-14T23:30:00-04:00,24121.5,24123,24116.75,24119.75,24107.012840973,NaN,NaN,NaN,NaN,NaN,24112.635,24127.132313546554,24098.137686453443,24116.714484246895,24113.13010518145,24120.8484301785,24105.411780184404,490,384.46666666666664,52.00518883282803,56.40636449167391,NaN,NaN,NaN,NaN,6.5190327504981225,15.980001277496154,-31086
2025-09-14T23:35:00-04:00,24120,24125,24118.5,24122.25,24107.012840973,NaN,NaN,NaN,NaN,NaN,24112.855,24127.593415792027,24098.11658420797,24116.714484246895,24113.214185995133,24120.942975540813,24105.485396449454,361,387.3333333333333,55.11106103794641,56.199567645056185,NaN,NaN,NaN,NaN,6.517673268319685,15.890694668989495,-30725
2025-09-14T23:40:00-04:00,24122.5,24127.75,24122,24125.75,24107.012840973,NaN,NaN,NaN,NaN,NaN,24113.315,24128.19814818957,24098.431851810426,24116.714484246895,24113.36528126744,24121.160292599492,24105.57026993539,483,396.1,59.1014055850425,56.7092442732887,NaN,NaN,NaN,NaN,6.462839463439708,16.297493409156107,-30242
2025-09-14T23:45:00-04:00,24126.5,24128.75,24124.75,24124.75,24107.012840973,NaN,NaN,NaN,NaN,NaN,24113.635,24128.79719312415,24098.472806875845,24116.714484246895,24113.46141241763,24121.304644027216,24105.618180808044,291,396.03333333333336,57.527907308944826,57.416491954929334,NaN,NaN,NaN,NaN,6.2869223589083,16.8462122454334,-30533
2025-09-14T23:50:00-04:00,24125.25,24127.25,24125,24126,24107.012840973,NaN,NaN,NaN,NaN,NaN,24113.995,24129.456723720148,24098.53327627985,24116.714484246895,24113.507145198713,24121.372800617115,24105.64148978031,140,393.1666666666667,58.997423272185834,57.67712448599453,NaN,NaN,NaN,NaN,6.016427904700564,17.35573687911945,-30393
2025-09-14T23:55:00-04:00,24126,24126,24121.25,24122,24107.012840973,NaN,NaN,NaN,NaN,NaN,24114.24,24129.81271972668,24098.667280273323,24116.714484246895,24113.55694798451,24121.432303000696,24105.681592968325,202,390.03333333333336,52.712255055910866,57.70258735824576,NaN,NaN,NaN,NaN,5.925968768650525,16.790965773990575,-30595
2025-09-15T00:00:00-04:00,24121.25,24124,24120.5,24123,24107.012840973,NaN,NaN,NaN,NaN,NaN,24114.575,24130.166423916147,24098.983576083854,24116.714484246895,24113.62707971458,24121.511058231015,24105.743101198146,307,387.73333333333335,54.03074263047836,57.67477424417125,NaN,NaN,NaN,NaN,5.752685285175487,16.074046804279167,-30288
2025-09-15T00:05:00-04:00,24123.25,24128.25,24122,24125.5,24107.012840973,NaN,NaN,NaN,NaN,NaN,24114.865,24130.716880005977,24099.013119994026,24115.46897307225,24113.71897913498,24121.638912923492,24105.79904534647,312,375.23333333333335,57.24058623079283,57.83340219020336,NaN,NaN,NaN,NaN,5.78820776480581,16.27837967047545,-29976
2025-09-15T00:10:00-04:00,24125,24125,24120,24123.5,24107.012840973,NaN,NaN,NaN,NaN,NaN,24115.22,24131.034436435868,24099.405563564134,24115.46897307225,24113.772480874035,24121.69977054004,24105.84519120803,233,369.5,53.99252158014633,57.60822792389399,NaN,NaN,NaN,NaN,5.767621495891109,15.94063685688707,-30209
2025-09-15T00:15:00-04:00,24123.5,24126.25,24121,24125,24107.012840973,NaN,NaN,NaN,NaN,NaN,24115.51,24131.498420811575,24099.521579188422,24115.46897307225,24113.807688284072,24121.74425684255,24105.871119725594,136,356.2,56.008719411703915,57.35884887168088,NaN,NaN,NaN,NaN,5.730648531898886,15.880461065258764,-30073
2025-09-15T00:20:00-04:00,24125.25,24129.75,24125.25,24128.5,24109.03476741035,NaN,NaN,NaN,NaN,NaN,24115.805,24132.191973480683,24099.418026519317,24116.971114212993,24113.928135527116,24121.935821527033,24105.9204495272,345,361,60.37249954279822,57.3179829458601,NaN,NaN,NaN,NaN,5.660602208191823,16.478993734764604,-29728
2025-09-15T00:25:00-04:00,24128,24130,24125,24128,24109.192277982605,NaN,NaN,NaN,NaN,NaN,24116.21,24132.78056426451,24099.639435735487,24117.27689137039,24114.00837045285,24122.060973755895,24105.955767149808,236,360.1333333333333,59.46500430627041,56.99491618427887,NaN,NaN,NaN,NaN,5.613416336178121,17.03477407073432,-29964
2025-09-15T00:30:00-04:00,24127.75,24132.25,24127.75,24129.75,24111.91081080158,NaN,NaN,NaN,NaN,NaN,24116.77,24133.24022767649,24100.29977232351,24119.821513096314,24114.112402481394,24122.240410884286,24105.984394078503,266,351.7,61.63847499872606,56.64477092276543,NaN,NaN,NaN,NaN,5.533886597879684,17.953699498629554,-29698
2025-09-15T00:35:00-04:00,24129.5,24136,24129,24130,24114.278501219687,NaN,NaN,NaN,NaN,NaN,24117.435,24133.291799798862,24101.57820020114,24122.55721047705,24114.321772698193,24122.62286126529,24106.020684131097,491,349.03333333333336,61.95233667548208,57.1540090335183,NaN,NaN,NaN,NaN,5.638608983745421,19.397303370785025,-29207
2025-09-15T00:40:00-04:00,24129.75,24132.25,24128,24131.75,24114.278501219687,NaN,NaN,NaN,NaN,NaN,24118.035,24133.742007995603,24102.327992004397,24122.55721047705,24114.44002258824,24122.826222153773,24106.053823022703,300,343.4,64.16268450027786,58.02240158119328,NaN,NaN,NaN,NaN,5.539422627763606,20.414606158398456,-28907
2025-09-15T00:45:00-04:00,24131.75,24132.25,24129.25,24131.25,24114.278501219687,NaN,NaN,NaN,NaN,NaN,24118.68,24133.846753122412,24103.51324687759,24122.55721047705,24114.498225757354,24122.92648274824,24106.069968766467,147,327.76666666666665,63.0359092701914,58.588462169210786,NaN,NaN,NaN,NaN,5.358035297209063,21.359244461182353,-29054
2025-09-15T00:50:00-04:00,24130.25,24131.25,24127.5,24130,24114.278501219687,NaN,NaN,NaN,NaN,NaN,24119.3,24133.71388218878,24104.88611781122,24122.55721047705,24114.580784121594,24123.059306158026,24106.10226208516,229,321.26666666666665,60.19010793128645,58.66622662251392,NaN,NaN,NaN,NaN,5.243175633122702,21.64149536625047,-29283
2025-09-15T00:55:00-04:00,24130,24131.25,24128.5,24131,24114.278501219687,NaN,NaN,NaN,NaN,NaN,24119.825,24133.990892140402,24105.6591078596,24122.55721047705,24114.62186851953,24123.127097863653,24106.11663917541,110,312.53333333333336,61.68053478691296,58.96284287094022,NaN,NaN,NaN,NaN,5.065091659328223,21.903585492385155,-29173
2025-09-15T01:00:00-04:00,24131,24133.25,24128.5,24129.5,24114.278501219687,NaN,NaN,NaN,NaN,NaN,24120.27,24134.224153503583,24106.315846496418,24122.55721047705,24114.71171165833,24123.275497866507,24106.14792545015,240,314.3333333333333,58.16296939205183,58.90323902235922,NaN,NaN,NaN,NaN,5.04258511223335,22.55402374010949,-29413
2025-09-15T01:05:00-04:00,24129.25,24131.25,24129,24129.5,24114.278501219687,NaN,NaN,NaN,NaN,NaN,24120.67,24134.51248533995,24106.827514660046,24122.55721047705,24114.765575183617,24123.361779237188,24106.169371130047,150,304.8666666666667,58.16296939205182,59.292575760655,NaN,NaN,NaN,NaN,4.843114747073825,23.158002112996375,-29413
2025-09-15T01:10:00-04:00,24129.75,24131.75,24128,24129.5,24114.278501219687,NaN,NaN,NaN,NaN,NaN,24121.12,24134.61416170327,24107.625838296728,24122.55721047705,24114.817767291894,24123.444277993938,24106.19125658985,148,301.06666666666666,58.16296939205182,59.58773481505311,NaN,NaN,NaN,NaN,4.765035122282837,23.322333190803292,-29413
2025-09-15T01:15:00-04:00,24129.5,24130,24122.75,24124.25,24114.278501219687,NaN,NaN,NaN,NaN,NaN,24121.4,24134.557127333,24108.242872667004,24122.55721047705,24114.936705693402,24123.589858176536,24106.28355321027,471,305.2,46.556578350947966,58.82459139506419,NaN,NaN,NaN,NaN,4.94253261354835,21.74302773718456,-29884
2025-09-15T01:20:00-04:00,24124.5,24127.5,24123.75,24127,24114.278501219687,NaN,NaN,NaN,NaN,NaN,24121.79,24134.421452799834,24109.158547200168,24122.55721047705,24115.008882182443,24123.68018658806,24106.337577776827,280,305.8666666666667,51.963835521588976,58.67968524802438,NaN,NaN,NaN,NaN,4.85735171258061,20.276529815967166,-29604
2025-09-15T01:25:00-04:00,24126.75,24130.75,24126.5,24128.5,24114.278501219687,NaN,NaN,NaN,NaN,NaN,24122.21,24134.297745871503,24110.122254128495,24122.53166672912,24115.085979596373,24123.792590504167,24106.37936868858,247,308,54.65860076123389,58.583248201562235,NaN,NaN,NaN,NaN,4.813969447396281,19.774566242562937,-29357
2025-09-15T01:30:00-04:00,24128.75,24132,24126.5,24130.75,24114.278501219687,NaN,NaN,NaN,NaN,NaN,24122.62,24134.445075046067,24110.79492495393,24122.53166672912,24115.167794724046,24123.918519173185,24106.417070274907,244,308.43333333333334,58.42606937444395,58.444217475251214,NaN,NaN,NaN,NaN,4.862971629725117,19.606163517177393,-29113
2025-09-15T01:35:00-04:00,24131.25,24138,24130.5,24135,24117.986898516396,NaN,NaN,NaN,NaN,NaN,24123.055,24135.068030428098,24111.041969571903,24125.088090594432,24115.381134905736,24124.314720789484,24106.44754902199,488,316.06666666666666,64.43702952761345,58.7993621339186,NaN,NaN,NaN,NaN,5.051330799030467,20.623318027849848,-28625
2025-09-15T01:40:00-04:00,24135,24144.75,24134.5,24139.5,24122.703403129286,NaN,NaN,NaN,NaN,NaN,24123.625,24135.995226353552,24111.254773646448,24129.295472475544,24115.947693292994,24125.50445261336,24106.390933972627,1060,343.06666666666666,69.47033280450238,59.358780548616906,NaN,NaN,NaN,NaN,5.422664313385433,22.485542710286126,-27565
2025-09-15T01:45:00-04:00,24139.75,24140,24135.25,24136.25,24122.703403129286,NaN,NaN,NaN,NaN,NaN,24124.055,24136.653924544018,24111.456075455982,24129.295472475544,24116.11967244237,24125.825910258176,24106.413434626567,370,319.3333333333333,62.58134389350089,59.403709635618256,NaN,NaN,NaN,NaN,5.37461686242933,24.214751343976953,-27935
2025-09-15T01:50:00-04:00,24135.25,24140.75,24134.5,24138.25,24122.703403129286,NaN,NaN,NaN,NaN,NaN,24124.6,24137.250296447506,24111.94970355249,24129.295472475544,24116.227580519775,24126.029330220197,24106.425830819353,228,316.76666666666665,64.88879824790726,59.45557490330608,NaN,NaN,NaN,NaN,5.437144229398664,25.820445075261294,-27707
2025-09-15T01:55:00-04:00,24139,24140.75,24137.25,24140,24122.703403129286,NaN,NaN,NaN,NaN,NaN,24125.09,24138.18265441681,24111.99734558319,24129.295472475544,24116.338846590457,24126.246931993788,24106.430761187126,222,307.56666666666666,66.81700353814819,59.725653065303,NaN,NaN,NaN,NaN,5.298776784441616,27.311446397168183,-27485
2025-09-15T02:00:00-04:00,24140,24144.5,24137,24141.25,24123.8833548297,NaN,NaN,NaN,NaN,NaN,24125.595,24139.18466150296,24112.00533849704,24129.80382552598,24116.57643588036,24126.725531477994,24106.427340282728,450,306.23333333333335,68.16196689838117,60.29507156295262,NaN,NaN,NaN,NaN,5.456007014124358,29.17849784152282,-27035
2025-09-15T02:05:00-04:00,24141.5,24145,24136,24144,24123.8833548297,NaN,NaN,NaN,NaN,NaN,24126.18,24140.357460988005,24112.002539011995,24129.80382552598,24116.793371240357,24127.162047314065,24106.42469516665,406,307.73333333333335,70.95146723396128,60.95728102345607,NaN,NaN,NaN,NaN,5.7091493702583325,30.527273039712295,-26629
2025-09-15T02:10:00-04:00,24143.5,24146,24138.5,24141.25,24124.68762289235,NaN,NaN,NaN,NaN,NaN,24126.705,24141.12952424784,24112.280475752163,24129.80382552598,24117.044439993537,24127.65950902767,24106.429370959402,474,307.43333333333334,64.83405101962889,61.43378685399729,NaN,NaN,NaN,NaN,5.837067272382738,31.91489935688074,-27103
2025-09-15T02:15:00-04:00,24141.25,24143.25,24139,24143,24124.68762289235,NaN,NaN,NaN,NaN,NaN,24127.165,24142.160535996903,24112.1694640031,24129.80382552598,24117.16263105255,24127.888610718765,24106.436651386335,228,305.3333333333333,66.79599736769123,62.05043170940011,NaN,NaN,NaN,NaN,5.723705324355399,33.203409508537156,-26875
2025-09-15T02:20:00-04:00,24142.25,24142.25,24134.75,24135.5,24124.68762289235,NaN,NaN,NaN,NaN,NaN,24127.48,24142.50093207247,24112.459067927528,24129.80382552598,24117.349092169097,24128.20032283205,24106.497861506145,441,315.3666666666667,53.118203316918155,61.69009127546199,NaN,NaN,NaN,NaN,5.9041549440443,32.768948931090044,-27316
2025-09-15T02:25:00-04:00,24135.25,24137.75,24132,24134.25,24124.68762289235,NaN,NaN,NaN,NaN,NaN,24127.71,24142.786259485772,24112.633740514226,24129.80382552598,24117.517023189423,24128.448049356226,24106.58599702262,471,324.3333333333333,51.23513139157484,62.02427363550676,NaN,NaN,NaN,NaN,5.893143876612564,31.494502204200653,-27787
2025-09-15T02:30:00-04:00,24134,24146,24131.5,24140.5,24124.68762289235,NaN,NaN,NaN,NaN,NaN,24128.135,24143.429839008502,24112.840160991494,24129.80382552598,24117.85835207966,24129.0363624479,24106.68034171142,772,339.8333333333333,59.05166904105413,62.53054745832571,NaN,NaN,NaN,NaN,6.507919313997381,31.748780433436103,-27015
2025-09-15T02:35:00-04:00,24139.5,24145,24138.25,24143.5,24124.68762289235,NaN,NaN,NaN,NaN,NaN,24128.615,24144.297222413268,24112.932777586735,24129.80382552598,24118.031123184763,24129.355751467152,24106.706494902373,352,341.1666666666667,62.18494084495193,63.068143178591285,NaN,NaN,NaN,NaN,6.5252107915689965,31.984895932011874,-26663
2025-09-15T02:40:00-04:00,24143,24148.25,24142.5,24146.75,24126.550432417793,NaN,NaN,NaN,NaN,NaN,24129.24,24145.268711724064,24113.21128827594,24129.80382552598,24118.283366566968,24129.86062632938,24106.706106804555,455,348.56666666666666,65.2840554808871,63.55799932905149,NaN,NaN,NaN,NaN,6.469838592171212,32.65667354038205,-26208
2025-09-15T02:45:00-04:00,24146.5,24147.5,24142,24145.75,24126.550432417793,NaN,NaN,NaN,NaN,NaN,24129.91,24145.84228170198,24113.97771829802,24129.977770131805,24118.441675917118,24130.165959466816,24106.71739236742,298,353.96666666666664,63.55804004384852,63.49521436592543,NaN,NaN,NaN,NaN,6.400564407016126,33.119838890694,-26506
2025-09-15T02:50:00-04:00,24145.25,24147,24141.25,24144,24126.550432417793,NaN,NaN,NaN,NaN,NaN,24130.42,24146.490606724146,24114.34939327585,24130.107216105444,24118.58873680338,24130.438619681536,24106.738853925224,291,352.1666666666667,60.54147112262323,62.85743853150548,NaN,NaN,NaN,NaN,6.354095520800689,33.30096796458955,-26797
2025-09-15T02:55:00-04:00,24143.75,24150,24142,24147,24127.104778326557,NaN,NaN,NaN,NaN,NaN,24131.035,24147.242408798575,24114.827591201425,24132.485772884356,24118.969486830596,24131.172415755536,24106.766557905656,706,367.8333333333333,63.72034834099685,62.938795992040916,NaN,NaN,NaN,NaN,6.471660126457783,33.91678552855794,-26091
2025-09-15T03:00:00-04:00,24146.75,24153,24144,24146,24129.236379311715,NaN,NaN,NaN,NaN,NaN,24131.595,24147.89680663178,24115.293193368223,24134.488618307485,24119.564898004508,24132.314562909803,24106.815233099212,1090,395.3,61.92935949385971,62.727407509608945,NaN,NaN,NaN,NaN,6.652255831710798,34.88242080152932,-27181
2025-09-15T03:05:00-04:00,24146.75,24147.25,24143,24146.75,24129.236379311715,NaN,NaN,NaN,NaN,NaN,24132.16,24148.565108966202,24115.754891033797,24134.488618307485,24119.735681687816,24132.616634878,24106.854728497634,346,390.46666666666664,62.774447311782076,62.438653493439936,NaN,NaN,NaN,NaN,6.4806661294457415,35.43203745669379,-26835
2025-09-15T03:10:00-04:00,24146.75,24148.75,24144,24145.75,24129.236379311715,NaN,NaN,NaN,NaN,NaN,24132.67,24149.14769402805,24116.192305971945,24134.488618307485,24119.922287211077,24132.94706727801,24106.897507144142,376,393,60.835386846356066,61.91532634686671,NaN,NaN,NaN,NaN,6.357047120199617,36.149705393472466,-27211
2025-09-15T03:15:00-04:00,24145.75,24148,24138.5,24146.5,24129.236379311715,NaN,NaN,NaN,NaN,NaN,24133.155,24149.80399096023,24116.506009039767,24134.488618307485,24120.20767995992,24133.419297636094,24106.996062283746,630,409.1,61.78872276328875,61.26084459896153,NaN,NaN,NaN,NaN,6.581543754471072,35.087242067547955,-26581
2025-09-15T03:20:00-04:00,24147,24154.25,24145.5,24149.5,24130.358217227826,NaN,NaN,NaN,NaN,NaN,24133.675,24150.70504697698,24116.64495302302,24135.884738058747,24120.627597687697,24134.203120766575,24107.05207460882,777,427.3666666666667,65.4151780952554,61.302353675792,NaN,NaN,NaN,NaN,6.736433486294567,35.051908288724725,-25804
2025-09-15T03:25:00-04:00,24149.75,24151.25,24143.25,24143.75,24130.358217227826,NaN,NaN,NaN,NaN,NaN,24134.025,24151.149324799197,24116.900675200806,24135.884738058747,24120.86746762347,24134.600884571584,24107.134050675355,520,441.03333333333336,54.69979401885221,60.438339150874924,NaN,NaN,NaN,NaN,6.826688237273527,34.42740161819136,-26324
2025-09-15T03:30:00-04:00,24144.25,24153.25,24140.5,24152.5,24130.358217227826,NaN,NaN,NaN,NaN,NaN,24134.5,24152.316284687786,24116.683715312214,24135.884738058747,24121.207358513086,24135.195535618586,24107.219181407585,681,455.73333333333335,64.28679779760392,61.23609589949533,NaN,NaN,NaN,NaN,7.249781934611133,33.171393562384,-25643
2025-09-15T03:35:00-04:00,24152.5,24159.25,24147.25,24151.25,24131.985497252714,NaN,NaN,NaN,NaN,NaN,24135.09,24153.130720602814,24117.049279397186,24136.186985886077,24122.07724482811,24136.80073219915,24107.35375745707,1593,503.8333333333333,62.25969237390948,62.023564541090664,NaN,NaN,NaN,NaN,7.5890832249960525,32.89439586843671,-27236
2025-09-15T03:40:00-04:00,24150.75,24155,24143,24143.75,24131.985497252714,NaN,NaN,NaN,NaN,NaN,24135.57,24153.22560533815,24117.91439466185,24136.186985886077,24122.326660405863,24137.18766470571,24107.465656106015,575,518.0666666666667,51.72159141443917,61.49998756776102,NaN,NaN,NaN,NaN,7.904148708924906,31.690552007926748,-27811
2025-09-15T03:45:00-04:00,24144.25,24148.75,24143.75,24147,24131.985497252714,NaN,NaN,NaN,NaN,NaN,24136.065,24153.586361256497,24118.5436387435,24136.186985886077,24122.461283514403,24137.389635355485,24107.532931673322,325,513.2,55.255850799590256,61.0050525645209,NaN,NaN,NaN,NaN,7.696709515430269,30.572696994596072,-27486
2025-09-15T03:50:00-04:00,24147.5,24147.5,24139.75,24144.75,24131.985497252714,NaN,NaN,NaN,NaN,NaN,24136.445,24153.87895824765,24119.01104175235,24136.186985886077,24122.679754110413,24137.688187577063,24107.671320643763,598,523.8,52.39609945811477,60.08448427718002,NaN,NaN,NaN,NaN,7.700515978613821,28.70063328613905,-28084
2025-09-15T03:55:00-04:00,24144.75,24146.25,24137.5,24138.5,24131.985497252714,NaN,NaN,NaN,NaN,NaN,24136.72,24153.838305972393,24119.60169402761,24136.186985886077,24122.81361679799,24137.84642870848,24107.7808048875,440,530.2333333333333,45.37158745088456,58.78545194911116,NaN,NaN,NaN,NaN,7.775479122998548,26.767184228249473,-28524
2025-09-15T04:00:00-04:00,24139,24141.5,24075.5,24085.25,NaN,NaN,NaN,24138.404889199443,24138.404889199443,24138.404889199443,24135.905,24158.11128064983,24113.698719350166,24136.186985886077,24120.407850196258,24136.1760680925,24104.639632300015,7269,764.4,20.345063589460054,55.91427998245665,NaN,NaN,NaN,NaN,11.934373471355794,29.400561437652357,-35793
2025-09-15T04:05:00-04:00,24085,24123.25,24082,24121.25,NaN,NaN,NaN,24136.795576054014,NaN,NaN,24135.89,24158.13481062433,24113.645189375668,24136.186985886077,24119.962130718013,24135.58334527106,24104.340916164965,2670,837.1333333333333,43.16820802453911,54.44626995985253,NaN,NaN,NaN,NaN,14.02834679483038,31.84584027495503,-33123
2025-09-15T04:10:00-04:00,24120.25,24121.75,24104.5,24113,NaN,NaN,NaN,24136.795576054014,NaN,NaN,24135.69,24158.565655190927,24112.81434480907,24136.186985886077,24119.85162794878,24135.370977862778,24104.332278034784,1132,839.5333333333333,40.31725617330344,52.90254829409851,NaN,NaN,NaN,NaN,14.258464880913923,34.11645633816466,-34255
2025-09-15T04:15:00-04:00,24112.25,24122.5,24097.25,24119.5,NaN,NaN,NaN,24136.795576054014,NaN,NaN,24135.57,24158.719522676758,24112.42047732324,24136.186985886077,24119.731434372723,24135.138321928534,24104.32454681691,1274,869.6666666666666,43.48419635904503,51.52467322604586,NaN,NaN,NaN,NaN,15.043574532277216,36.44384888032906,-32981
2025-09-15T04:20:00-04:00,24120,24120.25,24101,24112.75,NaN,NaN,NaN,24136.795576054014,NaN,NaN,24135.355,24159.139888060672,24111.570111939327,24136.186985886077,24119.61427465318,24134.944990865726,24104.283558440635,1015,895.9,41.048286504450466,50.11130891590975,NaN,NaN,NaN,NaN,15.344033494257415,38.60499909805314,-33996
2025-09-15T04:25:00-04:00,24113.5,24113.5,24094.75,24098.25,NaN,NaN,NaN,24136.795576054014,NaN,NaN,24134.82,24160.62969585123,24109.01030414877,24130.549588708862,24119.43296381937,24134.786108415083,24104.079819223658,764,913.9666666666667,36.33903325290452,48.2934739508823,NaN,NaN,NaN,NaN,15.587316816096171,40.796664242366454,-34760
2025-09-15T04:30:00-04:00,24098,24104.25,24080.25,24080.75,NaN,NaN,NaN,24132.38183422541,NaN,NaN,24133.865,24163.75115230073,24103.978847699273,24126.68967096709,24118.87044703829,24134.636701231506,24103.104192845076,1358,944.2333333333333,31.623586303738364,45.8797888229168,NaN,NaN,NaN,NaN,16.18822275780359,43.18852075294881,-36118
2025-09-15T04:35:00-04:00,24081.25,24096.5,24080,24095.5,NaN,NaN,NaN,24128.80765994244,NaN,NaN,24133.215,24164.9402281301,24101.4897718699,24125.97673677367,24118.39933464653,24134.445761456056,24102.352907837,1272,973.1,38.82862609588486,44.74613397127627,NaN,NaN,NaN,NaN,16.21049256081762,45.41506030699078,-34846
2025-09-15T04:40:00-04:00,24094.5,24101.25,24089.25,24101,NaN,NaN,NaN,24128.80765994244,NaN,NaN,24132.64,24165.613195178576,24099.666804821423,24124.65638941894,24118.19963879819,24134.301387338106,24102.097890258272,723,981.4,41.31195948149399,43.10507409155414,NaN,NaN,NaN,NaN,15.90974309218779,46.75992520246517,-34123
2025-09-15T04:45:00-04:00,24100.5,24116.5,24100,24116,NaN,NaN,NaN,24128.80765994244,NaN,NaN,24132.36,24165.654317833792,24099.06568216621,24091.22511153515,24118.10457810079,24134.1236834385,24102.085472763076,1005,1007.3,47.564100533679685,42.05538896010915,NaN,NaN,NaN,NaN,15.951904299888664,46.04845155283704,-33118
2025-09-15T04:50:00-04:00,24116.25,24117,24100.75,24101.75,NaN,NaN,NaN,24128.80765994244,NaN,NaN,24131.76,24166.14022106401,24097.379778935985,24071.439509035834,24117.967052394728,24133.940394178415,24101.99371061104,934,1023.7333333333333,42.88955895678951,41.424529498848464,NaN,NaN,NaN,NaN,15.973196849896615,45.330485653053024,-34052
2025-09-15T04:55:00-04:00,24102,24102,24091,24095.25,NaN,NaN,NaN,24128.80765994244,NaN,NaN,24131.04,24166.908420645545,24095.171579354457,24071.439509035834,24117.747420791933,24133.789397831173,24101.705443752693,799,1034.6666666666667,40.91432603373619,40.40013487271603,NaN,NaN,NaN,NaN,15.617968503475428,45.1651455047651,-34851
2025-09-15T05:00:00-04:00,24095.5,24096.5,24086,24089.75,NaN,NaN,NaN,24128.80765994244,NaN,NaN,24130.235,24167.921258766903,24092.5487412331,24071.439509035834,24117.48813700243,24133.668564871998,24101.307709132863,772,1034.6666666666667,39.26645781648202,39.46230332688513,NaN,NaN,NaN,NaN,15.252399324655755,45.24405066006482,-35623
2025-09-15T05:05:00-04:00,24090,24095.75,24087,24092.25,NaN,NaN,NaN,24128.80765994244,NaN,NaN,24129.46,24168.616526916205,24090.303473083794,24071.439509035834,24117.314245378606,24133.57779486765,24101.05069588956,545,1041.1,40.44070261272104,39.11009726701629,NaN,NaN,NaN,NaN,14.787942230037487,45.31731973284314,-35078
2025-09-15T05:10:00-04:00,24092,24096.5,24088,24090.75,NaN,NaN,NaN,24128.80765994244,NaN,NaN,24128.685,24169.31390719478,24088.056092805222,24071.439509035834,24117.13918648602,24133.483493765132,24100.794879206907,558,1044.5333333333333,39.941711697036126,40.509857846128874,NaN,NaN,NaN,NaN,14.338803499320523,45.282584610247454,-35636
2025-09-15T05:15:00-04:00,24090.75,24092.25,24082.75,24087,NaN,NaN,NaN,24126.073389036137,NaN,NaN,24127.835,24170.105274427293,24085.564725572705,24071.439509035834,24116.91880042553,24133.401560644746,24100.436040206314,607,1054.8333333333333,38.657512071203115,40.18766527803344,NaN,NaN,NaN,NaN,13.993174677940486,45.52236649105318,-36243
2025-09-15T05:20:00-04:00,24087.5,24091.75,24080.25,24090.5,NaN,NaN,NaN,24124.38823498904,NaN,NaN,24127.055,24170.593866547468,24083.516133452533,24071.439509035834,24116.65492760796,24133.29637354996,24100.01348166596,743,1069.9,40.577841553219706,40.206278519456035,NaN,NaN,NaN,NaN,13.815090772373308,45.870455547483424,-35500
2025-09-15T05:25:00-04:00,24090.25,24094.75,24088.25,24093,NaN,NaN,NaN,24124.38823498904,NaN,NaN,24126.43,24170.997032657073,24081.862967342928,24071.439509035834,24116.50759093927,24133.20769941894,24099.807482459597,498,1062.9666666666667,41.97512723221909,40.0984878675399,NaN,NaN,NaN,NaN,13.292584288632357,45.739100170854215,-35002
2025-09-15T05:30:00-04:00,24093,24099.75,24090.75,24093,NaN,NaN,NaN,24124.38823498904,NaN,NaN,24125.75,24171.288445296253,24080.211554703747,24073.190128420283,24116.34922899441,24133.09279045532,24099.605667533502,604,1046.7666666666667,41.97512723221909,40.164690776666234,NaN,NaN,NaN,NaN,12.985971125158617,44.89089742525347,-35002
2025-09-15T05:35:00-04:00,24094,24100.5,24089.25,24098.5,NaN,NaN,NaN,24124.38823498904,NaN,NaN,24125.15,24171.31394696792,24078.986053032084,24073.627102736224,24116.218493661443,24132.98663932914,24099.450347993745,545,1053.4,45.259394053411086,40.80185940527384,NaN,NaN,NaN,NaN,12.861973187647289,44.208613853861635,-34457
2025-09-15T05:40:00-04:00,24098.25,24098.75,24087.5,24093.75,NaN,NaN,NaN,24124.38823498904,NaN,NaN,24124.41,24171.37048977641,24077.44951022359,24073.627102736224,24116.07234257756,24132.88598003501,24099.25870512011,543,1058.9666666666667,42.99596176157015,41.61417193797611,NaN,NaN,NaN,NaN,12.746832245672483,43.70092962894596,-35000
2025-09-15T05:45:00-04:00,24093.25,24098.75,24091.25,24095.25,NaN,NaN,NaN,24124.38823498904,NaN,NaN,24123.615,24171.17351238142,24076.05648761858,24073.627102736224,24115.967218230468,24132.804020254975,24099.13041620596,428,1052.2333333333333,43.94924632774241,41.97993052596593,NaN,NaN,NaN,NaN,12.372058513838734,43.22950856295282,-34572
2025-09-15T05:50:00-04:00,24095.5,24099.5,24092.75,24097.75,NaN,NaN,NaN,24124.38823498904,NaN,NaN,24122.78,24170.65855888067,24074.901441119328,24075.766076600947,24115.906203946728,24132.751251831545,24099.06115606191,271,1035.3666666666666,45.58262894298009,42.28497834464351,NaN,NaN,NaN,NaN,11.970482905707396,42.66088695244039,-34301
2025-09-15T05:55:00-04:00,24098,24099.5,24095,24095.5,NaN,NaN,NaN,24124.38823498904,NaN,NaN,24121.965,24170.28394141976,24073.64605858024,24078.262861280757,24115.850705066317,24132.703058072602,24098.998352060033,248,1026.3,44.330535776530986,42.054009433418614,NaN,NaN,NaN,NaN,11.436876983871153,42.13288117125028,-34549
2025-09-15T06:00:00-04:00,24095.75,24098.25,24091.25,24096,NaN,NaN,NaN,24124.38823498904,NaN,NaN,24121.12,24169.746971942757,24072.49302805724,24078.262861280757,24115.7656476848,24132.635325169656,24098.89597019994,355,1015.4333333333333,44.694099808608506,42.18290520854854,NaN,NaN,NaN,NaN,11.119957199308928,41.975133465841665,-34194
2025-09-15T06:05:00-04:00,24095.5,24104,24095.5,24102,NaN,NaN,NaN,24124.38823498904,NaN,NaN,24120.36,24168.970714866053,24071.74928513395,24083.358231219685,24115.658187638983,24132.516764715536,24098.79961056243,612,982.7333333333333,48.99850097227054,42.760346275586706,NaN,NaN,NaN,NaN,10.93281739935829,40.767664052062415,-33582
2025-09-15T06:10:00-04:00,24101.75,24102.5,24096,24102.25,NaN,NaN,NaN,24124.38823498904,NaN,NaN,24119.58,24168.076333878376,24071.083666121627,24083.358231219685,24115.596230806535,24132.44911187748,24098.743349735592,351,975.2666666666667,49.175994941628545,43.46817035595432,NaN,NaN,NaN,NaN,10.616187585118412,39.64644245355311,-33231
2025-09-15T06:15:00-04:00,24102,24108.75,24100.75,24108,NaN,NaN,NaN,24124.38823498904,NaN,NaN,24118.86,24166.952011810085,24070.767988189917,24088.939267980597,24115.54671305583,24132.371100951863,24098.7223251598,445,979.2666666666667,53.2093996219967,44.380220142331154,NaN,NaN,NaN,NaN,10.429317043324241,37.55089849785165,-32786
2025-09-15T06:20:00-04:00,24108,24114.5,24106.25,24109,NaN,NaN,NaN,24124.38823498904,NaN,NaN,24118.215,24165.95230302437,24070.47769697563,24094.52641438448,24115.509485394017,24132.28436401301,24098.734606775026,584,978.8,53.89468387937904,45.37686101249851,NaN,NaN,NaN,NaN,10.273651540229652,34.95725950022185,-32202
2025-09-15T06:25:00-04:00,24110,24123,24109.25,24122.75,NaN,NaN,NaN,24124.38823498904,NaN,NaN,24117.81,24165.040240308048,24070.579759691955,24100.021131507583,24115.54316205371,24132.22053103219,24098.865793075227,1066,999.6666666666666,62.11155228289494,47.05214959904792,NaN,NaN,NaN,NaN,10.539819287356107,33.55666155876179,-31136
2025-09-15T06:30:00-04:00,24122.25,24133.25,24122.25,24124.5,24095.242748325825,24095.242748325825,24095.242748325825,NaN,NaN,NaN,24117.59,24164.590506378045,24070.589493621956,24109.366905206065,24115.71819358035,24132.321640089227,24099.11474707147,1429,805,63.01499585670862,48.65480347786856,NaN,NaN,NaN,NaN,10.572689338259242,33.20233581957249,-29707
2025-09-15T06:35:00-04:00,24125.75,24130.75,24118.5,24119.75,24095.242748325825,NaN,NaN,NaN,NaN,NaN,24117.3,24164.064088787385,24070.535911212613,24109.366905206065,24115.796875510576,24132.327527439596,24099.266223581555,992,749.0666666666667,58.90902113733656,49.864367328234096,NaN,NaN,NaN,NaN,10.692497242669296,32.33986210347409,-30699
2025-09-15T06:40:00-04:00,24119.5,24122.25,24116,24118,24095.242748325825,NaN,NaN,NaN,NaN,NaN,24116.85,24163.143088039044,24070.556911960954,24109.366905206065,24115.81678026614,24132.293399604852,24099.34016092743,623,732.1,57.42445895388115,50.967891022638526,NaN,NaN,NaN,NaN,10.37517601105006,31.19268164614043,-31322
2025-09-15T06:45:00-04:00,24118,24124.75,24116,24122.5,24095.242748325825,NaN,NaN,NaN,NaN,NaN,24116.43,24162.125518379708,24070.734481620293,24109.366905206065,24115.841845048377,24132.283205340682,24099.400484756072,442,704.3666666666667,60.20185949960585,52.03520998308101,NaN,NaN,NaN,NaN,10.25909201026077,30.374565559762303,-30880
2025-09-15T06:50:00-04:00,24122.5,24129.25,24119.75,24127.5,24095.242748325825,NaN,NaN,NaN,NaN,NaN,24116.045,24161.031074512914,24071.058925487083,24109.366905206065,24115.89304929293,24132.305761113013,24099.480337472844,495,687.0333333333333,63.08350760052147,53.47003468586325,NaN,NaN,NaN,NaN,10.204871152385001,30.04006883113694,-30385
2025-09-15T06:55:00-04:00,24127.25,24128.25,24124,24127.25,24095.33259275793,NaN,NaN,NaN,NaN,NaN,24115.675,24159.976834049536,24071.373165950463,24109.366905206065,24115.92521524952,24132.323396906555,24099.527033592487,284,671.0333333333333,62.83851174233672,54.81926792976285,NaN,NaN,NaN,NaN,9.77952321292893,29.729464725984815,-30669
2025-09-15T07:00:00-04:00,24127.5,24136.5,24126.25,24135,24100.584520359844,NaN,NaN,NaN,NaN,NaN,24115.495,24159.4064438389,24071.5835561611,24114.84714999834,24116.131974908956,24132.532104851365,24099.731844966547,1177,665,67.1036837869625,56.35648613290444,NaN,NaN,NaN,NaN,9.813128697719721,30.16402730188421,-29492
2025-09-15T07:05:00-04:00,24134.5,24144.25,24130.5,24142.25,24106.109087616216,NaN,NaN,NaN,NaN,NaN,24115.4,24159.058218006296,24071.741781993707,24120.05271999867,24116.37769321983,24132.85898381904,24099.896402620623,1030,656.9333333333333,70.51319526520476,58.22667609638115,NaN,NaN,NaN,NaN,10.094333790739741,31.122814454285262,-28462
2025-09-15T07:10:00-04:00,24142.5,24144.25,24137.25,24139.5,24109.950719997294,NaN,NaN,NaN,NaN,NaN,24115.27,24158.600455801254,24071.939544198747,24121.392175998935,24116.55111402246,24133.09774066543,24100.004487379487,699,656.1333333333333,67.64910744253699,59.866319498804614,NaN,NaN,NaN,NaN,9.873309948544046,32.01311681008624,-29161
2025-09-15T07:15:00-04:00,24138.75,24140.5,24131.75,24136.25,24109.950719997294,NaN,NaN,NaN,NaN,NaN,24115.06,24157.87688451661,24072.243115483394,24121.392175998935,24116.69189501825,24133.2619744262,24100.121815610302,698,645.9,64.32386424958462,60.96098830432704,NaN,NaN,NaN,NaN,9.793073523648044,31.910144797029588,-29859
2025-09-15T07:20:00-04:00,24136.75,24141.25,24135.75,24135.75,24109.950719997294,NaN,NaN,NaN,NaN,NaN,24114.86,24157.192276105194,24072.527723894807,24121.392175998935,24116.778745695145,24133.36889281814,24100.18859857215,406,628.3,63.804248546719506,62.00586356183354,NaN,NaN,NaN,NaN,9.48642541481604,31.879675288091818,-30265
2025-09-15T07:25:00-04:00,24136.25,24139,24131.5,24134.75,24109.950719997294,NaN,NaN,NaN,NaN,NaN,24114.625,24156.378592662077,24072.871407337923,24121.392175998935,24116.856014104855,24133.453590667083,24100.258437542627,414,615.4666666666667,62.71310195113822,62.68469944248651,NaN,NaN,NaN,NaN,9.344537885186323,31.154351728463638,-30679
2025-09-15T07:30:00-04:00,24134.25,24138.25,24129.5,24135.5,24109.950719997294,NaN,NaN,NaN,NaN,NaN,24114.345,24155.340230205395,24073.349769794608,24121.392175998935,24116.95606871661,24133.558989318946,24100.35314811427,562,608.4666666666667,63.2211186249912,63.350873352887376,NaN,NaN,NaN,NaN,9.3020708933873,30.16566251538415,-30117
2025-09-15T07:35:00-04:00,24135.25,24148,24133.75,24144,24110.810594255017,NaN,NaN,NaN,NaN,NaN,24114.35,24155.35963302004,24073.340366979955,24124.284948231332,24117.210799365806,24133.918197404244,24100.50340132737,1017,624.2,68.46504176127938,63.80469402991484,NaN,NaN,NaN,NaN,9.655494401002494,30.1918925121827,-29100
2025-09-15T07:40:00-04:00,24143.25,24146.25,24135.75,24142.25,24110.870339970697,NaN,NaN,NaN,NaN,NaN,24114.145,24154.486800899685,24073.803199100315,24124.284948231332,24117.379642731397,24134.15011004093,24100.609175421865,700,628.9333333333333,66.36700156578996,64.04412300913494,NaN,NaN,NaN,NaN,9.715816229502318,30.216248937781355,-29800
2025-09-15T07:45:00-04:00,24142.25,24148,24141,24143.5,24114.785324517485,NaN,NaN,NaN,NaN,NaN,24113.99,24153.81661923615,24074.163380763854,24125.122366868054,24117.50504168898,24134.335825864793,24100.674257513165,472,624.4333333333333,67.14155011743748,64.63216079342786,NaN,NaN,NaN,NaN,9.521829355966437,30.398686676497732,-29328
2025-09-15T07:50:00-04:00,24143.25,24145,24139.75,24140.25,24114.785324517485,NaN,NaN,NaN,NaN,NaN,24113.92,24153.54895911501,24074.291040884986,24125.122366868054,24117.57838687668,24134.43608966239,24100.72068409097,307,609.9,63.074364668375715,65.03572548732032,NaN,NaN,NaN,NaN,9.21669868768312,30.33880404540269,-29635
2025-09-15T07:55:00-04:00,24140,24146,24134.75,24143.75,24114.785324517485,NaN,NaN,NaN,NaN,NaN,24113.855,24153.276832785807,24074.433167214193,24125.122366868054,24117.741190854984,24134.65615776117,24100.8262239488,693,616.4,65.49825537951922,65.41403947874271,NaN,NaN,NaN,NaN,9.361934495705754,29.410285109378187,-28942
2025-09-15T08:00:00-04:00,24144,24152.5,24141.5,24151.75,24117.53926937983,NaN,NaN,NaN,NaN,NaN,24113.995,24153.901451864785,24074.088548135212,24129.106651836442,24118.03073631608,24135.12682998352,24100.934642648637,965,628.4333333333333,70.2976122775793,65.92933266996113,NaN,NaN,NaN,NaN,9.478939174583914,29.236832451625077,-27977
2025-09-15T08:05:00-04:00,24151.75,24153.25,24143.75,24149,24119.082938953474,NaN,NaN,NaN,NaN,NaN,24114.205,24154.730756004763,24073.67924399524,24129.785321469153,24118.301916098564,24135.562379151994,24101.041453045134,918,640.8666666666667,66.85488570573472,66.21621652448955,NaN,NaN,NaN,NaN,9.480443519256491,29.150289223824156,-28895
2025-09-15T08:10:00-04:00,24149.25,24151.75,24145.5,24148.5,24119.69280536468,NaN,NaN,NaN,NaN,NaN,24115.47,24156.249362420724,24074.69063757928,24129.853257175324,24118.468303893922,24135.82622290953,24101.110384878313,573,641.8666666666667,66.21988765667093,66.15308822946872,NaN,NaN,NaN,NaN,9.249697553595313,29.069927655151872,-29468
2025-09-15T08:15:00-04:00,24148.75,24164,24143.25,24151.75,24123.178359666286,NaN,NaN,NaN,NaN,NaN,24116.08,24158.081123793647,24074.078876206357,24136.107605740257,24119.513531776654,24137.60160735483,24101.425456198478,3255,736.1,68.32581202554802,65.99684656949326,NaN,NaN,NaN,NaN,10.071147728338506,30.09037019178482,-26213
2025-09-15T08:20:00-04:00,24151,24172.5,24147.75,24170.75,24127.68729786327,NaN,NaN,NaN,NaN,NaN,24117.235,24161.92397067231,24072.546029327692,24137.811084592206,24120.55272150538,24139.638883060925,24101.466559949837,2592,813.4666666666667,77.25367984017188,66.6828874550386,NaN,NaN,NaN,NaN,11.119637176314328,31.593487138724836,-23621
2025-09-15T08:25:00-04:00,24171,24172,24155.5,24157.25,24130.536738869487,NaN,NaN,NaN,NaN,NaN,24117.99,24164.060702183557,24071.919297816446,24137.811084592206,24121.244995640616,24140.89341904064,24101.596572240593,1890,868.2,63.54778149903774,66.62745297285667,NaN,NaN,NaN,NaN,11.503948806577588,32.98923858945484,-25511
2025-09-15T08:30:00-04:00,24157.75,24158.5,24145.75,24152.5,24130.536738869487,NaN,NaN,NaN,NaN,NaN,24118.785,24165.828172725473,24071.741827274527,24137.811084592206,24121.865600240282,24141.79522009845,24101.935980382113,2288,932.6333333333333,59.54485947699522,66.3232108964478,NaN,NaN,NaN,NaN,11.592952463250617,32.61791302994085,-27799
2025-09-15T08:35:00-04:00,24152.25,24152.5,24141.75,24145.75,24130.536738869487,NaN,NaN,NaN,NaN,NaN,24119.735,24166.998983115693,24072.47101688431,24137.811084592206,24122.165893167854,24142.159341022587,24102.17244531312,1401,958.9333333333333,54.309490320624995,65.72295292283972,NaN,NaN,NaN,NaN,11.532741573018429,31.690011022930527,-29200
2025-09-15T08:40:00-04:00,24145.75,24156,24140.25,24155.5,24130.536738869487,NaN,NaN,NaN,NaN,NaN,24121.23,24168.194757002122,24074.265242997877,24137.811084592206,24122.518079264817,24142.634442598515,24102.40171593112,1452,995.6333333333333,59.80669915087279,65.47906581754555,NaN,NaN,NaN,NaN,11.833974317802827,31.15434377092437,-27748
2025-09-15T08:45:00-04:00,24155.5,24156,24148.75,24156,24130.536738869487,NaN,NaN,NaN,NaN,NaN,24122.44,24169.806502935895,24075.073497064102,24137.811084592206,24122.760901936203,24142.984387207485,24102.53741666492,923,1011.5666666666667,60.07200316875687,64.8795630609368,NaN,NaN,NaN,NaN,11.50654758081691,30.656938465490075,-26825
2025-09-15T08:50:00-04:00,24155.25,24168.25,24153.75,24168.25,24130.536738869487,NaN,NaN,NaN,NaN,NaN,24123.785,24172.441552484706,24075.128447515293,24137.811084592206,24123.394368858648,24144.081794993413,24102.706942723882,1869,1054.4,65.9943286793353,64.85294356904716,NaN,NaN,NaN,NaN,11.72036561075856,31.209298449960617,-24956
2025-09-15T08:55:00-04:00,24168,24175,24159.5,24173,24132.761231931592,NaN,NaN,NaN,NaN,NaN,24124.925,24175.434231828305,24074.415768171693,24141.36995916747,24124.10475365839,24145.396508442078,24102.812998874702,1891,1081.9,67.97772343221074,64.9126702343881,NaN,NaN,NaN,NaN,11.990339495704376,32.162402895746645,-23065
2025-09-15T09:00:00-04:00,24173.25,24179,24168,24170.5,24139.07890320743,NaN,NaN,NaN,NaN,NaN,24126.3,24177.941262573368,24074.65873742663,24146.59596733398,24125.05716917828,24147.184130777838,24102.93020757872,2446,1115.8,65.80236710042601,65.10752755096313,NaN,NaN,NaN,NaN,11.91960096029692,33.28508158506321,-25511
2025-09-15T09:05:00-04:00,24171,24178.5,24170,24171.5,24140.23440760709,NaN,NaN,NaN,NaN,NaN,24127.825,24180.206604595325,24075.443395404676,24148.326773867182,24125.648392010375,24148.27136375452,24103.02542026623,1541,1134.1,66.26737317550946,65.162464536391,NaN,NaN,NaN,NaN,11.67534374884714,34.327568939428595,-23970
2025-09-15T09:10:00-04:00,24171.75,24176.25,24169.25,24172,24140.23440760709,NaN,NaN,NaN,NaN,NaN,24129.47,24182.130672232463,24076.80932776754,24148.611419093744,24125.933718269727,24148.780349943027,24103.087086596428,771,1139.0333333333333,66.51256117025443,64.89210374301065,NaN,NaN,NaN,NaN,11.341390623929486,35.1595383344554,-23199
2025-09-15T09:15:00-04:00,24172,24173.75,24162.25,24170,24140.23440760709,NaN,NaN,NaN,NaN,NaN,24131.025,24183.789216089346,24078.260783910657,24148.611419093744,24126.58782962196,24149.858048224534,24103.317611019385,1968,1189.9,64.49322867568,64.7234139551496,NaN,NaN,NaN,NaN,11.352719865077379,34.73690647942864,-25167
2025-09-15T09:20:00-04:00,24169.75,24177.5,24169,24173.5,24140.23440760709,NaN,NaN,NaN,NaN,NaN,24132.68,24185.478393911802,24079.881606088198,24150.961308219998,24127.002243310533,24150.579832575844,24103.424654045222,1150,1211.7333333333333,66.4148766912418,64.73734174333323,NaN,NaN,NaN,NaN,11.148954160428996,34.65795832041677,-24017
2025-09-15T09:25:00-04:00,24173.5,24183.25,24167.5,24177,24141.621813639074,NaN,NaN,NaN,NaN,NaN,24134.48,24187.062491385324,24081.897508614675,24154.144046576,24128.07763410864,24152.47285429362,24103.682413923656,2916,1299.4666666666667,68.26453781888218,64.73296501428567,NaN,NaN,NaN,NaN,11.477600291826926,35.02509595958397,-21101
2025-09-15T09:30:00-04:00,24177.75,24212.25,24172,24201,24154.417413019117,NaN,NaN,NaN,NaN,NaN,24136.69,24190.954496685834,24082.425503314164,24168.8402372608,24135.25955462961,24166.25936894136,24104.259740317862,15923,1791,77.439763438106,64.7462566998524,NaN,NaN,NaN,NaN,13.532771699553575,36.80821905105432,-5178
2025-09-15T09:35:00-04:00,24201,24224.75,24196,24214.5,24170.460939700064,NaN,NaN,NaN,NaN,NaN,24139.12,24196.152117269532,24082.087882730466,24175.64718980864,24140.692716638416,24176.452954805212,24104.93247847162,11359,2135.3,80.802045166673,65.97870410468349,NaN,NaN,NaN,NaN,14.619716578156892,38.84897196570627,6181
2025-09-15T09:40:00-04:00,24213.75,24227.5,24197.75,24204,24170.468396986427,NaN,NaN,NaN,NaN,NaN,24141.34,24199.64555376669,24083.03444623331,24175.64718980864,24145.645365565302,24184.434150200683,24106.85658092992,12355,2523.8333333333335,71.83468052578742,66.85654846531149,NaN,NaN,NaN,NaN,15.700451108288544,40.820442501339,-6174
2025-09-15T09:45:00-04:00,24204,24234.5,24204,24228.5,24174.850515305225,NaN,NaN,NaN,NaN,NaN,24143.94,24205.854663857026,24082.02533614297,24175.92420147753,24150.07984221608,24191.768864548463,24108.390819883698,10573,2853,77.9764252120938,68.54704381470212,NaN,NaN,NaN,NaN,16.75756174341079,42.83839570644809,4399
2025-09-15T09:50:00-04:00,24228.75,24251.25,24226,24246.5,24192.80049188226,NaN,NaN,NaN,NaN,NaN,24146.995,24213.598715363103,24080.391284636895,24191.764361182024,24155.627982259244,24201.532812773905,24109.723151744583,11848,3234.4,81.2170705802837,70.07635605966004,NaN,NaN,NaN,NaN,17.364164476024307,45.082557770797024,16247
2025-09-15T09:55:00-04:00,24246.5,24262.25,24238.75,24260.75,24203.553878614886,NaN,NaN,NaN,NaN,NaN,24150.305,24222.507790111566,24078.102209888435,24202.911488945618,24159.915866793726,24209.092977689405,24110.738755898048,8881,3516.633333333333,83.31073874761177,71.73626574386397,NaN,NaN,NaN,NaN,17.80243844202257,47.36132748928188,25128
2025-09-15T10:00:00-04:00,24260.5,24265.5,24248.75,24253,24210.02870231421,NaN,NaN,NaN,NaN,NaN,24153.41,24229.550774882307,24077.269225117692,24209.654191156496,24164.29769259856,24216.341331090905,24112.254054106215,9754,3823.0333333333333,78.20508854686551,72.60846287725899,NaN,NaN,NaN,NaN,17.727264267592385,49.53096102388954,15374
2025-09-15T10:05:00-04:00,24253.25,24262.25,24245.5,24249.5,24210.02870231421,NaN,NaN,NaN,NaN,NaN,24156.49,24235.419396297188,24077.560603702816,24209.654191156496,24167.293568530487,24220.879698997425,24113.70743806355,7508,4039.4,75.94158715333961,73.17731028591105,NaN,NaN,NaN,NaN,17.657459677050074,51.11470572921429,7866
2025-09-15T10:10:00-04:00,24250,24254.25,24238,24247.25,24210.02870231421,NaN,NaN,NaN,NaN,NaN,24159.515,24240.505827261804,24078.524172738194,24209.654191156496,24170.002416293468,24224.59627803101,24115.408554555925,7820,4276.733333333334,74.44979466656832,73.79498368349265,NaN,NaN,NaN,NaN,17.55692684297507,51.631243063568,46
2025-09-15T10:15:00-04:00,24248.25,24250,24239,24241.75,24210.02870231421,NaN,NaN,NaN,NaN,NaN,24162.31,24244.800215177864,24079.81978482214,24209.654191156496,24171.29885567351,24226.268740494113,24116.32897085291,4101,4397.7,70.7891281702277,74.11796618311537,NaN,NaN,NaN,NaN,17.088574925619707,52.110884874039286,-4055
2025-09-15T10:20:00-04:00,24242,24243.25,24229,24235,24210.02870231421,NaN,NaN,NaN,NaN,NaN,24164.965,24248.094838805515,24081.835161194485,24209.654191156496,24173.40654999875,24228.67203031616,24118.141069681336,7869,4649.766666666666,66.46951425157367,74.1148914032096,NaN,NaN,NaN,NaN,16.88581957378973,51.34178459622488,-11924
2025-09-15T10:25:00-04:00,24234.5,24258,24230.25,24254.5,24210.02870231421,NaN,NaN,NaN,NaN,NaN,24167.895,24253.08860832878,24082.70139167122,24209.654191156496,24176.207867797013,24232.23351143275,24120.182224161275,9444,4941.466666666666,71.81939604830959,74.63818907268315,NaN,NaN,NaN,NaN,17.661832461376175,51.23811358426157,-2480
2025-09-15T10:30:00-04:00,24254.25,24258,24221,24240.75,24210.02870231421,NaN,NaN,NaN,NaN,NaN,24170.53,24256.42130573027,24084.638694269728,24209.654191156496,24178.392353642346,24234.656411156004,24122.12829612869,8879,5205.266666666666,64.05814916938499,74.46985139255051,NaN,NaN,NaN,NaN,19.043130142706445,50.182646769770514,-11359
2025-09-15T10:35:00-04:00,24241.25,24253.75,24237,24248.25,24210.02870231421,NaN,NaN,NaN,NaN,NaN,24173.04,24260.51978966414,24085.56021033586,24209.654191156496,24179.675827697472,24236.168261844465,24123.18339355048,4986,5340.866666666667,66.20352973725778,74.32263652957735,NaN,NaN,NaN,NaN,18.879335132513127,49.202570442028815,-6373
2025-09-15T10:40:00-04:00,24248.5,24260,24246,24255.25,24210.02870231421,NaN,NaN,NaN,NaN,NaN,24175.655,24264.972125458262,24086.337874541736,24209.654191156496,24180.81652291936,24237.60952007847,24124.023525760247,4128,5459.366666666667,68.11642992414403,73.65668413572291,NaN,NaN,NaN,NaN,18.530811194476478,48.590222747095666,-2245
2025-09-15T10:45:00-04:00,24255.75,24263.5,24240,24244,24210.02870231421,NaN,NaN,NaN,NaN,NaN,24178.14,24268.009358517047,24088.27064148295,24211.2537625787,24182.2936208562,24239.342006336163,24125.245235376235,5921,5548.233333333334,62.03893678522318,72.3164621084765,NaN,NaN,NaN,NaN,18.885753252013874,47.38362839304679,-8166
2025-09-15T10:50:00-04:00,24244,24257,24240.25,24251.75,24210.02870231421,NaN,NaN,NaN,NaN,NaN,24180.815,24271.32471273865,24090.305287261348,24211.2537625787,24183.239893973685,24240.43836897923,24126.04141896814,3903,5591.933333333333,64.39566418649233,71.78510379852685,NaN,NaN,NaN,NaN,18.7331994482986,46.26321935000141,-4263
2025-09-15T10:55:00-04:00,24251.5,24262.75,24251,24262,24210.02870231421,NaN,NaN,NaN,NaN,NaN,24183.605,24275.34430945727,24091.86569054273,24216.73740805037,24184.21695176731,24241.67910157102,24126.7548019636,3651,5650.633333333333,67.2882215848438,71.02166068229471,NaN,NaN,NaN,NaN,18.23439948770584,45.54452425775763,-612
2025-09-15T11:00:00-04:00,24262,24278.75,24257.5,24265.75,24216.849281955365,NaN,NaN,NaN,NaN,NaN,24186.37,24279.501747542818,24093.23825245718,24231.314926440296,24186.44363229722,24244.697873417997,24128.189391176445,7750,5832.7,68.302814633272,70.09921382893673,NaN,NaN,NaN,NaN,18.449799524298278,45.62902322193755,7138
2025-09-15T11:05:00-04:00,24265.75,24267.75,24249,24249.5,24216.849281955365,NaN,NaN,NaN,NaN,NaN,24188.815,24282.028883623654,24095.601116376343,24231.314926440296,24187.756889836084,24246.2188215816,24129.29495809057,5615,5973.166666666667,59.66655880457715,68.41034383300568,NaN,NaN,NaN,NaN,18.471242415419827,44.80352958338528,1523
2025-09-15T11:10:00-04:00,24250,24266,24245.5,24255.75,24216.849281955365,NaN,NaN,NaN,NaN,NaN,24191.23,24284.99693660338,24097.46306339662,24231.314926440296,24188.91877590018,24247.54507898303,24130.29247281733,5127,6095.666666666667,61.67377555367339,67.22953576206339,NaN,NaN,NaN,NaN,18.616153671461266,43.68421669299453,6650
2025-09-15T11:15:00-04:00,24255.75,24261.75,24247,24250,24216.849281955365,NaN,NaN,NaN,NaN,NaN,24193.385,24287.50222531068,24099.267774689317,24231.314926440296,24189.55716464336,24248.23600557005,24130.87832371667,3023,6165.666666666667,58.775766057659986,66.00340568380055,NaN,NaN,NaN,NaN,18.339999837785463,42.644854723345986,3627
2025-09-15T11:20:00-04:00,24250,24251.25,24240.5,24247.75,24216.849281955365,NaN,NaN,NaN,NaN,NaN,24195.55,24289.58967247943,24101.51032752057,24231.314926440296,24190.356559292653,24249.005937170237,24131.70718141507,4315,6247.2,57.6345148069613,64.80231426525721,NaN,NaN,NaN,NaN,17.79785699222936,41.001682470314336,-688
2025-09-15T11:25:00-04:00,24247.5,24264.25,24247.5,24253.75,24216.849281955365,NaN,NaN,NaN,NaN,NaN,24197.9,24291.767086882108,24104.032913117895,24231.314926440296,24191.38170732097,24250.124618054502,24132.638796587435,4940,6348.833333333333,59.87211579673396,64.02252766715051,NaN,NaN,NaN,NaN,17.72301006421298,40.26047124628185,4252
2025-09-15T11:30:00-04:00,24253.5,24257.5,24250,24250.5,24216.849281955365,NaN,NaN,NaN,NaN,NaN,24200.195,24293.481080955764,24106.908919044236,24231.314926440296,24191.839989438362,24250.6005303437,24133.079448533023,2353,6345.733333333334,58.08260892498726,63.42346300096576,NaN,NaN,NaN,NaN,16.99279505962634,39.57220368110884,1899
2025-09-15T11:35:00-04:00,24251,24267.25,24250.25,24265,24216.849281955365,NaN,NaN,NaN,NaN,NaN,24202.8,24295.904672280696,24109.695327719302,24231.314926440296,24192.540151846402,24251.409308126582,24133.670995566223,3226,6401.9,63.34635847593636,62.81824603151053,NaN,NaN,NaN,NaN,16.993309698224458,39.459663096002345,5125
2025-09-15T11:40:00-04:00,24265.5,24274.75,24260.25,24261,24218.278248641458,NaN,NaN,NaN,NaN,NaN,24205.31,24297.786567839354,24112.83343216065,24236.782419249128,24193.682909025032,24252.784952897022,24134.580865153042,5070,6545.2,61.06815533144765,62.60467504308644,NaN,NaN,NaN,NaN,16.815216148351283,39.71347542066482,55
2025-09-15T11:45:00-04:00,24261.25,24278.75,24258.5,24277.5,24218.879237339574,NaN,NaN,NaN,NaN,NaN,24207.98,24300.929440020453,24115.030559979547,24238.250935399305,24194.99504348178,24254.448467881124,24135.541619082436,5533,6664.033333333334,66.43124079693621,62.62094011877775,NaN,NaN,NaN,NaN,17.06055785204048,40.129909656314474,5588
2025-09-15T11:50:00-04:00,24277.25,24282.5,24272.5,24281.5,24228.651772005956,NaN,NaN,NaN,NaN,NaN,24210.765,24304.01388256825,24117.516117431747,24245.100748319444,24196.153849964267,24256.000844083133,24136.3068558454,4604,6779.166666666667,67.59660320698279,62.583809638980526,NaN,NaN,NaN,NaN,16.556232291180443,40.683501825478366,10192
2025-09-15T11:55:00-04:00,24281.5,24289.75,24275,24280.25,24233.735782369324,NaN,NaN,NaN,NaN,NaN,24213.5,24306.718667657235,24120.281332342765,24252.455598655553,24197.585849566214,24257.935562036593,24137.236137095835,5673,6871.066666666667,66.81598123284195,62.92502709952472,NaN,NaN,NaN,NaN,16.42721569895327,41.50286595333406,4519
2025-09-15T12:00:00-04:00,24280,24281,24266,24270,24233.735782369324,NaN,NaN,NaN,NaN,NaN,24216.095,24308.230329269158,24123.959670730845,24252.455598655553,24198.5384366925,24259.08568141872,24137.991191966277,4373,6486.066666666667,60.63266972343993,62.656241780735265,NaN,NaN,NaN,NaN,16.325271720456605,41.189869828809506,146
2025-09-15T12:05:00-04:00,24269.5,24284.5,24269,24283.25,24233.735782369324,NaN,NaN,NaN,NaN,NaN,24218.885,24310.53576159053,24127.234238409466,24252.455598655553,24199.242671775857,24259.98770140562,24138.497642146096,3033,6208.533333333334,65.12554993749657,62.50176523449618,NaN,NaN,NaN,NaN,16.266323740423992,41.077698148022904,3179
2025-09-15T12:10:00-04:00,24283,24294.25,24276.25,24286,24236.610650405924,NaN,NaN,NaN,NaN,NaN,24221.57,24313.062132995186,24130.077867004813,24255.155266511643,24200.362433685168,24261.496636060776,24139.22823130956,4553,5948.466666666666,65.99302768456056,62.33678045244536,NaN,NaN,NaN,NaN,16.390157758965135,41.43290686212197,7732
2025-09-15T12:15:00-04:00,24285.5,24291.25,24280.5,24281.75,24237.98062084202,NaN,NaN,NaN,NaN,NaN,24224.225,24314.839747697417,24133.61025230258,24255.155266511643,24200.95958309859,24262.284548928892,24139.634617268286,2507,5679.6,63.36957817201402,62.60128183583371,NaN,NaN,NaN,NaN,15.987289347610483,41.76274352521395,5225
2025-09-15T12:20:00-04:00,24281.75,24288.25,24276.75,24279.25,24237.98062084202,NaN,NaN,NaN,NaN,NaN,24226.84,24316.09893568672,24137.58106431328,24255.155266511643,24201.531527163283,24263.010851070747,24140.05220325582,2529,5368.966666666666,61.812932506426044,62.61122161817319,NaN,NaN,NaN,NaN,15.66676867992402,41.595863688630615,2696
2025-09-15T12:25:00-04:00,24279.5,24280.5,24267.5,24270,24237.98062084202,NaN,NaN,NaN,NaN,NaN,24229.205,24316.627690988233,24141.78230901177,24255.155266511643,24202.272544994477,24263.85579915677,24140.689290832186,3745,5197.766666666666,56.302068328113954,62.43452892320561,NaN,NaN,NaN,NaN,15.47628520278659,40.37003397274145,-1049
2025-09-15T12:30:00-04:00,24270.25,24287.5,24268.75,24284.75,24237.98062084202,NaN,NaN,NaN,NaN,NaN,24231.485,24318.636558217353,24144.333441782648,24255.155266511643,24202.942036639197,24264.68167955577,24141.202393722622,3110,4976.3,62.103954729250354,62.753774631940544,NaN,NaN,NaN,NaN,15.710121974016118,39.66664989296447,2061
2025-09-15T12:35:00-04:00,24284.75,24286.75,24276.75,24284.5,24237.98062084202,NaN,NaN,NaN,NaN,NaN,24234.03,24319.782355070554,24148.277644929443,24255.155266511643,24203.380212604312,24265.23144472087,24141.528980487754,2004,4792.833333333333,61.95381036554656,62.90246710114145,NaN,NaN,NaN,NaN,15.302256118729252,39.01350753317156,57
2025-09-15T12:40:00-04:00,24284.5,24286.75,24275.5,24283.5,24237.98062084202,NaN,NaN,NaN,NaN,NaN,24236.65,24320.25633946959,24153.043660530413,24255.155266511643,24203.810350972406,24265.76371283435,24141.856989110463,2008,4599.1,61.315248550345245,63.13336993152416,NaN,NaN,NaN,NaN,15.012809253105733,38.25400423778355,-1951
2025-09-15T12:45:00-04:00,24283.75,24283.75,24272,24276.75,24237.98062084202,NaN,NaN,NaN,NaN,NaN,24239.27,24319.45839317532,24159.081606824682,24255.155266511643,24204.198422732894,24266.218194636316,24142.17865082947,1941,4527.1,57.041451020967635,62.683019399026385,NaN,NaN,NaN,NaN,14.779751449312467,37.11632839403311,-3892
2025-09-15T12:50:00-04:00,24276.5,24280.25,24268,24273.5,24237.98062084202,NaN,NaN,NaN,NaN,NaN,24241.63,24318.702968021822,24164.55703197818,24255.155266511643,24204.654694454763,24266.72627606492,24142.583112844604,2428,4345.733333333334,55.051780826098344,62.25327836293001,NaN,NaN,NaN,NaN,14.59905491721872,35.58061713042491,-6320
2025-09-15T12:55:00-04:00,24273,24275.75,24260,24265.75,24237.98062084202,NaN,NaN,NaN,NaN,NaN,24243.825,24317.17970332504,24170.47029667496,24255.155266511643,24205.40367876884,24267.476036815526,24143.33132072215,4499,4180.9,50.52585697180994,61.117179518278135,NaN,NaN,NaN,NaN,14.681265280274525,33.28199093130918,-10819
2025-09-15T13:00:00-04:00,24266.25,24271,24262.25,24264.5,24237.98062084202,NaN,NaN,NaN,NaN,NaN,24245.75,24316.05903213765,24175.44096786235,24254.599213209316,24205.801355535496,24267.862319563017,24143.740391507974,2484,3967.733333333333,49.81450476725483,59.84702962972614,NaN,NaN,NaN,NaN,14.25760347454063,31.147552317844568,-13303
2025-09-15T13:05:00-04:00,24264.75,24280.25,24264.75,24273,24237.98062084202,NaN,NaN,NaN,NaN,NaN,24247.75,24315.30264613717,24180.19735386283,24253.43207018443,24206.3247458852,24268.42255376209,24144.226938008305,2982,3900.9333333333334,54.505093601024264,58.967680513167736,NaN,NaN,NaN,NaN,14.364203226359157,30.021920280477097,-10321
2025-09-15T13:10:00-04:00,24273,24275.5,24262,24266,24237.98062084202,NaN,NaN,NaN,NaN,NaN,24249.66,24313.675682452274,24185.644317547725,24253.43207018443,24206.822806688644,24268.9138683027,24144.731745074587,3110,3867,50.332896009359956,58.23198239073345,NaN,NaN,NaN,NaN,14.30247442447636,28.661706885929974,-13431
2025-09-15T13:15:00-04:00,24265.5,24268.75,24256.25,24259.75,24237.98062084202,NaN,NaN,NaN,NaN,NaN,24251.425,24311.466423199716,24191.383576800283,24253.43207018443,24207.296734731262,24269.326259674268,24145.267209788257,3353,3781.4,46.882231670808615,56.92888822882717,NaN,NaN,NaN,NaN,14.173726251299476,26.770544713333617,-16784
2025-09-15T13:20:00-04:00,24259.5,24265.25,24253,24261.25,24237.98062084202,NaN,NaN,NaN,NaN,NaN,24253.21,24308.84527298693,24197.574727013067,24253.43207018443,24207.758974539363,24269.709595242457,24145.80835383627,3439,3765.9333333333334,47.807054472072195,55.62989014222085,NaN,NaN,NaN,NaN,14.036317233349513,25.038094945218788,-13345
2025-09-15T13:25:00-04:00,24261,24262.25,24253.5,24253.5,24237.98062084202,NaN,NaN,NaN,NaN,NaN,24254.88,24305.181316083297,24204.578683916705,24253.43207018443,24207.99176690158,24269.885149714097,24146.098384089066,1879,3706.866666666667,43.584760219821426,54.21668885992138,NaN,NaN,NaN,NaN,13.658723145253118,23.429391589112157,-15224
2025-09-15T13:30:00-04:00,24253.75,24261.5,24248.75,24258.25,24237.98062084202,NaN,NaN,NaN,NaN,NaN,24256.575,24301.18242650896,24211.96757349104,24251.220656147543,24208.58097820208,24270.322177759506,24146.839778644655,4863,3610.633333333333,46.692342922553436,53.13664674678763,NaN,NaN,NaN,NaN,13.59381434916361,22.43936663755804,-10361
2025-09-15T13:35:00-04:00,24258.25,24265.75,24251.5,24263.25,24237.98062084202,NaN,NaN,NaN,NaN,NaN,24258.3,24296.704557019282,24219.895442980716,24248.101524918035,24208.963705869075,24270.6345293693,24147.29288236885,2972,3522.5333333333333,49.82542001210398,52.674029009929775,NaN,NaN,NaN,NaN,13.640684752794781,21.010020553225736,-7389
2025-09-15T13:40:00-04:00,24263.25,24273,24263,24268.5,24237.98062084202,NaN,NaN,NaN,NaN,NaN,24259.65,24294.48216903572,24224.817830964283,24247.374980758035,24209.390974437254,24271.04286068775,24147.739088186758,2912,3448.7,52.95218288295661,52.02033102090879,NaN,NaN,NaN,NaN,13.380635841880869,20.118111809810095,-4477
2025-09-15T13:45:00-04:00,24268.5,24277,24263,24276,24237.98062084202,NaN,NaN,NaN,NaN,NaN,24260.88,24293.522493779295,24228.237506220707,24247.374980758035,24209.777732621664,24271.434364057342,24148.121101185985,2508,3431.5333333333333,57.068198004293016,51.67135870939069,NaN,NaN,NaN,NaN,13.424876138889378,19.680216782003114,-1969
2025-09-15T13:50:00-04:00,24276,24279.25,24273.5,24276.25,24237.98062084202,NaN,NaN,NaN,NaN,NaN,24262.325,24290.91262844409,24233.73737155591,24251.42097552939,24210.093758171202,24271.77376115818,24148.413755184225,1937,3352.266666666667,57.20260388113452,51.37759837587564,NaN,NaN,NaN,NaN,12.87667070039728,19.48814857492482,-32
2025-09-15T13:55:00-04:00,24276.75,24288.25,24275.25,24287.25,24240.901358473046,NaN,NaN,NaN,NaN,NaN,24263.5,24291.24707191931,24235.75292808069,24259.48678042351,24210.685431747817,24272.46669635635,24148.904167139284,3311,3297.9666666666667,62.731278103355216,51.784014596046184,NaN,NaN,NaN,NaN,12.885479936083188,20.085104298657114,3279
2025-09-15T14:00:00-04:00,24286.75,24288,24277.75,24286.75,24242.485387633362,NaN,NaN,NaN,NaN,NaN,24264.305,24292.36623482586,24236.243765174142,24259.864424338808,24211.202263014282,24273.07138738193,24149.333138646634,2913,3316.633333333333,62.337082182130345,52.30439326433418,NaN,NaN,NaN,NaN,12.697231369220104,20.6394203278371,366
2025-09-15T14:05:00-04:00,24287,24292,24280,24282.25,24245.80991546821,NaN,NaN,NaN,NaN,NaN,24264.735,24293.22085789305,24236.24914210695,24263.491539471048,24211.627410770856,24273.568912689167,24149.685908852545,2408,3289.366666666667,58.75838436144618,52.89243093502249,NaN,NaN,NaN,NaN,12.647429128561525,21.47958264276751,-2042
2025-09-15T14:10:00-04:00,24282.25,24286,24273.25,24282,24245.80991546821,NaN,NaN,NaN,NaN,NaN,24265.315,24294.001723411868,24236.62827658813,24263.491539471048,24212.0142768537,24273.995198161174,24150.033355546228,2356,3198.9,58.5572568590541,53.51691322729387,NaN,NaN,NaN,NaN,12.654755619378559,21.286198820794564,-4398
2025-09-15T14:15:00-04:00,24281.5,24285,24270.75,24275.5,24245.80991546821,NaN,NaN,NaN,NaN,NaN,24265.835,24294.297889879494,24237.372110120505,24263.491539471048,24212.411486519064,24274.410453361037,24150.41251967709,2573,3100.233333333333,53.43581675462925,53.44053630969422,NaN,NaN,NaN,NaN,12.768701646565804,20.772034011529133,-6971
2025-09-15T14:20:00-04:00,24275,24277,24270,24272,24245.80991546821,NaN,NaN,NaN,NaN,NaN,24266.33,24294.340076744673,24238.31992325533,24263.491539471048,24212.59178089751,24274.586336060613,24150.597225734407,1258,2988.7,50.856542199073495,53.47793960895948,NaN,NaN,NaN,NaN,12.356651528953961,20.19206545312051,-8229
2025-09-15T14:25:00-04:00,24272,24276.25,24263.75,24264.5,24245.80991546821,NaN,NaN,NaN,NaN,NaN,24266.785,24293.90823910847,24239.66176089153,24263.491539471048,24212.902381462012,24274.86212776649,24150.942635157535,2376,2878.8,45.75943594596423,53.39773991432774,NaN,NaN,NaN,NaN,12.36689070545725,18.837140631571977,-10605
2025-09-15T14:30:00-04:00,24264.5,24279.5,24263.25,24276.25,24245.80991546821,NaN,NaN,NaN,NaN,NaN,24267.61,24293.286674234616,24241.933325765385,24263.491539471048,24213.3201520492,24275.265738178194,24151.374565920207,2976,2832.233333333333,53.604770561554936,53.81186249214793,NaN,NaN,NaN,NaN,12.644255655067445,17.958308558780526,-7629
2025-09-15T14:35:00-04:00,24276.25,24278.5,24265,24266.75,24245.80991546821,NaN,NaN,NaN,NaN,NaN,24267.855,24293.258954415116,24242.451045584883,24263.491539471048,24213.590011786513,24275.511398145256,24151.66862542777,2045,2799.3,47.60897853575012,54.099306657571404,NaN,NaN,NaN,NaN,12.705380251134056,17.14225020547418,-9674
2025-09-15T14:40:00-04:00,24266.75,24267.5,24245.25,24252,NaN,NaN,NaN,24297.335304170585,24297.335304170585,24297.335304170585,24268.08,24292.707107007274,24243.45289299273,24263.491539471048,24214.14497435437,24275.832864684206,24152.457084024536,5855,2842.7,40.10786467050619,53.62898678242517,NaN,NaN,NaN,NaN,13.387138804624481,17.542100129632168,-15529
2025-09-15T14:45:00-04:00,24251.75,24263,24251.5,24261.75,NaN,NaN,NaN,24297.335304170585,NaN,NaN,24268.35,24292.39059068089,24244.309409319107,24263.491539471048,24214.478427359827,24276.05529291608,24152.901561803574,3284,2868.6,46.1478667085204,53.36630440359777,NaN,NaN,NaN,NaN,13.252343175722732,17.91338934492173,-12245
2025-09-15T14:50:00-04:00,24261.5,24273.5,24258,24272.25,NaN,NaN,NaN,24297.335304170585,NaN,NaN,24268.69,24292.459215389714,24244.920784610284,24263.491539471048,24214.90477574987,24276.419492323927,24153.390059175814,3533,2902.0666666666666,51.78686573862765,53.283067464717135,NaN,NaN,NaN,NaN,13.412890091742538,16.98797077479501,-8712
2025-09-15T14:55:00-04:00,24273,24274,24266,24271,NaN,NaN,NaN,24297.335304170585,NaN,NaN,24269.23,24291.933929175397,24246.526070824602,24256.818231576835,24215.13761228744,24276.62758207118,24153.647642503696,1868,2839.5,51.10085226032068,52.85682848300483,NaN,NaN,NaN,NaN,13.0262550851895,16.073363698593987,-10580
2025-09-15T15:00:00-04:00,24271.75,24277.75,24265.75,24267,NaN,NaN,NaN,24297.335304170585,NaN,NaN,24269.535,24291.694650264606,24247.375349735394,24254.52958526147,24215.501601873162,24276.94998974345,24154.053214002874,2961,2834.5333333333333,48.86990561894473,52.26163574999127,NaN,NaN,NaN,NaN,12.952951150533108,15.04480483501687,-13541
2025-09-15T15:05:00-04:00,24267.75,24276,24262.5,24273,NaN,NaN,NaN,24297.335304170585,NaN,NaN,24269.755,24291.829304065126,24247.680695934876,24249.123668209177,24215.78030191901,24277.197080217662,24154.36352362036,2280,2843.733333333333,52.23825525789137,51.51213411817242,NaN,NaN,NaN,NaN,12.992026068352173,14.212700294560426,-11261
2025-09-15T15:10:00-04:00,24273.25,24278.75,24269.5,24271,NaN,NaN,NaN,24297.335304170585,NaN,NaN,24269.86,24291.90703154532,24247.81296845468,24248.53414765387,24215.98676846191,24277.388872266278,24154.58466465754,1627,2831.0333333333333,51.03143720190251,50.70458804815615,NaN,NaN,NaN,NaN,12.724738492041302,13.275917487000827,-12888
2025-09-15T15:15:00-04:00,24270.5,24273.75,24261.5,24273.75,NaN,NaN,NaN,24297.335304170585,NaN,NaN,24270.345,24291.632998961035,24249.057001038967,24248.53414765387,24216.3054750211,24277.663771073985,24154.947178968217,2697,2856.233333333333,52.6511930556089,50.268360097739205,NaN,NaN,NaN,NaN,12.690828599752637,13.114528156432586,-10191
2025-09-15T15:20:00-04:00,24273.5,24277.5,24268.25,24273.25,NaN,NaN,NaN,24297.335304170585,NaN,NaN,24270.695,24291.58334363511,24249.80665636489,24248.455833578017,24216.548551151896,24277.88712669811,24155.20997560568,1956,2840.5,52.312381134456864,49.82229754598226,NaN,NaN,NaN,NaN,12.445055128341734,12.512360422832733,-12147
2025-09-15T15:25:00-04:00,24273,24277.75,24269.25,24273.75,NaN,NaN,NaN,24297.335304170585,NaN,NaN,24271.17,24291.217553475388,24251.12244652461,24250.26466686241,24216.7811322306,24278.102329716483,24155.45993474472,1868,2752.8,52.64058333897816,49.765495159150035,NaN,NaN,NaN,NaN,12.163265476317324,11.922708537119627,-10279
2025-09-15T15:30:00-04:00,24273.25,24278,24268.75,24276.75,NaN,NaN,NaN,24297.335304170585,NaN,NaN,24271.75,24290.701780920965,24252.798219079035,24251.38673348993,24217.009922360594,24278.316831620195,24155.703013100992,1823,2730.766666666667,54.657007838270275,50.03695699052123,NaN,NaN,NaN,NaN,11.955175085151803,11.43472523204558,-8456
2025-09-15T15:35:00-04:00,24277.75,24283.75,24273.5,24279.75,NaN,NaN,NaN,24297.335304170585,NaN,NaN,24272.27,24290.6354131371,24253.9045868629,24257.334386791943,24217.359203764947,24278.668988724323,24156.04941880557,2606,2718.233333333333,56.64493359234568,50.81449253669133,NaN,NaN,NaN,NaN,11.833376864783817,10.985038417216343,-5850
2025-09-15T15:40:00-04:00,24279.75,24285.5,24275.25,24278,NaN,NaN,NaN,24297.335304170585,NaN,NaN,24272.82,24290.163309950185,24255.476690049814,24259.242509433556,24217.71276135664,24279.02676078167,24156.39876193161,2643,2702.6666666666665,55.126649439714775,50.923198170845616,NaN,NaN,NaN,NaN,11.72027851729926,10.77697334025649,-8493
2025-09-15T15:45:00-04:00,24277.75,24293,24275.25,24290.5,NaN,NaN,NaN,24297.335304170585,NaN,NaN,24273.33,24291.214753267326,24255.445246732677,24263.119007546844,24218.292909408443,24279.668877033542,24156.916941783344,3971,2723.266666666667,62.79716669152744,52.00806875340113,NaN,NaN,NaN,NaN,12.15097290892074,11.403783331055747,-4522
2025-09-15T15:50:00-04:00,24290.25,24291.75,24265.5,24287.75,NaN,NaN,NaN,24297.335304170585,NaN,NaN,24273.865,24291.842544314262,24255.88745568574,24263.119007546844,24219.277179231576,24280.67678310241,24157.87757536074,7401,2855.3333333333335,60.35293748180652,53.45414538277972,NaN,NaN,NaN,NaN,13.15804627256926,10.715005357073485,-11923
2025-09-15T15:55:00-04:00,24287.5,24315.75,24276,24311.5,24252.569379330915,24252.569379330915,24252.569379330915,NaN,NaN,NaN,24274.545,24295.367989710005,24253.722010289992,24266.25116482998,24221.47843569489,24283.476021270413,24159.48085011937,13177,3231.9333333333334,70.89071494333125,55.22149168526622,NaN,NaN,NaN,NaN,15.057471538814314,12.060527185492319,1254
2025-09-15T16:00:00-04:00,24311.25,24313.5,24292.25,24293.75,24258.640089361328,NaN,NaN,NaN,NaN,NaN,24274.79,24296.21413591937,24253.36586408063,24266.25116482998,24222.256733183032,24284.43308637376,24160.080379992305,4913,3233.6,58.39803371190074,55.693717969071436,NaN,NaN,NaN,NaN,15.499795000327577,13.309940311881238,-3659
2025-09-15T16:05:00-04:00,24294,24300.75,24290,24296.25,24258.640089361328,NaN,NaN,NaN,NaN,NaN,24275.11,24297.31454008142,24252.90545991858,24266.25116482998,24222.578276881006,24284.8074255081,24160.34912825391,2176,3207.0666666666666,59.481088451685075,56.2923062684546,NaN,NaN,NaN,NaN,15.160523928875607,14.193971050764912,-1483
2025-09-15T16:10:00-04:00,24296.5,24296.5,24285.75,24287.5,24258.640089361328,NaN,NaN,NaN,NaN,NaN,24275.46,24297.88194461612,24253.038055383877,24266.25116482998,24222.79512877309,24285.04102620005,24160.54923134613,1605,3163.5,54.165938185875945,56.6705943089497,NaN,NaN,NaN,NaN,14.84548650538449,14.501087677316123,-3088
2025-09-15T16:15:00-04:00,24287.75,24297.25,24286.25,24295.25,24258.640089361328,NaN,NaN,NaN,NaN,NaN,24275.7,24298.699782602693,24252.70021739731,24266.25116482998,24222.900350766464,24285.158723554843,24160.641977978084,749,3104.866666666667,57.765749703729625,57.06541534079529,NaN,NaN,NaN,NaN,14.570808897857026,14.848904355973266,-2339
2025-09-15T16:20:00-04:00,24295,24299,24294.25,24295.25,24258.640089361328,NaN,NaN,NaN,NaN,NaN,24275.885,24299.357155845766,24252.41284415423,24266.25116482998,24222.970153209455,24285.23990049141,24160.7004059275,476,3056.1666666666665,57.765749703729625,57.54643766235437,NaN,NaN,NaN,NaN,13.869322548010095,15.323480393271605,-2339
2025-09-15T16:25:00-04:00,24295.75,24296.5,24289.5,24289.75,24258.640089361328,NaN,NaN,NaN,NaN,NaN,24276.045,24299.78245774822,24252.307542251776,24266.25116482998,24223.045142269704,24285.322495183784,24160.767789355625,544,2963.9333333333334,54.25832654837914,57.661232911837956,NaN,NaN,NaN,NaN,13.37865665172366,15.144128060098904,-2883
2025-09-15T16:30:00-04:00,24290,24294.25,24289.25,24293,24258.640089361328,NaN,NaN,NaN,NaN,NaN,24276.32,24300.513809130003,24252.126190869996,24267.485181882552,24223.11789566572,24285.40280525301,24160.832986078432,527,2884.4,55.95997809131268,57.92177555161337,NaN,NaN,NaN,NaN,12.78018117660054,14.94508574408784,-2356
2025-09-15T16:35:00-04:00,24292.5,24298.5,24291.75,24298,24258.640089361328,NaN,NaN,NaN,NaN,NaN,24276.88,24301.749507427623,24252.01049257238,24273.71314550604,24223.23254981919,24285.53557302897,24160.92952660941,788,2830.4,58.51680932071096,58.34150597888,NaN,NaN,NaN,NaN,12.349453949700502,15.19073341447165,-1568
2025-09-15T16:40:00-04:00,24297.25,24304.25,24296.5,24301.5,24262.60565398706,NaN,NaN,NaN,NaN,NaN,24277.215,24302.936199428867,24251.493800571134,24280.545516404833,24223.407291163036,24285.74854188391,24161.06604044216,1133,2789.633333333333,60.256236489407485,58.74145088253266,NaN,NaN,NaN,NaN,12.020921524721896,15.949721180408174,-435
2025-09-15T16:45:00-04:00,24300.75,24303.75,24298,24299,24264.0383515331,NaN,NaN,NaN,NaN,NaN,24277.505,24303.867186935397,24251.142813064605,24281.911413123868,24223.570075411622,24285.945397259627,24161.194753563617,1067,2739.4333333333334,58.373428863323525,58.864914830459654,NaN,NaN,NaN,NaN,11.572998558670331,16.654495534492096,-1502
2025-09-15T16:50:00-04:00,24299,24304,24297.5,24299,24264.70138100887,NaN,NaN,NaN,NaN,NaN,24277.815,24304.808853001752,24250.821146998245,24283.279130499093,24223.690480461773,24286.090584531892,24161.290376391655,793,2723.9333333333334,58.373428863323525,59.09682764643171,NaN,NaN,NaN,NaN,11.210641518765309,17.22714528548099,-1502
2025-09-15T16:55:00-04:00,24298.25,24301.75,24295,24295.75,24264.70138100887,NaN,NaN,NaN,NaN,NaN,24278.195,24305.64919640315,24250.74080359685,24283.279130499093,24223.82775621124,24286.25086497718,24161.404647445303,940,2676.0666666666666,55.74715868556212,58.593255646005616,NaN,NaN,NaN,NaN,10.89202426742493,17.342909712422852,-2442
2025-09-15T18:00:00-04:00,24536,24537.5,24526,24530.5,24465.05952277874,NaN,NaN,NaN,NaN,NaN,24283.335,24359.090634114073,24207.579365885926,24400.66364351942,24531.33333333333,24531.333678600313,24531.332988066344,1429,2624.5,90.16538496523144,60.72271618053596,NaN,NaN,NaN,NaN,27.381879676894577,22.237807422674,-1013
2025-09-15T18:05:00-04:00,24530.75,24537,24529.25,24532,24468.409089925164,NaN,NaN,NaN,NaN,NaN,24288.66,24391.361010706216,24185.958989293784,24423.655914815536,24531.64496906841,24532.231797309814,24531.058140827005,403,2569.766666666667,90.21773981004725,62.103217956729964,NaN,NaN,NaN,NaN,25.97960255711639,26.783069582192926,-610
2025-09-15T18:10:00-04:00,24533,24535.75,24528,24532.75,24469.043904019472,NaN,NaN,NaN,NaN,NaN,24294.025,24417.118714297372,24170.93128570263,24441.19973185243,24531.750761531766,24532.315150027607,24531.186373035925,466,2390.133333333333,90.24570065421554,64.37805130975245,NaN,NaN,NaN,NaN,24.67748808875093,30.93658287446758,-144
2025-09-15T18:15:00-04:00,24533,24533,24529.25,24530.75,24470.638499291315,NaN,NaN,NaN,NaN,NaN,24299.18,24438.799126197187,24159.560873802813,24455.48478548194,24531.662792931234,24532.24547267692,24531.080113185548,305,2290.8333333333335,89.51094887628501,66.52304134008101,NaN,NaN,NaN,NaN,23.182667510983006,34.79341664586547,-449
2025-09-15T18:20:00-04:00,24530.75,24537,24528.25,24532.25,24473.694703868983,NaN,NaN,NaN,NaN,NaN,24304.505,24458.250682541002,24150.759317459,24470.612828385554,24531.813838161208,24532.431821502374,24531.195854820042,573,2192.1666666666665,89.57947398190416,69.05257961122588,NaN,NaN,NaN,NaN,22.151762688769935,38.394574188247574,124
2025-09-15T18:25:00-04:00,24531.75,24532.25,24527.25,24530,24473.694703868983,NaN,NaN,NaN,NaN,NaN,24309.91,24475.525450970305,24144.294549029695,24476.640262708443,24531.551465901848,24532.435830126273,24530.667101677423,485,2146.0666666666666,88.64398489631151,71.25816783926744,NaN,NaN,NaN,NaN,20.926636782429227,41.67326542994142,-361
2025-09-15T18:30:00-04:00,24529.5,24531.25,24525,24527.25,24473.694703868983,NaN,NaN,NaN,NaN,NaN,24315.23,24491.02754947217,24139.432450527827,24483.637210166755,24530.95322408129,24532.541528347654,24529.36491981493,702,2070.766666666667,87.4420378174644,73.37790270453421,NaN,NaN,NaN,NaN,19.878305583684284,44.56231816112786,-1063
2025-09-15T18:35:00-04:00,24527.25,24531,24526.5,24529.5,24475.44750446381,NaN,NaN,NaN,NaN,NaN,24320.75,24505.549837662318,24135.950162337682,24490.659768133402,24530.755286646072,24532.372227812124,24529.13834548002,492,2011.1666666666667,87.59030049814629,75.75875798666043,NaN,NaN,NaN,NaN,18.77985518484969,47.24500998294384,-571
2025-09-15T18:40:00-04:00,24529.75,24533.75,24529.5,24533,24480.165799715454,NaN,NaN,NaN,NaN,NaN,24326.245,24519.43326284292,24133.05673715708,24499.352814506725,24530.84577735125,24532.442129095092,24529.249425607406,355,1968.7666666666667,87.83097966733126,78.03525809923319,NaN,NaN,NaN,NaN,17.742008385931857,49.75710623180246,-216
2025-09-15T18:45:00-04:00,24532.5,24533.5,24530.75,24532,24482.629854273844,NaN,NaN,NaN,NaN,NaN,24331.62,24532.307524276963,24130.932475723035,24504.60725160538,24530.9069664903,24532.48630843828,24529.32762454232,271,1887.9,87.30995576706667,80.09191141683003,NaN,NaN,NaN,NaN,16.67115064407958,52.08976703431403,-487
2025-09-15T18:50:00-04:00,24532,24533.75,24530,24530.25,24484.11826998867,NaN,NaN,NaN,NaN,NaN,24336.855,24544.227710114723,24129.482289885276,24508.7608012843,24530.922049161094,24532.475203355152,24529.368894967036,201,1829.4,86.34464300258114,81.95536902491385,NaN,NaN,NaN,NaN,15.748211312359611,54.1883135911925,-688
2025-09-15T18:55:00-04:00,24530.25,24532,24526,24530.25,24484.11826998867,NaN,NaN,NaN,NaN,NaN,24341.94,24555.471907686737,24128.40809231326,24509.00864102744,24530.82281220889,24532.36968258501,24529.275941832773,401,1780.5,86.34464300258114,83.9533128920037,NaN,NaN,NaN,NaN,15.051910504333923,55.762447921867555,-688
2025-09-15T19:00:00-04:00,24530.75,24533.75,24528,24531.25,24485.796037324388,NaN,NaN,NaN,NaN,NaN,24347.04,24566.160249178276,24127.919750821726,24512.481912821953,24530.831877502213,24532.339163482062,24529.324591522363,328,1730.6666666666667,86.44397018455098,85.95835155780564,NaN,NaN,NaN,NaN,14.38748832545293,57.24695045812956,-360
2025-09-15T19:05:00-04:00,24531.5,24533.75,24529.5,24529.5,24488.015535627823,NaN,NaN,NaN,NaN,NaN,24351.885,24576.155221162117,24127.61477883788,24514.610530257563,24530.83496167143,24532.314665472626,24529.355257870233,242,1651.8666666666666,85.27498385202671,88.06748192683884,NaN,NaN,NaN,NaN,13.663382016492006,58.625417098944276,-602
2025-09-15T19:10:00-04:00,24530,24533.75,24529.75,24530.5,24489.54323855383,NaN,NaN,NaN,NaN,NaN,24356.76,24585.703070653468,24127.81692934653,24516.31342420605,24530.85377494938,24532.308385527314,24529.399164371447,261,1572.4666666666667,85.39651230026173,87.72684816505527,NaN,NaN,NaN,NaN,12.990997586742578,59.905421836843665,-341
2025-09-15T19:15:00-04:00,24530.75,24540.5,24530.75,24540,24493.973091346837,NaN,NaN,NaN,NaN,NaN,24361.915,24595.475797437342,24128.35420256266,24521.55073936484,24531.591663479114,24534.02425584569,24529.15907111254,929,1471.0666666666666,86.53357105259842,87.46369325380894,NaN,NaN,NaN,NaN,12.777354901975253,61.195804383266115,588
2025-09-15T19:20:00-04:00,24539.75,24546.5,24538.75,24546,24501.809541740164,NaN,NaN,NaN,NaN,NaN,24367.195,24605.184921845303,24129.205078154697,24527.465591491873,24532.652847278794,24536.797378902713,24528.508315654875,750,1249.3666666666666,87.21086888325364,87.24691955588308,NaN,NaN,NaN,NaN,12.418258123262735,62.480518564616595,1338
2025-09-15T19:25:00-04:00,24546.25,24549,24544.25,24546,24507.017062570158,NaN,NaN,NaN,NaN,NaN,24372.605,24614.280797092564,24130.929202907435,24531.397473193498,24533.518902217376,24538.740634218833,24528.29717021592,577,829.3666666666667,87.21086888325364,87.08262812780943,NaN,NaN,NaN,NaN,11.87052540017254,63.709265516003754,1338
2025-09-15T19:30:00-04:00,24545.5,24546.25,24540.25,24544.25,24507.017062570158,NaN,NaN,NaN,NaN,NaN,24378.05,24622.663675005926,24133.436324994072,24531.397473193498,24534.03534726533,24539.584973011577,24528.485721519082,496,682.1333333333333,85.75196233761048,86.8092344389313,NaN,NaN,NaN,NaN,11.451202157303072,64.33906144315644,842
2025-09-15T19:35:00-04:00,24544,24544.75,24540.5,24542.5,24507.017062570158,NaN,NaN,NaN,NaN,NaN,24383.61,24630.276194683884,24136.943805316118,24531.397473193498,24534.300142021722,24539.960322007566,24528.63996203588,309,619.9,84.23445323776804,86.49426789189248,NaN,NaN,NaN,NaN,10.936830574638567,64.92387194694106,533
2025-09-15T19:40:00-04:00,24542.25,24546.75,24540.25,24541.75,24507.017062570158,NaN,NaN,NaN,NaN,NaN,24388.92,24637.53615876789,24140.303841232108,24531.397473193498,24534.64032258065,24540.435858981466,24528.844786179834,410,580.0666666666667,83.55203259651458,86.21641037611035,NaN,NaN,NaN,NaN,10.619914105021525,65.5112107291323,123
2025-09-15T19:45:00-04:00,24542,24543.25,24537.5,24542,24507.017062570158,NaN,NaN,NaN,NaN,NaN,24394.425,24644.16368843329,24144.686311566707,24531.397473193498,24534.87926083735,24540.688918018368,24529.069603656335,411,568.8,83.59972803786151,85.93136948609,NaN,NaN,NaN,NaN,10.272063097519988,65.65654698861884,534
2025-09-15T19:50:00-04:00,24542.25,24545.75,24541.25,24545,24508.75886261084,NaN,NaN,NaN,NaN,NaN,24400.285,24650.131132849423,24150.438867150577,24531.397473193498,24535.170417862268,24541.107206458917,24529.23362926562,356,564.8,84.19211347609755,85.67145047243046,NaN,NaN,NaN,NaN,9.859772876268561,65.86265970147106,890
2025-09-15T19:55:00-04:00,24544.75,24547.25,24544.25,24546,24512.17891431035,NaN,NaN,NaN,NaN,NaN,24405.97,24655.88415806239,24156.055841937614,24533.978163212836,24535.360122717397,24541.410347739762,24529.30989769503,202,553.4,84.39445991085745,85.46320076841552,NaN,NaN,NaN,NaN,9.369789099392236,66.09775071557226,1092
2025-09-15T20:00:00-04:00,24546.75,24547.5,24538.5,24544,24512.17891431035,NaN,NaN,NaN,NaN,NaN,24411.405,24661.27022147055,24161.539778529448,24533.978163212836,24535.930010358737,24542.11126555351,24529.748755163964,874,564.9666666666667,82.13013389222083,85.16216440338978,NaN,NaN,NaN,NaN,9.343375592292789,65.41807826602239,218
2025-09-15T20:05:00-04:00,24544,24544.25,24540.25,24542.75,24512.17891431035,NaN,NaN,NaN,NaN,NaN,24416.84,24666.07384120105,24167.60615879895,24533.978163212836,24536.115019464523,24542.302428556537,24529.92761037251,359,550.6666666666666,80.67326867957264,84.75706623746059,NaN,NaN,NaN,NaN,8.96170590712902,64.78695384858322,-141
2025-09-15T20:10:00-04:00,24542.5,24543.5,24538.75,24540.25,24512.17891431035,NaN,NaN,NaN,NaN,NaN,24422.305,24670.136158048896,24174.473841951105,24533.978163212836,24536.252583879672,24542.400591084213,24530.10457667513,378,525.5,77.70449122880785,84.1328177406218,NaN,NaN,NaN,NaN,8.660869770905517,63.954952993036486,-519
2025-09-15T20:15:00-04:00,24539.5,24542.25,24536.5,24541.5,24512.17891431035,NaN,NaN,NaN,NaN,NaN,24427.675,24673.963798974157,24181.38620102584,24533.978163212836,24536.436808614777,24542.490900441415,24530.38271678814,655,511.76666666666665,78.13770125674131,83.62301184095857,NaN,NaN,NaN,NaN,8.452950501555124,62.80713356695824,136
2025-09-15T20:20:00-04:00,24541.75,24542.25,24538.75,24538.75,24512.17891431035,NaN,NaN,NaN,NaN,NaN,24433.03,24677.092935326415,24188.967064673583,24533.978163212836,24536.53729649435,24542.53172830705,24530.542864681647,405,498.8333333333333,74.69893324660383,82.85889905141157,NaN,NaN,NaN,NaN,8.099168322872616,61.74130124274273,-269
2025-09-15T20:25:00-04:00,24538.75,24539.5,24534.25,24535.5,24512.17891431035,NaN,NaN,NaN,NaN,NaN,24438.265,24679.651607126605,24196.878392873394,24533.978163212836,24536.533473718122,24542.43219651016,24530.634750926085,459,482.8,70.73685243594278,81.73056200736472,NaN,NaN,NaN,NaN,7.895656299810287,59.973016312334096,-728
2025-09-15T20:30:00-04:00,24536,24537,24526.5,24534,24512.17891431035,NaN,NaN,NaN,NaN,NaN,24443.48,24681.62602327232,24205.333976727678,24533.978163212836,24536.270545587533,24542.06003198218,24530.481059192887,1010,468.8333333333333,68.91988943889211,80.42406347562462,NaN,NaN,NaN,NaN,8.081680849823837,57.15429858364336,-1738
2025-09-15T20:35:00-04:00,24534.5,24537,24532.25,24537,24512.17891431035,NaN,NaN,NaN,NaN,NaN,24448.745,24683.260809489046,24214.229190510952,24533.978163212836,24536.247227279382,24541.958810538243,24530.53564402052,435,469.9,70.54922934482565,79.2339463657369,NaN,NaN,NaN,NaN,7.843703646264991,54.5369178355734,-1303
2025-09-15T20:40:00-04:00,24537.25,24542,24535.25,24540.25,24512.17891431035,NaN,NaN,NaN,NaN,NaN,24454.015,24684.64423513726,24223.385764862738,24533.978163212836,24536.33986282495,24541.983347974823,24530.696377675074,522,471.76666666666665,72.24665684716922,78.26928168784823,NaN,NaN,NaN,NaN,7.765581957246064,52.57523101413663,-781
2025-09-15T20:45:00-04:00,24541.25,24546,24537.25,24543.5,24513.41795818366,NaN,NaN,NaN,NaN,NaN,24459.29,24685.76225790359,24232.817742096413,24532.38253057027,24536.67118047586,24542.32023882461,24531.02212212711,977,494.1666666666667,73.86862216534081,77.52886518267486,NaN,NaN,NaN,NaN,7.835897531728487,51.099559398061814,196
2025-09-15T20:50:00-04:00,24544,24546.25,24542,24543.5,24516.620550993495,NaN,NaN,NaN,NaN,NaN,24464.6,24686.218862013313,24242.981137986684,24530.886636544026,24536.818216313448,24542.502227698464,24531.134204928432,361,487.1,73.86862216534081,76.8371930090196,NaN,NaN,NaN,NaN,7.579761993747881,49.75093161535763,196
2025-09-15T20:55:00-04:00,24544.75,24545.25,24541.75,24544.25,24516.768480493793,NaN,NaN,NaN,NaN,NaN,24469.675,24686.687816442893,24252.662183557106,24531.20930923522,24536.90935315655,24542.610813085535,24531.20789322756,237,478.8333333333333,74.27105691426468,76.1708593573341,NaN,NaN,NaN,NaN,7.288350422765889,48.45359555998442,433
2025-09-15T21:00:00-04:00,24544.75,24545.75,24541.5,24544.75,24517.52900410771,NaN,NaN,NaN,NaN,NaN,24474.815,24686.456319453442,24263.173680546555,24532.392447388178,24537.070425589587,24542.804916151923,24531.33593502725,419,469.4,74.55242381808473,75.48231009604748,NaN,NaN,NaN,NaN,7.071325392568326,47.29860862853802,852
2025-09-15T21:05:00-04:00,24545,24551.25,24544.75,24550,24522.203822102812,NaN,NaN,NaN,NaN,NaN,24479.585,24686.996465691765,24272.173534308233,24537.31395791054,24537.515388492084,24543.56389823853,24531.466878745636,736,477.53333333333336,77.35293306760536,74.97934389295804,NaN,NaN,NaN,NaN,7.030516435956303,46.746058626548574,1588
2025-09-15T21:10:00-04:00,24550.25,24556.25,24549.5,24551.75,24527.330921098142,NaN,NaN,NaN,NaN,NaN,24484.745,24686.1571766431,24283.332823356897,24541.726166328433,24538.140495936583,24544.77634723195,24531.504644641216,835,493.53333333333336,78.21360833620143,74.69959206752809,NaN,NaN,NaN,NaN,7.01047954767371,46.644029541437106,2423
2025-09-15T21:15:00-04:00,24551.75,24553.75,24550,24550.75,24527.330921098142,NaN,NaN,NaN,NaN,NaN,24489.835,24684.692219779256,24294.977780220743,24541.726166328433,24538.42401792991,24545.265606092158,24531.58242976766,434,498.96666666666664,76.42623023336017,74.3962321785129,NaN,NaN,NaN,NaN,6.777588151411302,46.54928824811931,1989
2025-09-15T21:20:00-04:00,24550.25,24551.5,24549,24550.75,24527.330921098142,NaN,NaN,NaN,NaN,NaN,24495.1,24681.862282060836,24308.33771793916,24541.726166328433,24538.641668267075,24545.60734635671,24531.67599017744,378,504.8666666666667,76.42623023336017,74.3049278216952,NaN,NaN,NaN,NaN,6.472046140596208,46.237016643900546,1989
2025-09-15T21:25:00-04:00,24551,24553.5,24548,24548.75,24527.330921098142,NaN,NaN,NaN,NaN,NaN,24500.17,24678.530293789274,24321.809706210723,24541.726166328433,24538.910423210964,24546.008573460716,24531.81227296121,501,508.2,72.57903132495059,73.90787996942444,NaN,NaN,NaN,NaN,6.402614273410764,46.13072977342291,1488
2025-09-15T21:30:00-04:00,24549,24553,24548.5,24552.75,24527.458202740112,NaN,NaN,NaN,NaN,NaN,24505.32,24674.341005795053,24336.298994204946,24541.726166328433,24539.042696881133,24546.218182808927,24531.86721095334,228,504.8666666666667,75.2612525152309,73.94804563146923,NaN,NaN,NaN,NaN,6.2667132538814245,46.0320348222651,1716
2025-09-15T21:35:00-04:00,24552.25,24556.5,24551.5,24555.5,24531.08510261556,NaN,NaN,NaN,NaN,NaN,24510.635,24668.555587955827,24352.71441204417,24544.2728301825,24539.52816843398,24547.087196948392,24531.969139919565,699,520.1,76.93188632159203,74.39054805187276,NaN,NaN,NaN,NaN,6.176233735747037,46.26711358274475,2415
2025-09-15T21:40:00-04:00,24555.5,24561.5,24551.25,24560.75,24533.10396158758,NaN,NaN,NaN,NaN,NaN,24515.99,24661.71552830497,24370.264471695034,24546.593264146002,24540.550126562586,24549.012491498404,24532.087761626768,1316,555.2666666666667,79.74420279630898,75.16371329168824,NaN,NaN,NaN,NaN,6.467217040336535,46.894352855475944,3731
2025-09-15T21:45:00-04:00,24560.75,24562.75,24558.25,24558.75,24537.673099697236,NaN,NaN,NaN,NaN,NaN,24521.205,24653.38611400465,24389.023885995353,24548.5746113168,24541.111753034547,24550.06140287658,24532.162103192513,704,547.7666666666667,75.94571480490434,75.54917653883672,NaN,NaN,NaN,NaN,6.326701537455354,47.57156976166324,3027
2025-09-15T21:50:00-04:00,24559.25,24560,24553.5,24555.5,24537.673099697236,NaN,NaN,NaN,NaN,NaN,24526.285,24642.908711569682,24409.661288430318,24548.5746113168,24541.42134449825,24550.53637499759,24532.306313998906,504,539.5666666666667,70.10211076814574,75.39599467604933,NaN,NaN,NaN,NaN,6.339079999065686,46.99653638249376,2523
2025-09-15T21:55:00-04:00,24555.25,24558.25,24553.25,24556.25,24537.673099697236,NaN,NaN,NaN,NaN,NaN,24531.43,24628.5606357424,24434.2993642576,24548.5746113168,24541.6827025956,24550.91882188353,24532.446583307672,455,535.5,70.66309973070162,75.16702878786081,NaN,NaN,NaN,NaN,6.243431427703852,46.40206504327372,2978
2025-09-15T22:00:00-04:00,24556.5,24558,24553.75,24558,24537.673099697236,NaN,NaN,NaN,NaN,NaN,24536.61,24607.755004040497,24465.464995959504,24548.5746113168,24541.81902452751,24551.12161327172,24532.516435783302,233,526.7333333333333,71.98403298652762,75.03241527508844,NaN,NaN,NaN,NaN,6.101043468582148,45.8500559425694,3211
2025-09-15T22:05:00-04:00,24557.75,24559.75,24555.75,24558,24537.673099697236,NaN,NaN,NaN,NaN,NaN,24541.855,24560.485375732773,24523.224624267226,24548.5746113168,24541.958647957857,24551.339486841644,24532.57780907407,224,523.9,71.98403298652762,74.86905642310724,NaN,NaN,NaN,NaN,5.9509689351119945,45.54326177229627,3211
2025-09-15T22:10:00-04:00,24557.75,24561.75,24557.5,24560.25,24538.578222338456,NaN,NaN,NaN,NaN,NaN,24542.45,24561.48759438134,24523.412405618663,24549.40880863629,24542.28043738613,24551.87544911058,24532.68542566168,471,525.9333333333333,73.74667759829192,74.81150312169345,NaN,NaN,NaN,NaN,5.829471154032567,45.48656431824023,3682
2025-09-15T22:15:00-04:00,24560.25,24564.75,24560.25,24563,24541.796257686707,NaN,NaN,NaN,NaN,NaN,24543.07,24562.715365868917,24523.424634131083,24552.62704690903,24542.721826465233,24552.66538572806,24532.778267202404,579,531.5333333333333,75.75449935407927,74.69732928501301,NaN,NaN,NaN,NaN,5.734508928744527,45.75410129920085,4261
2025-09-15T22:20:00-04:00,24563,24564.5,24561,24563.25,24542.510064155493,NaN,NaN,NaN,NaN,NaN,24543.68,24563.891640217837,24523.468359782164,24553.051637527224,24542.935520571256,24553.039874737075,24532.831166405438,286,529.2,75.93468674681542,74.53454917148544,NaN,NaN,NaN,NaN,5.574901148119918,46.00252849580714,4547
2025-09-15T22:25:00-04:00,24563,24566.25,24561.25,24565.25,24543.74824305752,NaN,NaN,NaN,NaN,NaN,24544.37,24565.11734682333,24523.62265317667,24554.59131002178,24543.453359084506,24553.95987082553,24532.946847343483,673,544.9,77.38281324165283,74.60287652922064,NaN,NaN,NaN,NaN,5.533836780397067,46.421894138301504,5220
2025-09-15T22:30:00-04:00,24565,24584,24565,24580,24552.816504736722,NaN,NaN,NaN,NaN,NaN,24545.325,24568.054111282978,24522.595888717024,24565.173048017423,24546.327134260173,24560.000825563213,24532.653442957133,2653,604.2,84.69668346071941,75.19362318831772,NaN,NaN,NaN,NaN,6.495705581797276,48.05704827894527,7873
2025-09-15T22:35:00-04:00,24579.5,24580,24573,24574.75,24554.847572703235,NaN,NaN,NaN,NaN,NaN,24546.22,24569.966292336827,24522.473707663175,24565.173048017423,24547.049897152403,24561.307059629893,24532.792734674913,760,617.5666666666667,75.35600354745306,75.3919783470679,NaN,NaN,NaN,NaN,6.5317266116688995,49.575405695257324,7113
2025-09-15T22:40:00-04:00,24575,24575,24569.5,24572.25,24554.847572703235,NaN,NaN,NaN,NaN,NaN,24547.12,24571.328725696825,24522.911274303173,24565.173048017423,24547.409955647072,24561.877377020937,24532.942534273207,451,620,71.32231022618606,75.11062532642184,NaN,NaN,NaN,NaN,6.458031853692549,50.059758477224214,6662
2025-09-15T22:45:00-04:00,24573.25,24573.25,24569.25,24572.25,24554.847572703235,NaN,NaN,NaN,NaN,NaN,24547.975,24572.64932876957,24523.300671230427,24565.173048017423,24547.630775991962,24562.214448714054,24533.04710326987,291,607.8666666666667,71.32231022618606,74.70994131960713,NaN,NaN,NaN,NaN,6.282458149857367,50.44415191353105,6662
2025-09-15T22:50:00-04:00,24571.75,24574.5,24571.25,24572.5,24554.847572703235,NaN,NaN,NaN,NaN,NaN,24548.765,24573.994032885203,24523.535967114796,24565.173048017423,24547.787496880457,24562.45953511528,24533.115458645636,200,601.0333333333333,71.4992440098468,74.1210156920027,NaN,NaN,NaN,NaN,6.065853996296126,50.89832469827006,6862
2025-09-15T22:55:00-04:00,24571.75,24572.25,24567.75,24571,24554.847572703235,NaN,NaN,NaN,NaN,NaN,24549.545,24575.062384278663,24524.027615721334,24565.173048017423,24548.037194714376,24562.81731234304,24533.257077085713,359,597.7,68.75813307336085,73.60761699689245,NaN,NaN,NaN,NaN,5.971864425132117,50.37530213560394,6503
2025-09-15T23:00:00-04:00,24572,24574,24570,24573.75,24554.847572703235,NaN,NaN,NaN,NaN,NaN,24550.415,24576.20639585666,24524.62360414334,24565.173048017423,24548.29791736613,24563.213120902543,24533.382713829717,348,575.6333333333333,70.95650023774606,73.66864481614961,NaN,NaN,NaN,NaN,5.831016966194109,50.0647412470289,6851
2025-09-15T23:05:00-04:00,24573.75,24577.25,24573.25,24576.5,24555.78209853681,NaN,NaN,NaN,NaN,NaN,24551.34,24577.487229296945,24525.192770703055,24565.173048017423,24548.610896546168,24563.72338076076,24533.498412331577,379,573.7666666666667,73.00235069473104,73.83573417072314,NaN,NaN,NaN,NaN,5.700230040037387,50.084572411086704,7230
2025-09-15T23:10:00-04:00,24577.5,24579.25,24575.5,24576.5,24558.280639512406,NaN,NaN,NaN,NaN,NaN,24552.245,24578.678972459293,24525.811027540705,24567.34450239967,24548.82321833228,24564.077211621603,24533.569225042957,249,564.6666666666666,73.00235069473104,73.90847114988053,NaN,NaN,NaN,NaN,5.5609278943204306,50.28145848220089,7230
2025-09-15T23:15:00-04:00,24576.5,24577.75,24574.5,24576,24558.280639512406,NaN,NaN,NaN,NaN,NaN,24553.175,24579.614600985034,24526.735399014964,24567.34450239967,24548.986331070882,24564.3392426914,24533.633419450365,201,538.8,71.93387397411698,73.90488836327977,NaN,NaN,NaN,NaN,5.3958616161546855,50.17629799336451,7029
2025-09-15T23:20:00-04:00,24575.75,24577.5,24573.75,24575.5,24558.280639512406,NaN,NaN,NaN,NaN,NaN,24554.075,24580.429363960666,24527.720636039336,24567.34450239967,24549.1413995679,24564.582835227615,24533.699963908184,197,533.3333333333334,70.81764223652146,73.69567155172474,NaN,NaN,NaN,NaN,5.278300072143637,49.856907284388264,6832
2025-09-15T23:25:00-04:00,24576.25,24581,24575.75,24579.5,24560.125927641286,NaN,NaN,NaN,NaN,NaN,24554.865,24581.84503149721,24527.884968502793,24569.61438522863,24549.4681115729,24565.132519298248,24533.803703847552,377,538,74.25893833570143,73.58884576469775,NaN,NaN,NaN,NaN,5.294135781276234,49.928348876849675,7209
2025-09-15T23:30:00-04:00,24579.5,24587.75,24578.25,24584.5,24564.284976384864,NaN,NaN,NaN,NaN,NaN,24555.635,24583.733435899027,24527.53656410097,24573.891508182904,24550.2286605431,24566.513454380933,24533.943866705267,781,550.0666666666667,77.7853698099083,73.72103741206152,NaN,NaN,NaN,NaN,5.594554654042217,50.57260302908897,7990
2025-09-15T23:35:00-04:00,24584,24584.5,24578.75,24581.5,24564.284976384864,NaN,NaN,NaN,NaN,NaN,24556.345,24585.217112839924,24527.47288716008,24573.891508182904,24550.710999351977,24567.324423577615,24534.09757512634,546,543.7333333333333,71.45970538236263,73.29795827925508,NaN,NaN,NaN,NaN,5.605657893039202,51.170839027596884,7444
2025-09-15T23:40:00-04:00,24582.25,24584.75,24581,24581.5,24564.562860714308,NaN,NaN,NaN,NaN,NaN,24557.09,24586.59080676511,24527.58919323489,24573.891508182904,24550.94596780207,24567.719608611587,24534.17232699255,265,524.7333333333333,71.45970538236261,72.35245984508674,NaN,NaN,NaN,NaN,5.473110900679258,51.74693519035013,7444
2025-09-15T23:45:00-04:00,24582,24586.25,24579.5,24584.75,24564.562860714308,NaN,NaN,NaN,NaN,NaN,24557.935,24588.128014087528,24527.741985912475,24573.891508182904,24551.282040814436,24568.290216237743,24534.27386539113,373,522.7,74.1054508193591,72.26313465022288,NaN,NaN,NaN,NaN,5.564317264916454,52.281881627192426,7817
2025-09-15T23:50:00-04:00,24585,24585.25,24578.75,24581.75,24564.562860714308,NaN,NaN,NaN,NaN,NaN,24558.735,24589.287808383404,24528.182191616597,24573.891508182904,24551.61415984522,24568.824793825628,24534.40352586481,396,523.3,67.85259199398661,72.0152976336372,NaN,NaN,NaN,NaN,5.63115174599385,52.507350167738664,7421
2025-09-15T23:55:00-04:00,24582.25,24586.75,24582,24585.25,24566.081614206912,NaN,NaN,NaN,NaN,NaN,24559.6,24590.65350222071,24528.546497779287,24573.891508182904,24551.927861539705,24569.35384349242,24534.50187958699,350,518.2666666666667,70.93397437448698,71.98755935851584,NaN,NaN,NaN,NaN,5.58606947842286,52.87223010940279,7771
2025-09-16T00:00:00-04:00,24585,24585.5,24581.5,24583.25,24566.081614206912,NaN,NaN,NaN,NaN,NaN,24560.365,24591.824054341592,24528.90594565841,24573.891508182904,24552.176918834568,24569.75655278944,24534.597284879696,294,520.4666666666667,66.98294287908828,71.66496642060453,NaN,NaN,NaN,NaN,5.472778801392655,53.016991119948585,7477
2025-09-16T00:05:00-04:00,24583.25,24584.25,24580.5,24582.25,24566.081614206912,NaN,NaN,NaN,NaN,NaN,24561.09,24592.86070348161,24529.31929651839,24573.891508182904,24552.42633823359,24570.14488387363,24534.70779259355,310,507.5,65.03246468471575,71.39884724998701,NaN,NaN,NaN,NaN,5.349723172721752,52.75535334001449,7167
2025-09-16T00:10:00-04:00,24582.25,24582.5,24577,24578.25,24566.081614206912,NaN,NaN,NaN,NaN,NaN,24561.775,24593.519172687877,24530.030827312126,24573.891508182904,24552.710280168238,24570.547301046117,24534.873259290358,401,477,57.784250260043905,70.45797225157972,NaN,NaN,NaN,NaN,5.360457231813055,51.24412749752479,6766
2025-09-16T00:15:00-04:00,24577.75,24581,24577.5,24579.25,24566.081614206912,NaN,NaN,NaN,NaN,NaN,24562.505,24594.1441355715,24530.865864428502,24573.891508182904,24552.896719091303,24570.808657938414,24534.98478024419,268,462.46666666666664,59.01412181167178,69.4588130456469,NaN,NaN,NaN,NaN,5.227567429540694,49.84084635807006,7034
2025-09-16T00:20:00-04:00,24579,24585,24579,24583.75,24566.081614206912,NaN,NaN,NaN,NaN,NaN,24563.375,24594.910575146623,24531.839424853377,24572.811249401373,24553.18034425463,24571.23890751013,24535.12178099913,368,457.93333333333334,64.08474563987706,68.82184125601448,NaN,NaN,NaN,NaN,5.282741184573502,49.20288404839761,7402
2025-09-16T00:25:00-04:00,24583.25,24583.25,24580,24580.75,24566.081614206912,NaN,NaN,NaN,NaN,NaN,24564.16,24595.431354306682,24532.888645693318,24572.811249401373,24553.278671771914,24571.382021464025,24535.175322079802,135,447.26666666666665,58.85695306176401,67.8877754765607,NaN,NaN,NaN,NaN,5.173259671389681,48.610490475130334,7267
2025-09-16T00:30:00-04:00,24580.5,24581,24577,24580.5,24566.081614206912,NaN,NaN,NaN,NaN,NaN,24564.995,24595.73284150519,24534.25715849481,24572.811249401373,24553.464576536768,24571.63729840607,24535.291854667466,276,448.7,58.42919615382684,67.00288647065395,NaN,NaN,NaN,NaN,5.08945540914756,46.99484348267128,6991
2025-09-16T00:35:00-04:00,24581,24583,24579.25,24581.75,24566.081614206912,NaN,NaN,NaN,NaN,NaN,24565.92,24595.824086681474,24536.015913318523,24572.811249401373,24553.77114560574,24572.07591704191,24535.46637416957,433,455.6666666666667,59.99476014078474,65.98401659958846,NaN,NaN,NaN,NaN,4.993780022779878,45.86802251460173,7424
2025-09-16T00:40:00-04:00,24581,24584.75,24580.25,24582.25,24566.081614206912,NaN,NaN,NaN,NaN,NaN,24566.885,24595.700830725007,24538.06916927499,24573.637276243495,24553.90731142014,24572.274508675117,24535.54011416516,188,446.23333333333335,60.6333984975791,64.75887579156496,NaN,NaN,NaN,NaN,4.958510021152743,45.12830190292751,7612
2025-09-16T00:45:00-04:00,24582,24582.75,24578.5,24579,24566.081614206912,NaN,NaN,NaN,NaN,NaN,24567.725,24595.434610250395,24540.015389749602,24573.637276243495,24554.008840419097,24572.41244758002,24535.605233258175,154,432.06666666666666,54.53884243769417,63.550242724088626,NaN,NaN,NaN,NaN,4.907902162498976,43.831830175381945,7458
2025-09-16T00:50:00-04:00,24579,24580.5,24577,24579.5,24566.081614206912,NaN,NaN,NaN,NaN,NaN,24568.51,24595.269289982232,24541.750710017765,24573.637276243495,24554.18881276255,24572.647388231057,24535.730237294043,288,432.1333333333333,55.283521404535065,62.39480101138666,NaN,NaN,NaN,NaN,4.807337722320478,42.12967142801819,7746
2025-09-16T00:55:00-04:00,24579,24581.25,24578.75,24580,24566.081614206912,NaN,NaN,NaN,NaN,NaN,24569.24,24595.210167495476,24543.269832504528,24573.637276243495,24554.2967878486,24572.79189521324,24535.801680483964,168,415.3,56.05867265627769,61.10574542830942,NaN,NaN,NaN,NaN,4.642527885011872,40.71327960937326,7914
2025-09-16T01:00:00-04:00,24580.25,24583.75,24577.25,24580.75,24566.081614206912,NaN,NaN,NaN,NaN,NaN,24569.985,24595.08129653988,24544.88870346012,24573.637276243495,24554.566928309137,24573.156756704153,24535.977099914122,417,340.76666666666665,57.255616719035004,60.348818622955726,NaN,NaN,NaN,NaN,4.775204464653881,39.91697985932277,8331
2025-09-16T01:05:00-04:00,24580.75,24586.5,24579.25,24585,24566.798074167207,NaN,NaN,NaN,NaN,NaN,24570.8,24595.135570678885,24546.464429321113,24574.067182679468,24554.821396000258,24573.526208897358,24536.116583103158,359,327.4,63.348282603793066,59.80698349647759,NaN,NaN,NaN,NaN,4.951975574321461,39.679237993025325,8690
2025-09-16T01:10:00-04:00,24584.75,24593.25,24584,24590.25,24572.01747988688,NaN,NaN,NaN,NaN,NaN,24571.71,24595.47728003443,24547.94271996557,24578.678746143574,24555.726508736872,24574.98571155331,24536.467305920436,1108,349.3,69.19039032016487,59.96465831369734,NaN,NaN,NaN,NaN,5.258977319012785,40.403314083552516,9798
2025-09-16T01:15:00-04:00,24590.25,24591.75,24582.75,24584.75,24572.01747988688,NaN,NaN,NaN,NaN,NaN,24572.405,24595.618119132105,24549.191880867893,24578.678746143574,24556.238992313323,24575.737419219106,24536.74056540754,714,363.4,58.64434897074522,59.508364334128025,NaN,NaN,NaN,NaN,5.526193224797586,40.648267356324915,9084
2025-09-16T01:20:00-04:00,24584.75,24588,24582,24587.5,24572.01747988688,NaN,NaN,NaN,NaN,NaN,24573.12,24595.94328635444,24550.29671364556,24578.678746143574,24556.524825323293,24576.14354060247,24536.906110044118,417,370.6333333333333,61.78107671157589,59.79385193780888,NaN,NaN,NaN,NaN,5.560036565883473,40.61725628421998,9501
2025-09-16T01:25:00-04:00,24587.25,24590.75,24585.25,24589.5,24572.01747988688,NaN,NaN,NaN,NaN,NaN,24573.895,24596.254134600804,24551.535865399197,24578.678746143574,24556.95011845723,24576.77920232088,24537.12103459358,582,378.06666666666666,63.92416629020484,60.14456940056124,NaN,NaN,NaN,NaN,5.555748239748938,40.974356676371144,10083
2025-09-16T01:30:00-04:00,24589,24589.5,24583.25,24585,24572.01747988688,NaN,NaN,NaN,NaN,NaN,24574.58,24596.145351833886,24553.014648166118,24578.678746143574,24557.210564161793,24577.138776624826,24537.28235169876,397,379.7,56.27762807963369,59.58691814625814,NaN,NaN,NaN,NaN,5.605337651195443,40.618459366715406,9686
2025-09-16T01:35:00-04:00,24584.75,24589,24584.25,24589,24572.01747988688,NaN,NaN,NaN,NaN,NaN,24575.385,24596.01827652143,24554.751723478566,24578.678746143574,24557.482422474088,24577.524809502193,24537.440035445983,401,380.43333333333334,60.76976384925852,59.72354748822204,NaN,NaN,NaN,NaN,5.544242104681483,40.28798329346365,10087
2025-09-16T01:40:00-04:00,24588.75,24592,24586.25,24590.5,24572.079183498587,NaN,NaN,NaN,NaN,NaN,24576.14,24596.158531415582,24556.121468584417,24578.678746143574,24557.78149041668,24577.9672720232,24537.59570881016,419,386.1,62.332659797390086,60.00236631990513,NaN,NaN,NaN,NaN,5.558939097204234,40.452613614663406,10506
2025-09-16T01:45:00-04:00,24589.75,24594,24586,24594,24572.63808424865,NaN,NaN,NaN,NaN,NaN,24576.91,24596.653545781377,24557.166454218623,24578.678746143574,24558.080202227215,24578.42156936974,24537.73883508469,404,392.8666666666667,65.7603382699478,60.414193329131066,NaN,NaN,NaN,NaN,5.733300590261074,40.888158759108634,10910
2025-09-16T01:50:00-04:00,24593.25,24602,24593,24599.25,24579.699989510078,NaN,NaN,NaN,NaN,NaN,24577.68,24597.841111076938,24557.518888923063,24584.8880788666,24559.239241847125,24580.376993995982,24538.101489698267,1354,431.43333333333334,70.14845241335846,61.093840037401016,NaN,NaN,NaN,NaN,5.9666362623852836,42.166741243405454,12264
2025-09-16T01:55:00-04:00,24598.5,24599,24593,24594.5,24579.699989510078,NaN,NaN,NaN,NaN,NaN,24578.395,24598.354731953565,24558.435268046436,24584.8880788666,24559.598776483046,24580.936117424215,24538.261435541877,468,434.46666666666664,62.361237432911636,61.6525825370594,NaN,NaN,NaN,NaN,5.9868765293577635,43.35399640739536,11796
2025-09-16T02:00:00-04:00,24594.75,24603,24594,24600.5,24580.240589615587,NaN,NaN,NaN,NaN,NaN,24579.295,24599.101738752866,24559.48826124713,24585.048370474622,24560.306816132605,24582.093267869175,24538.520364396034,860,437.1,67.29936772126013,62.51085727396834,NaN,NaN,NaN,NaN,6.202099634403638,44.80147723498838,12656
2025-09-16T02:05:00-04:00,24600,24600.5,24596,24599.25,24580.240589615587,NaN,NaN,NaN,NaN,NaN,24580.155,24599.61570143144,24560.694298568556,24585.048370474622,24560.6000289071,24582.55795850977,24538.642099304434,371,431.26666666666665,65.37502457039989,63.17631098211992,NaN,NaN,NaN,NaN,6.080521089089092,46.145566574896186,12285
2025-09-16T02:10:00-04:00,24599.5,24603.75,24597.25,24601.5,24582.39070252164,NaN,NaN,NaN,NaN,NaN,24581.025,24600.334906769996,24561.715093230006,24587.210957103758,24561.061546207275,24583.309586060364,24538.813506354185,562,441.1666666666667,67.19342535727415,63.88615445627987,NaN,NaN,NaN,NaN,6.110483868439871,47.65211853932418,12847
2025-09-16T02:15:00-04:00,24601.75,24602.5,24598.5,24601,24582.668397861566,NaN,NaN,NaN,NaN,NaN,24581.885,24600.84343084401,24562.92656915599,24587.268765683006,24561.40771539369,24583.86298598273,24538.952444804647,432,443.1333333333333,66.35940853062486,64.10123487962498,NaN,NaN,NaN,NaN,5.959735020694166,49.05105964915018,12415
2025-09-16T02:20:00-04:00,24601,24603.25,24596.75,24597.25,24582.668397861566,NaN,NaN,NaN,NaN,NaN,24582.625,24601.02805681493,24564.22194318507,24587.815012546405,24561.718428110864,24584.339003759625,24539.097852462102,411,443.6333333333333,60.312906077913,63.46712886232128,NaN,NaN,NaN,NaN,5.998325376358869,49.651494951269584,12004
2025-09-16T02:25:00-04:00,24597,24597.5,24591.75,24593.75,24582.668397861566,NaN,NaN,NaN,NaN,NaN,24583.24,24601.02340799548,24565.456592004524,24587.815012546405,24562.15682305585,24584.93660682009,24539.377039291612,679,454.6,55.25260939549293,63.22486174980327,NaN,NaN,NaN,NaN,5.980587849476093,48.49388891989053,11325
2025-09-16T02:30:00-04:00,24593.75,24594,24585,24587.75,24582.668397861566,NaN,NaN,NaN,NaN,NaN,24583.73,24600.610414701583,24566.849585298416,24587.815012546405,24562.689517406845,24585.549083453803,24539.829951359887,1026,479,47.842162246615665,62.22922500230611,NaN,NaN,NaN,NaN,6.196260145942086,45.68918115406142,10299
2025-09-16T02:35:00-04:00,24587.5,24590,24585.5,24588.5,24582.668397861566,NaN,NaN,NaN,NaN,NaN,24584.195,24600.275513052988,24568.11448694701,24587.815012546405,24562.879114513118,24585.75723044736,24540.000998578875,389,481.6333333333333,48.7671475947918,61.1465808097766,NaN,NaN,NaN,NaN,6.075098706946222,43.084809657220106,10688
2025-09-16T02:40:00-04:00,24588.5,24595.75,24586.5,24593.25,24582.668397861566,NaN,NaN,NaN,NaN,NaN,24584.46,24600.691253814988,24568.22874618501,24587.815012546405,24563.229977932915,24586.188668402676,24540.271287463154,637,489.5,54.2954494312207,61.004996620604246,NaN,NaN,NaN,NaN,6.301877370735778,41.65219010656232,11325
2025-09-16T02:45:00-04:00,24593.5,24593.75,24588.75,24589.5,24582.668397861566,NaN,NaN,NaN,NaN,NaN,24584.755,24600.804763242217,24568.705236757785,24587.815012546405,24563.421230353626,24586.413358728983,24540.42910197827,369,492.8666666666667,49.73288312262236,60.21664799727309,NaN,NaN,NaN,NaN,6.2088861299689375,40.32190052380866,10956
2025-09-16T02:50:00-04:00,24589.25,24591.5,24587.75,24589.25,24582.668397861566,NaN,NaN,NaN,NaN,NaN,24585.095,24600.78700113777,24569.40299886223,24587.815012546405,24563.61826712161,24586.63442501285,24540.602109230367,403,494.03333333333336,49.43463991864179,59.29536086307679,NaN,NaN,NaN,NaN,6.033251406399728,38.825179201851824,10553
2025-09-16T02:55:00-04:00,24588.75,24590,24585.5,24588.25,24582.668397861566,NaN,NaN,NaN,NaN,NaN,24585.415,24600.693288509425,24570.136711490577,24587.815012546405,24563.791497586328,24586.81639802997,24540.766597142687,383,502.3,48.1897630846659,58.040319778413796,NaN,NaN,NaN,NaN,5.923733448799747,36.8620284308828,10170
2025-09-16T03:00:00-04:00,24588.5,24595.75,24585,24595.5,24582.668397861566,NaN,NaN,NaN,NaN,NaN,24585.875,24600.953875950905,24570.796124049095,24587.815012546405,24564.413177313734,24587.558342712895,24541.268011914573,1207,533.3333333333334,56.702685252651364,57.07990783836329,NaN,NaN,NaN,NaN,6.268466773885479,36.02805277062508,11377
2025-09-16T03:05:00-04:00,24595,24595.5,24582,24590.25,NaN,NaN,NaN,24605.57554110011,24605.57554110011,24605.57554110011,24586.26,24600.7723947212,24571.747605278797,24587.815012546405,24564.96148082868,24588.13883944122,24541.784122216137,1240,560.2333333333333,50.262305575421955,56.21569841997117,NaN,NaN,NaN,NaN,6.785004861465088,34.532339611136074,10137
2025-09-16T03:10:00-04:00,24590.75,24604.5,24589.75,24600.25,NaN,NaN,NaN,24605.57554110011,NaN,NaN,24586.79,24601.37161854971,24572.20838145029,24582.277010037124,24566.007516322952,24589.542743419213,24542.47228922669,1827,614.8666666666667,59.66083892454667,55.670089220205924,NaN,NaN,NaN,NaN,7.353933085646154,34.39734278174026,11964
2025-09-16T03:15:00-04:00,24600.25,24607.75,24593.25,24604.75,24578.8515798584,24578.8515798584,24578.8515798584,NaN,NaN,NaN,24587.355,24602.477198917382,24572.232801082617,24581.75068396305,24566.76870400998,24590.6207398851,24542.91666813486,1256,651.6,63.04495584670363,55.503655739941905,NaN,NaN,NaN,NaN,7.864366436671429,34.63001572481902,13220
2025-09-16T03:20:00-04:00,24605.25,24614.5,24595.25,24607.5,24581.585598955746,NaN,NaN,NaN,NaN,NaN,24587.975,24603.792158416174,24572.157841583823,24584.075547170443,24568.448926858404,24593.087746085814,24543.810107630994,2669,730.9666666666667,64.97851692128069,55.345447994513805,NaN,NaN,NaN,NaN,8.677625976909185,35.48150916108079,15889
2025-09-16T03:25:00-04:00,24607.25,24611.75,24605.25,24609.75,24585.38284445776,NaN,NaN,NaN,NaN,NaN,24588.65,24605.227695849993,24572.07230415001,24584.160437736355,24568.956169167705,24593.850580988004,24544.061757347405,786,751.5666666666667,66.5219195150625,55.35705592197364,NaN,NaN,NaN,NaN,8.522081264272815,36.27218163760958,16675
2025-09-16T03:30:00-04:00,24609.75,24615.75,24606.5,24614.5,24587.79726061877,NaN,NaN,NaN,NaN,NaN,24589.43,24607.093816117093,24571.766183882908,24589.053350189082,24569.479992122873,24594.672001995197,24544.28798225055,768,763.2666666666667,69.57074002794201,56.018329775547144,NaN,NaN,NaN,NaN,8.5740754596819,37.34734112494141,17443
2025-09-16T03:35:00-04:00,24614.5,24617.75,24608.75,24612.75,24589.755339681553,NaN,NaN,NaN,NaN,NaN,24590.095,24608.692282061373,24571.49771793863,24591.892680151268,24570.206815799385,24595.804125528393,24544.609506070377,1076,787.1666666666666,67.14462340536514,56.86775934768087,NaN,NaN,NaN,NaN,8.604498641133192,38.50523091956345,16367
2025-09-16T03:40:00-04:00,24613.25,24614.25,24604.25,24609.5,24589.755339681553,NaN,NaN,NaN,NaN,NaN,24590.595,24609.894712431946,24571.295287568057,24591.892680151268,24570.717104458432,24596.53148553211,24544.902723384756,853,778.6666666666666,62.76692442893068,57.9338137892748,NaN,NaN,NaN,NaN,8.70417730962368,38.48297747028618,15514
2025-09-16T03:45:00-04:00,24609.5,24610,24603.75,24606.75,24589.755339681553,NaN,NaN,NaN,NaN,NaN,24591.1,24610.73975560609,24571.460244393907,24591.892680151268,24571.119002620693,24597.06741975392,24545.170585487467,736,779.4,59.246987041629055,58.68237374976318,NaN,NaN,NaN,NaN,8.528878930364845,38.34553330584418,14778
2025-09-16T03:50:00-04:00,24605.75,24606.5,24595.75,24601.25,24589.755339681553,NaN,NaN,NaN,NaN,NaN,24591.495,24611.140989413027,24571.84901058697,24591.892680151268,24571.51619520782,24597.519980416397,24545.512409999243,886,795.0333333333333,52.861969321768456,58.57998231337374,NaN,NaN,NaN,NaN,8.705387578195928,36.56620147480574,13892
2025-09-16T03:55:00-04:00,24601,24604.25,24598.5,24602.25,24589.755339681553,NaN,NaN,NaN,NaN,NaN,24591.845,24611.62096772885,24572.069032271153,24591.892680151268,24571.730136039296,24597.76479281958,24545.69547925901,479,791.6,53.83610681412624,58.87306971990973,NaN,NaN,NaN,NaN,8.494288465467648,34.91396477455576,14371
2025-09-16T04:00:00-04:00,24602.5,24625.5,24601.25,24622.75,24589.755339681553,NaN,NaN,NaN,NaN,NaN,24592.665,24614.034513326147,24571.295486673855,24595.434073431967,24573.32647866934,24600.20686000306,24546.446097335618,2496,861.5666666666667,68.29911781432699,60.220532426744356,NaN,NaN,NaN,NaN,9.619696432219959,35.499469192591945,16867
2025-09-16T04:05:00-04:00,24622,24635.25,24620.25,24632.5,24600.96827811544,NaN,NaN,NaN,NaN,NaN,24593.61,24617.60232377039,24569.617676229613,24603.697258745575,24575.25026325106,24603.565982779866,24546.93454372225,2490,931.2,72.68270300799279,61.97002813555342,NaN,NaN,NaN,NaN,10.004003829918533,36.631771197836514,19357
2025-09-16T04:10:00-04:00,24633,24635.25,24628,24634,24605.071992746558,NaN,NaN,NaN,NaN,NaN,24594.625,24620.958106536935,24568.291893463065,24606.38280699646,24575.90741106898,24604.71189274841,24547.102929389548,843,945.3333333333334,73.29453140862036,63.15516000383692,NaN,NaN,NaN,NaN,9.807289270638638,37.68319448842076,20200
2025-09-16T04:15:00-04:00,24634.25,24638,24629.25,24629.5,24607.085765803535,NaN,NaN,NaN,NaN,NaN,24595.57,24623.407212502578,24567.73278749742,24610.53124559717,24576.725133487416,24606.103022337353,24547.34724463748,1080,967.8666666666667,68.3488189720976,64.44705381788518,NaN,NaN,NaN,NaN,9.731768608450164,38.81672084891365,19120
2025-09-16T04:20:00-04:00,24630,24634,24625,24633.75,24607.085765803535,NaN,NaN,NaN,NaN,NaN,24596.68,24626.050059584057,24567.309940415944,24610.53124559717,24577.510289196718,24607.384830180566,24547.63574821287,1094,959.2,70.38155349950603,65.21281914466799,NaN,NaN,NaN,NaN,9.679499422132295,39.10126862982988,20214
2025-09-16T04:25:00-04:00,24634,24636.5,24628.5,24636.25,24607.085765803535,NaN,NaN,NaN,NaN,NaN,24597.82,24628.77739652689,24566.86260347311,24611.31999718219,24578.428312120293,24608.902995720808,24547.95362851978,1253,985.3666666666667,71.53945013669906,65.81956873681052,NaN,NaN,NaN,NaN,9.559535177694274,39.53902792482055,21467
2025-09-16T04:30:00-04:00,24636.25,24636.75,24627.75,24628.75,24607.085765803535,NaN,NaN,NaN,NaN,NaN,24598.72,24630.591874742073,24566.84812525793,24612.105997745748,24578.854249852462,24609.56972109459,24548.138778610333,626,977.5666666666667,63.51705894486154,65.71517888135202,NaN,NaN,NaN,NaN,9.51956837928754,39.805095030030394,20841
2025-09-16T04:35:00-04:00,24628.25,24632.25,24626.5,24632,24607.085765803535,NaN,NaN,NaN,NaN,NaN,24599.745,24632.52281109368,24566.967188906317,24612.105997745748,24579.378823730032,24610.37070305058,24548.386944409485,798,991.8,65.33133011036723,65.63013678101665,NaN,NaN,NaN,NaN,9.250313495052714,39.80942427101355,21639
2025-09-16T04:40:00-04:00,24632,24638.5,24631.75,24636,24609.338599666986,NaN,NaN,NaN,NaN,NaN,24600.855,24634.692566406105,24567.017433593894,24617.05283855728,24579.816174915388,24611.078248796766,24548.55410103401,615,993.5666666666667,67.47515313530863,65.4804520029714,NaN,NaN,NaN,NaN,9.07171967397752,40.299925211358826,22254
2025-09-16T04:45:00-04:00,24635.75,24645.75,24635,24645.5,24614.294799682124,NaN,NaN,NaN,NaN,NaN,24602.13,24637.74927006468,24566.510729935322,24623.217270845824,24580.993016301858,24613.098151475064,24548.887881128652,1518,1029.7666666666667,71.91682308980832,65.82132340900306,NaN,NaN,NaN,NaN,9.191596840121983,41.22749116375402,23772
2025-09-16T04:50:00-04:00,24645.75,24646.75,24640.5,24643.75,24617.877990605662,NaN,NaN,NaN,NaN,NaN,24603.36,24640.368669256433,24566.351330743568,24625.59881667666,24581.695151302498,24614.294302566872,24549.096000038124,910,1046.4,70.0198918603154,66.33939251124482,NaN,NaN,NaN,NaN,8.98148278011327,42.149126025844446,22862
2025-09-16T04:55:00-04:00,24643.75,24643.75,24633.25,24639.25,24617.877990605662,NaN,NaN,NaN,NaN,NaN,24604.565,24642.2400328484,24566.889967151597,24625.59881667666,24582.34442510618,24615.31765575664,24549.37119445572,935,1054.9333333333334,65.25355822432455,66.76843331000879,NaN,NaN,NaN,NaN,9.089948295819465,41.64315264781995,21927
2025-09-16T05:00:00-04:00,24639.5,24645.5,24638.75,24643.5,24617.877990605662,NaN,NaN,NaN,NaN,NaN,24605.845,24644.366018935412,24567.32398106459,24625.59881667666,24582.875641381353,24616.182755853122,24549.568526909585,731,1045.1,67.5034486980779,67.81425326545947,NaN,NaN,NaN,NaN,8.922809131832361,41.317808856921154,22658
2025-09-16T05:05:00-04:00,24644,24645.25,24640.25,24643,24617.877990605662,NaN,NaN,NaN,NaN,NaN,24607.105,24646.277961341333,24567.932038658666,24625.86059413845,24583.1986559559,24616.704628333806,24549.692683577996,449,1047.1,66.9541679032825,68.75125762897063,NaN,NaN,NaN,NaN,8.642608479558621,41.01570390822941,22209
2025-09-16T05:10:00-04:00,24642.25,24642.25,24637,24637.25,24617.877990605662,NaN,NaN,NaN,NaN,NaN,24608.235,24647.561124902,24568.908875098,24625.86059413845,24583.517899607104,24617.19084542074,24549.84495379347,481,1041.9,60.82459515196408,68.21736315308756,NaN,NaN,NaN,NaN,8.45385073101872,40.11947724514338,21728
2025-09-16T05:15:00-04:00,24637.5,24638.5,24629,24630.75,24617.877990605662,NaN,NaN,NaN,NaN,NaN,24609.15,24648.399968146052,24569.90003185395,24625.86059413845,24583.975250167427,24617.822571661007,24550.127928673846,786,1055.8,54.72541014058947,66.93469937684446,NaN,NaN,NaN,NaN,8.528575678803097,37.97626072319878,20942
2025-09-16T05:20:00-04:00,24631.25,24635,24629,24631,24617.877990605662,NaN,NaN,NaN,NaN,NaN,24609.965,24649.303531996502,24570.6264680035,24625.86059413845,24584.312177275493,24618.275429988775,24550.34892456221,602,1062.4333333333334,54.912675900304485,65.62170969767905,NaN,NaN,NaN,NaN,8.347963130317162,35.98613109567879,21544
2025-09-16T05:25:00-04:00,24631.5,24634.75,24627.75,24632.5,24617.877990605662,NaN,NaN,NaN,NaN,NaN,24610.92,24650.081644505404,24571.758355494592,24625.86059413845,24584.59555847185,24618.653432039293,24550.537684904408,513,1066.7666666666667,56.08632841973318,64.7458175153673,NaN,NaN,NaN,NaN,8.251680049580221,33.93966250131338,22057
2025-09-16T05:30:00-04:00,24632,24632.75,24621.5,24624.75,24617.877990605662,NaN,NaN,NaN,NaN,NaN,24611.665,24650.43143006036,24572.898569939643,24625.86059413845,24585.032535129427,24619.176966213472,24550.88810404538,907,1056.7666666666667,48.99065744889617,63.217896368895175,NaN,NaN,NaN,NaN,8.465845760324491,31.908622481916595,21150
2025-09-16T05:35:00-04:00,24625,24627.75,24616.5,24617.75,NaN,NaN,NaN,24647.535271877874,24647.535271877874,24647.535271877874,24612.23,24650.50817133143,24573.95182866857,24625.86059413845,24585.396103018178,24619.55412644863,24551.238079587725,893,1045.2,43.62246934661104,61.22382631246031,NaN,NaN,NaN,NaN,8.664713920301313,30.653319670309344,20257
2025-09-16T05:40:00-04:00,24617.25,24623.25,24617,24622.25,NaN,NaN,NaN,24645.23253224706,NaN,NaN,24612.975,24650.547762742382,24575.402237257615,24625.86059413845,24585.701163844362,24619.869041852682,24551.53328583604,760,1009.6333333333333,47.59771387736747,60.08673023621075,NaN,NaN,NaN,NaN,8.492234354565506,29.487681345245463,21017
2025-09-16T05:45:00-04:00,24621.5,24625.25,24620.75,24621.5,NaN,NaN,NaN,24645.23253224706,NaN,NaN,24613.625,24650.636518476844,24576.613481523156,24625.86059413845,24585.89396901408,24620.075615717833,24551.712322310326,465,983.2666666666667,47.002852939977,58.77755329546858,NaN,NaN,NaN,NaN,8.207074757810826,28.066016145771655,20552
2025-09-16T05:50:00-04:00,24621,24625.5,24619.5,24624.75,NaN,NaN,NaN,24645.23253224706,NaN,NaN,24614.31,24650.848960024217,24577.771039975785,24625.86059413845,24586.053651367085,24620.249121608853,24551.858181125317,381,907,49.923442979130144,57.52385971288441,NaN,NaN,NaN,NaN,8.049426560824338,26.92157785127602,20933
2025-09-16T05:55:00-04:00,24624.5,24627.75,24619.75,24626.5,NaN,NaN,NaN,24645.23253224706,NaN,NaN,24614.96,24651.18559316398,24578.734406836018,24623.738475310758,24586.30799580927,24620.53348494582,24552.082506672723,591,900.5,51.474153036917386,56.063668994820766,NaN,NaN,NaN,NaN,8.04589609219403,25.458013458349697,21524
2025-09-16T06:00:00-04:00,24626.5,24626.75,24620.25,24621.25,NaN,NaN,NaN,24645.23253224706,NaN,NaN,24615.4,24651.385274760385,24579.414725239618,24618.94078024861,24586.552881688047,24620.79286868542,24552.312894690673,607,895.1333333333333,46.79270475808713,54.40458420180447,NaN,NaN,NaN,NaN,7.935474942751599,24.09898937920383,20917
2025-09-16T06:05:00-04:00,24620.5,24624.75,24618.5,24622,NaN,NaN,NaN,24645.23253224706,NaN,NaN,24615.95,24651.478439312486,24580.421560687515,24616.352624198887,24586.721955048746,24620.96618630037,24552.47772379712,436,873.8,47.52690470169164,53.138394664473545,NaN,NaN,NaN,NaN,7.815083875412199,23.125959288041788,21353
2025-09-16T06:10:00-04:00,24622.5,24624.75,24617.75,24622.25,NaN,NaN,NaN,24644.932621147862,NaN,NaN,24616.385,24651.67794689623,24581.092053103766,24616.332099359108,24586.91940178056,24621.166590553516,24552.672213007605,517,862.6,47.78554568141619,51.72997302042628,NaN,NaN,NaN,NaN,7.756863598597042,22.34751913504363,21870
2025-09-16T06:15:00-04:00,24622,24625.25,24620.25,24625,NaN,NaN,NaN,24644.932621147862,NaN,NaN,24616.9,24651.92827429405,24581.871725705954,24612.390679487286,24587.10123213208,24621.35993002884,24552.842534235322,456,853.2666666666667,50.6661463874296,50.56654291215108,NaN,NaN,NaN,NaN,7.559944770125825,21.513658294040415,22326
2025-09-16T06:20:00-04:00,24625,24630.75,24623.75,24629.75,NaN,NaN,NaN,24644.932621147862,NaN,NaN,24617.465,24652.392640919377,24582.537359080623,24614.044460685727,24587.439275431254,24621.757154766306,24553.1213960962,763,849.1666666666666,55.257667055246436,50.168905190956956,NaN,NaN,NaN,NaN,7.519948715116838,20.328764058618322,23089
2025-09-16T06:25:00-04:00,24630,24630.75,24625.25,24629.25,NaN,NaN,NaN,24644.932621147862,NaN,NaN,24618.03,24652.78753731253,24583.272462687466,24614.635568548583,24587.645991538484,24622.000083611045,24553.291899465923,469,848.8333333333334,54.680758326903415,50.16571577569367,NaN,NaN,NaN,NaN,7.375666664037063,19.228505125726382,22620
2025-09-16T06:30:00-04:00,24629.5,24630.25,24622.75,24624.5,NaN,NaN,NaN,24644.932621147862,NaN,NaN,24618.575,24652.863518484566,24584.286481515435,24614.635568548583,24587.84904832721,24622.224053960825,24553.474042693597,497,782.2,49.40380501229871,49.77222499797897,NaN,NaN,NaN,NaN,7.384547616605844,18.021585039699982,22123
2025-09-16T06:35:00-04:00,24623.75,24625,24620.25,24623,NaN,NaN,NaN,24644.932621147862,NaN,NaN,24619.16,24652.724826827845,24585.595173172154,24614.635568548583,24588.037712157482,24622.41506483139,24553.660359483572,508,716.1333333333333,47.8339228506161,49.18276745732775,NaN,NaN,NaN,NaN,7.196365643991141,17.384461043991756,21615
2025-09-16T06:40:00-04:00,24623.25,24625,24621,24622,NaN,NaN,NaN,24644.932621147862,NaN,NaN,24619.845,24652.193707856637,24587.496292143365,24614.635568548583,24588.164376590325,24622.542419574893,24553.786333605756,345,699.5333333333333,46.76698420716199,49.02393365434674,NaN,NaN,NaN,NaN,6.968053812277488,16.79284590511983,21270
2025-09-16T06:45:00-04:00,24621.5,24628,24621.5,24625.75,NaN,NaN,NaN,24644.932621147862,NaN,NaN,24620.59,24651.709248061707,24589.470751938294,24614.635568548583,24588.40238275818,24622.796583973115,24554.008181543246,612,683.9333333333333,51.16587154089166,49.56274809679535,NaN,NaN,NaN,NaN,6.93462139711481,15.628881058364218,21882
2025-09-16T06:50:00-04:00,24626.25,24632.25,24625,24632,NaN,NaN,NaN,24644.932621147862,NaN,NaN,24621.365,24651.64076752784,24591.089232472164,24616.712623102,24588.678838245905,24623.1230829827,24554.23459350911,639,668.7666666666667,57.47335756101172,50.26815121705566,NaN,NaN,NaN,NaN,6.957148440178038,15.389179801744927,22521
2025-09-16T06:55:00-04:00,24631.75,24631.75,24623.5,24626.25,NaN,NaN,NaN,24644.932621147862,NaN,NaN,24622.1,24650.9987889079,24593.2012110921,24616.712623102,24588.87994459074,24623.34596405163,24554.413925129847,502,643.7333333333333,50.95295057337415,50.5503010480126,NaN,NaN,NaN,NaN,7.067352123022464,14.821393807001071,22019
2025-09-16T07:00:00-04:00,24626.75,24627,24620.25,24623.5,NaN,NaN,NaN,24644.932621147862,NaN,NaN,24622.785,24650.117948986313,24595.452051013686,24616.712623102,24589.360832828654,24623.826798061516,24554.89486759579,1350,667.8666666666667,48.139989888770685,50.42291154155835,NaN,NaN,NaN,NaN,7.044684114235145,13.931736466674478,20669
2025-09-16T07:05:00-04:00,24622.75,24626,24617.5,24623.5,NaN,NaN,NaN,24643.87024581678,NaN,NaN,24623.49,24648.979794025767,24598.000205974236,24616.712623102,24589.636375588663,24624.08902671523,24555.183724462095,821,668.6333333333333,48.13998988877069,50.184757030976435,NaN,NaN,NaN,NaN,7.148635248932635,13.641114824108708,20669
2025-09-16T07:10:00-04:00,24624,24627.5,24618.75,24621.5,NaN,NaN,NaN,24643.87024581678,NaN,NaN,24624.01,24648.223417775527,24599.79658222447,24616.712623102,24589.93545835686,24624.37343862632,24555.4974780874,900,678.1333333333333,45.99808235112303,50.12799828762186,NaN,NaN,NaN,NaN,7.263018445437447,13.032575290116096,19769
2025-09-16T07:15:00-04:00,24620.75,24620.75,24600.25,24608.75,NaN,NaN,NaN,24634.691690919833,NaN,NaN,24624.38,24647.033750240935,24601.726249759067,24616.712623102,24590.34294802123,24624.54476421172,24556.141131830736,2064,696.3333333333334,35.23505297314526,49.25000887843998,NaN,NaN,NaN,NaN,8.262088556477629,14.936808361036382,17705
2025-09-16T07:20:00-04:00,24608.5,24614.75,24606,24611.5,NaN,NaN,NaN,24634.660250423476,NaN,NaN,24624.605,24646.506618663854,24602.703381336145,24616.712623102,24590.560585473293,24624.644054831635,24556.47711611495,1091,702.3666666666667,38.57359677076269,48.59201252767901,NaN,NaN,NaN,NaN,8.296939373872084,16.705024784033792,18796
2025-09-16T07:25:00-04:00,24611,24615,24608.75,24610.25,NaN,NaN,NaN,24634.660250423476,NaN,NaN,24624.715,24646.269120257148,24603.160879742853,24616.712623102,24590.681710544635,24624.70244812866,24556.66097296061,600,691.2,37.62420300633452,47.66044514331508,NaN,NaN,NaN,NaN,8.150729418595507,18.290284414097687,18196
2025-09-16T07:30:00-04:00,24610,24614,24606.5,24606.75,NaN,NaN,NaN,24634.213936852797,NaN,NaN,24624.7,24646.303009050993,24603.09699094901,24616.712623102,24590.803047344125,24624.74412735055,24556.8619673377,683,689.6,35.0247944250152,46.21523995544142,NaN,NaN,NaN,NaN,8.104248745838685,19.98996959313262,17513
2025-09-16T07:35:00-04:00,24607.25,24608.75,24601.25,24602.25,NaN,NaN,NaN,24628.897394268577,NaN,NaN,24624.55,24646.6642487994,24602.4357512006,24616.712623102,24590.939834543595,24624.7322772502,24557.14739183699,1078,710.5666666666667,31.966807283460227,44.59281488090976,NaN,NaN,NaN,NaN,8.061088121135922,22.047636687918533,16435
2025-09-16T07:40:00-04:00,24603.25,24605.5,24597.25,24600.75,NaN,NaN,NaN,24625.31114907455,NaN,NaN,24624.275,24647.20909033231,24601.34090966769,24615.0700984816,24591.05986846453,24624.671463816336,24557.448273112725,1243,735.9666666666667,30.995357971242385,43.277925806548595,NaN,NaN,NaN,NaN,8.074581826769071,24.27589257426445,15192
2025-09-16T07:45:00-04:00,24601,24606,24600.5,24601.25,NaN,NaN,NaN,24625.31114907455,NaN,NaN,24624.045,24647.657431063937,24600.43256893606,24610.28107878528,24591.141439616957,24624.64779102492,24557.635088208994,755,734.9333333333333,31.740005173203244,42.128360258161955,NaN,NaN,NaN,NaN,7.890683124856994,26.218522728148518,15947
2025-09-16T07:50:00-04:00,24601,24605.5,24599.25,24605.25,NaN,NaN,NaN,24625.31114907455,NaN,NaN,24623.96,24647.81065198323,24600.10934801677,24609.024890422577,24591.21190116643,24624.634069172775,24557.789733160083,620,735.5333333333333,37.546373560022204,41.469745211937685,NaN,NaN,NaN,NaN,7.773491473081494,28.126960715220505,16567
2025-09-16T07:55:00-04:00,24605.25,24609.75,24605,24605,NaN,NaN,NaN,24625.31114907455,NaN,NaN,24623.925,24647.881470940116,24599.968529059883,24609.024890422577,24591.337389786204,24624.65157976516,24558.02319980725,883,747.8666666666667,37.33263069315974,40.48165657995684,NaN,NaN,NaN,NaN,7.557527796432816,28.812451237474246,15684
2025-09-16T08:00:00-04:00,24605,24607,24591.25,24592.25,NaN,NaN,NaN,24623.19183375524,NaN,NaN,24623.745,24648.502118174434,24598.987881825564,24595.344912338063,24591.419132648407,24624.49134007855,24558.346925218262,1633,772.0666666666667,28.440345844436408,38.40787002877289,NaN,NaN,NaN,NaN,8.1427043824019,30.593858817305748,14051
2025-09-16T08:05:00-04:00,24593,24596.25,24590.5,24595.75,NaN,NaN,NaN,24617.131977675457,NaN,NaN,24623.615,24648.88518203169,24598.344817968315,24592.239229567967,24591.45226108421,24624.32584725883,24558.57867490959,1340,786.9666666666667,33.14776880562877,37.136071331076785,NaN,NaN,NaN,NaN,7.97179692651605,32.29722199948862,15391
2025-09-16T08:10:00-04:00,24595.25,24601.25,24588.5,24598.75,NaN,NaN,NaN,24617.131977675457,NaN,NaN,24623.135,24649.34686945661,24596.923130543386,24592.239229567967,24591.524071875207,24624.151438133074,24558.89670561734,1719,818.9333333333333,36.974842472250124,36.33856080132532,NaN,NaN,NaN,NaN,8.313097146050618,32.813297759128744,17110
2025-09-16T08:15:00-04:00,24598.25,24600.5,24594.75,24598.5,NaN,NaN,NaN,24617.131977675457,NaN,NaN,24622.455,24649.413243638668,24595.496756361335,24592.239229567967,24591.587724146393,24624.058449502867,24559.11699878992,1135,841.2666666666667,36.78585405133916,35.527551098651635,NaN,NaN,NaN,NaN,8.130018778475574,33.29251096450886,15975
2025-09-16T08:20:00-04:00,24599,24602,24593.25,24594.5,NaN,NaN,NaN,24617.131977675457,NaN,NaN,24621.665,24649.523680866216,24593.806319133786,24592.239229567967,24591.634568700545,24623.956280495633,24559.312856905457,1079,864.5333333333333,33.80831758360651,34.656853615257596,NaN,NaN,NaN,NaN,8.174303151441604,33.73749465521897,14896
2025-09-16T08:25:00-04:00,24595,24596.75,24586.5,24591,NaN,NaN,NaN,24616.111478576004,NaN,NaN,24620.895,24649.947554104285,24591.842445895716,24592.239229567967,24591.631208874885,24623.702780083193,24559.559637666578,1802,904.9,31.412409090974023,34.38380762367394,NaN,NaN,NaN,NaN,8.322567212052919,34.75574122927223,13094
2025-09-16T08:30:00-04:00,24589,24601,24576.25,24598,NaN,NaN,NaN,24615.37345682255,NaN,NaN,24620.18,24649.687971801814,24590.672028198187,24592.239229567967,24591.634653411867,24623.237827379973,24560.03147944376,3490,1001,40.4950916765856,34.52105725980415,NaN,NaN,NaN,NaN,9.495955268334853,36.39355242327317,16584
2025-09-16T08:35:00-04:00,24598,24608.25,24595,24600.5,NaN,NaN,NaN,24615.37345682255,NaN,NaN,24619.465,24649.112935849495,24589.817064150506,24592.239229567967,24591.833990334148,24623.137858071914,24560.53012259638,2548,1071.4,43.37894518706913,34.932110272713764,NaN,NaN,NaN,NaN,9.76410132059665,36.51424300610678,19132
2025-09-16T08:40:00-04:00,24600.25,24601,24590.25,24600.25,NaN,NaN,NaN,24615.37345682255,NaN,NaN,24618.895,24648.90068112782,24588.88931887218,24592.239229567967,24591.939297326317,24622.941416773883,24560.93717787875,2476,1136.7,43.153716712627705,35.512747578971805,NaN,NaN,NaN,NaN,9.834522654839747,36.98294018546076,16656
2025-09-16T08:45:00-04:00,24600,24605.75,24597.75,24603.75,NaN,NaN,NaN,24615.37345682255,NaN,NaN,24618.33,24648.391177619196,24588.268822380807,24585.116383654375,24592.058833346466,24622.903671202028,24561.213995490903,1447,1169.7333333333333,47.28064669855291,36.60659325147842,NaN,NaN,NaN,NaN,9.703485322351193,36.60159124149838,18103
2025-09-16T08:50:00-04:00,24604,24604,24595,24596.5,NaN,NaN,NaN,24615.37345682255,NaN,NaN,24617.54,24647.77778430731,24587.302215692693,24580.809470744833,24592.123388804754,24622.819974744485,24561.426802865022,1284,1187.1,40.69079231582769,37.29912427609166,NaN,NaN,NaN,NaN,9.65323637075468,36.47917396706508,16819
2025-09-16T08:55:00-04:00,24596.25,24604.75,24588,24597,NaN,NaN,NaN,24615.37345682255,NaN,NaN,24616.57,24646.264619041962,24586.875380958038,24580.809470744833,24592.196898918315,24622.644754245903,24561.749043590728,2147,1243.0333333333333,41.29844953701416,37.98187030207815,NaN,NaN,NaN,NaN,10.160148058557919,36.90085199921745,18966
2025-09-16T09:00:00-04:00,24597.25,24607.75,24593,24606,NaN,NaN,NaN,24615.37345682255,NaN,NaN,24615.815,24644.61305722969,24587.016942770308,24580.809470744833,24592.351238170097,24622.58973814767,24562.11273819252,2031,1294.1666666666667,51.02517433085332,38.94464178570894,NaN,NaN,NaN,NaN,10.48799462580378,36.77935918927378,20997
2025-09-16T09:05:00-04:00,24605.75,24609.75,24596.75,24598,NaN,NaN,NaN,24615.37345682255,NaN,NaN,24614.99,24643.416389145943,24586.56361085406,24580.809470744833,24592.515588811675,24622.50587990301,24562.52529772034,2420,1357.9,44.03973237935235,39.423720477579835,NaN,NaN,NaN,NaN,10.66742358110351,36.32900678917162,18577
2025-09-16T09:10:00-04:00,24597.5,24601.25,24596,24596.75,NaN,NaN,NaN,24615.37345682255,NaN,NaN,24614.055,24641.73446711449,24586.37553288551,24578.250413388254,24592.56321196243,24622.42734604581,24562.699077879053,1180,1385.7333333333333,43.048061188690625,40.46712871645514,NaN,NaN,NaN,NaN,10.28046475388183,35.97994483028745,17397
2025-09-16T09:15:00-04:00,24597,24601.25,24594.75,24598.75,NaN,NaN,NaN,24615.37345682255,NaN,NaN,24613.17,24639.904517028535,24586.43548297146,24578.250413388254,24592.633474329894,24622.319191345076,24562.947757314712,1700,1422,45.175242038157485,41.32623394735005,NaN,NaN,NaN,NaN,10.010431557175986,35.77517304726577,19097
2025-09-16T09:20:00-04:00,24599,24609.5,24597,24608.25,NaN,NaN,NaN,24615.37345682255,NaN,NaN,24612.59,24638.453828016343,24586.726171983657,24582.842211654784,24592.86720887012,24622.316982829172,24563.41743491107,2669,1489.6666666666667,53.96985169451955,42.540163177512156,NaN,NaN,NaN,NaN,10.18825787452056,34.18107016958025,21766
2025-09-16T09:25:00-04:00,24608,24608,24586.5,24588.25,NaN,NaN,NaN,24615.37345682255,NaN,NaN,24611.74,24637.951821748968,24585.528178251036,24582.842211654784,24592.917502547713,24621.82791440037,24564.007090695053,5294,1649.4,39.57634528812743,42.73948398013988,NaN,NaN,NaN,NaN,11.014096597769091,33.7413204565231,16472
2025-09-16T09:30:00-04:00,24588.25,24600.25,24559.5,24569.5,NaN,NaN,NaN,24614.630085647095,NaN,NaN,24610.51,24638.689240587802,24582.330759412194,24582.842211654784,24590.4270918403,24617.713674554278,24563.140509126326,25873,2466.8333333333335,31.180652483772974,42.55179361586606,NaN,NaN,NaN,NaN,13.138089697928441,34.96747580072025,-9401
2025-09-16T09:35:00-04:00,24570.25,24578.75,24555.25,24557.5,NaN,NaN,NaN,24603.379854481318,NaN,NaN,24609.01,24640.1739150299,24577.846084970097,24582.842211654784,24588.033321832056,24615.15282277528,24560.913820888833,16957,3004.7,27.203195966215375,42.25113553552615,NaN,NaN,NaN,NaN,13.87822614807641,36.28536809730312,-26358
2025-09-16T09:40:00-04:00,24557.5,24573.25,24552.25,24567.75,NaN,NaN,NaN,24600.339861095803,NaN,NaN,24607.87,24640.76927659587,24574.970723404127,24582.842211654784,24586.235338639613,24613.044000263682,24559.426677015545,15524,3492.1666666666665,34.84814082919415,41.847781903569626,NaN,NaN,NaN,NaN,14.386924280356666,37.6336296887191,-10834
2025-09-16T09:45:00-04:00,24568,24570.25,24544.5,24562,NaN,NaN,NaN,24596.76759468236,NaN,NaN,24606.755,24641.938872727063,24571.57112727294,24582.842211654784,24583.632584900293,24610.363841737402,24556.901328063184,21473,4139.133333333333,32.76913510065566,41.08993832596866,NaN,NaN,NaN,NaN,15.198572546045474,39.18756674139573,-32307
2025-09-16T09:50:00-04:00,24562.5,24566,24527.25,24538.25,NaN,NaN,NaN,24589.511113105887,NaN,NaN,24605.075,24644.85995318249,24565.29004681751,24582.842211654784,24579.78523299171,24607.781731470342,24551.78873451308,24119,4906.733333333334,25.896821254979017,39.85730293613661,NaN,NaN,NaN,NaN,16.880817364185084,41.16525454732013,-56426
2025-09-16T09:55:00-04:00,24538,24546.75,24523.5,24538,NaN,NaN,NaN,24579.2321988738,NaN,NaN,24603.405,24647.108877409482,24559.701122590515,24582.842211654784,24577.46033571139,24606.41380914164,24548.506862281138,14019,5354.033333333334,25.835400622496138,38.325499644989705,NaN,NaN,NaN,NaN,17.335758981029006,43.09956743629424,-70445
2025-09-16T10:00:00-04:00,24538,24548,24529.25,24537,NaN,NaN,NaN,24579.2321988738,NaN,NaN,24601.65,24648.703480208515,24554.59651979149,24582.842211654784,24575.32466837979,24604.860615045072,24545.78872171451,15112,5835,25.574116428922977,37.24573708163937,NaN,NaN,NaN,NaN,17.43677619666979,44.719848631094635,-85557
2025-09-16T10:05:00-04:00,24536.75,24555.5,24535,24544.5,NaN,NaN,NaN,24579.2321988738,NaN,NaN,24600.01,24649.154273321088,24550.86572667891,24582.842211654784,24573.91152810426,24603.45091434629,24544.372141862234,13619,6253.033333333334,31.19451296536512,36.524027326521576,NaN,NaN,NaN,NaN,17.655577896907662,45.20139147261486,-71938
2025-09-16T10:10:00-04:00,24544.5,24550.75,24517.75,24538,NaN,NaN,NaN,24579.2321988738,NaN,NaN,24598.345,24650.071191618605,24546.618808381398,24575.79876932383,24571.483150839485,24601.562907847543,24541.403393831428,19723,6869.033333333334,29.14061684083687,34.96084464866326,NaN,NaN,NaN,NaN,18.751608047128546,46.25965377629217,-91661
2025-09-16T10:15:00-04:00,24538.25,24560,24535.75,24546.5,NaN,NaN,NaN,24579.2321988738,NaN,NaN,24596.835,24650.09611245952,24543.57388754048,24554.11401545906,24570.322282644614,24600.117227671355,24540.527337617874,15811,7370.9,35.15342770626559,34.326108600585634,NaN,NaN,NaN,NaN,19.144350329476506,46.18638042802528,-75850
2025-09-16T10:20:00-04:00,24546.75,24561,24534.75,24556.75,NaN,NaN,NaN,24579.2321988738,NaN,NaN,24595.525,24649.439307002693,24541.61069299731,24530.09121236725,24569.537723672212,24598.977086716262,24540.098360628162,13749,7808.533333333334,41.59003141976764,34.221963617091134,NaN,NaN,NaN,NaN,19.651896734513894,46.11834089034888,-62101
2025-09-16T10:25:00-04:00,24556.75,24557.75,24535,24539,NaN,NaN,NaN,24579.2321988738,NaN,NaN,24593.805,24649.31196262297,24538.29803737703,24523.8229698938,24568.61539223268,24597.911417018928,24539.319367446435,12754,8204.233333333334,35.0938273754643,33.50186256975591,NaN,NaN,NaN,NaN,19.873189824905758,46.05516131964937,-74855
2025-09-16T10:30:00-04:00,24538.75,24549,24535,24545.25,NaN,NaN,NaN,24579.2321988738,NaN,NaN,24592.115,24648.28298108947,24535.947018910534,24517.83337591504,24568.036237061307,24597.246516769093,24538.82595735352,8223,8423.9,38.723210025752095,32.412816736272525,NaN,NaN,NaN,NaN,19.45367626598392,45.9964945754284,-66632
2025-09-16T10:35:00-04:00,24545.25,24557,24527,24533.75,NaN,NaN,NaN,24579.2321988738,NaN,NaN,24590.205,24647.671920048764,24532.73807995124,24504.691700732033,24567.052703140747,24596.232025224166,24537.87338105733,12824,8806.7,34.86057390602463,32.075975923265176,NaN,NaN,NaN,NaN,20.206985104127927,45.94201831293749,-79456
2025-09-16T10:40:00-04:00,24533.75,24538.75,24530.5,24531.5,NaN,NaN,NaN,24579.2321988738,NaN,NaN,24588.345,24647.25356389123,24529.436436108772,24498.9201507748,24566.457467901495,24595.712525461422,24537.202410341568,6796,8975.933333333332,34.14297273625239,32.28757022701371,NaN,NaN,NaN,NaN,19.352914739547362,45.89143321205308,-86252
2025-09-16T10:45:00-04:00,24532,24544,24527.25,24538,NaN,NaN,NaN,24579.2321988738,NaN,NaN,24586.645,24646.35555936912,24526.93444063088,24498.9201507748,24565.803338734764,24595.06842065981,24536.53825680972,8506,9221.633333333333,38.10673432946243,33.06639439581706,NaN,NaN,NaN,NaN,19.166992258151122,45.06008673362082,-77746
2025-09-16T10:50:00-04:00,24538.25,24550.75,24536.25,24547,NaN,NaN,NaN,24579.2321988738,NaN,NaN,24585.145,24644.995571425377,24525.294428574623,24503.539743746413,24565.478458332807,24594.633945091027,24536.322971574587,6098,9388.933333333332,43.20399697520429,33.66324126338922,NaN,NaN,NaN,NaN,18.833635668283186,43.37932618940115,-71648
2025-09-16T10:55:00-04:00,24547,24547.5,24535.25,24537.75,NaN,NaN,NaN,24579.2321988738,NaN,NaN,24583.385,24643.530673996287,24523.23932600371,24503.60679499713,24565.086880545812,24594.184136561722,24535.989624529902,6234,9536.666666666666,39.594761236277485,34.150785987362205,NaN,NaN,NaN,NaN,18.363375977691533,41.90210603779624,-77882
2025-09-16T11:00:00-04:00,24538,24539.5,24511,24516.25,NaN,NaN,NaN,24577.07838038513,NaN,NaN,24581.07,24642.45045617303,24519.68954382697,24503.60679499713,24563.518949473117,24593.1899415936,24533.847957352635,15310,9930.666666666666,32.74705681413097,34.640088527301636,NaN,NaN,NaN,NaN,19.087420550713567,42.07670888980969,-93192
2025-09-16T11:05:00-04:00,24516.75,24530,24515.5,24528,NaN,NaN,NaN,24574.19981764035,NaN,NaN,24579.105,24640.863650405478,24517.34634959452,24503.60679499713,24562.67277276083,24592.565527127565,24532.780018394096,9272,10154.8,38.96011050066165,35.57756780431345,NaN,NaN,NaN,NaN,18.759747654234026,42.23884010953646,-83920
2025-09-16T11:10:00-04:00,24527.75,24536.25,24519.5,24529.75,NaN,NaN,NaN,24574.19981764035,NaN,NaN,24577.23,24639.17568911325,24515.28431088675,24503.60679499713,24561.97316911309,24591.951510024497,24531.994828201685,8936,10370.133333333333,39.85137049516236,36.5973716661877,NaN,NaN,NaN,NaN,18.616194250360167,41.592978517185436,-74984
2025-09-16T11:15:00-04:00,24529.75,24534.5,24517.75,24530.5,NaN,NaN,NaN,24574.19981764035,NaN,NaN,24575.37,24637.2315583404,24513.508441659596,24503.60679499713,24561.408622558432,24591.459308425478,24531.357936691387,7285,10564.733333333334,40.254001666725586,37.244478001999155,NaN,NaN,NaN,NaN,18.48289466104873,41.101860456643145,-67699
2025-09-16T11:20:00-04:00,24531,24542,24524.5,24525.75,NaN,NaN,NaN,24574.19981764035,NaN,NaN,24573.455,24635.413993694874,24511.49600630513,24503.60679499713,24560.70769781242,24590.764248044652,24530.65114758019,10383,10868.033333333333,38.496406383848914,37.91274868364287,NaN,NaN,NaN,NaN,18.41268789954525,39.73102956379115,-78082
2025-09-16T11:25:00-04:00,24525.75,24532,24515,24517.5,NaN,NaN,NaN,24574.19981764035,NaN,NaN,24571.63,24634.68880112854,24508.57119887146,24503.60679499713,24559.949717992346,24590.199932603773,24529.699503380918,8953,11094.9,35.5898361045963,37.943920712095064,NaN,NaN,NaN,NaN,18.311781621006304,39.09841711599157,-87035
2025-09-16T11:30:00-04:00,24517.25,24524.25,24512,24514.75,NaN,NaN,NaN,24568.83791148161,NaN,NaN,24569.695,24633.67228424839,24505.71771575161,24503.60679499713,24559.314688825634,24589.784621216037,24528.844756435232,6950,11258.866666666667,34.65068412070556,37.44825304787634,NaN,NaN,NaN,NaN,17.878797219505852,38.69650652894099,-93985
2025-09-16T11:35:00-04:00,24514.25,24521.75,24508.25,24519,NaN,NaN,NaN,24565.248688232445,NaN,NaN,24567.87,24632.31992164373,24503.420078356266,24503.60679499713,24558.692180714486,24589.373429847885,24528.010931581088,6908,11408.466666666667,37.400003059897294,37.612979882478704,NaN,NaN,NaN,NaN,17.56602598954115,38.55208169746764,-87077
2025-09-16T11:40:00-04:00,24519.5,24523.5,24502.5,24512.25,NaN,NaN,NaN,24563.82829331279,NaN,NaN,24565.98,24631.295070237687,24500.66492976231,24503.60679499713,24557.715501874856,24588.783879659775,24526.647124089937,10360,11714.466666666667,34.889405114759825,37.33913667455069,NaN,NaN,NaN,NaN,17.81130984743107,38.75108085127534,-97437
2025-09-16T11:45:00-04:00,24511.75,24524,24510.25,24512.25,NaN,NaN,NaN,24563.82829331279,NaN,NaN,24564.18,24630.35258042429,24498.00741957571,24497.25827458466,24557.078757140247,24588.338318654325,24525.81919562617,7463,11906.566666666668,34.889405114759825,37.3411960466032,NaN,NaN,NaN,NaN,17.521216286900277,38.86671963691323,-97437
2025-09-16T11:50:00-04:00,24511.75,24525.75,24507,24522,NaN,NaN,NaN,24563.82829331279,NaN,NaN,24562.605,24628.969379755163,24496.240620244836,24497.25827458466,24556.603283671673,24587.962978224594,24525.243589118752,6134,12022.066666666668,41.47121385553705,37.86464184083782,NaN,NaN,NaN,NaN,17.608986552121685,39.16896329995412,-91303
2025-09-16T11:55:00-04:00,24522.5,24525.25,24502.75,24509,NaN,NaN,NaN,24563.82829331279,NaN,NaN,24560.76,24627.84963854718,24493.670361452816,24497.25827458466,24556.066186132884,24587.609615715734,24524.522756550035,6152,12050.666666666666,36.214656737716936,37.72949344142743,NaN,NaN,NaN,NaN,17.958344655541563,39.69563703692863,-97455
2025-09-16T12:00:00-04:00,24508.75,24515.75,24499,24500.25,NaN,NaN,NaN,24558.74624795849,NaN,NaN,24558.66,24626.615482485875,24490.704517514125,24497.25827458466,24555.336954232684,24587.235021619883,24523.438886845484,7346,11433.1,33.167358826877816,37.01259071654697,NaN,NaN,NaN,NaN,17.87203432300288,40.39236949545458,-104801
2025-09-16T12:05:00-04:00,24500.25,24516,24499.75,24514.5,NaN,NaN,NaN,24558.74624795849,NaN,NaN,24556.85,24624.592601075095,24489.1073989249,24497.25827458466,24554.83525555504,24586.907961123754,24522.762549986328,5767,11060.1,41.76201272771126,37.167394394506516,NaN,NaN,NaN,NaN,17.756174728502675,40.99781336983613,-99034
2025-09-16T12:10:00-04:00,24514.5,24519.75,24508.75,24517.5,NaN,NaN,NaN,24558.74624795849,NaN,NaN,24555.355,24623.205872507577,24487.504127492422,24487.706619667726,24554.471104874407,24586.618075854523,24522.32413389429,4840,10703.966666666667,43.411906209184956,37.92916935129609,NaN,NaN,NaN,NaN,17.27359081932391,40.931379230727835,-94194
2025-09-16T12:15:00-04:00,24518,24520,24514.5,24516,NaN,NaN,NaN,24558.74624795849,NaN,NaN,24553.76,24621.486875021947,24486.03312497805,24484.96723923709,24554.21280867584,24586.399616991574,24522.026000360103,3628,10109.133333333333,42.759620181060875,38.200562899896035,NaN,NaN,NaN,NaN,16.43262004651506,40.82740546250652,-97822
2025-09-16T12:20:00-04:00,24516.25,24518.75,24510.25,24517,NaN,NaN,NaN,24558.74624795849,NaN,NaN,24552.125,24619.37388474841,24484.87611525159,24486.47379138967,24553.927652711485,24586.167344156693,24521.687961266278,3906,9435.366666666667,43.37051335035463,38.45193024669548,NaN,NaN,NaN,NaN,15.86600432890684,41.04134509251115,-93916
2025-09-16T12:25:00-04:00,24516.25,24528.75,24514.25,24526,NaN,NaN,NaN,24558.74624795849,NaN,NaN,24550.675,24616.981504207717,24484.36849579228,24495.679033111737,24553.61145736342,24585.836453940698,24521.38646078614,5501,9151.433333333332,48.67915880434112,39.05372718509659,NaN,NaN,NaN,NaN,15.76843259112778,39.658303396234004,-88415
2025-09-16T12:30:00-04:00,24526.25,24527,24517,24521.25,NaN,NaN,NaN,24558.74624795849,NaN,NaN,24549.21,24614.81170424649,24483.608295753507,24495.679033111737,24553.355354738524,24585.576427762862,24521.134281714185,4360,8793.033333333333,46.21666318496484,39.60517409946202,NaN,NaN,NaN,NaN,15.35640169176151,38.37405039254808,-92775
2025-09-16T12:35:00-04:00,24520.75,24527.25,24507.5,24524,NaN,NaN,NaN,24558.74624795849,NaN,NaN,24547.87,24612.735494680386,24483.00450531961,24495.679033111737,24552.913066306905,24585.15189938861,24520.6742332252,7198,8579,47.86110309326145,40.48169317008096,NaN,NaN,NaN,NaN,15.670230142349974,37.99289958860966,-85577
2025-09-16T12:40:00-04:00,24524.25,24527.25,24512.75,24520.5,NaN,NaN,NaN,24558.74624795849,NaN,NaN,24546.32,24610.013095387247,24482.626904612753,24495.679033111737,24552.65733620124,24584.89914987168,24520.4155225308,4326,8065.766666666666,45.936044747305615,41.28779035769525,NaN,NaN,NaN,NaN,15.586642275039262,37.63897384209541,-89903
2025-09-16T12:45:00-04:00,24520.25,24524.75,24514.75,24517.5,NaN,NaN,NaN,24558.74624795849,NaN,NaN,24544.66,24606.928752999993,24482.391247000007,24495.679033111737,24552.422211974437,24584.673272657226,24520.171151291648,3897,7668.633333333333,44.291595728677414,41.780046976893836,NaN,NaN,NaN,NaN,15.187596398250744,37.31032850604646,-93800
2025-09-16T12:50:00-04:00,24517.25,24524,24515.25,24522.5,NaN,NaN,NaN,24558.74624795849,NaN,NaN,24543.105,24603.601205668045,24482.608794331954,24495.679033111737,24552.259584459887,24584.508143115287,24520.011025804488,2864,7305.8,47.654973668697906,42.69187330217512,NaN,NaN,NaN,NaN,14.727768084089975,37.005157836858146,-90936
2025-09-16T12:55:00-04:00,24522.75,24532.75,24521.75,24524,NaN,NaN,NaN,24558.74624795849,NaN,NaN,24541.51,24599.687225785405,24483.332774214592,24502.485444456044,24551.986424802344,24584.175480296453,24519.797369308235,5932,7078.4,48.65646378519144,43.67523463577738,NaN,NaN,NaN,NaN,14.461498935226405,35.274429658502356,-85004
2025-09-16T13:00:00-04:00,24524,24533.75,24523.5,24531,NaN,NaN,NaN,24558.74624795849,NaN,NaN,24540.2,24596.277178955603,24484.1228210444,24504.413355564833,24551.840163955985,24583.975820350646,24519.704507561324,3696,6927.5,53.16024536940097,44.510165458196234,NaN,NaN,NaN,NaN,14.160677582710234,33.51909933810738,-81308
2025-09-16T13:05:00-04:00,24531.25,24537.5,24527.75,24535.5,NaN,NaN,NaN,24558.74624795849,NaN,NaN,24538.97,24592.65674323689,24485.283256763112,24509.155684451867,24551.704620328506,24583.759098814397,24519.650141842616,4266,6642.233333333334,55.84188972714714,45.91211067172696,NaN,NaN,NaN,NaN,13.845629183945217,31.34220537387685,-77042
2025-09-16T13:10:00-04:00,24535.75,24539.5,24531.75,24537.25,NaN,NaN,NaN,24558.74624795849,NaN,NaN,24537.595,24587.74974952046,24487.440250479543,24512.949547561493,24551.612820067,24583.594643171262,24519.630996962736,3415,6529.533333333334,56.87588134941867,47.60557656619416,NaN,NaN,NaN,NaN,13.410227099377702,29.167388489110323,-73627
2025-09-16T13:15:00-04:00,24537.75,24541.5,24533.75,24536.5,NaN,NaN,NaN,24558.74624795849,NaN,NaN,24536.365,24583.456847488258,24489.273152511745,24516.384638049196,24551.512786097686,24583.405417397124,24519.62015479825,4054,6381.133333333333,56.26778242139678,48.64170297288598,NaN,NaN,NaN,NaN,13.005925163707866,27.427702595303582,-77681
2025-09-16T13:20:00-04:00,24536.5,24546,24536,24541.5,NaN,NaN,NaN,24558.74624795849,NaN,NaN,24535.26,24579.113843620118,24491.40615637988,24520.907710439355,24551.43227614739,24583.213581678003,24519.650970616774,4565,6330.033333333334,59.385392409198495,49.78266627288695,NaN,NaN,NaN,NaN,12.79121622344302,26.406520295577447,-73116
2025-09-16T13:25:00-04:00,24541.75,24542.25,24531,24532.5,NaN,NaN,NaN,24558.74624795849,NaN,NaN,24533.935,24573.863286962816,24494.006713037186,24520.907710439355,24551.313953468696,24583.008854445095,24519.619052492297,4321,6266.266666666666,52.175276715211744,50.45521316818344,NaN,NaN,NaN,NaN,12.681129350339946,24.69320092886901,-77437
2025-09-16T13:30:00-04:00,24533,24536.75,24528,24534.25,NaN,NaN,NaN,24558.74624795849,NaN,NaN,24532.455,24566.27358808246,24498.636411917545,24520.907710439355,24551.178084699703,24582.794280481627,24519.56188891778,4417,5903.166666666667,53.36102318321259,51.16882101338758,NaN,NaN,NaN,NaN,12.400334396744237,23.17829205089657,-73020
2025-09-16T13:35:00-04:00,24533.5,24535.5,24524.75,24532.25,NaN,NaN,NaN,24558.74624795849,NaN,NaN,24531.335,24561.161768183832,24501.508231816166,24520.907710439355,24551.033110869117,24582.582902964936,24519.4833187733,4273,5736.533333333334,51.78091887541187,51.39037530417835,NaN,NaN,NaN,NaN,12.282453368405362,22.20604751857273,-77293
2025-09-16T13:40:00-04:00,24532.5,24532.75,24527.25,24528.75,NaN,NaN,NaN,24558.74624795849,NaN,NaN,24530.52,24558.28667787083,24502.75332212917,24520.907710439355,24550.937707459638,24582.44960062504,24519.425814294234,2679,5527.966666666666,49.04395045962605,51.59232439522558,NaN,NaN,NaN,NaN,11.797992413519264,21.303249024272024,-79972
2025-09-16T13:45:00-04:00,24528.75,24535.75,24527.25,24534,NaN,NaN,NaN,24558.74624795849,NaN,NaN,24530.05,24556.74906365685,24503.350936343148,24520.907710439355,24550.839695262664,24582.297316069005,24519.382074456324,3190,5391.466666666666,53.05251012477361,51.963139183190734,NaN,NaN,NaN,NaN,11.562421526839316,19.97030473230617,-76782
2025-09-16T13:50:00-04:00,24533.5,24534.5,24521.75,24533.5,NaN,NaN,NaN,24558.74624795849,NaN,NaN,24529.365,24553.823374844396,24504.906625155607,24520.907710439355,24550.64182740414,24582.015770918482,24519.267883889795,5781,5238.066666666667,52.627886731413675,52.441127896341314,NaN,NaN,NaN,NaN,11.647248560636509,19.5040623368005,-82563
2025-09-16T13:55:00-04:00,24533.5,24538.5,24532,24534.25,NaN,NaN,NaN,24558.74624795849,NaN,NaN,24528.81,24551.474633237798,24506.145366762205,24520.907710439355,24550.552432231823,24581.859402029506,24519.24546243414,3495,5056.133333333333,53.232555532996486,53.0797678823641,NaN,NaN,NaN,NaN,11.279587949162472,18.423334155765083,-79068
2025-09-16T14:00:00-04:00,24534.25,24535,24523,24527.5,NaN,NaN,NaN,24558.74624795849,NaN,NaN,24528.595,24551.10075259103,24506.08924740897,24520.907710439355,24550.38961099944,24581.637872028936,24519.14134996994,4573,4976.9,47.371940793815284,53.059551248443924,NaN,NaN,NaN,NaN,11.331045952793724,18.528212689593285,-83641
2025-09-16T14:05:00-04:00,24527.5,24539.25,24524,24531,NaN,NaN,NaN,24558.74624795849,NaN,NaN,24528.455,24550.811585154635,24506.098414845368,24520.907710439355,24550.227038172958,24581.390237074353,24519.063839271563,5353,4925.066666666667,50.41998635231686,53.185517146095734,NaN,NaN,NaN,NaN,11.610971241879886,17.972759902492612,-78288
2025-09-16T14:10:00-04:00,24531,24534.75,24523.25,24525.75,NaN,NaN,NaN,24558.74624795849,NaN,NaN,24528.23,24550.464171905984,24505.995828094015,24516.551168351485,24550.11468327281,24581.239405622127,24518.989960923496,3162,4685.133333333333,46.10637493993921,52.68166925827704,NaN,NaN,NaN,NaN,11.603044724602752,17.548021248658646,-81450
2025-09-16T14:15:00-04:00,24525.25,24531.25,24524,24529.25,NaN,NaN,NaN,24558.74624795849,NaN,NaN,24527.925,24549.671091601107,24506.17890839889,24515.65000547633,24550.025386565576,24581.118132459702,24518.93264067145,2565,4521.866666666667,49.225125078680975,52.20904321195803,NaN,NaN,NaN,NaN,11.292112958559699,17.15362107009854,-78885
2025-09-16T14:20:00-04:00,24528.75,24533.75,24525.5,24531.5,NaN,NaN,NaN,24558.74624795849,NaN,NaN,24527.795,24549.375706663606,24506.21429333639,24515.65000547633,24549.945628711834,24581.00091180752,24518.890345616146,2553,4402.5,51.18095732241678,51.80226292431504,NaN,NaN,NaN,NaN,11.074819175805434,16.36873526028073,-76332
2025-09-16T14:25:00-04:00,24531.25,24535,24528.75,24530.5,NaN,NaN,NaN,24558.74624795849,NaN,NaN,24527.475,24548.401358985295,24506.548641014702,24515.65000547633,24549.870907749217,24580.885747876375,24518.85606762206,2563,4282.866666666667,50.25442785219387,51.3727375979434,NaN,NaN,NaN,NaN,10.730189234676475,15.432130171146424,-78895
2025-09-16T14:30:00-04:00,24530,24536.25,24526.5,24531.25,NaN,NaN,NaN,24558.74624795849,NaN,NaN,24526.965,24546.18608477545,24507.74391522455,24515.65000547633,24549.78780526391,24580.757818303282,24518.817792224538,2862,4133.4,50.97130886657018,50.77173163061281,NaN,NaN,NaN,NaN,10.66017571791387,14.91094834314643,-76033
2025-09-16T14:35:00-04:00,24531.25,24539.75,24528.5,24532.25,NaN,NaN,NaN,24558.74624795849,NaN,NaN,24526.83,24545.80430894018,24507.855691059824,24515.653307862776,24549.69150680452,24580.595069501534,24518.787944107506,3797,4067.733333333333,51.96527452901597,50.756731474455975,NaN,NaN,NaN,NaN,10.702306023777165,13.866525101673824,-72236
2025-09-16T14:40:00-04:00,24532.25,24538.75,24532,24536,NaN,NaN,NaN,24558.74624795849,NaN,NaN,24526.645,24545.06973609197,24508.22026390803,24516.09764629022,24549.637933789174,24580.494968568124,24518.780899010224,2448,3988,55.600374352425405,50.91668512939975,NaN,NaN,NaN,NaN,10.419998450650224,12.896703520306405,-69788
2025-09-16T14:45:00-04:00,24536,24544.75,24536,24540.75,NaN,NaN,NaN,24558.74624795849,NaN,NaN,24526.785,24545.527201047815,24508.042798952185,24522.253117032178,24549.59129750376,24580.37637767076,24518.80621733676,3307,3977.3,59.75489670749927,51.48625497454884,NaN,NaN,NaN,NaN,10.300712847032353,12.95138184607156,-66481
2025-09-16T14:50:00-04:00,24540.5,24547.5,24540.25,24543.5,NaN,NaN,NaN,24558.74624795849,NaN,NaN,24527.025,24546.302253427653,24507.74774657235,24525.87749362574,24549.549873353324,24580.22951734612,24518.870229360527,4628,4001.366666666667,61.97336610806197,52.409784663722846,NaN,NaN,NaN,NaN,10.082804786530042,13.385060452399838,-61853
2025-09-16T14:55:00-04:00,24543.75,24549,24541,24546.75,NaN,NaN,NaN,24558.74624795849,NaN,NaN,24527.2,24547.02372316239,24507.37627683761,24527.70199490059,24549.53048245246,24580.1362944561,24518.92467044882,3206,3924.866666666667,64.46632905329695,53.22505744433165,NaN,NaN,NaN,NaN,9.93403301606361,13.991296941621279,-58647
2025-09-16T15:00:00-04:00,24546.75,24555,24545.5,24550.25,NaN,NaN,NaN,24558.74624795849,NaN,NaN,24527.265,24547.367340665387,24507.16265933461,24533.211595920475,24549.53722642824,24579.999346835168,24519.075106021315,6205,3986.366666666667,66.97712912807458,54.250003329807434,NaN,NaN,NaN,NaN,9.903030657773353,15.288796878612063,-52442
2025-09-16T15:05:00-04:00,24550.5,24558.25,24549.5,24551,NaN,NaN,NaN,24558.74624795849,NaN,NaN,24527.53,24548.508474688617,24506.55152531138,24536.44427673638,24549.568913105286,24579.889635378262,24519.24819083231,6266,3955.3,67.50696365433271,55.26960390990288,NaN,NaN,NaN,NaN,9.820671325075256,16.839178626638684,-46176
2025-09-16T15:10:00-04:00,24551,24553.25,24545.5,24550.5,NaN,NaN,NaN,24558.74624795849,NaN,NaN,24528.215,24549.900250740055,24506.529749259946,24536.44427673638,24549.57011818532,24579.789787894046,24519.35044847659,4477,3960.3333333333335,66.73819912520858,56.65290807643097,NaN,NaN,NaN,NaN,9.672766230427024,17.433820742530653,-50653
2025-09-16T15:15:00-04:00,24550.5,24552.5,24546.75,24549.5,NaN,NaN,NaN,24558.74624795849,NaN,NaN,24528.645,24551.133906149294,24506.156093850706,24536.44427673638,24549.570162391454,24579.739245698056,24519.40107908485,2258,3905.7,65.14044422902168,57.70436935333846,NaN,NaN,NaN,NaN,9.392568642539379,17.985988421573197,-52911
2025-09-16T15:20:00-04:00,24549.5,24553.5,24544.5,24546.25,NaN,NaN,NaN,24558.74624795849,NaN,NaN,24528.975,24551.997000353706,24505.95299964629,24536.44427673638,24549.56205043921,24579.64892116947,24519.47517970895,3703,3933.6666666666665,60.10418120829748,58.70421265822119,NaN,NaN,NaN,NaN,9.364528025215138,18.021928760185585,-56614
2025-09-16T15:25:00-04:00,24546.25,24547,24533.5,24536.75,NaN,NaN,NaN,24558.74624795849,NaN,NaN,24529.1,24552.221418649846,24505.97858135015,24536.44427673638,24549.456971799107,24579.410810640453,24519.50313295776,6875,3965.1,48.3393996607813,58.64094655694264,NaN,NaN,NaN,NaN,9.659918880556916,17.269417211832092,-63489
2025-09-16T15:30:00-04:00,24537,24539,24530.25,24535.75,NaN,NaN,NaN,24558.74624795849,NaN,NaN,24529.3,24552.474986513993,24506.125013486006,24536.44427673638,24549.333621116435,24579.189024313262,24519.478217919608,5900,4038.5666666666666,47.290074093390736,58.36302632629792,NaN,NaN,NaN,NaN,9.59492467480285,17.001539826753646,-69389
2025-09-16T15:35:00-04:00,24535.75,24540.25,24528.75,24534.75,NaN,NaN,NaN,24558.74624795849,NaN,NaN,24529.645,24552.619788354725,24506.670211645276,24536.44427673638,24549.21697405327,24578.982780043585,24519.451168062955,5512,4080.1,46.20981503711611,58.074125410935224,NaN,NaN,NaN,NaN,9.731001483745505,16.94671374142363,-74901
2025-09-16T15:40:00-04:00,24534.5,24543.5,24532,24536.25,NaN,NaN,NaN,24558.74624795849,NaN,NaN,24530.075,24552.721026135572,24507.42897386443,24536.44427673638,24549.119633538772,24578.78361451646,24519.455652561086,5716,4156.8,48.12406990512147,57.87075119940317,NaN,NaN,NaN,NaN,9.857358520620826,16.329165768855113,-69185
2025-09-16T15:45:00-04:00,24536.25,24547.5,24536,24544.5,NaN,NaN,NaN,24558.74624795849,NaN,NaN,24530.585,24553.358583387166,24507.811416612833,24536.44427673638,24549.074840583562,24578.640541423163,24519.50913974396,4912,4185.4,57.155202007435165,58.241460305004544,NaN,NaN,NaN,NaN,9.974690054862196,15.21160119567025,-64273
2025-09-16T15:50:00-04:00,24545,24561.25,24536,24540.75,24521.292407739147,24521.292407739147,24521.292407739147,NaN,NaN,NaN,24531.155,24553.486791239728,24508.82320876027,24536.44427673638,24549.017478753085,24578.30905865787,24519.7258988483,13452,4481.633333333333,52.6669572759859,58.0319305138303,NaN,NaN,NaN,NaN,11.065783622372038,15.840591435625,-77725
2025-09-16T15:55:00-04:00,24540.75,24548.75,24516.75,24524,NaN,NaN,NaN,24569.41718309772,24569.41718309772,24569.41718309772,24531.39,24553.161348155623,24509.618651844376,24533.055469689025,24548.529238679348,24577.603085500392,24519.455391858304,18831,4965.3,38.227161667090066,56.49423515380107,NaN,NaN,NaN,NaN,12.561084792202607,15.310694870870476,-96556
2025-09-16T16:00:00-04:00,24524.25,24539,24521.25,24536.25,NaN,NaN,NaN,24567.54594750237,NaN,NaN,24531.675,24553.319918573587,24510.030081426412,24533.055469689025,24548.369773250644,24577.346219528135,24519.393326973153,7282,5060.8,49.19737204915908,55.58166414959372,NaN,NaN,NaN,NaN,12.931721592759564,14.818648060741271,-89274
2025-09-16T16:05:00-04:00,24536.25,24537.5,24527.25,24533.75,NaN,NaN,NaN,24567.54594750237,NaN,NaN,24532.17,24552.827550684247,24511.51244931575,24533.055469689025,24548.31976140514,24577.262915311407,24519.37660749887,2413,4998.8,47.349297267443916,54.35901902203279,NaN,NaN,NaN,NaN,12.740170050419595,14.361747451335582,-91687
2025-09-16T16:10:00-04:00,24533.5,24535.5,24531.75,24534.75,NaN,NaN,NaN,24567.54594750237,NaN,NaN,24532.86,24551.403235955284,24514.316764044717,24528.03774904616,24548.293010072604,24577.215727129522,24519.370293015687,1403,4956.266666666666,48.187704743670984,53.01691728028967,NaN,NaN,NaN,NaN,12.098015046818194,13.937482599744586,-90284
2025-09-16T16:15:00-04:00,24535,24541,24534.75,24539.25,NaN,NaN,NaN,24567.54594750237,NaN,NaN,24533.355,24551.220354736695,24515.489645263304,24528.03774904616,24548.276658836814,24577.178437160554,24519.374880513074,1235,4891.1,51.899609066827196,51.902106238325004,NaN,NaN,NaN,NaN,11.68029968633118,13.047753866519013,-89049
2025-09-16T16:20:00-04:00,24539,24539.25,24535.25,24537.25,NaN,NaN,NaN,24567.54594750237,NaN,NaN,24533.75,24551.06040150012,24516.43959849988,24528.03774904616,24548.266773383948,24577.15747836044,24519.376068407455,675,4720.9,50.17897739203355,50.71930468595536,NaN,NaN,NaN,NaN,11.131706851593238,12.221577185666696,-89724
2025-09-16T16:25:00-04:00,24538,24539.5,24536.25,24538.75,NaN,NaN,NaN,24567.54594750237,NaN,NaN,24534.205,24550.80671376597,24517.603286234033,24528.03774904616,24548.261490831235,24577.145562742022,24519.37741892045,394,4617.533333333334,51.4782673279339,49.74343490730623,NaN,NaN,NaN,NaN,10.56872779076515,11.488135213725023,-89330
2025-09-16T16:30:00-04:00,24539,24542,24538.25,24539.5,NaN,NaN,NaN,24567.54594750237,NaN,NaN,24534.655,24550.572565778064,24518.737434221934,24528.03774904616,24548.248473040472,24577.111885756545,24519.3850603244,1177,4504.333333333333,52.150203803510834,49.17529366410718,NaN,NaN,NaN,NaN,10.081675805710498,11.150766114894063,-88153
2025-09-16T16:35:00-04:00,24539,24542.25,24538,24542.25,NaN,NaN,NaN,24567.54594750237,NaN,NaN,24534.98,24550.840907915568,24519.11909208443,24528.03774904616,24548.239520770487,24577.086654101076,24519.392387439897,912,4356.3,54.63108746924353,49.624699936140196,NaN,NaN,NaN,NaN,9.665127533874033,10.837494808836743,-87241
2025-09-16T16:40:00-04:00,24542.25,24542.5,24540,24542,NaN,NaN,NaN,24567.54594750237,NaN,NaN,24535.395,24550.87856871137,24519.91143128863,24526.905889740166,24548.233201210754,24577.067544441546,24519.398857979962,709,4274.533333333334,54.35518266352162,50.1293505482924,NaN,NaN,NaN,NaN,9.15333271002589,10.584288681386665,-87950
2025-09-16T16:45:00-04:00,24542.25,24544,24538.5,24539.75,NaN,NaN,NaN,24567.54594750237,NaN,NaN,24535.71,24550.891356985154,24520.528643014844,24528.774711792135,24548.22379121383,24577.041219660463,24519.406362767197,952,4220.766666666666,51.818693165381355,50.52998470031135,NaN,NaN,NaN,NaN,8.892380373595469,10.349168705897306,-88902
2025-09-16T16:50:00-04:00,24539.75,24542.25,24538.25,24539,NaN,NaN,NaN,24567.54594750237,NaN,NaN,24536.08,24550.649982824612,24521.51001717539,24528.774711792135,24548.209132116644,24577.003507994435,24519.414756238853,1325,4179.833333333333,50.964950193055195,50.73290472087805,NaN,NaN,NaN,NaN,8.542924632624365,10.080870687535988,-90227
2025-09-16T16:55:00-04:00,24539.25,24540.75,24530.25,24531,NaN,NaN,NaN,24564.281966873645,NaN,NaN,24536.35,24550.004303370515,24522.695696629482,24528.774711792135,24548.183790326977,24576.958723998727,24519.408856655227,1355,4139.566666666667,42.854412637524135,49.7114197658844,NaN,NaN,NaN,NaN,8.682715730294053,10.286859000807933,-91582
2025-09-16T18:00:00-04:00,24531,24536,24525.25,24530.75,NaN,NaN,NaN,24559.564604743024,NaN,NaN,24536.515,24549.68671591304,24523.343284086957,24528.774711792135,24530.666666666668,24530.666666666668,24530.666666666668,2286,4120.366666666667,42.626121757791395,48.99421722887051,NaN,NaN,NaN,NaN,8.830378892415906,11.161493947442459,-93868
2025-09-16T18:05:00-04:00,24531.25,24536.75,24531.25,24534.75,NaN,NaN,NaN,24559.564604743024,NaN,NaN,24536.73,24549.419696605684,24524.040303394315,24528.774711792135,24531.757909948283,24533.406993469944,24530.10882642662,1001,4027.1666666666665,47.449736142872666,49.652972548569274,NaN,NaN,NaN,NaN,8.628208971529055,11.820956428974474,-92867
2025-09-16T18:10:00-04:00,24535,24540.25,24534.25,24539,NaN,NaN,NaN,24559.564604743024,NaN,NaN,24536.89,24549.488079211802,24524.291920788197,24528.774711792135,24532.82834168755,24535.584758325098,24530.07192505,703,3969,52.06139708310568,49.857545765279745,NaN,NaN,NaN,NaN,8.44047975927698,11.74007879890123,-92164
2025-09-16T18:15:00-04:00,24539.5,24540.5,24535,24537.25,NaN,NaN,NaN,24559.564604743024,NaN,NaN,24536.925,24549.517160278396,24524.332839721603,24528.774711792135,24533.54750762249,24536.60546955829,24530.48954568669,711,3882.4666666666667,50.111318553376414,50.054832999989216,NaN,NaN,NaN,NaN,8.230445490757196,11.616253211391188,-92875
2025-09-16T18:20:00-04:00,24537.25,24545.5,24536.75,24544.5,NaN,NaN,NaN,24559.564604743024,NaN,NaN,24537.07,24549.839510581303,24524.300489418696,24528.774711792135,24534.997665898478,24539.276674901274,24530.718656895682,940,3759.5333333333333,57.25477683090759,50.7024810062204,NaN,NaN,NaN,NaN,8.267556527131683,10.99254163385661,-91935
2025-09-16T18:25:00-04:00,24544.75,24546.25,24541.75,24545.5,NaN,NaN,NaN,24559.564604743024,NaN,NaN,24537.25,24550.23422119931,24524.26577880069,24529.863854110743,24535.806735863334,24540.683660206152,24530.929811520517,525,3670.1666666666665,58.14500324499712,51.148580590375396,NaN,NaN,NaN,NaN,7.998445346622277,10.542251858988434,-91410
2025-09-16T18:30:00-04:00,24545.75,24549.5,24545.25,24548.25,NaN,NaN,NaN,24559.564604743024,NaN,NaN,24537.385,24550.679814778356,24524.09018522164,24534.266083288596,24537.64908675799,24543.857594026707,24531.44057948927,1134,3501.133333333333,60.576561955424964,51.89126520204621,NaN,NaN,NaN,NaN,7.730699250434972,10.667262912670939,-90276
2025-09-16T18:35:00-04:00,24547.75,24551.5,24547,24549.25,NaN,NaN,NaN,24559.564604743024,NaN,NaN,24537.72,24551.345578876764,24524.094421123238,24537.062866630877,24538.664166666666,24545.44047040862,24531.887862924712,700,3315.6,61.45351081121745,52.60378259370932,NaN,NaN,NaN,NaN,7.499935018261046,11.097943562191826,-89576
2025-09-16T18:40:00-04:00,24549,24550.5,24544.25,24547,NaN,NaN,NaN,24559.564604743024,NaN,NaN,24537.975,24551.80693768887,24524.143062311126,24537.062866630877,24539.50891280664,24546.43276434706,24532.585061266218,873,3195.4666666666667,58.31058334831778,53.043809704052684,NaN,NaN,NaN,NaN,7.4106539455281135,10.920939679779423,-90449
2025-09-16T18:45:00-04:00,24547,24549.5,24545.25,24548.75,NaN,NaN,NaN,24559.564604743024,NaN,NaN,24538.305,24552.3603512883,24524.249648711702,24537.062866630877,24539.838682036294,24546.815572003066,24532.86179206952,366,3132.4,60.02310825664151,53.42895404600967,NaN,NaN,NaN,NaN,7.184892949418962,10.756578931825048,-90083
2025-09-16T18:50:00-04:00,24548,24550,24546.75,24549.25,NaN,NaN,NaN,24559.564604743024,NaN,NaN,24538.715,24552.82740943224,24524.60259056776,24537.28318771501,24540.178608596103,24547.227578365553,24533.129638826653,370,3021.3,60.52208683937298,53.869447201427626,NaN,NaN,NaN,NaN,6.903829167317608,10.697849181855277,-89713
2025-09-16T18:55:00-04:00,24549.25,24550,24545.75,24546,NaN,NaN,NaN,24559.564604743024,NaN,NaN,24538.955,24553.146437531956,24524.763562468048,24537.701550172005,24540.392698556865,24547.439096610524,24533.346300503206,300,2802.133333333333,55.659058743445414,54.1437590284322,NaN,NaN,NaN,NaN,6.714269941080636,10.407337820808864,-90013
2025-09-16T19:00:00-04:00,24546,24550.25,24545,24547.25,NaN,NaN,NaN,24559.564604743024,NaN,NaN,24539.23,24553.52050034119,24524.93949965881,24537.786240137604,24540.647864370498,24547.691837945444,24533.60389079555,369,2617.766666666667,57.087263355258905,54.58106711144676,NaN,NaN,NaN,NaN,6.609679231003448,9.95708931019058,-89644
2025-09-16T19:05:00-04:00,24547.5,24548.75,24545.5,24547.75,NaN,NaN,NaN,24559.564604743024,NaN,NaN,24539.5,24553.9135353054,24525.0864646946,24537.786240137604,24540.773595863164,24547.809872396952,24533.737319329375,197,2440.6,57.67452553543486,55.63964660415466,NaN,NaN,NaN,NaN,6.369702143074631,9.539001407473604,-89447
2025-09-16T19:10:00-04:00,24547.5,24547.75,24544.75,24545,NaN,NaN,NaN,24559.564604743024,NaN,NaN,24539.85,24553.92693149533,24525.773068504666,24537.786240137604,24540.88184323617,24547.880841755406,24533.882844716933,229,2257.7,53.35009991522285,56.4056450439712,NaN,NaN,NaN,NaN,6.129009132855015,8.951880222128786,-89676
2025-09-16T19:15:00-04:00,24545,24547,24542,24546.25,NaN,NaN,NaN,24559.564604743024,NaN,NaN,24540.155,24554.112037655872,24526.197962344126,24537.786240137604,24541.086110864217,24547.9723934483,24534.199828280132,547,2112.2,55.001691247690744,56.94507040860106,NaN,NaN,NaN,NaN,6.048365623365371,8.90958265078911,-89129
2025-09-16T19:20:00-04:00,24546.25,24546.5,24541.75,24541.75,NaN,NaN,NaN,24559.564604743024,NaN,NaN,24540.475,24553.81638299822,24527.13361700178,24537.786240137604,24541.174195844007,24547.938240943186,24534.41015074483,459,1679.1,48.363405601606914,56.68092815992258,NaN,NaN,NaN,NaN,5.955625221696416,8.930958546688915,-89588
2025-09-16T19:25:00-04:00,24541.5,24542,24536.5,24538.25,NaN,NaN,NaN,24559.564604743024,NaN,NaN,24540.655,24553.6233807872,24527.686619212796,24537.786240137604,24541.051329672693,24547.64864062596,24534.454018719425,674,1073.8666666666666,43.92309787157808,56.23891239693699,NaN,NaN,NaN,NaN,5.923080563003815,10.074333556574198,-90262
2025-09-16T19:30:00-04:00,24537.75,24542,24537,24539.25,NaN,NaN,NaN,24559.564604743024,NaN,NaN,24540.81,24553.51966560176,24528.10033439824,24537.786240137604,24540.970167293373,24547.411407045533,24534.528927541214,647,852.7,45.46372763392248,55.39669459715234,NaN,NaN,NaN,NaN,5.857146237074971,11.136038922896244,-89615
2025-09-16T19:35:00-04:00,24539,24543.75,24539,24542.75,NaN,NaN,NaN,24559.564604743024,NaN,NaN,24541.055,24553.428071558807,24528.681928441194,24537.786240137604,24540.998980045988,24547.333699820876,24534.6642602711,450,787.2666666666667,50.58123936608067,54.8564257486583,NaN,NaN,NaN,NaN,5.778064362998188,11.561726993689081,-89165
2025-09-16T19:40:00-04:00,24542.75,24544.5,24540,24540.5,NaN,NaN,NaN,24559.564604743024,NaN,NaN,24541.24,24553.29361354195,24529.186386458052,24537.786240137604,24541.018407154,24547.261297406763,24534.775516901234,404,753.9666666666667,47.495728317647476,53.92208048881705,NaN,NaN,NaN,NaN,5.686774051355459,11.72151539614305,-89569
2025-09-16T19:45:00-04:00,24540.25,24543,24538.5,24540.5,NaN,NaN,NaN,24559.564604743024,NaN,NaN,24541.405,24553.184596774317,24529.62540322568,24537.786240137604,24541.010434996828,24547.18239460527,24534.838475388387,322,723.5333333333333,47.49572831764747,52.92509602499062,NaN,NaN,NaN,NaN,5.6020044762586405,12.2219342226759,-89569
2025-09-16T19:50:00-04:00,24540.75,24543.75,24540.25,24543.25,NaN,NaN,NaN,24559.564604743024,NaN,NaN,24541.55,24553.23802806865,24529.86197193135,24537.153992110085,24541.0390405921,24547.151127210815,24534.926953973383,295,710.8666666666667,51.674366229546266,52.45108051650694,NaN,NaN,NaN,NaN,5.451861299383023,12.43331771464777,-89274
2025-09-16T19:55:00-04:00,24543.25,24546.25,24542.75,24543,NaN,NaN,NaN,24559.564604743024,NaN,NaN,24541.595,24553.287685736257,24529.902314263745,24536.973193688067,24541.117551632316,24547.1667957852,24535.068307479432,395,710.9,51.27484810854848,51.82620479164315,NaN,NaN,NaN,NaN,5.312442635141379,11.832925760368267,-89669
2025-09-16T20:00:00-04:00,24543,24549.25,24540.5,24547.25,NaN,NaN,NaN,24559.564604743024,NaN,NaN,24541.67,24553.458316261935,24529.881683738062,24536.37992923337,24541.50349141991,24547.427642581722,24535.579340258097,1381,717.7,57.316490906560325,51.597233653585114,NaN,NaN,NaN,NaN,5.557982446916995,11.526450608043366,-88288
2025-09-16T20:05:00-04:00,24547.25,24550,24545.75,24548,NaN,NaN,NaN,24559.564604743024,NaN,NaN,24541.695,24553.531507087322,24529.858492912677,24537.5789433867,24541.684953040432,24547.620721738633,24535.749184342232,474,703.1,58.299151967039144,51.78581174098466,NaN,NaN,NaN,NaN,5.4645551292800665,11.433872139885,-87814
2025-09-16T20:10:00-04:00,24547.5,24549.5,24530.75,24534,NaN,NaN,NaN,24559.564604743024,NaN,NaN,24541.37,24553.14125311359,24529.598746886408,24537.5789433867,24541.358101751335,24547.111904306934,24535.604299195737,1672,735.2,39.85444233592305,50.554895953889236,NaN,NaN,NaN,NaN,6.413515477188633,12.918310816238353,-89486
2025-09-16T20:15:00-04:00,24533.5,24539,24532.75,24537.75,NaN,NaN,NaN,24556.526757484837,NaN,NaN,24541.105,24552.590247063774,24529.619752936225,24537.5789433867,24541.13495762346,24546.846337412913,24535.423577834008,887,733.0333333333333,44.88448183459807,49.64132140382947,NaN,NaN,NaN,NaN,6.401835800246587,14.29671815856647,-88599
2025-09-16T20:20:00-04:00,24537.25,24539,24532.5,24534.5,NaN,NaN,NaN,24556.34940487189,NaN,NaN,24540.785,24552.09561890279,24529.47438109721,24537.5789433867,24540.95589514537,24546.66727530009,24535.24451499065,615,709.3666666666667,41.634659401469875,48.80450422427568,NaN,NaN,NaN,NaN,6.408847528800402,15.61243923462985,-89214
2025-09-16T20:25:00-04:00,24534.25,24540.25,24534,24539.75,NaN,NaN,NaN,24556.34940487189,NaN,NaN,24540.59,24551.6257419343,24529.554258065702,24537.5789433867,24540.888913413117,24546.552321304807,24535.225505521426,462,679.6,48.16381573143768,48.31608454454333,NaN,NaN,NaN,NaN,6.39750127674323,16.47148070430246,-88752
2025-09-16T20:30:00-04:00,24540.25,24543.25,24538,24538.5,NaN,NaN,NaN,24556.34940487189,NaN,NaN,24540.435,24551.36560381786,24529.504396182143,24537.5789433867,24540.862110082988,24546.44917500836,24535.275045157614,578,622.6666666666666,46.82081453156807,48.20589946811198,NaN,NaN,NaN,NaN,6.315536899832999,16.44872197698733,-89330
2025-09-16T20:35:00-04:00,24538.5,24538.5,24532,24533,NaN,NaN,NaN,24555.512428485967,NaN,NaN,24540.36,24551.441137136026,24529.278862863976,24537.5789433867,24540.67537037037,24546.283601343945,24535.067139396793,634,610.4333333333333,41.35648931044948,48.02257028517422,NaN,NaN,NaN,NaN,6.328712835559214,17.399947070899145,-89964
2025-09-16T20:40:00-04:00,24533.25,24538.75,24533,24534.5,NaN,NaN,NaN,24555.512428485967,NaN,NaN,24540.335,24551.463166969515,24529.206833030483,24537.5789433867,24540.565714717435,24546.16580646654,24534.96562296833,460,602.3333333333334,43.300030083704286,47.86802046015864,NaN,NaN,NaN,NaN,6.287376204447841,18.216189751951344,-89504
2025-09-16T20:45:00-04:00,24534,24540.5,24533.25,24540.5,NaN,NaN,NaN,24555.512428485967,NaN,NaN,24540.45,24551.463173927703,24529.4368260723,24537.5789433867,24540.525745952455,24546.089351311894,24534.962140593016,361,590.6666666666666,50.383477748776535,47.8538946303512,NaN,NaN,NaN,NaN,6.356135046987281,18.498362445966684,-89143
2025-09-16T20:50:00-04:00,24540.75,24541,24536.5,24540.5,NaN,NaN,NaN,24555.512428485967,NaN,NaN,24540.535,24551.48260704631,24529.58739295369,24537.5789433867,24540.51280495875,24546.047516726176,24534.978093191326,246,567.5333333333333,50.383477748776535,48.06016244686042,NaN,NaN,NaN,NaN,6.223553972202475,18.623732747607487,-89143
2025-09-16T20:55:00-04:00,24540.5,24542.75,24538.5,24540.5,NaN,NaN,NaN,24555.512428485967,NaN,NaN,24540.455,24551.343842903472,24529.56615709653,24530.188154709358,24540.5142018018,24545.993839673312,24535.03456393029,458,565.3,50.383477748776535,48.266430263369635,NaN,NaN,NaN,NaN,6.082585831330869,18.26141540495443,-89143
2025-09-16T21:00:00-04:00,24540.75,24546,24540.5,24544.5,NaN,NaN,NaN,24555.512428485967,NaN,NaN,24540.53,24551.477438068374,24529.582561931624,24531.62966848128,24540.59042605564,24546.025028042717,24535.155824068566,573,546.6,55.05838819870248,48.50814611830936,NaN,NaN,NaN,NaN,6.040972557664378,17.111548337282162,-88570
2025-09-16T21:05:00-04:00,24544.5,24545.5,24540.75,24544.5,NaN,NaN,NaN,24555.512428485967,NaN,NaN,24540.94,24550.86852457051,24531.01147542949,24531.62966848128,24540.64266760645,24546.04387010356,24535.241465109342,421,537.3,55.05838819870248,48.77839898189179,NaN,NaN,NaN,NaN,5.948760232116922,16.043814631586482,-88570
2025-09-16T21:10:00-04:00,24544.5,24547.25,24542.5,24545.25,NaN,NaN,NaN,24555.512428485967,NaN,NaN,24541.12,24551.02819864933,24531.21180135067,24533.77798782802,24540.72021094641,24546.104047249228,24535.33637464359,437,522.7666666666667,55.96070281887052,48.68155697562823,NaN,NaN,NaN,NaN,5.863134501251428,15.173403531848791,-88133
2025-09-16T21:15:00-04:00,24544.5,24544.75,24538,24540.5,NaN,NaN,NaN,24555.512428485967,NaN,NaN,24541.255,24550.939260411185,24531.570739588817,24533.77798782802,24540.729574968922,24546.04385169244,24535.415298245403,650,532.2333333333333,49.22050770029414,48.03308238514645,NaN,NaN,NaN,NaN,5.9621963225906125,14.854915123456808,-88783
2025-09-16T21:20:00-04:00,24540.25,24541.5,24535.25,24540.25,NaN,NaN,NaN,24555.512428485967,NaN,NaN,24541.365,24550.87457937131,24531.855420628694,24533.77798782802,24540.694615045737,24545.96053701777,24535.428693073703,520,537.2333333333333,48.88676506478932,48.67824829435119,NaN,NaN,NaN,NaN,5.982753728119854,15.09830915309596,-89303
2025-09-16T21:25:00-04:00,24540,24543.25,24536.75,24540.5,NaN,NaN,NaN,24555.512428485967,NaN,NaN,24541.39,24550.88376637079,24531.89623362921,24533.77798782802,24540.68504382784,24545.9034897168,24535.466597938885,475,543.0666666666667,49.25729550813196,48.99059212817504,NaN,NaN,NaN,NaN,6.019699890397007,14.861730517071589,-88828
2025-09-16T21:30:00-04:00,24540,24540.25,24527.75,24530.5,NaN,NaN,NaN,24553.97036757528,NaN,NaN,24541.255,24551.163324761437,24531.346675238565,24533.77798782802,24540.345846723147,24545.69411364651,24534.997579799783,1183,570.2,37.535844145561455,48.697819609895866,NaN,NaN,NaN,NaN,6.500435612511507,16.10837500217283,-90011
2025-09-16T21:35:00-04:00,24531,24535,24528.5,24529,NaN,NaN,NaN,24551.698987230946,NaN,NaN,24541.06,24551.52592564987,24530.594074350134,24533.77798782802,24540.106763972944,24545.593307411582,24534.620220534307,706,587.1666666666666,36.1463669533335,47.839430411459844,NaN,NaN,NaN,NaN,6.500404497332114,17.26597345262398,-90717
2025-09-16T21:40:00-04:00,24529.25,24535,24529.25,24533.5,NaN,NaN,NaN,24551.698987230946,NaN,NaN,24540.94,24551.610313976496,24530.2696860235,24533.77798782802,24539.970538543996,24545.498958715623,24534.442118372368,518,596.8,42.96717822098367,47.56417067498954,NaN,NaN,NaN,NaN,6.464661318951249,18.34088629947148,-90199
2025-09-16T21:45:00-04:00,24533.25,24536,24532.5,24535,NaN,NaN,NaN,24551.698987230946,NaN,NaN,24540.795,24551.586519846463,24530.003480153533,24533.77798782802,24539.909088814387,24545.436520600968,24534.381657027807,325,589.4,45.07336481504349,47.82966178246054,NaN,NaN,NaN,NaN,6.252899796169017,19.04334799865291,-89874
2025-09-16T21:50:00-04:00,24536,24536.25,24531.5,24534.25,NaN,NaN,NaN,24551.698987230946,NaN,NaN,24540.64,24551.579451555805,24529.700548444194,24533.77798782802,24539.84305080884,24545.374499180314,24534.311602437363,327,585,44.19455393062042,47.89355634295455,NaN,NaN,NaN,NaN,6.145549810728373,19.862846417724157,-90201
2025-09-16T21:55:00-04:00,24534.25,24536,24530.5,24530.75,NaN,NaN,NaN,24551.698987230946,NaN,NaN,24540.46,24551.742889714576,24529.17711028542,24533.77798782802,24539.783381925845,24545.332313998693,24534.234449852996,237,570.4333333333333,40.25053849227656,47.16977496749026,NaN,NaN,NaN,NaN,6.099439109962061,20.792107827685488,-90438
2025-09-16T22:00:00-04:00,24530.75,24533.5,24528.25,24529.25,NaN,NaN,NaN,24549.800345988788,NaN,NaN,24540.265,24551.971156502274,24528.558843497725,24530.347390262417,24539.628034344783,24545.26083068653,24533.995238003037,493,565.3,38.658256396710215,46.33225915662838,NaN,NaN,NaN,NaN,6.038764887821913,22.019052108956146,-90931
2025-09-16T22:05:00-04:00,24529,24531.25,24526.5,24528.75,NaN,NaN,NaN,24547.587830262026,NaN,NaN,24540.22,24552.084501669284,24528.35549833072,24528.282329767946,24539.46112241883,24545.206703539858,24533.715541297803,471,566,38.11696630965832,45.456079768119935,NaN,NaN,NaN,NaN,5.946710252977491,23.423293166850254,-91402
2025-09-16T22:10:00-04:00,24529.5,24529.75,24523.75,24525.75,NaN,NaN,NaN,24545.43042888648,NaN,NaN,24540.12,24552.37978795041,24527.86021204959,24528.282329767946,24539.187764492868,24545.171993287582,24533.203535698154,652,574.2666666666667,34.954493776864126,44.0200873094172,NaN,NaN,NaN,NaN,5.950516663479099,25.110038300395427,-92054
2025-09-16T22:15:00-04:00,24526.25,24527.5,24520.75,24522,NaN,NaN,NaN,24542.876773028,NaN,NaN,24539.865,24553.055985539908,24526.674014460095,24521.900863814357,24538.868915656327,24545.19457171706,24532.543259595594,642,584.9333333333333,31.44274395216685,42.3332555775218,NaN,NaN,NaN,NaN,6.007622616087735,27.04491197693738,-92696
2025-09-16T22:20:00-04:00,24522,24522.25,24513.25,24513.5,NaN,NaN,NaN,24536.87669243582,NaN,NaN,24539.355,24554.47157699417,24524.23842300583,24521.37519381836,24538.06546660998,24545.551987256782,24530.578945963178,1174,614.2333333333333,25.25033032370105,40.13965754215254,NaN,NaN,NaN,NaN,6.221363857795754,29.551150171010892,-93870
2025-09-16T22:25:00-04:00,24514,24519.5,24513.25,24518.5,NaN,NaN,NaN,24535.484570052377,NaN,NaN,24538.98,24555.178407331518,24522.78159266848,24521.37519381836,24537.655019948787,24545.61712873299,24529.692911164584,657,622.9666666666667,33.541669949617386,39.01974055996135,NaN,NaN,NaN,NaN,6.223409296524628,31.878371351222018,-93213
2025-09-16T22:30:00-04:00,24518.5,24524.5,24515.75,24521,NaN,NaN,NaN,24535.484570052377,NaN,NaN,24538.51,24555.389857840502,24521.630142159494,24521.37519381836,24537.33267593837,24545.558398350593,24529.10695352615,640,598.2666666666667,37.28730596722867,38.19120776727844,NaN,NaN,NaN,NaN,6.403880061058584,32.43616474645884,-92573
2025-09-16T22:35:00-04:00,24521,24521.25,24518,24520.75,NaN,NaN,NaN,24535.484570052377,NaN,NaN,24538.015,24555.48709490312,24520.542905096878,24521.37519381836,24537.098376327038,24545.50991626458,24528.686836389497,469,598.1,37.0623519220376,37.3201403682717,NaN,NaN,NaN,NaN,6.178602913840114,32.954115756321606,-93042
2025-09-16T22:40:00-04:00,24520,24523.75,24520,24522.25,NaN,NaN,NaN,24535.484570052377,NaN,NaN,24537.495,24555.262805168695,24519.727194831303,24521.35015505469,24536.948439536187,24545.45095043523,24528.445928637142,348,553.9666666666667,39.42376001517966,37.454991501815854,NaN,NaN,NaN,NaN,6.00513127713725,32.69362371263283,-92694
2025-09-16T22:45:00-04:00,24523,24524.75,24517.75,24519.5,NaN,NaN,NaN,24535.484570052377,NaN,NaN,24536.9,24555.041940362444,24518.75805963756,24519.15512404375,24536.795632508834,24545.40253858876,24528.188726428907,332,535.4666666666667,36.70476096472214,37.49487678834362,NaN,NaN,NaN,NaN,6.076193328770303,32.790988393364714,-93026
2025-09-16T22:50:00-04:00,24519.25,24522.75,24518,24520,NaN,NaN,NaN,24535.484570052377,NaN,NaN,24536.36,24554.870850868723,24517.849149131278,24517.399099235,24536.666619919783,24545.362547822122,24527.970692017443,278,524.2333333333333,37.548131538036245,37.107802025275944,NaN,NaN,NaN,NaN,5.981465233858139,32.88139845404433,-92748
2025-09-16T22:55:00-04:00,24520.25,24525.5,24520,24524.25,NaN,NaN,NaN,24535.484570052377,NaN,NaN,24535.87,24554.34004061351,24517.399959386486,24515.669279388,24536.529920877292,24545.285721647182,24527.774120107402,367,521.0666666666667,44.337281773894816,37.055224665193904,NaN,NaN,NaN,NaN,5.947074860011129,32.13273183002601,-92381
2025-09-16T23:00:00-04:00,24524,24524.5,24519.75,24523.25,NaN,NaN,NaN,24535.484570052377,NaN,NaN,24535.35,24553.74782595904,24516.95217404096,24512.8604235104,24536.407525387345,24545.22214149215,24527.59290928254,317,512.3666666666667,43.148688319373804,36.980519978676284,NaN,NaN,NaN,NaN,5.861569512867477,31.48432885666631,-92698
2025-09-16T23:05:00-04:00,24523.25,24525,24521,24521,NaN,NaN,NaN,24535.484570052377,NaN,NaN,24534.85,24553.42094505173,24516.279054948267,24512.032331667746,24536.33163400303,24545.182670341987,24527.48059766407,197,497.8,40.51680482044954,36.99953900211721,NaN,NaN,NaN,NaN,5.728600261948372,30.72529174664327,-92895
2025-09-16T23:10:00-04:00,24521.25,24525.25,24520,24524.5,NaN,NaN,NaN,24535.484570052377,NaN,NaN,24534.395,24552.84278848435,24515.94721151565,24512.250865334197,24536.246612097642,24545.131243642863,24527.36198055242,239,490.43333333333334,46.03136299614251,37.52618947350523,NaN,NaN,NaN,NaN,5.694414528952059,30.229830388146052,-92656
2025-09-16T23:15:00-04:00,24524.5,24524.5,24521,24523,NaN,NaN,NaN,24535.484570052377,NaN,NaN,24533.9,24552.215567150328,24515.584432849675,24512.35069226736,24536.161798218352,24545.08188734041,24527.241709096295,234,486.2,44.14258008226583,37.956590457262905,NaN,NaN,NaN,NaN,5.537670634026911,29.76975912668435,-92890
2025-09-16T23:20:00-04:00,24523.75,24526.75,24521.75,24521.75,NaN,NaN,NaN,24535.484570052377,NaN,NaN,24533.435,24551.78024732779,24515.08975267221,24514.530553813885,24536.052874225294,24545.011912250393,24527.093836200194,319,488.6333333333333,42.574803057206054,38.50089826300161,NaN,NaN,NaN,NaN,5.499265588739275,28.56334477802135,-93209
2025-09-16T23:25:00-04:00,24522,24523.25,24521.5,24522.5,NaN,NaN,NaN,24535.484570052377,NaN,NaN,24532.96,24551.182886716768,24514.73711328323,24514.530553813885,24535.978391196608,24544.969279066907,24526.98750332631,205,480.2,43.86308540241639,39.388065509448005,NaN,NaN,NaN,NaN,5.231460903829327,27.508037322085276,-93004
2025-09-16T23:30:00-04:00,24522.25,24523,24518.5,24520.75,NaN,NaN,NaN,24535.484570052377,NaN,NaN,24532.54,24550.90065357707,24514.17934642293,24514.530553813885,24535.80509970234,24544.88943299856,24526.720766406117,432,475.5,41.52235187871284,40.55035276337742,NaN,NaN,NaN,NaN,5.179213696412947,27.259832401328925,-93436
2025-09-16T23:35:00-04:00,24520.5,24521.25,24517.75,24518.25,NaN,NaN,NaN,24535.484570052377,NaN,NaN,24532.14,24550.853674146856,24513.426325853143,24514.530553813885,24535.67572771548,24544.842691605823,24526.508763825135,296,471.3333333333333,38.37203477942734,40.895378822649555,NaN,NaN,NaN,NaN,5.0592698609548785,27.197568408385692,-93732
2025-09-16T23:40:00-04:00,24518,24522.75,24518,24520.75,NaN,NaN,NaN,24535.484570052377,NaN,NaN,24531.77,24550.63765486176,24512.90234513824,24514.530553813885,24535.55492316202,24544.78438652068,24526.32545980336,307,467,43.027095693629384,41.305363803106744,NaN,NaN,NaN,NaN,5.037179156600958,26.574706206732824,-93425
2025-09-16T23:45:00-04:00,24521,24523,24519,24519.25,NaN,NaN,NaN,24535.484570052377,NaN,NaN,24531.3,24550.220887941025,24512.379112058974,24514.530553813885,24535.44232616994,24544.72894313028,24526.1557092096,289,454.96666666666664,41.02479238413485,41.588395264685126,NaN,NaN,NaN,NaN,4.963094931129461,25.902319668915013,-93714
2025-09-16T23:50:00-04:00,24519.5,24520.75,24516.25,24517.75,NaN,NaN,NaN,24534.51871463189,NaN,NaN,24530.845,24549.952299642086,24511.737700357917,24514.530553813885,24535.329357571412,24544.689058706426,24525.9696564364,257,446.2,39.06693155402737,41.56290751745996,NaN,NaN,NaN,NaN,4.930016721763072,25.966098972584543,-93971
2025-09-16T23:55:00-04:00,24517.75,24520.25,24517,24518.5,NaN,NaN,NaN,24534.358773057713,NaN,NaN,24530.405,24549.615645502017,24511.19435449798,24514.530553813885,24535.22173038655,24544.64678822963,24525.79667254347,253,438.8,40.59352672553117,41.84067650037489,NaN,NaN,NaN,NaN,4.810015527351424,26.025322611706255,-93718
2025-09-17T00:00:00-04:00,24518.75,24523,24517.25,24517.25,NaN,NaN,NaN,24534.358773057713,NaN,NaN,24529.885,24549.084273439406,24510.68572656059,24514.530553813885,24535.058232755004,24544.572712569097,24525.54375294091,405,412.8666666666667,38.846667002676206,41.933429033563456,NaN,NaN,NaN,NaN,4.87715727539775,25.003935921431307,-94123
2025-09-17T00:05:00-04:00,24517.25,24519.5,24515,24518.5,NaN,NaN,NaN,24532.948024624897,NaN,NaN,24529.395,24548.480620241968,24510.309379758033,24514.530553813885,24534.95347737705,24544.534236607782,24525.37271814632,241,397.3666666666667,41.55518615258067,41.7347079177553,NaN,NaN,NaN,NaN,4.850217470012197,24.65319914049476,-93882
2025-09-17T00:10:00-04:00,24518.75,24521.25,24513.5,24513.5,NaN,NaN,NaN,24532.948024624897,NaN,NaN,24528.72,24547.618317384753,24509.82168261525,24512.59944305111,24534.7685446416,24544.48177672855,24525.05531255465,396,393.3,34.89714659690834,41.145312080436334,NaN,NaN,NaN,NaN,5.057344793582755,23.696523241891356,-94278
2025-09-17T00:15:00-04:00,24513.5,24514,24507.75,24514,NaN,NaN,NaN,24527.039419131364,NaN,NaN,24528.04,24546.557386424305,24509.522613575697,24512.465531873735,24534.199977476386,24544.430766044206,24523.969188908566,1031,416.8333333333333,36.001418870381556,40.82278451257434,NaN,NaN,NaN,NaN,5.1425344511839866,24.117275118173573,-93247
2025-09-17T00:20:00-04:00,24514,24516.75,24511.25,24511.75,NaN,NaN,NaN,24527.039419131364,NaN,NaN,24527.595,24546.581545240897,24508.608454759105,24512.465531873735,24533.975902847407,24544.377521725237,24523.574283969578,448,420.8666666666667,33.26687236764795,39.91103518196758,NaN,NaN,NaN,NaN,5.168067704670845,23.618034827224694,-93695
2025-09-17T00:25:00-04:00,24511.5,24514.5,24510.5,24512.25,NaN,NaN,NaN,24527.039419131364,NaN,NaN,24527.085,24546.321322423675,24507.848677576323,24512.465531873735,24533.88161001505,24544.357509157737,24523.405710872365,184,419.1,34.45826739566952,39.219298561496416,NaN,NaN,NaN,NaN,5.084634297194356,23.317019204665474,-93511
2025-09-17T00:30:00-04:00,24511.75,24516,24510.75,24511.75,NaN,NaN,NaN,24527.039419131364,NaN,NaN,24526.63,24546.216280908,24507.043719092002,24512.465531873735,24533.761226129696,24544.327028024112,24523.19542423528,242,410.73333333333335,33.80825484769858,38.5931165465316,NaN,NaN,NaN,NaN,5.096446133109045,22.561191173620447,-93753
2025-09-17T00:35:00-04:00,24512,24520.5,24511.5,24519.25,NaN,NaN,NaN,24527.039419131364,NaN,NaN,24526.22,24545.547089780008,24506.892910219995,24511.991352319354,24533.58842045764,24544.23415385875,24522.94268705653,443,409.8,49.26756072677008,38.97915049827115,NaN,NaN,NaN,NaN,5.375271409315542,21.27084198990578,-93310
2025-09-17T00:40:00-04:00,24519.5,24522,24518.5,24518.75,NaN,NaN,NaN,24527.039419131364,NaN,NaN,24525.825,24544.938149911075,24506.711850088926,24511.991352319354,24533.487210742198,24544.15928214424,24522.815139340157,315,398.56666666666666,48.45506927232046,39.47434459781455,NaN,NaN,NaN,NaN,5.24132345150729,20.42749462327842,-93625
2025-09-17T00:45:00-04:00,24518.75,24520,24516,24516,NaN,NaN,NaN,24527.039419131364,NaN,NaN,24525.485,24544.6801582347,24506.2898417653,24511.991352319354,24533.41589037084,24544.11809934765,24522.713681394034,191,383.53333333333336,44.14316977755827,39.88656852625247,NaN,NaN,NaN,NaN,5.152657490685341,18.976740648998227,-93816
2025-09-17T00:50:00-04:00,24516.25,24518.5,24516,24517.25,NaN,NaN,NaN,24527.039419131364,NaN,NaN,24525.14,24544.294675678822,24505.985324321176,24508.529465484386,24533.364486124865,24544.088357839457,24522.640614410273,138,349,46.47474873871026,40.13282945804396,NaN,NaN,NaN,NaN,4.963181955636387,17.62961195859519,-93678
2025-09-17T00:55:00-04:00,24517.25,24519.25,24516,24518.75,NaN,NaN,NaN,24527.039419131364,NaN,NaN,24524.705,24543.42763069239,24505.982369307614,24508.529465484386,24533.30488737911,24544.0504672545,24522.559307503718,169,332.73333333333335,49.21431066776236,40.71779504973164,NaN,NaN,NaN,NaN,4.840811815948074,16.5845528390628,-93509
2025-09-17T01:00:00-04:00,24519.5,24521.75,24517.25,24520,NaN,NaN,NaN,24527.039419131364,NaN,NaN,24524.295,24542.506998802623,24506.083001197374,24510.830420766695,24533.19958852422,24543.969963601456,24522.429213446987,339,322.7,51.444610674466404,41.60191498690586,NaN,NaN,NaN,NaN,4.8164681148089254,16.26440632303196,-93170
2025-09-17T01:05:00-04:00,24519.75,24526.75,24509.25,24525.5,NaN,NaN,NaN,24527.039419131364,NaN,NaN,24523.995,24541.61387909408,24506.37612090592,24510.830420766695,24532.880949737617,24543.69924487069,24522.062654604542,1130,344.73333333333335,59.80826457369213,42.974396261774494,NaN,NaN,NaN,NaN,5.72243467803686,16.19507562914855,-92040
2025-09-17T01:10:00-04:00,24525.25,24527,24517,24519.25,NaN,NaN,NaN,24527.039419131364,NaN,NaN,24523.49,24540.150420151618,24506.829579848385,24510.830420766695,24532.722783266512,24543.553638579473,24521.89192795355,612,353.53333333333336,49.39585722694949,43.72790984922259,NaN,NaN,NaN,NaN,6.027975058177084,16.063518436254153,-92652
2025-09-17T01:15:00-04:00,24519,24520.5,24499.75,24507.75,NaN,NaN,NaN,24527.039419131364,NaN,NaN,24522.755,24538.87687643626,24506.63312356374,24510.830420766695,24531.88778104029,24543.3748420827,24520.400719997877,1690,398.8,36.726122240347834,43.38297671263452,NaN,NaN,NaN,NaN,7.079548268307292,18.2501316629082,-94342
2025-09-17T01:20:00-04:00,24507.5,24516,24506.75,24511.5,NaN,NaN,NaN,24527.039419131364,NaN,NaN,24522.08,24537.17120272038,24506.988797279624,24510.830420766695,24531.553018811723,24543.23786598029,24519.868171643157,787,415.76666666666665,41.95446369651275,43.88707079117769,NaN,NaN,NaN,NaN,7.234580534856771,20.28055823051553,-93555
2025-09-17T01:25:00-04:00,24510.75,24512.5,24508.75,24511,NaN,NaN,NaN,24527.039419131364,NaN,NaN,24521.49,24535.947855984436,24507.032144015568,24510.830420766695,24531.45064683097,24543.19726019036,24519.70403347158,238,411.46666666666664,41.46251641128093,44.277149186956215,NaN,NaN,NaN,NaN,6.985681925224144,22.16595432900805,-93793
2025-09-17T01:30:00-04:00,24510.75,24511.25,24508,24511,NaN,NaN,NaN,24527.039419131364,NaN,NaN,24520.905,24534.627569014447,24507.18243098555,24510.830420766695,24531.320668927245,24543.148769204756,24519.492568649734,296,410.76666666666665,41.46251641128093,44.86255233293,NaN,NaN,NaN,NaN,6.7188475019938485,23.993169907335034,-93793
2025-09-17T01:35:00-04:00,24511.25,24512.75,24507.25,24512,NaN,NaN,NaN,24527.039419131364,NaN,NaN,24520.335,24533.08788595935,24507.582114040648,24510.830420766695,24531.141003049004,24543.072704244423,24519.209301853585,427,418.43333333333334,43.01247311536021,45.47356702719362,NaN,NaN,NaN,NaN,6.6317869661371445,25.25231830699719,-93366
2025-09-17T01:40:00-04:00,24512,24516,24508.75,24514.75,NaN,NaN,NaN,24527.039419131364,NaN,NaN,24520.02,24532.528732949486,24507.511267050515,24510.830420766695,24530.888641719892,24542.923549696283,24518.8537337435,699,433.76666666666665,47.15625142377603,46.426995354056295,NaN,NaN,NaN,NaN,6.675945039984491,25.529226215012237,-92667
2025-09-17T01:45:00-04:00,24514.75,24519.75,24514.5,24516.5,NaN,NaN,NaN,24527.039419131364,NaN,NaN,24519.77,24532.048371225996,24507.491628774005,24510.830420766695,24530.788613022232,24542.83808047081,24518.739145573654,359,437.93333333333334,49.664558058094244,46.45535230629373,NaN,NaN,NaN,NaN,6.574091822842742,24.875246968326895,-92308
2025-09-17T01:50:00-04:00,24516.75,24517.75,24513.25,24516.5,NaN,NaN,NaN,24527.039419131364,NaN,NaN,24519.43,24531.09492178448,24507.76507821552,24509.264336613356,24530.69260338029,24542.762574918077,24518.6226318425,324,438.1,49.664558058094244,46.54174436242043,NaN,NaN,NaN,NaN,6.425942406925403,24.472540170765736,-92308
2025-09-17T01:55:00-04:00,24516.5,24519.5,24515.5,24518.25,NaN,NaN,NaN,24527.039419131364,NaN,NaN,24519.095,24529.881051159366,24508.308948840637,24508.011469290686,24530.644061272425,24542.717325922895,24518.570796621956,190,437.6,52.29093628671602,47.12372768450313,NaN,NaN,NaN,NaN,6.252660806430732,23.680442966483774,-92118
2025-09-17T02:00:00-04:00,24518.25,24524.75,24515.75,24517,NaN,NaN,NaN,24527.039419131364,NaN,NaN,24518.75,24528.641410422817,24508.858589577183,24508.45354687211,24530.38648321819,24542.443947235988,24518.32901920039,1163,461.96666666666664,50.27314569788911,47.3950417530159,NaN,NaN,NaN,NaN,6.448899320257108,22.141803909466,-93281
2025-09-17T02:05:00-04:00,24517.25,24520.25,24515,24516,NaN,NaN,NaN,24527.039419131364,NaN,NaN,24518.455,24527.759670870342,24509.15032912966,24508.45354687211,24530.270445184073,24542.338772846233,24518.202117521912,456,467.3,48.655597772596984,47.355133689075515,NaN,NaN,NaN,NaN,6.363263654524458,20.562574035749968,-93737
2025-09-17T02:10:00-04:00,24515.5,24522.5,24509.25,24521.5,NaN,NaN,NaN,24527.039419131364,NaN,NaN,24518.3,24527.126097670847,24509.47390232915,24508.45354687211,24530.046290382164,24542.12078068718,24517.97180007715,953,488.8333333333333,56.87432194624759,47.742970208488465,NaN,NaN,NaN,NaN,6.855173393486996,20.131305232020686,-92784
2025-09-17T02:15:00-04:00,24521.25,24522.25,24516.25,24516.25,NaN,NaN,NaN,24527.039419131364,NaN,NaN,24518.05,24526.371658488544,24509.728341511454,24508.45354687211,24529.946750117968,24542.018509336067,24517.87499089987,453,494.3,48.8381089323246,46.95938766267649,NaN,NaN,NaN,NaN,6.794089579666496,19.7308413428435,-93237
2025-09-17T02:20:00-04:00,24517,24526.75,24517,24526.25,NaN,NaN,NaN,24527.039419131364,NaN,NaN,24518.06,24526.419760738994,24509.70023926101,24508.45354687211,24529.86727276073,24541.88789581007,24517.84664971139,653,507.5,60.33474612375749,47.74073686959135,NaN,NaN,NaN,NaN,7.058797466833175,18.404542436594735,-92584
2025-09-17T02:25:00-04:00,24526.5,24529.5,24523.75,24525.75,24506.65703285091,24506.65703285091,24506.65703285091,NaN,NaN,NaN,24518.135,24526.699584046844,24509.570415953152,24510.697778239053,24529.823086475837,24541.77477645018,24517.871396501494,688,522,59.613434273661376,49.37554487197089,NaN,NaN,NaN,NaN,6.965311933487948,17.52216687920708,-93272
2025-09-17T02:30:00-04:00,24524.75,24526.25,24516.75,24523.25,24506.65703285091,NaN,NaN,NaN,NaN,NaN,24518.33,24526.907552095334,24509.75244790467,24510.697778239053,24529.73107727117,24541.641092287704,24517.82106225464,662,530.5666666666667,56.007978574861134,50.379367363281496,NaN,NaN,NaN,NaN,7.146361081095952,17.076997118896493,-93934
2025-09-17T02:35:00-04:00,24524,24529.25,24523.75,24528.25,24506.65703285091,NaN,NaN,NaN,NaN,NaN,24518.525,24527.541235330904,24509.5087646691,24510.697778239053,24529.707889068864,24541.56820303526,24517.84757510247,492,538.9333333333333,61.078165825302875,51.780485178568775,NaN,NaN,NaN,NaN,7.064478146731956,16.10580091973525,-93442
2025-09-17T02:40:00-04:00,24528.25,24530.75,24524.25,24529,24507.285326468096,NaN,NaN,NaN,NaN,NaN,24518.685,24528.14428643308,24509.225713566924,24512.433262458395,24529.691927207317,24541.497831878867,24517.886022535768,530,543.4,61.7895563933018,53.232416605855974,NaN,NaN,NaN,NaN,7.024158279108244,14.97591768522051,-92912
2025-09-17T02:45:00-04:00,24529.25,24530.75,24527,24528.75,24509.067811628636,NaN,NaN,NaN,NaN,NaN,24518.845,24528.700906848342,24508.98909315166,24514.221609966717,24529.686062803197,24541.451792314292,24517.920333292102,390,522.0333333333333,61.3867900630913,54.5448678164082,NaN,NaN,NaN,NaN,6.790289830600512,13.926740396028253,-93302
2025-09-17T02:50:00-04:00,24528.5,24534,24527.75,24531,24511.115865645515,NaN,NaN,NaN,NaN,NaN,24519.02,24529.40789678337,24508.63210321663,24517.65228797337,24529.703883173963,24541.385037405686,24518.02272894224,839,535.0666666666667,63.68132795543972,55.725230425812754,NaN,NaN,NaN,NaN,6.751697699843333,13.549512628539112,-92463
2025-09-17T02:55:00-04:00,24530.5,24534,24528.5,24532,24511.639008116173,NaN,NaN,NaN,NaN,NaN,24519.27,24530.27538048502,24508.26461951498,24518.1718303787,24529.72001237249,24541.34983410355,24518.090190641433,525,546.4333333333333,64.68573930576571,56.798171943503576,NaN,NaN,NaN,NaN,6.662290721283094,13.19922970158491,-91938
2025-09-17T03:00:00-04:00,24531.75,24535.25,24525.25,24534.5,24511.639008116173,NaN,NaN,NaN,NaN,NaN,24519.56,24531.362355694415,24507.757644305588,24518.1718303787,24529.765411216355,24541.262574991637,24518.268247441072,1396,584.9,67.13292748528329,58.04591261687421,NaN,NaN,NaN,NaN,6.90069852690573,12.326463897140961,-90542
2025-09-17T03:05:00-04:00,24534.5,24538.75,24529.5,24536.25,24513.69329045296,NaN,NaN,NaN,NaN,NaN,24519.8,24532.43289357798,24507.167106422017,24519.994971442367,24529.856371575912,24541.26974070425,24518.443002447573,1094,606.6,68.76465014846917,59.2226064641423,NaN,NaN,NaN,NaN,7.068505774983892,12.048069417873474,-89448
2025-09-17T03:10:00-04:00,24536.75,24539,24531.75,24532.25,24514.883368159644,NaN,NaN,NaN,NaN,NaN,24519.98,24533.05319395017,24506.90680604983,24520.370977153892,24529.910215576623,24541.265235099407,24518.55519605384,742,620.8333333333334,61.276325522798,60.008547880207225,NaN,NaN,NaN,NaN,7.081469648199329,11.836109402878572,-90190
2025-09-17T03:15:00-04:00,24532.5,24536.75,24530.75,24536.25,24514.883368159644,NaN,NaN,NaN,NaN,NaN,24520.285,24534.128052400876,24506.441947599124,24520.370977153892,24529.93979512949,24541.26488628649,24518.614703972486,393,627.5666666666667,65.34095280800125,61.20035895416466,NaN,NaN,NaN,NaN,7.004221816185091,11.407532996722576,-89797
2025-09-17T03:20:00-04:00,24536.75,24543.75,24535.5,24542.25,24519.047913963645,NaN,NaN,NaN,NaN,NaN,24520.64,24535.749652559083,24505.530347440916,24525.302425378493,24530.11409789323,24541.425641022364,24518.802554764097,1042,657.7,70.36570560801793,62.1640292157197,NaN,NaN,NaN,NaN,7.093205972171871,12.241505630441123,-88755
2025-09-17T03:25:00-04:00,24542.5,24549,24541.75,24548.25,24524.744599692567,NaN,NaN,NaN,NaN,NaN,24521.145,24538.110285142415,24504.179714857586,24530.616940302793,24530.371987529226,24541.775181055997,24518.968794002456,1020,686.0666666666667,74.36765111348504,63.98756794294544,NaN,NaN,NaN,NaN,7.104405545588166,13.723940765784867,-87735
2025-09-17T03:30:00-04:00,24548,24553,24545.75,24553,24528.69370879745,NaN,NaN,NaN,NaN,NaN,24521.77,24540.937900239252,24502.60209976075,24534.668552242234,24530.740388882932,24542.3581693621,24519.122608403763,1191,714.4666666666667,77.01410887859149,65.17895099686216,NaN,NaN,NaN,NaN,7.1148051494747255,15.558172536517207,-86544
2025-09-17T03:35:00-04:00,24552.25,24552.5,24542.25,24545,24528.69370879745,NaN,NaN,NaN,NaN,NaN,24522.22,24542.461699519106,24501.978300480896,24534.668552242234,24530.968136885185,24542.655261009062,24519.28101276131,953,708.5666666666667,64.86679949002874,65.55419136945982,NaN,NaN,NaN,NaN,7.374461924512246,16.43827863988891,-87497
2025-09-17T03:40:00-04:00,24545.25,24548.25,24541.25,24545.75,24528.69370879745,NaN,NaN,NaN,NaN,NaN,24522.72,24544.000187964022,24501.43981203598,24534.668552242234,24531.113954159573,24542.827826847613,24519.400081471533,692,711.2333333333333,65.4175083191677,66.2263006369103,NaN,NaN,NaN,NaN,7.347714644189942,17.028954021017398,-86805
2025-09-17T03:45:00-04:00,24546,24549.75,24543.5,24546,24528.69370879745,NaN,NaN,NaN,NaN,NaN,24523.275,24545.486990004112,24501.06300999589,24534.668552242234,24531.3463554301,24543.12061975632,24519.572091103884,1033,689.3333333333334,65.61101107782356,66.55007529780463,NaN,NaN,NaN,NaN,7.269306455319232,17.784623090968147,-85772
2025-09-17T03:50:00-04:00,24546,24553,24546,24548.5,24528.69370879745,NaN,NaN,NaN,NaN,NaN,24523.83,24547.122367848424,24500.53763215158,24534.668552242234,24531.523515812252,24543.371753939595,24519.67527768491,683,685.8666666666667,67.56545567515974,66.96263953222305,NaN,NaN,NaN,NaN,7.250070279939287,18.912787467821367,-85089
2025-09-17T03:55:00-04:00,24548.25,24551.25,24547.25,24550,24528.69370879745,NaN,NaN,NaN,NaN,NaN,24524.445,24548.819841533048,24500.07015846695,24534.668552242234,24531.632227768132,24543.526522246473,24519.73793328979,418,691.8666666666667,68.7143627300594,67.48603757986363,NaN,NaN,NaN,NaN,7.017922402800766,19.96036867489936,-84671
2025-09-17T04:00:00-04:00,24550,24550.75,24538.75,24539.5,24528.69370879745,NaN,NaN,NaN,NaN,NaN,24524.88,24549.536082413833,24500.22391758617,24534.668552242234,24531.887374423088,24543.767367620152,24520.007381226023,1587,734.9,54.232631139719466,66.81113066445504,NaN,NaN,NaN,NaN,7.373785088314997,19.02381689652439,-86258
2025-09-17T04:05:00-04:00,24539.25,24542,24531.5,24541,24528.69370879745,NaN,NaN,NaN,NaN,NaN,24525.33,24550.32288698096,24500.337113019043,24534.668552242234,24532.01543269741,24543.807111941,24520.22375345382,1472,769.7333333333333,55.66996510128171,66.16714679270618,NaN,NaN,NaN,NaN,7.597086153435354,18.360811091031522,-84786
2025-09-17T04:10:00-04:00,24540.75,24541.5,24527.25,24527.75,NaN,NaN,NaN,24557.153176838354,24557.153176838354,24557.153176838354,24525.54,24550.434047484465,24500.645952515537,24534.668552242234,24532.017399380096,24543.73216934937,24520.302629410824,951,778.1333333333333,42.864194653384615,64.43366587614199,NaN,NaN,NaN,NaN,8.072294285332829,18.320696689595536,-85737
2025-09-17T04:15:00-04:00,24528,24531,24520.75,24526.25,NaN,NaN,NaN,24549.01553243661,NaN,NaN,24525.695,24550.50815981855,24500.88184018145,24534.668552242234,24531.903890960966,24543.53648511169,24520.271296810242,1406,813.0333333333333,41.69489004704218,62.500111583182914,NaN,NaN,NaN,NaN,8.227844693523341,19.036096249929294,-87143
2025-09-17T04:20:00-04:00,24526.5,24529.5,24522.75,24525.75,NaN,NaN,NaN,24549.01553243661,NaN,NaN,24525.94,24550.507368614548,24501.37263138545,24534.49943899842,24531.84011170095,24543.42578834783,24520.254435054067,814,829.3666666666667,41.29054969458247,61.0725561668818,NaN,NaN,NaN,NaN,8.122284358271674,19.70039584166778,-87957
2025-09-17T04:25:00-04:00,24525.5,24530.5,24522.75,24527,NaN,NaN,NaN,24549.01553243661,NaN,NaN,24526.2,24550.53043361287,24501.869566387133,24534.49943899842,24531.796046688065,24543.341099688263,24520.250993687867,658,844.9666666666667,42.78438766679816,59.46137294251015,NaN,NaN,NaN,NaN,8.095692618395125,20.112270612121943,-87299
2025-09-17T04:30:00-04:00,24527.75,24529,24501.25,24501.25,NaN,NaN,NaN,24540.882815636312,NaN,NaN,24525.99,24550.98779189849,24500.992208101514,24534.49943899842,24530.9032308552,24542.982825110237,24518.823636600166,3326,917.0666666666667,27.347380232130902,56.388635415661085,NaN,NaN,NaN,NaN,9.499571717081187,22.310788150515055,-90625
2025-09-17T04:35:00-04:00,24501,24504.75,24470.5,24487.25,NaN,NaN,NaN,24516.882460380115,NaN,NaN,24525.49,24552.487214668152,24498.49278533185,24534.49943899842,24526.241147339326,24543.872303882104,24508.609990796547,9547,1220.1,22.577666340855927,52.689350789044724,NaN,NaN,NaN,NaN,11.26745945157539,25.560474681869433,-100172
2025-09-17T04:40:00-04:00,24487,24489.5,24456,24485.75,NaN,NaN,NaN,24505.245757635566,NaN,NaN,24524.97,24553.93560719385,24496.004392806153,24534.449551198737,24523.40742488178,24544.003729898974,24502.81111986459,5437,1369.5666666666666,22.13226615805368,48.76921916614917,NaN,NaN,NaN,NaN,12.855498062177148,28.92037957260291,-105609
2025-09-17T04:45:00-04:00,24485.5,24508.5,24479.75,24500,24459.185867711505,24459.185867711505,24459.185867711505,NaN,NaN,NaN,24524.585,24554.345310814526,24494.824689185472,24531.30964095899,24522.465890012692,24543.30888656205,24501.622893463336,3366,1466.6666666666667,35.208875423187536,46.65079601851765,NaN,NaN,NaN,NaN,13.990819629164495,29.899957976635168,-102243
2025-09-17T04:50:00-04:00,24500,24519.75,24499.5,24510,24473.51264645189,NaN,NaN,NaN,NaN,NaN,24524.41,24554.407459892183,24494.412540107816,24521.19771276719,24522.17735513046,24542.869349116358,24501.485361144565,2268,1520.5,42.505674886043636,45.01423648758022,NaN,NaN,NaN,NaN,14.437903941367031,29.794128428068174,-99975
2025-09-17T04:55:00-04:00,24509.25,24514.5,24505.75,24513,24474.460935249535,NaN,NaN,NaN,NaN,NaN,24524.35,24554.426402720892,24494.273597279105,24517.733170213753,24522.072250630936,24542.694016687426,24501.450484574445,956,1529.4333333333334,44.52416523269707,43.50803321292833,NaN,NaN,NaN,NaN,14.031625088412243,29.695858132970248,-99019
2025-09-17T05:00:00-04:00,24513.5,24519,24509.75,24518.5,24479.070665465464,NaN,NaN,NaN,NaN,NaN,24524.375,24554.42982490415,24494.32017509585,24508.476383149442,24521.988845914377,24542.486833237122,24501.49085859163,1349,1552.3333333333333,48.12021723449146,42.11908761002345,NaN,NaN,NaN,NaN,13.690080439239939,29.199233581698397,-97670
2025-09-17T05:05:00-04:00,24518.25,24533,24517.75,24522.5,24489.59586248976,NaN,NaN,NaN,NaN,NaN,24524.45,24554.466995185743,24494.43300481426,24508.476383149442,24522.034665719988,24542.340991947218,24501.728339492758,1967,1601.5,50.62687321498835,40.82712407323266,NaN,NaN,NaN,NaN,13.801503265008515,27.60735281692119,-95703
2025-09-17T05:10:00-04:00,24522.25,24524.25,24515.5,24517.5,24489.59586248976,NaN,NaN,NaN,NaN,NaN,24524.4,24554.45478331251,24494.345216687492,24508.476383149442,24522.009175766336,24542.229465648506,24501.788885884165,908,1614.1,47.53511294518752,40.34872991648037,NaN,NaN,NaN,NaN,13.440681603222192,26.274356414875356,-96611
2025-09-17T05:15:00-04:00,24517.5,24521,24510.75,24516,24489.59586248976,NaN,NaN,NaN,NaN,NaN,24524.21,24554.35454511479,24494.065454885207,24497.50610651955,24521.950122141527,24542.08102899089,24501.819215292162,1029,1635.4,46.615383883493955,39.701974115209815,NaN,NaN,NaN,NaN,13.212775774420606,25.344162569301133,-97640
2025-09-17T05:20:00-04:00,24516,24522.5,24515.75,24519.5,24489.59586248976,NaN,NaN,NaN,NaN,NaN,24524.215,24554.35633540731,24494.07366459269,24491.22039582997,24521.930352957308,24541.988750208206,24501.87195570641,783,1633.5333333333333,49.09055490291536,40.14671413303345,NaN,NaN,NaN,NaN,12.751148933390564,24.352365225104208,-96857
2025-09-17T05:25:00-04:00,24519,24526,24518.75,24522.75,24489.59586248976,NaN,NaN,NaN,NaN,NaN,24524.515,24554.291233815045,24494.738766184953,24497.042074131954,24521.934556350687,24541.918871150556,24501.950241550818,795,1642.5333333333333,51.346374152861685,40.8361058548777,NaN,NaN,NaN,NaN,12.358209723862666,23.12686066296175,-96062
2025-09-17T05:30:00-04:00,24523.5,24528,24520.75,24525.75,24491.043829471197,NaN,NaN,NaN,NaN,NaN,24524.8,24554.344373412925,24495.255626587073,24501.208659305565,24521.954038671927,24541.8724923726,24502.035584971254,729,1620.3,53.399063174577634,41.700999674877366,NaN,NaN,NaN,NaN,11.99333760072962,21.812791636948198,-95333
2025-09-17T05:35:00-04:00,24525.25,24528.25,24523.75,24526,24493.570246313415,NaN,NaN,NaN,NaN,NaN,24525.1,24554.38122265793,24495.81877734207,24504.56692744445,24521.969311498695,24541.851683410518,24502.086939586872,411,1597.5333333333333,53.57484128155705,42.471746361645856,NaN,NaN,NaN,NaN,11.458099200677504,20.569495547682184,-94922
2025-09-17T05:40:00-04:00,24526.5,24529,24516.5,24517,24493.570246313415,NaN,NaN,NaN,NaN,NaN,24525.22,24554.317704371788,24496.122295628214,24504.56692744445,24521.96295163117,24541.78977004679,24502.136133215547,613,1593.2333333333333,46.73975843046797,43.85691623295565,NaN,NaN,NaN,NaN,11.532520686343398,20.01532375346217,-95535
2025-09-17T05:45:00-04:00,24516.5,24524.25,24515,24516.5,24493.570246313415,NaN,NaN,NaN,NaN,NaN,24525.31,24554.271104946925,24496.348895053077,24504.56692744445,24521.940081157736,24541.70164241493,24502.178519900543,746,1605,46.38569656672989,45.55748982051807,NaN,NaN,NaN,NaN,11.369483494461727,19.620389642792787,-96281
2025-09-17T05:50:00-04:00,24516.75,24518,24506.75,24514.75,24493.570246313415,NaN,NaN,NaN,NaN,NaN,24525.31,24554.271104946925,24496.348895053077,24504.56692744445,24521.845216837308,24541.52058262702,24502.169851047594,1205,1610.4333333333334,45.09803124870849,47.197901612707696,NaN,NaN,NaN,NaN,11.360948959143032,19.8777478105755,-97486
2025-09-17T05:55:00-04:00,24514.5,24518.5,24508.25,24511.75,24493.570246313415,NaN,NaN,NaN,NaN,NaN,24525.215,24554.321873761604,24496.108126238396,24504.56692744445,24521.797117424278,24541.43088893366,24502.163345914894,598,1596.3666666666666,42.89946921476522,47.74722974067753,NaN,NaN,NaN,NaN,11.281595462061388,20.05841720635462,-98084
2025-09-17T06:00:00-04:00,24511.75,24520.5,24508.25,24514.25,24493.570246313415,NaN,NaN,NaN,NaN,NaN,24525.17,24554.33752304364,24496.002476956357,24504.56692744445,24521.749854404094,24541.330316584103,24502.169392224085,714,1580.4666666666667,45.29293906759317,47.94632003935964,NaN,NaN,NaN,NaN,11.35076721477129,19.983603180995964,-97370
2025-09-17T06:05:00-04:00,24515,24516.25,24510.25,24515.5,24493.570246313415,NaN,NaN,NaN,NaN,NaN,24525.115,24554.34481525136,24495.885184748644,24504.56692744445,24521.713256539268,24541.254654851866,24502.17185822667,535,1566.5333333333333,46.5004542463662,48.087483540336,NaN,NaN,NaN,NaN,10.96856955657334,19.9141330145915,-96835
2025-09-17T06:10:00-04:00,24515.5,24516.25,24503.75,24504,24493.570246313415,NaN,NaN,NaN,NaN,NaN,24524.855,24554.595727967226,24495.114272032773,24504.56692744445,24521.585424755445,24541.080122210515,24502.090727300376,1066,1579,38.15621081529189,47.375768796107465,NaN,NaN,NaN,NaN,11.077957445389531,20.397307868268495,-97901
2025-09-17T06:15:00-04:00,24504.25,24511.5,24501,24506.75,24493.570246313415,NaN,NaN,NaN,NaN,NaN,24524.67,24554.74198697168,24494.598013028317,24504.56692744445,24521.40287389092,24540.850374567584,24501.955373214252,1393,1591,40.8878664046122,46.68012545250917,NaN,NaN,NaN,NaN,11.03667477071885,21.06253976890875,-96508
2025-09-17T06:20:00-04:00,24507,24510.5,24502.25,24502.5,24493.570246313415,NaN,NaN,NaN,NaN,NaN,24524.29,24554.986312480047,24493.593687519955,24504.56692744445,24521.304077146342,24540.733905377023,24501.87424891566,705,1591.7333333333333,38.087870101762405,46.00532239226452,NaN,NaN,NaN,NaN,10.837626572810361,21.680255105217555,-97213
2025-09-17T06:25:00-04:00,24502.75,24504.75,24498,24501.5,24493.570246313415,NaN,NaN,NaN,NaN,NaN,24523.995,24555.272706124608,24492.71729387539,24503.80354195556,24521.1562682895,24540.58897501588,24501.723561563118,872,1606.8666666666666,37.438228170040105,45.349811269874955,NaN,NaN,NaN,NaN,10.545653246181049,22.60028986891078,-98085
2025-09-17T06:30:00-04:00,24501.75,24505.5,24495.5,24501.5,24493.570246313415,NaN,NaN,NaN,NaN,NaN,24523.5,24555.39655153565,24491.60344846435,24499.46783356445,24520.921022184782,24540.362843652136,24501.47920071743,1374,1599.7666666666667,37.43822817004011,44.517502217526726,NaN,NaN,NaN,NaN,10.506678014310975,23.65037224048257,-98085
2025-09-17T06:35:00-04:00,24500.5,24504.75,24490,24503.25,NaN,NaN,NaN,24529.213184499455,24529.213184499455,24529.213184499455,24523.05,24555.437960726464,24490.662039273535,24493.986530784998,24520.55628071338,24540.03290666609,24501.07965476067,2040,1618.7,39.5314922837715,43.67358208402028,NaN,NaN,NaN,NaN,10.80977244186019,25.029719873709272,-96045
2025-09-17T06:40:00-04:00,24504,24508,24498.25,24499.25,NaN,NaN,NaN,24529.213184499455,NaN,NaN,24522.57,24555.636151876985,24489.503848123015,24493.986530784998,24520.326532504365,24539.792731192574,24500.860333816156,1500,1637,36.52338938903859,42.46817681362463,NaN,NaN,NaN,NaN,10.734074410298748,25.755813167985202,-97545
2025-09-17T06:45:00-04:00,24499.25,24506.5,24499.25,24500,NaN,NaN,NaN,24529.213184499455,NaN,NaN,24522.005,24555.624412542915,24488.385587457087,24493.986530784998,24520.217690518595,24539.67750811928,24500.75787291791,727,1614.3666666666666,37.48395477066126,41.31882777713208,NaN,NaN,NaN,NaN,10.485211952420267,26.430042655527142,-96818
2025-09-17T06:50:00-04:00,24500,24502.5,24494.5,24502,NaN,NaN,NaN,24529.213184499455,NaN,NaN,24521.465,24555.48264395053,24487.44735604947,24492.039224628,24520.02678389193,24539.496083613885,24500.557484169978,1153,1625.6666666666667,40.08760877377066,40.843674230225126,NaN,NaN,NaN,NaN,10.307696812961677,27.44641061876371,-95665
2025-09-17T06:55:00-04:00,24502.25,24502.25,24492.25,24500.25,NaN,NaN,NaN,24528.144409149132,NaN,NaN,24520.895,24555.357456385405,24486.432543614595,24490.631379702398,24519.824802578714,24539.31571296491,24500.333892192517,1162,1642.4666666666667,38.57378015445597,40.28568020077699,NaN,NaN,NaN,NaN,10.2857184691787,28.564974426889115,-96827
2025-09-17T07:00:00-04:00,24500.5,24504.75,24491.75,24494.25,NaN,NaN,NaN,24528.144409149132,NaN,NaN,24520.16,24555.290152287118,24485.02984771288,24485.779083009536,24519.36150887373,24538.921957248163,24499.8010604993,2586,1617.8,33.85349765894786,39.482499230079796,NaN,NaN,NaN,NaN,10.479595721380221,29.12296235448646,-99413
2025-09-17T07:05:00-04:00,24493.5,24504.25,24486.75,24503,NaN,NaN,NaN,24527.728170319766,NaN,NaN,24519.58,24554.86632029076,24484.293679709244,24485.779083009536,24519.06676397469,24538.65097227384,24499.48255567554,1789,1359.2,44.51653337459112,39.5980038129245,NaN,NaN,NaN,NaN,10.981053169853064,30.059046501376198,-97624
2025-09-17T07:10:00-04:00,24503.5,24519.5,24502.5,24514.75,NaN,NaN,NaN,24527.728170319766,NaN,NaN,24519.185,24554.235793140055,24484.134206859948,24487.68292451797,24518.963771528695,24538.41725124328,24499.51029181411,1989,1244.2666666666667,55.005797761067356,40.29177943388694,NaN,NaN,NaN,NaN,11.410977943434988,28.571355491280855,-95635
2025-09-17T07:15:00-04:00,24514.75,24516.25,24506.25,24507.75,NaN,NaN,NaN,24527.728170319766,NaN,NaN,24518.615,24553.463559505242,24483.76644049476,24487.68292451797,24518.892506398613,24538.283966181494,24499.501046615733,1065,1167.5666666666666,49.05580169771107,40.474304251840145,NaN,NaN,NaN,NaN,11.310193804618203,27.189928124763746,-96700
2025-09-17T07:20:00-04:00,24507,24516,24506.5,24513,NaN,NaN,NaN,24527.728170319766,NaN,NaN,24518.23,24552.892348452326,24483.567651547673,24487.68292451797,24518.852363202717,24538.19589253447,24499.508833870965,759,1117.2666666666667,53.14908873287187,41.545224103095855,NaN,NaN,NaN,NaN,11.180894247145474,25.90717414156929,-95941
2025-09-17T07:25:00-04:00,24512.75,24514.25,24504.25,24507.25,NaN,NaN,NaN,24527.728170319766,NaN,NaN,24517.65,24552.056394750307,24483.243605249696,24487.68292451797,24518.785859882883,24538.084239371725,24499.48748039404,870,1114.4,48.54817973419063,42.092389340922885,NaN,NaN,NaN,NaN,11.096544658063655,24.98186042546798,-96811
2025-09-17T07:30:00-04:00,24507,24508.25,24498,24498.25,NaN,NaN,NaN,24527.728170319766,NaN,NaN,24516.77,24550.863964272725,24482.676035727276,24487.68292451797,24518.66130818214,24537.94553563878,24499.377080725502,975,1101.9333333333334,42.36621113144773,42.397985128757554,NaN,NaN,NaN,NaN,11.036077182487679,24.801903415010155,-97786
2025-09-17T07:35:00-04:00,24498.25,24498.5,24487,24492,NaN,NaN,NaN,24525.36973264904,NaN,NaN,24515.645,24549.21791914115,24482.072080858852,24487.68292451797,24518.23042365346,24537.642875129983,24498.817972176934,2266,1111.9,38.68246125416978,42.486858920481104,NaN,NaN,NaN,NaN,11.069214526595701,25.584883138456433,-100052
2025-09-17T07:40:00-04:00,24492.25,24496.25,24489.75,24490,NaN,NaN,NaN,24525.023381164992,NaN,NaN,24514.385,24546.969844643616,24481.80015535638,24487.68292451797,24518.031189438858,24537.503406775635,24498.55897210208,1053,1116.7333333333333,37.55708676161534,42.49534881987933,NaN,NaN,NaN,NaN,10.742842060410295,26.311935738799402,-101105
2025-09-17T07:45:00-04:00,24490,24502.75,24489.75,24502,NaN,NaN,NaN,24525.023381164992,NaN,NaN,24513.525,24545.086091544577,24481.963908455426,24487.68292451797,24517.845099265185,24537.32013932167,24498.3700592087,1311,1126.1333333333334,47.43787930606633,43.06009075004325,NaN,NaN,NaN,NaN,10.904067627523846,25.966936262152768,-99794
2025-09-17T07:50:00-04:00,24502,24508.5,24500.5,24506.5,NaN,NaN,NaN,24525.023381164992,NaN,NaN,24512.74,24542.98085977094,24482.49914022906,24487.68292451797,24517.775094986333,24537.219005101553,24498.331184871113,777,1125.9333333333334,50.595029342056996,44.06520788954457,NaN,NaN,NaN,NaN,10.696634225557856,24.856190611576853,-99017
2025-09-17T07:55:00-04:00,24505.5,24506.25,24498.75,24501.75,NaN,NaN,NaN,24525.023381164992,NaN,NaN,24511.855,24540.708784851045,24483.001215148954,24487.68292451797,24517.65033565484,24537.06550623981,24498.235165069866,1140,1137.4333333333334,47.36124376130696,44.770728531733546,NaN,NaN,NaN,NaN,10.486160352303724,24.010280617586623,-100157
2025-09-17T08:00:00-04:00,24502.5,24509.25,24498.75,24503.75,NaN,NaN,NaN,24525.023381164992,NaN,NaN,24510.96,24537.925971157085,24483.994028842913,24486.8870716915,24517.505028630414,24536.8682691246,24498.14178813623,1517,1163.7,48.843838276649876,45.39617349622491,NaN,NaN,NaN,NaN,10.487148898567742,22.81471713816776,-98640
2025-09-17T08:05:00-04:00,24503.5,24505.75,24500.75,24502,NaN,NaN,NaN,24525.023381164992,NaN,NaN,24510,24534.65704766979,24485.34295233021,24486.8870716915,24517.4612608478,24536.812147880486,24498.11037381511,429,1164.3,47.5810132145287,46.03954728623012,NaN,NaN,NaN,NaN,10.09520969152719,21.704551050135958,-99069
2025-09-17T08:10:00-04:00,24502,24509.5,24498.25,24508.75,NaN,NaN,NaN,24525.023381164992,NaN,NaN,24509.385,24532.557442696136,24486.21255730386,24486.047951765606,24517.356961667574,24536.655363965587,24498.05855936956,1265,1186.0333333333333,52.664596031450884,47.383197169980335,NaN,NaN,NaN,NaN,10.177694713560962,20.16035155204485,-97804
2025-09-17T08:15:00-04:00,24508,24512.25,24504,24512.25,NaN,NaN,NaN,24525.023381164992,NaN,NaN,24508.81,24530.172013011404,24487.447986988598,24489.363361412485,24517.310017472337,24536.560206082184,24498.05982886249,872,1190.2333333333333,55.09630881703662,48.13889541586929,NaN,NaN,NaN,NaN,10.040002234020893,19.093189316910937,-96932
2025-09-17T08:20:00-04:00,24512.25,24515,24508.75,24513.75,NaN,NaN,NaN,24525.023381164992,NaN,NaN,24508.53,24529.24898647536,24487.81101352464,24493.565689129988,24517.282067875585,24536.479727797057,24498.084407954113,853,1178.5,56.1363226758722,48.21964719549821,NaN,NaN,NaN,NaN,9.769287788733687,18.457259402277455,-96079
2025-09-17T08:25:00-04:00,24513.5,24519,24512.75,24516.25,NaN,NaN,NaN,24525.023381164992,NaN,NaN,24508.33,24528.5479227421,24488.112077257905,24498.72755130399,24517.269939271257,24536.376979727313,24498.1628988152,1402,1205.3,57.8870022869928,48.85044723758976,NaN,NaN,NaN,NaN,9.517910089538422,18.35368908092971,-94677
2025-09-17T08:30:00-04:00,24516.5,24525.25,24516,24517,24491.105778028472,24491.105778028472,24491.105778028472,NaN,NaN,NaN,24508.155,24527.913008504176,24488.39699149582,24504.407041043192,24517.299820793298,24536.275081188327,24498.32456039827,2092,1251.2333333333333,58.42311916347228,49.22716369691836,NaN,NaN,NaN,NaN,9.498773654571393,18.928928504382313,-92585
2025-09-17T08:35:00-04:00,24516.75,24523,24516,24518.5,24491.105778028472,NaN,NaN,NaN,NaN,NaN,24507.985,24527.231145060592,24488.73885493941,24504.407041043192,24517.31126489837,24536.228836200473,24498.393693596267,927,1264.3,59.53270816261822,50.01177287037748,NaN,NaN,NaN,NaN,9.320289822102009,19.463079397588302,-91658
2025-09-17T08:40:00-04:00,24518.75,24521.5,24511.75,24512.5,24491.105778028472,NaN,NaN,NaN,NaN,NaN,24508.21,24527.398892624606,24489.021107375393,24504.407041043192,24517.29184817379,24536.12116149205,24498.46253485553,1438,1276.7,53.394375466567894,50.79949889431463,NaN,NaN,NaN,NaN,9.35098340623758,19.218717393799214,-93096
2025-09-17T08:45:00-04:00,24513,24518,24507.75,24515,24491.105778028472,NaN,NaN,NaN,NaN,NaN,24508.765,24527.082316938537,24490.447683061462,24504.407041043192,24517.233481949046,24535.919737123386,24498.547226774706,2441,1311.6333333333334,55.45530986533427,51.99755950939782,NaN,NaN,NaN,NaN,9.41519887722061,18.355791621950868,-90655
2025-09-17T08:50:00-04:00,24514.25,24520.5,24511.25,24520.5,24491.105778028472,NaN,NaN,NaN,NaN,NaN,24509.46,24526.844866986536,24492.075133013463,24504.407041043192,24517.235190259627,24535.834119243307,24498.636261275948,1460,1336.8,59.679637798245174,53.57774172629995,NaN,NaN,NaN,NaN,9.403398957419139,17.880256149841948,-89195
2025-09-17T08:55:00-04:00,24520.75,24525.75,24518.75,24524.75,24493.475935520204,NaN,NaN,NaN,NaN,NaN,24509.955,24527.641065130367,24492.268934869637,24504.510579209033,24517.30275915263,24535.804489272137,24498.801029033122,1830,1368.7333333333333,62.62886917795923,54.66281243143515,NaN,NaN,NaN,NaN,9.23172760331777,18.069183216364806,-87365
2025-09-17T09:00:00-04:00,24524.75,24528.5,24521,24524,24496.261120269286,NaN,NaN,NaN,NaN,NaN,24510.235,24528.353060039582,24492.11693996042,24507.758463367227,24517.39064533363,24535.796046796517,24498.985243870746,1958,1388.2,61.770210585864824,55.46103966313571,NaN,NaN,NaN,NaN,9.108032774509358,18.547638953130924,-89323
2025-09-17T09:05:00-04:00,24524.5,24528.25,24519.5,24521,24496.261120269286,NaN,NaN,NaN,NaN,NaN,24510.395,24528.74768100206,24492.04231899794,24507.758463367227,24517.45192287925,24535.76413748429,24499.139708274208,1798,1380.1333333333334,58.325527296117784,56.24420277276505,NaN,NaN,NaN,NaN,9.082459004901546,18.720972860037925,-91121
2025-09-17T09:10:00-04:00,24520.75,24524,24519.75,24521.25,24496.261120269286,NaN,NaN,NaN,NaN,NaN,24510.45,24528.915643774835,24491.984356225166,24507.758463367227,24517.478655852363,24535.73576978419,24499.221541920535,1035,1364.6333333333334,58.533054816172914,56.93628966844526,NaN,NaN,NaN,NaN,8.737283361694292,18.88192577359443,-90086
2025-09-17T09:15:00-04:00,24521.5,24523.75,24516.5,24520.25,24496.261120269286,NaN,NaN,NaN,NaN,NaN,24510.405,24528.76361922636,24492.046380773638,24507.758463367227,24517.509288036672,24535.664318149396,24499.354257923947,1881,1403.1,57.303822829240254,57.63077606949609,NaN,NaN,NaN,NaN,8.631048835858985,18.418094370925033,-91967
2025-09-17T09:20:00-04:00,24520.5,24521.5,24512.5,24518.5,24496.261120269286,NaN,NaN,NaN,NaN,NaN,24510.425,24528.816642125086,24492.033357874912,24507.758463367227,24517.509148148587,24535.526942211036,24499.491354086138,2524,1448.8,55.12218904291173,57.80631842745758,NaN,NaN,NaN,NaN,8.657402490440486,17.29714201403631,-94491
2025-09-17T09:25:00-04:00,24519,24531.75,24516.75,24521.25,24496.261120269286,NaN,NaN,NaN,NaN,NaN,24510.53,24529.106770447546,24491.95322955245,24508.653413276174,24517.664432420086,24535.461259208812,24499.86760563136,4659,1565.3666666666666,57.838583157739464,58.00219516607921,NaN,NaN,NaN,NaN,9.110445169694737,17.588763081218488,-89832
2025-09-17T09:30:00-04:00,24521,24540.75,24496,24501.5,NaN,NaN,NaN,24542.08565126581,24542.08565126581,24542.08565126581,24510.17,24528.7351393902,24491.604860609797,24508.653413276174,24516.980436915685,24533.579782205066,24500.381091626303,27849,2407.4666666666667,39.39569385824594,56.80643596482019,NaN,NaN,NaN,NaN,11.656127657573686,17.36144681181839,-117681
2025-09-17T09:35:00-04:00,24501.75,24510.75,24478.25,24481.75,NaN,NaN,NaN,24530.441304247463,NaN,NaN,24509.35,24529.197669896115,24489.502330103882,24508.653413276174,24514.036858895957,24531.791132625498,24496.282585166417,24761,3173.2,29.325438007618104,54.76632423057914,NaN,NaN,NaN,NaN,13.144975682032708,18.456225187709336,-142442
2025-09-17T09:40:00-04:00,24481.5,24488,24462,24476,NaN,NaN,NaN,24512.853063145307,NaN,NaN,24508.355,24529.742634280043,24486.967365719956,24508.653413276174,24510.492811970576,24530.764891154704,24490.22073278645,22665,3862.4,27.149534805184317,52.53249677641571,NaN,NaN,NaN,NaN,14.063191704744657,20.309158614000104,-165107
2025-09-17T09:45:00-04:00,24476.25,24500,24462.75,24496.75,NaN,NaN,NaN,24512.853063145307,NaN,NaN,24507.77,24528.792093141255,24486.747906858745,24508.653413276174,24508.64361877986,24529.14316516605,24488.144072393672,20670,4515.9,43.45473826084166,51.38407035486024,NaN,NaN,NaN,NaN,15.719392297262896,20.776309477401096,-144437
2025-09-17T09:50:00-04:00,24496.5,24520.5,24493,24499.5,24463.661258580414,24463.661258580414,24463.661258580414,NaN,NaN,NaN,24507.42,24528.39842702411,24486.441572975888,24508.653413276174,24508.294036389714,24527.979905663226,24488.608167116203,23671,5279.633333333333,45.20512146599537,50.79912364053364,NaN,NaN,NaN,NaN,16.560864276029832,19.554493293173312,-120766
2025-09-17T09:55:00-04:00,24499.5,24506.75,24472.5,24477.75,24463.661258580414,NaN,NaN,NaN,NaN,NaN,24506.645,24529.039662305393,24484.250337694608,24508.653413276174,24506.87262353548,24526.70521481751,24487.04003225345,19563,5902.733333333334,35.77310058676683,49.39325154920739,NaN,NaN,NaN,NaN,17.82437397059913,19.551295373909028,-140329
2025-09-17T10:00:00-04:00,24477.5,24480.5,24447,24472,NaN,NaN,NaN,24512.03695240917,24512.03695240917,24512.03695240917,24505.79,24530.06681197722,24481.513188022782,24508.653413276174,24503.877142418296,24525.697101704245,24482.057183132347,24958,6702.166666666667,33.767217332536276,47.54236437308533,NaN,NaN,NaN,NaN,18.944061544127766,20.586092237624527,-165287
2025-09-17T10:05:00-04:00,24471,24478.5,24461.25,24465.75,NaN,NaN,NaN,24512.03695240917,NaN,NaN,24504.87,24531.541940316834,24478.198059683164,24508.653413276174,24502.487745063037,24524.951814122287,24480.023676003788,13751,7085,31.687367022603155,45.33225707627418,NaN,NaN,NaN,NaN,18.82305714811864,21.546975039646068,-179038
2025-09-17T10:10:00-04:00,24465.5,24475.5,24460,24474.5,NaN,NaN,NaN,24512.03695240917,NaN,NaN,24504.075,24531.92482046107,24476.22517953893,24508.653413276174,24501.577130780133,24524.364064540405,24478.79019701986,10097,7386.466666666666,37.492126751268245,43.598108230945854,NaN,NaN,NaN,NaN,18.58569592325302,22.487081105661414,-168941
2025-09-17T10:15:00-04:00,24474.5,24480.75,24454.5,24463.75,NaN,NaN,NaN,24512.03695240917,NaN,NaN,24503.04,24532.88918089179,24473.19081910821,24499.897730620938,24500.41026170965,24523.68720878665,24477.13331463265,12335,7753.933333333333,33.703017684990044,41.83935754443673,NaN,NaN,NaN,NaN,19.13314621444923,23.57419757249095,-181276
2025-09-17T10:20:00-04:00,24463.75,24473.5,24451.75,24453.5,NaN,NaN,NaN,24512.03695240917,NaN,NaN,24502.03,24534.941341513277,24469.11865848672,24461.81818449675,24499.399685181448,24523.245907584544,24475.553462778353,9456,8043.233333333334,30.534289855286374,39.83944576151625,NaN,NaN,NaN,NaN,19.320064341988573,24.691029917171107,-190732
2025-09-17T10:25:00-04:00,24454,24458.5,24436.25,24440,NaN,NaN,NaN,24498.55888553378,NaN,NaN,24500.695,24537.871106574872,24463.518893425127,24458.476910462337,24497.56933780927,24522.984128044114,24472.154547574424,13280,8447.9,26.94149494548094,37.67070805553345,NaN,NaN,NaN,NaN,19.529345460417964,26.28282267246692,-204012
2025-09-17T10:30:00-04:00,24440.25,24459.75,24434.5,24448.25,NaN,NaN,NaN,24498.55888553378,NaN,NaN,24499.61,24539.57412890864,24459.64587109136,24458.476910462337,24495.98644101152,24522.4862652672,24469.486616755836,12905,8827.5,32.19232900992584,36.032860910320174,NaN,NaN,NaN,NaN,19.93796364181668,27.818848126614803,-191107
2025-09-17T10:35:00-04:00,24448.25,24449.75,24431,24443.25,NaN,NaN,NaN,24492.855048595862,NaN,NaN,24498.445,24541.404665965376,24455.485334034624,24458.476910462337,24494.479687627794,24522.10139612471,24466.857979130877,11573,9198.966666666667,30.749876169926907,34.09795326833357,NaN,NaN,NaN,NaN,19.85310909597263,29.3641070900659,-202680
2025-09-17T10:40:00-04:00,24443,24449.25,24423.75,24425.25,NaN,NaN,NaN,24490.071864568778,NaN,NaN,24496.92,24544.502395911237,24449.33760408876,24440.006528369868,24492.690789681667,24521.812543430777,24463.569035932556,12528,9574.4,26.198766921279372,33.15531562997881,NaN,NaN,NaN,NaN,20.2564584462603,31.038813262696056,-215208
2025-09-17T10:45:00-04:00,24424.75,24435,24416,24429.25,NaN,NaN,NaN,24479.22768890656,NaN,NaN,24495.44,24546.61084717162,24444.269152828376,24419.9908740203,24490.943204473424,24521.56645746352,24460.31995148333,11769,9937.633333333333,28.72337061485399,33.11231081620995,NaN,NaN,NaN,NaN,20.166711414384565,32.833333231977804,-203439
2025-09-17T10:50:00-04:00,24429,24432,24409.75,24430,NaN,NaN,NaN,24475.194612138082,NaN,NaN,24494.055,24548.389270034313,24439.720729965687,24419.9908740203,24489.215428359774,24521.253398851746,24457.1774578678,11750,10300.866666666667,29.212330426851665,33.259653360614756,NaN,NaN,NaN,NaN,20.315517741928524,34.68162360331526,-191689
2025-09-17T10:55:00-04:00,24429.75,24436.5,24417.5,24420.25,NaN,NaN,NaN,24475.194612138082,NaN,NaN,24492.46,24550.554609045415,24434.365390954583,24419.9908740203,24487.955136050543,24520.909982003835,24455.00029009725,9089,10557.1,26.65260323810051,32.05950085899038,NaN,NaN,NaN,NaN,20.22155218893363,35.90914675027639,-200778
2025-09-17T11:00:00-04:00,24420.25,24425.75,24408.5,24411.75,NaN,NaN,NaN,24471.444109406806,NaN,NaN,24490.655,24552.91091457948,24428.39908542052,24419.9908740203,24486.80582775354,24520.731901584506,24452.87975392257,7476,10736.566666666668,24.62663969158885,30.589609303675633,NaN,NaN,NaN,NaN,20.009298461152657,37.34111887537366,-208254
2025-09-17T11:05:00-04:00,24411.75,24417.75,24403.5,24416.25,NaN,NaN,NaN,24464.418240797404,NaN,NaN,24488.975,24554.549633054765,24423.400366945232,24414.017699216238,24485.490758300406,24520.513555289603,24450.46796131121,8511,10989.366666666667,27.75749543760942,30.017066078735812,NaN,NaN,NaN,NaN,19.597919999641753,38.82299796535754,-199743
2025-09-17T11:10:00-04:00,24416.25,24433.25,24407.25,24432,NaN,NaN,NaN,24464.418240797404,NaN,NaN,24487.73,24555.193311513754,24420.266688486245,24400.156327498393,24484.456466659853,24520.069186036537,24448.84374728317,8250,11216.433333333332,37.537075805243404,30.286341683929177,NaN,NaN,NaN,NaN,20.055211428238774,38.62891235102289,-191493
2025-09-17T11:15:00-04:00,24431.75,24443,24424.75,24437.5,NaN,NaN,NaN,24464.418240797404,NaN,NaN,24486.42,24555.17772247638,24417.662277523617,24400.156327498393,24483.591715374158,24519.48043621842,24447.702994529896,8720,11425.733333333334,40.56295410612054,30.920312189894705,NaN,NaN,NaN,NaN,19.926267754793148,37.611787932846,-182773
2025-09-17T11:20:00-04:00,24437.25,24438.75,24422,24423.25,NaN,NaN,NaN,24464.418240797404,NaN,NaN,24484.59,24555.082961352942,24414.097038647058,24392.700061998716,24482.9404241072,24519.11628323609,24446.76456497831,5902,11573.8,35.73307368769069,30.794665542496308,NaN,NaN,NaN,NaN,19.699391486593637,36.804936274925524,-188675
2025-09-17T11:25:00-04:00,24423.5,24425.5,24405.75,24412.75,NaN,NaN,NaN,24464.418240797404,NaN,NaN,24482.69,24555.66112853852,24409.71887146148,24392.22673187366,24481.813997679394,24518.72927388389,24444.898721474896,8451,11794.5,32.64827933067757,30.719327088616843,NaN,NaN,NaN,NaN,19.703006380408375,36.79008787721624,-197126
2025-09-17T11:30:00-04:00,24412.75,24420.5,24408,24415.25,NaN,NaN,NaN,24464.418240797404,NaN,NaN,24480.735,24555.567172892082,24405.90282710792,24392.22673187366,24480.95376050536,24518.402328916844,24443.505192093875,6639,11950.533333333333,34.1068632387946,30.974510901724567,NaN,NaN,NaN,NaN,19.18850592466492,36.77630007934333,-190487
2025-09-17T11:35:00-04:00,24415.5,24423.75,24406.75,24408.5,NaN,NaN,NaN,24464.418240797404,NaN,NaN,24478.76,24555.86667675364,24401.653323246355,24392.22673187366,24480.162354247303,24518.099345985764,24442.22536250884,6114,12094.4,32.0863947032188,31.34200374156299,NaN,NaN,NaN,NaN,19.03218407290314,36.45761846751366,-196601
2025-09-17T11:40:00-04:00,24408.25,24418.25,24400,24417,NaN,NaN,NaN,24463.11453665584,NaN,NaN,24477.135,24555.936218899868,24398.33378110013,24392.22673187366,24479.07522655854,24517.669736054202,24440.480717062877,8477,12342.466666666667,37.13658903614698,31.69516517200736,NaN,NaN,NaN,NaN,18.976313781981485,36.478492036774476,-188124
2025-09-17T11:45:00-04:00,24416.5,24424,24408.5,24416,NaN,NaN,NaN,24463.11453665584,NaN,NaN,24475.615,24556.124080851496,24395.105919148507,24392.22673187366,24478.21496480533,24517.234765384477,24439.195164226185,7396,12526.3,36.789974676759634,32.126600779638274,NaN,NaN,NaN,NaN,18.728005654697093,35.94400879572723,-195520
2025-09-17T11:50:00-04:00,24416,24418.25,24401.25,24403.25,NaN,NaN,NaN,24463.11453665584,NaN,NaN,24473.88,24556.77784315718,24390.982156842823,24392.22673187366,24477.540421238777,24516.976361572586,24438.104480904967,5215,12616,32.6107118333919,32.58459684478917,NaN,NaN,NaN,NaN,18.60457667936159,35.81028264968837,-200735
2025-09-17T11:55:00-04:00,24403.5,24414.75,24402,24411.25,NaN,NaN,NaN,24461.209203509556,NaN,NaN,24472.065,24556.382365354693,24387.747634645304,24392.22673187366,24477.029782060392,24516.75532470205,24437.304239418732,4119,12598,37.41475230909294,33.20540982294909,NaN,NaN,NaN,NaN,18.186392630835762,35.68610837122371,-196616
2025-09-17T12:00:00-04:00,24410.75,24414,24401.5,24401.5,NaN,NaN,NaN,24459.88719425912,NaN,NaN,24469.965,24555.960756291322,24383.969243708678,24392.22673187366,24476.464871621945,24516.53507245804,24436.394670785852,4390,11816.033333333333,34.21354920179637,33.56263973544514,NaN,NaN,NaN,NaN,17.780221728633208,35.59757779615352,-201006
2025-09-17T12:05:00-04:00,24401.25,24411.25,24395.25,24403.5,NaN,NaN,NaN,24455.199139974615,NaN,NaN,24468,24555.47805438993,24380.52194561007,24389.756385498928,24475.697352894815,24516.24745365973,24435.1472521299,5882,11186.733333333334,35.433900781854746,34.18987527428473,NaN,NaN,NaN,NaN,17.653063033730835,35.84826400725819,-195124
2025-09-17T12:10:00-04:00,24403,24405,24392.25,24400.75,NaN,NaN,NaN,24449.95145179395,NaN,NaN,24465.94,24554.7937877652,24377.086212234797,24380.210972400288,24474.955240699346,24515.99730518295,24433.91317621574,5500,10614.566666666668,34.486603446142695,34.894158399610006,NaN,NaN,NaN,NaN,17.302844245607204,36.23522400610602,-200624
2025-09-17T12:15:00-04:00,24401,24407.25,24398.75,24404.75,NaN,NaN,NaN,24449.95145179395,NaN,NaN,24463.995,24553.858089755144,24374.131910244854,24380.210972400288,24474.498142127057,24515.802840582677,24433.193443671436,3648,10047.166666666666,37.11985801056389,35.562898583392474,NaN,NaN,NaN,NaN,16.67406965663526,36.31368721307203,-196976
2025-09-17T12:20:00-04:00,24404.75,24416.25,24402.75,24413,NaN,NaN,NaN,24449.95145179395,NaN,NaN,24462.08,24552.12723427056,24372.032765729444,24381.86359131912,24473.99152370419,24515.52005404599,24432.46299336239,4557,9410.033333333333,42.27352561149062,35.90121642669585,NaN,NaN,NaN,NaN,16.447350395447028,35.33630098977872,-192419
2025-09-17T12:25:00-04:00,24413,24421.75,24409.5,24420.25,NaN,NaN,NaN,24449.95145179395,NaN,NaN,24460.24,24549.870238200383,24370.60976179962,24388.115873055296,24473.514564695517,24515.192123342727,24431.837006048307,4860,8919.933333333332,46.42882929598827,36.3202075116864,NaN,NaN,NaN,NaN,16.147539652915096,33.85216697133825,-187559
2025-09-17T12:30:00-04:00,24420.5,24421,24397.25,24398.75,NaN,NaN,NaN,24449.95145179395,NaN,NaN,24457.94,24547.86127445925,24368.018725540747,24388.115873055296,24472.65542593293,24514.757399224767,24430.553452641096,7426,8335.533333333333,37.75050885981885,36.46431002398126,NaN,NaN,NaN,NaN,16.690572534849732,33.30620952608026,-194985
2025-09-17T12:35:00-04:00,24398.75,24403.5,24381.5,24381.75,NaN,NaN,NaN,24443.3515669334,NaN,NaN,24455.25,24546.075547068045,24364.424452931955,24388.115873055296,24471.561983378346,24514.454851625716,24428.669115130975,7759,8135.8,32.56703086273424,36.45850656198531,NaN,NaN,NaN,NaN,17.069817353789038,33.63632902427831,-202744
2025-09-17T12:40:00-04:00,24381.75,24396.75,24374.75,24394.75,NaN,NaN,NaN,24437.290132072794,NaN,NaN,24452.805,24543.431391848695,24362.178608151306,24388.115873055296,24470.138989277646,24514.00241540233,24426.27556315296,10389,8145.533333333334,39.41756292772247,36.83784225405158,NaN,NaN,NaN,NaN,17.42197325708982,34.24566160344023,-192355
2025-09-17T12:45:00-04:00,24395,24395.25,24376,24385,NaN,NaN,NaN,24437.290132072794,NaN,NaN,24450.135,24540.728388833373,24359.541611166624,24388.115873055296,24469.286274105274,24513.74020888505,24424.832339325498,6147,7939.266666666666,36.428473295339465,37.14799072491735,NaN,NaN,NaN,NaN,17.55254659586912,34.81147042694773,-198502
2025-09-17T12:50:00-04:00,24385.5,24399.25,24384.5,24394.5,NaN,NaN,NaN,24437.290132072794,NaN,NaN,24447.775,24537.893546925494,24357.65645307451,24388.115873055296,24468.609706101597,24513.442815603346,24423.776596599848,5447,7805.633333333333,41.114064746620066,37.43209613280828,NaN,NaN,NaN,NaN,17.352364696164184,34.88161042955106,-193055
2025-09-17T12:55:00-04:00,24394.25,24398,24383.75,24389.75,NaN,NaN,NaN,24437.290132072794,NaN,NaN,24445.27,24534.735459256106,24355.804540743895,24388.115873055296,24468.13208686638,24513.24079605607,24423.023377676687,3791,7489.333333333333,39.54462750459229,37.62885704908204,NaN,NaN,NaN,NaN,17.13076721786674,34.987884438672296,-196846
2025-09-17T13:00:00-04:00,24390,24402.25,24388.5,24399.5,NaN,NaN,NaN,24437.290132072794,NaN,NaN,24442.85,24530.57382800737,24355.126171992626,24388.115873055296,24467.610671810708,24512.963512623046,24422.25783099837,4562,7211.233333333334,44.24900187298209,38.46016348048135,NaN,NaN,NaN,NaN,16.889283845161973,34.580966507933425,-192284
2025-09-17T13:05:00-04:00,24400,24403,24395.5,24397.25,NaN,NaN,NaN,24437.290132072794,NaN,NaN,24440.3,24525.73535568069,24354.86464431931,24388.115873055296,24467.305541031546,24512.789132888814,24421.82194917428,2773,6917.9,43.40951389332168,38.88836073649769,NaN,NaN,NaN,NaN,16.21862071336469,34.112904471542485,-195057
2025-09-17T13:10:00-04:00,24397.75,24402.75,24388,24402.5,NaN,NaN,NaN,24437.290132072794,NaN,NaN,24437.87,24520.510379961775,24355.229620038222,24388.115873055296,24466.84273029767,24512.526084240722,24421.15937635462,4202,6640.366666666667,45.984590450827945,39.7291493971428,NaN,NaN,NaN,NaN,16.11371923383864,34.16759573264367,-190855
2025-09-17T13:15:00-04:00,24402.25,24404.5,24395.5,24404,NaN,NaN,NaN,24437.290132072794,NaN,NaN,24435.53,24515.194649628265,24355.865350371732,24382.217698444238,24466.568265021266,24512.351774715342,24420.78475532719,2657,6336.633333333333,46.730425159839946,40.53604399557031,NaN,NaN,NaN,NaN,15.605596431421594,33.99333532861928,-188198
2025-09-17T13:20:00-04:00,24404.25,24407.75,24395,24406.5,NaN,NaN,NaN,24437.290132072794,NaN,NaN,24433.235,24509.42538062717,24357.04461937283,24374.54635251086,24466.141001795957,24512.064467597105,24420.21753599481,4297,6088.2,48.018691204479275,41.50262169259435,NaN,NaN,NaN,NaN,15.401625257748622,33.411565047032035,-183901
2025-09-17T13:25:00-04:00,24406.5,24410.5,24401.5,24409.75,NaN,NaN,NaN,24437.290132072794,NaN,NaN,24431.025,24503.30108525304,24358.748914746964,24379.437082008688,24465.88752150814,24511.87394018387,24419.90110283241,2760,5877.233333333334,49.721010060397155,42.402703981868164,NaN,NaN,NaN,NaN,14.944366310766577,32.520035698252016,-181141
2025-09-17T13:30:00-04:00,24409.75,24423.75,24409.75,24421,NaN,NaN,NaN,24437.290132072794,NaN,NaN,24429.075,24496.931558266755,24361.218441733246,24391.89966560695,24465.51734396607,24511.515979100524,24419.518708831612,5013,5795.133333333333,55.19129487038828,43.32540178607513,NaN,NaN,NaN,NaN,14.876911574283252,30.235854441927295,-176128
2025-09-17T13:35:00-04:00,24420.5,24444.5,24419.25,24442,24384.03116840127,24384.03116840127,24384.03116840127,NaN,NaN,NaN,24427.49,24490.16479237757,24364.815207622432,24406.39473248556,24465.182742076744,24511.035759927276,24419.329724226212,7224,5752.233333333334,63.232770582406154,44.52568330653355,NaN,NaN,NaN,NaN,15.617846461834448,29.627400477170635,-168904
2025-09-17T13:40:00-04:00,24441.25,24449,24433.5,24435.75,24393.46725165576,NaN,NaN,NaN,NaN,NaN,24426.175,24485.238292321435,24367.111707678563,24410.76578598845,24464.89577088002,24510.572836291813,24419.218705468225,7360,5722.566666666667,59.793452095278994,46.10017925192357,NaN,NaN,NaN,NaN,15.6094288574177,29.337311928291467,-176264
2025-09-17T13:45:00-04:00,24435.75,24441.5,24426.75,24429,24393.46725165576,NaN,NaN,NaN,NaN,NaN,24425.12,24482.01966959564,24368.220330404358,24410.76578598845,24464.683709678226,24510.28650010209,24419.08091925436,4343,5576.666666666667,56.235892269210794,47.79081220952903,NaN,NaN,NaN,NaN,15.548041081887865,28.408047560915172,-180607
2025-09-17T13:50:00-04:00,24429,24434.5,24423.25,24434.25,24393.46725165576,NaN,NaN,NaN,NaN,NaN,24424.285,24479.36993532755,24369.20006467245,24410.76578598845,24464.51669105136,24510.06948987921,24418.963892223514,3282,5489.333333333333,58.3133663961212,49.140512457271804,NaN,NaN,NaN,NaN,15.241038147467304,27.21725359960984,-177325
2025-09-17T13:55:00-04:00,24434.5,24460,24423.75,24454.75,24393.46725165576,NaN,NaN,NaN,NaN,NaN,24423.445,24475.2685747508,24371.6214252492,24413.079082426084,24464.378884005677,24509.787955306718,24418.969812704636,5058,5376.233333333334,65.25003781010972,51.19919563689825,NaN,NaN,NaN,NaN,16.741678279791067,27.60208304614183,-172267
2025-09-17T14:00:00-04:00,24459.25,24524.25,24442.25,24512.75,24424.532949291643,NaN,NaN,NaN,NaN,NaN,24423.71,24477.195358748217,24370.22464125178,24445.713265940867,24465.78234091147,24510.497911058977,24421.066770763966,34623,6309.033333333334,76.94105942605213,53.75826668542912,NaN,NaN,NaN,NaN,21.402986974091707,29.84077347032743,-137644
2025-09-17T14:05:00-04:00,24511.75,24515,24436,24440.75,24424.532949291643,NaN,NaN,NaN,NaN,NaN,24422.97,24474.429657983554,24371.51034201645,24445.713265940867,24465.704530425068,24509.479297106634,24421.9297637435,30819,7132.533333333334,53.071338011164684,54.72446029304143,NaN,NaN,NaN,NaN,25.517059333085154,31.47302849900027,-168463
2025-09-17T14:10:00-04:00,24441,24453,24323.5,24324,NaN,NaN,NaN,24469.692601988398,24469.692601988398,24469.692601988398,24420.01,24476.616886511827,24363.40311348817,24445.713265940867,24460.239473851307,24508.413962563205,24412.06498513941,43235,8291.133333333333,34.42280924554616,54.02258939108172,NaN,NaN,NaN,NaN,32.94441223786479,30.17937383516059,-211698
2025-09-17T14:15:00-04:00,24324,24389,24291.5,24374.75,NaN,NaN,NaN,24431.286120079836,NaN,NaN,24418.19,24474.648795595796,24361.7312044042,24445.713265940867,24455.035373240116,24507.446859936827,24402.623886543406,39411,9358.3,43.686075968415444,54.042343825016985,NaN,NaN,NaN,NaN,37.555525649445876,29.702229547679472,-172287
2025-09-17T14:20:00-04:00,24374.25,24425,24333.5,24413.5,NaN,NaN,NaN,24431.286120079836,NaN,NaN,24416.97,24471.097039450266,24362.842960549737,24445.713265940867,24453.16808555439,24505.931564526087,24400.40460658269,24546,10002.666666666666,49.54642701493453,54.29676072245318,NaN,NaN,NaN,NaN,41.408702388771175,28.16390053539569,-147741
2025-09-17T14:25:00-04:00,24413.5,24444.25,24387,24441.5,24312.959857530564,24312.959857530564,24312.959857530564,NaN,NaN,NaN,24416.525,24469.459039141268,24363.590960858735,24445.713265940867,24452.529792917278,24504.8804010147,24400.179184819855,19098,10501.966666666667,53.326089645877374,54.767879614312996,NaN,NaN,NaN,NaN,42.540223646716086,26.219908129582205,-128643
2025-09-17T14:30:00-04:00,24442,24453.75,24347.25,24365.75,24312.959857530564,NaN,NaN,NaN,NaN,NaN,24414.77,24468.496794059447,24361.043205940554,24445.713265940867,24450.4426886491,24503.15967439445,24397.725702903746,29351,11334,43.77240669796728,54.46457357813356,NaN,NaN,NaN,NaN,47.108779100522085,25.328975180292527,-157994
2025-09-17T14:35:00-04:00,24366,24415,24322.5,24324.5,24312.959857530564,NaN,NaN,NaN,NaN,NaN,24412.46,24471.334388321047,24353.58561167895,24445.713265940867,24447.31646860913,24501.91247240345,24392.72046481481,29970,12136.933333333332,39.61071618937911,53.74240973020369,NaN,NaN,NaN,NaN,50.35100916477051,24.992916617854497,-187964
2025-09-17T14:40:00-04:00,24324.75,24374,24288.25,24319,NaN,NaN,NaN,24457.383018821325,24457.383018821325,24457.383018821325,24409.875,24473.40273016595,24346.34726983405,24445.713265940867,24443.376846196814,24501.18003118976,24385.573661203867,31321,12997.633333333333,39.077238041495974,52.591405670997105,NaN,NaN,NaN,NaN,52.87950851014404,25.28302116707274,-219285
2025-09-17T14:45:00-04:00,24318.75,24361.5,24264.25,24341.5,NaN,NaN,NaN,24446.655381602173,NaN,NaN,24407.84,24473.44569792126,24342.23430207874,24445.713265940867,24439.61037666205,24500.2616410861,24378.959112238,30721,13900.066666666668,42.48959813385634,51.10975049610068,NaN,NaN,NaN,NaN,56.04882933084804,25.928415287428138,-188564
2025-09-17T14:50:00-04:00,24341.75,24354,24241.75,24268.25,NaN,NaN,NaN,24440.881273347528,NaN,NaN,24404.7,24480.852806908217,24328.547193091785,24412.670612752696,24435.29791102489,24500.175936471413,24370.419885578365,28885,14711,35.515299415040886,49.37559673322654,NaN,NaN,NaN,NaN,60.06319866435889,26.85467435580006,-217449
2025-09-17T14:55:00-04:00,24267.5,24397.25,24266.5,24392.75,NaN,NaN,NaN,24440.881273347528,NaN,NaN,24403.97,24479.86681416109,24328.07318583891,24306.386490202156,24432.823920973628,24498.271905429407,24367.37593651785,31148,15587.266666666666,50.413340808014645,48.959700200283955,NaN,NaN,NaN,NaN,65.11225590261897,26.463914934925924,-186301
2025-09-17T15:00:00-04:00,24391.75,24455.5,24381.75,24450.75,24261.24789969781,24261.24789969781,24261.24789969781,NaN,NaN,NaN,24404.385,24481.069431930264,24327.700568069733,24272.758882983504,24432.72999528936,24497.29389981201,24368.166090766706,28942,16304.466666666667,55.5638720201677,48.7633077448587,NaN,NaN,NaN,NaN,65.72923762386047,24.76065819350749,-157359
2025-09-17T15:05:00-04:00,24450.5,24512.5,24435.75,24490.25,24313.43549516609,NaN,NaN,NaN,NaN,NaN,24405.785,24486.049251694265,24325.520748305735,24288.01999047733,24433.952879451575,24498.102734496188,24369.803024406963,28878,17008.433333333334,58.70939058016815,48.29611865700573,NaN,NaN,NaN,NaN,66.51643493644187,23.83188649145702,-128481
2025-09-17T15:10:00-04:00,24489.75,24519.25,24412.5,24431,24313.43549516609,NaN,NaN,NaN,NaN,NaN,24406.17,24486.729136047445,24325.610863952552,24288.01999047733,24434.38371277579,24497.916478305226,24370.850947246356,23952,17460.533333333333,52.684927187394024,46.56353778281586,NaN,NaN,NaN,NaN,69.3902610124103,22.50668556950253,-152433
2025-09-17T15:15:00-04:00,24430.75,24502.25,24430,24471,24313.43549516609,NaN,NaN,NaN,NaN,NaN,24407.265,24489.806408397522,24324.723591602477,24288.01999047733,24434.970165657025,24498.09457688503,24371.84575442902,20188,17928.566666666666,55.969794488324425,46.77057038832727,NaN,NaN,NaN,NaN,69.59452808295244,21.276141856259073,-132245
2025-09-17T15:20:00-04:00,24471.75,24529.5,24453,24520.75,24318.391974618065,NaN,NaN,NaN,NaN,NaN,24409.04,24497.254758401283,24320.82524159872,24313.256235124394,24436.101049458302,24499.2676503753,24372.934448541306,19989,18413.3,59.71581914363327,48.577213952476356,NaN,NaN,NaN,NaN,70.08777607702726,20.627696657569018,-112256
2025-09-17T15:25:00-04:00,24521,24550.75,24510.75,24530.5,24360.294612135425,NaN,NaN,NaN,NaN,NaN,24410.9,24505.15184348249,24316.648156517513,24357.754988099514,24437.841052620817,24501.70121353602,24373.980891705614,21905,19017.1,60.42641316330139,49.772952323539634,NaN,NaN,NaN,NaN,67.93864921438245,20.388050008328594,-90351
2025-09-17T15:30:00-04:00,24530.25,24547.25,24473.75,24494,24360.294612135425,NaN,NaN,NaN,NaN,NaN,24412.315,24509.34926250505,24315.280737494948,24357.754988099514,24439.088969142333,24502.999796648688,24375.178141635977,22540,19616.366666666665,56.41450722463906,50.26352948137567,NaN,NaN,NaN,NaN,68.33588855621227,19.346458123236772,-112891
2025-09-17T15:35:00-04:00,24493,24530.5,24489.5,24491.5,24360.294612135425,NaN,NaN,NaN,NaN,NaN,24413.89,24513.425579569262,24314.354420430736,24357.754988099514,24439.952937914175,24503.869120986972,24376.036754841378,16406,20070.8,56.1395754861788,50.46449275568291,NaN,NaN,NaN,NaN,66.38332508791139,18.37926565850865,-129297
2025-09-17T15:40:00-04:00,24491.5,24515.25,24476.25,24497.75,24360.294612135425,NaN,NaN,NaN,NaN,NaN,24415.54,24517.808732269386,24313.271267730615,24357.754988099514,24440.480975627503,24504.329310692563,24376.632640562442,11606,20317.6,56.70760433141582,51.38843544378638,NaN,NaN,NaN,NaN,64.42737329591772,17.186223988369832,-117691
2025-09-17T15:45:00-04:00,24498.75,24503.5,24475,24490,24360.294612135425,NaN,NaN,NaN,NaN,NaN,24417.17,24521.514834085858,24312.82516591414,24362.66324312556,24440.934175365062,24504.65960265024,24377.208748079884,11581,20615.066666666666,55.74355645693456,52.5407811771832,NaN,NaN,NaN,NaN,61.86113234620931,16.04971835061257,-129272
2025-09-17T15:50:00-04:00,24490.25,24510.5,24456.25,24482.5,24360.294612135425,NaN,NaN,NaN,NaN,NaN,24418.48,24524.415916479196,24312.544083520803,24370.70559450045,24441.460809734104,24504.959711126518,24377.96190834169,15849,21000.133333333335,54.7731157806962,53.66191530141178,NaN,NaN,NaN,NaN,61.31748003576579,15.24603619932943,-145121
2025-09-17T15:55:00-04:00,24483,24505,24447,24475.5,24360.294612135425,NaN,NaN,NaN,NaN,NaN,24419.67,24526.797794714475,24312.54220528552,24370.70559450045,24442.013928964796,24505.14816943886,24378.87968849073,20746,21599.666666666668,53.83116212913533,54.472027015360275,NaN,NaN,NaN,NaN,61.080517176068234,14.709723694226822,-165867
2025-09-17T16:00:00-04:00,24475,24512.75,24471.5,24503.5,24360.294612135425,NaN,NaN,NaN,NaN,NaN,24421.675,24531.223676397214,24312.126323602784,24379.456580480288,24442.451859160774,24505.515023201933,24379.388695119615,10560,21784.566666666666,57.01549658430215,56.00775538459323,NaN,NaN,NaN,NaN,59.66405166349193,14.00313687393567,-155307
2025-09-17T16:05:00-04:00,24503.25,24523.25,24499,24512.5,24360.294612135425,NaN,NaN,NaN,NaN,NaN,24423.7,24536.108851964604,24311.291148035398,24404.49026438423,24442.66844758979,24505.751163361285,24379.585731818293,4085,21679.933333333334,58.017810994158594,56.550931826460655,NaN,NaN,NaN,NaN,57.13447654467108,13.062199467010757,-151222
2025-09-17T16:10:00-04:00,24512.25,24518.75,24503.5,24507.5,24360.294612135425,NaN,NaN,NaN,NaN,NaN,24425.82,24540.450451451317,24311.189548548682,24416.117211507382,24442.805668790097,24505.89701514022,24379.714322439973,2666,21523.466666666667,57.21954316971197,56.66919405142811,NaN,NaN,NaN,NaN,54.142728220051715,12.188471874866195,-153888
2025-09-17T16:15:00-04:00,24507,24508.75,24487.5,24498,24360.294612135425,NaN,NaN,NaN,NaN,NaN,24427.71,24543.911521505022,24311.508478494976,24416.117211507382,24442.922236852683,24505.998016646223,24379.846457059142,2761,21470.733333333334,55.652748141365706,56.4508624486565,NaN,NaN,NaN,NaN,51.793247632905164,11.823385039637628,-156649
2025-09-17T16:20:00-04:00,24498.5,24501,24486.75,24492.5,24360.294612135425,NaN,NaN,NaN,NaN,NaN,24429.545,24546.877846639625,24312.21215336037,24419.690015364726,24442.977095470458,24506.04054466888,24379.913646272038,1424,21408.8,54.71857718171679,56.5961231625367,NaN,NaN,NaN,NaN,49.11158708769766,11.505416003830115,-158073
2025-09-17T16:25:00-04:00,24492.75,24509.5,24492.25,24508,24360.457344128252,NaN,NaN,NaN,NaN,NaN,24431.61,24550.745098102387,24312.474901897614,24435.827012291782,24443.048104087946,24506.108298371313,24379.98790980458,1546,21291.733333333334,56.91357407532136,56.66353599017934,NaN,NaN,NaN,NaN,46.835759438576396,10.92448292625583,-156527
2025-09-17T16:30:00-04:00,24508,24517.75,24505.25,24516.75,24375.76041939515,NaN,NaN,NaN,NaN,NaN,24433.685,24555.044581819577,24312.325418180426,24452.561609833425,24443.12911174236,24506.19796103642,24380.0602624483,1516,20188.166666666668,58.14696801136361,56.551475195017225,NaN,NaN,NaN,NaN,44.38320519296379,10.17998707199214,-155011
2025-09-17T16:35:00-04:00,24516.75,24517.25,24500.5,24502.25,24377.021309422642,NaN,NaN,NaN,NaN,NaN,24435.325,24558.12175280731,24312.52824719269,24456.72428786674,24443.18955564224,24506.258823510423,24380.120287774054,1251,19202.566666666666,55.32082199955069,56.18679011189217,NaN,NaN,NaN,NaN,42.40940482203781,9.580039096245214,-156262
2025-09-17T16:40:00-04:00,24502.5,24504,24497,24501.75,24377.021309422642,NaN,NaN,NaN,NaN,NaN,24437.385,24561.110632349162,24313.659367650835,24456.72428786674,24443.22680097749,24506.29275699473,24380.160844960246,849,17789.7,55.221153096535815,56.10155053131337,NaN,NaN,NaN,NaN,39.88016162046368,9.14712788194743,-157111
2025-09-17T16:45:00-04:00,24501.5,24503,24491.75,24491.75,24377.021309422642,NaN,NaN,NaN,NaN,NaN,24439.585,24563.187168672015,24315.982831327983,24456.72428786674,24443.25864098844,24506.31857724332,24380.198704733557,802,16502.733333333334,53.15835251304946,55.888606033232705,NaN,NaN,NaN,NaN,37.83515007614484,8.936714038728757,-157913
2025-09-17T16:50:00-04:00,24491.25,24492.75,24486.75,24487.25,24377.021309422642,NaN,NaN,NaN,NaN,NaN,24441.435,24565.066501243833,24317.80349875617,24456.72428786674,24443.28175859005,24506.334094928854,24380.229422251243,667,15706.766666666666,52.213141451626285,55.56757297039059,NaN,NaN,NaN,NaN,35.56121078499164,8.927059502906538,-158580
2025-09-17T16:55:00-04:00,24487,24504,24486.5,24501.25,24380.388766575135,NaN,NaN,NaN,NaN,NaN,24443.76,24567.431175301088,24320.08882469891,24462.666668310216,24443.31250755507,24506.360033298413,24380.264981811728,751,15095.2,54.899937095265535,55.507314444557096,NaN,NaN,NaN,NaN,34.27112430034938,8.428932040032091,-157829
2025-09-17T18:00:00-04:00,24504,24509.5,24492.5,24507.75,24389.04154991263,NaN,NaN,NaN,NaN,NaN,24446.025,24570.15192093107,24321.89807906893,24467.933334648173,24503.25,24503.25,24503.25,2064,14185.633333333333,56.133134940064615,55.60445867022627,NaN,NaN,NaN,NaN,33.037472564610134,7.920936403088661,-155765
2025-09-17T18:05:00-04:00,24507.5,24516.75,24506,24515.25,24403.039661280236,NaN,NaN,NaN,NaN,NaN,24448.535,24573.083424719378,24323.98657528062,24478.12166771854,24507.341735159822,24512.009519345054,24502.67395097459,1586,13239.5,57.57463218205738,55.87184938829213,NaN,NaN,NaN,NaN,31.445510238566552,7.756211824900454,-154179
2025-09-17T18:10:00-04:00,24515.75,24518.25,24509.5,24516.75,24409.270813040224,NaN,NaN,NaN,NaN,NaN,24450.88,24576.060758905627,24325.699241094375,24482.972334174832,24508.886327388722,24514.032363697526,24503.740291079917,948,12227.066666666668,57.87279572120072,55.933085040927736,NaN,NaN,NaN,NaN,29.824402364383225,7.6680456171318845,-153231
2025-09-17T18:15:00-04:00,24516.25,24518,24514.75,24517,24416.08236699294,NaN,NaN,NaN,NaN,NaN,24453.275,24578.841446552757,24327.708553447246,24488.152867339864,24509.681844773793,24515.08878028435,24504.274909263237,530,11220.7,57.92586919378387,55.9265177694724,NaN,NaN,NaN,NaN,27.926230766927283,7.586176995632499,-152701
2025-09-17T18:20:00-04:00,24517,24524.25,24513.25,24522,24421.516123038717,NaN,NaN,NaN,NaN,NaN,24455.665,24581.82238622661,24329.507613773392,24494.872293871893,24511.332870672763,24517.538891812444,24505.12684953308,996,10291.066666666668,59.03738892558929,56.056363894892215,NaN,NaN,NaN,NaN,26.717214283575334,7.806484202414045,-151705
2025-09-17T18:25:00-04:00,24522.75,24532,24522.75,24530.25,24433.19720835514,NaN,NaN,NaN,NaN,NaN,24458.19,24585.161160505257,24331.21883949474,24503.497835097514,24514.45188888889,24523.097408718128,24505.80636905965,1376,9298.666666666666,60.87407635883967,56.42931591042606,NaN,NaN,NaN,NaN,25.52312754903424,8.368048146830317,-150329
2025-09-17T18:30:00-04:00,24530.25,24534,24526.75,24534,24439.489380702635,NaN,NaN,NaN,NaN,NaN,24460.74,24588.574618157658,24332.905381842345,24507.57326807801,24516.11429488723,24525.76870877541,24506.45988099905,806,8360.8,61.71439716141735,56.929017337547535,NaN,NaN,NaN,NaN,24.217904152674652,8.981729304551141,-149523
2025-09-17T18:35:00-04:00,24534,24542,24532,24541,24448.881908852512,NaN,NaN,NaN,NaN,NaN,24463.365,24592.289249462825,24334.44075053718,24515.85861446241,24519.20289554611,24531.007024971237,24507.398766120983,1341,7442.9,63.298963049885884,57.385116550016434,NaN,NaN,NaN,NaN,23.202339570340747,9.918581032176464,-148182
2025-09-17T18:40:00-04:00,24541.5,24549.25,24538.5,24545.25,24458.296367541036,NaN,NaN,NaN,NaN,NaN,24465.85,24596.194121463734,24335.505878536263,24522.96189156993,24522.70295027361,24536.69004066526,24508.715859881962,1561,6696.533333333334,64.26597604485123,57.822188552408406,NaN,NaN,NaN,NaN,22.312886743887837,11.105399471025056,-146621
2025-09-17T18:45:00-04:00,24545.25,24563,24542,24562,24467.947669016445,NaN,NaN,NaN,NaN,NaN,24468.25,24601.143303067212,24335.356696932788,24531.469513255943,24529.584256971408,24547.86756638764,24511.300947555177,2957,6122.166666666667,67.86021917111557,58.71785977894876,NaN,NaN,NaN,NaN,22.219109119324422,12.754209638745742,-143664
2025-09-17T18:50:00-04:00,24562.5,24573.25,24560.5,24571,24484.427320424787,NaN,NaN,NaN,NaN,NaN,24470.955,24606.570142588855,24335.33985741115,24541.650610604753,24536.164455184535,24558.266953736675,24514.061956632395,2905,5552.7,69.62793414584019,59.74691556818478,NaN,NaN,NaN,NaN,21.54274418222982,14.648102156561512,-140759
2025-09-17T18:55:00-04:00,24571.25,24572.5,24566.25,24567.5,24489.82266949639,NaN,NaN,NaN,NaN,NaN,24473.725,24611.44076707352,24336.009232926477,24544.095488483803,24538.608282757126,24561.533026864392,24515.68353864986,1384,4868.666666666667,68.0601987586292,60.81133315715476,NaN,NaN,NaN,NaN,20.45040531207055,16.40671663739044,-142143
2025-09-17T19:00:00-04:00,24567.25,24575,24567,24573.25,24493.97277542837,NaN,NaN,NaN,NaN,NaN,24476.505,24616.51383864874,24336.49616135126,24548.276390787043,24541.622056650245,24565.46638224262,24517.77773105787,1846,4178.866666666667,69.2838035577198,62.03066616473287,NaN,NaN,NaN,NaN,19.561090646922654,18.132409400563287,-140297
2025-09-17T19:05:00-04:00,24573.75,24576.5,24569,24573.5,24498.201285636173,NaN,NaN,NaN,NaN,NaN,24478.88,24621.33944124382,24336.42055875618,24551.371112629633,24543.402293109055,24567.671323368028,24519.133262850082,1221,3672.7,69.33880257395181,63.06201369892476,NaN,NaN,NaN,NaN,18.699584172142465,19.79265462448238,-139076
2025-09-17T19:10:00-04:00,24574,24577.25,24567.5,24568.5,24499.885318107255,NaN,NaN,NaN,NaN,NaN,24479.995,24624.35733892535,24335.632661074647,24552.271890103708,24545.027099826504,24569.45557094822,24520.59862870479,1342,3330.5666666666666,66.76399670150732,63.82136096759924,NaN,NaN,NaN,NaN,18.060328159846573,21.188344015682112,-140418
2025-09-17T19:15:00-04:00,24568.75,24578.5,24568.25,24574,24502.782576375106,NaN,NaN,NaN,NaN,NaN,24482.66,24628.93309253507,24336.38690746493,24553.392512082966,24546.28098035936,24570.87328166965,24521.688679049068,1050,2979.5333333333333,68.16441679126676,64.57777415397133,NaN,NaN,NaN,NaN,17.50244757700039,22.53983486661941,-139368
2025-09-17T19:20:00-04:00,24574,24577,24572.5,24574.25,24506.752686539876,NaN,NaN,NaN,NaN,NaN,24487.665,24628.919649835196,24346.410350164806,24554.664009666372,24546.935383389846,24571.61109043279,24522.2596763469,566,2470.1,68.22994518246821,65.31757054406187,NaN,NaN,NaN,NaN,16.573701321500362,23.794790656775476,-138802
2025-09-17T19:25:00-04:00,24574.25,24576.25,24573,24574.5,24509.27529169715,NaN,NaN,NaN,NaN,NaN,24491.66,24631.20310301771,24352.11689698229,24556.7562077331,24547.64303532097,24572.389151394313,24522.896919247625,643,1800,68.30021320308227,66.05859511615462,NaN,NaN,NaN,NaN,15.622008369964622,24.960106747634683,-138159
2025-09-17T19:30:00-04:00,24574.5,24584.75,24574.5,24578.25,24515.84800571092,NaN,NaN,NaN,NaN,NaN,24494.955,24634.740395873974,24355.16960412603,24564.029966186477,24549.940676089605,24575.137653829133,24524.743698350077,1975,1513.8333333333333,69.39373156815059,66.79833387633757,NaN,NaN,NaN,NaN,15.23829348639572,26.461819162742366,-136184
2025-09-17T19:35:00-04:00,24578.5,24579.75,24571.5,24572,24515.84800571092,NaN,NaN,NaN,NaN,NaN,24497.565,24638.131667813006,24356.99833218699,24564.029966186477,24550.882160557347,24576.034172457894,24525.7301486568,1084,1413.8,65.34766304245125,67.11787578230982,NaN,NaN,NaN,NaN,14.739129665938885,27.481462095347105,-137268
2025-09-17T19:40:00-04:00,24572.75,24574.75,24568.5,24572.25,24515.84800571092,NaN,NaN,NaN,NaN,NaN,24501.695,24638.614585525193,24364.775414474807,24564.029966186477,24551.743333673596,24576.721752818095,24526.764914529096,1208,1365.2,65.43447924214284,67.38359593093307,NaN,NaN,NaN,NaN,14.132763261228964,28.053647656313103,-136060
2025-09-17T19:45:00-04:00,24572.5,24585.25,24572.5,24584.75,24519.794234211946,NaN,NaN,NaN,NaN,NaN,24506.9,24636.045692921343,24377.75430707866,24564.029966186477,24552.93469085846,24578.06647309872,24527.8029086182,1255,1315,69.54320479486361,67.82961319843147,NaN,NaN,NaN,NaN,14.05185159971261,29.152472798860877,-134805
2025-09-17T19:50:00-04:00,24584.5,24584.5,24578.5,24584.5,24524.252450838678,NaN,NaN,NaN,NaN,NaN,24512.21,24631.470444405655,24392.949555594343,24564.029966186477,24553.772771471453,24579.027042733123,24528.518500209782,894,1297.3333333333333,69.36561298375474,68.19387297978173,NaN,NaN,NaN,NaN,13.494576485447423,30.172810431226665,-135699
2025-09-17T19:55:00-04:00,24584.75,24588,24581.25,24584,24529.059157618736,NaN,NaN,NaN,NaN,NaN,24517.06,24627.55848686667,24406.561513133332,24567.885859319984,24554.736451487417,24580.159350404694,24529.31355257014,1024,1279.9333333333334,68.98617137095452,68.27429813691307,NaN,NaN,NaN,NaN,13.012821022201178,31.303894408154253,-136723
2025-09-17T20:00:00-04:00,24584.25,24584.75,24568,24568.25,24529.059157618736,NaN,NaN,NaN,NaN,NaN,24523.06,24608.634736924567,24437.485263075436,24567.885859319984,24555.88590494322,24580.936190340723,24530.83561954572,2105,1299.5666666666666,58.1884366098668,67.45719117005784,NaN,NaN,NaN,NaN,13.279762377758237,30.72380558752147,-138828
2025-09-17T20:05:00-04:00,24568.25,24578,24568.25,24575,24529.059157618736,NaN,NaN,NaN,NaN,NaN,24526.705,24604.981796688637,24448.428203311367,24567.885859319984,24556.516735770998,24581.34069015717,24531.692781384827,1269,1300.1666666666667,61.00541075094662,66.95327774093765,NaN,NaN,NaN,NaN,13.027636493632647,30.18515168264817,-137559
2025-09-17T20:10:00-04:00,24575.25,24579.5,24570.25,24574.25,24529.059157618736,NaN,NaN,NaN,NaN,NaN,24529.175,24605.47809626995,24452.871903730047,24567.885859319984,24556.938528897466,24581.624264558664,24532.25279323627,855,1300.3666666666666,60.517534303711095,66.32711565136559,NaN,NaN,NaN,NaN,12.757805315516029,29.79532827892286,-138414
2025-09-17T20:15:00-04:00,24573.5,24576,24572,24572.5,24529.059157618736,NaN,NaN,NaN,NaN,NaN,24530.82,24607.241792706696,24454.398207293303,24567.885859319984,24557.109600986325,24581.724531888376,24532.494670084274,384,1286.4333333333334,59.32535033600339,65.6118690629407,NaN,NaN,NaN,NaN,12.13224779297917,29.433349404035074,-138798
2025-09-17T20:20:00-04:00,24571.75,24573.25,24561,24563.75,24529.059157618736,NaN,NaN,NaN,NaN,NaN,24533.475,24604.9013431818,24462.0486568182,24567.885859319984,24557.52888418984,24581.630166379062,24533.42760200062,1840,1325.5333333333333,53.635876293741376,64.67414617667171,NaN,NaN,NaN,NaN,12.140658664909228,27.795887851181668,-140638
2025-09-17T20:25:00-04:00,24564.25,24567.25,24559.75,24562.5,24529.059157618736,NaN,NaN,NaN,NaN,NaN,24535.305,24604.900063761117,24465.709936238884,24567.885859319984,24557.67416826895,24581.479648136115,24533.868688401784,1032,1334.9,52.85602295723687,63.580689474241005,NaN,NaN,NaN,NaN,11.80918304598714,26.14178343326679,-141670
2025-09-17T20:30:00-04:00,24562.75,24568,24562,24566.25,24529.059157618736,NaN,NaN,NaN,NaN,NaN,24536.215,24606.2137149904,24466.2162850096,24567.885859319984,24557.85468746189,24581.410007778137,24534.299367145646,956,1297.9666666666667,54.97123322089339,62.633638619842806,NaN,NaN,NaN,NaN,11.394241399845201,24.682255814944423,-140714
2025-09-17T20:35:00-04:00,24566,24568.75,24562.5,24563.25,24529.059157618736,NaN,NaN,NaN,NaN,NaN,24536.87,24607.254390317998,24466.485609682,24567.885859319984,24557.944404988324,24581.36102252148,24534.52778745517,534,1262.9,52.925418498057525,61.53543899805533,NaN,NaN,NaN,NaN,11.026795585570543,23.40739051754063,-141248
2025-09-17T20:40:00-04:00,24563.5,24570,24562.75,24567,24529.059157618736,NaN,NaN,NaN,NaN,NaN,24538.33,24608.12279618635,24468.537203813652,24567.885859319984,24558.1174444392,24581.32993225949,24534.904956618913,849,1259.6,55.17127450435682,60.519549207784344,NaN,NaN,NaN,NaN,10.757024472315505,22.363198462687897,-140399
2025-09-17T20:45:00-04:00,24566.75,24570.25,24564,24564.75,24529.059157618736,NaN,NaN,NaN,NaN,NaN,24539.795,24608.663330170428,24470.92666982957,24560.283687455987,24558.26963985242,24581.292790654195,24535.246489050645,800,1268.6,53.52137078378543,59.67481404645107,NaN,NaN,NaN,NaN,10.435094152864398,21.422898430379462,-141199
2025-09-17T20:50:00-04:00,24565,24568.25,24561,24567.5,24529.059157618736,NaN,NaN,NaN,NaN,NaN,24541.19,24609.417894591686,24472.96210540831,24555.316559971834,24558.470093987642,24581.206920630862,24535.73326734442,1217,1275.9666666666667,55.28159015568743,58.94960768313282,NaN,NaN,NaN,NaN,10.2075874276598,20.121248066681314,-139982
2025-09-17T20:55:00-04:00,24566.75,24570.75,24563.5,24564.5,24529.059157618736,NaN,NaN,NaN,NaN,NaN,24542.68,24609.612805111294,24475.747194888707,24555.316559971834,24558.578932856642,24581.174640719266,24535.98322499402,630,1251.1,52.92674728382913,57.762717860916084,NaN,NaN,NaN,NaN,9.996331182826955,19.237454659066714,-140612
2025-09-17T21:00:00-04:00,24564.5,24569.25,24560.5,24568.25,24529.059157618736,NaN,NaN,NaN,NaN,NaN,24544.395,24609.439683869896,24479.350316130105,24554.653247977465,24558.7194258057,24581.1230646316,24536.315786979798,869,1253.2,55.47965226783706,56.770863524064815,NaN,NaN,NaN,NaN,9.907307526910744,17.976210577638955,-139743
2025-09-17T21:05:00-04:00,24568.5,24591,24566.25,24585,24535.74209757434,NaN,NaN,NaN,NaN,NaN,24546.585,24609.543765075974,24483.626234924024,24563.289495170684,24560.174862832067,24582.50666967505,24537.843055989084,3247,1316.7333333333333,64.69084709393474,56.46405464713483,NaN,NaN,NaN,NaN,10.967499846417118,18.976578326876776,-136496
2025-09-17T21:10:00-04:00,24585,24594.25,24585,24588.25,24547.429956775504,NaN,NaN,NaN,NaN,NaN,24548.28,24611.07081461817,24485.489185381826,24567.456596136548,24561.13751139262,24583.70147798774,24538.5735447975,1688,1320.9666666666667,66.15409136075694,57.033029986484124,NaN,NaN,NaN,NaN,10.844821285958753,20.13555586300657,-134808
2025-09-17T21:15:00-04:00,24587.75,24588.5,24577.5,24577.5,24547.429956775504,NaN,NaN,NaN,NaN,NaN,24549.58,24612.04450511866,24487.115494881342,24567.456596136548,24561.674684457033,24584.16798226226,24539.181386651806,1401,1269.1,57.64469650870409,56.792978969181085,NaN,NaN,NaN,NaN,10.855905479818842,20.194915593027005,-136209
2025-09-17T21:20:00-04:00,24578,24578.5,24568.25,24577.25,24547.429956775504,NaN,NaN,NaN,NaN,NaN,24550.975,24612.72953424988,24489.220465750117,24567.456596136548,24562.036157172188,24584.31702681206,24539.755287532316,1495,1222.1,57.459590412776066,56.57455440554287,NaN,NaN,NaN,NaN,10.81262651697464,19.189929402518647,-137704
2025-09-17T21:25:00-04:00,24577,24580.5,24574.5,24577,24547.429956775504,NaN,NaN,NaN,NaN,NaN,24552.555,24612.831968238843,24492.278031761158,24567.456596136548,24562.228991712454,24584.434661205967,24540.02332221894,686,1198.8333333333333,57.26157030106064,56.4271415459041,NaN,NaN,NaN,NaN,10.46886748004788,18.44296798487332,-138390
2025-09-17T21:30:00-04:00,24577,24585.25,24575.5,24582,24547.429956775504,NaN,NaN,NaN,NaN,NaN,24554.345,24612.665913053414,24496.02408694659,24567.456596136548,24562.499400859626,24584.6564980694,24540.342303649853,799,1163.9333333333334,60.21470993992508,56.897058234917225,NaN,NaN,NaN,NaN,10.417519802901603,18.181758008456512,-137591
2025-09-17T21:35:00-04:00,24582.25,24588,24582.25,24587.5,24547.429956775504,NaN,NaN,NaN,NaN,NaN,24555.935,24613.444374016137,24498.425625983866,24567.456596136548,24562.773921810774,24584.944507370656,24540.603336250893,655,1145.0666666666666,63.224917524837046,57.63769356117438,NaN,NaN,NaN,NaN,10.101982674122919,18.180920321281757,-136936
2025-09-17T21:40:00-04:00,24587.75,24589.5,24584,24588,24549.028468199336,NaN,NaN,NaN,NaN,NaN,24557.36,24614.44433760806,24500.27566239194,24568.76882993762,24563.04845835767,24585.243593976393,24540.853322738945,636,1121.5333333333333,63.495322347568084,58.24655707022257,NaN,NaN,NaN,NaN,9.773269625971281,18.313381936193565,-136300
2025-09-17T21:45:00-04:00,24588,24593.5,24586.75,24591,24553.19762873573,NaN,NaN,NaN,NaN,NaN,24559.135,24614.754979327496,24503.5150206725,24573.540063950095,24563.41589702853,24585.68541264235,24541.146381414714,769,1112.1666666666667,65.15104092571434,59.1198158150552,NaN,NaN,NaN,NaN,9.557321795544762,18.787322135978823,-135531
2025-09-17T21:50:00-04:00,24590.75,24593.25,24587.25,24593.25,24554.182963793195,NaN,NaN,NaN,NaN,NaN,24560.965,24614.908026426412,24507.02197357359,24574.282051160077,24563.719188727144,24586.054750574374,24541.383626879913,631,1114.3333333333333,66.38258036966239,59.92062337686275,NaN,NaN,NaN,NaN,9.303227381577281,19.22740946435085,-134900
2025-09-17T21:55:00-04:00,24593.25,24597.25,24592.5,24593.25,24559.799647257143,NaN,NaN,NaN,NaN,NaN,24562.995,24613.921367436,24512.068632563998,24579.700640928062,24564.235808589267,24586.730422312572,24541.74119486596,994,1126.0333333333333,66.38258036966239,60.83928120442539,NaN,NaN,NaN,NaN,8.977996854321761,19.992652382575777,-134900
2025-09-17T22:00:00-04:00,24593,24593.5,24589.75,24592.5,24559.799647257143,NaN,NaN,NaN,NaN,NaN,24565.1,24611.85927715764,24518.340722842357,24579.700640928062,24564.548045880547,24587.105648485027,24541.990443276067,672,1082.6,65.48790044043555,61.56830336762169,NaN,NaN,NaN,NaN,8.604568507584492,20.267587829613127,-135572
2025-09-17T22:05:00-04:00,24592,24593,24587.75,24588.25,24559.799647257143,NaN,NaN,NaN,NaN,NaN,24566.84,24610.32617711173,24523.35382288827,24579.700640928062,24564.80593812127,24587.389837718314,24542.222038524225,618,1067.0666666666666,60.510986320734794,62.11003472740066,NaN,NaN,NaN,NaN,8.364956471328457,20.209224842785027,-136190
2025-09-17T22:10:00-04:00,24587.75,24598,24587,24597.5,24559.799647257143,NaN,NaN,NaN,NaN,NaN,24568.635,24609.54993737256,24527.720062627435,24580.214728155166,24565.199589691478,24587.884325464904,24542.51485391805,818,1054.0666666666666,66.4816101933643,62.89588886493833,NaN,NaN,NaN,NaN,8.553173866233568,20.656427083362505,-135372
2025-09-17T22:15:00-04:00,24597,24605.5,24596.75,24604,24568.283132868386,NaN,NaN,NaN,NaN,NaN,24570.41,24609.569770177142,24531.250229822857,24586.896782524134,24566.174257051825,24589.32589216221,24543.02262194144,1656,1067.4333333333334,69.9230027142479,63.26961426638927,NaN,NaN,NaN,NaN,8.567232875788312,21.719811642810523,-133716
2025-09-17T22:20:00-04:00,24604.25,24606.25,24598.75,24603.25,24570.128217738005,NaN,NaN,NaN,NaN,NaN,24572.14,24609.25390035884,24535.02609964116,24587.617426019307,24566.817596555313,24590.263004248405,24543.37218886222,1122,1075.0333333333333,69.04216068744148,63.47590493258101,NaN,NaN,NaN,NaN,8.491001956089146,22.767622586624963,-134838
2025-09-17T22:25:00-04:00,24603.25,24605.5,24601.5,24604.5,24572.05420784082,NaN,NaN,NaN,NaN,NaN,24573.89,24608.613646119145,24539.166353880853,24588.593940815445,24567.096339053725,24590.671494439626,24543.521183667825,484,1057.0333333333333,69.72665801594704,64.33890218309837,NaN,NaN,NaN,NaN,8.17021610208278,23.74058989159552,-134354
2025-09-17T22:30:00-04:00,24604.5,24606.25,24602.5,24603.25,24573.847198393512,NaN,NaN,NaN,NaN,NaN,24575.515,24607.899009944922,24543.130990055077,24590.850152652358,24567.432582017762,24591.16061392078,24543.704550114744,591,1006.5666666666667,68.10497985558555,65.09928714329905,NaN,NaN,NaN,NaN,7.8544863805054375,24.712134945257727,-134945
2025-09-17T22:35:00-04:00,24603.25,24612,24602.75,24610,24576.9734621029,NaN,NaN,NaN,NaN,NaN,24577.11,24608.251156044207,24545.968843955794,24595.055122121885,24568.250287052426,24592.425653880615,24544.074920224237,1326,1008.4666666666667,71.90490287754099,66.1452394701905,NaN,NaN,NaN,NaN,7.954165924755048,26.10697432875736,-133619
2025-09-17T22:40:00-04:00,24610.25,24613.5,24608,24611.25,24580.98035018913,NaN,NaN,NaN,NaN,NaN,24578.655,24608.73470910595,24548.57529089405,24597.19409769751,24568.735885410442,24593.195638154473,24544.27613266641,762,1005.3666666666667,72.55694447969313,67.02682765160252,NaN,NaN,NaN,NaN,7.778868358701116,27.521664474356623,-132857
2025-09-17T22:45:00-04:00,24611.75,24617.5,24610.75,24616.75,24584.788061544168,NaN,NaN,NaN,NaN,NaN,24580.17,24610.141226205047,24550.19877379495,24601.080278158006,24569.476345144838,24594.424540285505,24544.52815000417,1089,1028.8666666666666,75.27590291314954,67.88761232219626,NaN,NaN,NaN,NaN,7.705377761651036,29.141740311044163,-131768
2025-09-17T22:50:00-04:00,24616.5,24619.75,24612.75,24615.75,24587.29201329216,NaN,NaN,NaN,NaN,NaN,24581.58,24611.480575240927,24551.679424759077,24603.114222526405,24570.19925821963,24595.614381769654,24544.784134669604,1072,1003.2666666666667,73.84337324395074,68.62675881479502,NaN,NaN,NaN,NaN,7.654993635818819,30.80916642860846,-132840
2025-09-17T22:55:00-04:00,24616,24622.75,24614.25,24620.5,24589.699194506153,NaN,NaN,NaN,NaN,NaN,24582.75,24614.040254072534,24551.459745927466,24605.191378021125,24571.0308551543,24597.011396199334,24545.050314109263,1194,1008.6666666666666,76.1637761479182,69.41338275923816,NaN,NaN,NaN,NaN,7.715351233260331,32.56710862789292,-131646
2025-09-17T23:00:00-04:00,24620.75,24644.75,24620,24638.75,24601.5083220286,NaN,NaN,NaN,NaN,NaN,24584.105,24618.912627044087,24549.297372955913,24618.3281024169,24574.22844433639,24603.102413938963,24545.354474733816,3730,1101.1333333333334,82.56386313735584,70.56918867121627,NaN,NaN,NaN,NaN,8.932111859456022,35.24345832882598,-127916
2025-09-17T23:05:00-04:00,24639,24643,24634.5,24636.5,24608.12726193639,NaN,NaN,NaN,NaN,NaN,24585.485,24622.92180141351,24548.04819858649,24618.3281024169,24575.534501995546,24605.50473972635,24545.56426426474,1548,1134.9333333333334,79.72182446363028,71.5219918207854,NaN,NaN,NaN,NaN,8.901246726637735,37.72864019397811,-129464
2025-09-17T23:10:00-04:00,24636.25,24637.25,24629.25,24631,24608.12726193639,NaN,NaN,NaN,NaN,NaN,24586.64,24626.009170680798,24547.2708293192,24618.3281024169,24576.646618670817,24607.3515873101,24545.941650031535,1505,1156.8,73.0979788454994,72.06556884971853,NaN,NaN,NaN,NaN,8.836871960449326,39.02594006558207,-130969
2025-09-17T23:15:00-04:00,24631.25,24636.75,24628.5,24636.75,24608.12726193639,NaN,NaN,NaN,NaN,NaN,24587.905,24629.505467549272,24546.304532450726,24618.3281024169,24577.514166049175,24608.77977314049,24546.24855895786,1184,1169.6,75.39926630559718,73.12901742006584,NaN,NaN,NaN,NaN,8.794952534702945,40.08986617478535,-129785
2025-09-17T23:20:00-04:00,24636.75,24642.25,24635.5,24639.25,24609.252847745393,NaN,NaN,NaN,NaN,NaN,24589.32,24632.94763344432,24545.69236655568,24620.01659074996,24578.376192995493,24610.25239928279,24546.499986708197,1113,1166.1333333333334,76.34667005333844,73.83366455292115,NaN,NaN,NaN,NaN,8.648884496509877,41.376459822579456,-128672
2025-09-17T23:25:00-04:00,24639,24643,24637.25,24637.75,24611.065218302418,NaN,NaN,NaN,NaN,NaN,24590.595,24636.045290427628,24545.144709572374,24622.33827259997,24579.079022076126,24611.432160640572,24546.72588351168,926,1176,74.49297499881078,74.16009114467565,NaN,NaN,NaN,NaN,8.441821318187744,42.610509121808946,-129598
2025-09-17T23:30:00-04:00,24638.5,24642.5,24635.5,24639,24611.065218302418,NaN,NaN,NaN,NaN,NaN,24591.89,24639.060876607724,24544.719123392275,24622.470618079977,24579.788268225162,24612.595765066264,24546.98077138406,962,1179.1,75.03691363534497,74.5882877838116,NaN,NaN,NaN,NaN,8.338834081174333,43.393917267856445,-128636
2025-09-17T23:35:00-04:00,24638.5,24638.5,24633.5,24638,24611.065218302418,NaN,NaN,NaN,NaN,NaN,24593.16,24641.786511287984,24544.533488712015,24622.470618079977,24580.29390639481,24613.388735030614,24547.199077759007,729,1095.1666666666667,73.68318026965302,74.87089651621918,NaN,NaN,NaN,NaN,8.13606021823331,43.70585007891992,-129365
2025-09-17T23:40:00-04:00,24638,24638.75,24633.5,24633.75,24611.065218302418,NaN,NaN,NaN,NaN,NaN,24594.27,24644.00558484475,24544.534415155253,24622.470618079977,24580.644034218276,24613.922382908877,24547.365685527675,525,1056.4,68.06308815352762,74.86790425178647,NaN,NaN,NaN,NaN,7.929913059788072,44.01443154335238,-129890
2025-09-17T23:45:00-04:00,24634.25,24634.25,24628,24630,24611.065218302418,NaN,NaN,NaN,NaN,NaN,24595.43,24645.73606722728,24545.12393277272,24622.470618079977,24581.166134079955,24614.659367769476,24547.672900390433,869,1038.6666666666667,63.4634292380374,74.26494184896478,NaN,NaN,NaN,NaN,7.80991926980321,43.16648859311262,-130759
2025-09-17T23:50:00-04:00,24630.25,24634.75,24626,24633.5,24611.065218302418,NaN,NaN,NaN,NaN,NaN,24596.655,24647.62223359435,24545.68776640565,24622.470618079977,24581.666629074316,24615.36415509092,24547.969103057712,839,1016.8,65.78735419211804,73.78139968556651,NaN,NaN,NaN,NaN,7.877067893388694,41.998501876830844,-129920
2025-09-17T23:55:00-04:00,24633,24635.25,24632.5,24634.25,24611.065218302418,NaN,NaN,NaN,NaN,NaN,24597.645,24649.562924650923,24545.727075349077,24622.470618079977,24581.843092133804,24615.62027603936,24548.065908228247,285,1003.4333333333333,66.28226912596077,73.1389972721959,NaN,NaN,NaN,NaN,7.510848758146644,40.97008580073675,-129635