time,open,high,low,close,Long Stop,Long Stop Start,Buy Label,Short Stop,Short Stop Start,Sell Label,Basis,Upper,Lower,ATR Trailing Stoploss,VWAP,Upper Band #1,Lower Band #1,Volume,Volume MA,RSI,RSI-based MA,Regular Bullish,Regular Bullish Label,Regular Bearish,Regular Bearish Label,ATR,ADX,OnBalanceVolume,Histogram,MACD,Signal
2025-08-28T09:45:00-04:00,350,351.52,349.01,350.8,NaN,NaN,NaN,353.0121236055778,NaN,NaN,350.81399999999957,351.96119135376824,349.6668086462309,350.1705624843869,351.0532863835957,351.8487351996808,350.25783756751065,136467,61630.6,50.84413047085912,44.55374673276138,NaN,NaN,NaN,NaN,1.1466675124033507,19.812052781180885,95097271,0.0560339900890135,-0.12344621773962672,-0.17948020782864021
2025-08-28T09:50:00-04:00,350.72,351.42,349.6,351.24,NaN,NaN,NaN,353.0121236055778,NaN,NaN,350.81679999999955,351.9674480966263,349.6661519033728,350.1705624843869,351.00441671059673,351.7405692656861,350.2682641555074,112498,64186.13333333333,53.535752017099526,46.15487813798432,NaN,NaN,NaN,NaN,1.1947626900888253,19.85603114672933,95209769,0.09690734935247236,-0.058346021138049764,-0.15525337049052212
2025-08-28T09:55:00-04:00,351.34,352.07,350.22,350.59,NaN,NaN,NaN,353.0121236055778,NaN,NaN,350.8057999999996,351.9543928095215,349.65720719047766,350.1705624843869,350.99730741751733,351.67217522798785,350.3224396070468,131580,67781.1,49.2457932837106,46.84833149566718,NaN,NaN,NaN,NaN,1.2415653550824781,20.40540582472653,95078189,0.07737986956739906,-0.0585285335312733,-0.13590840309867236
2025-08-28T10:00:00-04:00,350.58,351.45,350.07,350.21,NaN,NaN,NaN,353.0121236055778,NaN,NaN,350.8099999999995,351.94826534792963,349.67173465206935,350.1705624843869,350.9455758076848,351.5925060177937,350.2986455975759,115278,70627.26666666666,46.88064845075538,47.44299504227409,NaN,NaN,NaN,NaN,1.2514535440051577,20.71736660427606,94962911,0.03807238163910043,-0.08831792604979682,-0.12639030768889725
2025-08-28T10:05:00-04:00,350.17,351.14,348.3,348.35,NaN,NaN,NaN,353.0121236055778,NaN,NaN,350.7635999999995,352.093861689387,349.433338310612,350.1705624843869,350.72907837663905,351.55490351677633,349.90325323650177,138451,73192.7,37.40981508928556,47.322381753963164,NaN,NaN,NaN,NaN,1.3649211480047876,19.398106037602886,94824460,-0.1061091858303797,-0.2590267899768719,-0.1529176041464922
2025-08-28T10:10:00-04:00,348.25,349.44,348.06,348.95,NaN,NaN,NaN,352.2729799149675,NaN,NaN,350.7259999999995,352.1496291660022,349.30237083399675,350.1705624843869,350.5887315604999,351.5271566248563,349.65030649614357,85203,74665.86666666667,41.5143759792823,47.134235432373316,NaN,NaN,NaN,NaN,1.3659982088615883,18.387108621664712,94909663,-0.15123226130256398,-0.34195793077469716,-0.19072566947213318
2025-08-28T10:15:00-04:00,348.98,349.37,347.01,347.24,NaN,NaN,NaN,351.8746626461053,NaN,NaN,350.6557999999995,352.3818177989708,348.92978220102816,350.1705624843869,350.3409099343433,351.5290969692312,349.1527228994554,116601,76744.76666666666,34.55859246044632,46.1301190007752,NaN,NaN,NaN,NaN,1.4369983368000472,18.30246746151846,94793062,-0.27897608139830665,-0.5394457712200165,-0.2604696898217098
2025-08-28T10:20:00-04:00,347.26,347.5,346.34,346.62,NaN,NaN,NaN,350.5953597985551,NaN,NaN,350.5731999999995,352.6357593427521,348.5106406572468,348.1964499875095,350.0780366720553,351.5486944098124,348.6073789342982,103083,79094.26666666666,32.43651151409149,44.79558441906213,NaN,NaN,NaN,NaN,1.4172127413143314,18.69582159295681,94689979,-0.38161134497637034,-0.7374838710421727,-0.3558725260658024
2025-08-28T10:25:00-04:00,346.6,346.6,344.91,345.1,NaN,NaN,NaN,349.4964798077117,NaN,NaN,350.44699999999943,353.00256256086845,347.8914374391304,347.6237379148839,349.63722370201987,351.57641814256687,347.69802926147287,148425,83342,27.911446473951713,43.64096231574814,NaN,NaN,NaN,NaN,1.4381261169347348,19.9045770298578,94541554,-0.5196948696379023,-1.0054911131131803,-0.48579624347527794
2025-08-28T10:30:00-04:00,345.12,345.86,344.06,344.3,NaN,NaN,NaN,348.77686708917935,NaN,NaN,350.3049999999995,353.37101304667,347.238986953329,347.6237379148839,349.1934123580607,351.5163752517953,346.8704494643261,152386,87812.03333333334,25.8661618279572,42.768043629834445,NaN,NaN,NaN,NaN,1.4639742514393974,21.442070520281696,94389168,-0.6256249033845733,-1.2678273727059945,-0.6422024693214212
2025-08-28T10:35:00-04:00,344.19,345.48,343.55,345.4,NaN,NaN,NaN,348.4215549487621,NaN,NaN,350.1945999999994,353.54812759979245,346.8410724002064,347.6237379148839,348.8756596505338,351.3850150711175,346.3663042299501,131418,91250.2,33.1228212342196,42.05343459296822,NaN,NaN,NaN,NaN,1.4972618049080124,23.100292894282916,94520586,-0.5831692375730745,-1.3711640162877643,-0.7879947787146898
2025-08-28T10:40:00-04:00,345.39,346.12,345.26,345.5,NaN,NaN,NaN,348.4215549487621,NaN,NaN,350.08119999999946,353.67031385196935,346.49208614802956,347.6237379148839,348.69790747447746,351.2470805454566,346.14873440349834,104925,94126.6,33.75763752782147,40.174421701879965,NaN,NaN,NaN,NaN,1.451743104557441,23.92388761752439,94625511,-0.512422389305937,-1.428522765347111,-0.9161003760411741
2025-08-28T10:45:00-04:00,345.54,345.71,345,345.22,NaN,NaN,NaN,348.4215549487621,NaN,NaN,349.9681999999995,353.7985246653784,346.1378753346206,347.20299033190713,348.58688240474896,351.1654758756629,346.00828893383505,64979,95711.26666666666,32.81828476947919,38.95838586130729,NaN,NaN,NaN,NaN,1.398761454231908,24.826078158636573,94560532,-0.45073464062980784,-1.4795186768284339,-1.028784036198626
2025-08-28T10:50:00-04:00,345.23,345.27,344.31,345.18,NaN,NaN,NaN,348.4215549487621,NaN,NaN,349.8545999999995,353.9030924802077,345.8061075197913,346.3223922655257,348.45701771856244,351.07865744012094,345.83537799700395,72801,97392.83333333333,32.67838920221112,38.04145430722649,NaN,NaN,NaN,NaN,1.367421350358199,26.015446476504707,94487731,-0.381615179056624,-1.505803010019406,-1.124187830962782
2025-08-28T10:55:00-04:00,345.19,345.8,345.02,345.52,NaN,NaN,NaN,348.4215549487621,NaN,NaN,349.75199999999955,353.97108426108474,345.53291573891437,344.8959138124206,348.3820725643805,351.0130192464073,345.75112588235373,52483,98105.56666666667,35.20665138765321,36.924491515568924,NaN,NaN,NaN,NaN,1.3254626824754727,26.510385851968383,94540214,-0.28634052976941593,-1.4821134931745519,-1.195772963405136
2025-08-28T11:00:00-04:00,345.49,345.88,344.92,345.18,NaN,NaN,NaN,348.4215549487621,NaN,NaN,349.63639999999947,354.0298874715137,345.24291252848525,344.55473104993644,348.3158945260822,350.9559283139353,345.6758607382291,46671,98148.8,33.83810862002353,35.517516987206356,NaN,NaN,NaN,NaN,1.2993582051557946,27.027958183157804,94493543,-0.22241015349064597,-1.4737856552684434,-1.2513755017777974
2025-08-28T11:05:00-04:00,345.15,345.315,344.75,345.25,NaN,NaN,NaN,348.4215549487621,NaN,NaN,349.5211999999995,354.06410064189953,344.9782993580995,343.0677848399491,348.25899809692874,350.9096068018909,345.60838939196657,38871,97779.63333333333,34.40345991747705,34.457350318189675,NaN,NaN,NaN,NaN,1.2469040476446662,27.61116040471191,94532414,-0.1548049363645787,-1.444881672233521,-1.2900767358689422
2025-08-28T11:10:00-04:00,345.26,345.32,344.65,344.97,NaN,NaN,NaN,348.4215549487621,NaN,NaN,349.4021999999995,354.1013323286632,344.70306767133576,342.9478623930135,348.1983919228537,350.8612707139167,345.5355131317907,41309,96100.13333333333,33.18205833479878,33.478879595621336,NaN,NaN,NaN,NaN,1.2056966156700484,28.215429478102195,94491105,-0.11042372795539679,-1.428106395813188,-1.3176826678577913
2025-08-28T11:15:00-04:00,344.93,345.39,344.45,344.61,NaN,NaN,NaN,348.3619810787109,NaN,NaN,349.2839999999995,354.1587529170529,344.4092470829461,342.9699455452229,348.097535871179,350.78274356595136,345.4123281764066,68704,96198.93333333333,31.627352088971165,33.06584652417031,NaN,NaN,NaN,NaN,1.1867182859793304,28.906024995534025,94422401,-0.08777914966036948,-1.4274066049332532,-1.3396274552728837
2025-08-28T11:20:00-04:00,344.61,344.61,343.77,344.09,NaN,NaN,NaN,347.5900728478605,NaN,NaN,349.15419999999955,354.2256559489483,344.0827440510508,342.9699455452229,347.97863745031384,350.70759811337405,345.24967678725363,71665,96905.03333333334,29.478825542879477,32.20616435014154,NaN,NaN,NaN,NaN,1.1619526941236662,29.964641120172033,94350736,-0.0899564959979604,-1.4520730752703344,-1.362116579272374
2025-08-28T11:25:00-04:00,344.11,344.11,341.6,341.945,NaN,NaN,NaN,346.44279680932135,NaN,NaN,348.9848999999995,354.42885609480487,343.5409439051942,342.9699455452229,347.5100994001922,350.53127197033496,344.4889268300494,224452,103113.93333333333,22.645060871206027,31.355197808052946,NaN,NaN,NaN,NaN,1.2582417874005465,31.929583752042213,94126284,-0.21107627837467957,-1.6259619272407235,-1.414885648866044
2025-08-28T11:30:00-04:00,341.95,343.1,341.93,342.41,NaN,NaN,NaN,346.0992605907158,NaN,NaN,348.8200999999995,354.5441337142851,343.0960662857139,342.9699455452229,347.36096560081813,350.45689622725257,344.2650349743837,79434,104523.13333333333,26.61659276502104,30.939489325976485,NaN,NaN,NaN,NaN,1.2519388025862228,33.754173338778806,94205718,-0.2333523881308477,-1.7065761340296035,-1.4732237458987558
2025-08-28T11:35:00-04:00,342.4,343.19,342.15,342.27,NaN,NaN,NaN,346.0992605907158,NaN,NaN,348.6536999999995,354.63997657582206,342.66742342417695,342.9699455452229,347.21742661223965,350.37519142579157,344.0596617986877,82160,105355.56666666667,26.18076775368519,30.815869417386015,NaN,NaN,NaN,NaN,1.2368003166872084,35.317796925911644,94123558,-0.2305852776404047,-1.7614553429492616,-1.530870065308857
2025-08-28T11:40:00-04:00,342.27,342.42,341.31,341.4,NaN,NaN,NaN,345.41755975311094,NaN,NaN,348.4646999999996,354.75087671100516,342.17852328899403,342.9699455452229,346.9893972354302,350.27001872930725,343.70877574155315,119270,106831.7,23.595182129178,30.653656581758927,NaN,NaN,NaN,NaN,1.2277431512095516,37.10092179665553,94004288,-0.2583279624681525,-1.8537800183940476,-1.5954520559258951
2025-08-28T11:45:00-04:00,341.35,341.69,340.91,341.27,NaN,NaN,NaN,344.7974434006968,NaN,NaN,348.2610999999995,354.8016153590755,341.72058464092345,342.9699455452229,346.8135812660453,350.19020805310635,343.4369544789842,91691,108026.4,23.226067704743485,29.946745615367774,NaN,NaN,NaN,NaN,1.1957614975517246,38.90102863117466,93912597,-0.2559254256411647,-1.915358837977351,-1.6594334123361862
2025-08-28T11:50:00-04:00,341.22,341.43,340.26,340.96,NaN,NaN,NaN,344.3430141552106,NaN,NaN,348.0460999999995,354.8215212534961,341.27067874650294,342.9699455452229,346.60610208595375,350.0975287821871,343.1146753897204,107762,108057.63333333333,22.32903026347327,29.13041652505719,NaN,NaN,NaN,NaN,1.1939213905837451,40.79271024736624,93804835,-0.2456582665152256,-1.9665062454802182,-1.7208479789649926
2025-08-28T11:55:00-04:00,340.95,341.56,340.61,341.25,NaN,NaN,NaN,344.3430141552106,NaN,NaN,347.8406999999995,354.8025313712866,340.87886862871244,342.9699455452229,346.4089221150079,349.9851284015126,342.8327158285032,115267,106512.03333333334,25.23798438427866,28.588966497542867,NaN,NaN,NaN,NaN,1.1764984341134768,42.34484339090698,93920102,-0.19214943277086505,-1.961034769928574,-1.768885337157709
2025-08-28T12:00:00-04:00,341.27,342.15,341.16,342.13,NaN,NaN,NaN,344.3430141552106,NaN,NaN,347.6546999999995,354.7191910391577,340.59020896084127,342.9699455452229,346.2939644924767,349.89735371015286,342.6905752748005,81982,102446.56666666667,33.390366808126274,28.63982204082252,NaN,NaN,NaN,NaN,1.1631771173910823,42.8808117941021,94002084,-0.07625220751260997,-1.8642005965484714,-1.7879483890358614
2025-08-28T12:05:00-04:00,342.13,342.28,341.57,342.17,NaN,NaN,NaN,344.3430141552106,NaN,NaN,347.4710999999995,354.6185704030309,340.32362959696815,342.2539564361783,346.213728041416,349.83021407283735,342.59724200999466,62505,100349.33333333333,33.74403056639213,28.535349125018154,NaN,NaN,NaN,NaN,1.130807323291718,43.184031039909286,94064589,0.01924028542179035,-1.7638980322586235,-1.7831383176804139
2025-08-28T12:10:00-04:00,342.15,342.75,342.13,342.72,NaN,NaN,NaN,344.3430141552106,NaN,NaN,347.2992999999995,354.4822754309904,340.1163245690086,340.97016514894267,346.162381196655,349.77940217428875,342.5453602190213,47255,98185.86666666667,38.57347160699414,28.8735893383732,NaN,NaN,NaN,NaN,1.0943210859137384,42.77131026475148,94111844,0.12944076921206937,-1.621337356165327,-1.7507781253773964
2025-08-28T12:15:00-04:00,342.68,343.09,342.05,342.07,NaN,NaN,NaN,344.3430141552106,NaN,NaN,347.1054999999995,354.3194254918706,339.8915745081284,340.7335830099167,346.08831712433715,349.70743248662,342.4692017620543,68077,95906.2,35.29880418521668,28.9375425003546,NaN,NaN,NaN,NaN,1.0904410083484688,41.90764901104451,94043767,0.16620682699431377,-1.5430195916345042,-1.709226418628818
2025-08-28T12:20:00-04:00,342.06,342.28,341.86,342.2,NaN,NaN,NaN,344.3430141552106,NaN,NaN,346.92009999999954,354.1522804431449,339.6879195568542,340.7335830099167,346.03408869685506,349.6578883525844,342.41028904112574,47789,93749.23333333334,36.46061695284176,29.171725258786243,NaN,NaN,NaN,NaN,1.042552364895004,41.247363216013014,94091556,0.20441723051285554,-1.4537048804877486,-1.6581221110006041
2025-08-28T12:25:00-04:00,342.23,343.25,342.2,343.2,NaN,NaN,NaN,344.3430141552106,NaN,NaN,346.75469999999956,353.9412158207646,339.5681841792345,341.04889312634674,345.98052788836526,349.59640647512737,342.36464930160315,60578,91382.5,44.68837622501498,30.104655554217942,NaN,NaN,NaN,NaN,1.043084338831076,39.34609135719448,94152134,0.29658532876880717,-1.2873904500395952,-1.5839757788084023
2025-08-28T12:30:00-04:00,343.17,343.37,342.43,342.861,NaN,NaN,NaN,344.3430141552106,NaN,NaN,346.5879199999995,353.74101471325054,339.43482528674843,341.13911450107736,345.93175856550783,349.53965943112695,342.3238576998887,57079,89442.53333333334,42.67113799672405,31.04696358663541,NaN,NaN,NaN,NaN,1.0357211717717132,37.434974773636256,94095055,0.33161363093163976,-1.1694587401438525,-1.5010723710754923
2025-08-28T12:35:00-04:00,342.92,343.36,342.54,343.31,NaN,NaN,NaN,344.3430141552106,NaN,NaN,346.4385199999995,353.5470487170086,339.3299912829905,341.1652916008619,345.8957451293646,349.49503718692563,342.2964530718036,46144,86365.63333333333,46.13904911213183,32.7251056038444,NaN,NaN,NaN,NaN,1.0203125166451616,35.66036651747505,94141199,0.37852407894905404,-1.0279172723891747,-1.4064413513382288
2025-08-28T12:40:00-04:00,343.32,343.39,342.95,343.18,NaN,NaN,NaN,344.3430141552106,NaN,NaN,346.2801199999995,353.31872091386816,339.24151908613084,341.41423328068953,345.873799793394,349.46681198446123,342.2807876023268,29798,84518.8,45.28490762347157,34.05855666516229,NaN,NaN,NaN,NaN,0.9788616225990785,33.97125019684344,94111401,0.3926097422979169,-0.9156791734658327,-1.3082889157637496
2025-08-28T12:45:00-04:00,343.18,343.22,342.68,342.9,NaN,NaN,NaN,344.3430141552106,NaN,NaN,346.1197199999995,353.09329355797746,339.1461464420216,341.41423328068953,345.85238721151785,349.44101256419856,342.26376185883714,27116,81535.96666666666,43.42044035400994,35.28996185089978,NaN,NaN,NaN,NaN,0.9475143638420029,32.70053851143186,94084285,0.37491558619800225,-0.8396444330162467,-1.214560019214249
2025-08-28T12:50:00-04:00,342.88,343.98,342.72,343.82,NaN,NaN,NaN,344.3430141552106,NaN,NaN,346.00851999999946,352.94782899446824,339.0692110055307,341.8695092996413,345.8074586440446,349.3760635595425,342.23885372854664,72714,80523.66666666667,50.61509539978484,37.21995565594312,NaN,NaN,NaN,NaN,0.9698347664247163,30.478447530121016,94156999,0.4139566999685276,-0.6971141442535895,-1.111070844222117
2025-08-28T12:55:00-04:00,343.82,344.07,343.42,343.57,NaN,NaN,NaN,344.3430141552106,NaN,NaN,345.8799199999996,352.75662087006725,339.0032191299319,342.05660743971305,345.7735611578488,349.3235095722781,342.2236127434195,61665,77631.66666666667,48.79916310688988,39.04660532752501,NaN,NaN,NaN,NaN,0.9469894259658064,28.302136791094018,94095334,0.41090162433205624,-0.5974438138070468,-1.008345438139103
2025-08-28T13:00:00-04:00,343.53,344.29,343.42,343.93,NaN,NaN,NaN,344.3430141552106,NaN,NaN,345.76091999999954,352.5621327371873,338.9597072628118,342.24428595177045,345.7491243786518,349.282561248055,342.2156875092486,50440,74233.46666666666,51.497704362404235,41.13008204887722,NaN,NaN,NaN,NaN,0.9414901812539634,26.565833526577578,94145774,0.41961387183724885,-0.48382809834254203,-0.9034419701797909
2025-08-28T13:05:00-04:00,343.98,344.26,343.63,344.2,NaN,NaN,NaN,344.3430141552106,NaN,NaN,345.64651999999955,352.3558588079934,338.9371811920057,342.30842876141634,345.7338306737405,349.2552172113943,342.2124441360867,35083,71022.3,53.47811500874167,43.14723423633886,NaN,NaN,NaN,NaN,0.9192408825929658,24.953551923812306,94180857,0.428544964469466,-0.36776076459295837,-0.7963057290624244
2025-08-28T13:10:00-04:00,344.16,344.3,343.67,343.8,NaN,NaN,NaN,344.3430141552106,NaN,NaN,345.51651999999956,352.11106380836196,338.92197619163716,342.4237430091331,345.7164374655363,349.2253153852933,342.20755954577925,38253,68799.9,50.2074078021967,44.34845145020103,NaN,NaN,NaN,NaN,0.8985808195506108,23.513566002316413,94142604,0.3934104669362791,-0.30454264539207543,-0.6979531123283546
2025-08-28T13:15:00-04:00,343.78,344.05,343.67,343.93,NaN,NaN,NaN,344.3430141552106,NaN,NaN,345.3817199999996,351.82314989159727,338.9402901084019,342.4237430091331,345.7017398359037,349.20034419272184,342.2031354790856,32184,67706.73333333334,51.25092591724398,45.59894397526188,NaN,NaN,NaN,NaN,0.8615393324398525,22.17643621807023,94174788,0.36542501938791205,-0.24117183809346443,-0.6065968574813765
2025-08-28T13:20:00-04:00,343.94,344.09,343.62,343.66,NaN,NaN,NaN,344.3430141552106,NaN,NaN,345.2371199999996,351.49956649512853,338.9746735048707,342.50219552584514,345.68117682159647,349.1664978427448,342.19585580044816,43645,66734.86666666667,48.956113028237084,46.34056121963638,NaN,NaN,NaN,NaN,0.8335722372655752,20.845487881885827,94131143,0.3170275582100418,-0.21031240971882426,-0.5273399679288661
2025-08-28T13:25:00-04:00,343.66,343.67,342.91,343.43,NaN,NaN,NaN,344.3430141552106,NaN,NaN,345.1013199999996,351.218459585818,338.9841804141812,342.50219552584514,345.65809734955036,349.13393678800554,342.1822579110952,40341,66330.13333333333,47.02450691952681,47.17811141494424,NaN,NaN,NaN,NaN,0.8283170774608906,20.244863722645302,94090802,0.2602034538429952,-0.20208565062512207,-0.4622891044681173
2025-08-28T13:30:00-04:00,343.46,344.4,343.46,344.11,341.2029829553122,341.2029829553122,341.2029829553122,NaN,NaN,NaN,344.9933199999996,350.98468388416023,339.00195611583894,342.5948051365409,345.6319815658898,349.08671653824,342.1772465935396,65179,66947.06666666667,52.936835074302095,48.354984137905696,NaN,NaN,NaN,NaN,0.838437286213682,19.082572745752987,94155981,0.25855752399350346,-0.13909219947623797,-0.3976497234697414
2025-08-28T13:35:00-04:00,344.15,344.49,344.09,344.13,341.6323928209799,NaN,NaN,NaN,NaN,NaN,344.87711999999965,350.7033096385354,339.0509303614639,342.84584410923276,345.61990082535874,349.06207578083627,342.1777258698812,36360,66863.36666666667,53.10261727315797,48.95600135563019,NaN,NaN,NaN,NaN,0.8071203371984215,18.133686397094724,94192341,0.24887352429760845,-0.08655781809773089,-0.33543134239533934
2025-08-28T13:40:00-04:00,344.11,344.27,344.01,344.21,341.6323928209799,NaN,NaN,NaN,NaN,NaN,344.7209199999996,350.1799342971423,339.26190570285684,342.84584410923276,345.61197521150865,349.046444346695,342.1775060763223,22976,66252.26666666666,53.80360358925545,49.751177469382434,NaN,NaN,NaN,NaN,0.7680403131128193,17.117523433776043,94215317,0.23792089613662093,-0.038030222224563204,-0.27595111836118413
2025-08-28T13:45:00-04:00,344.19,344.24,343.68,343.79,341.6323928209799,NaN,NaN,NaN,NaN,NaN,344.5829199999996,349.7736421825424,339.3921978174568,342.84584410923276,345.6041308436582,349.0326533345476,342.1756083527688,19475,64611.3,49.61100800908151,49.99917453345028,NaN,NaN,NaN,NaN,0.7531802907476182,16.161634775165336,94195842,0.19429616934010535,-0.03308090668605246,-0.2273770760261578
2025-08-28T13:50:00-04:00,343.82,345,343.771,344.99,341.8012824863913,NaN,NaN,NaN,NaN,NaN,344.48271999999963,349.43944404801675,339.5259959519825,343.23649218392717,345.58362576875834,348.9804227208984,342.1868288166183,87277,65131.7,59.35605797336948,51.00425670130012,NaN,NaN,NaN,NaN,0.7871674128370729,15.883577989756636,94283119,0.23542185946027935,0.06690024829919139,-0.16852161116108796
2025-08-28T13:55:00-04:00,344.98,345.01,344.62,344.8,342.29506510064624,NaN,NaN,NaN,NaN,NaN,344.3627199999996,348.980828323571,339.74461167642824,343.40419374714173,345.5762213811193,348.9575628766685,342.1948798855701,41836,59044.5,57.46118536150386,52.00716705897826,NaN,NaN,NaN,NaN,0.7587983119201381,15.63905179913418,94241283,0.23826846563722898,0.12931397088544827,-0.1089544947517807
2025-08-28T14:00:00-04:00,344.78,344.93,344.45,344.71,342.29506510064624,NaN,NaN,NaN,NaN,NaN,344.2321199999996,348.4135777487167,340.0506622512825,343.4053549977134,345.5697145349318,348.9393684606287,342.20006060923487,32578,57482.63333333333,56.54042288457433,52.43040473646323,NaN,NaN,NaN,NaN,0.7388841467829866,15.103515594143383,94208705,0.2228119641398131,0.16956046042298567,-0.05325150371682743
2025-08-28T14:05:00-04:00,344.72,344.91,344.5,344.82,342.29506510064624,NaN,NaN,NaN,NaN,NaN,344.1167199999997,347.88834530589776,340.34509469410165,343.4852839981707,345.56435940506157,348.9237319972886,342.20498681283453,28723,55701.4,57.438117700607314,53.047472921728755,NaN,NaN,NaN,NaN,0.7153924220127751,14.606231975223357,94237428,0.20894938391840417,0.20793522618117777,-0.0010141577372263927
2025-08-28T14:10:00-04:00,344.84,345.2,344.42,344.54,342.3989390399216,NaN,NaN,NaN,NaN,NaN,344.00331999999963,347.352619567408,340.65402043259127,343.67022719853657,345.5533530998136,348.8921328610672,342.21457333856,58540,53677.066666666666,54.36008400425941,53.2519286104327,NaN,NaN,NaN,NaN,0.7200072490118606,14.607764274580578,94178888,0.17144741523446422,0.21329511130585388,0.04184769607138967
2025-08-28T14:15:00-04:00,344.55,344.83,344.32,344.7,342.3989390399216,NaN,NaN,NaN,NaN,NaN,343.93031999999965,347.04862570538074,340.81201429461856,343.67022719853657,345.54664089758813,348.8743745023565,342.2189072928198,32414,51701.166666666664,55.81713151572623,53.419001218074456,NaN,NaN,NaN,NaN,0.7050067312252984,14.399981052425858,94211302,0.14878365974099944,0.22782727074763898,0.07904361100663954
2025-08-28T14:20:00-04:00,344.71,344.86,344.61,344.76,342.4376696624079,NaN,NaN,NaN,NaN,NaN,343.84651999999966,346.62771313248516,341.06532686751416,343.67022719853657,345.5423456934738,348.8616878453024,342.2230035416452,24316,48919.63333333333,56.37951852869691,53.85986626996733,NaN,NaN,NaN,NaN,0.6725062504234913,14.25867957012074,94235618,0.1298874058862452,0.24140286836444602,0.11151546247820084
2025-08-28T14:25:00-04:00,344.74,345.05,344.58,344.98,342.55800285957116,NaN,NaN,NaN,NaN,NaN,343.80131999999963,346.42970138637963,341.17293861361964,343.7685563256507,345.5380388342268,348.84716727294347,342.2289103955102,29319,46054.7,58.46703735212119,54.37530280102999,NaN,NaN,NaN,NaN,0.6580415182503867,14.458323520431698,94264937,0.12425790846093146,0.26683784805436517,0.1425799395934337
2025-08-28T14:30:00-04:00,345.04,345.2,344.14,344.24,342.55800285957116,NaN,NaN,NaN,NaN,NaN,343.7537199999996,346.2595380956208,341.24790190437835,343.7685563256507,345.5258368260005,348.8167955457817,342.2348781062193,55895,45185.13333333333,49.82898709094236,54.43765094836608,NaN,NaN,NaN,NaN,0.6867528383753593,13.669394423025352,94209042,0.0656906983300232,0.2246933125059627,0.1590026141759395
2025-08-28T14:35:00-04:00,344.25,344.41,343.97,344.06,342.55800285957116,NaN,NaN,NaN,NaN,NaN,343.73291999999964,346.21080231687154,341.25503768312774,343.7685563256507,345.518158609429,348.8015477219049,342.2347694969531,25937,43966.2,47.972374369679336,54.505355766234125,NaN,NaN,NaN,NaN,0.669127635634262,12.790792857653779,94183105,0.012601514730539554,0.17475450758911393,0.16215299285857437
2025-08-28T14:40:00-04:00,344.04,344.56,344,344.3,342.55800285957116,NaN,NaN,NaN,NaN,NaN,343.73291999999964,346.21080231687154,341.25503768312774,343.7685563256507,345.51242059271215,348.7892248437836,342.2356163416407,21809,43118,50.61455009008054,54.33947826736115,NaN,NaN,NaN,NaN,0.6613328045175292,12.08416121579773,94204914,-0.007496427833798391,0.1527824580663264,0.1602788859001248
2025-08-28T14:45:00-04:00,344.3,344.45,344.01,344.03,342.55800285957116,NaN,NaN,NaN,NaN,NaN,343.7055199999997,346.1389590890545,341.2720809109449,343.7685563256507,345.503962043944,348.7722129375525,342.2357111503355,29532,41833.166666666664,47.6808934540588,53.95221228028264,NaN,NaN,NaN,NaN,0.6455233184805627,11.428003262645683,94175382,-0.03839245497596128,0.11228831718017318,0.15068077215613446
2025-08-28T14:50:00-04:00,344.04,344.1,343.68,343.88,342.55800285957116,NaN,NaN,NaN,NaN,NaN,343.6731199999997,346.0526681806536,341.2935718193458,343.7685563256507,345.48876310140236,348.7453613749664,342.2321648278383,44685,41729.7,46.08286129268326,53.40073068767033,NaN,NaN,NaN,NaN,0.6294145100176666,11.117534794025755,94130697,-0.0666912677127573,0.06731668751518782,0.13400795522794512
2025-08-28T14:55:00-04:00,343.86,344.28,343.77,344.26,342.55800285957116,NaN,NaN,NaN,NaN,NaN,343.65391999999963,345.99846733718095,341.3093726628183,343.7685563256507,345.4779588913198,348.72412248615274,342.2317952964869,37372,40956.166666666664,50.59982536233178,53.47136049861679,NaN,NaN,NaN,NaN,0.6208849021592612,10.416988963031256,94168069,-0.05790336153871886,0.061628753304546535,0.1195321148432654
2025-08-28T15:00:00-04:00,344.24,344.81,344.2,344.59,342.55800285957116,NaN,NaN,NaN,NaN,NaN,343.64211999999964,345.9616310054195,341.32260899457975,343.7685563256507,345.4689976835399,348.70102457671953,342.23697079036026,45897,40583.433333333334,54.18907669784956,53.10229040750822,NaN,NaN,NaN,NaN,0.6201074091478863,10.635604878814243,94213966,-0.029389804720732354,0.08279485894234995,0.1121846636630823
2025-08-28T15:05:00-04:00,344.61,345.1,344.41,345.08,342.6526210582081,NaN,NaN,NaN,NaN,NaN,343.6333199999997,345.9274662011206,341.3391737988788,343.7685563256507,345.4631625841268,348.6801268258255,342.2461983424281,47065,40614.13333333333,58.95751195372306,53.20917087838102,NaN,NaN,NaN,NaN,0.6250997370658943,11.32806449045335,94261031,0.020270491527381668,0.1375227780723094,0.11725228654492773
2025-08-28T15:10:00-04:00,345.07,346,345.06,345.77,343.39500191919865,NaN,NaN,NaN,NaN,NaN,343.64511999999974,345.97672983528975,341.3135101647097,344.38968503266887,345.46614415420214,348.6503476191911,342.2819406892132,101251,42995.9,64.55284479984644,53.78148672947189,NaN,NaN,NaN,NaN,0.6475926129897588,13.162101865817624,94362282,0.09329921179384912,0.23387630128723913,0.14057708949339
2025-08-28T15:15:00-04:00,345.77,345.89,345.56,345.74,343.6420472865079,NaN,NaN,NaN,NaN,NaN,343.6549199999997,346.0173447831492,341.2924952168502,344.4367480261351,345.4688181225356,348.6369560442664,342.3006802008048,51051,43793.73333333333,64.1433946508139,54.26043508305806,NaN,NaN,NaN,NaN,0.6249074263476321,14.865136571513023,94311231,0.13098515559798968,0.3043085339908771,0.17332337839288742
2025-08-28T15:20:00-04:00,345.74,346,345.45,345.72,343.661726955303,NaN,NaN,NaN,NaN,NaN,343.6699199999996,346.0746986709771,341.2651413290221,344.5623984209081,345.4708645869538,348.62632174858453,342.31540742532303,40833,42731.03333333333,63.85261916632702,54.93847330892004,NaN,NaN,NaN,NaN,0.6195568958942307,16.446525941087323,94270398,0.14488300734454299,0.35442713757356614,0.20954413022902316
2025-08-28T15:25:00-04:00,345.7,346.5,345.64,346.42,343.98323936642555,NaN,NaN,NaN,NaN,NaN,343.70611999999966,346.2185001193765,341.19373988062284,344.91991873672646,345.4820897758894,348.61397018783344,342.35020936394534,80907,43372.433333333334,69.12768384021491,55.88922704638351,NaN,NaN,NaN,NaN,0.636731403330358,18.485558094889456,94351305,0.18876089575586275,0.4454952499238516,0.25673435416798884
2025-08-28T15:30:00-04:00,346.46,346.86,346.31,346.47,344.51809212249714,NaN,NaN,NaN,NaN,NaN,343.75371999999965,346.38094749838217,341.1264925016171,345.32093498938116,345.4965015589435,348.60954252454405,342.383460593343,70802,44051.166666666664,69.4703954215782,56.82428968158932,NaN,NaN,NaN,NaN,0.6305363030924761,20.73068882103382,94422107,0.20721783317820847,0.5157566456407494,0.30853881246254095
2025-08-28T15:35:00-04:00,346.47,346.6,345.99,346.06,344.51809212249714,NaN,NaN,NaN,NaN,NaN,343.8360199999996,346.48913664279615,341.1829033572031,345.32093498938116,345.50207627988647,348.60368723495003,342.4004653248229,40801,44241.76666666667,63.268224239420746,57.167231602110725,NaN,NaN,NaN,NaN,0.6290694243001573,21.97020629242076,94381306,0.17894545113421378,0.5322206263803082,0.3532751752460944
2025-08-28T15:40:00-04:00,346.08,346.67,346.07,346.26,344.51809212249714,NaN,NaN,NaN,NaN,NaN,343.9130199999996,346.61906574985335,341.2069742501459,345.32093498938116,345.5097617762897,348.5980262056055,342.42149734697387,49187,44606.23333333333,64.91377558160028,58.24471649430056,NaN,NaN,NaN,NaN,0.6277073225644328,23.201922600817518,94430493,0.16138704397940462,0.5550089802203502,0.39362193624094555
2025-08-28T15:45:00-04:00,346.26,346.57,346.2,346.23,344.51809212249714,NaN,NaN,NaN,NaN,NaN,343.9922199999996,346.7328592627308,341.25158073726834,345.32093498938116,345.5176806215293,348.59211259517656,342.443248647882,51650,45255.1,64.44738395111798,59.42150289297474,NaN,NaN,NaN,NaN,0.6092996566669736,24.345659172900223,94378843,0.13641849304135728,0.5641450525426421,0.42772655950128485
2025-08-28T15:50:00-04:00,346.26,346.68,346.03,346.4,344.51809212249714,NaN,NaN,NaN,NaN,NaN,344.0922199999996,346.8120228547007,341.3724171452985,345.32093498938116,345.5323285918664,348.5822396891475,342.4824174945853,93932,46931.333333333336,65.94073364576454,60.516230289809315,NaN,NaN,NaN,NaN,0.6122068240479065,24.921414601403374,94472775,0.12056690766036932,0.5784351940767465,0.45786828641637717
2025-08-28T15:55:00-04:00,346.32,346.54,345.8,345.8,344.51809212249714,NaN,NaN,NaN,NaN,NaN,344.18281999999954,346.8211188975018,341.5445211024973,345.32093498938116,345.5443028231758,348.559500258264,342.52910538808766,130277,49929.2,56.862471861121655,61.172057318885244,NaN,NaN,NaN,NaN,0.6213349080444852,24.826990450171895,94342498,0.06184622845435761,0.5351760719843242,0.47332984352996654
2025-08-29T09:30:00-04:00,347.21,348.72,346.27,346.73,345.17736406967,NaN,NaN,NaN,NaN,NaN,344.29821999999956,346.8663860788488,341.73005392115033,346.0329529418563,347.24,347.24,347.24,199545,54408.066666666666,64.92336603606589,62.51780765769828,NaN,NaN,NaN,NaN,0.7855252717555946,26.946087261381322,94542043,0.07683433236272841,0.569372758983377,0.4925384266206486
2025-08-29T09:35:00-04:00,346.72,346.84,344.67,345.7,NaN,NaN,NaN,348.2631979334968,348.2631979334968,348.2631979334968,344.38721999999956,346.83214543207913,341.94229456792,346.0329529418563,346.5199418602121,347.2709436437053,345.7689400767189,183440,59310.73333333333,53.09063832982696,62.69572286966223,NaN,NaN,NaN,NaN,0.8844163237730492,26.240980794418533,94358603,0.01197823030909656,0.5075112145070193,0.49553298419792274
2025-08-29T09:40:00-04:00,345.64,346.86,344.99,345.87,NaN,NaN,NaN,348.2631979334968,NaN,NaN,344.46201999999954,346.8544179101498,342.0696220898493,346.0329529418563,346.3484578686575,347.0427611925131,345.6541545448018,148658,63500.13333333333,54.562590787003295,62.722402447458926,NaN,NaN,NaN,NaN,0.9548151577892604,25.605488990465762,94507261,-0.02296891339153767,0.46682184245850067,0.48979075585003834
2025-08-29T09:45:00-04:00,345.75,345.785,343.38,344.87,NaN,NaN,NaN,347.45081671213245,NaN,NaN,344.51601999999957,346.8192679502774,342.21277204972176,346.0329529418563,345.98396047773934,346.90740399724706,345.06051695823163,148421,67798.33333333333,45.51514564626439,61.76223342549759,NaN,NaN,NaN,NaN,1.0644712179471711,24.380056792569185,94358840,-0.11195203027605244,0.3498507180049728,0.46180274828102524
2025-08-29T09:50:00-04:00,344.9,346.13,344.26,344.74,NaN,NaN,NaN,347.45081671213245,NaN,NaN,344.5564199999995,346.80238990556126,342.3104500944377,346.0329529418563,345.8401557658204,346.75501377041144,344.92529776122933,122733,68980.2,44.48250725137845,60.32863788632131,NaN,NaN,NaN,NaN,1.122008988093802,22.868184877144877,94236107,-0.17436267743280076,0.24384940149002432,0.4182120789228251
2025-08-29T09:55:00-04:00,344.82,345.1,343.15,343.44,NaN,NaN,NaN,347.2478051034099,NaN,NaN,344.58381999999955,346.73939568007614,342.42824431992295,346.0329529418563,345.5776380601973,346.6570807208267,344.49819539956786,125373,71764.76666666666,35.74815589248627,58.30040654644076,NaN,NaN,NaN,NaN,1.1811512032299623,22.454997406283983,94110734,-0.29111580496061495,0.05431732272205636,0.3454331276826713
2025-08-29T10:00:00-04:00,343.51,344.5,342.11,342.13,NaN,NaN,NaN,346.6117685078004,NaN,NaN,344.5824199999995,346.7442686201975,342.4205713798015,346.0329529418563,345.2021508587405,346.56611715672096,343.83818456076,152269,75754.46666666666,29.468783550478662,55.844418288165876,NaN,NaN,NaN,NaN,1.2674975458563924,22.819510911476673,93958465,-0.4357840193578368,-0.19929689651462468,0.2364871228432121
2025-08-29T10:05:00-04:00,342.11,342.36,340.13,340.46,NaN,NaN,NaN,344.70555175744585,NaN,NaN,344.5276199999995,346.95006467937776,342.10517532062124,346.0329529418563,344.5569543028414,346.5271255567118,342.58678304897103,195067,81299.26666666666,23.74307310908887,52.60266037879973,NaN,NaN,NaN,NaN,1.3362477211523658,24.222490896496033,93763398,-0.6123462415923062,-0.5289456791471707,0.08340056244513552
2025-08-29T10:10:00-04:00,340.4,340.51,338.54,339.35,NaN,NaN,NaN,343.09689031392554,NaN,NaN,344.45739999999955,347.24503788218294,341.66976211781616,346.0329529418563,343.747358612787,346.3415542788874,341.1531629466867,241233,87389.03333333334,20.844115678219865,49.12935468284557,NaN,NaN,NaN,NaN,1.3815157410700518,26.146016168829732,93522165,-0.7625097739174069,-0.8697366549516232,-0.10722688103421624
2025-08-29T10:15:00-04:00,339.33,339.36,337.48,337.93,NaN,NaN,NaN,342.0858952996562,NaN,NaN,344.3497999999995,347.67062035681727,341.02897964318174,346.0329529418563,342.94139166044596,346.0264725657112,339.85631075518074,260942,95006.63333333333,17.842762802481573,45.88467886592134,NaN,NaN,NaN,NaN,1.4171217595650478,28.273490457890095,93261223,-0.9063008601058575,-1.2401029561665382,-0.3338020960606806
2025-08-29T10:20:00-04:00,337.88,339.15,337.86,338.86,NaN,NaN,NaN,342.0858952996562,NaN,NaN,344.26339999999954,347.91025422826084,340.61654577173823,343.605362353485,342.61958404591473,345.7967573475424,339.4424107442871,143152,98967.83333333333,25.41721879177814,43.0634962380769,NaN,NaN,NaN,NaN,1.4080416338818276,30.249002297731852,93404375,-0.8865229012115599,-1.4419557225751305,-0.5554328213635706
2025-08-29T10:25:00-04:00,338.83,339.85,337.94,339.7,NaN,NaN,NaN,342.0858952996562,NaN,NaN,344.19939999999946,348.0465317318749,340.352268268124,343.33728988278807,342.3371023104377,345.5255090083609,339.1486956125144,170964,103689.33333333333,31.55522004423146,40.71405595901358,NaN,NaN,NaN,NaN,1.4438958028902704,31.307055130226537,93575339,-0.7689828517317977,-1.5166613860283178,-0.7476785342965201
2025-08-29T10:30:00-04:00,339.67,340.16,339.14,339.21,NaN,NaN,NaN,342.0858952996562,NaN,NaN,344.1071999999994,348.19944054065303,340.0149594593458,341.94446552498437,342.1820555752886,345.3482908284855,339.01582032209166,121075,105862,30.00401485947073,38.1471474742783,NaN,NaN,NaN,NaN,1.413617531255254,31.956163704664732,93454264,-0.6794538868680934,-1.5969958928816368,-0.9175420060135434
2025-08-29T10:35:00-04:00,339.19,339.87,338.78,339.74,NaN,NaN,NaN,342.0858952996562,NaN,NaN,344.0305999999995,348.29975337770315,339.7614466222958,341.94446552498437,342.07575128525343,345.22388872351394,338.9276138469929,90046,107998.96666666666,33.79501003458111,36.49947162952541,NaN,NaN,NaN,NaN,1.3905019933084524,32.72359136491698,93544310,-0.5455323535130483,-1.5994574479048538,-1.0539250943918055
2025-08-29T10:40:00-04:00,339.67,339.92,338.62,338.62,NaN,NaN,NaN,342.0858952996562,NaN,NaN,343.9243999999994,348.45448990666705,339.3943100933318,340.7765724199875,341.95097342823414,345.0915423717339,338.81040448473436,99168,110577.6,30.08665851598704,34.0111353780912,NaN,NaN,NaN,NaN,1.3840375652149923,33.510599571073016,93445142,-0.49486257304350434,-1.672503310696186,-1.1776407376526816
2025-08-29T10:45:00-04:00,338.61,339.41,338.51,338.65,NaN,NaN,NaN,342.0858952996562,NaN,NaN,343.81339999999943,348.5770013437745,339.04979865622437,339.84625793598997,341.8689511804086,345.007230940467,338.7306714203502,65407,111773.43333333333,30.307257640423742,32.38375104313383,NaN,NaN,NaN,NaN,1.3494634534139238,34.29475574498811,93510549,-0.4245113667535283,-1.708279946094592,-1.2837685793410638
2025-08-29T10:50:00-04:00,338.68,338.94,338.19,338.53,NaN,NaN,NaN,342.0858952996562,NaN,NaN,343.7079999999994,348.6960449078357,338.7199550921631,337.522006348792,341.7915769518849,344.9331564874339,338.6499974163359,58958,112249.2,29.90084070308508,30.6221974657111,NaN,NaN,NaN,NaN,1.3066446353129293,35.1812707741063,93451591,-0.3541172528334475,-1.726415145382873,-1.3722978925494256
2025-08-29T10:55:00-04:00,338.54,339.05,337.7,338.18,NaN,NaN,NaN,342.0070786676357,NaN,NaN,343.59299999999945,348.81492033666046,338.37107966333843,336.17361615383817,341.66629754466425,344.8182583257836,338.5143367635449,94304,114146.93333333333,28.692298075259558,29.420565496353607,NaN,NaN,NaN,NaN,1.3097414470762931,36.23969704639981,93357287,-0.30125737884275194,-1.7488696161028656,-1.4476122372601137
2025-08-29T11:00:00-04:00,338.09,338.83,338.03,338.595,NaN,NaN,NaN,342.006075091834,NaN,NaN,343.49169999999947,348.89775645941916,338.0856435405798,336.17361615383817,341.59003983125757,344.74178461877875,338.4382950437364,64364,114762.5,32.19194780558705,28.54266839308279,NaN,NaN,NaN,NaN,1.2733313437137015,37.22252144210093,93421651,-0.21265148936162426,-1.713426598962144,-1.5007751096005197
2025-08-29T11:05:00-04:00,338.61,339.51,338.6,339.38,NaN,NaN,NaN,342.006075091834,NaN,NaN,343.4106999999994,348.9380306435017,337.8833693564971,336.6965649412897,341.5378660974246,344.67535158188406,338.4003806129652,58998,115160.26666666666,38.35495347122427,28.728868220135503,NaN,NaN,NaN,NaN,1.247736247734149,37.165941864451185,93480649,-0.08218834565554256,-1.603510541669948,-1.5213221960144054
2025-08-29T11:10:00-04:00,339.38,339.67,339.16,339.18,NaN,NaN,NaN,342.006075091834,NaN,NaN,343.3120999999995,348.96057593269944,337.6636240672995,337.1642519530318,341.49360977569677,344.6147246776159,338.3724948737776,56304,113662.03333333334,37.421741472508714,29.296936643137652,NaN,NaN,NaN,NaN,1.1950408014674232,36.89503526302488,93424345,0.004997945520059499,-1.5150747641143312,-1.5200727096343907
2025-08-29T11:15:00-04:00,339.19,339.47,338.66,338.89,NaN,NaN,NaN,342.006075091834,NaN,NaN,343.20729999999946,348.98417015972655,337.4304298402724,337.1642519530318,341.44282524526324,344.5518692064207,338.3337812841058,58378,113906.26666666666,36.051993022136145,30.17614520835531,NaN,NaN,NaN,NaN,1.167537887076893,36.97720283612414,93365967,0.054733713417215,-1.451655567862872,-1.506389281280087
2025-08-29T11:20:00-04:00,338.89,339.43,338.88,339.27,NaN,NaN,NaN,342.006075091834,NaN,NaN,343.1084999999995,348.9815687891702,337.2354312108288,337.2273212499403,341.40147395875357,344.4965952357814,338.30635268172574,53536,114329.7,39.19280594469,31.48676594167461,NaN,NaN,NaN,NaN,1.123428037999973,37.05350129685918,93419503,0.12102207327645353,-1.3551116896845201,-1.4761337629609736
2025-08-29T11:25:00-04:00,339.28,339.63,338.83,338.93,NaN,NaN,NaN,342.006075091834,NaN,NaN,343.0112999999994,348.9958450322102,337.0267549677886,337.46785699995223,341.3435668105059,344.41988569636214,338.2672479246496,76187,114172.36666666667,37.42180111503696,32.885268678285705,NaN,NaN,NaN,NaN,1.10032603528569,36.813688957169305,93343316,0.14798578000642548,-1.291151537952942,-1.4391373179593674
2025-08-29T11:30:00-04:00,338.93,339.09,336.81,337.25,NaN,NaN,NaN,341.3911793692851,NaN,NaN,342.8564999999994,349.02586893065006,336.68713106934877,337.46785699995223,341.16442980910347,344.2650643142513,338.06379530395566,155276,116988.16666666667,30.167874615420047,33.22460123711728,NaN,NaN,NaN,NaN,1.1845884613367104,37.79975077898335,93188040,0.06303511489514024,-1.3603434243404422,-1.4233785392355824
2025-08-29T11:35:00-04:00,337.29,337.29,335.71,335.89,NaN,NaN,NaN,340.00021667068125,NaN,NaN,342.6782999999994,349.121473631254,336.23512636874483,337.46785699995223,340.88839157229125,344.1033946317461,337.6733885128364,188994,121927.93333333333,25.806770679086796,32.81399771103551,NaN,NaN,NaN,NaN,1.2128321426698054,39.17458856796969,92999046,-0.06733007346095077,-1.507541131061771,-1.4402110576008202
2025-08-29T11:40:00-04:00,335.88,336.68,334.78,335.28,NaN,NaN,NaN,339.33020682201396,NaN,NaN,342.4896999999995,349.229193277848,335.750206722151,337.46785699995223,340.631989744256,343.9685045088529,337.29547497965905,169148,125926.63333333333,24.122363113543017,32.39387972918353,NaN,NaN,NaN,NaN,1.261915561050536,40.776356063957806,92829898,-0.17130953984939157,-1.6543479824125598,-1.4830384425631682
2025-08-29T11:45:00-04:00,335.29,335.71,334.83,335.38,NaN,NaN,NaN,338.8265610573769,NaN,NaN,342.30089999999944,349.29286615856034,335.30893384143855,337.46785699995223,340.4645072831011,343.8771403744952,337.05187419170704,113713,127995.4,24.986746421739056,31.764718042551955,NaN,NaN,NaN,NaN,1.2346358781183544,42.26371159594676,92943611,-0.20759918103466557,-1.7425374188565002,-1.5349382378218346
2025-08-29T11:50:00-04:00,335.35,336.25,335,335.65,NaN,NaN,NaN,338.8265610573769,NaN,NaN,342.1230999999994,349.32718297860043,334.91901702139836,337.46785699995223,340.28934660340593,343.7591263371531,336.8195668696588,136022,129398.4,27.391810383763826,31.5722288902503,NaN,NaN,NaN,NaN,1.235733315395615,42.87595506838019,93079633,-0.1882376248200779,-1.7702352688469318,-1.581997644026854
2025-08-29T11:55:00-04:00,335.64,336.39,335.58,335.7,NaN,NaN,NaN,338.8265610573769,NaN,NaN,341.94309999999945,349.32811696425966,334.55808303573923,337.46785699995223,340.2039005166861,343.69304700783516,336.714754025537,74310,127532.83333333333,27.853124853638136,31.396933691194185,NaN,NaN,NaN,NaN,1.205323792867357,43.24775371499135,93153943,-0.14862079540479445,-1.767773638282847,-1.6191528428780526
2025-08-29T12:00:00-04:00,335.65,336.09,335.59,335.7,NaN,NaN,NaN,338.8265610573769,NaN,NaN,341.76189999999946,349.30447592354284,334.2193240764561,337.46785699995223,340.10760262650416,343.6181289034974,336.5970763495109,85399,123727.96666666666,27.853124853638136,31.250668273376544,NaN,NaN,NaN,NaN,1.1549435219482602,43.59299531541598,93153943,-0.10123727915398506,-1.745699441820534,-1.644462162666549
2025-08-29T12:05:00-04:00,335.74,335.9,335.31,335.7,NaN,NaN,NaN,338.8265610573769,NaN,NaN,341.5762999999994,349.2485812280696,333.90401877192915,337.46785699995223,340.0292833676159,343.558014038678,336.5005526965538,69739,119937.93333333333,27.853124853638136,31.190727328975015,NaN,NaN,NaN,NaN,1.1145904132376685,44.06425197159906,93153943,-0.051238936042472316,-1.7085108327196394,-1.6572718966771671
2025-08-29T12:10:00-04:00,335.68,336.6,335.67,336.53,NaN,NaN,NaN,338.8265610573769,NaN,NaN,341.42209999999943,349.1834385676966,333.66076143230225,337.46785699995223,339.93300826703637,343.46660506969516,336.3994114643776,104541,118467.36666666667,36.2506167677933,31.48063225484689,NaN,NaN,NaN,NaN,1.1014053837206927,43.444054895471965,93258484,0.05086277899194536,-1.5936934229372355,-1.6445562019291808
2025-08-29T12:15:00-04:00,336.57,336.93,336.2,336.42,NaN,NaN,NaN,338.8265610573769,NaN,NaN,341.2692999999994,349.1172286466278,333.42137135337106,336.2202855999618,339.87058382960385,343.40152126197756,336.3396463972301,76044,116054.8,35.65824908204324,31.288010512762533,NaN,NaN,NaN,NaN,1.0748764277406446,42.407154600765956,93182440,0.12016500697001531,-1.4943499432166618,-1.6145149501866771
2025-08-29T12:20:00-04:00,336.36,336.39,335.69,336.12,NaN,NaN,NaN,338.8265610573769,NaN,NaN,341.1056999999994,349.034718605259,333.1766813947398,334.673232646818,339.8156779501599,343.35027909958393,336.2810768007359,60950,113995.36666666667,34.02523350829715,31.045402801033138,NaN,NaN,NaN,NaN,1.0502423971877428,41.81750641682376,93121490,0.15287697810254275,-1.4234187275584986,-1.5762957056610414
2025-08-29T12:25:00-04:00,336.1,336.2,335.66,335.87,NaN,NaN,NaN,338.8265610573769,NaN,NaN,340.9424999999994,348.95946208063816,332.9255379193607,334.673232646818,339.7728945065839,343.3115126524939,336.2342763606739,46768,111375.2,32.682027158773906,30.80469095365012,NaN,NaN,NaN,NaN,1.01379651167433,41.29177742319271,93074722,0.16378251516857945,-1.3715675617003171,-1.5353500768688966
2025-08-29T12:30:00-04:00,335.9,336.59,335.79,335.98,NaN,NaN,NaN,338.8265610573769,NaN,NaN,340.7844999999994,348.8747178587774,332.69428214122144,334.673232646818,339.7355167239124,343.2751255232614,336.19590792456336,44138,107770.83333333333,33.91814872304502,30.42792972353262,NaN,NaN,NaN,NaN,0.9985253322690174,40.21833905340487,93118860,0.1830495810415429,-1.3065381005669678,-1.4895876816085107
2025-08-29T12:35:00-04:00,335.99,336.3,335.71,336.26,NaN,NaN,NaN,338.8265610573769,NaN,NaN,340.6244999999994,348.74980522518905,332.4991947748097,334.673232646818,339.6898761293511,343.2305362886074,336.14921597009476,54689,103091.56666666667,37.08504662238793,30.403875831200548,NaN,NaN,NaN,NaN,0.9693449513926613,39.29153486816116,93173549,0.21697927557726082,-1.2183635871369347,-1.4353428627141955
2025-08-29T12:40:00-04:00,336.21,336.21,335.66,335.709,NaN,NaN,NaN,338.8265610573769,NaN,NaN,340.44687999999934,348.60588395545136,332.2878760445473,334.673232646818,339.6447403534823,343.18866292892596,336.1008177780386,52090,96786.8,33.6658813049216,30.653733451879226,NaN,NaN,NaN,NaN,0.9429631691503259,38.47698225681694,93121459,0.20479355275082445,-1.179350921775665,-1.3841444745264895
2025-08-29T12:45:00-04:00,335.71,335.93,335.39,335.43,NaN,NaN,NaN,338.59379195199136,NaN,NaN,340.2538799999994,348.42190376740257,332.08585623259626,334.673232646818,339.5835784557297,343.13532652892474,336.0318303825347,67585,90341.56666666667,32.05432602334028,31.099987405040192,NaN,NaN,NaN,NaN,0.9141800856395897,37.97303688787724,93053874,0.18123401407858308,-1.1576019569282607,-1.3388359710068438
2025-08-29T12:50:00-04:00,335.42,335.9,335.3,335.69,NaN,NaN,NaN,338.4822559541736,NaN,NaN,340.0522799999994,348.1631465189855,331.94141348101334,334.673232646818,339.5345137300215,343.0911883814517,335.97783907859133,56396,87449.7,35.168857491172005,31.889022717727975,NaN,NaN,NaN,NaN,0.8917386509510452,37.58977127801039,93110270,0.18576526974892404,-1.1066293838206889,-1.292394653569613
2025-08-29T12:55:00-04:00,335.73,335.88,335.41,335.58,NaN,NaN,NaN,338.46033522898387,NaN,NaN,339.8490799999994,347.88855044878125,331.80960955121753,334.673232646818,339.48013617792446,343.0415663266005,335.9187060292484,64071,83886.6,34.44938140965036,32.564925216864495,NaN,NaN,NaN,NaN,0.861614461597397,37.23388178313402,93046199,0.18362982295553576,-1.0628573748751933,-1.246487197830729
2025-08-29T13:00:00-04:00,335.56,335.56,333.76,333.88,NaN,NaN,NaN,337.59554726403,NaN,NaN,339.61227999999943,347.64357910342983,331.58098089656903,334.673232646818,339.3108376270232,342.9291919146126,335.6924833394338,158872,85146.5,25.699176437241434,32.4440227921129,NaN,NaN,NaN,NaN,0.9300705714832967,38.197263059861704,92887327,0.07553914488180258,-1.1520632667284758,-1.2276024116102784
2025-08-29T13:05:00-04:00,333.95,334.35,333.69,334.19,NaN,NaN,NaN,336.91211329748324,NaN,NaN,339.36767999999944,347.29906916916184,331.43629083083704,334.5849351151708,339.234886099019,342.881018450911,335.588753747127,70195,84484.8,29.229283266267856,32.542319821586446,NaN,NaN,NaN,NaN,0.9107798163773487,39.13453152843259,92957522,0.03480540777385466,-1.1840956518929602,-1.2189010596668148
2025-08-29T13:10:00-04:00,334.19,334.26,333.19,333.21,NaN,NaN,NaN,336.6315626930522,NaN,NaN,339.1024799999994,346.95254597939584,331.25241402060294,334.5849351151708,339.1039356057759,342.80727515398326,335.4005960575686,114126,84983.4,25.15970963494391,32.34993302025115,NaN,NaN,NaN,NaN,0.922152686636109,40.301635761308546,92843396,-0.04397908873855094,-1.2738749205900035,-1.2298958318514526
2025-08-29T13:15:00-04:00,333.21,333.5,332.67,333.27,NaN,NaN,NaN,335.9726280251862,NaN,NaN,338.8466799999994,346.60623284747885,331.08712715252,334.5849351151708,338.96800452155446,342.73537579768004,335.2006332454289,115622,86657.23333333334,25.84049067221126,32.20617343586351,NaN,NaN,NaN,NaN,0.9155703518763858,41.66287540088324,92959018,-0.07601244297786569,-1.3249113855737846,-1.248898942595919
2025-08-29T13:20:00-04:00,333.28,334.07,333.28,333.84,NaN,NaN,NaN,335.9726280251862,NaN,NaN,338.5982799999994,346.185941869691,331.0106181303078,334.4009480921367,338.889774101871,342.682498934162,335.09704926958,76827,87252.86666666667,32.154448172311106,31.91358996475764,NaN,NaN,NaN,NaN,0.907315326742359,41.86394837601411,93035845,-0.044343589318494914,-1.3043284292440376,-1.2599848399255427
2025-08-29T13:25:00-04:00,333.86,334.17,333.69,333.74,NaN,NaN,NaN,335.9726280251862,NaN,NaN,338.3484799999994,345.7343984426003,330.96256155739854,334.3907584737093,338.8410077302765,342.6472774391782,335.0347380213748,50430,85790.4,31.645404220449464,31.62695818892951,NaN,NaN,NaN,NaN,0.8767928034036204,41.87174426110126,92985415,-0.01706432625215437,-1.2813152477407357,-1.2642509214885813
2025-08-29T13:30:00-04:00,333.73,334.35,333.72,333.93,NaN,NaN,NaN,335.9726280251862,NaN,NaN,338.0990799999994,345.2179752160396,330.9801847839592,334.3007483385392,338.7945973575215,342.6118366445536,334.97735807048946,50281,85320.96666666666,33.79014659174007,31.61016626631829,NaN,NaN,NaN,NaN,0.8591647460176473,41.54925784314082,93035696,0.024579617982567026,-1.2335263990103726,-1.2581060169929397
2025-08-29T13:35:00-04:00,333.92,334.32,333.71,333.96,NaN,NaN,NaN,335.9726280251862,NaN,NaN,337.8622799999994,344.723810243973,331.00074975602575,334.3007483385392,338.7467671176479,342.57472398487045,334.91881025042534,52811,85114.73333333334,34.14152206126744,31.714415902210686,NaN,NaN,NaN,NaN,0.8413672641592448,41.258493525074236,93088507,0.06277717358129808,-1.179634550016317,-1.242411723597615
2025-08-29T13:40:00-04:00,333.94,334.11,333.46,334.04,NaN,NaN,NaN,335.9726280251862,NaN,NaN,337.6084799999994,344.06609634357415,331.1508636564247,334.3007483385392,338.70091881183333,342.5397965799639,334.8620410437028,50277,84913.83333333333,35.13017745073938,31.80098938276028,NaN,NaN,NaN,NaN,0.8276981738621583,41.21033834423932,93138784,0.09986002188137677,-1.117586696245894,-1.2174467181272708
2025-08-29T13:45:00-04:00,334.06,334.4,333.59,333.98,NaN,NaN,NaN,335.9726280251862,NaN,NaN,337.37407999999937,343.48116515553346,331.2669948444653,333.38659867083135,338.6401682567937,342.4910693517432,334.7892671618442,69865,85296.73333333334,34.70932930571328,31.631295288712092,NaN,NaN,NaN,NaN,0.82643401858629,40.57888563417482,93068919,0.1251381749338012,-1.0610239994600192,-1.1861621743938204
2025-08-29T13:50:00-04:00,333.96,334.26,333.75,333.86,NaN,NaN,NaN,335.9726280251862,NaN,NaN,337.1338799999994,342.8153545502218,331.452405449777,332.58108280676674,338.60077771257914,342.45922953308775,334.74232589207054,45952,85043.93333333333,33.836272961424754,31.64346612131946,NaN,NaN,NaN,NaN,0.8038315886872686,39.99253668911492,93022967,0.13757797610419886,-1.014189704263572,-1.1517676803677708
2025-08-29T13:55:00-04:00,333.81,333.97,333.35,333.56,NaN,NaN,NaN,335.9726280251862,NaN,NaN,336.9076799999994,342.22825257753635,331.58710742246245,332.58108280676674,338.5526096771497,342.4231077330535,334.6821116212459,53426,84285.23333333334,31.690194260962002,31.61745670972101,NaN,NaN,NaN,NaN,0.7907007609238926,39.86099475799702,92969541,0.1295180845781163,-0.9898700746451254,-1.1193881592232418
2025-08-29T14:00:00-04:00,333.55,333.59,332.99,333.33,NaN,NaN,NaN,335.8387111566355,NaN,NaN,336.6794799999994,341.60051202599493,331.75844797400384,332.58108280676674,338.4842251383342,342.3752259704667,334.59322430620165,72822,81536.76666666666,30.1132649197676,31.256342954620695,NaN,NaN,NaN,NaN,0.777079278000755,40.07685442913685,92896719,0.11320393420076602,-0.9778832414722842,-1.0910871756730502
2025-08-29T14:05:00-04:00,333.35,333.99,333.27,333.89,NaN,NaN,NaN,335.8387111566355,NaN,NaN,336.4884799999993,341.0750645289405,331.9018954710581,332.58108280676674,338.4541555351242,342.35118679912915,334.5571242711192,35480,76419.63333333333,38.17939888299643,31.52277277414542,NaN,NaN,NaN,NaN,0.7730021867149889,39.421302972305206,92932199,0.14272932875872835,-0.9126755147246399,-1.0554048434833683
2025-08-29T14:10:00-04:00,333.79,333.95,333.43,333.71,NaN,NaN,NaN,335.8387111566355,NaN,NaN,336.32007999999934,340.6783800879913,331.9617799120074,332.58108280676674,338.4168389124304,342.32117899267405,334.5124988321868,44473,72263.8,36.71265062370739,32.30944950175013,NaN,NaN,NaN,NaN,0.7549306019496312,38.812576619532955,92887726,0.15188791181495453,-0.8655449537146751,-1.0174328655296296
2025-08-29T14:15:00-04:00,333.68,333.73,333.26,333.46,NaN,NaN,NaN,335.8387111566355,NaN,NaN,336.1800799999994,340.44618703767026,331.91397296232856,332.58108280676674,338.38551429345694,342.2971177416365,334.4739108452774,36230,69681.03333333334,34.717710959616866,32.70148005127506,NaN,NaN,NaN,NaN,0.7345784160960881,38.44327761166313,92851496,0.1429874441929101,-0.838698560288492,-0.9816860044814021
2025-08-29T14:20:00-04:00,333.45,333.51,332.77,332.92,NaN,NaN,NaN,335.56804698472456,NaN,NaN,336.05147999999934,340.31526889264245,331.78769110735624,332.58108280676674,338.31088862468874,342.2450112297882,334.3767660195893,81198,67853.56666666667,30.821788581101913,33.105914261714915,NaN,NaN,NaN,NaN,0.7349656720892253,38.62036381967556,92770298,0.10440147087193619,-0.8511841658914818,-0.955585636763418
2025-08-29T14:25:00-04:00,332.89,333.1,332.46,332.68,NaN,NaN,NaN,335.1849539399643,NaN,NaN,335.9464799999994,340.2780892761146,331.61487072388417,332.58108280676674,338.2385617930521,342.19751989837744,334.27960368772676,76217,67917.13333333333,29.25071040529535,33.349501385506635,NaN,NaN,NaN,NaN,0.7281824097971408,39.07828492816566,92694081,0.06813928523942103,-0.8704115302141417,-0.9385508154535628
2025-08-29T14:30:00-04:00,332.7,333.04,332.62,332.92,NaN,NaN,NaN,335.1829105790569,NaN,NaN,335.82767999999936,340.15896892514115,331.49639107485757,332.58108280676674,338.1806395416418,342.1571637637192,334.20411531956444,63832,67198.23333333334,32.93232154618717,33.405063769354925,NaN,NaN,NaN,NaN,0.7061693805259176,39.50349738604931,92757913,0.0657117038203261,-0.8564111856781551,-0.9221228894984812
2025-08-29T14:35:00-04:00,332.93,333.02,332.2,332.361,NaN,NaN,NaN,334.9677782800089,NaN,NaN,335.6808999999994,339.97458453924855,331.3872154607502,332.5498662454134,338.1230750346132,342.119808350781,334.12634171844536,60972,66906,29.1300563333119,33.225396063130816,NaN,NaN,NaN,NaN,0.7143001390597802,40.28514336293876,92696941,0.033478171010926316,-0.8802751757348233,-0.9137533467457496
2025-08-29T14:40:00-04:00,332.4,332.48,331.94,332.16,NaN,NaN,NaN,334.53424290364484,NaN,NaN,335.5398999999994,339.82377419544594,331.2560258045529,332.35080921412134,338.0434816780168,342.07152053203805,334.01544282399556,81473,66137.06666666667,27.883433045459157,32.803487952682175,NaN,NaN,NaN,NaN,0.7018501291269402,41.22909698352545,92615468,0.00702300048360438,-0.9049745961412441,-0.9119975966248485
2025-08-29T14:45:00-04:00,332.15,332.4,331.85,331.95,NaN,NaN,NaN,334.41859549893366,NaN,NaN,335.3840999999995,339.61188983894016,331.1563101610588,332.35080921412134,337.9682804813201,342.0259594717421,333.9106014908981,77344,66180.4,26.602506038957074,32.26498680823144,NaN,NaN,NaN,NaN,0.6910036913321556,42.180218298259625,92538124,-0.015013946569679693,-0.9307650298369481,-0.9157510832672684
2025-08-29T14:50:00-04:00,331.96,332.27,331.71,331.74,NaN,NaN,NaN,334.2557047944367,NaN,NaN,335.24649999999946,339.49186749437115,331.00113250562777,332.35080921412134,337.9004719464981,341.98544515648234,333.81549873651386,69543,66466.83333333333,25.348457466206057,31.566292523621915,NaN,NaN,NaN,NaN,0.6816462848084303,43.18112607657119,92468581,-0.033092203744569226,-0.9571163379479799,-0.9240241342034107
2025-08-29T14:55:00-04:00,331.77,332.5,331.74,332.5,NaN,NaN,NaN,334.2557047944367,NaN,NaN,335.12349999999947,339.32342680438694,330.923573195612,332.35080921412134,337.84733344939036,341.94950126030886,333.74516563847186,58983,66874,36.935120095821624,31.725277580058226,NaN,NaN,NaN,NaN,0.6872429787506845,43.43799208174614,92527564,0.014237019047087296,-0.9062278603945515,-0.9204648794416388
2025-08-29T15:00:00-04:00,332.48,332.77,332.4,332.465,NaN,NaN,NaN,334.2557047944367,NaN,NaN,335.00219999999945,339.151609693234,330.8527903067649,332.2156473712971,337.79054281532626,341.90702730238786,333.67405832826466,67943,67667.5,36.65297794244625,31.926470792988336,NaN,NaN,NaN,NaN,0.6645827659827788,42.93409921814742,92459621,0.049313815280459194,-0.8588226103410648,-0.908136425621524
2025-08-29T15:05:00-04:00,332.48,332.57,331.9,332.18,NaN,NaN,NaN,334.2557047944367,NaN,NaN,334.88219999999944,339.0040094087816,330.7603905912173,331.92851789703764,337.7241852451134,341.8605088323985,333.5878616578283,76431,68392.23333333334,34.351853352683705,32.11658929953988,NaN,NaN,NaN,NaN,0.6649697112697243,43.028509132220435,92383190,0.058805432181216144,-0.8346296353950038,-0.8934350675762199
2025-08-29T15:10:00-04:00,332.17,332.4,331.96,332.3,NaN,NaN,NaN,334.2557047944367,NaN,NaN,334.75629999999944,338.80062187175145,330.71197812824744,331.5618514541041,337.6742156104741,341.82468458397426,333.52374663697395,58818,68616.5,36.16897399697807,32.54913994791206,NaN,NaN,NaN,NaN,0.6489004461790294,43.11617548100252,92442008,0.07747531247260864,-0.7965909269854592,-0.8740662394580678
2025-08-29T15:15:00-04:00,332.3,332.48,332.15,332.39,NaN,NaN,NaN,334.2557047944367,NaN,NaN,334.6164999999994,338.4915516335083,330.7414483664905,331.5618514541041,337.629690148922,341.7911955770871,333.46818472075694,54535,68181.5,37.56481717135499,32.505241254223385,NaN,NaN,NaN,NaN,0.6261218428805302,42.96628334970977,92496543,0.09882813264604895,-0.7505310736505066,-0.8493592062965556
2025-08-29T15:20:00-04:00,332.41,332.58,332.2,332.21,NaN,NaN,NaN,334.2557047944367,NaN,NaN,334.4770999999995,338.18325063403734,330.77094936596166,331.42748116328323,337.56933656587273,341.7451142183071,333.39355891343837,75260,68810.3,35.875105262030615,32.445416585532186,NaN,NaN,NaN,NaN,0.6085417112462063,42.53165378055455,92421283,0.10328719890706073,-0.7202502076627297,-0.8235374065697905
2025-08-29T15:25:00-04:00,332.21,332.43,331.88,332.13,NaN,NaN,NaN,334.2028655741997,NaN,NaN,334.3418999999995,337.88382768448946,330.79997231550954,331.3552708567386,337.4870851896884,341.68373725153367,333.29043312784313,101784,70067.4,35.119011194811165,32.47408088804606,NaN,NaN,NaN,NaN,0.6043601604429066,42.54194911437664,92319499,0.10307018984311134,-0.6946996692659013,-0.7977698591090127
2025-08-29T15:30:00-04:00,332.14,332.97,332.12,332.85,NaN,NaN,NaN,334.2028655741997,NaN,NaN,334.21349999999956,337.48679698652876,330.94020301347035,331.5411733483128,337.4190456773963,341.6248793333303,333.2132120214623,95670,67960.66666666667,46.124327798866695,33.56711940360069,NaN,NaN,NaN,NaN,0.6219058632684149,41.09441136617365,92415169,0.1507528965723982,-0.6093287383935149,-0.7600816349659131
2025-08-29T15:35:00-04:00,332.86,333.02,332.29,332.89,NaN,NaN,NaN,334.2028655741997,NaN,NaN,334.0926999999995,337.0954662250172,331.08993377498183,331.5411733483128,337.34919153148115,341.56200141640795,333.13638164655436,103000,69054.16666666667,46.66558636658044,34.811039115121055,NaN,NaN,NaN,NaN,0.6296268730349539,39.627498668647156,92518169,0.18221900316899486,-0.5323078810046695,-0.7145268841736644
2025-08-29T15:40:00-04:00,332.92,333.25,332.63,333.14,NaN,NaN,NaN,334.2028655741997,NaN,NaN,334.0104999999995,336.88534002373785,331.1356599762612,331.73355094292015,337.2912814347815,341.5054495350263,333.07711333453676,93382,68362.7,50.043647495739926,36.03327668294625,NaN,NaN,NaN,NaN,0.6289392392467432,37.70476516543741,92611551,0.21485774910147426,-0.4459546977968216,-0.6608124468982959
2025-08-29T15:45:00-04:00,333.14,333.85,333.14,333.53,NaN,NaN,NaN,334.2028655741997,NaN,NaN,333.9632999999995,336.790252882906,331.136347117093,332.28184075433614,337.2442804333557,341.45312033417434,333.03544053253705,88057,67443.86666666667,54.84811386886881,37.87028079262888,NaN,NaN,NaN,NaN,0.6347292935862642,35.34851251308246,92699608,0.25496527432012905,-0.34210585399813453,-0.5970711283182636
2025-08-29T15:50:00-04:00,333.71,334.48,332.8,333.2,331.43577732956976,331.43577732956976,331.43577732956976,NaN,NaN,NaN,333.9216999999995,336.7310868730199,331.1123131269791,332.3854726034689,337.153943382616,341.35137040503275,332.9565163601992,174981,70715.66666666667,50.42868548621179,39.480655966968364,NaN,NaN,NaN,NaN,0.7093914869015315,34.17338718390433,92524627,0.25112174757147254,-0.2831689438539229,-0.5342906914253954
2025-08-29T15:55:00-04:00,333.19,334.37,333.09,333.86,331.45142381458936,NaN,NaN,NaN,NaN,NaN,333.8912999999995,336.6696324858992,331.11296751409975,332.3854726034689,337.0925375919379,341.27609940428835,332.9089757795875,134413,73515.1,57.75944104599042,41.7061513246136,NaN,NaN,NaN,NaN,0.7501492378371386,33.082199378238926,92659040,0.2825391668665005,-0.1811167328422698,-0.4636558997087703
2025-09-02T09:30:00-04:00,328.24,328.88,325.59,327.96,NaN,NaN,NaN,330.53773181334657,330.53773181334657,330.53773181334657,333.7374999999995,336.92991243610754,330.54508756389146,332.3854726034689,327.4766666666667,327.4766666666667,327.4766666666667,220393,79185.5,23.831340894701427,41.597785855220415,NaN,NaN,NaN,NaN,1.2872814351344886,35.0818121997002,92438647,-0.08487732756762972,-0.5697525591683075,-0.48487523160067775
2025-09-02T09:35:00-04:00,327.96,330.7,327.87,329.83,325.7464832690783,325.7464832690783,325.7464832690783,NaN,NaN,NaN,333.6200999999995,336.9442146373266,330.29598536267247,332.3854726034689,328.4153119793652,329.4087147925399,327.42190916619046,196766,83984,36.552467497074964,41.57045352673851,NaN,NaN,NaN,NaN,1.3974756183391668,35.218511417450856,92635413,-0.18695791220336933,-0.7185726218548893,-0.53161470965152
2025-09-02T09:40:00-04:00,329.8,331.7,329.72,331.11,327.0623249386657,NaN,NaN,NaN,NaN,NaN,333.5282999999996,336.87105314701915,330.18554685298005,332.3854726034689,329.0516275996752,330.418490535828,327.6847646635224,148152,87246.5,43.507413610899434,42.06005607448516,NaN,NaN,NaN,NaN,1.439084502743509,34.55016049585605,92783565,-0.15460616281426454,-0.7248724131693507,-0.5702662503550862
2025-09-02T09:45:00-04:00,331.11,332.41,330.84,332.12,327.92903744145354,NaN,NaN,NaN,NaN,NaN,333.45669999999956,336.76348916807365,330.14991083192547,332.3854726034689,329.5490734800232,331.17500725849806,327.92313970154834,125489,89100.63333333333,48.3212073623419,43.05786707517503,NaN,NaN,NaN,NaN,1.4484356096904047,33.403567738019504,92909054,-0.056569153519367865,-0.640977692254296,-0.5844085387349282
2025-09-02T09:50:00-04:00,332.1,332.77,331.5,332.43,328.4338539213875,NaN,NaN,NaN,NaN,NaN,333.3746999999995,336.57418023938146,330.17521976061755,332.3854726034689,329.93112993312144,331.7050956699886,328.15716419625426,114640,91390.23333333334,49.73690418737526,44.02700494591769,NaN,NaN,NaN,NaN,1.4356902089982317,32.076839761640386,93023694,0.032955409995117924,-0.5432142762410308,-0.5761696862361487
2025-09-02T09:55:00-04:00,332.5,332.66,331.37,332.06,328.4338539213875,NaN,NaN,NaN,NaN,NaN,333.2874999999995,336.3863102817406,330.18868971825844,332.3854726034689,330.11577654026445,331.91120356907226,328.32034951145664,77693,92199.13333333333,48.0451691665484,44.77560151700294,NaN,NaN,NaN,NaN,1.4252837654983597,30.917249352494853,92946001,0.06898038841459864,-0.48994420071790046,-0.5589245891324991
2025-09-02T10:00:00-04:00,332.02,333.32,330.94,331.05,328.4338539213875,NaN,NaN,NaN,NaN,NaN,333.1860999999995,336.23899458093064,330.13320541906836,332.3854726034689,330.32447384400245,332.0904156897549,328.55853199825003,127502,94021.8,43.67781120004711,45.33293765543268,NaN,NaN,NaN,NaN,1.4934777822484764,29.335170389164674,92818499,0.02858384935669611,-0.523194777436629,-0.5517786267933251
2025-09-02T10:05:00-04:00,331.12,332,330.42,331.29,328.4338539213875,NaN,NaN,NaN,NaN,NaN,333.09449999999947,336.09415884097416,330.0948411590248,332.3854726034689,330.3790757014931,332.10496882603206,328.6531825769541,64346,94984,44.95818379561881,46.03573569834752,NaN,NaN,NaN,NaN,1.4996579406592985,28.187127264742738,92882845,0.022112368401829285,-0.5241381662910385,-0.5462505346928678
2025-09-02T10:10:00-04:00,331.26,332.17,330.9,331.46,328.4338539213875,NaN,NaN,NaN,NaN,NaN,333.0040999999994,335.9217879412304,330.0864120587685,332.0543780827751,330.4358507392355,332.1358960029985,328.7358054754725,56819,95395.53333333334,45.896405188013226,46.019455511857984,NaN,NaN,NaN,NaN,1.48325380204078,26.983160609595817,92939664,0.03272606732592276,-0.5053429505354643,-0.5380690178613871
2025-09-02T10:15:00-04:00,331.48,333.25,331.14,331.93,328.4338539213875,NaN,NaN,NaN,NaN,NaN,332.9174999999995,335.6972714226584,330.1377285773406,328.6454241902104,330.54042420131304,332.2354320454106,328.84541635721547,75567,96706.76666666666,48.509603856966145,46.15117104688553,NaN,NaN,NaN,NaN,1.5280213876092965,25.07705806706421,93015231,0.07256274818531516,-0.44736558262974313,-0.5199283308150583
2025-09-02T10:20:00-04:00,331.94,332.67,331.43,331.69,328.4338539213875,NaN,NaN,NaN,NaN,NaN,332.83711999999946,335.5201086516135,330.1541313483854,328.6454241902104,330.59814219106823,332.2805771820176,328.91570720011885,52323,95744.26666666666,47.25447781149217,45.95194464086784,NaN,NaN,NaN,NaN,1.5074484313514902,23.30710570614201,92962908,0.08315159684935558,-0.4159888347533638,-0.49914043160271937
2025-09-02T10:25:00-04:00,331.62,332.86,331.3,332.77,328.4338539213875,NaN,NaN,NaN,NaN,NaN,332.7839199999995,335.36260676200726,330.20523323799176,328.6454241902104,330.67430636317533,332.35633785213827,328.9922748742124,58656,95158.9,53.13126594547973,45.82931264634005,NaN,NaN,NaN,NaN,1.511202114826384,21.81219036479631,93021564,0.15890318290399313,-0.30051145297272797,-0.4594146358767211
2025-09-02T10:30:00-04:00,332.76,332.79,331.58,331.62,328.4338539213875,NaN,NaN,NaN,NaN,NaN,332.7025199999995,335.16338860287766,330.2416513971213,328.80665718538773,330.7206033039643,332.3907093043272,329.05049730360145,47831,94625.53333333334,47.11198506216843,45.5924054731941,NaN,NaN,NaN,NaN,1.4896876780530732,20.42405469068959,92973733,0.12885092421851874,-0.2983509806035727,-0.4272019048220914
2025-09-02T10:35:00-04:00,331.64,332.53,331.5,332.44,328.4338539213875,NaN,NaN,NaN,NaN,NaN,332.6397199999995,334.9598969261522,330.3195430738468,328.82832574831014,330.76962177974417,332.4315594128996,329.1076841465887,48281,94202.5,51.34475626348635,45.134213703015234,NaN,NaN,NaN,NaN,1.4568528439064232,19.061305119125457,93022014,0.1594853748709797,-0.2278451862333668,-0.3873305611043465
2025-09-02T10:40:00-04:00,332.41,332.55,330.85,330.945,328.4338539213875,NaN,NaN,NaN,NaN,NaN,332.58101999999946,334.9211355357732,330.2409044642257,328.82832574831014,330.80123907168013,332.4302966403657,329.17218150299453,69111,93790.43333333333,44.3722210204786,46.601419426285034,NaN,NaN,NaN,NaN,1.4742204979131066,18.19079501942695,92952903,0.07844977954745003,-0.28926833667003393,-0.36771811621748396
2025-09-02T10:45:00-04:00,331,331.23,330.5,330.87,328.4338539213875,NaN,NaN,NaN,NaN,NaN,332.51461999999947,334.85675720878555,330.1724827912134,328.82832574831014,330.8038618498753,332.3999852730002,329.20773842675044,61955,93277.46666666666,44.04904740528204,47.1368894197284,NaN,NaN,NaN,NaN,1.4210618909193147,17.68125978850064,92890948,0.022111862331037735,-0.3400782883036868,-0.36219015063472454
2025-09-02T10:50:00-04:00,330.8,331.64,330.71,331.46,328.4338539213875,NaN,NaN,NaN,NaN,NaN,332.4796199999995,334.8314278800518,330.1278121199472,328.82832574831014,330.8141286044928,332.39405861992395,329.23419858906163,34807,92119.6,47.30070611830914,47.407838884543374,NaN,NaN,NaN,NaN,1.3859860415679355,16.78270441737936,92925755,0.02659564702485706,-0.32894559185365324,-0.3555412388785103
2025-09-02T10:55:00-04:00,331.43,331.46,330.3,330.76,328.4338539213875,NaN,NaN,NaN,NaN,NaN,332.4294199999994,334.81845987761454,330.0403801223843,328.82832574831014,330.8148511174139,332.37256932041714,329.2571329144107,45402,91666.9,44.03115409305992,47.101406508166086,NaN,NaN,NaN,NaN,1.3698441814559377,16.318437297520376,92880353,-0.013419154422995017,-0.3723151819072541,-0.3588960274842591
2025-09-02T11:00:00-04:00,330.74,331.31,329.76,329.81,328.4338539213875,NaN,NaN,NaN,NaN,NaN,332.3488199999995,334.81281190596354,329.8848280940354,328.82832574831014,330.790841050578,332.3161995741037,329.26548252705237,78459,92017.43333333333,39.991040460172385,46.405273384794455,NaN,NaN,NaN,NaN,1.3827124542090858,16.347950309749667,92801894,-0.09515099655746218,-0.4778347731810868,-0.3826837766236246
2025-09-02T11:05:00-04:00,329.83,329.9,328.82,329.589,328.4338539213875,NaN,NaN,NaN,NaN,NaN,332.2657999999995,334.8149537423818,329.7166462576172,328.82832574831014,330.7358576897144,332.2536596024602,329.21805577696864,72105,91873.23333333334,39.09241369582277,45.7657908511712,NaN,NaN,NaN,NaN,1.361090136051293,17.08161873596783,92729789,-0.15200580808943692,-0.5726910367354208,-0.42068522864598384
2025-09-02T11:10:00-04:00,329.62,329.98,328.94,329.13,328.4338539213875,NaN,NaN,NaN,NaN,NaN,332.1697999999995,334.82053861448054,329.51906138551846,328.82832574831014,330.6924924573147,332.2057187328459,329.1792661817835,57378,91825.23333333334,37.2216564442838,45.304636940045256,NaN,NaN,NaN,NaN,1.3381551263333449,17.66551066312754,92672411,-0.20512990762368505,-0.6770976131755901,-0.4719677055519051
2025-09-02T11:15:00-04:00,329.15,329.3,328.16,328.33,NaN,NaN,NaN,332.548670007195,332.548670007195,332.548670007195,332.0571999999995,334.86768750258545,329.24671249741357,328.82832574831014,330.6163796212938,332.15274566153016,329.0800135810574,69102,92310.8,34.153858766902374,44.53289943799407,NaN,NaN,NaN,NaN,1.324001188738105,18.74992769595,92603309,-0.27442510688150534,-0.8149990891537868,-0.5405739822722815
2025-09-02T11:20:00-04:00,328.36,328.73,327.9,328.46,NaN,NaN,NaN,332.0732759159589,NaN,NaN,331.94559999999944,334.8730032729333,329.0181967270656,328.82832574831014,330.5206224018574,332.09118785832095,328.95005694539384,84460,92617.46666666666,35.09008351505882,43.76101931849733,NaN,NaN,NaN,NaN,1.288715389542529,19.925613051886973,92687769,-0.29024757163034276,-0.90338344681021,-0.6131358751798672
2025-09-02T11:25:00-04:00,328.5,328.82,328.13,328.42,NaN,NaN,NaN,332.0732759159589,NaN,NaN,331.8343999999995,334.8648313096004,328.8039686903986,328.73866059864815,330.4707704109426,332.05428037214506,328.8872604497401,49187,90864.23333333334,34.92553492067256,42.79072868019064,NaN,NaN,NaN,NaN,1.2459500045752052,20.89231690338501,92638582,-0.28191239250258826,-0.9655263658081026,-0.6836139733055143
2025-09-02T11:30:00-04:00,328.35,328.48,327.88,328.26,NaN,NaN,NaN,331.7760117333427,NaN,NaN,331.72239999999954,334.85723657023135,328.5875634297677,328.4437427831348,330.4272073702165,332.02595408671215,328.8284606537208,39951,89006.93333333333,34.23400315236768,41.86069477596747,NaN,NaN,NaN,NaN,1.1998107185341207,21.967139115737734,92598631,-0.26588819835805944,-1.0159742212530887,-0.7500860228950292
2025-09-02T11:35:00-04:00,328.22,328.38,327.47,327.62,NaN,NaN,NaN,331.4816475636453,NaN,NaN,331.6035999999995,334.8970752955201,328.31012470447894,328.4437427831348,330.3336776621337,331.97653281626975,328.69082250799767,77361,88152.3,31.543556402466123,40.31871552289506,NaN,NaN,NaN,NaN,1.1791099529245384,23.24782413388453,92521270,-0.27591115894254314,-1.0949749715732082,-0.8190638126306651
2025-09-02T11:40:00-04:00,327.67,327.89,327.4,327.61,NaN,NaN,NaN,331.106799947116,NaN,NaN,331.48919999999947,334.928982086443,328.04941791355594,328.32299422650783,330.26887145406744,331.94368457518203,328.59405833295284,52959,86804.86666666667,31.50189746992335,39.20370926630613,NaN,NaN,NaN,NaN,1.129887813429929,24.48524103254924,92468311,-0.2609005657904915,-1.1451895198687794,-0.8842889540782879
2025-09-02T11:45:00-04:00,327.57,327.96,327.42,327.65,NaN,NaN,NaN,331.0680817677016,NaN,NaN,331.3643999999994,334.8982152077296,327.83058479226924,328.0253953812063,330.2321699569079,331.92305004218315,328.54128987163267,31692,84926.03333333334,31.88938431376684,37.814039841326164,NaN,NaN,NaN,NaN,1.0877529696135029,25.514294741484893,92500003,-0.22720077787865756,-1.1682899264266098,-0.9410891485479522
2025-09-02T11:50:00-04:00,327.58,327.58,327.04,327.41,NaN,NaN,NaN,330.61771441462423,NaN,NaN,331.23839999999944,334.876418845797,327.6003811542019,326.92585304397204,330.17356594810076,331.8960461880349,328.4510857081666,46349,80638.3,30.764858882390243,36.84208540289128,NaN,NaN,NaN,NaN,1.0536277574982496,26.75484216053424,92453654,-0.20090467266806533,-1.1922199893830339,-0.9913153167149685
2025-09-02T11:55:00-04:00,327.39,328.48,327.29,328.47,NaN,NaN,NaN,330.61771441462423,NaN,NaN,331.1385999999994,334.8010614021694,327.47613859782945,326.92585304397204,330.11044858173034,331.84412869245864,328.37676847100204,71022,78525.26666666666,40.70946964302207,36.603544134158426,NaN,NaN,NaN,NaN,1.06336863196266,26.44976104723081,92524676,-0.09720667227803026,-1.1128236570625063,-1.015616984784476
2025-09-02T12:00:00-04:00,328.43,329.34,328.43,329.17,NaN,NaN,NaN,330.61771441462423,NaN,NaN,331.0635999999995,334.730653793192,327.396546206807,327.20105257230705,330.07638998195915,331.7946544919963,328.358125471922,73180,73618.16666666667,46.2046597820727,36.525255110141536,NaN,NaN,NaN,NaN,1.0524137296796108,25.04580462904102,92597856,0.026816510648055347,-0.9820963464744068,-1.0089128571224621
2025-09-02T12:05:00-04:00,329.21,329.75,328.79,328.79,NaN,NaN,NaN,330.61771441462423,NaN,NaN,330.9857999999994,334.6773569618163,327.2942430381825,327.55884205784565,330.0548196157529,331.7597867923782,328.3498524391276,55453,68907.73333333334,43.8298044353284,36.51087299173214,NaN,NaN,NaN,NaN,1.0458127489882085,23.2714190000449,92542403,0.0880934268605712,-0.8987960735467482,-0.9868895004073194
2025-09-02T12:10:00-04:00,328.85,329.73,328.85,329.35,NaN,NaN,NaN,330.61771441462423,NaN,NaN,330.91439999999943,334.5916242143159,327.23717578568295,327.55884205784565,330.04080876896353,331.7326923954742,328.34892514245286,47630,65557,48.06614674499626,37.08766629779099,NaN,NaN,NaN,NaN,1.0382546954890506,21.623775201691366,92590033,0.16661778274039185,-0.7786172719818296,-0.9452350547222215
2025-09-02T12:15:00-04:00,329.41,329.86,329.41,329.69,NaN,NaN,NaN,330.61771441462423,NaN,NaN,330.8609799999994,334.530187467659,327.1917725323398,327.82665891702123,330.03549656300964,331.7163464898753,328.35464663614397,35196,62547.23333333333,50.50680071506567,37.90297965630834,NaN,NaN,NaN,NaN,1.000522217239832,20.223429381902072,92625229,0.2374164815046269,-0.6484644528414378,-0.8858809343460647
2025-09-02T12:20:00-04:00,329.68,329.83,329.24,329.46,NaN,NaN,NaN,330.61771441462423,NaN,NaN,330.80697999999944,334.4775988579977,327.1363611420012,327.908327133617,330.0312104918696,331.7058588067693,328.35656217696993,21111,59429.6,48.83486618039638,38.73249463745925,NaN,NaN,NaN,NaN,0.9711992017226994,18.855489250635014,92604118,0.2627443147193411,-0.5574505409468884,-0.8201948556662295
2025-09-02T12:25:00-04:00,329.42,329.53,329.07,329.24,NaN,NaN,NaN,330.61771441462423,NaN,NaN,330.75277999999946,334.4343023439111,327.0712576560878,327.908327133617,330.0256502247827,331.69533139102293,328.3559690585424,19301,57483.2,47.224529889721545,39.6661140033749,NaN,NaN,NaN,NaN,0.9346849730282194,17.80855259798226,92584817,0.25828349265249195,-0.49734048985061463,-0.7556239825031066
2025-09-02T12:30:00-04:00,329.24,329.53,328.84,328.86,NaN,NaN,NaN,330.61771441462423,NaN,NaN,330.6951799999995,334.4031412663249,326.98721873367407,327.908327133617,330.0176739809734,331.682579094519,328.35276886742787,22103,53969.9,44.49526330152856,40.337912559551306,NaN,NaN,NaN,NaN,0.9172074749547751,17.137590578832253,92562714,0.22458605568523082,-0.474891412896568,-0.6994774685817988
2025-09-02T12:35:00-04:00,328.91,329.41,328.89,329.06,NaN,NaN,NaN,330.61771441462423,NaN,NaN,330.62637999999953,334.3254823322479,326.9272776677512,327.908327133617,330.00814019217484,331.66673513598187,328.3495452483678,28229,52766,46.25578397722741,41.14721606359094,NaN,NaN,NaN,NaN,0.8909783696008634,16.51455441819296,92590943,0.21083251819819238,-0.4359368208340584,-0.6467693390322508
2025-09-02T12:40:00-04:00,329.1,329.63,328.83,328.94,NaN,NaN,NaN,330.61771441462423,NaN,NaN,330.55587999999955,334.2464823064552,326.8652776935439,327.908327133617,329.99884218525983,331.6510364760976,328.34664789442206,28554,51823.833333333336,45.326812884850284,41.93955961591113,NaN,NaN,NaN,NaN,0.8844799146293739,15.575506551448616,92562389,0.18939823131187594,-0.4100215498924058,-0.5994197812042817
2025-09-02T12:45:00-04:00,328.96,329.23,328.45,328.7,NaN,NaN,NaN,330.61771441462423,NaN,NaN,330.48627999999945,334.1829935037265,326.7895664962724,327.908327133617,329.98914929747207,331.6382061115386,328.34009248340556,21776,50030.8,43.44743142075537,42.78983640293178,NaN,NaN,NaN,NaN,0.8770170635844208,15.253620141457592,92540613,0.15618362370145666,-0.4041902515774609,-0.5603738752789176
2025-09-02T12:50:00-04:00,328.68,329.44,328.65,329.19,NaN,NaN,NaN,330.61771441462423,NaN,NaN,330.42407999999944,334.1012360065768,326.74692399342206,327.908327133617,329.97882307239917,331.62113403068366,328.33651211411467,31583,49339.46666666667,48.17231476394701,43.980580495362055,NaN,NaN,NaN,NaN,0.870801559042678,14.595474625113397,92572196,0.1635574244151069,-0.3559270947600339,-0.5194845191751408
2025-09-02T12:55:00-04:00,329.23,329.7,329.22,329.52,NaN,NaN,NaN,330.61771441462423,NaN,NaN,330.36667999999946,334.0087259624641,326.7246340375348,327.9856132704919,329.97398771987594,331.6090500009599,328.338925438792,26819,48278.23333333333,51.13341615276262,45.35515419814747,NaN,NaN,NaN,NaN,0.8450300191110575,13.553067578903258,92599015,0.18540109965479445,-0.2877331446066478,-0.47313424426144224
2025-09-02T13:00:00-04:00,329.46,329.94,329.27,329.7,NaN,NaN,NaN,330.61771441462423,NaN,NaN,330.31647999999944,333.9245472555639,326.708412744435,328.2334906163935,329.9694731031948,331.594019405116,328.3449268012736,37531,47934.9,52.72017374858666,46.923390974304354,NaN,NaN,NaN,NaN,0.8325278748888402,12.967514654074593,92636546,0.20517391418677355,-0.21666685152797527,-0.4218407657147488
2025-09-02T13:05:00-04:00,329.73,330.36,329.48,329.98,NaN,NaN,NaN,330.61771441462423,NaN,NaN,330.2734799999995,333.8451326203642,326.7018273796348,328.5547924931148,329.9691121578833,331.58368348539454,328.354540830372,34768,47484.46666666667,55.159336856428126,47.955524346690495,NaN,NaN,NaN,NaN,0.8359187409682084,13.043715982864196,92671314,0.22852636326446207,-0.13618281163417123,-0.3647091748986333
2025-09-02T13:10:00-04:00,329.94,329.98,328.85,328.94,NaN,NaN,NaN,330.61771441462423,NaN,NaN,330.19527999999946,333.7086001631223,326.6819598368766,328.5547924931148,329.9578188586133,331.56201232300543,328.3536253942211,45727,46705,45.723788055354454,47.92117636621062,NaN,NaN,NaN,NaN,0.8569245451847646,12.160479403983828,92625587,0.1681381099103515,-0.15453653751069396,-0.32267464742104546
2025-09-02T13:15:00-04:00,328.92,329.18,328.76,328.97,NaN,NaN,NaN,330.61771441462423,NaN,NaN,330.1168799999995,333.5604270004749,326.6733329995242,328.5547924931148,329.9494329415711,331.54937149348683,328.3494943896554,24699,45463.13333333333,46.010686722808856,48.076953672459226,NaN,NaN,NaN,NaN,0.8257156491001396,11.47840904713429,92650286,0.12633013814822192,-0.16476197473576804,-0.29109211288398995
2025-09-02T13:20:00-04:00,328.94,329.62,328.88,329.47,NaN,NaN,NaN,330.61771441462423,NaN,NaN,330.0434799999995,333.38096432815087,326.7059956718481,328.5547924931148,329.941512293769,331.53283760334716,328.3501869841908,37278,45545.5,50.68906831956121,48.26430521349958,NaN,NaN,NaN,NaN,0.8195931027358446,11.153233324057197,92687564,0.12806593994775062,-0.13100968794930168,-0.2590756278970523
2025-09-02T13:25:00-04:00,329.45,329.91,329.37,329.81,NaN,NaN,NaN,330.61771441462423,NaN,NaN,329.9690799999995,333.15475975423294,326.7834002457661,328.5547924931148,329.9388640398051,331.521762669129,328.3559654104812,32220,45106.1,53.63148785851108,48.48749715231711,NaN,NaN,NaN,NaN,0.7996221668261428,11.262737554973814,92719784,0.14650042744100739,-0.07595009359579308,-0.22245052103680046
2025-09-02T13:30:00-04:00,329.85,330.23,329.8,330.14,NaN,NaN,NaN,330.61771441462423,NaN,NaN,329.9078799999995,332.95760184049857,326.8581581595005,328.63172560414387,329.9399669013138,331.5154794491205,328.36445435350714,28152,43429.2,56.353738708724286,49.024559475769095,NaN,NaN,NaN,NaN,0.7732205834814189,11.791678203012058,92747936,0.1734628805775023,-0.0056219203149225905,-0.1790848008924249
2025-09-02T13:35:00-04:00,330.12,330.42,329.93,330.26,NaN,NaN,NaN,330.61771441462423,NaN,NaN,329.8358799999995,332.6714480532123,327.0003119467867,328.8963804833151,329.942686168999,331.51027008843255,328.37510224956543,31372,42071.433333333334,57.334655630049,49.746711314363914,NaN,NaN,NaN,NaN,0.7529905418041754,12.526640229267857,92779308,0.19056001462384917,0.059115217387386565,-0.1314447972364626
2025-09-02T13:40:00-04:00,330.19,330.63,329.92,330.44,327.76274241428854,327.76274241428854,327.76274241428854,NaN,NaN,NaN,329.8854799999995,332.6744382930534,327.0965217069456,329.05610438665207,329.946327749557,331.50697263120026,328.3856828679137,28839,41120.13333333333,58.82933819543222,50.770573806785606,NaN,NaN,NaN,NaN,0.7499197888181613,13.473894130347466,92808147,0.20397223277847787,0.12352049373663476,-0.08045173904184312
2025-09-02T13:45:00-04:00,330.47,330.47,329.65,329.81,327.76274241428854,NaN,NaN,NaN,NaN,NaN,329.8850799999995,332.67407574336545,327.09608425663356,329.05610438665207,329.94674938201393,331.4965159286164,328.39698283541145,43228,40257.666666666664,51.96725166059103,51.17853578416872,NaN,NaN,NaN,NaN,0.7549255181882962,13.798195863172197,92764919,0.16221452473236742,0.12231641687361616,-0.03989810785875127
2025-09-02T13:50:00-04:00,329.77,329.78,328.88,328.9,327.76274241428854,NaN,NaN,NaN,NaN,NaN,329.8408799999995,332.6208582345244,327.0609017654746,329.05610438665207,329.93973056626675,331.4840373017209,328.3954238308126,28991,38408.7,43.98613659061559,51.08277319172339,NaN,NaN,NaN,NaN,0.7674308383177041,12.87065966935656,92735928,0.0698277182364258,0.04738653993678099,-0.022441178299644815
2025-09-02T13:55:00-04:00,328.91,329.12,328.65,328.8,327.76274241428854,NaN,NaN,NaN,NaN,NaN,329.7744799999995,332.4914206692637,327.0575393307354,329.05610438665207,329.92764735835254,331.46752307182123,328.38777164488386,35421,37949.833333333336,43.200954373202336,51.065167688326746,NaN,NaN,NaN,NaN,0.74618577843787,12.355202939760542,92700507,0.002083798937031256,-0.019836429628355745,-0.021920228565387
2025-09-02T14:00:00-04:00,328.74,329.29,328.725,328.88,327.76274241428854,NaN,NaN,NaN,NaN,NaN,329.70347999999956,332.32292025324455,327.08403974675457,329.05610438665207,329.92101649963195,331.45764369094206,328.38438930832183,22021,37352.166666666664,44.061238976198105,50.771519417773256,NaN,NaN,NaN,NaN,0.7332439371208792,11.594310037596756,92722528,-0.03518075780055323,-0.06589617581607854,-0.03071541801552531
2025-09-02T14:05:00-04:00,328.85,328.87,327.99,328.14,327.76274241428854,NaN,NaN,NaN,NaN,NaN,329.6250799999995,332.1918257327111,327.05833426728793,329.05610438665207,329.89803979538937,331.43524624485804,328.3608333459207,46945,36338.3,38.28487256889772,49.85376630464004,NaN,NaN,NaN,NaN,0.7444407987551012,11.929118962657212,92675583,-0.10363827119398919,-0.1602632570080118,-0.056624985814022616
2025-09-02T14:10:00-04:00,328.15,328.5,328,328.19,327.76274241428854,NaN,NaN,NaN,NaN,NaN,329.5678799999995,332.13252830035844,327.00323169964054,329.05610438665207,329.8877937150894,331.4258036627658,328.349783767413,20049,35241.3,38.86803475333788,48.86432780497942,NaN,NaN,NaN,NaN,0.7269807417011653,12.240012964499062,92695632,-0.1374061025386844,-0.22838261398737814,-0.09097651144869373
2025-09-02T14:15:00-04:00,328.25,328.44,328,328.02,327.76274241428854,NaN,NaN,NaN,NaN,NaN,329.5024799999995,332.0548771243718,326.9500828756272,329.05610438665207,329.87611718475483,331.41548918883257,328.3367451806771,22122,34922.3,37.568218608947205,47.60781935873077,NaN,NaN,NaN,NaN,0.7064821172939391,12.528700251923638,92673510,-0.16138765744602268,-0.2927110832562221,-0.1313234258101994
2025-09-02T14:20:00-04:00,328.01,328.59,327.95,328.21,327.76274241428854,NaN,NaN,NaN,NaN,NaN,329.4374799999995,331.9524194983868,326.92254050161216,329.05610438665207,329.86756579276636,331.40738300720307,328.32774857832965,17372,33956.4,39.98393648910202,47.19782996114132,NaN,NaN,NaN,NaN,0.7017333946300852,12.494208269384668,92690882,-0.1546360170472285,-0.32461844711923504,-0.16998243007200653
2025-09-02T14:25:00-04:00,328.18,328.36,328.08,328.19,327.76274241428854,NaN,NaN,NaN,NaN,NaN,329.3626799999995,331.7978441736248,326.9275158263742,329.05610438665207,329.8583768954965,331.3988442650143,328.31790952597873,18415,32202.833333333332,39.80931957076721,46.75487516456691,NaN,NaN,NaN,NaN,0.6716095807279384,12.462179999884196,92672467,-0.1420246000169449,-0.34751318009318766,-0.20548858007624277
2025-09-02T14:30:00-04:00,328.2,328.44,327.88,328.13,327.76274241428854,NaN,NaN,NaN,NaN,NaN,329.2914799999995,331.65748788680725,326.9254721131918,328.80088350932164,329.842749561274,331.38475655193076,328.3007425706172,30667,30785.733333333334,39.255451052772116,45.938188216939125,NaN,NaN,NaN,NaN,0.6636374678188002,12.767454165088818,92641800,-0.12863050359746295,-0.36627670957307146,-0.2376462059756085
2025-09-02T14:35:00-04:00,328.12,328.32,327.96,328.305,327.76274241428854,NaN,NaN,NaN,NaN,NaN,329.2021799999995,331.36457188687945,327.0397881131195,327.97970680745726,329.8266848746194,331.36967415324676,328.283695595992,33007,30037.533333333333,41.79890884138898,45.0930040014304,NaN,NaN,NaN,NaN,0.6419490772603155,13.050923032778822,92674807,-0.10015765363284523,-0.3628432730166651,-0.26268561938381985
2025-09-02T14:40:00-04:00,328.3,328.36,328.01,328.25,327.76274241428854,NaN,NaN,NaN,NaN,NaN,329.1347799999995,331.1993940289112,327.0701659710879,327.6673123567727,329.81737795510764,331.3607926796511,328.27396323056416,19562,29101.933333333334,41.21481861411113,44.01165256610089,NaN,NaN,NaN,NaN,0.6210955717417231,13.212267922932174,92655245,-0.07817611003993952,-0.3604057569337442,-0.2822296468938047
2025-09-02T14:45:00-04:00,328.24,328.94,328.08,328.61,327.76274241428854,NaN,NaN,NaN,NaN,NaN,329.0581799999995,330.89862397700705,327.2177360229919,327.6673123567727,329.80804382822043,331.34962795276795,328.2664597036729,25131,28766.433333333334,46.48598832384587,43.236747758514944,NaN,NaN,NaN,NaN,0.6381601737601724,12.494611898056318,92680376,-0.03475299070884619,-0.32567088527986243,-0.29091789457101624
2025-09-02T14:50:00-04:00,328.56,329.37,328.56,328.98,327.76274241428854,NaN,NaN,NaN,NaN,NaN,329.01887999999946,330.778635058126,327.2591249418729,327.85034868805786,329.79496520251587,331.3279959685582,328.26193443647355,54381,29875.433333333334,51.31763037556505,42.700197199953,NaN,NaN,NaN,NaN,0.6504344470630175,12.61266687584716,92734757,0.020550366967841793,-0.265229935861214,-0.2857803028290558
2025-09-02T14:55:00-04:00,328.99,329,328.38,328.59,327.76274241428854,NaN,NaN,NaN,NaN,NaN,328.9732799999995,330.65524428279537,327.2913157172036,327.85034868805786,329.7881330708224,331.3190830128053,328.25718312883953,21041,29933.433333333334,46.54709230068664,42.31304295995983,NaN,NaN,NaN,NaN,0.6482605579870879,12.325707611714867,92713716,0.03185267154255117,-0.24596446340086686,-0.27781713494341803
2025-09-02T15:00:00-04:00,328.52,329.15,328.43,329.13,327.76274241428854,NaN,NaN,NaN,NaN,NaN,328.92667999999946,330.45232097761954,327.4010390223794,327.85034868805786,329.7773751937285,331.30207623622397,328.25267415123307,43148,30634.933333333334,53.054507374199545,42.96078373021583,NaN,NaN,NaN,NaN,0.653384803845151,12.332321458119567,92756864,0.07426131166185929,-0.1849904953660939,-0.2592518070279532
2025-09-02T15:05:00-04:00,329.1,329.32,328.96,329.08,327.76274241428854,NaN,NaN,NaN,NaN,NaN,328.8930799999995,330.32697683608245,327.4591831639165,327.87553852828563,329.77187842861554,331.2913710967785,328.25238576045257,29924,30691.433333333334,52.418180820192575,43.61915704785799,NaN,NaN,NaN,NaN,0.6324287464276412,12.642304734081316,92726940,0.09612199107540564,-0.13909931818369614,-0.23522130925910179
2025-09-02T15:10:00-04:00,329.12,329.22,328.74,329.1,327.76274241428854,NaN,NaN,NaN,NaN,NaN,328.87887999999947,330.29005662418257,327.46770337581637,327.87553852828563,329.7660854165448,331.28114018400083,328.25103064908876,27787,30665.866666666665,52.66275209116773,44.23355084178439,NaN,NaN,NaN,NaN,0.6215409788256682,12.401804876383824,92754727,0.10820578886692739,-0.09996407317544254,-0.20816986204236992
2025-09-02T15:15:00-04:00,329.08,329.37,328.96,329.16,327.76274241428854,NaN,NaN,NaN,NaN,NaN,328.8702999999995,330.26926591885757,327.4713340811414,328.0485446581028,329.76070335840996,331.2700443271574,328.2513623896625,32493,31023.1,53.4360032623152,45.31577446274279,NaN,NaN,NaN,NaN,0.6064309089095508,12.466731449364184,92787220,0.11583425769175776,-0.06337703992767274,-0.1792112976194305
2025-09-02T15:20:00-04:00,329.12,329.48,328.97,329.11,327.76274241428854,NaN,NaN,NaN,NaN,NaN,328.8698999999995,330.26858007850126,327.4712199214978,328.1678357264822,329.75358945103835,331.25489258173144,328.25228632034526,45663,31492.433333333334,52.66397245062906,46.30119858397787,NaN,NaN,NaN,NaN,0.5995429868445823,12.73715508205338,92741557,0.11298636296902384,-0.03797834390815069,-0.15096470687717453
2025-09-02T15:25:00-04:00,329.06,329.34,328.91,329.3,327.76274241428854,NaN,NaN,NaN,NaN,NaN,328.8892999999995,330.28439140994976,327.4942085900492,328.1678357264822,329.74655092591354,331.23988808289454,328.25321376893254,46047,32133.366666666665,55.30646431271053,47.568216134246676,NaN,NaN,NaN,NaN,0.5874327734985371,12.825967229885379,92787604,0.1187800984230299,-0.0024895838483871557,-0.12126968227141706
2025-09-02T15:30:00-04:00,329.27,329.74,329.21,329.44,327.76274241428854,NaN,NaN,NaN,NaN,NaN,328.9088999999995,330.3068489125236,327.5109510874754,328.46321486494867,329.74326960263784,331.2282400670217,328.25829913825396,43730,32340,57.20230294085372,48.798099452228946,NaN,NaN,NaN,NaN,0.5833304325343579,13.664513294093231,92831334,0.12622491600759467,0.03651146273807626,-0.0897134532695184
2025-09-02T15:35:00-04:00,329.42,329.68,329.27,329.61,327.76274241428854,NaN,NaN,NaN,NaN,NaN,328.93269999999956,330.33704925923087,327.52835074076825,328.46321486494867,329.7416865484972,331.22150176701956,328.2618713299749,26953,32079.5,59.45154666489958,50.201115673238405,NaN,NaN,NaN,NaN,0.5709496873533342,14.443163210857666,92858287,0.13594116804326353,0.080213006784561,-0.05572816125870252
2025-09-02T15:40:00-04:00,329.63,329.87,329.33,329.6,327.76274241428854,NaN,NaN,NaN,NaN,NaN,328.95949999999954,330.3626197390094,327.55638026098967,328.6188575135671,329.74007374145657,331.21151931108005,328.2686281718331,43769,32014.233333333334,59.25427189520966,51.62960287626966,NaN,NaN,NaN,NaN,0.568738995399526,15.508266407980667,92814518,0.1347747522936202,0.11274027910832274,-0.02203447318529747
2025-09-02T15:45:00-04:00,329.55,329.8,329.2,329.77,327.76274241428854,NaN,NaN,NaN,NaN,NaN,329.0024999999995,330.3701114222105,327.63488857778844,328.6188575135671,329.7384754800139,331.2021458125628,328.27480514746503,41391,32570.633333333335,61.5877905674189,53.04309442812894,NaN,NaN,NaN,NaN,0.5709719242995615,16.084387409963124,92855909,0.13802843721407265,0.15050107333229334,0.012472636118220692
2025-09-02T15:50:00-04:00,329.36,329.75,329.04,329.17,327.76274241428854,NaN,NaN,NaN,NaN,NaN,329.0336999999995,330.34274058077625,327.72465941922275,328.6188575135671,329.73182916208776,331.18477204773086,328.27888627644467,62723,33418.8,50.578024894166106,53.711894876704285,NaN,NaN,NaN,NaN,0.5823310725638757,16.12576985288097,92793186,0.09442779619466632,0.1305073813615536,0.03607958516688728
2025-09-02T15:55:00-04:00,329.17,329.55,328.94,329.34,327.76274241428854,NaN,NaN,NaN,NaN,NaN,329.0674999999995,330.31784115427354,327.81715884572543,328.6188575135671,329.71874999877036,331.15268304026836,328.28481695727237,116840,36239.46666666667,53.13437436641156,54.18677959403042,NaN,NaN,NaN,NaN,0.5843074245235998,15.861928927972603,92910026,0.07266977013540632,0.12691679783614518,0.05424702770073886
2025-09-03T09:30:00-04:00,335.12,335.15,330.77,331.02,330.33568980815414,NaN,NaN,NaN,NaN,NaN,329.1396999999995,330.4155125419028,327.8638874580962,331.1013320375571,332.31333333333333,332.31333333333333,332.31333333333333,252418,43715,69.77356257085734,55.50506046512272,NaN,NaN,NaN,NaN,0.9575711799147715,19.909508404646033,93162444,0.16194190690985186,0.2566744113380537,0.09473250442820183
2025-09-03T09:35:00-04:00,331.04,331.26,328.96,329.28,NaN,NaN,NaN,332.9286597285801,332.9286597285801,332.9286597285801,329.15589999999946,330.4177806449735,327.8940193550254,331.1013320375571,331.0669093237957,332.30689268340893,329.82692596418246,255047,51170.833333333336,49.98082764595681,55.75032727549916,NaN,NaN,NaN,NaN,1.053458952778003,21.291797541058404,92907397,0.09750029719210082,0.21660787591832786,0.11910757872622704
2025-09-03T09:40:00-04:00,329.2,330.44,328.51,330.27,NaN,NaN,NaN,332.4287206500083,NaN,NaN,329.1778999999995,330.4777801337291,327.87801986626994,331.1013320375571,330.69472925283105,331.9037063245188,329.4857521811433,197824,56803.666666666664,57.38749158392603,56.05982614762247,NaN,NaN,NaN,NaN,1.1160690275795746,22.087027962063964,93105221,0.11409202409191896,0.26172260884112575,0.1476305847492068
2025-09-03T09:45:00-04:00,330.28,330.47,329.12,330.4,NaN,NaN,NaN,332.4287206500083,NaN,NaN,329.21009999999944,330.5491242575236,327.8710757424753,331.1013320375571,330.6030498701435,331.7542480292072,329.45185171107977,106633,58917.166666666664,58.26150039880646,56.477206117523465,NaN,NaN,NaN,NaN,1.1327783827524638,22.842408484523745,93211854,0.12546088108183678,0.3044566861015028,0.178995805019666
2025-09-03T09:50:00-04:00,330.35,331.1,330.01,330.85,NaN,NaN,NaN,332.4287206500083,NaN,NaN,329.2400999999994,330.65536038675134,327.8248396132475,331.1013320375571,330.6081756485215,331.699227918984,329.51712337805907,92160,61022.8,61.22613803361751,57.08887654198417,NaN,NaN,NaN,NaN,1.1297227839844328,23.89775745329011,93304014,0.15309587182209836,0.37036564479728895,0.2172697729751906
2025-09-03T09:55:00-04:00,330.92,331.04,330.12,330.92,NaN,NaN,NaN,332.4287206500083,NaN,NaN,329.26469999999944,330.7513450962525,327.77805490374635,331.1013320375571,330.6154974155635,331.65886506610644,329.5721297650205,85044,62676.9,61.682077253109334,57.677881827040885,NaN,NaN,NaN,NaN,1.114742585128403,24.87772435285888,93389058,0.16487783947965995,0.42336707232476556,0.2584892328451056
2025-09-03T10:00:00-04:00,330.92,333.61,330.69,333.13,328.8843237495122,328.8843237495122,328.8843237495122,NaN,NaN,NaN,329.3380999999995,331.17678310538884,327.49941689461014,331.1013320375571,330.8924951251121,332.0610024121157,329.7239878381084,172952,67707.93333333333,72.62621697793286,59.10375643613402,NaN,NaN,NaN,NaN,1.2436895433335182,26.938352219575464,93562010,0.30229981980198933,0.6363640075975923,0.33406418779560293
2025-09-03T10:05:00-04:00,333.14,334.12,332.84,333.3,330.1882181245344,NaN,NaN,NaN,NaN,NaN,329.4192999999994,331.5662382949473,327.2723617050515,331.1013320375571,331.17064190948525,332.5274029341611,329.8138808848094,143698,70933.03333333334,73.25892005275037,60.38607470327973,NaN,NaN,NaN,NaN,1.2462831473811262,29.024657371401837,93705708,0.38038960209714917,0.8095511904170394,0.4291615883198902
2025-09-03T10:10:00-04:00,333.32,333.79,331.92,332.22,330.1882181245344,NaN,NaN,NaN,NaN,NaN,329.4864999999994,331.7654842040291,327.2075157959697,331.1013320375571,331.27944381400084,332.64076544696417,329.9181221810375,104166,73736.93333333333,63.25600855067026,60.81848224683806,NaN,NaN,NaN,NaN,1.2908343511396174,29.933250109422833,93601542,0.33655845207929014,0.8498596534190028,0.5133012013397127
2025-09-03T10:15:00-04:00,332.24,333.88,332.05,333.78,330.1882181245344,NaN,NaN,NaN,NaN,NaN,329.5808999999995,332.1535062197666,327.00829378023235,331.1013320375571,331.39359724939203,332.79199029361524,329.9952042051688,87327,75910.43333333333,69.69314006863337,61.55002463281904,NaN,NaN,NaN,NaN,1.329346183201072,30.81698626723299,93688869,0.386318872687595,0.9961997921992065,0.6098809195116115
2025-09-03T10:20:00-04:00,333.8,335.45,333.75,335.26,331.0346373075989,NaN,NaN,NaN,NaN,NaN,329.70729999999946,332.72420385031256,326.69039614968636,331.1577720261236,331.73581998873397,333.4138151084892,330.05782486897874,166138,80869.3,74.29420975378248,62.62430590843139,NaN,NaN,NaN,NaN,1.355821455829566,32.26855149865305,93855007,0.4861462411603602,1.2175637209620618,0.7314174798017016
2025-09-03T10:25:00-04:00,335.21,337.31,335.15,336.06,332.53215379361717,NaN,NaN,NaN,NaN,NaN,329.85449999999946,333.34196455208854,326.3670354479104,332.79621762089886,332.2727185685363,334.4102947864098,330.13514235066276,228959,87887.43333333333,76.38150129244234,63.680999531647345,NaN,NaN,NaN,NaN,1.4132627804131703,34.18677265332634,94083966,0.5676174499674554,1.440939292261021,0.8733218422935655
2025-09-03T10:30:00-04:00,336.05,337.58,336.02,337.49,333.05751043936175,NaN,NaN,NaN,NaN,NaN,330.02049999999946,334.10472930331497,325.93627069668395,333.1889740967191,332.661230666525,335.08886266552986,330.23359866752014,168287,92474.76666666666,79.57422559433569,65.75215672451661,NaN,NaN,NaN,NaN,1.4237440103836583,36.04070944879524,94252253,0.6722239313429994,1.7136017564723147,1.0413778251293153
2025-09-03T10:35:00-04:00,337.48,339.6,337.32,339.52,334.57671451029995,NaN,NaN,NaN,NaN,NaN,330.22049999999945,335.090831508441,325.3501684915579,334.9471792773753,333.2880593690195,336.2471686704654,330.3289500675736,233776,99167.06666666667,83.07245168994795,67.8905908190549,NaN,NaN,NaN,NaN,1.4849051524991133,38.23810940694503,94486029,0.8226059727261952,2.0696352910370592,1.247029318310864
2025-09-03T10:40:00-04:00,339.53,340.47,339.02,339.99,335.8405002143772,NaN,NaN,NaN,NaN,NaN,330.42629999999946,336.0088165689088,324.8437834310901,336.0227434219002,333.91119945276114,337.3182509748174,330.5041479307049,241697,106571.56666666667,83.76570091118371,68.89002927193538,NaN,NaN,NaN,NaN,1.4824119273206084,40.449157463456345,94727726,0.8923655322348631,2.362486233604443,1.4701207013695798
2025-09-03T10:45:00-04:00,339.98,340.15,338.95,339.13,335.8405002143772,NaN,NaN,NaN,NaN,NaN,330.6092999999994,336.69822043323813,324.52037956676065,336.0227434219002,334.12642966410385,337.6322579258227,330.620601402385,103311,109177.56666666667,77.51050159692451,70.85643455414736,NaN,NaN,NaN,NaN,1.462239646797707,42.42739508377266,94624415,0.8210241962075095,2.4964009466289667,1.6753767504214572
2025-09-03T10:50:00-04:00,339.15,339.95,338.9,339.89,335.8405002143772,NaN,NaN,NaN,NaN,NaN,330.82829999999944,337.4275949958396,324.22900500415926,336.0987557900161,334.360639119632,337.964166898461,330.7571113408031,118440,111312.86666666667,79.00273731679971,72.40038067792405,NaN,NaN,NaN,NaN,1.432793957740729,44.20735962250166,94742855,0.7664967183226332,2.6334976483247488,1.8670009300021155
2025-09-03T10:55:00-04:00,339.86,341.48,339.52,341.27,336.5510525437028,NaN,NaN,NaN,NaN,NaN,331.0742999999995,338.26837367504925,323.8802263249497,337.4190046320129,334.8407942806108,338.69450979805174,330.98707876316985,223840,118072.83333333333,81.41424204023767,74.05414793802628,NaN,NaN,NaN,NaN,1.4704515321878222,46.17548166259967,94966695,0.7631862119756119,2.8209836949716305,2.0577974829960186
2025-09-03T11:00:00-04:00,341.28,342.08,341.05,341.23,337.65509560989807,NaN,NaN,NaN,NaN,NaN,331.30949999999945,339.0282160203038,323.5907839796951,338.3162037056103,335.2623330326284,339.3260917059549,331.1985743593019,203022,123401.96666666666,81.12341335527725,75.4753818895734,NaN,NaN,NaN,NaN,1.4389907084601188,48.11196091899748,94763673,0.6997905149890391,2.9325356267323173,2.232745111743278
2025-09-03T11:05:00-04:00,341.21,342.31,340.9,341.49,337.6805458094482,NaN,NaN,NaN,NaN,NaN,331.54309999999947,339.75722366366716,323.3289763363318,338.59396296448824,335.52999465816464,339.7047740812114,331.3552152351179,141209,127111.46666666666,81.58391605590518,76.89694180405881,NaN,NaN,NaN,NaN,1.436919943570112,49.95173516221523,94904882,0.6196082267541834,3.0072553951860073,2.387647168431824
2025-09-03T11:10:00-04:00,341.5,342.52,341.17,341.3,337.914839181746,NaN,NaN,NaN,NaN,NaN,331.7662999999995,340.41099937256416,323.1216006274348,338.8721703715906,335.7769980674333,340.0408967085334,331.51309942633316,139564,130837.36666666667,80.04710914716014,77.4270055304322,NaN,NaN,NaN,NaN,1.4307113761722445,51.69928324301559,94765318,0.5029775551789628,3.0163691124055276,2.513391557226565
2025-09-03T11:15:00-04:00,341.29,341.78,340.89,341.32,337.914839181746,NaN,NaN,NaN,NaN,NaN,331.98749999999944,341.0238404651527,322.95115953484617,338.8721703715906,335.92737767991696,340.2286478188109,331.62610754102303,96461,132969.63333333333,80.08962542779405,77.91491305722104,NaN,NaN,NaN,NaN,1.3920891350170834,52.95742943394981,94861779,0.38187103738700134,2.9907303539603163,2.608859316573315
2025-09-03T11:20:00-04:00,341.31,341.69,340.79,341.15,337.914839181746,NaN,NaN,NaN,NaN,NaN,332.20169999999945,341.5823425388745,322.8210574611244,338.8721703715906,336.1003524663357,340.43382320134634,331.7668817313251,120582,135466.93333333332,78.55733949694252,79.00786526766906,NaN,NaN,NaN,NaN,1.3569399110872902,53.99110449571366,94741197,0.2513120322155493,2.9229993568427517,2.6716873246272024
2025-09-03T11:25:00-04:00,341.11,341.32,340.06,340.15,337.914839181746,NaN,NaN,NaN,NaN,NaN,332.4084999999995,342.0221262150163,322.79487378498266,338.8721703715906,336.2362729451703,340.56998075062563,331.90256513971497,117119,137836,70.0654692714596,79.03446021072807,NaN,NaN,NaN,NaN,1.3500156317239116,53.98872520653937,94624078,0.0681310579440475,2.7568511470572616,2.688720089113214
2025-09-03T11:30:00-04:00,340.14,340.5,339.33,340.03,337.914839181746,NaN,NaN,NaN,NaN,NaN,332.6310999999995,342.42323057317316,322.8389694268258,338.8721703715906,336.34214034857166,340.65820563006923,332.0260750670741,111393,140091.43333333332,69.10017077022846,78.6634574261885,NaN,NaN,NaN,NaN,1.3371573723150618,53.1096325557963,94512685,-0.08242543804187452,2.5856882915608708,2.6681137296027453
2025-09-03T11:35:00-04:00,340.06,341.09,340.06,340.63,337.914839181746,NaN,NaN,NaN,NaN,NaN,332.86769999999945,342.8479960297929,322.887403970206,338.8721703715906,336.4226802411617,340.7367738301769,332.10858665214647,75527,141710.56666666668,71.23414683415889,78.29578925059683,NaN,NaN,NaN,NaN,1.3173604171497004,52.56367776993136,94588212,-0.15850454058223207,2.469983053874955,2.6284875944571873
2025-09-03T11:40:00-04:00,340.59,341.67,340.27,341.45,337.914839181746,NaN,NaN,NaN,NaN,NaN,333.11909999999943,343.31585589402374,322.9223441059751,338.8721703715906,336.517896841167,340.8392499765889,332.19654370574506,82303,142995.03333333333,73.88824405826342,77.88964771230594,NaN,NaN,NaN,NaN,1.3232632444961527,52.30714584013415,94670515,-0.16951331355777777,2.416595952509965,2.586109266067743
2025-09-03T11:45:00-04:00,341.46,341.95,341.04,341.72,337.914839181746,NaN,NaN,NaN,NaN,NaN,333.39069999999947,343.7643921123673,323.0170078876316,339.0091165999122,336.6309148079264,340.96848900172347,332.2933406141293,93106,144718.86666666667,74.71547904397804,77.29272109473665,NaN,NaN,NaN,NaN,1.2937444413178538,52.18682223484421,94763621,-0.17387352648251397,2.3687673579646003,2.5426408844471142
2025-09-03T11:50:00-04:00,341.7,342.15,341.41,341.8,338.10305004541215,NaN,NaN,NaN,NaN,NaN,333.6628999999994,344.1895633062074,323.13623669379143,339.42729327992976,336.72926909004707,341.08277902006387,332.37575916003027,80941,145326.13333333333,74.96851967140609,76.66435100618112,NaN,NaN,NaN,NaN,1.2541912669380035,52.1607106895679,94844562,-0.18556704439247707,2.3106820789565177,2.4962491233489947
2025-09-03T11:55:00-04:00,341.78,341.87,341.19,341.53,338.10305004541215,NaN,NaN,NaN,NaN,NaN,333.93309999999946,344.5596010027828,323.3065989972161,339.42729327992976,336.78158405152834,341.1399008162991,332.4232672867576,46746,142989.66666666666,72.33730483024898,76.29483695141857,NaN,NaN,NaN,NaN,1.213177605013861,51.833332241088925,94797816,-0.22315717977161764,2.2173026486344725,2.44045982840609
2025-09-03T12:00:00-04:00,341.5,341.75,340.97,341.15,338.10305004541215,NaN,NaN,NaN,NaN,NaN,334.19189999999946,344.8783865864408,323.50541341355813,339.42729327992976,336.8497392168218,341.2098308873274,332.4896475463161,65844,136770.53333333333,68.68358816541411,75.55775486917675,NaN,NaN,NaN,NaN,1.182236347512869,51.22128664970141,94731972,-0.2815195989355055,2.0885603297367084,2.370079928672214
2025-09-03T12:05:00-04:00,341.19,341.85,340.891,341.64,338.10305004541215,NaN,NaN,NaN,NaN,NaN,334.46089999999947,345.2064880603223,323.71531193967667,339.44687415932407,336.91046597028446,341.27352791450056,332.54740402606836,58133,130206.73333333334,70.73617173726971,74.79503556182189,NaN,NaN,NaN,NaN,1.166290894119093,50.71011303639366,94790105,-0.29367922106479405,2.0029809023412213,2.2966601234060153
2025-09-03T12:10:00-04:00,341.67,341.7,340.74,341.33,338.10305004541215,NaN,NaN,NaN,NaN,NaN,334.7248999999995,345.48395283759527,323.9658471624037,339.44687415932407,336.95160513646067,341.31431382392253,332.5888964489988,42177,125018.5,67.71241097121381,73.83710682010307,NaN,NaN,NaN,NaN,1.1515558302534419,50.004740738053776,94747928,-0.3266271743290887,1.8883761554946545,2.2150033298237433
2025-09-03T12:15:00-04:00,341.29,342.19,341.25,342.17,338.264339243764,NaN,NaN,NaN,NaN,NaN,335.0021999999995,345.799736230182,324.204663769817,339.7979994619674,337.03019605089605,341.401632911598,332.6587591901941,72356,123875.93333333333,71.29330410179426,73.10206310909516,NaN,NaN,NaN,NaN,1.136444699521053,49.65680977213877,94820284,-0.29674290186732044,1.8440747024895927,2.140817604356913
2025-09-03T12:20:00-04:00,342.15,343.33,342.06,342.76,339.223232914502,NaN,NaN,NaN,NaN,NaN,335.2923999999995,346.1283228938811,324.45647710611786,340.7813995695739,337.21446077306837,341.63080525859294,332.7981162875438,151646,125858.8,73.51513459287725,72.63549349807496,NaN,NaN,NaN,NaN,1.1459843638409768,49.937290080789644,94971930,-0.24432126938294374,1.8354160176282335,2.079737287011177
2025-09-03T12:25:00-04:00,342.78,342.8,341.62,341.715,339.223232914502,NaN,NaN,NaN,NaN,NaN,335.55449999999945,346.365145910498,324.7438540895009,340.7813995695739,337.27649213516776,341.6979663011321,332.8550179692034,60878,125053.26666666666,64.05818061367845,71.4903902970667,NaN,NaN,NaN,NaN,1.1484140521380506,49.53773598736903,94911052,-0.2843067076030197,1.7243539025074028,2.0086606101104225
2025-09-03T12:30:00-04:00,341.75,341.81,341.38,341.57,339.223232914502,NaN,NaN,NaN,NaN,NaN,335.80629999999945,346.579109626193,325.03349037380593,340.7813995695739,337.3080820398129,341.728637796496,332.88752628312983,35002,120454.93333333333,62.8500427610356,70.3684405302162,NaN,NaN,NaN,NaN,1.097098762699619,48.814791068697986,94876050,-0.32203111484194347,1.6061217165579933,1.9281528313999368
2025-09-03T12:35:00-04:00,341.56,342.11,341.56,341.79,339.223232914502,NaN,NaN,NaN,NaN,NaN,336.07029999999946,346.76950640244894,325.37109359755,340.7813995695739,337.35335246376445,341.77460251863585,332.93210240889306,48403,117278.43333333333,63.960644302923235,69.93238160389217,NaN,NaN,NaN,NaN,1.058020279649647,48.33359188683442,94924453,-0.33233335455689317,1.5127361382038202,1.8450694927607134
2025-09-03T12:40:00-04:00,341.79,341.79,341.06,341.37,339.223232914502,NaN,NaN,NaN,NaN,NaN,336.31509999999946,346.9276790438587,325.70252095614023,340.7813995695739,337.39693715775974,341.814178830148,332.97969548537145,52437,115554.13333333333,60.257084501336394,69.3007325846856,NaN,NaN,NaN,NaN,1.0345902596746734,47.145040035284325,94872016,-0.3649937003981327,1.3888273672630476,1.7538210676611803
2025-09-03T12:45:00-04:00,341.36,341.49,340.88,341.03,339.223232914502,NaN,NaN,NaN,NaN,NaN,336.55409999999944,347.0416659121779,326.06653408782097,340.7813995695739,337.42306050308645,341.83582932594385,333.01029168022905,34335,113787.73333333334,57.361467643786284,68.30982692823041,NaN,NaN,NaN,NaN,1.0042623839836262,45.78218568663913,94837681,-0.4040182571339659,1.248798246243723,1.652816503377689
2025-09-03T12:50:00-04:00,341.05,341.2,340.52,340.73,339.223232914502,NaN,NaN,NaN,NaN,NaN,336.7866999999994,347.1173626332617,326.4560373667372,340.7813995695739,337.46313772316586,341.8650652007164,333.0612102456153,58689,110206.1,54.85657735016447,66.9504221633662,NaN,NaN,NaN,NaN,0.9811007851276534,44.004201087651055,94778992,-0.4415125003288918,1.1009258779665743,1.542438378295466
2025-09-03T12:55:00-04:00,340.74,341.48,340.73,341.25,339.223232914502,NaN,NaN,NaN,NaN,NaN,337.0284999999995,347.1985088988251,326.8584911011739,340.7813995695739,337.5048244583752,341.8991578249962,333.11049109175417,56781,104466.83333333333,58.259071107591154,65.77496445362428,NaN,NaN,NaN,NaN,0.9645935861899639,42.606493192121704,94835773,-0.4227452818313915,1.0140067760062266,1.436752057837618
2025-09-03T13:00:00-04:00,341.27,341.83,341.2,341.48,339.223232914502,NaN,NaN,NaN,NaN,NaN,337.27589999999947,347.26355792176327,327.28824207823567,340.7813995695739,337.5400451290162,341.9309064057185,333.14918385231397,44668,100346.2,59.70569521103373,64.68476270645483,NaN,NaN,NaN,NaN,0.9406940443192519,41.61575819644675,94880441,-0.38724187821298584,0.9526997100713857,1.3399415882843715
2025-09-03T13:05:00-04:00,341.49,341.93,341.41,341.84,339.223232914502,NaN,NaN,NaN,NaN,NaN,337.5266999999994,347.3286891064229,327.72471089357583,340.7813995695739,337.56523754277487,341.95482596335603,333.1756491221937,30699,93576.96666666666,61.929717014626505,63.941363576767515,NaN,NaN,NaN,NaN,0.9106444697250183,40.78338222788407,94911140,-0.33393080621107996,0.9225280805205216,1.2564588867316016
2025-09-03T13:10:00-04:00,341.805,342.47,341.75,342.1,339.223232914502,NaN,NaN,NaN,NaN,NaN,337.7798999999994,347.3853244030353,328.1744755969634,340.72692599859874,337.62982426874396,342.02113397718625,333.23851456030167,73602,87973.8,63.49676487181348,63.57087619865318,NaN,NaN,NaN,NaN,0.8970270076018048,40.46553937280028,94984742,-0.27787355767214406,0.9091169396414216,1.1869904973135657
2025-09-03T13:15:00-04:00,342.15,342.56,342.04,342.17,339.43033056055486,NaN,NaN,NaN,NaN,NaN,338.0310999999994,347.42332173728585,328.638878262713,340.905540798879,337.68799922620116,342.0819636460457,333.2940348063566,65900,86726.76666666666,63.927276085498995,63.08452650924098,NaN,NaN,NaN,NaN,0.8700965070588174,40.24345712776235,95050642,-0.2345256985601334,0.8938333741133988,1.1283590726735322
2025-09-03T13:20:00-04:00,342.17,342.32,341.92,342,339.43033056055486,NaN,NaN,NaN,NaN,NaN,338.27909999999946,347.4191935860788,329.13900641392013,340.905540798879,337.7190585903745,342.1128993512931,333.32521782945594,37329,84023.06666666667,62.01442398919568,62.677527439096835,NaN,NaN,NaN,NaN,0.8365181851260431,39.816018836500064,95013313,-0.21619791273217248,0.8581116817583165,1.074309594490489
2025-09-03T13:25:00-04:00,341.99,342.01,341.45,341.76,339.43033056055486,NaN,NaN,NaN,NaN,NaN,338.5188999999994,347.37825918463324,329.6595408153656,340.905540798879,337.756630140273,342.14697236864976,333.3662879118962,49788,78221.33333333333,59.31597704445279,61.82200407785815,NaN,NaN,NaN,NaN,0.8167668861884688,38.58626778336337,94963525,-0.21848747462949136,0.8012002512036247,1.019687725833116
2025-09-03T13:30:00-04:00,341.74,342.01,341.14,341.18,339.43033056055486,NaN,NaN,NaN,NaN,NaN,338.7590999999995,347.2344656417997,330.28373435819924,340.905540798879,337.7818308318253,342.16767409005115,333.3959875735994,36673,72676.36666666667,53.282006623736635,60.37678065149097,NaN,NaN,NaN,NaN,0.8205692514607213,36.935541146992875,94926852,-0.2547795965864512,0.701213230100052,0.9559928266865032
2025-09-03T13:35:00-04:00,341.17,341.27,340.98,341.12,339.43033056055486,NaN,NaN,NaN,NaN,NaN,338.99469999999945,347.0543616332348,330.9350383667641,340.905540798879,337.80723515412427,342.18600465478374,333.4284656534648,41101,69339.43333333333,52.68493575351434,59.56440601862211,NaN,NaN,NaN,NaN,0.7826714477849529,35.14467456398474,94885751,-0.2767154920244186,0.6100984616559799,0.8868139536803985
2025-09-03T13:40:00-04:00,341.11,341.28,340.53,340.67,339.43033056055486,NaN,NaN,NaN,NaN,NaN,339.18769999999944,346.93018105210643,331.44521894789244,340.905540798879,337.83966756471244,342.2059645792881,333.4733705501368,58699,66643.93333333333,48.31224765135441,58.52599208221631,NaN,NaN,NaN,NaN,0.7803377729431705,32.790123393095804,94827052,-0.3127614652292179,0.49586212214387615,0.808623587373094
2025-09-03T13:45:00-04:00,340.72,340.77,339.69,340.54,339.43033056055486,NaN,NaN,NaN,NaN,NaN,339.4128999999994,346.6265293474459,332.1992706525529,340.905540798879,337.86978821451476,342.2181758577987,333.5214005712308,66816,65655.76666666666,47.096164947020036,57.32138641393751,NaN,NaN,NaN,NaN,0.8017422177329429,31.373928334690692,94760236,-0.3346272732760347,0.3903394957780506,0.7249667690540853
2025-09-03T13:50:00-04:00,340.6,340.96,340.17,340.21,339.43033056055486,NaN,NaN,NaN,NaN,NaN,339.6116999999994,346.3379011895504,332.88549881044844,340.905540798879,337.8958572916749,342.22987207258404,333.5618425107657,56533,63520.8,44.06405071870762,56.164741143749744,NaN,NaN,NaN,NaN,0.8009034878948729,29.77773457341579,94703703,-0.3584598362475224,0.2768919737446822,0.6353518099922046
2025-09-03T13:55:00-04:00,340.24,340.35,339.21,339.28,NaN,NaN,NaN,342.4633238261469,342.4633238261469,342.4633238261469,339.7892999999994,345.9809059340346,333.5976940659642,340.905540798879,337.9179862025537,342.22834360483125,333.6076288002762,72941,62048.2,36.86149465415101,54.70045735877579,NaN,NaN,NaN,NaN,0.8251246673309565,29.331225030293407,94630762,-0.41974937658584666,0.11066508925989638,0.530414465845743
2025-09-03T14:00:00-04:00,339.28,339.28,338.52,338.95,NaN,NaN,NaN,341.5649909249584,NaN,NaN,339.9512999999994,345.5988193884099,334.3037806115889,340.905540798879,337.93275413675525,342.21282103363285,333.65268723987765,84970,61167.433333333334,34.694402798214654,53.26030203363653,NaN,NaN,NaN,NaN,0.8204729053787447,29.516484575317932,94545792,-0.46205603366837966,-0.047155576239731545,0.4149004574286481
2025-09-03T14:05:00-04:00,338.97,339.4,338.62,338.7,NaN,NaN,NaN,341.5649909249584,NaN,NaN,340.1068999999994,345.14651700551906,335.0672829944798,340.79643263910316,337.94063208756046,342.20424573856326,333.67701843655766,46859,60211.833333333336,33.106484344907045,51.4636886934448,NaN,NaN,NaN,NaN,0.8175819835659752,29.498599375856273,94498933,-0.4840882701425052,-0.19020988024948338,0.29387838989302184
2025-09-03T14:10:00-04:00,338.72,338.87,338.26,338.81,NaN,NaN,NaN,341.17793594608816,NaN,NaN,340.22049999999945,344.866627958012,335.5743720419869,340.5111461112825,337.9477894590642,342.1903265934263,333.70525232470214,59327,59445.96666666667,34.52643140149435,49.66516984990627,NaN,NaN,NaN,NaN,0.8027546990255494,29.790853343862487,94558260,-0.46818023225457467,-0.2913469004251965,0.17683333182937816
2025-09-03T14:15:00-04:00,338.77,338.77,337.9,337.94,NaN,NaN,NaN,340.95325703944775,NaN,NaN,340.31329999999946,344.5720141770994,336.0545858228995,340.37591688902603,337.9506260210013,342.16963611264725,333.73161592935537,65690,58532.1,29.239854145027138,47.33017964493489,NaN,NaN,NaN,NaN,0.8104150776665834,30.35522957978367,94492570,-0.49080012414357815,-0.43666682335009455,0.05413330079348361
2025-09-03T14:20:00-04:00,337.99,338.19,337.05,337.21,NaN,NaN,NaN,340.27469990129106,NaN,NaN,340.4130999999994,344.1045934054366,336.7216065945622,339.8177335112208,337.9453447890784,342.1407368104266,333.7499527677302,67648,58089,25.685942061488632,44.62940658705454,NaN,NaN,NaN,NaN,0.833956857833255,31.483409300721675,94424922,-0.526329698200211,-0.6037788219567801,-0.07744912375656915
2025-09-03T14:25:00-04:00,337.19,337.35,336.39,336.83,NaN,NaN,NaN,339.5349408148687,NaN,NaN,340.4740999999994,343.80868944436037,337.1395105556384,339.74318680897665,337.93277867226175,342.10550832932586,333.76004901519764,69896,58860.666666666664,24.047444395115235,41.78084718059856,NaN,NaN,NaN,NaN,0.8429599394165965,32.923091974309145,94355026,-0.5445524977715848,-0.7581397459710502,-0.21358724819946537
2025-09-03T14:30:00-04:00,336.8,336.8,335.65,336.01,NaN,NaN,NaN,338.92971623237474,NaN,NaN,340.4890999999994,343.7353123717444,337.2428876282544,339.1494395577451,337.90786097300736,342.05654446229846,333.75917748371626,86000,59532.53333333333,20.942873777168643,38.84716502259663,NaN,NaN,NaN,NaN,0.8670342294582687,34.63851470960399,94269026,-0.5778111039039754,-0.9358511280794346,-0.3580400241754592
2025-09-03T14:35:00-04:00,336.01,336.14,334.72,334.84,NaN,NaN,NaN,338.2054109490849,NaN,NaN,340.46469999999937,343.8586866886185,337.07071331138025,339.1494395577451,337.85799231978206,341.9837091875225,333.7322754520416,116689,61484.4,17.47604454730913,35.858598415657795,NaN,NaN,NaN,NaN,0.9065317844969609,36.628699624416605,94152337,-0.6397696251573106,-1.1577520556220975,-0.5179824304647869
2025-09-03T14:40:00-04:00,334.87,336.04,334.78,336.02,NaN,NaN,NaN,338.2054109490849,NaN,NaN,340.4352999999994,343.9549888559037,336.9156111440951,338.3315516461961,337.83008928674116,341.93761914976835,333.72255942371396,78774,62704.3,30.052277705363366,34.19933206434541,NaN,NaN,NaN,NaN,0.9317795141757529,38.476728473885466,94231111,-0.5650390547736922,-1.2242812489319022,-0.65924219415821
2025-09-03T14:45:00-04:00,336,336.17,335.74,335.92,NaN,NaN,NaN,338.2054109490849,NaN,NaN,340.36329999999936,344.09579064869075,336.63080935130796,337.4141930535655,337.8114245089702,341.90285022469004,333.7199987932504,63315,62402.933333333334,29.640035980095846,32.55326779481552,NaN,NaN,NaN,NaN,0.8959381203060568,39.95468128017095,94167796,-0.4889506812308698,-1.2704305456967973,-0.7814798644659274
2025-09-03T14:50:00-04:00,335.92,336,335.11,335.62,NaN,NaN,NaN,338.2054109490849,NaN,NaN,340.2758999999994,344.23692193409727,336.31487806590155,337.4141930535655,337.7884889440541,341.86509191003336,333.71188597807486,66368,59560.333333333336,28.38219297140192,31.129692460533196,NaN,NaN,NaN,NaN,0.8955139688556232,41.60908105068323,94101428,-0.42764905650048624,-1.3160411850915352,-0.888392128591049
2025-09-03T14:55:00-04:00,335.61,335.68,334.89,335.02,NaN,NaN,NaN,338.0156045385774,NaN,NaN,340.19369999999935,344.4088606425525,335.9785393574462,336.97635444285237,337.7672852806966,341.83388594701375,333.7006846143795,53340,59309.066666666666,26.005226611701815,29.62319686515332,NaN,NaN,NaN,NaN,0.8879772567945087,43.23774978494693,94048088,-0.3969996123643579,-1.3846416440464964,-0.9876420316821385
2025-09-03T15:00:00-04:00,335,335.29,334.63,334.85,NaN,NaN,NaN,337.6564861504603,NaN,NaN,340.0928999999994,344.5654796093912,335.6203203906076,336.80008355428185,337.7187159074145,341.7672447578707,333.6701870569583,113284,61918.46666666667,25.35724670757324,28.286996578643727,NaN,NaN,NaN,NaN,0.8716931670234741,44.85875540657207,93934804,-0.3588226178377598,-1.4361703039793383,-1.0773476861415785
2025-09-03T15:05:00-04:00,334.87,335.55,334.84,335.47,NaN,NaN,NaN,337.6564861504603,NaN,NaN,339.9768999999994,344.6189895685536,335.33481043144513,336.0440668434255,337.6957904287323,341.7320401589187,333.6595406985459,63123,62409.13333333333,32.01100426423777,27.940532979364207,NaN,NaN,NaN,NaN,0.8601436550932285,45.84235261285935,93997927,-0.26669501795255446,-1.4107164585822716,-1.1440214406297171
2025-09-03T15:10:00-04:00,335.48,335.66,335.1,335.2,NaN,NaN,NaN,337.6564861504603,NaN,NaN,339.8562999999994,344.67197225238584,335.040627747613,335.15325347474044,337.6786395440976,341.7053202232125,333.65195886498276,48693,62284.333333333336,30.7264613239891,27.657108588348102,NaN,NaN,NaN,NaN,0.8387048225865695,46.532956551687896,93949234,-0.201771573749975,-1.3962359078171858,-1.1944643340672108
2025-09-03T15:15:00-04:00,335.2,335.38,334.91,335.29,NaN,NaN,NaN,337.6564861504603,NaN,NaN,339.7322999999994,344.69050177508666,334.7740982249121,334.45260277979236,337.6565411051876,341.6720634807351,333.6410187296401,60513,63156.933333333334,31.710175104151517,27.55737221400842,NaN,NaN,NaN,NaN,0.8123687638303839,47.28633306733489,94009747,-0.1338683243181169,-1.3617997394648569,-1.22793141514674
2025-09-03T15:20:00-04:00,335.27,335.81,335.01,335.64,NaN,NaN,NaN,337.6564861504603,NaN,NaN,339.6190999999994,344.6862142440659,334.55198575593283,333.98165464703214,337.64142212280973,341.64699922504707,333.6358450205724,47752,62792.36666666667,35.54352241200881,27.630021571902315,NaN,NaN,NaN,NaN,0.8114852806996431,47.097602600630104,94057499,-0.050759285654545794,-1.2913805222149222,-1.2406212365603764
2025-09-03T15:25:00-04:00,335.63,335.96,335.51,335.63,NaN,NaN,NaN,337.6564861504603,NaN,NaN,339.5052999999994,344.6691584065009,334.3414415934979,334.2723237176257,337.62670258679816,341.62061799252064,333.6327871810757,52358,62644.933333333334,35.482238029617065,28.075906135087312,NaN,NaN,NaN,NaN,0.7856649035068106,46.6239416457548,94005141,0.014665065681700673,-1.2222899044582505,-1.2369549701399511
2025-09-03T15:30:00-04:00,335.63,336.31,335.61,336.19,NaN,NaN,NaN,337.6564861504603,NaN,NaN,339.40609999999936,344.62998410691364,334.1822158930851,334.6098589741006,337.61365932660215,341.59374455479474,333.63357409840955,57117,63059.9,41.55909471415698,29.209702753135048,NaN,NaN,NaN,NaN,0.7795459818277519,45.505192402413556,94062258,0.10191798872984048,-1.1095574842276505,-1.211475472957491
2025-09-03T15:35:00-04:00,336.21,336.46,335.82,336.35,NaN,NaN,NaN,337.6564861504603,NaN,NaN,339.3300999999994,344.61865083764627,334.0415491623525,334.7798871792805,337.6017772704878,341.56706666328074,333.63648787769483,59444,64018.066666666666,43.20507956847317,30.57810526551776,NaN,NaN,NaN,NaN,0.7695784116971972,44.18305641758865,94121702,0.17251933799316466,-0.9958263004660353,-1.1683456384592
2025-09-03T15:40:00-04:00,336.36,337.07,336.3,336.86,NaN,NaN,NaN,337.6564861504603,NaN,NaN,339.2666999999994,344.5960165079964,333.93738349200237,335.3409097434244,337.58992248106557,341.5290112309947,333.65083373113646,98333,64842.433333333334,48.21202340355254,32.52590166740232,NaN,NaN,NaN,NaN,0.7696085251473962,41.8931229860522,94220035,0.250925739879005,-0.8546884636104437,-1.1056142034894487
2025-09-03T15:45:00-04:00,336.89,337.13,336.7,336.98,NaN,NaN,NaN,337.6564861504603,NaN,NaN,339.19369999999935,344.5462630535761,333.8411369464226,335.5317277947395,337.5815477188565,341.4959952993129,333.6671001384001,92472,65728.16666666667,49.34362381324224,34.80215732925469,NaN,NaN,NaN,NaN,0.7453507733511541,39.668630247277676,94312507,0.3046532049852062,-0.7247976972579409,-1.029450902243147
2025-09-03T15:50:00-04:00,336.97,337.13,335.96,336.47,NaN,NaN,NaN,337.6564861504603,NaN,NaN,339.0940999999994,344.460333573224,333.7278664267748,335.5317277947395,337.56469676881756,341.45021721330073,333.6791763243344,116347,68362.1,44.857485194814956,35.8596721499298,NaN,NaN,NaN,NaN,0.7756828609689299,38.495260901782956,94196160,0.2991964136427828,-0.6554553851896685,-0.9546517988324513
2025-09-03T15:55:00-04:00,336.4,336.47,334.01,334.05,NaN,NaN,NaN,337.6564861504603,NaN,NaN,338.94069999999937,344.43489184616465,333.4465081538341,335.5317277947395,337.4852202722987,341.3409078136073,333.6295327309901,220493,74052.26666666666,30.627978270485954,35.93023945638624,NaN,NaN,NaN,NaN,0.8959912280425805,38.964296108341806,93975667,0.13435646392740097,-0.7867062189232001,-0.9210626828506011
2025-09-04T09:30:00-04:00,336.16,337.63,334.17,337.39,NaN,NaN,NaN,337.6564861504603,NaN,NaN,338.85249999999934,344.30166076130394,333.40333923869474,335.5317277947395,336.39666666666665,336.39666666666665,336.39666666666665,221916,80227.03333333334,52.8558722964698,37.6783594081768,NaN,NaN,NaN,NaN,1.0877061403252521,37.80355385521595,94197583,0.2455429388888526,-0.6141340092395353,-0.8596769481283879
2025-09-04T09:35:00-04:00,337.48,337.48,334.73,335.53,NaN,NaN,NaN,337.6564861504603,NaN,NaN,338.73249999999933,344.2047347356866,333.26026526431207,335.5317277947395,336.18608104156334,336.4257406891087,335.946421394018,171339,84568.3,44.33618841239369,38.987713822511935,NaN,NaN,NaN,NaN,1.2064414160163055,36.72572176302765,94026244,0.1914973566950886,-0.6203052522595272,-0.8118026089546158
2025-09-04T09:40:00-04:00,335.51,335.51,333,335.2,NaN,NaN,NaN,337.6564861504603,NaN,NaN,338.6134999999993,344.1288829425155,333.09811705748314,335.5317277947395,335.6720587781375,336.4502944448029,334.8938231114721,183422,88725.73333333334,43.011539157913795,40.248734711821974,NaN,NaN,NaN,NaN,1.3009813148722817,36.88638085991304,93842822,0.1339252453071772,-0.6443960523206442,-0.7783212976278214
2025-09-04T09:45:00-04:00,335.16,336.04,334.04,334.67,NaN,NaN,NaN,337.6564861504603,NaN,NaN,338.4740999999993,344.02865117562436,332.9195488243742,335.5317277947395,335.5113935982467,336.2679556491361,334.75483154735724,155789,91691.5,40.89808824138972,40.88352642447569,NaN,NaN,NaN,NaN,1.3509112209528331,36.39121226756378,93687033,0.06409202346503262,-0.6982062682965307,-0.7622982917615633
2025-09-04T09:50:00-04:00,334.68,335,333.45,334.1,NaN,NaN,NaN,337.6564861504603,NaN,NaN,338.3294999999993,343.9551136556383,332.70388634436034,335.5317277947395,335.3597372530714,336.18764562116763,334.53182888497514,94426,92954.6,38.69589345480725,41.45277157667699,NaN,NaN,NaN,NaN,1.3651318480276315,36.29264436125857,93592607,-0.012464237228417496,-0.7778785882970851,-0.7654143510686676
2025-09-04T09:55:00-04:00,334.1,334.82,333.61,334.45,NaN,NaN,NaN,337.6564861504603,NaN,NaN,338.1750999999993,343.79437557274895,332.55582442724966,335.5317277947395,335.266675044594,336.1129597252097,334.42039036397836,79060,93158.56666666667,40.80367379450041,42.10230719741619,NaN,NaN,NaN,NaN,1.354051001739942,36.201117019689434,93671667,-0.030480503507990586,-0.8035149804536559,-0.7730344769456653
2025-09-04T10:00:00-04:00,334.55,334.75,332.15,332.43,NaN,NaN,NaN,337.27800771593917,NaN,NaN,337.96849999999927,343.6574641414519,332.27953585854664,335.5317277947395,334.98068107225197,336.0559611217586,333.9054010227453,138504,94943.03333333334,33.619251791410406,41.96485929594488,NaN,NaN,NaN,NaN,1.4430473587585193,36.91289119845778,93533163,-0.1620389849631031,-0.9755832081495441,-0.813544223186441
2025-09-04T10:05:00-04:00,332.46,332.86,331.86,332.11,NaN,NaN,NaN,336.1503710015783,NaN,NaN,337.7763999999993,343.59357836778685,331.9592216322117,335.2663822357916,334.60510747710424,335.972635942616,333.23757901159246,168469,98996.7,32.638835509230276,41.76175911591725,NaN,NaN,NaN,NaN,1.4114011188471964,37.71000606778141,93364694,-0.24900766611009373,-1.1248038058240581,-0.8757961397139644
2025-09-04T10:10:00-04:00,332.12,333.22,331.86,332.145,NaN,NaN,NaN,336.1503710015783,NaN,NaN,337.5878999999993,343.5110019206611,331.6647980793375,333.7491057886333,334.3675913130117,335.82816991107984,332.90701271494356,147040,101920.46666666666,32.86942821589017,41.14106865175533,NaN,NaN,NaN,NaN,1.407729610358112,37.972065864674185,93511734,-0.28024647280192716,-1.2261042307163734,-0.9458577579144463
2025-09-04T10:15:00-04:00,332.1,333.04,331.49,332.91,NaN,NaN,NaN,336.1070115944133,NaN,NaN,337.41029999999927,343.35125763683305,331.4693423631655,333.6632846309066,334.2118272691517,335.7041433121879,332.71951122611546,122318,103808.06666666667,37.87528546765752,40.76036907312564,NaN,NaN,NaN,NaN,1.4178917810468192,38.41493127766961,93634052,-0.22769165099938937,-1.230472321663683,-1.0027806706642937
2025-09-04T10:20:00-04:00,332.88,334.18,332.875,334.06,NaN,NaN,NaN,336.1070115944133,NaN,NaN,337.2640999999993,343.16775164643684,331.36044835356176,332.9316277047253,334.17964349051766,335.62908026126246,332.73020671977287,100508,104903.4,44.56713996863459,40.50002025634579,NaN,NaN,NaN,NaN,1.4098280824006184,37.42024241949608,93734560,-0.10028286091089722,-1.1281342468029152,-1.027851385892018
2025-09-04T10:25:00-04:00,334.07,334.22,333.29,333.73,NaN,NaN,NaN,336.1070115944133,NaN,NaN,337.11809999999934,343.00303564640967,331.233164353589,331.11704173102424,334.1604965591259,335.5803158469371,332.74067727131467,73232,105014.6,43.13139798134401,40.056289839781634,NaN,NaN,NaN,NaN,1.3755546479434317,36.45096581802413,93661328,-0.02685761049755442,-1.061423399013961,-1.0345657885164066
2025-09-04T10:30:00-04:00,333.73,334.86,333.62,333.94,NaN,NaN,NaN,336.1070115944133,NaN,NaN,336.9822999999993,342.84088863911757,331.1237113608811,331.35279540609923,334.15931529808984,335.5376221250598,332.7810084711199,101277,105523.83333333333,44.35979954510831,40.02074086480258,NaN,NaN,NaN,NaN,1.3658721730903303,34.83216203258579,93762605,0.04340548251482512,-0.9803089353728751,-1.0237144178877002
2025-09-04T10:35:00-04:00,333.92,334.86,333.83,334.66,NaN,NaN,NaN,336.1070115944133,NaN,NaN,336.8504999999994,342.61486995709504,331.08613004290373,331.53923632487937,334.172425568295,335.5206423258755,332.82420881071454,83000,104400.86666666667,48.469674243682576,41.29514772003091,NaN,NaN,NaN,NaN,1.3418813035838804,33.328987088964475,93845605,0.14045136776182743,-0.848150208185416,-0.9886015759472434
2025-09-04T10:40:00-04:00,334.69,334.96,332.98,333.1,NaN,NaN,NaN,336.1070115944133,NaN,NaN,336.6828999999993,342.38608510681286,330.9797148931857,331.53923632487937,334.1518302042369,335.4752282394787,332.82843216899505,80329,104452.7,41.343955097894394,40.47286792013267,NaN,NaN,NaN,NaN,1.3874612104707433,32.61812598184503,93765276,0.10337249206539856,-0.8593859608654952,-0.9627584529308938
2025-09-04T10:45:00-04:00,333.1,333.25,332.4,333.15,NaN,NaN,NaN,336.1070115944133,NaN,NaN,336.5090999999993,342.10162633096286,330.91657366903576,331.53923632487937,334.1106629097249,335.4300107930104,332.7913150264394,67158,104580.8,41.64009929948276,40.280290126353314,NaN,NaN,NaN,NaN,1.3490711240085491,32.371581552765306,93832434,0.08668138249892798,-0.8544067248072338,-0.9410881073061618
2025-09-04T10:50:00-04:00,333.13,333.45,332.47,332.89,NaN,NaN,NaN,336.1070115944133,NaN,NaN,336.3248999999993,341.77355212347027,330.8762478765283,331.53923632487937,334.07516076820866,335.3898694635806,332.7604520728367,61986,104434.73333333334,40.495162200679594,40.1005489151223,NaN,NaN,NaN,NaN,1.3227089008650785,31.890834858905787,93770448,0.06366286512222019,-0.8615095259033865,-0.9251723910256067
2025-09-04T10:55:00-04:00,332.84,333.19,332.75,333.05,NaN,NaN,NaN,336.1070115944133,NaN,NaN,336.14249999999925,341.403632292832,330.8813677071665,331.53923632487937,334.0583236140239,335.369563488409,332.74708373963875,32508,103740.33333333333,41.56006727549611,40.14783313184419,NaN,NaN,NaN,NaN,1.2596582650890014,31.444427214607668,93802956,0.06454343808557772,-0.8444930934186345,-0.9090365315042123
2025-09-04T11:00:00-04:00,333.05,333.68,332.83,333.45,NaN,NaN,NaN,336.1070115944133,NaN,NaN,335.97149999999937,341.0111119892691,330.9318880107296,331.53923632487937,334.0382669400079,335.3371316934895,332.73940218652626,58145,101902.36666666667,44.24637890527625,40.54429637830625,NaN,NaN,NaN,NaN,1.2303969604397886,30.384018592892335,93861101,0.09552646854711966,-0.7896284458203127,-0.8851549143674323
2025-09-04T11:05:00-04:00,333.43,333.91,333.34,333.78,NaN,NaN,NaN,336.1070115944133,NaN,NaN,335.81189999999935,340.60767684660317,331.01612315339554,331.53923632487937,334.02930929343773,335.31321602964414,332.74540255723133,54370,101610.6,46.434011766555,40.946463376310156,NaN,NaN,NaN,NaN,1.183225748979807,29.106994899131074,93915471,0.1390679939210251,-0.711319921966151,-0.8503879158871761
2025-09-04T11:10:00-04:00,333.82,333.93,332.63,333.21,NaN,NaN,NaN,336.1070115944133,NaN,NaN,335.65249999999935,340.2496853347941,331.0553146652046,331.53923632487937,334.00850590357487,335.2811699303425,332.7358418768072,60730,102011.83333333333,43.27545557919266,41.6361922182946,NaN,NaN,NaN,NaN,1.1915667669098216,28.574289383667956,93854741,0.13044556037386368,-0.6873309654198465,-0.8177765257937102
2025-09-04T11:15:00-04:00,333.21,334.76,333.14,334.46,NaN,NaN,NaN,336.1070115944133,NaN,NaN,335.51929999999936,339.8535155048372,331.1850844951615,331.90316385737543,334.01266986508784,335.26152166275585,332.76381806741983,87505,102911.56666666667,51.12678421956271,42.956759983318356,NaN,NaN,NaN,NaN,1.2221691407019775,27.06936771854102,93942246,0.2054306065028918,-0.5609882676650955,-0.7664188741679873
2025-09-04T11:20:00-04:00,334.5,334.59,334,334.4,NaN,NaN,NaN,336.1070115944133,NaN,NaN,335.39389999999935,339.4805090053238,331.3072909946749,332.00953108590033,334.01939439411217,335.2557881099298,332.7830006782945,50726,103010.7,50.76358048368604,44.23491371673235,NaN,NaN,NaN,NaN,1.1770142020804057,25.67194045806601,93891520,0.24481900361420628,-0.4603951196502294,-0.7052141232644357
2025-09-04T11:25:00-04:00,334.37,334.95,334,334.8,NaN,NaN,NaN,336.1070115944133,NaN,NaN,335.2790999999994,339.0945012583655,331.4636987416333,332.4106248687203,334.03961180377524,335.2581595968878,332.82106401066267,89008,104232.36666666667,53.15291955270002,45.32617329423538,NaN,NaN,NaN,NaN,1.1607989019318043,23.95003624267765,93980528,0.2886294392051545,-0.3444273242579925,-0.633056763463147
2025-09-04T11:30:00-04:00,334.82,335.13,334.32,334.99,NaN,NaN,NaN,336.1070115944133,NaN,NaN,335.17469999999935,338.72086322839607,331.6285367716026,332.69349989497624,334.05874218095715,335.26811432792914,332.84937003398517,62943,104426.56666666667,54.28767665362106,46.020497343162994,NaN,NaN,NaN,NaN,1.1357418375081043,22.33711924989363,94043471,0.31885535314170443,-0.23448757203601645,-0.5533429251777209
2025-09-04T11:35:00-04:00,335.02,335.55,334.58,335.49,NaN,NaN,NaN,336.1070115944133,NaN,NaN,335.0988999999994,338.44732726699584,331.75047273300294,333.115799915981,334.088567151334,335.2960140486209,332.8811202540471,67906,104708.63333333333,57.22411235607087,47.02711979850062,NaN,NaN,NaN,NaN,1.1239031348289559,21.316273283099484,94111377,0.35803899966248665,-0.10579417559961257,-0.4638331752620992
2025-09-04T11:40:00-04:00,335.5,336.08,335.4,335.505,NaN,NaN,NaN,336.1070115944133,NaN,NaN,335.02999999999935,338.1953897078218,331.8646102921769,333.79263993278477,334.131969216116,335.3502038293582,332.9137346028738,74156,103902.73333333334,57.31270380126812,47.952327245369176,NaN,NaN,NaN,NaN,1.0921957680554595,20.92163019854569,94185533,0.3690154976727655,-0.0025638031711423537,-0.37157930084390783
2025-09-04T11:45:00-04:00,335.51,335.57,334.88,335.28,NaN,NaN,NaN,336.1070115944133,NaN,NaN,334.9615999999994,337.9496538419229,331.9735461580759,333.79263993278477,334.15427931092603,335.37025627357474,332.9383023482773,55061,102655.7,55.45734556310951,48.451446625328245,NaN,NaN,NaN,NaN,1.0634674989086408,19.87919702978601,94130472,0.34557959501689994,0.06039519292721707,-0.2851844020896829
2025-09-04T11:50:00-04:00,335.3,335.78,335.08,335.18,NaN,NaN,NaN,336.1070115944133,NaN,NaN,334.8889999999994,337.6686373868374,332.10936261316135,333.79263993278477,334.168127887399,335.3837546239885,332.9525011508095,32230,99851.8,54.61116991020916,49.399104826207875,NaN,NaN,NaN,NaN,1.03750553470088,19.1408913872447,94098242,0.30899277722229457,0.1010565694381853,-0.20793620778410923
2025-09-04T11:55:00-04:00,335.17,335.26,334.34,334.43,NaN,NaN,NaN,336.1070115944133,NaN,NaN,334.8187999999994,337.4605490876872,332.1770509123116,333.79263993278477,334.1779540178867,335.3838127597897,332.9720952759837,54677,94324.6,48.619377143851466,49.89762467223421,NaN,NaN,NaN,NaN,1.0291122822222467,17.993808849102,94043565,0.22389542351631425,0.0719330716112836,-0.15196235190503066
2025-09-04T12:00:00-04:00,334.42,334.66,334.05,334.43,NaN,NaN,NaN,336.1070115944133,NaN,NaN,334.76319999999936,337.3168520989227,332.209547901076,333.79263993278477,334.18080967209306,335.3783539925718,332.9832653516143,40568,88279.66666666667,48.61937714385147,50.47792573960363,NaN,NaN,NaN,NaN,0.9991756906349443,17.249758816622034,94043565,0.16020649450803437,0.048295766230012305,-0.11191072827802206
2025-09-04T12:05:00-04:00,334.425,334.67,333.98,334.06,NaN,NaN,NaN,336.1070115944133,NaN,NaN,334.7077999999994,337.1991226692277,332.2164773307711,333.79263993278477,334.18150668919947,335.37157186878204,332.9914415096169,36270,83777.36666666667,45.747583126784896,50.77703401469569,NaN,NaN,NaN,NaN,0.9770917127324481,16.637503863570448,94007295,0.08929695162969668,-0.00028953874090120735,-0.08958649037059789
2025-09-04T12:10:00-04:00,334.14,334.43,333.8,334.19,NaN,NaN,NaN,336.1070115944133,NaN,NaN,334.67139999999944,337.1386211417173,332.2041788582816,333.79263993278477,334.180932077845,335.36274097231274,332.99912318337726,40803,79023.4,46.933597237291785,50.96897818126822,NaN,NaN,NaN,NaN,0.9522994475372729,16.2773099264262,94048098,0.049284169367494565,-0.02798127866122968,-0.07726544802872425
2025-09-04T12:15:00-04:00,334.21,334.46,333.98,334.3,NaN,NaN,NaN,336.1070115944133,NaN,NaN,334.6605999999994,337.1295014889499,332.1916985110489,333.79263993278477,334.1816266171353,335.3571947605185,333.0060584737521,31474,74879.56666666667,47.97007030383663,51.07869664821691,NaN,NaN,NaN,NaN,0.9185637727131792,15.897411367237593,94079572,0.029345732386421894,-0.040583282545696875,-0.06992901493211877
2025-09-04T12:20:00-04:00,334.31,334.63,334.16,334.16,NaN,NaN,NaN,336.1070115944133,NaN,NaN,334.62339999999944,337.06515137188046,332.1816486281184,333.79263993278477,334.1834067691276,335.35130236660035,333.01551117165485,39793,73058.46666666666,46.71936402988544,51.324690108980676,NaN,NaN,NaN,NaN,0.8865235032336642,15.278238862004123,94039779,0.007013411121560148,-0.06116225103016859,-0.06817566215172874
2025-09-04T12:25:00-04:00,334.2,334.241,332.87,333.2,NaN,NaN,NaN,336.1070115944133,NaN,NaN,334.56899999999945,337.0139752559085,332.1240247440904,333.79263993278477,334.16760672577533,335.32805957770415,333.0071538738465,65281,72599.16666666667,39.176467828441645,50.471096081043456,NaN,NaN,NaN,NaN,0.9211289672884011,16.13127153981317,93974498,-0.06799512256509559,-0.15316956535809823,-0.08517444279300264
2025-09-04T12:30:00-04:00,333.17,333.59,333.06,333.4,NaN,NaN,NaN,336.1070115944133,NaN,NaN,334.5245999999994,336.9722469030862,332.0769530969126,333.69008955698223,334.15906490739894,335.31642949267075,333.00170032212714,32559,69067.66666666667,41.30266265044987,49.7953162358123,NaN,NaN,NaN,NaN,0.8931911839106562,16.923373312064424,94007057,-0.09790454974149862,-0.2075551299698759,-0.10965058022837729
2025-09-04T12:35:00-04:00,333.37,333.67,333.34,333.49,NaN,NaN,NaN,336.1070115944133,NaN,NaN,334.4939999999995,336.9543308724484,332.03366912755064,333.69008955698223,334.1527673965026,335.3063723736786,332.99916241932664,30066,64454.23333333333,42.28046580457512,49.01871239666052,NaN,NaN,NaN,NaN,0.8529632422027552,17.520202507021505,94037123,-0.10477562782362948,-0.24062011500791414,-0.13584448718428466
2025-09-04T12:40:00-04:00,333.5,334.06,333.28,333.62,NaN,NaN,NaN,336.1070115944133,NaN,NaN,334.46939999999944,336.93957784019244,331.99922215980644,333.1280716455858,334.14494255688663,335.2911541185869,332.99873099518635,50083,61222.333333333336,43.73837616338983,48.26519093307257,NaN,NaN,NaN,NaN,0.8477515820454177,17.41056377453849,94087206,-0.09405501035111136,-0.25341325012317384,-0.15935823977206248
2025-09-04T12:45:00-04:00,333.63,334.38,333.63,334.15,NaN,NaN,NaN,336.1070115944133,NaN,NaN,334.44299999999953,336.8980063140443,331.98799368595473,333.0012417168256,334.14332859459887,335.27946229154816,333.0071948976496,57328,59056,49.35484215843133,47.70310020466974,NaN,NaN,NaN,NaN,0.8414836118993158,16.799094799658906,94144534,-0.04712881547448994,-0.21826925911517492,-0.17114044364068498
2025-09-04T12:50:00-04:00,334.15,334.29,333.81,334.17,NaN,NaN,NaN,336.1070115944133,NaN,NaN,334.42239999999947,336.8689234440147,331.97587655598426,333.0012417168256,334.1423889793591,335.2684910831596,333.01628687555865,58361,57651.1,49.55947215791783,47.14929794443044,NaN,NaN,NaN,NaN,0.8156633539065087,16.23130218012787,94202895,-0.012409207220261065,-0.1866519526660113,-0.17424274544575025
2025-09-04T12:55:00-04:00,334.16,334.32,333.46,333.58,NaN,NaN,NaN,336.1070115944133,NaN,NaN,334.3881999999995,336.8330621724237,331.94333782757525,333.0012417168256,334.1378894832355,335.2575528826274,333.01822608384356,42434,56624.5,43.92158846988472,46.325315294914375,NaN,NaN,NaN,NaN,0.8188302571989018,16.17535807837711,94160461,-0.026061002051598864,-0.20681899801024883,-0.18075799595864997
2025-09-04T13:00:00-04:00,333.6,334.77,333.5,334.44,NaN,NaN,NaN,336.1070115944133,NaN,NaN,334.36419999999947,336.7828569500701,331.94554304992886,333.0012417168256,334.1396689061259,335.24927915439076,333.03005865786105,61543,55300.03333333333,52.418460081200486,46.1686931642709,NaN,NaN,NaN,NaN,0.8510566673989789,15.372191338891007,94222004,0.023279605247324336,-0.15165848939949456,-0.1749380946468189
2025-09-04T13:05:00-04:00,334.4,334.7,334.18,334.34,NaN,NaN,NaN,336.1070115944133,NaN,NaN,334.33839999999947,336.7298651914958,331.94693480850316,333.0012417168256,334.142272755477,335.2467708044208,333.0377747065332,33645,53654.86666666667,51.442412670195914,46.37033855900979,NaN,NaN,NaN,NaN,0.8274097625847647,14.626393652225337,94188359,0.04819809747552847,-0.1146904728024083,-0.16288857027793677
2025-09-04T13:10:00-04:00,334.34,334.4,333.89,333.98,NaN,NaN,NaN,336.1070115944133,NaN,NaN,334.2941999999995,336.62814375298325,331.9602562470157,332.81803246009116,334.14179189399204,335.24120934668605,333.042374441298,32031,52044.933333333334,47.97884536177387,46.32458628886138,NaN,NaN,NaN,NaN,0.8047376366858524,14.366746482885198,94156328,0.03980056676766225,-0.11313786181835894,-0.1529384285860212
2025-09-04T13:15:00-04:00,333.96,334.22,333.93,334.05,NaN,NaN,NaN,336.1070115944133,NaN,NaN,334.2481999999995,336.5077342533342,331.98866574666476,332.81803246009116,334.14134749508736,335.2375234928775,333.04517149729725,20720,50497,48.70208503083611,46.53562213915076,NaN,NaN,NaN,NaN,0.7679706626368644,14.125645539926495,94177048,0.038312292657197544,-0.10504806276452427,-0.14336035542172182
2025-09-04T13:20:00-04:00,334.04,334.49,334.04,334.24,NaN,NaN,NaN,336.1070115944133,NaN,NaN,334.1957999999995,336.32859099818415,332.06300900181486,333.0222326195667,334.1422193045859,335.2342895955799,333.0501490135919,26682,49320.2,50.70536722715161,46.80503428128361,NaN,NaN,NaN,NaN,0.7452584724485162,13.391210942770556,94203730,0.04880342270887614,-0.08235607703562664,-0.13115949974450278
2025-09-04T13:25:00-04:00,334.24,335.11,334.2,335.04,NaN,NaN,NaN,336.1070115944133,NaN,NaN,334.15699999999947,336.15190551206615,332.1620944879328,333.48078609565334,334.15137535476754,335.23828447203215,333.0644662375029,51135,49941.1,58.12116791671217,47.53011268220329,NaN,NaN,NaN,NaN,0.7570257244164811,13.179138085357698,94254865,0.1050705908932662,0.0001787388720799754,-0.10489185202118623
2025-09-04T13:30:00-04:00,335.12,335.23,334.77,335.08,NaN,NaN,NaN,336.1070115944133,NaN,NaN,334.12919999999946,336.03096587467564,332.22743412532327,333.69662887652265,334.1614223474109,335.24609013652963,333.0767545582922,41576,49388.8,58.45768244776804,48.36856399776633,NaN,NaN,NaN,NaN,0.7358096012438778,13.160328357394244,94296441,0.13833877338497863,0.06803161471003705,-0.07030715867494157
2025-09-04T13:35:00-04:00,335.12,335.59,335.09,335.19,NaN,NaN,NaN,336.1070115944133,NaN,NaN,334.1519999999995,336.0766184042478,332.2273815957511,334.1083031012181,334.1774228488835,335.2626076354064,333.0922380623606,52091,49312.833333333336,59.42329611376543,49.8147660181466,NaN,NaN,NaN,NaN,0.7196803440121716,13.656130515288071,94348532,0.15959959852929606,0.12919233948667852,-0.030407259042617547
2025-09-04T13:40:00-04:00,335.18,335.4,334.88,334.99,NaN,NaN,NaN,336.1070115944133,NaN,NaN,334.10399999999953,335.81056028370017,332.3974397162989,334.1083031012181,334.1881999818008,335.27145322855534,333.1049467350462,43909,48752.13333333333,56.8365011246711,50.9243259091624,NaN,NaN,NaN,NaN,0.7054174622970153,13.693745422951615,94304623,0.15207268157130233,0.15968359292151035,0.007610911350208034
2025-09-04T13:45:00-04:00,334.99,335.18,334.83,334.9,NaN,NaN,NaN,336.1070115944133,NaN,NaN,334.0913999999995,335.76463762864523,332.4181623713538,334.1083031012181,334.1917526639667,335.273820169774,333.10968515815944,16973,46401.066666666666,55.66224406022448,51.88016721313736,NaN,NaN,NaN,NaN,0.6800305007043729,13.626898638277135,94287650,0.13357007761690431,0.17457350837133845,0.04100343075443412
2025-09-04T13:50:00-04:00,334.89,335.59,334.81,335.44,NaN,NaN,NaN,336.1070115944133,NaN,NaN,334.09619999999944,335.7834493123896,332.40895068760926,334.1349711878237,334.20349230833074,335.2855629871137,333.1214216295478,40732,46067.933333333334,60.88410234895893,53.104861940678006,NaN,NaN,NaN,NaN,0.6871711792254871,14.183362960280427,94328382,0.14905875774077987,0.22732687793040895,0.07826812018962909
2025-09-04T13:55:00-04:00,335.38,335.38,334.8,334.84,NaN,NaN,NaN,336.1070115944133,NaN,NaN,334.0995999999995,335.79213755112113,332.40706244887787,334.1349711878237,334.20884997210936,335.2892854966787,333.12841444754,25356,43946.2,53.36372421114492,53.39121065872897,NaN,NaN,NaN,NaN,0.6838018092808085,14.677527573861395,94303026,0.1119487021857973,0.21820399792187573,0.10625529573607842
2025-09-04T14:00:00-04:00,334.86,335.36,334.86,335.26,NaN,NaN,NaN,336.1070115944133,NaN,NaN,334.1227999999994,335.84624209133153,332.3993579086673,334.1349711878237,334.2151245312056,335.2947396800725,333.13550938233874,25242,42689.5,57.33634033123245,53.946701242537166,NaN,NaN,NaN,NaN,0.6721016800464678,15.136394715043725,94328268,0.10865501190471452,0.24207406061697156,0.13341904871225704
2025-09-04T14:05:00-04:00,335.25,335.41,334.9,335.3,NaN,NaN,NaN,336.1070115944133,NaN,NaN,334.13979999999947,335.8923398260997,332.3872601738992,334.1349711878237,334.2238306122444,335.3026391603262,333.1450220641626,34010,41559.63333333333,57.7058522076296,54.931291509518935,NaN,NaN,NaN,NaN,0.6605229886145806,15.646203156174842,94362278,0.10223106593102663,0.2612078811260403,0.1589768151950137
2025-09-04T14:10:00-04:00,335.29,335.45,335.18,335.45,NaN,NaN,NaN,336.1070115944133,NaN,NaN,334.20019999999937,335.92074056689603,332.4796594331027,334.18478019853256,334.2301471765089,335.3092645653892,333.15102978762866,21582,39807.166666666664,59.13519271417432,55.411058126159936,NaN,NaN,NaN,NaN,0.6326284894278235,16.189753253913196,94383860,0.10096882793680281,0.2851878501160172,0.1842190221792144
2025-09-04T14:15:00-04:00,335.4,336.06,335.35,335.99,NaN,NaN,NaN,336.1070115944133,NaN,NaN,334.2777999999994,335.96389864547973,332.59170135451905,334.69282415882606,334.2563257189162,335.34512625793735,333.167525179895,65833,40166.23333333333,63.86911579447136,56.298679777893895,NaN,NaN,NaN,NaN,0.6381550258972631,17.636588113260373,94449693,0.12766677761273343,0.3438024941951312,0.21613571658239777
2025-09-04T14:20:00-04:00,335.97,336.33,335.75,335.98,333.88910790498187,333.88910790498187,333.88910790498187,NaN,NaN,NaN,334.3544999999994,335.9937952761145,332.7152047238843,334.94625932706083,334.2793019640109,335.3793189666643,333.17928496135755,52109,40828.86666666667,63.72190102303387,57.42318375369818,NaN,NaN,NaN,NaN,0.634001095476029,19.323814167575197,94397584,0.13509938709300012,0.38500995044864794,0.24991056335564782
2025-09-04T14:25:00-04:00,335.98,336.15,335.3,335.4,333.88910790498187,NaN,NaN,NaN,NaN,NaN,334.40429999999935,336.01609652636165,332.79250347363705,334.94625932706083,334.2904838782613,335.3926405628712,333.1883271936514,33726,40130.5,55.70240447683795,57.923206571269745,NaN,NaN,NaN,NaN,0.6494295886563102,19.683316062547593,94363858,0.0933832376924616,0.36663961047122484,0.27325637277876325
2025-09-04T14:30:00-04:00,335.41,336.04,335.41,335.93,333.88910790498187,NaN,NaN,NaN,NaN,NaN,334.4416999999994,336.1057403968308,332.777659603168,334.94625932706083,334.30326872761236,335.40937254191465,333.1971649133101,34609,39931.86666666667,60.58401697941278,58.628824410716966,NaN,NaN,NaN,NaN,0.648756046609434,20.017139250736246,94398467,0.09367319542878727,0.39034786706474733,0.29667467163596006
2025-09-04T14:35:00-04:00,335.94,336,335.65,335.92,333.88910790498187,NaN,NaN,NaN,NaN,NaN,334.4854999999994,336.18716536146286,332.7838346385359,334.94625932706083,334.31059839780113,335.419212363877,333.20198443172524,19287,39365.76666666667,60.44866062602866,58.79507388995386,NaN,NaN,NaN,NaN,0.6274163289944761,20.327117925482856,94379180,0.0856015286392523,0.40367658243502547,0.31807505379577317
2025-09-04T14:40:00-04:00,335.9,336.3,335.8,335.875,333.9702443671402,NaN,NaN,NaN,NaN,NaN,334.5241999999994,336.2621083527116,332.78629164728716,334.94625932706083,334.3268666085846,335.4423102847507,333.21142293241854,39943,39337.1,59.801178889619,58.891037921514645,NaN,NaN,NaN,NaN,0.6183151626377278,21.104461648230636,94339237,0.07028336626659126,0.4059292616290122,0.33564589536242095
2025-09-04T14:45:00-04:00,335.9,336.07,335.6,336.07,333.9702443671402,NaN,NaN,NaN,NaN,NaN,334.55239999999947,336.34316211770147,332.76163788229746,334.94625932706083,334.338476123593,335.45802645991125,333.21892578727477,30427,39302.2,61.71489479320113,59.05472354147434,NaN,NaN,NaN,NaN,0.6077212224493166,21.253905236216355,94369664,0.06638229354165126,0.41862376228948506,0.3522414687478338
2025-09-04T14:50:00-04:00,336.09,336.37,336.06,336.18,334.21656563204306,NaN,NaN,NaN,NaN,NaN,334.6139999999994,336.4125605361896,332.81543946380924,335.14432468503304,334.355124550785,335.48338565388934,333.2268634476806,37454,39224.23333333333,62.791000413939905,59.48004491927925,NaN,NaN,NaN,NaN,0.586455420845794,21.885290954330824,94407118,0.06426593200134284,0.43257388374951233,0.3683079517481695
2025-09-04T14:55:00-04:00,336.2,336.62,336.17,336.33,334.4260399214956,NaN,NaN,NaN,NaN,NaN,334.6775999999994,336.4894357989301,332.8657642010687,335.41445974802645,334.37499611651896,335.5152370274553,333.2347552055826,41719,38438.833333333336,64.26599362948812,60.09459845994094,NaN,NaN,NaN,NaN,0.5767086050710937,22.843962423880846,94448837,0.06578536751905684,0.4505396611469905,0.3847542936279337
2025-09-04T15:00:00-04:00,336.39,336.61,336.02,336.6,334.4260399214956,NaN,NaN,NaN,NaN,NaN,334.75179999999943,336.5685925148997,332.93500748509916,335.41445974802645,334.3931893810217,335.54437058233833,333.2420081797051,38222,38627.6,66.81592740993068,60.51830025001034,NaN,NaN,NaN,NaN,0.5776579904231607,23.289844169279483,94487059,0.07701218037357327,0.48101951909490026,0.404007338721327
2025-09-04T15:05:00-04:00,336.61,337.25,336.54,336.86,334.92735249045364,NaN,NaN,NaN,NaN,NaN,334.82799999999935,336.67228305922777,332.98371694077093,335.8874542387369,334.4478133695218,335.643298997076,333.2523277419676,95887,40821.63333333333,69.10240101002165,61.64249144993011,NaN,NaN,NaN,NaN,0.5871109911072192,24.5872501047374,94582946,0.09292115822318114,0.5201587865003034,0.4272376282771223
2025-09-04T15:10:00-04:00,336.94,337.42,336.9,337.32,335.20542737725117,NaN,NaN,NaN,NaN,NaN,334.9053999999994,336.8347292519394,332.97607074805944,336.04996339098955,334.48015109976023,335.70524663225143,333.25505556726904,51718,40876.13333333333,72.68798146737956,62.73903724536918,NaN,NaN,NaN,NaN,0.585174491742418,25.99069677472563,94634664,0.1234825981237836,0.5815908759318518,0.4581082778080682
2025-09-04T15:15:00-04:00,337.3,337.3,336.93,337.2,335.20542737725117,NaN,NaN,NaN,NaN,NaN,334.9737999999994,336.979663964073,332.96793603592585,336.04996339098955,334.5003049338685,335.74238719947823,333.2582226682588,33726,40089.4,70.39303516218598,63.64526459926607,NaN,NaN,NaN,NaN,0.5712334566179585,27.293897254000417,94600938,0.1243301493593415,0.613520964507245,0.4891908151479035
2025-09-04T15:20:00-04:00,337.22,337.72,337,337.53,335.4301311433219,NaN,NaN,NaN,NaN,NaN,335.0601999999994,337.12598891526704,332.9944110847317,336.32717657023335,334.5557357925345,335.8488054110034,333.2626661740656,86348,41022.3,72.92466996007545,64.63022725968759,NaN,NaN,NaN,NaN,0.5818596382881063,28.981338895102688,94687286,0.13494375595517183,0.6578705100918683,0.5229267541366964
2025-09-04T15:25:00-04:00,337.58,337.58,336.74,336.88,335.4301311433219,NaN,NaN,NaN,NaN,NaN,335.10859999999934,337.2285594719162,332.9886405280825,336.32717657023335,334.5814181918137,335.89243088072175,333.2704055029057,46947,41172.73333333333,61.72833611550186,64.47731442547548,NaN,NaN,NaN,NaN,0.6002982355532398,29.750753119294693,94640339,0.08827327939755614,0.6332683533836416,0.5449950739860855
2025-09-04T15:30:00-04:00,336.86,336.99,336.75,336.765,335.4301311433219,NaN,NaN,NaN,NaN,NaN,335.1558999999994,337.3156691456345,332.9961308543643,336.32717657023335,334.59874911908855,335.9194658479646,333.2780323902125,35572,40307.03333333333,59.97391857796558,64.20960139368489,NaN,NaN,NaN,NaN,0.5745626472994376,30.465209184615844,94604767,0.04208605027972778,0.5976026368357452,0.5555165865560174
2025-09-04T15:35:00-04:00,336.75,337.5,336.74,337.35,335.4301311433219,NaN,NaN,NaN,NaN,NaN,335.2068999999994,337.4494859097247,332.9643140902741,336.32717657023335,334.6313524560808,335.9752423188332,333.28746259332837,58787,41145.1,65.36640083328645,64.89988684771693,NaN,NaN,NaN,NaN,0.5878081724923343,31.74855005244862,94663554,0.04319936421691717,0.6095157918271639,0.5663164276102467
2025-09-04T15:40:00-04:00,337.32,337.5,337.09,337.44,335.4301311433219,NaN,NaN,NaN,NaN,NaN,335.2558999999994,337.58286428046216,332.9289357195366,336.32717657023335,334.65941718482384,336.0242152189922,333.2946191506555,48982,41710.13333333333,66.12258442349936,65.29549880800882,NaN,NaN,NaN,NaN,0.5751075887428837,32.9402237154362,94712536,0.04221317674180203,0.6190828985374992,0.5768697217956972
2025-09-04T15:45:00-04:00,337.4,337.71,337.12,337.69,335.5338239735728,NaN,NaN,NaN,NaN,NaN,335.2998999999994,337.7240744909396,332.87572550905924,336.32717657023335,334.69420925219674,336.08624512602023,333.30217337837325,58554,42971.26666666667,68.199620804055,65.84913882072497,NaN,NaN,NaN,NaN,0.5761713324041045,34.283863118374114,94771090,0.050077373874801046,0.6394664391391984,0.5893890652643974
2025-09-04T15:50:00-04:00,337.68,338.71,337.66,338.7,336.24615015659225,NaN,NaN,NaN,NaN,NaN,335.3637999999994,337.9679847558294,332.7596152441694,337.07134209482723,334.79307336783376,336.28899031520547,333.29715642046204,132939,46513.166666666664,74.89603369369574,66.92734273530189,NaN,NaN,NaN,NaN,0.6100162372323794,36.386789785741364,94904029,0.11146385444777829,0.7287188833241203,0.617255028876342
2025-09-04T15:55:00-04:00,338.63,338.88,338.35,338.63,336.69200696765625,NaN,NaN,NaN,NaN,NaN,335.4307999999994,338.1906379377105,332.6709620622883,337.30407367586184,334.90517496040127,336.51410464362704,333.2962452771755,148614,49762.46666666667,73.73710331398337,67.78607191535777,NaN,NaN,NaN,NaN,0.6043007917157789,38.45211271324785,94755415,0.13400195903987067,0.7847574776761803,0.6507555186363096
2025-09-05T09:30:00-04:00,348.08,353.04,347.57,349.41,346.5044157418537,NaN,NaN,NaN,NaN,NaN,335.7153999999994,340.5030014205867,330.9277985794121,344.57425894068945,350.0066666666666,350.00667206146323,350.00666127187,840933,76407.7,92.63577135376062,69.91784126820211,NaN,NaN,NaN,NaN,1.5904221637360823,42.342404216902416,95596348,0.8231254043512134,1.6796622740753264,0.856536869724113
2025-09-05T09:35:00-04:00,349.31,350.82,348.13,350.445,346.5044157418537,NaN,NaN,NaN,NaN,NaN,336.0356999999995,342.3393075418916,329.7320924581074,344.57425894068945,349.95066858512064,350.0430291926346,349.85830797760667,309125,84975.5,93.14575305221535,71.98068122696834,NaN,NaN,NaN,NaN,1.6689634377549332,45.954817756010236,95905473,1.2701474343948436,2.4442211627176675,1.174073728322824
2025-09-05T09:40:00-04:00,350.4,354.6,349.72,354.13,347.6814717813171,NaN,NaN,NaN,NaN,NaN,336.42969999999946,344.49819165843786,328.36120834156105,345.66592572204127,350.8962202987704,352.24588598129134,349.54655461624947,566243,102386.63333333333,94.58388054029137,73.96410645056554,NaN,NaN,NaN,NaN,1.8983231922010089,49.409227491282856,96471716,1.708213240338171,3.3093402787455375,1.6011270384073666
2025-09-05T09:45:00-04:00,354.14,354.7,352.96,354.51,349.31776851852993,NaN,NaN,NaN,NaN,NaN,336.83869999999945,346.33259146990076,327.34480853009813,346.682740577633,351.4440026072322,353.1577824681835,349.73022274628096,359847,113815.76666666666,94.7072061876029,75.79302110610706,NaN,NaN,NaN,NaN,1.8870143927580805,52.61916725587227,96831563,1.902890582681212,3.9797402667588813,2.0768496840776693
2025-09-05T09:50:00-04:00,354.59,355.87,353.74,355.74,350.2074154040513,NaN,NaN,NaN,NaN,NaN,337.26969999999943,348.105308595842,326.43409140415685,348.3911924621064,352.1483707611404,354.2613139718996,350.03542755038126,492664,128880.16666666667,95.09641700105834,77.39362364422698,NaN,NaN,NaN,NaN,1.9043705075610744,55.62643460289117,97324227,1.9847193849748712,4.5577489152962585,2.5730295303213873
2025-09-05T09:55:00-04:00,355.7,355.82,353.58,354.49,350.2074154040513,NaN,NaN,NaN,NaN,NaN,337.6734999999994,349.49618011080156,325.8508198891973,348.7169539696851,352.3943016524829,354.53250624858657,350.25609705637925,282574,137454.1,88.01309778711115,78.65219954600734,NaN,NaN,NaN,NaN,1.928344042735284,58.28517858095731,97041653,1.8287359243596182,4.85894943577091,3.030213511411292
2025-09-05T10:00:00-04:00,354.49,354.74,352.41,354.67,350.2074154040513,NaN,NaN,NaN,NaN,NaN,338.08369999999945,350.78116491399953,325.3862350859994,348.7169539696851,352.5296677964558,354.6183131861848,350.44102240672674,273681,145735.4,88.14997747654334,79.73972151146934,NaN,NaN,NaN,NaN,1.9570337539684768,59.784504730623375,97315334,1.6189644554704712,5.053919080749381,3.43495462527891
2025-09-05T10:05:00-04:00,354.6,354.7,350.77,350.87,350.2074154040513,NaN,NaN,NaN,NaN,NaN,338.4370999999994,351.54805589049136,325.3261441095075,348.7169539696851,352.50078532643005,354.51845565978925,350.48311499307084,232957,152366.96666666667,69.98174790042812,80.32925092467836,NaN,NaN,NaN,NaN,2.0979599143993,59.94689966711143,97082377,1.1287920226010635,4.845944653530239,3.7171526309291756
2025-09-05T10:10:00-04:00,350.89,351.55,349.05,349.07,NaN,NaN,NaN,355.5245718777948,355.5245718777948,355.5245718777948,338.75049999999936,352.11160702758184,325.3893929724169,348.7169539696851,352.31139106642706,354.36912500519793,350.2536571276562,262655,160402.73333333334,63.32393079219079,80.56853751140873,NaN,NaN,NaN,NaN,2.1266770633707788,58.96492840428468,96819722,0.6136279289654585,4.484187542135999,3.87055961317054
2025-09-05T10:15:00-04:00,349.05,349.63,346.24,346.37,NaN,NaN,NaN,353.38436406516774,NaN,NaN,339.0080999999994,352.44999211243817,325.5662078875606,348.7169539696851,351.9404901492026,354.3053917232893,349.57558857511594,296635,168096.13333333333,54.888548594289404,79.82011949433752,NaN,NaN,NaN,NaN,2.2169144159871506,56.51923458976243,96523087,0.05097081997701158,3.934273138141805,3.883302318164793
2025-09-05T10:20:00-04:00,346.38,348.56,346.26,347.14,NaN,NaN,NaN,352.92530206220556,NaN,NaN,339.2784999999994,352.819537368035,325.73746263196375,348.7169539696851,351.79222665562367,354.2572551500536,349.32719816119373,129867,170688.06666666668,56.661600353218105,79.14433491788886,NaN,NaN,NaN,NaN,2.2228491005594977,54.24823319056321,96652954,-0.29062745490382325,3.520017999535014,3.8106454544388373
2025-09-05T10:25:00-04:00,347.07,348.29,346.64,347.87,NaN,NaN,NaN,352.92530206220556,NaN,NaN,339.55289999999945,353.22255619034905,325.88324380964985,348.7169539696851,351.5801839001644,354.1517577710874,349.0086100292414,215612,176750.93333333332,58.33360454995316,78.43961947116729,NaN,NaN,NaN,NaN,2.181931307662393,52.13944617702108,96868566,-0.47765349694869563,3.2135785832529677,3.6912320802016634
2025-09-05T10:30:00-04:00,347.84,348.57,347.16,348.01,NaN,NaN,NaN,352.92530206220556,NaN,NaN,339.8296999999994,353.6121809683363,326.04721903166245,348.7169539696851,351.4669357697975,354.0767620743667,348.8571094652283,135849,180125.6,58.6629817238033,77.28011575903213,NaN,NaN,NaN,NaN,2.1267933571150768,50.277809507555595,97004415,-0.5945561965574298,2.948036834504876,3.5425930310623057
2025-09-05T10:35:00-04:00,348.04,348.46,347.03,347.57,NaN,NaN,NaN,352.92530206220556,NaN,NaN,340.1094999999994,353.94105482953626,326.27794517046254,348.7169539696851,351.38335474128974,354.02334946597205,348.7433600166074,99452,182797.76666666666,57.13431121316182,76.09420203754486,NaN,NaN,NaN,NaN,2.077022403035429,48.46903380980495,96904963,-0.6970378421319614,2.6712957283973537,3.368333570529315
2025-09-05T10:40:00-04:00,347.56,348.38,346.66,347.2,NaN,NaN,NaN,352.89040720562036,NaN,NaN,340.3646999999994,354.2392074738681,326.4901925261307,348.7169539696851,351.27992095602957,353.9609514912493,348.5988904208098,120327,185477.23333333334,55.81711382312539,73.46429792821378,NaN,NaN,NaN,NaN,2.0515208028186107,46.552546996000316,96784636,-0.7790524665104721,2.3945179873912252,3.1735704539016973
2025-09-05T10:45:00-04:00,347.2,347.21,344.77,345.34,NaN,NaN,NaN,351.44902505991035,NaN,NaN,340.58469999999943,354.41889262705166,326.7505073729472,347.89256317574814,351.04406412933133,353.89418537594673,348.19394288271593,206667,191351.9,49.623588269801665,70.35557187232709,NaN,NaN,NaN,NaN,2.0792693169029954,43.66593894810421,96577969,-0.9372521173138191,2.0020053072594237,2.939257424573243
2025-09-05T10:50:00-04:00,345.27,348.25,344.7,348.21,NaN,NaN,NaN,351.44902505991035,NaN,NaN,340.86929999999944,354.7337418583085,327.00485814169036,347.25705054059847,350.91077573601206,353.80318527466204,348.01836619736207,166724,195660.9,57.46616437255278,67.70430643177433,NaN,NaN,NaN,NaN,2.1843215085527823,41.45617743543956,96744693,-0.8309162426038035,1.9006121213184883,2.731528363922292
2025-09-05T10:55:00-04:00,348.18,349.17,346.62,346.64,NaN,NaN,NaN,351.44902505991035,NaN,NaN,341.1210999999995,354.93822651611083,327.30397348388817,344.3456404324788,350.8108467556901,353.718727659687,347.9029658516932,149610,199257.26666666666,52.638496066129065,64.69939856595477,NaN,NaN,NaN,NaN,2.210441400799013,39.795024411532815,96595083,-0.8458055288273139,1.6742714528881493,2.520076981715463
2025-09-05T11:00:00-04:00,346.62,347.08,345.28,345.91,NaN,NaN,NaN,351.44902505991035,NaN,NaN,341.35449999999946,355.09283341429415,327.6161665857048,343.15936276553174,350.7302656483338,353.67735841753523,347.78317287913234,89284,200959.33333333334,50.51358247637907,61.51491038562053,NaN,NaN,NaN,NaN,2.1811241578847986,37.496671460621215,96505799,-0.8803612769191096,1.419625385566576,2.2999866624856855
2025-09-05T11:05:00-04:00,345.93,346.83,345.63,345.85,NaN,NaN,NaN,351.44902505991035,NaN,NaN,341.5706999999994,355.2448275422764,327.8965724577224,343.15936276553174,350.648096473667,353.63214623235007,347.66404671498395,94571,200915.46666666667,50.333732654038556,58.82352716182964,NaN,NaN,NaN,NaN,2.111043860893026,35.36248657763188,96411228,-0.8806677567050252,1.1991519666044042,2.0798197233094293
2025-09-05T11:10:00-04:00,345.8,347.25,344.94,347.19,NaN,NaN,NaN,351.44902505991035,NaN,NaN,341.81289999999944,355.44752168020716,328.17827831979173,343.15936276553174,350.5622291508982,353.57457590049,347.5498824013064,111468,202907.13333333333,54.25131961627496,56.40219445752475,NaN,NaN,NaN,NaN,2.1252550136863815,32.99062246341537,96522696,-0.7681394431555095,1.1196454193650425,1.887784862520552
2025-09-05T11:15:00-04:00,347.22,347.79,346.48,346.85,NaN,NaN,NaN,351.44902505991035,NaN,NaN,342.0460999999994,355.61835645066077,328.473843549338,343.15936276553174,350.5088659578026,353.52910840048196,347.4886235151232,83636,204570.8,53.106689533248776,55.19683314558337,NaN,NaN,NaN,NaN,2.067022512708783,31.074849732532616,96439060,-0.6962503173011023,1.017471965894174,1.7137222831952763
2025-09-05T11:20:00-04:00,346.8,348.26,346.58,348.22,NaN,NaN,NaN,351.44902505991035,NaN,NaN,342.31069999999943,355.838167318106,328.78323268189285,343.4661322705968,350.46001074445184,353.47653983297164,347.44348165593203,97247,204934.1,57.039894027976906,54.74797337671095,NaN,NaN,NaN,NaN,2.039378047515299,29.544059959038645,96536307,-0.5428864933122288,1.0351141665549903,1.5780006598672192
2025-09-05T11:25:00-04:00,348.24,348.79,347.77,348.56,NaN,NaN,NaN,351.44902505991035,NaN,NaN,342.5838999999994,356.0532964661558,329.114503533843,344.44490581647744,350.421832763227,353.42369406018355,347.4199714662704,104696,206859.06666666668,57.981818158882746,54.968921202753336,NaN,NaN,NaN,NaN,1.9665653298356374,28.400313544474713,96641003,-0.41099033763440884,1.0642627378242082,1.475253075458617
2025-09-05T11:30:00-04:00,348.6,349.17,348.06,348.15,NaN,NaN,NaN,351.44902505991035,NaN,NaN,342.8380999999994,356.23816953573527,329.4380304642635,345.13892465318196,350.38708357415635,353.3734734394841,347.4006937088286,103185,209112.83333333334,56.37658196338427,54.948562746336634,NaN,NaN,NaN,NaN,1.9053820919902356,27.53686158395873,96537818,-0.34639043273377257,1.0422650345414013,1.3886554672751739
2025-09-05T11:35:00-04:00,348.22,349.47,347.92,348.77,NaN,NaN,NaN,351.44902505991035,NaN,NaN,343.1166999999994,356.4189110358562,329.81448896414264,345.4701397225456,350.3609939098975,353.33113928289157,347.39084853690343,92618,210240.53333333333,58.258528930636565,54.94320020209974,NaN,NaN,NaN,NaN,1.8799976568480765,26.894155509570123,96630436,-0.26083526024046,1.062611391974599,1.323446652215059
2025-09-05T11:40:00-04:00,348.81,349.5,348.76,349.06,NaN,NaN,NaN,351.44902505991035,NaN,NaN,343.39269999999937,356.603745410664,330.18165458933476,345.93011177803646,350.34474133823767,353.2989891376805,347.39049353879483,77689,211197.43333333332,59.14631818457835,54.977724235012246,NaN,NaN,NaN,NaN,1.7985692527875001,26.313984199592884,96708125,-0.18709600824653694,1.0895766419068877,1.2766726501534247
2025-09-05T11:45:00-04:00,349.02,349.02,347.74,348.82,NaN,NaN,NaN,351.44902505991035,NaN,NaN,343.6630999999994,356.7534154875028,330.572784512496,345.93011177803646,350.3230258766724,353.26621204146034,347.3798397118844,72481,211661.66666666666,58.04601475061083,55.04284591625861,NaN,NaN,NaN,NaN,1.7643857347312495,24.971674893126966,96635644,-0.15802521192197982,1.07914113525095,1.2371663471729297
2025-09-05T11:50:00-04:00,348.84,349.05,347.61,348.15,NaN,NaN,NaN,351.44902505991035,NaN,NaN,343.91709999999944,356.8520324065617,330.98216759343717,345.93011177803646,350.30481038645763,353.2412288066716,347.3683919662437,54323,209041.13333333333,54.97154019846091,54.98244780021115,NaN,NaN,NaN,NaN,1.7412153251075888,23.626678333438893,96581321,-0.18555710143817739,1.005219970375208,1.1907770718133854
2025-09-05T11:55:00-04:00,348.15,348.5,346.93,346.96,NaN,NaN,NaN,351.44902505991035,NaN,NaN,344.13649999999944,356.89712525906737,331.3758747409315,345.93011177803646,350.2737819889214,353.20901625392656,347.3385477239163,67596,206340.53333333333,49.914651656815145,55.00323804214067,NaN,NaN,NaN,NaN,1.7289856590284747,22.01152201844915,96513725,-0.2798854537370512,0.8409202546420715,1.1208057083791227
2025-09-05T12:00:00-04:00,346.97,347.42,346.18,346.44,NaN,NaN,NaN,351.44902505991035,NaN,NaN,344.3456999999994,356.9059829602865,331.7854170397123,345.93011177803646,350.2230844518209,353.1681965792585,347.2779723243833,88575,181261.93333333332,47.843511042353356,54.315905661412145,NaN,NaN,NaN,NaN,1.6940581119550129,21.035963051377614,96425150,-0.3677399364259597,0.6611307878466732,1.028870724272633
2025-09-05T12:05:00-04:00,346.48,347.04,345.81,346.96,NaN,NaN,NaN,351.4094508244258,NaN,NaN,344.57689999999945,356.8932150155488,332.26058498445013,345.93011177803646,350.16418579875284,353.120920702222,347.20745089528367,103855,174419.6,50.07445685669364,54.13276000359533,NaN,NaN,NaN,NaN,1.6609111039582276,20.378177508765464,96529005,-0.3797227218362057,0.5542173219773758,0.9339400438135815
2025-09-05T12:10:00-04:00,346.94,347.62,346.91,347.38,NaN,NaN,NaN,351.4094508244258,NaN,NaN,344.80589999999944,356.8942799891606,332.71752001083826,345.93011177803646,350.1380857983208,353.09384477747517,347.1823268191664,58766,157503.7,51.865347808552684,54.229314670179164,NaN,NaN,NaN,NaN,1.5929888822469243,19.28706839652187,96587771,-0.3490387413480929,0.49764161712846544,0.8466803584765583
2025-09-05T12:15:00-04:00,347.34,347.55,346.68,347.24,NaN,NaN,NaN,351.4094508244258,NaN,NaN,345.0322999999995,356.86788840286937,333.19671159712965,345.93011177803646,350.1182530365519,353.07411691158387,347.1623891615199,43136,146946.66666666666,51.205975931013356,54.29161776139165,NaN,NaN,NaN,NaN,1.5413468192292872,18.443602922652683,96544635,-0.32816292539061787,0.436476701738286,0.7646396271289039
2025-09-05T12:20:00-04:00,347.33,347.8,346.43,347.78,NaN,NaN,NaN,351.4094508244258,NaN,NaN,345.2703999999995,356.8354284635248,333.70537153647416,345.93011177803646,350.0992277394321,353.0538732651225,347.14458221374167,44658,132013.13333333333,53.65346523040336,54.24891387668653,NaN,NaN,NaN,NaN,1.5291077607129098,17.660384982631292,96589293,-0.27038506062988543,0.42665830134154703,0.6970433619714325
2025-09-05T12:25:00-04:00,347.79,348,347.42,347.77,NaN,NaN,NaN,351.4094508244258,NaN,NaN,345.50439999999946,356.78530911949247,334.22349088050646,345.93011177803646,350.0807388918884,353.031207751626,347.1302700321508,51353,124305.76666666666,53.59984747329253,54.28413944383251,NaN,NaN,NaN,NaN,1.461314349233415,16.744046544284103,96537940,-0.22698997058817638,0.41330589873621193,0.6402958693243883
2025-09-05T12:30:00-04:00,347.8,347.98,347.16,347.32,NaN,NaN,NaN,351.4094508244258,NaN,NaN,345.7271999999994,356.6984582980445,334.7559417019543,345.5172715379433,350.06054388587415,353.0083354223686,347.1127523493797,51632,116904.13333333333,51.12395104033001,53.86157208757202,NaN,NaN,NaN,NaN,1.4155061814310277,16.119723204478223,96486308,-0.2224469834481495,0.3622371400142015,0.584684123462351
2025-09-05T12:35:00-04:00,347.32,347.53,346.86,347.31,NaN,NaN,NaN,351.4094508244258,NaN,NaN,345.9467999999994,356.591584781401,335.30201521859783,345.5172715379433,350.03481969937155,352.9814240533796,347.0882153453635,60899,111168.86666666667,51.06749821628951,53.36769209167251,NaN,NaN,NaN,NaN,1.362255739900237,15.80131594687027,96425409,-0.21390711885787694,0.31730022489000476,0.5312073437478817
2025-09-05T12:40:00-04:00,347.32,348.51,347.24,348.2,NaN,NaN,NaN,351.4094508244258,NaN,NaN,346.1787999999994,356.4993274207514,335.8582725792474,345.9622637460655,350.0155462724882,352.95494659737557,347.0761459476009,63477,104529.6,55.75069499096845,53.32298587935709,NaN,NaN,NaN,NaN,1.355666044193076,14.818534244595153,96488886,-0.14538632769876025,0.34947443412443135,0.4948607618231916
2025-09-05T12:45:00-04:00,348.18,348.52,347.76,348.235,NaN,NaN,NaN,351.4094508244258,NaN,NaN,346.4062999999994,356.39115329098246,336.4214467090164,346.10181099685235,350.00259562376544,352.93570006699684,347.06949118053404,47791,96234.8,55.92932622429589,53.15661425747561,NaN,NaN,NaN,NaN,1.3131184696078555,13.915375290889385,96536677,-0.09709536460236545,0.37349155607023476,0.4705869206726002
2025-09-05T12:50:00-04:00,348.22,348.59,347.97,348.34,NaN,NaN,NaN,351.4094508244258,NaN,NaN,346.6266999999994,356.28057271733536,336.97282728266345,346.34544879748194,349.99205762357286,352.91911839663163,347.0649968505141,42377,93318.46666666666,56.49671266982775,52.967356720707706,NaN,NaN,NaN,NaN,1.263610007493005,13.1469617725474,96579054,-0.059327021457839524,0.3964281438503008,0.4557551653081403
2025-09-05T12:55:00-04:00,348.34,349.07,348.18,349.03,NaN,NaN,NaN,351.4094508244258,NaN,NaN,346.8632999999994,356.15449983868916,337.57210016130966,346.82935903798557,349.97810729120016,352.8914674915627,347.0647470908376,78412,88745.13333333333,60.12938845027948,53.11616912782689,NaN,NaN,NaN,NaN,1.2369235783863608,12.911396710588402,96657466,0.007334620016882898,0.46492344032924393,0.45758882031236103
2025-09-05T13:00:00-04:00,349.04,349.1,348.61,348.88,NaN,NaN,NaN,351.4094508244258,NaN,NaN,347.0902999999994,356.0052764801972,338.17532351980157,347.06248723038846,349.9705524597774,352.87546408044653,347.0656408391083,47252,85791.9,58.97643979646306,53.402233384827056,NaN,NaN,NaN,NaN,1.183571894215907,12.722466728385603,96610214,0.034987953040085895,0.5013237616124684,0.4663358085723825
2025-09-05T13:05:00-04:00,348.85,349.62,348.54,349.59,NaN,NaN,NaN,351.4094508244258,NaN,NaN,347.3444999999994,355.7930618304176,338.8959381695812,347.4499897843108,349.9629189782114,352.85334396188495,347.07249399453787,74656,84965.36666666667,62.62909415317915,54.31040784885305,NaN,NaN,NaN,NaN,1.1761739017719124,13.056837516646826,96684870,0.09154544689115396,0.580767617186325,0.489222170295171
2025-09-05T13:10:00-04:00,349.55,350.54,349.25,350.38,NaN,NaN,NaN,351.4094508244258,NaN,NaN,347.61679999999944,355.54552518393643,339.68807481606245,348.15899182744863,349.9649372313227,352.8241119572294,347.10576250541607,155051,86122.83333333333,66.23185819085214,55.623861216602926,NaN,NaN,NaN,NaN,1.1843043373596345,14.143746864359413,96839921,0.1681514340122423,0.699411462810474,0.5312600287982316
2025-09-05T13:15:00-04:00,350.37,351.55,350.3,351.49,347.0053786055791,347.0053786055791,347.0053786055791,NaN,NaN,NaN,347.8995999999994,355.33682659076936,340.46237340922943,349.0201934619589,349.98753232832246,352.8229289595273,347.1521356971176,144548,84052.2,70.53070968187231,57.08502213268712,NaN,NaN,NaN,NaN,1.1889968846910892,15.842831555988553,96984469,0.2733460171707842,0.8729425502617119,0.5995965330909276
2025-09-05T13:20:00-04:00,351.48,353,351.46,352.2,348.27854321441646,NaN,NaN,NaN,NaN,NaN,348.1947999999995,355.10066590096983,341.2889340990291,350.2061547695671,350.04379723931174,352.8650201912335,347.22257428739,189945,84826.23333333334,72.90661234060696,58.58796959926242,NaN,NaN,NaN,NaN,1.2140685357845844,18.18444356613583,97174414,0.36479482820512055,1.0555900683473283,0.6907952401422077
2025-09-05T13:25:00-04:00,352.3,352.88,351.81,352.08,348.4272457955793,NaN,NaN,NaN,NaN,NaN,348.4825999999994,354.7865023598406,342.17869764015825,350.2061547695671,350.07345023881726,352.8872343952455,347.259666082389,102364,83251.36666666667,71.85220924347122,60.06270055015227,NaN,NaN,NaN,NaN,1.2037779260856851,20.358797575558302,97072050,0.3890340556128764,1.1770878096583033,0.7880537540454269
2025-09-05T13:30:00-04:00,352.04,352.27,351.25,351.89,348.4272457955793,NaN,NaN,NaN,NaN,NaN,348.7463999999994,354.4677383191654,343.02506168083346,350.2061547695671,350.09523038976425,352.89788983485454,347.29257094467397,97405,83522.06666666667,70.12296218383162,61.23909318968286,NaN,NaN,NaN,NaN,1.1906509313652778,21.61724763704689,96974645,0.3645230339418687,1.2437075464727627,0.879184512530894
2025-09-05T13:35:00-04:00,351.93,352.28,350.87,351.26,348.4272457955793,NaN,NaN,NaN,NaN,NaN,348.99899999999946,353.9786200660564,344.0193799339425,350.2061547695671,350.11282580045497,352.90177661665314,347.3238749842568,100300,83713.03333333334,64.5735943447003,62.02293225192627,NaN,NaN,NaN,NaN,1.2063187219820415,22.295483694580387,96874345,0.2818306150466161,1.2314727813391642,0.949642166292548
2025-09-05T13:40:00-04:00,351.3,351.4,349.56,350.42,348.4272457955793,NaN,NaN,NaN,NaN,NaN,349.0191999999994,354.01349769261594,344.02490230738283,350.2061547695671,350.11686789883794,352.88978561159445,347.34395018608143,92316,83074.63333333333,57.98459713766265,62.512978401735744,NaN,NaN,NaN,NaN,1.2515816704118936,21.465171511155987,96782029,0.15296203839144518,1.1408447142818545,0.9878826758904093
2025-09-05T13:45:00-04:00,350.43,351.02,349.81,350.34,348.4272457955793,NaN,NaN,NaN,NaN,NaN,349.0170999999994,354.0090856132072,344.0251143867916,350.2061547695671,350.1192233090554,352.8802742231753,347.35817239493554,68972,82585.83333333333,57.38404474290186,62.96416029649377,NaN,NaN,NaN,NaN,1.2486115510967568,20.69416734083333,96713057,0.05005943744160524,1.050456972692416,1.0003975352508108
2025-09-05T13:50:00-04:00,350.27,350.77,349.98,349.995,348.4272457955793,NaN,NaN,NaN,NaN,NaN,348.9343999999994,353.7174666483368,344.151333351662,350.2061547695671,350.11993017250506,352.8734289667285,347.3664313782816,44029,80811.9,54.75050324682054,62.89271802905464,NaN,NaN,NaN,NaN,1.2158535831612716,19.97823489696229,96669028,-0.048199645095950316,0.9401479788808729,0.9883476239768232
2025-09-05T13:55:00-04:00,349.98,350.31,349.25,350.14,348.4272457955793,NaN,NaN,NaN,NaN,NaN,348.8469999999994,353.37209270650294,344.3219072934959,350.2061547695671,350.11812439102437,352.86036762347544,347.3758811585733,66577,79541.26666666666,55.67130792580947,62.87428815059132,NaN,NaN,NaN,NaN,1.2047211843640382,18.562814313878295,96735605,-0.10701684476893125,0.8545765680156592,0.9615934127845904
2025-09-05T14:00:00-04:00,350.17,350.3,349.6,349.81,348.4272457955793,NaN,NaN,NaN,NaN,NaN,348.7283999999994,352.8141451905965,344.6426548094023,350.2061547695671,350.11661711996624,352.84928054974796,347.3839536901845,57303,78011.86666666667,53.026597391021106,62.626422773533704,NaN,NaN,NaN,NaN,1.1686696711951774,17.248495201014585,96678302,-0.16809881885785338,0.7514698892122738,0.9195687080701271
2025-09-05T14:05:00-04:00,349.83,350.23,349.42,349.91,348.4272457955793,NaN,NaN,NaN,NaN,NaN,348.63679999999937,352.3938950270898,344.87970497290894,350.2061547695671,350.1145576174626,352.83661093798736,347.39250429693783,64380,77070.6,53.743711467299896,62.170302989035164,NaN,NaN,NaN,NaN,1.1430504089669509,16.22224654092283,96742682,-0.19957356500721934,0.670101751811103,0.8696753168183223
2025-09-05T14:10:00-04:00,349.91,351.19,349.83,351.17,348.4272457955793,NaN,NaN,NaN,NaN,NaN,348.5667999999994,351.9869712007693,345.14662879922946,350.1099238156537,350.1210708933187,352.8294143514202,347.41272743521716,88033,77415.4,61.68150652194874,62.363522040855564,NaN,NaN,NaN,NaN,1.1585468083264554,15.851628840266695,96830715,-0.13635775751587764,0.6992281199234753,0.835585877439353
2025-09-05T14:15:00-04:00,351.17,352.04,351,351.87,348.4272457955793,NaN,NaN,NaN,NaN,NaN,348.58679999999936,352.0716935482346,345.10190645176414,349.54393905252294,350.1394446386827,352.8364261534606,347.44246312390476,102081,78402.06666666667,65.24933819447175,62.55068232951931,NaN,NaN,NaN,NaN,1.1500791791602814,16.233399522618946,96932796,-0.05253272737744208,0.7699199682175504,0.8224526955949925
2025-09-05T14:20:00-04:00,351.82,351.95,351.06,351.18,348.4272457955793,NaN,NaN,NaN,NaN,NaN,348.6289999999993,352.1866194291682,345.07138057083034,349.3941512420183,350.1487549672307,352.8378928353274,347.45961709913394,62822,78685.36666666667,59.3802124829475,62.06127906466899,NaN,NaN,NaN,NaN,1.131502094934546,16.587900870517466,96869974,-0.04877130233956206,0.7614885676705399,0.8102598700101019
2025-09-05T14:25:00-04:00,351.2,351.37,350.93,351.18,348.4272457955793,NaN,NaN,NaN,NaN,NaN,348.7251999999993,352.2933927978732,345.1570072021254,349.3573025731521,350.15465512425715,352.83704246691303,347.47226778160126,49786,78091.7,59.3802124829475,61.26481497903149,NaN,NaN,NaN,NaN,1.082109088153507,16.745158464310677,96869974,-0.05124402630726932,0.7462048371260153,0.7974488634332846
2025-09-05T14:30:00-04:00,351.15,351.54,351.09,351.17,348.4272457955793,NaN,NaN,NaN,NaN,NaN,348.8057999999993,352.40901376589824,345.20258623410035,349.47967364681733,350.1655167142754,352.83701121163375,347.494022216917,84168,77944.8,59.290572200070855,60.29224068327892,NaN,NaN,NaN,NaN,1.0369584389996882,17.04900447601195,96785806,-0.05801595095633405,0.724928924737867,0.782944875694201
2025-09-05T14:35:00-04:00,351.22,351.24,350.2,350.36,348.4272457955793,NaN,NaN,NaN,NaN,NaN,348.8555999999993,352.47449687097816,345.23670312902044,349.47967364681733,350.16917107823156,352.82970301090864,347.50863914555447,73092,76919.36666666667,52.391481525736914,58.90218870344075,NaN,NaN,NaN,NaN,1.0371756933568548,16.181715903829627,96712714,-0.11804943678942181,0.6353830797074238,0.7534325164968456
2025-09-05T14:40:00-04:00,350.36,350.44,349.72,349.87,348.4272457955793,NaN,NaN,NaN,NaN,NaN,348.89279999999934,352.51440139201094,345.27119860798774,349.47967364681733,350.1679354158194,352.81815704722095,347.5177137844178,67991,77226.86666666667,48.69976124159217,57.371960064709356,NaN,NaN,NaN,NaN,1.014520286688506,15.212694591842407,96644723,-0.18762847182970455,0.518896926709715,0.7065253985394195
2025-09-05T14:45:00-04:00,349.89,349.98,349.4,349.65,348.4272457955793,NaN,NaN,NaN,NaN,NaN,348.9343999999993,352.542025058502,345.3267749414966,349.47967364681733,350.162408753522,352.7981903219572,347.52662718508685,99649,79110.63333333333,47.09520092762117,56.12350339206085,NaN,NaN,NaN,NaN,0.9834831233536155,14.653458273393879,96545074,-0.24188461172291809,0.4041696338857719,0.64605424560869
2025-09-05T14:50:00-04:00,349.66,350.06,348.14,348.29,NaN,NaN,NaN,352.51081807575446,352.51081807575446,352.51081807575446,348.9561999999993,352.534694968937,345.37770503106157,349.47967364681733,350.14186599791583,352.7623967349636,347.52133526086806,138707,82245.6,38.623321846743586,54.74055515699519,NaN,NaN,NaN,NaN,1.0503771859712157,15.271487113841179,96406367,-0.35589329407834625,0.20118762801075718,0.5570809220891034
2025-09-05T14:55:00-04:00,348.31,348.89,347.87,348.75,NaN,NaN,NaN,351.77487179958376,NaN,NaN,349.0243999999992,352.45139147401125,345.5974085259872,349.47967364681733,350.1255594819798,352.7380855941891,347.5130333697705,90433,83548.26666666666,42.39770910206589,53.670102611221196,NaN,NaN,NaN,NaN,1.0482073869732704,16.054414600085856,96496800,-0.3844178879753291,0.07655856211994205,0.46097645009527116
2025-09-05T15:00:00-04:00,348.7,349.3,348,349.17,NaN,NaN,NaN,351.77487179958376,NaN,NaN,349.0435999999993,352.46287363086185,345.6243263691367,349.47967364681733,350.11136842770384,352.7131355965607,347.509601258847,100117,85164.43333333333,45.682152421649356,53.02236326656611,NaN,NaN,NaN,NaN,1.0661925736180378,16.251802706369,96596917,-0.35954394540806145,0.011546518335194378,0.3710904637432558
2025-09-05T15:05:00-04:00,349.12,349.57,348.55,349.13,NaN,NaN,NaN,351.77487179958376,NaN,NaN,349.09339999999924,352.44301576346413,345.74378423653434,349.47967364681733,350.10301419427856,352.695831547702,347.5101968408551,75270,85643.46666666666,45.4165502979528,52.289880578862075,NaN,NaN,NaN,NaN,1.062893104073891,16.09569172973304,96521647,-0.33104141983449004,-0.042711311049856704,0.28833010878463333
2025-09-05T15:10:00-04:00,349.11,349.73,348.95,349.68,NaN,NaN,NaN,351.77487179958376,NaN,NaN,349.16879999999924,352.3958714654106,345.94172853458787,349.47967364681733,350.0972888514704,352.67937029320234,347.5152074097385,82351,86272.6,49.743341847040035,52.055362325720566,NaN,NaN,NaN,NaN,1.0426864537829008,15.747970949887907,96603998,-0.26335178620761207,-0.04085962397488174,0.22249216223273033
2025-09-05T15:15:00-04:00,349.68,349.88,349.3,349.54,NaN,NaN,NaN,351.77487179958376,NaN,NaN,349.24259999999924,352.3283856313798,346.1568143686187,349.47967364681733,350.0912130614692,352.65889272776167,347.52353339517674,109633,88334,48.685419147311364,51.69405573143566,NaN,NaN,NaN,NaN,1.0096374213698354,15.230364042633354,96494365,-0.21808279092272548,-0.050111326420676505,0.16797146450204897
2025-09-05T15:20:00-04:00,349.64,349.68,349,349.24,NaN,NaN,NaN,351.77487179958376,NaN,NaN,349.2835999999993,352.313170293415,346.2540297065836,349.07173891745384,350.08726810215114,352.64908515778836,347.5254510465139,47780,88514.1,46.40776622943795,50.60307428197061,NaN,NaN,NaN,NaN,0.9860918912719905,15.077441258706228,96446585,-0.19895346434373384,-0.08072036592761833,0.11823309841611551
2025-09-05T15:25:00-04:00,349.21,349.4,348.47,348.8,NaN,NaN,NaN,351.77487179958376,NaN,NaN,349.3225999999993,352.2750784440672,346.37012155593135,348.34539113396306,350.0806821180576,352.63697766429726,347.52438657181796,52559,87652.33333333333,43.21450615778573,49.02915770792161,NaN,NaN,NaN,NaN,0.9820853276097018,15.476093537492824,96394026,-0.20569178435403276,-0.13888163202642545,0.06681015232760731
2025-09-05T15:30:00-04:00,348.82,349.18,348.1,348.38,NaN,NaN,NaN,351.77487179958376,NaN,NaN,349.3257999999993,352.2738348442175,346.37776515578105,348.01431290717045,350.07041172504756,352.62115412812625,347.5196693219689,64684,88233.4,40.35972315894687,47.67055132763585,NaN,NaN,NaN,NaN,0.9890792327804362,16.19453744319084,96329342,-0.22654504377737977,-0.21637115239411742,0.010173891383262357
2025-09-05T15:35:00-04:00,348.35,348.97,348.04,348.3,NaN,NaN,NaN,351.6916607281916,NaN,NaN,349.32059999999933,352.2749301377153,346.3662698622834,347.5800381227373,350.06198976304194,352.6088378705921,347.5151416554918,49845,87406.36666666667,39.8201236673993,46.27340212652526,NaN,NaN,NaN,NaN,0.984859287581834,16.91814026731992,96279497,-0.23293776377759207,-0.2809983133387277,-0.04806054956113566
2025-09-05T15:40:00-04:00,348.31,348.75,348.1,348.52,NaN,NaN,NaN,351.5554488769102,NaN,NaN,349.3279999999993,352.27240146764865,346.38359853234994,347.5800381227373,350.0521658697873,352.59429393048686,347.51003780908775,59536,84222.53333333334,42.11219339178743,45.04637506879074,NaN,NaN,NaN,NaN,0.9609407670402729,17.590057175439778,96339033,-0.21025556944121607,-0.31088001136265575,-0.10062444192143968
2025-09-05T15:45:00-04:00,348.5,348.83,348.32,348.63,NaN,NaN,NaN,351.5554488769102,NaN,NaN,349.3251999999993,352.27198398303756,346.37841601696107,347.5800381227373,350.0423467926082,352.5787115089229,347.50598207629355,65926,81601.8,43.27552021826786,44.39523497540009,NaN,NaN,NaN,NaN,0.9287307122516814,18.068221187186644,96404959,-0.17707954822792546,-0.3219738772063465,-0.14489432897842106
2025-09-05T15:50:00-04:00,348.62,350.835,348.55,350.6,NaN,NaN,NaN,351.5554488769102,NaN,NaN,349.3559999999993,352.3231744139217,346.3888255860769,348.0973988749175,350.04113920482575,352.54496093138596,347.53731747826555,256354,83815.43333333333,59.1201518573668,45.139548590812566,NaN,NaN,NaN,NaN,1.0256070899479874,17.73840408332955,96661313,-0.01996088666936885,-0.16984543731513213,-0.14988455064576328
2025-09-05T15:55:00-04:00,350.6,351.28,350.46,350.79,NaN,NaN,NaN,351.5554488769102,NaN,NaN,349.39539999999926,352.3852895235081,346.4055104764904,348.679919099934,350.06264516322375,352.5360727972821,347.5892175291654,276881,89632.66666666667,60.27273522551021,46.08080104066179,NaN,NaN,NaN,NaN,1.0109208692374163,17.850427231098266,96938194,0.0930562541273939,-0.03356423298652089,-0.1266204871139148
2025-09-08T09:30:00-04:00,354.7,358.48,353.85,354.34,352.0663123760742,352.0663123760742,352.0663123760742,NaN,NaN,NaN,349.51919999999933,352.7918101880039,346.24658981199474,352.55493527994724,355.55666666666673,355.55666666666673,355.55666666666673,422574,100471.63333333333,74.6526237949046,48.654322608387574,NaN,NaN,NaN,NaN,1.487997950006172,21.073018392162084,97360768,0.386722127227384,0.35678217192031525,-0.029939955307068777
2025-09-08T09:35:00-04:00,354.37,354.89,352.51,353.65,352.0663123760742,NaN,NaN,NaN,NaN,NaN,349.6529999999993,353.04113931276646,346.2648606872321,352.55493527994724,354.92173259494496,355.808469244456,354.03499594543393,216656,104350.16666666667,69.39487677623325,50.58269172797095,NaN,NaN,NaN,NaN,1.551712382148588,22.926590357949962,97144112,0.5067523631191059,0.6035004985918135,0.09674813547270769
2025-09-08T09:40:00-04:00,353.68,355.12,351.89,352.07,NaN,NaN,NaN,357.9369290955655,357.9369290955655,357.9369290955655,349.7655999999993,353.0927992069383,346.43840079306034,352.55493527994724,354.4972806734278,355.60831306813674,353.3862482787188,184496,107422.83333333333,59.12594267227297,51.54296246015836,NaN,NaN,NaN,NaN,1.671590069137976,24.15962121119771,96959616,0.45370625024528466,0.6638809482793135,0.21017469803402888
2025-09-08T09:45:00-04:00,352.08,352.55,350.76,352.14,NaN,NaN,NaN,356.18003250236444,NaN,NaN,349.8691999999994,353.1629263763825,346.57547362361635,352.55493527994724,354.06679731082477,355.48270831794684,352.6508863037027,157591,110376.8,59.41250286819485,52.542673358032786,NaN,NaN,NaN,NaN,1.6800479213424075,24.46737888499543,97117207,0.39922505688211507,0.7092060191366727,0.3099809622545576
2025-09-08T09:50:00-04:00,352.15,354.79,351.51,354.63,NaN,NaN,NaN,356.18003250236444,NaN,NaN,350.01419999999933,353.4901259834755,346.5382740165232,352.55493527994724,354.0064032506459,355.32580003153714,352.6870064697547,163235,114350.33333333333,68.00526241013227,53.84709625539652,NaN,NaN,NaN,NaN,1.7943302126750946,25.526982564096766,97280442,0.5002292088316029,0.9352674732940613,0.4350382644624584
2025-09-08T09:55:00-04:00,354.57,354.98,353.31,353.83,NaN,NaN,NaN,356.18003250236444,NaN,NaN,350.14599999999933,353.690249991555,346.6017500084437,352.55493527994724,354.0098073591102,355.2606181140908,352.7589966041296,129044,116432.56666666667,63.36377920777992,54.89555054542999,NaN,NaN,NaN,NaN,1.7854494831983032,26.570062509920707,97151398,0.48229352091164324,1.0379051656020124,0.5556116446903692
2025-09-08T10:00:00-04:00,353.83,353.98,351.75,352.45,NaN,NaN,NaN,356.18003250236444,NaN,NaN,350.23939999999936,353.7754501357424,346.7033498642563,352.55493527994724,353.9178061361093,355.16758098170163,352.6680312905169,98370,117801.46666666666,56.23384059671003,55.597413000235136,NaN,NaN,NaN,NaN,1.8172030915412827,26.46097261770683,97053028,0.35263537450091764,0.9964058628165162,0.6437704883155986
2025-09-08T10:05:00-04:00,352.4,352.72,351.43,351.76,NaN,NaN,NaN,356.18003250236444,NaN,NaN,350.3191999999994,353.8085153257449,346.8298846742539,352.55493527994724,353.7743367660192,355.0803830009304,352.468290531108,109090,119291.8,53.02129195468755,56.29789770001384,NaN,NaN,NaN,NaN,1.779545727859764,26.15217763333516,96943938,0.20297911050153983,0.8974943764425234,0.6945152659409836
2025-09-08T10:10:00-04:00,351.81,352.3,350.2,350.93,NaN,NaN,NaN,356.1366986133157,NaN,NaN,350.39139999999935,353.77735631434297,347.00544368565573,352.55493527994724,353.5605673494893,355.00413739776667,352.11699730121194,130978,120723.3,49.36779004970254,56.941331049353536,NaN,NaN,NaN,NaN,1.8024353187269253,25.100076654909753,96812960,0.03923653909378855,0.7435609398082192,0.7043244007144307
2025-09-08T10:15:00-04:00,350.92,352.13,350.55,351.52,NaN,NaN,NaN,356.1366986133157,NaN,NaN,350.4755999999993,353.75868369719154,347.19251630280706,352.55493527994724,353.43645724652174,354.92539433105526,351.9475201619882,98244,120595.4,51.90478445964466,57.80452110594249,NaN,NaN,NaN,NaN,1.786547081675001,24.123125746371873,96911204,-0.03421974612361145,0.6615497180599164,0.6957694641835278
2025-09-08T10:20:00-04:00,351.57,352.07,351.02,351.36,NaN,NaN,NaN,356.1366986133157,NaN,NaN,350.5387999999993,353.7654028951257,347.3121971048729,349.0043707925331,353.3653569291618,354.87202286187244,351.8586909964512,64612,120655.06666666667,51.15619532701448,58.450521244173,NaN,NaN,NaN,NaN,1.7339365758410732,23.2159570455867,96846592,-0.09502089058097485,0.5769933509573093,0.6720142415382842
2025-09-08T10:25:00-04:00,351.42,352.5,350.98,352.35,NaN,NaN,NaN,356.1366986133157,NaN,NaN,350.62109999999933,353.8182407792953,347.42395922070335,349.0043707925331,353.29381284072747,354.79462992179094,351.792995759664,94028,122129.8,55.438664268072685,59.31931724773049,NaN,NaN,NaN,NaN,1.7186553918524239,22.607002530028247,96940620,-0.07109585629853454,0.583144421165116,0.6542402774636505
2025-09-08T10:30:00-04:00,352.38,352.45,351.06,351.54,NaN,NaN,NaN,356.1366986133157,NaN,NaN,350.68509999999935,353.82462256921985,347.54557743077885,349.0043707925331,353.235667124997,354.7394588654559,351.7318753845381,70004,121657.66666666667,51.462960563838344,58.772375012478456,NaN,NaN,NaN,NaN,1.695180006720107,22.041544765581115,96870616,-0.11003003746618034,0.5167027306309251,0.6267327680971054
2025-09-08T10:35:00-04:00,351.565,351.69,350.65,350.65,NaN,NaN,NaN,355.8575730850284,NaN,NaN,350.71749999999935,353.82126432783076,347.61373567216793,349.0043707925331,353.1341749430285,354.6755454088861,351.5928044771709,92063,122290.03333333334,47.437524430830955,57.85557424142994,NaN,NaN,NaN,NaN,1.6483814348115295,21.19536519360273,96778553,-0.19117679537339916,0.3877617738803565,0.5789385692537556
2025-09-08T10:40:00-04:00,350.64,351.67,350.55,350.81,NaN,NaN,NaN,355.73722885389077,NaN,NaN,350.7560999999994,353.81517913636503,347.6970208636337,349.0043707925331,353.0443148560836,354.6121544332732,351.476475278894,89713,123014.1,48.22164186178619,55.9676469604929,NaN,NaN,NaN,NaN,1.6106399037535635,20.32941442256863,96868266,-0.22708345385295092,0.29508425193756693,0.5221677057905179
2025-09-08T10:45:00-04:00,350.8,350.85,349.74,350.3,NaN,NaN,NaN,354.8632639059867,NaN,NaN,350.77029999999934,353.8141491491452,347.7264508508535,348.21961556563025,352.8788581649668,354.5333489436062,351.2243673863274,135886,124222,45.87258572852758,54.28748331422821,NaN,NaN,NaN,NaN,1.57487991062831,18.889287162060004,96732380,-0.2749924737194155,0.17842711364124852,0.453419587360664
2025-09-08T10:50:00-04:00,350.25,351.04,349.81,349.92,NaN,NaN,NaN,354.8632639059867,NaN,NaN,350.7610999999994,353.8123838548061,347.70981614519263,348.21961556563025,352.7903265260333,354.48420653051824,351.0964465215484,78850,122226.76666666666,44.146945846921824,53.217554969560275,NaN,NaN,NaN,NaN,1.5502456312977178,17.696112736182116,96653530,-0.318989811422404,0.05468232308265897,0.373672134505063
2025-09-08T10:55:00-04:00,349.92,349.94,347.75,347.98,NaN,NaN,NaN,353.46614541847134,NaN,NaN,350.6908999999994,353.8320588247977,347.54974117520106,348.21961556563025,352.5190622981636,354.45819738485585,350.57992721147133,159883,124541.76666666666,36.58111389720289,51.58674147163227,NaN,NaN,NaN,NaN,1.595942371919309,17.6693423567216,96493647,-0.45705748263290424,-0.1976497187860673,0.25940776384683695
2025-09-08T11:00:00-04:00,347.92,349.22,347.82,348.68,NaN,NaN,NaN,353.1220024449044,NaN,NaN,350.62049999999937,353.7809368372939,347.46006316270484,348.21961556563025,352.38810756934294,354.42157970071224,350.3546354379736,85660,124059.86666666667,40.54076001646721,49.62499130065621,NaN,NaN,NaN,NaN,1.5819464882107894,17.644484147222546,96579307,-0.47732852203514475,-0.337252888697094,0.14007563333805073
2025-09-08T11:05:00-04:00,348.72,349.48,348.71,349.11,NaN,NaN,NaN,353.1220024449044,NaN,NaN,350.5610999999993,353.72122106771985,347.4009789322788,348.21961556563025,352.31824204173824,354.3851219721784,350.2513621112981,56031,123418.56666666667,42.899253335731224,48.163239452652725,NaN,NaN,NaN,NaN,1.5260931676243052,17.39360804353138,96635338,-0.4388471143135752,-0.4084832595539183,0.030363854759656916
2025-09-08T11:10:00-04:00,349.15,349.59,348.75,349.19,NaN,NaN,NaN,353.1220024449044,NaN,NaN,350.50709999999935,353.6668177662922,347.3473822337065,348.21961556563025,352.24455137218683,354.3416590738284,350.1474436705453,63341,122784.9,43.34947403467431,47.24292755536446,NaN,NaN,NaN,NaN,1.4770865127939958,17.060920495554218,96698679,-0.38689403093214925,-0.45325368390552967,-0.06635965297338041
2025-09-08T11:15:00-04:00,349.21,349.39,347.8,348.28,NaN,NaN,NaN,353.02310524438957,NaN,NaN,350.44749999999937,353.6601401918951,347.23485980810364,348.21961556563025,352.0961853712104,354.27772354526,349.91464719716083,111098,122833.73333333334,39.53125882361292,46.27935376028771,NaN,NaN,NaN,NaN,1.4851517618801373,17.38875373343713,96587581,-0.39151830613847816,-0.5557575356464781,-0.16423922950799996
2025-09-08T11:20:00-04:00,348.28,348.62,347.45,348.39,NaN,NaN,NaN,352.42137318782636,NaN,NaN,350.40689999999927,353.6708037306331,347.1429962693654,347.98655396200337,351.97238017474984,354.22681825649005,349.71794209300964,91141,124279.1,40.21673470586518,45.6257069500136,NaN,NaN,NaN,NaN,1.462640921745843,17.911166201675496,96678722,-0.3653753949647001,-0.6209584732138751,-0.255583078249175
2025-09-08T11:25:00-04:00,348.42,349.49,348.2,349.28,NaN,NaN,NaN,352.42137318782636,NaN,NaN,350.38569999999936,353.6648011028207,347.106598897178,347.98655396200337,351.89868666110914,354.1727262222772,349.62464709994106,73539,124978.43333333333,45.59094255470971,45.174718242518246,NaN,NaN,NaN,NaN,1.450309427335427,17.55516508000145,96752261,-0.27070811981948195,-0.5939682280235274,-0.3232601082040455
2025-09-08T11:30:00-04:00,349.28,349.73,348.84,349.28,NaN,NaN,NaN,352.42137318782636,NaN,NaN,350.37139999999926,353.66340245486515,347.07939754513336,347.6235945356821,351.8428913651187,354.1240631996875,349.5617195305499,64876,124984.83333333333,45.59094255470971,44.77720018735362,NaN,NaN,NaN,NaN,1.4102873253828996,17.004486967515543,96752261,-0.19423443810189311,-0.5660531558314119,-0.3718187177295188
2025-09-08T11:35:00-04:00,349.31,350.3,349.31,349.58,NaN,NaN,NaN,352.42137318782636,NaN,NaN,350.36019999999934,353.6590785734697,347.061321426529,347.6235945356821,351.78520642076387,354.061218230177,349.5091946113507,85354,126168.46666666666,47.43811061128953,44.205732069011965,NaN,NaN,NaN,NaN,1.3824096592841237,15.981267347652448,96837615,-0.11358502631929274,-0.5138000006286347,-0.400214974309342
2025-09-08T11:40:00-04:00,349.55,349.55,347.66,348,NaN,NaN,NaN,352.42137318782636,NaN,NaN,350.3239999999993,353.6853663892317,346.96263361076683,347.36451146545244,351.68672434033965,354.00032190205775,349.37312677862155,93772,127309.66666666667,39.778537963581115,43.37113045470788,NaN,NaN,NaN,NaN,1.4208089693352548,16.205973056874896,96743843,-0.1542644479881749,-0.5930455342945606,-0.43878108630638574
2025-09-08T11:45:00-04:00,348.03,348.36,346.63,346.92,NaN,NaN,NaN,351.83522706564514,NaN,NaN,350.2641999999993,353.756727085469,346.7716729145296,347.36451146545244,351.5204029669988,353.939291311773,349.1015146222246,127002,129345.53333333334,35.55280213274732,42.52222171913048,NaN,NaN,NaN,NaN,1.4428940429541666,17.003985596277385,96616841,-0.23659751764053494,-0.7345279833570544,-0.49793046571651944
2025-09-08T11:50:00-04:00,346.885,347.84,346.72,347.78,NaN,NaN,NaN,351.575671289934,NaN,NaN,350.19639999999924,353.74709291305464,346.64570708694384,347.36451146545244,351.42560058225956,353.89381260699975,348.9573885575194,79749,123458.7,40.93367642739536,42.00165275953113,NaN,NaN,NaN,NaN,1.419830182743151,17.744997240008264,96696590,-0.21637672991588652,-0.7684013781113777,-0.5520246481954911
2025-09-08T11:55:00-04:00,347.81,348.64,347.73,348.515,NaN,NaN,NaN,351.575671289934,NaN,NaN,350.1292999999992,353.6777509356766,346.5808490643218,347.36451146545244,351.3716306232055,353.8521733127184,348.8910879336926,60114,116233.13333333333,45.1487837811678,41.94995262043401,NaN,NaN,NaN,NaN,1.3834137411186378,17.66729040018915,96756704,-0.14042121993268797,-0.7275511731113511,-0.5871299531786631
2025-09-08T12:00:00-04:00,348.49,348.49,347.44,347.7,NaN,NaN,NaN,351.575671289934,NaN,NaN,350.0596999999992,353.65913462821993,346.4602653717785,347.36451146545244,351.32067462540135,353.8184484001608,348.82290085064193,51592,103867.06666666667,41.60348106395741,41.76827656450798,NaN,NaN,NaN,NaN,1.3613841881815916,17.78451448399099,96705112,-0.1321113096955152,-0.7522690902980571,-0.6201577806025419
2025-09-08T12:05:00-04:00,347.67,348.3,347.24,347.29,NaN,NaN,NaN,351.575671289934,NaN,NaN,349.9818999999992,353.6486440001932,346.3151559998052,347.36451146545244,351.2642110276928,353.78418517646304,348.74423687892255,54677,98467.76666666666,39.905807063395635,42.005754647807464,NaN,NaN,NaN,NaN,1.339856746168621,18.026401540593803,96650435,-0.14048870784795153,-0.7957686654124814,-0.6552799575645298
2025-09-08T12:10:00-04:00,347.29,347.86,347.11,347.62,NaN,NaN,NaN,351.53303910310797,NaN,NaN,349.91089999999923,353.62010567814394,346.2016943218545,347.36451146545244,351.241993382705,353.77081898077205,348.71316778463796,21507,93034.8,41.95874667893362,42.1070394094122,NaN,NaN,NaN,NaN,1.297724121442291,18.34054019101577,96671942,-0.11134095714977632,-0.7944561540017503,-0.683115196851974
2025-09-08T12:15:00-04:00,347.67,347.75,346.94,347.57,NaN,NaN,NaN,351.3194918711485,NaN,NaN,349.8550999999992,353.61914064310366,346.09105935689473,347.36451146545244,351.19170083839083,353.74130823118963,348.642093445592,48200,89388.43333333333,41.72615574051175,42.02324672403939,NaN,NaN,NaN,NaN,1.2628866841964133,18.7536006841564,96623742,-0.08419808707832155,-0.7883628056998759,-0.7041647186215544
2025-09-08T12:20:00-04:00,347.6,348.14,347.42,348.11,NaN,NaN,NaN,351.3194918711485,NaN,NaN,349.8198999999993,353.6155103544441,346.02428964555446,347.36451146545244,351.15277788644096,353.7122430666364,348.5933127062455,43697,85403.83333333333,45.25569234468246,42.15940517475426,NaN,NaN,NaN,NaN,1.2241090638966674,18.682043914072224,96667439,-0.021890385318864558,-0.731527700270135,-0.7096373149512705
2025-09-08T12:25:00-04:00,348.1,348.24,347.71,347.99,NaN,NaN,NaN,351.3194918711485,NaN,NaN,349.7866999999992,353.61655932417904,345.95684067581936,346.24160917236196,351.117682962099,353.6844938161089,348.55087210808915,41459,82484.33333333333,44.60908665424829,42.52210716265678,NaN,NaN,NaN,NaN,1.1745298450469075,18.498043519092317,96625980,0.017121913498184815,-0.6882349230785394,-0.7053568365767242
2025-09-08T12:30:00-04:00,348.01,348.06,346.95,347.47,NaN,NaN,NaN,351.2715880182857,NaN,NaN,349.7702999999993,353.6325410130354,345.90805898696317,346.0167003493784,351.06214636653436,353.6478301403549,348.4764625927138,58327,81149.56666666667,41.82063142719585,42.6366712141804,NaN,NaN,NaN,NaN,1.1699205704007007,18.942311189161515,96567653,0.01392192605778586,-0.6879544290044919,-0.7018763550622777
2025-09-08T12:35:00-04:00,347.48,347.58,346.54,347.44,NaN,NaN,NaN,350.79719765381816,NaN,NaN,349.74409999999915,353.6511836647148,345.8370163352835,346.0167003493784,350.989520110258,353.6042202529533,348.3748199675627,72695,79936.4,41.65884200191028,42.355806888980446,NaN,NaN,NaN,NaN,1.1606405296577909,19.657483128019777,96494958,0.015670768393564294,-0.6822878945703224,-0.6979586629638866
2025-09-08T12:40:00-04:00,347.4,347.87,347.18,347.58,NaN,NaN,NaN,350.79719765381816,NaN,NaN,349.7122999999992,353.6631931702766,345.76140682972175,346.0167003493784,350.95785752616985,353.5812058135227,348.334509238817,35971,76769.5,42.77150422130385,42.15441843659431,NaN,NaN,NaN,NaN,1.1270233489679484,19.942922754804293,96530929,0.03124305015114881,-0.6589048502749506,-0.6901479004260994
2025-09-08T12:45:00-04:00,347.57,347.71,346.95,347.14,NaN,NaN,NaN,350.79719765381816,NaN,NaN,349.6724999999992,353.6856574854302,345.6593425145682,346.0167003493784,350.9249304155895,353.55951237384414,348.2903484573348,35239,74669.33333333333,40.178005743719474,41.63583951748217,NaN,NaN,NaN,NaN,1.100807395470237,20.39294972347636,96495690,0.017577816946733438,-0.6681756292426826,-0.685753446189416
2025-09-08T12:50:00-04:00,347.12,347.3,346.81,347.3,NaN,NaN,NaN,350.5568686581527,NaN,NaN,349.6248999999992,353.6926593295269,345.5571406704714,346.0167003493784,350.8901299378178,353.5373702851319,348.2428895905037,36626,73736.46666666666,41.565567412790024,41.763484478139944,NaN,NaN,NaN,NaN,1.0571782957937923,20.925426026702727,96532316,0.024553964784382654,-0.6550609902089377,-0.6796149549933204
2025-09-08T12:55:00-04:00,347.29,347.4,345.87,346.12,NaN,NaN,NaN,350.1863291736912,NaN,NaN,349.55649999999923,353.74100964902544,345.371990350973,346.0167003493784,350.769336716089,353.4779885296159,348.0606849025621,111844,74330.33333333333,35.09951487179832,41.73110681664359,NaN,NaN,NaN,NaN,1.0909512746656624,22.12028678352837,96420472,-0.04146960379617215,-0.7314519597385356,-0.6899823559423635
2025-09-08T13:00:00-04:00,346.11,346.12,344.84,345.27,NaN,NaN,NaN,349.0444505748871,NaN,NaN,349.4770999999992,353.8298940868873,345.12430591311113,346.0167003493784,350.59228332191134,353.4228228355941,347.7617438082286,140037,76664.76666666666,31.319900503624226,41.04440853637423,NaN,NaN,NaN,NaN,1.1044547550466886,23.84528312853366,96280435,-0.12863256914899834,-0.8507730673786114,-0.722140498229613
2025-09-08T13:05:00-04:00,345.33,346.08,345.3,345.55,NaN,NaN,NaN,349.0444505748871,NaN,NaN,349.41209999999927,353.8984134489987,344.9257865509998,346.0167003493784,350.5367227090436,353.39921907862225,347.67422633946495,48129,75200.3,33.84698525481325,40.237137213063185,NaN,NaN,NaN,NaN,1.0834222725433538,25.44706544889571,96328564,-0.15206893242809127,-0.9122266637647272,-0.7601577313366359
2025-09-08T13:10:00-04:00,345.5,346.15,345.5,345.99,NaN,NaN,NaN,349.0444505748871,NaN,NaN,349.3642999999993,353.94354797784973,344.7850520221488,346.0167003493784,350.49062606330557,353.37598722508386,347.6052649015273,42861,73638.56666666667,37.72476884313955,39.96008634014762,NaN,NaN,NaN,NaN,1.0524635387902554,26.821848726025532,96371425,-0.12377670115869055,-0.9148786077849991,-0.7911019066263085
2025-09-08T13:15:00-04:00,346,346.86,345.99,346.8,NaN,NaN,NaN,349.0444505748871,NaN,NaN,349.3342999999992,353.96045867031216,344.7081413296862,345.7263602795027,350.44341258361277,353.34330625238,347.54351891484555,52506,70859.23333333334,44.20841964814226,40.26741581048667,NaN,NaN,NaN,NaN,1.0394304288766663,27.010013921265713,96423931,-0.04065046673762329,-0.8419149900483376,-0.8012645233107143
2025-09-08T13:20:00-04:00,346.76,347.55,346.44,347.485,NaN,NaN,NaN,349.0444505748871,NaN,NaN,349.3135999999992,353.96335011832406,344.66384988167437,345.61547057888174,350.3912715482009,353.2972098898067,347.4853332065951,70679,70586.86666666667,49.04035279725668,40.773244818938316,NaN,NaN,NaN,NaN,1.044471112528334,26.26675321070145,96494610,0.06460248663904111,-0.720511415011913,-0.7851139016509541
2025-09-08T13:25:00-04:00,347.45,347.73,347.04,347.44,NaN,NaN,NaN,349.0444505748871,NaN,NaN,349.2897999999992,353.9654128842002,344.61418711579825,345.61547057888174,350.3560291558206,353.26273451650945,347.4493237951317,53150,67029.1,48.7417048083869,41.274355466643684,NaN,NaN,NaN,NaN,1.0191517473477385,25.350592482473992,96441460,0.13147236833128362,-0.6207734412368495,-0.7522458095681331
2025-09-08T13:30:00-04:00,347.42,347.6,346.49,347.07,NaN,NaN,NaN,349.0444505748871,NaN,NaN,349.2191999999992,353.9200817729104,344.518318227088,345.5263764631054,350.3192489302394,353.23042845413084,347.4080694063479,50748,65865.36666666667,46.247848448578274,41.3452237597791,NaN,NaN,NaN,NaN,1.0256409082514726,25.0066555831635,96390712,0.1497386617375891,-0.5650724823961468,-0.7148111441337359
2025-09-08T13:35:00-04:00,347.1,347.25,346.75,346.83,NaN,NaN,NaN,349.0444505748871,NaN,NaN,349.1399999999992,353.8657240718066,344.4142759281918,345.50232517858836,350.28795787947774,353.20361721406454,347.37229854489095,42633,65418.76666666667,44.651949650149675,41.348285402343485,NaN,NaN,NaN,NaN,0.9880951290906531,24.687285605232333,96348079,0.14453862992748068,-0.5341378567243851,-0.6786764866518658
2025-09-08T13:40:00-04:00,346.825,346.95,346.47,346.91,NaN,NaN,NaN,349.0444505748871,NaN,NaN,348.9913999999992,353.5167477394406,344.46605226055783,345.50232517858836,350.26499269415103,353.18485213757197,347.3451332507301,30281,64316.76666666667,45.3291744833003,41.598895620636654,NaN,NaN,NaN,NaN,0.9518026198698895,24.652739672920696,96378360,0.14499517399695994,-0.4974325191556659,-0.6424276931526258
2025-09-08T13:45:00-04:00,346.93,347.23,346.69,346.75,NaN,NaN,NaN,349.0444505748871,NaN,NaN,348.8533999999992,353.22012666453907,344.4866733354594,345.50232517858836,350.2418374895643,353.16496923828515,347.3187057408435,31984,61679.63333333333,44.165247085963955,41.77792455521192,NaN,NaN,NaN,NaN,0.9223881470220416,24.20051879508747,96346376,0.13332650479992425,-0.4757695621527205,-0.6090960669526447
2025-09-08T13:50:00-04:00,346.77,347,345.43,346.26,NaN,NaN,NaN,349.0444505748871,NaN,NaN,348.73719999999923,353.06439639521676,344.4100036047817,345.50232517858836,350.19141645231326,353.13030188823245,347.2525310163941,59336,60619.46666666667,40.71710060449719,41.63118143972572,NaN,NaN,NaN,NaN,0.9686461365204667,24.869622342977756,96287040,0.09330597061921209,-0.4924636036786296,-0.5857695742978417
2025-09-08T13:55:00-04:00,346.27,346.35,345.4,345.63,NaN,NaN,NaN,349.03616243195046,NaN,NaN,348.6069999999992,352.9084964841255,344.30550351587283,345.50232517858836,350.14427118254713,353.1022415808776,347.18630078421666,51157,59873.4,36.744899241767186,41.38595954672913,NaN,NaN,NaN,NaN,0.9673142696261509,25.513535948068927,96235883,0.028465843150888404,-0.5501872703592312,-0.5786531135101196
2025-09-08T14:00:00-04:00,345.68,345.76,344.9,345.37,NaN,NaN,NaN,348.4647459577709,NaN,NaN,348.4217999999992,352.45934963348384,344.3842503665146,345.50232517858836,350.0468349872411,353.051881602492,347.04178837199015,98862,61006.26666666667,35.217911702224626,40.932555567403035,NaN,NaN,NaN,NaN,0.9596489646528553,26.48341916219502,96137021,-0.024984041731677564,-0.6098831656747166,-0.584899123943039
2025-09-08T14:05:00-04:00,345.41,345.93,345.35,345.7,NaN,NaN,NaN,348.4647459577709,NaN,NaN,348.25919999999917,352.0603600128092,344.4580399871891,345.50232517858836,350.0078734633451,353.0277248820914,346.98802204459884,43651,59616.166666666664,38.69988166603077,41.18972462413393,NaN,NaN,NaN,NaN,0.9325311814633644,27.105532058326364,96180672,-0.030783446602578146,-0.6233784321962617,-0.5925949855936835
2025-09-08T14:10:00-04:00,345.67,346.36,345.66,346.22,NaN,NaN,NaN,348.4647459577709,NaN,NaN,348.1345999999992,351.78348467384046,344.4857153261579,345.50232517858836,349.98088229976986,353.00778260669523,346.9539819928445,34007,57624,43.8237386198552,42.08285591815042,NaN,NaN,NaN,NaN,0.9159218113588377,26.998170197982656,96214679,0.005783078468043601,-0.585366137508629,-0.5911492159766726
2025-09-08T14:15:00-04:00,346.21,346.48,345.77,345.9,NaN,NaN,NaN,348.4647459577709,NaN,NaN,348.01739999999916,351.5680913359262,344.4667086640721,345.41138439314983,349.95351662227733,352.98751789944686,346.9195153451078,34694,54547.066666666666,41.52355989965793,42.63118267849648,NaN,NaN,NaN,NaN,0.9012131105474948,26.71119576452334,96179985,0.01336685158158979,-0.5744406514996854,-0.5878075030812752
2025-09-08T14:20:00-04:00,345.89,346.33,345.77,346.17,NaN,NaN,NaN,348.4647459577709,NaN,NaN,347.9221999999991,351.41011178832173,344.4342882116765,345.41138439314983,349.93719542155674,352.9751335251063,346.8992573180072,21142,52593.5,44.18549640688274,43.092663218763846,NaN,NaN,NaN,NaN,0.8768407455083881,26.444719504882546,96201127,0.04000919923325563,-0.5377960040397056,-0.5778052032729613
2025-09-08T14:25:00-04:00,346.2,346.71,345.95,346.53,NaN,NaN,NaN,348.4647459577709,NaN,NaN,347.8223999999991,351.1757882809982,344.46901171900004,345.41138439314983,349.91438190115224,352.9557387642176,346.8730250380869,32457,51671.6,47.60993308176545,43.33562846402265,NaN,NaN,NaN,NaN,0.868494977972074,25.571782386452195,96233584,0.0828528569767304,-0.47423913205204826,-0.5570919890287787
2025-09-08T14:30:00-04:00,346.535,346.855,345.95,346.83,NaN,NaN,NaN,348.4647459577709,NaN,NaN,347.73179999999905,350.939602837353,344.5239971626451,345.41138439314983,349.8858682584361,352.93001581425784,346.8417207026144,42991,51384.9,50.34404834844337,43.42874957482169,NaN,NaN,NaN,NaN,0.8711024795454995,24.529251885682893,96276575,0.12958734842996056,-0.395107803491328,-0.5246951519212886
2025-09-08T14:35:00-04:00,346.85,346.89,346.45,346.47,NaN,NaN,NaN,348.4647459577709,NaN,NaN,347.61419999999913,350.55627910210916,344.6721208978891,345.11481964763453,349.8734684624088,352.9185263971729,346.82841052764473,19263,50204.433333333334,47.16324050785109,43.316002124783424,NaN,NaN,NaN,NaN,0.8403094452922494,23.50303799115938,96257312,0.13389562590784526,-0.357325619536482,-0.49122124544432727
2025-09-08T14:40:00-04:00,346.475,346.72,345.96,346.72,NaN,NaN,NaN,348.4647459577709,NaN,NaN,347.5177999999991,350.24720884499715,344.7883911550011,345.11481964763453,349.85326468047543,352.90052751360815,346.8060018473427,30422,50501.6,49.547188942829315,43.55166930294421,NaN,NaN,NaN,NaN,0.8345730563428064,23.18917047109215,96287734,0.15000972708696014,-0.3037090865856271,-0.45371881367258726
2025-09-08T14:45:00-04:00,346.72,347.22,346.63,346.79,NaN,NaN,NaN,348.4647459577709,NaN,NaN,347.4405999999991,350.02581847494395,344.85538152505427,345.4848845744861,349.826555760914,352.8730447889247,346.7800667329033,46499,50444.9,50.22439363277494,43.94970101598887,NaN,NaN,NaN,NaN,0.8171035523183224,22.05850659238287,96334233,0.16084968003496547,-0.2526567136288804,-0.4135063936638459
2025-09-08T14:50:00-04:00,346.85,346.93,346.46,346.7,NaN,NaN,NaN,348.4647459577709,NaN,NaN,347.3583999999991,349.7650528131768,344.9517471868214,345.4848845744861,349.8112731016714,352.8581365749758,346.76440962836705,25399,49834.96666666667,49.30800193567083,44.23390297687248,NaN,NaN,NaN,NaN,0.7923104414384442,21.239270054347266,96308834,0.1572382156351022,-0.21695862411996814,-0.37419683975507034
2025-09-08T14:55:00-04:00,346.65,346.95,346.35,346.471,NaN,NaN,NaN,348.4647459577709,NaN,NaN,347.2818199999991,349.54881740488116,345.014822595117,345.4848845744861,349.79001332129434,352.83798423365215,346.7420424089365,34562,49605.066666666666,46.9601352229956,44.433537843803315,NaN,NaN,NaN,NaN,0.7785739813356958,20.630003798013288,96274272,0.13552916877341514,-0.2047853787883014,-0.34031454756171653
2025-09-08T15:00:00-04:00,346.47,346.82,346.38,346.8,NaN,NaN,NaN,348.4647459577709,NaN,NaN,347.219419999999,349.36079216241683,345.07804783758115,345.4848845744861,349.7692162038087,352.8176242355408,346.7208081720766,35100,48830.833333333336,50.59955377862788,45.13942735624122,NaN,NaN,NaN,NaN,0.754390125526003,20.064256559988877,96309372,0.13891628996202482,-0.1666691851091855,-0.3055854750712103
2025-09-08T15:05:00-04:00,346.8,346.98,346.48,346.54,NaN,NaN,NaN,348.4647459577709,NaN,NaN,347.19061999999906,349.32903234230207,345.05220765769604,345.5309767217095,349.752969632042,352.80162039176395,346.70431887232,27749,47332.63333333333,47.807718755254754,45.92962875006175,NaN,NaN,NaN,NaN,0.7362194022741457,19.229241428330106,96281623,0.11995042228800135,-0.1556474472112086,-0.27559786949920995
2025-09-08T15:10:00-04:00,346.57,346.66,345.48,346.22,NaN,NaN,NaN,348.4647459577709,NaN,NaN,347.1414199999991,349.2535357207076,345.02930427929056,345.5309767217095,349.7089396334199,352.7650237238923,346.6528555429475,65011,48300.63333333333,44.54973088671245,46.596187263239464,NaN,NaN,NaN,NaN,0.7679180163974214,19.79985448391143,96216612,0.08386590526237264,-0.17076548792124413,-0.25463139318361677
2025-09-08T15:15:00-04:00,346.22,346.3,345.71,345.86,NaN,NaN,NaN,348.4647459577709,NaN,NaN,347.0764199999991,349.1417217255661,345.0111182744321,345.5309767217095,349.6742335327344,352.7372853589269,346.61118170654186,50078,48795.26666666667,41.15206781257351,46.771343416563944,NaN,NaN,NaN,NaN,0.7552095866547507,20.32970946409409,96166534,0.036199506560752825,-0.20938200998267575,-0.24558151654342858
2025-09-08T15:20:00-04:00,345.83,346.14,345.67,345.97,NaN,NaN,NaN,348.398454277323,NaN,NaN,347.01201999999904,349.00937759488033,345.01466240511775,345.5309767217095,349.65362114400267,352.72078651589527,346.58645577211007,29944,48572.53333333333,42.592777991521906,46.68341765739728,NaN,NaN,NaN,NaN,0.7348374733222663,20.870848256308875,96196478,0.013684356184277074,-0.22847607131308223,-0.2421604274973593
2025-09-08T15:25:00-04:00,346.02,346.23,345.77,346.11,NaN,NaN,NaN,348.398454277323,NaN,NaN,346.9686199999991,348.9481079301732,344.98913206982496,345.5309767217095,349.63121857934675,352.70201045415575,346.56042670453775,33930,45975.4,44.456572912995355,46.89291858692138,NaN,NaN,NaN,NaN,0.7152062252278214,21.168807084594985,96230408,0.0099971428833604,-0.2296639988931588,-0.2396611417765192
2025-09-08T15:30:00-04:00,346.14,346.83,345.75,345.77,NaN,NaN,NaN,348.398454277323,NaN,NaN,346.916219999999,348.88108613538526,344.9513538646127,345.5309767217095,349.6014855094788,352.6761564533737,346.52681456558383,46740,42865.5,40.97713753666545,46.66375009619157,NaN,NaN,NaN,NaN,0.7412629234258331,20.20873190535025,96183668,-0.012351058545587629,-0.25509996495850373,-0.2427489064129161
2025-09-08T15:35:00-04:00,345.82,346.79,345.77,346.35,NaN,NaN,NaN,348.398454277323,NaN,NaN,346.85761999999903,348.7084617073853,345.00677829261275,345.5309767217095,349.57133673290593,352.64797634352186,346.49469712229,50969,42960.166666666664,48.39678564750566,46.71995385088731,NaN,NaN,NaN,NaN,0.7611727146097049,19.317233524622992,96234637,0.013516325110756428,-0.22585350002447058,-0.239369825135227
2025-09-08T15:40:00-04:00,346.36,346.89,346.24,346.65,NaN,NaN,NaN,348.398454277323,NaN,NaN,346.805019999999,348.5221578750248,345.0878821249732,345.5309767217095,349.5412124042524,352.61672255760044,346.46570225090437,56979,43430.76666666667,51.77373548232078,46.822074360449975,NaN,NaN,NaN,NaN,0.7532318064232958,18.288827862006688,96291616,0.05034854010447082,-0.17643415000463847,-0.2267826901091093
2025-09-08T15:45:00-04:00,346.65,346.94,346.6,346.86,NaN,NaN,NaN,348.398454277323,NaN,NaN,346.75061999999895,348.27407848189296,345.22716151810494,345.5309767217095,349.5065045479309,352.57781331879505,346.4351957770667,72234,44088.36666666667,54.04099481117048,47.31334252497278,NaN,NaN,NaN,NaN,0.7237152488216301,17.230143619641073,96363850,0.08626414913313013,-0.11895250369269661,-0.20521665282582674
2025-09-08T15:50:00-04:00,346.87,346.87,345.93,346.1,NaN,NaN,NaN,348.398454277323,NaN,NaN,346.712619999999,348.2039744937041,345.2212655062939,345.5309767217095,349.44954835670586,352.5227827061235,346.3763140072882,103169,45171.36666666667,45.672435057037376,47.036574390273366,NaN,NaN,NaN,NaN,0.7391641596200849,17.395091294710372,96260681,0.05762274437894449,-0.1331882223521461,-0.1908109667310906
2025-09-08T15:55:00-04:00,346.15,346.72,346.15,346.44,NaN,NaN,NaN,348.398454277323,NaN,NaN,346.70301999999896,348.19509064242857,345.21094935756935,345.29173698671093,349.3870044652321,352.4583612720607,346.3156476584035,123127,47503.933333333334,49.44423040397734,46.98084844535925,NaN,NaN,NaN,NaN,0.7306524339329362,17.54825699298901,96383808,0.0600877801369378,-0.11570124155991834,-0.17578902169685615
2025-09-09T09:30:00-04:00,348.44,350.2,346.9,348.94,345.74034460839573,345.74034460839573,345.74034460839573,NaN,NaN,NaN,346.726219999999,348.31733826396777,345.1351017360302,346.927289337196,348.67999999999995,348.6800066072494,348.6799933927505,208295,52755.5,67.37833715763,48.27158667549919,NaN,NaN,NaN,NaN,0.9470344029377259,19.17466170046348,96592103,0.2196297105690507,0.09874811651445725,-0.12088159405459345
2025-09-09T09:35:00-04:00,348.96,349.94,348.4,348.81,346.278056217105,NaN,NaN,NaN,NaN,NaN,346.732119999999,348.3516602143553,345.11257978564265,346.927289337196,348.837483386185,349.0204255517741,348.6545412205959,154355,56479.566666666666,66.06591217921587,49.636285029514916,NaN,NaN,NaN,NaN,0.9893890884421755,20.68489464311835,96437748,0.30091990749660813,0.2552682903161667,-0.04565161718044142
2025-09-09T09:40:00-04:00,348.87,349.95,347.96,349.19,346.278056217105,NaN,NaN,NaN,NaN,NaN,346.76191999999895,348.50195130375596,345.02188869624194,346.927289337196,348.90570143202933,349.08039312592285,348.7310097381358,193833,61931.3,68.02642771174678,50.881061739023416,NaN,NaN,NaN,NaN,1.0608612964105923,21.401667530539363,96631581,0.36076321861086325,0.4053024060831376,0.044539187472274394
2025-09-09T09:45:00-04:00,349.14,350.54,348.79,350.31,346.5323198176515,NaN,NaN,NaN,NaN,NaN,346.82231999999897,348.82179907065324,344.8228409293447,346.927289337196,349.1582242909784,349.61085270206996,348.70559587988686,194693,67354.93333333333,72.98115733002999,52.6791644943645,NaN,NaN,NaN,NaN,1.1100854895241214,22.512111846322288,96826274,0.450429770812508,0.6075764009879094,0.15714663017540142
2025-09-09T09:50:00-04:00,350.27,350.77,348.84,348.91,346.5515325532128,NaN,NaN,NaN,NaN,NaN,346.84811999999897,348.92008118352743,344.7761588164705,346.927289337196,349.2032478052863,349.64149561123196,348.76499999934066,111465,69092.56666666667,60.384652284735594,53.810230308509006,NaN,NaN,NaN,NaN,1.1686508117009704,23.707031281452156,96714809,0.39224135054143067,0.6474483183521897,0.2552069678107591
2025-09-09T09:55:00-04:00,348.85,348.88,347.72,348.38,346.5515325532128,NaN,NaN,NaN,NaN,NaN,346.86431999999894,348.9709801610192,344.75765983897867,346.927289337196,349.1116984811347,349.60553203966487,348.6178649226045,100600,70740.66666666667,56.414880772890704,54.90043123424595,NaN,NaN,NaN,NaN,1.1701757537223294,23.22355937324789,96614209,0.2990580012348728,0.6290294693543501,0.3299714681194773
2025-09-09T10:00:00-04:00,348.34,349,345.7,345.7,NaN,NaN,NaN,350.91931641329165,350.91931641329165,350.91931641329165,346.816119999999,348.91684317689464,344.71539682310333,346.927289337196,348.7675753719964,349.7081372394836,347.8270135045091,168468,73060.86666666667,41.542634122039196,54.82542095785432,NaN,NaN,NaN,NaN,1.3223060570278782,22.336819071364324,96445741,0.05093574263615086,0.39364114641466585,0.342705403778515
2025-09-09T10:05:00-04:00,345.68,347.37,345.5,346.44,NaN,NaN,NaN,350.097074758142,NaN,NaN,346.7851199999989,348.86123936698846,344.7090006330094,346.927289337196,348.5768427057785,349.6815909937248,347.47209441783224,100858,74967.76666666666,45.79203422415309,54.920811051508444,NaN,NaN,NaN,NaN,1.3614270529544588,21.670624628966454,96546599,-0.06315192644735096,0.2637654957193263,0.32691742216667724
2025-09-09T10:10:00-04:00,346.5,347.89,346.12,347.36,NaN,NaN,NaN,350.097074758142,NaN,NaN,346.78291999999897,348.8563631214578,344.70947687854016,346.927289337196,348.50203872123575,349.6248881080355,347.379189334436,66875,76063.36666666667,50.59994707824849,55.608154590192946,NaN,NaN,NaN,NaN,1.3906108348862818,20.53032608073893,96613474,-0.07561753186805953,0.23239550733160286,0.3080130391996624
2025-09-09T10:15:00-04:00,347.39,347.75,346.74,346.74,NaN,NaN,NaN,350.097074758142,NaN,NaN,346.76891999999896,348.8338629575477,344.7039770424502,346.927289337196,348.40422321707166,349.54620621672797,347.26224021741535,95744,78098.36666666667,47.53981937884923,55.546942713860346,NaN,NaN,NaN,NaN,1.3634243466801181,19.471477428813376,96517730,-0.12184178352510838,0.1557108097932769,0.2775525933183853
2025-09-09T10:20:00-04:00,346.75,347.11,345.65,346.26,NaN,NaN,NaN,350.097074758142,NaN,NaN,346.742519999999,348.7990446125077,344.68599538749027,346.7334577125155,348.28410077368676,349.4931354787364,347.0750660686371,86206,80267.16666666667,45.25781085787978,55.08151952640028,NaN,NaN,NaN,NaN,1.370322607631541,19.402780608008218,96431524,-0.1775899739704149,0.05556512585536666,0.23315509982578156
2025-09-09T10:25:00-04:00,346.3,346.94,345.59,346.63,NaN,NaN,NaN,350.0148277569762,NaN,NaN,346.732319999999,348.7859146420298,344.6787253579682,346.7334577125155,348.1976606146511,349.44333908797347,346.95198214132876,70708,81542.2,47.355577942272326,54.60398975005041,NaN,NaN,NaN,NaN,1.3688709928007181,19.385468403680232,96502232,-0.18173539475772185,0.005985856378629251,0.1877212511363511
2025-09-09T10:30:00-04:00,346.58,347.36,344.85,345,NaN,NaN,NaN,350.0148277569762,NaN,NaN,346.68631999999906,348.7894321495399,344.5832078504582,346.7334577125155,348.009553290165,349.3736117074688,346.6454948728612,128454,84390.96666666666,40.07055353180221,54.20385535539076,NaN,NaN,NaN,NaN,1.4503802076006662,19.923063157467364,96373778,-0.2805410053369645,-0.16295500553485454,0.11758599980210997
2025-09-09T10:35:00-04:00,345.09,345.37,344.12,345.18,NaN,NaN,NaN,348.6588513240217,NaN,NaN,346.667519999999,348.80703617936916,344.52800382062884,346.7334577125155,347.81832033925,349.33706519814695,346.2995754803531,109748,87407.13333333333,41.1472571250639,53.611214406896934,NaN,NaN,NaN,NaN,1.43606733562919,20.90489610872522,96483526,-0.31734885442130606,-0.2791000682245226,0.038248786196783444
2025-09-09T10:40:00-04:00,345.14,345.44,344.5,345.09,NaN,NaN,NaN,348.6588513240217,NaN,NaN,346.663919999999,348.81341254890094,344.51442745109705,345.05576617001236,347.7253423759387,349.30099666097,346.1496880909074,61303,88436.5,40.75300843580728,51.70940521248103,NaN,NaN,NaN,NaN,1.4006339545128192,21.726308638975876,96422223,-0.32987564642425715,-0.37409577183353804,-0.04422012540928086
2025-09-09T10:45:00-04:00,345.01,345.43,344.81,344.91,NaN,NaN,NaN,348.6588513240217,NaN,NaN,346.6511199999989,348.834350694636,344.46788930536184,344.2906129360099,347.6640487730742,349.27216293162445,346.055934614524,43416,88333.73333333334,39.92899847090422,49.84248280474448,NaN,NaN,NaN,NaN,1.3448743863333326,22.4890488456372,96378807,-0.33151860353289175,-0.45861837982539555,-0.1270997762925038
2025-09-09T10:50:00-04:00,344.92,345.66,343.83,345.25,NaN,NaN,NaN,348.5960778654926,NaN,NaN,346.63631999999893,348.84713539573573,344.42550460426213,343.52739382323705,347.50256708988854,349.1914516733321,345.813682506445,118186,91426.63333333333,42.3021397419504,48.00503366404474,NaN,NaN,NaN,NaN,1.3795262158809545,23.839976596878756,96496993,-0.2923128741162427,-0.49249086893780714,-0.20017799482156445
2025-09-09T10:55:00-04:00,345.25,346.17,345.24,345.8,NaN,NaN,NaN,348.5960778654926,NaN,NaN,346.6163199999989,348.83891216097453,344.39372783902326,343.52739382323705,347.44656579492886,349.1370192439453,345.7561123459124,65935,92472.4,46.01733381837666,46.079046270355214,NaN,NaN,NaN,NaN,1.3474172004608869,24.39326253654842,96562928,-0.215491258905872,-0.46954206845390445,-0.25405080954803244
2025-09-09T11:00:00-04:00,345.85,346.29,345.44,345.53,NaN,NaN,NaN,348.5960778654926,NaN,NaN,346.5772199999989,348.8060850856592,344.34835491433853,343.52739382323705,347.38485546816645,349.0742835977264,345.6954273386065,78641,93923.76666666666,44.50240901206929,44.94460032230762,NaN,NaN,NaN,NaN,1.3118874004279681,24.744553352911538,96484287,-0.17095918739389693,-0.4677497937904036,-0.2967906063965067
2025-09-09T11:05:00-04:00,345.5,345.73,344.95,345.55,NaN,NaN,NaN,348.5960778654926,NaN,NaN,346.5394199999989,348.77257640695683,344.306263593041,343.1915972359161,347.3368220537348,349.03308228484224,345.6405618226274,53791,94791.83333333333,44.647772602401524,44.10409259584411,NaN,NaN,NaN,NaN,1.273895443254544,25.427454992426547,96538078,-0.13010324801742235,-0.4594196664182846,-0.32931641840086223
2025-09-09T11:10:00-04:00,345.53,346.72,345.39,346.42,NaN,NaN,NaN,348.5960778654926,NaN,NaN,346.5264199999989,348.7546325612394,344.29820743875837,343.7600222309863,347.30805859778576,348.99284503262965,345.6232721629419,56225,94498.96666666666,50.69735837693543,44.758001471193836,NaN,NaN,NaN,NaN,1.2779029115935079,24.78344507646752,96594303,-0.03915162703384756,-0.37825595219317165,-0.3391043251593241
2025-09-09T11:15:00-04:00,346.41,346.89,346.41,346.8,NaN,NaN,NaN,348.5960778654926,NaN,NaN,346.5258199999989,348.7537213878803,344.2979186121174,344.282017784789,347.29807788192795,348.97076528659534,345.62539047726057,37845,94091.2,53.108029932366115,45.28057259320905,NaN,NaN,NaN,NaN,1.2209098464796833,23.98549282426396,96632148,0.04724974161090206,-0.2800421481456965,-0.32729188975659856
2025-09-09T11:20:00-04:00,346.82,347.03,346.4,346.615,NaN,NaN,NaN,348.5960778654926,NaN,NaN,346.5199199999988,348.7452815567296,344.29455844326804,344.6286142278312,347.2855799752609,348.94350125101005,345.6276586995117,47715,94683.56666666667,51.780611498959644,45.36490576611699,NaN,NaN,NaN,NaN,1.1787020003025626,23.07508961482537,96584433,0.0901051259511666,-0.21466048231764034,-0.30476560826880694
2025-09-09T11:25:00-04:00,346.66,346.86,346.31,346.38,NaN,NaN,NaN,348.5960778654926,NaN,NaN,346.51251999999886,348.7372326291198,344.28780737087794,344.663891382265,347.27612418683316,348.9259974475158,345.62625092615053,29301,94529.26666666666,50.06864863392631,45.54553642719393,NaN,NaN,NaN,NaN,1.133794714566666,22.320058261143785,96555132,0.10002392989369852,-0.1797356959016838,-0.2797596257953823
2025-09-09T11:30:00-04:00,346.37,346.91,346.21,346.79,NaN,NaN,NaN,348.5960778654926,NaN,NaN,346.5231199999988,348.7479694659708,344.2982705340268,344.803113105812,347.2688554984568,348.91072490978956,345.626986087124,27395,93884.43333333333,52.988950776295454,46.09776070708076,NaN,NaN,NaN,NaN,1.1028093778119075,21.723733569220425,96582527,0.12971318163115791,-0.11761814875643495,-0.24733133038759286
2025-09-09T11:35:00-04:00,346.77,347.14,346.53,346.59,NaN,NaN,NaN,348.5960778654926,NaN,NaN,346.5423199999988,348.75252934626786,344.3321106537298,345.14949048464956,347.25923786405264,348.88721478553714,345.63126094256813,45817,93712.7,51.409420349040005,46.38732087899273,NaN,NaN,NaN,NaN,1.0676087079682008,20.845428491703206,96536710,0.13101338988601374,-0.08356459303007568,-0.21457798291608943
2025-09-09T11:40:00-04:00,346.62,346.63,346.09,346.39,NaN,NaN,NaN,348.5960778654926,NaN,NaN,346.5627199999989,348.74795913797607,344.3774808620217,345.14949048464956,347.2504827704426,348.87280322135797,345.62816231952723,24420,92627.4,49.81042355070556,47.08302588034297,NaN,NaN,NaN,NaN,1.0299223716847594,20.520927053650333,96512290,0.11415313059116503,-0.07188656967713314,-0.18603970026829816
2025-09-09T11:45:00-04:00,346.37,346.81,346.31,346.74,NaN,NaN,NaN,348.5960778654926,NaN,NaN,346.5835199999989,348.75527296064286,344.4117670393549,345.14949048464956,347.24269497842823,348.856467966257,345.62892199059945,31020,91253.6,52.58951003833637,47.900329659862436,NaN,NaN,NaN,NaN,0.9920707737072766,19.950790025844984,96543310,0.12163362173966064,-0.03399767309372237,-0.155631294833383
2025-09-09T11:50:00-04:00,346.74,347.7,346.58,347.61,NaN,NaN,NaN,348.5960778654926,NaN,NaN,346.6113199999989,348.7992735447669,344.4233664552309,345.74805912814054,347.2438496163476,348.8402863345049,345.6474128981902,54900,89644.63333333333,58.709792781183104,49.18295711310356,NaN,NaN,NaN,NaN,1.0012085755853286,18.811576856660263,96598210,0.17688624155767832,0.06547650711371489,-0.11140973444396343
2025-09-09T11:55:00-04:00,347.61,347.93,347.34,347.73,NaN,NaN,NaN,348.5960778654926,NaN,NaN,346.64791999999886,348.8482426986332,344.4475973013645,346.0734473025124,347.2548709024601,348.831803309245,345.67793849567516,68682,87829.8,59.48665117509023,50.57993230625971,NaN,NaN,NaN,NaN,0.9718365344720931,18.023199745857692,96666892,0.2109186651061548,0.1522385969387301,-0.05868006816742473
2025-09-09T12:00:00-04:00,347.75,348.28,347.62,347.88,NaN,NaN,NaN,348.5960778654926,NaN,NaN,346.6821199999988,348.9047109444386,344.459529055559,346.46475784200993,347.2673319540317,348.8321980996576,345.7024658084058,49798,82546.56666666667,60.487400035349815,51.878879470073954,NaN,NaN,NaN,NaN,0.9495624962955127,17.689709252413046,96716690,0.23130044847040832,0.23044549242058565,-0.0008549560498226499
2025-09-09T12:05:00-04:00,347.85,348.1,347.71,348.06,NaN,NaN,NaN,348.5960778654926,NaN,NaN,346.71271999999885,348.9679800936839,344.45745990631383,346.46475784200993,347.27902184787894,348.83311330053664,345.72493039522124,46313,78945.16666666667,61.709710527842375,52.99976352075007,NaN,NaN,NaN,NaN,0.909593746560122,17.380039508500165,96763003,0.24344517766595702,0.30345151603262366,0.06000633836666662
2025-09-09T12:10:00-04:00,348.07,348.45,348.07,348.33,NaN,NaN,NaN,348.5960778654926,NaN,NaN,346.7427199999989,349.04288201386976,344.442557986128,346.93724501888636,347.2933942437197,348.8409293303909,345.7458591570485,39650,73805.73333333334,63.53206575855394,54.35902471692754,NaN,NaN,NaN,NaN,0.8724799075201124,17.498296664859165,96802653,0.2549791630539595,0.378730292184116,0.1237511291301565
2025-09-09T12:15:00-04:00,348.32,348.5,347.56,347.59,NaN,NaN,NaN,348.5960778654926,NaN,NaN,346.7651199999989,349.07601134882526,344.4542286511725,346.93724501888636,347.3019438940067,348.839841196334,345.76404659167935,40744,68674.1,55.70670294698292,55.148948312969075,NaN,NaN,NaN,NaN,0.8773027712686756,16.81486874770142,96761909,0.2004887259370543,0.3743620365514744,0.17387331061442007
2025-09-09T12:20:00-04:00,347.6,347.6,346.88,347.285,NaN,NaN,NaN,348.5960778654926,NaN,NaN,346.77641999999884,349.09183944756916,344.4610005524285,346.93724501888636,347.30124933125876,348.82773770746087,345.77476095505665,42221,66365.96666666666,52.81898759949105,55.30049325743733,NaN,NaN,NaN,NaN,0.8660668590352006,15.958098193817616,96719688,0.1347756680540256,0.3423428956819521,0.20756722762792648
2025-09-09T12:25:00-04:00,347.17,347.9,347.09,347.71,NaN,NaN,NaN,348.5960778654926,NaN,NaN,346.7948199999989,349.1249538918711,344.46468610812667,346.93724501888636,347.3038592441229,348.82304967777515,345.7846688104707,28339,63957.26666666667,56.224277007634555,55.523082334242225,NaN,NaN,NaN,NaN,0.8620620833898293,14.871845355069526,96748027,0.11175298955012625,0.3472584645655843,0.23550547501545804
2025-09-09T12:30:00-04:00,347.68,348.18,347.55,348.05,NaN,NaN,NaN,348.5960778654926,NaN,NaN,346.82181999999887,349.1780727101514,344.4655672898463,346.93724501888636,347.31055215578203,348.82292156446647,345.7981827470976,31307,59385.23333333333,58.78696670102021,56.02353627724654,NaN,NaN,NaN,NaN,0.8454862202905554,14.222667692502444,96779334,0.11101549154834622,0.3742748394508908,0.26325934790254457
2025-09-09T12:35:00-04:00,348.02,348.06,347.19,347.39,NaN,NaN,NaN,348.5960778654926,NaN,NaN,346.8401999999988,349.1995549635385,344.4808450364591,346.93724501888636,347.31293133690343,348.8178466163579,345.808016057449,29654,57011.76666666667,52.37703625681047,56.188421107452555,NaN,NaN,NaN,NaN,0.8472372045555161,13.289378795906643,96749680,0.060213883234464416,0.33852670194562506,0.27831281871116065
2025-09-09T12:40:00-04:00,347.36,347.62,347.18,347.24,NaN,NaN,NaN,348.5960778654926,NaN,NaN,346.84899999999885,349.21097036471093,344.4870296352868,346.93724501888636,347.31318593616805,348.81241453398894,345.81395733834717,22379,55528.566666666666,51.015569593380974,56.04746530867295,NaN,NaN,NaN,NaN,0.8181488328015505,12.436582404534754,96727301,0.013105933660583102,0.2946952357868895,0.2815893021263064
2025-09-09T12:45:00-04:00,347.33,347.85,347.07,347.4,NaN,NaN,NaN,348.5960778654926,NaN,NaN,346.8661999999988,349.23144211106364,344.50095788893395,346.93724501888636,347.3142261275444,348.8073371707179,345.82111508437083,24524,53154.566666666666,52.43580282132527,56.12077834240761,NaN,NaN,NaN,NaN,0.8154239161728704,11.78678007461937,96751825,-0.009463820904704712,0.2697595259954255,0.27922334690013023
2025-09-09T12:50:00-04:00,347.36,347.41,346.28,346.38,NaN,NaN,NaN,348.5960778654926,NaN,NaN,346.8693999999988,349.23156734461026,344.5072326553873,346.93724501888636,347.30400329165894,348.78695551220113,345.82105107111676,49779,51940.333333333336,43.731050988333145,55.686537445095304,NaN,NaN,NaN,NaN,0.8378936364462405,11.785079966554395,96702046,-0.090753639736049,0.16578129723006896,0.25653493696611795
2025-09-09T12:55:00-04:00,346.37,346.64,346.19,346.27,NaN,NaN,NaN,348.5960778654926,NaN,NaN,346.8775999999987,349.22851406992385,344.5266859300736,346.93724501888636,347.2905861632005,348.7670904215187,345.8140819048823,44141,51054.76666666667,42.903867023069374,54.99470580114765,NaN,NaN,NaN,NaN,0.8101869481286511,11.89451669024967,96657905,-0.14630579064785154,0.07365269865630353,0.21995848930415507
2025-09-09T13:00:00-04:00,346.31,346.91,346.295,346.49,NaN,NaN,NaN,348.5960778654926,NaN,NaN,346.8879999999988,349.2273340941344,344.5486659058632,346.8197960151091,347.28292463568806,348.75348430117214,345.812364970204,32909,47869.933333333334,45.13893682601387,54.025358947207,NaN,NaN,NaN,NaN,0.7980307375480363,11.560326384227624,96690814,-0.16142064483148638,0.018182683264797106,0.1796033280962835
2025-09-09T13:05:00-04:00,346.49,347.22,346.25,347.2,NaN,NaN,NaN,348.5960778654926,NaN,NaN,346.9097999999987,349.2400248484038,344.57957515159364,346.45033555973583,347.27665496491255,348.73626568004806,345.81704424977704,50537,45896.23333333333,51.70901864753651,53.46981376666746,NaN,NaN,NaN,NaN,0.8103142562946071,10.771980664596914,96741351,-0.11875927362180422,0.03115423606902823,0.14991350969083245
2025-09-09T13:10:00-04:00,347.23,347.42,346.9,346.91,NaN,NaN,NaN,348.5960778654926,NaN,NaN,346.9325999999988,349.2399658062635,344.62523419373406,346.45033555973583,347.2745810806039,348.72674530175,345.82241685945786,33188,44959.066666666666,49.121392331513256,52.65795607353626,NaN,NaN,NaN,NaN,0.789577523702138,10.263614278916771,96708163,-0.1056682506310374,0.0178281964020357,0.1234964470330731
2025-09-09T13:15:00-04:00,346.93,347.6,346.93,347.54,NaN,NaN,NaN,348.5960778654926,NaN,NaN,346.95639999999884,349.26378643574986,344.6490135642478,346.45033555973583,347.2752234140351,348.7217128456333,345.8287339824369,25241,44353.23333333333,54.45370440871491,52.13966992217002,NaN,NaN,NaN,NaN,0.7824648434376994,10.058068782663783,96733404,-0.05284451205817223,0.057440806960357804,0.11028531901853003
2025-09-09T13:20:00-04:00,347.57,347.6,346.76,346.83,NaN,NaN,NaN,348.5960778654926,NaN,NaN,346.95999999999884,349.26602428518584,344.65397571481185,346.2412684477887,347.2731472719462,348.71268406832047,345.8336104755719,31918,41477.63333333333,48.30887604442465,51.052299228303646,NaN,NaN,NaN,NaN,0.786574497477866,9.576526723844877,96701486,-0.06328141095549429,0.03118355532416217,0.09446496627965646
2025-09-09T13:25:00-04:00,346.84,347.19,346.84,346.91,NaN,NaN,NaN,348.5960778654926,NaN,NaN,346.9609999999988,349.2668933201525,344.6551066798451,346.1200118065848,347.2709839651804,348.7054187668456,345.8365491635152,24218,40087.066666666666,49.00712159394562,50.5737577030867,NaN,NaN,NaN,NaN,0.7561048905151623,9.129380526370177,96725704,-0.062261546818499505,0.016638032756532084,0.07889957957503159
2025-09-09T13:30:00-04:00,346.91,347.15,346.55,346.72,NaN,NaN,NaN,348.5960778654926,NaN,NaN,346.9733999999988,349.26727657994235,344.6795234200552,346.1200118065848,347.2680952507127,348.69852697403996,345.8376635273854,20545,38150.53333333333,47.370499308307714,50.184579968002176,NaN,NaN,NaN,NaN,0.7449545411926483,8.755091690580311,96705159,-0.07120313110072676,-0.010104334300876872,0.06109879679984989
2025-09-09T13:35:00-04:00,346.71,347.18,346.66,347.09,NaN,NaN,NaN,348.5960778654926,NaN,NaN,346.98639999999875,349.27539981740597,344.69740018259154,345.84195477502533,347.26491796505167,348.68785256914634,345.841983360957,36400,37570.833333333336,50.81521104011773,49.798218113179544,NaN,NaN,NaN,NaN,0.7288863596788863,8.350323672658929,96741559,-0.05001944756677077,-0.0014255126586135702,0.0485939349081572
2025-09-09T13:40:00-04:00,347.04,347.09,346.62,346.79,NaN,NaN,NaN,348.5960778654926,NaN,NaN,346.9433999999988,349.163734606293,344.7230653937046,345.84195477502533,347.26206131856765,348.6807106395264,345.8434119976089,22246,36438.2,48.06804860052586,49.03258110600137,NaN,NaN,NaN,NaN,0.710394476844678,8.050264291167855,96719313,-0.0537081438032393,-0.018541244845891924,0.03516689895734738
2025-09-09T13:45:00-04:00,346.78,346.98,346.53,346.91,NaN,NaN,NaN,348.5960778654926,NaN,NaN,346.90539999999885,349.06073370125984,344.75006629873786,345.84195477502533,347.258616706348,348.67244116815607,345.8447922445399,25616,36030.566666666666,49.249924758168675,48.80921599895554,NaN,NaN,NaN,NaN,0.6917948713557758,7.948592804838646,96744929,-0.045867167742600676,-0.022167060720903464,0.023700107021697208
2025-09-09T13:50:00-04:00,346.88,347.69,346.785,347.55,NaN,NaN,NaN,348.5960778654926,NaN,NaN,346.87259999999884,348.93581326184324,344.80938673815444,346.1133283140354,347.2592692316706,348.66754760545695,345.85099085788426,26819,35334.03333333333,55.116772529269326,49.102159065804706,NaN,NaN,NaN,NaN,0.7070238091160755,8.278764211602699,96771748,0.0020790723637552563,0.026298947476391277,0.02421987511263602
2025-09-09T13:55:00-04:00,347.58,347.83,347.25,347.27,NaN,NaN,NaN,348.5960778654926,NaN,NaN,346.8117999999988,348.6309863686438,344.99261363135383,346.27866265122833,347.2608426153737,348.66340644939925,345.85827878134813,28392,35303.73333333333,52.26980975042031,49.090302417882924,NaN,NaN,NaN,NaN,0.6979506798934976,8.815322945775844,96743356,0.01393210453338662,0.041635005779369294,0.027702901245982674
2025-09-09T14:00:00-04:00,347.32,347.41,346.76,346.76,NaN,NaN,NaN,348.5960778654926,NaN,NaN,346.7687999999988,348.48637452350334,345.05122547649427,346.27866265122833,347.25904575480035,348.65734975627686,345.86074175332385,21901,35120.6,47.46105904022085,49.35673156444632,NaN,NaN,NaN,NaN,0.6945256313296788,8.305476118022304,96721455,-0.012168559085076185,0.012492202389637441,0.024660761474713626
2025-09-09T14:05:00-04:00,346.75,346.765,346.41,346.57,NaN,NaN,NaN,348.5960778654926,NaN,NaN,346.73259999999885,348.3879866508214,345.0772133491763,346.27866265122833,347.2516043729568,348.643997924138,345.85921082177566,38473,34875.8,45.771607956442004,49.561570202544374,NaN,NaN,NaN,NaN,0.6702738005204133,8.214969867385925,96682982,-0.040240236992809916,-0.025639534766298766,0.014600702226511147
2025-09-09T14:10:00-04:00,346.615,346.7,345.98,346.67,NaN,NaN,NaN,348.5833473034758,NaN,NaN,346.7519999999989,348.3810524864858,345.1229475135119,346.27866265122833,347.2394506755881,348.62471585657175,345.85418549460445,53916,35859,46.844091954091745,49.68336699740708,NaN,NaN,NaN,NaN,0.6738256719118103,8.807305560302483,96736898,-0.049476906582999754,-0.04724543100223855,0.0022314755807612066
2025-09-09T14:15:00-04:00,346.65,346.97,346.6,346.89,NaN,NaN,NaN,348.5833473034758,NaN,NaN,346.76099999999883,348.3880291957413,345.13397080425636,346.27866265122833,347.2365889608219,348.61755225543925,345.85562566620456,24428,35639.26666666667,49.223318371232324,49.50581697767107,NaN,NaN,NaN,NaN,0.6521238382038241,8.821052467668725,96761326,-0.03865306883537061,-0.04608486046345206,-0.007431791628081448
2025-09-09T14:20:00-04:00,346.92,346.94,346.3,346.31,NaN,NaN,NaN,348.5833473034758,NaN,NaN,346.7399999999988,348.3626607790444,345.1173392209532,346.27866265122833,347.23345334815656,348.6122212807095,345.8546854156036,15663,34331.36666666667,43.6733474384766,49.11667091388273,NaN,NaN,NaN,NaN,0.6512578497606929,9.299147707911253,96745663,-0.06678913007674318,-0.09091820422401042,-0.024129074147267244
2025-09-09T14:25:00-04:00,346.34,346.63,346.28,346.59,NaN,NaN,NaN,348.58313574168756,NaN,NaN,346.73699999999883,348.36020423971695,345.1137957602807,346.27866265122833,347.22966860692753,348.605878306565,345.8534589072901,18653,32663.733333333334,46.79230175317403,48.56942786705838,NaN,NaN,NaN,NaN,0.629739431920645,9.773951340675561,96764316,-0.06283414558223586,-0.10267175612506207,-0.03983761054282621
2025-09-09T14:30:00-04:00,346.62,346.75,346.19,346.19,NaN,NaN,NaN,348.57776593524727,NaN,NaN,346.7355999999989,348.36056725001504,345.11063274998276,346.27866265122833,347.224604399412,348.59828668240937,345.8509221164146,21589,31723.433333333334,43.11904841141951,48.1987258932723,NaN,NaN,NaN,NaN,0.6247580439263133,9.949952907658023,96742727,-0.08222524181799659,-0.14261916281532194,-0.06039392099732536
2025-09-09T14:35:00-04:00,346.21,346.36,346.02,346.295,NaN,NaN,NaN,348.24832202909965,NaN,NaN,346.72889999999893,348.3583100661244,345.0994899338735,346.27866265122833,347.21818544756854,348.58977607492085,345.84659482021624,23502,30963.066666666666,44.35392901697009,47.8663549949169,NaN,NaN,NaN,NaN,0.6044181836458646,10.405039794405457,96766229,-0.08281736767336453,-0.16391563058903103,-0.08109826291566649
2025-09-09T14:40:00-04:00,346.28,346.64,346.25,346.36,NaN,NaN,NaN,348.24832202909965,NaN,NaN,346.7560999999989,348.31294847160837,345.1992515283895,346.27866265122833,347.2142193635277,348.5835677978014,345.84487092925406,18200,30248.066666666666,45.147819785060754,47.70759217182784,NaN,NaN,NaN,NaN,0.5891025990997305,10.194217601626377,96784429,-0.07395957189458532,-0.17354772778389815,-0.09958815588931283
2025-09-09T14:45:00-04:00,346.41,346.87,346.41,346.8,NaN,NaN,NaN,348.24832202909965,NaN,NaN,346.7884999999989,348.2788036615223,345.2981963384755,345.8439301209827,347.2107491955336,348.5761863220379,345.84531206902926,24668,29712.2,50.31523640020767,47.67187969754855,NaN,NaN,NaN,NaN,0.5834524134497491,9.513552289946723,96809097,-0.03554289584607913,-0.14401677569691174,-0.10847387985083261
2025-09-09T14:50:00-04:00,346.79,346.99,346.6,346.87,NaN,NaN,NaN,348.24832202909965,NaN,NaN,346.82409999999885,348.2332397247028,345.4149602752949,345.83206751083924,347.2087450837674,348.5709621102513,345.8465280572835,19089,28941.133333333335,51.10442211126089,47.88876351974391,NaN,NaN,NaN,NaN,0.5696343839176231,9.033010272708063,96828186,-0.004144678097487697,-0.11365472747269223,-0.10951004937520453
2025-09-09T14:55:00-04:00,346.86,346.96,346.55,346.84,NaN,NaN,NaN,348.24832202909965,NaN,NaN,346.8626999999989,348.161404294166,345.56399570583176,345.83206751083924,347.20603500772614,348.5643278694548,345.8477421459975,23862,28791.9,50.73250157348192,47.99466186369485,NaN,NaN,NaN,NaN,0.558231927923505,8.475568361848765,96804324,0.014836239679415497,-0.09096474977593516,-0.10580098945535066
2025-09-09T15:00:00-04:00,346.86,347.16,346.85,346.85,NaN,NaN,NaN,348.24832202909965,NaN,NaN,346.8946999999989,348.1089840045116,345.6804159954862,346.09492320693715,347.20312609517873,348.55384750633135,345.8524046840261,43620,29202.333333333332,50.8608771798031,47.690669338732974,NaN,NaN,NaN,NaN,0.5412153616432581,8.390144718324425,96847944,0.027558115084221943,-0.07135334560007323,-0.09891146068429517
2025-09-09T15:05:00-04:00,346.83,346.87,345.91,345.93,NaN,NaN,NaN,348.24832202909965,NaN,NaN,346.8972999999989,348.10272143819174,345.69187856180605,346.09492320693715,347.19358378299665,348.54101314626143,345.8461544197319,37787,29473.433333333334,40.42470250178557,46.84459024954479,NaN,NaN,NaN,NaN,0.5711285500973097,9.084549127501127,96810157,-0.023723195611816697,-0.12856545519906604,-0.10484225958724934
2025-09-09T15:10:00-04:00,345.9,346.21,345.7,346.16,NaN,NaN,NaN,347.863626412109,NaN,NaN,346.9098999999989,348.0702163205003,345.7495836794975,346.09492320693715,347.17980836287774,348.5252172852823,345.8343994404732,45587,30247.033333333333,43.54356097078299,46.56476895887066,NaN,NaN,NaN,NaN,0.5667622250903583,10.04448165875903,96855744,-0.03898782901124617,-0.15357704585130705,-0.11458921684006088
2025-09-09T15:15:00-04:00,346.19,346.58,346.19,346.5,NaN,NaN,NaN,347.863626412109,NaN,NaN,346.9288999999989,348.02907506043505,345.8287249395628,346.09492320693715,347.1752634370076,348.5178979166228,345.83262895739233,23408,30209.833333333332,47.886792821648044,46.715853592099656,NaN,NaN,NaN,NaN,0.5562792090124727,10.124171919813604,96879152,-0.023768905365055715,-0.14430034854638052,-0.1205314431813248
2025-09-09T15:20:00-04:00,346.52,346.81,346.46,346.62,NaN,NaN,NaN,347.863626412109,NaN,NaN,346.93289999999894,348.0270829661819,345.83871703381595,346.09492320693715,347.17134671208623,348.5099425322001,345.83275089197235,28189,29490.166666666668,49.36732356156006,46.896084421204534,NaN,NaN,NaN,NaN,0.5415449797972978,9.734015575342433,96907341,-0.004226991749473094,-0.12581518286816618,-0.12158819111869308
2025-09-09T15:25:00-04:00,346.6,346.83,346.3,346.32,NaN,NaN,NaN,347.863626412109,NaN,NaN,346.92329999999885,348.0303259453873,345.8162740546104,346.09492320693715,347.16669554572917,348.50194977645,345.83144131500836,26710,28909.133333333335,45.8596058381982,46.65581924027352,NaN,NaN,NaN,NaN,0.5407203383832031,9.65744804126956,96880631,-0.009793715808743497,-0.13383033587962245,-0.12403662007087896
2025-09-09T15:30:00-04:00,346.35,346.6,346.1,346.49,NaN,NaN,NaN,347.863626412109,NaN,NaN,346.92079999999885,348.0311591507942,345.8104408492035,346.09492320693715,347.15654806663076,348.48587855412995,345.82721757913157,52762,29570.9,48.109615054097716,46.972695498532175,NaN,NaN,NaN,NaN,0.5378117427844028,9.935136135544031,96933393,-0.0007896068000060874,-0.12502362857088656,-0.12423402177088047
2025-09-09T15:35:00-04:00,346.5,346.72,346.2,346.5,NaN,NaN,NaN,347.863626412109,NaN,NaN,346.92319999999893,348.029384000762,345.8170159992359,346.09492320693715,347.1503021603334,348.47513910601526,345.82546521465156,36940,29117.666666666668,48.245867303460535,47.076521609266926,NaN,NaN,NaN,NaN,0.5365394754426626,9.922179910740907,96970333,0.006666181281814579,-0.11590129516861225,-0.12256747645042683
2025-09-09T15:40:00-04:00,346.49,346.57,346.18,346.55,NaN,NaN,NaN,347.863626412109,NaN,NaN,346.91839999999894,348.0289285964605,345.8078714035374,346.09492320693715,347.1460083518981,348.46803008421847,345.82398661957774,24345,28822.9,48.9674051687255,47.49426137764592,NaN,NaN,NaN,NaN,0.5260723700539,9.948551946071529,96994678,0.0152981800483524,-0.10344475138998632,-0.11874293143833872
2025-09-09T15:45:00-04:00,346.55,347.03,346.54,346.89,NaN,NaN,NaN,347.863626412109,NaN,NaN,346.9243999999989,348.03100135713464,345.8177986428632,346.09492320693715,347.14229116046926,348.4572099768075,345.827372344131,46885,29544.366666666665,53.694953849925774,48.16147743714276,NaN,NaN,NaN,NaN,0.5234957721929037,9.515847579531062,97041563,0.04268715610631209,-0.06538398630544862,-0.1080711424117607
2025-09-09T15:50:00-04:00,346.87,346.91,346.32,346.62,NaN,NaN,NaN,347.863626412109,NaN,NaN,346.92899999999895,348.02856718918764,345.82943281081026,345.83670155988955,347.13482353521727,348.441849384926,345.82779768550853,59261,30455.8,49.75328908494111,48.49043952999135,NaN,NaN,NaN,NaN,0.5282460741791272,9.019179358923262,96982302,0.041370799172149,-0.05635764344657446,-0.09772844261872346
2025-09-09T15:55:00-04:00,346.65,347.15,346.6,347.005,NaN,NaN,NaN,347.863626412109,NaN,NaN,346.9342999999989,348.0327261666493,345.83587383334856,345.8752889983293,347.12611516986004,348.4072898679853,345.8449404717348,174820,35475.86666666667,54.84363014784023,48.81389622625081,NaN,NaN,NaN,NaN,0.529799926023472,8.69016073921921,97157122,0.06383777861977327,-0.017931219344006877,-0.08176899796378015
2025-09-10T09:30:00-04:00,350.37,352.2,348.36,351.16,347.8952602082666,347.8952602082666,347.8952602082666,NaN,NaN,NaN,347.0052999999989,348.6110314980222,345.3995685019756,348.58273119866345,350.5733333333334,350.5733333333334,350.5733333333334,240138,42795.63333333333,79.2615979050875,50.825123068667025,NaN,NaN,NaN,NaN,0.8630285027360808,12.525462273988158,97397260,0.3404810297461287,0.34383228921888076,0.0033512594727520273
2025-09-10T09:35:00-04:00,351.18,351.26,346.96,347.84,NaN,NaN,NaN,351.9727061648364,351.9727061648364,351.9727061648364,347.00749999999897,348.6174928582132,345.39750714178473,348.58273119866345,349.7636688631732,350.69748384097744,348.829853885369,180530,47599.96666666667,54.092039740298674,51.0650900805825,NaN,NaN,NaN,NaN,1.1085264668263615,14.30862217390844,97216730,0.28412188521666554,0.35850361599358394,0.07438173077691841
2025-09-10T09:40:00-04:00,347.8,347.8,346.08,346.9,NaN,NaN,NaN,349.9125831573438,NaN,NaN,346.987899999999,348.5786747682819,345.3971252317161,348.58273119866345,348.99136703118756,350.4844174615239,347.49831660085124,157351,52103.46666666667,49.31693101664888,50.95480821178577,NaN,NaN,NaN,NaN,1.1550602906244778,15.04107196543652,97059379,0.17323619854154404,0.29092697895384845,0.11769078041230442
2025-09-10T09:45:00-04:00,346.93,348.03,346.21,347.83,NaN,NaN,NaN,349.9125831573438,NaN,NaN,346.983299999999,348.56293870660465,345.4036612933934,348.58273119866345,348.71835315338683,350.2112217905982,347.22548451617547,115891,55112.63333333333,53.67418387398731,51.90119973837161,NaN,NaN,NaN,NaN,1.2025559841513005,15.860123458007758,97175270,0.1529313335301699,0.30885494732501684,0.15592361379484693
2025-09-10T09:50:00-04:00,347.87,348.5,346.66,348.13,NaN,NaN,NaN,349.9125831573438,NaN,NaN,346.979299999999,348.5462397063678,345.4123602936302,348.58273119866345,348.58268655689164,350.00508624160136,347.1602868721819,114896,58048.53333333333,55.01761476083177,52.72077500908939,NaN,NaN,NaN,NaN,1.2480876995690628,16.902514648162224,97290166,0.1499114976224693,0.34331298582293357,0.19340148820046427
2025-09-10T09:55:00-04:00,348.2,349.19,347.57,347.74,NaN,NaN,NaN,349.9125831573438,NaN,NaN,346.98229999999893,348.55447074253686,345.410129257461,348.58273119866345,348.5358497656394,349.88222706189384,347.18947246938495,102610,60522.46666666667,52.87107742749935,53.07679533807876,NaN,NaN,NaN,NaN,1.2746528638855585,18.259130441835435,97187556,0.11350802121735373,0.3352865147221564,0.2217784935048027
2025-09-10T10:00:00-04:00,347.68,350.27,347.6,349.8,345.4477101759469,345.4477101759469,345.4477101759469,NaN,NaN,NaN,347.0325999999989,348.79027601215,345.27492398784784,348.58273119866345,348.6108863121431,349.8996198297674,347.32215279451884,111666,63514.63333333333,61.43087946785903,53.938477902814405,NaN,NaN,NaN,NaN,1.3743205164651584,20.052383360416627,97299222,0.2141832246967263,0.48950752437571055,0.27532429967898425
2025-09-10T10:05:00-04:00,349.88,351.41,349.73,350.37,347.0121324406766,NaN,NaN,NaN,NaN,NaN,347.0857999999989,349.06884146293,345.10275853706787,348.58273119866345,348.9092504108443,350.2784119432786,347.54008887841,191490,68615.2,63.41111869616184,55.19215739266895,NaN,NaN,NaN,NaN,1.396154765289076,22.190705478927537,97490712,0.29992264256587825,0.6502276028863321,0.35030496032045383
2025-09-10T10:10:00-04:00,350.43,350.5,349,349.1,347.0121324406766,NaN,NaN,NaN,NaN,NaN,347.1067999999989,349.1515188177952,345.0620811822026,348.58273119866345,348.945450610457,350.282293009235,347.608608211679,74790,69311,56.4560423386892,55.78833077013977,NaN,NaN,NaN,NaN,1.403572282054142,23.37665360292353,97415922,0.25369791161137123,0.6674273498346679,0.41372943822329666
2025-09-10T10:15:00-04:00,349.17,350.06,349.13,349.895,347.0121324406766,NaN,NaN,NaN,NaN,NaN,347.1568999999989,349.3446713691546,344.9691286308433,348.58273119866345,348.9824822873337,350.2959657651342,347.6689988095332,67012,70730.46666666666,59.45404563216893,56.58891493647609,NaN,NaN,NaN,NaN,1.3718885476217018,24.477891146634093,97482934,0.25838903244912437,0.7367157287847022,0.4783266963355778
2025-09-10T10:20:00-04:00,349.84,350.57,349.5,349.81,347.0121324406766,NaN,NaN,NaN,NaN,NaN,347.20829999999887,349.5187844608375,344.89781553916026,346.6720609919355,349.0239722173589,350.32429842224576,347.72364601247205,60122,72212.43333333333,58.98642596364642,57.30455927897043,NaN,NaN,NaN,NaN,1.3503250799344368,25.749781261306616,97422812,0.23799884144903616,0.775825248146873,0.5378264066978369
2025-09-10T10:25:00-04:00,349.8,350.34,348.86,349.16,347.0121324406766,NaN,NaN,NaN,NaN,NaN,347.24349999999885,349.61735193388273,344.86964806611496,346.6720609919355,349.0436677450738,350.316992025246,347.77034346490154,68101,73860.7,55.39815079303376,57.42621620347814,NaN,NaN,NaN,NaN,1.3595875742248313,26.203614565708342,97354711,0.16635763004132564,0.7457734442494939,0.5794158142081682
2025-09-10T10:30:00-04:00,349.12,350.53,349.07,350.06,347.0121324406766,NaN,NaN,NaN,NaN,NaN,347.31709999999885,349.80476323362814,344.82943676636955,346.7133190348387,349.07599633415623,350.3351168223684,347.8168758459441,59204,75114.53333333334,59.107448591498425,58.09437045394652,NaN,NaN,NaN,NaN,1.3667598903516276,26.733494825232828,97413915,0.16488703885061695,0.7855246127714395,0.6206375739208225
2025-09-10T10:35:00-04:00,350.12,351.25,350.12,350.92,347.0597713762846,NaN,NaN,NaN,NaN,NaN,347.41009999999886,350.0755511745521,344.7446488254456,347.601655227871,349.1612034767078,350.4425459642809,347.87986098913467,82105,77067.96666666666,62.33119796405546,58.62919672653333,NaN,NaN,NaN,NaN,1.35413418389794,27.622071337554882,97496020,0.2045466063339474,0.8763208318382567,0.6717742255043093
2025-09-10T10:40:00-04:00,350.86,351.99,350.32,351.93,347.4668272228171,NaN,NaN,NaN,NaN,NaN,347.5188999999989,350.45554999001183,344.58225000998596,348.2363241822968,349.381077294611,350.769741021366,347.992413567856,175910,82324.96666666666,65.74650361267925,57.663832848504164,NaN,NaN,NaN,NaN,1.3766960279052312,28.815301929684782,97671930,0.2770131868700775,1.0180407090919061,0.7410275222218287
2025-09-10T10:45:00-04:00,352,353.32,351.47,353.28,348.62219871268906,NaN,NaN,NaN,NaN,NaN,347.64049999999884,350.98891051902785,344.2920894809698,349.3920593458374,349.7736012097223,351.46013214366747,348.08707027577714,242510,89586.36666666667,69.70085468371994,58.77874820160569,NaN,NaN,NaN,NaN,1.4105034544834265,30.48357108933501,97914440,0.3873103863242695,1.2251655051271655,0.837855118802896
2025-09-10T10:50:00-04:00,353.28,353.85,352.65,353.83,349.48505331665774,NaN,NaN,NaN,NaN,NaN,347.7788999999989,351.54152370744134,344.0162762925564,350.10764747666997,349.993437907547,351.8461133107019,348.14076250439206,130270,93292.4,71.16153782759542,60.33907725953044,NaN,NaN,NaN,NaN,1.3954674934488993,32.227464511599365,98044710,0.46360023359316904,1.4173554107943573,0.9537551772011883
2025-09-10T10:55:00-04:00,353.76,355.49,353.74,355.38,350.7825508931733,NaN,NaN,NaN,NaN,NaN,347.9356999999989,352.25733904597195,343.6140609540259,351.62111798133594,350.4691462605897,352.7475443843473,348.1907481368321,235062,100332.4,74.84239248362645,61.851092160218954,NaN,NaN,NaN,NaN,1.420791243916835,34.36115673069165,98279772,0.5773367165960166,1.675426072946209,1.0980893563501923
2025-09-10T11:00:00-04:00,355.41,355.87,354.31,355.02,351.21902585257453,NaN,NaN,NaN,NaN,NaN,348.0994999999989,352.8414849223517,343.3575150776461,351.99489438506873,350.92134465897783,353.48162297614846,348.3610663418072,262861,107640.43333333333,72.52696304962174,63.10175989513251,NaN,NaN,NaN,NaN,1.4307347264942043,36.446166746885815,98016911,0.5853741659833485,1.829807063829378,1.2444328978460295
2025-09-10T11:05:00-04:00,354.97,355.22,354.06,355.02,351.21902585257453,NaN,NaN,NaN,NaN,NaN,348.2616999999989,353.370462907384,343.15293709261374,351.99489438506873,351.07577012017714,353.69526400428134,348.45627623607294,111817,110108.1,72.52696304962174,64.50575172528411,NaN,NaN,NaN,NaN,1.41139653174462,38.07350597410886,98016911,0.5483803452938862,1.9299083294633874,1.3815279841695012
2025-09-10T11:10:00-04:00,355.07,356.05,354.64,355.99,351.4746702499698,NaN,NaN,NaN,NaN,NaN,348.4470999999989,353.97430077107623,342.91989922892157,352.400932406444,351.3173034108253,354.05900133952184,348.5756054821287,158510,113872.2,74.948831125501,65.47131970082997,NaN,NaN,NaN,NaN,1.411296779477149,39.836028949172146,98175421,0.5457543383011914,2.0637209070459903,1.517966568744799
2025-09-10T11:15:00-04:00,356,356.33,354.76,354.86,351.63650342042564,NaN,NaN,NaN,NaN,NaN,348.6024999999989,354.39870884749513,342.80629115250264,352.6257459251552,351.46533801423953,354.25976148688017,348.6709145415989,113115,116862.43333333333,67.48529939044354,65.76233260756437,NaN,NaN,NaN,NaN,1.4226327238002092,41.55357515539362,98062306,0.4295460921954466,2.0548991839891073,1.6253530917936607
2025-09-10T11:20:00-04:00,354.77,355,354.18,354.73,351.63650342042564,NaN,NaN,NaN,NaN,NaN,348.761299999999,354.78093912901056,342.7416608709874,352.6257459251552,351.5476852844645,354.35132702456343,348.7440435443655,81467,118638.36666666667,66.66284288081353,66.49138978914469,NaN,NaN,NaN,NaN,1.3795875292430508,42.40476555170511,97980839,0.31107716873849145,2.014199552716775,1.7031223839782836
2025-09-10T11:25:00-04:00,354.7,354.9,354.03,354.67,351.63650342042564,NaN,NaN,NaN,NaN,NaN,348.9164999999989,355.13409929584986,342.69890070414795,352.6257459251552,351.61704118323865,354.424188075073,348.8098942914043,74615,120235.2,66.2614613779218,66.97763377098418,NaN,NaN,NaN,NaN,1.3431884200114046,43.00456359377972,97906224,0.2011598619178463,1.9545722113755915,1.7534123494577452
2025-09-10T11:30:00-04:00,354.73,354.73,353.5,353.85,351.63650342042564,NaN,NaN,NaN,NaN,NaN,349.042499999999,355.39803341613026,342.68696658386773,352.6257459251552,351.66810138205784,354.46694452801455,348.86925823610113,69537,120794.36666666667,60.86751778001342,67.11199747215325,NaN,NaN,NaN,NaN,1.335103532867734,42.89311706514371,97836687,0.053404681068595306,1.8201682007934892,1.7667635197248939
2025-09-10T11:35:00-04:00,353.85,354.72,353.63,354.67,351.63650342042564,NaN,NaN,NaN,NaN,NaN,349.19049999999896,355.7163983292398,342.66460167075815,352.6257459251552,351.71314152100894,354.5095298156467,348.91675322637116,56266,121438.56666666667,64.02159272203397,67.72795760993897,NaN,NaN,NaN,NaN,1.3175961376628982,42.789631002838846,97892953,-0.005781726856301628,1.7595363611545167,1.7653180880108184
2025-09-10T11:40:00-04:00,354.7,355.15,354.37,355.15,351.63650342042564,NaN,NaN,NaN,NaN,NaN,349.358299999999,356.0548204728645,342.66177952713355,352.6257459251552,351.76523979933785,354.56779988311484,348.96267971556085,55651,122482.1,65.76125336411474,68.20322937941157,NaN,NaN,NaN,NaN,1.2791964135441176,42.92427368104937,97948604,-0.028037122443040685,1.7302716849570174,1.7583088074000581
2025-09-10T11:45:00-04:00,355.14,355.16,354.55,354.77,351.63650342042564,NaN,NaN,NaN,NaN,NaN,349.522299999999,356.33821907548065,342.70638092451736,352.6257459251552,351.7996603745732,354.60505259268876,348.9942681564576,38588,122205.53333333334,63.157645479040085,68.26226134476762,NaN,NaN,NaN,NaN,1.2313966697195387,43.05475143971453,97910016,-0.08079749896674193,1.6573119336916307,1.7381094326583726
2025-09-10T11:50:00-04:00,354.82,355.8,354.68,355.15,351.64164526933797,NaN,NaN,NaN,NaN,NaN,349.691899999999,356.63628820656913,342.7475117934289,353.1885977758431,351.8764733388416,354.6958736515005,349.0570730261827,79084,122866.3,64.66426739105312,68.18495875750861,NaN,NaN,NaN,NaN,1.2234397647395718,43.51859992788892,97989100,-0.10122644209702392,1.6115763800370928,1.7128028221341167
2025-09-10T11:55:00-04:00,355.19,355.39,354.82,354.84,351.64164526933797,NaN,NaN,NaN,NaN,NaN,349.85089999999894,356.8947332435997,342.80706675639817,353.1885977758431,351.9110885637526,354.73401154688906,349.0881655806162,39136,118343.5,62.42165128968133,67.66501565793442,NaN,NaN,NaN,NaN,1.1767654958296017,43.94931638119372,97949964,-0.14412322268081645,1.5326487937830962,1.6767720164639126
2025-09-10T12:00:00-04:00,354.84,355.09,354.24,354.65,351.64164526933797,NaN,NaN,NaN,NaN,NaN,350.01769999999897,357.1130343010467,342.92236569895124,353.1885977758431,351.9447796416867,354.7666061577495,349.1229531256239,44053,111807.33333333333,61.02472655623693,66.94095770998024,NaN,NaN,NaN,NaN,1.153425103270342,43.455868338261816,97905911,-0.19086708274856923,1.438188163028201,1.6290552457767702
2025-09-10T12:05:00-04:00,354.67,354.93,354.24,354.44,351.64164526933797,NaN,NaN,NaN,NaN,NaN,350.1746999999989,357.30700549288076,343.042394507117,353.1885977758431,351.9642014656011,354.784307811667,349.14409511953517,27137,106694.23333333334,59.4413763333441,65.84088512781722,NaN,NaN,NaN,NaN,1.120323310179603,42.99766658411077,97878774,-0.23841315590760925,1.3310388008922587,1.569451956799868
2025-09-10T12:10:00-04:00,354.47,354.705,354.02,354.27,351.64164526933797,NaN,NaN,NaN,NaN,NaN,350.33629999999886,357.4662940563693,343.2063059436284,353.1885977758431,351.9856085065883,354.80186657875197,349.1693504344246,33045,102550.7,58.12657484200988,64.81228597013066,NaN,NaN,NaN,NaN,1.0892287880239173,42.22482853073754,97845729,-0.28087349860861743,1.2183600835390962,1.4992335821477136
2025-09-10T12:15:00-04:00,354.295,354.85,354.04,354.18,351.64164526933797,NaN,NaN,NaN,NaN,NaN,350.49399999999895,357.6082597649824,343.3797402350155,353.1885977758431,352.00630713654374,354.81890749681344,349.19370677627404,32184,99760.46666666666,57.40266964669479,63.731979298493016,NaN,NaN,NaN,NaN,1.0692838745936377,41.626216747714956,97813545,-0.31217478203506355,1.109015104603884,1.4211898866389476
2025-09-10T12:20:00-04:00,354.1,354.2,353.58,353.83,351.64164526933797,NaN,NaN,NaN,NaN,NaN,350.64339999999885,357.71775691522356,343.56904308477414,353.1885977758431,352.0373262318523,354.83659462162916,349.2380578420755,62400,98010.6,54.55710475282458,62.27542741473042,NaN,NaN,NaN,NaN,1.037192169265521,40.33002284786847,97751145,-0.35072200141288934,0.9827873848728359,1.3335093862857252
2025-09-10T12:25:00-04:00,353.83,354.39,353.51,354.23,351.64164526933797,NaN,NaN,NaN,NaN,NaN,350.79199999999895,357.8493051516629,343.734694848335,353.1885977758431,352.07159929505497,354.85900001700224,349.2841985731077,65168,96762.53333333334,57.170221777566134,61.53863615666775,NaN,NaN,NaN,NaN,1.0259641571751263,39.30841862623943,97816313,-0.34312750988367413,0.9045999989311326,1.2477275088148068
2025-09-10T12:30:00-04:00,354.26,354.67,354.03,354.4,351.64164526933797,NaN,NaN,NaN,NaN,NaN,350.94259999999895,357.98004846970065,343.90515153029725,353.1885977758431,352.0916559102034,354.87505907337703,349.3082527470297,33627,94161.23333333334,58.26854460665053,60.93904342279897,NaN,NaN,NaN,NaN,0.9983952888054776,38.62500097758259,97849940,-0.320906409342105,0.8465944971371755,1.1675009064792805
2025-09-10T12:35:00-04:00,354.36,354.68,353.9,353.96,351.64164526933797,NaN,NaN,NaN,NaN,NaN,351.08499999999896,358.07259186012504,344.09740813987287,353.1885977758431,352.1079975046416,354.88658869282455,349.3294063164587,30348,88789.83333333333,54.381464234801896,60.0904721982904,NaN,NaN,NaN,NaN,0.9827956253193741,37.76351237767553,97819592,-0.328879864754382,0.7564010755363029,1.085280940290685
2025-09-10T12:40:00-04:00,353.96,354,352.7,352.76,351.64164526933797,NaN,NaN,NaN,NaN,NaN,351.2031999999989,358.0995894208375,344.3068105791603,353.01587822067444,352.12865117015207,354.8834996271214,349.3738027131827,78171,88902.53333333334,45.47208456497088,58.99079839721594,NaN,NaN,NaN,NaN,1.0054530806537054,35.19400978432897,97741421,-0.40311254192858814,0.5813902628799497,0.9845028048085378
2025-09-10T12:45:00-04:00,352.745,353.37,352.72,353.18,351.64164526933797,NaN,NaN,NaN,NaN,NaN,351.3481999999989,358.0983240761884,344.59807592380935,352.7657025765396,352.1405913735459,354.8803480109187,349.40083473617307,49758,88327.4,48.643442092375324,57.89235906652603,NaN,NaN,NaN,NaN,0.9800635748927249,32.808043090507155,97791179,-0.41068042563861895,0.47115227276026417,0.8818326983988831
2025-09-10T12:50:00-04:00,353.2,354.12,353.07,353.98,351.64164526933797,NaN,NaN,NaN,NaN,NaN,351.5045999999989,358.1278203167249,344.8813796832729,352.7601597191883,352.1557983793901,354.88672928977604,349.42486746900414,38865,87618.83333333333,54.11738036781287,57.060653852504466,NaN,NaN,NaN,NaN,0.9850590338289597,31.46413494914812,97830044,-0.3508806513347069,0.4432318842304994,0.7941125355652063
2025-09-10T12:55:00-04:00,353.97,354.3,353.93,354.23,351.64164526933797,NaN,NaN,NaN,NaN,NaN,351.6591999999989,358.16780856434343,345.1505914356544,352.7601597191883,352.1701798250621,354.89649781437004,349.4438618357542,29334,86326.6,55.70622484824935,56.52840952173371,NaN,NaN,NaN,NaN,0.94112624569832,30.407372685505518,97859378,-0.28629092421902114,0.43624888029142994,0.7225398045104511
2025-09-10T13:00:00-04:00,354.24,355.38,354.12,355.01,351.70745011592214,NaN,NaN,NaN,NaN,NaN,351.82699999999886,358.23918402761626,345.41481597238146,353.1969010480266,352.22027054119815,354.9450163058474,349.4955247765489,78004,86953.26666666666,60.32273875663562,56.21830033356103,NaN,NaN,NaN,NaN,0.9639029424341538,30.422474492122625,97937382,-0.18760897095225215,0.48802859082013583,0.675637561772388
2025-09-10T13:05:00-04:00,355.01,355.19,354.55,354.65,351.87847511065297,NaN,NaN,NaN,NaN,NaN,351.9935999999988,358.2559050200441,345.73129497995353,353.1969010480266,352.24461411929576,354.967887188028,349.52134105056354,39609,85536.73333333334,57.3516869165117,55.85616002119177,NaN,NaN,NaN,NaN,0.9407670179745704,30.43649759826709,97897773,-0.14505627982250446,0.4943172119942574,0.6393734918167618
2025-09-10T13:10:00-04:00,354.68,354.96,354.47,354.75,351.87847511065297,NaN,NaN,NaN,NaN,NaN,352.1587999999989,358.26551353870025,346.05208646129756,353.1969010480266,352.25641496998065,354.97856615644594,349.53426378351537,20026,80340.6,57.97092996756096,55.6380316934292,NaN,NaN,NaN,NaN,0.9085693738335262,30.317249004846953,97917799,-0.11022826722007106,0.501588157791673,0.611816425011744
2025-09-10T13:15:00-04:00,354.76,354.86,354.33,354.41,351.87847511065297,NaN,NaN,NaN,NaN,NaN,352.31699999999887,358.23608033430173,346.397919665696,353.1969010480266,352.27057856162213,354.990148596986,349.5510085262583,26365,73135.76666666666,55.044508444671,55.32396970138111,NaN,NaN,NaN,NaN,0.8815287042739907,29.96716898200174,97891434,-0.10989621499966651,0.4744461562621609,0.5843423712618274
2025-09-10T13:20:00-04:00,354.46,354.8,354.32,354.65,351.87847511065297,NaN,NaN,NaN,NaN,NaN,352.4789999999989,358.19785513051113,346.7601448694867,353.1969010480266,352.2884042037122,355.0050652126199,349.5717431948045,32826,69887.63333333333,56.70590125330639,55.22249301647373,NaN,NaN,NaN,NaN,0.8528480825401354,29.62419814340322,97924260,-0.09393824845707388,0.466919560690485,0.5608578091475589
2025-09-10T13:25:00-04:00,354.64,354.9,354.11,354.27,351.87847511065297,NaN,NaN,NaN,NaN,NaN,352.62659999999886,358.13802647270074,347.115173527297,353.1969010480266,352.3051844378646,355.0177346696121,349.59263420611717,33784,63178.36666666667,53.34438419209508,54.93261548400231,NaN,NaN,NaN,NaN,0.848358933787266,28.919257504985012,97890476,-0.10837565181402253,0.42538824438003076,0.5337638961940533
2025-09-10T13:30:00-04:00,354.29,354.69,353.85,354.65,351.87847511065297,NaN,NaN,NaN,NaN,NaN,352.78719999999885,358.0515940433833,347.5228059566144,353.1969010480266,352.3229853053443,355.0307921360929,349.61517847459567,36955,55648.166666666664,56.144135294596225,55.04597480841458,NaN,NaN,NaN,NaN,0.8477618670881738,27.79852102449427,97927431,-0.09235901709317362,0.41831512482758626,0.5106741419207599
2025-09-10T13:35:00-04:00,354.62,354.89,354.17,354.43,351.87847511065297,NaN,NaN,NaN,NaN,NaN,352.93569999999886,357.9523554639415,347.9190445360562,353.1969010480266,352.34511299438907,355.047923766873,349.64230222190514,44655,53409.433333333334,54.11929220637162,54.82805126761496,NaN,NaN,NaN,NaN,0.8386360194390164,27.025550989244163,97882776,-0.09617409316449577,0.3904565254651402,0.48663061862963597
2025-09-10T13:40:00-04:00,354.43,355.08,354.38,354.99,352.0205279324018,NaN,NaN,NaN,NaN,NaN,353.0122999999988,358.0351204073111,347.98947959268645,353.2882234293337,352.36936442383706,355.06989336340666,349.66883548426745,43469,49574.73333333333,58.24713619589247,54.82652209541796,NaN,NaN,NaN,NaN,0.828733446621943,26.558763842043103,97926245,-0.062222330774411916,0.4088527051616211,0.471075035936033
2025-09-10T13:45:00-04:00,354.94,355.66,354.83,355.61,352.54550393547447,NaN,NaN,NaN,NaN,NaN,353.16769999999883,358.0186542199399,348.3167457800578,353.81157874346695,352.4214812043496,355.12694654407505,349.7160158646242,78393,48417.333333333336,62.29209342770829,55.39156703776842,NaN,NaN,NaN,NaN,0.8288239147203785,26.818952261152766,98004638,-0.0024079760818788154,0.46806506583368446,0.4704730419155633
2025-09-10T13:50:00-04:00,355.65,356.26,355.01,355.03,352.88775375658923,NaN,NaN,NaN,NaN,NaN,353.33029999999883,357.86469407682654,348.7959059231711,354.15626299477356,352.4881107362885,355.1999100152608,349.7763114573162,101995,49101.6,56.753014109148566,56.19734771949539,NaN,NaN,NaN,NaN,0.85890792081178,27.657677208324387,97902643,-0.0060947252040439714,0.4628546354105083,0.4689493606145523
2025-09-10T13:55:00-04:00,355.01,355.02,354.32,354.68,352.88775375658923,NaN,NaN,NaN,NaN,NaN,353.4672999999988,357.7347494541986,349.19985054579894,354.15626299477356,352.50576495683015,355.2136628336503,349.79786708001,37551,47866.13333333333,53.65259689431536,56.555144491062535,NaN,NaN,NaN,NaN,0.8482716407537944,27.158073667885425,97865092,-0.034697516705734066,0.42557746473238467,0.46027498143811874
2025-09-10T14:00:00-04:00,354.65,354.86,354.46,354.71,352.88775375658923,NaN,NaN,NaN,NaN,NaN,353.5988999999988,357.59720628692554,349.6005937130721,354.15626299477356,352.51702495108907,355.22238912074624,349.8116607814319,24234,46356.03333333333,53.885143477920096,56.538556141784476,NaN,NaN,NaN,NaN,0.8162522378428115,26.694156094620674,97889326,-0.053088000362663756,0.39391498098478905,0.4470029813474528
2025-09-10T14:05:00-04:00,354.68,354.68,353.9,354.22,352.88775375658923,NaN,NaN,NaN,NaN,NaN,353.7284999999988,357.36222990247705,350.09477009752055,354.15626299477356,352.53032992867776,355.2296707065665,349.83098915078904,35802,45673.9,49.51513726508745,56.09633560013007,NaN,NaN,NaN,NaN,0.8158056494254681,25.32907971663051,97853524,-0.09717773465940832,0.3255308130231924,0.42270854768260074
2025-09-10T14:10:00-04:00,354.2,354.45,353.77,354.19,352.88775375658923,NaN,NaN,NaN,NaN,NaN,353.8162999999988,357.2739794594299,350.35862054056776,354.15626299477356,352.5411358789585,355.2345844894348,349.8476872684823,31886,44881.73333333333,49.25178030383224,55.30555285350125,NaN,NaN,NaN,NaN,0.806105245895078,23.858749621518307,97821638,-0.12548639158290842,0.2658505582039652,0.3913369497868736
2025-09-10T14:15:00-04:00,354.15,354.25,353.45,353.57,352.88775375658923,NaN,NaN,NaN,NaN,NaN,353.88029999999884,357.19599866605563,350.56460133394205,354.15626299477356,352.5515475590371,355.2357741869785,349.86732093109566,40951,44960.5,44.038678441273944,54.35462367669856,NaN,NaN,NaN,NaN,0.8056691569025733,22.304763123106177,97780687,-0.179786201148043,0.16660419835181983,0.34639039949986283
2025-09-10T14:20:00-04:00,353.56,354.2,353.46,354.12,352.88775375658923,NaN,NaN,NaN,NaN,NaN,353.9806999999988,357.0022942884629,350.95910571153473,354.15626299477356,352.5629835122488,355.23894087342427,349.88702615107337,40093,43660.8,49.17774123064224,53.726538766918644,NaN,NaN,NaN,NaN,0.8009785028381045,20.86177566029492,97820780,-0.1724538401269533,0.1308230993411712,0.3032769394681245
2025-09-10T14:25:00-04:00,354.16,354.26,353.22,353.65,352.88775375658923,NaN,NaN,NaN,NaN,NaN,354.05579999999884,356.8452059303138,351.2663940696839,354.15626299477356,352.5735883859963,355.23940791807547,349.9077688539171,44989,43855.9,45.34552302923919,53.03375409438781,NaN,NaN,NaN,NaN,0.8180514669210944,19.89808426058448,97775791,-0.1915769629854065,0.06380573573636639,0.2553826987217729
2025-09-10T14:30:00-04:00,353.65,354.35,353.42,354.22,352.88775375658923,NaN,NaN,NaN,NaN,NaN,354.14399999999887,356.6559076424137,351.63209235758404,354.15626299477356,352.58211381651296,355.24220385300003,349.9220237800259,29327,43365.03333333333,50.394181079512826,52.582916939116835,NaN,NaN,NaN,NaN,0.8260477907124454,18.840132248336076,97805118,-0.15947239189092527,0.05604220885811628,0.21551460074904155
2025-09-10T14:35:00-04:00,354.15,354.43,353.79,353.83,352.88775375658923,NaN,NaN,NaN,NaN,NaN,354.23739999999884,356.3099474576323,352.1648525423654,354.15626299477356,352.59042309112147,355.2450311041613,349.93581507808165,28520,43411.13333333333,47.18268566489521,52.14279561574541,NaN,NaN,NaN,NaN,0.8127586628044127,17.707991251516926,97776598,-0.15784375676508602,0.01820990479268403,0.17605366155777005
2025-09-10T14:40:00-04:00,353.88,353.9,352.58,352.7,NaN,NaN,NaN,355.88891736689106,355.88891736689106,355.88891736689106,354.2901999999989,356.0444336913841,352.5359663086137,353.02960831665507,352.59644127893534,355.2345122603451,349.95837029752556,63924,44440.433333333334,39.35662390919924,50.943687659645626,NaN,NaN,NaN,NaN,0.8489901868898112,18.35624402695494,97712674,-0.22226753700674362,-0.10178075970065947,0.12048677730608415
2025-09-10T14:45:00-04:00,352.75,352.95,351.49,351.77,NaN,NaN,NaN,354.9476029411233,NaN,NaN,354.30719999999883,355.94293611692353,352.6714638830741,353.02960831665507,352.58716696263053,355.2028142617244,349.97151966353664,89445,46349.13333333333,34.31233376183998,49.52890491360766,NaN,NaN,NaN,NaN,0.8926337449691089,19.96338136586764,97623229,-0.3114443650967929,-0.268818679064907,0.04262568603188592
2025-09-10T14:50:00-04:00,351.75,351.77,351,351.63,NaN,NaN,NaN,354.093620989254,NaN,NaN,354.30119999999886,355.97356187595346,352.62883812404425,352.81068665332407,352.56703663411344,355.1633510917353,349.97072217649156,92883,47365.23333333333,33.613891063851256,47.76938740417614,NaN,NaN,NaN,NaN,0.8838741917570284,21.815358195747944,97530346,-0.3603353282231092,-0.40779347424700063,-0.047458146023891395
2025-09-10T14:55:00-04:00,351.6,351.63,351.14,351.26,NaN,NaN,NaN,354.037320035197,NaN,NaN,354.2607999999989,356.1173423356334,352.40425766436437,352.61454932265923,352.55769395493974,355.1462706666054,349.96911724327407,39776,46518.833333333336,31.773124088347103,45.5894610227932,NaN,NaN,NaN,NaN,0.8557403209172413,23.535050966351086,97490570,-0.3952697321581418,-0.5415453112215687,-0.14627557906342686
2025-09-10T15:00:00-04:00,351.32,351.55,350.31,350.57,NaN,NaN,NaN,353.6308509426881,NaN,NaN,354.1955999999988,356.31801809361525,352.0731819063824,352.450479522049,352.52621164234296,355.1018776226794,349.9505456620065,95570,48583.6,28.62496258664538,43.58031448547155,NaN,NaN,NaN,NaN,0.8831874408517246,25.685658807006035,97395000,-0.4391458687422306,-0.6952079149912151,-0.25606204624898454
2025-09-10T15:05:00-04:00,350.59,350.76,349.44,349.6,NaN,NaN,NaN,352.8580849907477,NaN,NaN,354.07999999999885,356.5353093499858,351.62469065001187,352.450479522049,352.4799820480586,355.0555410597265,349.9044230363907,96310,50782.333333333336,24.89117348694397,41.52592709923073,NaN,NaN,NaN,NaN,0.9143883379337439,28.143623717598924,97298690,-0.5031944941428723,-0.885055163927575,-0.3818606697847027
2025-09-10T15:10:00-04:00,349.57,349.58,347.98,348.07,NaN,NaN,NaN,351.63362658207734,NaN,NaN,353.94099999999884,356.9024489703623,350.9795510296354,352.450479522049,352.3689777177414,354.99025945334756,349.74769598213527,156736,53401.166666666664,20.37639381138341,39.1324449801924,NaN,NaN,NaN,NaN,0.9647891709384767,30.998975133264032,97141954,-0.6111203196488626,-1.145761069345781,-0.5346407496969183
2025-09-10T15:15:00-04:00,348.1,348.53,347.65,348.43,NaN,NaN,NaN,350.93391628289197,NaN,NaN,353.8091999999987,357.1314350074041,350.48696499259336,352.450479522049,352.28691845306236,354.94602721130394,349.62780969482077,111697,55465.8,23.875147789977603,37.30101716054169,NaN,NaN,NaN,NaN,0.958732801585728,33.7566044940384,97253651,-0.6188816225855028,-1.3082427779287968,-0.689361155343294
2025-09-10T15:20:00-04:00,348.42,348.43,347.2,347.69,NaN,NaN,NaN,350.69737463366965,NaN,NaN,353.6431999999988,357.3231618264623,349.9632381735353,352.450479522049,352.2071589029777,354.90892687675637,349.50539092919905,102000,57570.3,21.75865181375093,35.33722226839303,NaN,NaN,NaN,NaN,0.9781090300438916,36.456451906029365,97151651,-0.6322437567546882,-1.4796658512866543,-0.847422094531966
2025-09-10T15:25:00-04:00,347.69,348.19,347.16,347.44,NaN,NaN,NaN,350.566812150321,NaN,NaN,353.49479999999875,357.546214054913,349.4433859450845,351.65638361763916,352.1284956717311,354.8728526337615,349.3841387097007,100193,59932.26666666667,21.078806106130685,33.69723138731137,NaN,NaN,NaN,NaN,0.9818155278978974,38.97584705967031,97051458,-0.615704251599253,-1.6170524090310323,-1.0013481574317793
2025-09-10T15:30:00-04:00,347.47,348.63,347.39,348.37,NaN,NaN,NaN,350.566812150321,NaN,NaN,353.36759999999873,357.64875229400246,349.086447705995,350.42510689411137,352.08029921523246,354.84274443160405,349.31785399886087,71647,59720.36666666667,29.85853010092454,32.31728773518867,NaN,NaN,NaN,NaN,1.000257275905191,40.48864818303695,97123105,-0.5045818485581992,-1.6320754681295284,-1.1274936195713292
2025-09-10T15:35:00-04:00,348.4,349,348.24,348.31,NaN,NaN,NaN,350.566812150321,NaN,NaN,353.2403999999988,357.731968920127,348.74883107987057,349.46106841223127,352.03458587329646,354.80839726299246,349.26077448360047,77239,60974.7,29.629514673116745,31.19471570975136,NaN,NaN,NaN,NaN,0.9830960419119625,41.235399384912036,97045866,-0.40203138056641263,-1.630032845279345,-1.2280014647129325
2025-09-10T15:40:00-04:00,348.33,349.5,348.13,349.47,NaN,NaN,NaN,350.566812150321,NaN,NaN,353.15279999999876,357.76268510098595,348.5429148990116,349.46106841223127,351.9856730067466,354.76290970785647,349.2084363056367,99757,63632.4,39.319764918825996,30.403685983988016,NaN,NaN,NaN,NaN,1.0107320389182513,41.09602223747179,97145623,-0.23145563968977245,-1.517321014325148,-1.2858653746353756
2025-09-10T15:45:00-04:00,349.45,349.72,349.09,349.44,NaN,NaN,NaN,350.566812150321,NaN,NaN,353.04819999999876,357.75201919766533,348.3443808023322,349.19485472978505,351.9586193641788,354.733612769843,349.1836259585146,65145,64925.066666666666,39.16954038299615,29.83131846385237,NaN,NaN,NaN,NaN,0.9835368932812371,40.615324123546074,97080478,-0.1026003235587174,-1.4141157790837724,-1.311515455525055
2025-09-10T15:50:00-04:00,349.5,350.26,348.76,349.34,NaN,NaN,NaN,350.566812150321,NaN,NaN,352.9319999999987,357.7088776417774,348.15512235822,348.215883783828,351.91723902637693,354.68768184450187,349.146796208252,103894,67294,38.63960121163231,29.7801025568833,NaN,NaN,NaN,NaN,1.0204271151897202,39.34966470679092,96976584,-0.010882759570187472,-1.3251189049877894,-1.314236145417602
2025-09-10T15:55:00-04:00,349.37,349.39,347.74,347.86,NaN,NaN,NaN,350.566812150321,NaN,NaN,352.7937999999987,357.7465687453025,347.84103125469494,347.4714786040974,351.8182645264643,354.6126936515548,349.0238354013738,178471,72116.9,31.7854678053521,29.599612131419878,NaN,NaN,NaN,NaN,1.0653966069618814,38.98926515188817,96798113,-0.035293977464988746,-1.358353617248838,-1.3230596397838492
2025-09-11T09:30:00-04:00,350.17,350.45,348.28,350.26,NaN,NaN,NaN,350.566812150321,NaN,NaN,352.6959999999988,357.65191928953516,347.7400807104624,347.4714786040974,349.66333333333336,349.66333333333336,349.66333333333336,184734,77042.86666666667,47.919112931610066,30.621413693402648,NaN,NaN,NaN,NaN,1.1742968493217454,37.29178484612666,96982847,0.11648018805010407,-1.177459404721219,-1.293939592771323
2025-09-11T09:35:00-04:00,350.26,351.43,348.8,349.38,346.6232994041423,346.6232994041423,346.6232994041423,NaN,NaN,NaN,352.5867999999987,357.5893360613049,347.58426393869246,347.4714786040974,349.7562432437265,349.8590495179139,349.6534369695391,150880,80583.7,43.8260877839243,31.48233967165816,NaN,NaN,NaN,NaN,1.2782756457987632,34.695680654238615,96831967,0.16114026682521354,-1.092514259239806,-1.2536545260650196
2025-09-11T09:40:00-04:00,349.34,349.83,347.6,348.99,346.6232994041423,NaN,NaN,NaN,NaN,NaN,352.4735999999988,357.54001136943543,347.40718863056213,347.4714786040974,349.4556463197337,349.9054292287053,349.0058634107621,155451,84316.43333333333,42.109437986952294,32.4455164859658,NaN,NaN,NaN,NaN,1.3462559568131345,33.27876883289472,96676516,0.16722554005700618,-1.0446226009937618,-1.211848141050768
2025-09-11T09:45:00-04:00,349.03,350.29,348.32,349.22,346.6232994041423,NaN,NaN,NaN,NaN,NaN,352.3691999999987,357.4841253605981,347.25427463939934,347.4714786040974,349.41588856204964,349.81949820223264,349.01227892186665,140234,86377.8,43.51462122283694,33.7757627528153,NaN,NaN,NaN,NaN,1.3908091027550553,31.513433494161262,96816750,0.1879996831490549,-0.9768485371144493,-1.1648482202635042
2025-09-11T09:50:00-04:00,349.27,351.47,349.27,350.91,346.6232994041423,NaN,NaN,NaN,NaN,NaN,352.3019999999987,357.4035385918967,347.20046140810075,347.4714786040974,349.63574815842054,350.21222689750323,349.05926941933785,151815,88038.46666666666,52.61588180523481,36.078583323804686,NaN,NaN,NaN,NaN,1.4521798811296942,29.670426137357726,96968565,0.309636810257754,-0.7778022074413116,-1.0874390176990656
2025-09-11T09:55:00-04:00,350.91,352.2,350.23,351.49,347.2454068472825,NaN,NaN,NaN,NaN,NaN,352.24819999999875,357.3260652054201,347.1703347945774,347.4714786040974,349.96680768850075,350.80945627308876,349.12415910391275,193496,93236.63333333333,55.279072577447366,38.32172080862396,NaN,NaN,NaN,NaN,1.489167032477571,28.501547734106207,97162061,0.4165731507472149,-0.566722579265047,-0.9832957300122619
2025-09-11T10:00:00-04:00,351.49,351.71,350.66,351.42,347.2526610814969,NaN,NaN,NaN,NaN,NaN,352.19999999999874,357.2626206656748,347.1373793343227,347.4714786040974,350.0885318072603,350.9753208210826,349.20174279343803,101189,95801.8,54.87818376752266,40.68740166246479,NaN,NaN,NaN,NaN,1.4577979587291698,27.416160645372656,97060872,0.4662586073568289,-0.4004724708162257,-0.8667310781730546
2025-09-11T10:05:00-04:00,351.37,353.68,351.34,353.57,348.43731285051973,NaN,NaN,NaN,NaN,NaN,352.18679999999875,357.2315904856767,347.1420095143208,348.9857992177626,350.52621589285775,351.82439603091746,349.22803575479804,201845,101336.56666666667,63.60782346900893,43.72518861695609,NaN,NaN,NaN,NaN,1.520812390248517,27.655085957124527,97262717,0.6180682413422639,-0.09414577649522471,-0.7122140178374886
2025-09-11T10:10:00-04:00,353.61,355.65,353.53,354.59,350.41334408458704,NaN,NaN,NaN,NaN,NaN,352.19059999999877,357.2423346094565,347.138865390541,350.83463937421004,351.2312442491561,353.17055106298915,349.291937435323,268607,109227.26666666666,66.8814385074582,46.36968207456564,NaN,NaN,NaN,NaN,1.5636115052307662,28.75821431079637,97531324,0.7524065567075066,0.22829417804689456,-0.524112378660612
2025-09-11T10:15:00-04:00,354.66,355.36,353.67,354.13,350.41334408458704,NaN,NaN,NaN,NaN,NaN,352.1939999999987,357.25071988590435,347.1372801140931,350.83463937421004,351.6127248328906,353.7018475293917,349.52360213638946,212920,114959.56666666667,64.08183295959348,48.830561952171124,NaN,NaN,NaN,NaN,1.57263925485714,29.78254778206309,97318404,0.772586922373143,0.44162127430581677,-0.3309656480673262
2025-09-11T10:20:00-04:00,354.21,357.34,353.84,357.1,351.0871585564109,NaN,NaN,NaN,NaN,NaN,352.2807999999987,357.51913536961985,347.04246463037754,351.83216919949444,352.24969243863063,354.7381169005872,349.76126797667405,291861,123351.83333333333,72.17920475980608,51.17766479795541,NaN,NaN,NaN,NaN,1.7103078795102014,31.43272780348953,97610265,0.9372911136796626,0.840648244032252,-0.09664286964741053
2025-09-11T10:25:00-04:00,357.12,359.25,356.76,358.9,353.3672877129377,NaN,NaN,NaN,NaN,NaN,352.39519999999874,357.9475173400376,346.84288265995986,353.59873535959554,353.15566323911645,356.3067233000712,350.0046031781617,361326,133896.4,75.74768899915473,53.790389699109596,NaN,NaN,NaN,NaN,1.766000173830902,33.475172364027536,97971591,1.1071430304278005,1.2872859183873402,0.18014288795953964
2025-09-11T10:30:00-04:00,358.86,358.94,357.88,358.45,353.8385473623496,NaN,NaN,NaN,NaN,NaN,352.48459999999875,358.27495226600587,346.69424773399163,353.88898828767645,353.495561709761,356.80666988674756,350.1844535327744,166533,138469.93333333332,73.21918398279315,56.26035989704966,NaN,NaN,NaN,NaN,1.7155715899858375,35.37172802738425,97805058,1.1252043771037457,1.5866483593392218,0.46144398223547606
2025-09-11T10:35:00-04:00,358.44,358.92,357.05,357.48,353.8385473623496,NaN,NaN,NaN,NaN,NaN,352.5495999999987,358.4879404554283,346.61125954456907,353.9441906301412,353.72455672084266,357.0890043273384,350.3601091143469,144427,142333.5,67.9535520461857,58.843794485680625,NaN,NaN,NaN,NaN,1.726602190701135,36.32155278854622,97660631,1.0114297759266861,1.7257312021438338,0.7143014262171477
2025-09-11T10:40:00-04:00,357.51,358.87,357.37,357.91,353.8385473623496,NaN,NaN,NaN,NaN,NaN,352.6075999999987,358.6956914057326,346.5195085942648,354.13935250411294,353.8789944768532,357.2789225871792,350.47906636652726,100909,143566.33333333334,69.01727050234953,60.35080574073345,NaN,NaN,NaN,NaN,1.7104163199367683,37.203532923910906,97761540,0.9080266856135608,1.8493347832340987,0.9413080976205379
2025-09-11T10:45:00-04:00,357.95,358.59,357.42,358.36,353.8385473623496,NaN,NaN,NaN,NaN,NaN,352.68179999999876,358.95526244464145,346.40833755535607,354.22048200329033,354.05063359855507,357.484448447638,350.61681874947215,119108,144555.1,70.13450727415447,62.22997856146417,NaN,NaN,NaN,NaN,1.6718151542269963,38.02251447817811,97880648,0.8157515950250489,1.9609975914018491,1.1452459963768002
2025-09-11T10:50:00-04:00,358.42,359.95,358.38,359.73,354.59247895284267,NaN,NaN,NaN,NaN,NaN,352.78139999999877,359.33491998275093,346.2278800172466,355.6593856026323,354.44161988687733,358.02520744990596,350.8580323238487,234457,149274.23333333334,73.2921124269976,64.45731245003884,NaN,NaN,NaN,NaN,1.665971214639352,39.24800589306643,98115105,0.7921415196224078,2.13542289590481,1.3432813762824023
2025-09-11T10:55:00-04:00,359.67,360.55,358.01,358.83,354.59247895284267,NaN,NaN,NaN,NaN,NaN,352.8697999999988,359.62494795131914,346.11465204867847,355.84750848210587,354.8303288255459,358.49757502662084,351.163082624471,287467,157530.6,68.1914706868924,66.21994455461423,NaN,NaN,NaN,NaN,1.728401842165114,40.567910115243905,97827638,0.6661354770191703,2.1759507225563652,1.509815245537195
2025-09-11T11:00:00-04:00,358.83,359.75,358.38,359.04,354.59247895284267,NaN,NaN,NaN,NaN,NaN,352.95759999999876,359.91413426386714,346.0010657361304,355.84750848210587,354.93112980586966,358.6113190004732,351.2509406112661,84717,157168.83333333334,68.73816371382586,67.37153611951359,NaN,NaN,NaN,NaN,1.7028017105818918,41.7935354644087,97912355,0.5518744202226136,2.199658270815462,1.6477838505928484
2025-09-11T11:05:00-04:00,359.03,360.38,358.81,359.935,354.9100828871409,NaN,NaN,NaN,NaN,NaN,353.07089999999874,360.2888608453068,345.8529391546907,356.03740542854774,355.126028716313,358.85219606607455,351.3998613665514,151076,158994.36666666667,71.02391062365513,68.49616740852844,NaN,NaN,NaN,NaN,1.693315874111756,43.127064644885365,98063431,0.49342191267489555,2.2645612414364678,1.7711393287615722
2025-09-11T11:10:00-04:00,359.92,362.69,359.56,362.08,356.22621548317994,NaN,NaN,NaN,NaN,NaN,353.2194999999988,360.85522242838863,345.58377757160895,357.6509243428382,355.65706276445036,359.63071479696833,351.6834107319324,339847,165098.06666666668,75.62398906581333,69.97801064412063,NaN,NaN,NaN,NaN,1.7959361688180588,44.94022170985876,98403278,0.5516607710630681,2.4607152925904074,1.9090545215273393
2025-09-11T11:15:00-04:00,362.01,363.3,361.83,363.15,357.6884329612172,NaN,NaN,NaN,NaN,NaN,353.3938999999988,361.51514110979275,345.2726588902048,358.53373947427053,356.0148562811995,360.1871338486321,351.84257871376695,214454,168523.3,77.53950574690978,70.97313080682783,NaN,NaN,NaN,NaN,1.772655013902485,46.746948300785604,98617732,0.6101252046498518,2.6717110273396543,2.0615858226898025
2025-09-11T11:20:00-04:00,363.15,363.23,361.88,362.46,357.7160041902528,NaN,NaN,NaN,NaN,NaN,353.5432999999988,362.04253563877455,345.04406436122304,358.74199157941644,356.26577997411977,360.5444404381745,351.98711951006504,170717,170813.86666666667,73.52696076920509,71.44781096838118,NaN,NaN,NaN,NaN,1.7424653700523092,48.42462299236053,98447015,0.5519565351083466,2.7515314915752356,2.199574956466889
2025-09-11T11:25:00-04:00,362.5,363,361.47,361.63,357.7160041902528,NaN,NaN,NaN,NaN,NaN,353.6636999999988,362.4425894083074,344.8848105916902,358.74199157941644,356.48870241809004,360.8286764199081,352.148728416272,178031,173408.46666666667,68.90764174172824,71.79251159567652,NaN,NaN,NaN,NaN,1.727289272191428,49.484996773642756,98268984,0.4135413003338848,2.716501581884245,2.30296028155036
2025-09-11T11:30:00-04:00,361.61,361.78,360.86,361.12,357.7160041902528,NaN,NaN,NaN,NaN,NaN,353.7854999999987,362.8025909390804,344.768409060917,358.74199157941644,356.5945553018337,360.94312580977993,352.24598479388743,104656,174508.76666666666,66.15730473040168,71.36237587929048,NaN,NaN,NaN,NaN,1.6696257527491802,49.7521994174352,98164328,0.251564136580392,2.61741545227585,2.365851315695458
2025-09-11T11:35:00-04:00,361.19,362.04,360.94,361.69,357.7160041902528,NaN,NaN,NaN,NaN,NaN,353.92569999999876,363.2081449388851,344.6432550611124,358.74199157941644,356.69013981134844,361.0502966777427,352.32998294495417,92525,175018.3,67.7086010060169,70.78815530835206,NaN,NaN,NaN,NaN,1.6289381989813834,50.09206790244644,98256853,0.1516596341613936,2.5554258583972,2.4037662242358064
2025-09-11T11:40:00-04:00,361.66,362.66,361.52,362.4,357.7160041902528,NaN,NaN,NaN,NaN,NaN,354.07949999999875,363.65890796727285,344.50009203272464,359.12563175092896,356.78450774780197,361.16576217830686,352.4032533172971,83803,174486.5,69.57915097229207,70.52815295045913,NaN,NaN,NaN,NaN,1.5940140419112878,50.62171599075621,98340656,0.1044870423713431,2.534375027199985,2.429887984828642
2025-09-11T11:45:00-04:00,362.42,362.78,362.1,362.5,357.9451252911375,NaN,NaN,NaN,NaN,NaN,354.24509999999873,364.11050267619885,344.3796973237986,359.61250540074315,356.87359602440085,361.277203998759,352.46998805004273,77936,174912.86666666667,69.8441113404734,70.6631929000511,NaN,NaN,NaN,NaN,1.5287273246319066,51.15464534044914,98418592,0.05367173375336476,2.496977652020348,2.4433059182669834
2025-09-11T11:50:00-04:00,362.56,363.56,362.2,362.23,358.40398323244943,NaN,NaN,NaN,NaN,NaN,354.40589999999867,364.52139261102116,344.2904073889762,360.34600432059455,357.03111263304754,361.47536237685233,352.58686288924275,138857,176078.3,68.11896447792722,70.59902818402095,NaN,NaN,NaN,NaN,1.5166753728724858,51.90881579909528,98279735,-0.0204978011055319,2.4176836668850683,2.4381814679906
2025-09-11T11:55:00-04:00,362.25,362.74,361.89,362.44,358.40398323244943,NaN,NaN,NaN,NaN,NaN,354.5832999999987,364.9421199348934,344.224480065104,360.34600432059455,357.1241176734437,361.58428282202345,352.663952524864,90718,173153.2,68.76517724857668,70.50121889647967,NaN,NaN,NaN,NaN,1.4690557033815956,52.19624867213633,98370453,-0.07473802568151555,2.3447589358887058,2.4194969615702213
2025-09-11T12:00:00-04:00,362.42,362.53,361.59,361.7,358.40398323244943,NaN,NaN,NaN,NaN,NaN,354.7348999999987,365.28230925363346,344.1874907463639,360.34600432059455,357.21509307664485,361.68131399889705,352.74887215439264,100019,170329.36666666667,63.853551335523186,69.82703596137436,NaN,NaN,NaN,NaN,1.43126601028291,52.06314644853003,98270434,-0.17410002001541036,2.2018719365509583,2.3759719565663686
2025-09-11T12:05:00-04:00,361.66,362.53,361.53,362.27,358.40398323244943,NaN,NaN,NaN,NaN,NaN,354.90729999999866,365.6579749948006,344.1566250051967,360.34600432059455,357.28240081185686,361.7542885338727,352.81051308984104,73819,167760.66666666666,65.87541520005715,69.66160342660041,NaN,NaN,NaN,NaN,1.400461295262702,51.85712843503039,98344253,-0.21253679678519122,2.1103009605848797,2.322837757370071
2025-09-11T12:10:00-04:00,362.26,362.73,362.02,362.58,358.40398323244943,NaN,NaN,NaN,NaN,NaN,355.07449999999875,366.0352036728298,344.1137963271677,360.34600432059455,357.34805417468874,361.8288918011418,352.86721654823566,69173,164884.73333333334,66.95790876451662,69.5344423587926,NaN,NaN,NaN,NaN,1.3511426313153687,51.76316747196883,98413426,-0.22688008639226265,2.039237649379743,2.2661177357720055
2025-09-11T12:15:00-04:00,362.52,362.8,362.2,362.75,358.44669130695206,NaN,NaN,NaN,NaN,NaN,355.2528999999987,366.41528685782635,344.09051314217106,360.4281178957724,357.39904181067277,361.88754903202914,352.9105345893164,53479,161992.9,67.56553510942163,69.28741553634735,NaN,NaN,NaN,NaN,1.2974895862214153,51.71126711387933,98466905,-0.23378751339627613,1.9738833440266603,2.2076708574229365
2025-09-11T12:20:00-04:00,362.73,362.88,361.66,361.81,358.44669130695206,NaN,NaN,NaN,NaN,NaN,355.4350999999987,366.7215677363482,344.14863226364923,360.4281178957724,357.4500550400232,361.94081256442564,352.95929751562073,60026,158933.26666666666,60.897025725455826,68.23548958346468,NaN,NaN,NaN,NaN,1.2919546157770263,50.83509029349155,98406879,-0.3059769448439824,1.8251996763679585,2.131176621211941
2025-09-11T12:25:00-04:00,361.79,361.87,360.32,360.38,358.44669130695206,NaN,NaN,NaN,NaN,NaN,355.6072999999987,366.9275150528906,344.2870849471068,360.4281178957724,357.509825487306,361.9834267725867,353.03622420202527,99136,155787.93333333332,52.42084126119487,66.44129926305648,NaN,NaN,NaN,NaN,1.310386428935811,48.32632083596729,98307743,-0.44587285459112325,1.573835552973037,2.0197084075641603
2025-09-11T12:30:00-04:00,360.43,361.05,360.31,360.96,358.44669130695206,NaN,NaN,NaN,NaN,NaN,355.79389999999876,367.1532392925637,344.43456070743383,360.4281178957724,357.5640525678244,362.01990228332386,353.1082028523249,95472,155597.36666666667,55.14771796465126,65.12849620558835,NaN,NaN,NaN,NaN,1.2696445411546822,45.98545959736416,98403215,-0.4915825597879977,1.4052302078291632,1.8968127676171609
2025-09-11T12:35:00-04:00,360.94,360.94,360.25,360.55,358.44669130695206,NaN,NaN,NaN,NaN,NaN,355.9796999999988,367.3402299895513,344.6191700104463,360.4281178957724,357.61323531083525,362.04908137333734,353.17738924833316,95252,152044.26666666666,52.84219150949791,63.98096404614332,NaN,NaN,NaN,NaN,1.2296699310722035,43.73959152811462,98307963,-0.5379210694734278,1.2244114307753762,1.762332500248804
2025-09-11T12:40:00-04:00,360.51,360.92,360.26,360.58,358.44669130695206,NaN,NaN,NaN,NaN,NaN,356.1798999999987,367.50479090294584,344.8550090970516,360.4281178957724,357.64286099386516,362.0664222407993,353.21929974693103,58782,145050.1,52.997033915196404,63.04094470220009,NaN,NaN,NaN,NaN,1.188979221709905,41.65414260666863,98366745,-0.5529187573745169,1.0711840535306578,1.6241028109051747
2025-09-11T12:45:00-04:00,360.54,361.33,360.2,361.22,358.44669130695206,NaN,NaN,NaN,NaN,NaN,356.4122999999987,367.6642205846696,345.16037941532784,360.4281178957724,357.67298015384125,362.087225922855,353.2587343848275,54782,139778.83333333334,56.29404433127713,62.225619225432965,NaN,NaN,NaN,NaN,1.1847664201591972,40.113433685741875,98421527,-0.5072974331507254,0.989981019466768,1.4972784526174934
2025-09-11T12:50:00-04:00,361.17,361.73,360.96,361.36,358.44669130695206,NaN,NaN,NaN,NaN,NaN,356.6780999999987,367.75573420427156,345.6004657957259,360.4281178957724,357.7091747941766,362.11661605367584,353.30173353467734,59196,132023.33333333334,57.004522240101814,61.32743145884795,NaN,NaN,NaN,NaN,1.1551402472906858,39.04684048657576,98480723,-0.45682543015687993,0.9262466649213934,1.3830720950782733
2025-09-11T12:55:00-04:00,361.32,361.83,361.11,361.82,358.44669130695206,NaN,NaN,NaN,NaN,NaN,356.94589999999874,367.85918322566556,346.0326167743319,360.4281178957724,357.75722641361943,362.15822848941656,353.3562243378223,75460,122494.46666666666,59.34313505091826,60.57736172387972,NaN,NaN,NaN,NaN,1.1240588010556347,38.14664949642322,98556183,-0.38449609149794006,0.9024519807058482,1.2869480722037883
2025-09-11T13:00:00-04:00,361.8,362.32,361.68,362.07,358.44669130695206,NaN,NaN,NaN,NaN,NaN,357.23349999999874,367.911312182449,346.55568781754846,360.4281178957724,357.80639112678165,362.20558744328156,353.40719481028174,70993,119309.8,60.597506363607074,60.04011471571399,NaN,NaN,NaN,NaN,1.0894831724088028,37.740506758020445,98627176,-0.31478398677579933,0.8934680887340392,1.2082520755098385
2025-09-11T13:05:00-04:00,362.1,362.58,361.93,362.44,358.7562752733359,NaN,NaN,NaN,NaN,NaN,357.53349999999875,367.9330804244007,347.1339195755968,360.59469071622937,357.8458801945185,362.2458840179003,353.44587637113665,54411,116309.26666666666,62.4442842603256,59.588622359410344,NaN,NaN,NaN,NaN,1.0580915172367438,37.57879008584041,98681587,-0.24199116126609832,0.9057631239272155,1.1477542851933138
2025-09-11T13:10:00-04:00,362.47,363.25,362.14,363.08,359.2039445790934,NaN,NaN,NaN,NaN,NaN,357.82769999999874,368.00358191969224,347.65181808030525,361.1067525729835,357.9330207638048,362.34292337067853,353.52311815693105,110738,116636.9,65.45990947033587,59.703362226182676,NaN,NaN,NaN,NaN,1.0617992660055486,37.93677277756009,98792325,-0.1533010038107694,0.9561280304298521,1.1094290342406214
2025-09-11T13:15:00-04:00,363.12,363.9,362.69,363.65,359.7976289164073,NaN,NaN,NaN,NaN,NaN,358.13449999999875,368.0661198579862,348.2028801420113,361.58040205838677,358.0117760078419,362.43819373866154,353.58535827702224,92224,115740.76666666666,67.92982561319066,59.850105827120785,NaN,NaN,NaN,NaN,1.0723850327194364,38.69275912699941,98884549,-0.06341382375175186,1.0301617545509316,1.0935755783026835
2025-09-11T13:20:00-04:00,363.67,364.27,363.28,364.09,360.30160032929786,NaN,NaN,NaN,NaN,NaN,358.4268999999988,368.18018844869357,348.673611551304,361.9193216467094,358.1282265218865,362.58627082746654,353.6701822163065,129930,112256.53333333334,69.72929231828311,60.048061795246966,NaN,NaN,NaN,NaN,1.0665003875251915,39.613718198968876,99014479,0.014359829010180736,1.1115253645654093,1.0971655355552286
2025-09-11T13:25:00-04:00,364.08,364.33,363.63,364.1,360.5690275870571,NaN,NaN,NaN,NaN,NaN,358.7200999999987,368.2540575184566,349.1861424815408,362.0994573173675,358.2372801192352,362.7246986766646,353.7498615618058,123476,106790.16666666667,69.77080693715055,60.20558121151332,NaN,NaN,NaN,NaN,1.0403217884162486,40.504487496316784,99137955,0.052989609751107336,1.1634025477441128,1.1104129379930054
2025-09-11T13:30:00-04:00,364.07,364.18,363.66,363.98,360.59316269673633,NaN,NaN,NaN,NaN,NaN,359.01289999999875,368.2718330035102,349.7539669964873,362.1355658538941,358.2987523762454,362.8006009182752,353.7969038342155,72693,106389.36666666667,68.55577290635561,60.75263458157759,NaN,NaN,NaN,NaN,1.0031559463865152,41.33163041528271,99065262,0.05664266257733663,1.1812162662146761,1.1245736036373395
2025-09-11T13:35:00-04:00,363.97,365.81,363.96,365.12,361.45710984688463,NaN,NaN,NaN,NaN,NaN,359.35809999999873,368.2059216281518,350.51027837184563,363.24945268311524,358.53972885699426,363.1312189296581,353.94823878433044,252983,109786.26666666666,73.31085153053701,62.244778172244885,NaN,NaN,NaN,NaN,1.0636448073589084,42.937790656609856,99318245,0.118462637217571,1.2726519001593033,1.1541892629417323
2025-09-11T13:40:00-04:00,365.15,366.66,365.02,366.19,362.34428667202627,NaN,NaN,NaN,NaN,NaN,359.67669999999873,368.3363696497945,351.01703035020296,363.7915621464922,358.75051325252196,363.4410991121971,354.0599273928468,204656,105279.9,76.8495236155736,63.79490714731077,NaN,NaN,NaN,NaN,1.1048130354047037,44.74166797981897,99522901,0.20876256956697348,1.415142474900449,1.2063799053334756
2025-09-11T13:45:00-04:00,366.18,366.26,365.46,365.84,362.4140918232978,NaN,NaN,NaN,NaN,NaN,360.00589999999875,368.3193545625479,351.6924454374496,363.7915621464922,358.8660056072192,363.6042364103271,354.12777480411137,119029,102099.06666666667,73.42033846231254,65.26477478679753,NaN,NaN,NaN,NaN,1.0830406757329398,46.41669692279886,99403872,0.22108262124718459,1.4827331818924563,1.2616505606452717
2025-09-11T13:50:00-04:00,365.86,366.56,365.55,366.47,362.6279967404206,NaN,NaN,NaN,NaN,NaN,360.3554999999987,368.2459631678853,352.4650368321121,363.899199773755,358.9612807065113,363.7412330164022,354.18132839662036,96438,99623.1,75.5363955928363,66.87472919234322,NaN,NaN,NaN,NaN,1.077823484609158,48.07920996718355,99500310,0.24591797550540972,1.5690480300270337,1.323130054521624
2025-09-11T13:55:00-04:00,366.4,366.46,365.9,366.09,362.83104234312873,NaN,NaN,NaN,NaN,NaN,360.6928999999987,368.07631820322325,353.30948179677415,364.04635981900395,359.02837704586665,363.83592592959076,354.22082816214254,69877,96017.96666666666,71.82220319889086,67.98388339717279,NaN,NaN,NaN,NaN,1.0415503785656501,49.622972079826475,99430433,0.212279431382981,1.5884793437503504,1.3761999123673694
2025-09-11T14:00:00-04:00,366.05,366.36,365.47,366.35,362.83104234312873,NaN,NaN,NaN,NaN,NaN,361.0016999999987,368.0043599548746,353.99904004512285,364.04635981900395,359.13066257548445,363.9768044190448,354.2845207319241,110512,96213.16666666667,72.80742258116015,69.11266199296267,NaN,NaN,NaN,NaN,1.0307253515252455,50.17546368994339,99540945,0.18411344573070165,1.6063417195307466,1.422228273800045
2025-09-11T14:05:00-04:00,366.34,366.5,365.88,366.35,362.9381811432227,NaN,NaN,NaN,NaN,NaN,361.29889999999875,367.912105362271,354.6856946377265,364.2892702841625,359.21053695508107,364.087328570555,354.33374533960716,86284,96005.13333333333,72.80742258116015,70.07439681655138,NaN,NaN,NaN,NaN,1.0013878264162996,50.76418703997252,99540945,0.14384183683869156,1.6020305698484094,1.4581887330097179
2025-09-11T14:10:00-04:00,366.38,367.44,366.24,367.44,363.5723547276217,NaN,NaN,NaN,NaN,NaN,361.61929999999876,367.82683542427037,355.41176457572715,365.07141622733,359.37115730508106,364.3236275703666,354.4186870397955,160926,98575.9,76.75847702467652,71.22875186377063,NaN,NaN,NaN,NaN,1.015574410243706,51.76329135138037,99701871,0.16732717102753636,1.6673476967941383,1.500020525766602
2025-09-11T14:15:00-04:00,367.43,367.64,366.76,366.81,363.9608840581843,NaN,NaN,NaN,NaN,NaN,361.88409999999874,367.8191813611641,355.94901863883337,365.305132981864,359.49276420230416,364.4988595658806,354.4866688387277,125894,100174.5,70.39219487601663,71.79645976489141,NaN,NaN,NaN,NaN,1.0058905237977267,52.77594332803475,99575977,0.119395227700408,1.649264560392112,1.5298693326917039
2025-09-11T14:20:00-04:00,366.84,366.85,365.22,365.29,363.9608840581843,NaN,NaN,NaN,NaN,NaN,362.09809999999874,367.7295924810112,356.4666075189863,365.305132981864,359.5932321597739,364.6214714449393,354.5649928746085,129291,99855.63333333333,57.91213117134476,71.2573327435349,NaN,NaN,NaN,NaN,1.0504697720978888,51.12588260622773,99446686,-0.027856856590915857,1.495048261953059,1.5229051185439748
2025-09-11T14:25:00-04:00,365.275,365.69,364.78,365.23,363.9608840581843,NaN,NaN,NaN,NaN,NaN,362.3200999999987,367.53757313971977,357.10262686027767,365.305132981864,359.6664517438578,364.70257819435545,354.63032529336016,106531,100382.73333333334,57.47892634316201,70.51083993853284,NaN,NaN,NaN,NaN,1.0404362169480414,49.01007609383107,99340155,-0.1364044029218352,1.3523996148916808,1.488804017813516
2025-09-11T14:30:00-04:00,365.225,365.59,364.95,365.25,363.9608840581843,NaN,NaN,NaN,NaN,NaN,362.48309999999873,367.54497115242873,357.4212288475687,365.305132981864,359.7238422431939,364.7657085299932,354.6819759563945,85017,99882.66666666667,57.59280091543858,69.64394769547253,NaN,NaN,NaN,NaN,1.0118336300231803,47.04539861803418,99425172,-0.20958614661428365,1.2268213345456616,1.4364074811599452
2025-09-11T14:35:00-04:00,365.26,366.36,364.98,366.36,363.9608840581843,NaN,NaN,NaN,NaN,NaN,362.63229999999874,367.7026882340224,357.5619117659751,365.305132981864,359.79913856400816,364.85580508830105,354.74247203971527,102328,100832.96666666666,63.44416256123053,69.19204452576396,NaN,NaN,NaN,NaN,1.0381312278786672,45.85675676052551,99527500,-0.18672603964663392,1.2029999316016529,1.3897259712482868
2025-09-11T14:40:00-04:00,366.37,366.55,366.02,366.34,363.9608840581843,NaN,NaN,NaN,NaN,NaN,362.7900999999987,367.82097129271415,357.7592287072832,365.305132981864,359.8762406461698,364.9518990188369,354.80058227350264,100691,101883.56666666667,63.27475238036219,68.81482877390728,NaN,NaN,NaN,NaN,1.0018361401730502,44.89841194641409,99426809,-0.1765554996056644,1.1690315967412062,1.3455870963468706
2025-09-11T14:45:00-04:00,366.32,366.51,366.02,366.13,363.9608840581843,NaN,NaN,NaN,NaN,NaN,362.96309999999875,367.84434692713984,358.08185307285765,365.305132981864,359.9271201270707,365.01395238200274,354.8402878721386,68677,102390.16666666667,61.420225113065854,67.96549831551648,NaN,NaN,NaN,NaN,0.9652764158749758,44.00852033331063,99358132,-0.18659464121977476,1.1123437948221522,1.298938436041927
2025-09-11T14:50:00-04:00,366.17,366.82,366.17,366.65,363.9608840581843,NaN,NaN,NaN,NaN,NaN,363.1378999999987,367.90750211797916,358.3682978820182,365.305132981864,359.98494332492726,365.0868303146904,354.8830563351641,75457,102904.53333333334,64.21694468078044,67.06317124874555,NaN,NaN,NaN,NaN,0.9456138147410488,43.435261119088764,99433589,-0.16176236985794867,1.096735473719491,1.2584978435774397
2025-09-11T14:55:00-04:00,366.675,367.38,366.47,367.38,363.9608840581843,NaN,NaN,NaN,NaN,NaN,363.3182999999987,368.0334134073176,358.60318659267983,365.305132981864,360.0804768824481,365.21340764582135,354.9475461190749,117956,103531.86666666667,67.75126652319628,66.65823753880868,NaN,NaN,NaN,NaN,0.9430699708309715,43.326266042487646,99551545,-0.10260472254870656,1.1302419403915565,1.232846662940263
2025-09-11T15:00:00-04:00,367.33,367.55,366.66,366.8,364.072329134401,NaN,NaN,NaN,NaN,NaN,363.4596999999987,368.15991548909204,358.75948451090534,365.4306954472437,360.1457531653467,365.29805239571397,354.99345393497947,83349,103127.76666666666,62.47166021209923,65.72504215447032,NaN,NaN,NaN,NaN,0.9392792586287584,43.34694761071973,99468196,-0.10840101889764497,1.0973453893182068,1.2057464082158518
2025-09-11T15:05:00-04:00,366.78,367.21,366.48,366.62,364.072329134401,NaN,NaN,NaN,NaN,NaN,363.61549999999875,368.20670910040496,359.02429089959253,365.4306954472437,360.22200413665587,365.3930686482217,355.05093962509005,102936,103383.9,60.88592658579002,64.94387953924883,NaN,NaN,NaN,NaN,0.9243307401552728,43.033670288953616,99365260,-0.12883120395557057,1.0447074032713886,1.1735386072269591
2025-09-11T15:10:00-04:00,366.64,366.75,365.77,366.11,364.072329134401,NaN,NaN,NaN,NaN,NaN,363.7568999999987,368.2091142315716,359.3046857684258,365.4306954472437,360.28308671171544,365.46277491083663,355.10339851259425,92161,104496.53333333334,56.50920669330574,63.779721261544935,NaN,NaN,NaN,NaN,0.9283071158584689,41.54158523463049,99273099,-0.17812883957687964,0.9508775577558595,1.129006397332739
2025-09-11T15:15:00-04:00,366.1,367.07,365.88,366.96,364.072329134401,NaN,NaN,NaN,NaN,NaN,363.89739999999875,368.3014305361854,359.4933694638121,365.4306954472437,360.3672342889854,365.56352129343605,355.17094728453475,121262,106712.53333333334,61.47924825127479,62.970565952267414,NaN,NaN,NaN,NaN,0.9469994647257209,40.464605108654965,99394361,-0.1557377559869746,0.9343342023490209,1.0900719583359955
2025-09-11T15:20:00-04:00,366.94,368.36,366.86,367.14,364.52447043997785,NaN,NaN,NaN,NaN,NaN,363.99859999999876,368.4630641519159,359.53413584808163,365.76545285519103,360.5286647196104,365.7731021874483,355.2842272517725,213446,111854.2,62.4576613894657,61.94907912118092,NaN,NaN,NaN,NaN,0.986499502959598,40.4841016634156,99607807,-0.13199022654751924,0.9250841751515964,1.0570744016991156
2025-09-11T15:25:00-04:00,367.13,367.33,366.4,367.06,364.52447043997785,NaN,NaN,NaN,NaN,NaN,364.07679999999874,368.61542788118254,359.53817211881494,365.76545285519103,360.61352299838967,365.8742763368937,355.35276965988567,125872,113534.6,61.70747793113795,61.32874219654673,NaN,NaN,NaN,NaN,0.9824638241767701,39.804860406591224,99481935,-0.12492914802976762,0.900912966661906,1.0258421146916736
2025-09-11T15:30:00-04:00,367.03,367.36,366.51,366.61,364.52447043997785,NaN,NaN,NaN,NaN,NaN,364.1597999999987,368.7288077526662,359.5907922473312,365.76545285519103,360.6655360857364,365.9347201344388,355.396352037034,80160,113840.16666666667,57.52219856892732,61.30088986780264,NaN,NaN,NaN,NaN,0.9730021224498596,39.19804108191393,99401775,-0.15202476389690944,0.8358111598205369,0.9878359237174463
2025-09-11T15:35:00-04:00,366.62,366.75,366.15,366.2,364.52447043997785,NaN,NaN,NaN,NaN,NaN,364.25119999999873,368.7969032727339,359.70549672726355,365.76545285519103,360.71869095744273,365.99179778862674,355.4455841262587,90117,115030.36666666667,53.93300175007196,61.04760953972477,NaN,NaN,NaN,NaN,0.9463591137034426,38.081542258344,99311658,-0.19620953538114227,0.7425740044910185,0.9387835398721608
2025-09-11T15:40:00-04:00,366.2,366.64,365.85,366.05,364.52447043997785,NaN,NaN,NaN,NaN,NaN,364.3497999999987,368.832994379437,359.8666056205604,365.76545285519103,360.7742091249842,366.04897078777344,355.499447462195,99266,114647.96666666666,52.63892249945262,60.69376108144006,NaN,NaN,NaN,NaN,0.9351906055817656,36.60122476083207,99212392,-0.23174942598827686,0.6490967573868147,0.8808461833750916
2025-09-11T15:45:00-04:00,366.07,366.73,366.02,366.73,364.52447043997785,NaN,NaN,NaN,NaN,NaN,364.45059999999876,368.9166558173528,359.9845441826447,365.76545285519103,360.8253740224556,366.10402894251246,355.54671910239875,88147,114512.06666666667,57.605099953641094,60.27668518089796,NaN,NaN,NaN,NaN,0.9191055623259279,35.32095793056228,99300539,-0.20651094815977478,0.6227074981753731,0.8292184463351479
2025-09-11T15:50:00-04:00,366.72,368.1,366.63,367.89,364.52447043997785,NaN,NaN,NaN,NaN,NaN,364.5603999999987,369.08890873510836,360.03189126488905,365.76545285519103,360.9565483406138,366.2653554977341,355.64774118349345,196318,116725,64.45273507006033,60.360826801590676,NaN,NaN,NaN,NaN,0.958455165016935,35.33776506882253,99496857,-0.11339765032460059,0.6874713834293971,0.8008690337539977
2025-09-11T15:55:00-04:00,367.91,368.99,367.32,368.88,365.07035340546815,NaN,NaN,NaN,NaN,NaN,364.68799999999874,369.33508080453373,360.04091919546374,366.2094030666169,361.13294158338005,366.4991806352801,355.76670253148,244037,120743.7,69.04769639314628,60.905646178739275,NaN,NaN,NaN,NaN,1.0092797960871551,35.937022738696896,99740894,0.006786570136091408,0.8093522464241119,0.8025656762880204
2025-09-12T09:30:00-04:00,370.78,374.72,370.25,374.39,368.7442009779469,NaN,NaN,NaN,NaN,NaN,364.93119999999874,370.26090339173015,359.6014966082673,369.57552245329356,373.12000000000006,373.12000000000006,373.12000000000006,587047,137888.83333333334,82.55989205740897,62.215856705641315,NaN,NaN,NaN,NaN,1.3543312392237892,38.37393456751549,100327941,0.426078437505639,1.3351637231700693,0.9090852856644303
2025-09-12T09:35:00-04:00,374.26,377.52,373.57,377.01,371.43560093349475,NaN,NaN,NaN,NaN,NaN,365.2225999999987,371.4868947698831,358.95830523011426,371.42941796263483,374.61403804729537,376.0702252460014,373.1578508485893,617962,150054.8,85.74626139823887,63.50121348243007,NaN,NaN,NaN,NaN,1.5397361507078033,41.05936211615647,100945903,0.8254610433662619,1.9409115898722575,1.1154505465059956
2025-09-12T09:40:00-04:00,376.985,379.53,376.85,378.2,373.90193725469953,NaN,NaN,NaN,NaN,NaN,365.55259999999873,372.7140331640923,358.39116683590515,373.31753437010786,375.55333887070645,377.56424919687095,373.54242854454196,428738,157524.2,86.91557732357222,65.247207561821,NaN,NaN,NaN,NaN,1.6211835685143854,43.78038835630309,101374641,1.0982879617211903,2.4883104986574835,1.3900225369362933
2025-09-12T09:45:00-04:00,378.17,381.28,377.68,381.14,374.8959401067587,NaN,NaN,NaN,NaN,NaN,365.9299999999987,374.2541653037323,357.6058346962651,374.5100274960863,376.5230105231992,379.0866738843346,373.95934716206386,451297,168599.8,89.25980723486995,67.27391332246957,NaN,NaN,NaN,NaN,1.7625275993347842,46.47159294721426,101825938,1.3866678803087151,3.123357387322187,1.736689507013472
2025-09-12T09:50:00-04:00,381.14,384.22,380.41,384.09,377.419761010997,NaN,NaN,NaN,NaN,NaN,366.36019999999866,376.05744124914133,356.662958750856,376.89902199686907,377.7144305050708,381.1102901893647,374.3185708207769,478438,181333.13333333333,91.0018480620609,69.7376734202378,NaN,NaN,NaN,NaN,1.9087756279537285,49.19124286303726,102304376,1.6671564463176263,3.8206350649105048,2.1534786185928785
2025-09-12T09:55:00-04:00,384.15,386.98,383.37,384.58,380.0099991468607,NaN,NaN,NaN,NaN,NaN,366.7967999999986,377.6958006442918,355.8977993557054,379.3182175974953,379.035768719362,383.1931256618171,374.87841177690694,570154,198009.03333333333,91.25555778585755,71.86455267270799,NaN,NaN,NaN,NaN,2.030291654528463,51.8757569318311,102874530,1.7672039515319335,4.362483558007796,2.595279606475862
2025-09-12T10:00:00-04:00,384.61,387.5,383.91,385.96,380.28522645836705,NaN,NaN,NaN,NaN,NaN,367.2797999999987,379.3315162198557,355.22808378014173,379.5755740779962,379.9241495723843,384.4209728954612,375.4273262493074,474588,210144.9,91.9444432801467,73.9707513791852,NaN,NaN,NaN,NaN,2.141699393490714,54.39536656416845,103349118,1.8016797455440106,4.847379288405875,3.0456995428618647
2025-09-12T10:05:00-04:00,386,387.9,384.9,387.85,380.8174888920776,NaN,NaN,NaN,NaN,NaN,367.82919999999865,381.0230839408312,354.6353160591661,380.06045926239693,380.6325040397991,385.38549731663454,375.8795107629636,408890,220898.43333333332,92.78301140108883,76.19043234132457,NaN,NaN,NaN,NaN,2.2030065796699487,56.75611482775711,103758008,1.8216897991835737,5.322811791841332,3.501121992657758
2025-09-12T10:10:00-04:00,387.89,388.49,386.16,386.685,381.678512124256,NaN,NaN,NaN,NaN,NaN,368.34369999999865,382.4038619921032,354.2835380078941,381.0533674099176,381.1282964258755,386.0097686888863,376.24682416286464,332865,226629.73333333334,86.78591746015609,78.28069797641231,NaN,NaN,NaN,NaN,2.212077538264951,58.97984573785047,103425143,1.632469084423485,5.5417083481871146,3.9092392637636295
2025-09-12T10:15:00-04:00,386.64,387.21,385.18,386.4,381.678512124256,NaN,NaN,NaN,NaN,NaN,368.8606999999986,383.6201734338436,354.10122656615357,381.0533674099176,381.47089978935634,386.3577033361053,376.58409624260736,310973,232799.03333333333,85.33282868457951,80.52354275744858,NaN,NaN,NaN,NaN,2.199071999817453,60.24874892000718,103114170,1.3744646569458565,5.62732008494595,4.252855428000093
2025-09-12T10:20:00-04:00,386.39,388.26,386.12,388.26,381.678512124256,NaN,NaN,NaN,NaN,NaN,369.4142999999986,384.94611225885194,353.88248774114527,381.61855514234725,381.9106861310213,386.873638128977,376.9477341330656,363703,240612.76666666666,86.87710595403225,82.96912728991855,NaN,NaN,NaN,NaN,2.1948525712590623,61.53341404207032,103477873,1.2206291552293767,5.778641872036815,4.558012716807438
2025-09-12T10:25:00-04:00,388.23,392.41,388.17,391.79,384.2700587699788,NaN,NaN,NaN,NaN,NaN,370.0256999999986,386.5914473131852,353.459952686812,384.97684411387786,382.9104758660612,388.3634915136046,377.4574602185178,637551,258313.43333333332,89.20096731316771,85.22597495845616,NaN,NaN,NaN,NaN,2.3409345304548443,63.059379141538685,104115424,1.2439424671164732,6.112940800703029,4.868998333586556
2025-09-12T10:30:00-04:00,391.8,394.19,391.34,393.06,386.6300560986161,NaN,NaN,NaN,NaN,NaN,370.6596999999986,388.2453455566533,353.0740544433439,386.81847529110223,383.6621203420548,389.5277652951771,377.79647538893244,462544,270897.6666666667,89.89432841184379,87.04323162572642,NaN,NaN,NaN,NaN,2.3772963497080712,64.58634827236122,104577968,1.2300039843607387,6.406503314037479,5.176499329676741
2025-09-12T10:35:00-04:00,393.08,393.74,389.45,390.01,386.6300560986161,NaN,NaN,NaN,NaN,NaN,371.2234999999986,389.43577478939085,353.0112252106063,386.81847529110223,384.0415658270552,389.9836455176558,378.0994861364546,330815,278513.9,77.0926126105264,87.61786849839642,NaN,NaN,NaN,NaN,2.5139180390146385,64.77443758014076,104247153,0.91495174113152,6.320189006091141,5.405237264959621
2025-09-12T10:40:00-04:00,390.05,390.62,386.9,387.87,386.6300560986161,NaN,NaN,NaN,NaN,NaN,371.73949999999866,390.3429265930805,353.1360734069168,386.81847529110223,384.2703514017586,390.1389735803183,378.4017292231989,352241,286898.9,69.60295156843254,86.69237274918382,NaN,NaN,NaN,NaN,2.600066750513595,63.52249717840074,103894912,0.4836714995499758,6.00982663939709,5.5261551398471145
2025-09-12T10:45:00-04:00,387.9,390.35,387.6,389.18,386.6300560986161,NaN,NaN,NaN,NaN,NaN,372.2742999999986,391.3100207387649,353.23857926123236,386.81847529110223,384.47869025033793,390.30006415493693,378.65731634573893,310721,294967.0333333333,71.43257890999323,85.66996685716627,NaN,NaN,NaN,NaN,2.6107762683340523,62.35998109107073,104205633,0.2212187782190016,5.802678612620866,5.581459834401865
2025-09-12T10:50:00-04:00,389.21,389.7,388.11,389.33,386.6300560986161,NaN,NaN,NaN,NaN,NaN,372.7992999999987,392.23548028430343,353.363119715694,386.81847529110223,384.62082280961397,390.40554522885,378.83610039037796,228606,300072,71.64305141439941,84.57907214936822,NaN,NaN,NaN,NaN,2.5378636777387613,61.28050186712144,104434239,0.003809388811218284,5.586221570415887,5.582412181604669
2025-09-12T10:55:00-04:00,389.4,389.85,388.5,389.63,386.6300560986161,NaN,NaN,NaN,NaN,NaN,373.3188999999987,393.13430282618657,353.5034971738108,386.81847529110223,384.7251005399655,390.48716100179763,378.9630400781334,166496,301690,72.08600779735258,83.35237218954555,NaN,NaN,NaN,NaN,2.4530162721859945,60.31090530145844,104600735,-0.1644067861317371,5.376903698939998,5.541310485071735
2025-09-12T11:00:00-04:00,389.65,390.64,389.01,390.07,386.6300560986161,NaN,NaN,NaN,NaN,NaN,373.8384999999987,394.0178060585347,353.6591939414627,386.81847529110223,384.8428419625567,390.59115686064115,379.09452706447223,174703,304735.13333333336,72.75813943633341,82.04925014485072,NaN,NaN,NaN,NaN,2.39422939560128,59.58618823742966,104775438,-0.283662248168322,5.186732674861332,5.470394923029654
2025-09-12T11:05:00-04:00,390.035,390.8,388.93,390.54,386.6300560986161,NaN,NaN,NaN,NaN,NaN,374.36729999999875,394.8810517983412,353.8535482016563,386.81847529110223,384.96286756461416,390.69895243331956,379.22678269590875,179983,307303.36666666664,73.49237113898151,80.78045109864529,NaN,NaN,NaN,NaN,2.356784438772617,58.9493703410629,104955421,-0.3634174619445467,5.016123095598971,5.379540557543518
2025-09-12T11:10:00-04:00,390.52,391.75,389.06,389.27,386.6300560986161,NaN,NaN,NaN,NaN,NaN,374.8730999999987,395.58363441039126,354.1625655896062,386.81847529110223,385.1139463961773,390.82912128477057,379.39877150758406,241971,312297.0333333333,68.14750453723637,79.08066975986597,NaN,NaN,NaN,NaN,2.3805855502888584,58.57280148582331,104713450,-0.5244482183979446,4.723980284546087,5.248428502944032
2025-09-12T11:15:00-04:00,389.265,389.96,388.14,388.14,386.6300560986161,NaN,NaN,NaN,NaN,NaN,375.33349999999876,396.17934795598075,354.4876520440168,386.81847529110223,385.19200635077334,390.86993138729173,379.51408131425495,178101,314191.6666666667,63.70787113972213,77.00387402691122,NaN,NaN,NaN,NaN,2.3405437252682253,57.56706505473821,104535349,-0.7178496155791958,4.351116483470037,5.0689660990492325
2025-09-12T11:20:00-04:00,388.16,389.34,387.2,389.02,386.6300560986161,NaN,NaN,NaN,NaN,NaN,375.7900999999987,396.81419993232004,354.76600006767734,385.83944443309485,385.2574757932787,390.8982394729481,379.61671211360925,166324,312620.93333333335,65.58803432873664,75.4897395175241,NaN,NaN,NaN,NaN,2.3262191734633513,55.99630407902799,104701673,-0.7914922536709001,4.0796007819606075,4.871093035631508
2025-09-12T11:25:00-04:00,389.04,389.2,387.95,388.19,386.6300560986161,NaN,NaN,NaN,NaN,NaN,376.2370999999987,397.34619245714356,355.1280075428538,385.83944443309485,385.30632125513876,390.917406763658,379.6952357466195,131506,312808.73333333334,62.30922935784047,73.84519670847132,NaN,NaN,NaN,NaN,2.2493463753588263,54.5377403158685,104570167,-0.893536187080171,3.7541728017812943,4.647708988861465
2025-09-12T11:30:00-04:00,388.225,389.25,387.8,388.8,386.6300560986161,NaN,NaN,NaN,NaN,NaN,376.68369999999874,397.89196242868775,355.4754375713097,385.83944443309485,385.3489970229614,390.9362903759536,379.76170366996917,112136,313874.6,63.74376104592393,72.19281492932072,NaN,NaN,NaN,NaN,2.192250205690338,53.074017917220814,104682303,-0.9140982049494353,3.505086232674671,4.419184437624106
2025-09-12T11:35:00-04:00,388.795,390.43,388.64,390.13,386.6300560986161,NaN,NaN,NaN,NaN,NaN,377.1644999999987,398.4800305119099,355.84896948808756,385.83944443309485,385.44564984932714,391.008388865274,379.88291083338027,196078,317406.63333333336,66.7180954133826,70.5868955079075,NaN,NaN,NaN,NaN,2.1635180481410297,52.12613634616344,104878381,-0.8344789091106204,3.3760858012358312,4.210564710346452
2025-09-12T11:40:00-04:00,390.17,390.22,389.09,389.78,386.6300560986161,NaN,NaN,NaN,NaN,NaN,377.63309999999876,399.0071331141324,356.25906688586514,385.8691225214692,385.5020136521416,391.0491036745161,379.9549236297671,119515,318081.6,65.20219612425812,68.82317177307995,NaN,NaN,NaN,NaN,2.089695330416674,51.24596060161017,104758866,-0.8015534107086904,3.2086229469605883,4.010176357669279
2025-09-12T11:45:00-04:00,389.68,390.24,389.43,389.9,386.6300560986161,NaN,NaN,NaN,NaN,NaN,378.1040999999987,399.5007213866634,356.70747861333405,386.3542980171754,385.5449213714387,391.081348618959,380.0084941239184,89701,318133.4,65.49169588623192,67.99453486420178,NaN,NaN,NaN,NaN,1.9982885211011971,50.43602080215419,104848567,-0.7677994846092346,3.0504270019077353,3.81822648651697
2025-09-12T11:50:00-04:00,389.9,390.85,389.4,390.83,386.6300560986161,NaN,NaN,NaN,NaN,NaN,378.5718999999987,400.03810831828713,357.1056916817103,387.0164384137403,385.6090023112211,391.136076217665,380.0819284047772,122789,315682.43333333335,67.73223073690937,67.8609119476644,NaN,NaN,NaN,NaN,1.9591250553082578,49.91260462272834,104971356,-0.6818534746325158,2.9659096432263254,3.647763117858841
2025-09-12T11:55:00-04:00,390.87,392.65,390.81,391.71,386.6300560986161,NaN,NaN,NaN,NaN,NaN,379.06989999999877,400.57681688652735,357.5629831134702,388.6631507309922,385.756766481416,391.2967961195552,380.21673684327675,228496,315164.4,69.73466375217596,67.7396322935346,NaN,NaN,NaN,NaN,1.9506161227862375,50.01492947532068,105199852,-0.5693367106696181,2.936092229521819,3.505428940191437
2025-09-12T12:00:00-04:00,391.72,391.89,389.77,389.92,386.6300560986161,NaN,NaN,NaN,NaN,NaN,379.5624999999987,400.91206620178025,358.21293379821714,388.6631507309922,385.8354592606979,391.3630938143653,380.30782470703053,158602,300882.9,61.389443674228275,67.00723174066523,NaN,NaN,NaN,NaN,1.9627149711586493,49.21655365556404,105041250,-0.6151597564259084,2.7364792446590513,3.3516390010849597
2025-09-12T12:05:00-04:00,389.94,390.91,389.43,390.67,386.6300560986161,NaN,NaN,NaN,NaN,NaN,380.07129999999876,401.2421513585064,358.9004486414911,388.6631507309922,385.89185981572024,391.4075265478314,380.37619308360905,121987,284350.4,63.36754279460354,66.38448424046888,NaN,NaN,NaN,NaN,1.9282353303616042,48.19481943870206,105163237,-0.5943260679690052,2.608731416123703,3.2030574840927084
2025-09-12T12:10:00-04:00,390.69,391.7,390.4,391.48,386.6300560986161,NaN,NaN,NaN,NaN,NaN,380.5958999999987,401.57072125702376,359.6210787429737,388.6631507309922,385.96051650342616,391.4730349853472,380.4479980215051,127734,274316.93333333335,65.42760303584049,65.86087449757653,NaN,NaN,NaN,NaN,1.883361378192919,47.553246196902435,105290971,-0.5276217170799087,2.5435303377428227,3.0711520548227313
2025-09-12T12:15:00-04:00,391.56,392.32,391.295,391.97,386.6300560986161,NaN,NaN,NaN,NaN,NaN,381.10809999999873,401.9174843148714,360.29871568512607,388.6631507309922,386.04931303981846,391.5671677693641,380.5314583102728,150683,264296.4666666667,66.64943860230849,65.3720936020999,NaN,NaN,NaN,NaN,1.8220498511791374,47.187143972115905,105441654,-0.45488237173967594,2.502549090148136,2.957431461887812
2025-09-12T12:20:00-04:00,391.9,392.07,391.21,391.77,386.6300560986161,NaN,NaN,NaN,NaN,NaN,381.6166999999987,402.19926850940436,361.034131490593,388.6945332315315,386.1084602816432,391.6272302984003,380.5896902648861,106244,251890,65.6299001398031,65.19226471656894,NaN,NaN,NaN,NaN,1.7533320046663428,46.76836541649972,105335410,-0.4251709445692349,2.4259677811762685,2.8511387257455034
2025-09-12T12:25:00-04:00,391.77,392.12,391.3,391.66,386.6300560986161,NaN,NaN,NaN,NaN,NaN,382.1272999999986,402.4123111373979,361.84228886259933,389.00962658522525,386.1563466950035,391.67547912658387,380.6372142634231,87524,235802.33333333334,65.04059665640982,65.28745939633235,NaN,NaN,NaN,NaN,1.6866654329044606,46.3999709112983,105247886,-0.41727346469688475,2.3295468948743974,2.746820359571282
2025-09-12T12:30:00-04:00,391.66,392.75,391.41,392.435,386.84062029753596,NaN,NaN,NaN,NaN,NaN,382.64299999999866,402.63685005456426,362.64914994543307,389.5917012681802,386.231472386214,391.75689900760113,380.7060457648269,128520,224266.73333333334,67.27042451894687,65.4076301242045,NaN,NaN,NaN,NaN,1.6619036162684258,46.31713125393971,105376406,-0.366032860219077,2.289279284297436,2.655312144516513
2025-09-12T12:35:00-04:00,392.47,392.83,391.82,392.11,387.1860466476479,NaN,NaN,NaN,NaN,NaN,383.13759999999866,402.817760491327,363.4574395086703,389.7983610145441,386.3171404133351,391.84927846639613,380.78500236027406,149167,215609.3,65.38692892825291,65.6274658078054,NaN,NaN,NaN,NaN,1.615339072249252,46.273176610526185,105227239,-0.35967690936239327,2.205716007813521,2.5653929171759144
2025-09-12T12:40:00-04:00,392.13,393.44,391.98,393.15,387.6055445273003,NaN,NaN,NaN,NaN,NaN,383.6645999999986,402.974293922083,364.35490607791417,390.2846888116353,386.4189688799477,391.9672606734961,380.8706770863993,165853,210042.23333333334,68.43279774087057,65.96239700030158,NaN,NaN,NaN,NaN,1.6042434242314467,46.483420624538006,105393092,-0.2938560917390882,2.198072802502054,2.491928894241142
2025-09-12T12:45:00-04:00,393.17,394.83,393.17,394.56,388.8984743215139,NaN,NaN,NaN,NaN,NaN,384.22339999999866,403.14086700180184,365.3059329981955,391.46575104930827,386.58063072244653,392.1817447628111,380.97951668208196,226386,207222.66666666666,72.0268390232669,66.34159297243617,NaN,NaN,NaN,NaN,1.6096546082149155,47.175873786433336,105619478,-0.16993199058938524,2.2795139060044107,2.449445896593796
2025-09-12T12:50:00-04:00,394.56,395.99,394.36,395.43,390.0830891250815,NaN,NaN,NaN,NaN,NaN,384.8097999999986,403.2568731511683,366.36272684882886,392.48360083944664,386.785674578049,392.4750448960184,381.0963042600796,263194,203872.36666666667,73.9942756264923,66.96959865116717,NaN,NaN,NaN,NaN,1.6111078504852785,48.162186911820676,105882672,-0.05016041221139922,2.386745381329547,2.436905793540946
2025-09-12T12:55:00-04:00,395.38,395.38,393.51,393.57,390.0830891250815,NaN,NaN,NaN,NaN,NaN,385.34199999999856,403.2252776639111,367.45872233608605,392.48360083944664,386.8976730862999,392.6151467924834,381.1801993801164,171970,188353,63.68200491544516,66.8403350103967,NaN,NaN,NaN,NaN,1.633171575450617,48.16207318358508,105710702,-0.11337807520706189,2.2951831995321186,2.4085612747391805
2025-09-12T13:00:00-04:00,393.63,393.64,391.78,392.62,390.0830891250815,NaN,NaN,NaN,NaN,NaN,385.8515999999986,403.07093128099314,368.63226871900406,392.48360083944664,386.98066233971724,392.69846980750987,381.2628548719246,164728,178425.8,59.147906869145025,66.2271690198421,NaN,NaN,NaN,NaN,1.6493736057755741,46.588869602729474,105545974,-0.2296433896070731,2.121507037730339,2.351150427337412
2025-09-12T13:05:00-04:00,392.63,392.73,391.4,391.45,390.0830891250815,NaN,NaN,NaN,NaN,NaN,386.3393999999986,402.76532470956977,369.9134752904274,392.48360083944664,387.0358182470825,392.7445694141262,381.3270670800388,131225,171772.8,54.04436655230666,65.10643350556572,NaN,NaN,NaN,NaN,1.626561205363036,44.82199629825553,105414749,-0.386579606606253,1.867925919079596,2.254505525685849
2025-09-12T13:10:00-04:00,391.44,393.2,391.08,393.09,390.0830891250815,NaN,NaN,NaN,NaN,NaN,386.86899999999855,402.3994477721865,371.3385522278106,392.48360083944664,387.1026191477304,392.8075198283539,381.3977184671069,144839,164859.4,59.34026213443339,64.96006339558038,NaN,NaN,NaN,NaN,1.6618068335513911,43.42294793695375,105559588,-0.3805719731602655,1.7787905592355173,2.159362532395783
2025-09-12T13:15:00-04:00,393.1,393.95,393.03,393.36,390.0830891250815,NaN,NaN,NaN,NaN,NaN,387.4121999999986,401.8762445465492,372.94815545344807,392.48360083944664,387.17241714875075,392.8843124467015,381.46052185080003,130753,158860.46666666667,60.15437735452293,64.73055157843176,NaN,NaN,NaN,NaN,1.6088206311548645,42.49357641112992,105690341,-0.35931201999614526,1.7102225074006014,2.0695345273967467
2025-09-12T13:20:00-04:00,393.36,394.18,392.97,394.13,390.0830891250815,NaN,NaN,NaN,NaN,NaN,387.9737999999986,401.2044396763178,374.74316032367943,392.48360083944664,387.2311580103387,392.9511524988654,381.51116352181197,106925,154804.43333333332,62.46269731186736,64.51877259814796,NaN,NaN,NaN,NaN,1.5803334432152298,41.741703944501936,105797266,-0.29687891351077766,1.6984358855082746,1.9953147990190523
2025-09-12T13:25:00-04:00,394.19,394.42,393.57,393.59,390.0830891250815,NaN,NaN,NaN,NaN,NaN,388.51099999999866,400.3564592145811,376.6655407854162,392.48360083944664,387.27068696691714,392.99639219776884,381.54498173606544,71935,151652.4,59.84435573132571,64.03269525022061,NaN,NaN,NaN,NaN,1.528166768699858,41.16261932536226,105725331,-0.29483661129282557,1.6267690349030204,1.921605646195846
2025-09-12T13:30:00-04:00,393.58,394.25,393.32,393.82,390.0830891250815,NaN,NaN,NaN,NaN,NaN,389.0295999999987,399.3966587614875,378.6625412385099,392.48360083944664,387.3104039773367,393.0411800386922,381.57962791598123,73866,148291.16666666666,60.60188560584872,63.67355135493817,NaN,NaN,NaN,NaN,1.4854405709355827,40.369518522912315,105799197,-0.28094156266627346,1.570428692863004,1.8513702555292775
2025-09-12T13:35:00-04:00,393.76,394.57,393.36,394.07,390.0830891250815,NaN,NaN,NaN,NaN,NaN,389.53339999999866,398.2519199296837,380.8148800703136,392.48360083944664,387.36894834976476,393.10851176782415,381.6293849317054,107156,145863.6,61.45310099840671,63.4173016650808,NaN,NaN,NaN,NaN,1.4657662444401824,39.810758149107954,105906353,-0.2584291676998436,1.528333795904473,1.7867629636043165
2025-09-12T13:40:00-04:00,394.08,394.26,393.22,393.85,390.0830891250815,NaN,NaN,NaN,NaN,NaN,389.9225999999986,397.57449655996857,382.2707034400287,391.6148806715573,387.4114397802147,393.15553274693866,381.6673468134908,81737,140522.46666666667,60.22007376109082,62.9137051823768,NaN,NaN,NaN,NaN,1.4353543698373097,39.135864916834294,105824616,-0.26110101358377635,1.460386696624596,1.7214877102083723
2025-09-12T13:45:00-04:00,393.83,394.95,393.78,394.59,390.0830891250815,NaN,NaN,NaN,NaN,NaN,390.2741999999987,397.090429268753,383.4579707312444,391.96784166503,387.4732678914012,393.22957750605286,381.7169582767495,109390,138232.1,62.915428057916735,62.73716940592421,NaN,NaN,NaN,NaN,1.416400486277503,38.90931409332442,105934006,-0.21755773186634464,1.4495405453754415,1.6670982772417862
2025-09-12T13:50:00-04:00,394.63,394.88,394.22,394.47,390.0830891250815,NaN,NaN,NaN,NaN,NaN,390.5995999999987,396.5814822593188,384.6177177406786,392.16427333202404,387.517375170937,393.28251274234583,381.75223759952814,78289,135297.6,62.17967086738197,62.29051748638932,NaN,NaN,NaN,NaN,1.362371880114822,38.69894547149383,105855717,-0.2017176470885218,1.414951218381134,1.6166688654696557
2025-09-12T13:55:00-04:00,394.48,395.37,394.45,394.93,390.5119612450485,NaN,NaN,NaN,NaN,NaN,390.8753999999987,396.3361801058356,385.41461989416183,392.7374186656192,387.5962957724477,393.3807608772143,381.81183066768114,134909,135411.03333333333,63.92142941717504,61.71155965738275,NaN,NaN,NaN,NaN,1.3307738886780502,38.78781477686846,105990626,-0.16659775253570497,1.4084216748000244,1.5750194273357294
2025-09-12T14:00:00-04:00,394.9,395.28,394.24,395.17,390.5119612450485,NaN,NaN,NaN,NaN,NaN,391.0969999999987,396.3330145152955,385.86098548470187,392.7374186656192,387.6663198592609,393.4667846008228,381.865855117699,122498,135756.43333333332,64.83145814545634,61.05707269445161,NaN,NaN,NaN,NaN,1.310004325201044,38.591660982387985,106113124,-0.1348948656958191,1.4064008452159555,1.5412957109117746
2025-09-12T14:05:00-04:00,395.17,395.5,394.8,395.02,390.91186964683135,NaN,NaN,NaN,NaN,NaN,391.3057999999986,396.31328933544614,386.2983106645511,393.0491479459963,387.7162344652792,393.5290278490383,381.90344108152004,86255,132095.66666666666,63.74916482015837,61.06186983050255,NaN,NaN,NaN,NaN,1.2664325876866829,38.548828302575934,106026869,-0.13157704701017603,1.3768244021490545,1.5084014491592306
2025-09-12T14:10:00-04:00,395.05,395.31,394.73,394.96,390.91186964683135,NaN,NaN,NaN,NaN,NaN,391.4857999999986,396.3568776471582,386.614722352839,393.05931835679706,387.7592398679468,393.581650151855,381.9368295840386,76364,130657.3,63.29400237249594,61.35801950931334,NaN,NaN,NaN,NaN,1.2174016885662042,38.407129072157005,105950505,-0.14018088422239483,1.333175343881237,1.4733562281036319
2025-09-12T14:15:00-04:00,395,395.41,394.16,394.93,390.91186964683135,NaN,NaN,NaN,NaN,NaN,391.62739999999866,396.47906702943857,386.77573297055875,393.05931835679706,387.83977600538213,393.6773911378716,382.00216087289266,148941,132631.96666666667,63.051596742816244,62.00139309434973,NaN,NaN,NaN,NaN,1.2197301393829039,37.46452648561501,105801564,-0.15357192652132245,1.2813913199519789,1.4349632464733013
2025-09-12T14:20:00-04:00,394.905,395.4,394.41,394.88,390.91186964683135,NaN,NaN,NaN,NaN,NaN,391.79129999999867,396.5160631945391,387.06653680545827,393.05931835679706,387.89237535750425,393.73978240328444,382.04496831172406,98245,131813.83333333334,62.62113504828357,62.235741159624745,NaN,NaN,NaN,NaN,1.203320843712693,36.589252655254576,105703319,-0.17018784745143822,1.2222284371590035,1.3924162846104418
2025-09-12T14:25:00-04:00,394.89,395.37,394.54,394.95,390.97032908777334,NaN,NaN,NaN,NaN,NaN,391.96229999999866,396.50975256649156,387.41484743350577,393.05931835679706,387.9290405446122,393.7832841079803,382.07479698124405,68801,126490.66666666667,63.00196387334905,62.43914019668375,NaN,NaN,NaN,NaN,1.1766550691617854,35.77649838420561,105772120,-0.1799080136118114,1.1675312675956775,1.347439281207489
2025-09-12T14:30:00-04:00,394.98,394.98,393.4,393.46,390.97032908777334,NaN,NaN,NaN,NaN,NaN,392.06629999999865,396.50690212635214,387.62569787364515,393.05931835679706,387.9926811098532,393.8483305860761,382.13703163363033,141622,125924.66666666667,51.07377351050405,61.62564563944351,NaN,NaN,NaN,NaN,1.2054654213645182,33.483763425272926,105630498,-0.2839420159043271,0.99251176132708,1.276453777231407
2025-09-12T14:35:00-04:00,393.43,394.1,392.84,393.95,390.97032908777334,NaN,NaN,NaN,NaN,NaN,392.10949999999866,396.5804329009235,387.63856709907384,393.05931835679706,388.05106768510626,393.904206410487,382.1979289597255,140147,126530,54.148248066513716,61.218780806242656,NaN,NaN,NaN,NaN,1.2093607484099134,31.446877187934163,105770645,-0.3146303335648759,0.8831658602753123,1.1977961938401882
2025-09-12T14:40:00-04:00,393.9,394.07,392.99,393.09,390.97032908777334,NaN,NaN,NaN,NaN,NaN,392.1100999999986,396.58155099096854,387.6386490090287,393.05931835679706,388.0856092902653,393.9354211449212,382.23579743560947,88226,125213.06666666667,48.39969125606659,60.34719549554393,NaN,NaN,NaN,NaN,1.200120694952061,29.555482824691033,105682419,-0.38317500469884,0.7188274379666382,1.1020024426654782
2025-09-12T14:45:00-04:00,393.09,393.74,392.72,392.87,390.97032908777334,NaN,NaN,NaN,NaN,NaN,392.16729999999865,396.60285507740116,387.73174492259614,393.05931835679706,388.13018708372357,393.97301822857065,382.2873559388765,121919,124254.26666666666,47.024363349704494,59.31657137777948,NaN,NaN,NaN,NaN,1.1872549310269125,28.101602997495924,105560500,-0.4301374416776056,0.5643306405684712,0.9944680822460767
2025-09-12T14:50:00-04:00,392.88,393.54,392.62,393.32,390.97032908777334,NaN,NaN,NaN,NaN,NaN,392.2762999999987,396.5489548239434,388.00364517605396,393.05931835679706,388.1659446607586,394.003286087815,382.3286032337022,98390,123992.46666666666,50.145024994119865,58.59692503728156,NaN,NaN,NaN,NaN,1.16816529309642,26.864807103201805,105658890,-0.41737249886180394,0.4727524586688219,0.8901249575306258
2025-09-12T14:55:00-04:00,393.34,394.28,393.06,393.7,390.97032908777334,NaN,NaN,NaN,NaN,NaN,392.3666999999987,396.5640894797371,388.16931052026024,393.05931835679706,388.20408626209996,394.0391283285141,382.36904419568583,96400,124288.33333333333,52.67998514653127,57.86582197218259,NaN,NaN,NaN,NaN,1.1718677721609592,25.14199020490074,105755290,-0.3713567110143986,0.4259290687626276,0.7972857797770262
2025-09-12T15:00:00-04:00,393.75,395.34,393.68,395.11,390.97032908777334,NaN,NaN,NaN,NaN,NaN,392.48229999999865,396.65710021613006,388.30749978386723,393.00665099868013,388.273249997539,394.11541976899935,382.4310802260786,149748,124995.93333333333,60.67090517814457,57.75805299437992,NaN,NaN,NaN,NaN,1.2067343598637454,24.643620650121118,105905038,-0.24033357051920246,0.49686881662802307,0.7372023871472255
2025-09-12T15:05:00-04:00,395.08,395.6,394.86,395.23,391.3881827682322,NaN,NaN,NaN,NaN,NaN,392.5942999999986,396.7574622650137,388.4311377349835,393.00665099868013,388.3383241394862,394.19154147709816,382.4851068018742,133007,124457.26666666666,61.270340605425496,57.56868950782638,NaN,NaN,NaN,NaN,1.17339619130205,24.415814807453476,106038045,-0.1446749352838006,0.5563587180424747,0.7010336533262753
2025-09-12T15:10:00-04:00,395.21,395.94,394.88,395.93,391.5982653696761,NaN,NaN,NaN,NaN,NaN,392.71149999999864,396.9135662779883,388.50943372200896,393.19152552417177,388.40622574029334,394.27362700830133,382.53882447228534,134525,123413,64.65459424434306,57.55605637203258,NaN,NaN,NaN,NaN,1.1652964633519038,24.50486285286501,106172570,-0.038852682091895296,0.6524678007114062,0.6913204828033015
2025-09-12T15:15:00-04:00,395.91,396.61,395.66,396.08,392.36698058014537,NaN,NaN,NaN,NaN,NaN,392.8222999999987,397.0812628836859,388.56333711631146,393.9362204193375,388.51579512970295,394.4124046145295,382.6191856448764,206913,122763.9,65.35324430812338,57.670633478315786,NaN,NaN,NaN,NaN,1.1499181445410527,25.12962900921351,106379483,0.03278139057974061,0.7322972210279772,0.6995158304482366
2025-09-12T15:20:00-04:00,396.08,396.2,394.57,394.92,392.36698058014537,NaN,NaN,NaN,NaN,NaN,392.9352999999987,397.11025025655516,388.7603497434422,393.9362204193375,388.5841046894712,394.48920718844965,382.6790021904927,149660,118979.43333333333,56.115590504121776,57.157889773431926,NaN,NaN,NaN,NaN,1.1842097056452627,24.265659872973373,106229823,-0.004444057444040306,0.6939607586431862,0.6984048160872265
2025-09-12T15:25:00-04:00,394.89,395.15,393.92,393.95,392.36698058014537,NaN,NaN,NaN,NaN,NaN,393.0514999999986,397.00358514644705,389.0994148535502,393.9362204193375,388.63788713765473,394.541367932486,382.73440634282343,138747,117872,49.77921375666728,56.20986241727843,NaN,NaN,NaN,NaN,1.1874804409563124,22.746552301930105,106091076,-0.09581363955156252,0.5786377666477733,0.6744514061993359
2025-09-12T15:30:00-04:00,393.94,393.94,392.83,393.44,392.36698058014537,NaN,NaN,NaN,NaN,NaN,393.13989999999865,396.9213751043399,389.3584248956574,393.9362204193375,388.70127689807816,394.590721700851,382.8118320953053,200183,119053.83333333333,46.787821249777735,55.07891143167087,NaN,NaN,NaN,NaN,1.1826604094594333,21.924269805767967,105890893,-0.18675546745965688,0.44100707187476473,0.6277625393344216
2025-09-12T15:35:00-04:00,393.48,393.5,391.98,392.38,NaN,NaN,NaN,396.5674399579637,396.5674399579637,396.5674399579637,393.22369999999864,396.73902918013164,389.70837081986565,393.9362204193375,388.75390047730275,394.62103130344366,382.88676965116184,204842,121507.73333333334,41.24065372205347,53.524532135149755,NaN,NaN,NaN,NaN,1.206756094498044,21.820001111560202,105686051,-0.30733592804195553,0.24359262928197722,0.5509285573239328
2025-09-12T15:40:00-04:00,392.39,393.64,392.23,393.31,NaN,NaN,NaN,396.5674399579637,NaN,NaN,393.3138999999986,396.5941532165739,390.03364678342336,393.9362204193375,388.7938940815007,394.6483052178722,382.9394829451292,143002,121446.5,47.159868718336284,53.24496750713778,NaN,NaN,NaN,NaN,1.2212735163196098,21.567353570328297,105829053,-0.312474650650453,0.16033524401086652,0.4728098946613195
2025-09-12T15:45:00-04:00,393.32,394.5,393.07,394.43,NaN,NaN,NaN,396.5674399579637,NaN,NaN,393.3998999999987,396.56520471907226,390.23459528092513,393.9362204193375,388.8421229815615,394.6906592098215,382.9935867533015,143970,121887.06666666667,53.26567337964372,53.18192645807564,NaN,NaN,NaN,NaN,1.2361825508682094,20.42885662648944,105973023,-0.2321497989832853,0.1826226459322129,0.4147724449154982
2025-09-12T15:50:00-04:00,394.46,396.38,394.46,396.24,NaN,NaN,NaN,396.5674399579637,NaN,NaN,393.52909999999866,396.61930756013595,390.4388924398614,393.9362204193375,388.95394188375167,394.8191528720024,383.08873089550093,257853,126918,61.09057770895153,54.08841834756742,NaN,NaN,NaN,NaN,1.2871695115204793,20.085594919554666,106230876,-0.057905491734424275,0.3423905802474678,0.4002960719818921
2025-09-12T15:55:00-04:00,396.1,396.5,394.54,396,NaN,NaN,NaN,396.5674399579637,NaN,NaN,393.6510999999986,396.6385144614935,390.6636855385037,393.9362204193375,389.0713258269709,394.95146929302666,383.19118236091515,280620,133874.16666666666,59.6640727276704,54.99125473170784,NaN,NaN,NaN,NaN,1.3352288321261578,19.84906647111008,105950256,0.03537730374226228,0.44451770165971993,0.40914039791745765
2025-09-15T09:30:00-04:00,423.2,425.69,418.96,424.06,414.4165960763672,414.4165960763672,414.4165960763672,NaN,NaN,NaN,394.3156999999987,403.287727643993,385.3436723560044,407.7617367811107,422.90333333333336,422.90333333333336,422.90333333333336,973235,163853.13333333333,89.76268083063867,57.821087291459186,NaN,NaN,NaN,NaN,3.3605696298314323,24.27431300671505,106923491,1.8789842078524859,2.757870657733065,0.8788864498805792
2025-09-15T09:35:00-04:00,424.07,425.23,417.6,419,414.4165960763672,NaN,NaN,NaN,NaN,NaN,394.8614999999986,406.15343026036066,383.56956973963656,407.7617367811107,421.92718620505144,423.0611031030282,420.7932693070747,721250,184322.93333333332,78.40143602278295,59.658333782620026,NaN,NaN,NaN,NaN,3.66552894198633,27.893573307555314,106202241,2.6050918227816307,4.1352512283576175,1.5301594055759868
2025-09-15T09:40:00-04:00,418.97,420.93,416.13,416.55,414.4165960763672,NaN,NaN,NaN,NaN,NaN,395.3940999999987,408.1240193542091,382.66418064578824,407.7617367811107,420.875977186693,422.90391653589256,418.8480378374934,592572,201350.76666666666,73.54745574074957,60.578087394234664,NaN,NaN,NaN,NaN,3.746562588987307,30.728657740008558,105609669,2.7533353431445557,4.971828584506682,2.218493241362126
2025-09-15T09:45:00-04:00,416.62,418.23,414.77,416.48,414.4165960763672,NaN,NaN,NaN,NaN,NaN,395.9102999999987,409.86626079260026,381.95433920739714,407.7617367811107,420.13347122851036,422.60705513819266,417.65988731882805,466508,213254.7,73.4076156338436,61.44503561055025,NaN,NaN,NaN,NaN,3.726093832631073,32.879717089950866,105143161,2.6772243055195757,5.565023623261595,2.8877993177420196
2025-09-15T09:50:00-04:00,416.5,420.33,415.05,419.5,414.4165960763672,NaN,NaN,NaN,NaN,NaN,396.4706999999987,411.847967639102,381.0934323608954,407.7617367811107,419.9213205596761,422.32102400981944,417.5216171095327,358830,222606.06666666668,75.56610714562757,62.22442938921342,NaN,NaN,NaN,NaN,3.8370871303002803,35.052488198083594,105501991,2.6555766892351493,6.207270179285956,3.551693490050807
2025-09-15T09:55:00-04:00,419.44,419.52,417.11,418.82,414.4165960763672,NaN,NaN,NaN,NaN,NaN,397.00769999999864,413.54993917263647,380.4654608273608,407.7617367811107,419.8152192677557,422.1550904765974,417.475348058914,247941,226373.8,74.10748832465086,62.8497325332511,NaN,NaN,NaN,NaN,3.7351523352788294,37.070061369921135,105254050,2.4270225415637485,6.585471667005493,4.158449125441744
2025-09-15T10:00:00-04:00,418.88,419.63,416.66,418.06,414.4165960763672,NaN,NaN,NaN,NaN,NaN,397.5334999999987,415.02066903917,380.0463309608274,407.7617367811107,419.7016364105574,422.00139890265643,417.40187391845836,240810,230317.53333333333,72.42484638660292,64.01467938199976,NaN,NaN,NaN,NaN,3.6804985970446253,38.76456312276865,105013240,2.0701274861395556,6.746108483116188,4.675980996976633
2025-09-15T10:05:00-04:00,418.04,422.6,417.52,421.75,414.4165960763672,NaN,NaN,NaN,NaN,NaN,398.1352999999986,416.8036608719389,379.4669391280583,410.494171333398,419.76913568799455,421.9960705699891,417.542200806,284565,236927.86666666667,75.35117620254353,65.84124812813377,NaN,NaN,NaN,NaN,3.780462982970012,40.61339569264904,105297805,1.9307702293628726,7.089443783680224,5.158673554317351
2025-09-15T10:10:00-04:00,421.76,422.84,421,421.94,414.4165960763672,NaN,NaN,NaN,NaN,NaN,398.72539999999856,418.4699803035941,378.980819696403,412.2353370667184,419.870124902981,422.0915651086167,417.6486846973453,190813,240742.83333333334,75.49537621214907,67.89178776830315,NaN,NaN,NaN,NaN,3.641858484186438,42.35159271928719,105488618,1.7073043487789352,7.29280399029102,5.585499641512085
2025-09-15T10:15:00-04:00,422.07,423.05,419.55,419.69,414.4165960763672,NaN,NaN,NaN,NaN,NaN,399.27699999999857,419.77801158491775,378.7759884150794,412.8162696533747,419.9204337112105,422.08821041441905,417.7526570080019,243309,243888.43333333332,70.2539055184609,69.96416289661796,NaN,NaN,NaN,NaN,3.631725735315978,43.34926360794064,105245309,1.2832288712893627,7.189535730623788,5.906306859334426
2025-09-15T10:20:00-04:00,419.77,419.77,415.85,416.36,414.4165960763672,NaN,NaN,NaN,NaN,NaN,399.7411999999986,420.711957026028,378.77044297396924,412.8162696533747,419.79467198154686,421.9814018954673,417.6079420676264,220125,247951.1,63.25436245478179,71.11376959207836,NaN,NaN,NaN,NaN,3.652316754221977,42.87224967801818,105025184,0.6837981071033221,6.761054493213578,6.077256386110256
2025-09-15T10:25:00-04:00,416.33,417.6,414.25,416.49,NaN,NaN,NaN,425.35975111043183,425.35975111043183,425.35975111043183,400.1797999999986,421.6110241331432,378.74857586685397,412.8162696533747,419.60058977106775,421.8823661974792,417.3188133446563,252670,254080.06666666668,63.40763820865758,71.83819565129365,NaN,NaN,NaN,NaN,3.63072270034898,41.889485041121155,105277854,0.22513180018828027,6.358671136345606,6.133539336157326
2025-09-15T10:30:00-04:00,416.61,418.32,415.82,415.82,NaN,NaN,NaN,425.35975111043183,NaN,NaN,400.5875999999986,422.4141110579973,378.7610889419999,412.8162696533747,419.50224390314077,421.8072272918289,417.19726051445264,165444,254874.13333333333,61.97285814437066,71.901215682395,NaN,NaN,NaN,NaN,3.5499567931811957,41.10906277647394,105112410,-0.17282927821763572,5.917502738385281,6.0903320166029165
2025-09-15T10:35:00-04:00,415.85,417.93,415.6,417.69,NaN,NaN,NaN,425.35975111043183,NaN,NaN,401.0699999999986,423.3169183485052,378.8230816514919,412.8162696533747,419.4522889595434,421.75934739236686,417.14523052671996,104113,253673,64.39451262632862,72.23910424658487,NaN,NaN,NaN,NaN,3.4628170222396806,40.3047325814105,105216523,-0.3493889391385334,5.653595842679749,6.002984781818283
2025-09-15T10:40:00-04:00,417.77,418.83,416.66,418.33,NaN,NaN,NaN,425.35975111043183,NaN,NaN,401.5841999999986,424.21135575243505,378.9570442475621,412.8162696533747,419.41898268041984,421.7112645533543,417.1267008074854,113999,254532.1,65.21106248868733,70.48541722215978,NaN,NaN,NaN,NaN,3.3704729492225574,39.73902883137036,105330522,-0.4556223300908737,5.43345686920469,5.889079199295564
2025-09-15T10:45:00-04:00,418.39,418.98,418.04,418.79,NaN,NaN,NaN,425.35975111043183,NaN,NaN,402.13099999999855,425.0713404509406,379.1906595490565,412.8162696533747,419.4048934699304,421.67977464678154,417.1300122930793,90983,253500.9,65.81783772458424,69.58658877228845,NaN,NaN,NaN,NaN,3.196867738563803,39.24487310645557,105421505,-0.5226563716110819,5.235758734781712,5.7584151063927935
2025-09-15T10:50:00-04:00,418.72,420.96,418.65,420.71,NaN,NaN,NaN,425.35975111043183,NaN,NaN,402.6833999999985,426.05247789719294,379.3143221028041,414.4172849536114,419.4264817788701,421.669374954307,417.1835886034332,167174,255793.7,68.30288416888172,69.21197651715502,NaN,NaN,NaN,NaN,3.133520042952103,39.18890739492774,105588679,-0.4672419563325807,5.174362660977067,5.641604617309648
2025-09-15T10:55:00-04:00,420.71,421.96,420.04,421.62,NaN,NaN,NaN,425.35975111043183,NaN,NaN,403.24859999999853,427.0513208563463,379.44587914365076,415.76582796288915,419.4814189312538,421.7107921128092,417.2520457496984,173046,258348.56666666668,69.43699595594481,68.92836082587654,NaN,NaN,NaN,NaN,3.0468400398840925,39.328907487040155,105761725,-0.4013750372944127,5.139885820691632,5.541260857986044
2025-09-15T11:00:00-04:00,421.68,422.58,421.04,421.74,NaN,NaN,NaN,425.35975111043183,NaN,NaN,403.80079999999856,428.00932043072913,379.592279569268,416.85466237031136,419.54855873271464,421.7791680138071,417.31794945162216,168213,258964.06666666668,69.59150559292661,68.50160357211219,NaN,NaN,NaN,NaN,2.9392086084637974,39.57801244038556,105929938,-0.38191068365039094,5.063872503423056,5.445783187073447
2025-09-15T11:05:00-04:00,421.78,421.82,419.05,419.29,NaN,NaN,NaN,425.35975111043183,NaN,NaN,404.31479999999857,428.72479934135663,379.9048006586405,416.85466237031136,419.5609881553489,421.7653518208074,417.35662448989046,145807,259390.73333333334,62.62988040402365,67.68177443492453,NaN,NaN,NaN,NaN,2.927122279287811,38.89936597615913,105784131,-0.5556918569203741,4.751168365922979,5.306860222843353
2025-09-15T11:10:00-04:00,419.315,421.24,418.86,421.08,NaN,NaN,NaN,425.35975111043183,NaN,NaN,404.8599999999986,429.52441939322364,380.19558060677355,416.85466237031136,419.57894594406434,421.7627514423266,417.3951404458021,130571,259258.93333333332,65.35663529460513,67.17690221406755,NaN,NaN,NaN,NaN,2.8880421164815386,38.18475121103986,105914702,-0.5696322576758677,4.594819900748519,5.164452158424386
2025-09-15T11:15:00-04:00,421.09,424.12,421.03,422.94,NaN,NaN,NaN,425.35975111043183,NaN,NaN,405.43739999999866,430.4141292687564,380.4606707312409,417.80522713359943,419.6993234873712,421.92321294832135,417.47543402642106,243056,260463.7,67.97179830258088,66.64980379264165,NaN,NaN,NaN,NaN,2.9024676795900026,38.17734203496432,106157758,-0.4768912363993234,4.5683381129252325,5.045229349324556
2025-09-15T11:20:00-04:00,422.93,423.36,421.27,421.32,NaN,NaN,NaN,425.35975111043183,NaN,NaN,405.9867999999986,431.1277780049408,380.8458219950564,417.80522713359943,419.7368964139617,421.96147074356827,417.5123220843551,105288,258984.63333333333,63.47727412438214,65.79136792922972,NaN,NaN,NaN,NaN,2.8444342739050046,38.17046208575131,106052470,-0.5431445426307828,4.366298671036077,4.90944321366686
2025-09-15T11:25:00-04:00,421.35,423,421.35,422.41,NaN,NaN,NaN,425.35975111043183,NaN,NaN,406.5431999999986,431.8812584703137,381.2051415296835,417.80522713359943,419.7763527298296,422.00544899479485,417.5472564648644,101952,257758.13333333333,65.14716920623555,65.42660104978506,NaN,NaN,NaN,NaN,2.7612603971975047,38.1640735614821,106154422,-0.5313955000958668,4.245198838547026,4.776594338642893
2025-09-15T11:30:00-04:00,422.41,422.74,421.02,421.2,NaN,NaN,NaN,425.35975111043183,NaN,NaN,407.07779999999866,432.5021739086088,381.6534260913885,417.80522713359943,419.80403220529985,422.02816863588055,417.57989577471915,97323,254329.46666666667,61.77077896916806,65.32063080081265,NaN,NaN,NaN,NaN,2.686884654540542,37.979096269865,106057099,-0.6169414696805671,4.005417501542183,4.62235897122275
2025-09-15T11:35:00-04:00,421.24,422.12,420.84,420.97,NaN,NaN,NaN,425.35975111043183,NaN,NaN,407.59859999999867,433.07305371670765,382.1241462832897,417.80522713359943,419.8215393754378,422.03859469208163,417.60448405879396,77624,250088.86666666667,61.122317688953174,65.15739362083377,NaN,NaN,NaN,NaN,2.586392893501934,37.7051570872773,105979475,-0.6950381619153614,3.7535612688285482,4.44859943074391
2025-09-15T11:40:00-04:00,420.99,421.86,420.54,421.32,NaN,NaN,NaN,425.35975111043183,NaN,NaN,408.12159999999864,433.62764269119083,382.61555730880644,417.80522713359943,419.8368832115599,422.0467911498864,417.62697527323337,73019,247756.1,61.77985171357737,65.14360744720568,NaN,NaN,NaN,NaN,2.4959362582517954,37.27270218440894,106052494,-0.7257734561911082,3.541382610505025,4.267156066696133
2025-09-15T11:45:00-04:00,421.33,422.08,421.03,421.44,NaN,NaN,NaN,425.35975111043183,NaN,NaN,408.6499999999986,434.14312879983436,383.15687120016287,417.8352105817102,419.85564422363126,422.0602555300579,417.65103291720465,76243,245498.53333333333,62.01704614286365,64.97378841267246,NaN,NaN,NaN,NaN,2.3926550969480966,36.94175929023558,106128737,-0.7382362270178318,3.344360782923843,4.082597009941675
2025-09-15T11:50:00-04:00,421.47,421.8,420.01,420.87,NaN,NaN,NaN,425.35975111043183,NaN,NaN,409.1681999999986,434.5803717892241,383.7560282107731,417.8352105817102,419.87410504478,422.06331958799393,417.68489050156603,123645,241024.93333333332,60.1088252326083,64.6093428943811,NaN,NaN,NaN,NaN,2.349608304308948,35.99625465816844,106005092,-0.780944413446806,3.1064164931331675,3.8873609065799735
2025-09-15T11:55:00-04:00,420.885,421.11,419.51,419.57,NaN,NaN,NaN,425.35975111043183,NaN,NaN,409.6609999999987,434.9047072555612,384.41729274443617,417.8352105817102,419.8760699004744,422.05397338276833,417.6981664181805,72924,234101.73333333334,55.88536105837869,63.89988027536642,NaN,NaN,NaN,NaN,2.2960648540011683,34.814862353423045,105932168,-0.8851779710194725,2.780888442805633,3.6660664138251056
2025-09-15T12:00:00-04:00,419.6,420.17,418.77,419.36,NaN,NaN,NaN,425.35975111043183,NaN,NaN,410.1505999999987,435.17725248419436,385.123947515803,417.8352105817102,419.86784899676155,422.02626529999543,417.7094326935277,132874,206089.7,55.21050228469984,62.964710140782,NaN,NaN,NaN,NaN,2.232060221572516,33.27508484931372,105799294,-0.950931590744414,2.477401925394588,3.428333516139002
2025-09-15T12:05:00-04:00,419.34,419.88,418.67,419.6,NaN,NaN,NaN,425.35975111043183,NaN,NaN,410.6435999999987,435.4230223533296,385.86417764666777,417.8352105817102,419.86286273734197,422.01070063668925,417.7150248379947,74409,184528.33333333334,55.866436764182,61.99538448422752,NaN,NaN,NaN,NaN,2.1590559200316206,31.784656617843428,105873703,-0.9582345033411541,2.2305403869625593,3.1887748903037134
2025-09-15T12:10:00-04:00,419.59,421.08,419.1,420.95,NaN,NaN,NaN,425.35975111043183,NaN,NaN,411.19339999999875,435.64102388790536,386.74577611209213,417.8352105817102,419.8687659143896,422.0049316326313,417.73260019614787,84036,167577.13333333333,59.46266063253669,61.27189555848538,NaN,NaN,NaN,NaN,2.1462662114579305,30.953180714052397,105957739,-0.8554971972407723,2.119403393752748,2.97490059099352
2025-09-15T12:15:00-04:00,420.99,421.2,420.4,420.62,NaN,NaN,NaN,425.35975111043183,NaN,NaN,411.7267999999987,435.8072968188899,387.64630318110756,417.8352105817102,419.878077597952,422.00468493073447,417.7514702651695,79020,154660.86666666667,58.21392793104619,60.956470381844134,NaN,NaN,NaN,NaN,2.0501043392109364,30.23482998876567,105878719,-0.7944382972973978,1.9818527193717728,2.7762910166691706
2025-09-15T12:20:00-04:00,420.64,420.9,418.92,419.1,NaN,NaN,NaN,425.35975111043183,NaN,NaN,412.24699999999865,435.8128777898239,388.6811222101734,417.8352105817102,419.8747223850942,421.98647794860966,417.7629668215787,105684,146222.66666666666,52.72192525774886,60.05399109349725,NaN,NaN,NaN,NaN,2.0450968864101524,28.60746066446242,105773035,-0.8368357576834975,1.7302463195647988,2.5670820772482963
2025-09-15T12:25:00-04:00,419.01,419.16,417.4,418.51,NaN,NaN,NaN,424.87726199531346,NaN,NaN,412.75979999999873,435.7249758940464,389.7946241059511,417.8352105817102,419.8391799829862,421.93865435049054,417.73970561548185,179786,143950.83333333334,50.72164754943882,58.82183746827282,NaN,NaN,NaN,NaN,2.024732823095145,26.87244445219184,105593249,-0.8805973701927501,1.4663353645073585,2.3469327347001085
2025-09-15T12:30:00-04:00,418.58,420.17,418.53,419.88,NaN,NaN,NaN,424.87726199531346,NaN,NaN,413.2909999999987,435.65377988097094,390.92822011902643,417.8352105817102,419.83586020938736,421.9243993812004,417.74732103757435,82447,138672.06666666668,54.991804825082724,58.21573251832286,NaN,NaN,NaN,NaN,1.998680478588351,25.18616538453947,105675696,-0.7958302701686231,1.35214489698933,2.147975167157953
2025-09-15T12:35:00-04:00,419.83,420.03,418.6,418.99,NaN,NaN,NaN,424.87726199531346,NaN,NaN,413.7967999999987,435.49851179987235,392.0950882001251,417.5287003227318,419.83068494657834,421.9113932161809,417.7499766769758,64368,131332.16666666666,51.84855792308846,57.26583171238378,NaN,NaN,NaN,NaN,1.958060444403465,23.620334821719414,105611328,-0.7773615566600831,1.176273221332849,1.9536347779929322
2025-09-15T12:40:00-04:00,418.96,418.96,417.6,417.66,NaN,NaN,NaN,424.5998425374341,NaN,NaN,414.2477999999987,435.30507704725403,393.1905229527433,417.5287003227318,419.8119835738161,421.88943153566504,417.7345356119672,84175,127777.56666666667,47.48092610048007,56.245127936048924,NaN,NaN,NaN,NaN,1.9174846983746452,22.268151314131526,105527153,-0.8277235557346108,0.9189803333246687,1.7467038890592794
2025-09-15T12:45:00-04:00,417.66,417.83,416.7,417.38,NaN,NaN,NaN,423.45166787664164,NaN,NaN,414.69079999999866,435.04945018720275,394.33214981279457,417.5287003227318,419.7727026910205,421.8572198173134,417.68818556472763,125824,123861.4,46.59110354382773,55.207184068539966,NaN,NaN,NaN,NaN,1.8612357913478843,21.48550670201304,105401329,-0.8496921563496385,0.6845886936222314,1.5342808499718699
2025-09-15T12:50:00-04:00,417.36,417.61,416.62,417.405,NaN,NaN,NaN,423.15545570043065,NaN,NaN,415.1202999999986,434.7714754774399,395.46912452255737,417.5287003227318,419.73721255886693,421.8287739040116,417.64565121372226,112921,120287.93333333333,46.68717239726785,54.12913554594643,NaN,NaN,NaN,NaN,1.7990046633944647,20.800615942661945,105514250,-0.8313116867723624,0.4951412415064169,1.3264529282787794
2025-09-15T12:55:00-04:00,417.39,417.74,415.79,416.38,NaN,NaN,NaN,422.79679862313833,NaN,NaN,415.52629999999857,434.4110467350018,396.64155326499537,417.5287003227318,419.69517244064116,421.80322686855885,417.58711801272347,112005,115599.1,43.25203517369518,52.78877761957726,NaN,NaN,NaN,NaN,1.8097900445805735,20.597227315767945,105402245,-0.8537185557948159,0.2593047335352594,1.1130232893300753
2025-09-15T13:00:00-04:00,416.33,417.19,416,416.78,NaN,NaN,NaN,422.514898685723,NaN,NaN,415.9634999999986,433.90856219005866,398.0184378099385,417.5287003227318,419.6749426933752,421.7904487563336,417.5594366304168,55366,111929.83333333333,44.95416161721188,51.70630164704894,NaN,NaN,NaN,NaN,1.7655193271105323,20.408366447937798,105457611,-0.8076295651514348,0.1034863328907818,0.9111158980422166
2025-09-15T13:05:00-04:00,416.78,417.87,416.78,417.62,NaN,NaN,NaN,422.514898685723,NaN,NaN,416.4368999999986,433.24704014114684,399.6267598588504,416.9729602581855,419.65505543714835,421.77170850939683,417.53840236489987,74105,110929.56666666667,48.450926033036914,51.17527057381024,NaN,NaN,NaN,NaN,1.7172679466026395,19.71644902374421,105531716,-0.6911042344773629,0.04723560494551293,0.7383398394228758
2025-09-15T13:10:00-04:00,417.64,418.07,417.25,418.06,NaN,NaN,NaN,422.514898685723,NaN,NaN,416.92929999999865,432.40551219952937,401.4530878004679,416.1226945652387,419.64472370832084,421.7600215747917,417.52942584184996,46821,108690.3,50.234251047829574,50.81982405689094,NaN,NaN,NaN,NaN,1.6531773789881647,18.923298822288924,105578537,-0.5604911200143519,0.03772593940493607,0.5982170594192879
2025-09-15T13:15:00-04:00,418,418.08,416.6,417.09,NaN,NaN,NaN,422.514898685723,NaN,NaN,417.4234999999986,431.2193263618018,403.62767363819546,416.1226945652387,419.62967179649473,421.7467454065508,417.51259818643865,53515,107441.36666666667,46.42154790532769,50.14518913840135,NaN,NaN,NaN,NaN,1.640807566203293,18.594818155020736,105525022,-0.5166004442309065,-0.04753349586934519,0.46906694836156126
2025-09-15T13:20:00-04:00,417.08,417.97,416.6,417.69,NaN,NaN,NaN,422.514898685723,NaN,NaN,417.9110999999986,429.8636152652101,405.9585847347871,416.0771556521909,419.61551232753646,421.7331448541253,417.4978798009476,54757,103694.13333333333,49.00004729842293,49.397859614536074,NaN,NaN,NaN,NaN,1.6214641686173439,18.289800392557417,105579779,-0.42799536556576906,-0.06592725859565007,0.362068106970119
2025-09-15T13:25:00-04:00,417.72,418.39,417.5,417.55,NaN,NaN,NaN,422.514898685723,NaN,NaN,418.3734999999986,428.2683892366256,408.47861076337165,415.3233729546395,419.60413774317806,421.7198961793825,417.4883793069736,54276,99735.13333333333,48.41456419447587,48.697905061923905,NaN,NaN,NaN,NaN,1.5692167280018183,17.641181927736774,105525503,-0.36225857328535527,-0.09075510963657507,0.2715034636487802
2025-09-15T13:30:00-04:00,417.49,418.19,416.95,417.19,NaN,NaN,NaN,422.514898685723,NaN,NaN,418.7924999999986,426.41662598303105,411.16837401696614,415.3233729546395,419.58506290722823,421.701137217732,417.46898859672444,76589,96681,46.86390800283592,48.27947525800156,NaN,NaN,NaN,NaN,1.5457012474302605,17.423821579624647,105448914,-0.32751543662874055,-0.13789083213714548,0.18962460449159507
2025-09-15T13:35:00-04:00,417.08,417.77,416.51,417.63,NaN,NaN,NaN,422.38943887107774,NaN,NaN,419.22509999999863,423.21596381187425,415.234236188123,415.3233729546395,419.5701605814238,421.68730641483774,417.4530147480099,57037,93722,49.01337421037967,48.157455733783046,NaN,NaN,NaN,NaN,1.5252940154709553,17.518757028281133,105505951,-0.2622192105203313,-0.13814940865881908,0.12406980186151224
2025-09-15T13:40:00-04:00,417.69,417.87,417.34,417.75,NaN,NaN,NaN,422.38943887107774,NaN,NaN,419.0988999999986,422.8628422372149,415.33495776278227,415.3233729546395,419.55989474500444,421.67599335052665,417.44379613948223,47023,90937.06666666667,49.61203536704815,47.773186486780574,NaN,NaN,NaN,NaN,1.4542015857944608,17.50709809744701,105552974,-0.20101983772413196,-0.1272049952936527,0.07381484243047925
2025-09-15T13:45:00-04:00,417.74,418.12,417.3,417.72,NaN,NaN,NaN,422.38943887107774,NaN,NaN,419.07329999999854,422.856944598183,415.28965540181406,415.52126956222037,419.5469758426214,421.6612686050415,417.4326830802013,61860,84897.2,49.45569690815419,47.6022678428567,NaN,NaN,NaN,NaN,1.4089014725234272,17.238861059718023,105491114,-0.15471095016424638,-0.11957384527482873,0.03513710488941765
2025-09-15T13:50:00-04:00,417.64,417.9,416.68,416.93,NaN,NaN,NaN,422.19460212106037,NaN,NaN,419.08089999999856,422.84572015045126,415.3160798495459,415.52126956222037,419.53065089623504,421.64679598833703,417.41450580413306,61146,83425.8,45.39863103625819,47.453532481126565,NaN,NaN,NaN,NaN,1.395408510200323,17.456740919530414,105429968,-0.16831152563276167,-0.17525230215153442,-0.0069407765187727635
2025-09-15T13:55:00-04:00,416.92,417.12,416.23,416.26,NaN,NaN,NaN,421.4780292973758,NaN,NaN,419.07649999999853,422.8539617146091,415.29903828538795,415.52126956222037,419.4929527610491,421.6220680298549,417.36383749224325,113531,83811.76666666666,42.234221931039905,47.142326651641724,NaN,NaN,NaN,NaN,1.3593079023288706,17.97751634736006,105316437,-0.21070749157743357,-0.2703251409905647,-0.05961764941313115
2025-09-15T14:00:00-04:00,416.25,416.48,411.84,413.255,NaN,NaN,NaN,419.377437056586,NaN,NaN,418.95159999999856,423.06300581372307,414.84019418627406,415.52126956222037,419.31092938746497,421.6302377653891,416.99162100954084,301001,90601.03333333334,31.596599516608492,46.064428588737485,NaN,NaN,NaN,NaN,1.5936430521625258,20.450596608019136,105015436,-0.4174633838414788,-0.5814468792149796,-0.16398349537350082
2025-09-15T14:05:00-04:00,413.23,413.73,410.4,410.55,NaN,NaN,NaN,417.49937173583214,NaN,NaN,418.7861999999986,423.5232659954409,414.04913400455627,415.52126956222037,419.1617134931967,421.6934976675955,416.6299293187979,182898,94110.16666666667,25.39577982777108,44.78898177831434,NaN,NaN,NaN,NaN,1.717668548436634,23.138511867448486,104832538,-0.6963016255799968,-1.0343605273484968,-0.3380589017685
2025-09-15T14:10:00-04:00,410.55,412.07,410.38,411.29,NaN,NaN,NaN,416.6428093842034,NaN,NaN,418.6507999999986,423.82957528428614,413.47202471571103,415.52126956222037,419.01522780218744,421.7408990960943,416.28955650828055,179144,97647.66666666667,29.47343611993034,43.68321567136565,NaN,NaN,NaN,NaN,1.7156922235483028,25.639602690835844,105011682,-0.7842636620077243,-1.3183884792781555,-0.5341248172704312
2025-09-15T14:15:00-04:00,411.33,411.84,409.3,409.67,NaN,NaN,NaN,416.08790895764866,NaN,NaN,418.4091999999986,424.0898874095602,412.72851259043694,415.52126956222037,418.85772724132426,421.7984848473124,415.9169696353361,177527,101023.8,26.10904700457317,42.08736716933252,NaN,NaN,NaN,NaN,1.7745713504377072,28.23476948012062,104834155,-0.8967992666171483,-1.6551239005418665,-0.7583246339247183
2025-09-15T14:20:00-04:00,409.69,410.27,408.03,408.055,NaN,NaN,NaN,414.7225494595737,NaN,NaN,418.13149999999854,424.419677240284,411.8433227597131,415.52126956222037,418.7030264273647,421.8731308267997,415.5329220279297,153752,102027.36666666667,23.258668740085483,40.16053986163651,NaN,NaN,NaN,NaN,1.8078162539778717,30.92591913174231,104680403,-1.0164747300921908,-2.0289180465399568,-1.012443316447766
2025-09-15T14:25:00-04:00,408.04,409.15,406.6,406.67,NaN,NaN,NaN,413.5419790295931,NaN,NaN,417.87109999999853,424.91275500187703,410.82944499812004,415.52126956222037,418.54985301378304,421.95706798370657,415.1426380438595,138438,104211.16666666667,21.128374942683138,38.35388465001904,NaN,NaN,NaN,NaN,1.8608293786937349,33.69654682854602,104541965,-1.1173569190328798,-2.409139465238866,-1.291782546205986
2025-09-15T14:30:00-04:00,406.65,407.76,406.58,407.23,NaN,NaN,NaN,412.74029816461154,NaN,NaN,417.6884999999986,425.3257443332083,410.0512556667889,415.52126956222037,418.3903503911968,422.02801401529746,414.7526867670962,144536,104599.9,24.153297702358145,36.579116821728704,NaN,NaN,NaN,NaN,1.8121987087870401,36.27290215401696,104686501,-1.0744993979756094,-2.6349067936754977,-1.5604073956998883
2025-09-15T14:35:00-04:00,407.25,407.79,403.87,404.39,NaN,NaN,NaN,411.6816482480384,NaN,NaN,417.44649999999854,425.9392228263553,408.95377717364175,415.2110156497763,418.11070247555205,422.1748542801091,414.046550670995,225589,109639.23333333334,19.970256518878173,34.547380559186,NaN,NaN,NaN,NaN,1.9627559438736812,39.089989788184354,104460912,-1.1583263289682195,-3.0083153069101627,-1.8499889779419432
2025-09-15T14:40:00-04:00,404.29,406.24,402.43,406.07,NaN,NaN,NaN,410.4402096913094,NaN,NaN,417.25149999999854,426.3133199609819,408.1896800390152,414.52381251982104,417.71109806536305,422.30797127406055,413.11422485666554,328467,117786.93333333333,27.922522710381983,33.194424466867865,NaN,NaN,NaN,NaN,2.094701947882704,41.88136072440978,104789379,-1.0260663735150652,-3.1325719448357745,-2.1065055713207093
2025-09-15T14:45:00-04:00,406.2,407.2,405.34,406.19,NaN,NaN,NaN,410.4402096913094,NaN,NaN,417.0214999999986,426.5963702865928,407.4466297134044,412.0830500158568,417.523151679598,422.3090603967257,412.7372429624703,180751,121177.96666666666,28.469272686583366,31.726988643739556,NaN,NaN,NaN,NaN,2.0779375230339405,43.61161429547884,104970130,-0.8625175720888487,-3.18465253643177,-2.322134964342921
2025-09-15T14:50:00-04:00,406.16,406.84,405.25,406.79,NaN,NaN,NaN,410.4402096913094,NaN,NaN,416.7906999999986,426.7758279433445,406.8055720566527,408.54744001268546,417.4218953301132,422.3030050490803,412.54078561114613,100348,121000.1,31.276323456982936,30.417294935877756,NaN,NaN,NaN,NaN,2.043084842817229,45.23471728643224,105070478,-0.6553326959461634,-3.1413008342756257,-2.4859681383294623
2025-09-15T14:55:00-04:00,406.73,407.5,406.52,407.14,NaN,NaN,NaN,410.4402096913094,NaN,NaN,416.5576999999986,426.88323770246484,406.23216229753234,407.0789520101483,417.3042678552952,422.28028385656546,412.328251854025,127704,119264.03333333334,32.92976532315505,29.236871251234955,NaN,NaN,NaN,NaN,1.9671502111874282,46.137209090314,105198182,-0.44611932728669723,-3.0436172974378337,-2.5974979701511365
2025-09-15T15:00:00-04:00,407.09,407.88,406.61,407.55,NaN,NaN,NaN,410.4402096913094,NaN,NaN,416.2944999999986,426.8515543716026,405.7374456283946,406.5771616081187,417.2142786108587,422.25659409579816,412.1719631259192,102658,119937.73333333334,34.905494320933784,28.487361485854642,NaN,NaN,NaN,NaN,1.917353767531182,46.63027762991573,105300840,-0.24175599329343145,-2.8996929617679257,-2.6579369684744942
2025-09-15T15:05:00-04:00,407.61,409.17,407.58,408.92,NaN,NaN,NaN,410.4402096913094,NaN,NaN,416.0404999999986,426.6835783613088,405.3974216386884,404.9397292864949,417.11003829083353,422.2100801979468,412.00999638372025,138438,122406.73333333334,41.14437809362824,28.409515497468096,NaN,NaN,NaN,NaN,1.8961142127075266,45.988552934879415,105439278,0.010670337345407788,-2.6445990467927345,-2.6552693841381423
2025-09-15T15:10:00-04:00,408.87,409.85,408.58,409.39,NaN,NaN,NaN,410.4402096913094,NaN,NaN,415.7934999999985,426.4692046139947,405.11779538600234,405.52647285056673,417.0278682145991,422.16351729341636,411.89221913578183,121836,123662.1,43.1571760433557,29.235270963664327,NaN,NaN,NaN,NaN,1.851391768942706,44.861573339305615,105561114,0.22252880048677515,-2.3771083835296736,-2.5996371840164487
2025-09-15T15:15:00-04:00,409.41,409.42,407.8,408.16,NaN,NaN,NaN,410.4402096913094,NaN,NaN,415.5708999999985,426.4086142777065,404.73318572229056,405.52647285056673,416.94776279895933,422.12542779143394,411.7700978064847,109664,123123.43333333333,39.36320017749218,30.232943845787258,NaN,NaN,NaN,NaN,1.8348637854467988,44.1269172955635,105451450,0.28885692285435116,-2.23856603044851,-2.527422953302861
2025-09-15T15:20:00-04:00,408.155,408.2,406.81,407.95,NaN,NaN,NaN,410.4402096913094,NaN,NaN,415.30829999999855,426.23525979882413,404.381340201173,405.52647285056673,416.860363589064,422.0911200982585,411.62960707986946,111343,123070.83333333333,38.73706639077109,30.894631722275882,NaN,NaN,NaN,NaN,1.8030878007720266,43.81282507748105,105340107,0.3249280709765694,-2.1212628645821496,-2.446190935558719
2025-09-15T15:25:00-04:00,407.99,408.42,407.44,407.71,NaN,NaN,NaN,410.4402096913094,NaN,NaN,415.0036999999985,425.91179934155366,404.09560065844335,405.52647285056673,416.80514636700246,422.06700225896213,411.5432904750428,73064,121772.8,37.99325995789671,31.743504076084708,NaN,NaN,NaN,NaN,1.7442958150025976,43.33651011074359,105267043,0.33748871791308455,-2.0243300381673635,-2.361818756080448
2025-09-15T15:30:00-04:00,407.72,408.17,406.43,407.25,NaN,NaN,NaN,410.4402096913094,NaN,NaN,414.7222999999985,425.68988062861894,403.75471937137803,405.52647285056673,416.69288680447266,422.0236481150222,411.36212549392314,142136,124665.13333333333,36.5448527037508,32.69251721634651,NaN,NaN,NaN,NaN,1.7439889710738412,43.27048265338037,105124907,0.31984589721762013,-1.9620113845584228,-2.281857281776043
2025-09-15T15:35:00-04:00,407.275,409.11,407.22,409.11,NaN,NaN,NaN,410.4402096913094,NaN,NaN,414.4562999999985,425.30971306894133,403.6028869310557,405.52647285056673,416.61151380255035,421.97781113059284,411.24521647450786,120645,126216.46666666666,45.57905849117327,34.43899461266724,NaN,NaN,NaN,NaN,1.7544183302828515,42.420929389705776,105245552,0.4315249805220689,-1.742451056123457,-2.173976036645526
2025-09-15T15:40:00-04:00,409.08,409.6,408.74,409.1,NaN,NaN,NaN,410.4402096913094,NaN,NaN,414.2142999999985,424.99480629818726,403.43379370180975,405.92284049893897,416.5529288315936,421.93856151267005,411.16729615051713,96319,127866.4,45.541517791542915,35.96672461903758,NaN,NaN,NaN,NaN,1.6905313066912202,41.24086522778242,105149233,0.4980835617261721,-1.5513715844878107,-2.0494551462139827
2025-09-15T15:45:00-04:00,409.08,409.44,408.55,409.21,NaN,NaN,NaN,410.4402096913094,NaN,NaN,413.9790999999985,424.67257103448014,403.2856289655168,406.0532723991512,416.4678526885978,421.88126951285574,411.0544358643399,141076,130785.1,46.06773259313735,37.830830052913235,NaN,NaN,NaN,NaN,1.6333504990704177,40.235651712253045,105290309,0.5393952620026166,-1.375211068710712,-1.9146063307133285
2025-09-15T15:50:00-04:00,409.02,411.23,408.85,411,404.7635178755037,404.7635178755037,404.7635178755037,NaN,NaN,NaN,413.7726999999985,424.28834628756994,403.2570537124271,407.33061791932096,416.32427999720903,421.7531414770857,410.89541851733236,298830,138920.86666666667,53.877765989446196,39.68477600141782,NaN,NaN,NaN,NaN,1.6866826062796731,37.9586574538471,105589139,0.668701363137213,-1.0787296267918123,-1.7474309899290252
2025-09-15T15:55:00-04:00,410.95,410.95,409.155,410.26,404.76426706298076,NaN,NaN,NaN,NaN,NaN,413.54909999999853,423.8768758866616,403.22132411333547,407.33061791932096,416.2050165296972,421.6484862172126,410.7615468421818,249233,145419.43333333332,50.614570162514205,41.26658296398431,NaN,NaN,NaN,NaN,1.6979909915454126,35.84430564247016,105339906,0.6833994153755809,-0.8931817207095492,-1.57658113608513
2025-09-16T09:30:00-04:00,414.47,417,413.18,413.64,409.1230503782998,NaN,NaN,NaN,NaN,NaN,413.4044999999985,423.51846722385426,403.29053277614275,410.39639546836537,414.6066666666668,414.6066666666668,414.6066666666668,420986,156899.33333333334,61.95039997335575,43.45758842943951,NaN,NaN,NaN,NaN,2.0581344921493123,35.527637381205025,105760892,0.8868640361305711,-0.46800109092191633,-1.3548651270524874
2025-09-16T09:35:00-04:00,413.61,414.34,411.5,412.5,409.1230503782998,NaN,NaN,NaN,NaN,NaN,413.26309999999853,423.2248636774365,403.3013363225606,410.39639546836537,413.68851759831927,414.6018382355678,412.7751969610707,425449,169179.73333333334,57.18287172252425,45.1899531722516,NaN,NaN,NaN,NaN,2.11398202842436,34.30527037095687,105335443,0.9075007503979886,-0.2204891890550016,-1.1279899394529902
2025-09-16T09:40:00-04:00,412.52,413.59,411.66,412.87,409.1230503782998,NaN,NaN,NaN,NaN,NaN,413.1332999999985,422.9418641377918,403.32473586220516,410.39639546836537,413.4467632833894,414.34547795683255,412.5480486099462,276490,176828.63333333333,58.30442694932833,46.86130550285121,NaN,NaN,NaN,NaN,2.1008404549654736,33.17021529001216,105611933,0.9067589587676841,0.005458759006614855,-0.9013001997610692
2025-09-16T09:45:00-04:00,412.86,415.64,412.83,413.11,409.1230503782998,NaN,NaN,NaN,NaN,NaN,413.00349999999844,422.63652263079996,403.3704773691969,410.39639546836537,413.526183838721,414.3501797157831,412.7021879616589,267163,183672.06666666668,59.053652359192235,48.14053937896292,NaN,NaN,NaN,NaN,2.1514947081822258,32.83172314648199,105879096,0.8822934363723578,0.20156659570437796,-0.6807268406679798
2025-09-16T09:50:00-04:00,413.2,417.93,412.99,416.55,409.1230503782998,NaN,NaN,NaN,NaN,NaN,412.9154999999985,422.3345558446807,403.4964441553162,410.39639546836537,413.96164528480676,415.12824422931124,412.7950463403023,325151,192472.23333333334,67.94472153385257,49.91107834256986,NaN,NaN,NaN,NaN,2.350673657597781,33.17529347636805,106204247,1.0464464612553288,0.6273312359011811,-0.41911522535414764
2025-09-16T09:55:00-04:00,416.57,417.84,414.85,416.05,409.66606968116173,NaN,NaN,NaN,NaN,NaN,412.8240999999985,422.0285803636725,403.6196196363245,410.39639546836537,414.22762075520916,415.546542833802,412.9086986766163,225954,196219.66666666666,65.711277991823,51.79308390073635,NaN,NaN,NaN,NaN,2.396339824912222,33.49432306840509,105978293,1.0663901060082255,0.9138724071561342,-0.15251769885209127
2025-09-16T10:00:00-04:00,415.99,419.57,415.62,418.98,410.68102105929074,NaN,NaN,NaN,NaN,NaN,412.82169999999854,422.0196938271833,403.6237061728138,411.5071750936592,414.6790213929008,416.428064852954,412.9299779328476,259428,194833.9,71.6022334569567,54.14059583403532,NaN,NaN,NaN,NaN,2.5073155517042056,34.241902328907095,106237721,1.211364694416816,1.3616881691689287,0.15032347475211277
2025-09-16T10:05:00-04:00,419.01,419.4,416.75,416.89,411.1139291929593,NaN,NaN,NaN,NaN,NaN,412.7892999999985,421.9180696895712,403.66053031042577,411.62474007492733,414.8956626831293,416.7507946299028,413.0405307363557,171224,194444.76666666666,63.25414945559823,55.94494508387114,NaN,NaN,NaN,NaN,2.5175072980110467,34.93608307080182,106066497,1.1039808310362678,1.5302995135474475,0.42631868251117977
2025-09-16T10:10:00-04:00,416.79,417,414.36,414.71,411.1139291929593,NaN,NaN,NaN,NaN,NaN,412.6858999999984,421.6057965669765,403.76600343302033,411.62474007492733,414.928096472552,416.7206611237256,413.1355318213784,179499,194456.6,55.92936244653934,57.32955292264175,NaN,NaN,NaN,NaN,2.526256776724542,34.144416328649015,105886998,0.8357930332618256,1.4710599740884618,0.6352669408266362
2025-09-16T10:15:00-04:00,414.74,415.14,413.28,413.945,411.1139291929593,NaN,NaN,NaN,NaN,NaN,412.58499999999844,421.3297883911078,403.8402116088891,411.62474007492733,414.88666272421824,416.64162380491,413.13170164352647,138186,193145.23333333334,53.58440990463477,57.90136373788901,NaN,NaN,NaN,NaN,2.478667006958504,32.84624686160525,105748812,0.5692723451335409,1.3468573722435622,0.7775850271100213
2025-09-16T10:20:00-04:00,413.97,415.3,413.44,415,411.1139291929593,NaN,NaN,NaN,NaN,NaN,412.5317999999984,421.18432165820525,403.8792783417915,411.62474007492733,414.87716621767515,416.60555700350386,413.14877543184645,85949,190885.13333333333,56.30522721607456,58.67020012535555,NaN,NaN,NaN,NaN,2.434476506461469,31.70113872828187,105834761,0.43261868523201186,1.318358383650036,0.8857396984180242
2025-09-16T10:25:00-04:00,415,417.42,414.81,416.19,411.1139291929593,NaN,NaN,NaN,NaN,NaN,412.50799999999845,421.11346663496,403.9025333650369,411.62474007492733,414.93640413733914,416.6447662676431,413.2280420070352,136602,190823.93333333332,59.20972671665867,59.60891399132135,NaN,NaN,NaN,NaN,2.4470138988570795,31.383189441168685,105971363,0.39215613246406966,1.3759348639981113,0.9837787315340416
2025-09-16T10:30:00-04:00,416.12,417.78,416.075,417.73,411.1139291929593,NaN,NaN,NaN,NaN,NaN,412.51449999999846,421.135229725796,403.8937702742009,411.7236708277522,415.007746283059,416.7346967752763,413.28079579084175,94984,189172.2,62.66816187548405,60.236799411752635,NaN,NaN,NaN,NaN,2.394012906081573,31.204486167457183,106066347,0.43554779517860687,1.5282134755073002,1.0926656803286934
2025-09-16T10:35:00-04:00,417.75,418.7,417.03,417.6,411.1139291929593,NaN,NaN,NaN,NaN,NaN,412.5388999999984,421.2100139518232,403.8677860481736,413.01993666220176,415.1044813869492,416.8755433155255,413.33341945837293,108858,185281.16666666666,62.18882297576123,61.06353175555599,NaN,NaN,NaN,NaN,2.3422976985043187,31.333850221187426,105957489,0.4216547928676957,1.619734171413313,1.1980793785456174
2025-09-16T10:40:00-04:00,417.6,418.82,417.2,418.72,411.34008488936985,NaN,NaN,NaN,NaN,NaN,412.57769999999834,421.3412449930734,403.8141550069233,413.4659493297614,415.2095566826162,417.0401016952526,413.37901166997983,107802,177925.66666666666,64.69435103451507,61.259528259924515,NaN,NaN,NaN,NaN,2.29070500575401,31.492726869189863,106065291,0.4513962096525208,1.7623246406112685,1.3109284309587477
2025-09-16T10:45:00-04:00,418.74,421.08,417.76,420.98,412.60053557621666,NaN,NaN,NaN,NaN,NaN,412.6448999999983,421.61125745248023,403.6785425475164,415.1367594638091,415.57846896625244,417.74609248789454,413.41084544461035,272673,180989.73333333334,69.13834433136167,62.11349058912718,NaN,NaN,NaN,NaN,2.3642260767715806,32.30987550742435,106337964,0.5786510542565044,2.0342422487793783,1.4555911945228739
2025-09-16T10:50:00-04:00,420.99,421.13,419.69,419.855,413.7041475954795,NaN,NaN,NaN,NaN,NaN,412.6807999999983,421.7474084863988,403.61419151359786,415.6554075710473,415.7479488313946,418.04707540622906,413.4488222565601,132357,182056.7,64.76797366137133,62.575172497130254,NaN,NaN,NaN,NaN,2.298209928430753,33.0823135949864,106205607,0.5430128622111117,2.1343572722867634,1.5913444100756517
2025-09-16T10:55:00-04:00,419.93,420.17,418.08,418.49,413.7041475954795,NaN,NaN,NaN,NaN,NaN,412.70879999999835,421.8381326287091,403.5794673712876,415.6554075710473,415.84625167420563,418.17505535848983,413.51744798992144,116305,181676.73333333334,59.82648716273035,62.63037498309726,NaN,NaN,NaN,NaN,2.2833377906857018,32.7354517944568,106089302,0.3905908080033762,2.079582920079872,1.688992112076496
2025-09-16T11:00:00-04:00,418.51,418.53,416.83,417.28,413.7041475954795,NaN,NaN,NaN,NaN,NaN,412.7005999999983,421.8127417112472,403.5884582887494,415.6554075710473,415.89373528456485,418.20682172477433,413.5806488443554,107584,181840.93333333332,55.764901259339624,61.76038782063205,NaN,NaN,NaN,NaN,2.2416708056367223,31.68006190141086,105981718,0.18196260985065082,1.9164453743898093,1.7344827645391585
2025-09-16T11:05:00-04:00,417.35,417.84,416.57,416.84,413.7041475954795,NaN,NaN,NaN,NaN,NaN,412.68639999999834,421.7704385383119,403.6023614616848,415.6554075710473,415.91682478081674,418.2132252297338,413.6204243318997,76258,179768.26666666666,54.320726665479974,60.946777011607544,NaN,NaN,NaN,NaN,2.172265748091241,30.55161044973414,105905460,-0.0022330039993843087,1.7316915095399281,1.7339245135393124
2025-09-16T11:10:00-04:00,416.86,419.65,416.75,419.63,413.7041475954795,NaN,NaN,NaN,NaN,NaN,412.7351999999984,421.94088975392896,403.5295102460678,415.6554075710473,416.00131528826154,418.311738174357,413.69089240216607,124079,179843.03333333333,61.18499993179906,60.20268890266771,NaN,NaN,NaN,NaN,2.2242467660847223,30.204792571116997,106029539,0.04467723469933427,1.7897710569134802,1.7450938222141459
2025-09-16T11:15:00-04:00,419.59,420.84,419.11,419.91,413.7041475954795,NaN,NaN,NaN,NaN,NaN,412.78079999999835,422.10484962693965,403.45675037305705,415.7514535528808,416.1474314304047,418.53422765304634,413.7606352077631,155602,181374.3,61.8053213123493,60.09920117814993,NaN,NaN,NaN,NaN,2.1889434256500966,30.287732420234597,106185141,0.07369686764567307,1.837214906771237,1.763518039125564
2025-09-16T11:20:00-04:00,419.96,420.97,419.38,419.48,413.7311045075127,NaN,NaN,NaN,NaN,NaN,412.81539999999836,422.2253957154875,403.40540428450925,416.1041628423047,416.2728532344973,418.71599147981397,413.8297149891806,143809,182456.5,60.21381483943368,60.405233491928094,NaN,NaN,NaN,NaN,2.1461617523893777,30.408366128775853,106041332,0.04450324701408048,1.8191470978931648,1.7746438508790843
2025-09-16T11:25:00-04:00,419.52,420.44,418.56,418.6,413.7311045075127,NaN,NaN,NaN,NaN,NaN,412.8329999999984,422.2828306865994,403.38316931339733,416.1041628423047,416.3316413818366,418.78473564383484,413.8785471198384,89204,182994.5,56.980079368069596,60.64778131074487,NaN,NaN,NaN,NaN,2.127150198647279,29.983111055006113,105952128,-0.04846631596832118,1.7140609559186828,1.762527271887004
2025-09-16T11:30:00-04:00,418.61,419.1,417.85,418.35,413.7311045075127,NaN,NaN,NaN,NaN,NaN,412.8613999999984,422.3686721726726,403.35412782732425,416.1041628423047,416.36663833582514,418.81404398804943,413.91923268360085,75213,180763.73333333334,56.05900279660464,60.63019385221131,NaN,NaN,NaN,NaN,2.064496613029616,29.139640535783055,105876915,-0.13622019321147283,1.5922520303726628,1.7284722235841357
2025-09-16T11:35:00-04:00,418.39,419.13,417.96,419.13,413.7311045075127,NaN,NaN,NaN,NaN,NaN,412.9187999999984,422.54141057329826,403.2961894266985,416.1041628423047,416.4024386418621,418.84848207368003,413.95639521004415,69176,179048.1,58.322666407168,60.56683240153341,NaN,NaN,NaN,NaN,2.000603997813216,28.369807855153045,105946091,-0.15006210931940234,1.5408945869348827,1.690956696254285
2025-09-16T11:40:00-04:00,419.17,419.36,417.46,417.82,413.7311045075127,NaN,NaN,NaN,NaN,NaN,413.0100999999984,422.72987314372506,403.2903268562717,416.1041628423047,416.4283674386218,418.86634666566715,413.9903882115765,66617,178058.03333333333,53.35158700958739,59.901362768255076,NaN,NaN,NaN,NaN,1.993417997969417,27.321048812102312,105879474,-0.24988871946263402,1.3785957969259925,1.6284845163886266
2025-09-16T11:45:00-04:00,417.83,418.43,417.07,418.15,413.7311045075127,NaN,NaN,NaN,NaN,NaN,413.1620999999984,422.9606148040632,403.36358519593364,416.1041628423047,416.448125825709,418.8753432189874,414.0209084324306,64052,175490.56666666668,54.40585194331944,59.345436265937806,NaN,NaN,NaN,NaN,1.9481738552573167,26.086442190056612,105943526,-0.293145278567569,1.2620529181791653,1.5551981967467343
2025-09-16T11:50:00-04:00,418.07,418.9,417.63,418.81,413.7311045075127,NaN,NaN,NaN,NaN,NaN,413.3124999999984,423.22168427548075,403.40331572451606,416.1041628423047,416.470714993825,418.8934056595235,414.04802432812653,53921,167326.93333333332,56.52223733298974,58.761713858685994,NaN,NaN,NaN,NaN,1.8997328655960786,25.197108419674187,105997447,-0.27694927887249965,1.2090115981561098,1.4859608770286095
2025-09-16T11:55:00-04:00,418.76,419.63,418.39,419.63,413.7311045075127,NaN,NaN,NaN,NaN,NaN,413.51169999999837,423.5199291363485,403.50347086364826,416.1041628423047,416.5121793677279,418.9397173105334,414.08464142492244,73141,161457.2,59.064609842097376,58.04216139516711,NaN,NaN,NaN,NaN,1.8526090894820737,24.758222349968282,106070588,-0.21349653853725892,1.2190902038570357,1.4325867423942946
2025-09-16T12:00:00-04:00,419.59,420.62,418.17,418.42,413.7311045075127,NaN,NaN,NaN,NaN,NaN,413.71899999999835,423.6958744607557,403.742125539241,416.38630290184517,416.57820600590406,419.0082979904051,414.14811402140305,128347,151702.56666666668,54.04273888774264,57.27607319705078,NaN,NaN,NaN,NaN,1.8952798688047818,24.835890729811585,105942241,-0.25281374193561024,1.1165695649747818,1.369383306910392
2025-09-16T12:05:00-04:00,418.32,420.2,418.1,419.98,413.7311045075127,NaN,NaN,NaN,NaN,NaN,413.9851999999984,423.9056592557852,404.0647407442115,416.38630290184517,416.6186350494123,419.05483223982515,414.1824378589995,71586,139907.13333333333,58.89512601152392,57.20954740053603,NaN,NaN,NaN,NaN,1.9099027353187237,24.850936816308685,106013827,-0.1771329398790491,1.1479671320615807,1.3251000719406298
2025-09-16T12:10:00-04:00,419.99,420.25,419.08,419.85,413.84572058750587,NaN,NaN,NaN,NaN,NaN,414.23759999999834,424.0997367342851,404.3754632657116,416.38630290184517,416.6548670236757,419.0996913546591,414.2100426926923,59490,132673.8,58.34230023023481,57.393647327028546,NaN,NaN,NaN,NaN,1.857052539938816,24.890929956575878,105954337,-0.1407890586368279,1.149113748644595,1.289902807281423
2025-09-16T12:15:00-04:00,419.82,420.55,419.44,420.48,414.2888696517102,NaN,NaN,NaN,NaN,NaN,414.5593999999983,424.1618427395393,404.9569572604573,416.68734708574476,416.70290968778943,419.16483788292743,414.24098149265143,70986,126134.56666666667,60.2877298666124,57.819861841395145,NaN,NaN,NaN,NaN,1.8036916442289017,25.090294996380415,106025323,-0.08218369234365452,1.1871731918518549,1.2693568841955094
2025-09-16T12:20:00-04:00,420.45,420.48,419.67,419.89,414.5177846675416,NaN,NaN,NaN,NaN,NaN,414.83579999999824,424.23840333344,405.4331966665565,416.9848776685958,416.7308393948686,419.2009877162413,414.26069107349593,44025,116763.7,57.57593170488364,57.56207125375833,NaN,NaN,NaN,NaN,1.7327136696411232,25.27541967619891,105981298,-0.09036768523768002,1.1563972776484093,1.2467649628860893
2025-09-16T12:25:00-04:00,419.85,420.4,419.77,420.18,414.6944762735624,NaN,NaN,NaN,NaN,NaN,415.1155999999983,424.30258245159513,405.9286175484015,417.2889021348766,416.7622560379787,419.2422562010215,414.2822558749359,48872,110860.96666666666,58.5625565638285,57.33044520029256,NaN,NaN,NaN,NaN,1.6539484075239,25.447321164601806,106030170,-0.08361942572075765,1.1422406807351422,1.2258601064558998
2025-09-16T12:30:00-04:00,420.16,421.66,420.09,421.02,415.5154091702186,NaN,NaN,NaN,NaN,NaN,415.4001999999983,424.41798042791635,406.3824195720802,418.3861217079013,416.85985321692465,419.39021458792126,414.32949184592803,126504,106430.16666666667,61.36529947131458,57.41269410256977,NaN,NaN,NaN,NaN,1.6479520927007678,26.31839446136951,106156674,-0.03257537390785692,1.1851408890710786,1.2177162629789355
2025-09-16T12:35:00-04:00,421.04,422.12,420.44,422.02,415.9349360261178,NaN,NaN,NaN,NaN,NaN,415.6977999999983,424.5867464305893,406.80885356940735,418.660897366321,416.95158430011617,419.5393543097088,414.3638142905235,108141,104327.4,64.44818555408737,57.94613025871389,NaN,NaN,NaN,NaN,1.6502412289364279,27.35604919003692,106264815,0.05384168089902075,1.2850183641027115,1.2311766832036908
2025-09-16T12:40:00-04:00,422.05,422.06,420.26,420.53,415.9349360261178,NaN,NaN,NaN,NaN,NaN,415.9573999999983,424.63500802099173,407.27979197900487,418.660897366321,417.0124003500614,419.6266245279973,414.3981761721255,84973,101176.53333333334,57.132812436305045,58.02283094726392,NaN,NaN,NaN,NaN,1.660938284012398,28.106423729917452,106179842,-0.001128975104590868,1.229765464322952,1.230894439427543
2025-09-16T12:45:00-04:00,420.6,420.98,419.34,419.55,415.9349360261178,NaN,NaN,NaN,NaN,NaN,416.16999999999825,424.66650681199786,407.67349318799864,418.660897366321,417.05418383340424,419.6730494212207,414.4353182455878,80424,99251.13333333333,52.881218930512475,57.63415612750281,NaN,NaN,NaN,NaN,1.6594426922972298,27.774707175627032,106099418,-0.10928747477707823,1.0942850959561952,1.2035725707332734
2025-09-16T12:50:00-04:00,419.66,419.79,418.62,418.82,415.9349360261178,NaN,NaN,NaN,NaN,NaN,416.35859999999826,424.661170455356,408.0560295446405,418.660897366321,417.07521386038167,419.688493885301,414.46193383546233,59546,98371.03333333334,49.902238650382664,57.38777410184533,NaN,NaN,NaN,NaN,1.624482499990286,26.753202223505205,106039872,-0.22890973294914962,0.9174354045468363,1.1463451374959859
2025-09-16T12:55:00-04:00,418.78,419.12,418.1,418.74,415.9349360261178,NaN,NaN,NaN,NaN,NaN,416.5701999999983,424.5595616670044,408.5808383329922,418.660897366321,417.0894652274165,419.69519884280066,414.48373161203233,52186,95557.16666666667,49.57265914546011,57.042546044855385,NaN,NaN,NaN,NaN,1.5813051785624073,25.324822452630002,105987686,-0.30744324335251005,0.7620410833053484,1.0694843266578584
2025-09-16T13:00:00-04:00,418.68,420.08,418.52,420.08,415.9349360261178,NaN,NaN,NaN,NaN,NaN,416.8127999999982,424.4701721763099,409.1554278236865,418.660897366321,417.1250453048945,419.7286385365229,414.5214520732661,84441,95205.73333333334,54.940791572903656,56.92958563342065,NaN,NaN,NaN,NaN,1.579783380093664,24.699843047314925,106072127,-0.26478445832790465,0.7385037537479775,1.0032882120758821
2025-09-16T13:05:00-04:00,420.05,420.26,419.65,420.13,415.9349360261178,NaN,NaN,NaN,NaN,NaN,417.0611999999983,424.3165405327511,409.80585946724545,418.660897366321,417.1494646234859,419.75548079068983,414.543448456282,49994,93243.6,55.13271889138923,56.64873627979865,NaN,NaN,NaN,NaN,1.5105131386584034,24.243576347264113,106122121,-0.23012222339914,0.7156354328269572,0.9457576562260972
2025-09-16T13:10:00-04:00,420.155,420.76,419.74,419.74,415.9349360261178,NaN,NaN,NaN,NaN,NaN,417.3109999999982,424.0388281790195,410.58317182097693,418.660897366321,417.1841289951862,419.7939894212272,414.5742685691452,70783,92009.63333333333,53.22824649212433,56.5905582515402,NaN,NaN,NaN,NaN,1.4754764858970877,24.162016948400332,106051338,-0.22984439976677695,0.658452156517626,0.888296556284403
2025-09-16T13:15:00-04:00,419.72,419.74,418.8,418.97,415.9349360261178,NaN,NaN,NaN,NaN,NaN,417.5081999999982,423.82862649243896,411.1877735075575,418.660897366321,417.20082841308874,419.8060112965155,414.59564552966197,50747,84612.1,49.58626705710789,55.925639754796194,NaN,NaN,NaN,NaN,1.437228165475867,23.153230965090277,106000591,-0.27485947334304295,0.5447222146055992,0.8195816879486422
2025-09-16T13:20:00-04:00,418.99,419.14,418.47,418.59,415.9349360261178,NaN,NaN,NaN,NaN,NaN,417.6979999999983,423.5496230232582,411.8463769767383,418.660897366321,417.21558647650807,419.81251121203337,414.61866174098276,58680,82156.2,47.84637647326758,55.17593091501283,NaN,NaN,NaN,NaN,1.382426153656159,21.913337873922963,105941911,-0.32038814365278134,0.41909650838266543,0.7394846520354468
2025-09-16T13:25:00-04:00,418.63,419.22,418.39,418.77,415.9349360261178,NaN,NaN,NaN,NaN,NaN,417.8891999999983,423.220569940857,412.55783005913963,418.39271789305684,417.2273363860306,419.8181265877595,414.63654618430166,45720,79803.36666666667,48.76347040654617,54.3527695250081,NaN,NaN,NaN,NaN,1.3429671426807221,20.762008574981884,105987631,-0.32738391718966375,0.33025475554836703,0.6576386727380308
2025-09-16T13:30:00-04:00,418.8,419.48,418.25,418.54,415.9349360261178,NaN,NaN,NaN,NaN,NaN,418.0399999999983,422.99676709218903,413.0832329078076,417.77601039935746,417.24388537034287,419.8254732089995,414.66229753168625,67159,78455.86666666667,47.611396689571606,53.64101702391438,NaN,NaN,NaN,NaN,1.3348980610606718,19.921999142114892,105920472,-0.33528035552182,0.23853822833575578,0.5738185838575758
2025-09-16T13:35:00-04:00,418.6,418.98,418.02,418.3,415.9349360261178,NaN,NaN,NaN,NaN,NaN,418.20079999999837,422.6312908809254,413.7703091190713,417.77601039935746,417.25414940349896,419.8269277749241,414.6813710320738,54022,77714.66666666667,46.38003724710835,52.770837072720084,NaN,NaN,NaN,NaN,1.3081196281277694,18.89740682181956,105866450,-0.34320137364092246,0.1448168668064227,0.48801824044734515
2025-09-16T13:40:00-04:00,418.22,419.06,417.85,418.75,415.9349360261178,NaN,NaN,NaN,NaN,NaN,418.30299999999835,422.5394522900688,414.0665477099279,417.77601039935746,417.2702360233144,419.8310698368875,414.7094022097413,78488,76194.96666666666,49.04124446238303,51.890547429224966,NaN,NaN,NaN,NaN,1.3011110832614985,17.762030393988937,105944938,-0.30590615164843427,0.10563555088680232,0.4115417025352366
2025-09-16T13:45:00-04:00,418.7,419.03,417.7,417.79,415.9349360261178,NaN,NaN,NaN,NaN,NaN,418.4087999999984,422.31134048612944,414.50625951386735,417.77601039935746,417.27727505449127,419.8293454011508,414.7252047078317,49795,72668.06666666667,44.02171980293073,50.4315141612852,NaN,NaN,NaN,NaN,1.3031745773142476,16.541068269012328,105895143,-0.3315110274873218,-0.002847081823915687,0.3286639456634061
2025-09-16T13:50:00-04:00,417.73,418.33,417.5,418.09,415.9349360261178,NaN,NaN,NaN,NaN,NaN,418.51319999999833,422.0825264134951,414.9438735865016,417.77601039935746,417.282113337498,419.8259559505922,414.73827072440383,44718,69365.03333333334,45.88572724216898,49.62815093313263,NaN,NaN,NaN,NaN,1.2693763932203717,15.538357898771654,105939861,-0.31403237906827014,-0.06387652817193157,0.25015585089633857
2025-09-16T13:55:00-04:00,418.12,418.27,417.6,417.92,415.9349360261178,NaN,NaN,NaN,NaN,NaN,418.60939999999835,421.83362991829426,415.3851700817024,417.77601039935746,417.2871289234961,419.8217420315649,414.7525158154273,50192,68064.63333333333,44.971863754524065,49.0631969919906,NaN,NaN,NaN,NaN,1.2265637937046279,14.607269697833885,105889669,-0.2997446306232895,-0.12452493738277326,0.1752196932405162
2025-09-16T14:00:00-04:00,417.94,418.68,417.75,418.6,415.9349360261178,NaN,NaN,NaN,NaN,NaN,418.6503999999984,421.82051850978263,415.48028149021417,416.882808319486,417.2966707987893,419.821787266466,414.7715543311126,59107,67527.76666666666,49.319832586761216,49.02159655887478,NaN,NaN,NaN,NaN,1.2053806655828692,13.895318967859465,105948776,-0.23327767095664337,-0.11637739545528802,0.11690027550135534
2025-09-16T14:05:00-04:00,418.61,419.08,418.2,418.92,415.9349360261178,NaN,NaN,NaN,NaN,NaN,418.7077999999984,421.7902212311133,415.6253787688834,416.8557178595768,417.30578075395636,419.8254605354446,414.7861009724681,41752,66613.63333333333,51.27108783227139,49.14291289364702,NaN,NaN,NaN,NaN,1.1821391894698066,13.698908742100649,105990528,-0.16003277240771827,-0.0831406900082925,0.07689208239942577
2025-09-16T14:10:00-04:00,418.95,419.25,418.7,419.02,415.9349360261178,NaN,NaN,NaN,NaN,NaN,418.7085999999984,421.7913241469101,415.6258758530867,417.0664469008518,417.3288667032059,419.83886887165926,414.81886453475255,91508,67443.33333333333,51.89440110332359,48.925313574391296,NaN,NaN,NaN,NaN,1.1369863902219641,13.708701286328715,106082036,-0.10005435067161048,-0.04817585594008733,0.051878494731523145
2025-09-16T14:15:00-04:00,419.02,419.77,419,419.69,415.9349360261178,NaN,NaN,NaN,NaN,NaN,418.7645999999984,421.8147002223046,415.71449977769214,417.63815752068143,417.3429369821862,419.8507633083193,414.8351106560531,43817,66768.83333333333,55.95915954535393,48.984345049674495,NaN,NaN,NaN,NaN,1.1107730766346797,14.275992243907416,106125853,-0.014931155084250823,0.033214550876209614,0.04814570596046044
2025-09-16T14:20:00-04:00,419.74,419.77,419.16,419.4,415.9349360261178,NaN,NaN,NaN,NaN,NaN,418.85839999999837,421.6841802048504,416.03261979514633,417.7595260165452,417.3525007631582,419.8586037990021,414.84639772731435,30737,65996.03333333334,53.8386456586384,49.02794499013977,NaN,NaN,NaN,NaN,1.075003571160771,14.802762418801924,106095116,0.020259072903483305,0.07346954708981457,0.053210474186331264
2025-09-16T14:25:00-04:00,419.385,420.14,418.8,418.87,415.9349360261178,NaN,NaN,NaN,NaN,NaN,418.9568999999984,421.40943248007767,416.5043675199192,417.86162081323613,417.3704403991874,419.8716142396486,414.86926655872617,63752,65683.06666666667,50.101954847736764,49.06477983232755,NaN,NaN,NaN,NaN,1.0939318875064286,15.681596179113935,106031364,0.006945140420542215,0.061891899712009035,0.05494675929146682
2025-09-16T14:30:00-04:00,418.9,419.01,418.41,418.78,415.9349360261178,NaN,NaN,NaN,NaN,NaN,419.0324999999984,421.2101117666101,416.85488823338665,417.86162081323613,417.37902925511025,419.8746410927268,414.8834174174937,43215,62845.333333333336,49.474010040114706,49.181039372816635,NaN,NaN,NaN,NaN,1.0586510383988241,15.832595570152645,105988149,-0.008008379122803846,0.044936285387962016,0.05294466451076586
2025-09-16T14:35:00-04:00,418.84,418.97,418.39,418.87,415.9349360261178,NaN,NaN,NaN,NaN,NaN,419.08609999999834,421.1075423479887,417.06465765200795,417.86162081323613,417.38506768769247,419.8767969387562,414.89333843662877,30486,61475.333333333336,50.1468993985978,49.27985572939175,NaN,NaN,NaN,NaN,1.0244616785131968,15.938907757312059,106018635,-0.011700239664450343,0.03831936493020294,0.05001960459465328
2025-09-16T14:40:00-04:00,418.89,419.29,418.68,418.99,415.9349360261178,NaN,NaN,NaN,NaN,NaN,419.1112999999984,421.09556491329647,417.1270350867003,417.86162081323613,417.39376815510605,419.8815072147547,414.90602909545737,37622,60746.4,51.082343607708324,49.52778050925866,NaN,NaN,NaN,NaN,0.9948572729051123,16.421015155588993,106056257,-0.006198779960880793,0.042271129643552285,0.04846990960443308
2025-09-16T14:45:00-04:00,419,419.43,418.66,419.02,415.9349360261178,NaN,NaN,NaN,NaN,NaN,419.1396999999984,421.07671462201984,417.202685377977,417.86162081323613,417.4028925263921,419.88671639765835,414.9190686551259,38678,59669.46666666667,51.328226086996594,49.881222569250674,NaN,NaN,NaN,NaN,0.9787960391261744,17.032581770357222,106094935,-0.0009529823103190532,0.047278681716534265,0.04823166402685332
2025-09-16T14:50:00-04:00,419.07,419.85,419.05,419.7,416.00910869200754,NaN,NaN,NaN,NaN,NaN,419.1592999999984,421.09876179286294,417.2198382071338,417.91386070808124,417.42257076558246,419.90328284124683,414.9418586899181,64926,60366.166666666664,56.647457180744034,50.42452347770503,NaN,NaN,NaN,NaN,0.9681677506171649,18.069303031030763,106159861,0.04534123145812509,0.10490820334950968,0.05956697189138459
2025-09-16T14:55:00-04:00,419.73,420.25,419.47,420.12,416.46914920600716,NaN,NaN,NaN,NaN,NaN,419.1420999999984,421.03127134374057,417.2529286562562,418.31108856646495,417.4424410172381,419.9234180130486,414.96146402142756,55774,60596.23333333333,59.585347597334334,51.53621117730529,NaN,NaN,NaN,NaN,0.9547271970016512,19.43462470527567,106215635,0.09824104359541998,0.18236827638565956,0.08412723279023958
2025-09-16T15:00:00-04:00,420.14,420.42,419.46,419.96,416.5723696966432,NaN,NaN,NaN,NaN,NaN,419.14419999999836,421.0367668934262,417.2516331065705,418.38887085317197,417.4600333404203,419.94111204988536,414.97895463095523,50124,58050.23333333333,57.9735652256468,52.399628176125134,NaN,NaN,NaN,NaN,0.9551038257872502,20.865395207079015,106165511,0.11526986502882261,0.22821456407626783,0.11294469904744522
2025-09-16T15:05:00-04:00,419.95,420.52,419.72,419.8,416.7963528922503,NaN,NaN,NaN,NaN,NaN,419.1703999999984,421.0622856641043,417.27851433589245,418.49509668253756,417.47744152629815,419.9589586910575,414.9959243615388,48980,56078.2,56.33255584518771,53.21110618260111,NaN,NaN,NaN,NaN,0.9440249810881577,22.291220277493085,106116531,0.10866004212815683,0.24876975170764126,0.14010970957948443
2025-09-16T15:10:00-04:00,419.86,420.3,419.51,420.22,416.7963528922503,NaN,NaN,NaN,NaN,NaN,419.2291999999984,421.0643145593593,417.3940854406375,418.49509668253756,417.50266076221044,419.9845632445858,415.0207582798351,72258,55654.36666666667,59.567905927644034,53.94311142123559,NaN,NaN,NaN,NaN,0.9330231967247193,23.128301188058035,106188789,0.12434705955277492,0.2955435340204531,0.17119647446767816
2025-09-16T15:15:00-04:00,420.23,420.95,420,420.46,417.2142595567818,NaN,NaN,NaN,NaN,NaN,419.3015999999984,421.0368826184454,417.5663173815514,418.863061876824,417.5304003745749,420.0171249636517,415.0436757854981,68474,55256.03333333333,61.33099067226249,54.661675909806384,NaN,NaN,NaN,NaN,0.9342358255300958,24.56044719134734,106257263,0.14141637356799458,0.3479669414276714,0.2065505678596768
2025-09-16T15:20:00-04:00,420.47,420.67,420.13,420.25,417.2142595567818,NaN,NaN,NaN,NaN,NaN,419.31399999999843,421.0672598227094,417.56074017728747,418.863061876824,417.54718874617697,420.0359704633487,415.05840702900525,43874,54733.63333333333,58.91034482913258,55.162814747364166,NaN,NaN,NaN,NaN,0.906076123706519,25.890297051544554,106213389,0.12941701742137385,0.3683218396363941,0.23890482221502024
2025-09-16T15:25:00-04:00,420.24,420.83,419.71,420.56,417.2142595567818,NaN,NaN,NaN,NaN,NaN,419.32699999999846,421.10717639741307,417.54682360258386,418.863061876824,417.57068621368495,420.06229451911025,415.07907790825965,61926,55058.3,61.33629473097414,55.54689583205133,NaN,NaN,NaN,NaN,0.9213564005846252,26.160796662398095,106275315,0.13271722567243321,0.40480135430556174,0.27208412863312853
2025-09-16T15:30:00-04:00,420.56,422.56,420.49,422.31,418.19384886883506,NaN,NaN,NaN,NaN,NaN,419.3835999999984,421.3498665551658,417.417333444831,419.8356876809339,417.67595422505264,420.2226833643963,415.129225085709,190283,58586.36666666667,71.54843081741757,56.811880486249834,NaN,NaN,NaN,NaN,1.0034023719714373,27.89338736250263,106465598,0.23702884861041584,0.5683701893961484,0.3313413407857325
2025-09-16T15:35:00-04:00,422.35,423.24,421.87,422.81,419.1884466475244,NaN,NaN,NaN,NaN,NaN,419.4677999999985,421.64218281950554,417.2934171804914,420.37555014474714,417.79908681556606,420.4298705832168,415.1683030479153,193842,63381.3,73.68689444979968,58.49651902925433,NaN,NaN,NaN,NaN,1.0295879168306208,29.895290888413268,106659440,0.31887196525259015,0.7299312973514702,0.41105933209888007
2025-09-16T15:40:00-04:00,422.81,423.17,422.25,422.31,419.3710172544552,NaN,NaN,NaN,NaN,NaN,419.54699999999843,421.83810017369404,417.2558998263028,420.4184401157977,417.8601244070772,420.5285486111044,415.19170020305,101131,64392.9,68.16907213663163,59.83188060757697,NaN,NaN,NaN,NaN,1.0217602084855775,31.75420130533028,106558309,0.31779746849452384,0.8083061677170349,0.49050869922251106
2025-09-16T15:45:00-04:00,422.29,422.9,421.88,422.45,419.3710172544552,NaN,NaN,NaN,NaN,NaN,419.6133999999984,422.04070009804934,417.1860999019475,420.4184401157977,417.9320544878991,420.63945493980617,415.22465403599205,127153,66939.76666666666,68.87193768980792,61.16938334266341,NaN,NaN,NaN,NaN,1.021634479308035,32.75137483653011,106685462,0.30492712506261777,0.8716676055507833,0.5667404804881655
2025-09-16T15:50:00-04:00,422.52,423.03,420.91,421.65,419.3710172544552,NaN,NaN,NaN,NaN,NaN,419.6899999999984,422.1277924452294,417.25220755476744,420.4184401157977,418.0114591985679,420.7478475280799,415.27507086905587,165802,70510.5,60.632875837454215,61.85156421621668,NaN,NaN,NaN,NaN,1.1000891593574573,32.05395705233119,106519660,0.22465446354205942,0.8475585599157398,0.6229040963736804
2025-09-16T15:55:00-04:00,421.83,421.88,421.16,421.65,419.3710172544552,NaN,NaN,NaN,NaN,NaN,419.7599999999984,422.21781040888334,417.30218959111346,420.4184401157977,418.08873066521585,420.8443449793968,415.3331163510349,182554,75071.63333333333,60.632875837454215,62.51618205553508,NaN,NaN,NaN,NaN,1.0729399336890653,31.406354824146476,106519660,0.15688545849331514,0.8190109194903243,0.6621254609970092
2025-09-17T09:30:00-04:00,415.78,417.2,413.13,413.94,NaN,NaN,NaN,419.5769647024465,419.5769647024465,419.5769647024465,419.6625999999984,422.6020688237704,416.7231311762264,420.4184401157977,414.75666666666666,414.75666666666666,414.75666666666666,288489,82449.3,25.94345559862552,60.32303908538376,NaN,NaN,NaN,NaN,1.6048727955684166,32.78839248973892,106231171,-0.39188569541602625,0.17226834172697636,0.5641540371430026
2025-09-17T09:35:00-04:00,413.9,414.39,410.2,410.65,NaN,NaN,NaN,417.0777844886989,NaN,NaN,419.4829999999984,423.3572126949767,415.60878730502014,420.4184401157977,413.19530084791944,414.69924496074185,411.69135673509703,310939,91013.2,20.542521997699723,57.534265828267,NaN,NaN,NaN,NaN,1.789524738742101,34.74244185646235,105920232,-0.9304049261375928,-0.5988521205289885,0.33155280560860434
2025-09-17T09:40:00-04:00,410.62,413.67,409.67,412.85,NaN,NaN,NaN,416.78083973921264,NaN,NaN,419.3715999999984,423.6598655894917,415.08333441050513,420.4184401157977,412.8361843179822,414.185932643244,411.48643599272043,278533,97681.36666666667,30.90158692912655,55.60055309280127,NaN,NaN,NaN,NaN,1.9474158288319507,36.65887370241022,106198765,-1.081788826695295,-1.0206832277605145,0.06110559893478057
2025-09-17T09:45:00-04:00,412.83,415.2,412.09,414.9,NaN,NaN,NaN,416.78083973921264,NaN,NaN,419.2699999999984,423.73295149044674,414.80704850955004,420.4184401157977,413.0454623279636,414.35852944723365,411.73239520869356,180512,102038.6,38.89575093358464,54.355067027686765,NaN,NaN,NaN,NaN,2.030457555343955,37.28215544339047,106379277,-0.9896950421599798,-1.1760132037651942,-0.18631816160521442
2025-09-17T09:50:00-04:00,414.93,415.8,414.28,414.29,NaN,NaN,NaN,416.78083973921264,NaN,NaN,419.15879999999845,423.8305870505612,414.4870129494357,420.4184401157977,413.2409257944977,414.5950875415096,411.88676404748577,133559,104999.96666666666,37.50529193200366,52.779166027998166,NaN,NaN,NaN,NaN,1.993996301390818,37.43936152710311,106245718,-0.9173211404771565,-1.33296958720166,-0.4156484467245035
2025-09-17T09:55:00-04:00,414.27,416.3,414.27,416.19,NaN,NaN,NaN,416.78083973921264,NaN,NaN,419.07299999999844,423.8018057695256,414.3441942304713,420.4184401157977,413.49080331736565,414.9612197559868,412.0203868787445,142119,108064.2,44.19679415063554,51.55529484788195,NaN,NaN,NaN,NaN,1.9965679941486187,37.235135234077475,106387837,-0.6988281422306956,-1.289183624512873,-0.5903554822821774
2025-09-17T10:00:00-04:00,416.18,416.43,414.87,415.92,NaN,NaN,NaN,416.78083973921264,NaN,NaN,418.9935999999984,423.7975879439824,414.1896120560144,420.18875209263814,413.68200687788163,415.2220778294152,412.1419359263481,123953,110225.73333333334,43.48425737080901,50.4534314580017,NaN,NaN,NaN,NaN,1.965384565995146,36.95180838623608,106263884,-0.5370958488558245,-1.261725293351958,-0.7246294444961335
2025-09-17T10:05:00-04:00,416.1,416.19,414.67,414.84,NaN,NaN,NaN,416.78083973921264,NaN,NaN,418.8867999999984,423.81632969826114,413.95727030173566,419.8010016741105,413.79285458012066,415.32974025053426,412.25596890970706,112204,112574.13333333333,40.66046029851939,48.97658614139779,NaN,NaN,NaN,NaN,1.9335713827097771,36.76446323645804,106151680,-0.4698864973350374,-1.3119875661649303,-0.8421010688298929
2025-09-17T10:10:00-04:00,414.77,416.31,414.74,415.84,NaN,NaN,NaN,416.78083973921264,NaN,NaN,418.7831999999984,423.74665918146314,413.8197408185336,418.9368013392885,413.9068437019543,415.45986747575455,412.35381992815405,103878,112986.46666666666,44.269216183536244,47.02807081040627,NaN,NaN,NaN,NaN,1.907601998230507,36.49298134222042,106255558,-0.33163381270314685,-1.2566433347088264,-0.9250095220056795
2025-09-17T10:15:00-04:00,415.78,416.49,414.95,415.09,NaN,NaN,NaN,416.78083973921264,NaN,NaN,418.6445999999985,423.625776102663,413.663423897334,411.4751211336853,413.97433746927516,415.5280391424212,412.4206357961291,73582,113978.63333333333,42.19651878714076,44.77875826307349,NaN,NaN,NaN,NaN,1.8813447126426153,36.08748082067718,106181976,-0.26702502853457966,-1.258790807673904,-0.9917657791393244
2025-09-17T10:20:00-04:00,415.12,415.43,413.75,413.85,NaN,NaN,NaN,416.78083973921264,NaN,NaN,418.5109999999984,423.63890366583337,413.3830963341634,411.4751211336853,413.9985766106256,415.50316022560264,412.49399299564857,122882,117050.13333333333,38.94952581086319,42.69164781123289,NaN,NaN,NaN,NaN,1.8669629474538574,36.22447734862623,106059094,-0.2826237649010097,-1.3450454852655866,-1.062421720364577
2025-09-17T10:25:00-04:00,413.82,414.13,412.25,412.64,NaN,NaN,NaN,416.78083973921264,NaN,NaN,418.37279999999845,423.74775382731764,412.99784617267926,411.4751211336853,413.9344262266394,415.4098521711849,412.4590002820939,129347,119236.63333333333,36.035560508476124,40.34619229828063,NaN,NaN,NaN,NaN,1.8678941654928671,36.89512376048172,105929747,-0.3451186230813097,-1.493819999216214,-1.1487013761349043
2025-09-17T10:30:00-04:00,412.705,414.89,411.93,414.5,NaN,NaN,NaN,416.78083973921264,NaN,NaN,418.2863999999985,423.767654980923,412.80514501907396,411.4751211336853,413.9237544351427,415.3500352090475,412.4974736612379,141892,122525.86666666667,43.084517786658616,39.092738151795224,NaN,NaN,NaN,NaN,1.945901725100518,36.86510618710484,106071639,-0.23702415507937458,-1.4449815699841224,-1.2079574149047478
2025-09-17T10:35:00-04:00,414.47,414.8,413.51,414.08,NaN,NaN,NaN,416.78083973921264,NaN,NaN,418.19319999999846,423.7975246734889,412.588875326508,411.4751211336853,413.92987201621725,415.33527628683265,412.52446774560184,65474,123692.13333333333,41.960059360220875,37.75896554627855,NaN,NaN,NaN,NaN,1.8990516018790538,36.837232726112035,106006165,-0.17263814043102998,-1.4237550904435352,-1.2511169500125052
2025-09-17T10:40:00-04:00,414.08,414.45,412.7,413.37,NaN,NaN,NaN,416.78083973921264,NaN,NaN,418.0589999999985,423.7959570336306,412.3220429663664,411.4751211336853,413.9192773116989,415.30855252512174,412.5300020982761,56679,124327.36666666667,40.05682432290374,38.76706331229843,NaN,NaN,NaN,NaN,1.8884050588876928,37.138006575821045,105949486,-0.1571366041158715,-1.4475377051573446,-1.290401101041473
2025-09-17T10:45:00-04:00,413.42,414.42,413.2,414.35,NaN,NaN,NaN,416.78083973921264,NaN,NaN,417.94339999999846,423.74138531956123,412.1454146804357,411.4751211336853,413.9209925895215,415.29336007484653,412.5486251041965,56276,124913.96666666666,43.84309701635212,40.43139009934503,NaN,NaN,NaN,NaN,1.8406618403957167,37.41729657912226,106005762,-0.06487752996091123,-1.3714980134926122,-1.306620483531701
2025-09-17T10:50:00-04:00,414.36,415.07,413.67,414.79,NaN,NaN,NaN,416.78083973921264,NaN,NaN,417.8443999999985,423.68518098937517,412.0036190106218,411.4751211336853,413.9392375130282,415.2940314493267,412.5844435767297,74171,125222.13333333333,45.507357475335134,41.47465942407422,NaN,NaN,NaN,NaN,1.8091859946531639,37.044012464782384,106079933,0.03634163930594125,-1.2611934343992743,-1.2975350737052156
2025-09-17T10:55:00-04:00,414.8,414.94,413.43,414.17,NaN,NaN,NaN,416.78083973921264,NaN,NaN,417.7483999999985,423.66926123512735,411.8275387648697,411.4751211336853,413.9461580743915,415.2819445959765,412.61037155280655,70865,125725.16666666667,43.54887891355087,41.80702570835752,NaN,NaN,NaN,NaN,1.7878155664636515,36.815379140509805,106009068,0.07014119289948129,-1.209858582580864,-1.2799997754803454
2025-09-17T11:00:00-04:00,414.17,415.52,414.12,414.89,NaN,NaN,NaN,416.78083973921264,NaN,NaN,417.6743999999985,423.64362663044767,411.70517336954936,411.486806729968,413.9739148154933,415.2980199936977,412.64980963728885,78708,126677.96666666666,46.43203303649858,42.44465007296429,NaN,NaN,NaN,NaN,1.7601144545733889,36.033105924138276,106087776,0.14526741262247667,-1.0984155097022494,-1.243682922324726
2025-09-17T11:05:00-04:00,414.93,416.86,414.84,416.67,410.6979429038482,410.6979429038482,410.6979429038482,NaN,NaN,NaN,417.63239999999854,423.59975192238295,411.66504807761413,412.6234453839744,414.07525901680776,415.4457150530477,412.7048029805678,125887,129241.53333333334,52.84417103874049,43.06231985068608,NaN,NaN,NaN,NaN,1.7786777078181495,34.145396940452585,106213663,0.3096737752955303,-0.8565907032053133,-1.1662644785008436
2025-09-17T11:10:00-04:00,416.7,418.6,416.7,418.38,412.46894549912776,NaN,NaN,NaN,NaN,NaN,417.62919999999855,423.59477301903945,411.66362698095764,414.24575630717953,414.26581987851205,415.8392470306526,412.6923927263715,140258,131508.2,58.04041648367178,44.10204550160485,NaN,NaN,NaN,NaN,1.7894864429739965,32.21817962538623,106353921,0.5162477030842476,-0.5209548496455341,-1.0372025527297817
2025-09-17T11:15:00-04:00,418.35,418.47,417.88,418.15,413.1489934309856,NaN,NaN,NaN,NaN,NaN,417.6261999999985,423.59057140407657,411.66182859592044,414.69160504574364,414.37106378826246,416.0468752414804,412.69525233504453,77921,131823.1,57.12856523110661,45.27833871107537,NaN,NaN,NaN,NaN,1.7038088399044276,30.428620689967467,106276000,0.6134395963763162,-0.2704030572593865,-0.8838426536357027
2025-09-17T11:20:00-04:00,418.13,418.13,416.89,417.06,413.1489934309856,NaN,NaN,NaN,NaN,NaN,417.5923999999985,423.55006472416625,411.6347352758308,414.69160504574364,414.4496429686006,416.1710395201723,412.72824641702886,77979,132959.93333333332,52.88790761476016,45.89395952759137,NaN,NaN,NaN,NaN,1.672108208482682,28.445342364629685,106198021,0.5806966460701739,-0.1579718460479853,-0.7386684921181592
2025-09-17T11:25:00-04:00,417.01,417.72,416.85,417.18,413.1489934309856,NaN,NaN,NaN,NaN,NaN,417.58019999999857,423.5386944277392,411.62170557225795,414.69160504574364,414.5110410834895,416.2621562724121,412.7599258945669,66490,133112.06666666668,53.29891187521488,46.68698760531094,NaN,NaN,NaN,NaN,1.6148147650196336,26.631358329053477,106264511,0.544125340713294,-0.05851181622654167,-0.6026371569398357
2025-09-17T11:30:00-04:00,417.14,417.83,416.81,417.61,413.1489934309856,NaN,NaN,NaN,NaN,NaN,417.5705999999986,423.5273244829066,411.6138755170906,414.69160504574364,414.5648934408333,416.34341724211146,412.7863696395552,57267,128678.2,54.81992435513174,47.820587501330124,NaN,NaN,NaN,NaN,1.5723279960896586,24.861318139736305,106321778,0.5256149289029741,0.05438150418888199,-0.47123342471409213
2025-09-17T11:35:00-04:00,417.65,419.39,417.65,419.03,413.7143440358049,NaN,NaN,NaN,NaN,NaN,417.5927999999986,423.5628265196424,411.6227734803548,415.9434094267366,414.6964561301929,416.59056951862397,412.8023427417619,101792,125609.86666666667,59.50978978672348,49.49731816406207,NaN,NaN,NaN,NaN,1.5871617106546811,24.050849890762116,106423570,0.5813765860796416,0.2554873078854598,-0.32588927819418173
2025-09-17T11:40:00-04:00,419.02,419.48,418.25,419.31,414.11005567054104,NaN,NaN,NaN,NaN,NaN,417.6069999999986,423.58990531473256,411.62409468526465,416.1077275413893,414.78615559636773,416.7590452997426,412.8132658929929,67726,124496.36666666667,60.38306015530257,50.73292833325093,NaN,NaN,NaN,NaN,1.5616501598936339,23.355637456234764,106491296,0.6066902074050398,0.432473481062118,-0.17421672634292176
2025-09-17T11:45:00-04:00,419.25,419.45,418.74,418.92,414.4593713218801,NaN,NaN,NaN,NaN,NaN,417.6069999999986,423.5899053147423,411.62409468525493,416.3971820331114,414.8551660049649,416.8843693913394,412.8259626185903,53792,122051,58.490814061078055,51.913696526169296,NaN,NaN,NaN,NaN,1.5008180056155158,22.71008305274508,106437504,0.5674520034153734,0.5350982779262949,-0.032353725489078416
2025-09-17T11:50:00-04:00,418.92,418.93,417.6,417.91,414.4593713218801,NaN,NaN,NaN,NaN,NaN,417.58479999999855,423.55479194685097,411.61480805314613,416.3971820331114,414.9213768608223,416.98253814029897,412.86021558134564,68015,118791.43333333333,53.78967727898684,52.89461459446095,NaN,NaN,NaN,NaN,1.4886167195001205,21.13043877599143,106369489,0.44895060791963404,0.5288345344104641,0.0798839264908301
2025-09-17T11:55:00-04:00,417.84,418.45,417.77,418.04,414.4593713218801,NaN,NaN,NaN,NaN,NaN,417.5517999999986,423.4930519762542,411.610548023743,416.3971820331114,414.9522235817979,417.0267527541982,412.87769440939763,33275,113815.46666666666,54.29883131371367,53.6414527585582,NaN,NaN,NaN,NaN,1.4308583823929695,19.663626233291605,106402764,0.3587095060405711,0.528270809041544,0.16956130300097288
2025-09-17T12:00:00-04:00,418.14,418.88,418.14,418.17,414.4593713218801,NaN,NaN,NaN,NaN,NaN,417.52719999999863,423.4477878631414,411.60661213685586,416.3971820331114,414.99789079037083,417.0959434214526,412.89983815928906,45878,105728.43333333333,54.83475047534705,54.307695115701904,NaN,NaN,NaN,NaN,1.3886542122220413,18.65583992377836,106448642,0.2900944248606398,0.5321793340767726,0.24208490921613285
2025-09-17T12:05:00-04:00,418.14,419.05,418.1,418.9,414.4593713218801,NaN,NaN,NaN,NaN,NaN,417.5277999999986,423.4489381207768,411.6066618792204,416.43048576076245,415.07069598650986,417.21029558109814,412.9310963919216,69736,97688.33333333333,57.82553903670468,55.327456553070036,NaN,NaN,NaN,NaN,1.3573217684918948,17.860359719860085,106518378,0.2762604448421477,0.5874104652688175,0.3111500204266698
2025-09-17T12:10:00-04:00,418.88,419.21,418.43,418.88,414.5807936868721,NaN,NaN,NaN,NaN,NaN,417.5297999999986,423.45269590024765,411.60690409974956,416.72438860860996,415.1316698814412,417.30651329691506,412.95682646596737,58043,90338.66666666667,57.71278161865256,56.133224308938175,NaN,NaN,NaN,NaN,1.3160844993139003,17.258091834753266,106460335,0.24899449653863426,0.6223931410999626,0.3733986445613283
2025-09-17T12:15:00-04:00,418.89,419.21,418.28,419.09,414.5807936868721,NaN,NaN,NaN,NaN,NaN,417.5341999999986,423.46139709855754,411.6070029014396,416.75651088688795,415.1792138179967,417.38026501196686,412.97816262402654,46347,85866.5,58.625079338305255,56.54614633033566,NaN,NaN,NaN,NaN,1.2885070350771937,16.539231457273466,106506682,0.22884953065351282,0.6594605578782193,0.4306110272247065
2025-09-17T12:20:00-04:00,419.12,419.95,419.1,419.36,415.424090941964,NaN,NaN,NaN,NaN,NaN,417.5415999999986,423.4769670286934,411.60623297130377,417.55720870951035,415.25032602234984,417.5007494379265,412.99990260677316,61250,83456.2,59.82516091730581,56.67362807559523,NaN,NaN,NaN,NaN,1.257899389714538,16.520506727281873,106567932,0.21753135644875693,0.7025252227856527,0.48499386633689573
2025-09-17T12:25:00-04:00,419.43,419.62,418.91,419.53,415.424090941964,NaN,NaN,NaN,NaN,NaN,417.55179999999854,423.49903558011994,411.60456441987714,417.55720870951035,415.30021086972715,417.58166244804187,413.01875929141244,45486,80235.1,60.60004923798932,56.921591218943995,NaN,NaN,NaN,NaN,1.218763719020641,16.284277173859603,106613418,0.2054613973148982,0.7418206129805185,0.5363592156656203
2025-09-17T12:30:00-04:00,419.53,419.53,418.331,418.331,415.424090941964,NaN,NaN,NaN,NaN,NaN,417.5244199999986,423.4443865150712,411.604453484926,417.55720870951035,415.35679875890514,417.66115999712537,413.0524375206849,62749,78194.96666666666,52.85652718144503,56.91934975942148,NaN,NaN,NaN,NaN,1.2173520248048777,15.421306797918124,106550669,0.10571829130300847,0.6685070797943808,0.5627887884913724
2025-09-17T12:35:00-04:00,418.33,418.62,417.03,417.16,415.424090941964,NaN,NaN,NaN,NaN,NaN,417.46521999999857,423.33920044698334,411.5912395530138,417.55720870951035,415.3925392098046,417.69571454732767,413.0893638722816,61496,76504.7,46.594402567963314,56.44045623747495,NaN,NaN,NaN,NaN,1.2439697373188174,15.221576150318764,106489173,-0.0422020050097085,0.5100362822292368,0.5522382872389453
2025-09-17T12:40:00-04:00,417.2,417.95,416.62,417.81,415.424090941964,NaN,NaN,NaN,NaN,NaN,417.42221999999856,423.2538446425503,411.59059535744683,417.55720870951035,415.4304245922139,417.72918576347325,413.13166342095457,72155,75447.26666666666,50.126510611926655,56.105212398674574,NaN,NaN,NaN,NaN,1.2501147560817578,15.360395199737473,106561328,-0.096256451778307,0.43191772251606153,0.5281741742943685
2025-09-17T12:45:00-04:00,417.76,418.57,417.41,418.46,415.424090941964,NaN,NaN,NaN,NaN,NaN,417.3954199999986,423.1953187042469,411.59552129575025,417.55720870951035,415.46129919418365,417.7650239381777,413.1575744501896,45272,74503.6,53.442559910894424,55.67183883611536,NaN,NaN,NaN,NaN,1.2436779877902013,14.83639089636879,106606600,-0.0884245911917485,0.41764343530468295,0.5060680264964315
2025-09-17T12:50:00-04:00,418.5,420.42,418.5,419.95,415.424090941964,NaN,NaN,NaN,NaN,NaN,417.3900199999986,423.17988342530396,411.6001565746932,417.55720870951035,415.5973900185493,417.98098136759467,413.2137986695039,134635,74895.36666666667,60.00693654890593,55.64497286422989,NaN,NaN,NaN,NaN,1.2948438458051896,14.750119220885157,106741235,0.011594223971193585,0.5205608064604235,0.5089665824892299
2025-09-17T12:55:00-04:00,419.97,419.97,418.91,418.98,415.424090941964,NaN,NaN,NaN,NaN,NaN,417.3604199999985,423.1021335577965,411.6187064422005,417.55720870951035,415.6422592585218,418.0455758453653,413.2389426716783,50694,72273.6,54.60887562260969,55.367691547196436,NaN,NaN,NaN,NaN,1.2780692853905333,14.670009807936072,106690541,0.0071330061672081335,0.51788284019824,0.5107498340310319
2025-09-17T13:00:00-04:00,419.05,419.81,418.88,419.78,415.424090941964,NaN,NaN,NaN,NaN,NaN,417.35101999999847,423.0752925934294,411.6267474065675,417.55720870951035,415.67876412834937,418.0995617243033,413.2579665323954,39924,68874.66666666667,57.967235385635874,55.66608855481422,NaN,NaN,NaN,NaN,1.2532071935769244,14.565140789554153,106730465,0.05036059961660122,0.5737005835517834,0.5233399839351822
2025-09-17T13:05:00-04:00,419.76,419.85,418.7,418.8,415.424090941964,NaN,NaN,NaN,NaN,NaN,417.3158199999985,422.982079771294,411.64956022870297,417.55720870951035,415.7076499606719,418.1385951250344,413.27670479630945,35657,67880.76666666666,52.81241998260617,55.55991631687798,NaN,NaN,NaN,NaN,1.245835251178575,14.276192225086865,106694808,0.007502330606148133,0.5327178971928674,0.5252155665867193
2025-09-17T13:10:00-04:00,418.84,419.26,418.63,419.09,415.424090941964,NaN,NaN,NaN,NaN,NaN,417.2514199999985,422.7601749246434,411.7426650753536,417.3507669676083,415.7287943780071,418.16610676885716,413.291481987157,27487,66907.7,54.11282447606675,55.50835017407224,NaN,NaN,NaN,NaN,1.2018470189515338,13.930322984304667,106722295,-0.006034854232935927,0.5176719987955494,0.5237068530284853
2025-09-17T13:15:00-04:00,419.09,419.27,418.82,419.22,415.424090941964,NaN,NaN,NaN,NaN,NaN,417.1796199999985,422.48659272535843,411.8726472746386,417.1542225199459,415.7538577697611,418.1993269805078,413.3083885590144,31961,66097.2,54.7152902536596,55.286189546711874,NaN,NaN,NaN,NaN,1.1481436604549948,13.618921895436698,106754256,-0.010681581516143512,0.5103548761333059,0.5210364576494494
2025-09-17T13:20:00-04:00,419.21,419.67,418.92,419.67,415.60828343905246,NaN,NaN,NaN,NaN,NaN,417.12681999999853,422.27883937454186,411.9748006254552,417.3987616282687,415.7803514143772,418.2366759043509,413.32402692440354,31324,64668.96666666667,56.82826544838008,55.22300982026385,NaN,NaN,NaN,NaN,1.1197048275653523,13.724063296191465,106785580,0.010933644788993169,0.5347035136356908,0.5237698688466976
2025-09-17T13:25:00-04:00,419.69,419.91,419.29,419.72,415.99631601000465,NaN,NaN,NaN,NaN,NaN,417.0722199999985,422.05242541462474,412.0920145853722,417.78300930261497,415.81462794848034,418.2866854491668,413.3425704477939,38839,63601.433333333334,57.067964581351646,55.11178733762431,NaN,NaN,NaN,NaN,1.0840116255963987,14.051842072179173,106824419,0.022324263429187696,0.5516751981331822,0.5293509347039945
2025-09-17T13:30:00-04:00,419.77,420.25,419.08,419.09,416.06557437318617,NaN,NaN,NaN,NaN,NaN,417.02101999999854,421.8626302201168,412.1794097798803,417.963407442092,415.85425380979245,418.34188141112577,413.36662620845914,47885,62574,53.06972314648027,54.62925606827962,NaN,NaN,NaN,NaN,1.0901536523395143,14.67552018206468,106776534,-0.01673771189076334,0.5084287948405404,0.5251665067313037
2025-09-17T13:35:00-04:00,419.1,420.15,419.02,420.12,416.06557437318617,NaN,NaN,NaN,NaN,NaN,416.9904199999985,421.7329448317556,412.24789516824137,417.963407442092,415.8842718474741,418.3857139650496,413.3828297298986,34214,59518.23333333333,58.22312428726768,54.45947571465665,NaN,NaN,NaN,NaN,1.0929998200295488,15.164375329428717,106810748,0.020600768185743523,0.5509174669634831,0.5303166987777396
2025-09-17T13:40:00-04:00,420.11,420.48,419.46,419.59,416.4041803689569,NaN,NaN,NaN,NaN,NaN,417.1034199999985,421.8189990842453,412.38784091575167,418.0545807629388,415.9193643418751,418.4371911001478,413.4015375836024,39846,56171.166666666664,54.88343947519902,54.6042551642105,NaN,NaN,NaN,NaN,1.087785547170298,15.940443403174179,106770902,0.004265719884119168,0.5356488486328885,0.5313831287487694
2025-09-17T13:45:00-04:00,419.56,419.81,419.15,419.28,416.4041803689569,NaN,NaN,NaN,NaN,NaN,417.27601999999854,421.65378115424215,412.8982588457549,418.0545807629388,415.9413685136849,418.466427911406,413.41630911596377,28490,54523.46666666667,52.969592905347824,55.0596259025951,NaN,NaN,NaN,NaN,1.0572294366581356,16.166500668322254,106742412,-0.0308243823501112,0.4928526508111304,0.5236770331612416
2025-09-17T13:50:00-04:00,419.33,420.19,419.2,420.19,416.4041803689569,NaN,NaN,NaN,NaN,NaN,417.4228199999985,421.68787824998236,413.1577617500147,418.0545807629388,415.97185940629583,418.51053361403564,413.43318519855603,35476,53106.7,57.639335517621284,55.59625625300186,NaN,NaN,NaN,NaN,1.0524273340396981,16.76714525798131,106777888,0.0020974969592603143,0.526298904360317,0.5242014074010567
2025-09-17T13:55:00-04:00,420.13,420.65,419.81,420.65,416.8032479711598,NaN,NaN,NaN,NaN,NaN,417.53781999999853,421.83454287629553,413.24109712370154,418.38098535062466,416.0183640751627,418.58333814141275,413.45339000891266,48724,52514.5,59.81161586509004,56.05118882115869,NaN,NaN,NaN,NaN,1.0372539530368607,17.76134370184843,106826612,0.04719942003711841,0.5832006824474547,0.5360012624103363
2025-09-17T14:00:00-04:00,420.67,424.55,417.6,424.28,416.8562821542889,NaN,NaN,NaN,NaN,NaN,417.7376199999985,422.33053191161366,413.14470808838337,419.2597882804998,416.41145989314225,419.3114644405877,413.5114553456968,316022,61139.666666666664,72.00974919203031,56.908532581381856,NaN,NaN,NaN,NaN,1.4595929563913699,20.789618048939925,107142634,0.29976565852355286,0.9107083355647774,0.6109426770412245
2025-09-17T14:05:00-04:00,424.28,424.64,418.51,418.63,416.8562821542889,NaN,NaN,NaN,NaN,NaN,417.78641999999854,422.3643465196923,413.2084934803048,419.2597882804998,416.5866354575827,419.5462996606081,413.6269712545573,215283,64922.7,47.727532907940684,56.41700810176264,NaN,NaN,NaN,NaN,1.7931934595062717,23.631344614129983,106927351,0.07621542428893091,0.7062119574023882,0.6299965331134573
2025-09-17T14:10:00-04:00,418.66,418.82,412.14,412.24,NaN,NaN,NaN,421.03273671479053,421.03273671479053,421.03273671479053,417.7128199999985,422.5209468157109,412.9046931842861,419.2597882804998,416.46323791351193,419.3821217609813,413.54435406604256,307372,72910.9,33.83230428688634,54.693084451851966,NaN,NaN,NaN,NaN,2.142251069541538,22.703623099677213,106619979,-0.4814353000543645,0.02820240804550167,0.5096377080998662
2025-09-17T14:15:00-04:00,412.2,416.9,411.77,416.45,NaN,NaN,NaN,420.33488504593635,NaN,NaN,417.7450199999985,422.496994924594,412.99304507540296,419.2597882804998,416.4099622238288,419.28640900168915,413.5335154459685,211814,78178.3,45.16040001282645,54.1465115968677,NaN,NaN,NaN,NaN,2.355661707431428,22.01446172533779,106831793,-0.5416962416510896,-0.1674825939639959,0.37421364768709375
2025-09-17T14:20:00-04:00,416.33,419.21,414.88,418.39,NaN,NaN,NaN,420.33488504593635,NaN,NaN,417.79601999999846,422.51976994300855,413.0722700569884,419.2597882804998,416.442883307079,419.28138685390707,413.60437976025094,177338,81822.4,49.454732955024284,53.81379077393609,NaN,NaN,NaN,NaN,2.496685871186325,20.749976255888683,107009131,-0.4306753868861459,-0.1641305859205886,0.26654480096555727
2025-09-17T14:25:00-04:00,418.38,419.07,416.84,418.91,NaN,NaN,NaN,420.33488504593635,NaN,NaN,417.87241999999856,422.5418887341913,413.20295126580584,419.2597882804998,416.47389930774017,419.2981497081393,413.64964890734103,100590,84066.23333333334,50.57200951041149,53.51784214941837,NaN,NaN,NaN,NaN,2.4776368803873035,19.575811177114513,107109721,-0.307757803399223,-0.11815245328347146,0.18960535011575153
2025-09-17T14:30:00-04:00,418.94,419.35,415.86,416.81,NaN,NaN,NaN,420.33488504593635,NaN,NaN,417.93161999999853,422.4687809611911,413.39445903880596,419.2597882804998,416.489812193661,419.2904137150255,413.6892106722965,111112,86240.7,46.13666812814458,52.75415662654441,NaN,NaN,NaN,NaN,2.549948531788211,18.393138199432062,106998609,-0.3503279605807135,-0.24830460061014037,0.10202335997057314
2025-09-17T14:35:00-04:00,416.83,418.55,415.59,415.65,NaN,NaN,NaN,420.33488504593635,NaN,NaN,417.9918199999985,422.3216811104749,413.66195888952205,419.2597882804998,416.4914858512756,419.2700996288096,413.71287207374166,96230,87123.83333333333,43.8489654993219,51.80994240639943,NaN,NaN,NaN,NaN,2.57923792237477,17.436422276335488,106902379,-0.43360395732469204,-0.43998158668529186,-0.006377629360599851
2025-09-17T14:40:00-04:00,415.67,417.54,415.1,415.79,NaN,NaN,NaN,420.33488504593635,NaN,NaN,418.0176199999985,422.27877606706386,413.7564639329331,419.2597882804998,416.4863537160299,419.2447307339171,413.7279766981427,91921,88253.1,44.20852923488385,51.17699998414254,NaN,NaN,NaN,NaN,2.5692923564908576,16.808510456114817,106994300,-0.4540768862561889,-0.573973737180836,-0.1198968509246471
2025-09-17T14:45:00-04:00,415.87,417.87,414.91,416.79,NaN,NaN,NaN,420.33488504593635,NaN,NaN,418.07181999999847,422.19806241120426,413.9455775887927,419.2597882804998,416.48708595137776,419.21802190060305,413.7561500021525,125968,90907.13333333333,46.827679315986124,50.363039629050995,NaN,NaN,NaN,NaN,2.597200045312938,16.015257940312274,107120268,-0.3781947202586251,-0.5926402512479285,-0.21444553098930338
2025-09-17T14:50:00-04:00,416.84,417.24,414.49,415.34,NaN,NaN,NaN,420.33488504593635,NaN,NaN,418.1112199999985,422.09219040078256,414.1302495992145,417.34283062439977,416.463313575445,419.1566323728078,413.7699947780822,195564,95384.26666666666,43.62934434573708,49.559175691232284,NaN,NaN,NaN,NaN,2.608114327790585,15.519762503920195,106924704,-0.40138821008370534,-0.716180793593935,-0.3147925835102297
2025-09-17T14:55:00-04:00,415.36,419.71,415.36,419.65,NaN,NaN,NaN,420.33488504593635,NaN,NaN,418.21721999999846,422.07219947750684,414.3622405224901,411.2666760345406,416.51273796828804,419.18435583537666,413.8411201011994,187631,100122.43333333333,53.74270500404709,49.61439798399652,NaN,NaN,NaN,NaN,2.7339633043769718,15.202630692726057,107112335,-0.11695997198902108,-0.46099254849650606,-0.344032576507485
2025-09-17T15:00:00-04:00,419.71,422.28,419.45,422.23,413.6874697207759,413.6874697207759,413.6874697207759,NaN,NaN,NaN,418.3660199999985,422.25457067140536,414.47746932859167,414.11034082763246,416.6506130454008,419.4031800742805,413.8980460165211,199159,104669.43333333333,58.538044004595754,49.67859144735184,NaN,NaN,NaN,NaN,2.740823068350044,15.997761720736174,107311494,0.235231424336528,-0.04999329608682501,-0.285224720423353
2025-09-17T15:05:00-04:00,422.23,424.42,421.93,423.81,415.9841756425588,NaN,NaN,NaN,NaN,NaN,418.55881999999843,422.5506323348041,414.56700766519276,416.639272662106,416.8109123249133,419.7178714565618,413.90395319326484,169277,108262.13333333333,61.19136340036808,49.77714484272884,NaN,NaN,NaN,NaN,2.72290713489647,17.43764364056158,107480771,0.5470791966704003,0.3986242754146474,-0.1484549212557529
2025-09-17T15:10:00-04:00,423.92,424.6,421.09,421.95,415.9841756425588,NaN,NaN,NaN,NaN,NaN,418.70001999999846,422.6620907823121,414.73794921768484,416.639272662106,416.9244635017137,419.91135582051044,413.937571182917,143667,110645.86666666667,56.59946165809075,48.67641001887601,NaN,NaN,NaN,NaN,2.7791280538324403,18.25579651304691,107337104,0.5965131238576455,0.5971864835663041,0.0006733597086585053
2025-09-17T15:15:00-04:00,422,424.21,422,423,415.9841756425588,NaN,NaN,NaN,NaN,NaN,418.82661999999846,422.9233751047247,414.7298648952722,416.6963345037478,417.0212307404218,420.0816834241081,413.9607780567355,116096,113006.66666666667,58.49304476923543,49.44537515182564,NaN,NaN,NaN,NaN,2.742047478558694,19.015509894640427,107453200,0.6632295561970962,0.8297103049550287,0.16648074875793256
2025-09-17T15:20:00-04:00,422.84,426.13,422.61,425.79,416.9055602578641,NaN,NaN,NaN,NaN,NaN,418.9748199999985,423.50898858487136,414.4406514151256,418.35906760299827,417.28851664157685,420.61501813076546,413.96201515238823,260856,117214.03333333334,63.10001147452351,51.535925665228284,NaN,NaN,NaN,NaN,2.7976155158045004,20.350306122965037,107714056,0.8468120430478745,1.2249958025677756,0.3781837595199012
2025-09-17T15:25:00-04:00,425.95,427.92,425.81,427.13,419.4493984279612,NaN,NaN,NaN,NaN,NaN,419.1544199999985,424.2235215712909,414.08531842870605,420.63825408239865,417.54776351122655,421.18192850459076,413.91359851786234,210415,122538.06666666667,65.10338869619153,52.96042485689723,NaN,NaN,NaN,NaN,2.749928693247036,22.082087854133285,107924471,0.9995545430040791,1.6276269382750002,0.6280723952709211
2025-09-17T15:30:00-04:00,427.09,427.94,425.61,426.17,419.4493984279612,NaN,NaN,NaN,NaN,NaN,419.3366199999985,424.7356518380175,413.93758816197953,420.9496032659189,417.71457721587547,421.5146848344808,413.9144695972701,147712,126131,62.48598773405403,53.891228769685064,NaN,NaN,NaN,NaN,2.7199337865865325,23.554477976321607,107776759,0.9759013086286801,1.8479490310567712,0.8720477224280911
2025-09-17T15:35:00-04:00,426.14,427.69,425.88,426.87,419.4781192287828,NaN,NaN,NaN,NaN,NaN,419.53041999999857,425.289532377762,413.77130762223516,421.1926826127351,417.8411711102753,421.7623595993505,413.9199826212001,112765,128701.26666666666,63.63406959840614,54.82423306168467,NaN,NaN,NaN,NaN,2.654938516116066,24.92169737549648,107889524,0.9466396324089046,2.0553472629392218,1.1087076305303172
2025-09-17T15:40:00-04:00,427,428.08,426.38,427.33,420.0234319911109,NaN,NaN,NaN,NaN,NaN,419.7248199999986,425.85571265568103,413.59392734431617,422.03214609018806,418.0750638441727,422.21548733880576,413.9346403495396,206313,134662.13333333333,64.40499590041898,56.129113616847135,NaN,NaN,NaN,NaN,2.5867286221077745,26.309366324346612,108095837,0.8979228163907931,2.2311111510188084,1.3331883346280153
2025-09-17T15:45:00-04:00,427.31,427.6,426.36,427.47,420.0234319911109,NaN,NaN,NaN,NaN,NaN,419.8936199999986,426.39241020030255,413.3948297996946,422.1417168721505,418.22461490515343,422.4900799173575,413.95914989294937,139363,138242.2,64.65061094182764,57.61494543416897,NaN,NaN,NaN,NaN,2.4905337205286484,27.581511533544635,108235200,0.8170975115007795,2.35456022400399,1.5374627125032103
2025-09-17T15:50:00-04:00,427.7,428.3,425.95,426.65,420.07682542991716,NaN,NaN,NaN,NaN,NaN,420.0404199999985,426.80597376740997,413.27486623258704,422.75837349772036,418.4411305325994,422.86713160186844,414.01512946333037,214610,144351.73333333334,61.95407454778147,58.88248438509022,NaN,NaN,NaN,NaN,2.480495597633747,28.988613290170484,108020590,0.6572569360950209,2.3590338826219863,1.7017769465269654
2025-09-17T15:55:00-04:00,426.63,427.26,425.3,425.63,420.07682542991716,NaN,NaN,NaN,NaN,NaN,420.17461999999847,427.1100164780502,413.2392235219467,422.75837349772036,418.6126160929166,423.1321789534848,414.0930532323484,199436,149704.96666666667,58.675668788165495,59.728769347388756,NaN,NaN,NaN,NaN,2.4433173406599065,29.73188841628765,107821154,0.44200867272663547,2.25428778743526,1.8122791147086244
2025-09-18T09:30:00-04:00,428.82,431.54,426.55,429.91,421.56197317064766,NaN,NaN,NaN,NaN,NaN,420.4146199999985,427.8335993036385,412.99564069635846,424.25435903854105,429.3333333333333,429.3333333333333,429.3333333333333,408974,161741.26666666666,66.65033606947327,61.373125899084194,NaN,NaN,NaN,NaN,2.6909375306127723,31.613445932230867,108230128,0.5405418046745287,2.4879563705517853,1.9474145658772566
2025-09-18T09:35:00-04:00,429.77,430.08,423.67,423.76,421.56197317064766,NaN,NaN,NaN,NaN,NaN,420.5290199999984,427.9743624531016,413.0836775468952,424.25435903854105,427.80051347686805,429.5355130116612,426.0655139420749,319212,171241.2,51.32386627468338,61.20035170412964,NaN,NaN,NaN,NaN,2.956584849854715,31.506977784729866,107910916,0.16373152892445808,2.1520789770328292,1.9883474481083712
2025-09-18T09:40:00-04:00,423.72,426.22,421.95,425.61,421.56197317064766,NaN,NaN,NaN,NaN,NaN,420.67781999999846,428.22531422496553,413.1303257750314,424.25435903854105,426.81460582023163,428.8821722753899,424.74703936507336,323204,180686.46666666667,54.69855081008876,60.926102190236286,NaN,NaN,NaN,NaN,3.0504002177222382,30.51018311136057,108234120,0.01890636473311802,2.0119804040247686,1.9930740392916506
2025-09-18T09:45:00-04:00,425.61,427.23,424.5,427.05,421.56197317064766,NaN,NaN,NaN,NaN,NaN,420.8408199999985,428.5773512508757,413.1042887491212,424.25435903854105,426.73667774350724,428.66315585995824,424.81019962705625,171883,185466.23333333334,57.18667205975346,60.64005280876381,NaN,NaN,NaN,NaN,3.027514487884937,29.923661911770473,108406003,0.0008686149925596354,1.9941598080323502,1.9932911930397905
2025-09-18T09:50:00-04:00,427.02,428.62,426.87,427.98,421.56197317064766,NaN,NaN,NaN,NaN,NaN,421.0228199999985,428.9909606787183,413.0546793212787,424.25435903854105,426.9019784655273,428.7183092184108,425.0856477126438,219468,191599.3,58.76196926612199,60.794517637908896,NaN,NaN,NaN,NaN,2.936263453036013,29.81540574744921,108625471,0.030695340700552798,2.0316603689154817,2.000965028214929
2025-09-18T09:55:00-04:00,427.985,428.99,427.1,428,421.56197317064766,NaN,NaN,NaN,NaN,NaN,421.20101999999844,429.3839207524117,413.01811924758516,424.25435903854105,427.03090065340217,428.7775581563074,425.28424315049693,186169,196180.8,58.79708026929229,60.81623445934154,NaN,NaN,NaN,NaN,2.8615303492477255,29.827597814486978,108811640,0.030814991118125246,2.0394837671125856,2.0086687759944604
2025-09-18T10:00:00-04:00,427.9,428.77,426.3,427.98,421.56197317064766,NaN,NaN,NaN,NaN,NaN,421.3734199999984,429.75472031080324,412.9921196891936,424.25435903854105,427.0877476740352,428.76669073177493,425.40880461629547,155475,190829.23333333334,58.74321761707177,60.50503489809498,NaN,NaN,NaN,NaN,2.833563895730029,29.385652743747002,108656165,0.00968560984211253,2.020775788297101,2.0110901784549884
2025-09-18T10:05:00-04:00,427.99,429.44,427.66,428.88,421.56197317064766,NaN,NaN,NaN,NaN,NaN,421.5604199999985,430.182621724603,412.938218275394,424.25435903854105,427.18722286879796,428.8566563433648,425.5177893942311,120522,187670.53333333333,60.49693638302061,60.17600259001135,NaN,NaN,NaN,NaN,2.758309331749311,29.205301025774926,108776687,0.035035559492055945,2.0548846278200585,2.0198490683280026
2025-09-18T10:10:00-04:00,428.94,429.47,427.96,428.15,421.56197317064766,NaN,NaN,NaN,NaN,NaN,421.75679999999846,430.5219340574742,412.99166594252273,424.25435903854105,427.25487608405575,428.90783749266234,425.60191467544917,101332,180802.53333333333,58.33108004295256,59.87922346921839,NaN,NaN,NaN,NaN,2.669144379481506,29.048434170837496,108675355,-0.01591367808721511,1.9999569707189835,2.0158706488061986
2025-09-18T10:15:00-04:00,428.22,429.23,426.92,428.95,421.56197317064766,NaN,NaN,NaN,NaN,NaN,421.9925999999985,430.8838368636369,413.10136313636013,424.25435903854105,427.33472000330636,428.9528842801151,425.71655572649763,155227,178916.3,60.02030523240189,59.62109744307522,NaN,NaN,NaN,NaN,2.643491209518541,28.263810419345813,108830582,-0.01433762870493549,1.997948612925029,2.0122862416299645
2025-09-18T10:20:00-04:00,428.95,429.4,428,429.35,421.56197317064766,NaN,NaN,NaN,NaN,NaN,422.2233999999985,431.26618683622183,413.18061316377515,423.9353180306634,427.39997894847033,429.0153475562466,425.7846103406941,93002,176105.1,60.8743710198975,59.3689099516094,NaN,NaN,NaN,NaN,2.5546704088386436,27.606905754624222,108923584,-0.005416753322969647,2.0055152999762527,2.0109320532992223
2025-09-18T10:25:00-04:00,429.39,429.68,427.8,428.94,421.56197317064766,NaN,NaN,NaN,NaN,NaN,422.4329999999986,431.60209090395625,413.2639090960409,424.36825442453073,427.4585620846685,429.06471269974764,425.8524114695893,97970,176017.76666666666,59.471968405285466,58.999006913284965,NaN,NaN,NaN,NaN,2.506479665350169,27.119829172139042,108825614,-0.04403989214176329,1.9558821881220183,1.9999220802637816
2025-09-18T10:30:00-04:00,428.98,429.7,428.01,428.14,421.56197317064766,NaN,NaN,NaN,NaN,NaN,422.59679999999855,431.8745837356321,413.319016264365,424.60560353962455,427.5127056993378,429.0998053741334,425.9256060245422,115375,176159.86666666667,56.725905529944974,58.625566269153786,NaN,NaN,NaN,NaN,2.4481596892537283,26.67678199228306,108710239,-0.1352265222887088,1.8308889274028957,1.9661154496916045
2025-09-18T10:35:00-04:00,428.12,428.18,427.21,428.1,421.56197317064766,NaN,NaN,NaN,NaN,NaN,422.7791999999986,432.12374436797904,413.4346556320181,424.60560353962455,427.52711962649715,429.079158314101,425.9750809388933,117442,176866.93333333332,56.58521792240177,58.47624835017067,NaN,NaN,NaN,NaN,2.3425768543070355,25.697824147898316,108592797,-0.20576914354575515,1.7089040202594106,1.9146731638051657
2025-09-18T10:40:00-04:00,428.1,430.78,427.74,430.42,422.06025189271776,NaN,NaN,NaN,NaN,NaN,422.9919999999986,432.5361240564574,413.44787594353977,425.61158626535973,427.6463243975259,429.23119048669173,426.0614583083601,154061,178938.26666666666,62.40860346721935,58.17326745000967,NaN,NaN,NaN,NaN,2.3923927932851017,25.951172674234446,108746858,-0.10859586308843361,1.7789283349446237,1.8875241980330573
2025-09-18T10:45:00-04:00,430.37,432.21,429.17,431.52,423.4029677157761,NaN,NaN,NaN,NaN,NaN,423.2463999999985,433.00568994165786,413.48711005833917,426.5552690122878,427.8466819850796,429.5744970582708,426.1188669118884,175912,180603.06666666668,64.81820533878046,59.13714881173088,NaN,NaN,NaN,NaN,2.4386504509075917,26.69035986249659,108922770,0.01099447351477223,1.9012672899265226,1.8902728164117504
2025-09-18T10:50:00-04:00,431.47,431.75,428.88,429,423.4029677157761,NaN,NaN,NaN,NaN,NaN,423.4445999999986,433.26054964151996,413.6286503584773,426.5552690122878,427.92809259061073,429.667131147636,426.1890540335855,121797,178144.16666666666,55.9673698485115,59.22777874304679,NaN,NaN,NaN,NaN,2.4694611329856215,27.16925592620979,108800973,-0.09267873808774874,1.7744243938020645,1.8671031318898133
2025-09-18T10:55:00-04:00,429.04,430.14,428.95,429.17,423.4029677157761,NaN,NaN,NaN,NaN,NaN,423.64359999999857,433.5121915998727,413.7750084001244,426.5552690122878,427.9680581909817,429.70047508753356,426.23564129442985,83596,174676.33333333334,56.399891547092274,59.171580134999566,NaN,NaN,NaN,NaN,2.378071052058077,27.613945128229194,108884569,-0.15897374604725778,1.668385949330741,1.8273596953779987
2025-09-18T11:00:00-04:00,429.2,430.29,428.92,429.59,423.4029677157761,NaN,NaN,NaN,NaN,NaN,423.8419999999985,433.78168128288127,413.90231871711575,426.5552690122878,428.00830924234,429.73784984788983,426.2787686367901,78915,170668.2,57.5103479172288,59.08217861007863,NaN,NaN,NaN,NaN,2.3060659769110714,28.086927190446158,108963484,-0.18204877695616695,1.59979872418279,1.781847501138957
2025-09-18T11:05:00-04:00,429.7,429.88,428.46,429.54,423.4029677157761,NaN,NaN,NaN,NaN,NaN,424.0383999999986,434.0324521193855,414.0443478806117,426.5552690122878,428.04599031225223,429.7637205017261,426.3282601227784,96655,168247.46666666667,57.32317218396019,58.97689946112633,NaN,NaN,NaN,NaN,2.242775549988853,28.142388885667692,108866829,-0.2064041083168504,1.523842365742894,1.7302464740597443
2025-09-18T11:10:00-04:00,429.55,429.99,427.92,428.21,423.4029677157761,NaN,NaN,NaN,NaN,NaN,424.2207999999986,434.1797781325703,414.2618218674269,426.5552690122878,428.0661112539328,429.7612882231066,426.37093428475896,103539,166909.86666666667,52.43454032938494,58.52627965486299,NaN,NaN,NaN,NaN,2.230434439275363,27.750608120764593,108763290,-0.31150133345449027,1.3408698072416314,1.6523711406961217
2025-09-18T11:15:00-04:00,428.19,428.65,426.68,428.63,423.4029677157761,NaN,NaN,NaN,NaN,NaN,424.39099999999854,434.3547007183618,414.42729928163527,426.5552690122878,428.06322994881594,429.7274488676545,426.3990110299774,127942,167304.73333333334,53.77518783825526,58.04615475880832,NaN,NaN,NaN,NaN,2.2118319793271204,26.454439206654907,108891232,-0.3493057569443889,1.2157389445156355,1.5650447014600244
2025-09-18T11:20:00-04:00,428.69,428.84,427.12,427.3,423.4029677157761,NaN,NaN,NaN,NaN,NaN,424.5451999999985,434.44536342517756,414.6450365748194,426.5552690122878,428.0566292952173,429.7036371418733,426.4096214485613,76773,161168.63333333333,49.05961876826746,57.383907524902256,NaN,NaN,NaN,NaN,2.1767011236608953,25.362283198142787,108814459,-0.45383535889501436,0.9977505028412565,1.451585861736271
2025-09-18T11:25:00-04:00,427.28,427.28,424.59,424.74,423.4029677157761,NaN,NaN,NaN,NaN,NaN,424.6543999999986,434.4396330869011,414.8691669130961,426.5552690122878,427.9445917643008,429.6362800016454,426.25290352695623,167710,159745.13333333333,41.513633853553834,56.062002426413095,NaN,NaN,NaN,NaN,2.2147939005422623,24.32844832252719,108646749,-0.6721687394734726,0.6113749373944302,1.2835436768679027
2025-09-18T11:30:00-04:00,424.79,426.83,424.7,425.82,423.4029677157761,NaN,NaN,NaN,NaN,NaN,424.7669999999985,434.473404689953,415.06059531004405,426.5552690122878,427.88024932905086,429.5865703338144,426.1739283242873,115746,158679.6,45.33377427780652,54.95195980197803,NaN,NaN,NaN,NaN,2.2087371933606716,23.368458795169854,108762495,-0.7165584223421737,0.3878456489401856,1.1044040712823593
2025-09-18T11:35:00-04:00,425.79,426.7,425.17,426.6,423.4029677157761,NaN,NaN,NaN,NaN,NaN,424.88599999999855,434.5333034577129,415.2386965422842,425.7912152098302,427.8523003182787,429.55867374896184,426.1459268875956,64084,157056.9,47.97666038090906,54.13086637166543,NaN,NaN,NaN,NaN,2.1602559652634787,22.47703994833804,108826579,-0.6671087023652824,0.27051819332575633,0.9376268956910387
2025-09-18T11:40:00-04:00,426.609,426.78,423.94,424.5,423.4029677157761,NaN,NaN,NaN,NaN,NaN,424.89039999999846,434.53679452673884,415.2440054732581,425.31537773429136,427.77741103985807,429.51975147395314,426.035070605763,109450,153828.13333333333,42.07835224066262,53.08461256528811,NaN,NaN,NaN,NaN,2.2088091106017997,22.33359554909186,108717129,-0.7437088948091054,0.007990777179657016,0.7516996719887624
2025-09-18T11:45:00-04:00,424.5,425.35,424.5,425.3,423.4029677157761,NaN,NaN,NaN,NaN,NaN,425.0237999999985,434.5032387093997,415.54436129059735,425.31537773429136,427.73935749559195,429.4988273591889,425.979887631995,57468,151098.3,44.85949668316307,52.247061048199626,NaN,NaN,NaN,NaN,2.111751316987387,22.200397178363268,108774597,-0.7085329336225545,-0.1339664950394308,0.5745664385831237
2025-09-18T11:50:00-04:00,425.25,425.32,423.9,424.48,423.4029677157761,NaN,NaN,NaN,NaN,NaN,425.26859999999857,434.0190093712877,416.5181906287094,425.20324174994647,427.6744567984939,429.47281868583394,425.87609491115387,86016,146811.83333333334,42.601535663839734,50.83227049081537,NaN,NaN,NaN,NaN,2.062340508631146,22.402418329952795,108688581,-0.7069115523227462,-0.30907300182030895,0.3978385505024372
2025-09-18T11:55:00-04:00,424.44,425.65,424.18,425.15,423.4029677157761,NaN,NaN,NaN,NaN,NaN,425.4425999999985,433.8228308420157,417.06236915798127,425.20324174994647,427.6233159422723,429.4418088283677,425.80482305617693,81766,142889.5,45.0359065562515,49.41924914920616,NaN,NaN,NaN,NaN,2.0200304723003475,22.29668989217505,108770347,-0.6297070136131272,-0.3892952165139718,0.2404117970991554
2025-09-18T12:00:00-04:00,425.13,425.83,424.54,424.92,423.4029677157761,NaN,NaN,NaN,NaN,NaN,425.57319999999856,433.70970779173945,417.4366922082577,424.12847471996577,427.5769792342223,429.4103367332601,425.74362173518443,80083,131926.46666666667,44.34067970660713,48.58877128192728,NaN,NaN,NaN,NaN,1.9678854385646058,22.035027126923822,108690264,-0.5651762733968886,-0.4660585446469554,0.09911772874993321
2025-09-18T12:05:00-04:00,424.88,425.15,420.84,421.13,NaN,NaN,NaN,429.57329435424197,429.57329435424197,429.57329435424197,425.61759999999856,433.63148650812326,417.60371349187386,424.12847471996577,427.33354561601993,429.4338886016342,425.2332026304057,214309,128429.7,34.80579851434561,47.04633606530251,NaN,NaN,NaN,NaN,2.1351793358099913,23.50819190876208,108475955,-0.7378747647186531,-0.8232257271483832,-0.08535096242973006
2025-09-18T12:10:00-04:00,421.14,422.77,420.91,422,NaN,NaN,NaN,428.3729173381401,NaN,NaN,425.72139999999854,433.40386940541066,418.0389305945864,422.1557797759726,427.21293630031414,429.4389715305127,424.9869010701156,103865,121118.4,38.09653153476673,45.65963489512666,NaN,NaN,NaN,NaN,2.1155236689664174,24.87613063475474,108579820,-0.751138722952793,-1.0242743661207214,-0.2731356431679284
2025-09-18T12:15:00-04:00,421.985,422.72,421.67,422.5,NaN,NaN,NaN,428.3729173381401,NaN,NaN,425.8583999999985,433.04594518352184,418.6708548164751,421.80349905662246,427.1297555921746,429.42614681757885,424.83336436677035,80631,118076.66666666667,39.97184599288556,44.42025445290704,NaN,NaN,NaN,NaN,2.039414835468817,26.14635945174793,108660451,-0.6856774245227181,-1.130232423821326,-0.44455499929860787
2025-09-18T12:20:00-04:00,422.55,424.3,422.33,424,NaN,NaN,NaN,428.3729173381401,NaN,NaN,426.0225999999984,432.6346675257829,419.41053247421394,421.80349905662246,427.06563378032143,429.39049621803923,424.74077134260364,86755,113652.9,45.32325010404559,43.91230515109709,NaN,NaN,NaN,NaN,2.034456632935332,25.939422368820324,108747206,-0.5089237884441293,-1.0807097348537695,-0.5717859464096402
2025-09-18T12:25:00-04:00,424.01,424.04,422.12,422.16,NaN,NaN,NaN,428.3729173381401,NaN,NaN,426.1299999999984,432.29827366495147,419.96172633504534,421.73888257087407,426.9823151062306,429.3594467641049,424.6051834483563,96054,110649.06666666667,40.548026340378684,42.967507901248766,NaN,NaN,NaN,NaN,2.0262811591542382,25.85199201015757,108651152,-0.48367104578551934,-1.1763747536415394,-0.6927037078560201
2025-09-18T12:30:00-04:00,422.3,423.11,421.79,423.11,NaN,NaN,NaN,428.3729173381401,NaN,NaN,426.2853999999985,431.7045057717452,420.86629422825183,421.73888257087407,426.92275195468505,429.33646529600554,424.50903861336457,69306,107776.76666666666,43.83809512017215,42.594541926384814,NaN,NaN,NaN,NaN,1.975832504928935,25.939204942488637,108720458,-0.3755462523596227,-1.1621365233055485,-0.7865902709459258
2025-09-18T12:35:00-04:00,423.05,424.81,422.95,424.36,NaN,NaN,NaN,428.3729173381401,NaN,NaN,426.3795999999984,431.4889544959936,421.2702455040032,421.73888257087407,426.88705768575176,429.30687131202023,424.4672440594833,62908,105856.3,47.92189946743013,43.05227518451884,NaN,NaN,NaN,NaN,1.9675587545768691,24.676695216648636,108783366,-0.2011456983307054,-1.0380223938593076,-0.8368766955286022
2025-09-18T12:40:00-04:00,424.38,425.31,424.14,425.1,NaN,NaN,NaN,428.3729173381401,NaN,NaN,426.43699999999836,431.4215541431401,421.4524458568566,421.73888257087407,426.86214330347553,429.27751350265504,424.446773104296,62908,104575.5,50.229199709470244,43.40194842963768,NaN,NaN,NaN,NaN,1.9105902721070938,23.15804744422902,108846274,-0.026435703569074875,-0.8699213249899458,-0.8434856214208709
2025-09-18T12:45:00-04:00,425.13,425.8,424.77,424.91,NaN,NaN,NaN,428.3729173381401,NaN,NaN,426.4589999999984,431.4065541437751,421.5114458562217,421.9245889728815,426.839101420824,429.2461178161455,424.43208502550254,70583,101754.03333333334,49.621311418115255,43.519423503723836,NaN,NaN,NaN,NaN,1.8476909669565893,21.59330108961541,108775691,0.08001948099439704,-0.7434612701778747,-0.8234807511722717
2025-09-18T12:50:00-04:00,424.89,425.44,424.55,424.9,NaN,NaN,NaN,428.3729173381401,NaN,NaN,426.51799999999844,431.31719993389055,421.7188000661063,421.9245889728815,426.8185622375507,429.22031013590197,424.4168143391994,57725,100578.13333333333,49.587296531029786,44.055776667321496,NaN,NaN,NaN,NaN,1.779284469316832,20.115970686908497,108717966,0.14941811506110037,-0.6367081073458962,-0.7861262224069966
2025-09-18T12:55:00-04:00,424.86,425.22,424.68,425.08,NaN,NaN,NaN,428.3729173381401,NaN,NaN,426.5595999999984,431.2713639335729,421.8478360664239,422.11373694264415,426.80151458247,429.1984587564488,424.4045704084912,49703,98969.23333333334,50.24839339051373,44.440697860703686,NaN,NaN,NaN,NaN,1.6907641500799167,18.744163884394933,108767669,0.20373723212450545,-0.5314546822513648,-0.7351919143758703
2025-09-18T13:00:00-04:00,425.08,425.85,425.07,425.67,NaN,NaN,NaN,428.3729173381401,NaN,NaN,426.55719999999843,431.2706514578493,421.8437485421476,422.9749895541153,426.78862023602403,429.17678005613413,424.4004604159139,54518,96940.66666666667,52.449516015227815,45.14412502865998,NaN,NaN,NaN,NaN,1.6257095679313533,17.817607088792954,108822187,0.2714581859959102,-0.3958691818809825,-0.6673273678768927
2025-09-18T13:05:00-04:00,425.65,426.31,425.05,425.07,NaN,NaN,NaN,428.3729173381401,NaN,NaN,426.51599999999837,431.2446919973432,421.78730800265356,423.37999164329227,426.7740133507168,429.15282790015186,424.39519880128177,60529,95043.56666666667,50.02562242094927,45.500533304709826,NaN,NaN,NaN,NaN,1.599587455936256,17.29038477403251,108761658,0.2674673791770481,-0.33299314390558266,-0.6004605230826308
2025-09-18T13:10:00-04:00,425.09,425.71,424.06,424.4,NaN,NaN,NaN,428.3729173381401,NaN,NaN,426.4805999999984,431.24548557739286,421.7157144226039,423.37999164329227,426.74212413512697,429.1159690056094,424.36827926464457,85877,92770.76666666666,47.391817147927654,45.71847169337558,NaN,NaN,NaN,NaN,1.6031883519408077,16.121734966114452,108675781,0.21366138600569629,-0.3333837905755104,-0.5470451765812067
2025-09-18T13:15:00-04:00,424.42,424.45,422.78,423.18,NaN,NaN,NaN,428.3729173381401,NaN,NaN,426.4067999999984,431.25878258918067,421.5548174108161,423.37999164329227,426.6888609425786,429.07943791140474,424.2982839737524,91381,89953.06666666667,42.95682321720756,46.300687743580006,NaN,NaN,NaN,NaN,1.6079606125164656,15.923518485118333,108584400,0.095866105563709,-0.42721254462657043,-0.5230786501902794
2025-09-18T13:20:00-04:00,423.28,424.48,422.9,423.92,NaN,NaN,NaN,428.3729173381401,NaN,NaN,426.3385999999984,431.232441044194,421.4447589558028,423.37999164329227,426.6557735863611,429.05280155535036,424.2587456173718,64292,88036.23333333334,46.24293113333905,46.882573429192306,NaN,NaN,NaN,NaN,1.6059634259081494,15.713927959788663,108648692,0.06900272562358589,-0.43682524316079707,-0.505827968784383
2025-09-18T13:25:00-04:00,423.91,423.97,423.29,423.43,NaN,NaN,NaN,428.3729173381401,NaN,NaN,426.2577999999984,431.2073410540667,421.30825894593005,423.37999164329227,426.6288662106222,429.0326621087552,424.22507031248927,49839,86911,44.41824344578556,47.20017324725659,NaN,NaN,NaN,NaN,1.539823181200425,15.519308186268255,108598853,0.021888924375157992,-0.4784668133154355,-0.5003557376905935
2025-09-18T13:30:00-04:00,423.44,423.76,422.56,423.4,NaN,NaN,NaN,428.25224344210557,NaN,NaN,426.1927999999984,431.2049963893954,421.1806036106014,423.37999164329227,426.5988241798191,429.0129320949424,424.18471626469574,51232,85988.23333333334,44.30298148600259,47.127296917396386,NaN,NaN,NaN,NaN,1.5155500968289652,15.84651397284141,108547621,-0.006141429250331787,-0.5080325242535082,-0.5018910950031764
2025-09-18T13:35:00-04:00,423.42,423.52,422.02,423.1,NaN,NaN,NaN,427.8353232856462,NaN,NaN,426.1421999999984,431.2266630636637,421.05773693633313,423.37999164329227,426.55205916911655,428.986469489322,424.1176488489111,73600,85219.73333333334,43.09857735180435,47.30947913249822,NaN,NaN,NaN,NaN,1.5144393756268963,16.499195049009778,108474021,-0.03795802182978403,-0.5493386222904064,-0.5113806004606224
2025-09-18T13:40:00-04:00,423.04,423.36,422.6,422.74,NaN,NaN,NaN,427.8353232856462,NaN,NaN,425.99879999999837,431.0544703062912,420.94312969370554,423.37999164329227,426.5293724250207,428.97311494304904,424.0856299069924,36585,82987.93333333333,41.6358198516716,47.15217375617675,NaN,NaN,NaN,NaN,1.4605508487964032,17.105256048308977,108437436,-0.07422242309569649,-0.604158629330243,-0.5299362062345465
2025-09-18T13:45:00-04:00,422.78,423.29,421.94,422.66,NaN,NaN,NaN,427.51332142349173,NaN,NaN,425.9767999999984,431.0805922220612,420.8730077779355,423.37999164329227,426.4812824667565,428.94774468553146,424.01482024798156,73539,81174.5,41.30036394198363,46.679206932930576,NaN,NaN,NaN,NaN,1.452654359596662,18.095270413988423,108363897,-0.09333547105465423,-0.6466055450528643,-0.55327007399821
2025-09-18T13:50:00-04:00,422.64,423.77,422.1,423.74,NaN,NaN,NaN,427.51332142349173,NaN,NaN,425.93939999999844,431.08066429642446,420.7981357035724,423.37999164329227,426.4539102524552,428.92809945096775,423.9797210539427,50212,80289.13333333333,47.45520040831097,46.48106412570491,NaN,NaN,NaN,NaN,1.4681790481968975,18.46470954464145,108414109,-0.026455225034063945,-0.58633910529079,-0.5598838802567261
2025-09-18T13:55:00-04:00,423.7,423.97,423.19,423.53,NaN,NaN,NaN,427.51332142349173,NaN,NaN,425.86899999999844,431.04379622842373,420.69420377157314,422.5409933146338,426.4319052634601,428.9094309063151,423.95437962060515,46127,76236.36666666667,46.4356404472502,46.25351619921455,NaN,NaN,NaN,NaN,1.4190234018971213,18.581498557816804,108367982,0.008553489159605965,-0.5491920188072186,-0.5577455079668245
2025-09-18T14:00:00-04:00,423.53,424.28,423.37,424.06,NaN,NaN,NaN,427.51332142349173,NaN,NaN,425.7905999999984,430.9538569726683,420.6273430273285,421.41812112085864,426.4106733954608,428.88854107859845,423.9328057123231,51309,74088.46666666666,49.39092059174292,46.23948934640835,NaN,NaN,NaN,NaN,1.382664587475896,18.337103334703944,108419291,0.06895610610425518,-0.47155037533650557,-0.5405064814407607
2025-09-18T14:05:00-04:00,424.09,424.84,424.07,424.65,NaN,NaN,NaN,427.51332142349173,NaN,NaN,425.7235999999984,430.85729537136206,420.5899046286347,422.16049689668694,426.3963913926521,428.8703047070902,423.922478078214,46510,73502.66666666667,52.5306813883863,46.40250991768496,NaN,NaN,NaN,NaN,1.3396171169419016,17.500739355211252,108465801,0.14578061925556296,-0.358280707371307,-0.50406132662687
2025-09-18T14:10:00-04:00,424.62,424.62,423.12,423.32,NaN,NaN,NaN,427.51332142349173,NaN,NaN,425.63039999999836,430.7660556899806,420.49474431001613,422.16049689668694,426.38125163492793,428.8564985808187,423.90600468903716,34594,71007.46666666666,45.65465543605897,45.91716273345862,NaN,NaN,NaN,NaN,1.3532158943031922,17.519221909977055,108431207,0.10600861282878382,-0.3715505605908902,-0.477559173419674
2025-09-18T14:15:00-04:00,423.389,423.71,422.72,422.96,NaN,NaN,NaN,427.51332142349173,NaN,NaN,425.51199999999835,430.6153886787222,420.4086113212745,422.16049689668694,426.3491956851465,428.8330704252381,423.865320945055,61655,71147.03333333334,43.97669169837574,45.48509625327479,NaN,NaN,NaN,NaN,1.3272719018529606,17.83765088434947,108369552,0.05690259990849106,-0.4064309235340602,-0.46333352344255124
2025-09-18T14:20:00-04:00,422.97,423.65,422.67,423.53,NaN,NaN,NaN,427.51332142349173,NaN,NaN,425.4195999999984,430.4958158509841,420.3433841490127,422.16049689668694,426.33024371405276,428.8180621159513,423.8424253121542,38896,69576.36666666667,47.28057862123782,45.47715064422552,NaN,NaN,NaN,NaN,1.3024667660063176,18.171546364377726,108408448,0.06374116570410221,-0.38365706631242347,-0.4473982320165257
2025-09-18T14:25:00-04:00,423.52,423.6,423,423.23,NaN,NaN,NaN,427.51332142349173,NaN,NaN,425.30519999999837,430.315396387953,420.29500361204373,422.16049689668694,426.3172515910503,428.80771551445025,423.82678766765036,26886,67747.03333333334,45.751285254002575,45.67675507542516,NaN,NaN,NaN,NaN,1.2522905684344394,18.481592167261105,108381562,0.049619574161466284,-0.38537376431469283,-0.4349933384761591
2025-09-18T14:30:00-04:00,423.24,423.82,423.22,423.51,NaN,NaN,NaN,427.51332142349173,NaN,NaN,425.18839999999835,430.08702080243074,420.28977919756596,422.16049689668694,426.30244912286,428.79460967563426,423.8102885700858,33577,66196.83333333333,47.45942844837602,45.763647740784954,NaN,NaN,NaN,NaN,1.2056983849748342,18.47366480339101,108415139,0.06000199119608679,-0.35999084948105065,-0.41999284067713744
2025-09-18T14:35:00-04:00,423.55,423.77,423,423.02,NaN,NaN,NaN,427.5056813125214,NaN,NaN,425.06999999999834,429.8856627795097,420.254337220487,422.16049689668694,426.2873582096916,428.7824852797796,423.7922311396036,31702,60109.933333333334,44.80088277837337,45.79097912168408,NaN,NaN,NaN,NaN,1.1745770717623447,18.67111782628808,108383437,0.035922424813678355,-0.37508980966003946,-0.4110122344737178
2025-09-18T14:40:00-04:00,423.18,423.33,422.6,423.12,NaN,NaN,NaN,426.9979230710432,NaN,NaN,424.9695999999983,429.7341036851814,420.2050963148152,422.16049689668694,426.2623374086098,428.764185138856,423.7604896783636,49217,58288.333333333336,45.47220062944367,45.87449477478702,NaN,NaN,NaN,NaN,1.1428215666364603,19.216513004903746,108432654,0.029075592704329023,-0.37466774359330657,-0.4037433362976356
2025-09-18T14:45:00-04:00,423.15,423.76,422.94,423.44,NaN,NaN,NaN,426.9979230710432,NaN,NaN,424.87639999999834,429.5741624637601,420.1786375362366,422.16049689668694,426.2370350139307,428.7423464875619,423.7317235402995,56977,57499.86666666667,47.665601260645396,46.20071076827566,NaN,NaN,NaN,NaN,1.1197628833052842,19.097405589479937,108489631,0.04736244371957676,-0.34454028164816464,-0.3919027253677414
2025-09-18T14:50:00-04:00,423.48,423.94,423.38,423.57,NaN,NaN,NaN,426.9979230710432,NaN,NaN,424.73939999999834,429.17470275922966,420.304097240767,422.16049689668694,426.2216148598161,428.72749270588713,423.71573701374507,38619,55895.333333333336,48.57068505748332,46.696058282976495,NaN,NaN,NaN,NaN,1.0797798202120499,18.73231415045426,108528250,0.06821066873403547,-0.3066393894501971,-0.37485005818423256
2025-09-18T14:55:00-04:00,423.55,424.76,423.47,424.28,NaN,NaN,NaN,426.9979230710432,NaN,NaN,424.59459999999825,428.5854399324578,420.6037600675387,422.53088311592353,426.2038292563004,428.7060602334957,423.70159827910516,57097,54596.76666666667,53.31901850802927,47.55453360912261,NaN,NaN,NaN,NaN,1.0947955473397581,17.449248109748552,108585347,0.12643019404650574,-0.21681231562610037,-0.3432425096726061
2025-09-18T15:00:00-04:00,424.35,424.4,423,423.6,NaN,NaN,NaN,426.9979230710432,NaN,NaN,424.4865999999983,428.28221349008805,420.69098650990856,422.53088311592353,426.1777288362507,428.68018553679065,423.67527213571077,68459,54568.53333333333,48.683020571071445,47.64223504931979,NaN,NaN,NaN,NaN,1.1165958653869166,16.680498649200512,108516888,0.11602664997025136,-0.1982091972097919,-0.31423584718004327
2025-09-18T15:05:00-04:00,423.615,423.93,422.91,423.45,NaN,NaN,NaN,426.9979230710432,NaN,NaN,424.3721999999983,427.9338789083182,420.8105210916784,422.53088311592353,426.1497116633334,428.65463378496827,423.6447895416985,68554,54756.73333333333,47.69781557076747,47.7323904152853,NaN,NaN,NaN,NaN,1.1096961607164213,16.066833546482968,108448334,0.09671578004072201,-0.19334112212914079,-0.2900569021698628
2025-09-18T15:10:00-04:00,423.51,423.68,422.47,422.66,NaN,NaN,NaN,426.90242314294767,NaN,NaN,424.2335999999983,427.4993636421112,420.96783635788546,422.53088311592353,426.1140376494776,428.62766410757416,423.60041119138106,75486,55176,42.786717809993746,47.26066164516037,NaN,NaN,NaN,NaN,1.116860720665247,15.978393390384296,108372848,0.03177053887180581,-0.25034372858010556,-0.28211426745191137
2025-09-18T15:15:00-04:00,422.61,422.67,420,421.85,NaN,NaN,NaN,425.35254027281366,NaN,NaN,424.0797999999984,427.0416385921323,421.11796140786447,422.53088311592353,425.96390161613573,428.5680560861889,423.35974714608255,229008,60456.833333333336,38.4188719007113,46.252675253183575,NaN,NaN,NaN,NaN,1.2277992406177307,17.76480205886732,108143840,-0.059721670007267746,-0.35676635496099607,-0.2970446849537283
2025-09-18T15:20:00-04:00,421.86,422.37,421.58,422.19,NaN,NaN,NaN,425.35254027281366,NaN,NaN,423.95939999999825,426.7226456579912,421.1961543420053,422.53088311592353,425.93164889675637,428.5491066302756,423.3141911632371,58344,60477.46666666667,41.13526196379001,45.9298614337358,NaN,NaN,NaN,NaN,1.1965278662878944,19.42361010817299,108202184,-0.08953040001697776,-0.40895768497495055,-0.3194272849579728
2025-09-18T15:25:00-04:00,422.2,422.71,421.45,422.44,NaN,NaN,NaN,425.35254027281366,NaN,NaN,423.8355999999983,426.2878941434768,421.38330585651977,422.53088311592353,425.89156858770446,428.5231952971478,423.2599418782611,76936,61385.23333333333,43.12197338195263,45.86881012541986,NaN,NaN,NaN,NaN,1.2010615901244728,20.49322360651029,108279120,-0.08465402944705869,-0.4252448217667961,-0.34059079231973743
2025-09-18T15:30:00-04:00,422.41,422.48,420.85,421.05,NaN,NaN,NaN,425.35254027281366,NaN,NaN,423.7105999999983,426.07953363479766,421.34166636519893,422.53088311592353,425.8523815551487,428.5049923026494,423.19977080764806,63906,61698.166666666664,35.87258009850163,45.05395308808156,NaN,NaN,NaN,NaN,1.2317000479727243,21.868716908597673,108215214,-0.16276136220313342,-0.5440424950736542,-0.3812811328705208
2025-09-18T15:35:00-04:00,421.12,421.51,420.33,420.35,NaN,NaN,NaN,424.87871721448784,NaN,NaN,423.62279999999834,426.15256849650547,421.0930315034912,422.53088311592353,425.7954523421178,428.4873875853298,423.1035170989058,81222,62387.933333333334,32.87521555180486,44.13423382363886,NaN,NaN,NaN,NaN,1.2280071874032445,23.45046222495839,108133992,-0.24438160299119327,-0.6867581366095123,-0.4423765336183191
2025-09-18T15:40:00-04:00,420.39,420.87,418.7,419.54,NaN,NaN,NaN,423.8596846138293,NaN,NaN,423.49719999999826,426.1960798873417,420.79832011265484,422.53088311592353,425.6556388892378,428.46854148719046,422.8427362912852,171662,65247.433333333334,29.774945083096085,42.87105644040458,NaN,NaN,NaN,NaN,1.295292388303014,25.690251034080617,107962330,-0.33038794649758896,-0.8553614667403053,-0.5249735202427164
2025-09-18T15:45:00-04:00,419.51,419.74,418.53,418.93,NaN,NaN,NaN,423.18947167683706,NaN,NaN,423.3437999999982,426.18780813051376,420.4997918694827,421.9167064927388,425.56940816417165,428.46243534524945,422.67638098309385,99188,65507.666666666664,27.65948622817767,41.64667097253346,NaN,NaN,NaN,NaN,1.2892000748528012,27.838476128498264,107863142,-0.40111826584539556,-1.0263713525494609,-0.6252530867040653
2025-09-18T15:50:00-04:00,418.87,419.15,417.5,418.77,NaN,NaN,NaN,422.42017750970814,NaN,NaN,423.22919999999823,426.32798644735385,420.1304135526426,421.4333651941911,425.404910726541,428.4570924418662,422.3527290112158,179863,69360.03333333334,27.11530575902033,40.33546419607465,NaN,NaN,NaN,NaN,1.3149714980775993,30.217142610546954,107683279,-0.42893389059612286,-1.161420449949219,-0.732486559353096
2025-09-18T15:55:00-04:00,418.71,419.08,416.57,416.66,NaN,NaN,NaN,422.07630580472136,NaN,NaN,423.05639999999823,426.60496762178406,419.5078323782124,421.0776921553529,425.20114175642846,428.4660678591081,421.93621565374883,203623,74486.16666666667,21.19355836015049,38.44460398889644,NaN,NaN,NaN,NaN,1.4003306767863415,32.719182172229374,107479656,-0.5518600925000179,-1.4223116749781184,-0.8704515824781005
2025-09-19T09:30:00-04:00,421.955,425.51,421.75,424.8,418.3651171864023,418.3651171864023,418.3651171864023,NaN,NaN,NaN,423.06279999999833,426.622750652196,419.5028493478007,419.57721838354064,424.02,424.02,424.02,430989,87144.73333333334,58.68217689547783,39.16685340589605,NaN,NaN,NaN,NaN,1.9324499141587432,30.91881294575895,107910645,-0.07256691202400989,-0.9611602225081128,-0.888593310484103
2025-09-19T09:35:00-04:00,424.76,426.29,423.17,426,419.27897549611134,NaN,NaN,NaN,NaN,NaN,423.0797999999983,426.68725780935273,419.4723421906438,419.57721838354064,424.4694488975384,425.02385949058174,423.9150383044951,283246,94132.93333333333,61.583505850591315,39.75717393036477,NaN,NaN,NaN,NaN,2.017274920290262,29.606366877803747,108193891,0.31633117766117946,-0.4931793384076286,-0.8095105160688081
2025-09-19T09:40:00-04:00,426.04,428.15,425.59,425.69,421.31765842810626,NaN,NaN,NaN,NaN,NaN,423.0951999999983,426.7403265885129,419.45007341148363,420.64590625071867,425.04529875053714,426.06678910478865,424.02380839628563,287342,102491.5,60.40349303140518,40.59435053467432,NaN,NaN,NaN,NaN,2.056040997412386,29.153294843086613,107906549,0.5310990400919163,-0.1456367159539127,-0.676735756045829
2025-09-19T09:45:00-04:00,425.73,426.39,424.35,426.36,421.31765842810626,NaN,NaN,NaN,NaN,NaN,423.1997999999983,426.9128763318564,419.48672366814014,420.64590625071867,425.14452742079544,426.11427675561885,424.17477808597204,178920,106004.2,62.094041368672464,41.622652377381826,NaN,NaN,NaN,NaN,2.054895211882927,28.02049995164298,108085469,0.6867977917056917,0.18176148358628552,-0.5050363081194061
2025-09-19T09:50:00-04:00,426.37,428.42,425.78,428.15,421.415407782634,NaN,NaN,NaN,NaN,NaN,423.3227999999983,427.2688887782722,419.37671122172446,421.48138000046,425.5214397833538,426.75171110547706,424.29116846123054,230713,112020.9,66.24094471609813,43.29795429924642,NaN,NaN,NaN,NaN,2.0966884110341497,27.741504860327904,108316182,0.867221615562157,0.5789907113332902,-0.2882309042288669
2025-09-19T09:55:00-04:00,428.1,428.62,426.71,427.77,421.97834379251424,NaN,NaN,NaN,NaN,NaN,423.4281999999984,427.5579974581879,419.2984025418089,422.11410400036794,425.72582529169927,427.05813989158753,424.393510691811,146102,115353.4,64.62461612796444,45.169793172621645,NaN,NaN,NaN,NaN,2.083353524531712,27.553270305481774,108170080,0.9132236167462668,0.8532986167039667,-0.05992500004230017
2025-09-19T10:00:00-04:00,427.75,428.42,427.24,428.17,422.2409190746727,NaN,NaN,NaN,NaN,NaN,423.51159999999834,427.8474991877086,419.1757008122881,422.62528320029435,425.9070015864041,427.3208509205461,424.49315225226206,138557,118261.66666666667,65.5767885514039,46.91561650030834,NaN,NaN,NaN,NaN,2.0188282727794475,27.378481075981796,108308637,0.9202574791750422,1.0903968489265026,0.17013936975146038
2025-09-19T10:05:00-04:00,428.11,429.47,427.01,427.49,422.5695136621876,NaN,NaN,NaN,NaN,NaN,423.6181999999983,428.07629769365997,419.1601023063366,423.6042265602355,426.10802251736055,427.58598567296735,424.63005936175375,181142,122749.4,62.49709249874875,48.29955358007949,NaN,NaN,NaN,NaN,2.0503405390094893,27.61045074342926,108127495,0.8314776106118018,1.2094863830162126,0.37800877240441083
2025-09-19T10:10:00-04:00,427.37,428.3,426.31,427.62,422.5695136621876,NaN,NaN,NaN,NaN,NaN,423.7083999999983,428.30215464801785,419.1146453519787,423.6042265602355,426.19263807920765,427.65736339106326,424.72791276735205,130466,125945.13333333333,62.856231686951936,50.2269572649688,NaN,NaN,NaN,NaN,2.046030500508812,27.356948679112765,108257961,0.7370947411221687,1.2993771988071217,0.562282457684953
2025-09-19T10:15:00-04:00,427.7,428.37,426.63,426.72,422.5695136621876,NaN,NaN,NaN,NaN,NaN,423.75559999999837,428.42307068185374,419.088129318143,423.6042265602355,426.23993437711624,427.6876352163382,424.7922335378943,94940,127054.63333333333,58.667529362379156,52.069265394295535,NaN,NaN,NaN,NaN,2.024171179043898,27.15075208255803,108163021,0.5767355434328165,1.2832018869759736,0.7064663435431571
2025-09-19T10:20:00-04:00,426.7,427.44,425.9,426.45,422.5695136621876,NaN,NaN,NaN,NaN,NaN,423.78259999999835,428.4962564327531,419.0689435672436,423.6042265602355,426.25535465881023,427.67327749059007,424.8374318270304,94986,128924.3,57.43105841899511,54.04470206114547,NaN,NaN,NaN,NaN,1.9895875233979066,26.45243784595559,108068035,0.42232058676570305,1.234367077000286,0.8120464902345829
2025-09-19T10:25:00-04:00,426.48,427.46,425.9,426.86,422.5695136621876,NaN,NaN,NaN,NaN,NaN,423.82159999999834,428.60369386838823,419.03950613160845,423.6042265602355,426.27300989543585,427.66782490315,424.8781948877217,83076,130797.3,58.84935652301944,56.27254993934845,NaN,NaN,NaN,NaN,1.9589027002980564,25.81391351220592,108151111,0.32215950975142627,1.2147458774238657,0.8925863676724395
2025-09-19T10:30:00-04:00,426.77,427.36,426.35,426.56,422.5695136621876,NaN,NaN,NaN,NaN,NaN,423.85479999999836,428.6891442002052,419.02045579979153,423.6042265602355,426.2890998372868,427.6632578532918,424.91494182128184,78476,132293.93333333332,57.343846765333744,58.431731439799414,NaN,NaN,NaN,NaN,1.8911239359910517,25.220998059438372,108072635,0.2152095145972881,1.1615982609190496,0.9463887463217615
2025-09-19T10:35:00-04:00,426.53,427.4,425.9,426.71,422.5695136621876,NaN,NaN,NaN,NaN,NaN,423.88739999999837,428.77603140009796,418.99876859989877,423.6042265602355,426.30349076520355,427.6533951035849,424.9535864268222,92624,134324.66666666666,57.92345772322338,61.0552956800189,NaN,NaN,NaN,NaN,1.8631865119916908,24.31807424529637,108165259,0.13783829525045588,1.1186866153848314,0.9808483201343755
2025-09-19T10:40:00-04:00,426.7,427.35,425.24,425.25,422.5695136621876,NaN,NaN,NaN,NaN,NaN,423.8789999999983,428.7567818735796,419.00121812641703,423.6042265602355,426.29225673627076,427.62220175836904,424.9623117141725,79693,135340.53333333333,50.7019796587086,60.485281591678245,NaN,NaN,NaN,NaN,1.8808160468494282,22.979615087208664,108085566,-0.01999819339156772,0.9558505783949158,0.9758487717864835
2025-09-19T10:45:00-04:00,425.25,425.69,424.46,425.47,422.5695136621876,NaN,NaN,NaN,NaN,NaN,423.88699999999835,428.77387262019437,419.00012737980234,423.6042265602355,426.2363822604209,427.5536719785981,424.9190925422437,137352,138019.7,51.67957003114754,59.77785760457512,NaN,NaN,NaN,NaN,1.8343291863601845,21.49272768736448,108222918,-0.11273544926778734,0.8349294602017494,0.9476649094695367
2025-09-19T10:50:00-04:00,425.42,425.55,424.32,425.43,422.5695136621876,NaN,NaN,NaN,NaN,NaN,423.90759999999835,428.8116025454804,419.0035974545163,423.6042265602355,426.1787459095255,427.48619252394855,424.87129929510246,142582,141485.13333333333,51.47968268987826,59.140442580180334,NaN,NaN,NaN,NaN,1.791162815905887,20.209725077665784,108080336,-0.17614397273372273,0.7274849435523834,0.9036289162861061
2025-09-19T10:55:00-04:00,425.46,425.93,424.49,424.59,422.5695136621876,NaN,NaN,NaN,NaN,NaN,423.93579999999844,428.8389583133486,419.0326416866483,423.1324890874063,426.1342460842655,427.43617751032133,424.83231465820967,110617,143269.13333333333,47.33884651028393,58.086500090295445,NaN,NaN,NaN,NaN,1.7660797576268947,18.804259818649275,107969719,-0.2684984986491685,0.5680057929746454,0.8365042916238139
2025-09-19T11:00:00-04:00,424.61,424.78,423.36,423.61,422.5695136621876,NaN,NaN,NaN,NaN,NaN,423.9295999999984,428.8336064606305,419.0255935393663,423.1324890874063,426.0523463585015,427.3967184336777,424.7079742833253,112047,144722.06666666668,42.993844858638425,56.425992957619755,NaN,NaN,NaN,NaN,1.7413597749392564,18.224893943091665,107857672,-0.3824769518100106,0.35840810186130057,0.7408850536713112
2025-09-19T11:05:00-04:00,423.68,424.22,423.42,423.73,422.5695136621876,NaN,NaN,NaN,NaN,NaN,423.9355999999984,428.83788054746157,419.0333194525352,423.1324890874063,425.9747707125415,427.3585509997335,424.5909904253495,107725,146027.76666666666,43.675569415154094,54.92963247813329,NaN,NaN,NaN,NaN,1.6741197910150247,17.6869113443596,107965397,-0.43296275224824243,0.1996816133610082,0.6326443656092506
2025-09-19T11:10:00-04:00,423.72,424,422.57,422.89,422.5695136621876,NaN,NaN,NaN,NaN,NaN,423.92539999999843,428.8342136413723,419.0165863586246,423.1324890874063,425.87129907328426,427.3293307306011,424.4132674159674,119599,147498.2,40.063784481578594,53.107275044574344,NaN,NaN,NaN,NaN,1.6566826630853806,17.753626111904005,107845798,-0.5012841865074948,0.006039132474882081,0.5073233189823769
2025-09-19T11:15:00-04:00,422.91,424.58,422.86,424.5,422.5695136621876,NaN,NaN,NaN,NaN,NaN,423.95339999999834,428.85903204553097,419.0477679544657,423.1324890874063,425.8240267179225,427.2936840823653,424.3543693534797,83602,142651.33333333334,48.80277041716908,52.12910918160437,NaN,NaN,NaN,NaN,1.6612053300078513,17.296716258917716,107929400,-0.419707323618676,-0.017310835540968128,0.4023964880777079
2025-09-19T11:20:00-04:00,424.39,425.1,423.77,423.92,422.5695136621876,NaN,NaN,NaN,NaN,NaN,423.9769999999984,428.8703935061529,419.0836064938439,423.1324890874063,425.78173185978727,427.2533228463767,424.31014087319784,93169,143812.16666666666,46.18997018555671,50.93866193150472,NaN,NaN,NaN,NaN,1.6375478064358648,16.428407095387247,107836231,-0.38725759191423376,-0.08167550181508432,0.30558209009914944
2025-09-19T11:25:00-04:00,423.92,424.01,422.97,423.88,422.5695136621876,NaN,NaN,NaN,NaN,NaN,424.00139999999834,428.8804277890363,419.1223722109604,422.8809912699251,425.73526929371,427.2243346366284,424.24620395079165,75516,143764.83333333334,46.00703272995876,50.03434074347469,NaN,NaN,NaN,NaN,1.5948658202618717,16.195754923245737,107760715,-0.35195668599434293,-0.1343637673937792,0.2175929186005637
2025-09-19T11:30:00-04:00,423.87,423.92,422.97,423.6,422.5695136621876,NaN,NaN,NaN,NaN,NaN,423.9985999999983,428.8783852582102,419.1188147417864,422.03626753020166,425.70083119323755,427.2038655270974,424.1977968593777,54895,143464.46666666667,44.67324959807145,49.123068684837286,NaN,NaN,NaN,NaN,1.5488039759574515,15.979720763400046,107705820,-0.3312333099682557,-0.1964487188597559,0.13478459110849977
2025-09-19T11:35:00-04:00,423.65,424.51,423.5,423.83,422.5695136621876,NaN,NaN,NaN,NaN,NaN,424.00459999999833,428.8828032928288,419.1263967071679,422.03626753020166,425.6761914546985,427.1828416462163,424.1695412631807,50837,142451.63333333333,46.0566670844679,48.20930515351217,NaN,NaN,NaN,NaN,1.5103179776747757,15.233284400200967,107756657,-0.28743124461895,-0.2245044646651877,0.06292677995376228
2025-09-19T11:40:00-04:00,423.85,424.97,423.68,424.895,422.5695136621876,NaN,NaN,NaN,NaN,NaN,424.02129999999835,428.9058604966924,419.1367395033043,422.03626753020166,425.6522111905796,427.15234011352385,424.1520822676353,76318,139273.5,52.03706772769465,47.83024950796653,NaN,NaN,NaN,NaN,1.494580979269436,14.154646394803391,107832975,-0.17751721731981948,-0.15896974169601208,0.018547475623807402
2025-09-19T11:45:00-04:00,424.89,424.93,424.03,424.09,422.5695136621876,NaN,NaN,NaN,NaN,NaN,424.0100999999984,428.8914098617013,419.12879013829547,422.0108208006911,425.63291537482826,427.1301782298705,424.135652519786,55583,137820,47.72969805080881,47.102123817079764,NaN,NaN,NaN,NaN,1.4521109093216216,13.153053961219928,107777392,-0.15086180170020683,-0.17002977650145112,-0.019167974801244304
2025-09-19T11:50:00-04:00,424.05,424.09,423.49,423.9,422.5695136621876,NaN,NaN,NaN,NaN,NaN,424.0216999999983,428.89914999422643,419.1442500057702,422.0108208006911,425.60899132746636,427.11057167376197,424.10741098117074,50351,133502.93333333332,46.7461677432964,46.819565823121756,NaN,NaN,NaN,NaN,1.3912458443700746,12.690980917232286,107727041,-0.13819688401653513,-0.19191407982191322,-0.05371719580537809
2025-09-19T11:55:00-04:00,423.84,424.12,423.13,423.82,422.5695136621876,NaN,NaN,NaN,NaN,NaN,424.0388999999983,428.90730971632365,419.17049028367296,422.0108208006911,425.57718905697874,427.08629274679856,424.0680853671589,64061,128850.86666666667,46.3134277293485,46.436269944421824,NaN,NaN,NaN,NaN,1.36258542691507,12.57249622738498,107662980,-0.1276299336379209,-0.21325461285277925,-0.08562467921485833
2025-09-19T12:00:00-04:00,423.84,424.95,423.54,424.95,422.5695136621876,NaN,NaN,NaN,NaN,NaN,424.06729999999834,428.9400689095413,419.19453109045537,422.16238024995386,425.56021260519304,427.06370678312203,424.05671842726406,60750,116509.56666666667,52.940229589934276,46.54059472299725,NaN,NaN,NaN,NaN,1.3659721821354196,11.708852459782003,107723730,-0.0414216178666162,-0.13740170154812859,-0.09598008368151238
2025-09-19T12:05:00-04:00,424.87,424.89,423.3,423.42,422.5695136621876,NaN,NaN,NaN,NaN,NaN,424.0710999999984,428.9415469164144,419.20065308358244,422.16238024995386,425.53230220153523,427.0388090292695,424.025795373801,65923,109265.46666666666,44.86517690829889,46.36390403714118,NaN,NaN,NaN,NaN,1.3862598834114592,11.062625800416678,107657807,-0.08198251955833338,-0.19845823312942912,-0.11647571357109573
2025-09-19T12:10:00-04:00,423.38,423.91,422.93,423.26,422.5695136621876,NaN,NaN,NaN,NaN,NaN,424.0660999999984,428.9393532425018,419.19284675749503,422.16238024995386,425.4945485717146,427.01452642959435,423.9745707138348,70831,102048.43333333333,44.107497992451066,46.443450689556364,NaN,NaN,NaN,NaN,1.357241320310642,10.805818114034613,107586976,-0.1122565871619906,-0.256796447523584,-0.1445398603615934
2025-09-19T12:15:00-04:00,423.2,423.45,422.34,422.44,NaN,NaN,NaN,427.21090864199164,427.21090864199164,427.21090864199164,424.05449999999837,428.94040309007147,419.16859690992527,422.16238024995386,425.4429936137599,426.9941932432463,423.8917939842735,77591,98670.8,40.34683954185449,46.205684270034965,NaN,NaN,NaN,NaN,1.3395812260027398,11.08392125615383,107509385,-0.17635985244937452,-0.36498967592331155,-0.18862982347393703
2025-09-19T12:20:00-04:00,422.45,423.33,421.88,422.59,NaN,NaN,NaN,426.92245824917387,NaN,NaN,424.0438999999984,428.9401554228319,419.14764457716495,422.16238024995386,425.38395307670714,426.97159797512853,423.79630817828576,87812,93907.43333333333,41.33224068216078,46.29628828436226,NaN,NaN,NaN,NaN,1.3474682812882575,11.717367741519144,107597197,-0.19600111069162957,-0.433631211838474,-0.2376301011468444
2025-09-19T12:25:00-04:00,422.59,423.23,422.31,422.74,NaN,NaN,NaN,426.92245824917387,NaN,NaN,424.02989999999846,428.9369734624071,419.12282653758984,422.16238024995386,425.34723076636084,426.95357733718123,423.74088419554045,60017,91037.93333333333,42.35767019347206,45.83592398266962,NaN,NaN,NaN,NaN,1.3169348326248116,12.30556804935836,107657214,-0.1862980908993141,-0.47050271477098704,-0.28420462387167295
2025-09-19T12:30:00-04:00,422.745,423.45,422.43,422.93,NaN,NaN,NaN,426.92245824917387,NaN,NaN,424.0170999999984,428.9322374716832,419.10196252831355,422.16238024995386,425.32255322916996,426.9389725559058,423.7061339024341,44356,87897.9,43.70000753716612,45.65806950778458,NaN,NaN,NaN,NaN,1.2957252017230378,12.568761544623202,107701570,-0.15573397687295515,-0.47887209496286687,-0.3231381180899117
2025-09-19T12:35:00-04:00,422.93,423.09,422.25,422.56,NaN,NaN,NaN,426.78669241600284,NaN,NaN,423.9826999999984,428.9140451355146,419.05135486448216,422.16238024995386,425.2850227690123,426.9208303532167,423.64921518480793,61324,83903.96666666666,41.66518621372717,45.34793761376803,NaN,NaN,NaN,NaN,1.263173401599962,12.982851764422945,107640246,-0.14907969699223966,-0.5094877393302113,-0.36040804233797163
2025-09-19T12:40:00-04:00,422.47,423.09,422.17,422.86,NaN,NaN,NaN,426.68502457891185,NaN,NaN,423.9678999999984,428.9081842393379,419.0276157606589,422.16238024995386,425.25109268793994,426.9024514489308,423.5997339269491,58596,81508.3,43.94431388940279,45.29587077743456,NaN,NaN,NaN,NaN,1.2386610157713904,13.445235314166673,107698842,-0.11466284874748656,-0.5037366032723298,-0.3890737545248433
2025-09-19T12:45:00-04:00,422.96,424.66,422.96,424.53,NaN,NaN,NaN,426.68502457891185,NaN,NaN,423.9894999999984,428.9299818596551,419.0490181403417,422.16238024995386,425.2287166070051,426.8726623777898,423.58477083622034,84528,81161.23333333334,54.582031226042226,45.90482535897558,NaN,NaN,NaN,NaN,1.2787566575020062,12.97331289644053,107783370,0.02304239069774139,-0.3602707661526665,-0.3833131568504079
2025-09-19T12:50:00-04:00,424.59,424.88,423.91,424.6,NaN,NaN,NaN,426.68502457891185,NaN,NaN,424.0282999999984,428.9568647449773,419.09973525501954,422.0072284884967,425.2115868968552,426.8409703064692,423.58220348724115,103871,81457.4,54.96779217881015,46.11416281976954,NaN,NaN,NaN,NaN,1.2567026105375751,12.749034378085478,107887241,0.11610727614228322,-0.23817906167255387,-0.3542863378148371
2025-09-19T12:55:00-04:00,424.6,424.64,423.62,423.8,NaN,NaN,NaN,426.68502457891185,NaN,NaN,424.06729999999834,428.95700723516865,419.17759276482803,422.0072284884967,425.19644009986786,426.8209283547674,423.57195184496834,59755,80680.03333333334,49.765491102272236,46.25957660915979,NaN,NaN,NaN,NaN,1.2397952812134612,12.198356874256493,107827486,0.12052783795936328,-0.203626540365633,-0.3241543783249963
2025-09-19T13:00:00-04:00,423.9,424.52,423.76,424.16,NaN,NaN,NaN,426.68502457891185,NaN,NaN,424.1066999999984,428.96692370322484,419.24647629677196,422.0072284884967,425.1859284973038,426.80563893878673,423.56621805582085,47547,79649.06666666667,51.96847228071932,46.63259836183285,NaN,NaN,NaN,NaN,1.2055241896982132,11.687013477843864,107875033,0.14290990460309982,-0.14551699757112146,-0.2884269021742213
2025-09-19T13:05:00-04:00,424.18,424.85,423.7,424.8,NaN,NaN,NaN,426.68502457891185,NaN,NaN,424.1538999999983,428.99426002437787,419.31353997561877,422.1737409861103,425.1783969852511,426.7914993580282,423.56529461247396,49098,78198.2,55.6888244654232,47.302269557266754,NaN,NaN,NaN,NaN,1.2015581761483431,11.58162199575501,107924131,0.19291981487055976,-0.04727713358602159,-0.24019694845658135
2025-09-19T13:10:00-04:00,424.76,424.76,424.06,424.22,NaN,NaN,NaN,426.68502457891185,NaN,NaN,424.2172999999984,428.9757262992436,419.45887370075314,422.24899278888824,425.1725212690964,426.7814244220474,423.56361811614545,34133,76679.53333333334,51.77492358221363,47.219033413858135,NaN,NaN,NaN,NaN,1.1685897349948908,11.4837584766725,107889998,0.17932746700808727,-0.016037614696472247,-0.19536508170455952
2025-09-19T13:15:00-04:00,424.22,424.4,423.74,424.01,NaN,NaN,NaN,426.68502457891185,NaN,NaN,424.29049999999836,428.91955443967436,419.66144556032236,422.24899278888824,425.16366913939305,426.7692887735821,423.558049505204,38405,73381.3,50.39391661266968,47.61394339274176,NaN,NaN,NaN,NaN,1.132261896780968,10.938525016102197,107851593,0.1497868013065792,-0.00813158007133552,-0.15791838137791472
2025-09-19T13:20:00-04:00,424,424.47,423.47,424.46,NaN,NaN,NaN,426.68502457891185,NaN,NaN,424.38889999999833,428.81454494346633,419.96325505653033,422.24899278888824,425.1522122349525,426.7525313165317,423.5518931533733,54762,70453.96666666666,53.27030328983682,48.26842948541218,NaN,NaN,NaN,NaN,1.12281461843947,10.251808584643284,107906355,0.1535768731641981,0.034052710077332904,-0.1195241630868652
2025-09-19T13:25:00-04:00,424.43,424.43,423.51,423.54,NaN,NaN,NaN,426.68502457891185,NaN,NaN,424.4810999999983,428.63152325138674,420.3306767486099,422.24899278888824,425.139688362301,426.7375833911582,423.5417933334438,46974,68332.53333333334,47.23946976025029,48.760760215297594,NaN,NaN,NaN,NaN,1.1104707171223642,9.614143326860006,107859381,0.09027909158113526,-0.006675298610446134,-0.09695439019158139
2025-09-19T13:30:00-04:00,423.59,424.24,423.52,423.81,NaN,NaN,NaN,426.68502457891185,NaN,NaN,424.58189999999826,428.4044734218945,420.759326578102,422.24899278888824,425.12909621213595,426.724611004399,423.5335814198729,41387,65977.2,49.06208078035879,49.31289165088317,NaN,NaN,NaN,NaN,1.0825799516136259,9.02202558748982,107900768,0.06398737310606528,-0.01697017380899979,-0.08095754691506507
2025-09-19T13:35:00-04:00,423.78,423.88,423.16,423.65,NaN,NaN,NaN,426.68502457891185,NaN,NaN,424.7216999999983,427.8173172963729,421.6260827036237,422.24899278888824,425.109794087241,426.7048287006198,423.5147594738622,62572,64472.1,48.00379892484931,49.71618656026725,NaN,NaN,NaN,NaN,1.0566813836412219,9.01227525473003,107838196,0.034681157779703486,-0.03760609969043571,-0.0722872574701392
2025-09-19T13:40:00-04:00,423.69,424.14,423.01,423.91,NaN,NaN,NaN,426.68502457891185,NaN,NaN,424.70389999999827,427.8077358793291,421.60006412066747,422.24899278888824,425.0945153164888,426.68772956548753,423.5013010674901,55085,62321.63333333333,49.895154411667846,50.158697051303086,NaN,NaN,NaN,NaN,1.0619184276668485,8.565771658946295,107893281,0.03174616789070975,-0.03260454760675202,-0.06435071549746177
2025-09-19T13:45:00-04:00,423.94,424.02,423.15,423.7,NaN,NaN,NaN,426.68502457891185,NaN,NaN,424.6578999999983,427.75169513957593,421.5641048604206,422.24899278888824,425.08293797334375,426.675186320531,423.4906896261565,40697,60891.46666666667,48.36490398523415,50.637248320696436,NaN,NaN,NaN,NaN,1.0482099685477881,8.151161177147111,107852584,0.01542735029759712,-0.04506652762546537,-0.06049387792306249
2025-09-19T13:50:00-04:00,423.67,424.08,423.52,423.82,NaN,NaN,NaN,426.68502457891185,NaN,NaN,424.6204999999983,427.708690571465,421.53230942853156,422.24899278888824,425.0728499627418,426.6628149611736,423.4828849643101,41203,59159.26666666667,49.32138317623508,51.02132469832732,NaN,NaN,NaN,NaN,1.013337827937232,7.657311408157992,107893787,0.01259993517904627,-0.04474395894925465,-0.05734389412830092
2025-09-19T13:55:00-04:00,423.9,424.09,423.31,424,NaN,NaN,NaN,426.68502457891185,NaN,NaN,424.57329999999826,427.62563393416923,421.5209660658273,422.24899278888824,425.06418430750506,426.65218082842904,423.4761877865811,35732,57833.13333333333,50.793785305163375,50.75073570397883,NaN,NaN,NaN,NaN,0.9966708402274278,7.57219329821531,107929519,0.022177229560400705,-0.02962235717780004,-0.051799586738200745
2025-09-19T14:00:00-04:00,424,425.75,423.78,425.22,NaN,NaN,NaN,426.68502457891185,NaN,NaN,424.51469999999824,427.39793458045074,421.63146541954575,423.1099093634664,425.0607016011205,426.63000069030534,423.4914025119357,126906,60233.5,59.40306698893216,51.067541047558976,NaN,NaN,NaN,NaN,1.0661943516397563,8.931950480837138,108056425,0.10534732191805649,0.07988456565936985,-0.025462756258686627
2025-09-19T14:05:00-04:00,425.25,426.18,425.18,425.61,NaN,NaN,NaN,426.68502457891185,NaN,NaN,424.4714999999983,427.2199164542064,421.7230835457902,423.5679274907731,425.07277114249393,426.6283649694932,423.5171773154947,111113,62242.7,61.70943294104529,51.92067975032848,NaN,NaN,NaN,NaN,1.061466183665488,10.612652834604933,108167538,0.17707527181953234,0.19588133351572878,0.018806061696196457
2025-09-19T14:10:00-04:00,425.59,425.96,425.33,425.8,NaN,NaN,NaN,426.68502457891185,NaN,NaN,424.4240999999983,426.9915280448609,421.8566719551357,423.5679274907731,425.07933334715995,426.62803303702424,423.53063365729565,58321,61642.8,62.817701229324896,52.695624675228885,NaN,NaN,NaN,NaN,1.030647170546524,12.17330502024646,108225859,0.22470428771533746,0.29968642134036827,0.07498213362503083
2025-09-19T14:15:00-04:00,425.76,425.76,424.81,425.18,NaN,NaN,NaN,426.68502457891185,NaN,NaN,424.37789999999825,426.802127787516,421.9536722124805,423.5679274907731,425.0808300553414,426.6228060208839,423.53885408979886,49057,61425.26666666667,57.01821528830461,52.79058116257755,NaN,NaN,NaN,NaN,1.027743801221773,12.670663549124276,108176802,0.20252731271681101,0.3281412745210446,0.12561396180423356
2025-09-19T14:20:00-04:00,425.24,425.95,425.06,425.67,NaN,NaN,NaN,426.68502457891185,NaN,NaN,424.33889999999826,426.6112250572583,422.0665749427382,423.5700188752758,425.0849591161874,426.62091566901415,423.54900256336066,48622,61367.63333333333,60.14955181716927,53.38876889364582,NaN,NaN,NaN,NaN,1.0179049582773596,13.35243033830893,108225424,0.20813585479244273,0.385783780294787,0.17764792550234426
2025-09-19T14:25:00-04:00,425.65,425.78,425.32,425.67,NaN,NaN,NaN,426.68502457891185,NaN,NaN,424.31789999999825,426.5201425765158,422.1156574234807,423.64601510022067,425.08798827196574,426.6198281193837,423.55614842454776,34047,60367.166666666664,60.149551817169275,54.085599979681504,NaN,NaN,NaN,NaN,0.9780546041146897,13.98549949969468,108225424,0.19912077264672035,0.4265488913107447,0.22742811866402435
2025-09-19T14:30:00-04:00,425.69,425.99,425.47,425.66,NaN,NaN,NaN,426.68502457891185,NaN,NaN,424.30209999999823,426.4536818288093,422.1505181711872,424.02281208017655,425.0925742698273,426.61964849801865,423.56550004163597,42392,59755.23333333333,60.0460131039631,54.569579252119105,NaN,NaN,NaN,NaN,0.9453364181064963,14.831915090666456,108183032,0.18032045849149492,0.452828691778393,0.2725082332868981
2025-09-19T14:35:00-04:00,425.64,426.25,425.27,425.83,NaN,NaN,NaN,426.68502457891185,NaN,NaN,424.2814999999983,426.35295770066676,422.2100422993298,424.18624966414126,425.10004441730007,426.62051844100813,423.579570393592,62523,59641.9,61.26665691893677,55.57152119202528,NaN,NaN,NaN,NaN,0.9478123882417478,15.927377655782538,108245555,0.167448686705428,0.4818190916686831,0.3143704049632551
2025-09-19T14:40:00-04:00,425.84,426.21,425.65,425.94,NaN,NaN,NaN,426.68502457891185,NaN,NaN,424.2690999999982,426.2927221895063,422.2454778104901,424.278999731313,425.1073534979844,426.62313725829665,423.5915697376721,51160,58986.2,62.07406588068564,56.50094869919148,NaN,NaN,NaN,NaN,0.9201115033673375,16.944592894818904,108296715,0.15475686071054123,0.5078164808514316,0.3530596201408904
2025-09-19T14:45:00-04:00,425.99,426.1,425.32,425.5,NaN,NaN,NaN,426.68502457891185,NaN,NaN,424.24489999999815,426.17810303281146,422.31169696718484,424.278999731313,425.11132098175284,426.6221432647528,423.60049869875286,43771,57858.86666666667,56.9593849239354,57.14063341341192,NaN,NaN,NaN,NaN,0.9101035388411012,17.152848378270843,108252944,0.10739071045302873,0.4872980082071763,0.37990729775414755
2025-09-19T14:50:00-04:00,425.55,425.6,424.22,424.24,NaN,NaN,NaN,426.68502457891185,NaN,NaN,424.22469999999817,426.13645982957,422.3129401704263,424.278999731313,425.10556218920163,426.60690887945253,423.60421549895074,80786,57624.666666666664,45.418402864702756,56.82086544577155,NaN,NaN,NaN,NaN,0.9436675717810222,16.404151184109704,108172158,-0.011800872116205396,0.3651562076088908,0.3769570797250962
2025-09-19T14:55:00-04:00,424.28,424.67,424.16,424.25,NaN,NaN,NaN,426.68502457891185,NaN,NaN,424.20029999999815,426.0787125335466,422.3218874664497,424.278999731313,425.0994096405894,426.59606934545917,423.6027499357196,49569,57276.4,45.51276253238977,56.61714105628266,NaN,NaN,NaN,NaN,0.9126913166538058,15.794498877624957,108221727,-0.08868769483249916,0.2660974611844722,0.35478515601697136
2025-09-19T15:00:00-04:00,424.27,424.4,423.69,424.24,NaN,NaN,NaN,426.68502457891185,NaN,NaN,424.1764999999981,426.02185118779784,422.33114881219836,424.278999731313,425.089240071973,426.58152863613464,423.59695150781135,62381,57877.23333333333,45.42818592875019,56.33905553860517,NaN,NaN,NaN,NaN,0.8982133654642467,15.871340296258879,108159346,-0.13610239543626068,0.18465716172164548,0.32075955715790616
2025-09-19T15:05:00-04:00,424.21,424.99,424.11,424.89,NaN,NaN,NaN,426.68502457891185,NaN,NaN,424.1824999999982,426.03512651546686,422.3298734845295,424.278999731313,425.0854552404872,426.57163597975267,423.5992745012217,54417,57647,51.709836315325006,56.40448775361671,NaN,NaN,NaN,NaN,0.8969124107882287,14.968745785604593,108213763,-0.12012912090551131,0.17059815602601702,0.29072727693152833
2025-09-19T15:10:00-04:00,424.96,425.88,424.9,425.68,NaN,NaN,NaN,426.68502457891185,NaN,NaN,424.2238999999982,426.11560535915453,422.33219464084186,424.278999731313,425.08912595172677,426.56898560500304,423.6092662984505,56542,57578.53333333333,58.0327126431025,56.30660530034317,NaN,NaN,NaN,NaN,0.9035615243033559,14.84338813232427,108270305,-0.05605456553443666,0.2206590700134825,0.27671363554791917
2025-09-19T15:15:00-04:00,425.77,426.7,425.68,425.82,423.2080295724553,423.2080295724553,423.2080295724553,NaN,NaN,NaN,424.26569999999816,426.2037010438386,422.32769895615775,424.4928965324522,425.10335042112746,426.5770600856214,423.62964075663353,91256,57802.8,59.05584897771174,56.11706358867649,NaN,NaN,NaN,NaN,0.9118785582816863,15.573225075090988,108361561,-0.006543675067983645,0.2685340417129396,0.27507771678092324
2025-09-19T15:20:00-04:00,425.86,426.29,425.65,425.73,423.2080295724553,NaN,NaN,NaN,NaN,NaN,424.3224999999982,426.26236417203353,422.3826358279628,424.4928965324522,425.1094181192969,426.5790454584865,423.63979078010726,48749,55965.4,58.07564644743959,55.7783453899704,NaN,NaN,NaN,NaN,0.8924586612615689,16.20314184973526,108312812,0.016580401371257936,0.2958032184949957,0.27922281712373775
2025-09-19T15:25:00-04:00,425.73,426.01,425.64,425.97,423.2080295724553,NaN,NaN,NaN,NaN,NaN,424.3518999999982,426.34544848595664,422.3583515140397,424.4928965324522,425.11481194822517,426.58063798487444,423.6489859115759,44942,55471.63333333333,59.98308234311205,55.990121608170924,NaN,NaN,NaN,NaN,0.8551401854571715,16.771034039306514,108357754,0.0429755706492988,0.3329422804353612,0.2899667097860624
2025-09-19T15:30:00-04:00,425.99,426.115,425.2,425.98,423.2080295724553,NaN,NaN,NaN,NaN,NaN,424.39309999999824,426.4338301550824,422.3523698449141,424.4928965324522,425.12410801144057,426.58146297090576,423.6667530519754,92324,56964.2,60.064611871066916,55.98405446916362,NaN,NaN,NaN,NaN,0.8594158864959465,16.559986485841762,108450078,0.05526130646100719,0.3590433428623214,0.30378203640131424
2025-09-19T15:35:00-04:00,426,426.25,425.27,425.32,423.2080295724553,NaN,NaN,NaN,NaN,NaN,424.4218999999983,426.47346807482154,422.37033192517504,424.4928965324522,425.12894332025104,426.5798857837185,423.67800085678357,64459,57476.23333333333,52.4668618251222,55.43529089830311,NaN,NaN,NaN,NaN,0.868029037460523,16.528838379149917,108385619,0.015175697695191337,0.3227516585203034,0.30757596082511207
2025-09-19T15:40:00-04:00,425.33,426.15,425.33,425.56,423.2080295724553,NaN,NaN,NaN,NaN,NaN,424.4610999999983,426.5232263699716,422.39897363002495,424.4928965324522,425.1337240842728,426.57926253632684,423.68818563221873,57076,58241,54.710317987518515,55.05416981855707,NaN,NaN,NaN,NaN,0.865312677641913,16.49991513722177,108442695,0.0017674075507157494,0.30978522026350674,0.308017812712791
2025-09-19T15:45:00-04:00,425.62,425.955,425.24,425.87,423.2080295724553,NaN,NaN,NaN,NaN,NaN,424.5018999999983,426.5929866949392,422.41081330505733,424.4928965324522,425.13870739416427,426.57868827405474,423.6987265142738,59649,58949.13333333333,57.50054534675794,54.78516184911574,NaN,NaN,NaN,NaN,0.854576057810346,16.304829841975284,108502344,0.010246036806006331,0.32082535872029894,0.3105793219142926
2025-09-19T15:50:00-04:00,425.875,427,425.44,426.41,423.33208433298745,NaN,NaN,NaN,NaN,NaN,424.53219999999834,426.6880934680423,422.37630653195436,424.6227579748825,425.16838499205915,426.6011695282814,423.7356004558369,176704,63013.86666666667,61.90348124419806,54.77297723222376,NaN,NaN,NaN,NaN,0.9049634822524643,17.369736817835175,108679048,0.046653209252744854,0.3688958334802237,0.32224262422747885
2025-09-19T15:55:00-04:00,426.46,426.51,425.84,425.9,423.33208433298745,NaN,NaN,NaN,NaN,NaN,424.5683999999983,426.7539575411409,422.3828424588557,424.6227579748825,425.18722701561137,426.6111231127615,423.76333091846124,143301,66224.76666666666,56.00245961479224,54.704625424427824,NaN,NaN,NaN,NaN,0.8881803763772894,18.35857900970508,108535747,0.03154204825702245,0.3616701845487569,0.33012813629173443