time,open,high,low,close,Long Stop,Long Stop Start,Buy Label,Short Stop,Short Stop Start,Sell Label,Basis,Upper,Lower,ATR Trailing Stoploss,VWAP,Upper Band #1,Lower Band #1,Volume,Volume MA,RSI,RSI-based MA,Regular Bullish,Regular Bullish Label,Regular Bearish,Regular Bearish Label,ATR,ADX,OnBalanceVolume
2025-08-11T14:40:00-04:00,342.43,343.22,342.22,342.28,NaN,NaN,NaN,344.60600254640957,NaN,NaN,343.5378000000001,346.3428341603281,340.73276583967214,341.1322714553478,342.36508751475384,344.4052916426151,340.32488338689257,85890,75733.83333333333,45.940609370477056,43.18738725156636,NaN,NaN,NaN,NaN,0.9930315551081293,16.177409108533112,86804181
2025-08-11T14:45:00-04:00,342.27,343.31,342.04,343.15,NaN,NaN,NaN,344.60600254640957,NaN,NaN,343.5552000000002,346.3395261016658,340.77087389833457,341.1322714553478,342.3685401952461,344.4016032402326,340.33547715025963,57375,74101.06666666667,53.69395208148068,43.78665199516786,NaN,NaN,NaN,NaN,1.0128150154575475,15.541836731903267,86861556
2025-08-11T14:50:00-04:00,343.17,343.76,343.15,343.7,NaN,NaN,NaN,344.60600254640957,NaN,NaN,343.57820000000015,346.34789295057925,340.80850704942105,341.1989571104884,342.37814416765764,344.405578182271,340.3507101530443,64504,73028.16666666667,57.81323982215082,44.62017955280679,NaN,NaN,NaN,NaN,0.9840425143534379,14.550838998837728,86926060
2025-08-11T14:55:00-04:00,343.68,344.08,343.61,343.79,NaN,NaN,NaN,344.60600254640957,NaN,NaN,343.6175000000001,346.3419656357934,340.89303436420687,341.7961656883907,342.3903305947621,344.4135485579066,340.36711263161754,66565,72605.76666666666,58.46437279571935,45.67827608757728,NaN,NaN,NaN,NaN,0.9473251918996188,14.052299047610422,86992625
2025-08-11T15:00:00-04:00,343.78,343.87,342.42,342.46,NaN,NaN,NaN,344.60600254640957,NaN,NaN,343.62410000000017,346.33568823579293,340.9125117642074,341.7961656883907,342.3963018482272,344.40878256547677,340.38382113097765,90793,73022.26666666666,46.93545885101926,46.049798216591945,NaN,NaN,NaN,NaN,0.9832305353353595,13.997067938455077,86901832
2025-08-11T15:05:00-04:00,342.42,342.66,341.99,342.2,NaN,NaN,NaN,344.60600254640957,NaN,NaN,343.61610000000013,346.3420488551075,340.89015114489274,341.7961656883907,342.39532184790227,344.39908181585525,340.3915618799493,70033,71769.7,45.064608311209184,46.081891700319524,NaN,NaN,NaN,NaN,0.9608569256685493,14.380230409855743,86831799
2025-08-11T15:10:00-04:00,342.2,342.99,341.98,342.05,NaN,NaN,NaN,344.60600254640957,NaN,NaN,343.6109000000002,346.3477651337673,340.87403486623305,341.7961656883907,342.39486179738344,344.3902791703606,340.3994444244063,67697,71085.5,43.975548125053166,46.282905621094606,NaN,NaN,NaN,NaN,0.9643671452636522,14.268895445948719,86764102
2025-08-11T15:15:00-04:00,342.07,342.45,341.9,342.07,NaN,NaN,NaN,344.60600254640957,NaN,NaN,343.61070000000024,346.3480140193113,340.8733859806892,341.7961656883907,342.3925119567686,344.37885846152966,340.40616545200754,75756,71424,44.16928526687534,46.52113966350481,NaN,NaN,NaN,NaN,0.9347694920305349,14.253329164615797,86839858
2025-08-11T15:20:00-04:00,342.12,342.28,341.94,342.04,NaN,NaN,NaN,344.60600254640957,NaN,NaN,343.5963000000002,346.35882262258673,340.8337773774137,341.7961656883907,342.39055707856704,344.37069533178885,340.41041882534523,52855,70870.3,43.92392043765014,46.51574364601358,NaN,NaN,NaN,NaN,0.892285956885495,14.23887476052094,86787003
2025-08-11T15:25:00-04:00,342.03,342.19,341.62,341.945,NaN,NaN,NaN,344.60600254640957,NaN,NaN,343.5750000000002,346.3714906580042,340.77850934199625,341.7961656883907,342.3868437435037,344.35962219965916,340.4140652873482,65541,70285.26666666666,43.10728237630702,46.60844033295406,NaN,NaN,NaN,NaN,0.8692655313936734,14.602429187720055,86721462
2025-08-11T15:30:00-04:00,342.01,342.08,341.06,341.13,NaN,NaN,NaN,344.39544051579463,NaN,NaN,343.53760000000017,346.4127620755139,340.6624379244864,341.7961656883907,342.3747065532763,344.3379632219146,340.41144988463805,106332,71832.96666666666,36.7881785186336,46.26040594183842,NaN,NaN,NaN,NaN,0.8800322791512668,15.53768129572391,86615130
2025-08-11T15:35:00-04:00,341.12,341.25,340.295,340.7,NaN,NaN,NaN,343.59973867416767,NaN,NaN,343.4702000000002,346.44843233485494,340.49196766514547,341.7961656883907,342.3544749985474,344.31379230180187,340.39515769529294,106328,73416.43333333333,33.959631826121296,45.62426381838268,NaN,NaN,NaN,NaN,0.8853871163547467,17.089860228986584,86508802
2025-08-11T15:40:00-04:00,340.7,341.08,340.5,340.89,NaN,NaN,NaN,343.5678187344327,NaN,NaN,343.40400000000017,346.46052155242444,340.3474784475759,341.7961656883907,342.34241263284514,344.298685839709,340.3861394259813,67872,73807.5,36.290558924287865,45.48097027094286,NaN,NaN,NaN,NaN,0.8635737509008351,18.531169238444782,86576674
2025-08-11T15:45:00-04:00,340.88,340.88,340.1,340.48,NaN,NaN,NaN,343.24928151923126,NaN,NaN,343.31960000000015,346.4602119404489,340.1789880595514,341.31793255071256,342.3198504190709,344.27480226157195,340.3648985765699,106035,74055.66666666667,33.53955365142802,44.5475857398866,NaN,NaN,NaN,NaN,0.8583184829793443,20.20252514363312,86470639
2025-08-11T15:50:00-04:00,340.52,341.3,339.54,340.08,NaN,NaN,NaN,343.24928151923126,NaN,NaN,343.23920000000015,346.4993327335669,339.9790672664334,340.58367683245604,342.27903393189996,344.23475774026326,340.32331012353666,180482,76996.43333333333,31.06535321201494,43.485067442853584,NaN,NaN,NaN,NaN,0.9227243056236762,22.1724193752923,86290157
2025-08-11T15:55:00-04:00,340.03,340.03,338.8,339.23,NaN,NaN,NaN,342.33277510326644,NaN,NaN,343.13180000000017,346.55526009768585,339.7083399023145,340.58367683245604,342.2029847857648,344.1884690738986,340.21750049763097,237566,81939.93333333333,26.57841316131021,41.54824323426998,NaN,NaN,NaN,NaN,0.948243998079126,24.469350579564036,86052591
2025-08-12T09:30:00-04:00,345.12,345.24,341.57,343.04,339.80030558324563,339.80030558324563,339.80030558324563,NaN,NaN,NaN,343.0874000000001,346.4564546093117,339.7183453906885,340.3609625382175,343.2833333333333,343.2833333333333,343.2833333333333,321769,90129.4,56.73987859144138,41.4715745749336,NaN,NaN,NaN,NaN,1.3097979982163306,24.21368068901664,86374360
2025-08-12T09:35:00-04:00,343.19,343.54,341.02,341.69,339.80030558324563,NaN,NaN,NaN,NaN,NaN,343.01640000000015,346.350449813737,339.6823501862633,340.3609625382175,342.77267707613635,343.36598786788727,342.1793662843854,238362,96055.46666666666,49.050892703652615,40.799183139785974,NaN,NaN,NaN,NaN,1.3962409983437385,23.52292488856604,86135998
2025-08-12T09:40:00-04:00,341.7,342.09,339.65,340.11,NaN,NaN,NaN,344.8151864417121,344.8151864417121,344.8151864417121,342.9130000000002,346.2803407906595,339.54565920934084,340.3609625382175,342.1902522639911,343.27349688322136,341.10700764476087,207319,101519.93333333333,41.895182413809145,40.43916339427097,NaN,NaN,NaN,NaN,1.4707952127477568,21.87148885757513,85928679
2025-08-12T09:45:00-04:00,340.08,340.98,336.86,337.39,NaN,NaN,NaN,343.24767796708886,NaN,NaN,342.7366000000002,346.3122372523403,339.16096274766005,340.1650384028948,341.33743713055816,343.18277214679705,339.49210211431927,223572,107279.86666666667,32.976399879735425,39.57571993487999,NaN,NaN,NaN,NaN,1.6600241261229172,21.808446136424177,85705107
2025-08-12T09:50:00-04:00,337.37,339.29,336.76,338.58,NaN,NaN,NaN,342.50096533222114,NaN,NaN,342.6028000000001,346.288218380671,338.9173816193292,340.1650384028948,340.7866409946893,342.8420580842125,338.73122390516613,211846,112638.06666666667,39.0861094773129,39.22647431718425,NaN,NaN,NaN,NaN,1.7221652599712822,21.79594094349408,85916953
2025-08-12T09:55:00-04:00,338.56,338.78,335.76,335.92,NaN,NaN,NaN,341.9543305443929,NaN,NaN,342.4066000000001,346.43385288014747,338.3793471198527,340.1650384028948,340.2699817932821,342.60598852610667,337.93397506045756,180138,116571.96666666666,32.052555353821205,38.36099360910896,NaN,NaN,NaN,NaN,1.8148677414019037,22.236335412359004,85736815
2025-08-12T10:00:00-04:00,335.94,336.1,334.2,334.9,NaN,NaN,NaN,339.8804973378296,NaN,NaN,342.18380000000013,346.596509172447,337.7710908275533,340.1650384028948,339.5524284409703,342.3672416803637,336.7376152015769,221229,121759.16666666667,29.83544111385838,37.35467365740954,NaN,NaN,NaN,NaN,1.8209486170160558,23.2599394591025,85515586
2025-08-12T10:05:00-04:00,334.8,336.17,334.65,335.08,NaN,NaN,NaN,339.8804973378296,NaN,NaN,341.95780000000013,346.6371342091076,337.27846579089265,340.1650384028948,339.1459599544927,342.1004647076094,336.191455201376,169547,125067.93333333333,30.74583291852977,36.471712981854026,NaN,NaN,NaN,NaN,1.7994522872291974,24.154443112236095,85685133
2025-08-12T10:10:00-04:00,335.09,335.8,332.96,335.47,NaN,NaN,NaN,339.27534984707205,NaN,NaN,341.74200000000013,346.59962287549274,336.8843771245075,340.1650384028948,338.69313342484605,341.79472210818,335.5915447415121,203356,129288.1,32.780905865714715,36.18547922093125,NaN,NaN,NaN,NaN,1.8737771238556855,25.580650276183427,85888489
2025-08-12T10:15:00-04:00,335.49,335.86,333.8,334.21,NaN,NaN,NaN,339.27534984707205,NaN,NaN,341.52140000000014,346.7138410598961,336.3289589401042,340.1650384028948,338.4675167986271,341.62249229660046,335.3125413006538,116039,131575.7,29.740237063384143,35.88409388073573,NaN,NaN,NaN,NaN,1.887078757865994,26.85413105177262,85772450
2025-08-12T10:20:00-04:00,334.13,334.72,333.24,333.85,NaN,NaN,NaN,338.9103910796669,NaN,NaN,341.3044000000001,346.84270647044724,335.76609352955296,338.22003072231587,338.1778633079487,341.42532464365894,334.9304019722385,142954,134157.7,28.914982858686386,35.35726701890706,NaN,NaN,NaN,NaN,1.85800170373271,28.227863306322238,85629496
2025-08-12T10:25:00-04:00,333.88,335.17,333.72,334.97,NaN,NaN,NaN,338.9103910796669,NaN,NaN,341.1002000000001,346.8023395844579,335.39806041554226,336.61402457785266,338.0067760124621,341.26535127943987,334.7482007454844,112961,135533.83333333334,34.96161150063074,35.4588425795644,NaN,NaN,NaN,NaN,1.8288587248946584,29.09310646508733,85742457
2025-08-12T10:30:00-04:00,335,335.74,333.92,334.48,NaN,NaN,NaN,338.9103910796669,NaN,NaN,340.9023000000001,346.8188832066019,334.98571679339824,334.53921966228216,337.8447283353085,341.1009982671729,334.5884584034441,121564,135692.4,33.61443714007332,35.640920002997134,NaN,NaN,NaN,NaN,1.8282259588307537,29.386160572331644,85620893
2025-08-12T10:35:00-04:00,334.5,335.07,333.97,334.94,NaN,NaN,NaN,338.9103910796669,NaN,NaN,340.7139000000001,346.776197020166,334.65160297983414,332.8723757298257,337.7535236683983,341.0064883388523,334.5005589979443,72841,134837.36666666667,36.1036103657626,36.32129123188658,NaN,NaN,NaN,NaN,1.776209818914269,29.658282243344214,85693734
2025-08-12T10:40:00-04:00,334.94,335.4,334.45,334.58,NaN,NaN,NaN,338.9103910796669,NaN,NaN,340.5135000000001,346.7096795487724,334.3173204512278,332.1359005838605,337.68037445616255,340.9251823152569,334.4355665970682,64819,134135,34.997624939680804,34.76827311390369,NaN,NaN,NaN,NaN,1.7171948318489634,29.596471600089462,85628915
2025-08-12T10:45:00-04:00,334.54,334.63,333.12,333.6,NaN,NaN,NaN,338.62843728245605,NaN,NaN,340.3093,346.72648131587925,333.89211868412076,331.30801808775965,337.51918098781795,340.7895739327731,334.24878804286277,112543,135973.93333333332,32.11361821431697,33.55846779323686,NaN,NaN,NaN,NaN,1.7023952010026082,30.177254589321638,85516372
2025-08-12T10:50:00-04:00,333.62,334.54,333.28,334.07,NaN,NaN,NaN,338.6191901332535,NaN,NaN,340.12350000000004,346.71227052269546,333.5347294773046,331.30801808775965,337.4206604826413,340.6978166205286,334.14350434475404,77534,136408.26666666666,34.88499295101768,33.05773997446604,NaN,NaN,NaN,NaN,1.6707955437881397,30.71655307932294,85593906
2025-08-12T10:55:00-04:00,334.05,335.02,333.63,334.78,NaN,NaN,NaN,338.6191901332535,NaN,NaN,339.9605000000001,346.66570283069046,333.2552971693097,331.30801808775965,337.34648137091455,340.61481820682286,334.07814453500623,72333,136600.53333333333,38.94020096269887,33.48372576610628,NaN,NaN,NaN,NaN,1.650738719231843,30.726457277098447,85666239
2025-08-12T11:00:00-04:00,334.83,335.56,334.61,335.2,NaN,NaN,NaN,338.6191901332535,NaN,NaN,339.79210000000006,346.5439845043946,333.04021549560554,332.06316420874634,337.29509032073724,340.54265944046136,334.0475212010131,67931,135838.46666666667,41.2702539240073,33.639736083727314,NaN,NaN,NaN,NaN,1.600685953572425,30.202827679673224,85734170
2025-08-12T11:05:00-04:00,335.19,336.83,335.19,336.36,NaN,NaN,NaN,338.6191901332535,NaN,NaN,339.67150000000004,346.44882875111875,332.8941712488813,333.2125313669971,337.2529167412887,340.4487774906873,334.0570559918901,110041,137172.06666666668,47.256725106751595,34.72574820893663,NaN,NaN,NaN,NaN,1.603494099745822,28.604567439596373,85844211
2025-08-12T11:10:00-04:00,336.34,337.56,336.04,336.88,NaN,NaN,NaN,338.6191901332535,NaN,NaN,339.5633000000001,346.34269749834755,332.7839025016526,333.9060250935977,337.2380603029722,340.3787063353394,334.097414270605,110096,138585.36666666667,49.730430505469165,36.146818879765966,NaN,NaN,NaN,NaN,1.597530235478262,26.562524275708533,85954307
2025-08-12T11:15:00-04:00,336.89,338.18,336.89,337.2,NaN,NaN,NaN,338.6191901332535,NaN,NaN,339.4505000000001,346.19566189580183,332.70533810419835,334.60682007487816,337.24486758530304,340.3274740950065,334.1622610755996,120487,140076.4,51.2458192792617,37.61110361981825,NaN,NaN,NaN,NaN,1.576278075801244,25.107999380092235,86074794
2025-08-12T11:20:00-04:00,337.2,337.78,336.72,337.38,NaN,NaN,NaN,338.6191901332535,NaN,NaN,339.3391000000001,346.0331874479367,332.64501255206346,334.60682007487816,337.2461766429409,340.2868778016072,334.2054754842746,91032,141348.96666666667,52.12015623347806,38.992478646087065,NaN,NaN,NaN,NaN,1.5394010703868657,23.62068448349815,86165826
2025-08-12T11:25:00-04:00,337.41,337.63,336.72,337.3,NaN,NaN,NaN,338.6191901332535,NaN,NaN,339.2337000000001,345.8868125979146,332.5805874020856,334.60682007487816,337.2457002520814,340.26176023958004,334.22964026458277,55301,141007.63333333333,51.6765854361126,40.55936067271052,NaN,NaN,NaN,NaN,1.4944438510735158,22.23960636523221,86110525
2025-08-12T11:30:00-04:00,337.31,337.83,337.06,337.47,NaN,NaN,NaN,338.6191901332535,NaN,NaN,339.1377000000001,345.75119868379136,332.52420131620886,334.9123318783376,337.24861350563555,340.2435394860862,334.2536875251849,48748,139088.16666666666,52.599754925132,42.251130106028064,NaN,NaN,NaN,NaN,1.4426978617111206,21.121227412197477,86159273
2025-08-12T11:35:00-04:00,337.5,337.59,337.04,337.53,NaN,NaN,NaN,338.6191901332535,NaN,NaN,339.03630000000004,345.589544329393,332.4830556706071,334.9808655026701,337.2500894784006,340.2289963919092,334.27118256489194,37547,136795.46666666667,52.94145832902222,43.535404879484595,NaN,NaN,NaN,NaN,1.3789337287317516,20.06311037551192,86196820
2025-08-12T11:40:00-04:00,337.51,338.72,337.38,338.7,333.8419173251661,333.8419173251661,333.8419173251661,NaN,NaN,NaN,338.9687000000001,345.46444100780093,332.4729589921993,335.9626924021361,337.27951970044154,340.21993406157725,334.33910533930583,104702,138023.13333333333,59.128816120938794,45.35786052097499,NaN,NaN,NaN,NaN,1.3761527481080573,19.987836017429057,86301522
2025-08-12T11:45:00-04:00,338.7,338.99,337.2,337.2,333.8419173251661,NaN,NaN,NaN,NaN,NaN,338.87210000000005,345.3263903839833,332.41780961601677,335.9626924021361,337.29155185999497,340.1986039580112,334.38449976197876,86150,137360.3,50.04412887800243,46.35361184327784,NaN,NaN,NaN,NaN,1.4057132661003404,20.11294188008766,86215372
2025-08-12T11:50:00-04:00,337.18,337.3,336.25,337.14,333.8419173251661,NaN,NaN,NaN,NaN,NaN,338.76770000000005,345.1615286527504,332.3738713472497,335.9626924021361,337.2839996861775,340.1636268789911,334.40437249336384,72196,133750.76666666666,49.715092644864974,47.40485953650528,NaN,NaN,NaN,NaN,1.3803051756646028,19.244241834847216,86143176
2025-08-12T11:55:00-04:00,337.14,338.49,337.11,337.97,333.8419173251661,NaN,NaN,NaN,NaN,NaN,338.68590000000006,345.0134624659627,332.35833753403745,335.9626924021361,337.2948918428055,340.1480747351799,334.4417089504311,73192,128271.63333333333,54.20107348936225,48.982534913294224,NaN,NaN,NaN,NaN,1.3802833774028451,19.30900801029097,86216368
2025-08-12T12:00:00-04:00,338,338.03,337.11,337.3,333.8419173251661,NaN,NaN,NaN,NaN,NaN,338.5911,344.8565414976833,332.3256585023167,335.9626924021361,337.29681351270943,340.13520985472564,334.4584171706932,40368,118891.6,50.300124976470066,50.08361577225511,NaN,NaN,NaN,NaN,1.347405993302639,19.369148030345887,86176000
2025-08-12T12:05:00-04:00,337.36,337.84,337.05,337.05,333.8419173251661,NaN,NaN,NaN,NaN,NaN,338.4891,344.6851373433978,332.2930626566022,335.9626924021361,337.2969892221696,340.12025072819614,334.47372771614306,41804,112339.66666666667,48.886288171637055,50.794050572893546,NaN,NaN,NaN,NaN,1.307591279495305,19.35899060786563,86134196
2025-08-12T12:10:00-04:00,337.11,337.57,336.87,337.29,333.8419173251661,NaN,NaN,NaN,NaN,NaN,338.40369999999996,344.5455481942323,332.2618518057676,335.9626924021361,337.2965697184993,340.1087768318947,334.4843626051039,30971,106461.4,50.329676288983435,51.441152170391845,NaN,NaN,NaN,NaN,1.2641919023884967,19.14309219933479,86165167
2025-08-12T12:15:00-04:00,337.25,337.9,337.2,337.49,333.8419173251661,NaN,NaN,NaN,NaN,NaN,338.30629999999996,344.34773652129854,332.2648634787014,335.9626924021361,337.29913544233057,340.09595071312225,334.5023201715389,44024,100476.46666666666,51.55733367737428,51.748338496864896,NaN,NaN,NaN,NaN,1.2238924807893174,19.215595819654823,86209191
2025-08-12T12:20:00-04:00,337.51,338.17,337.5,338.05,334.03225192039173,NaN,NaN,NaN,NaN,NaN,338.2217,344.15570020565707,332.2876997943429,335.9626924021361,337.304692257283,340.08928824154617,334.5200962730199,36973,94647.36666666667,54.917284878627484,52.11882809494763,NaN,NaN,NaN,NaN,1.1850430178757954,19.503580400367575,86246164
2025-08-12T12:25:00-04:00,338.08,339.01,337.93,338.08,334.6928313785557,NaN,NaN,NaN,NaN,NaN,338.1203,343.8848282236088,332.3557717763912,336.67105971561756,337.32671447616093,340.08558261112773,334.5678463411941,87853,91571.2,55.09696438421231,52.3939098881584,NaN,NaN,NaN,NaN,1.1775399451703803,20.400135690864207,86334017
2025-08-12T12:30:00-04:00,337.99,338.34,337.64,338.21,334.6928313785557,NaN,NaN,NaN,NaN,NaN,338.01050000000004,343.55049648021287,332.4705035197872,336.67105971561756,337.3310472268471,340.08236630080296,334.5797281528912,24437,85011.46666666666,55.916877085566995,52.66510423473618,NaN,NaN,NaN,NaN,1.1434299490867808,20.846667740728503,86358454
2025-08-12T12:35:00-04:00,338.22,338.63,338.05,338.43,334.72819966517164,NaN,NaN,NaN,NaN,NaN,337.9033000000001,343.19361780147136,332.61298219852887,336.67105971561756,337.3426044343905,340.08074709846096,334.6044617703201,46735,80917.73333333334,57.336624662122,53.06939275087969,NaN,NaN,NaN,NaN,1.103184952723438,21.482440595591257,86405189
2025-08-12T12:40:00-04:00,338.43,338.74,338.04,338.45,334.84691786220924,NaN,NaN,NaN,NaN,NaN,337.8231000000001,342.95384688134453,332.6923531186557,336.7364625743962,337.3530600870087,340.07978621211566,334.62633396190176,41561,75524.56666666667,57.47072157983784,53.41731894050155,NaN,NaN,NaN,NaN,1.074386027528906,22.157853344683836,86446750
2025-08-12T12:45:00-04:00,338.48,339.37,338.48,339.08,335.4175125048361,NaN,NaN,NaN,NaN,NaN,337.76070000000004,342.75096973626927,332.7704302637308,337.307170059517,337.37923494443277,340.09161111999725,334.6668587688683,69522,73974,61.56848026334907,54.03353479295346,NaN,NaN,NaN,NaN,1.0633584541339853,23.251910191044626,86516272
2025-08-12T12:50:00-04:00,339.06,339.83,338.97,339.76,335.93467102734354,NaN,NaN,NaN,NaN,NaN,337.71490000000006,342.5875101794245,332.8422898205756,337.74973604761357,337.42244154621164,340.1241314711793,334.720751621244,88829,72169.83333333333,65.43922782433054,54.48427848605287,NaN,NaN,NaN,NaN,1.048832850267269,24.577175577448827,86605101
2025-08-12T12:55:00-04:00,339.77,340.08,339.15,339.44,336.18036779882794,NaN,NaN,NaN,NaN,NaN,337.66230000000013,342.40065296706325,332.923947032937,337.9507888380909,337.4657159695427,340.1567404986046,334.7746914404808,91088,71440.73333333334,62.26124991325503,55.356929988570926,NaN,NaN,NaN,NaN,1.040344789533893,25.969732610586497,86514013
2025-08-12T13:00:00-04:00,339.45,339.55,338.18,338.32,336.18036779882794,NaN,NaN,NaN,NaN,NaN,337.5879000000001,342.16297512075056,333.01282487924965,337.9507888380909,337.484411911624,340.1588906306851,334.80993319256294,70053,69723.7,52.627822353630854,55.56498211062563,NaN,NaN,NaN,NaN,1.0638915902814725,25.822022822111656,86443960
2025-08-12T13:05:00-04:00,338.31,338.88,337.81,338.57,336.18036779882794,NaN,NaN,NaN,NaN,NaN,337.52040000000017,341.9330526444275,333.1077473555728,337.9507888380909,337.4995123837341,340.15493868134985,334.84408608611835,74845,69790.5,54.326586706447934,55.57394734041746,NaN,NaN,NaN,NaN,1.0643279052613668,25.203550929082947,86518805
2025-08-12T13:10:00-04:00,338.6,339.33,338.25,338.94,336.18036779882794,NaN,NaN,NaN,NaN,NaN,337.47660000000013,341.78736718930384,333.16583281069643,337.9507888380909,337.5170063700775,340.15943151727816,334.8745812228769,61318,69673.8,56.79592665995044,56.037933174951775,NaN,NaN,NaN,NaN,1.0654473405998395,25.022700617855065,86580123
2025-08-12T13:15:00-04:00,338.94,339.85,338.94,339.81,336.18036779882794,NaN,NaN,NaN,NaN,NaN,337.4588000000001,341.72328147381455,333.19431852618567,337.9507888380909,337.5388040565525,340.17516571523134,334.9024423978737,51349,67634,61.998522704544904,56.97452135587376,NaN,NaN,NaN,NaN,1.0543439591284243,25.2769000659006,86631472
2025-08-12T13:20:00-04:00,339.79,339.99,339.12,339.15,336.18036779882794,NaN,NaN,NaN,NaN,NaN,337.42400000000015,341.6034640805222,333.2445359194781,337.9507888380909,337.5605627666802,340.18934013354936,334.9317853998111,55582,66902.26666666666,56.44544582993263,57.411362037370125,NaN,NaN,NaN,NaN,1.0411765334763943,25.623531211161797,86575890
2025-08-12T13:25:00-04:00,339.17,339.36,338.67,338.79,336.18036779882794,NaN,NaN,NaN,NaN,NaN,337.3902000000001,341.4969622089057,333.2834377910945,337.9507888380909,337.5714579365136,340.1926790585863,334.95023681444087,38257,65766.4,53.62410440843779,57.55898851816038,NaN,NaN,NaN,NaN,1.0160924953709374,25.29658760998596,86537633
2025-08-12T13:30:00-04:00,338.79,339.45,338.45,339.35,336.18036779882794,NaN,NaN,NaN,NaN,NaN,337.37560000000013,341.44906370556146,333.3021362944388,337.9507888380909,337.5822047708998,340.19717952719213,334.9672300146075,34677,64657.933333333334,57.20727046847616,57.722558917435286,NaN,NaN,NaN,NaN,1.0149430314158703,24.686506898644286,86572310
2025-08-12T13:35:00-04:00,339.34,339.37,338.65,339.03,336.18036779882794,NaN,NaN,NaN,NaN,NaN,337.3716000000001,341.4381589582049,333.30504104179533,337.9507888380909,337.59004354426605,340.20000684803836,334.98008024049375,26805,61883.4,54.61070633076744,57.687826199332086,NaN,NaN,NaN,NaN,0.9938756720290244,24.120003380969873,86545505
2025-08-12T13:40:00-04:00,339.04,339.1,338.47,338.67,336.18036779882794,NaN,NaN,NaN,NaN,NaN,337.2842000000001,341.0353002973353,333.5330997026649,337.9507888380909,337.5976645958792,340.2006976387092,334.99463155304926,32535,59298.03333333333,51.76418517589274,57.391205348641066,NaN,NaN,NaN,NaN,0.9678845525983795,23.322574594077256,86512970
2025-08-12T13:45:00-04:00,338.69,338.75,338.03,338.2,336.18036779882794,NaN,NaN,NaN,NaN,NaN,337.21440000000007,340.75918131352523,333.6696186864749,337.5932040864656,337.6045466027042,340.19622273447135,335.01287047093706,47058,56850.4,48.229661641637534,56.740707990035034,NaN,NaN,NaN,NaN,0.9501785131270687,21.945464590270465,86465912
2025-08-12T13:50:00-04:00,338.17,338.33,337.88,338.2,336.18036779882794,NaN,NaN,NaN,NaN,NaN,337.1762000000001,340.6354759705667,333.7169240294335,337.5932040864656,337.6089527994843,340.19032691784935,335.0275786811193,41621,55203.36666666667,48.22966164163754,56.08063228016358,NaN,NaN,NaN,NaN,0.9144514764751345,20.45749206593345,86465912
2025-08-12T13:55:00-04:00,338.27,338.48,338.14,338.22,336.18036779882794,NaN,NaN,NaN,NaN,NaN,337.19280000000015,340.66396589066477,333.7216341093355,337.5932040864656,337.6131579628575,340.186975999603,335.03933992611195,31697,54416.566666666666,48.40353097221095,55.140278759368,NaN,NaN,NaN,NaN,0.8734192281554842,19.283655259887347,86497609
2025-08-12T14:00:00-04:00,338.21,338.25,337.12,337.18,336.18036779882794,NaN,NaN,NaN,NaN,NaN,337.1648000000001,340.6132668826257,333.7163331173746,337.5932040864656,337.612017417215,340.17059997640706,335.0534348580229,60503,54808.4,40.74115671198994,53.37613082277225,NaN,NaN,NaN,NaN,0.8917464261443779,18.936158285024636,86437106
2025-08-12T14:05:00-04:00,337.2,337.51,337.02,337.36,336.18036779882794,NaN,NaN,NaN,NaN,NaN,337.1936000000002,340.62400699631786,333.7631930036825,337.5932040864656,337.6095373677668,340.1581914183828,335.0608833171508,40574,54909.3,42.43953511584696,51.96029405152881,NaN,NaN,NaN,NaN,0.8630502528483516,18.725805277117942,86477680
2025-08-12T14:10:00-04:00,337.4,338.28,337.15,338.16,336.18036779882794,NaN,NaN,NaN,NaN,NaN,337.2588000000001,340.63586296069866,333.8817370393016,337.16204049227036,337.6117363109601,340.14943430480025,335.07403831711997,45091,52922.26666666667,49.383050785617684,51.72852465381358,NaN,NaN,NaN,NaN,0.8821180919306119,17.43501283171241,86522771
2025-08-12T14:15:00-04:00,338.14,339.17,338.1,339.14,336.18036779882794,NaN,NaN,NaN,NaN,NaN,337.3400000000001,340.69879740391457,333.9812025960856,337.16204049227036,337.62537423649445,340.15168987714657,335.09905859584234,60253,52059.03333333333,56.33227695395831,51.87178824292147,NaN,NaN,NaN,NaN,0.8955382282212819,17.158953197307966,86583024
2025-08-12T14:20:00-04:00,339.13,339.42,338.52,339.12,336.18036779882794,NaN,NaN,NaN,NaN,NaN,337.4130000000001,340.76470464099486,334.0612953590054,337.2841549889565,337.63860895545986,340.15654195071477,335.12067596020495,50438,51333.76666666667,56.16281276631879,51.82656582194778,NaN,NaN,NaN,NaN,0.8958569262054785,17.155719193363623,86532586
2025-08-12T14:25:00-04:00,339.08,339.67,338.9,339.43,336.373974756228,NaN,NaN,NaN,NaN,NaN,337.5174000000001,340.78772918228134,334.2470708177189,337.5763239911652,337.6514693542904,340.16413827121374,335.138800437367,40641,50248.73333333333,58.25886115218799,51.559447139636575,NaN,NaN,NaN,NaN,0.8868671457622328,17.403064340400768,86573227
2025-08-12T14:30:00-04:00,339.51,339.87,338.94,339.62,336.4994759036722,NaN,NaN,NaN,NaN,NaN,337.63280000000015,340.7823194300781,334.4832805699222,337.7300591929322,337.6728073667724,340.17843821504164,335.1671765185032,63352,51014.86666666667,59.53590282336363,51.78019406773878,NaN,NaN,NaN,NaN,0.8899480639220737,17.832045535324788,86636579
2025-08-12T14:35:00-04:00,339.6,339.86,339.3,339.63,336.73018154441445,NaN,NaN,NaN,NaN,NaN,337.7260000000001,340.83028606937097,334.62171393062926,337.8680473543457,337.68798709095114,340.189511174856,335.18646300704626,43097,51057.96666666667,59.605949777976406,52.207468736991544,NaN,NaN,NaN,NaN,0.8663803450704971,18.230385216325665,86679676
2025-08-12T14:40:00-04:00,339.64,339.91,339.36,339.82,336.839718746941,NaN,NaN,NaN,NaN,NaN,337.83280000000013,340.8492271316228,334.81637286837747,338.0414378834766,337.7088638858819,340.20567873447186,335.21204903729193,57365,51937.76666666667,60.987791264097346,52.477505936678774,NaN,NaN,NaN,NaN,0.8437817489940338,18.655464632370492,86737041
2025-08-12T14:45:00-04:00,339.81,340.8,339.74,340.74,337.457231531171,NaN,NaN,NaN,NaN,NaN,337.9488000000001,340.95740270565085,334.9401972943494,338.77515030678126,337.7608275653225,340.26151089815625,335.2601442324887,107587,54056.53333333333,66.89351132533469,53.35484915057644,NaN,NaN,NaN,NaN,0.8592259097801743,19.927786391935516,86844628
2025-08-12T14:50:00-04:00,340.77,341.05,340.36,340.94,337.9259937342996,NaN,NaN,NaN,NaN,NaN,338.07600000000014,341.04161089835753,335.11038910164274,339.085120245425,337.7934279322628,340.30010712471125,335.2867487398143,61354,54869.23333333333,68.02666070603783,54.516454545586804,NaN,NaN,NaN,NaN,0.8471383447958759,21.321292046804654,86905982
2025-08-12T14:55:00-04:00,340.9,340.91,340.21,340.61,337.9259937342996,NaN,NaN,NaN,NaN,NaN,338.2162000000001,340.9779295741339,335.45447042586625,339.085120245425,337.8142125082772,340.3229838704119,335.30544114614247,42799,53367.433333333334,64.12651941535226,55.65194438656643,NaN,NaN,NaN,NaN,0.8387713201676004,22.323338613579228,86863183
2025-08-12T15:00:00-04:00,340.58,340.93,340.28,340.76,337.9259937342996,NaN,NaN,NaN,NaN,NaN,338.35000000000014,340.93803709410776,335.7619629058925,339.085120245425,337.83291593099784,340.3439582051172,335.3218736568785,37961,53818.23333333333,65.10582038053181,56.857384296487446,NaN,NaN,NaN,NaN,0.8252876544413457,23.273163903782528,86901144
2025-08-12T15:05:00-04:00,340.73,341.24,340.73,341.13,338.32313044452934,NaN,NaN,NaN,NaN,NaN,338.4770000000001,340.97341743316406,335.9805825668361,339.4853815656576,337.86092206329295,340.3786598812009,335.343184245385,50930,53958.066666666666,67.46513989027929,58.218927790635185,NaN,NaN,NaN,NaN,0.8027671076955346,24.455810938874883,86952074
2025-08-12T15:10:00-04:00,341.13,341.3,340.52,340.8,338.32313044452934,NaN,NaN,NaN,NaN,NaN,338.5890000000001,340.9878605629461,336.19013943705414,339.5063052525261,337.8864209147673,340.40862420462884,335.3642176249058,49685,54228.86666666667,63.35095475827197,59.83391336536961,NaN,NaN,NaN,NaN,0.8011408857172843,25.09926039995807,86902389
2025-08-12T15:15:00-04:00,340.83,341.42,340.79,341.36,338.4921808389203,NaN,NaN,NaN,NaN,NaN,338.6890000000001,341.1244326105622,336.25356738943793,339.67004420202085,337.921185483596,340.45262860194407,335.3897423652479,62426,53992.333333333336,67.02578773521338,61.59007426675293,NaN,NaN,NaN,NaN,0.788916536737478,25.8262725313616,86964815
2025-08-12T15:20:00-04:00,341.34,341.45,340.61,340.87,338.4921808389203,NaN,NaN,NaN,NaN,NaN,338.7688000000001,341.2233065166786,336.31429348332165,339.67004420202085,337.9373148063066,340.4717573915207,335.4028722210924,31481,52080.73333333333,61.23950868770997,62.43696411690237,NaN,NaN,NaN,NaN,0.7925653555419421,26.09389748505766,86933334
2025-08-12T15:25:00-04:00,340.88,341.08,340.7,340.89,338.4921808389203,NaN,NaN,NaN,NaN,NaN,338.8426000000001,341.3257200052558,336.35947999474445,339.67004420202085,337.95395338580914,340.49089141746555,335.41701535415274,33796,50171,61.386036621808685,62.79794695032025,NaN,NaN,NaN,NaN,0.7630964015746601,26.34240637063257,86967130
2025-08-12T15:30:00-04:00,340.9,341.23,340.4,341.15,338.4921808389203,NaN,NaN,NaN,NaN,NaN,338.9180000000001,341.4474141615183,336.38858583848196,339.67004420202085,337.990972117731,340.53352655932497,335.44841767613707,75627,50356.8,63.32695027975078,63.309671058422545,NaN,NaN,NaN,NaN,0.7678752300336159,25.875639332538235,87042757
2025-08-12T15:35:00-04:00,341.13,341.44,340.89,341.07,338.66594237387324,NaN,NaN,NaN,NaN,NaN,338.9934000000001,341.55000903551576,336.4367909644845,339.7795781051477,338.0187029281625,340.5670171656216,335.4703886907034,54071,49664.333333333336,62.289474832706205,63.59757203560241,NaN,NaN,NaN,NaN,0.7523127136026442,25.75015012628964,86988686
2025-08-12T15:40:00-04:00,341.06,341.61,340.98,341.09,338.8236268114245,NaN,NaN,NaN,NaN,NaN,339.0658000000001,341.65061748690323,336.48098251309693,339.9666624841182,338.07515063684826,340.6359188388828,335.51438243481374,109745,51278.566666666666,62.455076676398804,63.806084453676355,NaN,NaN,NaN,NaN,0.743576091202455,25.876277806359187,87098431
2025-08-12T15:45:00-04:00,341.08,341.37,340.82,341.34,338.8236268114245,NaN,NaN,NaN,NaN,NaN,339.14200000000005,341.76557008686865,336.51842991313146,339.9666624841182,338.10747930715814,340.6742679699459,335.5406906443704,65695,51756.76666666667,64.55066229413305,64.1592782048304,NaN,NaN,NaN,NaN,0.7297492275451376,25.598030334408044,87164126
2025-08-12T15:50:00-04:00,341.29,342.5,341.17,341.83,339.3302364128889,NaN,NaN,NaN,NaN,NaN,339.2046000000001,341.93037390121754,336.47882609878263,340.56326398983566,338.2145335250416,340.8196263311007,335.60944071898246,186448,56118.96666666667,68.28689338252343,64.68064264186083,NaN,NaN,NaN,NaN,0.7726242827204838,26.722842233481764,87350574
2025-08-12T15:55:00-04:00,341.8,341.81,340.61,340.765,339.3302364128889,NaN,NaN,NaN,NaN,NaN,339.2759000000001,341.97457055427685,336.57722944572333,340.56326398983566,338.2703653161549,340.8798230409348,335.66090759137495,129794,59170.2,54.77425150852443,63.81498122637438,NaN,NaN,NaN,NaN,0.80457969109759,26.586364875968744,87220780
2025-08-13T09:30:00-04:00,341.59,346.59,340.24,346.38,340.1080563183553,NaN,NaN,NaN,NaN,NaN,339.4607000000001,342.74988105925314,336.17151894074703,341.68748895349484,344.40333333333336,344.40333333333336,344.40333333333336,324516,68831.5,78.70264177456491,64.57755130269774,NaN,NaN,NaN,NaN,1.200681141733474,29.242259306410617,87545296
2025-08-13T09:35:00-04:00,346.44,347.12,344.58,345.58,342.34700830388465,NaN,NaN,NaN,NaN,NaN,339.6129000000001,343.29310982562555,335.9326901743746,341.9279911627959,344.9914392401329,345.6637450653421,344.31913341492367,248321,76215.36666666667,72.79323796482711,65.19660262766024,NaN,NaN,NaN,NaN,1.2963467744667985,31.859229351949114,87296975
2025-08-13T09:40:00-04:00,345.53,347.8,344.34,347.6,342.34700830388465,NaN,NaN,NaN,NaN,NaN,339.81890000000016,344.06739869488916,335.57040130511115,341.9279911627959,345.51135763063166,346.4385409631963,344.584174298067,278698,84420.8,77.40628664723347,66.07520736099607,NaN,NaN,NaN,NaN,1.4508934334334584,34.47085441525216,87575673
2025-08-13T09:45:00-04:00,347.6,348.98,346.27,347.56,343.6133071529197,NaN,NaN,NaN,NaN,NaN,340.0291000000001,344.7252293381444,335.33297066185577,342.91811434418935,346.0460621565531,347.25957743611343,344.83254687699275,292383,92598.3,77.12740930634466,66.7653694621436,NaN,NaN,NaN,NaN,1.5408296167596427,37.171605168315125,87283290
2025-08-13T09:50:00-04:00,347.6,348.65,346.81,348.06,343.6497477368779,NaN,NaN,NaN,NaN,NaN,340.2445000000002,345.38526424283043,335.10373575716994,342.91811434418935,346.2500195636947,347.5265311153478,344.97350801204163,146738,96102.2,78.18539325680541,67.82497221203884,NaN,NaN,NaN,NaN,1.562198929848238,39.67944515330216,87430028
2025-08-13T09:55:00-04:00,348.11,348.12,345.75,345.85,343.6497477368779,NaN,NaN,NaN,NaN,NaN,340.4117000000002,345.7241742296066,335.09922577039384,342.91811434418935,346.28037216530834,347.49914146606363,345.06160286455304,133720,99502.96666666666,64.07712545820527,67.61435347796683,NaN,NaN,NaN,NaN,1.6198990062876497,40.618245569117,87296308
2025-08-13T10:00:00-04:00,345.84,346.2,344.52,345,343.6497477368779,NaN,NaN,NaN,NaN,NaN,340.5507000000001,345.9713169427896,335.13008305721064,342.91811434418935,346.1793292596219,347.37768081637444,344.9809777028694,153219,102593.5,59.620988049989066,67.49874486098678,NaN,NaN,NaN,NaN,1.624191934409961,40.13984717283306,87143089
2025-08-13T10:05:00-04:00,345.02,345.95,344.24,345.405,343.6497477368779,NaN,NaN,NaN,NaN,NaN,340.6972000000002,346.2374191870254,335.15698081297495,342.91811434418935,346.11961126925956,347.30436617750627,344.93485636101286,102261,104649.73333333334,61.01223638778722,67.47204484427095,NaN,NaN,NaN,NaN,1.6303210819521052,39.41410358873568,87245350
2025-08-13T10:10:00-04:00,345.38,345.51,343.8,344.31,343.6497477368779,NaN,NaN,NaN,NaN,NaN,340.8192000000002,346.4034443929531,335.2349556070473,342.91811434418935,346.03300258612666,347.2396469479527,344.82635822430063,97448,106394.96666666666,55.44947782772381,66.90936824055474,NaN,NaN,NaN,NaN,1.6360124332412391,38.29974333351223,87147902
2025-08-13T10:15:00-04:00,344.36,345.25,343.89,344.96,343.6497477368779,NaN,NaN,NaN,NaN,NaN,340.94980000000015,346.6093579191633,335.290242080837,342.91811434418935,345.97734447249854,347.1882498573004,344.7664390876967,77443,106967.96666666666,57.90309794744451,66.59605560589318,NaN,NaN,NaN,NaN,1.6162972594382945,37.26498023937617,87225345
2025-08-13T10:20:00-04:00,344.9,346.15,344.87,345.3,343.6497477368779,NaN,NaN,NaN,NaN,NaN,341.0868000000002,346.8287107481949,335.3448892518055,342.91811434418935,345.94144578938636,347.1188725116311,344.76401906714165,132782,109712.76666666666,59.16983338804673,66.3613953710109,NaN,NaN,NaN,NaN,1.5922760266212717,36.85462040012068,87358127
2025-08-13T10:25:00-04:00,345.3,345.64,344.321,345.08,343.6497477368779,NaN,NaN,NaN,NaN,NaN,341.2068000000002,347.02619954292544,335.387400457075,342.91811434418935,345.90749692505506,347.0762356160011,344.738758234109,75489,110874.36666666667,57.95462068882237,65.89024954206012,NaN,NaN,NaN,NaN,1.5727563104340352,35.888196271766866,87282638
2025-08-13T10:30:00-04:00,345.1,345.21,343.91,344.11,343.6497477368779,NaN,NaN,NaN,NaN,NaN,341.2938000000002,347.15400155286756,335.43359844713285,342.91811434418935,345.85512744831584,347.035746602527,344.67450829410467,74761,111254.66666666667,52.805156698636694,64.78441120749679,NaN,NaN,NaN,NaN,1.5532737168316009,34.569436077477384,87207877
2025-08-13T10:35:00-04:00,344.15,344.87,344,344.69,343.6497477368779,NaN,NaN,NaN,NaN,NaN,341.39880000000016,347.31028629706,335.48731370294036,342.88049147535145,345.8250889839259,347.0090250284164,344.6411529394355,49204,111458.23333333334,55.3593035412619,64.82620063840662,NaN,NaN,NaN,NaN,1.5044684513436297,33.34487303992287,87257081
2025-08-13T10:40:00-04:00,344.62,345.57,344.2,345.33,343.6497477368779,NaN,NaN,NaN,NaN,NaN,341.5390000000002,347.4841721589972,335.59382784100325,342.31939318028117,345.7945659970029,346.96542145923144,344.6237105347744,87691,112469.1,58.05673379525618,63.35149292559885,NaN,NaN,NaN,NaN,1.4948635619619421,32.716958682574536,87344772
2025-08-13T10:45:00-04:00,345.35,345.35,343.31,343.935,NaN,NaN,NaN,348.60545643195087,348.60545643195087,348.60545643195087,341.6463000000003,347.56686477372347,335.7257352262771,341.97545710123603,345.73253425404596,346.92114544345293,344.543923064639,91971,111948.56666666667,50.844901923605796,61.78375463694018,NaN,NaN,NaN,NaN,1.533801878964662,31.193437546385866,87252801
2025-08-13T10:50:00-04:00,343.92,344.07,342.85,343.39,NaN,NaN,NaN,347.70748113958945,NaN,NaN,341.7353000000003,347.6241638666504,335.84643613335015,341.97545710123603,345.6635753564342,346.8980496720262,344.42910104084217,73286,112346.3,48.31954477786067,59.706130217699275,NaN,NaN,NaN,NaN,1.5113874590386125,29.33661824911794,87179515
2025-08-13T10:55:00-04:00,343.41,343.94,343.3,343.32,NaN,NaN,NaN,347.70748113958945,NaN,NaN,341.8055000000002,347.68456157478624,335.9264384252142,341.97545710123603,345.6288084193863,346.8828127539291,344.3748040848435,40226,112260.53333333334,47.98985080089077,57.624876038738286,NaN,NaN,NaN,NaN,1.4491454976787106,27.612428901654866,87139289
2025-08-13T11:00:00-04:00,343.345,343.76,342.72,342.99,NaN,NaN,NaN,347.33524624495647,NaN,NaN,341.88230000000027,347.7207827515328,336.04381724846775,341.97545710123603,345.5697575953286,346.8649254259391,344.27458976471814,60692,113018.23333333334,46.38309996938951,55.353283661065724,NaN,NaN,NaN,NaN,1.4199208192730859,25.833533699518714,87078597
2025-08-13T11:05:00-04:00,343,343.05,341.02,341.11,NaN,NaN,NaN,346.22091687018565,NaN,NaN,341.9287000000002,347.7046846987389,336.15271530126154,341.97545710123603,345.4185834356059,346.89153847580496,343.94562839540686,104041,114788.6,38.479013907696604,53.52484712174367,NaN,NaN,NaN,NaN,1.4634979036107247,25.514152420058316,86974556
2025-08-13T11:10:00-04:00,341.15,341.33,339.04,339.77,NaN,NaN,NaN,344.49292064881365,NaN,NaN,341.93710000000027,347.69926455508937,336.17493544491117,341.97545710123603,345.11781809562757,347.0081489574796,343.22748723377555,156866,118361.3,34.0279909846132,51.696775902788254,NaN,NaN,NaN,NaN,1.5225337676385275,26.30654266082107,86817690
2025-08-13T11:15:00-04:00,339.75,339.94,338.55,339.88,NaN,NaN,NaN,343.546651528413,NaN,NaN,341.95410000000027,347.68679733719796,336.2214026628026,341.97545710123603,344.91413098431855,347.0487029446341,342.779559024003,104569,119766.06666666667,34.69579589484964,49.817030153292706,NaN,NaN,NaN,NaN,1.5130670699500601,27.26479459811507,86922259
2025-08-13T11:20:00-04:00,339.86,341.44,339.8,341.27,NaN,NaN,NaN,343.546651528413,NaN,NaN,342.00610000000023,347.6653947581884,336.34680524181204,341.97545710123603,344.7501260878988,346.98953567156246,342.5107165042352,121798,122776.63333333333,42.60240698599928,48.89938223602667,NaN,NaN,NaN,NaN,1.522133707810769,26.76346863260462,87044057
2025-08-13T11:25:00-04:00,341.29,341.49,340.52,340.77,NaN,NaN,NaN,343.546651528413,NaN,NaN,342.05750000000023,347.6235015271315,336.49149847286895,341.97545710123603,344.64587578153385,346.9406407768226,342.3511107862451,84879,124479.4,40.693796385222704,47.670146410153684,NaN,NaN,NaN,NaN,1.4826955858242876,26.25518844975261,86959178
2025-08-13T11:30:00-04:00,340.85,342.13,340.5,342.02,NaN,NaN,NaN,343.546651528413,NaN,NaN,342.1339000000002,347.5897879350799,336.6780120649205,341.4543656809889,344.5594439870455,346.8787200394124,342.24016793467854,89406,124938.7,47.077178948598906,46.80638537876455,NaN,NaN,NaN,NaN,1.4932173296939812,25.23434401768364,87048584
2025-08-13T11:35:00-04:00,342.01,342.24,341.67,341.88,NaN,NaN,NaN,343.546651528413,NaN,NaN,342.2071000000002,347.54797524288944,336.86622475711096,340.63879403583286,344.52018527519874,346.84406508688164,342.19630546351584,48538,124754.26666666666,46.473839107144336,45.986329551501846,NaN,NaN,NaN,NaN,1.4272732347158392,24.192464881812974,87000046
2025-08-13T11:40:00-04:00,341.91,342.32,341.63,341.81,NaN,NaN,NaN,343.546651528413,NaN,NaN,342.29970000000026,347.44572036917907,337.15367963082144,340.63879403583286,344.47919574075996,346.8073248174116,342.1510666641083,52069,122831.73333333334,46.15532543455021,45.51134160406709,NaN,NaN,NaN,NaN,1.374610860807565,23.15294824797041,86947977
2025-08-13T11:45:00-04:00,341.91,341.92,341.07,341.57,NaN,NaN,NaN,343.546651528413,NaN,NaN,342.3839000000002,347.33806119641804,337.4297388035824,340.5990352286663,344.4355596413567,346.7738245895734,342.09729469314,49435,122289.73333333334,45.016162400672634,44.77254580831072,NaN,NaN,NaN,NaN,1.3371386564641692,22.60276084846714,86898542
2025-08-13T11:50:00-04:00,341.63,341.63,340.45,340.65,NaN,NaN,NaN,343.546651528413,NaN,NaN,342.4337000000003,347.2655732640538,337.60182673594676,339.50622818293306,344.3814059365528,346.7418063692293,342.0210055038763,52298,117818.06666666667,40.853644270698624,43.54375369941374,NaN,NaN,NaN,NaN,1.3259144667167289,22.521967778079464,86846244
2025-08-13T11:55:00-04:00,340.68,341.56,340.65,341.26,NaN,NaN,NaN,343.546651528413,NaN,NaN,342.4761000000003,347.2281666198795,337.7240333801211,339.37013270462944,344.3582615351178,346.7258767573941,341.9906463128415,24613,114312.03333333334,44.516962043219124,43.091757993671834,NaN,NaN,NaN,NaN,1.2962062905226788,22.44694564129091,86870857
2025-08-13T12:00:00-04:00,341.26,341.98,341.12,341.92,NaN,NaN,NaN,343.546651528413,NaN,NaN,342.5321000000002,347.18970242615893,337.87449757384144,339.38253435581623,344.32641552205104,346.69782938746476,341.9550016566373,41164,104866.96666666666,48.251550317454864,43.0869012465,NaN,NaN,NaN,NaN,1.2650486983424885,21.917543754028674,86912021
2025-08-13T12:05:00-04:00,341.9,342.08,341.39,341.64,NaN,NaN,NaN,343.546651528413,NaN,NaN,342.5763000000003,347.15661344341135,337.99598655658923,339.65702748465293,344.29179284138365,346.66644983887943,341.9171358438879,46421,98136.96666666666,46.81196262402682,43.002766376724004,NaN,NaN,NaN,NaN,1.2239737913180249,21.31581712221175,86865600
2025-08-13T12:10:00-04:00,341.65,341.75,341.05,341.23,NaN,NaN,NaN,343.546651528413,NaN,NaN,342.6085000000003,347.12745441445014,338.0895455855504,339.65702748465293,344.26223241351846,346.6431450055598,341.8813198214771,35617,90034.26666666666,44.7085339433107,42.883154517718374,NaN,NaN,NaN,NaN,1.186547091938165,21.046148982769214,86829983
2025-08-13T12:15:00-04:00,341.23,341.76,341.21,341.21,NaN,NaN,NaN,343.546651528413,NaN,NaN,342.6401000000003,347.09697131963486,338.18322868036574,339.65702748465293,344.24096274247484,346.62576577903315,341.8561597059165,26535,81172.66666666667,44.60324851840218,43.320599847054496,NaN,NaN,NaN,NaN,1.1410794425140112,20.78332015983694,86803448
2025-08-13T12:20:00-04:00,341.2,341.28,340.22,340.65,NaN,NaN,NaN,343.546651528413,NaN,NaN,342.6567000000003,347.0774694398043,338.23593056019627,339.65702748465293,344.2067648127221,346.6049835692026,341.8085460562416,35070,77450.4,41.645961777391314,43.86474061796722,NaN,NaN,NaN,NaN,1.1352880537630063,21.343509928135486,86768378
2025-08-13T12:25:00-04:00,340.66,341.67,340.63,341.365,NaN,NaN,NaN,343.546651528413,NaN,NaN,342.66920000000033,347.0717171708601,338.26668282914056,339.65702748465293,344.1658134231914,346.57270315396005,341.7589236924228,50271,74668.76666666666,46.52135901015756,44.70942369763207,NaN,NaN,NaN,NaN,1.1284817642085074,21.361610469702853,86818649
2025-08-13T12:30:00-04:00,341.3,341.5,340.49,340.92,NaN,NaN,NaN,343.546651528413,NaN,NaN,342.66880000000026,347.07194912760724,338.2656508723933,339.65702748465293,344.1387696919826,346.55326566253865,341.7242737214265,31274,70603.93333333333,44.054372562131256,44.81313552449864,NaN,NaN,NaN,NaN,1.1200187810507563,21.4942804887686,86787375
2025-08-13T12:35:00-04:00,340.94,341.6,340.71,341,NaN,NaN,NaN,343.546651528413,NaN,NaN,342.67660000000024,347.0664949600165,338.286705039984,339.65702748465293,344.11013613258103,346.5310643199223,341.6892079452398,35194,68368.36666666667,44.622910119707,45.09378650553323,NaN,NaN,NaN,NaN,1.1035888681185624,21.47959879916994,86822569
2025-08-13T12:40:00-04:00,341,341.1,340.66,340.91,NaN,NaN,NaN,343.546651528413,NaN,NaN,342.6796000000003,347.06445385844125,338.2947461415593,339.65702748465293,344.09019424818774,346.5167999932341,341.6635885031414,23249,65895.06666666667,44.08019277486937,44.87971606455255,NaN,NaN,NaN,NaN,1.0561896632529506,21.512993352572376,86799320
2025-08-13T12:45:00-04:00,340.91,340.98,339.85,339.94,NaN,NaN,NaN,343.546651528413,NaN,NaN,342.6558000000002,347.086715192151,338.22488480784943,339.65702748465293,344.0372372413896,346.4882124684802,341.58626201429905,52587,65066.53333333333,38.62733174561386,44.319251253014656,NaN,NaN,NaN,NaN,1.0614618301634537,22.253982689011906,86746733
2025-08-13T12:50:00-04:00,339.92,340.53,339.25,340.3,NaN,NaN,NaN,343.3206541129828,NaN,NaN,342.64580000000024,347.0956397094796,338.1959602905209,339.65702748465293,343.9760728182421,346.45744882230366,341.4946968141805,58955,62605.63333333333,41.51876346532452,43.988068255212816,NaN,NaN,NaN,NaN,1.0770716994374907,23.390707525909527,86805688
2025-08-13T12:55:00-04:00,340.29,340.35,339.6,339.8,NaN,NaN,NaN,343.3206541129828,NaN,NaN,342.6146000000002,347.12157274898703,338.1076272510134,339.65429759017786,343.94590950530164,346.4425094072349,341.44930960336836,28939,61053.96666666667,38.7856292176224,43.54303017070923,NaN,NaN,NaN,NaN,1.0537094351919556,24.446237731600174,86776749
2025-08-13T13:00:00-04:00,339.78,341.63,339.69,341.36,NaN,NaN,NaN,343.3206541129828,NaN,NaN,342.62440000000026,347.1182681066526,338.13053189334795,339.65429759017786,343.89887514438436,346.4045359411246,341.3932143476441,60948,60593.53333333333,49.87297853529011,44.18726833246576,NaN,NaN,NaN,NaN,1.1170159041068157,23.59292142420508,86837697
2025-08-13T13:05:00-04:00,341.35,341.41,340.59,340.7,NaN,NaN,NaN,343.3206541129828,NaN,NaN,342.62060000000025,347.1206451731093,338.1205548268912,339.37835045771385,343.8594916696271,346.3719484915828,341.3470348476714,52639,60708.03333333333,46.07102960048935,44.29827315798507,NaN,NaN,NaN,NaN,1.095800482384904,22.800556281623923,86785058
2025-08-13T13:10:00-04:00,340.705,341.07,340.29,340.74,NaN,NaN,NaN,343.3206541129828,NaN,NaN,342.61240000000026,347.12461198083247,338.10018801916806,339.37835045771385,343.83352504837995,346.3518433127763,341.3152067839836,33215,58892.166666666664,46.33802780591953,44.16159297858969,NaN,NaN,NaN,NaN,1.0732433050716945,22.365227543653223,86818273
2025-08-13T13:15:00-04:00,340.7,340.96,340.5,340.93,NaN,NaN,NaN,343.3206541129828,NaN,NaN,342.6096000000003,347.12580895883184,338.09339104116873,339.28434429293685,343.8149394071222,346.33668695212907,341.29319186211535,24886,56656,47.66349571612048,44.22241677088209,NaN,NaN,NaN,NaN,1.0294402118522863,21.960993715537576,86843159
2025-08-13T13:20:00-04:00,340.95,341.54,340.9,341.49,NaN,NaN,NaN,343.3206541129828,NaN,NaN,342.6176000000003,347.1244207152943,338.1107792847063,339.4223148289678,343.7849165526506,346.30628456751145,341.26354853778975,49328,55857.4,51.46842088494916,44.705265838141976,NaN,NaN,NaN,NaN,1.0016230538628403,20.774557867439817,86892487
2025-08-13T13:25:00-04:00,341.46,341.6,341.15,341.5,NaN,NaN,NaN,343.3206541129828,NaN,NaN,342.6208000000003,347.1242135319601,338.11738646804054,339.6808518631742,343.763675359626,346.28362186132006,341.24372885793196,37248,55758.13333333333,51.536178127660996,45.200475095946175,NaN,NaN,NaN,NaN,0.9622214071583549,19.59217506740603,86929735
2025-08-13T13:30:00-04:00,341.48,341.81,340.1,340.1,NaN,NaN,NaN,343.3206541129828,NaN,NaN,342.5862000000003,347.13968989674686,338.03271010325375,339.6808518631742,343.7246473195225,346.25234145731594,341.19695318172904,53060,55503.73333333333,42.57442779142495,45.26679409694858,NaN,NaN,NaN,NaN,1.0156341637898996,19.644384625983204,86876675
2025-08-13T13:35:00-04:00,340.08,340.5,339.74,340.14,NaN,NaN,NaN,343.3175742911672,NaN,NaN,342.5737000000004,347.1504909324796,337.99690906752113,339.6808518631742,343.6716441054613,346.2178197819236,341.12546842899906,62886,54131.9,42.88005012604097,45.006700605225966,NaN,NaN,NaN,NaN,0.997374580662049,20.025490537428592,86939561
2025-08-13T13:40:00-04:00,340.14,340.23,339.36,339.65,NaN,NaN,NaN,342.96586636884143,NaN,NaN,342.43910000000034,346.95566448639045,337.9225355136102,339.6808518631742,343.6187097736198,346.1878616305238,341.0495579167158,58359,50848.333333333336,40.06694017361286,44.72188400604608,NaN,NaN,NaN,NaN,0.9882763963290458,20.713209131248966,86881202
2025-08-13T13:45:00-04:00,339.69,340.25,339.45,340.05,NaN,NaN,NaN,342.96586636884143,NaN,NaN,342.3285000000003,346.80262885373753,337.8543711462631,339.6808518631742,343.58395062779186,346.1658180251645,341.0020832304192,41014,48729.833333333336,43.3350349496444,44.62989292247018,NaN,NaN,NaN,NaN,0.9748280823055434,21.319218440740478,86922216
2025-08-13T13:50:00-04:00,340.08,340.59,340.06,340.53,NaN,NaN,NaN,342.96586636884143,NaN,NaN,342.18710000000027,346.4266193548175,337.94758064518305,339.6808518631742,343.5670359643927,346.15245318135436,340.981618747431,23281,45445.933333333334,47.065258968422505,44.843111936295415,NaN,NaN,NaN,NaN,0.9437689335694305,21.323434981181475,86945497
2025-08-13T13:55:00-04:00,340.54,341.09,340.49,340.95,NaN,NaN,NaN,342.96586636884143,NaN,NaN,342.05490000000026,346.01931748052215,338.09048251947837,339.6808518631742,343.5472921132048,346.13366299142837,340.9609212349812,32066,43685.5,50.15709444830819,45.6666664150593,NaN,NaN,NaN,NaN,0.9192140097430401,20.569049901010274,86977563
2025-08-13T14:00:00-04:00,340.98,341.43,340.31,341.32,NaN,NaN,NaN,342.96586636884143,NaN,NaN,341.92010000000033,345.49812039676897,338.3420796032317,339.6808518631742,343.50847230815407,346.0936544832294,340.92329013307875,69007,43005.53333333333,52.77403320011806,46.47061425325883,NaN,NaN,NaN,NaN,0.9335558661899661,19.392312857007866,87046570
2025-08-13T14:05:00-04:00,341.33,341.57,340.77,340.85,NaN,NaN,NaN,342.96586636884143,NaN,NaN,341.8201000000003,345.2286642079493,338.4115357920513,339.6808518631742,343.47116427234556,346.0539972659909,340.8883312787002,69610,43707.933333333334,49.23758145436036,47.217182270168685,NaN,NaN,NaN,NaN,0.9240161614621122,18.106318661616072,86976960
2025-08-13T14:10:00-04:00,340.84,341.08,338.2,340.02,NaN,NaN,NaN,342.89336225778493,NaN,NaN,341.72050000000024,345.04148133085295,338.39951866914754,339.6808518631742,343.32374933615756,345.95622533500074,340.6912733373144,189069,48274.6,43.671944228609526,46.77425124826293,NaN,NaN,NaN,NaN,1.0637292927862467,19.303425233737542,86787891
2025-08-13T14:15:00-04:00,339.96,340.72,339.69,340.41,NaN,NaN,NaN,342.89336225778493,NaN,NaN,341.62060000000025,344.78925058975483,338.4519494102457,339.4844783557248,343.2960053439135,345.9324351493399,340.65957553848716,43610,48080.433333333334,46.71953989552135,46.82057341219378,NaN,NaN,NaN,NaN,1.0613200575872312,20.415024193564623,86831501
2025-08-13T14:20:00-04:00,340.46,340.64,339.97,340.12,NaN,NaN,NaN,342.89336225778493,NaN,NaN,341.5368000000002,344.63740817260936,338.43619182739104,339.4844783557248,343.27485992083905,345.9143140489899,340.6354057926882,33445,47452,44.779417622777736,46.709244113397936,NaN,NaN,NaN,NaN,1.033368624902426,21.44722322768977,86798056
2025-08-13T14:25:00-04:00,340.11,340.28,339.89,340.23,NaN,NaN,NaN,342.89336225778493,NaN,NaN,341.44220000000024,344.40482191985103,338.47957808014945,339.4844783557248,343.2575020905018,345.8999353974236,340.61506878358006,26826,47525.76666666667,45.700515166545244,46.569031216999704,NaN,NaN,NaN,NaN,0.9874137231236804,22.466300527199696,86824882
2025-08-13T14:30:00-04:00,340.25,340.68,340.15,340.27,NaN,NaN,NaN,342.89336225778493,NaN,NaN,341.34160000000026,344.10854086672845,338.57465913327206,339.4844783557248,343.23150623293503,345.87614949410755,340.5868629717625,44056,47622.166666666664,46.05290606739541,46.18220873003158,NaN,NaN,NaN,NaN,0.9547413143291339,22.777182620608514,86868938
2025-08-13T14:35:00-04:00,340.3,340.48,339.75,339.95,NaN,NaN,NaN,342.89336225778493,NaN,NaN,341.23900000000026,343.8179005409131,338.6600994590874,339.4844783557248,343.2093631920419,345.85795570543917,340.56077067864464,34446,47223,43.61434837243043,45.61636374751511,NaN,NaN,NaN,NaN,0.9386883633056257,23.41051546748496,86834492
2025-08-13T14:40:00-04:00,339.98,340.34,339.56,340.18,NaN,NaN,NaN,342.89336225778493,NaN,NaN,341.1604000000002,343.621359845278,338.6994401547224,339.4844783557248,343.1899078873538,345.8420206893416,340.537795085366,30344,47047.23333333333,45.83439518668287,45.84921856146211,NaN,NaN,NaN,NaN,0.9273534802123647,24.15791759712978,86864836
2025-08-13T14:45:00-04:00,340.18,340.35,339.84,339.9,NaN,NaN,NaN,342.89336225778493,NaN,NaN,341.0646000000002,343.3339733408256,338.79522665917483,339.4844783557248,343.1736777307288,345.8285972521945,340.51875820926307,25628,47017,43.584607444520344,45.89954408421064,NaN,NaN,NaN,NaN,0.8975425173400564,24.834282282649514,86839208
2025-08-13T14:50:00-04:00,339.9,339.9,339.48,339.63,NaN,NaN,NaN,342.5121853301892,NaN,NaN,340.9506000000002,342.9018115621315,338.99938843786884,339.4844783557248,343.15565081971636,345.8155694582675,340.49573218116524,25805,46708.166666666664,41.470719195509346,45.9998140143461,NaN,NaN,NaN,NaN,0.8634323375300494,25.77896128724248,86813403
2025-08-13T14:55:00-04:00,339.67,340.23,339.62,339.9,NaN,NaN,NaN,342.5121853301892,NaN,NaN,340.8699000000002,342.64667965996716,339.09312034003324,338.5328007558485,343.1295425076442,345.794503951022,340.4645810642664,40756,46391,44.37604876856844,46.07417214426925,NaN,NaN,NaN,NaN,0.8453300277064754,26.04621881801442,86854159
2025-08-13T15:00:00-04:00,339.85,340.15,339.22,339.98,NaN,NaN,NaN,342.4626729971352,NaN,NaN,340.8017000000002,342.4429258954946,339.1604741045058,338.5328007558485,343.09643812228006,345.76878480564875,340.4240914389114,50521,47032.566666666666,45.243350060058425,45.94403579367181,NaN,NaN,NaN,NaN,0.851377882870295,26.67047972111814,86904680
2025-08-13T15:05:00-04:00,339.95,340.26,339.83,340.02,NaN,NaN,NaN,342.4626729971352,NaN,NaN,340.73570000000024,342.2249065135534,339.2464934864471,338.586792483743,343.08019564520544,345.75469778106435,340.4056935093465,27253,46767.86666666667,45.6992491029574,45.625618269003894,NaN,NaN,NaN,NaN,0.8212794626652745,27.041753822870163,86931933
2025-08-13T15:10:00-04:00,340.04,340.86,340.02,340.85,NaN,NaN,NaN,342.4626729971352,NaN,NaN,340.6929000000002,342.0363672902947,339.34943270970564,339.10143398699444,343.0541824062693,345.72683766236844,340.3815271501702,53905,47789.73333333333,54.21722997783472,45.72870375312651,NaN,NaN,NaN,NaN,0.8226166439034716,26.323960792853633,86985838
2025-08-13T15:15:00-04:00,340.86,341.46,340.7,341.15,NaN,NaN,NaN,342.4626729971352,NaN,NaN,340.69370000000015,342.0382070621684,339.3491929378319,339.6731471895955,343.0298440843635,345.69458773796646,340.36510043076055,65540,48221.5,56.851866368456925,46.272581246990555,NaN,NaN,NaN,NaN,0.8181440264817944,24.75221079776107,87051378
2025-08-13T15:20:00-04:00,341.1,341.16,340.56,340.61,NaN,NaN,NaN,342.4626729971352,NaN,NaN,340.7105000000002,342.02916333839397,339.3918366616064,339.6731471895955,343.0042480833379,345.6645507837748,340.34394538290104,60364,48268.46666666667,51.14640318854231,46.806471172700036,NaN,NaN,NaN,NaN,0.8025623103045251,23.473829698482582,86991014
2025-08-13T15:25:00-04:00,340.6,340.9,340.43,340.72,NaN,NaN,NaN,342.4626729971352,NaN,NaN,340.7273000000002,342.0244402546106,339.43015974538974,339.6731471895955,342.9914585442869,345.64997898345376,340.33293810512004,29444,48285.3,52.19877407268295,47.1978450424973,NaN,NaN,NaN,NaN,0.7788078595684854,22.458512438977525,87020458
2025-08-13T15:30:00-04:00,340.78,341.03,340.1,340.14,NaN,NaN,NaN,342.4626729971352,NaN,NaN,340.70470000000023,342.0026066376156,339.40679336238486,339.6731471895955,342.97651559335725,345.6344769446685,340.318554242046,31272,47296.1,46.509767442932926,47.32144145822267,NaN,NaN,NaN,NaN,0.7896072981707328,21.942966463596452,86989186
2025-08-13T15:35:00-04:00,340.13,340.38,340,340.29,NaN,NaN,NaN,342.4626729971352,NaN,NaN,340.69510000000025,341.9980236201657,339.3921763798348,339.6731471895955,342.95461187444033,345.6132540129994,340.2959697358813,43101,46978.166666666664,48.0856065343871,47.491805127354226,NaN,NaN,NaN,NaN,0.7603496340156802,21.591740096736505,87032287
2025-08-13T15:40:00-04:00,340.21,340.49,339.99,340.37,NaN,NaN,NaN,342.4626729971352,NaN,NaN,340.66210000000024,341.91161204875357,339.4125879512469,339.6731471895955,342.9348176399238,345.5934799505217,340.27615532932583,40444,47219.13333333333,48.94942294513383,47.69869919004982,NaN,NaN,NaN,NaN,0.7417532315859888,21.062148358331783,87072731
2025-08-13T15:45:00-04:00,340.38,340.63,340.32,340.49,NaN,NaN,NaN,342.4626729971352,NaN,NaN,340.6343000000002,341.8350897567822,339.4335102432182,339.6731471895955,342.9059784343817,345.56218023105725,340.2497766377062,64883,48552.36666666667,50.285683298629,48.17522311334972,NaN,NaN,NaN,NaN,0.7109137150441327,20.30709662371156,87137614
2025-08-13T15:50:00-04:00,340.5,341.25,340.5,340.805,NaN,NaN,NaN,342.4626729971352,NaN,NaN,340.6142000000002,341.7683357979673,339.4600642020331,339.76787780549546,342.87192098013037,345.51904101181526,340.2248009484455,93105,50011.6,53.71086403672146,48.737828031209624,NaN,NaN,NaN,NaN,0.7144198782552654,19.160216583374563,87230719
2025-08-13T15:55:00-04:00,340.8,340.8,339.2,339.34,NaN,NaN,NaN,342.4626729971352,NaN,NaN,340.5696000000002,341.7447065314102,339.3944934685902,339.76787780549546,342.8207161096326,345.4753155035581,340.1661167157071,94572,51922.4,39.93149473344997,48.476891408990305,NaN,NaN,NaN,NaN,0.7780327440941763,19.2120559156523,87136147
2025-08-14T09:30:00-04:00,335.69,337.95,334.82,336.22,NaN,NaN,NaN,339.4024421103983,NaN,NaN,340.4810000000002,342.1728865210551,338.78911347894535,339.76787780549546,336.33,336.33,336.33,193904,56617.2,25.13952689006321,47.31037767288701,NaN,NaN,NaN,NaN,1.0453161195160197,21.87272270641876,86942243
2025-08-14T09:35:00-04:00,336.2,337.82,336.2,336.99,NaN,NaN,NaN,339.4024421103983,NaN,NaN,340.3956000000002,342.33460143376726,338.4565985662331,339.76787780549546,336.6323520876369,336.9672654407853,336.2974387344885,158033,59788.76666666667,31.84921121531616,46.41560356194042,NaN,NaN,NaN,NaN,1.0863649681220184,24.34334186927333,87100276
2025-08-14T09:40:00-04:00,337,337.11,335.6,335.96,NaN,NaN,NaN,339.4024421103983,NaN,NaN,340.2764000000002,342.53271384345953,338.02008615654086,339.76787780549546,336.5211507008782,336.8599565873793,336.1823448143771,131409,62223.76666666667,28.207204437152186,45.19873601744712,NaN,NaN,NaN,NaN,1.1166246132561592,26.847800061446215,86968867
2025-08-14T09:45:00-04:00,335.92,336.89,335.12,336.77,NaN,NaN,NaN,339.26858859733267,NaN,NaN,340.17900000000026,342.60548717284524,337.7525128271553,339.76787780549546,336.47288002540995,336.7951342696955,336.1506257811244,109599,64509.933333333334,34.5460531373199,44.40207916275872,NaN,NaN,NaN,NaN,1.1632942837378608,29.33300580637246,87078466
2025-08-14T09:50:00-04:00,336.8,338.25,336.2,337.62,NaN,NaN,NaN,339.26858859733267,NaN,NaN,340.1068000000003,342.6172778508995,337.5963221491011,339.76787780549546,336.65756586849386,337.11719684270224,336.1979348942855,156642,68955.3,40.48456618299226,43.42117460598426,NaN,NaN,NaN,NaN,1.2266304063280145,29.980098672255913,87235108
2025-08-14T09:55:00-04:00,337.58,338.21,336.72,337.8,NaN,NaN,NaN,339.26858859733267,NaN,NaN,340.0386000000002,342.6100268724087,337.4671731275917,339.76787780549546,336.78609504662523,337.3183816032188,336.25380849003164,121866,71948.63333333333,41.69103328344566,42.338257957054886,NaN,NaN,NaN,NaN,1.2454425201617243,30.580970619147692,87356974
2025-08-14T10:00:00-04:00,337.91,338.38,337.13,337.66,NaN,NaN,NaN,339.26858859733267,NaN,NaN,339.97880000000026,342.62845021087344,337.3291497891271,339.76787780549546,336.87920068308443,337.4569345914512,336.30146677471765,96119,72852.36666666667,40.99495748504331,41.613154692519245,NaN,NaN,NaN,NaN,1.245768054435887,30.93702004955704,87260855
2025-08-14T10:05:00-04:00,337.64,337.95,336.4,336.6,NaN,NaN,NaN,339.26858859733267,NaN,NaN,339.88350000000025,342.66628583438217,337.10071416561834,339.76787780549546,336.8899039487199,337.4380547330216,336.3417531644182,110845,74226.86666666667,36.08275681951323,40.462010603007116,NaN,NaN,NaN,NaN,1.267498907690467,31.664837826179586,87150010
2025-08-14T10:10:00-04:00,336.6,336.73,335.77,336.22,NaN,NaN,NaN,339.26858859733267,NaN,NaN,339.78950000000026,342.7384498130776,336.84055018692294,338.8118022443964,336.83253340006587,337.3874560922649,336.2776107078668,104415,71405.06666666667,34.487362448846625,39.60326738914381,NaN,NaN,NaN,NaN,1.2455346999982935,32.65292193091264,87045595
2025-08-14T10:15:00-04:00,336.26,336.68,335.85,336.64,NaN,NaN,NaN,339.26858859733267,NaN,NaN,339.70230000000026,342.75880336822735,336.6457966317732,334.46581047004406,336.8094245415205,337.35856131496854,336.2602877680725,65170,72123.73333333334,37.76279601103973,38.86592378033328,NaN,NaN,NaN,NaN,1.215853649998414,33.570428599593335,87110765
2025-08-14T10:20:00-04:00,336.68,337.06,336,336.84,NaN,NaN,NaN,339.26858859733267,NaN,NaN,339.62090000000023,342.76007931313757,336.4817206868629,334.46581047004406,336.79699274104945,337.3283087219919,336.265676760107,94800,74168.9,39.31863426552892,38.17801030321864,NaN,NaN,NaN,NaN,1.2047212464270989,33.90922557333374,87205565
2025-08-14T10:25:00-04:00,336.79,337.53,336.69,337.19,NaN,NaN,NaN,339.26858859733267,NaN,NaN,339.5659000000003,342.77634276695574,336.35545723304483,334.574598374824,336.8121207908008,337.33617591905,336.2880656625516,62592,75361.1,42.048863192500356,37.58966600992374,NaN,NaN,NaN,NaN,1.1786697288251615,33.614135583536246,87268157
2025-08-14T10:30:00-04:00,337.2,338.55,337.05,338.51,NaN,NaN,NaN,339.26858859733267,NaN,NaN,339.53010000000023,342.746914878113,336.3132851218875,335.43567869985924,336.8867449264343,337.47301230689874,336.30047754596984,91203,76932.66666666667,51.002652262090486,37.39622231173582,NaN,NaN,NaN,NaN,1.2016218910519356,32.171655936933455,87359360
2025-08-14T10:35:00-04:00,338.46,339.97,338.15,339.94,335.53229010143247,335.53229010143247,335.53229010143247,NaN,NaN,NaN,339.5329000000002,342.75089321939953,336.3149067806009,336.5685429598874,337.09694001005295,337.9850291735816,336.2088508465243,139416,80431.66666666667,58.485859021614445,38.7215340466047,NaN,NaN,NaN,NaN,1.245791755976801,30.20281074252268,87498776
2025-08-14T10:40:00-04:00,339.91,340.45,338.84,339.04,336.0580950968219,NaN,NaN,NaN,NaN,NaN,339.4865000000002,342.66443030132467,336.30856969867574,336.9238343679099,337.25154681316917,338.28865764625095,336.2144359800874,115403,83266.96666666666,52.99957009767009,40.71153713286235,NaN,NaN,NaN,NaN,1.2718066305498876,28.747277233045192,87383373
2025-08-14T10:45:00-04:00,339,339.17,338.45,338.57,336.0580950968219,NaN,NaN,NaN,NaN,NaN,339.4439000000002,342.6127125788922,336.27508742110825,336.9238343679099,337.3273389893646,338.3888330131139,336.26584496561526,94637,85567.26666666666,50.34366435980564,42.032569500325884,NaN,NaN,NaN,NaN,1.2323918712248978,27.037423312548675,87288736
2025-08-14T10:50:00-04:00,338.5,338.83,338.06,338.06,336.0580950968219,NaN,NaN,NaN,NaN,NaN,339.3903000000002,342.5602693437215,336.2203306562789,336.9238343679099,337.36219632106616,338.42065745954653,336.3037351825858,67418,86954.36666666667,47.55865368735459,43.41481587534033,NaN,NaN,NaN,NaN,1.199363880423118,25.113618265999705,87221318
2025-08-14T10:55:00-04:00,338.1,338.32,337.76,338.23,336.0580950968219,NaN,NaN,NaN,NaN,NaN,339.33630000000016,342.4914689717314,336.1811310282689,336.9238343679099,337.3953229049707,338.4411327052098,336.34951310473167,89528,88580.1,48.5797798436663,44.417224925793654,NaN,NaN,NaN,NaN,1.1536950318214667,23.5939768281434,87310846
2025-08-14T11:00:00-04:00,338.26,338.43,337.66,337.95,336.0580950968219,NaN,NaN,NaN,NaN,NaN,339.2655000000002,342.3828246542729,336.1481753457275,336.9238343679099,337.4172893535316,338.45069933612376,336.38387937093944,73818,89356.66666666667,46.95793843851857,44.87960865833124,NaN,NaN,NaN,NaN,1.1262882438342179,22.07498497256027,87237028
2025-08-14T11:05:00-04:00,337.94,337.94,336.8,336.94,336.0580950968219,NaN,NaN,NaN,NaN,NaN,339.17430000000013,342.29161295193904,336.0569870480612,336.9238343679099,337.40874494774357,338.4194986952464,336.39799120024077,97459,91696.86666666667,41.567162882889335,44.87076077257722,NaN,NaN,NaN,NaN,1.1279819407032006,21.425745072806045,87139569
2025-08-14T11:10:00-04:00,336.98,337.17,336.18,336.44,336.0580950968219,NaN,NaN,NaN,NaN,NaN,339.10110000000014,342.2988750327823,335.903324967218,336.9238343679099,337.37979346451965,338.38372266160354,336.37586426743576,80381,92579.4,39.16983579224089,44.74039493737705,NaN,NaN,NaN,NaN,1.1181260877958297,21.308293098685404,87059188
2025-08-14T11:15:00-04:00,336.43,336.97,336.3,336.34,336.0580950968219,NaN,NaN,NaN,NaN,NaN,339.02510000000007,342.3001893057245,335.75001069427566,336.9238343679099,337.3478700057112,338.34567206236204,336.3500679490603,88728,93352.33333333333,38.68923800694395,44.92657216505067,NaN,NaN,NaN,NaN,1.0861170815247,21.199230551287666,86970460
2025-08-14T11:20:00-04:00,336.3,336.31,333.78,333.88,NaN,NaN,NaN,338.5109597106752,338.5109597106752,338.5109597106752,338.90970000000016,342.4817394231079,335.3376605768924,336.9238343679099,337.123982362732,338.3344299454067,335.9135347800573,212642,98428.26666666666,29.19832911807066,44.54878406999524,NaN,NaN,NaN,NaN,1.1913944328443644,22.639799989117783,86757818
2025-08-14T11:25:00-04:00,333.86,333.88,331.28,332.51,NaN,NaN,NaN,336.2429615420082,NaN,NaN,338.75890000000015,342.7389720044028,334.7788279955975,336.9238343679099,336.71734838791843,338.4570640956226,334.97763268021424,249807,105773.7,25.453475381244644,43.669546882152744,NaN,NaN,NaN,NaN,1.2920091162126257,24.912633955729454,86508011
2025-08-14T11:30:00-04:00,332.53,332.74,331.2,331.21,NaN,NaN,NaN,335.67646329009875,NaN,NaN,338.57250000000016,343.0457450190176,334.0992549809827,335.9890674943279,336.450594500138,338.4823312877009,334.41885771257506,158107,110001.53333333334,22.50400436720328,42.4685018894152,NaN,NaN,NaN,NaN,1.3097227507688682,27.047962546815757,86349904
2025-08-14T11:35:00-04:00,331.24,331.88,330.53,331.26,NaN,NaN,NaN,334.92707859509426,NaN,NaN,338.37870000000015,343.245454487359,333.5119455126413,335.9459625570959,336.1837286238486,338.473045406286,333.89441184141117,159458,113880.1,22.874180293706758,41.09888168235851,NaN,NaN,NaN,NaN,1.3125996971425222,29.238768097341854,86509362
2025-08-14T11:40:00-04:00,331.21,331.54,330.4,331.3,NaN,NaN,NaN,334.6783477498627,NaN,NaN,338.17830000000015,343.3591492006791,332.9974507993212,335.9459625570959,335.9816775620298,338.4360361615905,333.5273189624691,128749,116823.6,23.190276861204737,39.112283439438094,NaN,NaN,NaN,NaN,1.3002711473466309,31.313209573626644,86638111
2025-08-14T11:45:00-04:00,331.34,333.08,330.93,333,NaN,NaN,NaN,334.6783477498627,NaN,NaN,338.02130000000017,343.342648253986,332.69995174601434,335.9459625570959,335.82148808330413,338.3349265579905,333.30804960861775,149494,119643.96666666666,35.32265138841552,37.457768608495314,NaN,NaN,NaN,NaN,1.3609660653932985,31.60101466750693,86787605
2025-08-14T11:50:00-04:00,333.02,333.29,331.61,331.69,NaN,NaN,NaN,334.6783477498627,NaN,NaN,337.85470000000015,343.43080703270823,332.27859296729207,335.3777700456767,335.7198709537502,338.26904563986466,333.1706962676358,98111,119810.83333333333,31.229134265313704,35.90273747761272,NaN,NaN,NaN,NaN,1.383754203579492,31.66680667433697,86689494
2025-08-14T11:55:00-04:00,331.66,332.65,331.54,332.04,NaN,NaN,NaN,334.6783477498627,NaN,NaN,337.6873000000001,343.4460648710749,331.9285351289253,334.6252160365414,335.6480784692141,338.2223041126539,333.07385282577434,70352,119003.5,33.44827114105972,34.69592367627372,NaN,NaN,NaN,NaN,1.3642003318952394,31.763686923788192,86759846
2025-08-14T12:00:00-04:00,332.04,332.04,331.39,331.6,NaN,NaN,NaN,334.6783477498627,NaN,NaN,337.5169000000001,343.478292753414,331.55550724658616,334.5991728292331,335.5797792870829,338.1834793621412,332.97607921202456,62472,114622.43333333333,32.0481924244026,33.58803358606287,NaN,NaN,NaN,NaN,1.3131860224741534,31.93423993973071,86697374
2025-08-14T12:05:00-04:00,331.51,331.79,331.1,331.65,NaN,NaN,NaN,334.6783477498627,NaN,NaN,337.3453000000001,343.47597578985534,331.2146242101449,333.13333826338646,335.48591889513176,338.1308472431083,332.84099054715523,85827,112215.56666666667,32.394500656079416,32.43194221552095,NaN,NaN,NaN,NaN,1.2686727351545708,32.25199194838845,86783201
2025-08-14T12:10:00-04:00,331.64,332.27,331.32,331.49,NaN,NaN,NaN,334.6783477498627,NaN,NaN,337.1697000000001,343.4562171311635,330.8831828688367,330.0386706107092,335.42080942884473,338.0888127506374,332.7528061070521,64951,110000.3,31.835378780715686,31.35175938282074,NaN,NaN,NaN,NaN,1.2459103969292435,31.992155625403118,86718250
2025-08-14T12:15:00-04:00,331.4,332.32,331.35,331.95,NaN,NaN,NaN,334.6783477498627,NaN,NaN,337.00970000000007,343.41119307900095,330.6082069209992,329.5348248749358,335.36731942475706,338.0501917437494,332.6844471057647,57920,108277.66666666667,35.293238654899994,30.903621937964356,NaN,NaN,NaN,NaN,1.2262025114342954,31.692549952338396,86776170
2025-08-14T12:20:00-04:00,331.92,332.17,331.23,331.93,NaN,NaN,NaN,334.6783477498627,NaN,NaN,336.8447000000001,343.3354948388761,330.3539051611241,329.5348248749358,335.3113029924607,338.01010112256955,332.61250486235184,60876,105085.46666666666,35.20960782635596,30.62074851182972,NaN,NaN,NaN,NaN,1.205759474903274,31.497611885698852,86715294
2025-08-14T12:25:00-04:00,331.94,331.94,331.19,331.45,NaN,NaN,NaN,334.6783477498627,NaN,NaN,336.67570000000006,343.2785484792881,330.07285152071205,329.5348248749358,335.2689796649099,337.98199412852875,332.5559652012911,44131,102494.3,33.17764231488381,30.227063105253993,NaN,NaN,NaN,NaN,1.1732052266958972,31.345836693694373,86671163
2025-08-14T12:30:00-04:00,331.47,331.82,331.34,331.5,NaN,NaN,NaN,334.6783477498627,NaN,NaN,336.51310000000007,343.21658055568304,329.8096194443171,329.55319033596714,335.2282198352303,337.95392941707047,332.5025102533901,43770,100749.33333333333,33.60746353800205,30.542001278106238,NaN,NaN,NaN,NaN,1.1236905676461917,31.20490258683307,86714933
2025-08-14T12:35:00-04:00,331.56,331.87,331.25,331.7,NaN,NaN,NaN,334.6783477498627,NaN,NaN,336.3491,343.1140578535629,329.58414214643716,329.7465522687737,335.1827928692217,337.9211780535208,332.4444076849226,50685,98744,35.39749271270965,31.252288230353734,NaN,NaN,NaN,NaN,1.0877126699571782,31.148769286885774,86765618
2025-08-14T12:40:00-04:00,331.7,331.8,330.86,331.22,NaN,NaN,NaN,334.6669207015995,NaN,NaN,336.17390000000006,343.0070407976445,329.3407592023556,329.7465522687737,335.11260017577973,337.8751187330629,332.3500816184966,74263,97738.93333333333,33.09152334558689,32.00853958595256,NaN,NaN,NaN,NaN,1.0771617649602367,31.418020613850523,86691355
2025-08-14T12:45:00-04:00,331.2,331.69,331.09,331.63,NaN,NaN,NaN,334.6570606697085,NaN,NaN,336.00610000000006,342.86522160269004,329.1469783973101,329.7465522687737,335.07730035302984,337.84946380067544,332.30513690538424,40268,96908.86666666667,36.87433157580359,33.00855039181662,NaN,NaN,NaN,NaN,1.043078781748793,31.668039703174927,86731623
2025-08-14T12:50:00-04:00,331.64,332.18,331.64,332.08,NaN,NaN,NaN,334.6570606697085,NaN,NaN,335.8307000000001,342.63368170219366,329.02771829780653,330.2769947616121,335.0286442097457,337.8059933248109,332.25129509468053,66029,95949.83333333333,40.82853361394046,34.268425874154886,NaN,NaN,NaN,NaN,1.0078588687667371,31.0703721534634,86797652
2025-08-14T12:55:00-04:00,332.11,332.45,331.87,332.3,NaN,NaN,NaN,334.6570606697085,NaN,NaN,335.6537000000001,342.3536190473032,328.95378095269695,330.6375958092897,334.9813923973581,337.75909280812465,332.20369198659154,71886,96259.63333333333,42.71769138463056,34.796643016741676,NaN,NaN,NaN,NaN,0.9772975209976833,30.087248728496007,86869538
2025-08-14T13:00:00-04:00,332.3,332.47,332.03,332.19,NaN,NaN,NaN,334.6570606697085,NaN,NaN,335.4853000000001,342.1011949236252,328.869405076375,330.80007664743175,334.9580149475914,337.7353944963211,332.1806353988617,36790,94445.86666666667,41.995727139481176,35.5656853648965,NaN,NaN,NaN,NaN,0.9389191266407099,29.141980142809366,86832748
2025-08-14T13:05:00-04:00,332.17,332.48,331.8,332.44,NaN,NaN,NaN,334.6570606697085,NaN,NaN,335.3197000000002,341.81663109399955,328.8227689060008,330.8040613179454,334.9306072446474,337.70725924736433,332.1539552419304,44107,91268.9,44.29980238989245,36.34079473981312,NaN,NaN,NaN,NaN,0.920424903309231,28.535391988245067,86876855
2025-08-14T13:10:00-04:00,332.49,332.88,332.43,332.57,NaN,NaN,NaN,334.6570606697085,NaN,NaN,335.1683000000001,341.56083239651,328.7757676034902,331.3142490543563,334.8956247423461,337.6654814906269,332.1257679940653,67439,89670.1,45.51186933571421,37.30248594776395,NaN,NaN,NaN,NaN,0.8868231245014279,27.293252987568923,86944294
2025-08-14T13:15:00-04:00,332.595,333.5,332.48,333.15,NaN,NaN,NaN,334.6570606697085,NaN,NaN,335.0255000000001,341.27131788083085,328.7796821191693,331.7373992434851,334.85962017389176,337.6143201125376,332.1049202352459,88045,89450.36666666667,50.66954810963196,38.60784648016056,NaN,NaN,NaN,NaN,0.8963357584656102,25.47024767806975,87032339
2025-08-14T13:20:00-04:00,333.16,333.58,332.9,333.42,NaN,NaN,NaN,334.6570606697085,NaN,NaN,334.88650000000007,340.9572555543399,328.81574444566024,331.829919394788,334.83752252467946,337.57884167962567,332.09620336973325,65100,89373.1,52.904421730277186,40.11277811941495,NaN,NaN,NaN,NaN,0.8808832042894956,23.88896192879362,87097439
2025-08-14T13:25:00-04:00,333.39,334.13,333.34,333.96,NaN,NaN,NaN,334.6570606697085,NaN,NaN,334.75590000000005,340.6161544962324,328.8956455037677,332.3349355158304,334.81817834740576,337.537159518263,332.0991971765485,88159,89327.46666666666,57.091366555552796,41.66978725517587,NaN,NaN,NaN,NaN,0.8743915468402473,23.147539244461466,87185598
2025-08-14T13:30:00-04:00,333.99,334.01,332.99,333.16,NaN,NaN,NaN,334.6570606697085,NaN,NaN,334.603,340.21775662880793,328.9882433711921,332.3349355158304,334.79506565544835,337.4980358669139,332.0920954439828,76848,89428.46666666666,49.99945536740518,42.72620493667938,NaN,NaN,NaN,NaN,0.8847921506373712,21.91348388554563,87108750
2025-08-14T13:35:00-04:00,333.12,333.77,332.77,333.65,NaN,NaN,NaN,334.6570606697085,NaN,NaN,334.48920000000004,339.9436672921023,329.0347327078978,332.3349355158304,334.78147756846784,337.474779044716,332.08817609221967,46703,87736.6,53.78611367485452,44.19823860524872,NaN,NaN,NaN,NaN,0.8930212827347017,20.43811211627722,87155453
2025-08-14T13:40:00-04:00,333.72,333.92,333.4,333.81,NaN,NaN,NaN,334.6570606697085,NaN,NaN,334.44100000000003,339.8759951242535,329.00600487574656,332.3349355158304,334.7655080476365,337.4418143819814,332.08920171329163,72719,87481.2,54.98491722951128,45.725199583213666,NaN,NaN,NaN,NaN,0.8663769053965115,19.286753876766262,87228172
2025-08-14T13:45:00-04:00,333.79,334.5,333.63,334.42,NaN,NaN,NaN,334.6570606697085,NaN,NaN,334.3896000000001,339.7755862012913,329.0036137987089,332.54062158728414,334.75355809873463,337.403540563922,332.1035756335473,102249,87931.9,59.31777797740554,47.433791387834795,NaN,NaN,NaN,NaN,0.8666356978681895,18.998958832422865,87330421
2025-08-14T13:50:00-04:00,334.42,334.53,333.86,334.26,NaN,NaN,NaN,334.6570606697085,NaN,NaN,334.35560000000004,339.72293402730503,328.98826597269505,332.6274972698273,334.74766043258626,337.3836419719758,332.1116788931967,55327,82688.06666666667,57.74768247526905,49.19494561138352,NaN,NaN,NaN,NaN,0.8525902908776016,18.770023086859098,87275094
2025-08-14T13:55:00-04:00,334.28,334.57,334,334.51,NaN,NaN,NaN,334.6570606697085,NaN,NaN,334.3104,339.63352533768636,328.98727466231367,332.76299781586187,334.74420434951554,337.36866237455763,332.11974632447345,45307,75871.4,59.549337127986256,50.814588865110856,NaN,NaN,NaN,NaN,0.8324052701006296,18.611598260499022,87320401
2025-08-14T14:00:00-04:00,334.49,334.49,333.48,333.49,NaN,NaN,NaN,334.6570606697085,NaN,NaN,334.2278,339.4705035621702,328.9850964378298,332.76299781586187,334.73653245689275,337.35141973240894,332.12164518137655,42539,72019.13333333333,50.15292373694343,51.48061673103963,NaN,NaN,NaN,NaN,0.8465191793791541,17.53250596193901,87277862
2025-08-14T14:05:00-04:00,333.54,333.72,333.24,333.57,NaN,NaN,NaN,334.6570606697085,NaN,NaN,334.1432,339.28820525177986,328.9981947482201,332.76299781586187,334.7257681537979,337.33166797043003,332.11986833716577,45372,68216.26666666666,50.808539518461735,52.058534454884715,NaN,NaN,NaN,NaN,0.8203392379949301,16.419569205799096,87323234
2025-08-14T14:10:00-04:00,333.57,333.76,333.17,333.33,NaN,NaN,NaN,334.6570606697085,NaN,NaN,334.05660000000006,339.1068033385377,329.0063966614624,332.76299781586187,334.7156115402197,337.31389037309697,332.1173327073424,40528,65275.566666666666,48.737543414087405,52.54009276021373,NaN,NaN,NaN,NaN,0.8038864352810047,15.500191067433121,87282706
2025-08-14T14:15:00-04:00,333.34,333.4,332.94,333.16,NaN,NaN,NaN,334.6570606697085,NaN,NaN,333.9878,338.99104101365833,328.98455898634165,332.76299781586187,334.70137640027104,337.29190840320547,332.1108443973366,48329,61903.4,47.267836759343695,52.75209521517454,NaN,NaN,NaN,NaN,0.7793231184752172,15.021883175733928,87234377
2025-08-14T14:20:00-04:00,333.16,333.52,332.85,333.38,NaN,NaN,NaN,334.6570606697085,NaN,NaN,333.931,338.8959221545546,328.96607784544534,332.76299781586187,334.6877267633262,337.26985137028765,332.1056021563648,49926,60297.23333333333,49.3946149686495,53.02943418895563,NaN,NaN,NaN,NaN,0.771514324298413,14.34686868026121,87284303
2025-08-14T14:25:00-04:00,333.33,333.46,332.85,332.96,NaN,NaN,NaN,334.6570606697085,NaN,NaN,333.8574,338.76831813827243,328.94648186172753,332.76299781586187,334.6777560880521,337.25488443627484,332.10062773982935,33337,59063.4,45.61244324811025,52.66821241313266,NaN,NaN,NaN,NaN,0.7599775868485233,13.72006950589369,87250966
2025-08-14T14:30:00-04:00,333,333.31,332.96,333.08,NaN,NaN,NaN,334.6570606697085,NaN,NaN,333.7822,338.6227756518021,328.9416243481979,332.76299781586187,334.6663418258677,337.2374733694375,332.09521028229784,39347,58292.566666666666,46.86432829668634,52.23677716787616,NaN,NaN,NaN,NaN,0.7306934735022018,13.138041701123848,87290313
2025-08-14T14:35:00-04:00,333.03,333.58,333,333.51,NaN,NaN,NaN,334.6570606697085,NaN,NaN,333.7086,338.4505810375851,328.9666189624149,332.76299781586187,334.6547757649853,337.21738669135146,332.0921648386191,48195,57038.166666666664,51.19908531289795,51.815899936257956,NaN,NaN,NaN,NaN,0.719929653966329,12.382649318302285,87338508
2025-08-14T14:40:00-04:00,333.54,334.09,333.44,333.96,NaN,NaN,NaN,334.6570606697085,NaN,NaN,333.61760000000004,338.1578688203095,329.0773311796906,332.76299781586187,334.64861738137745,337.2026303506624,332.0946044120925,40846,56234.666666666664,55.30808656579934,52.195087879000404,NaN,NaN,NaN,NaN,0.7149346786830181,12.624242094230906,87379354
2025-08-14T14:45:00-04:00,333.94,334.12,333.65,334.06,NaN,NaN,NaN,334.6570606697085,NaN,NaN,333.5,337.66852012118943,329.33147987881057,332.6895272655632,334.64245203420097,337.18612475704157,332.0987793113604,48242,55912.066666666666,56.19085193773615,52.366854897777664,NaN,NaN,NaN,NaN,0.6974393444913759,12.89978363508692,87427596
2025-08-14T14:50:00-04:00,334.05,334.41,333.91,333.93,NaN,NaN,NaN,334.6570606697085,NaN,NaN,333.3978000000001,337.2571062382507,329.53849376174946,333.01562181245055,334.636546826008,337.1673967061022,332.1056969459138,58908,55846.46666666667,54.678811378790776,52.34499019415477,NaN,NaN,NaN,NaN,0.6833365341705634,13.641154205867547,87368688
2025-08-14T14:55:00-04:00,333.93,334.18,333.68,334.17,NaN,NaN,NaN,334.6570606697085,NaN,NaN,333.30980000000005,336.88343118418527,329.73616881581484,333.01562181245055,334.6320545742741,337.15436921746436,332.1097399310838,40279,55718.066666666666,56.98034498278268,52.178030694538855,NaN,NaN,NaN,NaN,0.6702410674440946,13.75725422250061,87408967
2025-08-14T15:00:00-04:00,334.115,334.82,334.05,334.7,332.15094892901243,332.15094892901243,332.15094892901243,NaN,NaN,NaN,333.24260000000004,336.5746019448685,329.9105980551316,333.3425979599684,334.63109299346235,337.14224923839964,332.11993674852505,50130,55930.066666666666,61.61604249726011,52.45434212468108,NaN,NaN,NaN,NaN,0.677366705483801,14.851694380531914,87459097
2025-08-14T15:05:00-04:00,334.7,334.87,334.19,334.77,332.2570421595118,NaN,NaN,NaN,NaN,NaN,333.1734,336.2196740783817,330.12712592161836,333.34807836797467,334.6308764592137,337.1291109756601,332.1326419427673,58789,56200.2,62.195469682186804,52.64335159283825,NaN,NaN,NaN,NaN,0.6775547979492442,15.936498301588125,87517886
2025-08-14T15:10:00-04:00,334.78,334.8,334.22,334.62,332.26126751589766,NaN,NaN,NaN,NaN,NaN,333.1068000000001,335.86436832018745,330.3492316798127,333.34807836797467,334.630393738628,337.1214656904874,332.1393217867686,33017,54825.333333333336,60.10177049017347,53.35398350378325,NaN,NaN,NaN,NaN,0.6705865980957257,16.943816228283183,87484869
2025-08-14T15:15:00-04:00,334.59,334.77,333.8,334.73,332.26126751589766,NaN,NaN,NaN,NaN,NaN,333.0626000000001,335.6378042560745,330.4873957439257,333.34807836797467,334.6286774537113,337.10894535453474,332.14840955288787,50605,55169.9,61.13500814290923,54.0915884055295,NaN,NaN,NaN,NaN,0.6919732696603146,16.79747622003161,87535474
2025-08-14T15:20:00-04:00,334.73,334.75,334.28,334.33,332.27570036055965,NaN,NaN,NaN,NaN,NaN,333.0204000000001,335.4371149936186,330.6036850063816,333.34807836797467,334.62718716219706,337.09694483076356,332.15742949363056,49807,54629.166666666664,55.505921815297015,54.57504400561591,NaN,NaN,NaN,NaN,0.6761180361131512,16.661589069512285,87485667
2025-08-14T15:25:00-04:00,334.31,334.53,334.07,334.37,332.27570036055965,NaN,NaN,NaN,NaN,NaN,332.98100000000005,335.23897165628415,330.72302834371595,333.34807836797467,334.62504343582737,337.0862048620876,332.16388200956715,41638,53620.9,55.94278919445642,55.19468346526681,NaN,NaN,NaN,NaN,0.660681033533639,16.016254090174357,87527305
2025-08-14T15:30:00-04:00,334.38,334.7,334.33,334.47,332.3643158243942,NaN,NaN,NaN,NaN,NaN,332.99280000000005,335.2754722586964,330.71012774130367,333.34807836797467,334.6239402855732,337.07424921026325,332.1736313608832,52530,54145.566666666666,57.077428510930396,55.74345586114402,NaN,NaN,NaN,NaN,0.6399181025669509,15.761872993018075,87579835
2025-08-14T15:35:00-04:00,334.48,334.91,334.23,334.6,332.42434692328544,NaN,NaN,NaN,NaN,NaN,333.03460000000007,335.3565826357092,330.71261736429096,333.4618341756944,334.6234296624299,337.059464207096,332.18739511776374,70008,55008.933333333334,58.571157017880246,56.66907827327045,NaN,NaN,NaN,NaN,0.6427810952407407,15.932188485027229,87649843
2025-08-14T15:40:00-04:00,334.61,335.06,334.3,334.44,332.52824024495425,NaN,NaN,NaN,NaN,NaN,333.09920000000005,335.3941051049183,330.8042948950818,333.5214673405555,334.6231096824009,337.04245404892663,332.2037653158752,83414,55541.433333333334,55.9886173952315,57.320813208880814,NaN,NaN,NaN,NaN,0.6511538741521157,16.368796405921753,87566429
2025-08-14T15:45:00-04:00,334.42,334.65,334.01,334.07,332.52824024495425,NaN,NaN,NaN,NaN,NaN,333.1554000000001,335.4045641470734,330.9062358529268,333.5214673405555,334.61905489332645,337.0257657210725,332.2123440655804,65915,54803.76666666667,50.44897233842414,57.267233710704126,NaN,NaN,NaN,NaN,0.6503571688555351,15.987769851397685,87500514
2025-08-14T15:50:00-04:00,334.07,335.09,334.07,334.52,332.52824024495425,NaN,NaN,NaN,NaN,NaN,333.2198000000001,335.43694226889056,331.0026577311096,333.5214673405555,334.618200357272,337.00744534920824,332.2289553653357,90646,55655.3,56.133688524536446,57.32620527918534,NaN,NaN,NaN,NaN,0.6767602282229956,16.450344437315096,87591160
2025-08-14T15:55:00-04:00,334.5,336.03,334.355,335.58,332.8803299125208,NaN,NaN,NaN,NaN,NaN,333.27140000000014,335.5837252713311,330.9590747286692,333.79197127836443,334.64035152852466,336.99488569344527,332.28581736360405,203668,59505.6,66.02217336542994,58.02844252402061,NaN,NaN,NaN,NaN,0.7480630690642069,18.14338101527777,87794828
2025-08-15T09:30:00-04:00,337.65,339.31,336.81,336.9,335.3442921892244,NaN,NaN,NaN,NaN,NaN,333.37560000000013,335.8568679340205,330.89433206597977,335.65457702269157,337.67333333333335,337.67333333333335,337.67333333333335,248048,65212.26666666667,73.90955520942752,59.4020670833518,NaN,NaN,NaN,NaN,0.9610585641310506,21.688658386028983,88042876
2025-08-15T09:35:00-04:00,336.93,337.13,334.85,334.86,NaN,NaN,NaN,338.89317563755856,338.89317563755856,338.89317563755856,333.43200000000013,335.91746494650874,330.9465350534915,335.65457702269157,336.8772753132776,337.88035614254596,335.87419448400925,156226,68863.03333333334,53.312427978431785,59.14007301161245,NaN,NaN,NaN,NaN,1.0552686666931164,22.23617272447193,87886650
2025-08-15T09:40:00-04:00,334.9,335.92,334.28,334.83,NaN,NaN,NaN,338.094849472215,NaN,NaN,333.49660000000017,335.9560100431228,331.03718995687757,335.65457702269157,336.4570298246253,337.63509260271945,335.27896704653114,117409,70352.7,53.07816818289835,58.5302248463009,NaN,NaN,NaN,NaN,1.097035190500754,22.126228714794266,87769241
2025-08-15T09:45:00-04:00,334.82,334.92,332.36,332.51,NaN,NaN,NaN,336.84781085984156,NaN,NaN,333.5138000000001,335.9330127315232,331.094587268477,335.65457702269157,335.6477334064163,337.36989361290705,333.92557319992557,177066,72846.6,38.85808575087017,56.863268851206854,NaN,NaN,NaN,NaN,1.2015326768935577,20.751545284380075,87592175
2025-08-15T09:50:00-04:00,332.55,333.39,332.15,332.48,NaN,NaN,NaN,336.0010921843942,NaN,NaN,333.53360000000015,335.9019032239013,331.165296776099,335.65457702269157,335.1299673766192,337.0590921067639,333.20084264647454,147270,75911.36666666667,38.71365213486285,55.33554611154182,NaN,NaN,NaN,NaN,1.2042803428297328,19.631082187859125,87444905
2025-08-15T09:55:00-04:00,332.45,333.64,332.45,333.11,NaN,NaN,NaN,336.0010921843942,NaN,NaN,333.5568000000001,335.8849836354435,331.22861636455673,335.65457702269157,334.920923269708,336.8527866657859,332.9890598736301,95378,77580.4,43.465922797958505,54.07346858690248,NaN,NaN,NaN,NaN,1.2032603183418946,18.38031486321313,87540283
2025-08-15T10:00:00-04:00,333.11,334.07,332.25,333.82,NaN,NaN,NaN,336.0010921843942,NaN,NaN,333.5946000000001,335.87682421343317,331.3123757865671,335.65457702269157,334.73063945749243,336.60899940165774,332.8522795133271,132628,80583.36666666667,48.32875039744952,53.560813485627655,NaN,NaN,NaN,NaN,1.2473131527460446,17.27598232271053,87672911
2025-08-15T10:05:00-04:00,333.91,334.32,333.33,333.74,NaN,NaN,NaN,336.0010921843942,NaN,NaN,333.64040000000017,335.8390139634414,331.44178603655894,335.65457702269157,334.64927591418063,336.46317866808135,332.8353731602799,102493,82487.4,47.82953150337579,52.98129507912189,NaN,NaN,NaN,NaN,1.2289336418356136,16.45838577046519,87570418
2025-08-15T10:10:00-04:00,333.79,333.85,332.26,332.96,NaN,NaN,NaN,336.0010921843942,NaN,NaN,333.6696000000001,335.7911615381963,331.5480384618039,335.65457702269157,334.50549863143465,336.2978151343482,332.7131821285211,114128,84940.73333333334,43.14948310350591,51.98644183573443,NaN,NaN,NaN,NaN,1.2547240959902148,15.784001413503827,87456290
2025-08-15T10:15:00-04:00,333.01,333.51,332.24,332.78,NaN,NaN,NaN,336.0010921843942,NaN,NaN,333.69120000000015,335.75326746745014,331.62913253255016,335.65457702269157,334.41339664280025,336.19637243560584,332.63042084999466,75711,85853.46666666666,42.12511072675965,50.811724243511534,NaN,NaN,NaN,NaN,1.2558152319909124,15.173976687808183,87380579
2025-08-15T10:20:00-04:00,332.84,333.57,332.5,332.59,NaN,NaN,NaN,336.0010921843942,NaN,NaN,333.71860000000015,335.6826733591771,331.7545266408232,333.06566161815323,334.3346354300067,336.10354682065724,332.56572403935616,74322,86666.66666666667,41.01817011241153,49.742406580452965,NaN,NaN,NaN,NaN,1.2425427154201325,14.547670784054048,87306257
2025-08-15T10:25:00-04:00,332.59,333.05,331.86,332.88,NaN,NaN,NaN,335.8674853958877,NaN,NaN,333.74360000000013,335.63102262366345,331.8561773763368,331.8485292945226,334.2068349145491,335.96886078369795,332.4448090454003,114348,89367.03333333334,43.4602843046428,49.24321457804001,NaN,NaN,NaN,NaN,1.2387896643186944,14.51672821352632,87420605
2025-08-15T10:30:00-04:00,332.92,333.13,332.33,332.9,NaN,NaN,NaN,335.8674853958877,NaN,NaN,333.76000000000016,335.6030453060542,331.91695469394614,330.54033247922916,334.1627942856181,335.91466762672184,332.4109209445143,49766,89714.33333333333,43.63361862469102,48.35035244233677,NaN,NaN,NaN,NaN,1.2074475454387883,14.398612821710675,87470371
2025-08-15T10:35:00-04:00,332.85,333.34,332.6,332.97,NaN,NaN,NaN,335.8674853958877,NaN,NaN,333.7734000000002,335.5832336277406,331.96356637225983,330.54033247922916,334.1191772062606,335.85323521941297,332.3851191931082,60910,90138.16666666667,44.27751230929042,46.797162366898235,NaN,NaN,NaN,NaN,1.1740584350503,14.04654032003381,87531281
2025-08-15T10:40:00-04:00,332.99,333.13,332.3,332.39,NaN,NaN,NaN,335.8674853958877,NaN,NaN,333.7774000000001,335.57405382317523,331.980746176825,330.54033247922916,334.067775766658,335.7940061427665,332.34154539054947,58599,90729.93333333333,40.181726466087255,44.388031742373926,NaN,NaN,NaN,NaN,1.1494828325467061,14.005514511196631,87472682
2025-08-15T10:45:00-04:00,332.44,332.67,331.98,332.47,NaN,NaN,NaN,335.54702262600586,NaN,NaN,333.7780000000001,335.5728860689362,331.98311393106394,330.54033247922916,333.9904035078494,335.7134588448878,332.26734817081103,82503,91871.96666666666,40.99251538902082,43.50803798598742,NaN,NaN,NaN,NaN,1.1166626302219413,14.266144297571984,87555185
2025-08-15T10:50:00-04:00,332.49,332.74,331.88,332.29,NaN,NaN,NaN,335.5028397793692,NaN,NaN,333.7724000000001,335.5839962464844,331.96080375351585,330.54033247922916,333.92241619504154,335.6426929652998,332.2021394247833,75870,92437.36666666667,39.68901415881108,42.55166984140976,NaN,NaN,NaN,NaN,1.0983295852060893,14.60229983193287,87479315
2025-08-15T10:55:00-04:00,332.24,332.73,331.98,332.22,NaN,NaN,NaN,335.5028397793692,NaN,NaN,333.7538000000001,335.6091442376642,331.898455762336,330.48386123743506,333.86168164427386,335.5769435897529,332.14641969879483,73690,93551.06666666667,39.1674089284943,42.5737643540972,NaN,NaN,NaN,NaN,1.0734489005485115,14.91444425669655,87405625
2025-08-15T11:00:00-04:00,332.18,332.59,331.9,332.32,NaN,NaN,NaN,335.34589327004505,NaN,NaN,333.7318000000001,335.6280898091824,331.83551019081773,330.48386123743506,333.81257295109043,335.523450780944,332.10169512123684,62282,93956.13333333333,40.37300328079316,42.69228943594936,NaN,NaN,NaN,NaN,1.0460596933664748,15.288983060846489,87467907
2025-08-15T11:05:00-04:00,332.33,332.68,332.2,332.35,NaN,NaN,NaN,335.34589327004505,NaN,NaN,333.69960000000015,335.6335988004887,331.7656011995116,330.6778211602262,333.77866229475853,335.48240677698334,332.0749178125337,50015,93663.66666666667,40.75235488182756,42.49846315622573,NaN,NaN,NaN,NaN,1.0056268581260135,15.487263012301591,87517922
2025-08-15T11:10:00-04:00,332.345,333.64,332.31,333.31,NaN,NaN,NaN,335.34589327004505,NaN,NaN,333.7026000000001,335.63370459592096,331.7714954040792,331.3732569281809,333.7474121363181,335.41843194851214,332.076392324124,97838,95824.36666666667,51.406363590204066,42.718292669993915,NaN,NaN,NaN,NaN,1.0287963682598684,14.496801438411477,87615760
2025-08-15T11:15:00-04:00,333.33,333.76,333.06,333.42,NaN,NaN,NaN,335.34589327004505,NaN,NaN,333.6980000000001,335.63067896979896,331.7653210302012,331.59660554254475,333.73432631976834,335.3735741393006,332.09507850023607,88321,97081.56666666667,52.46122659502787,43.04912803368335,NaN,NaN,NaN,NaN,1.0053109133841627,13.731349489077804,87704081
2025-08-15T11:20:00-04:00,333.38,333.79,332.97,332.97,NaN,NaN,NaN,335.34589327004505,NaN,NaN,333.6812000000001,335.6242682541436,331.7381317458566,331.64928443403585,333.7239309461349,335.34727226365663,332.10058962861314,48772,97047.06666666667,47.88198728225815,43.38716404645137,NaN,NaN,NaN,NaN,0.9920744195710077,12.891425372431325,87655309
2025-08-15T11:25:00-04:00,333,333.43,332.75,332.94,NaN,NaN,NaN,335.34589327004505,NaN,NaN,333.6516000000001,335.59383936741204,331.70936063258813,331.64928443403585,333.71338349984495,335.3263619283767,332.1004050713132,36082,96861.86666666667,47.58378749345239,43.777069529786566,NaN,NaN,NaN,NaN,0.9697833896016504,12.149128252693243,87619227
2025-08-15T11:30:00-04:00,332.89,333.47,332.81,333.41,NaN,NaN,NaN,335.34589327004505,NaN,NaN,333.63460000000015,335.5701090700241,331.6990909299762,331.64928443403585,333.7061037976398,335.3079727056799,332.1042348895997,35774,96303.33333333333,52.56770234418076,44.602036117770076,NaN,NaN,NaN,NaN,0.9476560046301057,11.397523464165552,87655001
2025-08-15T11:35:00-04:00,333.41,333.56,332.5,332.5,NaN,NaN,NaN,335.34589327004505,NaN,NaN,333.5944000000001,335.5389849326536,331.64981506734665,331.64928443403585,333.6861264994594,335.2743674510301,332.0978855478887,56983,95869.16666666667,43.87006203121232,44.63130595538219,NaN,NaN,NaN,NaN,0.9556805757279554,11.16575017408833,87598018
2025-08-15T11:40:00-04:00,332.5,332.56,331.2,331.47,NaN,NaN,NaN,334.8562861935145,NaN,NaN,333.5540000000001,335.5874837103793,331.5205162896209,331.64928443403585,333.6027409176546,335.20564136249584,331.9998404728134,109083,96724.8,36.50727298370419,44.12228126674027,NaN,NaN,NaN,NaN,0.9845605346045311,12.462936267947661,87488935
2025-08-15T11:45:00-04:00,331.46,331.95,330.76,331.81,NaN,NaN,NaN,334.3582731847184,NaN,NaN,333.5188000000001,335.61006809383184,331.4275319061684,331.64928443403585,333.52057489766696,335.14355013148503,331.8975996638489,103692,97984.03333333334,40.082115825227696,43.82261008930722,NaN,NaN,NaN,NaN,0.9992347821327787,14.058768592834634,87592627
2025-08-15T11:50:00-04:00,331.77,331.98,331.41,331.64,NaN,NaN,NaN,334.3582731847184,NaN,NaN,333.4850000000001,335.64100834883783,331.3289916511624,331.64928443403585,333.47746331902533,335.1053755725203,331.84955106553036,63327,97073.4,38.902698801913104,43.73125097043764,NaN,NaN,NaN,NaN,0.9685751548375797,15.486118967417712,87529300
2025-08-15T11:55:00-04:00,331.64,331.97,329.42,329.65,NaN,NaN,NaN,333.85337494723314,NaN,NaN,333.4148000000001,335.82245193501853,331.0071480649817,331.64928443403585,333.25029789844154,335.0159185175194,331.48467727936367,211902,97347.86666666667,28.37662637950133,42.83011604118624,NaN,NaN,NaN,NaN,1.081534072349182,18.167873345478572,87317398
2025-08-15T12:00:00-04:00,329.62,329.88,327.02,327.72,NaN,NaN,NaN,331.8548124496316,NaN,NaN,333.3016000000001,336.1894874216764,330.41371257832384,331.64928443403585,332.86281879197446,335.0266304791194,330.69900710482955,243035,97180.76666666666,22.12426142042598,41.575490845587304,NaN,NaN,NaN,NaN,1.20856735289567,21.57113765569759,87074363
2025-08-15T12:05:00-04:00,327.7,328.58,327.38,328.48,NaN,NaN,NaN,331.393684611012,NaN,NaN,333.2120000000001,336.39920441772716,330.02479558227304,331.64928443403585,332.6908936043366,334.99147286736786,330.3903143413054,119686,95962.76666666666,28.77902231854364,40.83346323059084,NaN,NaN,NaN,NaN,1.207955399117407,24.731311658043825,87194049
2025-08-15T12:10:00-04:00,328.445,328.52,327.7,328.51,NaN,NaN,NaN,331.393684611012,NaN,NaN,333.1206000000002,336.56910207483884,329.67209792516155,331.49794203778293,332.54624255924085,334.9426874885964,330.1497976298853,110370,95728.13333333333,29.036806210702423,40.0237348684415,NaN,NaN,NaN,NaN,1.180244299180449,27.66575894593676,87304419
2025-08-15T12:15:00-04:00,328.48,328.7,327.6,327.88,NaN,NaN,NaN,331.393684611012,NaN,NaN,333.00800000000015,336.7531878457931,329.2628121542072,331.49794203778293,332.39788636418456,334.88718068961066,329.90859203875846,116059,93694.56666666667,26.83980086845898,39.02998101034374,NaN,NaN,NaN,NaN,1.1745125635247002,30.096167930296396,87188360
2025-08-15T12:20:00-04:00,327.84,328.25,327.62,327.75,NaN,NaN,NaN,331.2349956031726,NaN,NaN,332.8838000000002,336.89677274351385,328.8708272564865,331.4523536302263,332.26663872129683,334.834409632345,329.69886781024866,104847,92280.46666666666,26.3959801761213,37.24352505219497,NaN,NaN,NaN,NaN,1.1356188089872215,32.35297627291606,87083513
2025-08-15T12:25:00-04:00,327.7,328.04,327.13,327.91,NaN,NaN,NaN,330.85908671211934,NaN,NaN,332.7608000000002,336.9930397663844,328.52856023361596,330.19388290418107,332.12150899048,334.7723334417668,329.47068453919314,118460,93049.86666666667,27.974591810220645,35.49447971042302,NaN,NaN,NaN,NaN,1.1195031797738504,34.64771697486365,87201973
2025-08-15T12:30:00-04:00,327.97,328.35,327.97,328.15,NaN,NaN,NaN,330.85908671211934,NaN,NaN,332.64520000000016,337.05539226794605,328.23500773205427,329.7046850586759,332.0507315757637,334.72973207213164,329.3717310793957,67848,90890.53333333334,30.386405559908454,34.24479530168376,NaN,NaN,NaN,NaN,1.0709672383614324,36.22354758879299,87269821
2025-08-15T12:35:00-04:00,328.1,328.92,327.95,328.9,NaN,NaN,NaN,330.85908671211934,NaN,NaN,332.5398000000002,337.0499529730403,328.02964702696005,329.7046850586759,331.97702032158975,334.67402587852825,329.28001476465124,82715,90231.26666666666,37.43677494835679,33.52000869131979,NaN,NaN,NaN,NaN,1.0637552927641891,36.729318742604065,87352536
2025-08-15T12:40:00-04:00,328.92,329.54,328.72,329.25,NaN,NaN,NaN,330.85908671211934,NaN,NaN,332.43080000000015,336.9900171960024,327.8715828039979,328.87474804694074,331.89582443703443,334.5948541879092,329.19679468615965,115679,90282.96666666666,40.466947953507315,32.65566909198597,NaN,NaN,NaN,NaN,1.0463442004238894,36.266712831614704,87468215
2025-08-15T12:45:00-04:00,329.26,329.94,329.05,329.915,NaN,NaN,NaN,330.85908671211934,NaN,NaN,332.3337000000002,336.8963022443586,327.7710977556418,327.59926557317823,331.8566302908232,334.5483855323911,329.16487504925533,70553,90111.03333333334,45.83487192023898,32.79601265548787,NaN,NaN,NaN,NaN,1.0351767575364677,35.28346036961567,87538768
2025-08-15T12:50:00-04:00,329.95,330.22,329.63,329.93,NaN,NaN,NaN,330.85908671211934,NaN,NaN,332.2399000000002,336.80347249971476,327.67632750028565,328.0524124585426,331.8180933519015,334.49648077061,329.139705933193,82918,90397.56666666667,45.953250216948945,33.47072531500535,NaN,NaN,NaN,NaN,1.0033784177124365,33.994738733639835,87621686
2025-08-15T12:55:00-04:00,329.92,330.3,329.4,330.01,NaN,NaN,NaN,330.85908671211934,NaN,NaN,332.1455000000002,336.69437865304724,327.59662134695316,328.1159299668341,331.78561602208754,334.45267666738255,329.11855537679253,71650,88974.3,46.6232700945276,33.937950619955345,NaN,NaN,NaN,NaN,0.9959942450186935,33.01438054185644,87693336
2025-08-15T13:00:00-04:00,330.09,330.85,329.79,330.5,NaN,NaN,NaN,330.85908671211934,NaN,NaN,332.06890000000016,336.59699862527833,327.540801374722,328.57274397346725,331.7626501675079,334.41382839769227,329.11147193732353,70165,89654.26666666666,50.65809587270346,34.77762183929751,NaN,NaN,NaN,NaN,1.0005660846602156,31.364217667949557,87763501
2025-08-15T13:05:00-04:00,330.49,331.3,330.35,331.14,327.78628569219785,327.78628569219785,327.78628569219785,NaN,NaN,NaN,332.00430000000017,336.4912152031401,327.51738479686026,329.0031951787738,331.74752832798515,334.37687402801134,329.11818262795896,79434,90271.73333333334,55.400231838709985,36.707879372098134,NaN,NaN,NaN,NaN,0.9969542214701993,29.278202328449943,87842935
2025-08-15T13:10:00-04:00,331.09,331.42,330.5,331.3,327.9339545243707,NaN,NaN,NaN,NaN,NaN,331.94090000000017,336.3759466469106,327.5058533530897,329.12255614301904,331.7361137018488,334.34455656407965,329.12767083961796,75328,90829.36666666667,56.52514988063937,39.165085690684805,NaN,NaN,NaN,NaN,0.9914574913651862,27.19632045309795,87918263
2025-08-15T13:15:00-04:00,331.27,331.31,330.32,330.32,327.9339545243707,NaN,NaN,NaN,NaN,NaN,331.8553000000001,336.24675188296425,327.463848117036,329.12255614301904,331.7217146788467,334.3157854051346,329.1276439525588,59777,90071.83333333333,48.462387459783145,40.571040343630486,NaN,NaN,NaN,NaN,0.9913533848391022,25.48480291591519,87858486
2025-08-15T13:20:00-04:00,330.31,330.38,329.78,330.06,327.9339545243707,NaN,NaN,NaN,NaN,NaN,331.76770000000016,336.1240228576728,327.4113771423275,329.12255614301904,331.6968670827317,334.2791351293519,329.11459903611154,69008,89843.1,46.564673895289474,41.82303089252956,NaN,NaN,NaN,NaN,0.9633995716363107,24.526108477440346,87789478
2025-08-15T13:25:00-04:00,330.1,331.1,329.86,330.88,327.9339545243707,NaN,NaN,NaN,NaN,NaN,331.70390000000015,336.0167020080162,327.3910979919841,329.12255614301904,331.68333559648653,334.2522485377915,329.11442265518156,57894,89316.56666666667,52.83730386174239,43.679995392049804,NaN,NaN,NaN,NaN,0.9831567450908606,22.839724370448838,87847372
2025-08-15T13:30:00-04:00,330.87,331.69,330.79,331.33,328.25165903906037,NaN,NaN,NaN,NaN,NaN,331.6401000000002,335.87811014159894,327.40208985840144,329.3575269961806,331.6758818912363,334.2221209235866,329.12964285888603,85134,90078.3,55.89696299489921,45.78720845053393,NaN,NaN,NaN,NaN,0.977216977584369,21.93011747498807,87932506
2025-08-15T13:35:00-04:00,331.3,331.59,330.91,331.36,328.30476544637577,NaN,NaN,NaN,NaN,NaN,331.5557000000001,335.64185810272335,327.4695418972769,329.3840215969445,331.67191685475063,334.2054545677555,329.13837914174576,48589,90030.76666666666,56.10142764909285,47.79626815331052,NaN,NaN,NaN,NaN,0.9559871934711962,21.08548250063164,87981095
2025-08-15T13:40:00-04:00,331.35,331.66,331.01,331.1,328.4350033806315,NaN,NaN,NaN,NaN,NaN,331.43970000000013,335.2310788574199,327.64832114258036,329.5702172775556,331.6691813933269,334.19458389905066,329.1437788876031,31628,87823.76666666666,53.77460259299938,49.466853655674164,NaN,NaN,NaN,NaN,0.9341309653661132,20.382080601451694,87949467
2025-08-15T13:45:00-04:00,331.13,331.41,330.81,331.05,328.4350033806315,NaN,NaN,NaN,NaN,NaN,331.3635000000002,335.0278691135282,327.69913088647223,329.5702172775556,331.66500729621947,334.181770071737,329.14824452070195,34853,86041.5,53.31663589616842,50.6011294376607,NaN,NaN,NaN,NaN,0.9102644678399638,19.43238688497689,87914614
2025-08-15T13:50:00-04:00,331.06,331.43,330.46,331.39,328.4350033806315,NaN,NaN,NaN,NaN,NaN,331.29470000000015,334.8227863992271,327.7666136007732,329.5702172775556,331.6588902200519,334.1628426521312,329.1549377879726,52307,86159.33333333333,56.05718838940696,51.714718040224966,NaN,NaN,NaN,NaN,0.9145312915656827,18.047884882846137,87966921
2025-08-15T13:55:00-04:00,331.37,331.68,331.19,331.38,328.64512690721523,NaN,NaN,NaN,NaN,NaN,331.2721000000002,334.7831933283419,327.7610066716585,329.7850312461084,331.6567213967736,334.1495430971113,329.1638996964359,44165,86428.76666666666,55.95314697101824,52.43745197242349,NaN,NaN,NaN,NaN,0.8842076278824204,17.105795809025945,87922756
2025-08-15T14:00:00-04:00,331.37,331.41,330.71,330.9,328.64512690721523,NaN,NaN,NaN,NaN,NaN,331.24050000000017,334.7359451791435,327.7450548208568,329.7850312461084,331.65064927183835,334.13258888646516,329.16870965721154,46509,86786.6,51.05492444316017,52.80185727429572,NaN,NaN,NaN,NaN,0.8710499401765365,16.21465080408628,87876247
2025-08-15T14:05:00-04:00,330.94,331.35,330.87,331.21,328.64512690721523,NaN,NaN,NaN,NaN,NaN,331.2025000000002,334.6568932897489,327.74810671025153,329.7850312461084,331.6482895189525,334.1246906980842,329.1718883398208,23268,85662.76666666666,53.863973486446596,53.3190503737185,NaN,NaN,NaN,NaN,0.8431178015924995,15.387159013785165,87899515
2025-08-15T14:10:00-04:00,331.21,331.33,330.08,330.28,328.64512690721523,NaN,NaN,NaN,NaN,NaN,331.1317000000002,334.5129362295774,327.750463770423,329.7850312461084,331.63739434780524,334.1037036249346,329.1710850706759,50743,83718.1,45.43873032338778,52.94623854876738,NaN,NaN,NaN,NaN,0.8721808157644638,15.622082102423299,87848772
2025-08-15T14:15:00-04:00,330.28,330.39,329.82,329.92,328.64512690721523,NaN,NaN,NaN,NaN,NaN,331.0553000000002,334.36930205796074,327.7412979420397,329.7850312461084,331.6263571674091,334.08766524603914,329.165049088779,35231,81436.06666666667,42.65721901068919,52.036023346765894,NaN,NaN,NaN,NaN,0.8505964717812874,16.12841038868231,87813541
2025-08-15T14:20:00-04:00,329.95,330.09,329.52,329.64,328.64512690721523,NaN,NaN,NaN,NaN,NaN,330.9889000000002,334.28055447155776,327.6972455284427,329.7850312461084,331.60539581314663,334.0608495177519,329.1499421085414,57485,81241.33333333333,40.576700489595915,50.89684839026279,NaN,NaN,NaN,NaN,0.8305538666540521,16.919144320606456,87756056
2025-08-15T14:25:00-04:00,329.61,329.91,329.33,329.83,328.64512690721523,NaN,NaN,NaN,NaN,NaN,330.9299000000002,334.19668220275474,327.66311779724566,329.7850312461084,331.5870811346152,334.0378660433363,329.13629622589406,49678,75833.86666666667,42.621762605281035,50.4796609006555,NaN,NaN,NaN,NaN,0.8126571618930513,17.851501544952672,87805734
2025-08-15T14:30:00-04:00,329.81,330.11,329.37,329.83,328.64512690721523,NaN,NaN,NaN,NaN,NaN,330.87470000000013,334.1206183046444,327.6287816953559,329.7850312461084,331.5727994857358,334.0192020989029,329.1263968725687,41158,69104.63333333333,42.621762605281035,50.198024379940605,NaN,NaN,NaN,NaN,0.8074673646149769,18.332931867907394,87805734
2025-08-15T14:35:00-04:00,329.83,329.84,328.79,329.08,328.64512690721523,NaN,NaN,NaN,NaN,NaN,330.79870000000017,334.0311695265996,327.5662304734007,329.7850312461084,331.541238104379,333.9859803844221,329.0964958243359,71716,67505.63333333333,36.82057008316134,49.053971967184815,NaN,NaN,NaN,NaN,0.8247911242853325,19.396642194294557,87734018
2025-08-15T14:40:00-04:00,329.14,329.6,328.82,329.18,328.64512690721523,NaN,NaN,NaN,NaN,NaN,330.72430000000014,333.9310266862774,327.5175733137229,329.7850312461084,331.51695867182735,333.96052945677377,329.07338788688094,55626,65680.83333333333,38.03166756767938,47.77787943666912,NaN,NaN,NaN,NaN,0.8215917582649538,20.384373211654058,87789644
2025-08-15T14:45:00-04:00,329.18,329.48,329.04,329.18,328.64512690721523,NaN,NaN,NaN,NaN,NaN,330.6485000000002,333.81827112743133,327.47872887256904,329.6172199975094,331.50632458794024,333.9491516840147,329.0634974918658,25095,62648.7,38.03166756767938,46.48718228799673,NaN,NaN,NaN,NaN,0.7943352041031712,21.301552013487886,87789644
2025-08-15T14:50:00-04:00,329.13,329.61,329.02,329.52,328.64512690721523,NaN,NaN,NaN,NaN,NaN,330.59110000000015,333.73649745666336,327.44570254333695,329.6172199975094,331.4931015576817,333.9340304447227,329.05217267064074,33776,60279.666666666664,42.38654189320039,45.67374938086823,NaN,NaN,NaN,NaN,0.7797398323815183,21.857699214677243,87823420
2025-08-15T14:55:00-04:00,329.54,329.64,328.6,328.75,NaN,NaN,NaN,331.6610372132895,331.6610372132895,331.6610372132895,330.5167000000001,333.6567851008425,327.37661489915774,329.3187759980075,331.4685875798387,333.9099445772997,329.0272305823777,53778,58123.6,36.184619606573456,44.45003393161145,NaN,NaN,NaN,NaN,0.7983298443542645,22.868038432139315,87769642
2025-08-15T15:00:00-04:00,328.75,329.02,327.99,328.41,NaN,NaN,NaN,331.07099006723087,NaN,NaN,330.43910000000017,333.59180277069885,327.2863972293015,328.496020798406,331.4200522241417,333.8709018849406,328.96920256334283,90205,58868.833333333336,33.830747802193756,42.86243103252479,NaN,NaN,NaN,NaN,0.8148777126146722,24.411150234517116,87679437
2025-08-15T15:05:00-04:00,328.45,328.79,328.13,328.58,NaN,NaN,NaN,330.99935415508406,NaN,NaN,330.36630000000014,333.51925214686935,327.2133478531309,328.35588264878385,331.382941922067,333.84003645255706,328.92584739157695,71658,58500.26666666667,36.07007561337964,41.442211649836324,NaN,NaN,NaN,NaN,0.8038150188564831,25.844039765296507,87751095
2025-08-15T15:10:00-04:00,328.6,328.81,328.27,328.81,NaN,NaN,NaN,330.99935415508406,NaN,NaN,330.29610000000014,333.4281608487593,327.16403915124096,328.35588264878385,331.36086432796935,333.820373910126,328.9013547458127,45584,56163.76666666667,39.07425521009484,40.586449561760226,NaN,NaN,NaN,NaN,0.7849710889381643,27.12291214401364,87796679
2025-08-15T15:15:00-04:00,328.77,328.83,328.18,328.7,NaN,NaN,NaN,330.97767599667776,NaN,NaN,330.2231000000001,333.330319264958,327.1158807350422,328.35588264878385,331.33622209138076,333.79872921495354,328.873714967808,50635,55499.833333333336,38.15088501724691,39.46408609967454,NaN,NaN,NaN,NaN,0.775330296871151,28.405619539986404,87746044
2025-08-15T15:20:00-04:00,328.72,329.29,328.47,329.05,NaN,NaN,NaN,330.97767599667776,NaN,NaN,330.1379000000002,333.1334888169635,327.14231118303684,327.9117061190271,331.3176028470484,333.77955729041247,328.85564840368437,44846,54230.76666666667,42.78389735551848,39.27445517339817,NaN,NaN,NaN,NaN,0.7785209899517825,28.40132929227421,87790890
2025-08-15T15:25:00-04:00,329.05,329.38,328.9,329.07,NaN,NaN,NaN,330.97767599667776,NaN,NaN,330.0509000000002,332.9096995313196,327.1921004686808,327.9021135329419,331.29680123488174,333.7563304283719,328.8372720413916,55145,53680.6,43.046438569185895,39.30225657043365,NaN,NaN,NaN,NaN,0.757198062098085,28.179817361926357,87846035
2025-08-15T15:30:00-04:00,329.075,329.37,328.79,329.3,NaN,NaN,NaN,330.97767599667776,NaN,NaN,329.97750000000013,332.71877725711073,327.23622274288954,327.9021135329419,331.2736271455159,333.72984740001414,328.81740689101764,63771,53467.46666666667,46.108954453048256,39.6974175678231,NaN,NaN,NaN,NaN,0.7445410576625064,28.1357245265634,87909806
2025-08-15T15:35:00-04:00,329.33,329.8,329.2,329.45,NaN,NaN,NaN,330.97767599667776,NaN,NaN,329.9077000000002,332.5183054547123,327.29709454528813,328.1719053875095,331.2571125164233,333.70796123776137,328.8062637950853,54917,52650.23333333333,48.07015756846424,40.0865886366219,NaN,NaN,NaN,NaN,0.7342166964009005,27.064439923829248,87964723
2025-08-15T15:40:00-04:00,329.45,330.07,329.44,329.72,NaN,NaN,NaN,330.97767599667776,NaN,NaN,329.83390000000014,332.24533218033287,327.4224678196674,328.4525243100076,331.2434170531834,333.68736065851454,328.7994734478523,54353,51951.066666666666,51.49212155089432,40.7201857041657,NaN,NaN,NaN,NaN,0.7267726466579786,25.495631430856708,88019076
2025-08-15T15:45:00-04:00,329.75,329.92,329.32,329.52,NaN,NaN,NaN,330.97767599667776,NaN,NaN,329.77430000000015,332.06341162689773,327.4851883731026,328.4525243100076,331.2261587249739,333.66315197446625,328.7891654754816,63241,52066.53333333333,48.920538396513514,41.58446915511943,NaN,NaN,NaN,NaN,0.7177174576109817,24.26176572458101,87955835
2025-08-15T15:50:00-04:00,329.52,329.69,328.59,328.93,NaN,NaN,NaN,330.97767599667776,NaN,NaN,329.7235000000001,331.97221185358677,327.47478814641346,328.4525243100076,331.1906055769299,333.6229711960156,328.7582399578442,101783,53159.03333333333,42.22166405064564,41.88375461818845,NaN,NaN,NaN,NaN,0.7450233534959132,24.27791723490231,87854052
2025-08-15T15:55:00-04:00,328.91,330.66,328.83,330.63,NaN,NaN,NaN,330.97767599667776,NaN,NaN,329.6999000000002,331.88437658724825,327.5154234127521,328.4525243100076,331.1347658988,333.5202232568892,328.74930854071084,314847,61724.13333333333,59.45110595899455,43.41371450328239,NaN,NaN,NaN,NaN,0.8225216853890652,22.593585201867565,88168899
2025-08-18T09:30:00-04:00,329.66,333.63,329.59,332.84,328.6659231162111,328.6659231162111,328.6659231162111,NaN,NaN,NaN,329.7239000000001,332.01678751585825,327.431012484142,329.7098819573791,332.02,332.02,332.02,277457,68134.9,71.39364636210087,45.48565053677528,NaN,NaN,NaN,NaN,1.0523415650041335,23.867874046609685,88446356
2025-08-18T09:35:00-04:00,332.8,332.8,330.82,332.52,328.7242902472924,NaN,NaN,NaN,NaN,NaN,329.7813000000002,332.2039372489899,327.3586627510105,329.7098819573791,332.0306883889744,332.04375675011585,332.01762002783295,185600,72701.93333333333,68.25878287241268,47.77666219862095,NaN,NaN,NaN,NaN,1.1214600246466941,25.051142259584513,88260756
2025-08-18T09:40:00-04:00,332.53,332.53,330.61,331.58,328.7242902472924,NaN,NaN,NaN,NaN,NaN,329.8585000000002,332.25938337912794,327.4576166208725,329.7098819573791,331.9395528664058,332.1226166788506,331.756489053961,115234,75488.8,59.933630098740686,49.64115379123144,NaN,NaN,NaN,NaN,1.1784985943147845,25.831192775750385,88145522
2025-08-18T09:45:00-04:00,331.53,333.36,331,332.675,328.7966983451569,NaN,NaN,NaN,NaN,NaN,329.9424000000002,332.4361275232497,327.4486724767507,329.7098819573791,332.0139010058189,332.2419003149005,331.78590169673737,129855,78655.53333333334,65.25046970887972,51.72546765519572,NaN,NaN,NaN,NaN,1.2628915518637294,27.10032734116639,88275377
2025-08-18T09:50:00-04:00,332.65,332.7,331.2,331.64,328.7966983451569,NaN,NaN,NaN,NaN,NaN,330.0050000000002,332.5088785913279,327.50112140867253,329.7098819573791,331.9948766880589,332.21598683361333,331.7737665425045,90898,79941.9,57.485452359362974,53.04055316585773,NaN,NaN,NaN,NaN,1.2798278695877487,28.278809437624115,88184479
2025-08-18T09:55:00-04:00,331.64,332.39,331.3,332.24,328.7966983451569,NaN,NaN,NaN,NaN,NaN,330.09220000000016,332.5976661522943,327.586733847706,329.7098819573791,331.99331633155134,332.20480268925076,331.7818299738519,74884,80965.86666666667,60.42559730254712,54.63160404337918,NaN,NaN,NaN,NaN,1.266268736045765,29.37311424147771,88259363
2025-08-18T10:00:00-04:00,332.25,332.65,330.65,332.08,328.7966983451569,NaN,NaN,NaN,NaN,NaN,330.1788000000002,332.6535925650947,327.7040074349057,329.7098819573791,331.9683375305991,332.1769312277349,331.75974383346335,124738,83573.5,59.2488996604788,55.80767563659064,NaN,NaN,NaN,NaN,1.3186781120424962,29.318860193339464,88134625
2025-08-18T10:05:00-04:00,332.08,333.32,331.87,333.11,329.0147684194406,NaN,NaN,NaN,NaN,NaN,330.2828000000001,332.8040878931915,327.76151210680877,329.7098819573791,332.0574036065834,332.37650898103465,331.7382982321322,125408,86978.16666666667,64.09606570347614,57.311220431897105,NaN,NaN,NaN,NaN,1.328058246896603,29.79784159091386,88260033
2025-08-18T10:10:00-04:00,333.105,334.14,331.59,331.87,329.0997789458296,NaN,NaN,NaN,NaN,NaN,330.35720000000015,332.8416276283174,327.8727723716829,329.7098819573791,332.11742771267296,332.4549926068558,331.77986281849013,162228,90694.33333333333,55.53232416889653,57.984318268743415,NaN,NaN,NaN,NaN,1.4153398006897036,30.792626905248515,88097805
2025-08-18T10:15:00-04:00,332,333.1,331.64,332.91,329.0997789458296,NaN,NaN,NaN,NaN,NaN,330.43740000000014,332.9865412201706,327.8882587798297,329.7098819573791,332.1407170022322,332.48327649039686,331.7981575140675,73194,91959.76666666666,60.320742185392035,58.859360027095406,NaN,NaN,NaN,NaN,1.418529814926156,31.716356125702124,88170999
2025-08-18T10:20:00-04:00,332.94,333.83,332.67,333.83,329.4710692460968,NaN,NaN,NaN,NaN,NaN,330.52900000000017,333.225765470032,327.83223452996833,329.7290018153821,332.22026904418885,332.67576632118266,331.76477176719504,88426,92991.13333333333,64.01254064279917,59.75367567651716,NaN,NaN,NaN,NaN,1.4000633995742855,33.01841580403778,88259425
2025-08-18T10:25:00-04:00,333.8,334.26,333.45,333.71,330.13738428036515,NaN,NaN,NaN,NaN,NaN,330.6049000000001,333.438421124057,327.7713788759432,330.57420145230566,332.32025414941563,332.9059334828845,331.73457481594676,97396,94581.73333333334,63.18673384625342,60.77268963721287,NaN,NaN,NaN,NaN,1.357916013890408,34.46174024716374,88162029
2025-08-18T10:30:00-04:00,333.67,333.67,332.9,333.13,330.13738428036515,NaN,NaN,NaN,NaN,NaN,330.6689000000001,333.58199271400883,327.7558072859914,330.57420145230566,332.36095290663087,332.9636432153375,331.7582625979242,72093,95612.9,59.210743393535516,61.98619530456215,NaN,NaN,NaN,NaN,1.3187791557553792,34.895926649297486,88089936
2025-08-18T10:35:00-04:00,333.14,333.46,332.5,332.69,330.13738428036515,NaN,NaN,NaN,NaN,NaN,330.72250000000014,333.68335680175045,327.7616431982498,330.57420145230566,332.37449825962614,332.9750890019682,331.7739075172841,43056,94657.56666666667,56.315679704138326,61.76223628635813,NaN,NaN,NaN,NaN,1.2931520732014221,34.6878495742495,88046880
2025-08-18T10:40:00-04:00,332.67,333.2,332.45,332.53,330.13738428036515,NaN,NaN,NaN,NaN,NaN,330.7631000000001,333.766012512959,327.76018748704126,330.57420145230566,332.3860403963267,332.98002586473103,331.7920549279223,56265,94678.86666666667,55.25764008254328,60.609664409246875,NaN,NaN,NaN,NaN,1.2543554965441779,34.41798996485484,87990615
2025-08-18T10:45:00-04:00,332.54,332.66,331.8,332.34,330.13738428036515,NaN,NaN,NaN,NaN,NaN,330.7871000000001,333.82070253831813,327.7534974616821,330.57420145230566,332.3830835428105,332.9699598023761,331.7962072832449,43603,95295.8,53.961141544056225,59.588404314364276,NaN,NaN,NaN,NaN,1.2261872467910233,33.21185892757888,87947012
2025-08-18T10:50:00-04:00,332.39,332.88,332.11,332.75,330.13738428036515,NaN,NaN,NaN,NaN,NaN,330.8161000000002,333.8961281103253,327.73607188967503,330.57420145230566,332.3862736958801,332.9689072940686,331.80364009769164,28988,95136.2,56.341609597230146,59.33183142139924,NaN,NaN,NaN,NaN,1.1936024434488062,32.30341205957612,87976000
2025-08-18T10:55:00-04:00,332.85,333.45,332.5,333.32,330.13738428036515,NaN,NaN,NaN,NaN,NaN,330.8761000000002,334.03110319498785,327.7210968050125,330.9042716255132,332.40300846104464,332.988573208495,331.8174437135943,43587,94796.5,59.47849772759292,58.91954770845018,NaN,NaN,NaN,NaN,1.1762022689167477,31.97705563070064,88019587
2025-08-18T11:00:00-04:00,333.28,333.97,333.28,333.56,330.2530211224662,NaN,NaN,NaN,NaN,NaN,330.9461000000002,334.1798948544123,327.71230514558806,331.5884173004106,332.4399116231256,333.05251117994845,331.8273120663028,58139,93727.63333333333,60.75703728079248,59.153232345695145,NaN,NaN,NaN,NaN,1.1414735354226981,32.09793165679851,88077726
2025-08-18T11:05:00-04:00,333.47,333.73,332.84,333.6,330.2530211224662,NaN,NaN,NaN,NaN,NaN,331.0005000000001,334.3184356534785,327.6825643465217,331.5884173004106,332.4578855380558,333.07831473892844,331.83745633718314,36465,92554.53333333334,60.978026603922146,59.192691581507646,NaN,NaN,NaN,NaN,1.1235111400353657,31.54539524081509,88114191
2025-08-18T11:10:00-04:00,333.61,333.94,333.1,333.86,330.2530211224662,NaN,NaN,NaN,NaN,NaN,331.0511000000001,334.46341727139054,327.6387827286096,331.6397870722628,332.47979218757456,333.11463759068226,331.84494678446686,36605,92255.23333333334,62.45790505918527,59.421906252843826,NaN,NaN,NaN,NaN,1.103260344318552,31.218991046853752,88150796
2025-08-18T11:15:00-04:00,333.83,333.91,332.99,333.14,330.2530211224662,NaN,NaN,NaN,NaN,NaN,331.0867000000001,334.5479550383527,327.62544496164753,331.6397870722628,332.4999075341319,333.1407737290432,331.85904133922065,46659,92122.7,56.11170030784981,58.851594438870514,NaN,NaN,NaN,NaN,1.0901703197243708,30.74251229615524,88104137
2025-08-18T11:20:00-04:00,333.08,333.63,333.05,333.07,330.2530211224662,NaN,NaN,NaN,NaN,NaN,331.12610000000006,334.63163008269083,327.6205699173093,331.6397870722628,332.50806565421544,333.1501679282465,331.8659633801844,22110,91364.83333333333,55.521044442487494,58.85078874412701,NaN,NaN,NaN,NaN,1.0537295826012003,30.300067741935194,88082027
2025-08-18T11:25:00-04:00,333.06,333.48,332.77,332.99,330.2530211224662,NaN,NaN,NaN,NaN,NaN,331.1649000000001,334.70893526513134,327.62086473486886,331.6397870722628,332.5198277158484,333.16045638419257,331.87919904750424,42685,90949.5,54.810935572462995,58.4572311289178,NaN,NaN,NaN,NaN,1.02917746955826,29.413967718554684,88039342
2025-08-18T11:30:00-04:00,333.05,333.1,332.72,332.88,330.2530211224662,NaN,NaN,NaN,NaN,NaN,331.1947000000002,334.7707181263888,327.6186818736116,331.6397870722628,332.5261382017906,333.1632818429855,331.88899456059573,35034,89991.6,53.79217116096138,57.72720473735796,NaN,NaN,NaN,NaN,0.9828076503040982,28.5055269664179,88004308
2025-08-18T11:35:00-04:00,332.89,333.42,332.7,333.21,330.2530211224662,NaN,NaN,NaN,NaN,NaN,331.23130000000015,334.8513435412248,327.6112564587755,331.6397870722628,332.537755225636,333.173776156954,331.901734294318,42847,89589.26666666666,56.40976180938227,57.24313530615287,NaN,NaN,NaN,NaN,0.9640356752823788,28.051703297074297,88047155
2025-08-18T11:40:00-04:00,333.21,333.45,333.04,333.31,330.3004738221282,NaN,NaN,NaN,NaN,NaN,331.2795000000001,334.94451309690646,327.61448690309373,331.7811361822712,332.54403805107347,333.1808865468916,331.90718955525534,18723,88401.6,57.20097011245844,57.09958007179023,NaN,NaN,NaN,NaN,0.9244616984764923,27.666824474471678,88065878
2025-08-18T11:45:00-04:00,333.28,333.42,332.97,333.2,330.3229522847588,NaN,NaN,NaN,NaN,NaN,331.31930000000017,335.0234414714292,327.61515852857116,331.85990894581704,332.5491666560091,333.18612003516733,331.9122132768509,17205,86867.06666666667,55.996923962218936,57.07681180451027,NaN,NaN,NaN,NaN,0.8905715771567421,27.167153448335945,88048673
2025-08-18T11:50:00-04:00,333.17,333.41,332.96,333.28,330.38213627181517,NaN,NaN,NaN,NaN,NaN,331.37930000000017,335.1112431989682,327.6473568010321,331.9369271566536,332.55497756355544,333.1921766884743,331.91777843863656,19227,84115.2,56.710603517009154,57.18059490697211,NaN,NaN,NaN,NaN,0.8591021787884066,26.681692574437633,88067900
2025-08-18T11:55:00-04:00,333.25,333.27,332.9,333.19,330.38213627181517,NaN,NaN,NaN,NaN,NaN,331.4447000000002,335.18665371968797,327.7027462803124,331.9369271566536,332.56035254922557,333.1968809303045,331.92382416814667,21212,74327.36666666667,55.61772807079248,57.298922516024696,NaN,NaN,NaN,NaN,0.8248805945892344,26.09464958831232,88046688
2025-08-18T12:00:00-04:00,333.2,333.84,333.2,333.65,330.8280518509721,NaN,NaN,NaN,NaN,NaN,331.5249000000001,335.28056265264524,327.769237347355,332.42023338025825,332.58302241049955,333.2297326076297,331.9363122133694,51565,66797.63333333333,59.87402575963378,57.551237956196395,NaN,NaN,NaN,NaN,0.8123891235471445,26.362082005710025,88098253
2025-08-18T12:05:00-04:00,333.64,334.73,333.63,334.04,331.46041313047334,NaN,NaN,NaN,NaN,NaN,331.6091000000002,335.3976203919628,327.8205796080376,333.04418670420665,332.64517965855663,333.34800622795973,331.9423530891535,95289,63787.26666666667,63.1046439201115,57.81024839851915,NaN,NaN,NaN,NaN,0.832932757579493,27.56269313461015,88193542
2025-08-18T12:10:00-04:00,334.04,334.67,333.86,334.49,331.55857616999725,NaN,NaN,NaN,NaN,NaN,331.70230000000015,335.54012397204303,327.86447602795727,333.04418670420665,332.6845447601708,333.4245847347397,331.9445047856019,56515,61829.96666666667,66.46011991151045,58.217611443570426,NaN,NaN,NaN,NaN,0.8312947034666722,28.6775463257317,88250057
2025-08-18T12:15:00-04:00,334.54,335.28,334.5,335.18,332.1988681622701,NaN,NaN,NaN,NaN,NaN,331.82430000000016,335.7084719890325,327.94012801096784,333.48207949069223,332.7735054389018,333.6240231328812,331.9229877449224,97805,60761.63333333333,70.83937740828283,58.92199364388191,NaN,NaN,NaN,NaN,0.8283450817904787,30.245436129846354,88347862
2025-08-18T12:20:00-04:00,335.2,335.33,334.87,335.33,332.46846506398515,NaN,NaN,NaN,NaN,NaN,331.94730000000015,335.87795959355606,328.01664040644425,333.6616635925538,332.81951423947555,333.7239372063429,331.9150912726082,49402,59378.433333333334,71.70431744958782,59.58245167176781,NaN,NaN,NaN,NaN,0.802034718805443,31.74171586403625,88397264
2025-08-18T12:25:00-04:00,335.34,335.34,334.81,334.84,332.49080756107674,NaN,NaN,NaN,NaN,NaN,332.06050000000016,335.99186223214645,328.1291377678539,333.740330874043,332.8448467696374,333.77381083030343,331.91588270897137,30378,57894.9,64.9291726157071,60.21227112232905,NaN,NaN,NaN,NaN,0.782603667462195,32.97363796461591,88366886
2025-08-18T12:30:00-04:00,334.9,335.28,334.82,334.94,332.52054358102777,NaN,NaN,NaN,NaN,NaN,332.1689000000001,336.1129584631162,328.22484153688407,333.7702646992344,332.8650380422869,333.8128332165157,331.91724286805817,24538,54554.9,65.64265213813178,60.93524310058935,NaN,NaN,NaN,NaN,0.759560548357751,34.11756562943988,88391424
2025-08-18T12:35:00-04:00,334.88,334.89,333.6,333.73,332.52054358102777,NaN,NaN,NaN,NaN,NaN,332.26850000000013,336.11242624804487,328.4245737519554,333.7702646992344,332.8960476818301,333.85091341052294,331.9411819531373,69414,52688.433333333334,51.88742732207119,60.72642108270423,NaN,NaN,NaN,NaN,0.8010205091893384,32.4566663718265,88322010
2025-08-18T12:40:00-04:00,333.79,334.1,333.45,333.96,332.52054358102777,NaN,NaN,NaN,NaN,NaN,332.3795000000001,336.08953194062235,328.6694680593779,333.7702646992344,332.91021306295056,333.86476071709,331.9556654088111,41355,48659.333333333336,53.86634001034183,60.73171885765998,NaN,NaN,NaN,NaN,0.790233329961531,30.654893311380064,88363365
2025-08-18T12:45:00-04:00,333.94,334.15,333.29,333.6,332.52054358102777,NaN,NaN,NaN,NaN,NaN,332.4799000000001,336.0419625991829,328.9178374008173,333.7702646992344,332.9207968025493,333.87298845841167,331.96860514668697,38282,47495.6,50.37386975492917,60.30058371091332,NaN,NaN,NaN,NaN,0.7952166635357043,28.703944610009422,88325083
2025-08-18T12:50:00-04:00,333.58,334.03,333.4,333.53,332.52054358102777,NaN,NaN,NaN,NaN,NaN,332.57430000000016,335.989473207959,329.1591267920413,333.7702646992344,332.9263134933195,333.8770246066898,331.97560237994924,21128,45252.333333333336,49.6991178018689,59.76473711729979,NaN,NaN,NaN,NaN,0.7834154732831536,26.892349387308112,88303955
2025-08-18T12:55:00-04:00,333.55,333.62,333.17,333.38,332.52054358102777,NaN,NaN,NaN,NaN,NaN,332.66790000000015,335.905102551658,329.4306974483423,333.7702646992344,332.9303342488707,333.87789019665695,331.9827783010844,24540,42823.8,48.20891926233256,59.208451067307905,NaN,NaN,NaN,NaN,0.7596000823343562,25.153771630926396,88279415
2025-08-18T13:00:00-04:00,333.4,334.33,333.33,334.18,332.52054358102777,NaN,NaN,NaN,NaN,NaN,332.7705000000002,335.8645512278028,329.6764487721976,333.7702646992344,332.9436885914549,333.8920865623104,331.99529062059935,37681,41676.73333333333,55.817881087235484,59.14468517946693,NaN,NaN,NaN,NaN,0.7767715050247592,24.34226843002165,88317096
2025-08-18T13:05:00-04:00,334.15,334.15,333.86,333.93,332.52054358102777,NaN,NaN,NaN,NaN,NaN,332.8677000000001,335.7912972432054,329.94410275679485,333.7702646992344,332.95001137194515,333.89894935372774,332.00107339016256,17604,40828.333333333336,53.188099910521835,58.97114031087617,NaN,NaN,NaN,NaN,0.7441449689515617,23.588729743467244,88299492
2025-08-18T13:10:00-04:00,333.96,334.57,333.88,334.52,332.52054358102777,NaN,NaN,NaN,NaN,NaN,332.9721000000001,335.7476994596648,330.1965005403355,333.7702646992344,332.9653466985389,333.91994249359595,332.01075090348183,32583,40038.933333333334,58.193993735577315,58.85113802344357,NaN,NaN,NaN,NaN,0.7402774711693071,23.495959545682155,88332075
2025-08-18T13:15:00-04:00,334.55,334.77,334.27,334.66,332.52054358102777,NaN,NaN,NaN,NaN,NaN,333.0763000000001,335.7023287965964,330.4502712034038,333.7702646992344,332.98087204042446,333.94370028394667,332.01804379690225,28567,39537.73333333333,59.306022977186515,58.579807956091784,NaN,NaN,NaN,NaN,0.7231147946572137,23.67688996288177,88360642
2025-08-18T13:20:00-04:00,334.61,334.61,334.12,334.25,332.52054358102777,NaN,NaN,NaN,NaN,NaN,333.16690000000017,335.63108740367846,330.7027125963219,333.19430085084986,332.99134940190316,333.9576886768377,332.02501012696865,23119,39342.1,54.715829239776504,57.74093005096794,NaN,NaN,NaN,NaN,0.7100351664674143,23.50814253302003,88337523
2025-08-18T13:25:00-04:00,334.23,334.9,334.18,334.75,332.52054358102777,NaN,NaN,NaN,NaN,NaN,333.2715000000002,335.54415505531296,330.9988449446874,333.3155525445439,333.0102442356207,333.9865321762475,332.03395629499386,35074,39058.333333333336,58.89419281023405,56.88770257967873,NaN,NaN,NaN,NaN,0.7107469402911682,23.757570152087844,88372597
2025-08-18T13:30:00-04:00,334.79,335.75,334.79,335.31,332.9044025183157,NaN,NaN,NaN,NaN,NaN,333.3991000000001,335.3801054923335,331.4180945076667,333.98244203563513,333.07214465474374,334.1036755243666,332.04061378512085,84113,39924.13333333333,63.010783140136596,56.26673584328936,NaN,NaN,NaN,NaN,0.7314078731275133,24.957594692050815,88456710
2025-08-18T13:35:00-04:00,335.36,335.4,334.61,334.67,332.9044025183157,NaN,NaN,NaN,NaN,NaN,333.4799000000001,335.3276147941913,331.6321852058089,333.98244203563513,333.0934217673732,334.13741477216655,332.0494287625798,36513,39925.73333333333,56.09650418818285,55.63583095560906,NaN,NaN,NaN,NaN,0.735593025046974,25.663944208747147,88420197
2025-08-18T13:40:00-04:00,334.66,334.87,334.34,334.69,332.9044025183157,NaN,NaN,NaN,NaN,NaN,333.5169000000002,335.3858471796688,331.64795282033157,333.98244203563513,333.10968455926024,334.1600129215858,332.0593561969347,33358,39817.5,56.258038571439506,54.965501415131044,NaN,NaN,NaN,NaN,0.7209078089721922,25.726550941230634,88453555
2025-08-18T13:45:00-04:00,334.67,334.8,334.38,334.59,332.9044025183157,NaN,NaN,NaN,NaN,NaN,333.55830000000014,335.4287882893341,331.6878117106662,333.98244203563513,333.1197489313787,334.1735451422396,332.06595272051777,21622,38982.933333333334,55.16512660155817,55.19962279223726,NaN,NaN,NaN,NaN,0.6994143940456082,25.78468576425102,88431933
2025-08-18T13:50:00-04:00,334.56,334.83,334.34,334.8,332.9044025183157,NaN,NaN,NaN,NaN,NaN,333.6227000000001,335.43719410045304,331.8082058995472,333.98244203563513,333.1296621072369,334.1872353861781,332.07208882829576,20646,38934.13333333333,57.05201979725311,55.427171348445206,NaN,NaN,NaN,NaN,0.6844562230423511,25.74401177124627,88452579
2025-08-18T13:55:00-04:00,334.8,334.93,334.5,334.62,332.9044025183157,NaN,NaN,NaN,NaN,NaN,333.66160000000013,335.4765528259959,331.8466471740044,333.98244203563513,333.13881943016685,334.1999568639424,332.0776819963913,18978,38143.9,54.9185413585255,55.75179074870209,NaN,NaN,NaN,NaN,0.6662807785393265,25.85272448512968,88433601
2025-08-18T14:00:00-04:00,334.6,334.6,333.97,334.18,332.9044025183157,NaN,NaN,NaN,NaN,NaN,333.7124000000001,335.4381696719216,331.9866303280786,333.98244203563513,333.14960774366455,334.2111875633855,332.08802792394357,31568,38028.36666666667,49.99674315408328,55.773049702431685,NaN,NaN,NaN,NaN,0.6651178657865159,24.723429141196007,88402033
2025-08-18T14:05:00-04:00,334.17,334.64,334.07,334.57,332.9044025183157,NaN,NaN,NaN,NaN,NaN,333.75900000000007,335.44867334143794,332.0693266585622,333.98244203563513,333.1558748236033,334.21860029553494,332.0931493516717,16035,37134.63333333333,53.93724330942559,56.18221570579548,NaN,NaN,NaN,NaN,0.6583237325160499,23.744706780683938,88418068
2025-08-18T14:10:00-04:00,334.58,334.85,334.1,334.12,332.9044025183157,NaN,NaN,NaN,NaN,NaN,333.7998000000001,335.42252605224155,332.1770739477587,333.98244203563513,333.1652016354946,334.2290276627403,332.10137560824893,25578,37363.13333333333,49.12660808796663,55.704267634419125,NaN,NaN,NaN,NaN,0.664872037336332,23.204192463138558,88392490
2025-08-18T14:15:00-04:00,334.12,334.18,333.66,333.83,332.9044025183157,NaN,NaN,NaN,NaN,NaN,333.81420000000014,335.4249195412395,332.2034804587608,333.98244203563513,333.1712353740083,334.2326690088571,332.1098017391595,27644,37711.1,46.26297479328796,55.20961584033099,NaN,NaN,NaN,NaN,0.6545240346694499,21.74269522745857,88364846
2025-08-18T14:20:00-04:00,333.82,334.17,333.7,334,332.9044025183157,NaN,NaN,NaN,NaN,NaN,333.85680000000013,335.3692572855386,332.3443427144617,333.5909536285081,333.17497093384526,334.2352553562334,332.11468651145714,15869,37599.166666666664,48.17025839191949,54.49363474435544,NaN,NaN,NaN,NaN,0.6413437464787768,20.38559065147001,88380715
2025-08-18T14:25:00-04:00,334.06,334.48,334.06,334.22,332.9044025183157,NaN,NaN,NaN,NaN,NaN,333.8830000000001,335.3741807404352,332.391819259565,333.5079346062369,333.1819921917376,334.2423720720833,332.1216123113919,21867,37621,50.61318872637202,53.872718012154394,NaN,NaN,NaN,NaN,0.6298191931588655,19.72514676067303,88402582
2025-08-18T14:30:00-04:00,334.23,334.58,334.05,334.53,332.9044025183157,NaN,NaN,NaN,NaN,NaN,333.8970000000001,335.3990319572824,332.39496804271784,333.5079346062369,333.1915285261636,334.2530848417647,332.1299722105625,26798,36795.433333333334,53.90977583037258,53.81514276862554,NaN,NaN,NaN,NaN,0.6226892507903731,19.296689875181563,88429380
2025-08-18T14:35:00-04:00,334.5,334.67,334.17,334.27,332.9044025183157,NaN,NaN,NaN,NaN,NaN,333.9082000000001,335.41283651452,332.40356348548016,333.5079346062369,333.2011513960301,334.26367090836,332.13863188370027,27870,34548.13333333333,50.84433805953668,53.24015314357573,NaN,NaN,NaN,NaN,0.613925732876775,19.067974043456264,88401510
2025-08-18T14:40:00-04:00,334.33,334.96,334.2,334.94,332.9044025183157,NaN,NaN,NaN,NaN,NaN,333.9444000000001,335.45946123994827,332.4293387600519,333.5079346062369,333.2144352679438,334.28152299673843,332.1473475391492,30520,33681.63333333333,57.54396405130489,52.84966606580205,NaN,NaN,NaN,NaN,0.6243596090998619,19.376768042904928,88432030
2025-08-18T14:45:00-04:00,334.92,335.06,334.8,334.93,332.9435292555058,NaN,NaN,NaN,NaN,NaN,333.98920000000004,335.4856001606912,332.4927998393089,333.76408162382535,333.23353189497794,334.30982088308167,332.1572429068742,38764,31713.6,57.41817689772724,52.94407125934093,NaN,NaN,NaN,NaN,0.5983339227355854,19.834686251864326,88393266
2025-08-18T14:50:00-04:00,334.92,335.41,334.85,335.31,333.1574597438918,NaN,NaN,NaN,NaN,NaN,334.0448000000001,335.52671357397605,332.5628864260242,334.0932652990603,333.25588219978647,334.34601650285947,332.16574789671347,40242,31408.266666666666,60.91456581070096,53.2766803478596,NaN,NaN,NaN,NaN,0.5955957853973295,20.819006528532444,88433508
2025-08-18T14:55:00-04:00,335.33,335.52,335.13,335.39,333.3889388464422,NaN,NaN,NaN,NaN,NaN,334.1058000000001,335.5526729870739,332.6589270129263,334.2716122392482,333.28155883142995,334.38917940099674,332.17393826186316,43799,31855.633333333335,61.628882834542765,53.738377221644214,NaN,NaN,NaN,NaN,0.5809103721546621,21.89646103071585,88477307
2025-08-18T15:00:00-04:00,335.39,335.66,335.26,335.55,333.55739617160395,NaN,NaN,NaN,NaN,NaN,334.1618000000001,335.61117884654294,332.7124211534572,334.4612897913986,333.3039814270006,334.4279847351949,332.17997811880633,36582,32257.1,63.082091013723534,54.16909659424925,NaN,NaN,NaN,NaN,0.5679882027150459,23.10349461275152,88513889
2025-08-18T15:05:00-04:00,335.51,336.26,335.43,335.95,333.91569634562194,NaN,NaN,NaN,NaN,NaN,334.2144,335.72726303446245,332.70153696553757,334.88603183311886,333.34559724388896,334.50682271822564,332.1843717695523,59163,31915.4,66.49808940264603,54.99620716882929,NaN,NaN,NaN,NaN,0.5867033310925416,24.977704309444196,88573052
2025-08-18T15:10:00-04:00,335.98,336,335.22,335.35,333.91569634562194,NaN,NaN,NaN,NaN,NaN,334.25020000000006,335.7839978487665,332.71640215123364,334.88603183311886,333.3696150795292,334.54660297884965,332.1926271802087,40840,31898.233333333334,57.85104458394631,55.55722869953379,NaN,NaN,NaN,NaN,0.600510236014501,26.067405086175448,88532212
2025-08-18T15:15:00-04:00,335.33,335.47,335.02,335.31,333.91569634562194,NaN,NaN,NaN,NaN,NaN,334.2844,335.83484850320144,332.73395149679857,334.88603183311886,333.3826423720681,334.5659982853154,332.19928645882084,25605,31475.666666666668,57.31595377595055,55.79856516142843,NaN,NaN,NaN,NaN,0.5897595048706114,26.489544189792447,88506607
2025-08-18T15:20:00-04:00,335.29,335.29,334.6,334.675,333.91569634562194,NaN,NaN,NaN,NaN,NaN,334.30070000000006,335.8500947337337,332.7513052662664,334.88603183311886,333.40289209426305,334.59052708663785,332.21525710188826,51996,32504.6,49.49007969341218,55.82452741896025,NaN,NaN,NaN,NaN,0.5983481116655662,25.773847126941675,88454611
2025-08-18T15:25:00-04:00,334.66,335,334.49,334.84,333.91569634562194,NaN,NaN,NaN,NaN,NaN,334.3347,335.8550583923347,332.8143416076653,334.88603183311886,333.4202190803176,334.61025694647753,332.2301812141577,48293,33296.36666666667,51.348930879391894,56.1878099965391,NaN,NaN,NaN,NaN,0.5920375322608822,24.84240250602075,88502904
2025-08-18T15:30:00-04:00,334.85,334.94,334.52,334.81,333.91569634562194,NaN,NaN,NaN,NaN,NaN,334.3695,335.85164742892744,332.8873525710726,334.88603183311886,333.43018125881747,334.621335409266,332.23902710836893,28756,32998.86666666667,50.98156140588094,56.3886173546792,NaN,NaN,NaN,NaN,0.5797491370993918,23.977489643737034,88474148
2025-08-18T15:35:00-04:00,334.81,335.09,334.79,334.82,333.91569634562194,NaN,NaN,NaN,NaN,NaN,334.4061000000001,335.8397656377536,332.9724343622466,334.88603183311886,333.44155602686317,334.63506235671827,332.24804969700807,30087,33414.96666666667,51.107129881162145,56.42389886573564,NaN,NaN,NaN,NaN,0.5597670558780034,23.47531538163691,88504235
2025-08-18T15:40:00-04:00,334.85,335.04,334.55,334.97,333.91569634562194,NaN,NaN,NaN,NaN,NaN,334.44790000000006,335.8217734879879,333.0740265120122,334.88603183311886,333.45652732563497,334.652463609102,332.2605910421679,41670,33717.86666666667,53.04995239218344,56.36248290586498,NaN,NaN,NaN,NaN,0.5547836947438609,22.367434662835173,88545905
2025-08-18T15:45:00-04:00,334.93,335.06,334.74,335,333.91569634562194,NaN,NaN,NaN,NaN,NaN,334.4837000000001,335.8194377140817,333.14796228591854,334.88603183311886,333.467441394363,334.6656451892562,332.26923759946976,29256,33740.833333333336,53.44836876538227,56.54848509913967,NaN,NaN,NaN,NaN,0.5380134308335847,21.383690320392155,88575161
2025-08-18T15:50:00-04:00,335.04,335.07,333.87,334.13,NaN,NaN,NaN,336.3345864460294,336.3345864460294,336.3345864460294,334.5001000000001,335.7973748208586,333.2028251791416,334.88603183311886,333.4872117759543,334.6792527400941,332.29517081181444,90016,35970.73333333333,42.25090149210743,55.45612348776842,NaN,NaN,NaN,NaN,0.5852981857740421,21.125843344219028,88485145
2025-08-18T15:55:00-04:00,334.05,335.33,334,335.155,NaN,NaN,NaN,336.3345864460294,NaN,NaN,334.53920000000005,335.7945475379172,333.2838524620829,334.51082546649513,333.5286558278219,334.7248641077427,332.33244754790115,129105,39105.1,54.37782479387445,55.23895548035038,NaN,NaN,NaN,NaN,0.6384911725044665,20.276649334869035,88614250
2025-08-19T09:30:00-04:00,335.85,337.36,333.92,334.7,333.29885821756415,333.29885821756415,333.29885821756415,NaN,NaN,NaN,334.5676000000001,335.7708842394538,333.3643157605464,334.13439138041406,335.32666666666665,335.32666666666665,335.32666666666665,262055,45036.5,49.41699871007521,54.41770068744853,NaN,NaN,NaN,NaN,0.8385989458970045,21.123196126139273,88352195
2025-08-19T09:35:00-04:00,334.71,335,333.3,334.18,333.29885821756415,NaN,NaN,NaN,NaN,NaN,334.58740000000006,335.73043147856583,333.4443685214343,334.13439138041406,334.8478176833283,335.42171732473673,334.27391804191984,182439,49900.7,44.42849393134378,53.18910148007717,NaN,NaN,NaN,NaN,0.9001275926186462,20.863986602720345,88169756
2025-08-19T09:40:00-04:00,334.18,336.07,334.08,334.7,333.29885821756415,NaN,NaN,NaN,NaN,NaN,334.6084,335.71991867332963,333.4968813266704,334.13439138041406,334.87198334066215,335.3753259455926,334.36864073573173,137682,53378.166666666664,49.87743372441687,52.24591167369812,NaN,NaN,NaN,NaN,0.9779756217173149,21.62931754779105,88307438
2025-08-19T09:45:00-04:00,334.73,335.17,334.1,334.63,333.29885821756415,NaN,NaN,NaN,NaN,NaN,334.62020000000007,335.7197943984106,333.5206056015895,334.13439138041406,334.83478752306064,335.3052760931282,334.36429895299307,107491,56240.46666666667,49.17837541874334,51.00878924627649,NaN,NaN,NaN,NaN,0.984548791594649,22.339981996785273,88199947
2025-08-19T09:50:00-04:00,334.69,337.61,334.5,337.45,333.29885821756415,NaN,NaN,NaN,NaN,NaN,334.67940000000004,336.03378346159985,333.32501653840023,334.13439138041406,335.19444869224316,336.0012112807922,334.38768610369414,187127,61789.833333333336,68.395653266507,51.761975580745116,NaN,NaN,NaN,NaN,1.1363667350521751,24.520026883556483,88387074
2025-08-19T09:55:00-04:00,337.48,339.54,337.48,338.99,335.40348107610555,NaN,NaN,NaN,NaN,NaN,334.7556000000001,336.56600950091837,332.9451904990818,334.9940325675341,335.9169054581997,337.4994866736388,334.33432424276066,230085,68826.73333333334,74.14527793296597,52.964070163389074,NaN,NaN,NaN,NaN,1.204483396834165,27.24962089651758,88617159
2025-08-19T10:00:00-04:00,338.9,339.08,337.03,338.33,335.40348107610555,NaN,NaN,NaN,NaN,NaN,334.8156000000001,336.8793089331873,332.75189106681285,334.9940325675341,336.16490358071417,337.8133800632887,334.5164270981396,138515,72391.63333333333,68.40188358645597,54.314913298606484,NaN,NaN,NaN,NaN,1.2648774399174398,29.203442672416564,88478644
2025-08-19T10:05:00-04:00,338.28,339.37,338,339.37,335.40348107610555,NaN,NaN,NaN,NaN,NaN,334.9062,337.3321880958255,332.48021190417455,334.9940325675341,336.4564043934873,338.22994711968676,334.6828616672878,147759,76782.43333333333,72.07289058563737,55.795196134766876,NaN,NaN,NaN,NaN,1.2723861942090515,31.126383208282395,88626403
2025-08-19T10:10:00-04:00,339.37,340.29,338.86,339.75,336.24509750618085,NaN,NaN,NaN,NaN,NaN,335.0024000000001,337.7818425629971,332.22295743700306,336.0434646745774,336.88153007071503,338.85495406076177,334.9081060806683,215228,83104.1,73.29376669972189,57.38892508432694,NaN,NaN,NaN,NaN,1.2836443231941197,33.233950082414246,88841631
2025-08-19T10:15:00-04:00,339.74,340.02,338.79,339.15,336.24509750618085,NaN,NaN,NaN,NaN,NaN,335.11080000000004,338.0982714125977,332.1233285874024,336.0434646745774,337.02295752196704,339.0213063037546,335.0246087401795,99027,85483.53333333334,68.22240079930245,58.61144443562268,NaN,NaN,NaN,NaN,1.2798125858231084,35.09519225209455,88742604
2025-08-19T10:20:00-04:00,339.19,339.8,338.7,339.7,336.24509750618085,NaN,NaN,NaN,NaN,NaN,335.22560000000004,338.45842887901534,331.99277112098474,336.0434646745774,337.1449093573783,339.1607300171159,335.1290886976407,92334,88032.36666666667,70.2541951635985,59.84031891929518,NaN,NaN,NaN,NaN,1.2669688296928878,36.69347424959676,88834938
2025-08-19T10:25:00-04:00,339.77,340.55,338.06,338.78,336.24509750618085,NaN,NaN,NaN,NaN,NaN,335.32920000000007,338.67696723218285,331.9814327678173,336.29717391338363,337.3214006935751,339.3267566763514,335.31604471079874,175627,93157.7,62.9982053076546,60.52245010088607,NaN,NaN,NaN,NaN,1.3543281990005394,38.4601387077089,88659311
2025-08-19T10:30:00-04:00,338.83,339.25,338.22,338.3,336.24509750618085,NaN,NaN,NaN,NaN,NaN,335.42460000000005,338.83315150481445,332.01604849518566,336.29717391338363,337.3789137839183,339.3559797306979,335.40184783713863,93808,95391.36666666667,59.542854482208696,61.75758960017902,NaN,NaN,NaN,NaN,1.3311618990719276,40.10061284738446,88565503
2025-08-19T10:35:00-04:00,338.32,338.37,334.66,334.95,NaN,NaN,NaN,340.372917343518,340.372917343518,340.372917343518,335.45599999999996,338.81723013214156,332.09476986785836,336.29717391338363,337.24813618518664,339.172703643863,335.3235687265103,215653,101650.8,42.1619346995157,60.88502602201053,NaN,NaN,NaN,NaN,1.5010789062810743,37.71928422278838,88349850
2025-08-19T10:40:00-04:00,334.99,335.46,331.72,332.565,NaN,NaN,NaN,337.7825574642672,NaN,NaN,335.42370000000005,338.8634777894788,331.9839222105213,336.29717391338363,336.9017198098938,339.0578178832214,334.7456217365662,216649,107855.1,34.45149077039311,59.8160611691761,NaN,NaN,NaN,NaN,1.6610018415467085,36.30714376529136,88133201
2025-08-19T10:45:00-04:00,332.6,333.66,332.51,333.43,NaN,NaN,NaN,337.24380485225504,NaN,NaN,335.4137,338.8736374620225,331.9537625379775,336.29717391338363,336.7151704057704,338.96688888095173,334.46345193058903,132753,110988.06666666667,38.82138476623816,59.415553371668544,NaN,NaN,NaN,NaN,1.6245017100076602,34.995870483329846,88265954
2025-08-19T10:50:00-04:00,333.43,334.47,333.35,334.47,NaN,NaN,NaN,337.24380485225504,NaN,NaN,335.4127,338.87369882131736,331.9517011786826,336.29717391338363,336.61623305068446,338.880728997521,334.35173710384794,103440,113094.66666666667,43.682679801081356,58.97307094857315,NaN,NaN,NaN,NaN,1.588465873578542,33.19807465785463,88369394
2025-08-19T10:55:00-04:00,334.38,334.54,332.3,332.35,NaN,NaN,NaN,337.24380485225504,NaN,NaN,335.36650000000003,338.92670519085306,331.806294809147,336.29717391338363,336.4714145704589,338.7978876145761,334.14494152634165,116331,115512.4,37.194558638976815,58.11708403573268,NaN,NaN,NaN,NaN,1.6350040254657896,32.09359490621217,88253063
2025-08-19T11:00:00-04:00,332.27,332.38,330.65,331.12,NaN,NaN,NaN,335.7987201105122,NaN,NaN,335.3039,339.04586220732966,331.56193779267034,336.29717391338363,336.1219139046101,338.7097374047299,333.5340904044903,210501,121309.7,34.0359122618394,55.66281682111357,NaN,NaN,NaN,NaN,1.6417894522182344,31.827433186800896,88042562
2025-08-19T11:05:00-04:00,331.12,331.72,330.84,331.35,NaN,NaN,NaN,335.48900556003434,NaN,NaN,335.23589999999996,339.1358880462949,331.335911953705,336.29717391338363,335.9794323095452,338.65619687856076,333.3026677405296,93376,122450.13333333333,35.1450164857512,52.87708386059823,NaN,NaN,NaN,NaN,1.5873759199169355,31.580283018776147,88135938
2025-08-19T11:10:00-04:00,331.35,331.99,330.76,331.99,NaN,NaN,NaN,335.48900556003434,NaN,NaN,335.16949999999997,339.1738352758144,331.16516472418556,336.29717391338363,335.8741867406882,338.60285053240955,333.1455229489668,77396,123668.66666666667,38.25599093981648,50.723805814409694,NaN,NaN,NaN,NaN,1.5618490684942985,31.131277214446257,88213334
2025-08-19T11:15:00-04:00,331.95,332.46,331.59,332.07,NaN,NaN,NaN,335.48900556003434,NaN,NaN,335.1175,339.2129214680555,331.0220785319445,335.3327391307069,335.8141266680683,338.5628808900538,333.0653724460828,51485,124531.33333333333,38.65212964626981,48.33660860445487,NaN,NaN,NaN,NaN,1.5124312778875633,30.329944541494875,88264819
2025-08-19T11:20:00-04:00,332.01,332.44,331.11,331.38,NaN,NaN,NaN,335.48900556003434,NaN,NaN,335.0513,339.2771536700934,330.82544632990664,333.38119130456556,335.7298709798232,338.51327347151766,332.94646848812874,67766,125057,36.47827484657383,45.70693061494429,NaN,NaN,NaN,NaN,1.4994004723241647,29.84389584226652,88197053
2025-08-19T11:25:00-04:00,331.35,332.33,331.24,332.18,NaN,NaN,NaN,335.48900556003434,NaN,NaN,335.0031000000001,339.3032245983046,330.70297540169554,329.6989299479376,335.67220773893456,338.4734094552103,332.87100602265883,51506,125164.1,40.646301350366194,43.73720922573456,NaN,NaN,NaN,NaN,1.4701575814438654,29.392564907268763,88248559
2025-08-19T11:30:00-04:00,332.14,332.73,332.02,332.66,NaN,NaN,NaN,335.48900556003434,NaN,NaN,334.9603000000001,339.3099728199815,330.61062718001864,329.6989299479376,335.6021992577217,338.4119077630251,332.79249075241825,76129,126743.2,43.06041877126565,41.79479662628221,NaN,NaN,NaN,NaN,1.4158606113407348,28.6048812426065,88324688
2025-08-19T11:35:00-04:00,332.64,332.78,332.17,332.48,NaN,NaN,NaN,335.48900556003434,NaN,NaN,334.9175000000001,339.32149965950094,330.5135003404992,329.9970067902833,335.5640310310503,338.37755122868674,332.7505108334139,43049,127175.26666666666,42.36454715542434,40.32096390112291,NaN,NaN,NaN,NaN,1.3582991391021078,27.82618139353349,88281639
2025-08-19T11:40:00-04:00,332.47,333.35,332.15,333.14,NaN,NaN,NaN,335.48900556003434,NaN,NaN,334.89670000000007,339.3241970853707,330.4692029146294,330.5236054322267,335.5202607493696,338.33137637710297,332.7091451216362,58441,127734.3,45.82180311598858,39.340888803535755,NaN,NaN,NaN,NaN,1.3469920577376746,26.56298567287587,88340080
2025-08-19T11:45:00-04:00,333.18,333.87,333.05,333.53,NaN,NaN,NaN,335.48900556003434,NaN,NaN,334.87590000000006,339.31908475431237,330.43271524568775,331.1988843457813,335.49380399906977,338.29611040384304,332.6914975942965,47159,128331.06666666667,47.81386273232822,39.744597948736654,NaN,NaN,NaN,NaN,1.3093497678992687,24.922946689642657,88387239
2025-08-19T11:50:00-04:00,333.5,333.52,332.3,332.76,NaN,NaN,NaN,335.48900556003434,NaN,NaN,334.8487000000001,339.3265770908469,330.37082290915333,331.1988843457813,335.449236995707,338.2484217396107,332.6500522518033,62495,127413.7,44.34688016350723,40.45141147681623,NaN,NaN,NaN,NaN,1.3036819273350326,23.981397091860075,88324744
2025-08-19T11:55:00-04:00,332.79,333.33,332.72,332.97,NaN,NaN,NaN,335.48900556003434,NaN,NaN,334.83150000000006,339.3314489998078,330.33155100019235,331.1988843457813,335.42624796438434,338.2221938432919,332.6303020854768,35091,124279.9,45.507389644979995,40.92898325386922,NaN,NaN,NaN,NaN,1.25413321823967,23.10710103677625,88359835
2025-08-19T12:00:00-04:00,332.93,333.99,332.84,333.36,NaN,NaN,NaN,335.48900556003434,NaN,NaN,334.8187000000001,339.331659033813,330.30574096618716,331.40978878504006,335.399783102273,338.1869664786707,332.61259972587527,49259,117186.7,47.68902415639431,41.21515070782014,NaN,NaN,NaN,NaN,1.2466951312225532,21.662062655309803,88409094
2025-08-19T12:05:00-04:00,333.36,333.84,332.86,332.97,NaN,NaN,NaN,335.48900556003434,NaN,NaN,334.7937000000001,339.3334179692962,330.25398203070404,331.40978878504006,335.37355855283334,338.15405791613216,332.59305918953453,46073,112641.16666666667,45.717894086169096,41.823960382619596,NaN,NaN,NaN,NaN,1.227645478992368,20.32024130109096,88363021
2025-08-19T12:10:00-04:00,332.96,333.03,331.92,332.09,NaN,NaN,NaN,335.48900556003434,NaN,NaN,334.74490000000003,339.3469375879691,330.142862412031,331.40978878504006,335.334367207493,338.1179202624982,332.5508141524878,50158,109723.7,41.545165915880695,42.36033564362254,NaN,NaN,NaN,NaN,1.21924223049291,19.87801500446338,88312863
2025-08-19T12:15:00-04:00,332.129,333.45,332.07,333.2,NaN,NaN,NaN,335.48900556003434,NaN,NaN,334.72350000000006,339.344085785482,330.10291421451814,331.40978878504006,335.30955851729175,338.089594780746,332.5295222538375,39996,107473.86666666667,47.99309002516948,43.278055182152414,NaN,NaN,NaN,NaN,1.2307249283148447,19.03690982016766,88352859
2025-08-19T12:20:00-04:00,333.22,333.93,333.05,333.85,NaN,NaN,NaN,335.48900556003434,NaN,NaN,334.7017000000001,339.3282756711544,330.07512432884573,331.40978878504006,335.2868513687783,338.055139515192,332.51856322236455,53000,103002.96666666666,51.37552511132576,44.21516476583166,NaN,NaN,NaN,NaN,1.2056731477209268,17.78467847398662,88405859
2025-08-19T12:25:00-04:00,333.87,333.9,332.86,333.16,NaN,NaN,NaN,335.48900556003434,NaN,NaN,334.6663000000001,339.3123916091833,330.0202083908169,331.40978878504006,335.2688793056216,338.03096754434637,332.5067910668969,36333,96544.56666666667,47.82004070015122,44.87001555539461,NaN,NaN,NaN,NaN,1.193839351455144,16.80026528528163,88369526
2025-08-19T12:30:00-04:00,333.13,333.37,332.45,332.9,NaN,NaN,NaN,335.48900556003434,NaN,NaN,334.6181,339.28643070390183,329.9497692960982,331.40978878504006,335.2514126810639,338.01070155115576,332.4921238109721,29821,92921.43333333333,46.51377058224436,45.586836679371075,NaN,NaN,NaN,NaN,1.1742793977797776,16.26769677342051,88339705
2025-08-19T12:35:00-04:00,332.9,333.16,332.19,332.3,NaN,NaN,NaN,335.48900556003434,NaN,NaN,334.5563,339.26376802867884,329.8488319713212,331.40978878504006,335.2278592887814,337.98654824185274,332.4691703357101,35473,89178.56666666667,43.55683443978994,45.7947319000442,NaN,NaN,NaN,NaN,1.1596880122240811,16.010220120275395,88304232
2025-08-19T12:40:00-04:00,332.27,332.36,331.29,331.97,NaN,NaN,NaN,335.34488777630196,NaN,NaN,334.4847000000001,339.2382112959601,329.73118870404005,331.40978878504006,335.18718579006094,337.95356886774493,332.42080271237694,49936,83668.83333333333,41.97627206952173,45.71729284991964,NaN,NaN,NaN,NaN,1.153281725636646,16.52023873985945,88254296
2025-08-19T12:45:00-04:00,331.94,332.33,331.37,332.24,NaN,NaN,NaN,335.3408019682882,NaN,NaN,334.4105,339.1859762067274,329.63502379327264,331.40978878504006,335.15630233289806,337.9270923821048,332.38551228369136,40044,81702.73333333334,43.77401226989653,45.81796892952479,NaN,NaN,NaN,NaN,1.13947588809117,16.993827458044645,88294340
2025-08-19T12:50:00-04:00,332.21,332.8,331.92,331.95,NaN,NaN,NaN,335.3408019682882,NaN,NaN,334.3425000000001,339.15917821230346,329.5258217876967,331.285831028032,335.1162384399952,337.88901829784857,332.3434585821418,57591,80544.63333333333,42.25952768271305,45.56352068429082,NaN,NaN,NaN,NaN,1.1209418960846576,16.83721873362426,88236749
2025-08-19T12:55:00-04:00,331.93,332.02,330.05,330.385,NaN,NaN,NaN,334.59885055375014,NaN,NaN,334.244,339.1775220685701,329.31047793142994,331.27506548635245,335.0173989555663,337.83280880068924,332.2019891104434,99240,77998.4,35.18486932268472,44.66144972645913,NaN,NaN,NaN,NaN,1.1815889035071798,18.061684493636637,88137509
2025-08-19T13:00:00-04:00,330.41,331.02,328.7,328.87,NaN,NaN,NaN,333.57822098312516,NaN,NaN,334.1279,339.2836009572963,328.9721990427037,331.27506548635245,334.85992527452925,337.78197682308877,331.9378737259697,127497,79121.36666666667,29.956616633968025,43.633573760063484,NaN,NaN,NaN,NaN,1.2629039818280952,19.901057761644505,88010012
2025-08-19T13:05:00-04:00,328.87,329.25,328.44,328.85,NaN,NaN,NaN,332.5046654838922,NaN,NaN,334.00810000000007,339.3664370144964,328.64976298550374,331.27506548635245,334.74350994446274,337.75342140440887,331.7335984845166,87710,74856.6,29.893465821413216,42.51829348695157,NaN,NaN,NaN,NaN,1.230553697411803,21.729311353607457,87922302
2025-08-19T13:10:00-04:00,328.9,329.42,328.6,329.32,NaN,NaN,NaN,332.5046654838922,NaN,NaN,333.8983,339.40923190314635,328.38736809685366,331.25605238908196,334.68252761325704,337.73229190548847,331.6327633210256,49609,69288.6,33.444250253174346,41.50080963672157,NaN,NaN,NaN,NaN,1.2012284333109595,23.212219896396995,87971911
2025-08-19T13:15:00-04:00,329.26,329.38,328.12,328.73,NaN,NaN,NaN,332.36308363305056,NaN,NaN,333.7765000000001,339.466840323811,328.0861596761892,330.79484191126556,334.56589053435806,337.69599102141194,331.4357900473042,91749,67921.8,31.30104630097854,40.471034794922254,NaN,NaN,NaN,NaN,1.2054264023601762,24.832060830422044,87880162
2025-08-19T13:20:00-04:00,328.7,329.24,327.85,329.12,NaN,NaN,NaN,332.18339801336646,NaN,NaN,333.65950000000004,339.4858110971735,327.8331889028266,330.61487352901247,334.3819842677462,337.62646203149166,331.1375065040007,152195,69546.96666666666,34.29824995519667,39.95339794058767,NaN,NaN,NaN,NaN,1.2186102307630198,26.46982959734775,88032357
2025-08-19T13:25:00-04:00,329.1,329.78,328.85,329.72,NaN,NaN,NaN,332.18339801336646,NaN,NaN,333.55390000000006,339.4699048310446,327.63789516895554,330.3304952468544,334.31948750425113,337.5902018757465,331.04877313275574,61914,67733.06666666667,38.72724187059556,39.2915516438324,NaN,NaN,NaN,NaN,1.1979952142799435,27.25912351430782,88094271
2025-08-19T13:30:00-04:00,329.62,330.2,329.42,330.15,NaN,NaN,NaN,332.18339801336646,NaN,NaN,333.4743000000001,339.46380248692105,327.4847975130791,330.3304952468544,334.27835982556854,337.561133775857,330.9955858752801,46142,62254.433333333334,41.75743514801995,38.60454521788198,NaN,NaN,NaN,NaN,1.1681384132599457,27.453088968952876,88140413
2025-08-19T13:35:00-04:00,330.16,330.87,330.03,330.2,NaN,NaN,NaN,332.18339801336646,NaN,NaN,333.37520000000006,339.4139548253716,327.3364451746285,330.3304952468544,334.2353264945525,337.525391920823,330.94526106828204,54863,60970.666666666664,42.11590150830016,38.19710670417833,NaN,NaN,NaN,NaN,1.1446999551699517,26.833490948882243,88195276
2025-08-19T13:40:00-04:00,330.17,330.36,329.96,330.12,NaN,NaN,NaN,332.18339801336646,NaN,NaN,333.2836000000001,339.37788389237215,327.18931610762803,329.0593961974835,334.1993271350004,337.4970713814722,330.90158288852854,44299,59867.433333333334,41.67394735549138,37.851405045124544,NaN,NaN,NaN,NaN,1.0915071012292432,26.31383799743312,88150977
2025-08-19T13:45:00-04:00,330.13,330.33,329.86,329.91,NaN,NaN,NaN,332.18339801336646,NaN,NaN,333.19820000000004,339.3591524459309,327.0372475540692,328.25565174601445,334.1625870856658,337.4687809777933,330.8563931935383,44766,59643.46666666667,40.47330468167553,37.631152919544945,NaN,NaN,NaN,NaN,1.0471137368557237,25.91491987936273,88106211
2025-08-19T13:50:00-04:00,329.98,330.13,329.6,329.84,NaN,NaN,NaN,332.18339801336646,NaN,NaN,333.10100000000006,339.3172136386167,326.8847863613834,328.25565174601445,334.1321729251913,337.4463463130005,330.8179995373821,36109,58588.23333333333,40.059006771877286,37.49420539828463,NaN,NaN,NaN,NaN,1.0101770413660272,25.766182576179386,88070102
2025-08-19T13:55:00-04:00,329.84,330.64,329.82,330.41,NaN,NaN,NaN,332.18339801336646,NaN,NaN,333.0166000000001,339.2620070932895,326.77119290671067,328.6904171174493,334.11140260462474,337.428591204584,330.7942140046655,27786,57797.566666666666,44.9963892853102,37.58151804224274,NaN,NaN,NaN,NaN,0.996592966982739,24.952404598218667,88097888
2025-08-19T14:00:00-04:00,330.4,330.47,329,329.38,NaN,NaN,NaN,332.18339801336646,NaN,NaN,332.85520000000014,339.0508836459583,326.65951635404195,328.6904171174493,334.0656290041891,337.3965935907217,330.73466441765646,52883,57022.7,38.78012960937315,37.332989608432754,NaN,NaN,NaN,NaN,1.0304077550554025,24.91122512751444,88045005
2025-08-19T14:05:00-04:00,329.36,330.33,329.22,330.3,NaN,NaN,NaN,332.18339801336646,NaN,NaN,332.68140000000005,338.66279884650424,326.70000115349586,328.6904171174493,334.0442833687362,337.37972553642203,330.7088412010504,27073,56490.166666666664,45.9612478941853,38.102730934968505,NaN,NaN,NaN,NaN,1.036092915408585,24.872987047574803,88072078
2025-08-19T14:10:00-04:00,330.32,330.32,329.4,329.4,NaN,NaN,NaN,332.18339801336646,NaN,NaN,332.50280000000015,338.330184717074,326.6754152829263,328.6904171174493,334.01299843744397,337.3565979586354,330.66939891625253,37922,55806.2,40.906169929529405,38.88484188465146,NaN,NaN,NaN,NaN,1.0278005643079728,24.837480259059426,88034156
2025-08-19T14:15:00-04:00,329.4,329.46,329.09,329.15,NaN,NaN,NaN,332.18339801336646,NaN,NaN,332.29840000000013,337.8587886339733,326.73801136602697,328.6904171174493,333.98492540512194,337.3386377376713,330.63121307257256,31064,55269.7,39.603159000392715,39.57839139743571,NaN,NaN,NaN,NaN,0.9808148097145466,25.086880918950445,88003092
2025-08-19T14:20:00-04:00,329.15,329.65,329.1,329.62,NaN,NaN,NaN,332.18339801336646,NaN,NaN,332.0958000000001,337.2809261740596,326.91067382594065,328.6904171174493,333.9627371336863,337.32313244056405,330.6023418268085,26043,54054.63333333333,43.26225531873004,40.279677473546826,NaN,NaN,NaN,NaN,0.9500423233063614,25.012742992646665,88029135
2025-08-19T14:25:00-04:00,329.53,329.9,329.34,329.72,NaN,NaN,NaN,332.18339801336646,NaN,NaN,331.9072000000001,336.72527727635685,327.08912272364336,328.6904171174493,333.9490368094827,337.31284553671,330.58522808225547,16951,53449.96666666667,44.03909459606704,41.18953806605315,NaN,NaN,NaN,NaN,0.9221821573559071,24.54403508418168,88046086
2025-08-19T14:30:00-04:00,329.64,330.13,329.61,330.02,NaN,NaN,NaN,332.18339801336646,NaN,NaN,331.7136000000001,336.0136753668886,327.4135246331116,328.6904171174493,333.92757721293276,337.2952088260044,330.5599455998611,28551,52759.7,46.40965798966893,42.05463863994403,NaN,NaN,NaN,NaN,0.8934548604019125,23.746700869007288,88074637
2025-08-19T14:35:00-04:00,330.07,330.22,329.01,329.09,NaN,NaN,NaN,332.18339801336646,NaN,NaN,331.5198000000001,335.3793797492681,327.6602202507321,328.6904171174493,333.87824313368145,337.25984377854263,330.49664248882027,59585,53210.1,40.65955249104866,42.192660827119255,NaN,NaN,NaN,NaN,0.9160652275160642,23.670378675649133,88015052
2025-08-19T14:40:00-04:00,329.1,329.36,328.78,329.08,NaN,NaN,NaN,331.9803917198623,NaN,NaN,331.3354000000001,334.7352328430823,327.9355671569179,328.6904171174493,333.8452982808886,337.2385311088687,330.45206545290847,37419,52785.46666666667,40.6013007209547,42.11007979661459,NaN,NaN,NaN,NaN,0.8920605684077768,23.833839323268087,87977633
2025-08-19T14:45:00-04:00,329.115,329.3,328.06,328.21,NaN,NaN,NaN,331.6271920962322,NaN,NaN,331.2006000000001,334.5505854568241,327.85061454317616,328.4034685958693,333.7889272163359,337.2078302283764,330.37002420429536,58425,53399.76666666667,35.79634730574783,41.658683067860856,NaN,NaN,NaN,NaN,0.9169133849500791,24.647430516555154,87919208
2025-08-19T14:50:00-04:00,328.33,329.17,327.99,329.17,NaN,NaN,NaN,331.55413791003986,NaN,NaN,331.1327000000001,334.506851869859,327.7585481301412,328.4034685958693,333.749071360921,337.1833297901377,330.3148129317043,44212,53106.833333333336,43.71223945440311,41.80427536064026,NaN,NaN,NaN,NaN,0.935705286025074,25.462744809075748,87963420
2025-08-19T14:55:00-04:00,329.17,329.38,328.85,329.07,NaN,NaN,NaN,331.55413791003986,NaN,NaN,331.0455000000001,334.4029777736968,327.6880222263034,328.4034685958693,333.7282404465228,337.16883573402464,330.287645159021,25025,52729.9,43.11590339363218,41.99303241149431,NaN,NaN,NaN,NaN,0.9067263370232811,25.830041862790903,87938395
2025-08-19T15:00:00-04:00,329.05,329.05,328.11,328.46,NaN,NaN,NaN,331.48980334365206,NaN,NaN,330.9253000000001,334.21338054052256,327.63721945947765,328.4034685958693,333.68910893232913,337.14597229976914,330.2322455648891,42445,53150.7,39.56968763217688,41.958081044372854,NaN,NaN,NaN,NaN,0.9105315986644739,26.825864072150036,87895950
2025-08-19T15:05:00-04:00,328.44,328.55,327.99,328.05,NaN,NaN,NaN,331.1239031916678,NaN,NaN,330.8393000000001,334.1980045182658,327.4805954817344,328.4034685958693,333.65384780829066,337.1274069440267,330.18028867255464,36362,53180.333333333336,37.346305959313725,41.41164652108739,NaN,NaN,NaN,NaN,0.8854936273312973,27.847559093729412,87859588
2025-08-19T15:10:00-04:00,328.09,328.78,328,328.7,NaN,NaN,NaN,331.1239031916678,NaN,NaN,330.79090000000014,334.2013766178458,327.38042338215445,328.4034685958693,333.63058201957006,337.11350296456993,330.1476610745702,25651,52370.833333333336,42.83069777851802,41.70097281888345,NaN,NaN,NaN,NaN,0.8779583682362028,28.347968223509245,87885239
2025-08-19T15:15:00-04:00,328.68,328.8,328.45,328.47,NaN,NaN,NaN,331.1239031916678,NaN,NaN,330.7333000000001,334.20086376162607,327.26573623837413,328.4034685958693,333.6037807104131,337.096812778685,330.11074864214123,30313,52046.46666666667,41.448131647005496,41.378607372656326,NaN,NaN,NaN,NaN,0.8402470562193328,28.77268524481359,87854926
2025-08-19T15:20:00-04:00,328.47,329.59,328.27,329.55,NaN,NaN,NaN,331.1239031916678,NaN,NaN,330.6845000000001,334.14862254414766,327.2203774558526,328.23377487669546,333.567021189538,337.0689817045463,330.0650606745298,47459,51708.73333333333,49.664595189440526,42.004209176935696,NaN,NaN,NaN,NaN,0.8745151236322372,27.728545922728472,87902385
2025-08-19T15:25:00-04:00,329.55,330.09,329.51,329.94,NaN,NaN,NaN,331.1239031916678,NaN,NaN,330.6419000000001,334.08916842021193,327.1946315797882,328.1389342930028,333.5305505447735,337.0345282441661,330.02657284538094,57097,50303.96666666667,52.26935119249506,42.908937190657284,NaN,NaN,NaN,NaN,0.8534783290870763,26.002826942652025,87959482
2025-08-19T15:30:00-04:00,329.92,330.26,329.73,329.87,NaN,NaN,NaN,331.1239031916678,NaN,NaN,330.61170000000016,334.05903149564193,327.1643685043584,328.4341474344023,333.50402297137595,337.00844902435114,329.99959691840075,43515,47504.566666666666,51.75170118007815,43.515326180753576,NaN,NaN,NaN,NaN,0.8303727341522833,24.157427655203435,87915967
2025-08-19T15:35:00-04:00,329.85,330.21,329.64,330.04,NaN,NaN,NaN,331.1239031916678,NaN,NaN,330.56890000000016,333.9903250190327,327.1474749809676,328.4643179475218,333.4802565868866,336.9848467200214,329.9756664537518,39654,45902.7,52.96985191179899,44.153237417591576,NaN,NaN,NaN,NaN,0.8117746817128341,22.574904687324246,87955621
2025-08-19T15:40:00-04:00,330.04,330.38,329.98,330.28,NaN,NaN,NaN,331.1239031916678,NaN,NaN,330.5213000000001,333.89086187670983,327.1517381232904,328.7834543580175,333.4559403645217,336.95873667182025,329.9531440572232,44301,45725.76666666667,54.70838837384115,44.746003873603875,NaN,NaN,NaN,NaN,0.78236220444763,21.081984932000704,87999922
2025-08-19T15:45:00-04:00,330.27,330.45,330.145,330.3,NaN,NaN,NaN,331.1239031916678,NaN,NaN,330.4777000000002,333.80085224459935,327.15454775540104,329.02026348641397,333.4288112495122,336.92868165805464,329.92894084096974,51580,44386.8,54.85814646021405,45.76018915711569,NaN,NaN,NaN,NaN,0.7482649041299426,19.806178942332924,88051502
2025-08-19T15:50:00-04:00,330.31,330.58,329.04,329.22,NaN,NaN,NaN,331.1239031916678,NaN,NaN,330.3993000000002,333.65172556266884,327.1468744373316,329.02026348641397,333.37758820467343,336.88150952027564,329.8736668890712,81694,42036.76666666667,46.01083928852014,46.14658476908465,NaN,NaN,NaN,NaN,0.8048174109778012,19.71701093569778,87969808
2025-08-19T15:55:00-04:00,329.27,329.85,329.13,329.32,NaN,NaN,NaN,331.1239031916678,NaN,NaN,330.31510000000014,333.4550047693994,327.1751952306009,329.02026348641397,333.3173296798566,336.8278765003152,329.80678285939797,94409,43119.933333333334,46.86533299297422,46.937226603886536,NaN,NaN,NaN,NaN,0.7987590244793888,19.634212072393716,88064217
2025-08-20T09:30:00-04:00,329.23,331.37,327.53,329,327.7819161846485,327.7819161846485,327.7819161846485,NaN,NaN,NaN,330.2399000000002,333.321545333376,327.15825466662443,329.02026348641397,329.3,329.3,329.3,227065,49150.7,44.441378435013775,46.98930795964444,NaN,NaN,NaN,NaN,1.0159905227308632,21.07924317152769,87837152
2025-08-20T09:35:00-04:00,329.07,330.75,328.94,329.82,326.73778688275485,NaN,NaN,NaN,NaN,NaN,330.17690000000016,333.15993395233335,327.193866047667,329.02026348641397,329.52265817685503,329.7870755701367,329.25824078357334,161008,52688.86666666667,51.38088195686939,47.57966357130424,NaN,NaN,NaN,NaN,1.0727054853929445,22.421057763580663,87998160
2025-08-20T09:40:00-04:00,329.84,329.86,327.19,327.34,326.73778688275485,NaN,NaN,NaN,NaN,NaN,330.05650000000026,333.0016276713437,327.1113723286568,329.02026348641397,329.18211187552396,329.8232925754793,328.54093117556863,125611,55399.26666666667,36.52278137981712,47.3620274104214,NaN,NaN,NaN,NaN,1.186797950722021,24.737313668449783,87872549
2025-08-20T09:45:00-04:00,327.32,327.32,323.6,323.65,NaN,NaN,NaN,329.1487003816222,329.1487003816222,329.1487003816222,329.87010000000026,333.20764070544766,326.53255929455287,329.02026348641397,327.5060642645464,329.6722426894711,325.33988583962173,324964,64739.2,24.95811899094481,46.47715691268076,NaN,NaN,NaN,NaN,1.3691695256704446,28.033151472410882,87547585
2025-08-20T09:50:00-04:00,323.68,323.68,319.3,319.855,NaN,NaN,NaN,325.60830490973024,NaN,NaN,329.62540000000024,333.930003043325,325.3207969566755,329.02026348641397,325.5730465825013,329.0738997759271,322.07219338907555,350282,75211.63333333333,18.477876332405316,44.73766966652985,NaN,NaN,NaN,NaN,1.5842288452654125,31.746947716317646,87197303
2025-08-20T09:55:00-04:00,319.855,322.03,319.68,321.46,NaN,NaN,NaN,325.1065637774698,NaN,NaN,329.3906000000002,334.1467289470334,324.63447105296694,329.02026348641397,324.92538667558136,328.5314997435808,321.3192736075819,199038,80920.03333333334,27.098946183958518,43.71272784774078,NaN,NaN,NaN,NaN,1.6389267848893092,35.19547279994536,87396341
2025-08-20T10:00:00-04:00,321.43,322.81,321.18,321.81,NaN,NaN,NaN,325.1065637774698,NaN,NaN,329.1498000000002,334.1891614516854,324.110438548315,329.02026348641397,324.6733939908182,328.2229456529024,321.12384232873404,127646,83412.13333333333,28.86556660739477,42.22708294902323,NaN,NaN,NaN,NaN,1.6382891573972154,37.600601546464155,87523987
2025-08-20T10:05:00-04:00,321.8,322.12,318,319.19,NaN,NaN,NaN,324.7078298055045,NaN,NaN,328.87040000000025,334.50353228679955,323.23726771320094,328.6662107891312,324.03397033670984,327.73299661387324,320.33494405954644,227281,90085.73333333334,24.14808635187792,40.21842117469343,NaN,NaN,NaN,NaN,1.815554217583129,40.3096630503605,87296706
2025-08-20T10:10:00-04:00,319.3,319.69,318.08,319,NaN,NaN,NaN,323.54111026889063,NaN,NaN,328.5924000000002,334.75016038512723,322.4346396148732,327.95896863130497,323.65495115998675,327.4577678531882,319.8521344667853,139612,93475.4,23.84375849215735,38.2249966969848,NaN,NaN,NaN,NaN,1.8008717734700492,42.82522016112139,87157094
2025-08-20T10:15:00-04:00,318.95,319.23,316.66,318.35,NaN,NaN,NaN,322.7399234384866,NaN,NaN,328.3134000000002,335.01410785520295,321.6126921447974,327.93717490504395,323.15003908892555,327.1138248547011,319.18625332315,187474,98689.06666666667,22.78580213543883,36.068993141530505,NaN,NaN,NaN,NaN,1.8558095039364737,45.335443425922115,86969620
2025-08-20T10:20:00-04:00,318.3,319.32,318.03,318.74,NaN,NaN,NaN,322.7399234384866,NaN,NaN,328.0488000000002,335.18194616705995,320.91565383294045,327.09873992403516,322.9453766454516,326.92772460624246,318.9630286846607,99712,101144.7,24.937840582975724,33.942525442182976,NaN,NaN,NaN,NaN,1.8153945393695843,47.5804092631198,87069332
2025-08-20T10:25:00-04:00,318.7,319.15,316.99,317.32,NaN,NaN,NaN,322.7399234384866,NaN,NaN,327.75040000000024,335.38773483360586,320.1130651663946,325.60399193922814,322.70808618385763,326.7435242259578,318.67264814175746,105327,104090.56666666667,22.481000352554176,31.6298721487787,NaN,NaN,NaN,NaN,1.8400092151288976,49.79383441936633,86964005
2025-08-20T10:30:00-04:00,317.36,318.19,316.9,317.72,NaN,NaN,NaN,322.3326874496453,NaN,NaN,327.46580000000023,335.50586700473343,319.425732995267,322.0451935513825,322.50953036166885,326.58696801544045,318.43209270789725,92071,106207.9,24.73053773380647,30.109850609156293,NaN,NaN,NaN,NaN,1.800722842619692,51.86015135334283,87056076
2025-08-20T10:35:00-04:00,317.7,318.2,316.06,316.29,NaN,NaN,NaN,321.99188347466145,NaN,NaN,327.1839000000002,335.7649808853296,318.60281911467087,317.27015484110603,322.1769539771691,326.3506977303873,318.0032102239509,147784,109147.86666666667,22.245217062483476,28.351270899835527,NaN,NaN,NaN,NaN,1.824956925289713,53.88119444515962,86908292
2025-08-20T10:40:00-04:00,316.32,316.62,315.35,315.72,NaN,NaN,NaN,320.79907058944957,NaN,NaN,326.92090000000024,336.0666377373595,317.775162262641,316.95269909830785,321.7965310501597,326.1103890674105,317.48267303290885,162159,113305.86666666667,21.325261724084413,26.700119706197718,NaN,NaN,NaN,NaN,1.7853171449118752,55.83972868113117,86746133
2025-08-20T10:45:00-04:00,315.69,316.52,314.6,316.08,NaN,NaN,NaN,320.4170673808382,NaN,NaN,326.66550000000024,336.2825628052763,317.04843719472416,316.95269909830785,321.4312476594208,325.8549999525971,317.00749536624454,171620,117079.03333333334,23.477698713858757,24.707035188839818,NaN,NaN,NaN,NaN,1.7949373488467384,57.74069664360422,86917753
2025-08-20T10:50:00-04:00,316.06,316.92,316.06,316.68,NaN,NaN,NaN,320.4170673808382,NaN,NaN,326.4127000000002,336.39495289405215,316.43044710594825,315.3741592786463,321.2803159703783,325.7162506744441,316.8443812663125,90957,118637.2,27.059467147005122,24.031084172210388,NaN,NaN,NaN,NaN,1.7281561096434008,59.0602734083194,87008710
2025-08-20T10:55:00-04:00,316.67,316.91,314.92,316.09,NaN,NaN,NaN,320.4170673808382,NaN,NaN,326.1599000000002,336.52738773622167,315.7924122637788,313.6779295506669,321.0855361377736,325.5521965823872,316.61887569316,112002,121536.43333333333,25.781546486379227,24.08990042188427,NaN,NaN,NaN,NaN,1.7468592446688729,60.44695532248422,86896708
2025-08-20T11:00:00-04:00,316.1,316.66,315.62,316.36,NaN,NaN,NaN,320.4170673808382,NaN,NaN,325.9047000000002,336.59143765191106,315.2179623480894,313.6779295506669,320.97126427030497,325.44639826905023,316.4961302715597,73291,122564.63333333333,27.469656786590065,24.732170454326045,NaN,NaN,NaN,NaN,1.6963692986210979,61.73458852849441,86969999
2025-08-20T11:05:00-04:00,316.35,318.22,316.3,317.87,NaN,NaN,NaN,320.4170673808382,NaN,NaN,325.6677000000002,336.5296370666962,314.8057629333042,314.0315270062746,320.82762247473767,325.2649667166542,316.3902782328211,133421,125799.93333333333,36.20842305637844,25.382847373784607,NaN,NaN,NaN,NaN,1.7123429201481635,61.26039030264454,87103420
2025-08-20T11:10:00-04:00,317.9,318.69,317.38,318.44,NaN,NaN,NaN,320.4170673808382,NaN,NaN,325.43350000000027,336.40319320449225,314.4638067955083,314.6842216050197,320.76597618191073,325.1697615794367,316.3621907843848,77375,127524.06666666667,39.18700384347201,26.120092890647268,NaN,NaN,NaN,NaN,1.6836041401375805,60.36842920153492,87180795
2025-08-20T11:15:00-04:00,318.47,319.65,318.46,319.48,NaN,NaN,NaN,320.4170673808382,NaN,NaN,325.21910000000025,336.2267460135983,314.2114539864022,315.8403772840157,320.72086259606505,325.0688023220032,316.3729228701269,98731,129804.66666666667,44.297508989004434,27.559337364727735,NaN,NaN,NaN,NaN,1.649775272984895,58.665655857149744,87279526
2025-08-20T11:20:00-04:00,319.49,320.28,319.38,320.26,NaN,NaN,NaN,320.4170673808382,NaN,NaN,325.02190000000024,336.0245645664012,314.0192354335993,316.78230182721256,320.68975974082923,324.94890163394166,316.4306178477168,149102,133192.76666666666,47.83803141035723,29.273214001742012,NaN,NaN,NaN,NaN,1.5962198963431151,56.54849426995635,87428628
2025-08-20T11:25:00-04:00,320.23,320.4,319.3,320.03,NaN,NaN,NaN,320.4170673808382,NaN,NaN,324.8243000000003,335.82359488833816,313.8250051116624,317.0518414617701,320.6721748996875,324.88460882430155,316.45974097507343,82679,134045.5,46.891564636132415,30.995054180362985,NaN,NaN,NaN,NaN,1.5607756180328902,54.47980859034818,87345949
2025-08-20T11:30:00-04:00,320,320.65,319.6,320.57,315.64793149074825,315.64793149074825,315.64793149074825,NaN,NaN,NaN,324.63890000000026,335.6062306305884,313.6715693694121,317.4464731694161,320.66362725445725,324.831078269571,316.4961762393435,80292,135271.4,49.42171748507027,32.74390253051259,NaN,NaN,NaN,NaN,1.524291645316252,52.33649059577598,87426241
2025-08-20T11:35:00-04:00,320.55,321.03,319.98,320.17,316.08825278662334,NaN,NaN,NaN,NaN,NaN,324.4341000000002,335.345003113896,313.5231968861045,317.9421785355329,320.6576733485796,324.77916040227683,316.5361862948823,84385,136762.43333333332,47.61224161905723,34.53899119240567,NaN,NaN,NaN,NaN,1.4904136706508022,50.00474854991992,87341856
2025-08-20T11:40:00-04:00,320.21,320.99,320.13,320.46,316.2267412963223,NaN,NaN,NaN,NaN,NaN,324.2557000000002,335.1289250984163,313.38247490158415,318.0897428284263,320.6560555522326,324.75204106485194,316.56007003961327,47899,136882.36666666667,49.06819255429081,36.27739510815455,NaN,NaN,NaN,NaN,1.4453841227471744,47.8395595073393,87389755
2025-08-20T11:45:00-04:00,320.46,320.83,319.57,319.65,316.2267412963223,NaN,NaN,NaN,NaN,NaN,324.0427000000002,334.8510236831991,313.2343763168013,318.0897428284263,320.64325905764235,324.6990382472424,316.5874798680423,79214,137803.5,45.28271169674218,37.92293043917304,NaN,NaN,NaN,NaN,1.432142399693804,46.182417129572286,87310541
2025-08-20T11:50:00-04:00,319.67,319.67,317.87,318.26,316.2267412963223,NaN,NaN,NaN,NaN,NaN,323.81990000000025,334.63657314661475,313.00322685338574,318.0897428284263,320.5971273564233,324.6183324586952,316.5759222541514,91426,138127.9,39.63224713323326,39.23057225411224,NaN,NaN,NaN,NaN,1.4584179425728188,45.546035542480816,87219115
2025-08-20T11:55:00-04:00,318.1,318.54,317.49,318.17,316.2267412963223,NaN,NaN,NaN,NaN,NaN,323.60030000000023,334.4210409007296,312.77955909927084,318.0897428284263,320.54788206025245,324.54508014470525,316.55068397579964,80370,137659.93333333332,39.29038546186458,40.3600498789698,NaN,NaN,NaN,NaN,1.4292452323890468,45.12890757549651,87138745
2025-08-20T12:00:00-04:00,318.15,319.75,317.96,319.71,316.2267412963223,NaN,NaN,NaN,NaN,NaN,323.4021000000002,334.13723448266427,312.6669655173361,318.0897428284263,320.51858453758297,324.4790761290435,316.55809294612243,87766,133016.63333333333,47.61677692860136,41.82842914908381,NaN,NaN,NaN,NaN,1.4550134300755448,43.57003644554785,87226511
2025-08-20T12:05:00-04:00,319.66,319.9,319.21,319.75,316.2267412963223,NaN,NaN,NaN,NaN,NaN,323.20270000000016,333.8308620631643,312.574537936836,318.0897428284263,320.5074436330141,324.4445628077512,316.57032445827696,52947,129414.6,47.81697163199923,43.40238808805667,NaN,NaN,NaN,NaN,1.4003696136415773,41.98660156813197,87279458
2025-08-20T12:10:00-04:00,319.8,320.55,319.65,320.41,316.2267412963223,NaN,NaN,NaN,NaN,NaN,323.01050000000015,333.4850383192291,312.5359616807712,318.0897428284263,320.5041641941149,324.42012340992255,316.5882049783072,46554,126779.36666666667,51.13533485269194,45.0927936642068,NaN,NaN,NaN,NaN,1.3646289269528957,39.93375105989714,87326012
2025-08-20T12:15:00-04:00,320.36,321.41,320.28,321.41,316.7034807112481,NaN,NaN,NaN,NaN,NaN,322.85690000000017,333.19467943085067,312.51912056914966,318.522629267212,320.5145699478767,324.39253171470847,316.6366081810449,86595,118833.73333333334,55.72895579896459,46.48711743153438,NaN,NaN,NaN,NaN,1.3478697178848356,37.32092017419552,87412607
2025-08-20T12:20:00-04:00,321.44,321.85,321.095,321.44,317.416277042555,NaN,NaN,NaN,NaN,NaN,322.70410000000015,332.8942296734088,312.5139703265915,319.1626034137696,320.52808168699687,324.3799194394453,316.67624393454844,63734,109282.13333333333,55.86300644577674,47.678260474556154,NaN,NaN,NaN,NaN,1.305521880893061,34.75456599177814,87476341
2025-08-20T12:25:00-04:00,321.44,322.08,321.09,321.76,317.5781508133479,NaN,NaN,NaN,NaN,NaN,322.5751000000002,332.64576482218683,312.50443517781355,319.4350827310156,320.5455660273357,324.36960138215943,316.721530672512,71153,105019.3,57.34660420228895,48.610338704076476,NaN,NaN,NaN,NaN,1.2829846036864143,32.549010166193945,87547494
2025-08-20T12:30:00-04:00,321.77,321.9,320.84,321.16,317.5781508133479,NaN,NaN,NaN,NaN,NaN,322.41490000000016,332.3142140146664,312.5155859853339,319.4350827310156,320.55548421674115,324.3552718009899,316.7556966324924,60461,102779.8,53.70168984797215,49.02917144962039,NaN,NaN,NaN,NaN,1.2670571319945279,30.288402845089873,87487033
2025-08-20T12:35:00-04:00,321.14,321.35,320.61,321.28,317.5781508133479,NaN,NaN,NaN,NaN,NaN,322.25910000000016,331.97810893923037,312.54009106076995,319.4350827310156,320.56042239840247,324.3426198751956,316.7782249216093,43710,96660.76666666666,54.32694085833499,49.5602697512063,NaN,NaN,NaN,NaN,1.2294101939949194,28.25956981428647,87530743
2025-08-20T12:40:00-04:00,321.29,321.38,320.68,321.21,317.5781508133479,NaN,NaN,NaN,NaN,NaN,322.1141000000002,331.6737543222505,312.55444567774987,319.4350827310156,320.5639898093186,324.333675590531,316.79430402810624,31487,93056.6,53.86991890585305,49.877998424119355,NaN,NaN,NaN,NaN,1.1915951801381386,26.347544193021623,87499256
2025-08-20T12:45:00-04:00,321.21,321.35,320.65,320.88,317.5781508133479,NaN,NaN,NaN,NaN,NaN,321.9707000000002,331.383870775082,312.55752922491837,319.4350827310156,320.5665636155092,324.32411393439395,316.80901329662447,30578,87826.73333333334,51.66341108518715,50.167367671700056,NaN,NaN,NaN,NaN,1.1564812386997032,24.601239028018956,87468678
2025-08-20T12:50:00-04:00,320.86,321.46,320.65,321.15,317.5781508133479,NaN,NaN,NaN,NaN,NaN,321.8197000000002,331.0364123010809,312.6029876989195,319.4350827310156,320.5705174678179,324.3140305707616,316.82700436487426,36040,85704.33333333333,53.34713910064753,50.47300671072554,NaN,NaN,NaN,NaN,1.1317325787925818,22.86253062581301,87504718
2025-08-20T12:55:00-04:00,321.08,321.11,320.07,320.36,317.5781508133479,NaN,NaN,NaN,NaN,NaN,321.65750000000014,330.6838441658812,312.63115583411906,319.4350827310156,320.5699062404268,324.29336348393184,316.84644899692177,51221,83900.8,48.07088101045771,50.67216166170522,NaN,NaN,NaN,NaN,1.1280373945931106,21.844563899519258,87453497
2025-08-20T13:00:00-04:00,320.35,322.36,320.145,322.1,317.5781508133479,NaN,NaN,NaN,NaN,NaN,321.50850000000014,330.25026326612505,312.76673673387523,319.4350827310156,320.58729834423735,324.27928543398855,316.89531125448616,87943,83763.2,57.93839182023901,51.97974342506278,NaN,NaN,NaN,NaN,1.205677580693605,20.931531362890638,87541440
2025-08-20T13:05:00-04:00,322.1,322.21,321.42,321.86,318.0914092239434,NaN,NaN,NaN,NaN,NaN,321.3469000000002,329.7514604025966,312.94233959740376,319.4661061807612,320.5962757346815,324.2764081202756,316.9161433490874,35510,80020.73333333334,56.3479369404138,53.19813995924486,NaN,NaN,NaN,NaN,1.1759863249297737,20.08371543602121,87505930
2025-08-20T13:10:00-04:00,321.86,321.99,321.125,321.23,318.0914092239434,NaN,NaN,NaN,NaN,NaN,321.1741000000001,329.2181556164815,313.13004438351874,319.4661061807612,320.60386623666574,324.2684445205373,316.9392879527942,44183,76088.2,52.29015385658114,53.5319525969577,NaN,NaN,NaN,NaN,1.1537730160062192,18.96430150548502,87461747
2025-08-20T13:15:00-04:00,321.17,321.55,320.81,321.27,318.0914092239434,NaN,NaN,NaN,NaN,NaN,320.99870000000016,328.63389294065166,313.36350705934865,319.4661061807612,320.60816671004227,324.260076275305,316.95625714477956,35440,71548.86666666667,52.52392437803474,53.868163507388815,NaN,NaN,NaN,NaN,1.124217800577204,17.64315228676539,87497187
2025-08-20T13:20:00-04:00,321.29,321.89,320.89,320.99,318.0914092239434,NaN,NaN,NaN,NaN,NaN,320.8129000000001,327.97297600246037,313.6528239975399,319.4661061807612,320.6121417654229,324.25319356737384,316.97108996347197,30807,69543.86666666667,50.65294436495039,53.8337070439787,NaN,NaN,NaN,NaN,1.1153451005359751,16.71927659893698,87466380
2025-08-20T13:25:00-04:00,320.96,321.28,320.8,321.06,318.0914092239434,NaN,NaN,NaN,NaN,NaN,320.62810000000013,327.25641528829124,313.999784711709,319.4661061807612,320.61477175661105,324.2449444325704,316.9845990806517,30605,66830.63333333333,51.121706696731025,53.50461782239059,NaN,NaN,NaN,NaN,1.0699633076405457,15.753116841985577,87496985
2025-08-20T13:30:00-04:00,321.06,322.8,321,322.62,318.33129036627304,NaN,NaN,NaN,NaN,NaN,320.4961000000002,326.68291025739217,314.3092897426082,320.12228887331185,320.6410139988785,324.24528290016656,317.0367450975905,88523,67338.36666666667,60.19628258686434,53.81413754675399,NaN,NaN,NaN,NaN,1.122108785666222,16.29718590495683,87585508
2025-08-20T13:35:00-04:00,322.62,322.85,322.34,322.56,319.11895898598794,NaN,NaN,NaN,NaN,NaN,320.3609000000002,326.04556206215915,314.6762379378412,320.4528310986495,320.66210065573716,324.25239778164683,317.0718035298275,56470,64773.333333333336,59.73691071546102,53.98487372626629,NaN,NaN,NaN,NaN,1.0783867295472096,16.84251073148133,87529038
2025-08-20T13:40:00-04:00,322.55,323.7,322.45,323.56,319.5865063048066,NaN,NaN,NaN,NaN,NaN,320.2521000000002,325.4594072082246,315.0447927917758,321.15726487891953,320.6875869201114,324.2691503176065,317.10602352261634,52006,63927.7,64.58740416252272,54.762424748734176,NaN,NaN,NaN,NaN,1.0906448202938375,17.99170881987661,87581044
2025-08-20T13:45:00-04:00,323.54,324.06,323.5,323.71,320.373710563679,NaN,NaN,NaN,NaN,NaN,320.12990000000013,324.6784498745287,315.58135012547154,321.74581190313563,320.73118844856356,324.3057197315014,317.1566571656257,75711,63160.36666666667,65.26339703251095,55.54360018974675,NaN,NaN,NaN,NaN,1.0527416188442777,19.304095993462425,87656755
2025-08-20T13:50:00-04:00,323.7,323.71,322.69,322.98,320.373710563679,NaN,NaN,NaN,NaN,NaN,320.04270000000014,324.1839429101732,315.9014570898271,321.74581190313563,320.7563661328604,324.3204448326189,317.19228743310197,56608,60077.23333333333,59.327868682187685,55.93345374519922,NaN,NaN,NaN,NaN,1.050402931783971,19.4477271374578,87600147
2025-08-20T13:55:00-04:00,322.91,323.08,322.45,322.75,320.373710563679,NaN,NaN,NaN,NaN,NaN,320.02470000000017,324.1105225170693,315.93887748293105,321.74581190313563,320.76706927557774,324.32461501869597,317.2095235324595,28925,58285.433333333334,57.55188520262247,56.35405903930174,NaN,NaN,NaN,NaN,1.0203741509422584,19.286314385913045,87571222
2025-08-20T14:00:00-04:00,322.72,323,320.55,321.23,320.373710563679,NaN,NaN,NaN,NaN,NaN,320.05220000000014,324.15157027372805,315.9528297262722,321.74581190313563,320.7814021434651,324.30960681823615,317.253197468694,95586,58795.23333333333,47.44396917909099,55.93240404490484,NaN,NaN,NaN,NaN,1.1224902830178105,18.56292500116942,87475636
2025-08-20T14:05:00-04:00,321.24,322.03,320.95,321.99,320.373710563679,NaN,NaN,NaN,NaN,NaN,320.06280000000015,324.17938118357984,315.94621881642047,321.74581190313563,320.7885795406377,324.30317483993645,317.273984241339,45560,57501.066666666666,51.98480171258631,56.21196980934259,NaN,NaN,NaN,NaN,1.1194552628022516,17.89120628676462,87521196
2025-08-20T14:10:00-04:00,321.94,322.13,321.24,321.46,320.373710563679,NaN,NaN,NaN,NaN,NaN,320.05580000000015,324.16164966127565,315.94995033872465,321.74581190313563,320.79465771324544,324.29693317226315,317.29238225422773,41418,57285.03333333333,48.817185038884126,55.56045503924582,NaN,NaN,NaN,NaN,1.1030656011735185,17.16191404150332,87479778
2025-08-20T14:15:00-04:00,321.48,321.56,320.32,320.35,NaN,NaN,NaN,324.40793128063086,324.40793128063086,324.40793128063086,320.0790000000002,324.17812234520613,315.9798776547942,321.74581190313563,320.79419488030027,324.2806465447466,317.3077432158539,50935,56342.4,42.91877047699342,54.601228863287226,NaN,NaN,NaN,NaN,1.112846629661125,17.264571191681497,87428843
2025-08-20T14:20:00-04:00,320.32,321.04,320.03,320.5,NaN,NaN,NaN,323.98302531332945,NaN,NaN,320.1090000000002,324.19803949612157,316.01996050387885,321.74581190313563,320.79251027088407,324.2681683559364,317.31685218583175,35349,54473.166666666664,43.905137650502986,54.00229913428164,NaN,NaN,NaN,NaN,1.1055004418281908,17.584311762273746,87464192
2025-08-20T14:25:00-04:00,320.5,320.63,319.58,319.83,NaN,NaN,NaN,323.53947870817814,NaN,NaN,320.13860000000017,324.1975949693116,316.07960503068875,321.74581190313563,320.7859417125033,324.2476517621878,317.3242316628188,48321,53404.86666666667,40.53574461837455,53.14600058002019,NaN,NaN,NaN,NaN,1.1015361245547495,18.219912364686138,87415871
2025-08-20T14:30:00-04:00,319.81,320.71,319.8,320.66,NaN,NaN,NaN,323.53947870817814,NaN,NaN,320.1770000000002,324.2186338281515,316.1353661718489,321.74581190313563,320.78366779860187,324.2355528103358,317.33178278686796,33109,51582.96666666667,46.058402121055174,52.81781899117054,NaN,NaN,NaN,NaN,1.0878549728008367,18.70651209452536,87448980
2025-08-20T14:35:00-04:00,320.64,321.37,320.3,321.37,NaN,NaN,NaN,323.53947870817814,NaN,NaN,320.2580000000002,324.2290734066263,316.2869265933741,321.3486495225085,320.7852802555139,324.2250797192025,317.3454807918253,40762,51176.8,50.309764456953594,52.759823116900726,NaN,NaN,NaN,NaN,1.0865796176007765,18.33258733766147,87489742
2025-08-20T14:40:00-04:00,321.36,322.1,321.36,321.99,NaN,NaN,NaN,323.53947870817814,NaN,NaN,320.3434000000002,324.2759464728212,316.4108535271792,320.87591961800683,320.79456938427626,324.2202296795345,317.368909089018,52765,51383.833333333336,53.73855923278382,52.29855716303782,NaN,NaN,NaN,NaN,1.0618239306292931,17.18127132964445,87542507
2025-08-20T14:45:00-04:00,321.96,322.29,321.71,322.12,NaN,NaN,NaN,323.53947870817814,NaN,NaN,320.4600000000002,324.2479598731769,316.6720401268235,320.01173569440544,320.80471822879036,324.21822918002334,317.3912072775574,48133,50101.76666666667,54.44831869990462,51.92080059049808,NaN,NaN,NaN,NaN,1.0274079355843466,15.993415254809035,87590640
2025-08-20T14:50:00-04:00,322.09,322.22,321.77,321.85,NaN,NaN,NaN,323.53947870817814,NaN,NaN,320.58260000000024,324.1386760622859,317.02652393771456,320.16347523507164,320.8113379378267,324.216044574226,317.4066313014274,34440,49125.3,52.641858697658144,51.06754734300775,NaN,NaN,NaN,NaN,0.9861645116140394,14.890406042461862,87556200
2025-08-20T14:55:00-04:00,321.9,322,321.05,321.22,NaN,NaN,NaN,323.53947870817814,NaN,NaN,320.68540000000024,324.00414002609017,317.3666599739103,320.16347523507164,320.8141547905366,324.2112694802228,317.41704010085033,27472,47669.26666666667,48.59087870936849,49.876653177069,NaN,NaN,NaN,NaN,0.9835813322130358,14.550681864056239,87528728
2025-08-20T15:00:00-04:00,321.19,321.89,321.19,321.69,NaN,NaN,NaN,323.53947870817814,NaN,NaN,320.7856000000002,323.9114846045317,317.6597153954687,320.16347523507164,320.8178415644745,324.2072951628937,317.42838796605537,28498,46603.833333333336,51.58423019764754,49.32353614245899,NaN,NaN,NaN,NaN,0.9633255227692467,14.235223698393876,87557226
2025-08-20T15:05:00-04:00,321.65,321.85,321.26,321.43,NaN,NaN,NaN,323.53947870817814,NaN,NaN,320.89240000000024,323.71991780908013,318.06488219092034,320.16347523507164,320.8219291470412,324.2018258370274,317.442032457055,35455,46328.666666666664,49.85487062502357,48.773749386916215,NaN,NaN,NaN,NaN,0.9366594140000171,13.942298258850252,87521771
2025-08-20T15:10:00-04:00,321.42,322.94,321.41,322.7,NaN,NaN,NaN,323.53947870817814,NaN,NaN,321.0192000000002,323.5782086832206,318.46019131677974,320.62944745628533,320.8378689206286,324.20367351130506,317.4720643299521,63591,47398.8,57.37238753378792,49.48292212653742,NaN,NaN,NaN,NaN,0.9790408844285853,13.538774437650469,87585362
2025-08-20T15:15:00-04:00,322.68,322.91,322.38,322.63,NaN,NaN,NaN,323.53947870817814,NaN,NaN,321.1144000000002,323.5488302332754,318.67996976672504,320.7965579650283,320.8536499597399,324.20888877351837,317.4984111459615,53855,48174.7,56.86635313777846,49.83160437119401,NaN,NaN,NaN,NaN,0.9469665355408312,13.164073746536383,87531507
2025-08-20T15:20:00-04:00,322.62,323.63,322.58,323.57,320.0449986457795,320.0449986457795,320.0449986457795,NaN,NaN,NaN,321.2170000000002,323.6241867398966,318.80981326010385,321.4142463720226,320.87998903199286,324.22619474824984,317.5337833157359,68061,49242.066666666666,61.74580141998757,50.755076969844254,NaN,NaN,NaN,NaN,0.954326068716487,13.560372329185565,87599568
2025-08-20T15:25:00-04:00,323.55,323.67,322.71,322.99,320.1381805255168,NaN,NaN,NaN,NaN,NaN,321.2872000000002,323.69239118589485,318.8820088141056,321.4173970976181,320.8972955411492,324.2363427887395,317.55824829355896,48343,49146.13333333333,57.42892097996,51.79151629148472,NaN,NaN,NaN,NaN,0.9547313495224549,13.967565357421915,87551225
2025-08-20T15:30:00-04:00,322.94,323.65,322.65,323.59,320.1381805255168,NaN,NaN,NaN,NaN,NaN,321.3538000000002,323.8250390092338,318.8825609907666,321.4173970976181,320.9224744299003,324.2529423362881,317.59200652351257,66457,48429.933333333334,60.505099616418164,52.97722786047866,NaN,NaN,NaN,NaN,0.9579648245565652,14.253767738284301,87617682
2025-08-20T15:35:00-04:00,323.6,323.95,323.3,323.36,320.6255115945308,NaN,NaN,NaN,NaN,NaN,321.4204000000002,323.92461072611644,318.91618927388396,321.78333414247555,320.9480200493689,324.27213722616176,317.623902872576,62495,49329.433333333334,58.75249294053124,54.27842416920415,NaN,NaN,NaN,NaN,0.9359673370882374,14.841206048517147,87555187
2025-08-20T15:40:00-04:00,323.4,323.74,323.375,323.6,320.6425337947794,NaN,NaN,NaN,NaN,NaN,321.48100000000017,324.04587426610044,318.9161257338999,321.8166673139805,320.96138252237284,324.28227960601237,317.6404854387333,32739,48947.96666666667,60.05280288213781,55.27802422356719,NaN,NaN,NaN,NaN,0.8962553844390773,15.386684479447647,87587926
2025-08-20T15:45:00-04:00,323.59,323.96,323.26,323.88,320.7320777131985,NaN,NaN,NaN,NaN,NaN,321.5552000000002,324.17807549092447,318.9323245090759,322.07133385118436,320.98078764359497,324.29786166343825,317.6637136237517,45873,49295.73333333333,61.57474254922563,56.08266551587234,NaN,NaN,NaN,NaN,0.882237142693428,16.14022994042159,87633799
2025-08-20T15:50:00-04:00,323.88,324,323.22,323.85,320.756528726235,NaN,NaN,NaN,NaN,NaN,321.62300000000016,324.30374989525615,318.9422501047442,322.0990670809475,321.0165558433506,324.3261386282243,317.7069730584769,86616,51156.03333333333,61.305243861443834,56.62314298934806,NaN,NaN,NaN,NaN,0.8749344896438955,16.839950725611683,87547183
2025-08-20T15:55:00-04:00,323.84,324.77,323.71,323.94,321.3716865114061,NaN,NaN,NaN,NaN,NaN,321.70880000000017,324.4060271392883,319.011572860712,322.719253664758,321.100013351446,324.40370491525437,317.7963217876377,180110,56139.53333333333,61.84477192841916,57.15146107709909,NaN,NaN,NaN,NaN,0.8881534546693317,18.300809938704855,87727293
2025-08-21T09:30:00-04:00,322.11,323.92,321.6,323.38,321.3716865114061,NaN,NaN,NaN,NaN,NaN,321.81120000000016,324.3616874516557,319.2607125483446,322.719253664758,322.96666666666664,322.96666666666664,322.96666666666664,163321,58632.8,56.560275092533644,57.43134796244734,NaN,NaN,NaN,NaN,0.9918567793358062,17.38478512465191,87563972
2025-08-21T09:35:00-04:00,323.3,324.9,323.03,324.36,321.3716865114061,NaN,NaN,NaN,NaN,NaN,321.9350000000002,324.36455222230705,319.5054477776933,322.719253664758,323.59503791266087,324.15647275766065,323.0336030676611,204586,63570,62.5853812851562,58.43095528928933,NaN,NaN,NaN,NaN,1.0545812950975346,16.7674936641885,87768558
2025-08-21T09:40:00-04:00,324.38,324.38,322.29,323.35,321.3716865114061,NaN,NaN,NaN,NaN,NaN,322.00780000000015,324.3838582149895,319.6317417850108,322.719253664758,323.54584479593996,324.0601753983025,323.03151419357744,87923,64767.23333333333,54.23615029453296,58.620378153352576,NaN,NaN,NaN,NaN,1.1285397740191374,15.712706719264311,87680635
2025-08-21T09:45:00-04:00,323.4,323.63,321.07,322.71,NaN,NaN,NaN,325.81702651183963,325.81702651183963,325.81702651183963,322.0670000000002,324.3611813356648,319.77281866433555,322.719253664758,323.26678546902446,323.91352297169163,322.6200479663573,159646,67565.06666666667,49.710652846210806,58.61007688343738,NaN,NaN,NaN,NaN,1.2307869330177705,15.777869872781643,87520989
2025-08-21T09:50:00-04:00,322.68,323.15,321.64,322.25,NaN,NaN,NaN,325.81702651183963,NaN,NaN,322.10380000000015,324.3489900233631,319.8586099766372,322.719253664758,323.15327988301505,323.83020448205536,322.4763552839747,86609,68565.1,46.69481055097411,57.8473928132364,NaN,NaN,NaN,NaN,1.2507307235165006,15.838378515333451,87434380
2025-08-21T09:55:00-04:00,322.32,322.51,320.5,320.77,NaN,NaN,NaN,325.1758992073999,NaN,NaN,322.0910000000002,324.35904673694006,319.8229532630603,322.719253664758,322.90164723356725,323.80187875169634,322.00141571543816,107616,71188.13333333333,38.58414321545322,56.54152067592745,NaN,NaN,NaN,NaN,1.3049642432653212,16.723608265629796,87326764
2025-08-21T10:00:00-04:00,320.72,323,319.66,322.96,NaN,NaN,NaN,325.1758992073999,NaN,NaN,322.12140000000016,324.39447020589097,319.84832979410936,322.719253664758,322.75151677066145,323.65922855012957,321.84380499119334,138423,72616.03333333334,51.898343521240555,55.83813082601695,NaN,NaN,NaN,NaN,1.4503239401749395,18.055558277782254,87465187
2025-08-21T10:05:00-04:00,322.96,323.49,322.25,323.37,NaN,NaN,NaN,325.1758992073999,NaN,NaN,322.15360000000015,324.4507661152312,319.8564338847691,322.719253664758,322.7760238844456,323.6475254434228,321.90452232546835,89148,74068.96666666666,53.91271747853564,55.58697343305807,NaN,NaN,NaN,NaN,1.4353008015910158,18.723651941292047,87554335
2025-08-21T10:10:00-04:00,323.38,323.77,322.75,322.75,NaN,NaN,NaN,325.1758992073999,NaN,NaN,322.18540000000013,324.4706578324988,319.9001421675015,322.719253664758,322.79872840622454,323.6420583675728,321.95539844487627,80855,75383.53333333334,50.47070861699829,54.87023121881379,NaN,NaN,NaN,NaN,1.4056364586202277,19.026135391932293,87473480
2025-08-21T10:15:00-04:00,322.76,323.96,322.65,323.77,NaN,NaN,NaN,325.1758992073999,NaN,NaN,322.23520000000013,324.54772672222146,319.9226732777788,321.7165223454451,322.839855198881,323.67200761171955,322.0077027860425,74152,76157.43333333333,55.50382118255041,54.63818323610088,NaN,NaN,NaN,NaN,1.3988052830044972,19.088403914975842,87547632
2025-08-21T10:20:00-04:00,323.73,324.48,323.54,324.13,NaN,NaN,NaN,325.1758992073999,NaN,NaN,322.29360000000014,324.6467417639021,319.94045823609815,321.7165223454451,322.8995653800961,323.75220980456885,322.0469209556233,61882,77041.86666666667,57.158545863592494,54.431450591919074,NaN,NaN,NaN,NaN,1.3660334770756044,18.56088307831112,87609514
2025-08-21T10:25:00-04:00,324.2,324.48,323.29,324.19,NaN,NaN,NaN,325.1758992073999,NaN,NaN,322.3598000000001,324.736266250772,319.9833337492282,320.90888350309353,322.9539247675498,323.8180941460744,322.0897553890252,66014,77631.63333333333,57.44260677686563,54.136298036750496,NaN,NaN,NaN,NaN,1.3534596572844895,18.286599115907244,87675528
2025-08-21T10:30:00-04:00,324.27,324.27,322.96,323.37,NaN,NaN,NaN,325.1758992073999,NaN,NaN,322.4042000000001,324.77153129094097,320.03686870905926,320.90888350309353,322.97821592411105,323.8320102480466,322.12442160017554,57769,78453.63333333333,52.335328565281095,53.49558980131031,NaN,NaN,NaN,NaN,1.3503553960498833,18.31414381285432,87617759
2025-08-21T10:35:00-04:00,323.42,323.8,322.38,322.55,NaN,NaN,NaN,325.1758992073999,NaN,NaN,322.44800000000015,324.74233737731646,320.15366262268384,320.90888350309353,322.97591793532547,323.8152984223535,322.1365374482974,48037,78696.13333333333,47.76209456761176,52.48968427553835,NaN,NaN,NaN,NaN,1.35533001061775,18.80810273309407,87569722
2025-08-21T10:40:00-04:00,322.5,323.18,322.33,323.12,NaN,NaN,NaN,325.1758992073999,NaN,NaN,322.46840000000014,324.76812993217715,320.16867006782314,320.90888350309353,322.9719936983181,323.7948402963577,322.1491471002785,58702,78894.03333333334,50.96940722980198,52.090336571057506,NaN,NaN,NaN,NaN,1.3192350098593408,19.30645952917189,87628424
2025-08-21T10:45:00-04:00,323.12,323.6,322.45,322.63,NaN,NaN,NaN,325.1758992073999,NaN,NaN,322.48380000000014,324.77733139088076,320.1902686091195,320.90888350309353,322.96950345525084,323.7793375145267,322.159669395975,48539,78907.56666666667,48.228076748649755,51.06481481844991,NaN,NaN,NaN,NaN,1.3071467948693904,19.20338183296067,87579885
2025-08-21T10:50:00-04:00,322.65,323.24,322.1,323.12,NaN,NaN,NaN,325.1758992073999,NaN,NaN,322.52160000000015,324.7934252047283,320.249774795272,320.90888350309353,322.9645900845863,323.7614514280207,322.1677287411519,52101,79496.26666666666,51.062583736121354,50.83813149284907,NaN,NaN,NaN,NaN,1.2952077380930045,19.421519343660947,87631986
2025-08-21T10:55:00-04:00,323.07,323.53,322.86,323.27,NaN,NaN,NaN,325.1758992073999,NaN,NaN,322.56160000000017,324.8142157596916,320.30898424030875,320.90888350309353,322.9712495886486,323.7587062619558,322.1837929153414,42442,79995.26666666666,51.930215161895944,50.99667165825515,NaN,NaN,NaN,NaN,1.2505500425149296,19.226218604279754,87674428
2025-08-21T11:00:00-04:00,323.31,323.6,322.72,322.84,NaN,NaN,NaN,325.1758992073999,NaN,NaN,322.5986000000001,324.8070854903443,320.39011450965586,320.90888350309353,322.9728986391048,323.75249031136644,322.1933069668432,33372,80157.73333333334,49.23537290330422,51.1781403977073,NaN,NaN,NaN,NaN,1.2240821823352914,19.18256071506348,87641056
2025-08-21T11:05:00-04:00,322.8,323,322.4,322.95,NaN,NaN,NaN,325.1758992073999,NaN,NaN,322.63640000000015,324.8025459232841,320.47025407671623,320.90888350309353,322.9687698083904,323.74032111192923,322.19721850485155,36986,80208.76666666666,49.95088753700326,51.990050706389454,NaN,NaN,NaN,NaN,1.1795048835970579,19.455273611823685,87678042
2025-08-21T11:10:00-04:00,322.97,323.01,321.24,321.44,NaN,NaN,NaN,325.1758992073999,NaN,NaN,322.6128000000001,324.80470525367326,320.42089474632695,320.90888350309353,322.925182199981,323.7099877025741,322.1403766973879,71965,80487.9,41.33755767758655,51.23570886041417,NaN,NaN,NaN,NaN,1.2216831061972668,20.664411540515083,87606077
2025-08-21T11:15:00-04:00,321.37,322.23,321.11,322.1,NaN,NaN,NaN,325.1758992073999,NaN,NaN,322.60360000000014,324.8001710006644,320.40702899933586,320.905445469628,322.8945504593909,323.6895790650306,322.09952185375124,50148,80364.33333333333,45.741553486682584,50.652054289567516,NaN,NaN,NaN,NaN,1.2144200271831767,21.880540809828304,87656225
2025-08-21T11:20:00-04:00,322.08,322.64,321.49,322.48,NaN,NaN,NaN,325.1758992073999,NaN,NaN,322.5820000000001,324.7617027322717,320.4022972677285,320.905445469628,322.8755114516758,323.6676340596793,322.08338884367225,51557,79814.2,48.15489540411923,50.486639060076165,NaN,NaN,NaN,NaN,1.2098185966700912,22.36827677495821,87707782
2025-08-21T11:25:00-04:00,322.5,322.61,321.57,321.87,NaN,NaN,NaN,325.1758992073999,NaN,NaN,322.54520000000014,324.70955945282924,320.38084054717103,320.905445469628,322.85895982080865,323.65224866822956,322.06567097338774,36782,79428.83333333333,44.71654110615503,49.71611905461935,NaN,NaN,NaN,NaN,1.1976886969079434,22.821174456864547,87671000
2025-08-21T11:30:00-04:00,321.89,323.1,321.87,322.85,NaN,NaN,NaN,325.1758992073999,NaN,NaN,322.5426000000001,324.7051755388303,320.3800244611699,320.905445469628,322.85326054129195,323.63843352239326,322.06808756019063,44111,78683.96666666666,50.79508543064411,49.2615861665516,NaN,NaN,NaN,NaN,1.199996647128806,22.47944754902752,87715111
2025-08-21T11:35:00-04:00,322.81,323.08,322.73,322.9,NaN,NaN,NaN,325.1758992073999,NaN,NaN,322.5456000000001,324.70973367449506,320.38146632550513,320.905445469628,322.85388848798675,323.6341425327459,322.0736344432276,24799,77427.43333333333,51.090563769786144,48.80786880890306,NaN,NaN,NaN,NaN,1.1392826009053174,22.16212970603599,87739910
2025-08-21T11:40:00-04:00,322.94,323.19,322.7,322.76,NaN,NaN,NaN,325.1758992073999,NaN,NaN,322.5762000000001,324.70808701415064,320.44431298584954,320.9791559662017,322.8543456827737,323.62852702421105,322.0801643413364,31189,77375.76666666666,50.1818922518344,48.654051929371164,NaN,NaN,NaN,NaN,1.0929052722692238,21.68931676339001,87708721
2025-08-21T11:45:00-04:00,322.8,322.86,322.01,322.05,NaN,NaN,NaN,325.1758992073999,NaN,NaN,322.5774000000001,324.7080329953788,320.44676700462145,320.9791559662017,322.8471564592962,323.61876184372824,322.0755510748641,26718,76737.26666666666,45.738980407605034,48.509543775084964,NaN,NaN,NaN,NaN,1.0755548956785665,22.003843615873397,87682003
2025-08-21T11:50:00-04:00,322.01,322.13,320.84,320.94,NaN,NaN,NaN,324.86533228355773,NaN,NaN,322.5670000000002,324.72425844554186,320.4097415544585,320.9791559662017,322.7903713156125,323.60149236896444,321.97925026226056,77725,76440.9,39.805457828725714,47.71211881786523,NaN,NaN,NaN,NaN,1.090872403130099,23.27642897227377,87604278
2025-08-21T11:55:00-04:00,321.01,321.48,320.66,321.24,NaN,NaN,NaN,324.4084989979415,NaN,NaN,322.58480000000014,324.68245675002146,320.4871432499788,320.9791559662017,322.75792701187146,323.5933982949785,321.9224557287644,42028,71838.16666666667,41.99558887427093,47.26694111255246,NaN,NaN,NaN,NaN,1.0715243743350913,24.58644630383325,87646306
2025-08-21T12:00:00-04:00,321.3,321.3,320.49,320.72,NaN,NaN,NaN,324.1922035889441,NaN,NaN,322.5892000000002,324.6702029891568,320.50819701084356,320.9791559662017,322.7100040930012,323.5877154393219,321.8322927466805,55132,68231.86666666667,39.32476128909506,46.428525223479156,NaN,NaN,NaN,NaN,1.052844061882585,25.925787160454654,87591174
2025-08-21T12:05:00-04:00,320.8,321.04,320.15,320.2,NaN,NaN,NaN,323.8636943349012,NaN,NaN,322.5966000000002,324.64060630156604,320.55259369843435,320.9791559662017,322.66594541379436,323.5891538338814,321.7427369937073,44212,62886.066666666666,36.80405344017446,45.34808510049904,NaN,NaN,NaN,NaN,1.041212343176689,27.41102663159745,87546962
2025-08-21T12:10:00-04:00,320.16,321.04,320.04,320.73,NaN,NaN,NaN,323.79648095604205,NaN,NaN,322.5980000000002,324.6367878753863,320.5592121246141,320.9791559662017,322.6345858572179,323.584877681261,321.68429403317487,34806,61115.5,40.95812317126868,44.75685297678222,NaN,NaN,NaN,NaN,1.0382686043783542,28.867707363281802,87581768
2025-08-21T12:15:00-04:00,320.77,321.4,320.74,321.3,NaN,NaN,NaN,323.79648095604205,NaN,NaN,322.5966000000002,324.638852129601,320.5543478703994,320.9791559662017,322.6138322095771,323.5734715642938,321.65419285486036,32383,56873.4,45.13510674402929,44.412868634426935,NaN,NaN,NaN,NaN,1.0119637040656118,29.51310035154276,87614151
2025-08-21T12:20:00-04:00,321.32,321.37,320.9,321.15,NaN,NaN,NaN,323.79648095604205,NaN,NaN,322.5798000000002,324.65528544702596,320.50431455297445,320.9791559662017,322.601302415529,323.5663870785262,321.6362177525318,19907,54650,44.247957017138596,44.620754301537794,NaN,NaN,NaN,NaN,0.9732520109180699,30.11239384064222,87594244
2025-08-21T12:25:00-04:00,321.12,321.12,320.05,320.21,NaN,NaN,NaN,323.7117186451827,NaN,NaN,322.5416000000002,324.71741381574935,320.365786184251,320.9791559662017,322.5693600356857,323.56176752090084,321.57695255047054,35459,52244.76666666667,39.06590659361174,44.14392238060416,NaN,NaN,NaN,NaN,0.9823054387096339,31.35640396336166,87558785
2025-08-21T12:30:00-04:00,320.2,320.8,320.09,320.25,NaN,NaN,NaN,323.52641325221987,NaN,NaN,322.50960000000015,324.77055540887795,320.24864459112234,320.6663247729614,322.53670073296195,323.5568072644159,321.516594201508,35996,48830.53333333333,39.39118931452074,43.51794337420427,NaN,NaN,NaN,NaN,0.9628550502303769,32.51155622017257,87594781
2025-08-21T12:35:00-04:00,320.26,320.8,319.8,320.57,NaN,NaN,NaN,323.3777126498462,NaN,NaN,322.49660000000017,324.7942426529979,320.1989573470024,319.73005981836906,322.4856936288461,323.5453099774217,321.4260772802705,58731,47816.63333333333,42.056102199510214,43.327912023729645,NaN,NaN,NaN,NaN,0.9655082609282071,33.80078749961719,87653512
2025-08-21T12:40:00-04:00,320.55,320.87,320.32,320.56,NaN,NaN,NaN,323.3777126498462,NaN,NaN,322.4740000000002,324.8245539774309,320.1234460225695,319.3897932810265,322.4747504000956,323.54106472666297,321.40843607352826,14301,45598.166666666664,41.993962547578896,42.69926038922499,NaN,NaN,NaN,NaN,0.935829099433336,34.83877000670864,87639211
2025-08-21T12:45:00-04:00,320.55,320.79,320.03,320.3,NaN,NaN,NaN,323.3777126498462,NaN,NaN,322.4514000000002,324.8626171533839,320.0401828466165,319.3897932810265,322.4581403531455,323.5364110466732,321.3798696596178,19807,43786.666666666664,40.325643402694766,41.93033750586132,NaN,NaN,NaN,NaN,0.923269878045244,36.03120071002009,87619404
2025-08-21T12:50:00-04:00,320.31,321.06,320.24,320.95,NaN,NaN,NaN,323.3777126498462,NaN,NaN,322.4164000000002,324.86271562983546,319.9700843701649,319.3897932810265,322.4351297568557,323.5240655083534,321.34619400535803,34218,42864.53333333333,46.091624494729786,41.63817552321099,NaN,NaN,NaN,NaN,0.9158934581848689,36.50556537032155,87653622
2025-08-21T12:55:00-04:00,320.94,321.05,319.26,319.61,NaN,NaN,NaN,323.2206249737669,NaN,NaN,322.3560000000002,324.9243239672402,319.78767603276026,319.3897932810265,322.3952084812341,323.5191463853649,321.2712705771033,41870,42059.73333333333,37.95058180501748,41.08186133731187,NaN,NaN,NaN,NaN,0.978329639743094,37.707842873637965,87611752
2025-08-21T13:00:00-04:00,319.64,320.13,319.27,320.09,NaN,NaN,NaN,322.743551111323,NaN,NaN,322.2864000000002,324.9074280732643,319.66537192673604,319.3897932810265,322.3460943161294,323.5134100502123,321.17877858204645,50400,41814.1,41.90871259550717,41.23209382065341,NaN,NaN,NaN,NaN,0.9698775226185882,38.82424341243178,87662152
2025-08-21T13:05:00-04:00,320.05,320.45,320,320.37,NaN,NaN,NaN,322.743551111323,NaN,NaN,322.2340000000002,324.901022309741,319.5669776902594,319.3897932810265,322.3240136251801,323.5044333342782,321.143593916082,28344,41157.666666666664,44.14692348514092,41.385760578572686,NaN,NaN,NaN,NaN,0.9327434138601168,39.14004525507275,87690496
2025-08-21T13:10:00-04:00,320.3,320.3,319.54,319.68,NaN,NaN,NaN,322.743551111323,NaN,NaN,322.1558000000002,324.88770070110985,319.4238992988906,319.0692686898614,322.2944007982235,323.4983365607112,321.09046503573575,32102,40271,40.05162220787446,41.43767921562836,NaN,NaN,NaN,NaN,0.9254045985843931,39.80813850994318,87658394
2025-08-21T13:15:00-04:00,319.65,319.8,318.85,318.98,NaN,NaN,NaN,322.26559512039466,NaN,NaN,322.06820000000016,324.91836403753865,319.21803596246167,319.0692686898614,322.2235675308203,323.50013921869913,320.9469958429414,63294,40762.833333333336,36.36597099676769,41.40638761252787,NaN,NaN,NaN,NaN,0.9271614129712213,40.906629101210676,87595100
2025-08-21T13:20:00-04:00,318.98,319.29,318.69,318.98,NaN,NaN,NaN,321.8787498876494,NaN,NaN,321.97580000000016,324.91935727665106,319.03224272334927,319.0692686898614,322.17235006464506,323.50164017412715,320.84305995516297,44311,40503.166666666664,36.36597099676769,41.07837674292067,NaN,NaN,NaN,NaN,0.9037927406161357,42.02727073931359,87595100
2025-08-21T13:25:00-04:00,319,319.41,318.68,319.41,NaN,NaN,NaN,321.8787498876494,NaN,NaN,321.88640000000015,324.864511509147,318.9082884908533,319.0692686898614,322.1335385780732,323.4971162278647,320.76996092828176,36634,40309.566666666666,40.28109685280912,40.731661750690655,NaN,NaN,NaN,NaN,0.8913789734292702,42.79092089590516,87631734
2025-08-21T13:30:00-04:00,319.3,320.18,319.17,320.12,NaN,NaN,NaN,321.8787498876494,NaN,NaN,321.8118000000002,324.77626336473253,318.8473366352678,319.0692686898614,322.1009429451907,323.4820113312278,320.7198745591536,40602,40550.566666666666,46.170254852597516,40.86896873893772,NaN,NaN,NaN,NaN,0.8998519038986074,41.906318246771065,87672336
2025-08-21T13:35:00-04:00,320.16,320.89,320.09,320.52,NaN,NaN,NaN,321.8787498876494,NaN,NaN,321.7434000000001,324.66581163443846,318.8209883655618,319.0692686898614,322.07164125534524,323.4567375862996,320.6865449243909,53651,41106.066666666666,49.20913332879855,41.59348493430821,NaN,NaN,NaN,NaN,0.8927196250487076,39.90476030181099,87725987
2025-08-21T13:40:00-04:00,320.65,321.05,320.57,321.05,NaN,NaN,NaN,321.8787498876494,NaN,NaN,321.69680000000017,324.58747311208646,318.8061268879139,319.1143962778358,322.04949254493766,323.43087332375956,320.66811176611577,55994,40573.7,52.995567289607145,42.56522621824295,NaN,NaN,NaN,NaN,0.8668110804023735,37.803513414787176,87781981
2025-08-21T13:45:00-04:00,321.02,321.31,320.83,320.92,NaN,NaN,NaN,321.8787498876494,NaN,NaN,321.62800000000016,324.4240543630147,318.8319456369856,319.5215170222686,322.03565289687424,323.4128299719409,320.6584758218076,40706,40258.96666666667,51.972115651431594,43.273512893380186,NaN,NaN,NaN,NaN,0.839181717516491,35.46081233319124,87741275
2025-08-21T13:50:00-04:00,320.88,321,320.33,320.63,NaN,NaN,NaN,321.8787498876494,NaN,NaN,321.57360000000017,324.3391994216388,318.80800057836154,319.5215170222686,322.0200440749383,323.39719087122035,320.6428972786563,34582,39693.13333333333,49.66779968041128,43.82164411715393,NaN,NaN,NaN,NaN,0.8270973091224569,33.91766914689139,87706693
2025-08-21T13:55:00-04:00,320.66,321.11,320.59,320.86,NaN,NaN,NaN,321.8787498876494,NaN,NaN,321.53660000000013,324.28986892276805,318.7833310772322,319.5215170222686,322.0110832506288,323.38670730053354,320.6354592007241,23704,39257.2,51.50429339691872,44.62011911674136,NaN,NaN,NaN,NaN,0.8051617870422841,32.309097472312246,87730397
2025-08-21T14:00:00-04:00,320.84,321.17,320.7,320.85,NaN,NaN,NaN,321.8787498876494,NaN,NaN,321.5086000000002,324.26075409469934,318.756445905301,319.5968967154015,322.0031309041097,323.37697048491935,320.62929132330004,22384,38532.96666666667,51.41645134399582,45.00046389168893,NaN,NaN,NaN,NaN,0.7812216593964086,30.715736306599567,87708013
2025-08-21T14:05:00-04:00,320.85,321.02,320.23,320.34,NaN,NaN,NaN,321.8787498876494,NaN,NaN,321.50000000000017,324.26399421145356,318.7360057885468,319.5968967154015,321.9888255049627,323.3635893450758,320.61406166484954,30484,38722.46666666667,47.01264151149771,45.64775387072323,NaN,NaN,NaN,NaN,0.781848683725234,29.850650036879227,87677529
2025-08-21T14:10:00-04:00,320.28,320.58,319.86,320.47,NaN,NaN,NaN,321.8787498876494,NaN,NaN,321.45020000000017,324.19685029463193,318.7035497053684,319.5968967154015,321.97178309279525,323.34993403940996,320.59363214618054,32065,38751.666666666664,48.22984662659578,46.09926344437241,NaN,NaN,NaN,NaN,0.7774309206020008,29.483180342836278,87709594
2025-08-21T14:15:00-04:00,320.38,320.63,320.17,320.51,NaN,NaN,NaN,321.8787498876494,NaN,NaN,321.3930000000002,324.0961218990065,318.6898781009939,319.5968967154015,321.9639315504882,323.3429084220314,320.584954678945,16303,38404.5,48.620938675857744,46.41883595799504,NaN,NaN,NaN,NaN,0.7547572834161421,29.04583267191786,87725897
2025-08-21T14:20:00-04:00,320.5,320.92,320.36,320.88,NaN,NaN,NaN,321.8787498876494,NaN,NaN,321.35560000000015,324.03422101854903,318.67697898145127,319.5968967154015,321.9546028733649,323.33258467012206,320.5766210766077,24085,36616.5,52.21678650591514,47.28777626499795,NaN,NaN,NaN,NaN,0.7408460488864178,28.083293198319225,87749982
2025-08-21T14:25:00-04:00,320.87,320.93,320.39,320.5,NaN,NaN,NaN,321.8787498876494,NaN,NaN,321.29020000000014,323.8882992746656,318.6921007253347,319.5968967154015,321.9467844361914,323.3245716653978,320.56899720698505,18737,35840.13333333333,48.4652261426485,48.15200877541802,NaN,NaN,NaN,NaN,0.7264999025373894,27.170193470508824,87731245
2025-08-21T14:30:00-04:00,320.56,320.8,320.14,320.61,NaN,NaN,NaN,321.8787498876494,NaN,NaN,321.21980000000013,323.6940982522211,318.74550174777914,319.5968967154015,321.9373272889846,323.3154346496177,320.55921992835147,21504,34719.2,49.594180157250705,49.09688085830965,NaN,NaN,NaN,NaN,0.7217499094990062,26.68081212529611,87752749
2025-08-21T14:35:00-04:00,320.57,321.54,320.56,321.48,NaN,NaN,NaN,321.8787498876494,NaN,NaN,321.1656000000001,323.4915515388606,318.8396484611396,319.8242166500498,321.9271735681597,323.29856406214844,320.5557830741709,44994,34745.26666666667,57.52042204561152,50.32826122922411,NaN,NaN,NaN,NaN,0.7401963445347928,24.86095345384356,87797743
2025-08-21T14:40:00-04:00,321.45,321.6,320.97,321.09,NaN,NaN,NaN,321.8787498876494,NaN,NaN,321.1200000000001,323.3590712362755,318.88092876372474,319.9123733200398,321.9198146659002,323.2859372529754,320.55369207882507,34668,34740.666666666664,53.461959440198136,50.84909727119559,NaN,NaN,NaN,NaN,0.7323251770680216,23.09816965280328,87763075
2025-08-21T14:45:00-04:00,321.08,321.13,320.41,320.93,NaN,NaN,NaN,321.8787498876494,NaN,NaN,321.0876000000002,323.2895393636098,318.8856606363906,319.9123733200398,321.90779788275313,323.2712014399899,320.54439432551635,36916,34891.76666666667,51.84576780639626,51.03742830530971,NaN,NaN,NaN,NaN,0.7314448072774465,22.30047785877884,87726159
2025-08-21T14:50:00-04:00,320.97,321.59,320.83,321.52,NaN,NaN,NaN,321.8787498876494,NaN,NaN,321.05560000000014,323.18373217659075,318.92746782340953,319.9123733200398,321.9006224695119,323.25732657987834,320.5439183591455,41155,35600.03333333333,57.00709600117821,51.323966070421925,NaN,NaN,NaN,NaN,0.7334844639004855,20.787282453805776,87767314
2025-08-21T14:55:00-04:00,321.46,322.14,321.17,321.91,319.2411059814255,319.2411059814255,319.2411059814255,NaN,NaN,NaN,321.0412000000001,323.13600744726193,318.9463925527383,320.2565351398604,321.8983225666134,323.24541370482694,320.55123142839983,49530,36069.066666666666,60.05490502039142,51.90130816820477,NaN,NaN,NaN,NaN,0.7503784307647344,20.021921205016675,87816844
2025-08-21T15:00:00-04:00,321.9,322.37,321.8,321.95,319.703101164088,NaN,NaN,NaN,NaN,NaN,321.01780000000014,323.0442226215463,318.991377378454,320.57822811188834,321.9000933636473,323.2388320565941,320.56135467070044,43782,36328.6,60.365251726893504,52.66541188581065,NaN,NaN,NaN,NaN,0.7374942571386816,19.616109001020703,87860626
2025-08-21T15:05:00-04:00,321.94,322.35,321.71,322.2,319.703101164088,NaN,NaN,NaN,NaN,NaN,320.99640000000016,322.94846868758475,319.0443313124156,320.59658248951064,321.9016961013231,323.2347834447337,320.56860875791256,30352,35382.63333333333,62.33489495156655,53.439026282571206,NaN,NaN,NaN,NaN,0.7305303816287788,19.07913061463851,87890978
2025-08-21T15:10:00-04:00,322.22,322.46,322,322.44,319.9136830854603,NaN,NaN,NaN,NaN,NaN,320.9884000000001,322.91327032317616,319.0635296768241,320.8272659916085,321.90507380588974,323.2329990392115,320.577148572568,30219,35913.23333333333,64.17544722405049,54.35038313114654,NaN,NaN,NaN,NaN,0.7112067829410075,18.73848654980275,87921197
2025-08-21T15:15:00-04:00,322.46,322.59,322.1,322.21,320.0671520361213,NaN,NaN,NaN,NaN,NaN,320.9736000000001,322.84864777571175,319.0985522242884,321.0388127932868,321.90977808235743,323.23046580720097,320.5890903575139,42959,36684.96666666667,61.09431017449999,55.356216607075275,NaN,NaN,NaN,NaN,0.6954062984452178,18.612097095886764,87878238
2025-08-21T15:20:00-04:00,322.23,322.46,321.87,322.35,320.0671520361213,NaN,NaN,NaN,NaN,NaN,320.9918000000001,322.90194005796104,319.0816599420392,321.0388127932868,321.91295501448,323.2273850271662,320.59852500179386,36522,36761.76666666667,62.28139729017901,56.35989879733122,NaN,NaN,NaN,NaN,0.6878772771277005,18.028353157163806,87914760
2025-08-21T15:25:00-04:00,322.38,322.47,321.92,322.04,320.0671520361213,NaN,NaN,NaN,NaN,NaN,320.99060000000014,322.8980272098989,319.0831727901014,321.0388127932868,321.9145302164922,323.22459640343095,320.60446402955347,25080,36202.1,58.0572026670493,57.03391765384491,NaN,NaN,NaN,NaN,0.6780289001900084,17.5029819095126,87889680
2025-08-21T15:30:00-04:00,322.04,322.1,321.73,321.84,320.0671520361213,NaN,NaN,NaN,NaN,NaN,320.9778000000001,322.853400341509,319.10219965849126,321.0388127932868,321.9142029319209,323.21550329924054,320.61290256460126,49601,36175.46666666667,55.44445955367335,57.26446572868478,NaN,NaN,NaN,NaN,0.6560268358907224,16.614818382640653,87840079
2025-08-21T15:35:00-04:00,321.86,322.07,321.5,321.64,320.0671520361213,NaN,NaN,NaN,NaN,NaN,320.97320000000013,322.84113764377656,319.1052623562237,321.0388127932868,321.91259490745,323.20809783193556,320.61709198296444,33980,36363.333333333336,52.88157147501747,57.57991896671114,NaN,NaN,NaN,NaN,0.6498820618985274,15.53075979214713,87806099
2025-08-21T15:40:00-04:00,321.61,321.9,321.31,321.51,320.0671520361213,NaN,NaN,NaN,NaN,NaN,320.94640000000015,322.7429467322085,319.1498532677918,321.0388127932868,321.9097255928266,323.2001125643113,320.61933862134185,32000,36359.933333333334,51.22410813258926,57.696342393521036,NaN,NaN,NaN,NaN,0.6456047717629164,14.891744513758292,87774099
2025-08-21T15:45:00-04:00,321.53,321.55,321.11,321.47,320.0671520361213,NaN,NaN,NaN,NaN,NaN,320.9178000000001,322.6327100970703,319.20288990292994,321.0388127932868,321.90535868435296,323.1913472217374,320.61937014696855,31252,35291.86666666667,50.69757213998939,57.20899597169089,NaN,NaN,NaN,NaN,0.6309187166369936,14.671265400335143,87742847
2025-08-21T15:50:00-04:00,321.46,321.98,320.96,321.13,320.0671520361213,NaN,NaN,NaN,NaN,NaN,320.8852000000001,322.5188376100714,319.25156238992884,321.0388127932868,321.89664037891646,323.1742150585359,320.61906569929704,61594,35867.96666666667,46.33753494873827,56.700108508015184,NaN,NaN,NaN,NaN,0.6587102368772112,13.69506375194712,87681253
2025-08-21T15:55:00-04:00,321.1,321.13,320,320.13,NaN,NaN,NaN,322.76583683036785,322.76583683036785,322.76583683036785,320.8468000000001,322.4592388488147,319.23436115118545,321.0388127932868,321.8364049570383,323.1212916795273,320.55151823454935,164854,40141.96666666667,36.41739722615949,55.598082037998275,NaN,NaN,NaN,NaN,0.6923737913859815,14.203227897760778,87516399
2025-08-22T09:30:00-04:00,321.67,322.61,319.69,321.38,NaN,NaN,NaN,322.76583683036785,NaN,NaN,320.8556000000001,322.4747660079137,319.2364339920865,321.0388127932868,321.22666666666663,321.22666666666663,321.22666666666663,147921,43719.26666666667,50.64192060958311,55.14342665288434,NaN,NaN,NaN,NaN,0.8514899491441269,13.979830313955786,87664320
2025-08-22T09:35:00-04:00,321.58,323.36,321.295,322.87,319.6605185078673,319.6605185078673,319.6605185078673,NaN,NaN,NaN,320.8882000000001,322.5999976052247,319.1764023947755,320.9662401877036,321.9006624528159,322.54063714981993,321.26068775581183,164066,47399.76666666667,61.65421855531865,55.257663333950575,NaN,NaN,NaN,NaN,0.9381692384909748,14.572082862976648,87828386
2025-08-22T09:40:00-04:00,322.87,324.95,322.6,324.74,320.90879039387335,NaN,NaN,NaN,NaN,NaN,320.9686000000001,322.9907375228276,318.9464624771726,321.07436401293586,322.8154800987861,324.00333567015804,321.6276245274142,222771,52959,70.53837849006072,55.98431524560538,NaN,NaN,NaN,NaN,1.0390142928844741,16.361616917833246,88051157
2025-08-22T09:45:00-04:00,324.8,325.93,324.14,325.77,322.0549817396063,NaN,NaN,NaN,NaN,NaN,321.0800000000001,323.4958675462983,318.6641324537019,321.9344912103487,323.4721190181261,324.96281793089736,321.9814201053548,194229,58076.433333333334,74.09806163881457,56.824541437551666,NaN,NaN,NaN,NaN,1.0926561291070132,18.579930722159183,88245386
2025-08-22T09:50:00-04:00,325.82,326.63,325.58,326.511,323.117255296897,NaN,NaN,NaN,NaN,NaN,321.19562000000013,324.04742731177305,318.3438126882272,322.9085929682789,324.1691212909031,325.9315923898754,322.4066501919308,245318,65100.96666666667,76.31518734461078,57.6916657318774,NaN,NaN,NaN,NaN,1.0896092627422274,20.97900991674246,88490704
2025-08-22T09:55:00-04:00,326.53,326.63,324.62,325.72,323.117255296897,NaN,NaN,NaN,NaN,NaN,321.2840200000001,324.40464113040713,318.1633988695931,322.9085929682789,324.3619902749689,326.08049448240786,322.6434860675299,145143,69148.93333333333,69.47841794799204,58.29053057284113,NaN,NaN,NaN,NaN,1.1553514582606392,21.927525877116736,88345561
2025-08-22T10:00:00-04:00,325.75,334.04,325.68,332.23,325.7360631940735,NaN,NaN,NaN,NaN,NaN,321.5056200000001,325.87889924373013,317.13234075627,326.6742994996985,326.25759315204436,329.4808241178548,323.0343621862339,483113,84506.56666666667,82.9870048916587,59.769502544375385,NaN,NaN,NaN,NaN,1.669969211242023,25.13047182965335,88828674
2025-08-22T10:05:00-04:00,332.33,335.28,331.85,334.26,329.1607875943429,NaN,NaN,NaN,NaN,NaN,321.7866200000001,327.41595153968126,316.1572884603189,327.67243959975883,327.6028440761295,331.7098674281965,323.49582072406247,348064,95092.56666666667,85.18842909046285,61.70744728890492,NaN,NaN,NaN,NaN,1.7956856961533034,28.298864861313866,89176738
2025-08-22T10:10:00-04:00,334.27,335.68,333.6,335.23,330.1523427036909,NaN,NaN,NaN,NaN,NaN,322.0862200000001,328.83895234532594,315.33348765467423,328.5539516798071,328.5516682030469,333.0924341498862,324.01090225620766,294479,103839.7,86.11310289855189,63.89806467068196,NaN,NaN,NaN,NaN,1.8159938607137804,31.30118458236346,89471217
2025-08-22T10:15:00-04:00,335.18,337.45,334.75,335.09,331.44814530806866,NaN,NaN,NaN,NaN,NaN,322.3766200000001,330.03207656270735,314.7211634372929,330.39916134384566,329.4918863512326,334.3731717550663,324.6106009473989,336587,114515.83333333333,85.28553469608444,66.21263347218674,NaN,NaN,NaN,NaN,1.879137156377081,34.33569954498193,89134630
2025-08-22T10:20:00-04:00,335.14,335.62,332.39,334.09,331.44814530806866,NaN,NaN,NaN,NaN,NaN,322.6472200000001,330.95537086331336,314.3390691366869,330.39916134384566,329.84675809687184,334.6893597376326,325.00415645611105,218835,121007.5,79.414797524705,68.22625414305216,NaN,NaN,NaN,NaN,1.975627359493005,35.37601938899308,88915795
2025-08-22T10:25:00-04:00,334.15,335.48,333.44,334.72,331.44814530806866,NaN,NaN,NaN,NaN,NaN,322.93562000000014,331.8749756000112,313.99626439998906,330.39916134384566,330.06238281591055,334.89372074433453,325.2310448874866,134662,124871.66666666667,80.3332871815701,70.34309093173648,NaN,NaN,NaN,NaN,1.980225405243506,36.342030672717726,89050457
2025-08-22T10:30:00-04:00,334.81,336.12,334.63,335.86,331.44814530806866,NaN,NaN,NaN,NaN,NaN,323.23382000000015,332.8569244113357,313.6107155886646,330.39916134384566,330.32099937395753,335.177743928879,325.46425481903606,145540,129006.2,81.9065107334759,72.88373205921775,NaN,NaN,NaN,NaN,1.9452093048689705,37.39633474729007,89195997
2025-08-22T10:35:00-04:00,335.9,336.81,335.6,336.65,331.44814530806866,NaN,NaN,NaN,NaN,NaN,323.57462000000015,333.8453797140326,313.3038602859677,331.2412964864392,330.58363646503653,335.4903997481352,325.6768731819379,140235,132180.9,82.92581882564924,76.205762173467,NaN,NaN,NaN,NaN,1.8926943545211856,38.54176086031793,89336232
2025-08-22T10:40:00-04:00,336.68,337.7,336.07,337.21,332.0260248366256,NaN,NaN,NaN,NaN,NaN,323.91702000000015,334.8221580073536,313.0118819926467,332.43003718915134,330.9404665507229,335.93003901059603,325.9508940908497,189883,137354.73333333334,83.6298337316378,78.5620416821852,NaN,NaN,NaN,NaN,1.8739304720553864,39.81186950827444,89526115
2025-08-22T10:45:00-04:00,337.28,337.65,336.19,336.34,332.08279643496076,NaN,NaN,NaN,NaN,NaN,324.2364200000001,335.6317653662256,312.84107463377467,332.70402975132106,331.1294322040644,336.14345958491356,326.1154048232153,115152,139962.6,78.23289742006811,79.74623302966731,NaN,NaN,NaN,NaN,1.8443640097657144,40.99125610994835,89410963
2025-08-22T10:50:00-04:00,336.32,336.73,335.76,336.23,332.08279643496076,NaN,NaN,NaN,NaN,NaN,324.56742000000014,336.3683713114633,312.766468688537,332.70402975132106,331.27292524316454,336.28763604170604,326.25821444462304,101862,141986.16666666666,77.55144728374336,80.24716651493034,NaN,NaN,NaN,NaN,1.7819094376395939,41.71103621166531,89309101
2025-08-22T10:55:00-04:00,336.26,336.72,335.84,336.18,332.08279643496076,NaN,NaN,NaN,NaN,NaN,324.91142000000013,337.03906313523146,312.7837768647688,332.7265790408455,331.41580081777937,336.42730315749037,326.40429847806837,107296,143911.7,77.222179889036,80.4703178185176,NaN,NaN,NaN,NaN,1.7174873349510553,42.37940344897391,89201805
2025-08-22T11:00:00-04:00,336.19,337.19,336.045,337.05,332.08279643496076,NaN,NaN,NaN,NaN,NaN,325.2728200000001,337.7440011257643,312.80163887423583,333.4227632326764,331.6264249254505,336.6471059949592,326.60574385594185,153199,147558.93333333332,78.90082262346235,80.65500605272128,NaN,NaN,NaN,NaN,1.67659538245455,43.142885380244344,89355004
2025-08-22T11:05:00-04:00,337.02,337.13,336.24,336.36,332.17433441819037,NaN,NaN,NaN,NaN,NaN,325.61182000000014,338.34582592239184,312.87781407760843,333.6712105861411,331.73967459559594,336.757477395702,326.7218717954899,91039,149581.83333333334,74.22851519076326,80.99429871291922,NaN,NaN,NaN,NaN,1.6204099979935098,43.8518328878526,89263965
2025-08-22T11:10:00-04:00,336.36,336.909,336.26,336.41,332.190364671909,NaN,NaN,NaN,NaN,NaN,325.9376200000001,338.92398102315,312.95125897685017,333.81746846891286,331.84356204618354,336.8553847521389,326.8317393402282,88283,151517.3,74.34706273885095,80.37715998771867,NaN,NaN,NaN,NaN,1.551023569565402,44.510141287774545,89352248
2025-08-22T11:15:00-04:00,336.42,336.69,336.07,336.41,332.190364671909,NaN,NaN,NaN,NaN,NaN,326.2554200000001,339.471591767031,313.03924823296916,333.9067747751303,331.96709464244833,336.96531845907055,326.9688708258261,113611,153872.36666666667,74.34706273885095,79.60277667688925,NaN,NaN,NaN,NaN,1.4845218860250164,44.90035853194718,89352248
2025-08-22T11:20:00-04:00,336.41,336.54,335.24,335.35,332.190364671909,NaN,NaN,NaN,NaN,NaN,326.54142000000013,339.91262829302696,313.1702117069733,333.9067747751303,332.0526314601729,337.02497099813036,327.08029192221545,97790,155914.63333333333,66.79286365053137,78.22275958774493,NaN,NaN,NaN,NaN,1.4713417513089446,44.33223052473309,89254458
2025-08-22T11:25:00-04:00,335.35,335.78,335.1,335.53,332.190364671909,NaN,NaN,NaN,NaN,NaN,326.8336200000001,340.33855333798806,313.32868666201216,333.9067747751303,332.12615868199356,337.0696458287872,327.1826715351999,94092,158215.03333333333,67.39863909338953,76.94512418755244,NaN,NaN,NaN,NaN,1.4148173405011593,43.65274140458241,89348550
2025-08-22T11:30:00-04:00,335.53,336.33,335.52,336.1,332.190364671909,NaN,NaN,NaN,NaN,NaN,327.1430200000001,340.7735292641302,313.51251073586997,333.9067747751303,332.230698911108,337.1467976149195,327.3146002072965,121827,160622.56666666668,69.30801835862955,76.22321138997562,NaN,NaN,NaN,NaN,1.371616101893934,43.3088798117113,89470377
2025-08-22T11:35:00-04:00,336.12,336.12,335.04,335.36,332.190364671909,NaN,NaN,NaN,NaN,NaN,327.4330200000001,341.13330380726313,313.7327361927371,333.9067747751303,332.28226851340935,337.17653652360013,327.38800050321856,71891,161886.26666666666,64.06234937933597,75.06100154695889,NaN,NaN,NaN,NaN,1.3507863803300804,42.44631715572537,89398486
2025-08-22T11:40:00-04:00,335.34,335.45,335.05,335.26,332.190364671909,NaN,NaN,NaN,NaN,NaN,327.72122000000013,341.4616558201442,313.9807841798561,333.9067747751303,332.3347324026492,337.2013530575031,327.46811174779526,82093,163556.03333333333,63.36441309016826,73.73656600100836,NaN,NaN,NaN,NaN,1.2828730674493587,41.64536611802414,89316393
2025-08-22T11:45:00-04:00,335.29,335.81,334.89,335.25,332.190364671909,NaN,NaN,NaN,NaN,NaN,328.0194200000002,341.7533157741543,314.2855242258461,333.9067747751303,332.3821401282704,337.2243070218744,327.53997323466643,75105,165017.8,63.29015671029843,72.33401870705472,NaN,NaN,NaN,NaN,1.2569535626315484,41.12503145910759,89241288
2025-08-22T11:50:00-04:00,335.22,335.82,334.99,335.37,332.190364671909,NaN,NaN,NaN,NaN,NaN,328.31742000000014,342.02973781485156,314.6051021851487,333.9067747751303,332.4111433547938,337.2389006459663,327.58338606362133,45944,164496.13333333333,63.83781410987235,70.92030301978576,NaN,NaN,NaN,NaN,1.2264568795864366,40.64823400600181,89287232
2025-08-22T11:55:00-04:00,335.37,336,335.03,335.08,332.190364671909,NaN,NaN,NaN,NaN,NaN,328.60882000000015,342.2642269332039,314.95341306679643,333.9067747751303,332.4560490721076,337.26066833133126,327.6514298128839,73509,161451.3,61.45185571288352,69.72165718355828,NaN,NaN,NaN,NaN,1.2081385310445503,40.32564961131665,89213723
2025-08-22T12:00:00-04:00,335.09,335.75,335.06,335.58,332.190364671909,NaN,NaN,NaN,NaN,NaN,328.90282000000013,342.51286812156843,315.29277187843184,333.9067747751303,332.4898623251157,337.2779050712335,327.70181957899797,55079,158356.56666666668,63.9533873968713,68.75036719163884,NaN,NaN,NaN,NaN,1.1711286359699393,40.02610695910901,89268802
2025-08-22T12:05:00-04:00,335.52,335.84,335.27,335.47,332.190364671909,NaN,NaN,NaN,NaN,NaN,329.2022200000002,342.7180065463799,315.68643345362045,333.8325449934445,332.5252976614527,337.29648204982976,327.7541132730757,57835,154815.53333333333,62.98500460881969,67.73342610019483,NaN,NaN,NaN,NaN,1.1281908762578003,39.814853004709555,89210967
2025-08-22T12:10:00-04:00,335.47,335.74,334.22,334.57,332.190364671909,NaN,NaN,NaN,NaN,NaN,329.4814200000001,342.8516713370324,316.1111686629678,333.8325449934445,332.5594913372219,337.303592457912,327.81539021653185,74208,149863.43333333332,55.57079851244761,66.06699580655092,NaN,NaN,NaN,NaN,1.1561772422393848,38.09558198534154,89136759
2025-08-22T12:15:00-04:00,334.62,334.69,333.76,334.18,332.190364671909,NaN,NaN,NaN,NaN,NaN,329.73542000000015,342.96983994858164,316.50100005141866,333.8325449934445,332.58865812016387,337.2956809268276,327.88163531350017,90498,146405.73333333334,52.67708202064134,64.52760772297077,NaN,NaN,NaN,NaN,1.140021724936572,35.93380417870118,89046261
2025-08-22T12:20:00-04:00,334.255,335.27,334.21,334.9,332.190364671909,NaN,NaN,NaN,NaN,NaN,330.0116200000001,343.08828217287265,316.93495782712756,333.8325449934445,332.61715241442755,337.300283493465,327.9340213353901,67055,140463.63333333333,57.11674179365785,63.296870512599845,NaN,NaN,NaN,NaN,1.136448744583958,34.48576813691851,89113316
2025-08-22T12:25:00-04:00,334.89,335.15,334.48,335.13,332.190364671909,NaN,NaN,NaN,NaN,NaN,330.2956200000001,343.18647834781683,317.40476165218337,333.8325449934445,332.6442267700864,337.306359622289,327.9820939178838,61723,137682.96666666667,58.45750108175969,62.161901822807614,NaN,NaN,NaN,NaN,1.1031309771136724,33.141163240977455,89175039
2025-08-22T12:30:00-04:00,335.09,336.66,335.08,336.52,332.3023367174067,NaN,NaN,NaN,NaN,NaN,330.5956200000001,343.35307824776464,317.8381617522356,334.0460211434519,332.7253238208764,337.36170526489377,328.088942376859,126662,125801.26666666666,65.48152910880134,62.06823506982689,NaN,NaN,NaN,NaN,1.1371930501769845,33.122461390041586,89301701
2025-08-22T12:35:00-04:00,336.525,337.38,336.34,337.02,333.3126850484337,NaN,NaN,NaN,NaN,NaN,330.89782000000014,343.5332485511578,318.2623914488425,334.76881691476154,332.82924455255267,337.45385854526,328.2046305598453,136809,118759.43333333333,67.60346412733449,62.082865429394396,NaN,NaN,NaN,NaN,1.1302506894500586,33.56000869512125,89438510
2025-08-22T12:40:00-04:00,337.03,338.25,336.91,337.18,334.01119936441404,NaN,NaN,NaN,NaN,NaN,331.2024200000001,343.6938216129297,318.71101838707045,335.49105353180926,332.9551270704943,337.5778314845315,328.33242265645714,154522,114094.2,68.27552655333494,62.00911601473048,NaN,NaN,NaN,NaN,1.145232783060767,34.44321754897178,89593032
2025-08-22T12:45:00-04:00,337.18,337.26,336.73,337.12,334.01119936441404,NaN,NaN,NaN,NaN,NaN,331.5008200000001,343.82952143167915,319.172118568321,335.49105353180926,332.99412156554166,337.61179118249214,328.3764519485912,54673,104697.06666666667,67.70828400478212,62.26953991654807,NaN,NaN,NaN,NaN,1.1012875842707102,35.014200934749276,89538359
2025-08-22T12:50:00-04:00,337.13,337.37,336.49,336.94,334.01119936441404,NaN,NaN,NaN,NaN,NaN,331.7908200000001,343.9341052470564,319.64753475294384,335.49105353180926,333.03968577746997,337.64985340207204,328.4295181528679,66967,99634.8,65.93838698283342,62.453395194595586,NaN,NaN,NaN,NaN,1.0854813282513736,35.206799242807946,89471392
2025-08-22T12:55:00-04:00,336.94,336.94,335.96,336.52,334.01119936441404,NaN,NaN,NaN,NaN,NaN,332.0770200000001,343.97565762619047,320.17838237380977,335.49105353180926,333.0798792154421,337.6778407356581,328.48191769522606,68574,97431.86666666667,61.87416859565884,62.35225318640703,NaN,NaN,NaN,NaN,1.077946947661991,34.66617517176194,89402818
2025-08-22T13:00:00-04:00,336.57,337.11,336.5,336.95,334.01119936441404,NaN,NaN,NaN,NaN,NaN,332.3690200000001,344.0123443809286,320.7256956190716,335.49105353180926,333.12690057738195,337.7152585630707,328.5385425916932,73920,95044.53333333334,64.3002624057523,62.385285207541315,NaN,NaN,NaN,NaN,1.0445221656861354,34.291539161049464,89476738
2025-08-22T13:05:00-04:00,336.95,337.75,336.89,337.4,334.01119936441404,NaN,NaN,NaN,NaN,NaN,332.6762200000001,344.019909158619,321.33253084138124,335.5245244213032,333.18128518302507,337.76475863639615,328.597811729654,77451,92951.73333333334,66.68918596904544,62.75938022583859,NaN,NaN,NaN,NaN,1.0313420109942695,34.4015901256287,89554189
2025-08-22T13:10:00-04:00,337.41,337.95,337.15,337.9,334.2804315314418,NaN,NaN,NaN,NaN,NaN,332.99742000000003,343.9999534835051,321.99488651649494,335.76961953704256,333.2355919802958,337.81756852423837,328.6536154363532,73652,89077.36666666667,69.15870306402377,63.131188487778054,NaN,NaN,NaN,NaN,1.0148175816375367,34.639735864372845,89627841
2025-08-22T13:15:00-04:00,337.895,338.08,337.55,337.59,334.62177555273996,NaN,NaN,NaN,NaN,NaN,333.31642000000005,343.90021720212235,322.73262279787775,336.0706956296341,333.30682616519175,337.88703233152245,328.72661999886105,97747,88497.2,65.89682548728504,63.33917569338272,NaN,NaN,NaN,NaN,0.9801877543777107,34.95133868679318,89530094
2025-08-22T13:20:00-04:00,337.57,337.93,337.23,337.71,334.62177555273996,NaN,NaN,NaN,NaN,NaN,333.64042000000006,343.73942087016337,323.54141912983675,336.0706956296341,333.35178960875504,337.9291063819464,328.7744728355637,65062,87270.53333333334,66.5544283213112,64.12372067973011,NaN,NaN,NaN,NaN,0.9601743433507305,34.73269192685822,89595156
2025-08-22T13:25:00-04:00,337.72,338.32,337.68,338.02,334.912082683385,NaN,NaN,NaN,NaN,NaN,333.9714200000001,343.5232000652811,324.41963993471904,336.4340452029658,333.4164664108929,337.99441298906186,328.83851983272393,88007,86627.56666666667,68.25728489862414,65.23659231387174,NaN,NaN,NaN,NaN,0.9373047473971059,34.83580085844821,89683163
2025-08-22T13:30:00-04:00,338.02,338.22,337.67,337.82,334.922442561413,NaN,NaN,NaN,NaN,NaN,334.30522000000013,343.1812310797261,325.42920892027416,336.43623616237267,333.45722137663967,338.03416737363176,328.88027537964757,58060,83456.26666666666,65.92520242719667,65.86576807341022,NaN,NaN,NaN,NaN,0.9096401225830277,34.91467251464639,89625103
2025-08-22T13:35:00-04:00,337.81,338.07,337.53,337.91,334.922442561413,NaN,NaN,NaN,NaN,NaN,334.6608200000001,342.61332736506085,326.7083126349394,336.43623616237267,333.49262790867533,338.0678743556189,328.91738146173174,52099,82158.26666666666,66.48020305173682,66.43881821412289,NaN,NaN,NaN,NaN,0.8832372566842415,34.740440573465754,89677202
2025-08-22T13:40:00-04:00,337.9,338.61,337.77,338.45,335.2511408462461,NaN,NaN,NaN,NaN,NaN,335.0022200000001,342.06014986416494,327.9442901358352,336.83239114391847,333.55159034116656,338.1290883472525,328.9740923350806,80414,81895.96666666666,69.6720308364162,66.73813976609537,NaN,NaN,NaN,NaN,0.880148881206798,35.04038065111384,89757616
2025-08-22T13:45:00-04:00,338.46,338.58,338.13,338.21,335.4883617168713,NaN,NaN,NaN,NaN,NaN,335.3090200000001,341.5127121457678,329.10532785423237,336.93291291513475,333.60795566513156,338.18725208153114,329.02865924873197,78268,80717.86666666667,66.63504389070015,66.66896689205007,NaN,NaN,NaN,NaN,0.8494239611205974,35.318896437501344,89679348
2025-08-22T13:50:00-04:00,338.21,338.53,338.19,338.46,335.57729982064984,NaN,NaN,NaN,NaN,NaN,335.5834200000001,341.0645306625725,330.1023093374277,337.04233033210784,333.64046791629727,338.22108036579203,329.0598554668025,45167,78963.76666666666,68.1904897130741,66.66289283203143,NaN,NaN,NaN,NaN,0.8130365353262672,35.57751823914689,89724515
2025-08-22T13:55:00-04:00,338.47,338.67,337.86,337.93,335.57729982064984,NaN,NaN,NaN,NaN,NaN,335.8266200000001,340.57448764593653,331.0787523540637,337.0748642656863,333.68619433333816,338.2658970905646,329.10649157611175,68050,78095.7,61.63080841535455,66.2287874327866,NaN,NaN,NaN,NaN,0.8128196399458197,35.14190088040042,89656465
2025-08-22T14:00:00-04:00,337.99,338.15,337.65,337.75,335.57729982064984,NaN,NaN,NaN,NaN,NaN,336.05140000000006,340.0129189209459,332.08988107905424,337.0748642656863,333.71859820356894,338.2950955410932,329.1421008660447,52676,75790.66666666667,59.53611372688109,65.77148220021859,NaN,NaN,NaN,NaN,0.7904753799496899,34.32506254834112,89603789
2025-08-22T14:05:00-04:00,337.73,337.81,337.13,337.49,335.57729982064984,NaN,NaN,NaN,NaN,NaN,336.2868000000001,338.9511046073811,333.62249539261904,337.0748642656863,333.75571962420685,338.32469883131387,329.1867404170998,67527,75645.2,56.54650625461051,65.3909348901437,NaN,NaN,NaN,NaN,0.7825842813818554,32.62765738978138,89536262
2025-08-22T14:10:00-04:00,337.54,338.1,337.33,338.03,335.57729982064984,NaN,NaN,NaN,NaN,NaN,336.40280000000007,338.84640075318134,333.9591992468188,337.0748642656863,333.7911855980239,338.355864242496,329.2265069535518,60180,74914.76666666666,60.93419272251992,65.15050134134138,NaN,NaN,NaN,NaN,0.7816854041402971,31.434735526881465,89596442
2025-08-22T14:15:00-04:00,338.02,338.5,338.02,338.28,335.65362079108786,NaN,NaN,NaN,NaN,NaN,336.48320000000007,338.90392531298517,334.06247468701497,337.0748642656863,333.8316634467857,338.39536366265173,329.26796323091963,62943,74509.36666666667,62.80663028822538,64.87317593556853,NaN,NaN,NaN,NaN,0.7601364467017058,30.81835896298489,89659385
2025-08-22T14:20:00-04:00,338.26,338.42,337.79,338.4,335.65362079108786,NaN,NaN,NaN,NaN,NaN,336.5466000000001,338.99856283838295,334.0946371616173,337.0748642656863,333.8639059553769,338.4261055380098,329.301706372744,51709,74701.53333333334,63.70586469776312,64.48368748083563,NaN,NaN,NaN,NaN,0.7508409862230121,29.823021796965065,89711094
2025-08-22T14:25:00-04:00,338.38,338.75,338.19,338.31,335.93681150592926,NaN,NaN,NaN,NaN,NaN,336.61100000000005,339.07566306033897,334.1463369396611,337.22794073806404,333.9063077587491,338.46822247065955,329.34439304683866,65911,74448.26666666666,62.4856572295474,64.24003260528293,NaN,NaN,NaN,NaN,0.7372094872070828,29.31045761382241,89645183
2025-08-22T14:30:00-04:00,338.34,338.739,338.21,338.71,335.9843200738415,NaN,NaN,NaN,NaN,NaN,336.70340000000004,339.12918683336994,334.27761316663015,337.2568525904512,333.953276758417,338.51581453189897,329.39073898493507,72265,75021.13333333333,65.63601548275777,64.1744316882434,NaN,NaN,NaN,NaN,0.7223373809780052,28.83450515804708,89717448
2025-08-22T14:35:00-04:00,338.67,339.06,338.4,338.53,336.2630100704851,NaN,NaN,NaN,NaN,NaN,336.7796000000001,339.1907041787681,334.36849582123205,337.544282072361,334.0213189278074,338.58551456582205,329.4571232897927,104793,76586.4,63.06929955033166,63.80386130622251,NaN,NaN,NaN,NaN,0.7178847109081493,28.793413375400945,89612655
2025-08-22T14:40:00-04:00,338.54,338.55,338.03,338.36,336.2630100704851,NaN,NaN,NaN,NaN,NaN,336.8296000000001,339.26590526838993,334.39329473161024,337.544282072361,334.06023738720603,338.6218719267315,329.49860284768056,66379,76325.43333333333,60.65675217765311,63.42754343125512,NaN,NaN,NaN,NaN,0.7037500887004271,27.998353448880138,89546276
2025-08-22T14:45:00-04:00,338.36,339.03,338.19,338.72,336.2630100704851,NaN,NaN,NaN,NaN,NaN,336.87100000000004,339.3633956349325,334.3786043650676,337.544282072361,334.1158053068894,338.6774026164175,329.5542079973613,89780,76301.5,63.813518686255414,63.23706597657787,NaN,NaN,NaN,NaN,0.7134822252218234,27.868684242441688,89636056
2025-08-22T14:50:00-04:00,338.77,339.09,338.54,338.67,336.42041005472976,NaN,NaN,NaN,NaN,NaN,336.9002000000001,339.4415271810027,334.3588728189975,337.544282072361,334.1644028808179,338.7266831290106,329.60212263262514,78248,76674.6,63.05676227947076,62.76454679393891,NaN,NaN,NaN,NaN,0.7018049234202614,27.8207170974527,89557808
2025-08-22T14:55:00-04:00,338.67,338.89,338.56,338.74,336.42041005472976,NaN,NaN,NaN,NaN,NaN,336.94820000000004,339.5356332920985,334.3607667079016,337.544282072361,334.19176638985357,338.75398446420553,329.6295483155016,45152,76122.23333333334,63.7056875792953,62.55530705741,NaN,NaN,NaN,NaN,0.6752474288902415,27.776176177105782,89602960
2025-08-22T15:00:00-04:00,338.75,339.23,338.63,339.07,336.6233798225947,NaN,NaN,NaN,NaN,NaN,337.00500000000005,339.6509032486091,334.359096751391,337.80379354947127,334.23704368170246,338.80119523447763,329.6728921289273,71968,74299.1,66.67735247825408,62.44722582635143,NaN,NaN,NaN,NaN,0.6698726125409402,28.165466930989012,89674928
2025-08-22T15:05:00-04:00,339.06,339.57,339.02,339.35,337.01822619429487,NaN,NaN,NaN,NaN,NaN,337.0684000000001,339.78321081493226,334.35358918506796,338.154034839577,334.31253137292003,338.8840957547814,329.74096699105866,114807,73565.7,68.99685966319035,62.97337234405398,NaN,NaN,NaN,NaN,0.661310283073731,28.917490978721,89789735
2025-08-22T15:10:00-04:00,339.33,339.48,338.97,339.26,337.01822619429487,NaN,NaN,NaN,NaN,NaN,337.1126000000001,339.89587234760387,334.32932765239633,338.154034839577,334.3730427201683,338.94870450735505,329.7973809329816,96054,71616.76666666666,67.37350093813775,63.533185716286596,NaN,NaN,NaN,NaN,0.650502405711321,29.488976405485495,89693681
2025-08-22T15:15:00-04:00,339.26,339.3,338.51,338.63,337.01822619429487,NaN,NaN,NaN,NaN,NaN,337.15800000000013,339.9646435471609,334.35135645283935,338.154034839577,334.4300608000731,339.00365426728166,329.8564673328645,101677,73183.56666666667,57.22397176792905,63.581576110095064,NaN,NaN,NaN,NaN,0.6604665195890852,28.91882940385629,89592004
2025-08-22T15:20:00-04:00,338.6,338.65,338.37,338.5,337.01822619429487,NaN,NaN,NaN,NaN,NaN,337.1998000000001,340.0228437192722,334.376756280728,338.154034839577,334.46135761048276,339.03123432908154,329.891480891884,61259,72993.3,55.37034828664085,63.18415865038941,NaN,NaN,NaN,NaN,0.6332903396184343,28.080609530050015,89530745
2025-08-22T15:25:00-04:00,338.5,338.55,338.03,338.52,337.01822619429487,NaN,NaN,NaN,NaN,NaN,337.24200000000013,340.07960180447805,334.4043981955222,338.154034839577,334.4977558850165,339.0617403160657,329.93377145396727,75069,73209.8,55.60858781049967,62.67001275912329,NaN,NaN,NaN,NaN,0.6251981725028346,26.589681562758283,89605814
2025-08-22T15:30:00-04:00,338.51,338.66,338.08,338.35,337.01822619429487,NaN,NaN,NaN,NaN,NaN,337.30200000000013,340.1036823518686,334.50031764813167,338.154034839577,334.53096681181677,339.08928566441614,329.9726479592174,69799,73072.43333333333,53.01789224344962,61.90658615524376,NaN,NaN,NaN,NaN,0.621969731609778,25.396182375892458,89536015
2025-08-22T15:35:00-04:00,338.36,338.36,337.455,337.68,337.01822619429487,NaN,NaN,NaN,NaN,NaN,337.3450000000001,340.102219614203,334.58778038579715,338.154034839577,334.57025436294504,339.1154808901556,330.0250278357345,97866,73752.93333333333,44.26510151505219,60.605117889922674,NaN,NaN,NaN,NaN,0.6421861793519389,24.05254361057731,89438149
2025-08-22T15:40:00-04:00,337.68,338.32,337.34,338.28,337.01822619429487,NaN,NaN,NaN,NaN,NaN,337.38860000000005,340.134613867592,334.6425861324081,338.154034839577,334.60484658384354,339.13984930688656,330.0698438608005,84269,74106.83333333333,51.92015572127885,59.62541362124561,NaN,NaN,NaN,NaN,0.6663157379696588,22.997297519703956,89522418
2025-08-22T15:45:00-04:00,338.28,338.48,338.11,338.31,337.01822619429487,NaN,NaN,NaN,NaN,NaN,337.4476000000001,340.1430348370745,334.7521651629257,338.154034839577,334.6492778296827,339.17488974765496,330.1236659117105,101093,74218.36666666667,52.27312648061869,58.8542584019804,NaN,NaN,NaN,NaN,0.6451503281146834,21.694127264359665,89623511
2025-08-22T15:50:00-04:00,338.4,339.4,338.31,339.17,337.01822619429487,NaN,NaN,NaN,NaN,NaN,337.5258000000001,340.18951797322114,334.8620820267791,338.154034839577,334.74803632713656,339.2677606203567,330.22831203391644,197131,78620.66666666667,61.09139330870248,58.88530419705535,NaN,NaN,NaN,NaN,0.6769253046779184,21.33237752568142,89820642
2025-08-22T15:55:00-04:00,339.17,340.22,339.1,339.97,337.4070097011677,NaN,NaN,NaN,NaN,NaN,337.6202000000001,340.2891578192177,334.9512421807826,338.2242976067527,334.9360840462881,339.47146935915566,330.40069873342054,335196,86860.3,67.16838586316379,59.124937566834525,NaN,NaN,NaN,NaN,0.7085734972009246,21.972088674984228,90155838
2025-08-25T09:30:00-04:00,338.92,341.45,336.64,337.59,NaN,NaN,NaN,341.8514907397945,341.8514907397945,341.8514907397945,337.6646000000001,340.25505389089454,335.0741461091057,338.2242976067527,338.55999999999995,338.55999999999995,338.55999999999995,254040,93392.96666666666,44.76707620021662,57.81853141831636,NaN,NaN,NaN,NaN,1.0015325331151443,21.460180105862406,89901798
2025-08-25T09:35:00-04:00,337.58,340.11,337.57,338.74,NaN,NaN,NaN,341.8514907397945,NaN,NaN,337.7378000000001,340.23722486202564,335.2383751379746,338.2242976067527,338.6614892933486,338.7828727726029,338.5401058140943,177592,97576.06666666667,52.93500721074645,57.04919710627716,NaN,NaN,NaN,NaN,1.111423066464064,20.984836434534998,90079390
2025-08-25T09:40:00-04:00,338.75,338.99,337.34,337.71,NaN,NaN,NaN,341.2777735872921,NaN,NaN,337.78040000000016,340.2026797858146,335.3581202141857,338.2242976067527,338.5053642682274,338.80201766990933,338.2087108665455,136960,99460.93333333333,46.32697650637468,55.595598822571496,NaN,NaN,NaN,NaN,1.1498928474309191,20.76356421271725,89942430
2025-08-25T09:45:00-04:00,337.71,337.73,335.02,336.9,NaN,NaN,NaN,339.7158293333243,NaN,NaN,337.80900000000014,340.1540245202953,335.46397547970497,338.2242976067527,337.8858908125735,338.8280543225458,336.9437273026012,263665,105640.83333333333,41.89752527090374,53.65993208026531,NaN,NaN,NaN,NaN,1.2613290726144275,22.21261264428809,89678765
2025-08-25T09:50:00-04:00,336.9,337.93,336.07,337.64,NaN,NaN,NaN,339.7158293333243,NaN,NaN,337.87040000000013,340.02610298530163,335.71469701469863,338.2242976067527,337.81818178641913,338.73429330472106,336.9020702681172,93166,107240.8,46.893235029501,52.19705594393411,NaN,NaN,NaN,NaN,1.3040912817133978,23.301039688362618,89771931
2025-08-25T09:55:00-04:00,337.65,339.52,337.06,339.17,NaN,NaN,NaN,339.7158293333243,NaN,NaN,337.9702000000001,339.88143202173444,336.05896797826574,338.2242976067527,337.89345453411744,338.7926909300227,336.9942181382122,100973,108338.23333333334,55.426639658305994,52.06867507896103,NaN,NaN,NaN,NaN,1.3866561901624392,22.551231151227395,89872904
2025-08-25T10:00:00-04:00,339.25,339.91,338.32,339.59,335.4412170871604,335.4412170871604,335.4412170871604,NaN,NaN,NaN,338.06400000000014,339.8171183647482,336.3108816352521,338.2242976067527,338.0013035943043,338.9407781390766,337.06182904953204,87023,109483.13333333333,57.4479612178734,52.2170760026205,NaN,NaN,NaN,NaN,1.4011807480079814,21.490592226203223,89959927
2025-08-25T10:05:00-04:00,339.6,341.31,339.05,340.94,336.36502540138036,NaN,NaN,NaN,NaN,NaN,338.1802000000001,339.9100716255288,336.45032837447144,338.2242976067527,338.3335336149746,339.5416969778972,337.12537025205205,176165,113104.4,63.221283050890285,52.76083994836269,NaN,NaN,NaN,NaN,1.462524980293125,20.550210474516504,90136092
2025-08-25T10:10:00-04:00,340.9,341.76,340.31,341.44,337.1957060649539,NaN,NaN,NaN,NaN,NaN,338.27860000000015,340.1715680823376,336.3856319176627,338.2242976067527,338.6445343856275,340.08850046205214,337.2005683092028,158807,116391.96666666666,65.10942417320283,53.624520800487915,NaN,NaN,NaN,NaN,1.4616303388436154,19.99778698227417,90294899
2025-08-25T10:15:00-04:00,341.4,342.15,340.34,340.38,337.3334012438197,NaN,NaN,NaN,NaN,NaN,338.34580000000017,340.2930569015539,336.39854309844645,337.44843808540213,338.86636675007804,340.39891035099316,337.3338231491629,153710,119417.53333333334,58.27867849434665,54.62549058472324,NaN,NaN,NaN,NaN,1.4865138860690714,19.757107559905222,90141189
2025-08-25T10:20:00-04:00,340.41,340.99,339.33,340.9,337.3334012438197,NaN,NaN,NaN,NaN,NaN,338.42020000000014,340.4654031294791,336.37499687052116,337.4478382481713,338.9569016715536,340.48722654409255,337.4265767990147,100048,121028.83333333333,60.46965168956682,55.23616886817238,NaN,NaN,NaN,NaN,1.4989057513498538,18.628172407785012,90241237
2025-08-25T10:25:00-04:00,340.76,341.1,340.03,340.75,337.3334012438197,NaN,NaN,NaN,NaN,NaN,338.49280000000016,340.6048531813377,336.3807468186626,337.4478382481713,339.01327812490007,340.54748206035777,337.4790741894424,59478,120814.4,59.49900470868242,55.75230302731978,NaN,NaN,NaN,NaN,1.4682696262534394,17.666233382099563,90181759
2025-08-25T10:30:00-04:00,340.77,341.38,340.24,340.76,337.3334012438197,NaN,NaN,NaN,NaN,NaN,338.56920000000014,340.72691671930613,336.41148328069414,337.4478382481713,339.0723292694617,340.6141869667863,337.5304715721371,60445,120420.4,59.54562583402113,55.64189106484254,NaN,NaN,NaN,NaN,1.4448217958067642,16.998957112382897,90242204
2025-08-25T10:35:00-04:00,340.745,341.09,340.32,340.43,337.3334012438197,NaN,NaN,NaN,NaN,NaN,338.6474000000001,340.78570516082067,336.50909483917957,337.55563454645096,339.11446537311633,340.6557238686605,337.57320687757215,51222,118634.7,57.205426209672225,54.93025108959314,NaN,NaN,NaN,NaN,1.3966202389634226,16.37934343336028,90190982
2025-08-25T10:40:00-04:00,340.4,340.75,339.61,340.53,337.3334012438197,NaN,NaN,NaN,NaN,NaN,338.7190000000001,340.8648993454598,336.57310065454044,337.55563454645096,339.15439648129234,340.6843813058127,337.624411656772,65486,118604.93333333333,57.7473370885567,55.85741258161743,NaN,NaN,NaN,NaN,1.3782902218946056,15.305968520981322,90256468
2025-08-25T10:45:00-04:00,340.5,341.11,340.14,340.84,337.3334012438197,NaN,NaN,NaN,NaN,NaN,338.7878000000001,340.9802097794137,336.5953902205865,337.9070061097286,339.2006494166439,340.7303049892574,337.6709938440304,59942,117610.33333333333,59.46112560053395,56.32356389517368,NaN,NaN,NaN,NaN,1.3491266346164215,14.4528048724031,90316410
2025-08-25T10:50:00-04:00,340.82,341.38,340.31,340.55,337.3334012438197,NaN,NaN,NaN,NaN,NaN,338.8408000000001,341.07257002417447,336.60902997582576,338.2826048877829,339.2452971472901,340.7747761577482,337.715818136832,59438,116983.33333333333,57.12678660320848,57.094978902090375,NaN,NaN,NaN,NaN,1.3291890178581052,13.910493933925473,90256972
2025-08-25T10:55:00-04:00,340.55,341.22,340.35,340.82,337.3334012438197,NaN,NaN,NaN,NaN,NaN,338.9054000000001,341.1752729834298,336.6355270165704,338.30708391022637,339.2852632431815,340.81478806025706,337.7557384261059,54424,117292.4,58.750466056319524,58.298760386762936,NaN,NaN,NaN,NaN,1.296389802296812,13.40691949105339,90311396
2025-08-25T11:00:00-04:00,340.84,340.86,340.02,340.17,337.3334012438197,NaN,NaN,NaN,NaN,NaN,338.95460000000014,341.22533982674855,336.68386017325173,338.30708391022637,339.3090703893114,340.8295698207895,337.78857095783326,48317,116504.03333333334,53.49774860001183,58.77051135608514,NaN,NaN,NaN,NaN,1.263790530704185,12.566716961680099,90263079
2025-08-25T11:05:00-04:00,340.15,340.6,339.94,340.21,337.3334012438197,NaN,NaN,NaN,NaN,NaN,338.9984000000001,341.2798008330257,336.7169991669745,338.30708391022637,339.32966994648604,340.8397237893242,337.8196161036479,48367,114289.36666666667,53.77166140055579,58.65229862338869,NaN,NaN,NaN,NaN,1.2206626356538879,11.695166765191347,90311446
2025-08-25T11:10:00-04:00,340.25,341.05,339.71,340.97,337.3334012438197,NaN,NaN,NaN,NaN,NaN,339.06140000000016,341.3827789351864,336.7400210648139,338.35578696203584,339.3680748705877,340.8702236996154,337.86592604156,70203,113427.66666666667,58.74403122873816,58.74487505273617,NaN,NaN,NaN,NaN,1.229186733107184,11.389949112579274,90381649
2025-08-25T11:15:00-04:00,340.99,341.85,340.99,341.41,337.87727067650593,NaN,NaN,NaN,NaN,NaN,339.13140000000004,341.51979196137705,336.74300803862303,339.2546295696287,339.45075130907907,340.9765038526034,337.92499876555473,95863,113233.86666666667,61.33687224953029,58.610274281210465,NaN,NaN,NaN,NaN,1.2042448235995276,11.896171842911262,90477512
2025-08-25T11:20:00-04:00,341.45,343.3,341.34,343.25,338.6710311003011,NaN,NaN,NaN,NaN,NaN,339.22740000000005,341.87077605366545,336.58402394633464,340.2437036557029,339.65299265463295,341.3208982021451,337.9850871071208,161367,116570.8,69.86586367590755,58.95001995997511,NaN,NaN,NaN,NaN,1.258227336199564,13.466941750918258,90638879
2025-08-25T11:25:00-04:00,343.27,343.44,342.78,343.39,339.5368933230147,NaN,NaN,NaN,NaN,NaN,339.3310000000001,342.2029115587108,336.45908844128934,340.6649629245623,339.8072623353104,341.59190234949546,338.0226223211253,115232,117909.56666666667,70.40088890081162,59.81589213186546,NaN,NaN,NaN,NaN,1.2154968121853111,15.0165408313637,90754111
2025-08-25T11:30:00-04:00,343.4,344.47,343.15,344.13,340.21930726287763,NaN,NaN,NaN,NaN,NaN,339.4444000000001,342.60322550341505,336.2855744965851,341.5899703396499,339.9627669381,341.8809086904875,338.0446251857125,104299,119059.56666666667,73.11776168808107,60.719328560330766,NaN,NaN,NaN,NaN,1.2229613256006497,17.069055305039015,90858410
2025-08-25T11:35:00-04:00,344.18,345.52,344.18,345.05,341.2329751145651,NaN,NaN,NaN,NaN,NaN,339.5868000000001,343.08357208879147,336.0900279112087,342.52097627171986,340.27236703062744,342.48306895246134,338.06166510879353,183737,121921.93333333333,76.05986561651767,61.90224719660471,NaN,NaN,NaN,NaN,1.2348926594863165,19.485139079834994,91042147
2025-08-25T11:40:00-04:00,345.05,345.37,343.68,344.4,341.2329751145651,NaN,NaN,NaN,NaN,NaN,339.7198000000001,343.4265646055482,336.01303539445195,342.52097627171986,340.42006560576283,342.7256944647992,338.1144367467265,106867,122675.2,70.21303463464648,62.66420496807795,NaN,NaN,NaN,NaN,1.267400326665865,21.06969579659496,90935280
2025-08-25T11:45:00-04:00,344.35,345.05,344.02,344.9,341.2329751145651,NaN,NaN,NaN,NaN,NaN,339.8680000000001,343.7924423808809,335.9435576191193,342.52097627171986,340.5255946199724,342.89613435574745,338.1550548841974,77832,121899.83333333333,71.99632222998835,63.720697540957666,NaN,NaN,NaN,NaN,1.2504431604754482,22.54106989072921,91013112
2025-08-25T11:50:00-04:00,344.89,345.94,344.89,345.8,341.7818935514638,NaN,NaN,NaN,NaN,NaN,340.0234000000001,344.2482647032695,335.7985352967307,342.92669985112053,340.68044843892636,343.17024185853955,338.19065501931317,99502,118645.53333333334,74.9082660425563,64.94647818052907,NaN,NaN,NaN,NaN,1.2361257918700599,24.3742730070464,91112614
2025-08-25T11:55:00-04:00,345.78,345.88,344.72,345.08,341.7818935514638,NaN,NaN,NaN,NaN,NaN,340.1594000000002,344.58408965699266,335.7347103430077,342.92669985112053,340.7804135287675,343.33134126399773,338.22948579353726,72489,109888.63333333333,68.74926016715486,65.60991636385913,NaN,NaN,NaN,NaN,1.2306882353079105,25.837993505726974,91040125
2025-08-25T12:00:00-04:00,345.07,345.09,344.32,344.72,341.7818935514638,NaN,NaN,NaN,NaN,NaN,340.28580000000017,344.86075982940423,335.7108401705961,342.92669985112053,340.86218999172877,343.4480117508771,338.27636823258047,70063,103756.06666666667,65.8345881922834,66.2319021916502,NaN,NaN,NaN,NaN,1.1977819327859156,26.63825108166894,90970062
2025-08-25T12:05:00-04:00,344.7,345.19,344.54,344.93,341.7818935514638,NaN,NaN,NaN,NaN,NaN,340.41820000000024,345.1376621558578,335.69873784414267,342.92669985112053,340.93523011779484,343.5531940102162,338.3172662253735,62232,99910.73333333334,66.72091624324557,66.80122006214492,NaN,NaN,NaN,NaN,1.1586546518726344,27.44580643047656,91032294
2025-08-25T12:10:00-04:00,345,346.13,344.75,345.74,341.9177312204692,NaN,NaN,NaN,NaN,NaN,340.5588000000002,345.4808461436907,335.63675385630967,343.402392259019,341.0498170896726,343.73267009891487,338.36696408043036,87505,98262.23333333334,69.95822304271154,67.97696823662348,NaN,NaN,NaN,NaN,1.1744650338817315,28.757350742681364,91119799
2025-08-25T12:15:00-04:00,345.75,345.78,345.2,345.62,342.04874343772065,NaN,NaN,NaN,NaN,NaN,340.7006000000002,345.78647126858266,335.6147287314177,343.402392259019,341.11942992159015,343.8384757593283,338.40038408385203,55459,91322.03333333334,68.88906065517382,69.05678246909619,NaN,NaN,NaN,NaN,1.132003245747321,29.975213318300113,91064340
2025-08-25T12:20:00-04:00,345.61,346.42,345.58,346.3,342.600618736006,NaN,NaN,NaN,NaN,NaN,340.85940000000016,346.1353081266278,335.5834918733725,344.02233104577215,341.2250116013816,344.00910807654867,338.4409151262145,77360,90795.16666666667,71.54308593256016,69.97100066222633,NaN,NaN,NaN,NaN,1.1111458710510862,31.458168484345585,91141700
2025-08-25T12:25:00-04:00,346.29,346.29,345.65,345.81,342.63649970255125,NaN,NaN,NaN,NaN,NaN,341.00120000000027,346.41869852241643,335.5837014775841,344.0468648366177,341.2945570821767,344.11550413932946,338.47361002502396,54908,89259.66666666667,67.1009441852939,70.38272008620945,NaN,NaN,NaN,NaN,1.0782068802617253,32.835198281387804,91086792
2025-08-25T12:30:00-04:00,345.725,345.87,345.03,345.45,342.63649970255125,NaN,NaN,NaN,NaN,NaN,341.1368000000002,346.65262514593775,335.6209748540627,344.0468648366177,341.35948196096757,344.2053537895054,338.51361013242973,58793,88318.66666666667,63.95886865348699,69.96079187032227,NaN,NaN,NaN,NaN,1.0611921031001759,33.11559939577822,91027999
2025-08-25T12:35:00-04:00,345.43,345.65,344.7,345.33,342.63649970255125,NaN,NaN,NaN,NaN,NaN,341.2686000000002,346.86341046689984,335.6737895331006,344.0468648366177,341.4237379691768,344.2888343193013,338.55864161905225,63581,84565.86666666667,62.901533547774015,69.42512363081958,NaN,NaN,NaN,NaN,1.053249810021591,32.883014394736136,90964418
2025-08-25T12:40:00-04:00,345.3,345.92,345.24,345.87,342.63649970255125,NaN,NaN,NaN,NaN,NaN,341.4046000000002,347.1085498034791,335.7006501965213,344.0468648366177,341.4802010144627,344.3675424134782,338.5928596154472,51486,80988.5,65.6531974670459,68.89194047217421,NaN,NaN,NaN,NaN,1.0265891093057635,32.880326543261,91015904
2025-08-25T12:45:00-04:00,345.85,346.34,345.81,345.94,342.92905807600175,NaN,NaN,NaN,NaN,NaN,341.5364000000002,347.34789173282076,335.7249082671796,344.3651718370786,341.5497207681674,344.4687659927538,338.630675543581,60175,77870.66666666667,66.00519606696281,68.17374979006316,NaN,NaN,NaN,NaN,0.9911184586410642,33.19714413138826,91076079
2025-08-25T12:50:00-04:00,345.91,346.72,345.82,346.67,343.1443281634562,NaN,NaN,NaN,NaN,NaN,341.6846000000002,347.6326527368689,335.7365472631315,344.6901374696629,341.62081693632626,344.5764944857122,338.6651393869403,58545,76487.23333333334,69.51403963584954,68.12382157586337,NaN,NaN,NaN,NaN,0.984609997309562,33.76405717507505,91134624
2025-08-25T12:55:00-04:00,346.63,347.15,346.48,346.9,343.7400405196627,NaN,NaN,NaN,NaN,NaN,341.8500000000002,347.90801023444624,335.79198976555415,345.1911099757303,341.7314520946095,344.7508091814508,338.7120950077682,86501,77388,70.54559233303809,68.0201980117955,NaN,NaN,NaN,NaN,0.9621378546445903,34.58101612553636,91221125
2025-08-25T13:00:00-04:00,346.9,346.97,346.19,346.41,343.7400405196627,NaN,NaN,NaN,NaN,NaN,342.0082000000002,348.1208971985001,335.89550280150036,345.1911099757303,341.7914227922158,344.8387493915238,338.7440961929079,51750,77098.16666666667,65.46348766860558,67.34557098508473,NaN,NaN,NaN,NaN,0.9491280078842645,34.84398872869229,91169375
2025-08-25T13:05:00-04:00,346.4,347.45,346.19,347.42,343.74488196109763,NaN,NaN,NaN,NaN,NaN,342.18620000000016,348.39972832461376,335.97267167538655,345.2543103844674,341.89441258783864,344.9978248831541,338.79100029252317,83086,78160.3,70.2249107196892,67.45097459598004,NaN,NaN,NaN,NaN,0.9713331501782451,35.434325814424504,91252461
2025-08-25T13:10:00-04:00,347.42,347.49,347.04,347.08,344.2682964174114,NaN,NaN,NaN,NaN,NaN,342.36080000000015,348.6237562860323,336.097843713968,345.50844830757393,341.95704315616786,345.09489670450523,338.8191896078305,50356,77655.96666666666,66.88211001962222,67.5257975836471,NaN,NaN,NaN,NaN,0.9340950680226553,36.010921891813894,91202105
2025-08-25T13:15:00-04:00,347.05,348.1,347.03,347.96,344.5586011257109,NaN,NaN,NaN,NaN,NaN,342.5664000000002,348.8759822492992,336.2568177507012,345.9797586460591,342.1106282970854,345.34181807844766,338.8794385157231,117359,79569.86666666667,70.7614950790051,67.81441035762994,NaN,NaN,NaN,NaN,0.9438025631638978,36.96213942571717,91319464
2025-08-25T13:20:00-04:00,347.99,348.65,347.8,348.63,345.2393465290877,NaN,NaN,NaN,NaN,NaN,342.7734000000002,349.1851824168143,336.3616175831861,346.52880691684726,342.2642012655856,345.5988929751644,338.9295095560068,110493,81271.7,73.32363958304815,68.05479725336826,NaN,NaN,NaN,NaN,0.9371023800807599,38.17461742408707,91429957
2025-08-25T13:25:00-04:00,348.6,348.7,348,348.35,345.40460350503827,NaN,NaN,NaN,NaN,NaN,342.9742000000002,349.44287787423013,336.5055221257703,346.65304553347784,342.3482058882276,345.7350704082371,338.9613413682181,62933,81555.33333333333,70.54161003568848,68.17283649483359,NaN,NaN,NaN,NaN,0.9201664957892762,39.3295296238087,91367024
2025-08-25T13:30:00-04:00,348.35,348.68,347.45,347.52,345.40460350503827,NaN,NaN,NaN,NaN,NaN,343.1412000000002,349.6394787136735,336.6429212863269,346.65304553347784,342.4369430148279,345.86772307729694,339.0061629523588,74283,82420.86666666667,62.9205563233946,67.55694152275034,NaN,NaN,NaN,NaN,0.9422974603757578,39.35838801924234,91292741
2025-08-25T13:35:00-04:00,347.55,347.69,347.09,347.54,345.40460350503827,NaN,NaN,NaN,NaN,NaN,343.2926000000002,349.8408343391546,336.74436566084586,346.65304553347784,342.49489016472387,345.9474949348108,339.04228539463696,54296,82618.5,63.02421928064015,67.26574688670364,NaN,NaN,NaN,NaN,0.917847641777491,38.76087186065183,91347037
2025-08-25T13:40:00-04:00,347.53,347.63,347.16,347.45,345.40460350503827,NaN,NaN,NaN,NaN,NaN,343.48980000000023,349.93223493102175,337.0473650689787,346.65304553347784,342.54529618964307,346.01569856036025,339.0748938189259,48540,81896.4,62.18175679820138,67.13881032561181,NaN,NaN,NaN,NaN,0.8858585245076681,38.20603542767493,91298497
2025-08-25T13:45:00-04:00,347.49,348.28,347.32,347.95,345.40460350503827,NaN,NaN,NaN,NaN,NaN,343.6740000000002,350.0892842493923,337.25871575060813,346.65304553347784,342.61365095650973,346.1131410261903,339.11416088682915,61828,80761.9,64.9823036684432,67.28743676280247,NaN,NaN,NaN,NaN,0.8911543441856903,38.261675815369586,91360325
2025-08-25T13:50:00-04:00,347.94,348.37,347.9,348.1,345.40460350503827,NaN,NaN,NaN,NaN,NaN,343.8818000000002,350.18297156094127,337.5806284390592,346.65304553347784,342.6774541890398,346.20620457756587,339.1487038005137,56215,77256.83333333333,65.80051777752398,67.29795964212232,NaN,NaN,NaN,NaN,0.8610718910295715,38.387326463897956,91416540
2025-08-25T13:55:00-04:00,348.075,348.43,347.74,347.81,345.40460350503827,NaN,NaN,NaN,NaN,NaN,344.1000000000002,350.1703489191775,338.0296510808229,346.65304553347784,342.73364064801797,346.28554012814527,339.18174116789066,51857,75144.33333333333,62.74791621607069,67.06529679563003,NaN,NaN,NaN,NaN,0.8488524702417448,38.189177354223865,91364683
2025-08-25T14:00:00-04:00,347.8,348.18,347.25,347.5,345.40460350503827,NaN,NaN,NaN,NaN,NaN,344.2972000000002,350.1521002246408,338.44229977535963,346.65304553347784,342.7808309537161,346.3479295312965,339.2137323761357,47615,73254.86666666667,59.56670317411826,66.35477276264922,NaN,NaN,NaN,NaN,0.8546487223673349,37.09413133176382,91317068
2025-08-25T14:05:00-04:00,347.49,347.52,347.14,347.37,345.40460350503827,NaN,NaN,NaN,NaN,NaN,344.46120000000025,350.1904744951123,338.7319255048882,346.65304553347784,342.82331596619844,346.4007089267096,339.24592300568725,46563,68682.4,58.23339092831479,65.47532980516898,NaN,NaN,NaN,NaN,0.8207452421982392,35.88220048588592,91270505
2025-08-25T14:10:00-04:00,347.38,348.03,347.3,347.81,345.40460350503827,NaN,NaN,NaN,NaN,NaN,344.62560000000025,350.25723799976606,338.99396200023443,346.65304553347784,342.8642560244506,346.454397670562,339.27411437833916,42218,66527.43333333333,61.3839669878169,65.18393547082694,NaN,NaN,NaN,NaN,0.8142634391840764,35.326872282290395,91312723
2025-08-25T14:15:00-04:00,347.84,347.84,346.42,346.64,345.40460350503827,NaN,NaN,NaN,NaN,NaN,344.7396000000003,350.2984933575268,339.18070664247375,346.608479968328,342.9133031903599,346.50966589343466,339.31694048728514,61018,65966.96666666666,50.479722536567515,63.77356488631825,NaN,NaN,NaN,NaN,0.8575303363852109,33.37831879026819,91251705
2025-08-25T14:20:00-04:00,346.59,347,346.08,346.61,345.40460350503827,NaN,NaN,NaN,NaN,NaN,344.84300000000025,350.34458268140526,339.34141731859523,346.608479968328,342.96134938552757,346.5581028348357,339.3645959362194,68077,64919.46666666667,50.23331581538918,62.5843653003016,NaN,NaN,NaN,NaN,0.8619924552148398,31.096863161330994,91183628
2025-08-25T14:25:00-04:00,346.6,346.99,346.51,346.82,345.40460350503827,NaN,NaN,NaN,NaN,NaN,344.9718000000003,350.3495566921723,339.5940433078283,346.608479968328,342.9856489904224,346.58373315309404,339.3875648277508,33179,63609.13333333333,51.99961016085958,61.244230663291205,NaN,NaN,NaN,NaN,0.8347072798423526,28.978368648746454,91216807
2025-08-25T14:30:00-04:00,346.9,347.18,346.76,347.07,345.40460350503827,NaN,NaN,NaN,NaN,NaN,345.0952000000003,350.3758427487713,339.81455725122936,346.608479968328,343.01283532679065,346.6138204641233,339.411850189458,35460,62455.7,54.08866431286042,59.8703038582778,NaN,NaN,NaN,NaN,0.8050853312821857,27.279652761836388,91252267
2025-08-25T14:35:00-04:00,347.06,347.08,346.57,346.62,345.40460350503827,NaN,NaN,NaN,NaN,NaN,345.2126000000003,350.36095866662936,340.0642413333712,346.608479968328,343.0405164423115,346.6424721789868,339.43856070563623,39035,61682.46666666667,49.88049793684879,58.39451013693211,NaN,NaN,NaN,NaN,0.7840078076191718,25.40587717799962,91213232
2025-08-25T14:40:00-04:00,346.65,346.89,346.42,346.46,345.40460350503827,NaN,NaN,NaN,NaN,NaN,345.3266000000003,350.32580411266906,340.3273958873316,346.608479968328,343.06907040696933,346.6704938857231,339.4676469282156,42815,60192.8,48.437516755247565,57.360007310635886,NaN,NaN,NaN,NaN,0.7615786785035146,23.750603044470015,91170417
2025-08-25T14:45:00-04:00,346.43,347.08,346.28,347.06,345.40460350503827,NaN,NaN,NaN,NaN,NaN,345.45920000000035,350.2803979258293,340.6380020741714,346.2827817437839,343.11313194512263,346.71592128390785,339.5103426063374,63491,60460.53333333333,53.831299937855576,56.70337021472271,NaN,NaN,NaN,NaN,0.7643230586104072,22.204222978287277,91233908
2025-08-25T14:50:00-04:00,347.07,347.61,346.87,347.45,345.40460350503827,NaN,NaN,NaN,NaN,NaN,345.5976000000003,350.23878874429346,340.9564112557071,346.2827817437839,343.14272677220043,346.74992648189584,339.535527062505,38248,59156.8,56.98132987077832,56.331911148478206,NaN,NaN,NaN,NaN,0.762585697281093,21.558135852593946,91272156
2025-08-25T14:55:00-04:00,347.46,347.6,347.19,347.22,345.40460350503827,NaN,NaN,NaN,NaN,NaN,345.7252000000003,350.183372253303,341.26702774669764,346.2827817437839,343.1839546723268,346.79715075073784,339.5707585939158,53849,59121.5,54.61473051757265,55.59137020913032,NaN,NaN,NaN,NaN,0.7374010046181596,20.958197807307283,91218307
2025-08-25T15:00:00-04:00,347.25,347.93,347.17,347.75,345.40460350503827,NaN,NaN,NaN,NaN,NaN,345.8692000000003,350.10921479243376,341.6291852075669,346.29912779978446,343.21483514011305,346.8342505107162,339.59541976950993,38429,58442.7,58.85542918744147,55.09529245269585,NaN,NaN,NaN,NaN,0.7390152185740047,20.868891554148586,91256736
2025-08-25T15:05:00-04:00,347.76,349.2,347.66,349.18,345.90062156619655,NaN,NaN,NaN,NaN,NaN,346.0364000000003,350.1233622166311,341.9494377833695,347.12530223982753,343.3512499286343,347.0254978123655,339.6770020449031,141215,61030.5,67.64087996380621,55.44478986324839,NaN,NaN,NaN,NaN,0.7962284172472874,22.151640079700037,91397951
2025-08-25T15:10:00-04:00,349.18,349.45,348.94,349.27,346.71104785864213,NaN,NaN,NaN,NaN,NaN,346.21840000000026,350.0464655376179,342.3903344623826,347.53524179186206,343.45446142323897,347.17706081617337,339.73186203030457,101277,62690.2,68.10251536462604,56.05449073399894,NaN,NaN,NaN,NaN,0.775783530301052,23.552737435394437,91499228
2025-08-25T15:15:00-04:00,349.29,349.54,348.7,349.03,346.71104785864213,NaN,NaN,NaN,NaN,NaN,346.3948000000003,349.8982205913786,342.891379408622,347.58819343348966,343.5412089782112,347.29963667081614,339.7827812856063,90030,63685.36666666667,65.42222924844893,56.56797918543709,NaN,NaN,NaN,NaN,0.7803704209938361,24.374485048593915,91409198
2025-08-25T15:20:00-04:00,349.03,349.4,348.93,348.93,346.72829980508504,NaN,NaN,NaN,NaN,NaN,346.5540000000003,349.7684175211228,343.33958247887784,347.6035547467917,343.59056205958166,347.368301170281,339.81282294888234,52520,63484.53333333333,64.28692028531268,56.77533299240107,NaN,NaN,NaN,NaN,0.75820110520856,25.137536403707717,91356678
2025-08-25T15:25:00-04:00,348.95,349.14,348.42,348.505,346.72829980508504,NaN,NaN,NaN,NaN,NaN,346.6959000000003,349.6009973753417,343.79080262465885,347.6035547467917,343.6443954984721,347.438092576159,339.85069842078514,62984,62700.63333333333,59.55658294069325,57.423680164124335,NaN,NaN,NaN,NaN,0.7554724548365179,24.838369349219988,91293694
2025-08-25T15:30:00-04:00,348.49,348.7,348.03,348.15,346.72829980508504,NaN,NaN,NaN,NaN,NaN,346.7939000000003,349.554405236408,344.0333947635926,347.6035547467917,343.6800508115151,347.48087232414366,339.87922929888657,46097,62512.2,55.859248888681776,57.825532526502386,NaN,NaN,NaN,NaN,0.7493672794910535,23.876247079111288,91247597
2025-08-25T15:35:00-04:00,348.17,348.43,347.76,347.84,346.72829980508504,NaN,NaN,NaN,NaN,NaN,346.88290000000023,349.4808469510196,344.28495304898087,347.6035547467917,343.7220408826586,347.52811525515114,339.915966510166,58857,61704.566666666666,52.77797927670549,57.88113032049138,NaN,NaN,NaN,NaN,0.7436981880988365,22.539252989271716,91188740
2025-08-25T15:40:00-04:00,347.85,348.6,347.77,348.27,346.72829980508504,NaN,NaN,NaN,NaN,NaN,346.9657000000002,349.46960735461533,344.46179264538506,347.6035547467917,343.7821670007536,347.5977535016363,339.9665804998709,82353,62771.13333333333,56.37284709585268,58.044286233562254,NaN,NaN,NaN,NaN,0.7498626032346368,21.544574953336035,91271093
2025-08-25T15:45:00-04:00,348.29,348.44,348.05,348.3,346.72829980508504,NaN,NaN,NaN,NaN,NaN,347.0307000000002,349.5008190336642,344.5605809663362,347.6035547467917,343.8312509496676,347.6544403737462,340.008061525589,68127,61130.066666666666,56.62096365022996,58.52574807023233,NaN,NaN,NaN,NaN,0.7241581315750188,20.62094534853862,91339220
2025-08-25T15:50:00-04:00,348.31,348.54,347.31,348.21,346.72829980508504,NaN,NaN,NaN,NaN,NaN,347.1069000000002,349.4808999074142,344.73290009258625,347.6035547467917,343.91865894607315,347.74883574388195,340.08848214826435,132555,61865.46666666667,55.59937810005621,59.037309594861526,NaN,NaN,NaN,NaN,0.7602896936053759,19.738025393107243,91206665
2025-08-25T15:55:00-04:00,348.18,348.18,346.5,346.68,NaN,NaN,NaN,349.8621601603522,349.8621601603522,349.8621601603522,347.1425000000002,349.43504291137606,344.84995708862436,347.6035547467917,343.98887310290826,347.80572324076553,340.172022965051,142447,64515.933333333334,41.79407831556279,58.17750805041204,NaN,NaN,NaN,NaN,0.8281261440621333,19.93246435076953,91064218
2025-08-26T09:30:00-04:00,344.93,348.66,344.29,347.93,NaN,NaN,NaN,349.47842560760887,NaN,NaN,347.18510000000026,349.4553250902345,344.914874909766,347.6035547467917,346.96000000000004,346.96000000000004,346.96000000000004,270453,71054.93333333333,52.230071066324925,57.83813242152251,NaN,NaN,NaN,NaN,1.0811171337719812,21.844493442903094,91334671
2025-08-26T09:35:00-04:00,347.92,348.09,344.59,346.02,NaN,NaN,NaN,349.47842560760887,NaN,NaN,347.20390000000026,349.4189822017084,344.98881779829213,347.6035547467917,346.6440045609431,347.0042409206674,346.2837682012187,208103,76181.83333333333,40.3309879871658,56.81786509792202,NaN,NaN,NaN,NaN,1.2538944813596966,23.619949028455693,91126568
2025-08-26T09:40:00-04:00,345.99,347.67,345.05,347.37,NaN,NaN,NaN,349.47842560760887,NaN,NaN,347.25690000000026,349.3554660724317,345.15833392756883,347.3428437974334,346.6577298053654,346.9683466659982,346.34711294473266,168691,80186.86666666667,49.149117256441116,56.12455710285057,NaN,NaN,NaN,NaN,1.3514734469768614,25.268586357897387,91295259
2025-08-26T09:45:00-04:00,347.42,348.26,346.17,347.58,NaN,NaN,NaN,349.47842560760887,NaN,NaN,347.30990000000025,349.3018683632901,345.3179316367104,346.9272750379467,346.8160403525815,347.21152254549474,346.4205581596683,196813,84686.36666666667,50.377618021345604,54.89146696410337,NaN,NaN,NaN,NaN,1.4042253436213696,25.810283870490657,91492072
2025-08-26T09:50:00-04:00,347.61,349.13,346.82,348.5,NaN,NaN,NaN,349.47842560760887,NaN,NaN,347.3651000000002,349.3328118591113,345.3973881408891,346.7909648194287,347.081185107205,347.720488419351,346.441881795059,209389,89792.16666666667,55.45488746269947,53.988064971108614,NaN,NaN,NaN,NaN,1.4689235333627004,25.076199549001903,91701461
2025-08-26T09:55:00-04:00,348.45,348.67,347.16,347.51,NaN,NaN,NaN,349.47842560760887,NaN,NaN,347.4029000000003,349.30663957261356,345.499160427387,346.7909648194287,347.147716441767,347.78948267033894,346.50595021319504,110848,91758.53333333334,49.5764720570486,52.856225171722876,NaN,NaN,NaN,NaN,1.4718575666939355,24.394549821905205,91590613
2025-08-26T10:00:00-04:00,347.505,348.47,346.4,346.54,NaN,NaN,NaN,349.47842560760887,NaN,NaN,347.40770000000026,349.3014763438166,345.5139236561839,346.7909648194287,347.1467236618458,347.7589895233413,346.53445780035025,114934,94002.5,44.589114394673025,51.44923903667719,NaN,NaN,NaN,NaN,1.5145820262158007,24.465482063551086,91475679
2025-08-26T10:05:00-04:00,346.58,346.64,345.49,346.17,NaN,NaN,NaN,349.47842560760887,NaN,NaN,347.4149000000003,349.28693684803306,345.5428631519675,346.60577185554297,347.0557236702797,347.7108953675664,346.40055197299296,121803,96510.5,42.81960753164006,50.25374079317339,NaN,NaN,NaN,NaN,1.4885404529146704,25.2282627196987,91353876
2025-08-26T10:10:00-04:00,346.15,346.99,345.68,346.15,NaN,NaN,NaN,349.47842560760887,NaN,NaN,347.4289000000003,349.2517738739661,345.60602612603446,345.77761748443436,347.00601153626263,347.66812854105274,346.34389453147253,95060,98271.9,42.72091667412259,49.315288492133455,NaN,NaN,NaN,NaN,1.4757875634207653,25.44057216464154,91258816
2025-08-26T10:15:00-04:00,346.13,347.18,345.85,347.18,NaN,NaN,NaN,349.47842560760887,NaN,NaN,347.46590000000026,349.1892452238225,345.742554776178,344.5530939875475,346.99017296324513,347.6356452455973,346.34470068089297,93473,99353.73333333334,49.212928783835764,49.060642028357044,NaN,NaN,NaN,NaN,1.4653741660335666,25.37067490925932,91352289
2025-08-26T10:20:00-04:00,347.19,347.47,346.33,346.61,NaN,NaN,NaN,349.47842560760887,NaN,NaN,347.4807000000003,349.1611451911104,345.8002548088902,343.72241129729946,346.98050109245673,347.61040637589974,346.3505958090137,86777,99977.06666666667,46.09907787462096,48.32680136969764,NaN,NaN,NaN,NaN,1.4421331541740294,24.899120149640723,91265512
2025-08-26T10:25:00-04:00,346.615,346.63,345.7,346.109,NaN,NaN,NaN,349.47842560760887,NaN,NaN,347.48408000000035,349.1527545322497,345.815405467751,343.72241129729946,346.94150127054564,347.58122105190733,346.30178148918395,82218,101611.7,43.49414263487273,47.389171297172126,NaN,NaN,NaN,NaN,1.4055522145901709,25.0221417087094,91183294
2025-08-26T10:30:00-04:00,346.04,346.42,345.58,345.99,NaN,NaN,NaN,349.47842560760887,NaN,NaN,347.4704800000003,349.1761466610806,345.76481333891996,343.72241129729946,346.90723936514473,347.55961909135567,346.2548596389338,66169,102635.33333333333,42.87442068795132,46.48024576773606,NaN,NaN,NaN,NaN,1.3651556278337325,25.23828804945997,91117125
2025-08-26T10:35:00-04:00,346.06,346.3,345.54,345.86,NaN,NaN,NaN,349.47842560760887,NaN,NaN,347.4496800000003,349.20724196784806,345.6921180321525,343.72241129729946,346.87108826884474,347.5384936288676,346.20368290882186,67930,103598.5,42.16757309577709,46.5069239663228,NaN,NaN,NaN,NaN,1.3219302258456083,25.4746191905041,91049195
2025-08-26T10:40:00-04:00,345.83,346.6,345.23,346.54,NaN,NaN,NaN,349.47842560760887,NaN,NaN,347.4522800000003,349.204057293688,345.70050270631265,343.5889290378396,346.8387717266224,347.50907000219553,346.16847345104924,85492,105021.06666666667,47.082085980877146,46.13921074593367,NaN,NaN,NaN,NaN,1.3253637811423509,25.973183463460455,91134687
2025-08-26T10:45:00-04:00,346.48,346.6,345.58,345.68,NaN,NaN,NaN,349.47842560760887,NaN,NaN,347.41748000000035,349.23821454368476,345.59674545631594,343.61386900324163,346.8087300776606,347.4867811176562,346.13067903766495,69473,105220.46666666666,42.19808215288234,46.27257461491342,NaN,NaN,NaN,NaN,1.3035520824893285,26.436136002634214,91065214
2025-08-26T10:50:00-04:00,345.67,346.17,345.15,346.01,NaN,NaN,NaN,349.3498824212151,NaN,NaN,347.3960800000004,349.25688923645885,345.5352707635419,343.61386900324163,346.7742666419305,347.46620703766587,346.0823262461952,70738,106303.46666666666,44.574013582542975,45.94578149534926,NaN,NaN,NaN,NaN,1.283298362311522,27.25615436602176,91135952
2025-08-26T10:55:00-04:00,346.01,346.26,345.52,345.62,NaN,NaN,NaN,349.3498824212151,NaN,NaN,347.3492800000003,349.2678123574662,345.4307476425344,343.61386900324163,346.74336882831307,347.4453271655922,346.04141049103396,69382,106821.23333333334,42.358048329561285,45.37295508879323,NaN,NaN,NaN,NaN,1.2444913364321282,27.841261317013682,91066570
2025-08-26T11:00:00-04:00,345.59,346.46,345.47,346.32,NaN,NaN,NaN,349.3498824212151,NaN,NaN,347.30308000000036,349.2072235173074,345.39893648269333,343.8137009296597,346.7259151836525,347.4265798607305,346.0252505065745,59423,107521.03333333334,47.41152110843492,44.79842892063148,NaN,NaN,NaN,NaN,1.22631338382983,27.987147001177547,91125993
2025-08-26T11:05:00-04:00,346.3,346.47,346.01,346.09,NaN,NaN,NaN,349.3498824212151,NaN,NaN,347.2578800000003,349.1677575098875,345.34800249011306,344.1229607437278,346.7155474524692,347.41331693476354,346.01777797017485,44331,104291.56666666667,45.98498814363169,44.54189435538741,NaN,NaN,NaN,NaN,1.1715767135562731,28.102136684315,91081662
2025-08-26T11:10:00-04:00,346.09,346.47,345.74,346.07,NaN,NaN,NaN,349.3498824212151,NaN,NaN,347.22888000000034,349.1657992710474,345.2919607289533,344.22736859498224,346.7042031088955,347.400576014471,346.00783020332,42555,102334.16666666667,45.855783274047276,44.63237070391415,NaN,NaN,NaN,NaN,1.1400355197308263,28.512168538103488,91039107
2025-08-26T11:15:00-04:00,346.03,346.47,345.63,346.42,NaN,NaN,NaN,349.3498824212151,NaN,NaN,347.2064800000004,349.1543630864349,345.2585969135659,344.25589487598575,346.69306520994445,347.38628218493074,345.99984823495816,50019,101000.46666666666,48.578665628672155,45.043731996559295,NaN,NaN,NaN,NaN,1.1186044111786266,29.01471842160433,91089126
2025-08-26T11:20:00-04:00,346.42,347.53,346.3,347.36,NaN,NaN,NaN,349.3498824212151,NaN,NaN,347.2046800000004,349.15182582671054,345.25753417329025,345.1437159007886,346.7068243257669,347.3906355974843,346.0230130540495,92011,102316.83333333333,55.1082800909129,45.92854366918717,NaN,NaN,NaN,NaN,1.1265612389515791,27.438061175981165,91181137
2025-08-26T11:25:00-04:00,347.37,347.78,346.96,347.07,NaN,NaN,NaN,349.3498824212151,NaN,NaN,347.18708000000044,349.1228353498289,345.25132465017197,345.4609727206309,346.7252401410532,347.4051957474702,346.04528453463615,83705,103007.53333333334,52.8774350458645,46.19029411647494,NaN,NaN,NaN,NaN,1.1046640075978944,25.585398036077844,91097432
2025-08-26T11:30:00-04:00,347.02,347.1,343.72,343.87,NaN,NaN,NaN,349.0806605999896,NaN,NaN,347.1024800000004,349.23135009432247,344.97360990567836,345.4609727206309,346.63383002800407,347.40714861531995,345.8605114406882,134697,105960.86666666667,35.702693949150344,45.447695264655614,NaN,NaN,NaN,NaN,1.2671880070551873,26.78647536101572,90962735
2025-08-26T11:35:00-04:00,343.83,345.15,343.81,344.835,NaN,NaN,NaN,348.16653966362645,NaN,NaN,347.04298000000045,349.25413294774916,344.83182705225175,345.4609727206309,346.5642115566774,347.4094508226301,345.71897229072465,95421,107179.66666666667,41.83780751469123,45.32938561321407,NaN,NaN,NaN,NaN,1.2723888636941008,27.901761448458036,91058156
2025-08-26T11:40:00-04:00,344.84,345.43,344.72,345.31,NaN,NaN,NaN,348.16653966362645,NaN,NaN,346.9991800000004,349.2586205923724,344.73973940762846,345.4609727206309,346.5293368550665,347.39233022228314,345.6663434878499,70710,106791.56666666667,44.63802880857495,45.45535762183004,NaN,NaN,NaN,NaN,1.2322182305730922,28.530992250085973,91128866
2025-08-26T11:45:00-04:00,345.33,345.47,344.7,344.79,NaN,NaN,NaN,348.16653966362645,NaN,NaN,346.94758000000047,349.2872079734885,344.60795202651246,345.4609727206309,346.5032185666737,347.3817162163698,345.6247209169776,49266,106162.86666666667,42.24044139746737,45.4605625005222,NaN,NaN,NaN,NaN,1.1992026426750169,29.055620855340354,91079600
2025-08-26T11:50:00-04:00,344.78,345.6,344.78,345.36,NaN,NaN,NaN,348.16653966362645,NaN,NaN,346.89858000000044,349.26636090508777,344.5307990949131,345.4609727206309,346.47944407848235,347.3662725769401,345.5926155800246,56118,103614.96666666666,45.68434254874341,45.360723683941224,NaN,NaN,NaN,NaN,1.172116739626805,29.33959607106948,91135718
2025-08-26T11:55:00-04:00,345.33,345.52,344.91,345.02,NaN,NaN,NaN,348.16653966362645,NaN,NaN,346.86618000000044,349.29087860197086,344.44148139803,345.4609727206309,346.45622447869295,347.35235989238146,345.56008906500443,52724,100624.2,43.999111457883146,45.48936863429843,NaN,NaN,NaN,NaN,1.1319655439391731,29.603287342817953,91082994
2025-08-26T12:00:00-04:00,345.04,345.23,344.36,344.51,NaN,NaN,NaN,348.16653966362645,NaN,NaN,346.8241800000004,349.3363471501901,344.31201284981074,345.4609727206309,346.4179370135835,347.3406106524704,345.49526337469666,67278,93851.7,41.52468595770925,45.271559518238874,NaN,NaN,NaN,NaN,1.1132537193720897,30.293732194975814,91015716
2025-08-26T12:05:00-04:00,344.5,344.76,344.33,344.6,NaN,NaN,NaN,347.842501429635,NaN,NaN,346.7797800000004,349.36799465231627,344.19156534768456,345.4609727206309,346.3940792103564,347.33431996117423,345.45383845953853,40216,88255.46666666666,42.14304831111901,45.25620237406442,NaN,NaN,NaN,NaN,1.0644498822740838,30.958466633085912,91055932
2025-08-26T12:10:00-04:00,344.61,345.09,344.32,345.03,NaN,NaN,NaN,347.842501429635,NaN,NaN,346.7389800000004,349.37154466558735,344.1064153344135,345.4609727206309,346.367680535692,347.3217882727129,345.41357279867105,53095,84402.26666666666,45.128616654811246,45.09313777023416,NaN,NaN,NaN,NaN,1.0434177478259337,30.97181887997641,91109027
2025-08-26T12:15:00-04:00,345.01,345.25,344.37,345.11,NaN,NaN,NaN,347.842501429635,NaN,NaN,346.7087800000004,349.38046525964256,344.0370947403582,343.5547781765047,346.3381456896345,347.30461199734754,345.3716793819214,65750,80033.5,45.69012534785098,45.072076141964104,NaN,NaN,NaN,NaN,1.0317450515526523,30.697071054109532,91174777
2025-08-26T12:20:00-04:00,345.11,345.4,345.03,345.19,NaN,NaN,NaN,347.842501429635,NaN,NaN,346.68338000000045,349.387988212389,343.9787717876119,343.5100319187155,346.32282860859056,347.2915953140527,345.3540619031284,44532,74538.26666666666,46.28211506485918,45.10252841273638,NaN,NaN,NaN,NaN,0.9844775478703204,30.169363332437854,91219309
2025-08-26T12:25:00-04:00,345.19,346.35,345.19,346.28,NaN,NaN,NaN,347.842501429635,NaN,NaN,346.66778000000045,349.3725169495873,343.9630430504136,344.25802553497243,346.3137025601811,347.27263255762546,345.3547725627368,80334,73521.13333333333,53.68907524850473,45.46755767129586,NaN,NaN,NaN,NaN,0.997014865879585,28.18247092275285,91299643
2025-08-26T12:30:00-04:00,346.3,346.93,346.01,346.61,NaN,NaN,NaN,347.842501429635,NaN,NaN,346.6509800000004,349.3464930566507,343.95546694335013,344.7964204279779,346.3171026790305,347.2683233388752,345.3658820191858,57416,71603.86666666667,55.68148399908691,45.508500807594,NaN,NaN,NaN,NaN,0.9915138040310444,26.736188448454506,91357059
2025-08-26T12:35:00-04:00,346.62,346.66,345.95,346.59,NaN,NaN,NaN,347.842501429635,NaN,NaN,346.6383800000004,349.3290212586329,343.94773874136786,344.7964204279779,346.31835918194986,347.2623976608104,345.3743207030893,52749,69302.06666666667,55.52556869655765,45.697653211214934,NaN,NaN,NaN,NaN,0.9714056751716866,25.307841062633468,91304310
2025-08-26T12:40:00-04:00,346.59,346.8,346.2,346.35,NaN,NaN,NaN,347.842501429635,NaN,NaN,346.6103800000004,349.2832457846056,343.93751421539525,344.85050907390587,346.31982665885846,347.25869025587883,345.3809630618381,39232,67441.13333333333,53.5864738598498,46.97506606197919,NaN,NaN,NaN,NaN,0.9448766983737107,24.161857536944034,91265078
2025-08-26T12:45:00-04:00,346.34,346.62,345.87,346.02,NaN,NaN,NaN,347.842501429635,NaN,NaN,346.54718000000037,349.1216474537879,343.97271254621285,344.85050907390587,346.3184337303284,347.2530334794063,345.3838339812505,33026,65426.23333333333,50.95164953155655,47.62605477746957,NaN,NaN,NaN,NaN,0.93095693420416,22.595878950899834,91232052
2025-08-26T12:50:00-04:00,346.04,346.4,345.72,346.13,NaN,NaN,NaN,347.842501429635,NaN,NaN,346.4843800000004,348.9405824636826,344.0281775363182,344.85050907390587,346.31616937638756,347.2465408511796,345.38579790159554,34547,63685.23333333333,51.802367525641834,48.137793257260064,NaN,NaN,NaN,NaN,0.9130314389038593,21.044869444393054,91266599
2025-08-26T12:55:00-04:00,346.04,346.54,345.8,346.47,NaN,NaN,NaN,347.842501429635,NaN,NaN,346.43318000000033,348.7792505084796,344.08710949152106,344.85050907390587,346.31572968613256,347.24167126238325,345.38978810988186,34488,62094.23333333333,54.43312820921109,49.00869945809891,NaN,NaN,NaN,NaN,0.9006720504107272,19.693126399555048,91301087
2025-08-26T13:00:00-04:00,346.45,346.89,346.23,346.62,NaN,NaN,NaN,347.842501429635,NaN,NaN,346.38698000000034,348.62295236091654,344.1510076390841,345.05588851667187,346.3195961351152,347.23928672682,345.3999055434104,53770,61680.933333333334,55.58494360777577,49.715885248029785,NaN,NaN,NaN,NaN,0.8834811896671015,18.956550704761334,91354857
2025-08-26T13:05:00-04:00,346.66,346.74,346.28,346.32,NaN,NaN,NaN,347.842501429635,NaN,NaN,346.3432800000004,348.4958161429368,344.190743857064,345.05588851667187,346.32077582683274,347.236268487032,345.40528316663347,34439,60564.566666666666,52.71494239202999,50.33844460046885,NaN,NaN,NaN,NaN,0.8532325332623112,18.272587559595742,91320418
2025-08-26T13:10:00-04:00,346.32,346.7,345.97,346.65,NaN,NaN,NaN,347.842501429635,NaN,NaN,346.31328000000036,348.4052166736771,344.2213433263236,345.05588851667187,346.32218000587324,347.2323564161696,345.4120035955769,44211,59188.53333333333,55.440424436923934,51.33242592041275,NaN,NaN,NaN,NaN,0.8444302094578576,17.08430007951383,91364629
2025-08-26T13:15:00-04:00,346.6,346.73,346.04,346.44,NaN,NaN,NaN,347.842501429635,NaN,NaN,346.28528000000034,348.33171049398976,344.2388495060109,345.05588851667187,346.32309315309504,347.2281748471344,345.41801145905566,42719,58296.73333333333,53.33368403151711,52.13175704329833,NaN,NaN,NaN,NaN,0.8333994802108676,16.032354860936866,91321910
2025-08-26T13:20:00-04:00,346.47,346.97,346.45,346.93,NaN,NaN,NaN,347.842501429635,NaN,NaN,346.25848000000036,348.23411378152224,344.2828462184785,345.32638793642883,346.3275609262556,347.22936858584353,345.4257532666677,37216,57179.333333333336,57.4013200840984,53.00837871681885,NaN,NaN,NaN,NaN,0.8117280887672363,15.469560926342323,91359126
2025-08-26T13:25:00-04:00,346.94,347.28,346.54,347.11,NaN,NaN,NaN,347.842501429635,NaN,NaN,346.2346800000003,348.13874031176977,344.33061968823085,345.595110349143,346.33662725419344,347.2353489936489,345.43790551473796,54306,56676.8,58.821268739454545,53.946317530504814,NaN,NaN,NaN,NaN,0.8066046538552875,15.447363262150112,91413432
2025-08-26T13:30:00-04:00,347.12,347.19,346.11,346.31,NaN,NaN,NaN,347.842501429635,NaN,NaN,346.19668000000024,348.01546321717535,344.37789678282513,345.595110349143,346.3386288468187,347.23306459585615,345.4441930977813,39297,56005.933333333334,50.72796072639889,54.263877934900506,NaN,NaN,NaN,NaN,0.8261328928656229,14.58539866642754,91374135
2025-08-26T13:35:00-04:00,346.22,346.47,345.79,345.96,NaN,NaN,NaN,347.842501429635,NaN,NaN,346.18228000000033,347.9969250029621,344.3676349970386,345.595110349143,346.3354595160249,347.2250036449738,345.445915387076,47485,56111.066666666666,47.63963668195595,53.83177518014703,NaN,NaN,NaN,NaN,0.8156948290895075,13.86162240593915,91326650
2025-08-26T13:40:00-04:00,345.95,346.24,345.79,345.92,NaN,NaN,NaN,347.842501429635,NaN,NaN,346.1420800000003,347.8878215544213,344.3963384455793,345.595110349143,346.3330211869207,347.2199609041285,345.44608146971285,27716,55616.433333333334,47.2853306716906,53.23204994247586,NaN,NaN,NaN,NaN,0.7895737698688275,13.18954444977136,91298934
2025-08-26T13:45:00-04:00,345.91,346.13,345.69,346.01,NaN,NaN,NaN,347.842501429635,NaN,NaN,346.1418800000003,347.8876797430722,344.39608025692837,345.595110349143,346.329341686587,347.2128882785351,345.44579509463887,38153,55220.9,48.218481956802606,52.7101151753505,NaN,NaN,NaN,NaN,0.7646042148781967,12.747863560306458,91337087
2025-08-26T13:50:00-04:00,346,346.14,345.08,345.14,NaN,NaN,NaN,347.842501429635,NaN,NaN,346.0972800000003,347.8291861426447,344.3653738573559,345.595110349143,346.31954999151253,347.2029584154046,345.43614156762044,45676,53676.4,40.715385208635645,51.79075170026378,NaN,NaN,NaN,NaN,0.7857039138154686,13.32972666056586,91291411
2025-08-26T13:55:00-04:00,345.1,345.8,345.08,345.76,NaN,NaN,NaN,347.842501429635,NaN,NaN,346.06088000000034,347.74237427083165,344.37938572916903,345.595110349143,346.3139543404101,347.1965945673977,345.43131411342245,29801,51879.6,47.03997437437339,51.511346331893556,NaN,NaN,NaN,NaN,0.7810107771143656,13.870028110806738,91321212
2025-08-26T14:00:00-04:00,345.74,346.09,345.57,345.93,NaN,NaN,NaN,347.842501429635,NaN,NaN,346.0094800000003,347.53993124030245,344.4790287596981,345.595110349143,346.31011399468656,347.1899606864108,345.4302673029623,35381,48569.066666666666,48.65734862587452,51.28670212476732,NaN,NaN,NaN,NaN,0.762367150177624,13.714786440031885,91356593
2025-08-26T14:05:00-04:00,345.96,346.38,345.85,346.33,NaN,NaN,NaN,347.842501429635,NaN,NaN,345.98588000000024,347.45834289701327,344.5134171029872,345.595110349143,346.3090258197883,347.1850620489245,345.4329895906521,36921,46619.066666666666,52.345131688947134,51.137559516177035,NaN,NaN,NaN,NaN,0.7457694965935061,12.966471060317849,91393514
2025-08-26T14:10:00-04:00,346.33,346.89,346.33,346.74,NaN,NaN,NaN,347.842501429635,NaN,NaN,345.98988000000026,347.46941196079104,344.5103480392095,345.595110349143,346.3125912429479,347.1847765809218,345.44040590497406,43827,45722.96666666667,55.845924570032565,51.1562010134811,NaN,NaN,NaN,NaN,0.7325002468368272,12.733908781571252,91437341
2025-08-26T14:15:00-04:00,346.73,346.96,346.6,346.93,NaN,NaN,NaN,347.842501429635,NaN,NaN,346.00508000000025,347.50714566268573,344.50301433731477,345.516862243785,346.31681549271633,347.1866801292734,345.4469508561593,34838,45242.03333333333,57.40744358926325,51.491379670426326,NaN,NaN,NaN,NaN,0.7058930863484794,12.635349780188152,91472179
2025-08-26T14:20:00-04:00,346.95,347.04,346.36,346.97,NaN,NaN,NaN,347.842501429635,NaN,NaN,346.0214800000002,347.5472358517431,344.49572414825735,345.54548979502806,346.32274397845157,347.18874306962834,345.4567448872748,54141,45176.13333333333,57.74623544740176,51.65608045688903,NaN,NaN,NaN,NaN,0.7040435801807313,12.042925923569973,91526320
2025-08-26T14:25:00-04:00,347,347.07,346.79,346.92,NaN,NaN,NaN,347.842501429635,NaN,NaN,346.01628000000017,347.5279136617441,344.50464633825624,345.73439183602244,346.3275918517933,347.1917900638317,345.4633936397548,34969,44584.3,57.134459947517776,51.92756445088908,NaN,NaN,NaN,NaN,0.6737547530249629,11.550256337610797,91491351
2025-08-26T14:30:00-04:00,346.94,347.53,346.91,347.5,NaN,NaN,NaN,347.842501429635,NaN,NaN,346.03408000000024,347.5934653580989,344.4746946419016,346.15151346881794,346.34367179873385,347.2098402709658,345.4775033265019,72240,44749.7,62.144488435376196,52.26636219026607,NaN,NaN,NaN,NaN,0.6699151278088904,11.918633649415558,91563591
2025-08-26T14:35:00-04:00,347.48,347.7,347.36,347.62,NaN,NaN,NaN,347.842501429635,NaN,NaN,346.06430000000023,347.68565500143893,344.44294499856153,346.4272107750544,346.35628304824644,347.22671363505737,345.4858524614355,46397,44955.73333333333,63.105290497988975,52.572363744447095,NaN,NaN,NaN,NaN,0.6463497615368251,12.535965669186286,91609988
2025-08-26T14:40:00-04:00,347.61,348.08,347.58,347.88,345.65060936294685,345.65060936294685,345.65060936294685,NaN,NaN,NaN,346.10210000000023,347.8010338894333,344.40316611056716,346.8117686200435,346.3834626774302,347.26867550418723,345.4982498506732,83123,45956.666666666664,65.16809835962741,53.60380214682056,NaN,NaN,NaN,NaN,0.6358962071413377,13.6778448036179,91693111
2025-08-26T14:45:00-04:00,347.89,347.97,347.63,347.745,345.6733089373584,NaN,NaN,NaN,NaN,NaN,346.13980000000015,347.8981889902041,344.3814110097962,346.8117686200435,346.3940016510504,347.2841251870141,345.5038781150867,34617,44918.9,63.192470591896296,54.71471885467344,NaN,NaN,NaN,NaN,0.6147607637741015,14.73816114273297,91658494
2025-08-26T14:50:00-04:00,347.73,348.25,347.7,348.22,345.869976712933,NaN,NaN,NaN,NaN,NaN,346.1734000000002,348.0229355527338,344.32386444726654,347.02733191682785,346.4140854517001,347.3172678955299,345.5109030078703,56154,45306.3,66.98497605033472,56.121836381719454,NaN,NaN,NaN,NaN,0.6101349949330951,16.125490494733473,91714648
2025-08-26T14:55:00-04:00,348.22,348.66,347.94,348.28,346.1924777714361,NaN,NaN,NaN,NaN,NaN,346.2254000000002,348.1607323644166,344.2900676355838,347.3218655334623,346.4431610398372,347.36885663051027,345.51746544916415,73056,45063.7,67.44132659402491,57.49489671294962,NaN,NaN,NaN,NaN,0.6179824952950188,17.934009529168655,91787704
2025-08-26T15:00:00-04:00,348.27,348.48,347.73,348.15,346.1924777714361,NaN,NaN,NaN,NaN,NaN,346.2682000000002,348.27588499539803,344.2605150046024,347.3218655334623,346.46142807062455,347.39837766354316,345.52447847770594,52005,44883.333333333336,65.334135651687,59.25337888745328,NaN,NaN,NaN,NaN,0.6274123170596603,19.03226609617155,91735699
2025-08-26T15:05:00-04:00,348.13,348.43,347.85,348.4,346.1924777714361,NaN,NaN,NaN,NaN,NaN,346.3238000000002,348.4090784564256,344.23852154357473,347.3218655334623,346.4783198977034,347.4264795892699,345.5301602061369,46123,44662.46666666667,67.4409708833077,60.710592923805734,NaN,NaN,NaN,NaN,0.6240257229839691,20.052075765531377,91781822
2025-08-26T15:10:00-04:00,348.41,348.88,348.34,348.7,346.5346831932071,NaN,NaN,NaN,NaN,NaN,346.3714000000002,348.5602417395324,344.18255826046806,347.45287515313265,346.52656569386767,347.5169729319744,345.5361584557609,110031,47022.433333333334,69.81195911274372,62.22163653001068,NaN,NaN,NaN,NaN,0.6180238856279727,21.594779416614056,91891853
2025-08-26T15:15:00-04:00,348.7,348.82,348.32,348.78,346.5346831932071,NaN,NaN,NaN,NaN,NaN,346.4252000000002,348.7136981627227,344.13670183727766,347.45287515313265,346.5472402878526,347.5545028021174,345.53997777358785,48704,47545.03333333333,70.43034228782022,63.51343728707303,NaN,NaN,NaN,NaN,0.6095936080831176,22.96708692402614,91940557
2025-08-26T15:20:00-04:00,348.82,350,348.67,349.55,347.1976142318272,NaN,NaN,NaN,NaN,NaN,346.49480000000017,348.94202370061055,344.0475762993898,348.2216400980049,346.6915481960991,347.8556734918989,345.5274229002993,264617,55214.03333333333,75.60920219217142,64.92509997436868,NaN,NaN,NaN,NaN,0.661051207505751,25.401320751527084,92205174
2025-08-26T15:25:00-04:00,349.54,349.99,349.15,349.75,347.41522267583497,NaN,NaN,NaN,NaN,NaN,346.56140000000016,349.1726104780948,343.95018952190554,348.2216400980049,346.7455424966501,347.96457091344513,345.5265140798551,98150,57336.1,76.74831378788126,66.30659070284138,NaN,NaN,NaN,NaN,0.6738332641124852,27.661680734206534,92303324
2025-08-26T15:30:00-04:00,349.7,349.96,349.48,349.52,347.59771255420617,NaN,NaN,NaN,NaN,NaN,346.6046000000001,349.33593655213474,343.8732634478655,348.2458496627231,346.78916188744887,348.049587191954,345.52873658294374,81347,58255.333333333336,72.55196142293727,67.36414255823676,NaN,NaN,NaN,NaN,0.6599880309615906,29.760586432408875,92221977
2025-08-26T15:35:00-04:00,349.54,349.97,349.12,349.72,347.59771255420617,NaN,NaN,NaN,NaN,NaN,346.6576000000002,349.5225769564308,343.79262304356956,348.2458496627231,346.83987505237064,348.1437871589734,345.5359629457679,99516,60424.566666666666,73.88891072429993,68.56088904229264,NaN,NaN,NaN,NaN,0.6735603144643357,30.647896957806086,92321493
2025-08-26T15:40:00-04:00,349.725,349.94,349.24,349.33,347.59771255420617,NaN,NaN,NaN,NaN,NaN,346.7668000000002,349.61461934834006,343.9189806516604,348.2458496627231,346.8825776798741,348.2185571789319,345.54659818081626,89981,61950.23333333333,67.03233515694748,68.9100209509763,NaN,NaN,NaN,NaN,0.6754488634311681,31.47182815996064,92231512
2025-08-26T15:45:00-04:00,349.32,349.86,349.27,349.73,347.59771255420617,NaN,NaN,NaN,NaN,NaN,346.86470000000025,349.77599415220425,343.95340584779626,348.2458496627231,346.9108718011205,348.2684598917579,345.5532837104831,58615,62480.1,70.09725504302193,69.40944698990722,NaN,NaN,NaN,NaN,0.6693453731860869,32.23690713338986,92290127
2025-08-26T15:50:00-04:00,349.72,350.85,349.64,350.74,348.05347937834915,NaN,NaN,NaN,NaN,NaN,346.9733000000002,350.04519297351413,343.9014070264863,348.8652840218514,347.1109844559861,348.6594733080172,345.562495603955,343989,72705.86666666667,76.13126928870453,70.19253062769845,NaN,NaN,NaN,NaN,0.7079635608156547,33.960471354279804,92634116
2025-08-26T15:55:00-04:00,350.9,351.9,350.78,351.7,349.0899121338787,NaN,NaN,NaN,NaN,NaN,347.1115000000002,350.3926767707348,343.8303232292656,349.73222721748107,347.24391588648876,348.9424377261021,345.5453940468754,189648,77217.26666666666,80.21740726495159,71.40859753291669,NaN,NaN,NaN,NaN,0.7402518779002485,36.24308445104483,92823764
2025-08-27T09:30:00-04:00,351.94,354.66,351.68,354.25,350.61582521870247,NaN,NaN,NaN,NaN,NaN,347.2893000000002,351.09336414783587,343.4852358521645,351.4357817739849,353.53000000000003,353.53000000000003,353.53000000000003,273015,85007.86666666667,86.7204910486268,72.81827717565183,NaN,NaN,NaN,NaN,0.9002338866216606,39.29399105480291,93096779
2025-08-27T09:35:00-04:00,354.18,355.4,352.79,353.37,351.3010149814887,NaN,NaN,NaN,NaN,NaN,347.4563000000003,351.5679132163146,343.344686783686,351.5156254191879,353.6894303848391,353.85108158396406,353.52777918571417,265565,92277.2,77.27930566054292,73.52098996611741,NaN,NaN,NaN,NaN,1.022360037577253,42.27649846784258,92831214
2025-08-27T09:40:00-04:00,353.37,353.38,351.15,351.97,NaN,NaN,NaN,355.23607660857897,355.23607660857897,355.23607660857897,347.60550000000023,351.81878197498986,343.3922180250106,351.5156254191879,353.3150846683909,353.985616232238,352.64455310454383,175559,97205.3,65.13083780664192,73.50646869147133,NaN,NaN,NaN,NaN,1.1086200348931647,42.56481524162526,92655655
2025-08-27T09:45:00-04:00,351.96,352.74,349.78,351.52,NaN,NaN,NaN,354.49966403546176,NaN,NaN,347.7439000000003,352.0075075289116,343.48029247108894,351.5156254191879,352.8485342876231,353.87017181692954,351.8268967583167,221845,103328.36666666667,61.76957791971688,73.10136919407198,NaN,NaN,NaN,NaN,1.2408614609722268,41.29420350545184,92433810
2025-08-27T09:50:00-04:00,351.56,352,350.44,351.44,NaN,NaN,NaN,354.49966403546176,NaN,NaN,347.8721000000003,352.18675877684615,343.5574412231544,351.5156254191879,352.6367675442968,353.72585649740864,351.54767859118493,147540,106723.83333333333,61.1652366607259,72.48374616178499,NaN,NaN,NaN,NaN,1.2636570709027823,40.11434975043366,92286270
2025-08-27T09:55:00-04:00,351.48,351.48,350,350.76,NaN,NaN,NaN,354.09671867693936,NaN,NaN,347.9851000000002,352.30042918336255,343.6697708166379,351.5156254191879,352.43567759371757,353.61871005072396,351.2526451367112,129002,110030.53333333334,56.13758748760297,71.46283510462662,NaN,NaN,NaN,NaN,1.2791101372668707,38.55551632182188,92157268
2025-08-27T10:00:00-04:00,350.75,351.03,350.02,350.52,NaN,NaN,NaN,353.8668678279875,NaN,NaN,348.0917000000002,352.3888691194167,343.79453088058364,351.5156254191879,352.2589517678164,353.5147208793576,351.00318265627527,123463,112966.6,54.43683853416626,69.95052341476911,NaN,NaN,NaN,NaN,1.2598879846049509,37.108028138110924,92033805
2025-08-27T10:05:00-04:00,350.45,351.65,350.41,351.53,NaN,NaN,NaN,353.8668678279875,NaN,NaN,348.1967000000002,352.56759629718476,343.8258037028156,351.5156254191879,352.1799601218677,353.41986551763523,350.94005472610013,107325,115313.4,59.937549139102515,68.7497545112849,NaN,NaN,NaN,NaN,1.2584674142760224,36.220874318504386,92141130
2025-08-27T10:10:00-04:00,351.52,352.4,350.79,352.01,NaN,NaN,NaN,353.8668678279875,NaN,NaN,348.30470000000014,352.779068071688,343.83033192831226,351.5156254191879,352.15043094902865,353.35377524779204,350.94708665026525,102182,117258.56666666667,62.2689066824518,68.01525060125024,NaN,NaN,NaN,NaN,1.2835768846848747,35.89497471297212,92243312
2025-08-27T10:15:00-04:00,352.02,352.64,351.89,352.53,NaN,NaN,NaN,353.8668678279875,NaN,NaN,348.4235000000001,353.02312531093236,343.82387468906785,351.5156254191879,352.1630735619756,353.3293571208595,350.99679000309163,102697,119520.53333333334,64.667685712353,67.35659167182546,NaN,NaN,NaN,NaN,1.2454642500645268,35.74324001135784,92346009
2025-08-27T10:20:00-04:00,352.65,353.11,352.14,352.64,NaN,NaN,NaN,353.8668678279875,NaN,NaN,348.54930000000013,353.2579737029577,343.84062629704255,351.5156254191879,352.1856546101354,353.3277884022851,351.04352081798567,83759,120507.8,65.17210548167806,67.22371812359192,NaN,NaN,NaN,NaN,1.2257882322027769,35.89185086311672,92429768
2025-08-27T10:25:00-04:00,352.63,353.2,352.5,352.77,NaN,NaN,NaN,353.8668678279875,NaN,NaN,348.6843000000001,353.4813891216312,343.88721087836905,350.21780807573,352.21580525432364,353.3387964371268,351.0928140715205,85954,122207.3,65.79363574627521,66.91631674525287,NaN,NaN,NaN,NaN,1.1882319299025776,36.08519649102754,92515722
2025-08-27T10:30:00-04:00,352.81,352.82,351.82,352.04,NaN,NaN,NaN,353.8668678279875,NaN,NaN,348.8025000000001,353.63313981279185,343.9718601872084,350.21780807573,352.21622643990236,353.3172305727452,351.1152223070595,73339,122243.93333333333,59.38486115333951,65.72014473558394,NaN,NaN,NaN,NaN,1.1747867920523933,35.35323693098892,92442383
2025-08-27T10:35:00-04:00,352.01,352.96,351.96,352.51,NaN,NaN,NaN,353.8668678279875,NaN,NaN,348.92330000000015,353.8162654035996,344.03033459640073,350.21780807573,352.2241636989209,353.3091847043231,351.1391426935187,59450,122679.03333333334,61.95440023189739,64.41564423322293,NaN,NaN,NaN,NaN,1.162302021191508,34.779535656472845,92501833
2025-08-27T10:40:00-04:00,352.59,352.95,351.88,352.05,NaN,NaN,NaN,353.8668678279875,NaN,NaN,349.0319000000002,353.9564933396394,344.10730666036096,350.21780807573,352.2262616749647,353.2947670054838,351.1577563444456,61017,121942.16666666667,58.08138750142577,62.36999397985143,NaN,NaN,NaN,NaN,1.1557090196778286,34.13621267210814,92440816
2025-08-27T10:45:00-04:00,352.05,352.09,351.2,351.83,NaN,NaN,NaN,353.8668678279875,NaN,NaN,349.1421000000002,354.06561910332096,344.21858089667944,350.21780807573,352.210348362703,353.26616683199074,351.1545298934152,63558,122906.86666666667,56.269628822639575,60.86930277714405,NaN,NaN,NaN,NaN,1.136729803986554,32.638917594236176,92377258
2025-08-27T10:50:00-04:00,351.82,352.05,351.42,351.94,NaN,NaN,NaN,353.8668678279875,NaN,NaN,349.24790000000013,354.1800070913858,344.31579290861447,350.21780807573,352.1988679164881,353.2418685621382,351.155867270838,60235,123042.9,56.99201127629017,60.28795802497607,NaN,NaN,NaN,NaN,1.1005348179875143,31.24857216478364,92437493
2025-08-27T10:55:00-04:00,351.91,352.34,351.53,352.34,NaN,NaN,NaN,353.8668678279875,NaN,NaN,349.3659000000002,354.3059533155812,344.4258466844192,350.21780807573,352.1945670811085,353.2202766855729,351.1688574766441,73731,123065.4,59.605147449046164,60.13335584849959,NaN,NaN,NaN,NaN,1.0797823309884063,30.250305915426672,92511224
2025-08-27T11:00:00-04:00,352.35,352.9,352.26,352.56,NaN,NaN,NaN,353.8668678279875,NaN,NaN,349.4785000000002,354.4478968447572,344.5091031552432,350.6871010241633,352.2062981594817,353.21812871729503,351.1944676016684,70611,123685.6,61.00838595794022,60.12215222687204,NaN,NaN,NaN,NaN,1.0483693073463762,29.851581231950853,92581835
2025-08-27T11:05:00-04:00,352.58,353.58,352.395,353.51,NaN,NaN,NaN,353.8668678279875,NaN,NaN,349.60650000000015,354.6543535043036,344.55864649569673,351.2171808193307,352.2466168368342,353.2553229349699,351.23791073869853,100454,125496.63333333333,66.43122343197452,60.85741193718428,NaN,NaN,NaN,NaN,1.0581286425359209,30.044521099301686,92682289
2025-08-27T11:10:00-04:00,353.56,354.13,353.06,353.25,350.4813958587419,350.4813958587419,350.4813958587419,NaN,NaN,NaN,349.7453000000002,354.80459023092624,344.6860097690742,351.70474465546454,352.31215971708133,353.33194477027695,351.2923746638857,133590,126281.93333333333,63.81536024077584,61.52730634479925,NaN,NaN,NaN,NaN,1.0589765966404976,30.62619577408575,92548699
2025-08-27T11:15:00-04:00,353.29,353.78,352.91,352.91,350.4813958587419,NaN,NaN,NaN,NaN,NaN,349.8843000000002,354.90167780526576,344.8669221947347,351.70474465546454,352.3320593450016,353.3488799040936,351.31523878590957,57637,126579.7,60.462473096276945,61.56480091316886,NaN,NaN,NaN,NaN,1.0454782683090298,30.929907829729032,92491062
2025-08-27T11:20:00-04:00,352.94,353.43,352.35,353.37,350.4813958587419,NaN,NaN,NaN,NaN,NaN,350.0333000000002,355.013262895512,345.05333710448843,351.70474465546454,352.35114786933644,353.3609865943014,351.3413091443715,70239,120100.43333333333,63.27393201719974,61.63658843707942,NaN,NaN,NaN,NaN,1.047944106286955,30.365676361208006,92561301
2025-08-27T11:25:00-04:00,353.38,353.44,352.7,353.02,350.4813958587419,NaN,NaN,NaN,NaN,NaN,350.1735000000003,355.0867556416817,345.26024435831886,351.70474465546454,352.36419261208135,353.36909022584354,351.35929499831917,50006,118495.63333333333,59.79018177700317,61.288195298840144,NaN,NaN,NaN,NaN,1.0259480986950302,29.85101839104368,92511295
2025-08-27T11:30:00-04:00,352.98,353.32,352.42,352.62,350.4813958587419,NaN,NaN,NaN,NaN,NaN,350.3231000000003,355.06677995975036,345.5794200402502,351.70474465546454,352.3717773119269,353.3691923136683,351.3743623101855,49209,117424.36666666667,55.99569161196856,60.63273716528947,NaN,NaN,NaN,NaN,1.0169518059310978,28.947431276122654,92462086
2025-08-27T11:35:00-04:00,352.58,352.88,352.485,352.66,350.4813958587419,NaN,NaN,NaN,NaN,NaN,350.4611000000002,355.06517006471177,345.85702993528867,351.70474465546454,352.3765736139761,353.3667917446374,351.38635548331484,44053,115575.6,56.29439857198393,59.95422022426867,NaN,NaN,NaN,NaN,0.972526676936018,28.108386097981704,92506139
2025-08-27T11:40:00-04:00,352.66,352.66,351.36,352.44,350.4813958587419,NaN,NaN,NaN,NaN,NaN,350.5913000000002,355.04107159422824,346.1415284057722,351.70474465546454,352.37042231707954,353.347586151032,351.3932584831271,78915,115206.73333333334,54.11847775299196,59.5780499813867,NaN,NaN,NaN,NaN,0.9959176285834461,26.41233088827945,92427224
2025-08-27T11:45:00-04:00,352.43,353.22,352.35,353.15,350.4813958587419,NaN,NaN,NaN,NaN,NaN,350.72770000000025,355.0632632668276,346.3921367331729,351.70474465546454,352.3837715298549,353.3523062365844,351.41523682312544,73115,115690.06666666667,59.552152846556275,59.406460882433755,NaN,NaN,NaN,NaN,0.9869235122560573,24.88330970858965,92500339
2025-08-27T11:50:00-04:00,353.17,353.18,352.51,352.78,350.4813958587419,NaN,NaN,NaN,NaN,NaN,350.84850000000023,355.06792567191235,346.6290743280881,351.70474465546454,352.3899308150975,353.35304271333683,351.42681891685817,41740,105615.1,55.84077361700921,59.24641703354687,NaN,NaN,NaN,NaN,0.964286118523483,23.46350432744912,92458599
2025-08-27T11:55:00-04:00,352.76,353.1,352.55,352.59,350.4813958587419,NaN,NaN,NaN,NaN,NaN,350.9617000000002,355.05639784488733,346.867002155113,351.70474465546454,352.39354887938356,353.35243074956844,351.4346670091987,30521,100310.86666666667,53.98035712593032,59.08289762663906,NaN,NaN,NaN,NaN,0.9346942529146636,22.14511361639006,92428078
2025-08-27T12:00:00-04:00,352.57,352.65,352.28,352.29,350.4813958587419,NaN,NaN,NaN,NaN,NaN,351.0681000000002,355.0162291216124,347.11997087838796,351.40479572437164,352.3937335040251,353.3458448857808,351.44162212226934,42959,92642.33333333333,51.08624676423355,58.661057304349306,NaN,NaN,NaN,NaN,0.894358949135045,20.59044697190929,92385119
2025-08-27T12:05:00-04:00,352.28,352.3,351.7,351.84,350.4813958587419,NaN,NaN,NaN,NaN,NaN,351.16650000000016,354.9374575708392,347.39554242916114,351.11786926359787,352.38429287265114,353.3284881973027,351.4400975479996,65845,85985,47.014445305602166,57.76172143696045,NaN,NaN,NaN,NaN,0.8733333099111149,19.9015888038192,92319274
2025-08-27T12:10:00-04:00,351.84,351.84,350.85,351.1,350.4813958587419,NaN,NaN,NaN,NaN,NaN,351.2385000000002,354.86124495388117,347.61575504611926,351.11786926359787,352.35515184772856,353.3039118366384,351.4063918588187,83224,82907.16666666667,41.19911516632312,56.34677352327351,NaN,NaN,NaN,NaN,0.8816666449174605,20.17408776706183,92236050
2025-08-27T12:15:00-04:00,351.09,351.32,350.61,351.14,350.4813958587419,NaN,NaN,NaN,NaN,NaN,351.3089000000002,354.7813269842455,347.83647301575496,351.1087153602366,352.32883749065843,353.28628918663105,351.3713857946858,64528,77663.26666666666,41.619477688854985,54.574505970193556,NaN,NaN,NaN,NaN,0.869404741709069,20.654783192384503,92300578
2025-08-27T12:20:00-04:00,351.13,351.13,349.82,350,NaN,NaN,NaN,353.2653050936678,353.2653050936678,353.2653050936678,351.3513000000002,354.7049587842128,347.9976412157876,351.1087153602366,352.27041727948875,353.2725335069778,351.2683010519997,97655,76000.43333333333,34.13064444544075,52.45416912766962,NaN,NaN,NaN,NaN,0.9015901173012778,21.77469233201437,92202923
2025-08-27T12:25:00-04:00,350,350.67,349.15,350.67,NaN,NaN,NaN,352.7807457712283,NaN,NaN,351.4098000000002,354.6082433465408,348.2113566534596,351.1087153602366,352.1987707901819,353.2551429499547,351.14239863040916,118395,75646.86666666667,40.865288564069154,51.05437023251192,NaN,NaN,NaN,NaN,0.9457622517797607,23.293948691507,92321318
2025-08-27T12:30:00-04:00,350.66,351.15,350.53,350.83,NaN,NaN,NaN,352.7807457712283,NaN,NaN,351.4620000000001,354.53316394893056,348.39083605106964,351.1087153602366,352.17515194510463,353.2373127425166,351.11299114769264,61442,73579.5,42.38035500347282,49.56197187438857,NaN,NaN,NaN,NaN,0.9224935195097782,23.936264950022863,92382760
2025-08-27T12:35:00-04:00,350.83,351.14,350,350.75,NaN,NaN,NaN,352.7807457712283,NaN,NaN,351.51140000000015,354.45296967639933,348.56983032360097,351.1087153602366,352.1573187280255,353.2261506721959,351.08848678385505,41373,71381.1,41.803644279147576,48.27721919597031,NaN,NaN,NaN,NaN,0.9380296966876502,24.929733705405017,92341387
2025-08-27T12:40:00-04:00,350.77,351.16,350.61,350.75,NaN,NaN,NaN,352.7807457712283,NaN,NaN,351.5634000000001,354.3534669815036,348.77333301849666,351.1087153602366,352.13653010408007,353.20952896019463,351.0635312479655,57478,69890.96666666666,41.803644279147576,47.263501529340246,NaN,NaN,NaN,NaN,0.9103132897813904,25.819503878046117,92341387
2025-08-27T12:45:00-04:00,350.75,351.49,350.68,351.41,NaN,NaN,NaN,352.7807457712283,NaN,NaN,351.62360000000007,354.26392046566,348.9832795343401,350.8719722881892,352.124359516423,353.19571449035493,351.05300454249107,47612,68054.8,48.50799267814199,46.7073296797801,NaN,NaN,NaN,NaN,0.9031480547970056,26.09829203350983,92388999
2025-08-27T12:50:00-04:00,351.39,351.49,351.11,351.4,NaN,NaN,NaN,352.7807457712283,NaN,NaN,351.6776000000001,354.183559489152,349.1716405108482,350.57757783055143,352.1188392309925,353.18847823822955,351.0492002237554,25931,66127.2,48.41698055730801,46.3000798800884,NaN,NaN,NaN,NaN,0.8657803365972192,26.357166749297566,92363068
2025-08-27T12:55:00-04:00,351.42,351.42,350.87,350.92,NaN,NaN,NaN,352.7807457712283,NaN,NaN,351.7204000000001,354.0966860436517,349.3441139563485,349.9670622644411,352.11052292870005,353.1799662699343,351.0410795874658,29698,64252,44.13634533064518,45.19895077180903,NaN,NaN,NaN,NaN,0.8432245982688472,26.823128366660175,92333370
2025-08-27T13:00:00-04:00,350.88,351.36,350.52,351.17,NaN,NaN,NaN,352.7807457712283,NaN,NaN,351.75280000000015,354.05278274799,349.4528172520103,349.60936516364785,352.1006232518879,353.17024422341876,351.03100228035703,34207,62947.6,46.775735776508164,44.551448068916095,NaN,NaN,NaN,NaN,0.8429942698210747,27.57185490304871,92367577
2025-08-27T13:05:00-04:00,351.15,351.4,350.78,350.87,NaN,NaN,NaN,352.7807457712283,NaN,NaN,351.7752000000001,354.0178243201402,349.53257567986,349.60936516364785,352.09348118873754,353.1631734020828,351.0237889753923,25069,61801.566666666666,44.08406546726265,43.84457009329698,NaN,NaN,NaN,NaN,0.8270661076909983,28.188167808615262,92342508
2025-08-27T13:10:00-04:00,350.84,350.96,350.45,350.86,NaN,NaN,NaN,352.7807457712283,NaN,NaN,351.80200000000013,353.9668611967487,349.63713880325156,349.60936516364785,352.0810013163754,353.15342234295576,351.0085802897951,35854,60962.8,43.993189276978015,43.337923129921585,NaN,NaN,NaN,NaN,0.804418528570212,29.064571759644352,92306654
2025-08-27T13:15:00-04:00,350.85,350.9,350.48,350.65,NaN,NaN,NaN,352.7807457712283,NaN,NaN,351.8206000000001,353.9288292477727,349.71237075222757,349.60936516364785,352.07437198072006,353.14858033501014,351.00016362643,18216,59451.4,42.03358282238047,42.98214723826289,NaN,NaN,NaN,NaN,0.7769600622437653,29.878375428457076,92288438
2025-08-27T13:20:00-04:00,350.64,350.98,350.46,350.96,NaN,NaN,NaN,352.7807457712283,NaN,NaN,351.85320000000013,353.85404558152976,349.8523544184705,349.60936516364785,352.0638769349324,353.1398346187909,350.9879192510739,32043,58511.666666666664,45.86688878549847,43.31555963963256,NaN,NaN,NaN,NaN,0.7586057720834992,30.44927880540457,92320481
2025-08-27T13:25:00-04:00,350.98,351.2,350.54,351.01,NaN,NaN,NaN,352.7807457712283,NaN,NaN,351.8788000000001,353.80155901796235,349.9560409820379,349.6577913414593,352.0519693803098,353.1286250073812,350.9753137532384,40809,57414.26666666667,46.48163079413695,43.66285629000985,NaN,NaN,NaN,NaN,0.7515625026489613,30.470054583798678,92361290
2025-08-27T13:30:00-04:00,350.97,351.25,350.86,350.92,NaN,NaN,NaN,352.7807457712283,NaN,NaN,351.8824000000002,353.7972746593285,349.9675253406719,349.82123307316743,352.04461853997964,353.1210082791055,350.96822880085375,27934,55991.7,45.480451499212265,44.47355679385066,NaN,NaN,NaN,NaN,0.725736609602606,30.372606303449157,92333356
2025-08-27T13:35:00-04:00,350.93,350.97,350.36,350.52,NaN,NaN,NaN,352.7807457712283,NaN,NaN,351.8588000000002,353.8108108198817,349.9067891801187,349.82123307316743,352.0307915657282,353.11104569182794,350.9505374396284,38716,53933.76666666667,41.22990295381071,44.49960067883221,NaN,NaN,NaN,NaN,0.7174697089167065,30.882952513998557,92294640
2025-08-27T13:40:00-04:00,350.59,350.76,350.33,350.58,NaN,NaN,NaN,352.7807457712283,NaN,NaN,351.78540000000015,353.646097546914,349.9247024530863,349.82123307316743,352.0167484205606,353.1013387861809,350.93215805494026,38456,50762.63333333333,42.10397038338274,44.479858920254344,NaN,NaN,NaN,NaN,0.6969361582797993,31.39080180087127,92333096
2025-08-27T13:45:00-04:00,350.57,350.94,350.39,350.41,NaN,NaN,NaN,352.7807457712283,NaN,NaN,351.7262000000002,353.5697395957375,349.8826604042629,349.82123307316743,352.00596809512047,353.09357201253727,350.91836417770367,30518,49858.666666666664,40.276209111399666,44.37075640827236,NaN,NaN,NaN,NaN,0.6864407184026716,31.400513635219575,92302578
2025-08-27T13:50:00-04:00,350.4,350.7,350.3,350.65,NaN,NaN,NaN,352.7312252293179,NaN,NaN,351.69980000000015,353.5662811387,349.8333188613003,349.82123307316743,351.9932533198313,353.0845383282352,350.90196831142737,35832,48711.76666666667,43.973925655127324,44.52577650655662,NaN,NaN,NaN,NaN,0.6659806670881935,31.529899429125585,92338410
2025-08-27T13:55:00-04:00,350.64,350.74,350.45,350.59,NaN,NaN,NaN,352.7312252293179,NaN,NaN,351.68120000000016,353.5728432647364,349.78955673526394,349.82123307316743,351.9852032348635,353.0784824694587,350.89192400026826,23731,47835.933333333334,43.252940080061215,44.150415606693706,NaN,NaN,NaN,NaN,0.639124905153324,31.539266675462326,92314679
2025-08-27T14:00:00-04:00,350.57,350.94,350.38,350.85,NaN,NaN,NaN,352.7312252293179,NaN,NaN,351.66940000000017,353.57422927345937,349.76457072654097,349.82123307316743,351.9761285656112,353.0706752951529,350.8815818360695,29893,47192.066666666666,47.28625376942196,44.069649407558984,NaN,NaN,NaN,NaN,0.6334731262138009,30.993196898086282,92344572
2025-08-27T14:05:00-04:00,350.82,351.63,350.7,351.45,NaN,NaN,NaN,352.7312252293179,NaN,NaN,351.6832000000002,353.5714010064879,349.79499899351254,350.1831207381859,351.96568975777836,353.0556143947221,350.8757651208346,61488,47773.23333333333,55.19964559871408,44.85988514099248,NaN,NaN,NaN,NaN,0.65465361719853,28.895227971199926,92406060
2025-08-27T14:10:00-04:00,351.44,351.85,351.4,351.71,NaN,NaN,NaN,352.7312252293179,NaN,NaN,351.70700000000016,353.56572321797614,349.8482767820242,350.4674965905487,351.96268238738986,353.0477762017409,350.87758857303885,41008,46509.666666666664,58.13270256151031,45.671097054206925,NaN,NaN,NaN,NaN,0.6400355016843525,27.137463556824194,92447068
2025-08-27T14:15:00-04:00,351.74,352.01,351.42,351.52,NaN,NaN,NaN,352.7312252293179,NaN,NaN,351.7068000000002,353.56560150659504,349.8479984934054,350.60899727243896,351.958750981614,353.0375644098658,350.8799375533622,54234,45880.3,55.284272358477125,46.47111183215082,NaN,NaN,NaN,NaN,0.6364615372783256,25.803005466152268,92392834
2025-08-27T14:20:00-04:00,351.55,351.56,351.15,351.43,NaN,NaN,NaN,352.7312252293179,NaN,NaN,351.69520000000017,353.55352716199224,349.8368728380081,350.60899727243896,351.9544100216624,353.03032937600017,350.8784906673246,32598,45575.566666666666,53.93612185946487,47.18132130232845,NaN,NaN,NaN,NaN,0.6202857131870184,23.99569541241466,92360236
2025-08-27T14:25:00-04:00,351.38,351.39,351.13,351.35,NaN,NaN,NaN,352.7312252293179,NaN,NaN,351.6716000000002,353.5168462602566,349.82635373974375,350.60899727243896,351.95121612379626,353.02552966338493,350.8769025842076,20993,45257.96666666667,52.705776166770804,47.94362082692776,NaN,NaN,NaN,NaN,0.5974081622450893,22.28771104390801,92339243
2025-08-27T14:30:00-04:00,351.31,351.51,351.18,351.31,NaN,NaN,NaN,352.7312252293179,NaN,NaN,351.6450000000002,353.471893538472,349.81810646152843,350.60899727243896,351.9486398216029,353.02145038064646,350.87582926255936,18285,44435.5,52.06624984708901,48.38643233132708,NaN,NaN,NaN,NaN,0.5783075792275818,20.948691976170906,92320958
2025-08-27T14:35:00-04:00,351.3,351.77,351.29,351.76,NaN,NaN,NaN,352.7312252293179,NaN,NaN,351.62480000000016,353.42360956219943,349.8259904378009,350.62318928279103,351.9464491934026,353.01616607075175,350.87673231605345,28273,43183.1,58.20970696885241,49.224152058092464,NaN,NaN,NaN,NaN,0.5712856092827517,20.242272621698294,92349231
2025-08-27T14:40:00-04:00,351.78,351.8,351.44,351.47,NaN,NaN,NaN,352.7312252293179,NaN,NaN,351.61340000000024,353.4087611783791,349.81803882162137,350.70255142623284,351.94486661833906,353.0126104510014,350.8771227856767,18633,41030.066666666666,53.45493798424005,49.79375823559445,NaN,NaN,NaN,NaN,0.5561937800482705,19.647244082522594,92330598
2025-08-27T14:45:00-04:00,351.5,351.65,351.31,351.47,NaN,NaN,NaN,352.7312252293179,NaN,NaN,351.59260000000023,353.3699364793813,349.81526352061917,350.70255142623284,351.94303167483,353.00908257370384,350.8769807759562,17439,39460.433333333334,53.45493798424005,50.666975023482266,NaN,NaN,NaN,NaN,0.5407513671876779,18.752256296036666,92330598
2025-08-27T14:50:00-04:00,351.49,351.66,351.2,351.2,NaN,NaN,NaN,352.7312252293179,NaN,NaN,351.5756000000003,353.3513709764289,349.7998290235717,350.70255142623284,351.9400840066078,353.0042801021284,350.87588791108715,22354,36950.4,49.12234188353549,51.16828727349317,NaN,NaN,NaN,NaN,0.5349834123885607,17.633722839452965,92308244
2025-08-27T14:55:00-04:00,351.25,351.44,350.75,350.78,NaN,NaN,NaN,352.7312252293179,NaN,NaN,351.5546000000003,353.3426322594404,349.76656774056016,350.70255142623284,351.93352225257127,352.9969519816677,350.87009252347485,31101,34040.6,43.24993614136436,51.380696347062084,NaN,NaN,NaN,NaN,0.5460560257893776,17.19905580990532,92277143
2025-08-27T15:00:00-04:00,350.78,351.1,350.46,351.1,NaN,NaN,NaN,352.6454060263612,NaN,NaN,351.5378000000003,353.3268166686796,349.74878333132096,350.70255142623284,351.9230792989109,352.986293683282,350.85986491453986,45374,33505,48.31927114725674,51.691078167928474,NaN,NaN,NaN,NaN,0.552766309661568,17.36228904632146,92322517
2025-08-27T15:05:00-04:00,351.09,351.36,350.65,350.92,NaN,NaN,NaN,352.6454060263612,NaN,NaN,351.5094000000003,353.29164761488346,349.72715238511717,350.70255142623284,351.91279989612474,352.9747649038866,350.8508348883629,49946,33790.76666666667,45.83884926180813,51.875785966624676,NaN,NaN,NaN,NaN,0.5639972875428871,16.83347747482081,92272571
2025-08-27T15:10:00-04:00,350.93,350.93,349.37,349.38,NaN,NaN,NaN,352.1548224331101,NaN,NaN,351.4458000000003,353.29908719867166,349.59251280132895,350.70255142623284,351.8733187677445,352.96138748273177,350.7852500527572,91694,34931.3,31.119912343978427,50.72104729337871,NaN,NaN,NaN,NaN,0.635140338432681,18.253189580675006,92180877
2025-08-27T15:15:00-04:00,349.49,350.08,349.33,350,NaN,NaN,NaN,351.72096686796874,NaN,NaN,351.37560000000025,353.1759651187674,349.5752348812331,350.70255142623284,351.8447057338274,352.9519268681815,350.73748459947336,65740,35535.566666666666,39.53744627615054,49.60231877033846,NaN,NaN,NaN,NaN,0.6433445999732038,19.61624609452972,92246617
2025-08-27T15:20:00-04:00,349.97,350.4,349.85,349.88,NaN,NaN,NaN,351.72096686796874,NaN,NaN,351.3082000000003,353.07484060882774,349.5415593911728,350.70255142623284,351.82578572167654,352.94238166159903,350.70918978175405,50482,36353.933333333334,38.555358798258624,48.20393707296334,NaN,NaN,NaN,NaN,0.6366771285465431,20.111051816403354,92196135
2025-08-27T15:25:00-04:00,349.87,350.14,349.65,349.92,NaN,NaN,NaN,351.72096686796874,NaN,NaN,351.24840000000034,352.9964336840764,349.5003663159243,350.70255142623284,351.81063291569046,352.93573746146717,350.68552836991375,38185,36636.833333333336,39.09840112563853,47.04780341347487,NaN,NaN,NaN,NaN,0.6262001907932193,20.834097807928767,92234320
2025-08-27T15:30:00-04:00,349.92,350.37,349.78,350.3,NaN,NaN,NaN,351.72096686796874,NaN,NaN,351.18700000000035,352.8460370702769,349.5279629297238,350.6020411409862,351.7979927634245,352.9280617155505,350.66792381129846,37158,36735.2,44.14842448154014,46.34868217219453,NaN,NaN,NaN,NaN,0.6236144628794202,20.960642022229862,92271478
2025-08-27T15:35:00-04:00,350.33,350.78,350.24,350.67,NaN,NaN,NaN,351.72096686796874,NaN,NaN,351.1400000000004,352.7199240489859,349.5600759510149,350.591632912789,351.7836968189645,352.91494181400685,350.6524518239221,57187,37805.8,48.61622250281995,46.05657119619804,NaN,NaN,NaN,NaN,0.6176420012451734,20.192965911614632,92328665
2025-08-27T15:40:00-04:00,350.72,351.1,350.66,350.89,NaN,NaN,NaN,351.72096686796874,NaN,NaN,351.1054000000004,352.628928588706,349.58187141129474,350.2403063302312,351.77023132715124,352.8982910884053,350.6421715658972,74986,39110.2,51.11999565807454,45.98898161126844,NaN,NaN,NaN,NaN,0.604953286870518,18.86368029912451,92403651
2025-08-27T15:45:00-04:00,350.9,350.91,350.03,350.22,NaN,NaN,NaN,351.72096686796874,NaN,NaN,351.0566000000004,352.5334160889118,349.579783911089,349.9811960513479,351.7549895389359,352.88607576042983,350.62390331744194,55850,40364.666666666664,44.07615592034761,44.97944225066095,NaN,NaN,NaN,NaN,0.6245994806654848,18.63026260469684,92347801
2025-08-27T15:50:00-04:00,350.25,351.1,349.44,349.51,NaN,NaN,NaN,351.72096686796874,NaN,NaN,350.9980000000004,352.4830939366038,349.512906063397,349.9811960513479,351.71911711960746,352.86542684204335,350.5728073971716,106825,42857.4,38.08702343074885,43.88173406826873,NaN,NaN,NaN,NaN,0.698556660617952,19.17055046995125,92240976
2025-08-27T15:55:00-04:00,349.5,350,349.47,349.94,NaN,NaN,NaN,351.72096686796874,NaN,NaN,350.9338000000004,352.3151320528925,349.5524679471083,349.62061153414766,351.6611093611493,352.83669610305645,350.4855226192421,161635,46884.933333333334,43.12734775034676,43.14404905156206,NaN,NaN,NaN,NaN,0.6865168991452392,19.67224634483035,92402611
2025-08-28T09:30:00-04:00,351,353.55,350.7,352.02,349.65781672313,349.65781672313,349.65781672313,NaN,NaN,NaN,350.91860000000037,352.2334627915491,349.60373720845166,350.1705624843869,352.09,352.09,352.09,203946,52752,60.06381800305712,43.92558306009932,NaN,NaN,NaN,NaN,0.8953371206348659,20.605726422909868,92606557
2025-08-28T09:35:00-04:00,351.91,352.18,349.62,350.69,NaN,NaN,NaN,353.60412949155767,353.60412949155767,353.60412949155767,350.8806000000004,352.10688812294165,349.6543118770592,350.1705624843869,351.61019710475824,352.2220310934123,350.9983631161042,125422,55642.2,49.8427865374966,44.39650094553734,NaN,NaN,NaN,NaN,1.01424161201809,20.214299432580727,92481135
2025-08-28T09:40:00-04:00,350.67,350.94,349.54,350,NaN,NaN,NaN,353.0121236055778,NaN,NaN,350.83480000000037,352.01738861846695,349.6522113815338,350.1705624843869,351.2418104442084,352.0650803569996,350.4185405314172,112159,58098.96666666667,45.515430959342346,44.196226646400596,NaN,NaN,NaN,NaN,1.0417957825882247,19.764691464436407,92368976
2025-08-28T09:45:00-04:00,350,351.52,349.01,350.8,NaN,NaN,NaN,353.0121236055778,NaN,NaN,350.81400000000036,351.96119135305867,349.66680864694206,350.1705624843869,351.0532863835957,351.8487351996808,350.25783756751065,136467,61630.6,50.84413047085912,44.55374673276138,NaN,NaN,NaN,NaN,1.1466675124033507,19.812052781180885,92505443
2025-08-28T09:50:00-04:00,350.72,351.42,349.6,351.24,NaN,NaN,NaN,353.0121236055778,NaN,NaN,350.81680000000034,351.9674480959189,349.6661519040818,350.1705624843869,351.00441671059673,351.7405692656861,350.2682641555074,112498,64186.13333333333,53.535752017099526,46.15487813798432,NaN,NaN,NaN,NaN,1.1947626900888253,19.85603114672933,92617941
2025-08-28T09:55:00-04:00,351.34,352.07,350.22,350.59,NaN,NaN,NaN,353.0121236055778,NaN,NaN,350.8058000000004,351.9543928088381,349.6572071911626,350.1705624843869,350.99730741751733,351.67217522798785,350.3224396070468,131580,67781.1,49.2457932837106,46.84833149566718,NaN,NaN,NaN,NaN,1.2415653550824781,20.40540582472653,92486361
2025-08-28T10:00:00-04:00,350.58,351.45,350.07,350.21,NaN,NaN,NaN,353.0121236055778,NaN,NaN,350.81000000000046,351.9482653470613,349.6717346529396,350.1705624843869,350.9455758076848,351.5925060177937,350.2986455975759,115278,70627.26666666666,46.88064845075538,47.44299504227409,NaN,NaN,NaN,NaN,1.2514535440051577,20.71736660427606,92371083
2025-08-28T10:05:00-04:00,350.17,351.14,348.3,348.35,NaN,NaN,NaN,353.0121236055778,NaN,NaN,350.76360000000045,352.09386168868787,349.43333831131304,350.1705624843869,350.72907837663905,351.55490351677633,349.90325323650177,138451,73192.7,37.40981508928556,47.322381753963164,NaN,NaN,NaN,NaN,1.3649211480047876,19.398106037602886,92232632
2025-08-28T10:10:00-04:00,348.25,349.44,348.06,348.95,NaN,NaN,NaN,352.2729799149675,NaN,NaN,350.7260000000004,352.1496291653694,349.3023708346314,350.1705624843869,350.5887315604999,351.5271566248563,349.65030649614357,85203,74665.86666666667,41.5143759792823,47.134235432373316,NaN,NaN,NaN,NaN,1.3659982088615883,18.387108621664712,92317835
2025-08-28T10:15:00-04:00,348.98,349.37,347.01,347.24,NaN,NaN,NaN,351.8746626461053,NaN,NaN,350.65580000000045,352.3818177983816,348.92978220161933,350.1705624843869,350.3409099343433,351.5290969692312,349.1527228994554,116601,76744.76666666666,34.55859246044632,46.1301190007752,NaN,NaN,NaN,NaN,1.4369983368000472,18.30246746151846,92201234
2025-08-28T10:20:00-04:00,347.26,347.5,346.34,346.62,NaN,NaN,NaN,350.5953597985551,NaN,NaN,350.57320000000044,352.63575934227333,348.51064065772755,348.1964499875095,350.0780366720553,351.5486944098124,348.6073789342982,103083,79094.26666666666,32.43651151409149,44.79558441906213,NaN,NaN,NaN,NaN,1.4172127413143314,18.69582159295681,92098151
2025-08-28T10:25:00-04:00,346.6,346.6,344.91,345.1,NaN,NaN,NaN,349.4964798077117,NaN,NaN,350.44700000000034,353.0025625604935,347.8914374395072,347.6237379148839,349.63722370201987,351.57641814256687,347.69802926147287,148425,83342,27.911446473951713,43.64096231574814,NaN,NaN,NaN,NaN,1.4381261169347348,19.9045770298578,91949726
2025-08-28T10:30:00-04:00,345.12,345.86,344.06,344.3,NaN,NaN,NaN,348.77686708917935,NaN,NaN,350.30500000000035,353.37101304639555,347.23898695360515,347.6237379148839,349.1934123580607,351.5163752517953,346.8704494643261,152386,87812.03333333334,25.8661618279572,42.768043629834445,NaN,NaN,NaN,NaN,1.4639742514393974,21.442070520281696,91797340
2025-08-28T10:35:00-04:00,344.19,345.48,343.55,345.4,NaN,NaN,NaN,348.4215549487621,NaN,NaN,350.19460000000043,353.548127599481,346.84107240051986,347.6237379148839,348.8756596505338,351.3850150711175,346.3663042299501,131418,91250.2,33.1228212342196,42.05343459296822,NaN,NaN,NaN,NaN,1.4972618049080124,23.100292894282916,91928758
2025-08-28T10:40:00-04:00,345.39,346.12,345.26,345.5,NaN,NaN,NaN,348.4215549487621,NaN,NaN,350.08120000000036,353.670313851727,346.49208614827376,347.6237379148839,348.69790747447746,351.2470805454566,346.14873440349834,104925,94126.6,33.75763752782147,40.174421701879965,NaN,NaN,NaN,NaN,1.451743104557441,23.92388761752439,92033683
2025-08-28T10:45:00-04:00,345.54,345.71,345,345.22,NaN,NaN,NaN,348.4215549487621,NaN,NaN,349.96820000000037,353.7985246651741,346.1378753348266,347.20299033190713,348.58688240474896,351.1654758756629,346.00828893383505,64979,95711.26666666666,32.81828476947919,38.95838586130729,NaN,NaN,NaN,NaN,1.398761454231908,24.826078158636573,91968704
2025-08-28T10:50:00-04:00,345.23,345.27,344.31,345.18,NaN,NaN,NaN,348.4215549487621,NaN,NaN,349.85460000000035,353.90309248001444,345.80610751998626,346.3223922655257,348.45701771856244,351.07865744012094,345.83537799700395,72801,97392.83333333333,32.67838920221112,38.041454307226495,NaN,NaN,NaN,NaN,1.367421350358199,26.015446476504707,91895903
2025-08-28T10:55:00-04:00,345.19,345.8,345.02,345.52,NaN,NaN,NaN,348.4215549487621,NaN,NaN,349.75200000000035,353.9710842609062,345.5329157390945,344.8959138124206,348.3820725643805,351.0130192464073,345.75112588235373,52483,98105.56666666667,35.20665138765321,36.92449151556893,NaN,NaN,NaN,NaN,1.3254626824754727,26.510385851968383,91948386
2025-08-28T11:00:00-04:00,345.49,345.88,344.92,345.18,NaN,NaN,NaN,348.4215549487621,NaN,NaN,349.63640000000026,354.02988747134884,345.2429125286517,344.55473104993644,348.3158945260822,350.9559283139353,345.6758607382291,46671,98148.8,33.83810862002353,35.517516987206356,NaN,NaN,NaN,NaN,1.2993582051557946,27.027958183157804,91901715
2025-08-28T11:05:00-04:00,345.15,345.315,344.75,345.25,NaN,NaN,NaN,348.4215549487621,NaN,NaN,349.5212000000003,354.06410064174014,344.9782993582605,343.0677848399491,348.25899809692874,350.9096068018909,345.60838939196657,38871,97779.63333333333,34.40345991747705,34.45735031818968,NaN,NaN,NaN,NaN,1.2469040476446662,27.61116040471191,91940586
2025-08-28T11:10:00-04:00,345.26,345.32,344.65,344.97,NaN,NaN,NaN,348.4215549487621,NaN,NaN,349.4022000000003,354.10133232851535,344.7030676714852,342.9478623930135,348.1983919228537,350.8612707139167,345.5355131317907,41309,96100.13333333333,33.18205833479878,33.47887959562136,NaN,NaN,NaN,NaN,1.2056966156700484,28.215429478102195,91899277
2025-08-28T11:15:00-04:00,344.93,345.39,344.45,344.61,NaN,NaN,NaN,348.3619810787109,NaN,NaN,349.28400000000033,354.15875291688656,344.4092470831141,342.9699455452229,348.097535871179,350.78274356595136,345.4123281764066,68704,96198.93333333333,31.627352088971165,33.06584652417033,NaN,NaN,NaN,NaN,1.1867182859793304,28.906024995534025,91830573
2025-08-28T11:20:00-04:00,344.61,344.61,343.77,344.09,NaN,NaN,NaN,347.5900728478605,NaN,NaN,349.1542000000003,354.22565594881706,344.0827440511835,342.9699455452229,347.97863745031384,350.70759811337405,345.24967678725363,71665,96905.03333333334,29.478825542879477,32.206164350141556,NaN,NaN,NaN,NaN,1.1619526941236662,29.964641120172033,91758908
2025-08-28T11:25:00-04:00,344.11,344.11,341.6,341.945,NaN,NaN,NaN,346.44279680932135,NaN,NaN,348.98490000000027,354.42885609468266,343.5409439053179,342.9699455452229,347.5100994001922,350.53127197033496,344.4889268300494,224452,103113.93333333333,22.645060871206027,31.35519780805296,NaN,NaN,NaN,NaN,1.2582417874005465,31.929583752042213,91534456
2025-08-28T11:30:00-04:00,341.95,343.1,341.93,342.41,NaN,NaN,NaN,346.0992605907158,NaN,NaN,348.8201000000003,354.54413371414864,343.096066285852,342.9699455452229,347.36096560081813,350.45689622725257,344.2650349743837,79434,104523.13333333333,26.61659276502104,30.939489325976496,NaN,NaN,NaN,NaN,1.2519388025862228,33.754173338778806,91613890
2025-08-28T11:35:00-04:00,342.4,343.19,342.15,342.27,NaN,NaN,NaN,346.0992605907158,NaN,NaN,348.6537000000003,354.63997657569644,342.66742342430416,342.9699455452229,347.21742661223965,350.37519142579157,344.0596617986877,82160,105355.56666666667,26.18076775368519,30.815869417386033,NaN,NaN,NaN,NaN,1.2368003166872084,35.317796925911644,91531730
2025-08-28T11:40:00-04:00,342.27,342.42,341.31,341.4,NaN,NaN,NaN,345.41755975311094,NaN,NaN,348.4647000000003,354.75087671091325,342.1785232890873,342.9699455452229,346.9893972354302,350.27001872930725,343.70877574155315,119270,106831.7,23.595182129178,30.653656581758945,NaN,NaN,NaN,NaN,1.2277431512095516,37.10092179665553,91412460
2025-08-28T11:45:00-04:00,341.35,341.69,340.91,341.27,NaN,NaN,NaN,344.7974434006968,NaN,NaN,348.2611000000004,354.8016153589429,341.7205846410579,342.9699455452229,346.8135812660453,350.19020805310635,343.4369544789842,91691,108026.4,23.226067704743485,29.946745615367796,NaN,NaN,NaN,NaN,1.1957614975517246,38.90102863117466,91320769
2025-08-28T11:50:00-04:00,341.22,341.43,340.26,340.96,NaN,NaN,NaN,344.3430141552106,NaN,NaN,348.04610000000037,354.8215212533681,341.27067874663265,342.9699455452229,346.60610208595375,350.0975287821871,343.1146753897204,107762,108057.63333333333,22.32903026347327,29.130416525057203,NaN,NaN,NaN,NaN,1.1939213905837451,40.79271024736624,91213007
2025-08-28T11:55:00-04:00,340.95,341.56,340.61,341.25,NaN,NaN,NaN,344.3430141552106,NaN,NaN,347.84070000000037,354.80253137116625,340.8788686288345,342.9699455452229,346.4089221150079,349.9851284015126,342.8327158285032,115267,106512.03333333334,25.23798438427866,28.58896649754288,NaN,NaN,NaN,NaN,1.1764984341134768,42.34484339090698,91328274
2025-08-28T12:00:00-04:00,341.27,342.15,341.16,342.13,NaN,NaN,NaN,344.3430141552106,NaN,NaN,347.6547000000003,354.71919103904725,340.5902089609533,342.9699455452229,346.2939644924767,349.89735371015286,342.6905752748005,81982,102446.56666666667,33.390366808126274,28.639822040822533,NaN,NaN,NaN,NaN,1.1631771173910823,42.8808117941021,91410256
2025-08-28T12:05:00-04:00,342.13,342.28,341.57,342.17,NaN,NaN,NaN,344.3430141552106,NaN,NaN,347.4711000000004,354.6185704029177,340.323629597083,342.2539564361783,346.213728041416,349.83021407283735,342.59724200999466,62505,100349.33333333333,33.74403056639213,28.535349125018172,NaN,NaN,NaN,NaN,1.130807323291718,43.184031039909286,91472761
2025-08-28T12:10:00-04:00,342.15,342.75,342.13,342.72,NaN,NaN,NaN,344.3430141552106,NaN,NaN,347.2993000000003,354.4822754308899,340.1163245691107,340.97016514894267,346.162381196655,349.77940217428875,342.5453602190213,47255,98185.86666666667,38.57347160699414,28.873589338373215,NaN,NaN,NaN,NaN,1.0943210859137384,42.77131026475148,91520016
2025-08-28T12:15:00-04:00,342.68,343.09,342.05,342.07,NaN,NaN,NaN,344.3430141552106,NaN,NaN,347.10550000000035,354.31942549175847,339.89157450824223,340.7335830099167,346.08831712433715,349.70743248662,342.4692017620543,68077,95906.2,35.29880418521668,28.937542500354617,NaN,NaN,NaN,NaN,1.0904410083484688,41.90764901104451,91451939
2025-08-28T12:20:00-04:00,342.06,342.28,341.86,342.2,NaN,NaN,NaN,344.3430141552106,NaN,NaN,346.92010000000033,354.15228044304104,339.6879195569596,340.7335830099167,346.03408869685506,349.6578883525844,342.41028904112574,47789,93749.23333333334,36.46061695284176,29.17172525878626,NaN,NaN,NaN,NaN,1.042552364895004,41.247363216013014,91499728
2025-08-28T12:25:00-04:00,342.23,343.25,342.2,343.2,NaN,NaN,NaN,344.3430141552106,NaN,NaN,346.75470000000035,353.9412158206642,339.5681841793365,341.04889312634674,345.98052788836526,349.59640647512737,342.36464930160315,60578,91382.5,44.68837622501498,30.10465555421796,NaN,NaN,NaN,NaN,1.043084338831076,39.34609135719448,91560306
2025-08-28T12:30:00-04:00,343.17,343.37,342.43,342.861,NaN,NaN,NaN,344.3430141552106,NaN,NaN,346.5879200000004,353.7410147131253,339.4348252868755,341.13911450107736,345.93175856550783,349.53965943112695,342.3238576998887,57079,89442.53333333334,42.67113799672405,31.046963586635428,NaN,NaN,NaN,NaN,1.0357211717717132,37.434974773636256,91503227
2025-08-28T12:35:00-04:00,342.92,343.36,342.54,343.31,NaN,NaN,NaN,344.3430141552106,NaN,NaN,346.43852000000044,353.54704871688665,339.3299912831142,341.1652916008619,345.8957451293646,349.49503718692563,342.2964530718036,46144,86365.63333333333,46.13904911213183,32.72510560384442,NaN,NaN,NaN,NaN,1.0203125166451616,35.66036651747505,91549371
2025-08-28T12:40:00-04:00,343.32,343.39,342.95,343.18,NaN,NaN,NaN,344.3430141552106,NaN,NaN,346.2801200000004,353.31872091373674,339.2415190862641,341.41423328068953,345.873799793394,349.46681198446123,342.2807876023268,29798,84518.8,45.28490762347157,34.05855666516231,NaN,NaN,NaN,NaN,0.9788616225990785,33.97125019684344,91519573
2025-08-28T12:45:00-04:00,343.18,343.22,342.68,342.9,NaN,NaN,NaN,344.3430141552106,NaN,NaN,346.11972000000037,353.093293557874,339.14614644212674,341.41423328068953,345.85238721151785,349.44101256419856,342.26376185883714,27116,81535.96666666666,43.42044035400994,35.289961850899786,NaN,NaN,NaN,NaN,0.9475143638420029,32.70053851143186,91492457
2025-08-28T12:50:00-04:00,342.88,343.98,342.72,343.82,NaN,NaN,NaN,344.3430141552106,NaN,NaN,346.0085200000004,352.9478289943475,339.06921100565324,341.8695092996413,345.8074586440446,349.3760635595425,342.23885372854664,72714,80523.66666666667,50.61509539978484,37.21995565594313,NaN,NaN,NaN,NaN,0.9698347664247163,30.478447530121016,91565171
2025-08-28T12:55:00-04:00,343.82,344.07,343.42,343.57,NaN,NaN,NaN,344.3430141552106,NaN,NaN,345.87992000000037,352.7566208699622,339.00321913003853,342.05660743971305,345.7735611578488,349.3235095722781,342.2236127434195,61665,77631.66666666667,48.79916310688988,39.046605327525015,NaN,NaN,NaN,NaN,0.9469894259658064,28.302136791094018,91503506
2025-08-28T13:00:00-04:00,343.53,344.29,343.42,343.93,NaN,NaN,NaN,344.3430141552106,NaN,NaN,345.7609200000004,352.5621327370726,338.9597072629282,342.24428595177045,345.7491243786518,349.282561248055,342.2156875092486,50440,74233.46666666666,51.497704362404235,41.130082048877235,NaN,NaN,NaN,NaN,0.9414901812539634,26.565833526577578,91553946
2025-08-28T13:05:00-04:00,343.98,344.26,343.63,344.2,NaN,NaN,NaN,344.3430141552106,NaN,NaN,345.6465200000004,352.3558588078815,338.93718119211934,342.30842876141634,345.7338306737405,349.2552172113943,342.2124441360867,35083,71022.3,53.47811500874167,43.147234236338875,NaN,NaN,NaN,NaN,0.9192408825929658,24.953551923812306,91589029
2025-08-28T13:10:00-04:00,344.16,344.3,343.67,343.8,NaN,NaN,NaN,344.3430141552106,NaN,NaN,345.51652000000036,352.11106380825686,338.92197619174385,342.4237430091331,345.7164374655363,349.2253153852933,342.20755954577925,38253,68799.9,50.2074078021967,44.34845145020105,NaN,NaN,NaN,NaN,0.8985808195506108,23.513566002316413,91550776
2025-08-28T13:15:00-04:00,343.78,344.05,343.67,343.93,NaN,NaN,NaN,344.3430141552106,NaN,NaN,345.38172000000037,351.82314989149415,338.9402901085066,342.4237430091331,345.7017398359037,349.20034419272184,342.2031354790856,32184,67706.73333333334,51.25092591724398,45.598943975261896,NaN,NaN,NaN,NaN,0.8615393324398525,22.17643621807023,91582960
2025-08-28T13:20:00-04:00,343.94,344.09,343.62,343.66,NaN,NaN,NaN,344.3430141552106,NaN,NaN,345.2371200000003,351.4995664950409,338.9746735049597,342.50219552584514,345.68117682159647,349.1664978427448,342.19585580044816,43645,66734.86666666667,48.956113028237084,46.34056121963639,NaN,NaN,NaN,NaN,0.8335722372655752,20.845487881885827,91539315
2025-08-28T13:25:00-04:00,343.66,343.67,342.91,343.43,NaN,NaN,NaN,344.3430141552106,NaN,NaN,345.1013200000003,351.2184595857188,338.98418041428187,342.50219552584514,345.65809734955036,349.13393678800554,342.1822579110952,40341,66330.13333333333,47.02450691952681,47.17811141494426,NaN,NaN,NaN,NaN,0.8283170774608906,20.244863722645302,91498974
2025-08-28T13:30:00-04:00,343.46,344.4,343.46,344.11,341.2029829553122,341.2029829553122,341.2029829553122,NaN,NaN,NaN,344.9933200000003,350.9846838840541,339.00195611594654,342.5948051365409,345.6319815658898,349.08671653824,342.1772465935396,65179,66947.06666666667,52.936835074302095,48.35498413790571,NaN,NaN,NaN,NaN,0.838437286213682,19.082572745752987,91564153
2025-08-28T13:35:00-04:00,344.15,344.49,344.09,344.13,341.6323928209799,NaN,NaN,NaN,NaN,NaN,344.8771200000003,350.7033096384661,339.0509303615344,342.84584410923276,345.61990082535874,349.06207578083627,342.1777258698812,36360,66863.36666666667,53.10261727315797,48.956001355630214,NaN,NaN,NaN,NaN,0.8071203371984215,18.133686397094724,91600513
2025-08-28T13:40:00-04:00,344.11,344.27,344.01,344.21,341.6323928209799,NaN,NaN,NaN,NaN,NaN,344.72092000000026,350.1799342970524,339.2619057029481,342.84584410923276,345.61197521150865,349.046444346695,342.1775060763223,22976,66252.26666666666,53.80360358925545,49.751177469382455,NaN,NaN,NaN,NaN,0.7680403131128193,17.117523433776043,91623489
2025-08-28T13:45:00-04:00,344.19,344.24,343.68,343.79,341.6323928209799,NaN,NaN,NaN,NaN,NaN,344.58292000000023,349.77364218245896,339.3921978175415,342.84584410923276,345.6041308436582,349.0326533345476,342.1756083527688,19475,64611.3,49.61100800908151,49.99917453345029,NaN,NaN,NaN,NaN,0.7531802907476182,16.161634775165336,91604014
2025-08-28T13:50:00-04:00,343.82,345,343.771,344.99,341.8012824863913,NaN,NaN,NaN,NaN,NaN,344.48272000000026,349.43944404792927,339.52599595207124,343.23649218392717,345.58362576875834,348.9804227208984,342.1868288166183,87277,65131.7,59.35605797336948,51.00425670130014,NaN,NaN,NaN,NaN,0.7871674128370729,15.883577989756636,91691291
2025-08-28T13:55:00-04:00,344.98,345.01,344.62,344.8,342.29506510064624,NaN,NaN,NaN,NaN,NaN,344.3627200000002,348.9808283234897,339.7446116765107,343.40419374714173,345.5762213811193,348.9575628766685,342.1948798855701,41836,59044.5,57.46118536150386,52.007167058978276,NaN,NaN,NaN,NaN,0.7587983119201381,15.63905179913418,91649455
2025-08-28T14:00:00-04:00,344.78,344.93,344.45,344.71,342.29506510064624,NaN,NaN,NaN,NaN,NaN,344.23212000000024,348.413577748606,340.0506622513945,343.4053549977134,345.5697145349318,348.9393684606287,342.20006060923487,32578,57482.63333333333,56.54042288457433,52.43040473646324,NaN,NaN,NaN,NaN,0.7388841467829866,15.103515594143383,91616877
2025-08-28T14:05:00-04:00,344.72,344.91,344.5,344.82,342.29506510064624,NaN,NaN,NaN,NaN,NaN,344.1167200000002,347.8883453058134,340.345094694187,343.4852839981707,345.56435940506157,348.9237319972886,342.20498681283453,28723,55701.4,57.438117700607314,53.047472921728776,NaN,NaN,NaN,NaN,0.7153924220127751,14.606231975223357,91645600
2025-08-28T14:10:00-04:00,344.84,345.2,344.42,344.54,342.3989390399216,NaN,NaN,NaN,NaN,NaN,344.00332000000026,347.35261956726964,340.6540204327309,343.67022719853657,345.5533530998136,348.8921328610672,342.21457333856,58540,53677.066666666666,54.36008400425941,53.25192861043271,NaN,NaN,NaN,NaN,0.7200072490118606,14.607764274580578,91587060
2025-08-28T14:15:00-04:00,344.55,344.83,344.32,344.7,342.3989390399216,NaN,NaN,NaN,NaN,NaN,343.9303200000002,347.04862570526,340.81201429474044,343.67022719853657,345.54664089758813,348.8743745023565,342.2189072928198,32414,51701.166666666664,55.81713151572623,53.41900121807447,NaN,NaN,NaN,NaN,0.7050067312252984,14.399981052425858,91619474
2025-08-28T14:20:00-04:00,344.71,344.86,344.61,344.76,342.4376696624079,NaN,NaN,NaN,NaN,NaN,343.84652000000017,346.627713132381,341.0653268676193,343.67022719853657,345.5423456934738,348.8616878453024,342.2230035416452,24316,48919.63333333333,56.37951852869691,53.859866269967334,NaN,NaN,NaN,NaN,0.6725062504234913,14.25867957012074,91643790
2025-08-28T14:25:00-04:00,344.74,345.05,344.58,344.98,342.55800285957116,NaN,NaN,NaN,NaN,NaN,343.8013200000002,346.4297013862362,341.1729386137642,343.7685563256507,345.5380388342268,348.84716727294347,342.2289103955102,29319,46054.7,58.46703735212119,54.37530280103,NaN,NaN,NaN,NaN,0.6580415182503867,14.458323520431698,91673109
2025-08-28T14:30:00-04:00,345.04,345.2,344.14,344.24,342.55800285957116,NaN,NaN,NaN,NaN,NaN,343.75372000000016,346.2595380954936,341.2479019045067,343.7685563256507,345.5258368260005,348.8167955457817,342.2348781062193,55895,45185.13333333333,49.82898709094236,54.43765094836609,NaN,NaN,NaN,NaN,0.6867528383753593,13.669394423025352,91617214
2025-08-28T14:35:00-04:00,344.25,344.41,343.97,344.06,342.55800285957116,NaN,NaN,NaN,NaN,NaN,343.73292000000015,346.2108023167546,341.2550376832457,343.7685563256507,345.518158609429,348.8015477219049,342.2347694969531,25937,43966.2,47.972374369679336,54.50535576623413,NaN,NaN,NaN,NaN,0.669127635634262,12.790792857653779,91591277
2025-08-28T14:40:00-04:00,344.04,344.56,344,344.3,342.55800285957116,NaN,NaN,NaN,NaN,NaN,343.73292000000015,346.2108023167546,341.2550376832457,343.7685563256507,345.51242059271215,348.7892248437836,342.2356163416407,21809,43118,50.61455009008054,54.339478267361166,NaN,NaN,NaN,NaN,0.6613328045175292,12.08416121579773,91613086
2025-08-28T14:45:00-04:00,344.3,344.45,344.01,344.03,342.55800285957116,NaN,NaN,NaN,NaN,NaN,343.7055200000002,346.1389590889354,341.272080911065,343.7685563256507,345.503962043944,348.7722129375525,342.2357111503355,29532,41833.166666666664,47.6808934540588,53.95221228028265,NaN,NaN,NaN,NaN,0.6455233184805627,11.428003262645683,91583554
2025-08-28T14:50:00-04:00,344.04,344.1,343.68,343.88,342.55800285957116,NaN,NaN,NaN,NaN,NaN,343.6731200000002,346.05266818053184,341.2935718194686,343.7685563256507,345.48876310140236,348.7453613749664,342.2321648278383,44685,41729.7,46.08286129268326,53.40073068767036,NaN,NaN,NaN,NaN,0.6294145100176666,11.117534794025755,91538869
2025-08-28T14:55:00-04:00,343.86,344.28,343.77,344.26,342.55800285957116,NaN,NaN,NaN,NaN,NaN,343.6539200000002,345.99846733700775,341.30937266299264,343.7685563256507,345.4779588913198,348.72412248615274,342.2317952964869,37372,40956.166666666664,50.59982536233178,53.4713604986168,NaN,NaN,NaN,NaN,0.6208849021592612,10.416988963031256,91576241
2025-08-28T15:00:00-04:00,344.24,344.81,344.2,344.59,342.55800285957116,NaN,NaN,NaN,NaN,NaN,343.6421200000002,345.961631005257,341.3226089947434,343.7685563256507,345.4689976835399,348.70102457671953,342.23697079036026,45897,40583.433333333334,54.18907669784956,53.102290407508235,NaN,NaN,NaN,NaN,0.6201074091478863,10.635604878814243,91622138
2025-08-28T15:05:00-04:00,344.61,345.1,344.41,345.08,342.6526210582081,NaN,NaN,NaN,NaN,NaN,343.63332000000025,345.9274662009689,341.3391737990316,343.7685563256507,345.4631625841268,348.6801268258255,342.2461983424281,47065,40614.13333333333,58.95751195372306,53.20917087838103,NaN,NaN,NaN,NaN,0.6250997370658943,11.32806449045335,91669203
2025-08-28T15:10:00-04:00,345.07,346,345.06,345.77,343.39500191919865,NaN,NaN,NaN,NaN,NaN,343.64512000000025,345.9767298351405,341.31351016486,344.38968503266887,345.46614415420214,348.6503476191911,342.2819406892132,101251,42995.9,64.55284479984644,53.7814867294719,NaN,NaN,NaN,NaN,0.6475926129897588,13.162101865817624,91770454
2025-08-28T15:15:00-04:00,345.77,345.89,345.56,345.74,343.6420472865079,NaN,NaN,NaN,NaN,NaN,343.6549200000002,346.01734478303877,341.2924952169616,344.4367480261351,345.4688181225356,348.6369560442664,342.3006802008048,51051,43793.73333333333,64.1433946508139,54.260435083058084,NaN,NaN,NaN,NaN,0.6249074263476321,14.865136571513023,91719403
2025-08-28T15:20:00-04:00,345.74,346,345.45,345.72,343.661726955303,NaN,NaN,NaN,NaN,NaN,343.6699200000002,346.07469867079624,341.2651413292042,344.5623984209081,345.4708645869538,348.62632174858453,342.31540742532303,40833,42731.03333333333,63.85261916632702,54.93847330892005,NaN,NaN,NaN,NaN,0.6195568958942307,16.446525941087323,91678570
2025-08-28T15:25:00-04:00,345.7,346.5,345.64,346.42,343.98323936642555,NaN,NaN,NaN,NaN,NaN,343.7061200000002,346.2185001192148,341.19373988078564,344.91991873672646,345.4820897758894,348.61397018783344,342.35020936394534,80907,43372.433333333334,69.12768384021491,55.88922704638353,NaN,NaN,NaN,NaN,0.636731403330358,18.485558094889456,91759477
2025-08-28T15:30:00-04:00,346.46,346.86,346.31,346.47,344.51809212249714,NaN,NaN,NaN,NaN,NaN,343.75372000000016,346.3809474982608,341.1264925017395,345.32093498938116,345.4965015589435,348.60954252454405,342.383460593343,70802,44051.166666666664,69.4703954215782,56.824289681589335,NaN,NaN,NaN,NaN,0.6305363030924761,20.73068882103382,91830279
2025-08-28T15:35:00-04:00,346.47,346.6,345.99,346.06,344.51809212249714,NaN,NaN,NaN,NaN,NaN,343.8360200000002,346.48913664264313,341.18290335735725,345.32093498938116,345.50207627988647,348.60368723495003,342.4004653248229,40801,44241.76666666667,63.268224239420746,57.16723160211074,NaN,NaN,NaN,NaN,0.6290694243001573,21.97020629242076,91789478
2025-08-28T15:40:00-04:00,346.08,346.67,346.07,346.26,344.51809212249714,NaN,NaN,NaN,NaN,NaN,343.9130200000002,346.61906574970334,341.20697425029704,345.32093498938116,345.5097617762897,348.5980262056055,342.42149734697387,49187,44606.23333333333,64.91377558160028,58.24471649430058,NaN,NaN,NaN,NaN,0.6277073225644328,23.201922600817518,91838665
2025-08-28T15:45:00-04:00,346.26,346.57,346.2,346.23,344.51809212249714,NaN,NaN,NaN,NaN,NaN,343.99222000000015,346.73285926258274,341.25158073741756,345.32093498938116,345.5176806215293,348.59211259517656,342.443248647882,51650,45255.1,64.44738395111798,59.42150289297478,NaN,NaN,NaN,NaN,0.6092996566669736,24.345659172900223,91787015
2025-08-28T15:50:00-04:00,346.26,346.68,346.03,346.4,344.51809212249714,NaN,NaN,NaN,NaN,NaN,344.09222000000017,346.81202285454077,341.37241714545956,345.32093498938116,345.5323285918664,348.5822396891475,342.4824174945853,93932,46931.333333333336,65.94073364576454,60.51623028980935,NaN,NaN,NaN,NaN,0.6122068240479065,24.921414601403374,91880947
2025-08-28T15:55:00-04:00,346.32,346.54,345.8,345.8,344.51809212249714,NaN,NaN,NaN,NaN,NaN,344.1828200000002,346.82111889725974,341.5445211027407,345.32093498938116,345.5443028231758,348.559500258264,342.52910538808766,130277,49929.2,56.862471861121655,61.17205731888527,NaN,NaN,NaN,NaN,0.6213349080444852,24.826990450171895,91750670
2025-08-29T09:30:00-04:00,347.21,348.72,346.27,346.73,345.17736406967,NaN,NaN,NaN,NaN,NaN,344.29822000000024,346.86638607860016,341.7300539214003,346.0329529418563,347.24,347.24,347.24,199545,54408.066666666666,64.92336603606589,62.51780765769831,NaN,NaN,NaN,NaN,0.7855252717555946,26.946087261381322,91950215
2025-08-29T09:35:00-04:00,346.72,346.84,344.67,345.7,NaN,NaN,NaN,348.2631979334968,348.2631979334968,348.2631979334968,344.38722000000024,346.83214543185363,341.94229456814685,346.0329529418563,346.5199418602121,347.2709436437053,345.7689400767189,183440,59310.73333333333,53.09063832982696,62.69572286966225,NaN,NaN,NaN,NaN,0.8844163237730492,26.240980794418533,91766775
2025-08-29T09:40:00-04:00,345.64,346.86,344.99,345.87,NaN,NaN,NaN,348.2631979334968,NaN,NaN,344.4620200000003,346.85441790989506,342.0696220901055,346.0329529418563,346.3484578686575,347.0427611925131,345.6541545448018,148658,63500.13333333333,54.562590787003295,62.72240244745895,NaN,NaN,NaN,NaN,0.9548151577892604,25.605488990465762,91915433
2025-08-29T09:45:00-04:00,345.75,345.785,343.38,344.87,NaN,NaN,NaN,347.45081671213245,NaN,NaN,344.5160200000002,346.8192679500632,342.2127720499372,346.0329529418563,345.98396047773934,346.90740399724706,345.06051695823163,148421,67798.33333333333,45.51514564626439,61.762233425497605,NaN,NaN,NaN,NaN,1.0644712179471711,24.380056792569185,91767012
2025-08-29T09:50:00-04:00,344.9,346.13,344.26,344.74,NaN,NaN,NaN,347.45081671213245,NaN,NaN,344.5564200000003,346.8023899052381,342.3104500947625,346.0329529418563,345.8401557658204,346.75501377041144,344.92529776122933,122733,68980.2,44.48250725137845,60.32863788632132,NaN,NaN,NaN,NaN,1.122008988093802,22.868184877144877,91644279
2025-08-29T09:55:00-04:00,344.82,345.1,343.15,343.44,NaN,NaN,NaN,347.2478051034099,NaN,NaN,344.5838200000003,346.73939567976635,342.4282443202342,346.0329529418563,345.5776380601973,346.6570807208267,344.49819539956786,125373,71764.76666666666,35.74815589248627,58.300406546440776,NaN,NaN,NaN,NaN,1.1811512032299623,22.454997406283983,91518906
2025-08-29T10:00:00-04:00,343.51,344.5,342.11,342.13,NaN,NaN,NaN,346.6117685078004,NaN,NaN,344.5824200000003,346.7442686198617,342.4205713801389,346.0329529418563,345.2021508587405,346.56611715672096,343.83818456076,152269,75754.46666666666,29.468783550478662,55.8444182881659,NaN,NaN,NaN,NaN,1.2674975458563924,22.819510911476673,91366637
2025-08-29T10:05:00-04:00,342.11,342.36,340.13,340.46,NaN,NaN,NaN,344.70555175744585,NaN,NaN,344.52762000000024,346.9500646791021,342.10517532089835,346.0329529418563,344.5569543028414,346.5271255567118,342.58678304897103,195067,81299.26666666666,23.74307310908887,52.60266037879975,NaN,NaN,NaN,NaN,1.3362477211523658,24.222490896496033,91171570
2025-08-29T10:10:00-04:00,340.4,340.51,338.54,339.35,NaN,NaN,NaN,343.09689031392554,NaN,NaN,344.4574000000003,347.2450378819436,341.669762118057,346.0329529418563,343.747358612787,346.3415542788874,341.1531629466867,241233,87389.03333333334,20.844115678219865,49.12935468284559,NaN,NaN,NaN,NaN,1.3815157410700518,26.146016168829732,90930337
2025-08-29T10:15:00-04:00,339.33,339.36,337.48,337.93,NaN,NaN,NaN,342.0858952996562,NaN,NaN,344.34980000000024,347.67062035661644,341.02897964338405,346.0329529418563,342.94139166044596,346.0264725657112,339.85631075518074,260942,95006.63333333333,17.842762802481573,45.884678865921366,NaN,NaN,NaN,NaN,1.4171217595650478,28.273490457890095,90669395
2025-08-29T10:20:00-04:00,337.88,339.15,337.86,338.86,NaN,NaN,NaN,342.0858952996562,NaN,NaN,344.2634000000003,347.91025422807803,340.6165457719225,343.605362353485,342.61958404591473,345.7967573475424,339.4424107442871,143152,98967.83333333333,25.41721879177814,43.06349623807692,NaN,NaN,NaN,NaN,1.4080416338818276,30.249002297731852,90812547
2025-08-29T10:25:00-04:00,338.83,339.85,337.94,339.7,NaN,NaN,NaN,342.0858952996562,NaN,NaN,344.19940000000025,348.04653173167895,340.35226826832155,343.33728988278807,342.3371023104377,345.5255090083609,339.1486956125144,170964,103689.33333333333,31.55522004423146,40.7140559590136,NaN,NaN,NaN,NaN,1.4438958028902704,31.307055130226537,90983511
2025-08-29T10:30:00-04:00,339.67,340.16,339.14,339.21,NaN,NaN,NaN,342.0858952996562,NaN,NaN,344.1072000000002,348.199440540476,340.0149594595244,341.94446552498437,342.1820555752886,345.3482908284855,339.01582032209166,121075,105862,30.00401485947073,38.14714747427833,NaN,NaN,NaN,NaN,1.413617531255254,31.956163704664732,90862436
2025-08-29T10:35:00-04:00,339.19,339.87,338.78,339.74,NaN,NaN,NaN,342.0858952996562,NaN,NaN,344.0306000000002,348.29975337754706,339.7614466224534,341.94446552498437,342.07575128525343,345.22388872351394,338.9276138469929,90046,107998.96666666666,33.79501003458111,36.49947162952544,NaN,NaN,NaN,NaN,1.3905019933084524,32.72359136491698,90952482
2025-08-29T10:40:00-04:00,339.67,339.92,338.62,338.62,NaN,NaN,NaN,342.0858952996562,NaN,NaN,343.9244000000002,348.45448990650726,339.3943100934932,340.7765724199875,341.95097342823414,345.0915423717339,338.81040448473436,99168,110577.6,30.08665851598704,34.01113537809123,NaN,NaN,NaN,NaN,1.3840375652149923,33.510599571073016,90853314
2025-08-29T10:45:00-04:00,338.61,339.41,338.51,338.65,NaN,NaN,NaN,342.0858952996562,NaN,NaN,343.81340000000023,348.57700134362864,339.0497986563718,339.84625793598997,341.8689511804086,345.007230940467,338.7306714203502,65407,111773.43333333333,30.307257640423742,32.38375104313386,NaN,NaN,NaN,NaN,1.3494634534139238,34.29475574498811,90918721
2025-08-29T10:50:00-04:00,338.68,338.94,338.19,338.53,NaN,NaN,NaN,342.0858952996562,NaN,NaN,343.7080000000002,348.6960449076848,338.7199550923156,337.522006348792,341.7915769518849,344.9331564874339,338.6499974163359,58958,112249.2,29.90084070308508,30.622197465711128,NaN,NaN,NaN,NaN,1.3066446353129293,35.1812707741063,90859763
2025-08-29T10:55:00-04:00,338.54,339.05,337.7,338.18,NaN,NaN,NaN,342.0070786676357,NaN,NaN,343.59300000000025,348.81492033651637,338.3710796634841,336.17361615383817,341.66629754466425,344.8182583257836,338.5143367635449,94304,114146.93333333333,28.692298075259558,29.420565496353635,NaN,NaN,NaN,NaN,1.3097414470762931,36.23969704639981,90765459
2025-08-29T11:00:00-04:00,338.09,338.83,338.03,338.595,NaN,NaN,NaN,342.006075091834,NaN,NaN,343.4917000000002,348.8977564592907,338.0856435407097,336.17361615383817,341.59003983125757,344.74178461877875,338.4382950437364,64364,114762.5,32.19194780558705,28.542668393082824,NaN,NaN,NaN,NaN,1.2733313437137015,37.22252144210093,90829823
2025-08-29T11:05:00-04:00,338.61,339.51,338.6,339.38,NaN,NaN,NaN,342.006075091834,NaN,NaN,343.4107000000002,348.93803064336555,337.88336935663483,336.6965649412897,341.5378660974246,344.67535158188406,338.4003806129652,58998,115160.26666666666,38.35495347122427,28.728868220135535,NaN,NaN,NaN,NaN,1.247736247734149,37.165941864451185,90888821
2025-08-29T11:10:00-04:00,339.38,339.67,339.16,339.18,NaN,NaN,NaN,342.006075091834,NaN,NaN,343.31210000000027,348.9605759325766,337.66362406742394,337.1642519530318,341.49360977569677,344.6147246776159,338.3724948737776,56304,113662.03333333334,37.421741472508714,29.296936643137684,NaN,NaN,NaN,NaN,1.1950408014674232,36.89503526302488,90832517
2025-08-29T11:15:00-04:00,339.19,339.47,338.66,338.89,NaN,NaN,NaN,342.006075091834,NaN,NaN,343.20730000000026,348.9841701596014,337.43042984039914,337.1642519530318,341.44282524526324,344.5518692064207,338.3337812841058,58378,113906.26666666666,36.051993022136145,30.176145208355347,NaN,NaN,NaN,NaN,1.167537887076893,36.97720283612414,90774139
2025-08-29T11:20:00-04:00,338.89,339.43,338.88,339.27,NaN,NaN,NaN,342.006075091834,NaN,NaN,343.1085000000002,348.98156878905695,337.2354312109435,337.2273212499403,341.40147395875357,344.4965952357814,338.30635268172574,53536,114329.7,39.19280594469,31.486765941674644,NaN,NaN,NaN,NaN,1.123428037999973,37.05350129685918,90827675
2025-08-29T11:25:00-04:00,339.28,339.63,338.83,338.93,NaN,NaN,NaN,342.006075091834,NaN,NaN,343.0113000000002,348.9958450320894,337.02675496791096,337.46785699995223,341.3435668105059,344.41988569636214,338.2672479246496,76187,114172.36666666667,37.42180111503696,32.88526867828574,NaN,NaN,NaN,NaN,1.10032603528569,36.813688957169305,90751488
2025-08-29T11:30:00-04:00,338.93,339.09,336.81,337.25,NaN,NaN,NaN,341.3911793692851,NaN,NaN,342.8565000000002,349.0258689305329,336.6871310694675,337.46785699995223,341.16442980910347,344.2650643142513,338.06379530395566,155276,116988.16666666667,30.167874615420047,33.22460123711731,NaN,NaN,NaN,NaN,1.1845884613367104,37.79975077898335,90596212
2025-08-29T11:35:00-04:00,337.29,337.29,335.71,335.89,NaN,NaN,NaN,340.00021667068125,NaN,NaN,342.67830000000026,349.12147363112837,336.23512636887216,337.46785699995223,340.88839157229125,344.1033946317461,337.6733885128364,188994,121927.93333333333,25.806770679086796,32.813997711035555,NaN,NaN,NaN,NaN,1.2128321426698054,39.17458856796969,90407218
2025-08-29T11:40:00-04:00,335.88,336.68,334.78,335.28,NaN,NaN,NaN,339.33020682201396,NaN,NaN,342.48970000000025,349.2291932777538,335.75020672224673,337.46785699995223,340.631989744256,343.9685045088529,337.29547497965905,169148,125926.63333333333,24.122363113543017,32.393879729183574,NaN,NaN,NaN,NaN,1.261915561050536,40.776356063957806,90238070
2025-08-29T11:45:00-04:00,335.29,335.71,334.83,335.38,NaN,NaN,NaN,338.8265610573769,NaN,NaN,342.30090000000024,349.29286615844455,335.3089338415559,337.46785699995223,340.4645072831011,343.8771403744952,337.05187419170704,113713,127995.4,24.986746421739056,31.764718042551998,NaN,NaN,NaN,NaN,1.2346358781183544,42.26371159594676,90351783
2025-08-29T11:50:00-04:00,335.35,336.25,335,335.65,NaN,NaN,NaN,338.8265610573769,NaN,NaN,342.12310000000025,349.32718297848817,334.91901702151233,337.46785699995223,340.28934660340593,343.7591263371531,336.8195668696588,136022,129398.4,27.391810383763826,31.572228890250337,NaN,NaN,NaN,NaN,1.235733315395615,42.87595506838019,90487805
2025-08-29T11:55:00-04:00,335.64,336.39,335.58,335.7,NaN,NaN,NaN,338.8265610573769,NaN,NaN,341.94310000000024,349.3281169641619,334.5580830358386,337.46785699995223,340.2039005166861,343.69304700783516,336.714754025537,74310,127532.83333333333,27.853124853638136,31.396933691194224,NaN,NaN,NaN,NaN,1.205323792867357,43.24775371499135,90562115
2025-08-29T12:00:00-04:00,335.65,336.09,335.59,335.7,NaN,NaN,NaN,338.8265610573769,NaN,NaN,341.76190000000025,349.3044759234433,334.2193240765572,337.46785699995223,340.10760262650416,343.6181289034974,336.5970763495109,85399,123727.96666666666,27.853124853638136,31.250668273376586,NaN,NaN,NaN,NaN,1.1549435219482602,43.59299531541598,90562115
2025-08-29T12:05:00-04:00,335.74,335.9,335.31,335.7,NaN,NaN,NaN,338.8265610573769,NaN,NaN,341.5763000000003,349.2485812279491,333.9040187720515,337.46785699995223,340.0292833676159,343.558014038678,336.5005526965538,69739,119937.93333333333,27.853124853638136,31.190727328975054,NaN,NaN,NaN,NaN,1.1145904132376685,44.06425197159906,90562115
2025-08-29T12:10:00-04:00,335.68,336.6,335.67,336.53,NaN,NaN,NaN,338.8265610573769,NaN,NaN,341.4221000000002,349.1834385675999,333.66076143240053,337.46785699995223,339.93300826703637,343.46660506969516,336.3994114643776,104541,118467.36666666667,36.2506167677933,31.48063225484693,NaN,NaN,NaN,NaN,1.1014053837206927,43.444054895471965,90666656
2025-08-29T12:15:00-04:00,336.57,336.93,336.2,336.42,NaN,NaN,NaN,338.8265610573769,NaN,NaN,341.26930000000027,349.1172286465174,333.42137135348315,336.2202855999618,339.87058382960385,343.40152126197756,336.3396463972301,76044,116054.8,35.65824908204324,31.288010512762575,NaN,NaN,NaN,NaN,1.0748764277406446,42.407154600765956,90590612
2025-08-29T12:20:00-04:00,336.36,336.39,335.69,336.12,NaN,NaN,NaN,338.8265610573769,NaN,NaN,341.1057000000003,349.0347186051461,333.1766813948545,334.673232646818,339.8156779501599,343.35027909958393,336.2810768007359,60950,113995.36666666667,34.02523350829715,31.045402801033173,NaN,NaN,NaN,NaN,1.0502423971877428,41.81750641682376,90529662
2025-08-29T12:25:00-04:00,336.1,336.2,335.66,335.87,NaN,NaN,NaN,338.8265610573769,NaN,NaN,340.9425000000002,348.9594620805482,332.92553791945227,334.673232646818,339.7728945065839,343.3115126524939,336.2342763606739,46768,111375.2,32.682027158773906,30.80469095365016,NaN,NaN,NaN,NaN,1.01379651167433,41.29177742319271,90482894
2025-08-29T12:30:00-04:00,335.9,336.59,335.79,335.98,NaN,NaN,NaN,338.8265610573769,NaN,NaN,340.78450000000026,348.8747178586775,332.694282141323,334.673232646818,339.7355167239124,343.2751255232614,336.19590792456336,44138,107770.83333333333,33.91814872304502,30.42792972353266,NaN,NaN,NaN,NaN,0.9985253322690174,40.21833905340487,90527032
2025-08-29T12:35:00-04:00,335.99,336.3,335.71,336.26,NaN,NaN,NaN,338.8265610573769,NaN,NaN,340.62450000000024,348.74980522509316,332.4991947749073,334.673232646818,339.6898761293511,343.2305362886074,336.14921597009476,54689,103091.56666666667,37.08504662238793,30.403875831200587,NaN,NaN,NaN,NaN,0.9693449513926613,39.29153486816116,90581721
2025-08-29T12:40:00-04:00,336.21,336.21,335.66,335.709,NaN,NaN,NaN,338.8265610573769,NaN,NaN,340.44688000000025,348.6058839553453,332.2878760446552,334.673232646818,339.6447403534823,343.18866292892596,336.1008177780386,52090,96786.8,33.6658813049216,30.653733451879265,NaN,NaN,NaN,NaN,0.9429631691503259,38.47698225681694,90529631
2025-08-29T12:45:00-04:00,335.71,335.93,335.39,335.43,NaN,NaN,NaN,338.59379195199136,NaN,NaN,340.25388000000027,348.42190376730724,332.0858562326933,334.673232646818,339.5835784557297,343.13532652892474,336.0318303825347,67585,90341.56666666667,32.05432602334028,31.099987405040228,NaN,NaN,NaN,NaN,0.9141800856395897,37.97303688787724,90462046
2025-08-29T12:50:00-04:00,335.42,335.9,335.3,335.69,NaN,NaN,NaN,338.4822559541736,NaN,NaN,340.0522800000002,348.1631465188966,331.94141348110384,334.673232646818,339.5345137300215,343.0911883814517,335.97783907859133,56396,87449.7,35.168857491172005,31.889022717728015,NaN,NaN,NaN,NaN,0.8917386509510452,37.58977127801039,90518442
2025-08-29T12:55:00-04:00,335.73,335.88,335.41,335.58,NaN,NaN,NaN,338.46033522898387,NaN,NaN,339.8490800000003,347.88855044867717,331.80960955132343,334.673232646818,339.48013617792446,343.0415663266005,335.9187060292484,64071,83886.6,34.44938140965036,32.56492521686454,NaN,NaN,NaN,NaN,0.861614461597397,37.23388178313402,90454371
2025-08-29T13:00:00-04:00,335.56,335.56,333.76,333.88,NaN,NaN,NaN,337.59554726403,NaN,NaN,339.6122800000002,347.64357910334365,331.5809808966568,334.673232646818,339.3108376270232,342.9291919146126,335.6924833394338,158872,85146.5,25.699176437241434,32.44402279211294,NaN,NaN,NaN,NaN,0.9300705714832967,38.197263059861704,90295499
2025-08-29T13:05:00-04:00,333.95,334.35,333.69,334.19,NaN,NaN,NaN,336.91211329748324,NaN,NaN,339.36768000000023,347.2990691690782,331.43629083092225,334.5849351151708,339.234886099019,342.881018450911,335.588753747127,70195,84484.8,29.229283266267856,32.54231982158649,NaN,NaN,NaN,NaN,0.9107798163773487,39.13453152843259,90365694
2025-08-29T13:10:00-04:00,334.19,334.26,333.19,333.21,NaN,NaN,NaN,336.6315626930522,NaN,NaN,339.1024800000003,346.9525459792855,331.2524140207151,334.5849351151708,339.1039356057759,342.80727515398326,335.4005960575686,114126,84983.4,25.15970963494391,32.349933020251186,NaN,NaN,NaN,NaN,0.922152686636109,40.301635761308546,90251568
2025-08-29T13:15:00-04:00,333.21,333.5,332.67,333.27,NaN,NaN,NaN,335.9726280251862,NaN,NaN,338.8466800000003,346.6062328473784,331.08712715262214,334.5849351151708,338.96800452155446,342.73537579768004,335.2006332454289,115622,86657.23333333334,25.84049067221126,32.206173435863555,NaN,NaN,NaN,NaN,0.9155703518763858,41.66287540088324,90367190
2025-08-29T13:20:00-04:00,333.28,334.07,333.28,333.84,NaN,NaN,NaN,335.9726280251862,NaN,NaN,338.59828000000033,346.1859418695768,331.01061813042384,334.4009480921367,338.889774101871,342.682498934162,335.09704926958,76827,87252.86666666667,32.154448172311106,31.91358996475768,NaN,NaN,NaN,NaN,0.907315326742359,41.86394837601411,90444017
2025-08-29T13:25:00-04:00,333.86,334.17,333.69,333.74,NaN,NaN,NaN,335.9726280251862,NaN,NaN,338.3484800000003,345.7343984424948,330.96256155750575,334.3907584737093,338.8410077302765,342.6472774391782,335.0347380213748,50430,85790.4,31.645404220449464,31.626958188929553,NaN,NaN,NaN,NaN,0.8767928034036204,41.87174426110126,90393587
2025-08-29T13:30:00-04:00,333.73,334.35,333.72,333.93,NaN,NaN,NaN,335.9726280251862,NaN,NaN,338.0990800000003,345.2179752159097,330.9801847840909,334.3007483385392,338.7945973575215,342.6118366445536,334.97735807048946,50281,85320.96666666666,33.79014659174007,31.610166266318327,NaN,NaN,NaN,NaN,0.8591647460176473,41.54925784314082,90443868
2025-08-29T13:35:00-04:00,333.92,334.32,333.71,333.96,NaN,NaN,NaN,335.9726280251862,NaN,NaN,337.86228000000034,344.72381024382975,331.00074975617093,334.3007483385392,338.7467671176479,342.57472398487045,334.91881025042534,52811,85114.73333333334,34.14152206126744,31.714415902210725,NaN,NaN,NaN,NaN,0.8413672641592448,41.258493525074236,90496679
2025-08-29T13:40:00-04:00,333.94,334.11,333.46,334.04,NaN,NaN,NaN,335.9726280251862,NaN,NaN,337.6084800000003,344.0660963434354,331.15086365656526,334.3007483385392,338.70091881183333,342.5397965799639,334.8620410437028,50277,84913.83333333333,35.13017745073938,31.80098938276032,NaN,NaN,NaN,NaN,0.8276981738621583,41.21033834423932,90546956
2025-08-29T13:45:00-04:00,334.06,334.4,333.59,333.98,NaN,NaN,NaN,335.9726280251862,NaN,NaN,337.37408000000033,343.481165155382,331.2669948446187,333.38659867083135,338.6401682567937,342.4910693517432,334.7892671618442,69865,85296.73333333334,34.70932930571328,31.63129528871213,NaN,NaN,NaN,NaN,0.82643401858629,40.57888563417482,90477091
2025-08-29T13:50:00-04:00,333.96,334.26,333.75,333.86,NaN,NaN,NaN,335.9726280251862,NaN,NaN,337.13388000000026,342.81535455007923,331.4524054499213,332.58108280676674,338.60077771257914,342.45922953308775,334.74232589207054,45952,85043.93333333333,33.836272961424754,31.6434661213195,NaN,NaN,NaN,NaN,0.8038315886872686,39.99253668911492,90431139
2025-08-29T13:55:00-04:00,333.81,333.97,333.35,333.56,NaN,NaN,NaN,335.9726280251862,NaN,NaN,336.9076800000003,342.2282525773677,331.5871074226329,332.58108280676674,338.5526096771497,342.4231077330535,334.6821116212459,53426,84285.23333333334,31.690194260962002,31.61745670972105,NaN,NaN,NaN,NaN,0.7907007609238926,39.86099475799702,90377713
2025-08-29T14:00:00-04:00,333.55,333.59,332.99,333.33,NaN,NaN,NaN,335.8387111566355,NaN,NaN,336.67948000000035,341.60051202580075,331.75844797419995,332.58108280676674,338.4842251383342,342.3752259704667,334.59322430620165,72822,81536.76666666666,30.1132649197676,31.256342954620738,NaN,NaN,NaN,NaN,0.777079278000755,40.07685442913685,90304891
2025-08-29T14:05:00-04:00,333.35,333.99,333.27,333.89,NaN,NaN,NaN,335.8387111566355,NaN,NaN,336.48848000000027,341.07506452873207,331.90189547126846,332.58108280676674,338.4541555351242,342.35118679912915,334.5571242711192,35480,76419.63333333333,38.17939888299643,31.522772774145455,NaN,NaN,NaN,NaN,0.7730021867149889,39.421302972305206,90340371
2025-08-29T14:10:00-04:00,333.79,333.95,333.43,333.71,NaN,NaN,NaN,335.8387111566355,NaN,NaN,336.32008000000025,340.6783800877918,331.96177991220867,332.58108280676674,338.4168389124304,342.32117899267405,334.5124988321868,44473,72263.8,36.71265062370739,32.309449501750166,NaN,NaN,NaN,NaN,0.7549306019496312,38.812576619532955,90295898
2025-08-29T14:15:00-04:00,333.68,333.73,333.26,333.46,NaN,NaN,NaN,335.8387111566355,NaN,NaN,336.18008000000026,340.44618703748006,331.91397296252046,332.58108280676674,338.38551429345694,342.2971177416365,334.4739108452774,36230,69681.03333333334,34.717710959616866,32.70148005127509,NaN,NaN,NaN,NaN,0.7345784160960881,38.44327761166313,90259668
2025-08-29T14:20:00-04:00,333.45,333.51,332.77,332.92,NaN,NaN,NaN,335.56804698472456,NaN,NaN,336.0514800000003,340.31526889241815,331.7876911075825,332.58108280676674,338.31088862468874,342.2450112297882,334.3767660195893,81198,67853.56666666667,30.821788581101913,33.10591426171495,NaN,NaN,NaN,NaN,0.7349656720892253,38.62036381967556,90178470
2025-08-29T14:25:00-04:00,332.89,333.1,332.46,332.68,NaN,NaN,NaN,335.1849539399643,NaN,NaN,335.94648000000024,340.27808927593406,331.6148707240664,332.58108280676674,338.2385617930521,342.19751989837744,334.27960368772676,76217,67917.13333333333,29.25071040529535,33.34950138550668,NaN,NaN,NaN,NaN,0.7281824097971408,39.07828492816566,90102253
2025-08-29T14:30:00-04:00,332.7,333.04,332.62,332.92,NaN,NaN,NaN,335.1829105790569,NaN,NaN,335.82768000000027,340.158968924927,331.4963910750735,332.58108280676674,338.1806395416418,342.1571637637192,334.20411531956444,63832,67198.23333333334,32.93232154618717,33.40506376935497,NaN,NaN,NaN,NaN,0.7061693805259176,39.50349738604931,90166085
2025-08-29T14:35:00-04:00,332.93,333.02,332.2,332.361,NaN,NaN,NaN,334.9677782800089,NaN,NaN,335.68090000000024,339.97458453905284,331.38721546094763,332.5498662454134,338.1230750346132,342.119808350781,334.12634171844536,60972,66906,29.1300563333119,33.22539606313085,NaN,NaN,NaN,NaN,0.7143001390597802,40.28514336293876,90105113
2025-08-29T14:40:00-04:00,332.4,332.48,331.94,332.16,NaN,NaN,NaN,334.53424290364484,NaN,NaN,335.5399000000002,339.8237741952769,331.25602580472355,332.35080921412134,338.0434816780168,342.07152053203805,334.01544282399556,81473,66137.06666666667,27.883433045459157,32.80348795268222,NaN,NaN,NaN,NaN,0.7018501291269402,41.22909698352545,90023640
2025-08-29T14:45:00-04:00,332.15,332.4,331.85,331.95,NaN,NaN,NaN,334.41859549893366,NaN,NaN,335.3841000000003,339.61188983876883,331.1563101612317,332.35080921412134,337.9682804813201,342.0259594717421,333.9106014908981,77344,66180.4,26.602506038957074,32.26498680823148,NaN,NaN,NaN,NaN,0.6910036913321556,42.180218298259625,89946296
2025-08-29T14:50:00-04:00,331.96,332.27,331.71,331.74,NaN,NaN,NaN,334.2557047944367,NaN,NaN,335.24650000000025,339.4918674942074,331.0011325057931,332.35080921412134,337.9004719464981,341.98544515648234,333.81549873651386,69543,66466.83333333333,25.348457466206057,31.566292523621957,NaN,NaN,NaN,NaN,0.6816462848084303,43.18112607657119,89876753
2025-08-29T14:55:00-04:00,331.77,332.5,331.74,332.5,NaN,NaN,NaN,334.2557047944367,NaN,NaN,335.1235000000002,339.32342680424216,330.92357319575825,332.35080921412134,337.84733344939036,341.94950126030886,333.74516563847186,58983,66874,36.935120095821624,31.725277580058265,NaN,NaN,NaN,NaN,0.6872429787506845,43.43799208174614,89935736
2025-08-29T15:00:00-04:00,332.48,332.77,332.4,332.465,NaN,NaN,NaN,334.2557047944367,NaN,NaN,335.00220000000024,339.15160969306646,330.852790306934,332.2156473712971,337.79054281532626,341.90702730238786,333.67405832826466,67943,67667.5,36.65297794244625,31.92647079298837,NaN,NaN,NaN,NaN,0.6645827659827788,42.93409921814742,89867793
2025-08-29T15:05:00-04:00,332.48,332.57,331.9,332.18,NaN,NaN,NaN,334.2557047944367,NaN,NaN,334.88220000000024,339.00400940861294,330.76039059138753,331.92851789703764,337.7241852451134,341.8605088323985,333.5878616578283,76431,68392.23333333334,34.351853352683705,32.11658929953992,NaN,NaN,NaN,NaN,0.6649697112697243,43.028509132220435,89791362
2025-08-29T15:10:00-04:00,332.17,332.4,331.96,332.3,NaN,NaN,NaN,334.2557047944367,NaN,NaN,334.7563000000002,338.8006218715939,330.7119781284065,331.5618514541041,337.6742156104741,341.82468458397426,333.52374663697395,58818,68616.5,36.16897399697807,32.549139947912096,NaN,NaN,NaN,NaN,0.6489004461790294,43.11617548100252,89850180
2025-08-29T15:15:00-04:00,332.3,332.48,332.15,332.39,NaN,NaN,NaN,334.2557047944367,NaN,NaN,334.61650000000026,338.4915516333139,330.7414483666866,331.5618514541041,337.629690148922,341.7911955770871,333.46818472075694,54535,68181.5,37.56481717135499,32.50524125422342,NaN,NaN,NaN,NaN,0.6261218428805302,42.96628334970977,89904715
2025-08-29T15:20:00-04:00,332.41,332.58,332.2,332.21,NaN,NaN,NaN,334.2557047944367,NaN,NaN,334.47710000000023,338.1832506338732,330.7709493661273,331.42748116328323,337.56933656587273,341.7451142183071,333.39355891343837,75260,68810.3,35.875105262030615,32.44541658553222,NaN,NaN,NaN,NaN,0.6085417112462063,42.53165378055455,89829455
2025-08-29T15:25:00-04:00,332.21,332.43,331.88,332.13,NaN,NaN,NaN,334.2028655741997,NaN,NaN,334.34190000000024,337.88382768432587,330.7999723156746,331.3552708567386,337.4870851896884,341.68373725153367,333.29043312784313,101784,70067.4,35.119011194811165,32.474080888046096,NaN,NaN,NaN,NaN,0.6043601604429066,42.54194911437664,89727671
2025-08-29T15:30:00-04:00,332.14,332.97,332.12,332.85,NaN,NaN,NaN,334.2028655741997,NaN,NaN,334.2135000000002,337.48679698637824,330.9402030136221,331.5411733483128,337.4190456773963,341.6248793333303,333.2132120214623,95670,67960.66666666667,46.124327798866695,33.56711940360073,NaN,NaN,NaN,NaN,0.6219058632684149,41.09441136617365,89823341
2025-08-29T15:35:00-04:00,332.86,333.02,332.29,332.89,NaN,NaN,NaN,334.2028655741997,NaN,NaN,334.0927000000002,337.09546622484345,331.08993377515696,331.5411733483128,337.34919153148115,341.56200141640795,333.13638164655436,103000,69054.16666666667,46.66558636658044,34.81103911512109,NaN,NaN,NaN,NaN,0.6296268730349539,39.627498668647156,89926341
2025-08-29T15:40:00-04:00,332.92,333.25,332.63,333.14,NaN,NaN,NaN,334.2028655741997,NaN,NaN,334.01050000000015,336.88534002357653,331.13565997642377,331.73355094292015,337.2912814347815,341.5054495350263,333.07711333453676,93382,68362.7,50.043647495739926,36.03327668294629,NaN,NaN,NaN,NaN,0.6289392392467432,37.70476516543741,90019723
2025-08-29T15:45:00-04:00,333.14,333.85,333.14,333.53,NaN,NaN,NaN,334.2028655741997,NaN,NaN,333.9633000000002,336.790252882711,331.13634711728935,332.28184075433614,337.2442804333557,341.45312033417434,333.03544053253705,88057,67443.86666666667,54.84811386886881,37.87028079262892,NaN,NaN,NaN,NaN,0.6347292935862642,35.34851251308246,90107780
2025-08-29T15:50:00-04:00,333.71,334.48,332.8,333.2,331.43577732956976,331.43577732956976,331.43577732956976,NaN,NaN,NaN,333.9217000000001,336.73108687283406,331.11231312716615,332.3854726034689,337.153943382616,341.35137040503275,332.9565163601992,174981,70715.66666666667,50.42868548621179,39.48065596696839,NaN,NaN,NaN,NaN,0.7093914869015315,34.17338718390433,89932799
2025-08-29T15:55:00-04:00,333.19,334.37,333.09,333.86,331.45142381458936,NaN,NaN,NaN,NaN,NaN,333.8913000000001,336.6696324857322,331.112967514268,332.3854726034689,337.0925375919379,341.27609940428835,332.9089757795875,134413,73515.1,57.75944104599042,41.70615132461363,NaN,NaN,NaN,NaN,0.7501492378371386,33.082199378238926,90067212
2025-09-02T09:30:00-04:00,328.24,328.88,325.59,327.96,NaN,NaN,NaN,330.53773181334657,330.53773181334657,330.53773181334657,333.7375000000001,336.9299124359623,330.54508756403794,332.3854726034689,327.4766666666667,327.4766666666667,327.4766666666667,220393,79185.5,23.831340894701427,41.597785855220444,NaN,NaN,NaN,NaN,1.2872814351344886,35.0818121997002,89846819
2025-09-02T09:35:00-04:00,327.96,330.7,327.87,329.83,325.7464832690783,325.7464832690783,325.7464832690783,NaN,NaN,NaN,333.6201000000001,336.94421463721335,330.29598536278684,332.3854726034689,328.4153119793652,329.4087147925399,327.42190916619046,196766,83984,36.552467497074964,41.57045352673854,NaN,NaN,NaN,NaN,1.3974756183391668,35.218511417450856,90043585
2025-09-02T09:40:00-04:00,329.8,331.7,329.72,331.11,327.0623249386657,NaN,NaN,NaN,NaN,NaN,333.5283000000001,336.87105314693264,330.1855468530676,332.3854726034689,329.0516275996752,330.418490535828,327.6847646635224,148152,87246.5,43.507413610899434,42.060056074485196,NaN,NaN,NaN,NaN,1.439084502743509,34.55016049585605,90191737
2025-09-02T09:45:00-04:00,331.11,332.41,330.84,332.12,327.92903744145354,NaN,NaN,NaN,NaN,NaN,333.45670000000007,336.76348916795973,330.1499108320404,332.3854726034689,329.5490734800232,331.17500725849806,327.92313970154834,125489,89100.63333333333,48.3212073623419,43.05786707517507,NaN,NaN,NaN,NaN,1.4484356096904047,33.403567738019504,90317226
2025-09-02T09:50:00-04:00,332.1,332.77,331.5,332.43,328.4338539213875,NaN,NaN,NaN,NaN,NaN,333.3747000000001,336.5741802392547,330.17521976074545,332.3854726034689,329.93112993312144,331.7050956699886,328.15716419625426,114640,91390.23333333334,49.73690418737526,44.027004945917724,NaN,NaN,NaN,NaN,1.4356902089982317,32.076839761640386,90431866
2025-09-02T09:55:00-04:00,332.5,332.66,331.37,332.06,328.4338539213875,NaN,NaN,NaN,NaN,NaN,333.2875000000001,336.3863102816003,330.18868971839987,332.3854726034689,330.11577654026445,331.91120356907226,328.32034951145664,77693,92199.13333333333,48.0451691665484,44.77560151700296,NaN,NaN,NaN,NaN,1.4252837654983597,30.917249352494853,90354173
2025-09-02T10:00:00-04:00,332.02,333.32,330.94,331.05,328.4338539213875,NaN,NaN,NaN,NaN,NaN,333.18610000000007,336.23899458077864,330.1332054192215,332.3854726034689,330.32447384400245,332.0904156897549,328.55853199825003,127502,94021.8,43.67781120004711,45.332937655432715,NaN,NaN,NaN,NaN,1.4934777822484764,29.335170389164674,90226671
2025-09-02T10:05:00-04:00,331.12,332,330.42,331.29,328.4338539213875,NaN,NaN,NaN,NaN,NaN,333.09450000000004,336.0941588408389,330.0948411591612,332.3854726034689,330.3790757014931,332.10496882603206,328.6531825769541,64346,94984,44.95818379561881,46.035735698347544,NaN,NaN,NaN,NaN,1.4996579406592985,28.187127264742738,90291017
2025-09-02T10:10:00-04:00,331.26,332.17,330.9,331.46,328.4338539213875,NaN,NaN,NaN,NaN,NaN,333.0041000000001,335.92178794103154,330.0864120589687,332.0543780827751,330.4358507392355,332.1358960029985,328.7358054754725,56819,95395.53333333334,45.896405188013226,46.01945551185802,NaN,NaN,NaN,NaN,1.48325380204078,26.983160609595817,90347836
2025-09-02T10:15:00-04:00,331.48,333.25,331.14,331.93,328.4338539213875,NaN,NaN,NaN,NaN,NaN,332.91750000000013,335.6972714224706,330.1377285775297,328.6454241902104,330.54042420131304,332.2354320454106,328.84541635721547,75567,96706.76666666666,48.509603856966145,46.151171046885565,NaN,NaN,NaN,NaN,1.5280213876092965,25.07705806706421,90423403
2025-09-02T10:20:00-04:00,331.94,332.67,331.43,331.69,328.4338539213875,NaN,NaN,NaN,NaN,NaN,332.8371200000001,335.5201086514297,330.15413134857044,328.6454241902104,330.59814219106823,332.2805771820176,328.91570720011885,52323,95744.26666666666,47.25447781149217,45.951944640867865,NaN,NaN,NaN,NaN,1.5074484313514902,23.30710570614201,90371080
2025-09-02T10:25:00-04:00,331.62,332.86,331.3,332.77,328.4338539213875,NaN,NaN,NaN,NaN,NaN,332.78392000000014,335.3626067618047,330.20523323819555,328.6454241902104,330.67430636317533,332.35633785213827,328.9922748742124,58656,95158.9,53.13126594547973,45.829312646340085,NaN,NaN,NaN,NaN,1.511202114826384,21.81219036479631,90429736
2025-09-02T10:30:00-04:00,332.76,332.79,331.58,331.62,328.4338539213875,NaN,NaN,NaN,NaN,NaN,332.70252000000016,335.16338860263,330.24165139737033,328.80665718538773,330.7206033039643,332.3907093043272,329.05049730360145,47831,94625.53333333334,47.11198506216843,45.59240547319413,NaN,NaN,NaN,NaN,1.4896876780530732,20.42405469068959,90381905
2025-09-02T10:35:00-04:00,331.64,332.53,331.5,332.44,328.4338539213875,NaN,NaN,NaN,NaN,NaN,332.63972000000007,334.9598969259396,330.31954307406056,328.82832574831014,330.76962177974417,332.4315594128996,329.1076841465887,48281,94202.5,51.34475626348635,45.13421370301527,NaN,NaN,NaN,NaN,1.4568528439064232,19.061305119125457,90430186
2025-09-02T10:40:00-04:00,332.41,332.55,330.85,330.945,328.4338539213875,NaN,NaN,NaN,NaN,NaN,332.58102000000014,334.9211355355003,330.2409044645,328.82832574831014,330.80123907168013,332.4302966403657,329.17218150299453,69111,93790.43333333333,44.3722210204786,46.60141942628506,NaN,NaN,NaN,NaN,1.4742204979131066,18.19079501942695,90361075
2025-09-02T10:45:00-04:00,331,331.23,330.5,330.87,328.4338539213875,NaN,NaN,NaN,NaN,NaN,332.51462000000015,334.8567572085004,330.1724827914999,328.82832574831014,330.8038618498753,332.3999852730002,329.20773842675044,61955,93277.46666666666,44.04904740528204,47.13688941972843,NaN,NaN,NaN,NaN,1.4210618909193147,17.68125978850064,90299120
2025-09-02T10:50:00-04:00,330.8,331.64,330.71,331.46,328.4338539213875,NaN,NaN,NaN,NaN,NaN,332.47962000000024,334.83142787974316,330.1278121202573,328.82832574831014,330.8141286044928,332.39405861992395,329.23419858906163,34807,92119.6,47.30070611830914,47.4078388845434,NaN,NaN,NaN,NaN,1.3859860415679355,16.78270441737936,90333927
2025-09-02T10:55:00-04:00,331.43,331.46,330.3,330.76,328.4338539213875,NaN,NaN,NaN,NaN,NaN,332.42942000000016,334.8184598773229,330.04038012267745,328.82832574831014,330.8148511174139,332.37256932041714,329.2571329144107,45402,91666.9,44.03115409305992,47.10140650816612,NaN,NaN,NaN,NaN,1.3698441814559377,16.318437297520376,90288525
2025-09-02T11:00:00-04:00,330.74,331.31,329.76,329.81,328.4338539213875,NaN,NaN,NaN,NaN,NaN,332.3488200000002,334.8128119056926,329.8848280943078,328.82832574831014,330.790841050578,332.3161995741037,329.26548252705237,78459,92017.43333333333,39.991040460172385,46.40527338479449,NaN,NaN,NaN,NaN,1.3827124542090858,16.347950309749667,90210066
2025-09-02T11:05:00-04:00,329.83,329.9,328.82,329.589,328.4338539213875,NaN,NaN,NaN,NaN,NaN,332.2658000000002,334.81495374214273,329.71664625785763,328.82832574831014,330.7358576897144,332.2536596024602,329.21805577696864,72105,91873.23333333334,39.09241369582277,45.76579085117123,NaN,NaN,NaN,NaN,1.361090136051293,17.08161873596783,90137961
2025-09-02T11:10:00-04:00,329.62,329.98,328.94,329.13,328.4338539213875,NaN,NaN,NaN,NaN,NaN,332.1698000000002,334.82053861425067,329.5190613857497,328.82832574831014,330.6924924573147,332.2057187328459,329.1792661817835,57378,91825.23333333334,37.2216564442838,45.30463694004528,NaN,NaN,NaN,NaN,1.3381551263333449,17.66551066312754,90080583
2025-09-02T11:15:00-04:00,329.15,329.3,328.16,328.33,NaN,NaN,NaN,332.548670007195,332.548670007195,332.548670007195,332.05720000000014,334.86768750241004,329.24671249759024,328.82832574831014,330.6163796212938,332.15274566153016,329.0800135810574,69102,92310.8,34.153858766902374,44.532899437994104,NaN,NaN,NaN,NaN,1.324001188738105,18.74992769595,90011481
2025-09-02T11:20:00-04:00,328.36,328.73,327.9,328.46,NaN,NaN,NaN,332.0732759159589,NaN,NaN,331.9456000000001,334.8730032727451,329.01819672725514,328.82832574831014,330.5206224018574,332.09118785832095,328.95005694539384,84460,92617.46666666666,35.09008351505882,43.76101931849736,NaN,NaN,NaN,NaN,1.288715389542529,19.925613051886973,90095941
2025-09-02T11:25:00-04:00,328.5,328.82,328.13,328.42,NaN,NaN,NaN,332.0732759159589,NaN,NaN,331.8344000000002,334.8648313093994,328.803968690601,328.73866059864815,330.4707704109426,332.05428037214506,328.8872604497401,49187,90864.23333333334,34.92553492067256,42.790728680190675,NaN,NaN,NaN,NaN,1.2459500045752052,20.89231690338501,90046754
2025-09-02T11:30:00-04:00,328.35,328.48,327.88,328.26,NaN,NaN,NaN,331.7760117333427,NaN,NaN,331.7224000000002,334.85723657005565,328.5875634299448,328.4437427831348,330.4272073702165,332.02595408671215,328.8284606537208,39951,89006.93333333333,34.23400315236768,41.860694775967495,NaN,NaN,NaN,NaN,1.1998107185341207,21.967139115737734,90006803
2025-09-02T11:35:00-04:00,328.22,328.38,327.47,327.62,NaN,NaN,NaN,331.4816475636453,NaN,NaN,331.60360000000014,334.8970752953617,328.3101247046386,328.4437427831348,330.3336776621337,331.97653281626975,328.69082250799767,77361,88152.3,31.543556402466123,40.3187155228951,NaN,NaN,NaN,NaN,1.1791099529245384,23.24782413388453,89929442
2025-09-02T11:40:00-04:00,327.67,327.89,327.4,327.61,NaN,NaN,NaN,331.106799947116,NaN,NaN,331.48920000000015,334.9289820862829,328.04941791371743,328.32299422650783,330.26887145406744,331.94368457518203,328.59405833295284,52959,86804.86666666667,31.50189746992335,39.203709266306156,NaN,NaN,NaN,NaN,1.129887813429929,24.48524103254924,89876483
2025-09-02T11:45:00-04:00,327.57,327.96,327.42,327.65,NaN,NaN,NaN,331.0680817677016,NaN,NaN,331.36440000000016,334.89821520754913,327.8305847924512,328.0253953812063,330.2321699569079,331.92305004218315,328.54128987163267,31692,84926.03333333334,31.88938431376684,37.81403984132619,NaN,NaN,NaN,NaN,1.0877529696135029,25.514294741484893,89908175
2025-09-02T11:50:00-04:00,327.58,327.58,327.04,327.41,NaN,NaN,NaN,330.61771441462423,NaN,NaN,331.2384000000001,334.87641884562964,327.6003811543706,326.92585304397204,330.17356594810076,331.8960461880349,328.4510857081666,46349,80638.3,30.764858882390243,36.84208540289131,NaN,NaN,NaN,NaN,1.0536277574982496,26.75484216053424,89861826
2025-09-02T11:55:00-04:00,327.39,328.48,327.29,328.47,NaN,NaN,NaN,330.61771441462423,NaN,NaN,331.13860000000017,334.80106140199536,327.476138598005,326.92585304397204,330.11044858173034,331.84412869245864,328.37676847100204,71022,78525.26666666666,40.70946964302207,36.60354413415845,NaN,NaN,NaN,NaN,1.06336863196266,26.44976104723081,89932848
2025-09-02T12:00:00-04:00,328.43,329.34,328.43,329.17,NaN,NaN,NaN,330.61771441462423,NaN,NaN,331.06360000000006,334.7306537930894,327.3965462069107,327.20105257230705,330.07638998195915,331.7946544919963,328.358125471922,73180,73618.16666666667,46.2046597820727,36.525255110141565,NaN,NaN,NaN,NaN,1.0524137296796108,25.04580462904102,90006028
2025-09-02T12:05:00-04:00,329.21,329.75,328.79,328.79,NaN,NaN,NaN,330.61771441462423,NaN,NaN,330.9858000000001,334.67735696167506,327.29424303832513,327.55884205784565,330.0548196157529,331.7597867923782,328.3498524391276,55453,68907.73333333334,43.8298044353284,36.510872991732164,NaN,NaN,NaN,NaN,1.0458127489882085,23.2714190000449,89950575
2025-09-02T12:10:00-04:00,328.85,329.73,328.85,329.35,NaN,NaN,NaN,330.61771441462423,NaN,NaN,330.9144,334.59162421420564,327.23717578579436,327.55884205784565,330.04080876896353,331.7326923954742,328.34892514245286,47630,65557,48.06614674499626,37.08766629779102,NaN,NaN,NaN,NaN,1.0382546954890506,21.623775201691366,89998205
2025-09-02T12:15:00-04:00,329.41,329.86,329.41,329.69,NaN,NaN,NaN,330.61771441462423,NaN,NaN,330.86098000000004,334.5301874675486,327.19177253245147,327.82665891702123,330.03549656300964,331.7163464898753,328.35464663614397,35196,62547.23333333333,50.50680071506567,37.902979656308354,NaN,NaN,NaN,NaN,1.000522217239832,20.223429381902072,90033401
2025-09-02T12:20:00-04:00,329.68,329.83,329.24,329.46,NaN,NaN,NaN,330.61771441462423,NaN,NaN,330.80698000000007,334.4775988578873,327.13636114211283,327.908327133617,330.0312104918696,331.7058588067693,328.35656217696993,21111,59429.6,48.83486618039638,38.732494637459254,NaN,NaN,NaN,NaN,0.9711992017226994,18.855489250635014,90012290
2025-09-02T12:25:00-04:00,329.42,329.53,329.07,329.24,NaN,NaN,NaN,330.61771441462423,NaN,NaN,330.75278000000003,334.434302343801,327.07125765619907,327.908327133617,330.0256502247827,331.69533139102293,328.3559690585424,19301,57483.2,47.224529889721545,39.66611400337491,NaN,NaN,NaN,NaN,0.9346849730282194,17.80855259798226,89992989
2025-09-02T12:30:00-04:00,329.24,329.53,328.84,328.86,NaN,NaN,NaN,330.61771441462423,NaN,NaN,330.6951800000001,334.4031412661999,326.9872187338003,327.908327133617,330.0176739809734,331.682579094519,328.35276886742787,22103,53969.9,44.49526330152856,40.33791255955133,NaN,NaN,NaN,NaN,0.9172074749547751,17.137590578832253,89970886
2025-09-02T12:35:00-04:00,328.91,329.41,328.89,329.06,NaN,NaN,NaN,330.61771441462423,NaN,NaN,330.62638000000004,334.3254823321697,326.92727766783037,327.908327133617,330.00814019217484,331.66673513598187,328.3495452483678,28229,52766,46.25578397722741,41.14721606359096,NaN,NaN,NaN,NaN,0.8909783696008634,16.51455441819296,89999115
2025-09-02T12:40:00-04:00,329.1,329.63,328.83,328.94,NaN,NaN,NaN,330.61771441462423,NaN,NaN,330.5558800000001,334.24648230635324,326.865277693647,327.908327133617,329.99884218525983,331.6510364760976,328.34664789442206,28554,51823.833333333336,45.326812884850284,41.93955961591114,NaN,NaN,NaN,NaN,0.8844799146293739,15.575506551448616,89970561
2025-09-02T12:45:00-04:00,328.96,329.23,328.45,328.7,NaN,NaN,NaN,330.61771441462423,NaN,NaN,330.48628000000014,334.18299350358546,326.7895664964148,327.908327133617,329.98914929747207,331.6382061115386,328.34009248340556,21776,50030.8,43.44743142075537,42.78983640293181,NaN,NaN,NaN,NaN,0.8770170635844208,15.253620141457592,89948785
2025-09-02T12:50:00-04:00,328.68,329.44,328.65,329.19,NaN,NaN,NaN,330.61771441462423,NaN,NaN,330.4240800000002,334.10123600640344,326.7469239935969,327.908327133617,329.97882307239917,331.62113403068366,328.33651211411467,31583,49339.46666666667,48.17231476394701,43.98058049536206,NaN,NaN,NaN,NaN,0.870801559042678,14.595474625113397,89980368
2025-09-02T12:55:00-04:00,329.23,329.7,329.22,329.52,NaN,NaN,NaN,330.61771441462423,NaN,NaN,330.3666800000002,334.00872596227305,326.72463403772736,327.9856132704919,329.97398771987594,331.6090500009599,328.338925438792,26819,48278.23333333333,51.13341615276262,45.35515419814748,NaN,NaN,NaN,NaN,0.8450300191110575,13.553067578903258,90007187
2025-09-02T13:00:00-04:00,329.46,329.94,329.27,329.7,NaN,NaN,NaN,330.61771441462423,NaN,NaN,330.31648000000024,333.92454725536305,326.7084127446374,328.2334906163935,329.9694731031948,331.594019405116,328.3449268012736,37531,47934.9,52.72017374858666,46.92339097430437,NaN,NaN,NaN,NaN,0.8325278748888402,12.967514654074593,90044718
2025-09-02T13:05:00-04:00,329.73,330.36,329.48,329.98,NaN,NaN,NaN,330.61771441462423,NaN,NaN,330.2734800000002,333.84513262019374,326.7018273798066,328.5547924931148,329.9691121578833,331.58368348539454,328.354540830372,34768,47484.46666666667,55.159336856428126,47.95552434669052,NaN,NaN,NaN,NaN,0.8359187409682084,13.043715982864196,90079486
2025-09-02T13:10:00-04:00,329.94,329.98,328.85,328.94,NaN,NaN,NaN,330.61771441462423,NaN,NaN,330.1952800000002,333.7086001629408,326.6819598370596,328.5547924931148,329.9578188586133,331.56201232300543,328.3536253942211,45727,46705,45.723788055354454,47.921176366210645,NaN,NaN,NaN,NaN,0.8569245451847646,12.160479403983828,90033759
2025-09-02T13:15:00-04:00,328.92,329.18,328.76,328.97,NaN,NaN,NaN,330.61771441462423,NaN,NaN,330.11688000000015,333.5604270003234,326.6733329996769,328.5547924931148,329.9494329415711,331.54937149348683,328.3494943896554,24699,45463.13333333333,46.010686722808856,48.07695367245925,NaN,NaN,NaN,NaN,0.8257156491001396,11.47840904713429,90058458
2025-09-02T13:20:00-04:00,328.94,329.62,328.88,329.47,NaN,NaN,NaN,330.61771441462423,NaN,NaN,330.0434800000001,333.38096432799455,326.70599567200566,328.5547924931148,329.941512293769,331.53283760334716,328.3501869841908,37278,45545.5,50.68906831956121,48.2643052134996,NaN,NaN,NaN,NaN,0.8195931027358446,11.153233324057197,90095736
2025-09-02T13:25:00-04:00,329.45,329.91,329.37,329.81,NaN,NaN,NaN,330.61771441462423,NaN,NaN,329.9690800000001,333.1547597541056,326.78340024589454,328.5547924931148,329.9388640398051,331.521762669129,328.3559654104812,32220,45106.1,53.63148785851108,48.48749715231713,NaN,NaN,NaN,NaN,0.7996221668261428,11.262737554973814,90127956
2025-09-02T13:30:00-04:00,329.85,330.23,329.8,330.14,NaN,NaN,NaN,330.61771441462423,NaN,NaN,329.9078800000001,332.95760184038465,326.8581581596155,328.63172560414387,329.9399669013138,331.5154794491205,328.36445435350714,28152,43429.2,56.353738708724286,49.024559475769124,NaN,NaN,NaN,NaN,0.7732205834814189,11.791678203012058,90156108
2025-09-02T13:35:00-04:00,330.12,330.42,329.93,330.26,NaN,NaN,NaN,330.61771441462423,NaN,NaN,329.8358800000001,332.6714480530897,327.0003119469105,328.8963804833151,329.942686168999,331.51027008843255,328.37510224956543,31372,42071.433333333334,57.334655630049,49.74671131436394,NaN,NaN,NaN,NaN,0.7529905418041754,12.526640229267857,90187480
2025-09-02T13:40:00-04:00,330.19,330.63,329.92,330.44,327.76274241428854,327.76274241428854,327.76274241428854,NaN,NaN,NaN,329.8854800000001,332.67443829292876,327.0965217070714,329.05610438665207,329.946327749557,331.50697263120026,328.3856828679137,28839,41120.13333333333,58.82933819543222,50.770573806785634,NaN,NaN,NaN,NaN,0.7499197888181613,13.473894130347466,90216319
2025-09-02T13:45:00-04:00,330.47,330.47,329.65,329.81,327.76274241428854,NaN,NaN,NaN,NaN,NaN,329.8850800000002,332.67407574316786,327.0960842568325,329.05610438665207,329.94674938201393,331.4965159286164,328.39698283541145,43228,40257.666666666664,51.96725166059103,51.178535784168744,NaN,NaN,NaN,NaN,0.7549255181882962,13.798195863172197,90173091
2025-09-02T13:50:00-04:00,329.77,329.78,328.88,328.9,327.76274241428854,NaN,NaN,NaN,NaN,NaN,329.8408800000002,332.6208582343471,327.0609017656533,329.05610438665207,329.93973056626675,331.4840373017209,328.3954238308126,28991,38408.7,43.98613659061559,51.08277319172341,NaN,NaN,NaN,NaN,0.7674308383177041,12.87065966935656,90144100
2025-09-02T13:55:00-04:00,328.91,329.12,328.65,328.8,327.76274241428854,NaN,NaN,NaN,NaN,NaN,329.7744800000001,332.4914206691571,327.0575393308431,329.05610438665207,329.92764735835254,331.46752307182123,328.38777164488386,35421,37949.833333333336,43.200954373202336,51.06516768832677,NaN,NaN,NaN,NaN,0.74618577843787,12.355202939760542,90108679
2025-09-02T14:00:00-04:00,328.74,329.29,328.725,328.88,327.76274241428854,NaN,NaN,NaN,NaN,NaN,329.7034800000001,332.32292025311176,327.0840397468885,329.05610438665207,329.92101649963195,331.45764369094206,328.38438930832183,22021,37352.166666666664,44.061238976198105,50.77151941777328,NaN,NaN,NaN,NaN,0.7332439371208792,11.594310037596756,90130700
2025-09-02T14:05:00-04:00,328.85,328.87,327.99,328.14,327.76274241428854,NaN,NaN,NaN,NaN,NaN,329.6250800000001,332.19182573258695,327.0583342674132,329.05610438665207,329.89803979538937,331.43524624485804,328.3608333459207,46945,36338.3,38.28487256889772,49.853766304640075,NaN,NaN,NaN,NaN,0.7444407987551012,11.929118962657212,90083755
2025-09-02T14:10:00-04:00,328.15,328.5,328,328.19,327.76274241428854,NaN,NaN,NaN,NaN,NaN,329.5678800000002,332.1325283001662,327.00323169983415,329.05610438665207,329.8877937150894,331.4258036627658,328.349783767413,20049,35241.3,38.86803475333788,48.86432780497944,NaN,NaN,NaN,NaN,0.7269807417011653,12.240012964499062,90103804
2025-09-02T14:15:00-04:00,328.25,328.44,328,328.02,327.76274241428854,NaN,NaN,NaN,NaN,NaN,329.50248000000016,332.05487712419006,326.95008287581027,329.05610438665207,329.87611718475483,331.41548918883257,328.3367451806771,22122,34922.3,37.568218608947205,47.6078193587308,NaN,NaN,NaN,NaN,0.7064821172939391,12.528700251923638,90081682
2025-09-02T14:20:00-04:00,328.01,328.59,327.95,328.21,327.76274241428854,NaN,NaN,NaN,NaN,NaN,329.43748000000005,331.9524194982485,326.9225405017516,329.05610438665207,329.86756579276636,331.40738300720307,328.32774857832965,17372,33956.4,39.98393648910202,47.197829961141345,NaN,NaN,NaN,NaN,0.7017333946300852,12.494208269384668,90099054
2025-09-02T14:25:00-04:00,328.18,328.36,328.08,328.19,327.76274241428854,NaN,NaN,NaN,NaN,NaN,329.3626800000001,331.7978441734342,326.92751582656604,329.05610438665207,329.8583768954965,331.3988442650143,328.31790952597873,18415,32202.833333333332,39.80931957076721,46.75487516456694,NaN,NaN,NaN,NaN,0.6716095807279384,12.462179999884196,90080639
2025-09-02T14:30:00-04:00,328.2,328.44,327.88,328.13,327.76274241428854,NaN,NaN,NaN,NaN,NaN,329.2914800000001,331.6574878866602,326.92547211334,328.80088350932164,329.842749561274,331.38475655193076,328.3007425706172,30667,30785.733333333334,39.255451052772116,45.93818821693914,NaN,NaN,NaN,NaN,0.6636374678188002,12.767454165088818,90049972
2025-09-02T14:35:00-04:00,328.12,328.32,327.96,328.305,327.76274241428854,NaN,NaN,NaN,NaN,NaN,329.20218000000006,331.364571886732,327.0397881132681,327.97970680745726,329.8266848746194,331.36967415324676,328.283695595992,33007,30037.533333333333,41.79890884138898,45.093004001430415,NaN,NaN,NaN,NaN,0.6419490772603155,13.050923032778822,90082979
2025-09-02T14:40:00-04:00,328.3,328.36,328.01,328.25,327.76274241428854,NaN,NaN,NaN,NaN,NaN,329.1347800000001,331.1993940287426,327.0701659712576,327.6673123567727,329.81737795510764,331.3607926796511,328.27396323056416,19562,29101.933333333334,41.21481861411113,44.01165256610091,NaN,NaN,NaN,NaN,0.6210955717417231,13.212267922932174,90063417
2025-09-02T14:45:00-04:00,328.24,328.94,328.08,328.61,327.76274241428854,NaN,NaN,NaN,NaN,NaN,329.05818000000005,330.8986239768178,327.2177360231823,327.6673123567727,329.80804382822043,331.34962795276795,328.2664597036729,25131,28766.433333333334,46.48598832384587,43.23674775851498,NaN,NaN,NaN,NaN,0.6381601737601724,12.494611898056318,90088548
2025-09-02T14:50:00-04:00,328.56,329.37,328.56,328.98,327.76274241428854,NaN,NaN,NaN,NaN,NaN,329.0188800000001,330.77863505787855,327.2591249421216,327.85034868805786,329.79496520251587,331.3279959685582,328.26193443647355,54381,29875.433333333334,51.31763037556505,42.70019719995304,NaN,NaN,NaN,NaN,0.6504344470630175,12.61266687584716,90142929
2025-09-02T14:55:00-04:00,328.99,329,328.38,328.59,327.76274241428854,NaN,NaN,NaN,NaN,NaN,328.9732800000001,330.65524428251916,327.29131571748104,327.85034868805786,329.7881330708224,331.3190830128053,328.25718312883953,21041,29933.433333333334,46.54709230068664,42.313042959959866,NaN,NaN,NaN,NaN,0.6482605579870879,12.325707611714867,90121888
2025-09-02T15:00:00-04:00,328.52,329.15,328.43,329.13,327.76274241428854,NaN,NaN,NaN,NaN,NaN,328.92668000000003,330.45232097735305,327.401039022647,327.85034868805786,329.7773751937285,331.30207623622397,328.25267415123307,43148,30634.933333333334,53.054507374199545,42.96078373021586,NaN,NaN,NaN,NaN,0.653384803845151,12.332321458119567,90165036
2025-09-02T15:05:00-04:00,329.1,329.32,328.96,329.08,327.76274241428854,NaN,NaN,NaN,NaN,NaN,328.89308000000005,330.32697683579886,327.45918316420125,327.87553852828563,329.77187842861554,331.2913710967785,328.25238576045257,29924,30691.433333333334,52.418180820192575,43.619157047858025,NaN,NaN,NaN,NaN,0.6324287464276412,12.642304734081316,90135112
2025-09-02T15:10:00-04:00,329.12,329.22,328.74,329.1,327.76274241428854,NaN,NaN,NaN,NaN,NaN,328.87888000000004,330.2900566238738,327.4677033761263,327.87553852828563,329.7660854165448,331.28114018400083,328.25103064908876,27787,30665.866666666665,52.66275209116773,44.23355084178443,NaN,NaN,NaN,NaN,0.6215409788256682,12.401804876383824,90162899
2025-09-02T15:15:00-04:00,329.08,329.37,328.96,329.16,327.76274241428854,NaN,NaN,NaN,NaN,NaN,328.87030000000004,330.2692659185877,327.4713340814124,328.0485446581028,329.76070335840996,331.2700443271574,328.2513623896625,32493,31023.1,53.4360032623152,45.315774462742816,NaN,NaN,NaN,NaN,0.6064309089095508,12.466731449364184,90195392
2025-09-02T15:20:00-04:00,329.12,329.48,328.97,329.11,327.76274241428854,NaN,NaN,NaN,NaN,NaN,328.86990000000003,330.2685800782937,327.47121992170634,328.1678357264822,329.75358945103835,331.25489258173144,328.25228632034526,45663,31492.433333333334,52.66397245062906,46.3011985839779,NaN,NaN,NaN,NaN,0.5995429868445823,12.73715508205338,90149729
2025-09-02T15:25:00-04:00,329.06,329.34,328.91,329.3,327.76274241428854,NaN,NaN,NaN,NaN,NaN,328.8893,330.2843914097208,327.4942085902792,328.1678357264822,329.74655092591354,331.23988808289454,328.25321376893254,46047,32133.366666666665,55.30646431271053,47.56821613424671,NaN,NaN,NaN,NaN,0.5874327734985371,12.825967229885379,90195776
2025-09-02T15:30:00-04:00,329.27,329.74,329.21,329.44,327.76274241428854,NaN,NaN,NaN,NaN,NaN,328.9089,330.3068489123159,327.51095108768413,328.46321486494867,329.74326960263784,331.2282400670217,328.25829913825396,43730,32340,57.20230294085372,48.798099452228975,NaN,NaN,NaN,NaN,0.5833304325343579,13.664513294093231,90239506
2025-09-02T15:35:00-04:00,329.42,329.68,329.27,329.61,327.76274241428854,NaN,NaN,NaN,NaN,NaN,328.93270000000007,330.3370492590034,327.52835074099676,328.46321486494867,329.7416865484972,331.22150176701956,328.2618713299749,26953,32079.5,59.45154666489958,50.20111567323843,NaN,NaN,NaN,NaN,0.5709496873533342,14.443163210857666,90266459
2025-09-02T15:40:00-04:00,329.63,329.87,329.33,329.6,327.76274241428854,NaN,NaN,NaN,NaN,NaN,328.9595,330.36261973880244,327.55638026119755,328.6188575135671,329.74007374145657,331.21151931108005,328.2686281718331,43769,32014.233333333334,59.25427189520966,51.629602876269686,NaN,NaN,NaN,NaN,0.568738995399526,15.508266407980667,90222690
2025-09-02T15:45:00-04:00,329.55,329.8,329.2,329.77,327.76274241428854,NaN,NaN,NaN,NaN,NaN,329.0025,330.37011142197696,327.63488857802304,328.6188575135671,329.7384754800139,331.2021458125628,328.27480514746503,41391,32570.633333333335,61.5877905674189,53.043094428128974,NaN,NaN,NaN,NaN,0.5709719242995615,16.084387409963124,90264081
2025-09-02T15:50:00-04:00,329.36,329.75,329.04,329.17,327.76274241428854,NaN,NaN,NaN,NaN,NaN,329.0337,330.34274058051,327.72465941949,328.6188575135671,329.73182916208776,331.18477204773086,328.27888627644467,62723,33418.8,50.578024894166106,53.71189487670432,NaN,NaN,NaN,NaN,0.5823310725638757,16.12576985288097,90201358
2025-09-02T15:55:00-04:00,329.17,329.55,328.94,329.34,327.76274241428854,NaN,NaN,NaN,NaN,NaN,329.0675,330.3178411540413,327.8171588459587,328.6188575135671,329.71874999877036,331.15268304026836,328.28481695727237,116840,36239.46666666667,53.13437436641156,54.18677959403044,NaN,NaN,NaN,NaN,0.5843074245235998,15.861928927972603,90318198
2025-09-03T09:30:00-04:00,335.12,335.15,330.77,331.02,330.33568980815414,NaN,NaN,NaN,NaN,NaN,329.1397,330.41551254162954,327.86388745837047,331.1013320375571,332.31333333333333,332.31333333333333,332.31333333333333,252418,43715,69.77356257085734,55.505060465122746,NaN,NaN,NaN,NaN,0.9575711799147715,19.909508404646033,90570616
2025-09-03T09:35:00-04:00,331.04,331.26,328.96,329.28,NaN,NaN,NaN,332.9286597285801,332.9286597285801,332.9286597285801,329.15590000000003,330.4177806446512,327.89401935534886,331.1013320375571,331.0669093237957,332.30689268340893,329.82692596418246,255047,51170.833333333336,49.98082764595681,55.75032727549918,NaN,NaN,NaN,NaN,1.053458952778003,21.291797541058404,90315569
2025-09-03T09:40:00-04:00,329.2,330.44,328.51,330.27,NaN,NaN,NaN,332.4287206500083,NaN,NaN,329.1779,330.4777801334385,327.87801986656154,331.1013320375571,330.69472925283105,331.9037063245188,329.4857521811433,197824,56803.666666666664,57.38749158392603,56.05982614762251,NaN,NaN,NaN,NaN,1.1160690275795746,22.087027962063964,90513393
2025-09-03T09:45:00-04:00,330.28,330.47,329.12,330.4,NaN,NaN,NaN,332.4287206500083,NaN,NaN,329.2101,330.5491242571982,327.87107574280185,331.1013320375571,330.6030498701435,331.7542480292072,329.45185171107977,106633,58917.166666666664,58.26150039880646,56.4772061175235,NaN,NaN,NaN,NaN,1.1327783827524638,22.842408484523745,90620026
2025-09-03T09:50:00-04:00,330.35,331.1,330.01,330.85,NaN,NaN,NaN,332.4287206500083,NaN,NaN,329.24010000000004,330.6553603863818,327.8248396136183,331.1013320375571,330.6081756485215,331.699227918984,329.51712337805907,92160,61022.8,61.22613803361751,57.08887654198419,NaN,NaN,NaN,NaN,1.1297227839844328,23.89775745329011,90712186
2025-09-03T09:55:00-04:00,330.92,331.04,330.12,330.92,NaN,NaN,NaN,332.4287206500083,NaN,NaN,329.2647,330.75134509595944,327.7780549040406,331.1013320375571,330.6154974155635,331.65886506610644,329.5721297650205,85044,62676.9,61.682077253109334,57.67788182704091,NaN,NaN,NaN,NaN,1.114742585128403,24.87772435285888,90797230
2025-09-03T10:00:00-04:00,330.92,333.61,330.69,333.13,328.8843237495122,328.8843237495122,328.8843237495122,NaN,NaN,NaN,329.33810000000005,331.17678310516783,327.4994168948323,331.1013320375571,330.8924951251121,332.0610024121157,329.7239878381084,172952,67707.93333333333,72.62621697793286,59.10375643613405,NaN,NaN,NaN,NaN,1.2436895433335182,26.938352219575464,90970182
2025-09-03T10:05:00-04:00,333.14,334.12,332.84,333.3,330.1882181245344,NaN,NaN,NaN,NaN,NaN,329.4193,331.56623829471744,327.2723617052826,331.1013320375571,331.17064190948525,332.5274029341611,329.8138808848094,143698,70933.03333333334,73.25892005275037,60.386074703279746,NaN,NaN,NaN,NaN,1.2462831473811262,29.024657371401837,91113880
2025-09-03T10:10:00-04:00,333.32,333.79,331.92,332.22,330.1882181245344,NaN,NaN,NaN,NaN,NaN,329.48650000000004,331.7654842038382,327.2075157961619,331.1013320375571,331.27944381400084,332.64076544696417,329.9181221810375,104166,73736.93333333333,63.25600855067026,60.81848224683807,NaN,NaN,NaN,NaN,1.2908343511396174,29.933250109422833,91009714
2025-09-03T10:15:00-04:00,332.24,333.88,332.05,333.78,330.1882181245344,NaN,NaN,NaN,NaN,NaN,329.5809,332.153506219654,327.008293780346,331.1013320375571,331.39359724939203,332.79199029361524,329.9952042051688,87327,75910.43333333333,69.69314006863337,61.55002463281905,NaN,NaN,NaN,NaN,1.329346183201072,30.81698626723299,91097041
2025-09-03T10:20:00-04:00,333.8,335.45,333.75,335.26,331.0346373075989,NaN,NaN,NaN,NaN,NaN,329.7073,332.7242038502166,326.69039614978334,331.1577720261236,331.73581998873397,333.4138151084892,330.05782486897874,166138,80869.3,74.29420975378248,62.624305908431396,NaN,NaN,NaN,NaN,1.355821455829566,32.26855149865305,91263179
2025-09-03T10:25:00-04:00,335.21,337.31,335.15,336.06,332.53215379361717,NaN,NaN,NaN,NaN,NaN,329.8545,333.3419645519889,326.36703544801105,332.79621762089886,332.2727185685363,334.4102947864098,330.13514235066276,228959,87887.43333333333,76.38150129244234,63.680999531647366,NaN,NaN,NaN,NaN,1.4132627804131703,34.18677265332634,91492138
2025-09-03T10:30:00-04:00,336.05,337.58,336.02,337.49,333.05751043936175,NaN,NaN,NaN,NaN,NaN,330.02049999999997,334.1047293032371,325.93627069676285,333.1889740967191,332.661230666525,335.08886266552986,330.23359866752014,168287,92474.76666666666,79.57422559433569,65.75215672451661,NaN,NaN,NaN,NaN,1.4237440103836583,36.04070944879524,91660425
2025-09-03T10:35:00-04:00,337.48,339.6,337.32,339.52,334.57671451029995,NaN,NaN,NaN,NaN,NaN,330.22049999999996,335.0908315083698,325.35016849163014,334.9471792773753,333.2880593690195,336.2471686704654,330.3289500675736,233776,99167.06666666667,83.07245168994795,67.89059081905494,NaN,NaN,NaN,NaN,1.4849051524991133,38.23810940694503,91894201
2025-09-03T10:40:00-04:00,339.53,340.47,339.02,339.99,335.8405002143772,NaN,NaN,NaN,NaN,NaN,330.42629999999997,336.00881656885196,324.843783431148,336.0227434219002,333.91119945276114,337.3182509748174,330.5041479307049,241697,106571.56666666667,83.76570091118371,68.89002927193538,NaN,NaN,NaN,NaN,1.4824119273206084,40.449157463456345,92135898
2025-09-03T10:45:00-04:00,339.98,340.15,338.95,339.13,335.8405002143772,NaN,NaN,NaN,NaN,NaN,330.6092999999999,336.6982204331813,324.5203795668185,336.0227434219002,334.12642966410385,337.6322579258227,330.620601402385,103311,109177.56666666667,77.51050159692451,70.85643455414736,NaN,NaN,NaN,NaN,1.462239646797707,42.42739508377266,92032587
2025-09-03T10:50:00-04:00,339.15,339.95,338.9,339.89,335.8405002143772,NaN,NaN,NaN,NaN,NaN,330.82829999999996,337.427594995796,324.2290050042039,336.0987557900161,334.360639119632,337.964166898461,330.7571113408031,118440,111312.86666666667,79.00273731679971,72.40038067792405,NaN,NaN,NaN,NaN,1.432793957740729,44.20735962250166,92151027
2025-09-03T10:55:00-04:00,339.86,341.48,339.52,341.27,336.5510525437028,NaN,NaN,NaN,NaN,NaN,331.07429999999994,338.2683736750133,323.88022632498655,337.4190046320129,334.8407942806108,338.69450979805174,330.98707876316985,223840,118072.83333333333,81.41424204023767,74.05414793802628,NaN,NaN,NaN,NaN,1.4704515321878222,46.17548166259967,92374867
2025-09-03T11:00:00-04:00,341.28,342.08,341.05,341.23,337.65509560989807,NaN,NaN,NaN,NaN,NaN,331.3094999999999,339.02821602027785,323.59078397972195,338.3162037056103,335.2623330326284,339.3260917059549,331.1985743593019,203022,123401.96666666666,81.12341335527725,75.4753818895734,NaN,NaN,NaN,NaN,1.4389907084601188,48.11196091899748,92171845
2025-09-03T11:05:00-04:00,341.21,342.31,340.9,341.49,337.6805458094482,NaN,NaN,NaN,NaN,NaN,331.5430999999999,339.75722366363925,323.3289763363606,338.59396296448824,335.52999465816464,339.7047740812114,331.3552152351179,141209,127111.46666666666,81.58391605590518,76.8969418040588,NaN,NaN,NaN,NaN,1.436919943570112,49.95173516221523,92313054
2025-09-03T11:10:00-04:00,341.5,342.52,341.17,341.3,337.914839181746,NaN,NaN,NaN,NaN,NaN,331.7662999999999,340.4109993725443,323.12160062745545,338.8721703715906,335.7769980674333,340.0408967085334,331.51309942633316,139564,130837.36666666667,80.04710914716014,77.4270055304322,NaN,NaN,NaN,NaN,1.4307113761722445,51.69928324301559,92173490
2025-09-03T11:15:00-04:00,341.29,341.78,340.89,341.32,337.914839181746,NaN,NaN,NaN,NaN,NaN,331.98749999999995,341.0238404651146,322.95115953488533,338.8721703715906,335.92737767991696,340.2286478188109,331.62610754102303,96461,132969.63333333333,80.08962542779405,77.91491305722103,NaN,NaN,NaN,NaN,1.3920891350170834,52.95742943394981,92269951
2025-09-03T11:20:00-04:00,341.31,341.69,340.79,341.15,337.914839181746,NaN,NaN,NaN,NaN,NaN,332.2016999999999,341.58234253884393,322.8210574611559,338.8721703715906,336.1003524663357,340.43382320134634,331.7668817313251,120582,135466.93333333332,78.55733949694252,79.00786526766903,NaN,NaN,NaN,NaN,1.3569399110872902,53.99110449571366,92149369
2025-09-03T11:25:00-04:00,341.11,341.32,340.06,340.15,337.914839181746,NaN,NaN,NaN,NaN,NaN,332.4084999999999,342.0221262149955,322.79487378500426,338.8721703715906,336.2362729451703,340.56998075062563,331.90256513971497,117119,137836,70.0654692714596,79.03446021072806,NaN,NaN,NaN,NaN,1.3500156317239116,53.98872520653937,92032250
2025-09-03T11:30:00-04:00,340.14,340.5,339.33,340.03,337.914839181746,NaN,NaN,NaN,NaN,NaN,332.63109999999995,342.4232305731409,322.83896942685897,338.8721703715906,336.34214034857166,340.65820563006923,332.0260750670741,111393,140091.43333333332,69.10017077022846,78.66345742618849,NaN,NaN,NaN,NaN,1.3371573723150618,53.1096325557963,91920857
2025-09-03T11:35:00-04:00,340.06,341.09,340.06,340.63,337.914839181746,NaN,NaN,NaN,NaN,NaN,332.86769999999996,342.84799602974965,322.88740397025026,338.8721703715906,336.4226802411617,340.7367738301769,332.10858665214647,75527,141710.56666666668,71.23414683415889,78.29578925059681,NaN,NaN,NaN,NaN,1.3173604171497004,52.56367776993136,91996384
2025-09-03T11:40:00-04:00,340.59,341.67,340.27,341.45,337.914839181746,NaN,NaN,NaN,NaN,NaN,333.11909999999995,343.31585589398145,322.92234410601844,338.8721703715906,336.517896841167,340.8392499765889,332.19654370574506,82303,142995.03333333333,73.88824405826342,77.88964771230594,NaN,NaN,NaN,NaN,1.3232632444961527,52.30714584013415,92078687
2025-09-03T11:45:00-04:00,341.46,341.95,341.04,341.72,337.914839181746,NaN,NaN,NaN,NaN,NaN,333.3907,343.76439211232577,323.0170078876742,339.0091165999122,336.6309148079264,340.96848900172347,332.2933406141293,93106,144718.86666666667,74.71547904397804,77.29272109473666,NaN,NaN,NaN,NaN,1.2937444413178538,52.18682223484421,92171793
2025-09-03T11:50:00-04:00,341.7,342.15,341.41,341.8,338.10305004541215,NaN,NaN,NaN,NaN,NaN,333.66290000000004,344.1895633061583,323.1362366938418,339.42729327992976,336.72926909004707,341.08277902006387,332.37575916003027,80941,145326.13333333333,74.96851967140609,76.66435100618112,NaN,NaN,NaN,NaN,1.2541912669380035,52.1607106895679,92252734
2025-09-03T11:55:00-04:00,341.78,341.87,341.19,341.53,338.10305004541215,NaN,NaN,NaN,NaN,NaN,333.93309999999997,344.55960100275047,323.30659899724947,339.42729327992976,336.78158405152834,341.1399008162991,332.4232672867576,46746,142989.66666666666,72.33730483024898,76.29483695141857,NaN,NaN,NaN,NaN,1.213177605013861,51.833332241088925,92205988
2025-09-03T12:00:00-04:00,341.5,341.75,340.97,341.15,338.10305004541215,NaN,NaN,NaN,NaN,NaN,334.1919,344.87838658640317,323.5054134135968,339.42729327992976,336.8497392168218,341.2098308873274,332.4896475463161,65844,136770.53333333333,68.68358816541411,75.55775486917675,NaN,NaN,NaN,NaN,1.182236347512869,51.22128664970141,92140144
2025-09-03T12:05:00-04:00,341.19,341.85,340.891,341.64,338.10305004541215,NaN,NaN,NaN,NaN,NaN,334.4609,345.20648806028214,323.7153119397178,339.44687415932407,336.91046597028446,341.27352791450056,332.54740402606836,58133,130206.73333333334,70.73617173726971,74.7950355618219,NaN,NaN,NaN,NaN,1.166290894119093,50.71011303639366,92198277
2025-09-03T12:10:00-04:00,341.67,341.7,340.74,341.33,338.10305004541215,NaN,NaN,NaN,NaN,NaN,334.7249,345.4839528375552,323.9658471624448,339.44687415932407,336.95160513646067,341.31431382392253,332.5888964489988,42177,125018.5,67.71241097121381,73.83710682010307,NaN,NaN,NaN,NaN,1.1515558302534419,50.004740738053776,92156100
2025-09-03T12:15:00-04:00,341.29,342.19,341.25,342.17,338.264339243764,NaN,NaN,NaN,NaN,NaN,335.0022,345.7997362301367,324.2046637698633,339.7979994619674,337.03019605089605,341.401632911598,332.6587591901941,72356,123875.93333333333,71.29330410179426,73.10206310909517,NaN,NaN,NaN,NaN,1.136444699521053,49.65680977213877,92228456
2025-09-03T12:20:00-04:00,342.15,343.33,342.06,342.76,339.223232914502,NaN,NaN,NaN,NaN,NaN,335.29240000000004,346.12832289383334,324.45647710616674,340.7813995695739,337.21446077306837,341.63080525859294,332.7981162875438,151646,125858.8,73.51513459287725,72.63549349807496,NaN,NaN,NaN,NaN,1.1459843638409768,49.937290080789644,92380102
2025-09-03T12:25:00-04:00,342.78,342.8,341.62,341.715,339.223232914502,NaN,NaN,NaN,NaN,NaN,335.5545,346.36514591045005,324.74385408955,340.7813995695739,337.27649213516776,341.6979663011321,332.8550179692034,60878,125053.26666666666,64.05818061367845,71.4903902970667,NaN,NaN,NaN,NaN,1.1484140521380506,49.53773598736903,92319224
2025-09-03T12:30:00-04:00,341.75,341.81,341.38,341.57,339.223232914502,NaN,NaN,NaN,NaN,NaN,335.80629999999996,346.5791096261503,325.03349037384965,340.7813995695739,337.3080820398129,341.728637796496,332.88752628312983,35002,120454.93333333333,62.8500427610356,70.3684405302162,NaN,NaN,NaN,NaN,1.097098762699619,48.814791068697986,92284222
2025-09-03T12:35:00-04:00,341.56,342.11,341.56,341.79,339.223232914502,NaN,NaN,NaN,NaN,NaN,336.0703,346.76950640240597,325.371093597594,340.7813995695739,337.35335246376445,341.77460251863585,332.93210240889306,48403,117278.43333333333,63.960644302923235,69.93238160389218,NaN,NaN,NaN,NaN,1.058020279649647,48.33359188683442,92332625
2025-09-03T12:40:00-04:00,341.79,341.79,341.06,341.37,339.223232914502,NaN,NaN,NaN,NaN,NaN,336.31510000000003,346.9276790438099,325.70252095619014,340.7813995695739,337.39693715775974,341.814178830148,332.97969548537145,52437,115554.13333333333,60.257084501336394,69.3007325846856,NaN,NaN,NaN,NaN,1.0345902596746734,47.145040035284325,92280188
2025-09-03T12:45:00-04:00,341.36,341.49,340.88,341.03,339.223232914502,NaN,NaN,NaN,NaN,NaN,336.55410000000006,347.0416659121174,326.0665340878827,340.7813995695739,337.42306050308645,341.83582932594385,333.01029168022905,34335,113787.73333333334,57.361467643786284,68.30982692823042,NaN,NaN,NaN,NaN,1.0042623839836262,45.78218568663913,92245853
2025-09-03T12:50:00-04:00,341.05,341.2,340.52,340.73,339.223232914502,NaN,NaN,NaN,NaN,NaN,336.7867,347.11736263321154,326.45603736678845,340.7813995695739,337.46313772316586,341.8650652007164,333.0612102456153,58689,110206.1,54.85657735016447,66.95042216336621,NaN,NaN,NaN,NaN,0.9811007851276534,44.004201087651055,92187164
2025-09-03T12:55:00-04:00,340.74,341.48,340.73,341.25,339.223232914502,NaN,NaN,NaN,NaN,NaN,337.0285,347.1985088987741,326.8584911012259,340.7813995695739,337.5048244583752,341.8991578249962,333.11049109175417,56781,104466.83333333333,58.259071107591154,65.77496445362429,NaN,NaN,NaN,NaN,0.9645935861899639,42.606493192121704,92243945
2025-09-03T13:00:00-04:00,341.27,341.83,341.2,341.48,339.223232914502,NaN,NaN,NaN,NaN,NaN,337.27590000000004,347.26355792171137,327.2882420782887,340.7813995695739,337.5400451290162,341.9309064057185,333.14918385231397,44668,100346.2,59.70569521103373,64.68476270645483,NaN,NaN,NaN,NaN,0.9406940443192519,41.61575819644675,92288613
2025-09-03T13:05:00-04:00,341.49,341.93,341.41,341.84,339.223232914502,NaN,NaN,NaN,NaN,NaN,337.5267,347.3286891063552,327.7247108936448,340.7813995695739,337.56523754277487,341.95482596335603,333.1756491221937,30699,93576.96666666666,61.929717014626505,63.94136357676751,NaN,NaN,NaN,NaN,0.9106444697250183,40.78338222788407,92319312
2025-09-03T13:10:00-04:00,341.805,342.47,341.75,342.1,339.223232914502,NaN,NaN,NaN,NaN,NaN,337.7799,347.38532440296933,328.17447559703066,340.72692599859874,337.62982426874396,342.02113397718625,333.23851456030167,73602,87973.8,63.49676487181348,63.57087619865318,NaN,NaN,NaN,NaN,0.8970270076018048,40.46553937280028,92392914
2025-09-03T13:15:00-04:00,342.15,342.56,342.04,342.17,339.43033056055486,NaN,NaN,NaN,NaN,NaN,338.0311,347.42332173722133,328.63887826277863,340.905540798879,337.68799922620116,342.0819636460457,333.2940348063566,65900,86726.76666666666,63.927276085498995,63.08452650924098,NaN,NaN,NaN,NaN,0.8700965070588174,40.24345712776235,92458814
2025-09-03T13:20:00-04:00,342.17,342.32,341.92,342,339.43033056055486,NaN,NaN,NaN,NaN,NaN,338.2791,347.41919358600927,329.1390064139908,340.905540798879,337.7190585903745,342.1128993512931,333.32521782945594,37329,84023.06666666667,62.01442398919568,62.67752743909683,NaN,NaN,NaN,NaN,0.8365181851260431,39.816018836500064,92421485
2025-09-03T13:25:00-04:00,341.99,342.01,341.45,341.76,339.43033056055486,NaN,NaN,NaN,NaN,NaN,338.5189,347.37825918456815,329.6595408154318,340.905540798879,337.756630140273,342.14697236864976,333.3662879118962,49788,78221.33333333333,59.31597704445279,61.822004077858146,NaN,NaN,NaN,NaN,0.8167668861884688,38.58626778336337,92371697
2025-09-03T13:30:00-04:00,341.74,342.01,341.14,341.18,339.43033056055486,NaN,NaN,NaN,NaN,NaN,338.75910000000005,347.23446564172474,330.28373435827535,340.905540798879,337.7818308318253,342.16767409005115,333.3959875735994,36673,72676.36666666667,53.282006623736635,60.376780651490954,NaN,NaN,NaN,NaN,0.8205692514607213,36.935541146992875,92335024
2025-09-03T13:35:00-04:00,341.17,341.27,340.98,341.12,339.43033056055486,NaN,NaN,NaN,NaN,NaN,338.9947,347.05436163315954,330.9350383668405,340.905540798879,337.80723515412427,342.18600465478374,333.4284656534648,41101,69339.43333333333,52.68493575351434,59.564406018622094,NaN,NaN,NaN,NaN,0.7826714477849529,35.14467456398474,92293923
2025-09-03T13:40:00-04:00,341.11,341.28,340.53,340.67,339.43033056055486,NaN,NaN,NaN,NaN,NaN,339.18769999999995,346.9301810520393,331.4452189479606,340.905540798879,337.83966756471244,342.2059645792881,333.4733705501368,58699,66643.93333333333,48.31224765135441,58.5259920822163,NaN,NaN,NaN,NaN,0.7803377729431705,32.790123393095804,92235224
2025-09-03T13:45:00-04:00,340.72,340.77,339.69,340.54,339.43033056055486,NaN,NaN,NaN,NaN,NaN,339.41290000000004,346.62652934735377,332.1992706526463,340.905540798879,337.86978821451476,342.2181758577987,333.5214005712308,66816,65655.76666666666,47.096164947020036,57.321386413937496,NaN,NaN,NaN,NaN,0.8017422177329429,31.373928334690692,92168408
2025-09-03T13:50:00-04:00,340.6,340.96,340.17,340.21,339.43033056055486,NaN,NaN,NaN,NaN,NaN,339.6117,346.3379011894558,332.88549881054416,340.905540798879,337.8958572916749,342.22987207258404,333.5618425107657,56533,63520.8,44.06405071870762,56.16474114374973,NaN,NaN,NaN,NaN,0.8009034878948729,29.77773457341579,92111875
2025-09-03T13:55:00-04:00,340.24,340.35,339.21,339.28,NaN,NaN,NaN,342.4633238261469,342.4633238261469,342.4633238261469,339.7893,345.9809059339177,333.59769406608234,340.905540798879,337.9179862025537,342.22834360483125,333.6076288002762,72941,62048.2,36.86149465415101,54.700457358775786,NaN,NaN,NaN,NaN,0.8251246673309565,29.331225030293407,92038934
2025-09-03T14:00:00-04:00,339.28,339.28,338.52,338.95,NaN,NaN,NaN,341.5649909249584,NaN,NaN,339.95129999999995,345.5988193882919,334.303780611708,340.905540798879,337.93275413675525,342.21282103363285,333.65268723987765,84970,61167.433333333334,34.694402798214654,53.26030203363651,NaN,NaN,NaN,NaN,0.8204729053787447,29.516484575317932,91953964
2025-09-03T14:05:00-04:00,338.97,339.4,338.62,338.7,NaN,NaN,NaN,341.5649909249584,NaN,NaN,340.10689999999994,345.14651700540406,335.0672829945958,340.79643263910316,337.94063208756046,342.20424573856326,333.67701843655766,46859,60211.833333333336,33.106484344907045,51.46368869344479,NaN,NaN,NaN,NaN,0.8175819835659752,29.498599375856273,91907105
2025-09-03T14:10:00-04:00,338.72,338.87,338.26,338.81,NaN,NaN,NaN,341.17793594608816,NaN,NaN,340.22049999999996,344.86662795789346,335.57437204210646,340.5111461112825,337.9477894590642,342.1903265934263,333.70525232470214,59327,59445.96666666667,34.52643140149435,49.66516984990626,NaN,NaN,NaN,NaN,0.8027546990255494,29.790853343862487,91966432
2025-09-03T14:15:00-04:00,338.77,338.77,337.9,337.94,NaN,NaN,NaN,340.95325703944775,NaN,NaN,340.3133,344.57201417695643,336.0545858230436,340.37591688902603,337.9506260210013,342.16963611264725,333.73161592935537,65690,58532.1,29.239854145027138,47.33017964493488,NaN,NaN,NaN,NaN,0.8104150776665834,30.35522957978367,91900742
2025-09-03T14:20:00-04:00,337.99,338.19,337.05,337.21,NaN,NaN,NaN,340.27469990129106,NaN,NaN,340.4131,344.1045934052637,336.7216065947363,339.8177335112208,337.9453447890784,342.1407368104266,333.7499527677302,67648,58089,25.685942061488632,44.62940658705453,NaN,NaN,NaN,NaN,0.833956857833255,31.483409300721675,91833094
2025-09-03T14:25:00-04:00,337.19,337.35,336.39,336.83,NaN,NaN,NaN,339.5349408148687,NaN,NaN,340.4741,343.8086894441515,337.1395105558485,339.74318680897665,337.93277867226175,342.10550832932586,333.76004901519764,69896,58860.666666666664,24.047444395115235,41.78084718059855,NaN,NaN,NaN,NaN,0.8429599394165965,32.923091974309145,91763198
2025-09-03T14:30:00-04:00,336.8,336.8,335.65,336.01,NaN,NaN,NaN,338.92971623237474,NaN,NaN,340.4891,343.7353123715209,337.24288762847914,339.1494395577451,337.90786097300736,342.05654446229846,333.75917748371626,86000,59532.53333333333,20.942873777168643,38.84716502259662,NaN,NaN,NaN,NaN,0.8670342294582687,34.63851470960399,91677198
2025-09-03T14:35:00-04:00,336.01,336.14,334.72,334.84,NaN,NaN,NaN,338.2054109490849,NaN,NaN,340.4647,343.8586866884047,337.0707133115953,339.1494395577451,337.85799231978206,341.9837091875225,333.7322754520416,116689,61484.4,17.47604454730913,35.85859841565779,NaN,NaN,NaN,NaN,0.9065317844969609,36.628699624416605,91560509
2025-09-03T14:40:00-04:00,334.87,336.04,334.78,336.02,NaN,NaN,NaN,338.2054109490849,NaN,NaN,340.4353,343.9549888557223,336.91561114427765,338.3315516461961,337.83008928674116,341.93761914976835,333.72255942371396,78774,62704.3,30.052277705363366,34.199332064345406,NaN,NaN,NaN,NaN,0.9317795141757529,38.476728473885466,91639283
2025-09-03T14:45:00-04:00,336,336.17,335.74,335.92,NaN,NaN,NaN,338.2054109490849,NaN,NaN,340.36330000000004,344.0957906484809,336.6308093515192,337.4141930535655,337.8114245089702,341.90285022469004,333.7199987932504,63315,62402.933333333334,29.640035980095846,32.55326779481551,NaN,NaN,NaN,NaN,0.8959381203060568,39.95468128017095,91575968
2025-09-03T14:50:00-04:00,335.92,336,335.11,335.62,NaN,NaN,NaN,338.2054109490849,NaN,NaN,340.27590000000004,344.23692193392156,336.3148780660785,337.4141930535655,337.7884889440541,341.86509191003336,333.71188597807486,66368,59560.333333333336,28.38219297140192,31.129692460533192,NaN,NaN,NaN,NaN,0.8955139688556232,41.60908105068323,91509600
2025-09-03T14:55:00-04:00,335.61,335.68,334.89,335.02,NaN,NaN,NaN,338.0156045385774,NaN,NaN,340.19370000000004,344.40886064236673,335.97853935763334,336.97635444285237,337.7672852806966,341.83388594701375,333.7006846143795,53340,59309.066666666666,26.005226611701815,29.623196865153318,NaN,NaN,NaN,NaN,0.8879772567945087,43.23774978494693,91456260
2025-09-03T15:00:00-04:00,335,335.29,334.63,334.85,NaN,NaN,NaN,337.6564861504603,NaN,NaN,340.0929,344.56547960925514,335.62032039074484,336.80008355428185,337.7187159074145,341.7672447578707,333.6701870569583,113284,61918.46666666667,25.35724670757324,28.28699657864372,NaN,NaN,NaN,NaN,0.8716931670234741,44.85875540657207,91342976
2025-09-03T15:05:00-04:00,334.87,335.55,334.84,335.47,NaN,NaN,NaN,337.6564861504603,NaN,NaN,339.9769,344.6189895684037,335.3348104315963,336.0440668434255,337.6957904287323,341.7320401589187,333.6595406985459,63123,62409.13333333333,32.01100426423777,27.940532979364207,NaN,NaN,NaN,NaN,0.8601436550932285,45.84235261285935,91406099
2025-09-03T15:10:00-04:00,335.48,335.66,335.1,335.2,NaN,NaN,NaN,337.6564861504603,NaN,NaN,339.8563,344.6719722522595,335.0406277477405,335.15325347474044,337.6786395440976,341.7053202232125,333.65195886498276,48693,62284.333333333336,30.7264613239891,27.6571085883481,NaN,NaN,NaN,NaN,0.8387048225865695,46.532956551687896,91357406
2025-09-03T15:15:00-04:00,335.2,335.38,334.91,335.29,NaN,NaN,NaN,337.6564861504603,NaN,NaN,339.7323,344.6905017749464,334.7740982250536,334.45260277979236,337.6565411051876,341.6720634807351,333.6410187296401,60513,63156.933333333334,31.710175104151517,27.557372214008414,NaN,NaN,NaN,NaN,0.8123687638303839,47.28633306733489,91417919
2025-09-03T15:20:00-04:00,335.27,335.81,335.01,335.64,NaN,NaN,NaN,337.6564861504603,NaN,NaN,339.61909999999995,344.68621424395735,334.55198575604254,333.98165464703214,337.64142212280973,341.64699922504707,333.6358450205724,47752,62792.36666666667,35.54352241200881,27.6300215719023,NaN,NaN,NaN,NaN,0.8114852806996431,47.097602600630104,91465671
2025-09-03T15:25:00-04:00,335.63,335.96,335.51,335.63,NaN,NaN,NaN,337.6564861504603,NaN,NaN,339.5053,344.6691584063775,334.34144159362245,334.2723237176257,337.62670258679816,341.62061799252064,333.6327871810757,52358,62644.933333333334,35.482238029617065,28.075906135087298,NaN,NaN,NaN,NaN,0.7856649035068106,46.6239416457548,91413313
2025-09-03T15:30:00-04:00,335.63,336.31,335.61,336.19,NaN,NaN,NaN,337.6564861504603,NaN,NaN,339.4061,344.6299841067973,334.1822158932027,334.6098589741006,337.61365932660215,341.59374455479474,333.63357409840955,57117,63059.9,41.55909471415698,29.20970275313503,NaN,NaN,NaN,NaN,0.7795459818277519,45.505192402413556,91470430
2025-09-03T15:35:00-04:00,336.21,336.46,335.82,336.35,NaN,NaN,NaN,337.6564861504603,NaN,NaN,339.3301,344.61865083753133,334.0415491624687,334.7798871792805,337.6017772704878,341.56706666328074,333.63648787769483,59444,64018.066666666666,43.20507956847317,30.57810526551774,NaN,NaN,NaN,NaN,0.7695784116971972,44.18305641758865,91529874
2025-09-03T15:40:00-04:00,336.36,337.07,336.3,336.86,NaN,NaN,NaN,337.6564861504603,NaN,NaN,339.26670000000007,344.59601650786055,333.9373834921396,335.3409097434244,337.58992248106557,341.5290112309947,333.65083373113646,98333,64842.433333333334,48.21202340355254,32.5259016674023,NaN,NaN,NaN,NaN,0.7696085251473962,41.8931229860522,91628207
2025-09-03T15:45:00-04:00,336.89,337.13,336.7,336.98,NaN,NaN,NaN,337.6564861504603,NaN,NaN,339.19370000000004,344.5462630534463,333.8411369465538,335.5317277947395,337.5815477188565,341.4959952993129,333.6671001384001,92472,65728.16666666667,49.34362381324224,34.80215732925467,NaN,NaN,NaN,NaN,0.7453507733511541,39.668630247277676,91720679
2025-09-03T15:50:00-04:00,336.97,337.13,335.96,336.47,NaN,NaN,NaN,337.6564861504603,NaN,NaN,339.0941,344.4603335731053,333.72786642689476,335.5317277947395,337.56469676881756,341.45021721330073,333.6791763243344,116347,68362.1,44.857485194814956,35.859672149929786,NaN,NaN,NaN,NaN,0.7756828609689299,38.495260901782956,91604332
2025-09-03T15:55:00-04:00,336.4,336.47,334.01,334.05,NaN,NaN,NaN,337.6564861504603,NaN,NaN,338.94070000000005,344.4348918460382,333.4465081539619,335.5317277947395,337.4852202722987,341.3409078136073,333.6295327309901,220493,74052.26666666666,30.627978270485954,35.930239456386225,NaN,NaN,NaN,NaN,0.8959912280425805,38.964296108341806,91383839
2025-09-04T09:30:00-04:00,336.16,337.63,334.17,337.39,NaN,NaN,NaN,337.6564861504603,NaN,NaN,338.8525000000001,344.30166076116046,333.4033392388397,335.5317277947395,336.39666666666665,336.39666666666665,336.39666666666665,221916,80227.03333333334,52.8558722964698,37.67835940817679,NaN,NaN,NaN,NaN,1.0877061403252521,37.80355385521595,91605755
2025-09-04T09:35:00-04:00,337.48,337.48,334.73,335.53,NaN,NaN,NaN,337.6564861504603,NaN,NaN,338.7325000000001,344.20473473554904,333.2602652644511,335.5317277947395,336.18608104156334,336.4257406891087,335.946421394018,171339,84568.3,44.33618841239369,38.98771382251192,NaN,NaN,NaN,NaN,1.2064414160163055,36.72572176302765,91434416
2025-09-04T09:40:00-04:00,335.51,335.51,333,335.2,NaN,NaN,NaN,337.6564861504603,NaN,NaN,338.61350000000016,344.12888294235273,333.0981170576476,335.5317277947395,335.6720587781375,336.4502944448029,334.8938231114721,183422,88725.73333333334,43.011539157913795,40.24873471182195,NaN,NaN,NaN,NaN,1.3009813148722817,36.88638085991304,91250994
2025-09-04T09:45:00-04:00,335.16,336.04,334.04,334.67,NaN,NaN,NaN,337.6564861504603,NaN,NaN,338.47410000000013,344.02865117546804,332.9195488245322,335.5317277947395,335.5113935982467,336.2679556491361,334.75483154735724,155789,91691.5,40.89808824138972,40.88352642447567,NaN,NaN,NaN,NaN,1.3509112209528331,36.39121226756378,91095205
2025-09-04T09:50:00-04:00,334.68,335,333.45,334.1,NaN,NaN,NaN,337.6564861504603,NaN,NaN,338.3295000000001,343.95511365549424,332.703886344506,335.5317277947395,335.3597372530714,336.18764562116763,334.53182888497514,94426,92954.6,38.69589345480725,41.452771576676966,NaN,NaN,NaN,NaN,1.3651318480276315,36.29264436125857,91000779
2025-09-04T09:55:00-04:00,334.1,334.82,333.61,334.45,NaN,NaN,NaN,337.6564861504603,NaN,NaN,338.1751000000001,343.79437557260474,332.55582442739546,335.5317277947395,335.266675044594,336.1129597252097,334.42039036397836,79060,93158.56666666667,40.80367379450041,42.102307197416174,NaN,NaN,NaN,NaN,1.354051001739942,36.201117019689434,91079839
2025-09-04T10:00:00-04:00,334.55,334.75,332.15,332.43,NaN,NaN,NaN,337.27800771593917,NaN,NaN,337.96850000000006,343.6574641412992,332.2795358587009,335.5317277947395,334.98068107225197,336.0559611217586,333.9054010227453,138504,94943.03333333334,33.619251791410406,41.964859295944855,NaN,NaN,NaN,NaN,1.4430473587585193,36.91289119845778,90941335
2025-09-04T10:05:00-04:00,332.46,332.86,331.86,332.11,NaN,NaN,NaN,336.1503710015783,NaN,NaN,337.7764000000001,343.5935783676376,331.9592216323626,335.2663822357916,334.60510747710424,335.972635942616,333.23757901159246,168469,98996.7,32.638835509230276,41.76175911591723,NaN,NaN,NaN,NaN,1.4114011188471964,37.71000606778141,90772866
2025-09-04T10:10:00-04:00,332.12,333.22,331.86,332.145,NaN,NaN,NaN,336.1503710015783,NaN,NaN,337.5879000000001,343.5110019205194,331.6647980794808,333.7491057886333,334.3675913130117,335.82816991107984,332.90701271494356,147040,101920.46666666666,32.86942821589017,41.14106865175531,NaN,NaN,NaN,NaN,1.407729610358112,37.972065864674185,90919906
2025-09-04T10:15:00-04:00,332.1,333.04,331.49,332.91,NaN,NaN,NaN,336.1070115944133,NaN,NaN,337.41030000000006,343.3512576366869,331.4693423633132,333.6632846309066,334.2118272691517,335.7041433121879,332.71951122611546,122318,103808.06666666667,37.87528546765752,40.760369073125624,NaN,NaN,NaN,NaN,1.4178917810468192,38.41493127766961,91042224
2025-09-04T10:20:00-04:00,332.88,334.18,332.875,334.06,NaN,NaN,NaN,336.1070115944133,NaN,NaN,337.2641000000001,343.1677516462996,331.3604483537006,332.9316277047253,334.17964349051766,335.62908026126246,332.73020671977287,100508,104903.4,44.56713996863459,40.50002025634577,NaN,NaN,NaN,NaN,1.4098280824006184,37.42024241949608,91142732
2025-09-04T10:25:00-04:00,334.07,334.22,333.29,333.73,NaN,NaN,NaN,336.1070115944133,NaN,NaN,337.11810000000014,343.00303564627694,331.23316435372334,331.11704173102424,334.1604965591259,335.5803158469371,332.74067727131467,73232,105014.6,43.13139798134401,40.05628983978162,NaN,NaN,NaN,NaN,1.3755546479434317,36.45096581802413,91069500
2025-09-04T10:30:00-04:00,333.73,334.86,333.62,333.94,NaN,NaN,NaN,336.1070115944133,NaN,NaN,336.9823000000001,342.84088863897927,331.123711361021,331.35279540609923,334.15931529808984,335.5376221250598,332.7810084711199,101277,105523.83333333333,44.35979954510831,40.02074086480257,NaN,NaN,NaN,NaN,1.3658721730903303,34.83216203258579,91170777
2025-09-04T10:35:00-04:00,333.92,334.86,333.83,334.66,NaN,NaN,NaN,336.1070115944133,NaN,NaN,336.8505,342.6148699569947,331.0861300430053,331.53923632487937,334.172425568295,335.5206423258755,332.82420881071454,83000,104400.86666666667,48.469674243682576,41.2951477200309,NaN,NaN,NaN,NaN,1.3418813035838804,33.328987088964475,91253777
2025-09-04T10:40:00-04:00,334.69,334.96,332.98,333.1,NaN,NaN,NaN,336.1070115944133,NaN,NaN,336.6829000000001,342.38608510667075,330.9797148933294,331.53923632487937,334.1518302042369,335.4752282394787,332.82843216899505,80329,104452.7,41.343955097894394,40.47286792013266,NaN,NaN,NaN,NaN,1.3874612104707433,32.61812598184503,91173448
2025-09-04T10:45:00-04:00,333.1,333.25,332.4,333.15,NaN,NaN,NaN,336.1070115944133,NaN,NaN,336.5091000000001,342.1016263308179,330.9165736691823,331.53923632487937,334.1106629097249,335.4300107930104,332.7913150264394,67158,104580.8,41.64009929948276,40.28029012635331,NaN,NaN,NaN,NaN,1.3490711240085491,32.371581552765306,91240606
2025-09-04T10:50:00-04:00,333.13,333.45,332.47,332.89,NaN,NaN,NaN,336.1070115944133,NaN,NaN,336.32490000000007,341.7735521233268,330.87624787667335,331.53923632487937,334.07516076820866,335.3898694635806,332.7604520728367,61986,104434.73333333334,40.495162200679594,40.100548915122296,NaN,NaN,NaN,NaN,1.3227089008650785,31.890834858905787,91178620
2025-09-04T10:55:00-04:00,332.84,333.19,332.75,333.05,NaN,NaN,NaN,336.1070115944133,NaN,NaN,336.14250000000015,341.4036322926559,330.8813677073444,331.53923632487937,334.0583236140239,335.369563488409,332.74708373963875,32508,103740.33333333333,41.56006727549611,40.14783313184417,NaN,NaN,NaN,NaN,1.2596582650890014,31.444427214607668,91211128
2025-09-04T11:00:00-04:00,333.05,333.68,332.83,333.45,NaN,NaN,NaN,336.1070115944133,NaN,NaN,335.97150000000016,341.0111119891082,330.9318880108921,331.53923632487937,334.0382669400079,335.3371316934895,332.73940218652626,58145,101902.36666666667,44.24637890527625,40.54429637830625,NaN,NaN,NaN,NaN,1.2303969604397886,30.384018592892335,91269273
2025-09-04T11:05:00-04:00,333.43,333.91,333.34,333.78,NaN,NaN,NaN,336.1070115944133,NaN,NaN,335.81190000000015,340.60767684643406,331.01612315356624,331.53923632487937,334.02930929343773,335.31321602964414,332.74540255723133,54370,101610.6,46.434011766555,40.94646337631015,NaN,NaN,NaN,NaN,1.183225748979807,29.106994899131074,91323643
2025-09-04T11:10:00-04:00,333.82,333.93,332.63,333.21,NaN,NaN,NaN,336.1070115944133,NaN,NaN,335.6525000000002,340.2496853345987,331.0553146654017,331.53923632487937,334.00850590357487,335.2811699303425,332.7358418768072,60730,102011.83333333333,43.27545557919266,41.636192218294596,NaN,NaN,NaN,NaN,1.1915667669098216,28.574289383667956,91262913
2025-09-04T11:15:00-04:00,333.21,334.76,333.14,334.46,NaN,NaN,NaN,336.1070115944133,NaN,NaN,335.5193000000002,339.8535155046366,331.1850844953638,331.90316385737543,334.01266986508784,335.26152166275585,332.76381806741983,87505,102911.56666666667,51.12678421956271,42.95675998331835,NaN,NaN,NaN,NaN,1.2221691407019775,27.06936771854102,91350418
2025-09-04T11:20:00-04:00,334.5,334.59,334,334.4,NaN,NaN,NaN,336.1070115944133,NaN,NaN,335.3939000000002,339.480509005111,331.3072909948894,332.00953108590033,334.01939439411217,335.2557881099298,332.7830006782945,50726,103010.7,50.76358048368604,44.23491371673234,NaN,NaN,NaN,NaN,1.1770142020804057,25.67194045806601,91299692
2025-09-04T11:25:00-04:00,334.37,334.95,334,334.8,NaN,NaN,NaN,336.1070115944133,NaN,NaN,335.27910000000026,339.09450125812225,331.46369874187826,332.4106248687203,334.03961180377524,335.2581595968878,332.82106401066267,89008,104232.36666666667,53.15291955270002,45.326173294235375,NaN,NaN,NaN,NaN,1.1607989019318043,23.95003624267765,91388700
2025-09-04T11:30:00-04:00,334.82,335.13,334.32,334.99,NaN,NaN,NaN,336.1070115944133,NaN,NaN,335.17470000000026,338.7208632281261,331.6285367718744,332.69349989497624,334.05874218095715,335.26811432792914,332.84937003398517,62943,104426.56666666667,54.28767665362106,46.02049734316298,NaN,NaN,NaN,NaN,1.1357418375081043,22.33711924989363,91451643
2025-09-04T11:35:00-04:00,335.02,335.55,334.58,335.49,NaN,NaN,NaN,336.1070115944133,NaN,NaN,335.0989000000003,338.4473272667099,331.7504727332907,333.115799915981,334.088567151334,335.2960140486209,332.8811202540471,67906,104708.63333333333,57.22411235607087,47.027119798500614,NaN,NaN,NaN,NaN,1.1239031348289559,21.316273283099484,91519549
2025-09-04T11:40:00-04:00,335.5,336.08,335.4,335.505,NaN,NaN,NaN,336.1070115944133,NaN,NaN,335.0300000000003,338.19538970750096,331.86461029249966,333.79263993278477,334.131969216116,335.3502038293582,332.9137346028738,74156,103902.73333333334,57.31270380126812,47.95232724536917,NaN,NaN,NaN,NaN,1.0921957680554595,20.92163019854569,91593705
2025-09-04T11:45:00-04:00,335.51,335.57,334.88,335.28,NaN,NaN,NaN,336.1070115944133,NaN,NaN,334.9616000000003,337.94965384161213,331.9735461583885,333.79263993278477,334.15427931092603,335.37025627357474,332.9383023482773,55061,102655.7,55.45734556310951,48.45144662532823,NaN,NaN,NaN,NaN,1.0634674989086408,19.87919702978601,91538644
2025-09-04T11:50:00-04:00,335.3,335.78,335.08,335.18,NaN,NaN,NaN,336.1070115944133,NaN,NaN,334.8890000000003,337.66863738649283,332.10936261350776,333.79263993278477,334.168127887399,335.3837546239885,332.9525011508095,32230,99851.8,54.61116991020916,49.399104826207854,NaN,NaN,NaN,NaN,1.03750553470088,19.1408913872447,91506414
2025-09-04T11:55:00-04:00,335.17,335.26,334.34,334.43,NaN,NaN,NaN,336.1070115944133,NaN,NaN,334.81880000000024,337.46054908735755,332.1770509126429,333.79263993278477,334.1779540178867,335.3838127597897,332.9720952759837,54677,94324.6,48.619377143851466,49.897624672234194,NaN,NaN,NaN,NaN,1.0291122822222467,17.993808849102,91451737
2025-09-04T12:00:00-04:00,334.42,334.66,334.05,334.43,NaN,NaN,NaN,336.1070115944133,NaN,NaN,334.76320000000027,337.3168520985589,332.2095479014416,333.79263993278477,334.18080967209306,335.3783539925718,332.9832653516143,40568,88279.66666666667,48.61937714385147,50.47792573960361,NaN,NaN,NaN,NaN,0.9991756906349443,17.249758816622034,91451737
2025-09-04T12:05:00-04:00,334.425,334.67,333.98,334.06,NaN,NaN,NaN,336.1070115944133,NaN,NaN,334.7078000000003,337.19912266887815,332.21647733112246,333.79263993278477,334.18150668919947,335.37157186878204,332.9914415096169,36270,83777.36666666667,45.747583126784896,50.777034014695666,NaN,NaN,NaN,NaN,0.9770917127324481,16.637503863570448,91415467
2025-09-04T12:10:00-04:00,334.14,334.43,333.8,334.19,NaN,NaN,NaN,336.1070115944133,NaN,NaN,334.6714000000003,337.13862114137606,332.2041788586245,333.79263993278477,334.180932077845,335.36274097231274,332.99912318337726,40803,79023.4,46.933597237291785,50.968978181268206,NaN,NaN,NaN,NaN,0.9522994475372729,16.2773099264262,91456270
2025-09-04T12:15:00-04:00,334.21,334.46,333.98,334.3,NaN,NaN,NaN,336.1070115944133,NaN,NaN,334.6606000000003,337.1295014886089,332.1916985113916,333.79263993278477,334.1816266171353,335.3571947605185,333.0060584737521,31474,74879.56666666667,47.97007030383663,51.0786966482169,NaN,NaN,NaN,NaN,0.9185637727131792,15.897411367237593,91487744
2025-09-04T12:20:00-04:00,334.31,334.63,334.16,334.16,NaN,NaN,NaN,336.1070115944133,NaN,NaN,334.62340000000034,337.06515137152377,332.1816486284769,333.79263993278477,334.1834067691276,335.35130236660035,333.01551117165485,39793,73058.46666666666,46.71936402988544,51.32469010898067,NaN,NaN,NaN,NaN,0.8865235032336642,15.278238862004123,91447951
2025-09-04T12:25:00-04:00,334.2,334.241,332.87,333.2,NaN,NaN,NaN,336.1070115944133,NaN,NaN,334.5690000000003,337.013975255588,332.1240247444126,333.79263993278477,334.16760672577533,335.32805957770415,333.0071538738465,65281,72599.16666666667,39.176467828441645,50.47109608104345,NaN,NaN,NaN,NaN,0.9211289672884011,16.13127153981317,91382670
2025-09-04T12:30:00-04:00,333.17,333.59,333.06,333.4,NaN,NaN,NaN,336.1070115944133,NaN,NaN,334.52460000000036,336.9722469026948,332.07695309730593,333.69008955698223,334.15906490739894,335.31642949267075,333.00170032212714,32559,69067.66666666667,41.30266265044987,49.79531623581229,NaN,NaN,NaN,NaN,0.8931911839106562,16.923373312064424,91415229
2025-09-04T12:35:00-04:00,333.37,333.67,333.34,333.49,NaN,NaN,NaN,336.1070115944133,NaN,NaN,334.49400000000037,336.9543308721062,332.03366912789454,333.69008955698223,334.1527673965026,335.3063723736786,332.99916241932664,30066,64454.23333333333,42.28046580457512,49.01871239666051,NaN,NaN,NaN,NaN,0.8529632422027552,17.520202507021505,91445295
2025-09-04T12:40:00-04:00,333.5,334.06,333.28,333.62,NaN,NaN,NaN,336.1070115944133,NaN,NaN,334.4694000000004,336.93957783978107,331.99922216021974,333.1280716455858,334.14494255688663,335.2911541185869,332.99873099518635,50083,61222.333333333336,43.73837616338983,48.26519093307257,NaN,NaN,NaN,NaN,0.8477515820454177,17.41056377453849,91495378
2025-09-04T12:45:00-04:00,333.63,334.38,333.63,334.15,NaN,NaN,NaN,336.1070115944133,NaN,NaN,334.4430000000003,336.89800631372503,331.9879936862756,333.0012417168256,334.14332859459887,335.27946229154816,333.0071948976496,57328,59056,49.35484215843133,47.70310020466974,NaN,NaN,NaN,NaN,0.8414836118993158,16.799094799658906,91552706
2025-09-04T12:50:00-04:00,334.15,334.29,333.81,334.17,NaN,NaN,NaN,336.1070115944133,NaN,NaN,334.4224000000003,336.86892344367055,331.9758765563301,333.0012417168256,334.1423889793591,335.2684910831596,333.01628687555865,58361,57651.1,49.55947215791783,47.14929794443044,NaN,NaN,NaN,NaN,0.8156633539065087,16.23130218012787,91611067
2025-09-04T12:55:00-04:00,334.16,334.32,333.46,333.58,NaN,NaN,NaN,336.1070115944133,NaN,NaN,334.3882000000004,336.8330621720318,331.94333782796895,333.0012417168256,334.1378894832355,335.2575528826274,333.01822608384356,42434,56624.5,43.92158846988472,46.32531529491438,NaN,NaN,NaN,NaN,0.8188302571989018,16.17535807837711,91568633
2025-09-04T13:00:00-04:00,333.6,334.77,333.5,334.44,NaN,NaN,NaN,336.1070115944133,NaN,NaN,334.3642000000003,336.78285694971,331.94554305029067,333.0012417168256,334.1396689061259,335.24927915439076,333.03005865786105,61543,55300.03333333333,52.418460081200486,46.168693164270906,NaN,NaN,NaN,NaN,0.8510566673989789,15.372191338891007,91630176
2025-09-04T13:05:00-04:00,334.4,334.7,334.18,334.34,NaN,NaN,NaN,336.1070115944133,NaN,NaN,334.3384000000003,336.7298651911437,331.94693480885695,333.0012417168256,334.142272755477,335.2467708044208,333.0377747065332,33645,53654.86666666667,51.442412670195914,46.370338559009795,NaN,NaN,NaN,NaN,0.8274097625847647,14.626393652225337,91596531
2025-09-04T13:10:00-04:00,334.34,334.4,333.89,333.98,NaN,NaN,NaN,336.1070115944133,NaN,NaN,334.29420000000033,336.62814375261,331.96025624739065,332.81803246009116,334.14179189399204,335.24120934668605,333.042374441298,32031,52044.933333333334,47.97884536177387,46.3245862888614,NaN,NaN,NaN,NaN,0.8047376366858524,14.366746482885198,91564500
2025-09-04T13:15:00-04:00,333.96,334.22,333.93,334.05,NaN,NaN,NaN,336.1070115944133,NaN,NaN,334.24820000000034,336.50773425296154,331.98866574703914,332.81803246009116,334.14134749508736,335.2375234928775,333.04517149729725,20720,50497,48.70208503083611,46.53562213915077,NaN,NaN,NaN,NaN,0.7679706626368644,14.125645539926495,91585220
2025-09-04T13:20:00-04:00,334.04,334.49,334.04,334.24,NaN,NaN,NaN,336.1070115944133,NaN,NaN,334.19580000000036,336.3285909977756,332.0630090022251,333.0222326195667,334.1422193045859,335.2342895955799,333.0501490135919,26682,49320.2,50.70536722715161,46.80503428128362,NaN,NaN,NaN,NaN,0.7452584724485162,13.391210942770556,91611902
2025-09-04T13:25:00-04:00,334.24,335.11,334.2,335.04,NaN,NaN,NaN,336.1070115944133,NaN,NaN,334.1570000000004,336.15190551158565,332.1620944884151,333.48078609565334,334.15137535476754,335.23828447203215,333.0644662375029,51135,49941.1,58.12116791671217,47.5301126822033,NaN,NaN,NaN,NaN,0.7570257244164811,13.179138085357698,91663037
2025-09-04T13:30:00-04:00,335.12,335.23,334.77,335.08,NaN,NaN,NaN,336.1070115944133,NaN,NaN,334.12920000000037,336.03096587417156,332.2274341258292,333.69662887652265,334.1614223474109,335.24609013652963,333.0767545582922,41576,49388.8,58.45768244776804,48.368563997766344,NaN,NaN,NaN,NaN,0.7358096012438778,13.160328357394244,91704613
2025-09-04T13:35:00-04:00,335.12,335.59,335.09,335.19,NaN,NaN,NaN,336.1070115944133,NaN,NaN,334.1520000000003,336.0766184038253,332.22738159617535,334.1083031012181,334.1774228488835,335.2626076354064,333.0922380623606,52091,49312.833333333336,59.42329611376543,49.814766018146614,NaN,NaN,NaN,NaN,0.7196803440121716,13.656130515288071,91756704
2025-09-04T13:40:00-04:00,335.18,335.4,334.88,334.99,NaN,NaN,NaN,336.1070115944133,NaN,NaN,334.1040000000004,335.8105602831894,332.3974397168114,334.1083031012181,334.1881999818008,335.27145322855534,333.1049467350462,43909,48752.13333333333,56.8365011246711,50.92432590916241,NaN,NaN,NaN,NaN,0.7054174622970153,13.693745422951615,91712795
2025-09-04T13:45:00-04:00,334.99,335.18,334.83,334.9,NaN,NaN,NaN,336.1070115944133,NaN,NaN,334.09140000000036,335.76463762812426,332.41816237187646,334.1083031012181,334.1917526639667,335.273820169774,333.10968515815944,16973,46401.066666666666,55.66224406022448,51.88016721313737,NaN,NaN,NaN,NaN,0.6800305007043729,13.626898638277135,91695822
2025-09-04T13:50:00-04:00,334.89,335.59,334.81,335.44,NaN,NaN,NaN,336.1070115944133,NaN,NaN,334.0962000000004,335.78344931178685,332.40895068821396,334.1349711878237,334.20349230833074,335.2855629871137,333.1214216295478,40732,46067.933333333334,60.88410234895893,53.10486194067802,NaN,NaN,NaN,NaN,0.6871711792254871,14.183362960280427,91736554
2025-09-04T13:55:00-04:00,335.38,335.38,334.8,334.84,NaN,NaN,NaN,336.1070115944133,NaN,NaN,334.09960000000035,335.7921375506061,332.4070624493946,334.1349711878237,334.20884997210936,335.2892854966787,333.12841444754,25356,43946.2,53.36372421114492,53.391210658728994,NaN,NaN,NaN,NaN,0.6838018092808085,14.677527573861395,91711198
2025-09-04T14:00:00-04:00,334.86,335.36,334.86,335.26,NaN,NaN,NaN,336.1070115944133,NaN,NaN,334.12280000000044,335.84624209069085,332.39935790931,334.1349711878237,334.2151245312056,335.2947396800725,333.13550938233874,25242,42689.5,57.33634033123245,53.94670124253719,NaN,NaN,NaN,NaN,0.6721016800464678,15.136394715043725,91736440
2025-09-04T14:05:00-04:00,335.25,335.41,334.9,335.3,NaN,NaN,NaN,336.1070115944133,NaN,NaN,334.1398000000004,335.8923398255526,332.38726017444816,334.1349711878237,334.2238306122444,335.3026391603262,333.1450220641626,34010,41559.63333333333,57.7058522076296,54.931291509518964,NaN,NaN,NaN,NaN,0.6605229886145806,15.646203156174842,91770450
2025-09-04T14:10:00-04:00,335.29,335.45,335.18,335.45,NaN,NaN,NaN,336.1070115944133,NaN,NaN,334.2002000000004,335.92074056622045,332.47965943378034,334.18478019853256,334.2301471765089,335.3092645653892,333.15102978762866,21582,39807.166666666664,59.13519271417432,55.41105812615995,NaN,NaN,NaN,NaN,0.6326284894278235,16.189753253913196,91792032
2025-09-04T14:15:00-04:00,335.4,336.06,335.35,335.99,NaN,NaN,NaN,336.1070115944133,NaN,NaN,334.27780000000035,335.9638986448593,332.5917013551414,334.69282415882606,334.2563257189162,335.34512625793735,333.167525179895,65833,40166.23333333333,63.86911579447136,56.2986797778939,NaN,NaN,NaN,NaN,0.6381550258972631,17.636588113260373,91857865
2025-09-04T14:20:00-04:00,335.97,336.33,335.75,335.98,333.88910790498187,333.88910790498187,333.88910790498187,NaN,NaN,NaN,334.3545000000004,335.9937952754054,332.7152047245955,334.94625932706083,334.2793019640109,335.3793189666643,333.17928496135755,52109,40828.86666666667,63.72190102303387,57.42318375369819,NaN,NaN,NaN,NaN,0.634001095476029,19.323814167575197,91805756
2025-09-04T14:25:00-04:00,335.98,336.15,335.3,335.4,333.88910790498187,NaN,NaN,NaN,NaN,NaN,334.4043000000004,336.0160965256404,332.79250347436033,334.94625932706083,334.2904838782613,335.3926405628712,333.1883271936514,33726,40130.5,55.70240447683795,57.92320657126975,NaN,NaN,NaN,NaN,0.6494295886563102,19.683316062547593,91772030
2025-09-04T14:30:00-04:00,335.41,336.04,335.41,335.93,333.88910790498187,NaN,NaN,NaN,NaN,NaN,334.44170000000037,336.1057403961846,332.7776596038161,334.94625932706083,334.30326872761236,335.40937254191465,333.1971649133101,34609,39931.86666666667,60.58401697941278,58.62882441071697,NaN,NaN,NaN,NaN,0.648756046609434,20.017139250736246,91806639
2025-09-04T14:35:00-04:00,335.94,336,335.65,335.92,333.88910790498187,NaN,NaN,NaN,NaN,NaN,334.48550000000034,336.1871653607968,332.78383463920386,334.94625932706083,334.31059839780113,335.419212363877,333.20198443172524,19287,39365.76666666667,60.44866062602866,58.79507388995387,NaN,NaN,NaN,NaN,0.6274163289944761,20.327117925482856,91787352
2025-09-04T14:40:00-04:00,335.9,336.3,335.8,335.875,333.9702443671402,NaN,NaN,NaN,NaN,NaN,334.5242000000003,336.26210835210964,332.78629164789095,334.94625932706083,334.3268666085846,335.4423102847507,333.21142293241854,39943,39337.1,59.801178889619,58.891037921514645,NaN,NaN,NaN,NaN,0.6183151626377278,21.104461648230636,91747409
2025-09-04T14:45:00-04:00,335.9,336.07,335.6,336.07,333.9702443671402,NaN,NaN,NaN,NaN,NaN,334.55240000000026,336.3431621171822,332.7616378828183,334.94625932706083,334.338476123593,335.45802645991125,333.21892578727477,30427,39302.2,61.71489479320113,59.05472354147434,NaN,NaN,NaN,NaN,0.6077212224493166,21.253905236216355,91777836
2025-09-04T14:50:00-04:00,336.09,336.37,336.06,336.18,334.21656563204306,NaN,NaN,NaN,NaN,NaN,334.61400000000026,336.41256053564024,332.8154394643603,335.14432468503304,334.355124550785,335.48338565388934,333.2268634476806,37454,39224.23333333333,62.791000413939905,59.48004491927926,NaN,NaN,NaN,NaN,0.586455420845794,21.885290954330824,91815290
2025-09-04T14:55:00-04:00,336.2,336.62,336.17,336.33,334.4260399214956,NaN,NaN,NaN,NaN,NaN,334.6776000000002,336.4894357984169,332.86576420158354,335.41445974802645,334.37499611651896,335.5152370274553,333.2347552055826,41719,38438.833333333336,64.26599362948812,60.09459845994095,NaN,NaN,NaN,NaN,0.5767086050710937,22.843962423880846,91857009
2025-09-04T15:00:00-04:00,336.39,336.61,336.02,336.6,334.4260399214956,NaN,NaN,NaN,NaN,NaN,334.75180000000023,336.5685925144199,332.93500748558057,335.41445974802645,334.3931893810217,335.54437058233833,333.2420081797051,38222,38627.6,66.81592740993068,60.51830025001036,NaN,NaN,NaN,NaN,0.5776579904231607,23.289844169279483,91895231
2025-09-04T15:05:00-04:00,336.61,337.25,336.54,336.86,334.92735249045364,NaN,NaN,NaN,NaN,NaN,334.82800000000026,336.67228305861323,332.9837169413873,335.8874542387369,334.4478133695218,335.643298997076,333.2523277419676,95887,40821.63333333333,69.10240101002165,61.64249144993012,NaN,NaN,NaN,NaN,0.5871109911072192,24.5872501047374,91991118
2025-09-04T15:10:00-04:00,336.94,337.42,336.9,337.32,335.20542737725117,NaN,NaN,NaN,NaN,NaN,334.9054000000002,336.8347292514424,332.976070748558,336.04996339098955,334.48015109976023,335.70524663225143,333.25505556726904,51718,40876.13333333333,72.68798146737956,62.739037245369204,NaN,NaN,NaN,NaN,0.585174491742418,25.99069677472563,92042836
2025-09-04T15:15:00-04:00,337.3,337.3,336.93,337.2,335.20542737725117,NaN,NaN,NaN,NaN,NaN,334.97380000000027,336.97966396356605,332.9679360364345,336.04996339098955,334.5003049338685,335.74238719947823,333.2582226682588,33726,40089.4,70.39303516218598,63.64526459926609,NaN,NaN,NaN,NaN,0.5712334566179585,27.293897254000417,92009110
2025-09-04T15:20:00-04:00,337.22,337.72,337,337.53,335.4301311433219,NaN,NaN,NaN,NaN,NaN,335.0602000000002,337.1259889147888,332.99441108521154,336.32717657023335,334.5557357925345,335.8488054110034,333.2626661740656,86348,41022.3,72.92466996007545,64.6302272596876,NaN,NaN,NaN,NaN,0.5818596382881063,28.981338895102688,92095458
2025-09-04T15:25:00-04:00,337.58,337.58,336.74,336.88,335.4301311433219,NaN,NaN,NaN,NaN,NaN,335.10860000000025,337.2285594713954,332.9886405286051,336.32717657023335,334.5814181918137,335.89243088072175,333.2704055029057,46947,41172.73333333333,61.72833611550186,64.4773144254755,NaN,NaN,NaN,NaN,0.6002982355532398,29.750753119294693,92048511
2025-09-04T15:30:00-04:00,336.86,336.99,336.75,336.765,335.4301311433219,NaN,NaN,NaN,NaN,NaN,335.15590000000026,337.3156691451368,332.99613085486374,336.32717657023335,334.59874911908855,335.9194658479646,333.2780323902125,35572,40307.03333333333,59.97391857796558,64.2096013936849,NaN,NaN,NaN,NaN,0.5745626472994376,30.465209184615844,92012939
2025-09-04T15:35:00-04:00,336.75,337.5,336.74,337.35,335.4301311433219,NaN,NaN,NaN,NaN,NaN,335.20690000000025,337.44948590924537,332.9643140907551,336.32717657023335,334.6313524560808,335.9752423188332,333.28746259332837,58787,41145.1,65.36640083328645,64.8998868477169,NaN,NaN,NaN,NaN,0.5878081724923343,31.74855005244862,92071726
2025-09-04T15:40:00-04:00,337.32,337.5,337.09,337.44,335.4301311433219,NaN,NaN,NaN,NaN,NaN,335.25590000000017,337.5828642800377,332.9289357199626,336.32717657023335,334.65941718482384,336.0242152189922,333.2946191506555,48982,41710.13333333333,66.12258442349936,65.2954988080088,NaN,NaN,NaN,NaN,0.5751075887428837,32.9402237154362,92120708
2025-09-04T15:45:00-04:00,337.4,337.71,337.12,337.69,335.5338239735728,NaN,NaN,NaN,NaN,NaN,335.2999000000002,337.72407449049615,332.87572550950426,336.32717657023335,334.69420925219674,336.08624512602023,333.30217337837325,58554,42971.26666666667,68.199620804055,65.84913882072497,NaN,NaN,NaN,NaN,0.5761713324041045,34.283863118374114,92179262
2025-09-04T15:50:00-04:00,337.68,338.71,337.66,338.7,336.24615015659225,NaN,NaN,NaN,NaN,NaN,335.3638000000002,337.96798475542784,332.75961524457256,337.07134209482723,334.79307336783376,336.28899031520547,333.29715642046204,132939,46513.166666666664,74.89603369369574,66.92734273530188,NaN,NaN,NaN,NaN,0.6100162372323794,36.386789785741364,92312201
2025-09-04T15:55:00-04:00,338.63,338.88,338.35,338.63,336.69200696765625,NaN,NaN,NaN,NaN,NaN,335.43080000000026,338.19063793731067,332.67096206268985,337.30407367586184,334.90517496040127,336.51410464362704,333.2962452771755,148614,49762.46666666667,73.73710331398337,67.78607191535775,NaN,NaN,NaN,NaN,0.6043007917157789,38.45211271324785,92163587
2025-09-05T09:30:00-04:00,348.08,353.04,347.57,349.41,346.5044157418537,NaN,NaN,NaN,NaN,NaN,335.7154000000002,340.50300142037474,330.9277985796257,344.57425894068945,350.0066666666666,350.00667206146323,350.00666127187,840933,76407.7,92.63577135376062,69.91784126820208,NaN,NaN,NaN,NaN,1.5904221637360823,42.342404216902416,93004520
2025-09-05T09:35:00-04:00,349.31,350.82,348.13,350.445,346.5044157418537,NaN,NaN,NaN,NaN,NaN,336.03570000000013,342.339307541763,329.7320924582373,344.57425894068945,349.95066858512064,350.0430291926346,349.85830797760667,309125,84975.5,93.14575305221535,71.98068122696831,NaN,NaN,NaN,NaN,1.6689634377549332,45.954817756010236,93313645
2025-09-05T09:40:00-04:00,350.4,354.6,349.72,354.13,347.6814717813171,NaN,NaN,NaN,NaN,NaN,336.42970000000014,344.49819165833037,328.3612083416699,345.66592572204127,350.8962202987704,352.24588598129134,349.54655461624947,566243,102386.63333333333,94.58388054029137,73.96410645056551,NaN,NaN,NaN,NaN,1.8983231922010089,49.409227491282856,93879888
2025-09-05T09:45:00-04:00,354.14,354.7,352.96,354.51,349.31776851852993,NaN,NaN,NaN,NaN,NaN,336.8387000000002,346.3325914698034,327.344808530197,346.682740577633,351.4440026072322,353.1577824681835,349.73022274628096,359847,113815.76666666666,94.7072061876029,75.79302110610703,NaN,NaN,NaN,NaN,1.8870143927580805,52.61916725587227,94239735
2025-09-05T09:50:00-04:00,354.59,355.87,353.74,355.74,350.2074154040513,NaN,NaN,NaN,NaN,NaN,337.26970000000017,348.1053085957595,326.43409140424086,348.3911924621064,352.1483707611404,354.2613139718996,350.03542755038126,492664,128880.16666666667,95.09641700105834,77.39362364422695,NaN,NaN,NaN,NaN,1.9043705075610744,55.62643460289117,94732399
2025-09-05T09:55:00-04:00,355.7,355.82,353.58,354.49,350.2074154040513,NaN,NaN,NaN,NaN,NaN,337.6735000000002,349.4961801107162,325.85081988928425,348.7169539696851,352.3943016524829,354.53250624858657,350.25609705637925,282574,137454.1,88.01309778711115,78.65219954600731,NaN,NaN,NaN,NaN,1.928344042735284,58.28517858095731,94449825
2025-09-05T10:00:00-04:00,354.49,354.74,352.41,354.67,350.2074154040513,NaN,NaN,NaN,NaN,NaN,338.0837000000002,350.78116491392694,325.38623508607344,348.7169539696851,352.5296677964558,354.6183131861848,350.44102240672674,273681,145735.4,88.14997747654334,79.73972151146931,NaN,NaN,NaN,NaN,1.9570337539684768,59.784504730623375,94723506
2025-09-05T10:05:00-04:00,354.6,354.7,350.77,350.87,350.2074154040513,NaN,NaN,NaN,NaN,NaN,338.43710000000016,351.5480558904188,325.3261441095815,348.7169539696851,352.50078532643005,354.51845565978925,350.48311499307084,232957,152366.96666666667,69.98174790042812,80.32925092467833,NaN,NaN,NaN,NaN,2.0979599143993,59.94689966711143,94490549
2025-09-05T10:10:00-04:00,350.89,351.55,349.05,349.07,NaN,NaN,NaN,355.5245718777948,355.5245718777948,355.5245718777948,338.7505000000001,352.1116070275129,325.3893929724873,348.7169539696851,352.31139106642706,354.36912500519793,350.2536571276562,262655,160402.73333333334,63.32393079219079,80.5685375114087,NaN,NaN,NaN,NaN,2.1266770633707788,58.96492840428468,94227894
2025-09-05T10:15:00-04:00,349.05,349.63,346.24,346.37,NaN,NaN,NaN,353.38436406516774,NaN,NaN,339.00810000000007,352.44999211237604,325.5662078876241,348.7169539696851,351.9404901492026,354.3053917232893,349.57558857511594,296635,168096.13333333333,54.888548594289404,79.82011949433749,NaN,NaN,NaN,NaN,2.2169144159871506,56.51923458976243,93931259
2025-09-05T10:20:00-04:00,346.38,348.56,346.26,347.14,NaN,NaN,NaN,352.92530206220556,NaN,NaN,339.27850000000007,352.8195373679691,325.73746263203105,348.7169539696851,351.79222665562367,354.2572551500536,349.32719816119373,129867,170688.06666666668,56.661600353218105,79.14433491788883,NaN,NaN,NaN,NaN,2.2228491005594977,54.24823319056321,94061126
2025-09-05T10:25:00-04:00,347.07,348.29,346.64,347.87,NaN,NaN,NaN,352.92530206220556,NaN,NaN,339.5529000000001,353.22255619029005,325.8832438097101,348.7169539696851,351.5801839001644,354.1517577710874,349.0086100292414,215612,176750.93333333332,58.33360454995316,78.43961947116726,NaN,NaN,NaN,NaN,2.181931307662393,52.13944617702108,94276738
2025-09-05T10:30:00-04:00,347.84,348.57,347.16,348.01,NaN,NaN,NaN,352.92530206220556,NaN,NaN,339.82970000000006,353.6121809682715,326.0472190317286,348.7169539696851,351.4669357697975,354.0767620743667,348.8571094652283,135849,180125.6,58.6629817238033,77.28011575903209,NaN,NaN,NaN,NaN,2.1267933571150768,50.277809507555595,94412587
2025-09-05T10:35:00-04:00,348.04,348.46,347.03,347.57,NaN,NaN,NaN,352.92530206220556,NaN,NaN,340.10950000000014,353.9410548294676,326.2779451705327,348.7169539696851,351.38335474128974,354.02334946597205,348.7433600166074,99452,182797.76666666666,57.13431121316182,76.09420203754483,NaN,NaN,NaN,NaN,2.077022403035429,48.46903380980495,94313135
2025-09-05T10:40:00-04:00,347.56,348.38,346.66,347.2,NaN,NaN,NaN,352.89040720562036,NaN,NaN,340.3647000000001,354.23920747380583,326.49019252619433,348.7169539696851,351.27992095602957,353.9609514912493,348.5988904208098,120327,185477.23333333334,55.81711382312539,73.46429792821375,NaN,NaN,NaN,NaN,2.0515208028186107,46.552546996000316,94192808
2025-09-05T10:45:00-04:00,347.2,347.21,344.77,345.34,NaN,NaN,NaN,351.44902505991035,NaN,NaN,340.5847000000001,354.41889262699135,326.7505073730089,347.89256317574814,351.04406412933133,353.89418537594673,348.19394288271593,206667,191351.9,49.623588269801665,70.35557187232705,NaN,NaN,NaN,NaN,2.0792693169029954,43.66593894810421,93986141
2025-09-05T10:50:00-04:00,345.27,348.25,344.7,348.21,NaN,NaN,NaN,351.44902505991035,NaN,NaN,340.8693000000001,354.7337418582442,327.0048581417561,347.25705054059847,350.91077573601206,353.80318527466204,348.01836619736207,166724,195660.9,57.46616437255278,67.7043064317743,NaN,NaN,NaN,NaN,2.1843215085527823,41.45617743543956,94152865
2025-09-05T10:55:00-04:00,348.18,349.17,346.62,346.64,NaN,NaN,NaN,351.44902505991035,NaN,NaN,341.1211000000001,354.9382265160525,327.30397348394774,344.3456404324788,350.8108467556901,353.718727659687,347.9029658516932,149610,199257.26666666666,52.638496066129065,64.69939856595474,NaN,NaN,NaN,NaN,2.210441400799013,39.795024411532815,94003255
2025-09-05T11:00:00-04:00,346.62,347.08,345.28,345.91,NaN,NaN,NaN,351.44902505991035,NaN,NaN,341.35450000000014,355.0928334142292,327.6161665857711,343.15936276553174,350.7302656483338,353.67735841753523,347.78317287913234,89284,200959.33333333334,50.51358247637907,61.5149103856205,NaN,NaN,NaN,NaN,2.1811241578847986,37.496671460621215,93913971
2025-09-05T11:05:00-04:00,345.93,346.83,345.63,345.85,NaN,NaN,NaN,351.44902505991035,NaN,NaN,341.57070000000016,355.24482754220696,327.89657245779335,343.15936276553174,350.648096473667,353.63214623235007,347.66404671498395,94571,200915.46666666667,50.333732654038556,58.823527161829595,NaN,NaN,NaN,NaN,2.111043860893026,35.36248657763188,93819400
2025-09-05T11:10:00-04:00,345.8,347.25,344.94,347.19,NaN,NaN,NaN,351.44902505991035,NaN,NaN,341.8129000000001,355.4475216801395,328.17827831986074,343.15936276553174,350.5622291508982,353.57457590049,347.5498824013064,111468,202907.13333333333,54.25131961627496,56.402194457524715,NaN,NaN,NaN,NaN,2.1252550136863815,32.99062246341537,93930868
2025-09-05T11:15:00-04:00,347.22,347.79,346.48,346.85,NaN,NaN,NaN,351.44902505991035,NaN,NaN,342.04610000000014,355.6183564505929,328.4738435494074,343.15936276553174,350.5088659578026,353.52910840048196,347.4886235151232,83636,204570.8,53.106689533248776,55.19683314558334,NaN,NaN,NaN,NaN,2.067022512708783,31.074849732532616,93847232
2025-09-05T11:20:00-04:00,346.8,348.26,346.58,348.22,NaN,NaN,NaN,351.44902505991035,NaN,NaN,342.31070000000017,355.8381673180379,328.78323268196243,343.4661322705968,350.46001074445184,353.47653983297164,347.44348165593203,97247,204934.1,57.039894027976906,54.747973376710924,NaN,NaN,NaN,NaN,2.039378047515299,29.544059959038645,93944479
2025-09-05T11:25:00-04:00,348.24,348.79,347.77,348.56,NaN,NaN,NaN,351.44902505991035,NaN,NaN,342.58390000000014,356.0532964660874,329.1145035339129,344.44490581647744,350.421832763227,353.42369406018355,347.4199714662704,104696,206859.06666666668,57.981818158882746,54.96892120275329,NaN,NaN,NaN,NaN,1.9665653298356374,28.400313544474713,94049175
2025-09-05T11:30:00-04:00,348.6,349.17,348.06,348.15,NaN,NaN,NaN,351.44902505991035,NaN,NaN,342.8381000000001,356.23816953566654,329.4380304643337,345.13892465318196,350.38708357415635,353.3734734394841,347.4006937088286,103185,209112.83333333334,56.37658196338427,54.948562746336606,NaN,NaN,NaN,NaN,1.9053820919902356,27.53686158395873,93945990
2025-09-05T11:35:00-04:00,348.22,349.47,347.92,348.77,NaN,NaN,NaN,351.44902505991035,NaN,NaN,343.11670000000015,356.4189110357891,329.8144889642112,345.4701397225456,350.3609939098975,353.33113928289157,347.39084853690343,92618,210240.53333333333,58.258528930636565,54.9432002020997,NaN,NaN,NaN,NaN,1.8799976568480765,26.894155509570123,94038608
2025-09-05T11:40:00-04:00,348.81,349.5,348.76,349.06,NaN,NaN,NaN,351.44902505991035,NaN,NaN,343.39270000000016,356.6037454105855,330.18165458941485,345.93011177803646,350.34474133823767,353.2989891376805,347.39049353879483,77689,211197.43333333332,59.14631818457835,54.977724235012204,NaN,NaN,NaN,NaN,1.7985692527875001,26.313984199592884,94116297
2025-09-05T11:45:00-04:00,349.02,349.02,347.74,348.82,NaN,NaN,NaN,351.44902505991035,NaN,NaN,343.6631000000001,356.7534154874412,330.572784512559,345.93011177803646,350.3230258766724,353.26621204146034,347.3798397118844,72481,211661.66666666666,58.04601475061083,55.042845916258564,NaN,NaN,NaN,NaN,1.7643857347312495,24.971674893126966,94043816
2025-09-05T11:50:00-04:00,348.84,349.05,347.61,348.15,NaN,NaN,NaN,351.44902505991035,NaN,NaN,343.9171000000001,356.85203240649713,330.9821675935031,345.93011177803646,350.30481038645763,353.2412288066716,347.3683919662437,54323,209041.13333333333,54.97154019846091,54.982447800211105,NaN,NaN,NaN,NaN,1.7412153251075888,23.626678333438893,93989493
2025-09-05T11:55:00-04:00,348.15,348.5,346.93,346.96,NaN,NaN,NaN,351.44902505991035,NaN,NaN,344.13650000000007,356.8971252590087,331.37587474099143,345.93011177803646,350.2737819889214,353.20901625392656,347.3385477239163,67596,206340.53333333333,49.914651656815145,55.003238042140644,NaN,NaN,NaN,NaN,1.7289856590284747,22.01152201844915,93921897
2025-09-05T12:00:00-04:00,346.97,347.42,346.18,346.44,NaN,NaN,NaN,351.44902505991035,NaN,NaN,344.34570000000014,356.9059829602154,331.7854170397849,345.93011177803646,350.2230844518209,353.1681965792585,347.2779723243833,88575,181261.93333333332,47.843511042353356,54.31590566141211,NaN,NaN,NaN,NaN,1.6940581119550129,21.035963051377614,93833322
2025-09-05T12:05:00-04:00,346.48,347.04,345.81,346.96,NaN,NaN,NaN,351.4094508244258,NaN,NaN,344.5769000000001,356.8932150154927,332.2605849845075,345.93011177803646,350.16418579875284,353.120920702222,347.20745089528367,103855,174419.6,50.07445685669364,54.1327600035953,NaN,NaN,NaN,NaN,1.6609111039582276,20.378177508765464,93937177
2025-09-05T12:10:00-04:00,346.94,347.62,346.91,347.38,NaN,NaN,NaN,351.4094508244258,NaN,NaN,344.8059000000001,356.8942799890963,332.71752001090397,345.93011177803646,350.1380857983208,353.09384477747517,347.1823268191664,58766,157503.7,51.865347808552684,54.22931467017912,NaN,NaN,NaN,NaN,1.5929888822469243,19.28706839652187,93995943
2025-09-05T12:15:00-04:00,347.34,347.55,346.68,347.24,NaN,NaN,NaN,351.4094508244258,NaN,NaN,345.0323000000001,356.86788840281827,333.1967115971819,345.93011177803646,350.1182530365519,353.07411691158387,347.1623891615199,43136,146946.66666666666,51.205975931013356,54.291617761391606,NaN,NaN,NaN,NaN,1.5413468192292872,18.443602922652683,93952807
2025-09-05T12:20:00-04:00,347.33,347.8,346.43,347.78,NaN,NaN,NaN,351.4094508244258,NaN,NaN,345.2704000000001,356.83542846347007,333.70537153653015,345.93011177803646,350.0992277394321,353.0538732651225,347.14458221374167,44658,132013.13333333333,53.65346523040336,54.2489138766865,NaN,NaN,NaN,NaN,1.5291077607129098,17.660384982631292,93997465
2025-09-05T12:25:00-04:00,347.79,348,347.42,347.77,NaN,NaN,NaN,351.4094508244258,NaN,NaN,345.5044000000001,356.7853091194338,334.2234908805664,345.93011177803646,350.0807388918884,353.031207751626,347.1302700321508,51353,124305.76666666666,53.59984747329253,54.28413944383248,NaN,NaN,NaN,NaN,1.461314349233415,16.744046544284103,93946112
2025-09-05T12:30:00-04:00,347.8,347.98,347.16,347.32,NaN,NaN,NaN,351.4094508244258,NaN,NaN,345.7272000000001,356.69845829797356,334.75594170202663,345.5172715379433,350.06054388587415,353.0083354223686,347.1127523493797,51632,116904.13333333333,51.12395104033001,53.861572087571986,NaN,NaN,NaN,NaN,1.4155061814310277,16.119723204478223,93894480
2025-09-05T12:35:00-04:00,347.32,347.53,346.86,347.31,NaN,NaN,NaN,351.4094508244258,NaN,NaN,345.94680000000005,356.5915847813333,335.3020152186668,345.5172715379433,350.03481969937155,352.9814240533796,347.0882153453635,60899,111168.86666666667,51.06749821628951,53.367692091672474,NaN,NaN,NaN,NaN,1.362255739900237,15.80131594687027,93833581
2025-09-05T12:40:00-04:00,347.32,348.51,347.24,348.2,NaN,NaN,NaN,351.4094508244258,NaN,NaN,346.17880000000014,356.4993274206647,335.85827257933556,345.9622637460655,350.0155462724882,352.95494659737557,347.0761459476009,63477,104529.6,55.75069499096845,53.32298587935706,NaN,NaN,NaN,NaN,1.355666044193076,14.818534244595153,93897058
2025-09-05T12:45:00-04:00,348.18,348.52,347.76,348.235,NaN,NaN,NaN,351.4094508244258,NaN,NaN,346.4063000000001,356.3911532909015,336.4214467090987,346.10181099685235,350.00259562376544,352.93570006699684,347.06949118053404,47791,96234.8,55.92932622429589,53.156614257475574,NaN,NaN,NaN,NaN,1.3131184696078555,13.915375290889385,93944849
2025-09-05T12:50:00-04:00,348.22,348.59,347.97,348.34,NaN,NaN,NaN,351.4094508244258,NaN,NaN,346.62670000000014,356.28057271723964,336.97282728276065,346.34544879748194,349.99205762357286,352.91911839663163,347.0649968505141,42377,93318.46666666666,56.49671266982775,52.96735672070768,NaN,NaN,NaN,NaN,1.263610007493005,13.1469617725474,93987226
2025-09-05T12:55:00-04:00,348.34,349.07,348.18,349.03,NaN,NaN,NaN,351.4094508244258,NaN,NaN,346.86330000000015,356.1544998385897,337.5721001614106,346.82935903798557,349.97810729120016,352.8914674915627,347.0647470908376,78412,88745.13333333333,60.12938845027948,53.116169127826865,NaN,NaN,NaN,NaN,1.2369235783863608,12.911396710588402,94065638
2025-09-05T13:00:00-04:00,349.04,349.1,348.61,348.88,NaN,NaN,NaN,351.4094508244258,NaN,NaN,347.0903000000001,356.0052764801,338.17532351990025,347.06248723038846,349.9705524597774,352.87546408044653,347.0656408391083,47252,85791.9,58.97643979646306,53.40223338482702,NaN,NaN,NaN,NaN,1.183571894215907,12.722466728385603,94018386
2025-09-05T13:05:00-04:00,348.85,349.62,348.54,349.59,NaN,NaN,NaN,351.4094508244258,NaN,NaN,347.3445000000001,355.79306183032526,338.89593816967493,347.4499897843108,349.9629189782114,352.85334396188495,347.07249399453787,74656,84965.36666666667,62.62909415317915,54.31040784885302,NaN,NaN,NaN,NaN,1.1761739017719124,13.056837516646826,94093042
2025-09-05T13:10:00-04:00,349.55,350.54,349.25,350.38,NaN,NaN,NaN,351.4094508244258,NaN,NaN,347.6168000000001,355.54552518383804,339.6880748161622,348.15899182744863,349.9649372313227,352.8241119572294,347.10576250541607,155051,86122.83333333333,66.23185819085214,55.623861216602926,NaN,NaN,NaN,NaN,1.1843043373596345,14.143746864359413,94248093
2025-09-05T13:15:00-04:00,350.37,351.55,350.3,351.49,347.0053786055791,347.0053786055791,347.0053786055791,NaN,NaN,NaN,347.89960000000013,355.33682659066443,340.46237340933584,349.0201934619589,349.98753232832246,352.8229289595273,347.1521356971176,144548,84052.2,70.53070968187231,57.08502213268712,NaN,NaN,NaN,NaN,1.1889968846910892,15.842831555988553,94392641
2025-09-05T13:20:00-04:00,351.48,353,351.46,352.2,348.27854321441646,NaN,NaN,NaN,NaN,NaN,348.19480000000016,355.1006659008652,341.28893409913513,350.2061547695671,350.04379723931174,352.8650201912335,347.22257428739,189945,84826.23333333334,72.90661234060696,58.58796959926242,NaN,NaN,NaN,NaN,1.2140685357845844,18.18444356613583,94582586
2025-09-05T13:25:00-04:00,352.3,352.88,351.81,352.08,348.4272457955793,NaN,NaN,NaN,NaN,NaN,348.48260000000016,354.7865023597028,342.1786976402975,350.2061547695671,350.07345023881726,352.8872343952455,347.259666082389,102364,83251.36666666667,71.85220924347122,60.06270055015227,NaN,NaN,NaN,NaN,1.2037779260856851,20.358797575558302,94480222
2025-09-05T13:30:00-04:00,352.04,352.27,351.25,351.89,348.4272457955793,NaN,NaN,NaN,NaN,NaN,348.7464000000002,354.4677383190085,343.02506168099194,350.2061547695671,350.09523038976425,352.89788983485454,347.29257094467397,97405,83522.06666666667,70.12296218383162,61.23909318968286,NaN,NaN,NaN,NaN,1.1906509313652778,21.61724763704689,94382817
2025-09-05T13:35:00-04:00,351.93,352.28,350.87,351.26,348.4272457955793,NaN,NaN,NaN,NaN,NaN,348.99900000000014,353.97862006591095,344.01937993408933,350.2061547695671,350.11282580045497,352.90177661665314,347.3238749842568,100300,83713.03333333334,64.5735943447003,62.02293225192627,NaN,NaN,NaN,NaN,1.2063187219820415,22.295483694580387,94282517
2025-09-05T13:40:00-04:00,351.3,351.4,349.56,350.42,348.4272457955793,NaN,NaN,NaN,NaN,NaN,349.0192000000002,354.0134976924361,344.0249023075643,350.2061547695671,350.11686789883794,352.88978561159445,347.34395018608143,92316,83074.63333333333,57.98459713766265,62.512978401735744,NaN,NaN,NaN,NaN,1.2515816704118936,21.465171511155987,94190201
2025-09-05T13:45:00-04:00,350.43,351.02,349.81,350.34,348.4272457955793,NaN,NaN,NaN,NaN,NaN,349.0171000000002,354.00908561301566,344.02511438698474,350.2061547695671,350.1192233090554,352.8802742231753,347.35817239493554,68972,82585.83333333333,57.38404474290186,62.96416029649377,NaN,NaN,NaN,NaN,1.2486115510967568,20.69416734083333,94121229
2025-09-05T13:50:00-04:00,350.27,350.77,349.98,349.995,348.4272457955793,NaN,NaN,NaN,NaN,NaN,348.93440000000015,353.71746664815504,344.15133335184527,350.2061547695671,350.11993017250506,352.8734289667285,347.3664313782816,44029,80811.9,54.75050324682054,62.89271802905464,NaN,NaN,NaN,NaN,1.2158535831612716,19.97823489696229,94077200
2025-09-05T13:55:00-04:00,349.98,350.31,349.25,350.14,348.4272457955793,NaN,NaN,NaN,NaN,NaN,348.8470000000002,353.3720927062915,344.32190729370893,350.2061547695671,350.11812439102437,352.86036762347544,347.3758811585733,66577,79541.26666666666,55.67130792580947,62.87428815059132,NaN,NaN,NaN,NaN,1.2047211843640382,18.562814313878295,94143777
2025-09-05T14:00:00-04:00,350.17,350.3,349.6,349.81,348.4272457955793,NaN,NaN,NaN,NaN,NaN,348.7284000000002,352.81414519035513,344.64265480964525,350.2061547695671,350.11661711996624,352.84928054974796,347.3839536901845,57303,78011.86666666667,53.026597391021106,62.6264227735337,NaN,NaN,NaN,NaN,1.1686696711951774,17.248495201014585,94086474
2025-09-05T14:05:00-04:00,349.83,350.23,349.42,349.91,348.4272457955793,NaN,NaN,NaN,NaN,NaN,348.63680000000016,352.39389502682724,344.8797049731731,350.2061547695671,350.1145576174626,352.83661093798736,347.39250429693783,64380,77070.6,53.743711467299896,62.17030298903516,NaN,NaN,NaN,NaN,1.1430504089669509,16.22224654092283,94150854
2025-09-05T14:10:00-04:00,349.91,351.19,349.83,351.17,348.4272457955793,NaN,NaN,NaN,NaN,NaN,348.56680000000017,351.98697120048075,345.1466287995196,350.1099238156537,350.1210708933187,352.8294143514202,347.41272743521716,88033,77415.4,61.68150652194874,62.363522040855564,NaN,NaN,NaN,NaN,1.1585468083264554,15.851628840266695,94238887
2025-09-05T14:15:00-04:00,351.17,352.04,351,351.87,348.4272457955793,NaN,NaN,NaN,NaN,NaN,348.58680000000015,352.0716935479765,345.1019064520238,349.54393905252294,350.1394446386827,352.8364261534606,347.44246312390476,102081,78402.06666666667,65.24933819447175,62.55068232951932,NaN,NaN,NaN,NaN,1.1500791791602814,16.233399522618946,94340968
2025-09-05T14:20:00-04:00,351.82,351.95,351.06,351.18,348.4272457955793,NaN,NaN,NaN,NaN,NaN,348.62900000000013,352.18661942887456,345.0713805711257,349.3941512420183,350.1487549672307,352.8378928353274,347.45961709913394,62822,78685.36666666667,59.3802124829475,62.06127906466899,NaN,NaN,NaN,NaN,1.131502094934546,16.587900870517466,94278146
2025-09-05T14:25:00-04:00,351.2,351.37,350.93,351.18,348.4272457955793,NaN,NaN,NaN,NaN,NaN,348.7252000000002,352.2933927975479,345.1570072024525,349.3573025731521,350.15465512425715,352.83704246691303,347.47226778160126,49786,78091.7,59.3802124829475,61.2648149790315,NaN,NaN,NaN,NaN,1.082109088153507,16.745158464310677,94278146
2025-09-05T14:30:00-04:00,351.15,351.54,351.09,351.17,348.4272457955793,NaN,NaN,NaN,NaN,NaN,348.80580000000015,352.4090137656083,345.202586234392,349.47967364681733,350.1655167142754,352.83701121163375,347.494022216917,84168,77944.8,59.290572200070855,60.29224068327892,NaN,NaN,NaN,NaN,1.0369584389996882,17.04900447601195,94193978
2025-09-05T14:35:00-04:00,351.22,351.24,350.2,350.36,348.4272457955793,NaN,NaN,NaN,NaN,NaN,348.8556000000002,352.4744968706654,345.236703129335,349.47967364681733,350.16917107823156,352.82970301090864,347.50863914555447,73092,76919.36666666667,52.391481525736914,58.90218870344075,NaN,NaN,NaN,NaN,1.0371756933568548,16.181715903829627,94120886
2025-09-05T14:40:00-04:00,350.36,350.44,349.72,349.87,348.4272457955793,NaN,NaN,NaN,NaN,NaN,348.8928000000002,352.51440139172246,345.2711986082779,349.47967364681733,350.1679354158194,352.81815704722095,347.5177137844178,67991,77226.86666666667,48.69976124159217,57.37196006470936,NaN,NaN,NaN,NaN,1.014520286688506,15.212694591842407,94052895
2025-09-05T14:45:00-04:00,349.89,349.98,349.4,349.65,348.4272457955793,NaN,NaN,NaN,NaN,NaN,348.93440000000015,352.54202505822053,345.3267749417798,349.47967364681733,350.162408753522,352.7981903219572,347.52662718508685,99649,79110.63333333333,47.09520092762117,56.12350339206086,NaN,NaN,NaN,NaN,0.9834831233536155,14.653458273393879,93953246
2025-09-05T14:50:00-04:00,349.66,350.06,348.14,348.29,NaN,NaN,NaN,352.51081807575446,352.51081807575446,352.51081807575446,348.95620000000025,352.5346949686289,345.3777050313716,349.47967364681733,350.14186599791583,352.7623967349636,347.52133526086806,138707,82245.6,38.623321846743586,54.74055515699521,NaN,NaN,NaN,NaN,1.0503771859712157,15.271487113841179,93814539
2025-09-05T14:55:00-04:00,348.31,348.89,347.87,348.75,NaN,NaN,NaN,351.77487179958376,NaN,NaN,349.0244000000002,352.451391473664,345.5974085263364,349.47967364681733,350.1255594819798,352.7380855941891,347.5130333697705,90433,83548.26666666666,42.39770910206589,53.67010261122122,NaN,NaN,NaN,NaN,1.0482073869732704,16.054414600085856,93904972
2025-09-05T15:00:00-04:00,348.7,349.3,348,349.17,NaN,NaN,NaN,351.77487179958376,NaN,NaN,349.04360000000014,352.46287363057326,345.624326369427,349.47967364681733,350.11136842770384,352.7131355965607,347.509601258847,100117,85164.43333333333,45.682152421649356,53.022363266566124,NaN,NaN,NaN,NaN,1.0661925736180378,16.251802706369,94005089
2025-09-05T15:05:00-04:00,349.12,349.57,348.55,349.13,NaN,NaN,NaN,351.77487179958376,NaN,NaN,349.0934000000001,352.44301576316957,345.7437842368306,349.47967364681733,350.10301419427856,352.695831547702,347.5101968408551,75270,85643.46666666666,45.4165502979528,52.28988057886208,NaN,NaN,NaN,NaN,1.062893104073891,16.09569172973304,93929819
2025-09-05T15:10:00-04:00,349.11,349.73,348.95,349.68,NaN,NaN,NaN,351.77487179958376,NaN,NaN,349.16880000000015,352.39587146507785,345.94172853492245,349.47967364681733,350.0972888514704,352.67937029320234,347.5152074097385,82351,86272.6,49.743341847040035,52.05536232572058,NaN,NaN,NaN,NaN,1.0426864537829008,15.747970949887907,94012170
2025-09-05T15:15:00-04:00,349.68,349.88,349.3,349.54,NaN,NaN,NaN,351.77487179958376,NaN,NaN,349.2426000000001,352.3283856310788,346.1568143689214,349.47967364681733,350.0912130614692,352.65889272776167,347.52353339517674,109633,88334,48.685419147311364,51.69405573143568,NaN,NaN,NaN,NaN,1.0096374213698354,15.230364042633354,93902537
2025-09-05T15:20:00-04:00,349.64,349.68,349,349.24,NaN,NaN,NaN,351.77487179958376,NaN,NaN,349.2836000000001,352.313170293118,346.2540297068822,349.07173891745384,350.08726810215114,352.64908515778836,347.5254510465139,47780,88514.1,46.40776622943795,50.60307428197062,NaN,NaN,NaN,NaN,0.9860918912719905,15.077441258706228,93854757
2025-09-05T15:25:00-04:00,349.21,349.4,348.47,348.8,NaN,NaN,NaN,351.77487179958376,NaN,NaN,349.3226000000001,352.27507844378215,346.370121556218,348.34539113396306,350.0806821180576,352.63697766429726,347.52438657181796,52559,87652.33333333333,43.21450615778573,49.02915770792162,NaN,NaN,NaN,NaN,0.9820853276097018,15.476093537492824,93802198
2025-09-05T15:30:00-04:00,348.82,349.18,348.1,348.38,NaN,NaN,NaN,351.77487179958376,NaN,NaN,349.3258,352.27383484396154,346.3777651560385,348.01431290717045,350.07041172504756,352.62115412812625,347.5196693219689,64684,88233.4,40.35972315894687,47.67055132763586,NaN,NaN,NaN,NaN,0.9890792327804362,16.19453744319084,93737514
2025-09-05T15:35:00-04:00,348.35,348.97,348.04,348.3,NaN,NaN,NaN,351.6916607281916,NaN,NaN,349.32060000000007,352.27493013745004,346.3662698625501,347.5800381227373,350.06198976304194,352.6088378705921,347.5151416554918,49845,87406.36666666667,39.8201236673993,46.27340212652528,NaN,NaN,NaN,NaN,0.984859287581834,16.91814026731992,93687669
2025-09-05T15:40:00-04:00,348.31,348.75,348.1,348.52,NaN,NaN,NaN,351.5554488769102,NaN,NaN,349.3280000000001,352.2724014673628,346.3835985326374,347.5800381227373,350.0521658697873,352.59429393048686,347.51003780908775,59536,84222.53333333334,42.11219339178743,45.046375068790745,NaN,NaN,NaN,NaN,0.9609407670402729,17.590057175439778,93747205
2025-09-05T15:45:00-04:00,348.5,348.83,348.32,348.63,NaN,NaN,NaN,351.5554488769102,NaN,NaN,349.3252000000001,352.27198398274203,346.3784160172582,347.5800381227373,350.0423467926082,352.5787115089229,347.50598207629355,65926,81601.8,43.27552021826786,44.3952349754001,NaN,NaN,NaN,NaN,0.9287307122516814,18.068221187186644,93813131
2025-09-05T15:50:00-04:00,348.62,350.835,348.55,350.6,NaN,NaN,NaN,351.5554488769102,NaN,NaN,349.3560000000001,352.32317441363807,346.38882558636215,348.0973988749175,350.04113920482575,352.54496093138596,347.53731747826555,256354,83815.43333333333,59.1201518573668,45.139548590812566,NaN,NaN,NaN,NaN,1.0256070899479874,17.73840408332955,94069485
2025-09-05T15:55:00-04:00,350.6,351.28,350.46,350.79,NaN,NaN,NaN,351.5554488769102,NaN,NaN,349.3954000000001,352.3852895231975,346.4055104768027,348.679919099934,350.06264516322375,352.5360727972821,347.5892175291654,276881,89632.66666666667,60.27273522551021,46.08080104066179,NaN,NaN,NaN,NaN,1.0109208692374163,17.850427231098266,94346366
2025-09-08T09:30:00-04:00,354.7,358.48,353.85,354.34,352.0663123760742,352.0663123760742,352.0663123760742,NaN,NaN,NaN,349.51920000000007,352.7918101877557,346.24658981224445,352.55493527994724,355.55666666666673,355.55666666666673,355.55666666666673,422574,100471.63333333333,74.6526237949046,48.654322608387574,NaN,NaN,NaN,NaN,1.487997950006172,21.073018392162084,94768940
2025-09-08T09:35:00-04:00,354.37,354.89,352.51,353.65,352.0663123760742,NaN,NaN,NaN,NaN,NaN,349.6530000000001,353.04113931250953,346.2648606874906,352.55493527994724,354.92173259494496,355.808469244456,354.03499594543393,216656,104350.16666666667,69.39487677623325,50.582691727970946,NaN,NaN,NaN,NaN,1.551712382148588,22.926590357949962,94552284
2025-09-08T09:40:00-04:00,353.68,355.12,351.89,352.07,NaN,NaN,NaN,357.9369290955655,357.9369290955655,357.9369290955655,349.76560000000006,353.0927992066854,346.4384007933147,352.55493527994724,354.4972806734278,355.60831306813674,353.3862482787188,184496,107422.83333333333,59.12594267227297,51.54296246015834,NaN,NaN,NaN,NaN,1.671590069137976,24.15962121119771,94367788
2025-09-08T09:45:00-04:00,352.08,352.55,350.76,352.14,NaN,NaN,NaN,356.18003250236444,NaN,NaN,349.86920000000003,353.162926376171,346.57547362382905,352.55493527994724,354.06679731082477,355.48270831794684,352.6508863037027,157591,110376.8,59.41250286819485,52.542673358032786,NaN,NaN,NaN,NaN,1.6800479213424075,24.46737888499543,94525379
2025-09-08T09:50:00-04:00,352.15,354.79,351.51,354.63,NaN,NaN,NaN,356.18003250236444,NaN,NaN,350.0142000000001,353.49012598323344,346.5382740167667,352.55493527994724,354.0064032506459,355.32580003153714,352.6870064697547,163235,114350.33333333333,68.00526241013227,53.84709625539652,NaN,NaN,NaN,NaN,1.7943302126750946,25.526982564096766,94688614
2025-09-08T09:55:00-04:00,354.57,354.98,353.31,353.83,NaN,NaN,NaN,356.18003250236444,NaN,NaN,350.1460000000001,353.6902499913176,346.60175000868253,352.55493527994724,354.0098073591102,355.2606181140908,352.7589966041296,129044,116432.56666666667,63.36377920777992,54.89555054542999,NaN,NaN,NaN,NaN,1.7854494831983032,26.570062509920707,94559570
2025-09-08T10:00:00-04:00,353.83,353.98,351.75,352.45,NaN,NaN,NaN,356.18003250236444,NaN,NaN,350.2394000000001,353.7754501355127,346.7033498644875,352.55493527994724,353.9178061361093,355.16758098170163,352.6680312905169,98370,117801.46666666666,56.23384059671003,55.597413000235136,NaN,NaN,NaN,NaN,1.8172030915412827,26.46097261770683,94461200
2025-09-08T10:05:00-04:00,352.4,352.72,351.43,351.76,NaN,NaN,NaN,356.18003250236444,NaN,NaN,350.3192000000001,353.80851532552873,346.82988467447143,352.55493527994724,353.7743367660192,355.0803830009304,352.468290531108,109090,119291.8,53.02129195468755,56.297897700013834,NaN,NaN,NaN,NaN,1.779545727859764,26.15217763333516,94352110
2025-09-08T10:10:00-04:00,351.81,352.3,350.2,350.93,NaN,NaN,NaN,356.1366986133157,NaN,NaN,350.3914000000001,353.77735631408586,347.0054436859143,352.55493527994724,353.5605673494893,355.00413739776667,352.11699730121194,130978,120723.3,49.36779004970254,56.94133104935353,NaN,NaN,NaN,NaN,1.8024353187269253,25.100076654909753,94221132
2025-09-08T10:15:00-04:00,350.92,352.13,350.55,351.52,NaN,NaN,NaN,356.1366986133157,NaN,NaN,350.47560000000004,353.75868369693524,347.19251630306485,352.55493527994724,353.43645724652174,354.92539433105526,351.9475201619882,98244,120595.4,51.90478445964466,57.80452110594248,NaN,NaN,NaN,NaN,1.786547081675001,24.123125746371873,94319376
2025-09-08T10:20:00-04:00,351.57,352.07,351.02,351.36,NaN,NaN,NaN,356.1366986133157,NaN,NaN,350.53880000000004,353.76540289485587,347.3121971051442,349.0043707925331,353.3653569291618,354.87202286187244,351.8586909964512,64612,120655.06666666667,51.15619532701448,58.45052124417299,NaN,NaN,NaN,NaN,1.7339365758410732,23.2159570455867,94254764
2025-09-08T10:25:00-04:00,351.42,352.5,350.98,352.35,NaN,NaN,NaN,356.1366986133157,NaN,NaN,350.62110000000007,353.81824077904116,347.423959220959,349.0043707925331,353.29381284072747,354.79462992179094,351.792995759664,94028,122129.8,55.438664268072685,59.319317247730474,NaN,NaN,NaN,NaN,1.7186553918524239,22.607002530028247,94348792
2025-09-08T10:30:00-04:00,352.38,352.45,351.06,351.54,NaN,NaN,NaN,356.1366986133157,NaN,NaN,350.68510000000003,353.8246225689795,347.54557743102055,349.0043707925331,353.235667124997,354.7394588654559,351.7318753845381,70004,121657.66666666667,51.462960563838344,58.77237501247845,NaN,NaN,NaN,NaN,1.695180006720107,22.041544765581115,94278788
2025-09-08T10:35:00-04:00,351.565,351.69,350.65,350.65,NaN,NaN,NaN,355.8575730850284,NaN,NaN,350.7175000000001,353.8212643275408,347.61373567245937,349.0043707925331,353.1341749430285,354.6755454088861,351.5928044771709,92063,122290.03333333334,47.437524430830955,57.85557424142993,NaN,NaN,NaN,NaN,1.6483814348115295,21.19536519360273,94186725
2025-09-08T10:40:00-04:00,350.64,351.67,350.55,350.81,NaN,NaN,NaN,355.73722885389077,NaN,NaN,350.75610000000006,353.8151791361184,347.69702086388173,349.0043707925331,353.0443148560836,354.6121544332732,351.476475278894,89713,123014.1,48.22164186178619,55.9676469604929,NaN,NaN,NaN,NaN,1.6106399037535635,20.32941442256863,94276438
2025-09-08T10:45:00-04:00,350.8,350.85,349.74,350.3,NaN,NaN,NaN,354.8632639059867,NaN,NaN,350.7703000000001,353.81414914884954,347.7264508511506,348.21961556563025,352.8788581649668,354.5333489436062,351.2243673863274,135886,124222,45.87258572852758,54.28748331422821,NaN,NaN,NaN,NaN,1.57487991062831,18.889287162060004,94140552
2025-09-08T10:50:00-04:00,350.25,351.04,349.81,349.92,NaN,NaN,NaN,354.8632639059867,NaN,NaN,350.76110000000006,353.81238385453975,347.70981614546037,348.21961556563025,352.7903265260333,354.48420653051824,351.0964465215484,78850,122226.76666666666,44.146945846921824,53.217554969560275,NaN,NaN,NaN,NaN,1.5502456312977178,17.696112736182116,94061702
2025-09-08T10:55:00-04:00,349.92,349.94,347.75,347.98,NaN,NaN,NaN,353.46614541847134,NaN,NaN,350.6909000000001,353.8320588245112,347.54974117548903,348.21961556563025,352.5190622981636,354.45819738485585,350.57992721147133,159883,124541.76666666666,36.58111389720289,51.586741471632266,NaN,NaN,NaN,NaN,1.595942371919309,17.6693423567216,93901819
2025-09-08T11:00:00-04:00,347.92,349.22,347.82,348.68,NaN,NaN,NaN,353.1220024449044,NaN,NaN,350.6205000000001,353.7809368370276,347.46006316297263,348.21961556563025,352.38810756934294,354.42157970071224,350.3546354379736,85660,124059.86666666667,40.54076001646721,49.62499130065619,NaN,NaN,NaN,NaN,1.5819464882107894,17.644484147222546,93987479
2025-09-08T11:05:00-04:00,348.72,349.48,348.71,349.11,NaN,NaN,NaN,353.1220024449044,NaN,NaN,350.5611000000001,353.7212210674167,347.40097893258354,348.21961556563025,352.31824204173824,354.3851219721784,350.2513621112981,56031,123418.56666666667,42.899253335731224,48.16323945265272,NaN,NaN,NaN,NaN,1.5260931676243052,17.39360804353138,94043510
2025-09-08T11:10:00-04:00,349.15,349.59,348.75,349.19,NaN,NaN,NaN,353.1220024449044,NaN,NaN,350.50710000000015,353.666817765989,347.3473822340113,348.21961556563025,352.24455137218683,354.3416590738284,350.1474436705453,63341,122784.9,43.34947403467431,47.24292755536445,NaN,NaN,NaN,NaN,1.4770865127939958,17.060920495554218,94106851
2025-09-08T11:15:00-04:00,349.21,349.39,347.8,348.28,NaN,NaN,NaN,353.02310524438957,NaN,NaN,350.44750000000016,353.66014019159695,347.23485980840337,348.21961556563025,352.0961853712104,354.27772354526,349.91464719716083,111098,122833.73333333334,39.53125882361292,46.27935376028769,NaN,NaN,NaN,NaN,1.4851517618801373,17.38875373343713,93995753
2025-09-08T11:20:00-04:00,348.28,348.62,347.45,348.39,NaN,NaN,NaN,352.42137318782636,NaN,NaN,350.4069000000002,353.6708037302952,347.1429962697052,347.98655396200337,351.97238017474984,354.22681825649005,349.71794209300964,91141,124279.1,40.21673470586518,45.625706950013594,NaN,NaN,NaN,NaN,1.462640921745843,17.911166201675496,94086894
2025-09-08T11:25:00-04:00,348.42,349.49,348.2,349.28,NaN,NaN,NaN,352.42137318782636,NaN,NaN,350.3857000000002,353.6648011025109,347.1065988974895,347.98655396200337,351.89868666110914,354.1727262222772,349.62464709994106,73539,124978.43333333333,45.59094255470971,45.17471824251824,NaN,NaN,NaN,NaN,1.450309427335427,17.55516508000145,94160433
2025-09-08T11:30:00-04:00,349.28,349.73,348.84,349.28,NaN,NaN,NaN,352.42137318782636,NaN,NaN,350.3714000000002,353.6634024545125,347.07939754548795,347.6235945356821,351.8428913651187,354.1240631996875,349.5617195305499,64876,124984.83333333333,45.59094255470971,44.777200187353614,NaN,NaN,NaN,NaN,1.4102873253828996,17.004486967515543,94160433
2025-09-08T11:35:00-04:00,349.31,350.3,349.31,349.58,NaN,NaN,NaN,352.42137318782636,NaN,NaN,350.3602000000002,353.6590785731794,347.061321426821,347.6235945356821,351.78520642076387,354.061218230177,349.5091946113507,85354,126168.46666666666,47.43811061128953,44.20573206901196,NaN,NaN,NaN,NaN,1.3824096592841237,15.981267347652448,94245787
2025-09-08T11:40:00-04:00,349.55,349.55,347.66,348,NaN,NaN,NaN,352.42137318782636,NaN,NaN,350.32400000000024,353.6853663889037,346.9626336110968,347.36451146545244,351.68672434033965,354.00032190205775,349.37312677862155,93772,127309.66666666667,39.778537963581115,43.37113045470788,NaN,NaN,NaN,NaN,1.4208089693352548,16.205973056874896,94152015
2025-09-08T11:45:00-04:00,348.03,348.36,346.63,346.92,NaN,NaN,NaN,351.83522706564514,NaN,NaN,350.2642000000002,353.7567270851533,346.7716729148471,347.36451146545244,351.5204029669988,353.939291311773,349.1015146222246,127002,129345.53333333334,35.55280213274732,42.52222171913047,NaN,NaN,NaN,NaN,1.4428940429541666,17.003985596277385,94025013
2025-09-08T11:50:00-04:00,346.885,347.84,346.72,347.78,NaN,NaN,NaN,351.575671289934,NaN,NaN,350.1964000000002,353.74709291272774,346.6457070872727,347.36451146545244,351.42560058225956,353.89381260699975,348.9573885575194,79749,123458.7,40.93367642739536,42.001652759531126,NaN,NaN,NaN,NaN,1.419830182743151,17.744997240008264,94104762
2025-09-08T11:55:00-04:00,347.81,348.64,347.73,348.515,NaN,NaN,NaN,351.575671289934,NaN,NaN,350.1293000000002,353.67775093534135,346.5808490646591,347.36451146545244,351.3716306232055,353.8521733127184,348.8910879336926,60114,116233.13333333333,45.1487837811678,41.949952620434,NaN,NaN,NaN,NaN,1.3834137411186378,17.66729040018915,94164876
2025-09-08T12:00:00-04:00,348.49,348.49,347.44,347.7,NaN,NaN,NaN,351.575671289934,NaN,NaN,350.05970000000025,353.65913462788944,346.46026537211105,347.36451146545244,351.32067462540135,353.8184484001608,348.82290085064193,51592,103867.06666666667,41.60348106395741,41.768276564507964,NaN,NaN,NaN,NaN,1.3613841881815916,17.78451448399099,94113284
2025-09-08T12:05:00-04:00,347.67,348.3,347.24,347.29,NaN,NaN,NaN,351.575671289934,NaN,NaN,349.9819000000002,353.6486439998609,346.31515600013955,347.36451146545244,351.2642110276928,353.78418517646304,348.74423687892255,54677,98467.76666666666,39.905807063395635,42.00575464780745,NaN,NaN,NaN,NaN,1.339856746168621,18.026401540593803,94058607
2025-09-08T12:10:00-04:00,347.29,347.86,347.11,347.62,NaN,NaN,NaN,351.53303910310797,NaN,NaN,349.9109000000003,353.6201056778076,346.201694322193,347.36451146545244,351.241993382705,353.77081898077205,348.71316778463796,21507,93034.8,41.95874667893362,42.107039409412195,NaN,NaN,NaN,NaN,1.297724121442291,18.34054019101577,94080114
2025-09-08T12:15:00-04:00,347.67,347.75,346.94,347.57,NaN,NaN,NaN,351.3194918711485,NaN,NaN,349.85510000000033,353.61914064274134,346.0910593572593,347.36451146545244,351.19170083839083,353.74130823118963,348.642093445592,48200,89388.43333333333,41.72615574051175,42.023246724039375,NaN,NaN,NaN,NaN,1.2628866841964133,18.7536006841564,94031914
2025-09-08T12:20:00-04:00,347.6,348.14,347.42,348.11,NaN,NaN,NaN,351.3194918711485,NaN,NaN,349.81990000000036,353.61551035410014,346.0242896459006,347.36451146545244,351.15277788644096,353.7122430666364,348.5933127062455,43697,85403.83333333333,45.25569234468246,42.15940517475424,NaN,NaN,NaN,NaN,1.2241090638966674,18.682043914072224,94075611
2025-09-08T12:25:00-04:00,348.1,348.24,347.71,347.99,NaN,NaN,NaN,351.3194918711485,NaN,NaN,349.78670000000034,353.6165593238154,345.95684067618527,346.24160917236196,351.117682962099,353.6844938161089,348.55087210808915,41459,82484.33333333333,44.60908665424829,42.52210716265677,NaN,NaN,NaN,NaN,1.1745298450469075,18.498043519092317,94034152
2025-09-08T12:30:00-04:00,348.01,348.06,346.95,347.47,NaN,NaN,NaN,351.2715880182857,NaN,NaN,349.77030000000036,353.6325410127049,345.9080589872958,346.0167003493784,351.06214636653436,353.6478301403549,348.4764625927138,58327,81149.56666666667,41.82063142719585,42.636671214180396,NaN,NaN,NaN,NaN,1.1699205704007007,18.942311189161515,93975825
2025-09-08T12:35:00-04:00,347.48,347.58,346.54,347.44,NaN,NaN,NaN,350.79719765381816,NaN,NaN,349.74410000000034,353.65118366434353,345.83701633565715,346.0167003493784,350.989520110258,353.6042202529533,348.3748199675627,72695,79936.4,41.65884200191028,42.35580688898043,NaN,NaN,NaN,NaN,1.1606405296577909,19.657483128019777,93903130
2025-09-08T12:40:00-04:00,347.4,347.87,347.18,347.58,NaN,NaN,NaN,350.79719765381816,NaN,NaN,349.7123000000003,353.6631931699315,345.7614068300691,346.0167003493784,350.95785752616985,353.5812058135227,348.334509238817,35971,76769.5,42.77150422130385,42.1544184365943,NaN,NaN,NaN,NaN,1.1270233489679484,19.942922754804293,93939101
2025-09-08T12:45:00-04:00,347.57,347.71,346.95,347.14,NaN,NaN,NaN,350.79719765381816,NaN,NaN,349.67250000000035,353.68565748508325,345.65934251491745,346.0167003493784,350.9249304155895,353.55951237384414,348.2903484573348,35239,74669.33333333333,40.178005743719474,41.635839517482154,NaN,NaN,NaN,NaN,1.100807395470237,20.39294972347636,93903862
2025-09-08T12:50:00-04:00,347.12,347.3,346.81,347.3,NaN,NaN,NaN,350.5568686581527,NaN,NaN,349.6249000000004,353.6926593291633,345.55714067083755,346.0167003493784,350.8901299378178,353.5373702851319,348.2428895905037,36626,73736.46666666666,41.565567412790024,41.76348447813994,NaN,NaN,NaN,NaN,1.0571782957937923,20.925426026702727,93940488
2025-09-08T12:55:00-04:00,347.29,347.4,345.87,346.12,NaN,NaN,NaN,350.1863291736912,NaN,NaN,349.55650000000037,353.7410096487066,345.37199035129413,346.0167003493784,350.769336716089,353.4779885296159,348.0606849025621,111844,74330.33333333333,35.09951487179832,41.73110681664358,NaN,NaN,NaN,NaN,1.0909512746656624,22.12028678352837,93828644
2025-09-08T13:00:00-04:00,346.11,346.12,344.84,345.27,NaN,NaN,NaN,349.0444505748871,NaN,NaN,349.47710000000035,353.8298940865809,345.1243059134198,346.0167003493784,350.59228332191134,353.4228228355941,347.7617438082286,140037,76664.76666666666,31.319900503624226,41.044408536374206,NaN,NaN,NaN,NaN,1.1044547550466886,23.84528312853366,93688607
2025-09-08T13:05:00-04:00,345.33,346.08,345.3,345.55,NaN,NaN,NaN,349.0444505748871,NaN,NaN,349.4121000000003,353.89841344874026,344.92578655126033,346.0167003493784,350.5367227090436,353.39921907862225,347.67422633946495,48129,75200.3,33.84698525481325,40.23713721306317,NaN,NaN,NaN,NaN,1.0834222725433538,25.44706544889571,93736736
2025-09-08T13:10:00-04:00,345.5,346.15,345.5,345.99,NaN,NaN,NaN,349.0444505748871,NaN,NaN,349.36430000000036,353.94354797757757,344.78505202242314,346.0167003493784,350.49062606330557,353.37598722508386,347.6052649015273,42861,73638.56666666667,37.72476884313955,39.960086340147605,NaN,NaN,NaN,NaN,1.0524635387902554,26.821848726025532,93779597
2025-09-08T13:15:00-04:00,346,346.86,345.99,346.8,NaN,NaN,NaN,349.0444505748871,NaN,NaN,349.33430000000027,353.9604586700364,344.7081413299641,345.7263602795027,350.44341258361277,353.34330625238,347.54351891484555,52506,70859.23333333334,44.20841964814226,40.26741581048666,NaN,NaN,NaN,NaN,1.0394304288766663,27.010013921265713,93832103
2025-09-08T13:20:00-04:00,346.76,347.55,346.44,347.485,NaN,NaN,NaN,349.0444505748871,NaN,NaN,349.3136000000003,353.96335011804973,344.66384988195085,345.61547057888174,350.3912715482009,353.2972098898067,347.4853332065951,70679,70586.86666666667,49.04035279725668,40.7732448189383,NaN,NaN,NaN,NaN,1.044471112528334,26.26675321070145,93902782
2025-09-08T13:25:00-04:00,347.45,347.73,347.04,347.44,NaN,NaN,NaN,349.0444505748871,NaN,NaN,349.2898000000003,353.96541288392115,344.61418711607945,345.61547057888174,350.3560291558206,353.26273451650945,347.4493237951317,53150,67029.1,48.7417048083869,41.27435546664367,NaN,NaN,NaN,NaN,1.0191517473477385,25.350592482473992,93849632
2025-09-08T13:30:00-04:00,347.42,347.6,346.49,347.07,NaN,NaN,NaN,349.0444505748871,NaN,NaN,349.2192000000003,353.9200817726391,344.5183182273615,345.5263764631054,350.3192489302394,353.23042845413084,347.4080694063479,50748,65865.36666666667,46.247848448578274,41.34522375977908,NaN,NaN,NaN,NaN,1.0256409082514726,25.0066555831635,93798884
2025-09-08T13:35:00-04:00,347.1,347.25,346.75,346.83,NaN,NaN,NaN,349.0444505748871,NaN,NaN,349.14000000000027,353.86572407154284,344.4142759284577,345.50232517858836,350.28795787947774,353.20361721406454,347.37229854489095,42633,65418.76666666667,44.651949650149675,41.34828540234347,NaN,NaN,NaN,NaN,0.9880951290906531,24.687285605232333,93756251
2025-09-08T13:40:00-04:00,346.825,346.95,346.47,346.91,NaN,NaN,NaN,349.0444505748871,NaN,NaN,348.9914000000003,353.5167477391587,344.4660522608419,345.50232517858836,350.26499269415103,353.18485213757197,347.3451332507301,30281,64316.76666666667,45.3291744833003,41.59889562063664,NaN,NaN,NaN,NaN,0.9518026198698895,24.652739672920696,93786532
2025-09-08T13:45:00-04:00,346.93,347.23,346.69,346.75,NaN,NaN,NaN,349.0444505748871,NaN,NaN,348.85340000000025,353.22012666426684,344.48667333573366,345.50232517858836,350.2418374895643,353.16496923828515,347.3187057408435,31984,61679.63333333333,44.165247085963955,41.777924555211904,NaN,NaN,NaN,NaN,0.9223881470220416,24.20051879508747,93754548
2025-09-08T13:50:00-04:00,346.77,347,345.43,346.26,NaN,NaN,NaN,349.0444505748871,NaN,NaN,348.7372000000003,353.06439639491515,344.4100036050855,345.50232517858836,350.19141645231326,353.13030188823245,347.2525310163941,59336,60619.46666666667,40.71710060449719,41.631181439725715,NaN,NaN,NaN,NaN,0.9686461365204667,24.869622342977756,93695212
2025-09-08T13:55:00-04:00,346.27,346.35,345.4,345.63,NaN,NaN,NaN,349.03616243195046,NaN,NaN,348.60700000000026,352.90849648382215,344.30550351617836,345.50232517858836,350.14427118254713,353.1022415808776,347.18630078421666,51157,59873.4,36.744899241767186,41.385959546729126,NaN,NaN,NaN,NaN,0.9673142696261509,25.513535948068927,93644055
2025-09-08T14:00:00-04:00,345.68,345.76,344.9,345.37,NaN,NaN,NaN,348.4647459577709,NaN,NaN,348.42180000000025,352.4593496331749,344.3842503668256,345.50232517858836,350.0468349872411,353.051881602492,347.04178837199015,98862,61006.26666666667,35.217911702224626,40.93255556740303,NaN,NaN,NaN,NaN,0.9596489646528553,26.48341916219502,93545193
2025-09-08T14:05:00-04:00,345.41,345.93,345.35,345.7,NaN,NaN,NaN,348.4647459577709,NaN,NaN,348.2592000000002,352.060360012481,344.4580399875194,345.50232517858836,350.0078734633451,353.0277248820914,346.98802204459884,43651,59616.166666666664,38.69988166603077,41.18972462413391,NaN,NaN,NaN,NaN,0.9325311814633644,27.105532058326364,93588844
2025-09-08T14:10:00-04:00,345.67,346.36,345.66,346.22,NaN,NaN,NaN,348.4647459577709,NaN,NaN,348.1346000000002,351.78348467349855,344.48571532650186,345.50232517858836,349.98088229976986,353.00778260669523,346.9539819928445,34007,57624,43.8237386198552,42.08285591815041,NaN,NaN,NaN,NaN,0.9159218113588377,26.998170197982656,93622851
2025-09-08T14:15:00-04:00,346.21,346.48,345.77,345.9,NaN,NaN,NaN,348.4647459577709,NaN,NaN,348.0174000000003,351.5680913355503,344.46670866445027,345.41138439314983,349.95351662227733,352.98751789944686,346.9195153451078,34694,54547.066666666666,41.52355989965793,42.63118267849645,NaN,NaN,NaN,NaN,0.9012131105474948,26.71119576452334,93588157
2025-09-08T14:20:00-04:00,345.89,346.33,345.77,346.17,NaN,NaN,NaN,348.4647459577709,NaN,NaN,347.9222000000002,351.41011178795566,344.43428821204475,345.41138439314983,349.93719542155674,352.9751335251063,346.8992573180072,21142,52593.5,44.18549640688274,43.09266321876383,NaN,NaN,NaN,NaN,0.8768407455083881,26.444719504882546,93609299
2025-09-08T14:25:00-04:00,346.2,346.71,345.95,346.53,NaN,NaN,NaN,348.4647459577709,NaN,NaN,347.82240000000024,351.1757882806001,344.4690117194004,345.41138439314983,349.91438190115224,352.9557387642176,346.8730250380869,32457,51671.6,47.60993308176545,43.335628464022626,NaN,NaN,NaN,NaN,0.868494977972074,25.571782386452195,93641756
2025-09-08T14:30:00-04:00,346.535,346.855,345.95,346.83,NaN,NaN,NaN,348.4647459577709,NaN,NaN,347.73180000000025,350.9396028369006,344.5239971630999,345.41138439314983,349.8858682584361,352.93001581425784,346.8417207026144,42991,51384.9,50.34404834844337,43.428749574821666,NaN,NaN,NaN,NaN,0.8711024795454995,24.529251885682893,93684747
2025-09-08T14:35:00-04:00,346.85,346.89,346.45,346.47,NaN,NaN,NaN,348.4647459577709,NaN,NaN,347.6142000000002,350.55627910167493,344.6721208983255,345.11481964763453,349.8734684624088,352.9185263971729,346.82841052764473,19263,50204.433333333334,47.16324050785109,43.31600212478339,NaN,NaN,NaN,NaN,0.8403094452922494,23.50303799115938,93665484
2025-09-08T14:40:00-04:00,346.475,346.72,345.96,346.72,NaN,NaN,NaN,348.4647459577709,NaN,NaN,347.5178000000003,350.2472088444545,344.7883911555461,345.11481964763453,349.85326468047543,352.90052751360815,346.8060018473427,30422,50501.6,49.547188942829315,43.55166930294418,NaN,NaN,NaN,NaN,0.8345730563428064,23.18917047109215,93695906
2025-09-08T14:45:00-04:00,346.72,347.22,346.63,346.79,NaN,NaN,NaN,348.4647459577709,NaN,NaN,347.44060000000025,350.02581847440473,344.85538152559576,345.4848845744861,349.826555760914,352.8730447889247,346.7800667329033,46499,50444.9,50.22439363277494,43.94970101598884,NaN,NaN,NaN,NaN,0.8171035523183224,22.05850659238287,93742405
2025-09-08T14:50:00-04:00,346.85,346.93,346.46,346.7,NaN,NaN,NaN,348.4647459577709,NaN,NaN,347.35840000000024,349.76505281259745,344.95174718740304,345.4848845744861,349.8112731016714,352.8581365749758,346.76440962836705,25399,49834.96666666667,49.30800193567083,44.23390297687245,NaN,NaN,NaN,NaN,0.7923104414384442,21.239270054347266,93717006
2025-09-08T14:55:00-04:00,346.65,346.95,346.35,346.471,NaN,NaN,NaN,348.4647459577709,NaN,NaN,347.2818200000003,349.54881740418915,345.0148225958115,345.4848845744861,349.79001332129434,352.83798423365215,346.7420424089365,34562,49605.066666666666,46.9601352229956,44.43353784380328,NaN,NaN,NaN,NaN,0.7785739813356958,20.630003798013288,93682444
2025-09-08T15:00:00-04:00,346.47,346.82,346.38,346.8,NaN,NaN,NaN,348.4647459577709,NaN,NaN,347.2194200000003,349.3607921616434,345.0780478383572,345.4848845744861,349.7692162038087,352.8176242355408,346.7208081720766,35100,48830.833333333336,50.59955377862788,45.13942735624119,NaN,NaN,NaN,NaN,0.754390125526003,20.064256559988877,93717544
2025-09-08T15:05:00-04:00,346.8,346.98,346.48,346.54,NaN,NaN,NaN,348.4647459577709,NaN,NaN,347.19062000000025,349.32903234160915,345.05220765839135,345.5309767217095,349.752969632042,352.80162039176395,346.70431887232,27749,47332.63333333333,47.807718755254754,45.92962875006173,NaN,NaN,NaN,NaN,0.7362194022741457,19.229241428330106,93689795
2025-09-08T15:10:00-04:00,346.57,346.66,345.48,346.22,NaN,NaN,NaN,348.4647459577709,NaN,NaN,347.14142000000027,349.2535357200336,345.02930427996694,345.5309767217095,349.7089396334199,352.7650237238923,346.6528555429475,65011,48300.63333333333,44.54973088671245,46.59618726323943,NaN,NaN,NaN,NaN,0.7679180163974214,19.79985448391143,93624784
2025-09-08T15:15:00-04:00,346.22,346.3,345.71,345.86,NaN,NaN,NaN,348.4647459577709,NaN,NaN,347.07642000000027,349.1417217248627,345.01111827513785,345.5309767217095,349.6742335327344,352.7372853589269,346.61118170654186,50078,48795.26666666667,41.15206781257351,46.771343416563916,NaN,NaN,NaN,NaN,0.7552095866547507,20.32970946409409,93574706
2025-09-08T15:20:00-04:00,345.83,346.14,345.67,345.97,NaN,NaN,NaN,348.398454277323,NaN,NaN,347.01202000000035,349.00937759405105,345.01466240594965,345.5309767217095,349.65362114400267,352.72078651589527,346.58645577211007,29944,48572.53333333333,42.592777991521906,46.68341765739725,NaN,NaN,NaN,NaN,0.7348374733222663,20.870848256308875,93604650
2025-09-08T15:25:00-04:00,346.02,346.23,345.77,346.11,NaN,NaN,NaN,348.398454277323,NaN,NaN,346.9686200000004,348.94810792933646,344.9891320706643,345.5309767217095,349.63121857934675,352.70201045415575,346.56042670453775,33930,45975.4,44.456572912995355,46.89291858692136,NaN,NaN,NaN,NaN,0.7152062252278214,21.168807084594985,93638580
2025-09-08T15:30:00-04:00,346.14,346.83,345.75,345.77,NaN,NaN,NaN,348.398454277323,NaN,NaN,346.9162200000004,348.88108613445354,344.9513538655473,345.5309767217095,349.6014855094788,352.6761564533737,346.52681456558383,46740,42865.5,40.97713753666545,46.663750096191556,NaN,NaN,NaN,NaN,0.7412629234258331,20.20873190535025,93591840
2025-09-08T15:35:00-04:00,345.82,346.79,345.77,346.35,NaN,NaN,NaN,348.398454277323,NaN,NaN,346.85762000000034,348.7084617064903,345.00677829351037,345.5309767217095,349.57133673290593,352.64797634352186,346.49469712229,50969,42960.166666666664,48.39678564750566,46.719953850887286,NaN,NaN,NaN,NaN,0.7611727146097049,19.317233524622992,93642809
2025-09-08T15:40:00-04:00,346.36,346.89,346.24,346.65,NaN,NaN,NaN,348.398454277323,NaN,NaN,346.80502000000035,348.52215787402616,345.08788212597455,345.5309767217095,349.5412124042524,352.61672255760044,346.46570225090437,56979,43430.76666666667,51.77373548232078,46.82207436044995,NaN,NaN,NaN,NaN,0.7532318064232958,18.288827862006688,93699788
2025-09-08T15:45:00-04:00,346.65,346.94,346.6,346.86,NaN,NaN,NaN,348.398454277323,NaN,NaN,346.7506200000004,348.2740784806527,345.22716151934816,345.5309767217095,349.5065045479309,352.57781331879505,346.4351957770667,72234,44088.36666666667,54.04099481117048,47.31334252497277,NaN,NaN,NaN,NaN,0.7237152488216301,17.230143619641073,93772022
2025-09-08T15:50:00-04:00,346.87,346.87,345.93,346.1,NaN,NaN,NaN,348.398454277323,NaN,NaN,346.71262000000047,348.2039744924566,345.22126550754433,345.5309767217095,349.44954835670586,352.5227827061235,346.3763140072882,103169,45171.36666666667,45.672435057037376,47.036574390273344,NaN,NaN,NaN,NaN,0.7391641596200849,17.395091294710372,93668853
2025-09-08T15:55:00-04:00,346.15,346.72,346.15,346.44,NaN,NaN,NaN,348.398454277323,NaN,NaN,346.7030200000004,348.19509064122065,345.2109493587801,345.29173698671093,349.3870044652321,352.4583612720607,346.3156476584035,123127,47503.933333333334,49.44423040397734,46.98084844535923,NaN,NaN,NaN,NaN,0.7306524339329362,17.54825699298901,93791980
2025-09-09T09:30:00-04:00,348.44,350.2,346.9,348.94,345.74034460839573,345.74034460839573,345.74034460839573,NaN,NaN,NaN,346.7262200000004,348.31733826285347,345.13510173714735,346.927289337196,348.67999999999995,348.6800066072494,348.6799933927505,208295,52755.5,67.37833715763,48.27158667549919,NaN,NaN,NaN,NaN,0.9470344029377259,19.17466170046348,94000275
2025-09-09T09:35:00-04:00,348.96,349.94,348.4,348.81,346.278056217105,NaN,NaN,NaN,NaN,NaN,346.7321200000004,348.3516602132606,345.11257978674024,346.927289337196,348.837483386185,349.0204255517741,348.6545412205959,154355,56479.566666666666,66.06591217921587,49.63628502951492,NaN,NaN,NaN,NaN,0.9893890884421755,20.68489464311835,93845920
2025-09-09T09:40:00-04:00,348.87,349.95,347.96,349.19,346.278056217105,NaN,NaN,NaN,NaN,NaN,346.7619200000004,348.5019513027036,345.02188869729713,346.927289337196,348.90570143202933,349.08039312592285,348.7310097381358,193833,61931.3,68.02642771174678,50.88106173902342,NaN,NaN,NaN,NaN,1.0608612964105923,21.401667530539363,94039753
2025-09-09T09:45:00-04:00,349.14,350.54,348.79,350.31,346.5323198176515,NaN,NaN,NaN,NaN,NaN,346.8223200000004,348.82179906976677,344.822840930234,346.927289337196,349.1582242909784,349.61085270206996,348.70559587988686,194693,67354.93333333333,72.98115733002999,52.67916449436451,NaN,NaN,NaN,NaN,1.1100854895241214,22.512111846322288,94234446
2025-09-09T09:50:00-04:00,350.27,350.77,348.84,348.91,346.5515325532128,NaN,NaN,NaN,NaN,NaN,346.84812000000034,348.92008118267194,344.77615881732874,346.927289337196,349.2032478052863,349.64149561123196,348.76499999934066,111465,69092.56666666667,60.384652284735594,53.81023030850901,NaN,NaN,NaN,NaN,1.1686508117009704,23.707031281452156,94122981
2025-09-09T09:55:00-04:00,348.85,348.88,347.72,348.38,346.5515325532128,NaN,NaN,NaN,NaN,NaN,346.86432000000036,348.97098016019174,344.757659839809,346.927289337196,349.1116984811347,349.60553203966487,348.6178649226045,100600,70740.66666666667,56.414880772890704,54.90043123424596,NaN,NaN,NaN,NaN,1.1701757537223294,23.22355937324789,94022381
2025-09-09T10:00:00-04:00,348.34,349,345.7,345.7,NaN,NaN,NaN,350.91931641329165,350.91931641329165,350.91931641329165,346.81612000000035,348.9168431760786,344.7153968239221,346.927289337196,348.7675753719964,349.7081372394836,347.8270135045091,168468,73060.86666666667,41.542634122039196,54.82542095785433,NaN,NaN,NaN,NaN,1.3223060570278782,22.336819071364324,93853913
2025-09-09T10:05:00-04:00,345.68,347.37,345.5,346.44,NaN,NaN,NaN,350.097074758142,NaN,NaN,346.7851200000003,348.8612393661908,344.7090006338098,346.927289337196,348.5768427057785,349.6815909937248,347.47209441783224,100858,74967.76666666666,45.79203422415309,54.92081105150846,NaN,NaN,NaN,NaN,1.3614270529544588,21.670624628966454,93954771
2025-09-09T10:10:00-04:00,346.5,347.89,346.12,347.36,NaN,NaN,NaN,350.097074758142,NaN,NaN,346.78292000000033,348.85636312065907,344.7094768793416,346.927289337196,348.50203872123575,349.6248881080355,347.379189334436,66875,76063.36666666667,50.59994707824849,55.60815459019296,NaN,NaN,NaN,NaN,1.3906108348862818,20.53032608073893,94021646
2025-09-09T10:15:00-04:00,347.39,347.75,346.74,346.74,NaN,NaN,NaN,350.097074758142,NaN,NaN,346.7689200000004,348.83386295668936,344.7039770433114,346.927289337196,348.40422321707166,349.54620621672797,347.26224021741535,95744,78098.36666666667,47.53981937884923,55.54694271386035,NaN,NaN,NaN,NaN,1.3634243466801181,19.471477428813376,93925902
2025-09-09T10:20:00-04:00,346.75,347.11,345.65,346.26,NaN,NaN,NaN,350.097074758142,NaN,NaN,346.74252000000035,348.7990446116883,344.6859953883124,346.7334577125155,348.28410077368676,349.4931354787364,347.0750660686371,86206,80267.16666666667,45.25781085787978,55.08151952640028,NaN,NaN,NaN,NaN,1.370322607631541,19.402780608008218,93839696
2025-09-09T10:25:00-04:00,346.3,346.94,345.59,346.63,NaN,NaN,NaN,350.0148277569762,NaN,NaN,346.7323200000003,348.7859146412517,344.6787253587489,346.7334577125155,348.1976606146511,349.44333908797347,346.95198214132876,70708,81542.2,47.355577942272326,54.60398975005041,NaN,NaN,NaN,NaN,1.3688709928007181,19.385468403680232,93910404
2025-09-09T10:30:00-04:00,346.58,347.36,344.85,345,NaN,NaN,NaN,350.0148277569762,NaN,NaN,346.68632000000025,348.7894321488907,344.5832078511098,346.7334577125155,348.009553290165,349.3736117074688,346.6454948728612,128454,84390.96666666666,40.07055353180221,54.20385535539076,NaN,NaN,NaN,NaN,1.4503802076006662,19.923063157467364,93781950
2025-09-09T10:35:00-04:00,345.09,345.37,344.12,345.18,NaN,NaN,NaN,348.6588513240217,NaN,NaN,346.66752000000037,348.8070361785952,344.52800382140555,346.7334577125155,347.81832033925,349.33706519814695,346.2995754803531,109748,87407.13333333333,41.1472571250639,53.611214406896934,NaN,NaN,NaN,NaN,1.43606733562919,20.90489610872522,93891698
2025-09-09T10:40:00-04:00,345.14,345.44,344.5,345.09,NaN,NaN,NaN,348.6588513240217,NaN,NaN,346.66392000000036,348.81341254813054,344.5144274518702,345.05576617001236,347.7253423759387,349.30099666097,346.1496880909074,61303,88436.5,40.75300843580728,51.70940521248103,NaN,NaN,NaN,NaN,1.4006339545128192,21.726308638975876,93830395
2025-09-09T10:45:00-04:00,345.01,345.43,344.81,344.91,NaN,NaN,NaN,348.6588513240217,NaN,NaN,346.6511200000004,348.83435069381096,344.4678893061898,344.2906129360099,347.6640487730742,349.27216293162445,346.055934614524,43416,88333.73333333334,39.92899847090422,49.842482804744485,NaN,NaN,NaN,NaN,1.3448743863333326,22.4890488456372,93786979
2025-09-09T10:50:00-04:00,344.92,345.66,343.83,345.25,NaN,NaN,NaN,348.5960778654926,NaN,NaN,346.63632000000035,348.84713539494726,344.42550460505345,343.52739382323705,347.50256708988854,349.1914516733321,345.813682506445,118186,91426.63333333333,42.3021397419504,48.00503366404474,NaN,NaN,NaN,NaN,1.3795262158809545,23.839976596878756,93905165
2025-09-09T10:55:00-04:00,345.25,346.17,345.24,345.8,NaN,NaN,NaN,348.5960778654926,NaN,NaN,346.6163200000003,348.83891216020334,344.3937278397973,343.52739382323705,347.44656579492886,349.1370192439453,345.7561123459124,65935,92472.4,46.01733381837666,46.07904627035522,NaN,NaN,NaN,NaN,1.3474172004608869,24.39326253654842,93971100
2025-09-09T11:00:00-04:00,345.85,346.29,345.44,345.53,NaN,NaN,NaN,348.5960778654926,NaN,NaN,346.57722000000035,348.8060850848642,344.3483549151365,343.52739382323705,347.38485546816645,349.0742835977264,345.6954273386065,78641,93923.76666666666,44.50240901206929,44.94460032230763,NaN,NaN,NaN,NaN,1.3118874004279681,24.744553352911538,93892459
2025-09-09T11:05:00-04:00,345.5,345.73,344.95,345.55,NaN,NaN,NaN,348.5960778654926,NaN,NaN,346.5394200000003,348.77257640621536,344.3062635937852,343.1915972359161,347.3368220537348,349.03308228484224,345.6405618226274,53791,94791.83333333333,44.647772602401524,44.104092595844115,NaN,NaN,NaN,NaN,1.273895443254544,25.427454992426547,93946250
2025-09-09T11:10:00-04:00,345.53,346.72,345.39,346.42,NaN,NaN,NaN,348.5960778654926,NaN,NaN,346.52642000000037,348.75463256043105,344.2982074395697,343.7600222309863,347.30805859778576,348.99284503262965,345.6232721629419,56225,94498.96666666666,50.69735837693543,44.75800147119384,NaN,NaN,NaN,NaN,1.2779029115935079,24.78344507646752,94002475
2025-09-09T11:15:00-04:00,346.41,346.89,346.41,346.8,NaN,NaN,NaN,348.5960778654926,NaN,NaN,346.5258200000004,348.75372138701965,344.29791861298116,344.282017784789,347.29807788192795,348.97076528659534,345.62539047726057,37845,94091.2,53.108029932366115,45.280572593209065,NaN,NaN,NaN,NaN,1.2209098464796833,23.98549282426396,94040320
2025-09-09T11:20:00-04:00,346.82,347.03,346.4,346.615,NaN,NaN,NaN,348.5960778654926,NaN,NaN,346.5199200000004,348.745281555868,344.2945584441328,344.6286142278312,347.2855799752609,348.94350125101005,345.6276586995117,47715,94683.56666666667,51.780611498959644,45.364905766117,NaN,NaN,NaN,NaN,1.1787020003025626,23.07508961482537,93992605
2025-09-09T11:25:00-04:00,346.66,346.86,346.31,346.38,NaN,NaN,NaN,348.5960778654926,NaN,NaN,346.5125200000004,348.7372326282579,344.2878073717429,344.663891382265,347.27612418683316,348.9259974475158,345.62625092615053,29301,94529.26666666666,50.06864863392631,45.54553642719394,NaN,NaN,NaN,NaN,1.133794714566666,22.320058261143785,93963304
2025-09-09T11:30:00-04:00,346.37,346.91,346.21,346.79,NaN,NaN,NaN,348.5960778654926,NaN,NaN,346.52312000000035,348.74796946513516,344.29827053486554,344.803113105812,347.2688554984568,348.91072490978956,345.626986087124,27395,93884.43333333333,52.988950776295454,46.097760707080774,NaN,NaN,NaN,NaN,1.1028093778119075,21.723733569220425,93990699
2025-09-09T11:35:00-04:00,346.77,347.14,346.53,346.59,NaN,NaN,NaN,348.5960778654926,NaN,NaN,346.5423200000003,348.75252934542664,344.33211065457397,345.14949048464956,347.25923786405264,348.88721478553714,345.63126094256813,45817,93712.7,51.409420349040005,46.38732087899275,NaN,NaN,NaN,NaN,1.0676087079682008,20.845428491703206,93944882
2025-09-09T11:40:00-04:00,346.62,346.63,346.09,346.39,NaN,NaN,NaN,348.5960778654926,NaN,NaN,346.56272000000035,348.74795913713854,344.37748086286217,345.14949048464956,347.2504827704426,348.87280322135797,345.62816231952723,24420,92627.4,49.81042355070556,47.083025880342994,NaN,NaN,NaN,NaN,1.0299223716847594,20.520927053650333,93920462
2025-09-09T11:45:00-04:00,346.37,346.81,346.31,346.74,NaN,NaN,NaN,348.5960778654926,NaN,NaN,346.58352000000036,348.75527295982687,344.41176704017386,345.14949048464956,347.24269497842823,348.856467966257,345.62892199059945,31020,91253.6,52.58951003833637,47.90032965986245,NaN,NaN,NaN,NaN,0.9920707737072766,19.950790025844984,93951482
2025-09-09T11:50:00-04:00,346.74,347.7,346.58,347.61,NaN,NaN,NaN,348.5960778654926,NaN,NaN,346.61132000000043,348.79927354391714,344.4233664560837,345.74805912814054,347.2438496163476,348.8402863345049,345.6474128981902,54900,89644.63333333333,58.709792781183104,49.182957113103576,NaN,NaN,NaN,NaN,1.0012085755853286,18.811576856660263,94006382
2025-09-09T11:55:00-04:00,347.61,347.93,347.34,347.73,NaN,NaN,NaN,348.5960778654926,NaN,NaN,346.6479200000004,348.8482426977882,344.4475973022126,346.0734473025124,347.2548709024601,348.831803309245,345.67793849567516,68682,87829.8,59.48665117509023,50.57993230625972,NaN,NaN,NaN,NaN,0.9718365344720931,18.023199745857692,94075064
2025-09-09T12:00:00-04:00,347.75,348.28,347.62,347.88,NaN,NaN,NaN,348.5960778654926,NaN,NaN,346.68212000000034,348.9047109436021,344.4595290563986,346.46475784200993,347.2673319540317,348.8321980996576,345.7024658084058,49798,82546.56666666667,60.487400035349815,51.87887947007397,NaN,NaN,NaN,NaN,0.9495624962955127,17.689709252413046,94124862
2025-09-09T12:05:00-04:00,347.85,348.1,347.71,348.06,NaN,NaN,NaN,348.5960778654926,NaN,NaN,346.7127200000004,348.9679800928595,344.4574599071413,346.46475784200993,347.27902184787894,348.83311330053664,345.72493039522124,46313,78945.16666666667,61.709710527842375,52.999763520750086,NaN,NaN,NaN,NaN,0.909593746560122,17.380039508500165,94171175
2025-09-09T12:10:00-04:00,348.07,348.45,348.07,348.33,NaN,NaN,NaN,348.5960778654926,NaN,NaN,346.7427200000004,349.0428820130488,344.442557986952,346.93724501888636,347.2933942437197,348.8409293303909,345.7458591570485,39650,73805.73333333334,63.53206575855394,54.35902471692756,NaN,NaN,NaN,NaN,0.8724799075201124,17.498296664859165,94210825
2025-09-09T12:15:00-04:00,348.32,348.5,347.56,347.59,NaN,NaN,NaN,348.5960778654926,NaN,NaN,346.7651200000005,349.0760113479579,344.45422865204307,346.93724501888636,347.3019438940067,348.839841196334,345.76404659167935,40744,68674.1,55.70670294698292,55.14894831296909,NaN,NaN,NaN,NaN,0.8773027712686756,16.81486874770142,94170081
2025-09-09T12:20:00-04:00,347.6,347.6,346.88,347.285,NaN,NaN,NaN,348.5960778654926,NaN,NaN,346.7764200000004,349.09183944671605,344.4610005532848,346.93724501888636,347.30124933125876,348.82773770746087,345.77476095505665,42221,66365.96666666666,52.81898759949105,55.300493257437346,NaN,NaN,NaN,NaN,0.8660668590352006,15.958098193817616,94127860
2025-09-09T12:25:00-04:00,347.17,347.9,347.09,347.71,NaN,NaN,NaN,348.5960778654926,NaN,NaN,346.7948200000004,349.1249538910483,344.46468610895255,346.93724501888636,347.3038592441229,348.82304967777515,345.7846688104707,28339,63957.26666666667,56.224277007634555,55.52308233424224,NaN,NaN,NaN,NaN,0.8620620833898293,14.871845355069526,94156199
2025-09-09T12:30:00-04:00,347.68,348.18,347.55,348.05,NaN,NaN,NaN,348.5960778654926,NaN,NaN,346.82182000000046,349.1780727093131,344.46556729068783,346.93724501888636,347.31055215578203,348.82292156446647,345.7981827470976,31307,59385.23333333333,58.78696670102021,56.02353627724657,NaN,NaN,NaN,NaN,0.8454862202905554,14.222667692502444,94187506
2025-09-09T12:35:00-04:00,348.02,348.06,347.19,347.39,NaN,NaN,NaN,348.5960778654926,NaN,NaN,346.8402000000004,349.1995549627013,344.48084503729945,346.93724501888636,347.31293133690343,348.8178466163579,345.808016057449,29654,57011.76666666667,52.37703625681047,56.188421107452584,NaN,NaN,NaN,NaN,0.8472372045555161,13.289378795906643,94157852
2025-09-09T12:40:00-04:00,347.36,347.62,347.18,347.24,NaN,NaN,NaN,348.5960778654926,NaN,NaN,346.84900000000044,349.2109703638623,344.4870296361386,346.93724501888636,347.31318593616805,348.81241453398894,345.81395733834717,22379,55528.566666666666,51.015569593380974,56.047465308672976,NaN,NaN,NaN,NaN,0.8181488328015505,12.436582404534754,94135473
2025-09-09T12:45:00-04:00,347.33,347.85,347.07,347.4,NaN,NaN,NaN,348.5960778654926,NaN,NaN,346.8662000000004,349.2314421102039,344.5009578897969,346.93724501888636,347.3142261275444,348.8073371707179,345.82111508437083,24524,53154.566666666666,52.43580282132527,56.12077834240763,NaN,NaN,NaN,NaN,0.8154239161728704,11.78678007461937,94159997
2025-09-09T12:50:00-04:00,347.36,347.41,346.28,346.38,NaN,NaN,NaN,348.5960778654926,NaN,NaN,346.86940000000044,349.2315673437248,344.5072326562761,346.93724501888636,347.30400329165894,348.78695551220113,345.82105107111676,49779,51940.333333333336,43.731050988333145,55.68653744509532,NaN,NaN,NaN,NaN,0.8378936364462405,11.785079966554395,94110218
2025-09-09T12:55:00-04:00,346.37,346.64,346.19,346.27,NaN,NaN,NaN,348.5960778654926,NaN,NaN,346.87760000000037,349.22851406903413,344.5266859309666,346.93724501888636,347.2905861632005,348.7670904215187,345.8140819048823,44141,51054.76666666667,42.903867023069374,54.994705801147674,NaN,NaN,NaN,NaN,0.8101869481286511,11.89451669024967,94066077
2025-09-09T13:00:00-04:00,346.31,346.91,346.295,346.49,NaN,NaN,NaN,348.5960778654926,NaN,NaN,346.8880000000004,349.22733409326514,344.5486659067356,346.8197960151091,347.28292463568806,348.75348430117214,345.812364970204,32909,47869.933333333334,45.13893682601387,54.02535894720701,NaN,NaN,NaN,NaN,0.7980307375480363,11.560326384227624,94098986
2025-09-09T13:05:00-04:00,346.49,347.22,346.25,347.2,NaN,NaN,NaN,348.5960778654926,NaN,NaN,346.9098000000004,349.24002484746876,344.5795751525321,346.45033555973583,347.27665496491255,348.73626568004806,345.81704424977704,50537,45896.23333333333,51.70901864753651,53.46981376666747,NaN,NaN,NaN,NaN,0.8103142562946071,10.771980664596914,94149523
2025-09-09T13:10:00-04:00,347.23,347.42,346.9,346.91,NaN,NaN,NaN,348.5960778654926,NaN,NaN,346.9326000000004,349.2399658053948,344.625234194606,346.45033555973583,347.2745810806039,348.72674530175,345.82241685945786,33188,44959.066666666666,49.121392331513256,52.65795607353629,NaN,NaN,NaN,NaN,0.789577523702138,10.263614278916771,94116335
2025-09-09T13:15:00-04:00,346.93,347.6,346.93,347.54,NaN,NaN,NaN,348.5960778654926,NaN,NaN,346.95640000000043,349.2637864348559,344.64901356514497,346.45033555973583,347.2752234140351,348.7217128456333,345.8287339824369,25241,44353.23333333333,54.45370440871491,52.13966992217005,NaN,NaN,NaN,NaN,0.7824648434376994,10.058068782663783,94141576
2025-09-09T13:20:00-04:00,347.57,347.6,346.76,346.83,NaN,NaN,NaN,348.5960778654926,NaN,NaN,346.9600000000004,349.26602428432915,344.6539757156716,346.2412684477887,347.2731472719462,348.71268406832047,345.8336104755719,31918,41477.63333333333,48.30887604442465,51.05229922830366,NaN,NaN,NaN,NaN,0.786574497477866,9.576526723844877,94109658
2025-09-09T13:25:00-04:00,346.84,347.19,346.84,346.91,NaN,NaN,NaN,348.5960778654926,NaN,NaN,346.9610000000004,349.26689331925803,344.6551066807428,346.1200118065848,347.2709839651804,348.7054187668456,345.8365491635152,24218,40087.066666666666,49.00712159394562,50.57375770308671,NaN,NaN,NaN,NaN,0.7561048905151623,9.129380526370177,94133876
2025-09-09T13:30:00-04:00,346.91,347.15,346.55,346.72,NaN,NaN,NaN,348.5960778654926,NaN,NaN,346.9734000000004,349.2672765790178,344.67952342098306,346.1200118065848,347.2680952507127,348.69852697403996,345.8376635273854,20545,38150.53333333333,47.370499308307714,50.18457996800219,NaN,NaN,NaN,NaN,0.7449545411926483,8.755091690580311,94113331
2025-09-09T13:35:00-04:00,346.71,347.18,346.66,347.09,NaN,NaN,NaN,348.5960778654926,NaN,NaN,346.98640000000046,349.27539981645407,344.69740018354685,345.84195477502533,347.26491796505167,348.68785256914634,345.841983360957,36400,37570.833333333336,50.81521104011773,49.79821811317955,NaN,NaN,NaN,NaN,0.7288863596788863,8.350323672658929,94149731
2025-09-09T13:40:00-04:00,347.04,347.09,346.62,346.79,NaN,NaN,NaN,348.5960778654926,NaN,NaN,346.9434000000004,349.1637346053902,344.7230653946106,345.84195477502533,347.26206131856765,348.6807106395264,345.8434119976089,22246,36438.2,48.06804860052586,49.03258110600139,NaN,NaN,NaN,NaN,0.710394476844678,8.050264291167855,94127485
2025-09-09T13:45:00-04:00,346.78,346.98,346.53,346.91,NaN,NaN,NaN,348.5960778654926,NaN,NaN,346.90540000000044,349.0607337003297,344.7500662996712,345.84195477502533,347.258616706348,348.67244116815607,345.8447922445399,25616,36030.566666666666,49.249924758168675,48.80921599895555,NaN,NaN,NaN,NaN,0.6917948713557758,7.948592804838646,94153101
2025-09-09T13:50:00-04:00,346.88,347.69,346.785,347.55,NaN,NaN,NaN,348.5960778654926,NaN,NaN,346.8726000000004,348.9358132608997,344.80938673910106,346.1133283140354,347.2592692316706,348.66754760545695,345.85099085788426,26819,35334.03333333333,55.116772529269326,49.10215906580471,NaN,NaN,NaN,NaN,0.7070238091160755,8.278764211602699,94179920
2025-09-09T13:55:00-04:00,347.58,347.83,347.25,347.27,NaN,NaN,NaN,348.5960778654926,NaN,NaN,346.81180000000035,348.63098636760543,344.99261363239526,346.27866265122833,347.2608426153737,348.66340644939925,345.85827878134813,28392,35303.73333333333,52.26980975042031,49.09030241788294,NaN,NaN,NaN,NaN,0.6979506798934976,8.815322945775844,94151528
2025-09-09T14:00:00-04:00,347.32,347.41,346.76,346.76,NaN,NaN,NaN,348.5960778654926,NaN,NaN,346.76880000000034,348.4863745224034,345.05122547759726,346.27866265122833,347.25904575480035,348.65734975627686,345.86074175332385,21901,35120.6,47.46105904022085,49.35673156444635,NaN,NaN,NaN,NaN,0.6945256313296788,8.305476118022304,94129627
2025-09-09T14:05:00-04:00,346.75,346.765,346.41,346.57,NaN,NaN,NaN,348.5960778654926,NaN,NaN,346.73260000000033,348.3879866497328,345.07721335026787,346.27866265122833,347.2516043729568,348.643997924138,345.85921082177566,38473,34875.8,45.771607956442004,49.56157020254439,NaN,NaN,NaN,NaN,0.6702738005204133,8.214969867385925,94091154
2025-09-09T14:10:00-04:00,346.615,346.7,345.98,346.67,NaN,NaN,NaN,348.5833473034758,NaN,NaN,346.75200000000035,348.3810524853618,345.1229475146389,346.27866265122833,347.2394506755881,348.62471585657175,345.85418549460445,53916,35859,46.844091954091745,49.6833669974071,NaN,NaN,NaN,NaN,0.6738256719118103,8.807305560302483,94145070
2025-09-09T14:15:00-04:00,346.65,346.97,346.6,346.89,NaN,NaN,NaN,348.5833473034758,NaN,NaN,346.76100000000025,348.38802919466946,345.13397080533105,346.27866265122833,347.2365889608219,348.61755225543925,345.85562566620456,24428,35639.26666666667,49.223318371232324,49.50581697767108,NaN,NaN,NaN,NaN,0.6521238382038241,8.821052467668725,94169498
2025-09-09T14:20:00-04:00,346.92,346.94,346.3,346.31,NaN,NaN,NaN,348.5833473034758,NaN,NaN,346.7400000000003,348.3626607779159,345.1173392220847,346.27866265122833,347.23345334815656,348.6122212807095,345.8546854156036,15663,34331.36666666667,43.6733474384766,49.11667091388274,NaN,NaN,NaN,NaN,0.6512578497606929,9.299147707911253,94153835
2025-09-09T14:25:00-04:00,346.34,346.63,346.28,346.59,NaN,NaN,NaN,348.58313574168756,NaN,NaN,346.73700000000025,348.36020423864255,345.11379576135795,346.27866265122833,347.22966860692753,348.605878306565,345.8534589072901,18653,32663.733333333334,46.79230175317403,48.569427867058394,NaN,NaN,NaN,NaN,0.629739431920645,9.773951340675561,94172488
2025-09-09T14:30:00-04:00,346.62,346.75,346.19,346.19,NaN,NaN,NaN,348.57776593524727,NaN,NaN,346.73560000000026,348.3605672489776,345.11063275102293,346.27866265122833,347.224604399412,348.59828668240937,345.8509221164146,21589,31723.433333333334,43.11904841141951,48.19872589327232,NaN,NaN,NaN,NaN,0.6247580439263133,9.949952907658023,94150899
2025-09-09T14:35:00-04:00,346.21,346.36,346.02,346.295,NaN,NaN,NaN,348.24832202909965,NaN,NaN,346.72890000000024,348.35831006512547,345.099489934875,346.27866265122833,347.21818544756854,348.58977607492085,345.84659482021624,23502,30963.066666666666,44.35392901697009,47.86635499491693,NaN,NaN,NaN,NaN,0.6044181836458646,10.405039794405457,94174401
2025-09-09T14:40:00-04:00,346.28,346.64,346.25,346.36,NaN,NaN,NaN,348.24832202909965,NaN,NaN,346.75610000000023,348.3129484705815,345.199251529419,346.27866265122833,347.2142193635277,348.5835677978014,345.84487092925406,18200,30248.066666666666,45.147819785060754,47.707592171827855,NaN,NaN,NaN,NaN,0.5891025990997305,10.194217601626377,94192601
2025-09-09T14:45:00-04:00,346.41,346.87,346.41,346.8,NaN,NaN,NaN,348.24832202909965,NaN,NaN,346.7885000000002,348.27880366044957,345.2981963395509,345.8439301209827,347.2107491955336,348.5761863220379,345.84531206902926,24668,29712.2,50.31523640020767,47.67187969754857,NaN,NaN,NaN,NaN,0.5834524134497491,9.513552289946723,94217269
2025-09-09T14:50:00-04:00,346.79,346.99,346.6,346.87,NaN,NaN,NaN,348.24832202909965,NaN,NaN,346.82410000000027,348.2332397234856,345.41496027651493,345.83206751083924,347.2087450837674,348.5709621102513,345.8465280572835,19089,28941.133333333335,51.10442211126089,47.88876351974393,NaN,NaN,NaN,NaN,0.5696343839176231,9.033010272708063,94236358
2025-09-09T14:55:00-04:00,346.86,346.96,346.55,346.84,NaN,NaN,NaN,348.24832202909965,NaN,NaN,346.86270000000025,348.1614042928452,345.5639957071553,345.83206751083924,347.20603500772614,348.5643278694548,345.8477421459975,23862,28791.9,50.73250157348192,47.99466186369488,NaN,NaN,NaN,NaN,0.558231927923505,8.475568361848765,94212496
2025-09-09T15:00:00-04:00,346.86,347.16,346.85,346.85,NaN,NaN,NaN,348.24832202909965,NaN,NaN,346.8947000000003,348.10898400307497,345.6804159969256,346.09492320693715,347.20312609517873,348.55384750633135,345.8524046840261,43620,29202.333333333332,50.8608771798031,47.69066933873301,NaN,NaN,NaN,NaN,0.5412153616432581,8.390144718324425,94256116
2025-09-09T15:05:00-04:00,346.83,346.87,345.91,345.93,NaN,NaN,NaN,348.24832202909965,NaN,NaN,346.89730000000026,348.1027214367686,345.6918785632319,346.09492320693715,347.19358378299665,348.54101314626143,345.8461544197319,37787,29473.433333333334,40.42470250178557,46.844590249544815,NaN,NaN,NaN,NaN,0.5711285500973097,9.084549127501127,94218329
2025-09-09T15:10:00-04:00,345.9,346.21,345.7,346.16,NaN,NaN,NaN,347.863626412109,NaN,NaN,346.90990000000033,348.0702163189717,345.749583681029,346.09492320693715,347.17980836287774,348.5252172852823,345.8343994404732,45587,30247.033333333333,43.54356097078299,46.56476895887068,NaN,NaN,NaN,NaN,0.5667622250903583,10.04448165875903,94263916
2025-09-09T15:15:00-04:00,346.19,346.58,346.19,346.5,NaN,NaN,NaN,347.863626412109,NaN,NaN,346.9289000000003,348.02907505887566,345.8287249411249,346.09492320693715,347.1752634370076,348.5178979166228,345.83262895739233,23408,30209.833333333332,47.886792821648044,46.715853592099684,NaN,NaN,NaN,NaN,0.5562792090124727,10.124171919813604,94287324
2025-09-09T15:20:00-04:00,346.52,346.81,346.46,346.62,NaN,NaN,NaN,347.863626412109,NaN,NaN,346.9329000000003,348.02708296464056,345.83871703536005,346.09492320693715,347.17134671208623,348.5099425322001,345.83275089197235,28189,29490.166666666668,49.36732356156006,46.89608442120457,NaN,NaN,NaN,NaN,0.5415449797972978,9.734015575342433,94315513
2025-09-09T15:25:00-04:00,346.6,346.83,346.3,346.32,NaN,NaN,NaN,347.863626412109,NaN,NaN,346.9233000000003,348.03032594373246,345.8162740562682,346.09492320693715,347.16669554572917,348.50194977645,345.83144131500836,26710,28909.133333333335,45.8596058381982,46.65581924027356,NaN,NaN,NaN,NaN,0.5407203383832031,9.65744804126956,94288803
2025-09-09T15:30:00-04:00,346.35,346.6,346.1,346.49,NaN,NaN,NaN,347.863626412109,NaN,NaN,346.9208000000003,348.0311591491182,345.81044085088246,346.09492320693715,347.15654806663076,348.48587855412995,345.82721757913157,52762,29570.9,48.109615054097716,46.97269549853222,NaN,NaN,NaN,NaN,0.5378117427844028,9.935136135544031,94341565
2025-09-09T15:35:00-04:00,346.5,346.72,346.2,346.5,NaN,NaN,NaN,347.863626412109,NaN,NaN,346.92320000000035,348.0293839991585,345.8170160008422,346.09492320693715,347.1503021603334,348.47513910601526,345.82546521465156,36940,29117.666666666668,48.245867303460535,47.07652160926697,NaN,NaN,NaN,NaN,0.5365394754426626,9.922179910740907,94378505
2025-09-09T15:40:00-04:00,346.49,346.57,346.18,346.55,NaN,NaN,NaN,347.863626412109,NaN,NaN,346.9184000000003,348.0289285949156,345.807871405085,346.09492320693715,347.1460083518981,348.46803008421847,345.82398661957774,24345,28822.9,48.9674051687255,47.49426137764597,NaN,NaN,NaN,NaN,0.5260723700539,9.948551946071529,94402850
2025-09-09T15:45:00-04:00,346.55,347.03,346.54,346.89,NaN,NaN,NaN,347.863626412109,NaN,NaN,346.92440000000033,348.03100135553177,345.8177986444689,346.09492320693715,347.14229116046926,348.4572099768075,345.827372344131,46885,29544.366666666665,53.694953849925774,48.16147743714281,NaN,NaN,NaN,NaN,0.5234957721929037,9.515847579531062,94449735
2025-09-09T15:50:00-04:00,346.87,346.91,346.32,346.62,NaN,NaN,NaN,347.863626412109,NaN,NaN,346.92900000000037,348.02856718754805,345.8294328124527,345.83670155988955,347.13482353521727,348.441849384926,345.82779768550853,59261,30455.8,49.75328908494111,48.4904395299914,NaN,NaN,NaN,NaN,0.5282460741791272,9.019179358923262,94390474
2025-09-09T15:55:00-04:00,346.65,347.15,346.6,347.005,NaN,NaN,NaN,347.863626412109,NaN,NaN,346.93430000000035,348.03272616503443,345.83587383496626,345.8752889983293,347.12611516986004,348.4072898679853,345.8449404717348,174820,35475.86666666667,54.84363014784023,48.81389622625087,NaN,NaN,NaN,NaN,0.529799926023472,8.69016073921921,94565294
2025-09-10T09:30:00-04:00,350.37,352.2,348.36,351.16,347.8952602082666,347.8952602082666,347.8952602082666,NaN,NaN,NaN,347.0053000000004,348.6110314968456,345.39956850315514,348.58273119866345,350.5733333333334,350.5733333333334,350.5733333333334,240138,42795.63333333333,79.2615979050875,50.825123068667025,NaN,NaN,NaN,NaN,0.8630285027360808,12.525462273988158,94805432
2025-09-10T09:35:00-04:00,351.18,351.26,346.96,347.84,NaN,NaN,NaN,351.9727061648364,351.9727061648364,351.9727061648364,347.00750000000045,348.6174928570397,345.3975071429612,348.58273119866345,349.7636688631732,350.69748384097744,348.829853885369,180530,47599.96666666667,54.092039740298674,51.065090080582515,NaN,NaN,NaN,NaN,1.1085264668263615,14.30862217390844,94624902
2025-09-10T09:40:00-04:00,347.8,347.8,346.08,346.9,NaN,NaN,NaN,349.9125831573438,NaN,NaN,346.98790000000037,348.57867476720384,345.3971252327969,348.58273119866345,348.99136703118756,350.4844174615239,347.49831660085124,157351,52103.46666666667,49.31693101664888,50.95480821178578,NaN,NaN,NaN,NaN,1.1550602906244778,15.04107196543652,94467551
2025-09-10T09:45:00-04:00,346.93,348.03,346.21,347.83,NaN,NaN,NaN,349.9125831573438,NaN,NaN,346.9833000000004,348.5629387055006,345.4036612945002,348.58273119866345,348.71835315338683,350.2112217905982,347.22548451617547,115891,55112.63333333333,53.67418387398731,51.90119973837162,NaN,NaN,NaN,NaN,1.2025559841513005,15.860123458007758,94583442
2025-09-10T09:50:00-04:00,347.87,348.5,346.66,348.13,NaN,NaN,NaN,349.9125831573438,NaN,NaN,346.97930000000036,348.5462397052548,345.41236029474595,348.58273119866345,348.58268655689164,350.00508624160136,347.1602868721819,114896,58048.53333333333,55.01761476083177,52.72077500908939,NaN,NaN,NaN,NaN,1.2480876995690628,16.902514648162224,94698338
2025-09-10T09:55:00-04:00,348.2,349.19,347.57,347.74,NaN,NaN,NaN,349.9125831573438,NaN,NaN,346.9823000000004,348.55447074127954,345.41012925872127,348.58273119866345,348.5358497656394,349.88222706189384,347.18947246938495,102610,60522.46666666667,52.87107742749935,53.076795338078774,NaN,NaN,NaN,NaN,1.2746528638855585,18.259130441835435,94595728
2025-09-10T10:00:00-04:00,347.68,350.27,347.6,349.8,345.4477101759469,345.4477101759469,345.4477101759469,NaN,NaN,NaN,347.0326000000004,348.7902760110586,345.2749239889422,348.58273119866345,348.6108863121431,349.8996198297674,347.32215279451884,111666,63514.63333333333,61.43087946785903,53.938477902814405,NaN,NaN,NaN,NaN,1.3743205164651584,20.052383360416627,94707394
2025-09-10T10:05:00-04:00,349.88,351.41,349.73,350.37,347.0121324406766,NaN,NaN,NaN,NaN,NaN,347.0858000000004,349.0688414619481,345.1027585380527,348.58273119866345,348.9092504108443,350.2784119432786,347.54008887841,191490,68615.2,63.41111869616184,55.19215739266896,NaN,NaN,NaN,NaN,1.396154765289076,22.190705478927537,94898884
2025-09-10T10:10:00-04:00,350.43,350.5,349,349.1,347.0121324406766,NaN,NaN,NaN,NaN,NaN,347.10680000000036,349.1515188168288,345.0620811831719,348.58273119866345,348.945450610457,350.282293009235,347.608608211679,74790,69311,56.4560423386892,55.78833077013978,NaN,NaN,NaN,NaN,1.403572282054142,23.37665360292353,94824094
2025-09-10T10:15:00-04:00,349.17,350.06,349.13,349.895,347.0121324406766,NaN,NaN,NaN,NaN,NaN,347.1569000000004,349.34467136826476,344.96912863173606,348.58273119866345,348.9824822873337,350.2959657651342,347.6689988095332,67012,70730.46666666666,59.45404563216893,56.5889149364761,NaN,NaN,NaN,NaN,1.3718885476217018,24.477891146634093,94891106
2025-09-10T10:20:00-04:00,349.84,350.57,349.5,349.81,347.0121324406766,NaN,NaN,NaN,NaN,NaN,347.2083000000004,349.5187844599698,344.897815540031,346.6720609919355,349.0239722173589,350.32429842224576,347.72364601247205,60122,72212.43333333333,58.98642596364642,57.304559278970444,NaN,NaN,NaN,NaN,1.3503250799344368,25.749781261306616,94830984
2025-09-10T10:25:00-04:00,349.8,350.34,348.86,349.16,347.0121324406766,NaN,NaN,NaN,NaN,NaN,347.2435000000003,349.61735193303826,344.8696480669624,346.6720609919355,349.0436677450738,350.316992025246,347.77034346490154,68101,73860.7,55.39815079303376,57.426216203478155,NaN,NaN,NaN,NaN,1.3595875742248313,26.203614565708342,94762883
2025-09-10T10:30:00-04:00,349.12,350.53,349.07,350.06,347.0121324406766,NaN,NaN,NaN,NaN,NaN,347.3171000000004,349.804763232799,344.82943676720174,346.7133190348387,349.07599633415623,350.3351168223684,347.8168758459441,59204,75114.53333333334,59.107448591498425,58.09437045394653,NaN,NaN,NaN,NaN,1.3667598903516276,26.733494825232828,94822087
2025-09-10T10:35:00-04:00,350.12,351.25,350.12,350.92,347.0597713762846,NaN,NaN,NaN,NaN,NaN,347.4101000000004,350.0755511737675,344.7446488262333,347.601655227871,349.1612034767078,350.4425459642809,347.87986098913467,82105,77067.96666666666,62.33119796405546,58.62919672653334,NaN,NaN,NaN,NaN,1.35413418389794,27.622071337554882,94904192
2025-09-10T10:40:00-04:00,350.86,351.99,350.32,351.93,347.4668272228171,NaN,NaN,NaN,NaN,NaN,347.5189000000004,350.4555499893196,344.58225001068115,348.2363241822968,349.381077294611,350.769741021366,347.992413567856,175910,82324.96666666666,65.74650361267925,57.663832848504164,NaN,NaN,NaN,NaN,1.3766960279052312,28.815301929684782,95080102
2025-09-10T10:45:00-04:00,352,353.32,351.47,353.28,348.62219871268906,NaN,NaN,NaN,NaN,NaN,347.6405000000004,350.988910518421,344.29208948157975,349.3920593458374,349.7736012097223,351.46013214366747,348.08707027577714,242510,89586.36666666667,69.70085468371994,58.77874820160569,NaN,NaN,NaN,NaN,1.4105034544834265,30.48357108933501,95322612
2025-09-10T10:50:00-04:00,353.28,353.85,352.65,353.83,349.48505331665774,NaN,NaN,NaN,NaN,NaN,347.77890000000036,351.5415237069168,344.01627629308393,350.10764747666997,349.993437907547,351.8461133107019,348.14076250439206,130270,93292.4,71.16153782759542,60.339077259530434,NaN,NaN,NaN,NaN,1.3954674934488993,32.227464511599365,95452882
2025-09-10T10:55:00-04:00,353.76,355.49,353.74,355.38,350.7825508931733,NaN,NaN,NaN,NaN,NaN,347.93570000000034,352.2573390455357,343.614060954465,351.62111798133594,350.4691462605897,352.7475443843473,348.1907481368321,235062,100332.4,74.84239248362645,61.85109216021895,NaN,NaN,NaN,NaN,1.420791243916835,34.36115673069165,95687944
2025-09-10T11:00:00-04:00,355.41,355.87,354.31,355.02,351.21902585257453,NaN,NaN,NaN,NaN,NaN,348.0995000000003,352.8414849219419,343.3575150780587,351.99489438506873,350.92134465897783,353.48162297614846,348.3610663418072,262861,107640.43333333333,72.52696304962174,63.10175989513251,NaN,NaN,NaN,NaN,1.4307347264942043,36.446166746885815,95425083
2025-09-10T11:05:00-04:00,354.97,355.22,354.06,355.02,351.21902585257453,NaN,NaN,NaN,NaN,NaN,348.26170000000036,353.3704629069867,343.15293709301403,351.99489438506873,351.07577012017714,353.69526400428134,348.45627623607294,111817,110108.1,72.52696304962174,64.50575172528411,NaN,NaN,NaN,NaN,1.41139653174462,38.07350597410886,95425083
2025-09-10T11:10:00-04:00,355.07,356.05,354.64,355.99,351.4746702499698,NaN,NaN,NaN,NaN,NaN,348.4471000000004,353.97430077071436,342.9198992292864,352.400932406444,351.3173034108253,354.05900133952184,348.5756054821287,158510,113872.2,74.948831125501,65.47131970082998,NaN,NaN,NaN,NaN,1.411296779477149,39.836028949172146,95583593
2025-09-10T11:15:00-04:00,356,356.33,354.76,354.86,351.63650342042564,NaN,NaN,NaN,NaN,NaN,348.60250000000036,354.3987088471602,342.8062911528405,352.6257459251552,351.46533801423953,354.25976148688017,348.6709145415989,113115,116862.43333333333,67.48529939044354,65.76233260756439,NaN,NaN,NaN,NaN,1.4226327238002092,41.55357515539362,95470478
2025-09-10T11:20:00-04:00,354.77,355,354.18,354.73,351.63650342042564,NaN,NaN,NaN,NaN,NaN,348.76130000000035,354.78093912870736,342.74166087129333,352.6257459251552,351.5476852844645,354.35132702456343,348.7440435443655,81467,118638.36666666667,66.66284288081353,66.49138978914469,NaN,NaN,NaN,NaN,1.3795875292430508,42.40476555170511,95389011
2025-09-10T11:25:00-04:00,354.7,354.9,354.03,354.67,351.63650342042564,NaN,NaN,NaN,NaN,NaN,348.9165000000004,355.13409929552836,342.6989007044724,352.6257459251552,351.61704118323865,354.424188075073,348.8098942914043,74615,120235.2,66.2614613779218,66.97763377098418,NaN,NaN,NaN,NaN,1.3431884200114046,43.00456359377972,95314396
2025-09-10T11:30:00-04:00,354.73,354.73,353.5,353.85,351.63650342042564,NaN,NaN,NaN,NaN,NaN,349.04250000000036,355.398033415834,342.6869665841667,352.6257459251552,351.66810138205784,354.46694452801455,348.86925823610113,69537,120794.36666666667,60.86751778001342,67.11199747215325,NaN,NaN,NaN,NaN,1.335103532867734,42.89311706514371,95244859
2025-09-10T11:35:00-04:00,353.85,354.72,353.63,354.67,351.63650342042564,NaN,NaN,NaN,NaN,NaN,349.1905000000004,355.71639832895136,342.6646016710494,352.6257459251552,351.71314152100894,354.5095298156467,348.91675322637116,56266,121438.56666666667,64.02159272203397,67.72795760993897,NaN,NaN,NaN,NaN,1.3175961376628982,42.789631002838846,95301125
2025-09-10T11:40:00-04:00,354.7,355.15,354.37,355.15,351.63650342042564,NaN,NaN,NaN,NaN,NaN,349.3583000000004,356.05482047259204,342.6617795274087,352.6257459251552,351.76523979933785,354.56779988311484,348.96267971556085,55651,122482.1,65.76125336411474,68.20322937941157,NaN,NaN,NaN,NaN,1.2791964135441176,42.92427368104937,95356776
2025-09-10T11:45:00-04:00,355.14,355.16,354.55,354.77,351.63650342042564,NaN,NaN,NaN,NaN,NaN,349.52230000000037,356.33821907521303,342.7063809247877,352.6257459251552,351.7996603745732,354.60505259268876,348.9942681564576,38588,122205.53333333334,63.157645479040085,68.26226134476762,NaN,NaN,NaN,NaN,1.2313966697195387,43.05475143971453,95318188
2025-09-10T11:50:00-04:00,354.82,355.8,354.68,355.15,351.64164526933797,NaN,NaN,NaN,NaN,NaN,349.6919000000004,356.6362882063023,342.74751179369844,353.1885977758431,351.8764733388416,354.6958736515005,349.0570730261827,79084,122866.3,64.66426739105312,68.18495875750861,NaN,NaN,NaN,NaN,1.2234397647395718,43.51859992788892,95397272
2025-09-10T11:55:00-04:00,355.19,355.39,354.82,354.84,351.64164526933797,NaN,NaN,NaN,NaN,NaN,349.8509000000004,356.89473324331607,342.8070667566848,353.1885977758431,351.9110885637526,354.73401154688906,349.0881655806162,39136,118343.5,62.42165128968133,67.66501565793443,NaN,NaN,NaN,NaN,1.1767654958296017,43.94931638119372,95358136
2025-09-10T12:00:00-04:00,354.84,355.09,354.24,354.65,351.64164526933797,NaN,NaN,NaN,NaN,NaN,350.01770000000033,357.11303430079374,342.9223656992069,353.1885977758431,351.9447796416867,354.7666061577495,349.1229531256239,44053,111807.33333333333,61.02472655623693,66.94095770998025,NaN,NaN,NaN,NaN,1.153425103270342,43.455868338261816,95314083
2025-09-10T12:05:00-04:00,354.67,354.93,354.24,354.44,351.64164526933797,NaN,NaN,NaN,NaN,NaN,350.17470000000037,357.3070054926129,343.0423945073878,353.1885977758431,351.9642014656011,354.784307811667,349.14409511953517,27137,106694.23333333334,59.4413763333441,65.84088512781722,NaN,NaN,NaN,NaN,1.120323310179603,42.99766658411077,95286946
2025-09-10T12:10:00-04:00,354.47,354.705,354.02,354.27,351.64164526933797,NaN,NaN,NaN,NaN,NaN,350.33630000000034,357.4662940560973,343.2063059439034,353.1885977758431,351.9856085065883,354.80186657875197,349.1693504344246,33045,102550.7,58.12657484200988,64.81228597013066,NaN,NaN,NaN,NaN,1.0892287880239173,42.22482853073754,95253901
2025-09-10T12:15:00-04:00,354.295,354.85,354.04,354.18,351.64164526933797,NaN,NaN,NaN,NaN,NaN,350.49400000000037,357.608259764722,343.37974023527875,353.1885977758431,352.00630713654374,354.81890749681344,349.19370677627404,32184,99760.46666666666,57.40266964669479,63.731979298493016,NaN,NaN,NaN,NaN,1.0692838745936377,41.626216747714956,95221717
2025-09-10T12:20:00-04:00,354.1,354.2,353.58,353.83,351.64164526933797,NaN,NaN,NaN,NaN,NaN,350.6434000000003,357.7177569149453,343.56904308505534,353.1885977758431,352.0373262318523,354.83659462162916,349.2380578420755,62400,98010.6,54.55710475282458,62.275427414730416,NaN,NaN,NaN,NaN,1.037192169265521,40.33002284786847,95159317
2025-09-10T12:25:00-04:00,353.83,354.39,353.51,354.23,351.64164526933797,NaN,NaN,NaN,NaN,NaN,350.7920000000003,357.84930515140036,343.73469484860027,353.1885977758431,352.07159929505497,354.85900001700224,349.2841985731077,65168,96762.53333333334,57.170221777566134,61.53863615666774,NaN,NaN,NaN,NaN,1.0259641571751263,39.30841862623943,95224485
2025-09-10T12:30:00-04:00,354.26,354.67,354.03,354.4,351.64164526933797,NaN,NaN,NaN,NaN,NaN,350.94260000000037,357.9800484694291,343.90515153057163,353.1885977758431,352.0916559102034,354.87505907337703,349.3082527470297,33627,94161.23333333334,58.26854460665053,60.93904342279895,NaN,NaN,NaN,NaN,0.9983952888054776,38.62500097758259,95258112
2025-09-10T12:35:00-04:00,354.36,354.68,353.9,353.96,351.64164526933797,NaN,NaN,NaN,NaN,NaN,351.0850000000004,358.07259185985157,344.0974081401492,353.1885977758431,352.1079975046416,354.88658869282455,349.3294063164587,30348,88789.83333333333,54.381464234801896,60.09047219829039,NaN,NaN,NaN,NaN,0.9827956253193741,37.76351237767553,95227764
2025-09-10T12:40:00-04:00,353.96,354,352.7,352.76,351.64164526933797,NaN,NaN,NaN,NaN,NaN,351.2032000000004,358.09958942054783,344.30681057945293,353.01587822067444,352.12865117015207,354.8834996271214,349.3738027131827,78171,88902.53333333334,45.47208456497088,58.990798397215926,NaN,NaN,NaN,NaN,1.0054530806537054,35.19400978432897,95149593
2025-09-10T12:45:00-04:00,352.745,353.37,352.72,353.18,351.64164526933797,NaN,NaN,NaN,NaN,NaN,351.34820000000036,358.0983240758924,344.59807592410834,352.7657025765396,352.1405913735459,354.8803480109187,349.40083473617307,49758,88327.4,48.643442092375324,57.89235906652602,NaN,NaN,NaN,NaN,0.9800635748927249,32.808043090507155,95199351
2025-09-10T12:50:00-04:00,353.2,354.12,353.07,353.98,351.64164526933797,NaN,NaN,NaN,NaN,NaN,351.50460000000044,358.12782031641444,344.88137968358643,352.7601597191883,352.1557983793901,354.88672928977604,349.42486746900414,38865,87618.83333333333,54.11738036781287,57.06065385250446,NaN,NaN,NaN,NaN,0.9850590338289597,31.46413494914812,95238216
2025-09-10T12:55:00-04:00,353.97,354.3,353.93,354.23,351.64164526933797,NaN,NaN,NaN,NaN,NaN,351.6592000000004,358.1678085640319,345.1505914359689,352.7601597191883,352.1701798250621,354.89649781437004,349.4438618357542,29334,86326.6,55.70622484824935,56.52840952173369,NaN,NaN,NaN,NaN,0.94112624569832,30.407372685505518,95267550
2025-09-10T13:00:00-04:00,354.24,355.38,354.12,355.01,351.70745011592214,NaN,NaN,NaN,NaN,NaN,351.8270000000004,358.23918402728646,345.41481597271434,353.1969010480266,352.22027054119815,354.9450163058474,349.4955247765489,78004,86953.26666666666,60.32273875663562,56.21830033356101,NaN,NaN,NaN,NaN,0.9639029424341538,30.422474492122625,95345554
2025-09-10T13:05:00-04:00,355.01,355.19,354.55,354.65,351.87847511065297,NaN,NaN,NaN,NaN,NaN,351.99360000000036,358.2559050197157,345.731294980285,353.1969010480266,352.24461411929576,354.967887188028,349.52134105056354,39609,85536.73333333334,57.3516869165117,55.85616002119176,NaN,NaN,NaN,NaN,0.9407670179745704,30.43649759826709,95305945
2025-09-10T13:10:00-04:00,354.68,354.96,354.47,354.75,351.87847511065297,NaN,NaN,NaN,NaN,NaN,352.1588000000003,358.2655135383919,346.0520864616088,353.1969010480266,352.25641496998065,354.97856615644594,349.53426378351537,20026,80340.6,57.97092996756096,55.63803169342919,NaN,NaN,NaN,NaN,0.9085693738335262,30.317249004846953,95325971
2025-09-10T13:15:00-04:00,354.76,354.86,354.33,354.41,351.87847511065297,NaN,NaN,NaN,NaN,NaN,352.31700000000035,358.23608033396397,346.3979196660367,353.1969010480266,352.27057856162213,354.990148596986,349.5510085262583,26365,73135.76666666666,55.044508444671,55.32396970138111,NaN,NaN,NaN,NaN,0.8815287042739907,29.96716898200174,95299606
2025-09-10T13:20:00-04:00,354.46,354.8,354.32,354.65,351.87847511065297,NaN,NaN,NaN,NaN,NaN,352.4790000000004,358.1978551301666,346.76014486983416,353.1969010480266,352.2884042037122,355.0050652126199,349.5717431948045,32826,69887.63333333333,56.70590125330639,55.22249301647372,NaN,NaN,NaN,NaN,0.8528480825401354,29.62419814340322,95332432
2025-09-10T13:25:00-04:00,354.64,354.9,354.11,354.27,351.87847511065297,NaN,NaN,NaN,NaN,NaN,352.62660000000034,358.13802647233257,347.1151735276681,353.1969010480266,352.3051844378646,355.0177346696121,349.59263420611717,33784,63178.36666666667,53.34438419209508,54.93261548400231,NaN,NaN,NaN,NaN,0.848358933787266,28.919257504985012,95298648
2025-09-10T13:30:00-04:00,354.29,354.69,353.85,354.65,351.87847511065297,NaN,NaN,NaN,NaN,NaN,352.7872000000003,358.0515940430034,347.5228059569973,353.1969010480266,352.3229853053443,355.0307921360929,349.61517847459567,36955,55648.166666666664,56.144135294596225,55.04597480841458,NaN,NaN,NaN,NaN,0.8477618670881738,27.79852102449427,95335603
2025-09-10T13:35:00-04:00,354.62,354.89,354.17,354.43,351.87847511065297,NaN,NaN,NaN,NaN,NaN,352.9357000000003,357.9523554635658,347.91904453643474,353.1969010480266,352.34511299438907,355.047923766873,349.64230222190514,44655,53409.433333333334,54.11929220637162,54.82805126761497,NaN,NaN,NaN,NaN,0.8386360194390164,27.025550989244163,95290948
2025-09-10T13:40:00-04:00,354.43,355.08,354.38,354.99,352.0205279324018,NaN,NaN,NaN,NaN,NaN,353.01230000000027,358.0351204069186,347.9894795930819,353.2882234293337,352.36936442383706,355.06989336340666,349.66883548426745,43469,49574.73333333333,58.24713619589247,54.826522095417964,NaN,NaN,NaN,NaN,0.828733446621943,26.558763842043103,95334417
2025-09-10T13:45:00-04:00,354.94,355.66,354.83,355.61,352.54550393547447,NaN,NaN,NaN,NaN,NaN,353.16770000000025,358.01865421955137,348.31674578044914,353.81157874346695,352.4214812043496,355.12694654407505,349.7160158646242,78393,48417.333333333336,62.29209342770829,55.39156703776842,NaN,NaN,NaN,NaN,0.8288239147203785,26.818952261152766,95412810
2025-09-10T13:50:00-04:00,355.65,356.26,355.01,355.03,352.88775375658923,NaN,NaN,NaN,NaN,NaN,353.3303000000003,357.8646940763916,348.79590592360904,354.15626299477356,352.4881107362885,355.1999100152608,349.7763114573162,101995,49101.6,56.753014109148566,56.1973477194954,NaN,NaN,NaN,NaN,0.85890792081178,27.657677208324387,95310815
2025-09-10T13:55:00-04:00,355.01,355.02,354.32,354.68,352.88775375658923,NaN,NaN,NaN,NaN,NaN,353.4673000000003,357.73474945371595,349.19985054628467,354.15626299477356,352.50576495683015,355.2136628336503,349.79786708001,37551,47866.13333333333,53.65259689431536,56.55514449106255,NaN,NaN,NaN,NaN,0.8482716407537944,27.158073667885425,95273264
2025-09-10T14:00:00-04:00,354.65,354.86,354.46,354.71,352.88775375658923,NaN,NaN,NaN,NaN,NaN,353.5989000000003,357.5972062864321,349.6005937135685,354.15626299477356,352.51702495108907,355.22238912074624,349.8116607814319,24234,46356.03333333333,53.885143477920096,56.53855614178449,NaN,NaN,NaN,NaN,0.8162522378428115,26.694156094620674,95297498
2025-09-10T14:05:00-04:00,354.68,354.68,353.9,354.22,352.88775375658923,NaN,NaN,NaN,NaN,NaN,353.7285000000003,357.3622299019339,350.09477009806665,354.15626299477356,352.53032992867776,355.2296707065665,349.83098915078904,35802,45673.9,49.51513726508745,56.09633560013007,NaN,NaN,NaN,NaN,0.8158056494254681,25.32907971663051,95261696
2025-09-10T14:10:00-04:00,354.2,354.45,353.77,354.19,352.88775375658923,NaN,NaN,NaN,NaN,NaN,353.81630000000024,357.27397945886736,350.3586205411331,354.15626299477356,352.5411358789585,355.2345844894348,349.8476872684823,31886,44881.73333333333,49.25178030383224,55.305552853501254,NaN,NaN,NaN,NaN,0.806105245895078,23.858749621518307,95229810
2025-09-10T14:15:00-04:00,354.15,354.25,353.45,353.57,352.88775375658923,NaN,NaN,NaN,NaN,NaN,353.88030000000026,357.19599866547776,350.56460133452276,354.15626299477356,352.5515475590371,355.2357741869785,349.86732093109566,40951,44960.5,44.038678441273944,54.354623676698566,NaN,NaN,NaN,NaN,0.8056691569025733,22.304763123106177,95188859
2025-09-10T14:20:00-04:00,353.56,354.2,353.46,354.12,352.88775375658923,NaN,NaN,NaN,NaN,NaN,353.9807000000003,357.0022942878094,350.9591057121912,354.15626299477356,352.5629835122488,355.23894087342427,349.88702615107337,40093,43660.8,49.17774123064224,53.72653876691866,NaN,NaN,NaN,NaN,0.8009785028381045,20.86177566029492,95228952
2025-09-10T14:25:00-04:00,354.16,354.26,353.22,353.65,352.88775375658923,NaN,NaN,NaN,NaN,NaN,354.0558000000003,356.84520592960575,351.2663940703949,354.15626299477356,352.5735883859963,355.23940791807547,349.9077688539171,44989,43855.9,45.34552302923919,53.03375409438781,NaN,NaN,NaN,NaN,0.8180514669210944,19.89808426058448,95183963
2025-09-10T14:30:00-04:00,353.65,354.35,353.42,354.22,352.88775375658923,NaN,NaN,NaN,NaN,NaN,354.1440000000003,356.655907641662,351.6320923583386,354.15626299477356,352.58211381651296,355.24220385300003,349.9220237800259,29327,43365.03333333333,50.394181079512826,52.58291693911684,NaN,NaN,NaN,NaN,0.8260477907124454,18.840132248336076,95213290
2025-09-10T14:35:00-04:00,354.15,354.43,353.79,353.83,352.88775375658923,NaN,NaN,NaN,NaN,NaN,354.23740000000026,356.30994745670694,352.1648525432936,354.15626299477356,352.59042309112147,355.2450311041613,349.93581507808165,28520,43411.13333333333,47.18268566489521,52.14279561574542,NaN,NaN,NaN,NaN,0.8127586628044127,17.707991251516926,95184770
2025-09-10T14:40:00-04:00,353.88,353.9,352.58,352.7,NaN,NaN,NaN,355.88891736689106,355.88891736689106,355.88891736689106,354.29020000000025,356.04443369035687,352.53596630964364,353.02960831665507,352.59644127893534,355.2345122603451,349.95837029752556,63924,44440.433333333334,39.35662390919924,50.94368765964564,NaN,NaN,NaN,NaN,0.8489901868898112,18.35624402695494,95120846
2025-09-10T14:45:00-04:00,352.75,352.95,351.49,351.77,NaN,NaN,NaN,354.9476029411233,NaN,NaN,354.3072000000003,355.9429361156795,352.6714638843211,353.02960831665507,352.58716696263053,355.2028142617244,349.97151966353664,89445,46349.13333333333,34.31233376183998,49.52890491360767,NaN,NaN,NaN,NaN,0.8926337449691089,19.96338136586764,95031401
2025-09-10T14:50:00-04:00,351.75,351.77,351,351.63,NaN,NaN,NaN,354.093620989254,NaN,NaN,354.3012000000002,355.97356187482364,352.6288381251768,352.81068665332407,352.56703663411344,355.1633510917353,349.97072217649156,92883,47365.23333333333,33.613891063851256,47.76938740417615,NaN,NaN,NaN,NaN,0.8838741917570284,21.815358195747944,94938518
2025-09-10T14:55:00-04:00,351.6,351.63,351.14,351.26,NaN,NaN,NaN,354.037320035197,NaN,NaN,354.26080000000024,356.11734233464716,352.4042576653533,352.61454932265923,352.55769395493974,355.1462706666054,349.96911724327407,39776,46518.833333333336,31.773124088347103,45.58946102279321,NaN,NaN,NaN,NaN,0.8557403209172413,23.535050966351086,94898742
2025-09-10T15:00:00-04:00,351.32,351.55,350.31,350.57,NaN,NaN,NaN,353.6308509426881,NaN,NaN,354.1956000000002,356.3180180927664,352.07318190723396,352.450479522049,352.52621164234296,355.1018776226794,349.9505456620065,95570,48583.6,28.62496258664538,43.58031448547155,NaN,NaN,NaN,NaN,0.8831874408517246,25.685658807006035,94803172
2025-09-10T15:05:00-04:00,350.59,350.76,349.44,349.6,NaN,NaN,NaN,352.8580849907477,NaN,NaN,354.0800000000002,356.53530934922856,351.62469065077187,352.450479522049,352.4799820480586,355.0555410597265,349.9044230363907,96310,50782.333333333336,24.89117348694397,41.525927099230735,NaN,NaN,NaN,NaN,0.9143883379337439,28.143623717598924,94706862
2025-09-10T15:10:00-04:00,349.57,349.58,347.98,348.07,NaN,NaN,NaN,351.63362658207734,NaN,NaN,353.9410000000002,356.90244896975435,350.97955103024606,352.450479522049,352.3689777177414,354.99025945334756,349.74769598213527,156736,53401.166666666664,20.37639381138341,39.13244498019241,NaN,NaN,NaN,NaN,0.9647891709384767,30.998975133264032,94550126
2025-09-10T15:15:00-04:00,348.1,348.53,347.65,348.43,NaN,NaN,NaN,350.93391628289197,NaN,NaN,353.80920000000015,357.13143500683606,350.48696499316424,352.450479522049,352.28691845306236,354.94602721130394,349.62780969482077,111697,55465.8,23.875147789977603,37.3010171605417,NaN,NaN,NaN,NaN,0.958732801585728,33.7566044940384,94661823
2025-09-10T15:20:00-04:00,348.42,348.43,347.2,347.69,NaN,NaN,NaN,350.69737463366965,NaN,NaN,353.64320000000015,357.3231618259812,349.9632381740191,352.450479522049,352.2071589029777,354.90892687675637,349.50539092919905,102000,57570.3,21.75865181375093,35.337222268393035,NaN,NaN,NaN,NaN,0.9781090300438916,36.456451906029365,94559823
2025-09-10T15:25:00-04:00,347.69,348.19,347.16,347.44,NaN,NaN,NaN,350.566812150321,NaN,NaN,353.49480000000017,357.54621405445465,349.4433859455457,351.65638361763916,352.1284956717311,354.8728526337615,349.3841387097007,100193,59932.26666666667,21.078806106130685,33.69723138731137,NaN,NaN,NaN,NaN,0.9818155278978974,38.97584705967031,94459630
2025-09-10T15:30:00-04:00,347.47,348.63,347.39,348.37,NaN,NaN,NaN,350.566812150321,NaN,NaN,353.36760000000015,357.6487522935688,349.0864477064315,350.42510689411137,352.08029921523246,354.84274443160405,349.31785399886087,71647,59720.36666666667,29.85853010092454,32.317287735188685,NaN,NaN,NaN,NaN,1.000257275905191,40.48864818303695,94531277
2025-09-10T15:35:00-04:00,348.4,349,348.24,348.31,NaN,NaN,NaN,350.566812150321,NaN,NaN,353.24040000000014,357.7319689197396,348.7488310802607,349.46106841223127,352.03458587329646,354.80839726299246,349.26077448360047,77239,60974.7,29.629514673116745,31.194715709751367,NaN,NaN,NaN,NaN,0.9830960419119625,41.235399384912036,94454038
2025-09-10T15:40:00-04:00,348.33,349.5,348.13,349.47,NaN,NaN,NaN,350.566812150321,NaN,NaN,353.1528000000001,357.7626851006022,348.54291489939806,349.46106841223127,351.9856730067466,354.76290970785647,349.2084363056367,99757,63632.4,39.319764918825996,30.403685983988023,NaN,NaN,NaN,NaN,1.0107320389182513,41.09602223747179,94553795
2025-09-10T15:45:00-04:00,349.45,349.72,349.09,349.44,NaN,NaN,NaN,350.566812150321,NaN,NaN,353.0482000000001,357.75201919728926,348.344380802711,349.19485472978505,351.9586193641788,354.733612769843,349.1836259585146,65145,64925.066666666666,39.16954038299615,29.831318463852373,NaN,NaN,NaN,NaN,0.9835368932812371,40.615324123546074,94488650
2025-09-10T15:50:00-04:00,349.5,350.26,348.76,349.34,NaN,NaN,NaN,350.566812150321,NaN,NaN,352.9320000000002,357.7088776413707,348.1551223586297,348.215883783828,351.91723902637693,354.68768184450187,349.146796208252,103894,67294,38.63960121163231,29.78010255688331,NaN,NaN,NaN,NaN,1.0204271151897202,39.34966470679092,94384756
2025-09-10T15:55:00-04:00,349.37,349.39,347.74,347.86,NaN,NaN,NaN,350.566812150321,NaN,NaN,352.79380000000015,357.7465687449278,347.8410312550725,347.4714786040974,351.8182645264643,354.6126936515548,349.0238354013738,178471,72116.9,31.7854678053521,29.59961213141989,NaN,NaN,NaN,NaN,1.0653966069618814,38.98926515188817,94206285
2025-09-11T09:30:00-04:00,350.17,350.45,348.28,350.26,NaN,NaN,NaN,350.566812150321,NaN,NaN,352.69600000000014,357.6519192891665,347.74008071083375,347.4714786040974,349.66333333333336,349.66333333333336,349.66333333333336,184734,77042.86666666667,47.919112931610066,30.621413693402662,NaN,NaN,NaN,NaN,1.1742968493217454,37.29178484612666,94391019
2025-09-11T09:35:00-04:00,350.26,351.43,348.8,349.38,346.6232994041423,346.6232994041423,346.6232994041423,NaN,NaN,NaN,352.58680000000015,357.58933606091074,347.58426393908957,347.4714786040974,349.7562432437265,349.8590495179139,349.6534369695391,150880,80583.7,43.8260877839243,31.482339671658174,NaN,NaN,NaN,NaN,1.2782756457987632,34.695680654238615,94240139
2025-09-11T09:40:00-04:00,349.34,349.83,347.6,348.99,346.6232994041423,NaN,NaN,NaN,NaN,NaN,352.47360000000015,357.5400113690807,347.4071886309196,347.4714786040974,349.4556463197337,349.9054292287053,349.0058634107621,155451,84316.43333333333,42.109437986952294,32.44551648596582,NaN,NaN,NaN,NaN,1.3462559568131345,33.27876883289472,94084688
2025-09-11T09:45:00-04:00,349.03,350.29,348.32,349.22,346.6232994041423,NaN,NaN,NaN,NaN,NaN,352.36920000000015,357.48412536022965,347.25427463977064,347.4714786040974,349.41588856204964,349.81949820223264,349.01227892186665,140234,86377.8,43.51462122283694,33.77576275281532,NaN,NaN,NaN,NaN,1.3908091027550553,31.513433494161262,94224922
2025-09-11T09:50:00-04:00,349.27,351.47,349.27,350.91,346.6232994041423,NaN,NaN,NaN,NaN,NaN,352.30200000000013,357.4035385915216,347.20046140847865,347.4714786040974,349.63574815842054,350.21222689750323,349.05926941933785,151815,88038.46666666666,52.61588180523481,36.0785833238047,NaN,NaN,NaN,NaN,1.4521798811296942,29.670426137357726,94376737
2025-09-11T09:55:00-04:00,350.91,352.2,350.23,351.49,347.2454068472825,NaN,NaN,NaN,NaN,NaN,352.24820000000017,357.32606520504896,347.1703347949514,347.4714786040974,349.96680768850075,350.80945627308876,349.12415910391275,193496,93236.63333333333,55.279072577447366,38.32172080862397,NaN,NaN,NaN,NaN,1.489167032477571,28.501547734106207,94570233
2025-09-11T10:00:00-04:00,351.49,351.71,350.66,351.42,347.2526610814969,NaN,NaN,NaN,NaN,NaN,352.2000000000002,357.26262066526806,347.1373793347324,347.4714786040974,350.0885318072603,350.9753208210826,349.20174279343803,101189,95801.8,54.87818376752266,40.687401662464815,NaN,NaN,NaN,NaN,1.4577979587291698,27.416160645372656,94469044
2025-09-11T10:05:00-04:00,351.37,353.68,351.34,353.57,348.43731285051973,NaN,NaN,NaN,NaN,NaN,352.18680000000023,357.2315904852801,347.14200951472037,348.9857992177626,350.52621589285775,351.82439603091746,349.22803575479804,201845,101336.56666666667,63.60782346900893,43.72518861695612,NaN,NaN,NaN,NaN,1.520812390248517,27.655085957124527,94670889
2025-09-11T10:10:00-04:00,353.61,355.65,353.53,354.59,350.41334408458704,NaN,NaN,NaN,NaN,NaN,352.1906000000002,357.2423346090662,347.1388653909342,350.83463937421004,351.2312442491561,353.17055106298915,349.291937435323,268607,109227.26666666666,66.8814385074582,46.36968207456567,NaN,NaN,NaN,NaN,1.5636115052307662,28.75821431079637,94939496
2025-09-11T10:15:00-04:00,354.66,355.36,353.67,354.13,350.41334408458704,NaN,NaN,NaN,NaN,NaN,352.1940000000002,357.25071988551446,347.1372801144859,350.83463937421004,351.6127248328906,353.7018475293917,349.52360213638946,212920,114959.56666666667,64.08183295959348,48.83056195217114,NaN,NaN,NaN,NaN,1.57263925485714,29.78254778206309,94726576
2025-09-11T10:20:00-04:00,354.21,357.34,353.84,357.1,351.0871585564109,NaN,NaN,NaN,NaN,NaN,352.28080000000017,357.5191353692379,347.0424646307624,351.83216919949444,352.24969243863063,354.7381169005872,349.76126797667405,291861,123351.83333333333,72.17920475980608,51.17766479795544,NaN,NaN,NaN,NaN,1.7103078795102014,31.43272780348953,95018437
2025-09-11T10:25:00-04:00,357.12,359.25,356.76,358.9,353.3672877129377,NaN,NaN,NaN,NaN,NaN,352.3952000000001,357.9475173397088,346.8428826602914,353.59873535959554,353.15566323911645,356.3067233000712,350.0046031781617,361326,133896.4,75.74768899915473,53.79038969910962,NaN,NaN,NaN,NaN,1.766000173830902,33.475172364027536,95379763
2025-09-11T10:30:00-04:00,358.86,358.94,357.88,358.45,353.8385473623496,NaN,NaN,NaN,NaN,NaN,352.4846000000001,358.27495226569056,346.69424773430967,353.88898828767645,353.495561709761,356.80666988674756,350.1844535327744,166533,138469.93333333332,73.21918398279315,56.260359897049675,NaN,NaN,NaN,NaN,1.7155715899858375,35.37172802738425,95213230
2025-09-11T10:35:00-04:00,358.44,358.92,357.05,357.48,353.8385473623496,NaN,NaN,NaN,NaN,NaN,352.5496000000001,358.48794045511113,346.6112595448891,353.9441906301412,353.72455672084266,357.0890043273384,350.3601091143469,144427,142333.5,67.9535520461857,58.84379448568065,NaN,NaN,NaN,NaN,1.726602190701135,36.32155278854622,95068803
2025-09-11T10:40:00-04:00,357.51,358.87,357.37,357.91,353.8385473623496,NaN,NaN,NaN,NaN,NaN,352.6076000000001,358.6956914054281,346.51950859457213,354.13935250411294,353.8789944768532,357.2789225871792,350.47906636652726,100909,143566.33333333334,69.01727050234953,60.35080574073346,NaN,NaN,NaN,NaN,1.7104163199367683,37.203532923910906,95169712
2025-09-11T10:45:00-04:00,357.95,358.59,357.42,358.36,353.8385473623496,NaN,NaN,NaN,NaN,NaN,352.68180000000007,358.95526244436905,346.4083375556311,354.22048200329033,354.05063359855507,357.484448447638,350.61681874947215,119108,144555.1,70.13450727415447,62.22997856146419,NaN,NaN,NaN,NaN,1.6718151542269963,38.02251447817811,95288820
2025-09-11T10:50:00-04:00,358.42,359.95,358.38,359.73,354.59247895284267,NaN,NaN,NaN,NaN,NaN,352.78140000000013,359.3349199824814,346.2278800175189,355.6593856026323,354.44161988687733,358.02520744990596,350.8580323238487,234457,149274.23333333334,73.2921124269976,64.45731245003886,NaN,NaN,NaN,NaN,1.665971214639352,39.24800589306643,95523277
2025-09-11T10:55:00-04:00,359.67,360.55,358.01,358.83,354.59247895284267,NaN,NaN,NaN,NaN,NaN,352.8698000000001,359.62494795107057,346.11465204892966,355.84750848210587,354.8303288255459,358.49757502662084,351.163082624471,287467,157530.6,68.1914706868924,66.21994455461426,NaN,NaN,NaN,NaN,1.728401842165114,40.567910115243905,95235810
2025-09-11T11:00:00-04:00,358.83,359.75,358.38,359.04,354.59247895284267,NaN,NaN,NaN,NaN,NaN,352.95760000000007,359.9141342636258,346.00106573637436,355.84750848210587,354.93112980586966,358.6113190004732,351.2509406112661,84717,157168.83333333334,68.73816371382586,67.3715361195136,NaN,NaN,NaN,NaN,1.7028017105818918,41.7935354644087,95320527
2025-09-11T11:05:00-04:00,359.03,360.38,358.81,359.935,354.9100828871409,NaN,NaN,NaN,NaN,NaN,353.0709000000001,360.2888608450662,345.852939154934,356.03740542854774,355.126028716313,358.85219606607455,351.3998613665514,151076,158994.36666666667,71.02391062365513,68.49616740852845,NaN,NaN,NaN,NaN,1.693315874111756,43.127064644885365,95471603
2025-09-11T11:10:00-04:00,359.92,362.69,359.56,362.08,356.22621548317994,NaN,NaN,NaN,NaN,NaN,353.2195000000001,360.85522242822987,345.5837775717703,357.6509243428382,355.65706276445036,359.63071479696833,351.6834107319324,339847,165098.06666666668,75.62398906581333,69.97801064412064,NaN,NaN,NaN,NaN,1.7959361688180588,44.94022170985876,95811450
2025-09-11T11:15:00-04:00,362.01,363.3,361.83,363.15,357.6884329612172,NaN,NaN,NaN,NaN,NaN,353.39390000000014,361.51514110963285,345.27265889036744,358.53373947427053,356.0148562811995,360.1871338486321,351.84257871376695,214454,168523.3,77.53950574690978,70.97313080682785,NaN,NaN,NaN,NaN,1.772655013902485,46.746948300785604,96025904
2025-09-11T11:20:00-04:00,363.15,363.23,361.88,362.46,357.7160041902528,NaN,NaN,NaN,NaN,NaN,353.54330000000016,362.0425356386184,345.0440643613819,358.74199157941644,356.26577997411977,360.5444404381745,351.98711951006504,170717,170813.86666666667,73.52696076920509,71.44781096838119,NaN,NaN,NaN,NaN,1.7424653700523092,48.42462299236053,95855187
2025-09-11T11:25:00-04:00,362.5,363,361.47,361.63,357.7160041902528,NaN,NaN,NaN,NaN,NaN,353.6637000000002,362.4425894081629,344.88481059183744,358.74199157941644,356.48870241809004,360.8286764199081,352.148728416272,178031,173408.46666666667,68.90764174172824,71.79251159567653,NaN,NaN,NaN,NaN,1.727289272191428,49.484996773642756,95677156
2025-09-11T11:30:00-04:00,361.61,361.78,360.86,361.12,357.7160041902528,NaN,NaN,NaN,NaN,NaN,353.7855000000002,362.8025909389141,344.7684090610863,358.74199157941644,356.5945553018337,360.94312580977993,352.24598479388743,104656,174508.76666666666,66.15730473040168,71.36237587929051,NaN,NaN,NaN,NaN,1.6696257527491802,49.7521994174352,95572500
2025-09-11T11:35:00-04:00,361.19,362.04,360.94,361.69,357.7160041902528,NaN,NaN,NaN,NaN,NaN,353.9257000000001,363.2081449387422,344.64325506125806,358.74199157941644,356.69013981134844,361.0502966777427,352.32998294495417,92525,175018.3,67.7086010060169,70.78815530835209,NaN,NaN,NaN,NaN,1.6289381989813834,50.09206790244644,95665025
2025-09-11T11:40:00-04:00,361.66,362.66,361.52,362.4,357.7160041902528,NaN,NaN,NaN,NaN,NaN,354.0795000000001,363.6589079671375,344.5000920328627,359.12563175092896,356.78450774780197,361.16576217830686,352.4032533172971,83803,174486.5,69.57915097229207,70.52815295045916,NaN,NaN,NaN,NaN,1.5940140419112878,50.62171599075621,95748828
2025-09-11T11:45:00-04:00,362.42,362.78,362.1,362.5,357.9451252911375,NaN,NaN,NaN,NaN,NaN,354.2451000000001,364.11050267606157,344.3796973239386,359.61250540074315,356.87359602440085,361.277203998759,352.46998805004273,77936,174912.86666666667,69.8441113404734,70.66319290005113,NaN,NaN,NaN,NaN,1.5287273246319066,51.15464534044914,95826764
2025-09-11T11:50:00-04:00,362.56,363.56,362.2,362.23,358.40398323244943,NaN,NaN,NaN,NaN,NaN,354.4059000000001,364.52139261088735,344.29040738911283,360.34600432059455,357.03111263304754,361.47536237685233,352.58686288924275,138857,176078.3,68.11896447792722,70.59902818402097,NaN,NaN,NaN,NaN,1.5166753728724858,51.90881579909528,95687907
2025-09-11T11:55:00-04:00,362.25,362.74,361.89,362.44,358.40398323244943,NaN,NaN,NaN,NaN,NaN,354.58330000000007,364.94211993477114,344.224480065229,360.34600432059455,357.1241176734437,361.58428282202345,352.663952524864,90718,173153.2,68.76517724857668,70.5012188964797,NaN,NaN,NaN,NaN,1.4690557033815956,52.19624867213633,95778625
2025-09-11T12:00:00-04:00,362.42,362.53,361.59,361.7,358.40398323244943,NaN,NaN,NaN,NaN,NaN,354.73490000000015,365.282309253497,344.18749074650333,360.34600432059455,357.21509307664485,361.68131399889705,352.74887215439264,100019,170329.36666666667,63.853551335523186,69.82703596137439,NaN,NaN,NaN,NaN,1.43126601028291,52.06314644853003,95678606
2025-09-11T12:05:00-04:00,361.66,362.53,361.53,362.27,358.40398323244943,NaN,NaN,NaN,NaN,NaN,354.9073000000001,365.6579749946125,344.15662500538764,360.34600432059455,357.28240081185686,361.7542885338727,352.81051308984104,73819,167760.66666666666,65.87541520005715,69.6616034266004,NaN,NaN,NaN,NaN,1.400461295262702,51.85712843503039,95752425
2025-09-11T12:10:00-04:00,362.26,362.73,362.02,362.58,358.40398323244943,NaN,NaN,NaN,NaN,NaN,355.0745000000001,366.03520367265327,344.11379632734696,360.34600432059455,357.34805417468874,361.8288918011418,352.86721654823566,69173,164884.73333333334,66.95790876451662,69.53444235879259,NaN,NaN,NaN,NaN,1.3511426313153687,51.76316747196883,95821598
2025-09-11T12:15:00-04:00,362.52,362.8,362.2,362.75,358.44669130695206,NaN,NaN,NaN,NaN,NaN,355.25290000000007,366.4152868576452,344.09051314235495,360.4281178957724,357.39904181067277,361.88754903202914,352.9105345893164,53479,161992.9,67.56553510942163,69.28741553634734,NaN,NaN,NaN,NaN,1.2974895862214153,51.71126711387933,95875077
2025-09-11T12:20:00-04:00,362.73,362.88,361.66,361.81,358.44669130695206,NaN,NaN,NaN,NaN,NaN,355.43510000000003,366.7215677361819,344.1486322638182,360.4281178957724,357.4500550400232,361.94081256442564,352.95929751562073,60026,158933.26666666666,60.897025725455826,68.23548958346467,NaN,NaN,NaN,NaN,1.2919546157770263,50.83509029349155,95815051
2025-09-11T12:25:00-04:00,361.79,361.87,360.32,360.38,358.44669130695206,NaN,NaN,NaN,NaN,NaN,355.6073,366.9275150527248,344.2870849472752,360.4281178957724,357.509825487306,361.9834267725867,353.03622420202527,99136,155787.93333333332,52.42084126119487,66.44129926305645,NaN,NaN,NaN,NaN,1.310386428935811,48.32632083596729,95715915
2025-09-11T12:30:00-04:00,360.43,361.05,360.31,360.96,358.44669130695206,NaN,NaN,NaN,NaN,NaN,355.7939,367.153239292401,344.434560707599,360.4281178957724,357.5640525678244,362.01990228332386,353.1082028523249,95472,155597.36666666667,55.14771796465126,65.12849620558832,NaN,NaN,NaN,NaN,1.2696445411546822,45.98545959736416,95811387
2025-09-11T12:35:00-04:00,360.94,360.94,360.25,360.55,358.44669130695206,NaN,NaN,NaN,NaN,NaN,355.97970000000004,367.34022998939116,344.6191700106089,360.4281178957724,357.61323531083525,362.04908137333734,353.17738924833316,95252,152044.26666666666,52.84219150949791,63.9809640461433,NaN,NaN,NaN,NaN,1.2296699310722035,43.73959152811462,95716135
2025-09-11T12:40:00-04:00,360.51,360.92,360.26,360.58,358.44669130695206,NaN,NaN,NaN,NaN,NaN,356.1799,367.50479090278776,344.8550090972122,360.4281178957724,357.64286099386516,362.0664222407993,353.21929974693103,58782,145050.1,52.997033915196404,63.04094470220007,NaN,NaN,NaN,NaN,1.188979221709905,41.65414260666863,95774917
2025-09-11T12:45:00-04:00,360.54,361.33,360.2,361.22,358.44669130695206,NaN,NaN,NaN,NaN,NaN,356.41229999999996,367.66422058450786,345.16037941549206,360.4281178957724,357.67298015384125,362.087225922855,353.2587343848275,54782,139778.83333333334,56.29404433127713,62.225619225432936,NaN,NaN,NaN,NaN,1.1847664201591972,40.113433685741875,95829699
2025-09-11T12:50:00-04:00,361.17,361.73,360.96,361.36,358.44669130695206,NaN,NaN,NaN,NaN,NaN,356.6781,367.75573420410996,345.60046579589,360.4281178957724,357.7091747941766,362.11661605367584,353.30173353467734,59196,132023.33333333334,57.004522240101814,61.327431458847926,NaN,NaN,NaN,NaN,1.1551402472906858,39.04684048657576,95888895
2025-09-11T12:55:00-04:00,361.32,361.83,361.11,361.82,358.44669130695206,NaN,NaN,NaN,NaN,NaN,356.94589999999994,367.8591832255121,346.0326167744878,360.4281178957724,357.75722641361943,362.15822848941656,353.3562243378223,75460,122494.46666666666,59.34313505091826,60.5773617238797,NaN,NaN,NaN,NaN,1.1240588010556347,38.14664949642322,95964355
2025-09-11T13:00:00-04:00,361.8,362.32,361.68,362.07,358.44669130695206,NaN,NaN,NaN,NaN,NaN,357.2335,367.91131218227855,346.55568781772143,360.4281178957724,357.80639112678165,362.20558744328156,353.40719481028174,70993,119309.8,60.597506363607074,60.040114715713976,NaN,NaN,NaN,NaN,1.0894831724088028,37.740506758020445,96035348
2025-09-11T13:05:00-04:00,362.1,362.58,361.93,362.44,358.7562752733359,NaN,NaN,NaN,NaN,NaN,357.5334999999999,367.93308042424513,347.13391957575465,360.59469071622937,357.8458801945185,362.2458840179003,353.44587637113665,54411,116309.26666666666,62.4442842603256,59.58862235941033,NaN,NaN,NaN,NaN,1.0580915172367438,37.57879008584041,96089759
2025-09-11T13:10:00-04:00,362.47,363.25,362.14,363.08,359.2039445790934,NaN,NaN,NaN,NaN,NaN,357.8276999999999,368.0035819195332,347.65181808046657,361.1067525729835,357.9330207638048,362.34292337067853,353.52311815693105,110738,116636.9,65.45990947033587,59.70336222618266,NaN,NaN,NaN,NaN,1.0617992660055486,37.93677277756009,96200497
2025-09-11T13:15:00-04:00,363.12,363.9,362.69,363.65,359.7976289164073,NaN,NaN,NaN,NaN,NaN,358.13449999999995,368.0661198578145,348.2028801421854,361.58040205838677,358.0117760078419,362.43819373866154,353.58535827702224,92224,115740.76666666666,67.92982561319066,59.85010582712077,NaN,NaN,NaN,NaN,1.0723850327194364,38.69275912699941,96292721
2025-09-11T13:20:00-04:00,363.67,364.27,363.28,364.09,360.30160032929786,NaN,NaN,NaN,NaN,NaN,358.42689999999993,368.18018844852764,348.6736115514722,361.9193216467094,358.1282265218865,362.58627082746654,353.6701822163065,129930,112256.53333333334,69.72929231828311,60.048061795246944,NaN,NaN,NaN,NaN,1.0665003875251915,39.613718198968876,96422651
2025-09-11T13:25:00-04:00,364.08,364.33,363.63,364.1,360.5690275870571,NaN,NaN,NaN,NaN,NaN,358.7201,368.25405751825946,349.18614248174055,362.0994573173675,358.2372801192352,362.7246986766646,353.7498615618058,123476,106790.16666666667,69.77080693715055,60.2055812115133,NaN,NaN,NaN,NaN,1.0403217884162486,40.504487496316784,96546127
2025-09-11T13:30:00-04:00,364.07,364.18,363.66,363.98,360.59316269673633,NaN,NaN,NaN,NaN,NaN,359.0129,368.27183300332285,349.75396699667715,362.1355658538941,358.2987523762454,362.8006009182752,353.7969038342155,72693,106389.36666666667,68.55577290635561,60.75263458157757,NaN,NaN,NaN,NaN,1.0031559463865152,41.33163041528271,96473434
2025-09-11T13:35:00-04:00,363.97,365.81,363.96,365.12,361.45710984688463,NaN,NaN,NaN,NaN,NaN,359.35810000000004,368.20592162793935,350.5102783720607,363.24945268311524,358.53972885699426,363.1312189296581,353.94823878433044,252983,109786.26666666666,73.31085153053701,62.244778172244864,NaN,NaN,NaN,NaN,1.0636448073589084,42.937790656609856,96726417
2025-09-11T13:40:00-04:00,365.15,366.66,365.02,366.19,362.34428667202627,NaN,NaN,NaN,NaN,NaN,359.67670000000004,368.3363696495807,351.01703035041936,363.7915621464922,358.75051325252196,363.4410991121971,354.0599273928468,204656,105279.9,76.8495236155736,63.794907147310745,NaN,NaN,NaN,NaN,1.1048130354047037,44.74166797981897,96931073
2025-09-11T13:45:00-04:00,366.18,366.26,365.46,365.84,362.4140918232978,NaN,NaN,NaN,NaN,NaN,360.00590000000005,368.3193545623286,351.6924454376715,363.7915621464922,358.8660056072192,363.6042364103271,354.12777480411137,119029,102099.06666666667,73.42033846231254,65.2647747867975,NaN,NaN,NaN,NaN,1.0830406757329398,46.41669692279886,96812044
2025-09-11T13:50:00-04:00,365.86,366.56,365.55,366.47,362.6279967404206,NaN,NaN,NaN,NaN,NaN,360.3555,368.24596316764683,352.4650368323532,363.899199773755,358.9612807065113,363.7412330164022,354.18132839662036,96438,99623.1,75.5363955928363,66.87472919234321,NaN,NaN,NaN,NaN,1.077823484609158,48.07920996718355,96908482
2025-09-11T13:55:00-04:00,366.4,366.46,365.9,366.09,362.83104234312873,NaN,NaN,NaN,NaN,NaN,360.6929,368.07631820296837,353.30948179703165,364.04635981900395,359.02837704586665,363.83592592959076,354.22082816214254,69877,96017.96666666666,71.82220319889086,67.98388339717278,NaN,NaN,NaN,NaN,1.0415503785656501,49.622972079826475,96838605
2025-09-11T14:00:00-04:00,366.05,366.36,365.47,366.35,362.83104234312873,NaN,NaN,NaN,NaN,NaN,361.00169999999997,368.0043599546223,353.9990400453776,364.04635981900395,359.13066257548445,363.9768044190448,354.2845207319241,110512,96213.16666666667,72.80742258116015,69.11266199296264,NaN,NaN,NaN,NaN,1.0307253515252455,50.17546368994339,96949117
2025-09-11T14:05:00-04:00,366.34,366.5,365.88,366.35,362.9381811432227,NaN,NaN,NaN,NaN,NaN,361.2989,367.9121053620038,354.6856946379962,364.2892702841625,359.21053695508107,364.087328570555,354.33374533960716,86284,96005.13333333333,72.80742258116015,70.07439681655136,NaN,NaN,NaN,NaN,1.0013878264162996,50.76418703997252,96949117
2025-09-11T14:10:00-04:00,366.38,367.44,366.24,367.44,363.5723547276217,NaN,NaN,NaN,NaN,NaN,361.6193,367.8268354239903,355.4117645760097,365.07141622733,359.37115730508106,364.3236275703666,354.4186870397955,160926,98575.9,76.75847702467652,71.2287518637706,NaN,NaN,NaN,NaN,1.015574410243706,51.76329135138037,97110043
2025-09-11T14:15:00-04:00,367.43,367.64,366.76,366.81,363.9608840581843,NaN,NaN,NaN,NaN,NaN,361.88410000000005,367.8191813608516,355.9490186391485,365.305132981864,359.49276420230416,364.4988595658806,354.4866688387277,125894,100174.5,70.39219487601663,71.7964597648914,NaN,NaN,NaN,NaN,1.0058905237977267,52.77594332803475,96984149
2025-09-11T14:20:00-04:00,366.84,366.85,365.22,365.29,363.9608840581843,NaN,NaN,NaN,NaN,NaN,362.09810000000004,367.7295924806818,356.4666075193183,365.305132981864,359.5932321597739,364.6214714449393,354.5649928746085,129291,99855.63333333333,57.91213117134476,71.25733274353487,NaN,NaN,NaN,NaN,1.0504697720978888,51.12588260622773,96854858
2025-09-11T14:25:00-04:00,365.275,365.69,364.78,365.23,363.9608840581843,NaN,NaN,NaN,NaN,NaN,362.3201000000001,367.5375731393418,357.10262686065835,365.305132981864,359.6664517438578,364.70257819435545,354.63032529336016,106531,100382.73333333334,57.47892634316201,70.51083993853283,NaN,NaN,NaN,NaN,1.0404362169480414,49.01007609383107,96748327
2025-09-11T14:30:00-04:00,365.225,365.59,364.95,365.25,363.9608840581843,NaN,NaN,NaN,NaN,NaN,362.48310000000004,367.54497115205055,357.4212288479495,365.305132981864,359.7238422431939,364.7657085299932,354.6819759563945,85017,99882.66666666667,57.59280091543858,69.6439476954725,NaN,NaN,NaN,NaN,1.0118336300231803,47.04539861803418,96833344
2025-09-11T14:35:00-04:00,365.26,366.36,364.98,366.36,363.9608840581843,NaN,NaN,NaN,NaN,NaN,362.63230000000004,367.70268823363335,357.56191176636673,365.305132981864,359.79913856400816,364.85580508830105,354.74247203971527,102328,100832.96666666666,63.44416256123053,69.19204452576393,NaN,NaN,NaN,NaN,1.0381312278786672,45.85675676052551,96935672
2025-09-11T14:40:00-04:00,366.37,366.55,366.02,366.34,363.9608840581843,NaN,NaN,NaN,NaN,NaN,362.7901,367.82097129233364,357.75922870766635,365.305132981864,359.8762406461698,364.9518990188369,354.80058227350264,100691,101883.56666666667,63.27475238036219,68.81482877390725,NaN,NaN,NaN,NaN,1.0018361401730502,44.89841194641409,96834981
2025-09-11T14:45:00-04:00,366.32,366.51,366.02,366.13,363.9608840581843,NaN,NaN,NaN,NaN,NaN,362.9631,367.8443469267595,358.0818530732405,365.305132981864,359.9271201270707,365.01395238200274,354.8402878721386,68677,102390.16666666667,61.420225113065854,67.96549831551646,NaN,NaN,NaN,NaN,0.9652764158749758,44.00852033331063,96766304
2025-09-11T14:50:00-04:00,366.17,366.82,366.17,366.65,363.9608840581843,NaN,NaN,NaN,NaN,NaN,363.1379,367.9075021175655,358.3682978824345,365.305132981864,359.98494332492726,365.0868303146904,354.8830563351641,75457,102904.53333333334,64.21694468078044,67.06317124874552,NaN,NaN,NaN,NaN,0.9456138147410488,43.435261119088764,96841761
2025-09-11T14:55:00-04:00,366.675,367.38,366.47,367.38,363.9608840581843,NaN,NaN,NaN,NaN,NaN,363.3183,368.03341340688684,358.6031865931132,365.305132981864,360.0804768824481,365.21340764582135,354.9475461190749,117956,103531.86666666667,67.75126652319628,66.65823753880863,NaN,NaN,NaN,NaN,0.9430699708309715,43.326266042487646,96959717
2025-09-11T15:00:00-04:00,367.33,367.55,366.66,366.8,364.072329134401,NaN,NaN,NaN,NaN,NaN,363.4597000000001,368.15991548863525,358.759484511365,365.4306954472437,360.1457531653467,365.29805239571397,354.99345393497947,83349,103127.76666666666,62.47166021209923,65.72504215447027,NaN,NaN,NaN,NaN,0.9392792586287584,43.34694761071973,96876368
2025-09-11T15:05:00-04:00,366.78,367.21,366.48,366.62,364.072329134401,NaN,NaN,NaN,NaN,NaN,363.6155000000001,368.2067090999626,359.0242909000376,365.4306954472437,360.22200413665587,365.3930686482217,355.05093962509005,102936,103383.9,60.88592658579002,64.94387953924878,NaN,NaN,NaN,NaN,0.9243307401552728,43.033670288953616,96773432
2025-09-11T15:10:00-04:00,366.64,366.75,365.77,366.11,364.072329134401,NaN,NaN,NaN,NaN,NaN,363.7569000000001,368.2091142311023,359.30468576889785,365.4306954472437,360.28308671171544,365.46277491083663,355.10339851259425,92161,104496.53333333334,56.50920669330574,63.7797212615449,NaN,NaN,NaN,NaN,0.9283071158584689,41.54158523463049,96681271
2025-09-11T15:15:00-04:00,366.1,367.07,365.88,366.96,364.072329134401,NaN,NaN,NaN,NaN,NaN,363.8974000000001,368.3014305357242,359.49336946427604,365.4306954472437,360.3672342889854,365.56352129343605,355.17094728453475,121262,106712.53333333334,61.47924825127479,62.970565952267364,NaN,NaN,NaN,NaN,0.9469994647257209,40.464605108654965,96802533
2025-09-11T15:20:00-04:00,366.94,368.36,366.86,367.14,364.52447043997785,NaN,NaN,NaN,NaN,NaN,363.9986000000001,368.4630641514348,359.5341358485654,365.76545285519103,360.5286647196104,365.7731021874483,355.2842272517725,213446,111854.2,62.4576613894657,61.94907912118088,NaN,NaN,NaN,NaN,0.986499502959598,40.4841016634156,97015979
2025-09-11T15:25:00-04:00,367.13,367.33,366.4,367.06,364.52447043997785,NaN,NaN,NaN,NaN,NaN,364.07680000000016,368.6154278806966,359.53817211930374,365.76545285519103,360.61352299838967,365.8742763368937,355.35276965988567,125872,113534.6,61.70747793113795,61.328742196546685,NaN,NaN,NaN,NaN,0.9824638241767701,39.804860406591224,96890107
2025-09-11T15:30:00-04:00,367.03,367.36,366.51,366.61,364.52447043997785,NaN,NaN,NaN,NaN,NaN,364.15980000000013,368.72880775218357,359.5907922478167,365.76545285519103,360.6655360857364,365.9347201344388,355.396352037034,80160,113840.16666666667,57.52219856892732,61.30088986780259,NaN,NaN,NaN,NaN,0.9730021224498596,39.19804108191393,96809947
2025-09-11T15:35:00-04:00,366.62,366.75,366.15,366.2,364.52447043997785,NaN,NaN,NaN,NaN,NaN,364.2512000000001,368.79690327227433,359.70549672772586,365.76545285519103,360.71869095744273,365.99179778862674,355.4455841262587,90117,115030.36666666667,53.93300175007196,61.04760953972472,NaN,NaN,NaN,NaN,0.9463591137034426,38.081542258344,96719830
2025-09-11T15:40:00-04:00,366.2,366.64,365.85,366.05,364.52447043997785,NaN,NaN,NaN,NaN,NaN,364.34980000000013,368.832994378958,359.86660562104225,365.76545285519103,360.7742091249842,366.04897078777344,355.499447462195,99266,114647.96666666666,52.63892249945262,60.693761081440016,NaN,NaN,NaN,NaN,0.9351906055817656,36.60122476083207,96620564
2025-09-11T15:45:00-04:00,366.07,366.73,366.02,366.73,364.52447043997785,NaN,NaN,NaN,NaN,NaN,364.4506000000001,368.916655816885,359.98454418311525,365.76545285519103,360.8253740224556,366.10402894251246,355.54671910239875,88147,114512.06666666667,57.605099953641094,60.276685180897914,NaN,NaN,NaN,NaN,0.9191055623259279,35.32095793056228,96708711
2025-09-11T15:50:00-04:00,366.72,368.1,366.63,367.89,364.52447043997785,NaN,NaN,NaN,NaN,NaN,364.56040000000013,369.0889087346213,360.03189126537893,365.76545285519103,360.9565483406138,366.2653554977341,355.64774118349345,196318,116725,64.45273507006033,60.36082680159064,NaN,NaN,NaN,NaN,0.958455165016935,35.33776506882253,96905029
2025-09-11T15:55:00-04:00,367.91,368.99,367.32,368.88,365.07035340546815,NaN,NaN,NaN,NaN,NaN,364.6880000000001,369.33508080407165,360.04091919592855,366.2094030666169,361.13294158338005,366.4991806352801,355.76670253148,244037,120743.7,69.04769639314628,60.90564617873924,NaN,NaN,NaN,NaN,1.0092797960871551,35.937022738696896,97149066
2025-09-12T09:30:00-04:00,370.78,374.72,370.25,374.39,368.7442009779469,NaN,NaN,NaN,NaN,NaN,364.9312000000001,370.26090339133833,359.6014966086619,369.57552245329356,373.12000000000006,373.12000000000006,373.12000000000006,587047,137888.83333333334,82.55989205740897,62.21585670564128,NaN,NaN,NaN,NaN,1.3543312392237892,38.37393456751549,97736113
2025-09-12T09:35:00-04:00,374.26,377.52,373.57,377.01,371.43560093349475,NaN,NaN,NaN,NaN,NaN,365.2226000000001,371.48689476953143,358.9583052304688,371.42941796263483,374.61403804729537,376.0702252460014,373.1578508485893,617962,150054.8,85.74626139823887,63.50121348243004,NaN,NaN,NaN,NaN,1.5397361507078033,41.05936211615647,98354075
2025-09-12T09:40:00-04:00,376.985,379.53,376.85,378.2,373.90193725469953,NaN,NaN,NaN,NaN,NaN,365.55260000000015,372.714033163793,358.39116683620733,373.31753437010786,375.55333887070645,377.56424919687095,373.54242854454196,428738,157524.2,86.91557732357222,65.24720756182096,NaN,NaN,NaN,NaN,1.6211835685143854,43.78038835630309,98782813
2025-09-12T09:45:00-04:00,378.17,381.28,377.68,381.14,374.8959401067587,NaN,NaN,NaN,NaN,NaN,365.9300000000001,374.25416530347496,357.6058346965253,374.5100274960863,376.5230105231992,379.0866738843346,373.95934716206386,451297,168599.8,89.25980723486995,67.27391332246954,NaN,NaN,NaN,NaN,1.7625275993347842,46.47159294721426,99234110
2025-09-12T09:50:00-04:00,381.14,384.22,380.41,384.09,377.419761010997,NaN,NaN,NaN,NaN,NaN,366.3602000000002,376.05744124890276,356.6629587510976,376.89902199686907,377.7144305050708,381.1102901893647,374.3185708207769,478438,181333.13333333333,91.0018480620609,69.73767342023775,NaN,NaN,NaN,NaN,1.9087756279537285,49.19124286303726,99712548
2025-09-12T09:55:00-04:00,384.15,386.98,383.37,384.58,380.0099991468607,NaN,NaN,NaN,NaN,NaN,366.79680000000013,377.6958006440744,355.8977993559259,379.3182175974953,379.035768719362,383.1931256618171,374.87841177690694,570154,198009.03333333333,91.25555778585755,71.86455267270794,NaN,NaN,NaN,NaN,2.030291654528463,51.8757569318311,100282702
2025-09-12T10:00:00-04:00,384.61,387.5,383.91,385.96,380.28522645836705,NaN,NaN,NaN,NaN,NaN,367.2798000000001,379.3315162196735,355.22808378032664,379.5755740779962,379.9241495723843,384.4209728954612,375.4273262493074,474588,210144.9,91.9444432801467,73.97075137918516,NaN,NaN,NaN,NaN,2.141699393490714,54.39536656416845,100757290
2025-09-12T10:05:00-04:00,386,387.9,384.9,387.85,380.8174888920776,NaN,NaN,NaN,NaN,NaN,367.8292000000001,381.02308394065625,354.635316059344,380.06045926239693,380.6325040397991,385.38549731663454,375.8795107629636,408890,220898.43333333332,92.78301140108883,76.1904323413245,NaN,NaN,NaN,NaN,2.2030065796699487,56.75611482775711,101166180
2025-09-12T10:10:00-04:00,387.89,388.49,386.16,386.685,381.678512124256,NaN,NaN,NaN,NaN,NaN,368.3437000000001,382.40386199193904,354.2835380080612,381.0533674099176,381.1282964258755,386.0097686888863,376.24682416286464,332865,226629.73333333334,86.78591746015609,78.28069797641227,NaN,NaN,NaN,NaN,2.212077538264951,58.97984573785047,100833315
2025-09-12T10:15:00-04:00,386.64,387.21,385.18,386.4,381.678512124256,NaN,NaN,NaN,NaN,NaN,368.8607000000001,383.6201734336795,354.10122656632075,381.0533674099176,381.47089978935634,386.3577033361053,376.58409624260736,310973,232799.03333333333,85.33282868457951,80.52354275744854,NaN,NaN,NaN,NaN,2.199071999817453,60.24874892000718,100522342
2025-09-12T10:20:00-04:00,386.39,388.26,386.12,388.26,381.678512124256,NaN,NaN,NaN,NaN,NaN,369.41430000000014,384.9461122586998,353.88248774130045,381.61855514234725,381.9106861310213,386.873638128977,376.9477341330656,363703,240612.76666666666,86.87710595403225,82.96912728991852,NaN,NaN,NaN,NaN,2.1948525712590623,61.53341404207032,100886045
2025-09-12T10:25:00-04:00,388.23,392.41,388.17,391.79,384.2700587699788,NaN,NaN,NaN,NaN,NaN,370.02570000000014,386.5914473130391,353.4599526869612,384.97684411387786,382.9104758660612,388.3634915136046,377.4574602185178,637551,258313.43333333332,89.20096731316771,85.22597495845613,NaN,NaN,NaN,NaN,2.3409345304548443,63.059379141538685,101523596
2025-09-12T10:30:00-04:00,391.8,394.19,391.34,393.06,386.6300560986161,NaN,NaN,NaN,NaN,NaN,370.6597000000001,388.2453455565257,353.0740544434745,386.81847529110223,383.6621203420548,389.5277652951771,377.79647538893244,462544,270897.6666666667,89.89432841184379,87.04323162572636,NaN,NaN,NaN,NaN,2.3772963497080712,64.58634827236122,101986140
2025-09-12T10:35:00-04:00,393.08,393.74,389.45,390.01,386.6300560986161,NaN,NaN,NaN,NaN,NaN,371.22350000000006,389.43577478926767,353.01122521073245,386.81847529110223,384.0415658270552,389.9836455176558,378.0994861364546,330815,278513.9,77.0926126105264,87.61786849839639,NaN,NaN,NaN,NaN,2.5139180390146385,64.77443758014076,101655325
2025-09-12T10:40:00-04:00,390.05,390.62,386.9,387.87,386.6300560986161,NaN,NaN,NaN,NaN,NaN,371.73950000000013,390.34292659295687,353.1360734070434,386.81847529110223,384.2703514017586,390.1389735803183,378.4017292231989,352241,286898.9,69.60295156843254,86.69237274918378,NaN,NaN,NaN,NaN,2.600066750513595,63.52249717840074,101303084
2025-09-12T10:45:00-04:00,387.9,390.35,387.6,389.18,386.6300560986161,NaN,NaN,NaN,NaN,NaN,372.2743000000001,391.3100207386471,353.2385792613531,386.81847529110223,384.47869025033793,390.30006415493693,378.65731634573893,310721,294967.0333333333,71.43257890999323,85.66996685716624,NaN,NaN,NaN,NaN,2.6107762683340523,62.35998109107073,101613805
2025-09-12T10:50:00-04:00,389.21,389.7,388.11,389.33,386.6300560986161,NaN,NaN,NaN,NaN,NaN,372.7993000000001,392.23548028419697,353.3631197158032,386.81847529110223,384.62082280961397,390.40554522885,378.83610039037796,228606,300072,71.64305141439941,84.57907214936817,NaN,NaN,NaN,NaN,2.5378636777387613,61.28050186712144,101842411
2025-09-12T10:55:00-04:00,389.4,389.85,388.5,389.63,386.6300560986161,NaN,NaN,NaN,NaN,NaN,373.31890000000004,393.13430282607925,353.50349717392083,386.81847529110223,384.7251005399655,390.48716100179763,378.9630400781334,166496,301690,72.08600779735258,83.3523721895455,NaN,NaN,NaN,NaN,2.4530162721859945,60.31090530145844,102008907
2025-09-12T11:00:00-04:00,389.65,390.64,389.01,390.07,386.6300560986161,NaN,NaN,NaN,NaN,NaN,373.83850000000007,394.0178060584293,353.65919394157083,386.81847529110223,384.8428419625567,390.59115686064115,379.09452706447223,174703,304735.13333333336,72.75813943633341,82.04925014485069,NaN,NaN,NaN,NaN,2.39422939560128,59.58618823742966,102183610
2025-09-12T11:05:00-04:00,390.035,390.8,388.93,390.54,386.6300560986161,NaN,NaN,NaN,NaN,NaN,374.36730000000006,394.8810517982404,353.85354820175974,386.81847529110223,384.96286756461416,390.69895243331956,379.22678269590875,179983,307303.36666666664,73.49237113898151,80.78045109864526,NaN,NaN,NaN,NaN,2.356784438772617,58.9493703410629,102363593
2025-09-12T11:10:00-04:00,390.52,391.75,389.06,389.27,386.6300560986161,NaN,NaN,NaN,NaN,NaN,374.87309999999997,395.58363441029695,354.162565589703,386.81847529110223,385.1139463961773,390.82912128477057,379.39877150758406,241971,312297.0333333333,68.14750453723637,79.08066975986596,NaN,NaN,NaN,NaN,2.3805855502888584,58.57280148582331,102121622
2025-09-12T11:15:00-04:00,389.265,389.96,388.14,388.14,386.6300560986161,NaN,NaN,NaN,NaN,NaN,375.33349999999996,396.1793479558898,354.4876520441101,386.81847529110223,385.19200635077334,390.86993138729173,379.51408131425495,178101,314191.6666666667,63.70787113972213,77.00387402691119,NaN,NaN,NaN,NaN,2.3405437252682253,57.56706505473821,101943521
2025-09-12T11:20:00-04:00,388.16,389.34,387.2,389.02,386.6300560986161,NaN,NaN,NaN,NaN,NaN,375.79009999999994,396.8141999322244,354.76600006777545,385.83944443309485,385.2574757932787,390.8982394729481,379.61671211360925,166324,312620.93333333335,65.58803432873664,75.48973951752409,NaN,NaN,NaN,NaN,2.3262191734633513,55.99630407902799,102109845
2025-09-12T11:25:00-04:00,389.04,389.2,387.95,388.19,386.6300560986161,NaN,NaN,NaN,NaN,NaN,376.2371,397.34619245704556,355.12800754295444,385.83944443309485,385.30632125513876,390.917406763658,379.6952357466195,131506,312808.73333333334,62.30922935784047,73.8451967084713,NaN,NaN,NaN,NaN,2.2493463753588263,54.5377403158685,101978339
2025-09-12T11:30:00-04:00,388.225,389.25,387.8,388.8,386.6300560986161,NaN,NaN,NaN,NaN,NaN,376.68370000000004,397.8919624285902,355.4754375714099,385.83944443309485,385.3489970229614,390.9362903759536,379.76170366996917,112136,313874.6,63.74376104592393,72.19281492932072,NaN,NaN,NaN,NaN,2.192250205690338,53.074017917220814,102090475
2025-09-12T11:35:00-04:00,388.795,390.43,388.64,390.13,386.6300560986161,NaN,NaN,NaN,NaN,NaN,377.1645,398.48003051181286,355.8489694881871,385.83944443309485,385.44564984932714,391.008388865274,379.88291083338027,196078,317406.63333333336,66.7180954133826,70.58689550790749,NaN,NaN,NaN,NaN,2.1635180481410297,52.12613634616344,102286553
2025-09-12T11:40:00-04:00,390.17,390.22,389.09,389.78,386.6300560986161,NaN,NaN,NaN,NaN,NaN,377.63309999999996,399.00713311404104,356.2590668859589,385.8691225214692,385.5020136521416,391.0491036745161,379.9549236297671,119515,318081.6,65.20219612425812,68.82317177307993,NaN,NaN,NaN,NaN,2.089695330416674,51.24596060161017,102167038
2025-09-12T11:45:00-04:00,389.68,390.24,389.43,389.9,386.6300560986161,NaN,NaN,NaN,NaN,NaN,378.10409999999996,399.5007213865667,356.70747861343324,386.3542980171754,385.5449213714387,391.081348618959,380.0084941239184,89701,318133.4,65.49169588623192,67.99453486420177,NaN,NaN,NaN,NaN,1.9982885211011971,50.43602080215419,102256739
2025-09-12T11:50:00-04:00,389.9,390.85,389.4,390.83,386.6300560986161,NaN,NaN,NaN,NaN,NaN,378.57189999999997,400.03810831819624,357.1056916818037,387.0164384137403,385.6090023112211,391.136076217665,380.0819284047772,122789,315682.43333333335,67.73223073690937,67.86091194766439,NaN,NaN,NaN,NaN,1.9591250553082578,49.91260462272834,102379528
2025-09-12T11:55:00-04:00,390.87,392.65,390.81,391.71,386.6300560986161,NaN,NaN,NaN,NaN,NaN,379.06989999999996,400.57681688643925,357.5629831135607,388.6631507309922,385.756766481416,391.2967961195552,380.21673684327675,228496,315164.4,69.73466375217596,67.73963229353458,NaN,NaN,NaN,NaN,1.9506161227862375,50.01492947532068,102608024
2025-09-12T12:00:00-04:00,391.72,391.89,389.77,389.92,386.6300560986161,NaN,NaN,NaN,NaN,NaN,379.5625,400.9120662016834,358.2129337983166,388.6631507309922,385.8354592606979,391.3630938143653,380.30782470703053,158602,300882.9,61.389443674228275,67.00723174066522,NaN,NaN,NaN,NaN,1.9627149711586493,49.21655365556404,102449422
2025-09-12T12:05:00-04:00,389.94,390.91,389.43,390.67,386.6300560986161,NaN,NaN,NaN,NaN,NaN,380.07129999999995,401.2421513584169,358.900448641583,388.6631507309922,385.89185981572024,391.4075265478314,380.37619308360905,121987,284350.4,63.36754279460354,66.38448424046886,NaN,NaN,NaN,NaN,1.9282353303616042,48.19481943870206,102571409
2025-09-12T12:10:00-04:00,390.69,391.7,390.4,391.48,386.6300560986161,NaN,NaN,NaN,NaN,NaN,380.5959,401.57072125693344,359.6210787430665,388.6631507309922,385.96051650342616,391.4730349853472,380.4479980215051,127734,274316.93333333335,65.42760303584049,65.86087449757652,NaN,NaN,NaN,NaN,1.883361378192919,47.553246196902435,102699143
2025-09-12T12:15:00-04:00,391.56,392.32,391.295,391.97,386.6300560986161,NaN,NaN,NaN,NaN,NaN,381.1081,401.9174843147803,360.29871568521963,388.6631507309922,386.04931303981846,391.5671677693641,380.5314583102728,150683,264296.4666666667,66.64943860230849,65.37209360209987,NaN,NaN,NaN,NaN,1.8220498511791374,47.187143972115905,102849826
2025-09-12T12:20:00-04:00,391.9,392.07,391.21,391.77,386.6300560986161,NaN,NaN,NaN,NaN,NaN,381.61670000000004,402.1992685092954,361.0341314907047,388.6945332315315,386.1084602816432,391.6272302984003,380.5896902648861,106244,251890,65.6299001398031,65.19226471656891,NaN,NaN,NaN,NaN,1.7533320046663428,46.76836541649972,102743582
2025-09-12T12:25:00-04:00,391.77,392.12,391.3,391.66,386.6300560986161,NaN,NaN,NaN,NaN,NaN,382.12730000000005,402.4123111372875,361.8422888627126,389.00962658522525,386.1563466950035,391.67547912658387,380.6372142634231,87524,235802.33333333334,65.04059665640982,65.28745939633232,NaN,NaN,NaN,NaN,1.6866654329044606,46.3999709112983,102656058
2025-09-12T12:30:00-04:00,391.66,392.75,391.41,392.435,386.84062029753596,NaN,NaN,NaN,NaN,NaN,382.64300000000003,402.6368500544521,362.64914994554795,389.5917012681802,386.231472386214,391.75689900760113,380.7060457648269,128520,224266.73333333334,67.27042451894687,65.40763012420447,NaN,NaN,NaN,NaN,1.6619036162684258,46.31713125393971,102784578
2025-09-12T12:35:00-04:00,392.47,392.83,391.82,392.11,387.1860466476479,NaN,NaN,NaN,NaN,NaN,383.1376,402.817760491216,363.45743950878403,389.7983610145441,386.3171404133351,391.84927846639613,380.78500236027406,149167,215609.3,65.38692892825291,65.62746580780536,NaN,NaN,NaN,NaN,1.615339072249252,46.273176610526185,102635411
2025-09-12T12:40:00-04:00,392.13,393.44,391.98,393.15,387.6055445273003,NaN,NaN,NaN,NaN,NaN,383.6646,402.9742939219669,364.35490607803314,390.2846888116353,386.4189688799477,391.9672606734961,380.8706770863993,165853,210042.23333333334,68.43279774087057,65.96239700030155,NaN,NaN,NaN,NaN,1.6042434242314467,46.483420624538006,102801264
2025-09-12T12:45:00-04:00,393.17,394.83,393.17,394.56,388.8984743215139,NaN,NaN,NaN,NaN,NaN,384.22339999999997,403.14086700169236,365.3059329983076,391.46575104930827,386.58063072244653,392.1817447628111,380.97951668208196,226386,207222.66666666666,72.0268390232669,66.34159297243615,NaN,NaN,NaN,NaN,1.6096546082149155,47.175873786433336,103027650
2025-09-12T12:50:00-04:00,394.56,395.99,394.36,395.43,390.0830891250815,NaN,NaN,NaN,NaN,NaN,384.8097999999999,403.25687315105597,366.3627268489438,392.48360083944664,386.785674578049,392.4750448960184,381.0963042600796,263194,203872.36666666667,73.9942756264923,66.96959865116716,NaN,NaN,NaN,NaN,1.6111078504852785,48.162186911820676,103290844
2025-09-12T12:55:00-04:00,395.38,395.38,393.51,393.57,390.0830891250815,NaN,NaN,NaN,NaN,NaN,385.34199999999987,403.22527766379517,367.4587223362046,392.48360083944664,386.8976730862999,392.6151467924834,381.1801993801164,171970,188353,63.68200491544516,66.84033501039669,NaN,NaN,NaN,NaN,1.633171575450617,48.16207318358508,103118874
2025-09-12T13:00:00-04:00,393.63,393.64,391.78,392.62,390.0830891250815,NaN,NaN,NaN,NaN,NaN,385.8515999999999,403.07093128086933,368.6322687191305,392.48360083944664,386.98066233971724,392.69846980750987,381.2628548719246,164728,178425.8,59.147906869145025,66.22716901984208,NaN,NaN,NaN,NaN,1.6493736057755741,46.588869602729474,102954146
2025-09-12T13:05:00-04:00,392.63,392.73,391.4,391.45,390.0830891250815,NaN,NaN,NaN,NaN,NaN,386.3393999999999,402.76532470944346,369.91347529055633,392.48360083944664,387.0358182470825,392.7445694141262,381.3270670800388,131225,171772.8,54.04436655230666,65.10643350556572,NaN,NaN,NaN,NaN,1.626561205363036,44.82199629825553,102822921
2025-09-12T13:10:00-04:00,391.44,393.2,391.08,393.09,390.0830891250815,NaN,NaN,NaN,NaN,NaN,386.8689999999999,402.3994477720454,371.33855222795444,392.48360083944664,387.1026191477304,392.8075198283539,381.3977184671069,144839,164859.4,59.34026213443339,64.96006339558036,NaN,NaN,NaN,NaN,1.6618068335513911,43.42294793695375,102967760
2025-09-12T13:15:00-04:00,393.1,393.95,393.03,393.36,390.0830891250815,NaN,NaN,NaN,NaN,NaN,387.4121999999999,401.8762445463976,372.9481554536023,392.48360083944664,387.17241714875075,392.8843124467015,381.46052185080003,130753,158860.46666666667,60.15437735452293,64.73055157843176,NaN,NaN,NaN,NaN,1.6088206311548645,42.49357641112992,103098513
2025-09-12T13:20:00-04:00,393.36,394.18,392.97,394.13,390.0830891250815,NaN,NaN,NaN,NaN,NaN,387.9737999999999,401.2044396761563,374.74316032384354,392.48360083944664,387.2311580103387,392.9511524988654,381.51116352181197,106925,154804.43333333332,62.46269731186736,64.51877259814795,NaN,NaN,NaN,NaN,1.5803334432152298,41.741703944501936,103205438
2025-09-12T13:25:00-04:00,394.19,394.42,393.57,393.59,390.0830891250815,NaN,NaN,NaN,NaN,NaN,388.5109999999999,400.35645921441034,376.6655407855895,392.48360083944664,387.27068696691714,392.99639219776884,381.54498173606544,71935,151652.4,59.84435573132571,64.03269525022061,NaN,NaN,NaN,NaN,1.528166768699858,41.16261932536226,103133503
2025-09-12T13:30:00-04:00,393.58,394.25,393.32,393.82,390.0830891250815,NaN,NaN,NaN,NaN,NaN,389.0296,399.3966587612867,378.66254123871335,392.48360083944664,387.3104039773367,393.0411800386922,381.57962791598123,73866,148291.16666666666,60.60188560584872,63.67355135493815,NaN,NaN,NaN,NaN,1.4854405709355827,40.369518522912315,103207369
2025-09-12T13:35:00-04:00,393.76,394.57,393.36,394.07,390.0830891250815,NaN,NaN,NaN,NaN,NaN,389.5334,398.25191992943803,380.8148800705619,392.48360083944664,387.36894834976476,393.10851176782415,381.6293849317054,107156,145863.6,61.45310099840671,63.417301665080785,NaN,NaN,NaN,NaN,1.4657662444401824,39.810758149107954,103314525
2025-09-12T13:40:00-04:00,394.08,394.26,393.22,393.85,390.0830891250815,NaN,NaN,NaN,NaN,NaN,389.92259999999993,397.57449655969606,382.2707034403038,391.6148806715573,387.4114397802147,393.15553274693866,381.6673468134908,81737,140522.46666666667,60.22007376109082,62.91370518237678,NaN,NaN,NaN,NaN,1.4353543698373097,39.135864916834294,103232788
2025-09-12T13:45:00-04:00,393.83,394.95,393.78,394.59,390.0830891250815,NaN,NaN,NaN,NaN,NaN,390.2742,397.0904292684469,383.45797073155313,391.96784166503,387.4732678914012,393.22957750605286,381.7169582767495,109390,138232.1,62.915428057916735,62.7371694059242,NaN,NaN,NaN,NaN,1.416400486277503,38.90931409332442,103342178
2025-09-12T13:50:00-04:00,394.63,394.88,394.22,394.47,390.0830891250815,NaN,NaN,NaN,NaN,NaN,390.5996,396.5814822589601,384.61771774103994,392.16427333202404,387.517375170937,393.28251274234583,381.75223759952814,78289,135297.6,62.17967086738197,62.290517486389305,NaN,NaN,NaN,NaN,1.362371880114822,38.69894547149383,103263889
2025-09-12T13:55:00-04:00,394.48,395.37,394.45,394.93,390.5119612450485,NaN,NaN,NaN,NaN,NaN,390.87539999999996,396.3361801054531,385.41461989454683,392.7374186656192,387.5962957724477,393.3807608772143,381.81183066768114,134909,135411.03333333333,63.92142941717504,61.71155965738274,NaN,NaN,NaN,NaN,1.3307738886780502,38.78781477686846,103398798
2025-09-12T14:00:00-04:00,394.9,395.28,394.24,395.17,390.5119612450485,NaN,NaN,NaN,NaN,NaN,391.097,396.33301451488546,385.8609854851145,392.7374186656192,387.6663198592609,393.4667846008228,381.865855117699,122498,135756.43333333332,64.83145814545634,61.0570726944516,NaN,NaN,NaN,NaN,1.310004325201044,38.591660982387985,103521296
2025-09-12T14:05:00-04:00,395.17,395.5,394.8,395.02,390.91186964683135,NaN,NaN,NaN,NaN,NaN,391.30580000000003,396.313289334971,386.2983106650291,393.0491479459963,387.7162344652792,393.5290278490383,381.90344108152004,86255,132095.66666666666,63.74916482015837,61.06186983050254,NaN,NaN,NaN,NaN,1.2664325876866829,38.548828302575934,103435041
2025-09-12T14:10:00-04:00,395.05,395.31,394.73,394.96,390.91186964683135,NaN,NaN,NaN,NaN,NaN,391.48580000000004,396.3568776466697,386.61472235333036,393.05931835679706,387.7592398679468,393.581650151855,381.9368295840386,76364,130657.3,63.29400237249594,61.358019509313316,NaN,NaN,NaN,NaN,1.2174016885662042,38.407129072157005,103358677
2025-09-12T14:15:00-04:00,395,395.41,394.16,394.93,390.91186964683135,NaN,NaN,NaN,NaN,NaN,391.62739999999997,396.479067028984,386.77573297101594,393.05931835679706,387.83977600538213,393.6773911378716,382.00216087289266,148941,132631.96666666667,63.051596742816244,62.00139309434972,NaN,NaN,NaN,NaN,1.2197301393829039,37.46452648561501,103209736
2025-09-12T14:20:00-04:00,394.905,395.4,394.41,394.88,390.91186964683135,NaN,NaN,NaN,NaN,NaN,391.7912999999999,396.5160631940845,387.06653680591535,393.05931835679706,387.89237535750425,393.73978240328444,382.04496831172406,98245,131813.83333333334,62.62113504828357,62.23574115962474,NaN,NaN,NaN,NaN,1.203320843712693,36.589252655254576,103111491
2025-09-12T14:25:00-04:00,394.89,395.37,394.54,394.95,390.97032908777334,NaN,NaN,NaN,NaN,NaN,391.9622999999999,396.5097525660192,387.41484743398064,393.05931835679706,387.9290405446122,393.7832841079803,382.07479698124405,68801,126490.66666666667,63.00196387334905,62.43914019668375,NaN,NaN,NaN,NaN,1.1766550691617854,35.77649838420561,103180292
2025-09-12T14:30:00-04:00,394.98,394.98,393.4,393.46,390.97032908777334,NaN,NaN,NaN,NaN,NaN,392.0662999999999,396.5069021258684,387.6256978741314,393.05931835679706,387.9926811098532,393.8483305860761,382.13703163363033,141622,125924.66666666667,51.07377351050405,61.62564563944351,NaN,NaN,NaN,NaN,1.2054654213645182,33.483763425272926,103038670
2025-09-12T14:35:00-04:00,393.43,394.1,392.84,393.95,390.97032908777334,NaN,NaN,NaN,NaN,NaN,392.10949999999997,396.5804329004301,387.63856709956985,393.05931835679706,388.05106768510626,393.904206410487,382.1979289597255,140147,126530,54.148248066513716,61.218780806242656,NaN,NaN,NaN,NaN,1.2093607484099134,31.446877187934163,103178817
2025-09-12T14:40:00-04:00,393.9,394.07,392.99,393.09,390.97032908777334,NaN,NaN,NaN,NaN,NaN,392.1100999999999,396.58155099048815,387.6386490095116,393.05931835679706,388.0856092902653,393.9354211449212,382.23579743560947,88226,125213.06666666667,48.39969125606659,60.34719549554393,NaN,NaN,NaN,NaN,1.200120694952061,29.555482824691033,103090591
2025-09-12T14:45:00-04:00,393.09,393.74,392.72,392.87,390.97032908777334,NaN,NaN,NaN,NaN,NaN,392.1672999999999,396.6028550769169,387.7317449230829,393.05931835679706,388.13018708372357,393.97301822857065,382.2873559388765,121919,124254.26666666666,47.024363349704494,59.31657137777949,NaN,NaN,NaN,NaN,1.1872549310269125,28.101602997495924,102968672
2025-09-12T14:50:00-04:00,392.88,393.54,392.62,393.32,390.97032908777334,NaN,NaN,NaN,NaN,NaN,392.2763,396.5489548233998,388.0036451766002,393.05931835679706,388.1659446607586,394.003286087815,382.3286032337022,98390,123992.46666666666,50.145024994119865,58.596925037281565,NaN,NaN,NaN,NaN,1.16816529309642,26.864807103201805,103067062
2025-09-12T14:55:00-04:00,393.34,394.28,393.06,393.7,390.97032908777334,NaN,NaN,NaN,NaN,NaN,392.3666999999999,396.56408947921136,388.1693105207885,393.05931835679706,388.20408626209996,394.0391283285141,382.36904419568583,96400,124288.33333333333,52.67998514653127,57.86582197218261,NaN,NaN,NaN,NaN,1.1718677721609592,25.14199020490074,103163462
2025-09-12T15:00:00-04:00,393.75,395.34,393.68,395.11,390.97032908777334,NaN,NaN,NaN,NaN,NaN,392.4822999999999,396.6571002156294,388.3074997843704,393.00665099868013,388.273249997539,394.11541976899935,382.4310802260786,149748,124995.93333333333,60.67090517814457,57.75805299437992,NaN,NaN,NaN,NaN,1.2067343598637454,24.643620650121118,103313210
2025-09-12T15:05:00-04:00,395.08,395.6,394.86,395.23,391.3881827682322,NaN,NaN,NaN,NaN,NaN,392.5942999999999,396.7574622644558,388.43113773554404,393.00665099868013,388.3383241394862,394.19154147709816,382.4851068018742,133007,124457.26666666666,61.270340605425496,57.56868950782639,NaN,NaN,NaN,NaN,1.17339619130205,24.415814807453476,103446217
2025-09-12T15:10:00-04:00,395.21,395.94,394.88,395.93,391.5982653696761,NaN,NaN,NaN,NaN,NaN,392.71149999999994,396.9135662774494,388.5094337225505,393.19152552417177,388.40622574029334,394.27362700830133,382.53882447228534,134525,123413,64.65459424434306,57.556056372032586,NaN,NaN,NaN,NaN,1.1652964633519038,24.50486285286501,103580742
2025-09-12T15:15:00-04:00,395.91,396.61,395.66,396.08,392.36698058014537,NaN,NaN,NaN,NaN,NaN,392.82229999999987,397.08126288319505,388.5633371168047,393.9362204193375,388.51579512970295,394.4124046145295,382.6191856448764,206913,122763.9,65.35324430812338,57.6706334783158,NaN,NaN,NaN,NaN,1.1499181445410527,25.12962900921351,103787655
2025-09-12T15:20:00-04:00,396.08,396.2,394.57,394.92,392.36698058014537,NaN,NaN,NaN,NaN,NaN,392.9352999999999,397.11025025601265,388.7603497439872,393.9362204193375,388.5841046894712,394.48920718844965,382.6790021904927,149660,118979.43333333333,56.115590504121776,57.157889773431926,NaN,NaN,NaN,NaN,1.1842097056452627,24.265659872973373,103637995
2025-09-12T15:25:00-04:00,394.89,395.15,393.92,393.95,392.36698058014537,NaN,NaN,NaN,NaN,NaN,393.0514999999999,397.00358514585923,389.0994148541406,393.9362204193375,388.63788713765473,394.541367932486,382.73440634282343,138747,117872,49.77921375666728,56.20986241727844,NaN,NaN,NaN,NaN,1.1874804409563124,22.746552301930105,103499248
2025-09-12T15:30:00-04:00,393.94,393.94,392.83,393.44,392.36698058014537,NaN,NaN,NaN,NaN,NaN,393.13989999999995,396.9213751037101,389.3584248962898,393.9362204193375,388.70127689807816,394.590721700851,382.8118320953053,200183,119053.83333333333,46.787821249777735,55.078911431670875,NaN,NaN,NaN,NaN,1.1826604094594333,21.924269805767967,103299065
2025-09-12T15:35:00-04:00,393.48,393.5,391.98,392.38,NaN,NaN,NaN,396.5674399579637,396.5674399579637,396.5674399579637,393.2237,396.7390291794541,389.7083708205459,393.9362204193375,388.75390047730275,394.62103130344366,382.88676965116184,204842,121507.73333333334,41.24065372205347,53.52453213514976,NaN,NaN,NaN,NaN,1.206756094498044,21.820001111560202,103094223
2025-09-12T15:40:00-04:00,392.39,393.64,392.23,393.31,NaN,NaN,NaN,396.5674399579637,NaN,NaN,393.3139,396.59415321583,390.03364678417,393.9362204193375,388.7938940815007,394.6483052178722,382.9394829451292,143002,121446.5,47.159868718336284,53.24496750713779,NaN,NaN,NaN,NaN,1.2212735163196098,21.567353570328297,103237225
2025-09-12T15:45:00-04:00,393.32,394.5,393.07,394.43,NaN,NaN,NaN,396.5674399579637,NaN,NaN,393.3998999999999,396.5652047183747,390.2345952816251,393.9362204193375,388.8421229815615,394.6906592098215,382.9935867533015,143970,121887.06666666667,53.26567337964372,53.181926458075644,NaN,NaN,NaN,NaN,1.2361825508682094,20.42885662648944,103381195
2025-09-12T15:50:00-04:00,394.46,396.38,394.46,396.24,NaN,NaN,NaN,396.5674399579637,NaN,NaN,393.52909999999997,396.619307559365,390.43889244063496,393.9362204193375,388.95394188375167,394.8191528720024,383.08873089550093,257853,126918,61.09057770895153,54.088418347567426,NaN,NaN,NaN,NaN,1.2871695115204793,20.085594919554666,103639048
2025-09-12T15:55:00-04:00,396.1,396.5,394.54,396,NaN,NaN,NaN,396.5674399579637,NaN,NaN,393.65109999999993,396.63851446071544,390.6636855392844,393.9362204193375,389.0713258269709,394.95146929302666,383.19118236091515,280620,133874.16666666666,59.6640727276704,54.99125473170785,NaN,NaN,NaN,NaN,1.3352288321261578,19.84906647111008,103358428
2025-09-15T09:30:00-04:00,423.2,425.69,418.96,424.06,414.4165960763672,414.4165960763672,414.4165960763672,NaN,NaN,NaN,394.31569999999994,403.2877276437412,385.34367235625865,407.7617367811107,422.90333333333336,422.90333333333336,422.90333333333336,973235,163853.13333333333,89.76268083063867,57.82108729145919,NaN,NaN,NaN,NaN,3.3605696298314323,24.27431300671505,104331663
2025-09-15T09:35:00-04:00,424.07,425.23,417.6,419,414.4165960763672,NaN,NaN,NaN,NaN,NaN,394.8614999999999,406.1534302601506,383.5695697398492,407.7617367811107,421.92718620505144,423.0611031030282,420.7932693070747,721250,184322.93333333332,78.40143602278295,59.658333782620026,NaN,NaN,NaN,NaN,3.66552894198633,27.893573307555314,103610413
2025-09-15T09:40:00-04:00,418.97,420.93,416.13,416.55,414.4165960763672,NaN,NaN,NaN,NaN,NaN,395.3941,408.12401935402295,382.664180645977,407.7617367811107,420.875977186693,422.90391653589256,418.8480378374934,592572,201350.76666666666,73.54745574074957,60.578087394234664,NaN,NaN,NaN,NaN,3.746562588987307,30.728657740008558,103017841
2025-09-15T09:45:00-04:00,416.62,418.23,414.77,416.48,414.4165960763672,NaN,NaN,NaN,NaN,NaN,395.9103,409.86626079242643,381.9543392075736,407.7617367811107,420.13347122851036,422.60705513819266,417.65988731882805,466508,213254.7,73.4076156338436,61.44503561055024,NaN,NaN,NaN,NaN,3.726093832631073,32.879717089950866,102551333
2025-09-15T09:50:00-04:00,416.5,420.33,415.05,419.5,414.4165960763672,NaN,NaN,NaN,NaN,NaN,396.4707,411.84796763894434,381.0934323610557,407.7617367811107,419.9213205596761,422.32102400981944,417.5216171095327,358830,222606.06666666668,75.56610714562757,62.22442938921342,NaN,NaN,NaN,NaN,3.8370871303002803,35.052488198083594,102910163
2025-09-15T09:55:00-04:00,419.44,419.52,417.11,418.82,414.4165960763672,NaN,NaN,NaN,NaN,NaN,397.00769999999994,413.54993917249,380.4654608275099,407.7617367811107,419.8152192677557,422.1550904765974,417.475348058914,247941,226373.8,74.10748832465086,62.8497325332511,NaN,NaN,NaN,NaN,3.7351523352788294,37.070061369921135,102662222
2025-09-15T10:00:00-04:00,418.88,419.63,416.66,418.06,414.4165960763672,NaN,NaN,NaN,NaN,NaN,397.53350000000006,415.0206690390283,380.04633096097183,407.7617367811107,419.7016364105574,422.00139890265643,417.40187391845836,240810,230317.53333333333,72.42484638660292,64.01467938199976,NaN,NaN,NaN,NaN,3.6804985970446253,38.76456312276865,102421412
2025-09-15T10:05:00-04:00,418.04,422.6,417.52,421.75,414.4165960763672,NaN,NaN,NaN,NaN,NaN,398.1353,416.8036608718031,379.4669391281968,410.494171333398,419.76913568799455,421.9960705699891,417.542200806,284565,236927.86666666667,75.35117620254353,65.84124812813376,NaN,NaN,NaN,NaN,3.780462982970012,40.61339569264904,102705977
2025-09-15T10:10:00-04:00,421.76,422.84,421,421.94,414.4165960763672,NaN,NaN,NaN,NaN,NaN,398.72540000000004,418.4699803034571,378.980819696543,412.2353370667184,419.870124902981,422.0915651086167,417.6486846973453,190813,240742.83333333334,75.49537621214907,67.89178776830315,NaN,NaN,NaN,NaN,3.641858484186438,42.35159271928719,102896790
2025-09-15T10:15:00-04:00,422.07,423.05,419.55,419.69,414.4165960763672,NaN,NaN,NaN,NaN,NaN,399.27700000000004,419.77801158479144,378.77598841520864,412.8162696533747,419.9204337112105,422.08821041441905,417.7526570080019,243309,243888.43333333332,70.2539055184609,69.96416289661796,NaN,NaN,NaN,NaN,3.631725735315978,43.34926360794064,102653481
2025-09-15T10:20:00-04:00,419.77,419.77,415.85,416.36,414.4165960763672,NaN,NaN,NaN,NaN,NaN,399.74120000000005,420.71195702590734,378.77044297409276,412.8162696533747,419.79467198154686,421.9814018954673,417.6079420676264,220125,247951.1,63.25436245478179,71.11376959207836,NaN,NaN,NaN,NaN,3.652316754221977,42.87224967801818,102433356
2025-09-15T10:25:00-04:00,416.33,417.6,414.25,416.49,NaN,NaN,NaN,425.35975111043183,425.35975111043183,425.35975111043183,400.17980000000006,421.611024133017,378.7485758669831,412.8162696533747,419.60058977106775,421.8823661974792,417.3188133446563,252670,254080.06666666668,63.40763820865758,71.83819565129363,NaN,NaN,NaN,NaN,3.63072270034898,41.889485041121155,102686026
2025-09-15T10:30:00-04:00,416.61,418.32,415.82,415.82,NaN,NaN,NaN,425.35975111043183,NaN,NaN,400.58759999999995,422.414111057884,378.7610889421159,412.8162696533747,419.50224390314077,421.8072272918289,417.19726051445264,165444,254874.13333333333,61.97285814437066,71.901215682395,NaN,NaN,NaN,NaN,3.5499567931811957,41.10906277647394,102520582
2025-09-15T10:35:00-04:00,415.85,417.93,415.6,417.69,NaN,NaN,NaN,425.35975111043183,NaN,NaN,401.07,423.31691834838887,378.8230816516111,412.8162696533747,419.4522889595434,421.75934739236686,417.14523052671996,104113,253673,64.39451262632862,72.23910424658489,NaN,NaN,NaN,NaN,3.4628170222396806,40.3047325814105,102624695
2025-09-15T10:40:00-04:00,417.77,418.83,416.66,418.33,NaN,NaN,NaN,425.35975111043183,NaN,NaN,401.5842,424.21135575232074,378.9570442476793,412.8162696533747,419.41898268041984,421.7112645533543,417.1267008074854,113999,254532.1,65.21106248868733,70.48541722215978,NaN,NaN,NaN,NaN,3.3704729492225574,39.73902883137036,102738694
2025-09-15T10:45:00-04:00,418.39,418.98,418.04,418.79,NaN,NaN,NaN,425.35975111043183,NaN,NaN,402.1310000000001,425.07134045081784,379.1906595491823,412.8162696533747,419.4048934699304,421.67977464678154,417.1300122930793,90983,253500.9,65.81783772458424,69.58658877228845,NaN,NaN,NaN,NaN,3.196867738563803,39.24487310645557,102829677
2025-09-15T10:50:00-04:00,418.72,420.96,418.65,420.71,NaN,NaN,NaN,425.35975111043183,NaN,NaN,402.68340000000006,426.0524778970749,379.31432210292525,414.4172849536114,419.4264817788701,421.669374954307,417.1835886034332,167174,255793.7,68.30288416888172,69.21197651715502,NaN,NaN,NaN,NaN,3.133520042952103,39.18890739492774,102996851
2025-09-15T10:55:00-04:00,420.71,421.96,420.04,421.62,NaN,NaN,NaN,425.35975111043183,NaN,NaN,403.24860000000007,427.05132085623046,379.4458791437697,415.76582796288915,419.4814189312538,421.7107921128092,417.2520457496984,173046,258348.56666666668,69.43699595594481,68.92836082587655,NaN,NaN,NaN,NaN,3.0468400398840925,39.328907487040155,103169897
2025-09-15T11:00:00-04:00,421.68,422.58,421.04,421.74,NaN,NaN,NaN,425.35975111043183,NaN,NaN,403.8008000000001,428.00932043061283,379.59227956938736,416.85466237031136,419.54855873271464,421.7791680138071,417.31794945162216,168213,258964.06666666668,69.59150559292661,68.50160357211219,NaN,NaN,NaN,NaN,2.9392086084637974,39.57801244038556,103338110
2025-09-15T11:05:00-04:00,421.78,421.82,419.05,419.29,NaN,NaN,NaN,425.35975111043183,NaN,NaN,404.3148000000001,428.72479934124135,379.90480065875886,416.85466237031136,419.5609881553489,421.7653518208074,417.35662448989046,145807,259390.73333333334,62.62988040402365,67.68177443492453,NaN,NaN,NaN,NaN,2.927122279287811,38.89936597615913,103192303
2025-09-15T11:10:00-04:00,419.315,421.24,418.86,421.08,NaN,NaN,NaN,425.35975111043183,NaN,NaN,404.86000000000007,429.5244193931166,380.19558060688354,416.85466237031136,419.57894594406434,421.7627514423266,417.3951404458021,130571,259258.93333333332,65.35663529460513,67.17690221406755,NaN,NaN,NaN,NaN,2.8880421164815386,38.18475121103986,103322874
2025-09-15T11:15:00-04:00,421.09,424.12,421.03,422.94,NaN,NaN,NaN,425.35975111043183,NaN,NaN,405.43740000000014,430.41412926864837,380.4606707313519,417.80522713359943,419.6993234873712,421.92321294832135,417.47543402642106,243056,260463.7,67.97179830258088,66.64980379264165,NaN,NaN,NaN,NaN,2.9024676795900026,38.17734203496432,103565930
2025-09-15T11:20:00-04:00,422.93,423.36,421.27,421.32,NaN,NaN,NaN,425.35975111043183,NaN,NaN,405.98680000000013,431.1277780048312,380.84582199516905,417.80522713359943,419.7368964139617,421.96147074356827,417.5123220843551,105288,258984.63333333333,63.47727412438214,65.79136792922972,NaN,NaN,NaN,NaN,2.8444342739050046,38.17046208575131,103460642
2025-09-15T11:25:00-04:00,421.35,423,421.35,422.41,NaN,NaN,NaN,425.35975111043183,NaN,NaN,406.5432000000001,431.8812584702027,381.2051415297976,417.80522713359943,419.7763527298296,422.00544899479485,417.5472564648644,101952,257758.13333333333,65.14716920623555,65.42660104978506,NaN,NaN,NaN,NaN,2.7612603971975047,38.1640735614821,103562594
2025-09-15T11:30:00-04:00,422.41,422.74,421.02,421.2,NaN,NaN,NaN,425.35975111043183,NaN,NaN,407.07780000000014,432.502173908505,381.6534260914953,417.80522713359943,419.80403220529985,422.02816863588055,417.57989577471915,97323,254329.46666666667,61.77077896916806,65.32063080081265,NaN,NaN,NaN,NaN,2.686884654540542,37.979096269865,103465271
2025-09-15T11:35:00-04:00,421.24,422.12,420.84,420.97,NaN,NaN,NaN,425.35975111043183,NaN,NaN,407.5986000000002,433.07305371659953,382.1241462834009,417.80522713359943,419.8215393754378,422.03859469208163,417.60448405879396,77624,250088.86666666667,61.122317688953174,65.15739362083376,NaN,NaN,NaN,NaN,2.586392893501934,37.7051570872773,103387647
2025-09-15T11:40:00-04:00,420.99,421.86,420.54,421.32,NaN,NaN,NaN,425.35975111043183,NaN,NaN,408.12160000000017,433.62764269108055,382.6155573089198,417.80522713359943,419.8368832115599,422.0467911498864,417.62697527323337,73019,247756.1,61.77985171357737,65.14360744720567,NaN,NaN,NaN,NaN,2.4959362582517954,37.27270218440894,103460666
2025-09-15T11:45:00-04:00,421.33,422.08,421.03,421.44,NaN,NaN,NaN,425.35975111043183,NaN,NaN,408.6500000000002,434.1431287997218,383.1568712002786,417.8352105817102,419.85564422363126,422.0602555300579,417.65103291720465,76243,245498.53333333333,62.01704614286365,64.97378841267246,NaN,NaN,NaN,NaN,2.3926550969480966,36.94175929023558,103536909
2025-09-15T11:50:00-04:00,421.47,421.8,420.01,420.87,NaN,NaN,NaN,425.35975111043183,NaN,NaN,409.16820000000024,434.58037178910666,383.7560282108938,417.8352105817102,419.87410504478,422.06331958799393,417.68489050156603,123645,241024.93333333332,60.1088252326083,64.6093428943811,NaN,NaN,NaN,NaN,2.349608304308948,35.99625465816844,103413264
2025-09-15T11:55:00-04:00,420.885,421.11,419.51,419.57,NaN,NaN,NaN,425.35975111043183,NaN,NaN,409.66100000000023,434.9047072554521,384.4172927445484,417.8352105817102,419.8760699004744,422.05397338276833,417.6981664181805,72924,234101.73333333334,55.88536105837869,63.899880275366414,NaN,NaN,NaN,NaN,2.2960648540011683,34.814862353423045,103340340
2025-09-15T12:00:00-04:00,419.6,420.17,418.77,419.36,NaN,NaN,NaN,425.35975111043183,NaN,NaN,410.1506000000003,435.17725248407965,385.1239475159209,417.8352105817102,419.86784899676155,422.02626529999543,417.7094326935277,132874,206089.7,55.21050228469984,62.964710140782,NaN,NaN,NaN,NaN,2.232060221572516,33.27508484931372,103207466
2025-09-15T12:05:00-04:00,419.34,419.88,418.67,419.6,NaN,NaN,NaN,425.35975111043183,NaN,NaN,410.6436000000003,435.42302235321375,385.8641776467868,417.8352105817102,419.86286273734197,422.01070063668925,417.7150248379947,74409,184528.33333333334,55.866436764182,61.99538448422751,NaN,NaN,NaN,NaN,2.1590559200316206,31.784656617843428,103281875
2025-09-15T12:10:00-04:00,419.59,421.08,419.1,420.95,NaN,NaN,NaN,425.35975111043183,NaN,NaN,411.1934000000003,435.6410238877902,386.74577611221036,417.8352105817102,419.8687659143896,422.0049316326313,417.73260019614787,84036,167577.13333333333,59.46266063253669,61.27189555848537,NaN,NaN,NaN,NaN,2.1462662114579305,30.953180714052397,103365911
2025-09-15T12:15:00-04:00,420.99,421.2,420.4,420.62,NaN,NaN,NaN,425.35975111043183,NaN,NaN,411.7268000000003,435.8072968187706,387.64630318123,417.8352105817102,419.878077597952,422.00468493073447,417.7514702651695,79020,154660.86666666667,58.21392793104619,60.95647038184412,NaN,NaN,NaN,NaN,2.0501043392109364,30.23482998876567,103286891
2025-09-15T12:20:00-04:00,420.64,420.9,418.92,419.1,NaN,NaN,NaN,425.35975111043183,NaN,NaN,412.24700000000024,435.81287778969954,388.68112221030094,417.8352105817102,419.8747223850942,421.98647794860966,417.7629668215787,105684,146222.66666666666,52.72192525774886,60.05399109349725,NaN,NaN,NaN,NaN,2.0450968864101524,28.60746066446242,103181207
2025-09-15T12:25:00-04:00,419.01,419.16,417.4,418.51,NaN,NaN,NaN,424.87726199531346,NaN,NaN,412.75980000000027,435.7249758939263,389.79462410607425,417.8352105817102,419.8391799829862,421.93865435049054,417.73970561548185,179786,143950.83333333334,50.72164754943882,58.82183746827282,NaN,NaN,NaN,NaN,2.024732823095145,26.87244445219184,103001421
2025-09-15T12:30:00-04:00,418.58,420.17,418.53,419.88,NaN,NaN,NaN,424.87726199531346,NaN,NaN,413.2910000000002,435.6537798808423,390.92822011915814,417.8352105817102,419.83586020938736,421.9243993812004,417.74732103757435,82447,138672.06666666668,54.991804825082724,58.21573251832286,NaN,NaN,NaN,NaN,1.998680478588351,25.18616538453947,103083868
2025-09-15T12:35:00-04:00,419.83,420.03,418.6,418.99,NaN,NaN,NaN,424.87726199531346,NaN,NaN,413.79680000000025,435.49851179973706,392.09508820026343,417.5287003227318,419.83068494657834,421.9113932161809,417.7499766769758,64368,131332.16666666666,51.84855792308846,57.26583171238378,NaN,NaN,NaN,NaN,1.958060444403465,23.620334821719414,103019500
2025-09-15T12:40:00-04:00,418.96,418.96,417.6,417.66,NaN,NaN,NaN,424.5998425374341,NaN,NaN,414.24780000000027,435.30507704711465,393.1905229528859,417.5287003227318,419.8119835738161,421.88943153566504,417.7345356119672,84175,127777.56666666667,47.48092610048007,56.245127936048924,NaN,NaN,NaN,NaN,1.9174846983746452,22.268151314131526,102935325
2025-09-15T12:45:00-04:00,417.66,417.83,416.7,417.38,NaN,NaN,NaN,423.45166787664164,NaN,NaN,414.69080000000025,435.0494501870557,394.3321498129448,417.5287003227318,419.7727026910205,421.8572198173134,417.68818556472763,125824,123861.4,46.59110354382773,55.207184068539966,NaN,NaN,NaN,NaN,1.8612357913478843,21.48550670201304,102809501
2025-09-15T12:50:00-04:00,417.36,417.61,416.62,417.405,NaN,NaN,NaN,423.15545570043065,NaN,NaN,415.1203000000002,434.7714754772845,395.4691245227159,417.5287003227318,419.73721255886693,421.8287739040116,417.64565121372226,112921,120287.93333333333,46.68717239726785,54.129135545946426,NaN,NaN,NaN,NaN,1.7990046633944647,20.800615942661945,102922422
2025-09-15T12:55:00-04:00,417.39,417.74,415.79,416.38,NaN,NaN,NaN,422.79679862313833,NaN,NaN,415.5263000000003,434.41104673483704,396.6415532651635,417.5287003227318,419.69517244064116,421.80322686855885,417.58711801272347,112005,115599.1,43.25203517369518,52.78877761957725,NaN,NaN,NaN,NaN,1.8097900445805735,20.597227315767945,102810417
2025-09-15T13:00:00-04:00,416.33,417.19,416,416.78,NaN,NaN,NaN,422.514898685723,NaN,NaN,415.9635000000003,433.90856218988523,398.01843781011536,417.5287003227318,419.6749426933752,421.7904487563336,417.5594366304168,55366,111929.83333333333,44.95416161721188,51.70630164704893,NaN,NaN,NaN,NaN,1.7655193271105323,20.408366447937798,102865783
2025-09-15T13:05:00-04:00,416.78,417.87,416.78,417.62,NaN,NaN,NaN,422.514898685723,NaN,NaN,416.43690000000026,433.247040140965,399.62675985903553,416.9729602581855,419.65505543714835,421.77170850939683,417.53840236489987,74105,110929.56666666667,48.450926033036914,51.17527057381023,NaN,NaN,NaN,NaN,1.7172679466026395,19.71644902374421,102939888
2025-09-15T13:10:00-04:00,417.64,418.07,417.25,418.06,NaN,NaN,NaN,422.514898685723,NaN,NaN,416.9293000000003,432.4055121993317,401.45308780066887,416.1226945652387,419.64472370832084,421.7600215747917,417.52942584184996,46821,108690.3,50.234251047829574,50.81982405689093,NaN,NaN,NaN,NaN,1.6531773789881647,18.923298822288924,102986709
2025-09-15T13:15:00-04:00,418,418.08,416.6,417.09,NaN,NaN,NaN,422.514898685723,NaN,NaN,417.4235000000003,431.2193263615798,403.62767363842073,416.1226945652387,419.62967179649473,421.7467454065508,417.51259818643865,53515,107441.36666666667,46.42154790532769,50.145189138401335,NaN,NaN,NaN,NaN,1.640807566203293,18.594818155020736,102933194
2025-09-15T13:20:00-04:00,417.08,417.97,416.6,417.69,NaN,NaN,NaN,422.514898685723,NaN,NaN,417.9111000000003,429.863615264944,405.95858473505666,416.0771556521909,419.61551232753646,421.7331448541253,417.4978798009476,54757,103694.13333333333,49.00004729842293,49.39785961453606,NaN,NaN,NaN,NaN,1.6214641686173439,18.289800392557417,102987951
2025-09-15T13:25:00-04:00,417.72,418.39,417.5,417.55,NaN,NaN,NaN,422.514898685723,NaN,NaN,418.3735000000004,428.26838923628617,408.4786107637146,415.3233729546395,419.60413774317806,421.7198961793825,417.4883793069736,54276,99735.13333333333,48.41456419447587,48.6979050619239,NaN,NaN,NaN,NaN,1.5692167280018183,17.641181927736774,102933675
2025-09-15T13:30:00-04:00,417.49,418.19,416.95,417.19,NaN,NaN,NaN,422.514898685723,NaN,NaN,418.7925000000003,426.4166259826052,411.1683740173954,415.3233729546395,419.58506290722823,421.701137217732,417.46898859672444,76589,96681,46.86390800283592,48.27947525800154,NaN,NaN,NaN,NaN,1.5457012474302605,17.423821579624647,102857086
2025-09-15T13:35:00-04:00,417.08,417.77,416.51,417.63,NaN,NaN,NaN,422.38943887107774,NaN,NaN,419.22510000000034,423.2159638110738,415.2342361889269,415.3233729546395,419.5701605814238,421.68730641483774,417.4530147480099,57037,93722,49.01337421037967,48.15745573378303,NaN,NaN,NaN,NaN,1.5252940154709553,17.518757028281133,102914123
2025-09-15T13:40:00-04:00,417.69,417.87,417.34,417.75,NaN,NaN,NaN,422.38943887107774,NaN,NaN,419.0989000000003,422.8628422363506,415.33495776365,415.3233729546395,419.55989474500444,421.67599335052665,417.44379613948223,47023,90937.06666666667,49.61203536704815,47.77318648678057,NaN,NaN,NaN,NaN,1.4542015857944608,17.50709809744701,102961146
2025-09-15T13:45:00-04:00,417.74,418.12,417.3,417.72,NaN,NaN,NaN,422.38943887107774,NaN,NaN,419.0733000000003,422.8569445973079,415.2896554026927,415.52126956222037,419.5469758426214,421.6612686050415,417.4326830802013,61860,84897.2,49.45569690815419,47.60226784285669,NaN,NaN,NaN,NaN,1.4089014725234272,17.238861059718023,102899286
2025-09-15T13:50:00-04:00,417.64,417.9,416.68,416.93,NaN,NaN,NaN,422.19460212106037,NaN,NaN,419.0809000000003,422.8457201495718,415.3160798504289,415.52126956222037,419.53065089623504,421.64679598833703,417.41450580413306,61146,83425.8,45.39863103625819,47.45353248112656,NaN,NaN,NaN,NaN,1.395408510200323,17.456740919530414,102838140
2025-09-15T13:55:00-04:00,416.92,417.12,416.23,416.26,NaN,NaN,NaN,421.4780292973758,NaN,NaN,419.0765000000003,422.85396171373253,415.29903828626806,415.52126956222037,419.4929527610491,421.6220680298549,417.36383749224325,113531,83811.76666666666,42.234221931039905,47.14232665164171,NaN,NaN,NaN,NaN,1.3593079023288706,17.97751634736006,102724609
2025-09-15T14:00:00-04:00,416.25,416.48,411.84,413.255,NaN,NaN,NaN,419.377437056586,NaN,NaN,418.9516000000003,423.0630058129179,414.8401941870828,415.52126956222037,419.31092938746497,421.6302377653891,416.99162100954084,301001,90601.03333333334,31.596599516608492,46.06442858873748,NaN,NaN,NaN,NaN,1.5936430521625258,20.450596608019136,102423608
2025-09-15T14:05:00-04:00,413.23,413.73,410.4,410.55,NaN,NaN,NaN,417.49937173583214,NaN,NaN,418.7862000000003,423.5232659947545,414.04913400524606,415.52126956222037,419.1617134931967,421.6934976675955,416.6299293187979,182898,94110.16666666667,25.39577982777108,44.78898177831432,NaN,NaN,NaN,NaN,1.717668548436634,23.138511867448486,102240710
2025-09-15T14:10:00-04:00,410.55,412.07,410.38,411.29,NaN,NaN,NaN,416.6428093842034,NaN,NaN,418.6508000000003,423.82957528366967,413.4720247163309,415.52126956222037,419.01522780218744,421.7408990960943,416.28955650828055,179144,97647.66666666667,29.47343611993034,43.683215671365645,NaN,NaN,NaN,NaN,1.7156922235483028,25.639602690835844,102419854
2025-09-15T14:15:00-04:00,411.33,411.84,409.3,409.67,NaN,NaN,NaN,416.08790895764866,NaN,NaN,418.4092000000003,424.0898874089984,412.7285125910022,415.52126956222037,418.85772724132426,421.7984848473124,415.9169696353361,177527,101023.8,26.10904700457317,42.087367169332516,NaN,NaN,NaN,NaN,1.7745713504377072,28.23476948012062,102242327
2025-09-15T14:20:00-04:00,409.69,410.27,408.03,408.055,NaN,NaN,NaN,414.7225494595737,NaN,NaN,418.13150000000024,424.4196772397673,411.8433227602332,415.52126956222037,418.7030264273647,421.8731308267997,415.5329220279297,153752,102027.36666666667,23.258668740085483,40.1605398616365,NaN,NaN,NaN,NaN,1.8078162539778717,30.92591913174231,102088575
2025-09-15T14:25:00-04:00,408.04,409.15,406.6,406.67,NaN,NaN,NaN,413.5419790295931,NaN,NaN,417.87110000000024,424.91275500140756,410.8294449985929,415.52126956222037,418.54985301378304,421.95706798370657,415.1426380438595,138438,104211.16666666667,21.128374942683138,38.35388465001904,NaN,NaN,NaN,NaN,1.8608293786937349,33.69654682854602,101950137
2025-09-15T14:30:00-04:00,406.65,407.76,406.58,407.23,NaN,NaN,NaN,412.74029816461154,NaN,NaN,417.6885000000002,425.325744332806,410.0512556671944,415.52126956222037,418.3903503911968,422.02801401529746,414.7526867670962,144536,104599.9,24.153297702358145,36.5791168217287,NaN,NaN,NaN,NaN,1.8121987087870401,36.27290215401696,102094673
2025-09-15T14:35:00-04:00,407.25,407.79,403.87,404.39,NaN,NaN,NaN,411.6816482480384,NaN,NaN,417.44650000000024,425.9392228259732,408.95377717402727,415.2110156497763,418.11070247555205,422.1748542801091,414.046550670995,225589,109639.23333333334,19.970256518878173,34.54738055918601,NaN,NaN,NaN,NaN,1.9627559438736812,39.089989788184354,101869084
2025-09-15T14:40:00-04:00,404.29,406.24,402.43,406.07,NaN,NaN,NaN,410.4402096913094,NaN,NaN,417.25150000000025,426.3133199606239,408.1896800393766,414.52381251982104,417.71109806536305,422.30797127406055,413.11422485666554,328467,117786.93333333333,27.922522710381983,33.194424466867865,NaN,NaN,NaN,NaN,2.094701947882704,41.88136072440978,102197551
2025-09-15T14:45:00-04:00,406.2,407.2,405.34,406.19,NaN,NaN,NaN,410.4402096913094,NaN,NaN,417.02150000000023,426.59637028627833,407.44662971372213,412.0830500158568,417.523151679598,422.3090603967257,412.7372429624703,180751,121177.96666666666,28.469272686583366,31.72698864373956,NaN,NaN,NaN,NaN,2.0779375230339405,43.61161429547884,102378302
2025-09-15T14:50:00-04:00,406.16,406.84,405.25,406.79,NaN,NaN,NaN,410.4402096913094,NaN,NaN,416.79070000000024,426.775827943043,406.8055720569575,408.54744001268546,417.4218953301132,422.3030050490803,412.54078561114613,100348,121000.1,31.276323456982936,30.417294935877756,NaN,NaN,NaN,NaN,2.043084842817229,45.23471728643224,102478650
2025-09-15T14:55:00-04:00,406.73,407.5,406.52,407.14,NaN,NaN,NaN,410.4402096913094,NaN,NaN,416.55770000000024,426.8832377021677,406.23216229783276,407.0789520101483,417.3042678552952,422.28028385656546,412.328251854025,127704,119264.03333333334,32.92976532315505,29.236871251234966,NaN,NaN,NaN,NaN,1.9671502111874282,46.137209090314,102606354
2025-09-15T15:00:00-04:00,407.09,407.88,406.61,407.55,NaN,NaN,NaN,410.4402096913094,NaN,NaN,416.29450000000026,426.85155437131755,405.73744562868296,406.5771616081187,417.2142786108587,422.25659409579816,412.1719631259192,102658,119937.73333333334,34.905494320933784,28.487361485854656,NaN,NaN,NaN,NaN,1.917353767531182,46.63027762991573,102709012
2025-09-15T15:05:00-04:00,407.61,409.17,407.58,408.92,NaN,NaN,NaN,410.4402096913094,NaN,NaN,416.04050000000024,426.68357836102604,405.39742163897444,404.9397292864949,417.11003829083353,422.2100801979468,412.00999638372025,138438,122406.73333333334,41.14437809362824,28.409515497468107,NaN,NaN,NaN,NaN,1.8961142127075266,45.988552934879415,102847450
2025-09-15T15:10:00-04:00,408.87,409.85,408.58,409.39,NaN,NaN,NaN,410.4402096913094,NaN,NaN,415.7935000000003,426.46920461369655,405.117795386304,405.52647285056673,417.0278682145991,422.16351729341636,411.89221913578183,121836,123662.1,43.1571760433557,29.235270963664334,NaN,NaN,NaN,NaN,1.851391768942706,44.861573339305615,102969286
2025-09-15T15:15:00-04:00,409.41,409.42,407.8,408.16,NaN,NaN,NaN,410.4402096913094,NaN,NaN,415.5709000000003,426.4086142774128,404.73318572258773,405.52647285056673,416.94776279895933,422.12542779143394,411.7700978064847,109664,123123.43333333333,39.36320017749218,30.232943845787272,NaN,NaN,NaN,NaN,1.8348637854467988,44.1269172955635,102859622
2025-09-15T15:20:00-04:00,408.155,408.2,406.81,407.95,NaN,NaN,NaN,410.4402096913094,NaN,NaN,415.30830000000026,426.2352597985382,404.3813402014623,405.52647285056673,416.860363589064,422.0911200982585,411.62960707986946,111343,123070.83333333333,38.73706639077109,30.894631722275896,NaN,NaN,NaN,NaN,1.8030878007720266,43.81282507748105,102748279
2025-09-15T15:25:00-04:00,407.99,408.42,407.44,407.71,NaN,NaN,NaN,410.4402096913094,NaN,NaN,415.00370000000026,425.9117993412566,404.09560065874393,405.52647285056673,416.80514636700246,422.06700225896213,411.5432904750428,73064,121772.8,37.99325995789671,31.743504076084715,NaN,NaN,NaN,NaN,1.7442958150025976,43.33651011074359,102675215
2025-09-15T15:30:00-04:00,407.72,408.17,406.43,407.25,NaN,NaN,NaN,410.4402096913094,NaN,NaN,414.72230000000025,425.6898806283288,403.7547193716717,405.52647285056673,416.69288680447266,422.0236481150222,411.36212549392314,142136,124665.13333333333,36.5448527037508,32.69251721634652,NaN,NaN,NaN,NaN,1.7439889710738412,43.27048265338037,102533079
2025-09-15T15:35:00-04:00,407.275,409.11,407.22,409.11,NaN,NaN,NaN,410.4402096913094,NaN,NaN,414.4563000000003,425.3097130686535,403.6028869313471,405.52647285056673,416.61151380255035,421.97781113059284,411.24521647450786,120645,126216.46666666666,45.57905849117327,34.438994612667244,NaN,NaN,NaN,NaN,1.7544183302828515,42.420929389705776,102653724
2025-09-15T15:40:00-04:00,409.08,409.6,408.74,409.1,NaN,NaN,NaN,410.4402096913094,NaN,NaN,414.2143000000003,424.9948062978867,403.4337937021139,405.92284049893897,416.5529288315936,421.93856151267005,411.16729615051713,96319,127866.4,45.541517791542915,35.966724619037585,NaN,NaN,NaN,NaN,1.6905313066912202,41.24086522778242,102557405
2025-09-15T15:45:00-04:00,409.08,409.44,408.55,409.21,NaN,NaN,NaN,410.4402096913094,NaN,NaN,413.97910000000024,424.67257103418797,403.2856289658125,406.0532723991512,416.4678526885978,421.88126951285574,411.0544358643399,141076,130785.1,46.06773259313735,37.83083005291324,NaN,NaN,NaN,NaN,1.6333504990704177,40.235651712253045,102698481
2025-09-15T15:50:00-04:00,409.02,411.23,408.85,411,404.7635178755037,404.7635178755037,404.7635178755037,NaN,NaN,NaN,413.77270000000027,424.28834628726173,403.2570537127388,407.33061791932096,416.32427999720903,421.7531414770857,410.89541851733236,298830,138920.86666666667,53.877765989446196,39.68477600141782,NaN,NaN,NaN,NaN,1.6866826062796731,37.9586574538471,102997311
2025-09-15T15:55:00-04:00,410.95,410.95,409.155,410.26,404.76426706298076,NaN,NaN,NaN,NaN,NaN,413.54910000000024,423.8768758863646,403.2213241136359,407.33061791932096,416.2050165296972,421.6484862172126,410.7615468421818,249233,145419.43333333332,50.614570162514205,41.26658296398431,NaN,NaN,NaN,NaN,1.6979909915454126,35.84430564247016,102748078
2025-09-16T09:30:00-04:00,414.47,417,413.18,413.64,409.1230503782998,NaN,NaN,NaN,NaN,NaN,413.40450000000027,423.5184672235395,403.290532776461,410.39639546836537,414.6066666666668,414.6066666666668,414.6066666666668,420986,156899.33333333334,61.95039997335575,43.45758842943951,NaN,NaN,NaN,NaN,2.0581344921493123,35.527637381205025,103169064
2025-09-16T09:35:00-04:00,413.61,414.34,411.5,412.5,409.1230503782998,NaN,NaN,NaN,NaN,NaN,413.2631000000002,423.2248636771343,403.30133632286606,410.39639546836537,413.68851759831927,414.6018382355678,412.7751969610707,425449,169179.73333333334,57.18287172252425,45.1899531722516,NaN,NaN,NaN,NaN,2.11398202842436,34.30527037095687,102743615
2025-09-16T09:40:00-04:00,412.52,413.59,411.66,412.87,409.1230503782998,NaN,NaN,NaN,NaN,NaN,413.13330000000025,422.94186413747315,403.32473586252735,410.39639546836537,413.4467632833894,414.34547795683255,412.5480486099462,276490,176828.63333333333,58.30442694932833,46.86130550285121,NaN,NaN,NaN,NaN,2.1008404549654736,33.17021529001216,103020105
2025-09-16T09:45:00-04:00,412.86,415.64,412.83,413.11,409.1230503782998,NaN,NaN,NaN,NaN,NaN,413.00350000000014,422.6365226304753,403.37047736952496,410.39639546836537,413.526183838721,414.3501797157831,412.7021879616589,267163,183672.06666666668,59.053652359192235,48.14053937896292,NaN,NaN,NaN,NaN,2.1514947081822258,32.83172314648199,103287268
2025-09-16T09:50:00-04:00,413.2,417.93,412.99,416.55,409.1230503782998,NaN,NaN,NaN,NaN,NaN,412.9155000000001,422.33455584436723,403.496444155633,410.39639546836537,413.96164528480676,415.12824422931124,412.7950463403023,325151,192472.23333333334,67.94472153385257,49.91107834256986,NaN,NaN,NaN,NaN,2.350673657597781,33.17529347636805,103612419
2025-09-16T09:55:00-04:00,416.57,417.84,414.85,416.05,409.66606968116173,NaN,NaN,NaN,NaN,NaN,412.82410000000016,422.02858036335164,403.6196196366487,410.39639546836537,414.22762075520916,415.546542833802,412.9086986766163,225954,196219.66666666666,65.711277991823,51.79308390073634,NaN,NaN,NaN,NaN,2.396339824912222,33.49432306840509,103386465
2025-09-16T10:00:00-04:00,415.99,419.57,415.62,418.98,410.68102105929074,NaN,NaN,NaN,NaN,NaN,412.8217000000002,422.01969382687486,403.6237061731255,411.5071750936592,414.6790213929008,416.428064852954,412.9299779328476,259428,194833.9,71.6022334569567,54.14059583403532,NaN,NaN,NaN,NaN,2.5073155517042056,34.241902328907095,103645893
2025-09-16T10:05:00-04:00,419.01,419.4,416.75,416.89,411.1139291929593,NaN,NaN,NaN,NaN,NaN,412.7893000000002,421.9180696892413,403.6605303107591,411.62474007492733,414.8956626831293,416.7507946299028,413.0405307363557,171224,194444.76666666666,63.25414945559823,55.94494508387114,NaN,NaN,NaN,NaN,2.5175072980110467,34.93608307080182,103474669
2025-09-16T10:10:00-04:00,416.79,417,414.36,414.71,411.1139291929593,NaN,NaN,NaN,NaN,NaN,412.68590000000023,421.6057965666129,403.76600343338754,411.62474007492733,414.928096472552,416.7206611237256,413.1355318213784,179499,194456.6,55.92936244653934,57.32955292264175,NaN,NaN,NaN,NaN,2.526256776724542,34.144416328649015,103295170
2025-09-16T10:15:00-04:00,414.74,415.14,413.28,413.945,411.1139291929593,NaN,NaN,NaN,NaN,NaN,412.5850000000002,421.3297883907501,403.84021160925033,411.62474007492733,414.88666272421824,416.64162380491,413.13170164352647,138186,193145.23333333334,53.58440990463477,57.90136373788899,NaN,NaN,NaN,NaN,2.478667006958504,32.84624686160525,103156984
2025-09-16T10:20:00-04:00,413.97,415.3,413.44,415,411.1139291929593,NaN,NaN,NaN,NaN,NaN,412.53180000000015,421.1843216578438,403.8792783421565,411.62474007492733,414.87716621767515,416.60555700350386,413.14877543184645,85949,190885.13333333333,56.30522721607456,58.67020012535555,NaN,NaN,NaN,NaN,2.434476506461469,31.70113872828187,103242933
2025-09-16T10:25:00-04:00,415,417.42,414.81,416.19,411.1139291929593,NaN,NaN,NaN,NaN,NaN,412.50800000000015,421.11346663460995,403.90253336539035,411.62474007492733,414.93640413733914,416.6447662676431,413.2280420070352,136602,190823.93333333332,59.20972671665867,59.60891399132135,NaN,NaN,NaN,NaN,2.4470138988570795,31.383189441168685,103379535
2025-09-16T10:30:00-04:00,416.12,417.78,416.075,417.73,411.1139291929593,NaN,NaN,NaN,NaN,NaN,412.5145000000001,421.13522972547355,403.8937702745267,411.7236708277522,415.007746283059,416.7346967752763,413.28079579084175,94984,189172.2,62.66816187548405,60.23679941175262,NaN,NaN,NaN,NaN,2.394012906081573,31.204486167457183,103474519
2025-09-16T10:35:00-04:00,417.75,418.7,417.03,417.6,411.1139291929593,NaN,NaN,NaN,NaN,NaN,412.5389000000001,421.21001395147584,403.8677860485244,413.01993666220176,415.1044813869492,416.8755433155255,413.33341945837293,108858,185281.16666666666,62.18882297576123,61.063531755555985,NaN,NaN,NaN,NaN,2.3422976985043187,31.333850221187426,103365661
2025-09-16T10:40:00-04:00,417.6,418.82,417.2,418.72,411.34008488936985,NaN,NaN,NaN,NaN,NaN,412.5777000000001,421.3412449927165,403.8141550072837,413.4659493297614,415.2095566826162,417.0401016952526,413.37901166997983,107802,177925.66666666666,64.69435103451507,61.259528259924515,NaN,NaN,NaN,NaN,2.29070500575401,31.492726869189863,103473463
2025-09-16T10:45:00-04:00,418.74,421.08,417.76,420.98,412.60053557621666,NaN,NaN,NaN,NaN,NaN,412.6449000000001,421.611257452138,403.67854254786226,415.1367594638091,415.57846896625244,417.74609248789454,413.41084544461035,272673,180989.73333333334,69.13834433136167,62.11349058912719,NaN,NaN,NaN,NaN,2.3642260767715806,32.30987550742435,103746136
2025-09-16T10:50:00-04:00,420.99,421.13,419.69,419.855,413.7041475954795,NaN,NaN,NaN,NaN,NaN,412.6808000000001,421.74740848605387,403.6141915139463,415.6554075710473,415.7479488313946,418.04707540622906,413.4488222565601,132357,182056.7,64.76797366137133,62.57517249713026,NaN,NaN,NaN,NaN,2.298209928430753,33.0823135949864,103613779
2025-09-16T10:55:00-04:00,419.93,420.17,418.08,418.49,413.7041475954795,NaN,NaN,NaN,NaN,NaN,412.7088000000001,421.83813262836657,403.57946737163365,415.6554075710473,415.84625167420563,418.17505535848983,413.51744798992144,116305,181676.73333333334,59.82648716273035,62.63037498309727,NaN,NaN,NaN,NaN,2.2833377906857018,32.7354517944568,103497474
2025-09-16T11:00:00-04:00,418.51,418.53,416.83,417.28,413.7041475954795,NaN,NaN,NaN,NaN,NaN,412.70060000000007,421.8127417109104,403.5884582890897,415.6554075710473,415.89373528456485,418.20682172477433,413.5806488443554,107584,181840.93333333332,55.764901259339624,61.760387820632054,NaN,NaN,NaN,NaN,2.2416708056367223,31.68006190141086,103389890
2025-09-16T11:05:00-04:00,417.35,417.84,416.57,416.84,413.7041475954795,NaN,NaN,NaN,NaN,NaN,412.68640000000005,421.7704385379804,403.6023614620197,415.6554075710473,415.91682478081674,418.2132252297338,413.6204243318997,76258,179768.26666666666,54.320726665479974,60.94677701160755,NaN,NaN,NaN,NaN,2.172265748091241,30.55161044973414,103313632
2025-09-16T11:10:00-04:00,416.86,419.65,416.75,419.63,413.7041475954795,NaN,NaN,NaN,NaN,NaN,412.7352,421.94088975361444,403.5295102463856,415.6554075710473,416.00131528826154,418.311738174357,413.69089240216607,124079,179843.03333333333,61.18499993179906,60.202688902667724,NaN,NaN,NaN,NaN,2.2242467660847223,30.204792571116997,103437711
2025-09-16T11:15:00-04:00,419.59,420.84,419.11,419.91,413.7041475954795,NaN,NaN,NaN,NaN,NaN,412.7808000000001,422.10484962660433,403.4567503733959,415.7514535528808,416.1474314304047,418.53422765304634,413.7606352077631,155602,181374.3,61.8053213123493,60.09920117814995,NaN,NaN,NaN,NaN,2.1889434256500966,30.287732420234597,103593313
2025-09-16T11:20:00-04:00,419.96,420.97,419.38,419.48,413.7311045075127,NaN,NaN,NaN,NaN,NaN,412.81540000000007,422.22539571516756,403.40540428483257,416.1041628423047,416.2728532344973,418.71599147981397,413.8297149891806,143809,182456.5,60.21381483943368,60.405233491928115,NaN,NaN,NaN,NaN,2.1461617523893777,30.408366128775853,103449504
2025-09-16T11:25:00-04:00,419.52,420.44,418.56,418.6,413.7311045075127,NaN,NaN,NaN,NaN,NaN,412.833,422.28283068629923,403.3831693137008,416.1041628423047,416.3316413818366,418.78473564383484,413.8785471198384,89204,182994.5,56.980079368069596,60.64778131074488,NaN,NaN,NaN,NaN,2.127150198647279,29.983111055006113,103360300
2025-09-16T11:30:00-04:00,418.61,419.1,417.85,418.35,413.7311045075127,NaN,NaN,NaN,NaN,NaN,412.86140000000006,422.3686721723681,403.354127827632,416.1041628423047,416.36663833582514,418.81404398804943,413.91923268360085,75213,180763.73333333334,56.05900279660464,60.63019385221131,NaN,NaN,NaN,NaN,2.064496613029616,29.139640535783055,103285087
2025-09-16T11:35:00-04:00,418.39,419.13,417.96,419.13,413.7311045075127,NaN,NaN,NaN,NaN,NaN,412.91880000000015,422.54141057297943,403.29618942702086,416.1041628423047,416.4024386418621,418.84848207368003,413.95639521004415,69176,179048.1,58.322666407168,60.56683240153341,NaN,NaN,NaN,NaN,2.000603997813216,28.369807855153045,103354263
2025-09-16T11:40:00-04:00,419.17,419.36,417.46,417.82,413.7311045075127,NaN,NaN,NaN,NaN,NaN,413.0101000000001,422.7298731434154,403.2903268565848,416.1041628423047,416.4283674386218,418.86634666566715,413.9903882115765,66617,178058.03333333333,53.35158700958739,59.901362768255076,NaN,NaN,NaN,NaN,1.993417997969417,27.321048812102312,103287646
2025-09-16T11:45:00-04:00,417.83,418.43,417.07,418.15,413.7311045075127,NaN,NaN,NaN,NaN,NaN,413.1621000000001,422.960614803756,403.36358519624423,416.1041628423047,416.448125825709,418.8753432189874,414.0209084324306,64052,175490.56666666668,54.40585194331944,59.3454362659378,NaN,NaN,NaN,NaN,1.9481738552573167,26.086442190056612,103351698
2025-09-16T11:50:00-04:00,418.07,418.9,417.63,418.81,413.7311045075127,NaN,NaN,NaN,NaN,NaN,413.31250000000017,423.2216842751653,403.40331572483507,416.1041628423047,416.470714993825,418.8934056595235,414.04802432812653,53921,167326.93333333332,56.52223733298974,58.761713858685994,NaN,NaN,NaN,NaN,1.8997328655960786,25.197108419674187,103405619
2025-09-16T11:55:00-04:00,418.76,419.63,418.39,419.63,413.7311045075127,NaN,NaN,NaN,NaN,NaN,413.51170000000013,423.5199291360362,403.5034708639641,416.1041628423047,416.5121793677279,418.9397173105334,414.08464142492244,73141,161457.2,59.064609842097376,58.04216139516711,NaN,NaN,NaN,NaN,1.8526090894820737,24.758222349968282,103478760
2025-09-16T12:00:00-04:00,419.59,420.62,418.17,418.42,413.7311045075127,NaN,NaN,NaN,NaN,NaN,413.71900000000016,423.69587446043084,403.7421255395695,416.38630290184517,416.57820600590406,419.0082979904051,414.14811402140305,128347,151702.56666666668,54.04273888774264,57.27607319705078,NaN,NaN,NaN,NaN,1.8952798688047818,24.835890729811585,103350413
2025-09-16T12:05:00-04:00,418.32,420.2,418.1,419.98,413.7311045075127,NaN,NaN,NaN,NaN,NaN,413.9852000000002,423.9056592554468,404.0647407445536,416.38630290184517,416.6186350494123,419.05483223982515,414.1824378589995,71586,139907.13333333333,58.89512601152392,57.20954740053604,NaN,NaN,NaN,NaN,1.9099027353187237,24.850936816308685,103421999
2025-09-16T12:10:00-04:00,419.99,420.25,419.08,419.85,413.84572058750587,NaN,NaN,NaN,NaN,NaN,414.23760000000016,424.0997367339505,404.3754632660498,416.38630290184517,416.6548670236757,419.0996913546591,414.2100426926923,59490,132673.8,58.34230023023481,57.393647327028546,NaN,NaN,NaN,NaN,1.857052539938816,24.890929956575878,103362509
2025-09-16T12:15:00-04:00,419.82,420.55,419.44,420.48,414.2888696517102,NaN,NaN,NaN,NaN,NaN,414.55940000000015,424.1618427391714,404.9569572608289,416.68734708574476,416.70290968778943,419.16483788292743,414.24098149265143,70986,126134.56666666667,60.2877298666124,57.81986184139515,NaN,NaN,NaN,NaN,1.8036916442289017,25.090294996380415,103433495
2025-09-16T12:20:00-04:00,420.45,420.48,419.67,419.89,414.5177846675416,NaN,NaN,NaN,NaN,NaN,414.83580000000006,424.2384033330889,405.4331966669112,416.9848776685958,416.7308393948686,419.2009877162413,414.26069107349593,44025,116763.7,57.57593170488364,57.56207125375834,NaN,NaN,NaN,NaN,1.7327136696411232,25.27541967619891,103389470
2025-09-16T12:25:00-04:00,419.85,420.4,419.77,420.18,414.6944762735624,NaN,NaN,NaN,NaN,NaN,415.11560000000014,424.30258245122315,405.92861754877714,417.2889021348766,416.7622560379787,419.2422562010215,414.2822558749359,48872,110860.96666666666,58.5625565638285,57.33044520029256,NaN,NaN,NaN,NaN,1.6539484075239,25.447321164601806,103438342
2025-09-16T12:30:00-04:00,420.16,421.66,420.09,421.02,415.5154091702186,NaN,NaN,NaN,NaN,NaN,415.40020000000004,424.41798042754374,406.38241957245634,418.3861217079013,416.85985321692465,419.39021458792126,414.32949184592803,126504,106430.16666666667,61.36529947131458,57.41269410256977,NaN,NaN,NaN,NaN,1.6479520927007678,26.31839446136951,103564846
2025-09-16T12:35:00-04:00,421.04,422.12,420.44,422.02,415.9349360261178,NaN,NaN,NaN,NaN,NaN,415.6978000000001,424.5867464302178,406.8088535697824,418.660897366321,416.95158430011617,419.5393543097088,414.3638142905235,108141,104327.4,64.44818555408737,57.94613025871389,NaN,NaN,NaN,NaN,1.6502412289364279,27.35604919003692,103672987
2025-09-16T12:40:00-04:00,422.05,422.06,420.26,420.53,415.9349360261178,NaN,NaN,NaN,NaN,NaN,415.95740000000006,424.63500802060446,407.27979197939567,418.660897366321,417.0124003500614,419.6266245279973,414.3981761721255,84973,101176.53333333334,57.132812436305045,58.02283094726393,NaN,NaN,NaN,NaN,1.660938284012398,28.106423729917452,103588014
2025-09-16T12:45:00-04:00,420.6,420.98,419.34,419.55,415.9349360261178,NaN,NaN,NaN,NaN,NaN,416.1700000000001,424.66650681158865,407.6734931884115,418.660897366321,417.05418383340424,419.6730494212207,414.4353182455878,80424,99251.13333333333,52.881218930512475,57.63415612750282,NaN,NaN,NaN,NaN,1.6594426922972298,27.774707175627032,103507590
2025-09-16T12:50:00-04:00,419.66,419.79,418.62,418.82,415.9349360261178,NaN,NaN,NaN,NaN,NaN,416.3586000000001,424.6611704549442,408.05602954505594,418.660897366321,417.07521386038167,419.688493885301,414.46193383546233,59546,98371.03333333334,49.902238650382664,57.38777410184533,NaN,NaN,NaN,NaN,1.624482499990286,26.753202223505205,103448044
2025-09-16T12:55:00-04:00,418.78,419.12,418.1,418.74,415.9349360261178,NaN,NaN,NaN,NaN,NaN,416.57020000000006,424.5595616665836,408.5808383334165,418.660897366321,417.0894652274165,419.69519884280066,414.48373161203233,52186,95557.16666666667,49.57265914546011,57.042546044855385,NaN,NaN,NaN,NaN,1.5813051785624073,25.324822452630002,103395858
2025-09-16T13:00:00-04:00,418.68,420.08,418.52,420.08,415.9349360261178,NaN,NaN,NaN,NaN,NaN,416.81280000000004,424.4701721758556,409.15542782414445,418.660897366321,417.1250453048945,419.7286385365229,414.5214520732661,84441,95205.73333333334,54.940791572903656,56.929585633420665,NaN,NaN,NaN,NaN,1.579783380093664,24.699843047314925,103480299
2025-09-16T13:05:00-04:00,420.05,420.26,419.65,420.13,415.9349360261178,NaN,NaN,NaN,NaN,NaN,417.0612000000001,424.3165405322876,409.8058594677126,418.660897366321,417.1494646234859,419.75548079068983,414.543448456282,49994,93243.6,55.13271889138923,56.64873627979865,NaN,NaN,NaN,NaN,1.5105131386584034,24.243576347264113,103530293
2025-09-16T13:10:00-04:00,420.155,420.76,419.74,419.74,415.9349360261178,NaN,NaN,NaN,NaN,NaN,417.31100000000004,424.03882817851087,410.5831718214892,418.660897366321,417.1841289951862,419.7939894212272,414.5742685691452,70783,92009.63333333333,53.22824649212433,56.5905582515402,NaN,NaN,NaN,NaN,1.4754764858970877,24.162016948400332,103459510
2025-09-16T13:15:00-04:00,419.72,419.74,418.8,418.97,415.9349360261178,NaN,NaN,NaN,NaN,NaN,417.50820000000004,423.8286264919066,411.18777350809347,418.660897366321,417.20082841308874,419.8060112965155,414.59564552966197,50747,84612.1,49.58626705710789,55.925639754796194,NaN,NaN,NaN,NaN,1.437228165475867,23.153230965090277,103408763
2025-09-16T13:20:00-04:00,418.99,419.14,418.47,418.59,415.9349360261178,NaN,NaN,NaN,NaN,NaN,417.69800000000004,423.54962302269297,411.8463769773071,418.660897366321,417.21558647650807,419.81251121203337,414.61866174098276,58680,82156.2,47.84637647326758,55.17593091501282,NaN,NaN,NaN,NaN,1.382426153656159,21.913337873922963,103350083
2025-09-16T13:25:00-04:00,418.63,419.22,418.39,418.77,415.9349360261178,NaN,NaN,NaN,NaN,NaN,417.8892000000001,423.2205699402146,412.55783005978554,418.39271789305684,417.2273363860306,419.8181265877595,414.63654618430166,45720,79803.36666666667,48.76347040654617,54.35276952500809,NaN,NaN,NaN,NaN,1.3429671426807221,20.762008574981884,103395803
2025-09-16T13:30:00-04:00,418.8,419.48,418.25,418.54,415.9349360261178,NaN,NaN,NaN,NaN,NaN,418.04,422.9967670915214,413.08323290847864,417.77601039935746,417.24388537034287,419.8254732089995,414.66229753168625,67159,78455.86666666667,47.611396689571606,53.641017023914365,NaN,NaN,NaN,NaN,1.3348980610606718,19.921999142114892,103328644
2025-09-16T13:35:00-04:00,418.6,418.98,418.02,418.3,415.9349360261178,NaN,NaN,NaN,NaN,NaN,418.2008,422.63129088019133,413.7703091198087,417.77601039935746,417.25414940349896,419.8269277749241,414.6813710320738,54022,77714.66666666667,46.38003724710835,52.77083707272006,NaN,NaN,NaN,NaN,1.3081196281277694,18.89740682181956,103274622
2025-09-16T13:40:00-04:00,418.22,419.06,417.85,418.75,415.9349360261178,NaN,NaN,NaN,NaN,NaN,418.30300000000005,422.53945228928734,414.06654771071277,417.77601039935746,417.2702360233144,419.8310698368875,414.7094022097413,78488,76194.96666666666,49.04124446238303,51.89054742922496,NaN,NaN,NaN,NaN,1.3011110832614985,17.762030393988937,103353110
2025-09-16T13:45:00-04:00,418.7,419.03,417.7,417.79,415.9349360261178,NaN,NaN,NaN,NaN,NaN,418.4088,422.3113404853107,414.50625951468925,417.77601039935746,417.27727505449127,419.8293454011508,414.7252047078317,49795,72668.06666666667,44.02171980293073,50.4315141612852,NaN,NaN,NaN,NaN,1.3031745773142476,16.541068269012328,103303315
2025-09-16T13:50:00-04:00,417.73,418.33,417.5,418.09,415.9349360261178,NaN,NaN,NaN,NaN,NaN,418.5132,422.0825264125998,414.94387358740016,417.77601039935746,417.282113337498,419.8259559505922,414.73827072440383,44718,69365.03333333334,45.88572724216898,49.62815093313263,NaN,NaN,NaN,NaN,1.2693763932203717,15.538357898771654,103348033
2025-09-16T13:55:00-04:00,418.12,418.27,417.6,417.92,415.9349360261178,NaN,NaN,NaN,NaN,NaN,418.60940000000005,421.83362991728495,415.38517008271515,417.77601039935746,417.2871289234961,419.8217420315649,414.7525158154273,50192,68064.63333333333,44.971863754524065,49.063196991990594,NaN,NaN,NaN,NaN,1.2265637937046279,14.607269697833885,103297841
2025-09-16T14:00:00-04:00,417.94,418.68,417.75,418.6,415.9349360261178,NaN,NaN,NaN,NaN,NaN,418.6504,421.8205185087927,415.4802814912073,416.882808319486,417.2966707987893,419.821787266466,414.7715543311126,59107,67527.76666666666,49.319832586761216,49.021596558874776,NaN,NaN,NaN,NaN,1.2053806655828692,13.895318967859465,103356948
2025-09-16T14:05:00-04:00,418.61,419.08,418.2,418.92,415.9349360261178,NaN,NaN,NaN,NaN,NaN,418.7077999999999,421.7902212301329,415.6253787698669,416.8557178595768,417.30578075395636,419.8254605354446,414.7861009724681,41752,66613.63333333333,51.27108783227139,49.142912893647015,NaN,NaN,NaN,NaN,1.1821391894698066,13.698908742100649,103398700
2025-09-16T14:10:00-04:00,418.95,419.25,418.7,419.02,415.9349360261178,NaN,NaN,NaN,NaN,NaN,418.7086,421.79132414591095,415.62587585408903,417.0664469008518,417.3288667032059,419.83886887165926,414.81886453475255,91508,67443.33333333333,51.89440110332359,48.92531357439129,NaN,NaN,NaN,NaN,1.1369863902219641,13.708701286328715,103490208
2025-09-16T14:15:00-04:00,419.02,419.77,419,419.69,415.9349360261178,NaN,NaN,NaN,NaN,NaN,418.7646,421.8147002212757,415.71449977872425,417.63815752068143,417.3429369821862,419.8507633083193,414.8351106560531,43817,66768.83333333333,55.95915954535393,48.98434504967448,NaN,NaN,NaN,NaN,1.1107730766346797,14.275992243907416,103534025
2025-09-16T14:20:00-04:00,419.74,419.77,419.16,419.4,415.9349360261178,NaN,NaN,NaN,NaN,NaN,418.85839999999996,421.6841802037397,416.03261979626024,417.7595260165452,417.3525007631582,419.8586037990021,414.84639772731435,30737,65996.03333333334,53.8386456586384,49.02794499013977,NaN,NaN,NaN,NaN,1.075003571160771,14.802762418801924,103503288
2025-09-16T14:25:00-04:00,419.385,420.14,418.8,418.87,415.9349360261178,NaN,NaN,NaN,NaN,NaN,418.9569,421.4094324788214,416.50436752117866,417.86162081323613,417.3704403991874,419.8716142396486,414.86926655872617,63752,65683.06666666667,50.101954847736764,49.064779832327545,NaN,NaN,NaN,NaN,1.0939318875064286,15.681596179113935,103439536
2025-09-16T14:30:00-04:00,418.9,419.01,418.41,418.78,415.9349360261178,NaN,NaN,NaN,NaN,NaN,419.0325,421.2101117651416,416.85488823485844,417.86162081323613,417.37902925511025,419.8746410927268,414.8834174174937,43215,62845.333333333336,49.474010040114706,49.181039372816635,NaN,NaN,NaN,NaN,1.0586510383988241,15.832595570152645,103396321
2025-09-16T14:35:00-04:00,418.84,418.97,418.39,418.87,415.9349360261178,NaN,NaN,NaN,NaN,NaN,419.0861,421.10754234637784,417.06465765362213,417.86162081323613,417.38506768769247,419.8767969387562,414.89333843662877,30486,61475.333333333336,50.1468993985978,49.27985572939175,NaN,NaN,NaN,NaN,1.0244616785131968,15.938907757312059,103426807
2025-09-16T14:40:00-04:00,418.89,419.29,418.68,418.99,415.9349360261178,NaN,NaN,NaN,NaN,NaN,419.11129999999997,421.09556491171395,417.127035088286,417.86162081323613,417.39376815510605,419.8815072147547,414.90602909545737,37622,60746.4,51.082343607708324,49.52778050925866,NaN,NaN,NaN,NaN,0.9948572729051123,16.421015155588993,103464429
2025-09-16T14:45:00-04:00,419,419.43,418.66,419.02,415.9349360261178,NaN,NaN,NaN,NaN,NaN,419.1397,421.0767146203987,417.2026853796013,417.86162081323613,417.4028925263921,419.88671639765835,414.9190686551259,38678,59669.46666666667,51.328226086996594,49.881222569250674,NaN,NaN,NaN,NaN,0.9787960391261744,17.032581770357222,103503107
2025-09-16T14:50:00-04:00,419.07,419.85,419.05,419.7,416.00910869200754,NaN,NaN,NaN,NaN,NaN,419.15930000000003,421.0987617912139,417.21983820878614,417.91386070808124,417.42257076558246,419.90328284124683,414.9418586899181,64926,60366.166666666664,56.647457180744034,50.42452347770503,NaN,NaN,NaN,NaN,0.9681677506171649,18.069303031030763,103568033
2025-09-16T14:55:00-04:00,419.73,420.25,419.47,420.12,416.46914920600716,NaN,NaN,NaN,NaN,NaN,419.14209999999997,421.03127134210916,417.2529286578908,418.31108856646495,417.4424410172381,419.9234180130486,414.96146402142756,55774,60596.23333333333,59.585347597334334,51.53621117730529,NaN,NaN,NaN,NaN,0.9547271970016512,19.43462470527567,103623807
2025-09-16T15:00:00-04:00,420.14,420.42,419.46,419.96,416.5723696966432,NaN,NaN,NaN,NaN,NaN,419.14419999999996,421.036766891767,417.2516331082329,418.38887085317197,417.4600333404203,419.94111204988536,414.97895463095523,50124,58050.23333333333,57.9735652256468,52.399628176125134,NaN,NaN,NaN,NaN,0.9551038257872502,20.865395207079015,103573683
2025-09-16T15:05:00-04:00,419.95,420.52,419.72,419.8,416.7963528922503,NaN,NaN,NaN,NaN,NaN,419.1703999999999,421.06228566250593,417.2785143374939,418.49509668253756,417.47744152629815,419.9589586910575,414.9959243615388,48980,56078.2,56.33255584518771,53.21110618260111,NaN,NaN,NaN,NaN,0.9440249810881577,22.291220277493085,103524703
2025-09-16T15:10:00-04:00,419.86,420.3,419.51,420.22,416.7963528922503,NaN,NaN,NaN,NaN,NaN,419.2292,421.0643145576798,417.3940854423202,418.49509668253756,417.50266076221044,419.9845632445858,415.0207582798351,72258,55654.36666666667,59.567905927644034,53.94311142123559,NaN,NaN,NaN,NaN,0.9330231967247193,23.128301188058035,103596961
2025-09-16T15:15:00-04:00,420.23,420.95,420,420.46,417.2142595567818,NaN,NaN,NaN,NaN,NaN,419.3016,421.03688261670277,417.56631738329725,418.863061876824,417.5304003745749,420.0171249636517,415.0436757854981,68474,55256.03333333333,61.33099067226249,54.66167590980639,NaN,NaN,NaN,NaN,0.9342358255300958,24.56044719134734,103665435
2025-09-16T15:20:00-04:00,420.47,420.67,420.13,420.25,417.2142595567818,NaN,NaN,NaN,NaN,NaN,419.314,421.0672598209182,417.56074017908185,418.863061876824,417.54718874617697,420.0359704633487,415.05840702900525,43874,54733.63333333333,58.91034482913258,55.16281474736417,NaN,NaN,NaN,NaN,0.906076123706519,25.890297051544554,103621561
2025-09-16T15:25:00-04:00,420.24,420.83,419.71,420.56,417.2142595567818,NaN,NaN,NaN,NaN,NaN,419.32700000000006,421.107176395649,417.5468236043511,418.863061876824,417.57068621368495,420.06229451911025,415.07907790825965,61926,55058.3,61.33629473097414,55.546895832051334,NaN,NaN,NaN,NaN,0.9213564005846252,26.160796662398095,103683487
2025-09-16T15:30:00-04:00,420.56,422.56,420.49,422.31,418.19384886883506,NaN,NaN,NaN,NaN,NaN,419.3836,421.3498665535985,417.4173334464015,419.8356876809339,417.67595422505264,420.2226833643963,415.129225085709,190283,58586.36666666667,71.54843081741757,56.81188048624985,NaN,NaN,NaN,NaN,1.0034023719714373,27.89338736250263,103873770
2025-09-16T15:35:00-04:00,422.35,423.24,421.87,422.81,419.1884466475244,NaN,NaN,NaN,NaN,NaN,419.46780000000007,421.6421828180883,417.2934171819118,420.37555014474714,417.79908681556606,420.4298705832168,415.1683030479153,193842,63381.3,73.68689444979968,58.496519029254344,NaN,NaN,NaN,NaN,1.0295879168306208,29.895290888413268,104067612
2025-09-16T15:40:00-04:00,422.81,423.17,422.25,422.31,419.3710172544552,NaN,NaN,NaN,NaN,NaN,419.547,421.8381001723237,417.25589982767633,420.4184401157977,417.8601244070772,420.5285486111044,415.19170020305,101131,64392.9,68.16907213663163,59.83188060757698,NaN,NaN,NaN,NaN,1.0217602084855775,31.75420130533028,103966481
2025-09-16T15:45:00-04:00,422.29,422.9,421.88,422.45,419.3710172544552,NaN,NaN,NaN,NaN,NaN,419.6134,422.040700096756,417.18609990324404,420.4184401157977,417.9320544878991,420.63945493980617,415.22465403599205,127153,66939.76666666666,68.87193768980792,61.169383342663416,NaN,NaN,NaN,NaN,1.021634479308035,32.75137483653011,104093634
2025-09-16T15:50:00-04:00,422.52,423.03,420.91,421.65,419.3710172544552,NaN,NaN,NaN,NaN,NaN,419.69000000000005,422.1277924438939,417.2522075561062,420.4184401157977,418.0114591985679,420.7478475280799,415.27507086905587,165802,70510.5,60.632875837454215,61.85156421621669,NaN,NaN,NaN,NaN,1.1000891593574573,32.05395705233119,103927832
2025-09-16T15:55:00-04:00,421.83,421.88,421.16,421.65,419.3710172544552,NaN,NaN,NaN,NaN,NaN,419.76,422.21781040760607,417.3021895923939,420.4184401157977,418.08873066521585,420.8443449793968,415.3331163510349,182554,75071.63333333333,60.632875837454215,62.51618205553508,NaN,NaN,NaN,NaN,1.0729399336890653,31.406354824146476,103927832
2025-09-17T09:30:00-04:00,415.78,417.2,413.13,413.94,NaN,NaN,NaN,419.5769647024465,419.5769647024465,419.5769647024465,419.6626,422.6020688227027,416.7231311772973,420.4184401157977,414.75666666666666,414.75666666666666,414.75666666666666,288489,82449.3,25.94345559862552,60.32303908538377,NaN,NaN,NaN,NaN,1.6048727955684166,32.78839248973892,103639343
2025-09-17T09:35:00-04:00,413.9,414.39,410.2,410.65,NaN,NaN,NaN,417.0777844886989,NaN,NaN,419.483,423.35721269416695,415.60878730583306,420.4184401157977,413.19530084791944,414.69924496074185,411.69135673509703,310939,91013.2,20.542521997699723,57.53426582826701,NaN,NaN,NaN,NaN,1.789524738742101,34.74244185646235,103328404
2025-09-17T09:40:00-04:00,410.62,413.67,409.67,412.85,NaN,NaN,NaN,416.78083973921264,NaN,NaN,419.37160000000006,423.6598655887468,415.0833344112533,420.4184401157977,412.8361843179822,414.185932643244,411.48643599272043,278533,97681.36666666667,30.90158692912655,55.60055309280127,NaN,NaN,NaN,NaN,1.9474158288319507,36.65887370241022,103606937
2025-09-17T09:45:00-04:00,412.83,415.2,412.09,414.9,NaN,NaN,NaN,416.78083973921264,NaN,NaN,419.2700000000001,423.73295148970504,414.80704851029515,420.4184401157977,413.0454623279636,414.35852944723365,411.73239520869356,180512,102038.6,38.89575093358464,54.355067027686765,NaN,NaN,NaN,NaN,2.030457555343955,37.28215544339047,103787449
2025-09-17T09:50:00-04:00,414.93,415.8,414.28,414.29,NaN,NaN,NaN,416.78083973921264,NaN,NaN,419.15880000000004,423.83058704987747,414.4870129501226,420.4184401157977,413.2409257944977,414.5950875415096,411.88676404748577,133559,104999.96666666666,37.50529193200366,52.779166027998166,NaN,NaN,NaN,NaN,1.993996301390818,37.43936152710311,103653890
2025-09-17T09:55:00-04:00,414.27,416.3,414.27,416.19,NaN,NaN,NaN,416.78083973921264,NaN,NaN,419.0730000000001,423.8018057688502,414.34419423114997,420.4184401157977,413.49080331736565,414.9612197559868,412.0203868787445,142119,108064.2,44.19679415063554,51.55529484788196,NaN,NaN,NaN,NaN,1.9965679941486187,37.235135234077475,103796009
2025-09-17T10:00:00-04:00,416.18,416.43,414.87,415.92,NaN,NaN,NaN,416.78083973921264,NaN,NaN,418.9936000000001,423.7975879433177,414.18961205668245,420.18875209263814,413.68200687788163,415.2220778294152,412.1419359263481,123953,110225.73333333334,43.48425737080901,50.45343145800171,NaN,NaN,NaN,NaN,1.965384565995146,36.95180838623608,103672056
2025-09-17T10:05:00-04:00,416.1,416.19,414.67,414.84,NaN,NaN,NaN,416.78083973921264,NaN,NaN,418.88680000000005,423.81632969760153,413.95727030239857,419.8010016741105,413.79285458012066,415.32974025053426,412.25596890970706,112204,112574.13333333333,40.66046029851939,48.97658614139779,NaN,NaN,NaN,NaN,1.9335713827097771,36.76446323645804,103559852
2025-09-17T10:10:00-04:00,414.77,416.31,414.74,415.84,NaN,NaN,NaN,416.78083973921264,NaN,NaN,418.7832000000001,423.74665918078466,413.8197408192155,418.9368013392885,413.9068437019543,415.45986747575455,412.35381992815405,103878,112986.46666666666,44.269216183536244,47.02807081040627,NaN,NaN,NaN,NaN,1.907601998230507,36.49298134222042,103663730
2025-09-17T10:15:00-04:00,415.78,416.49,414.95,415.09,NaN,NaN,NaN,416.78083973921264,NaN,NaN,418.64459999999997,423.6257761020568,413.6634238979431,411.4751211336853,413.97433746927516,415.5280391424212,412.4206357961291,73582,113978.63333333333,42.19651878714076,44.778758263073485,NaN,NaN,NaN,NaN,1.8813447126426153,36.08748082067718,103590148
2025-09-17T10:20:00-04:00,415.12,415.43,413.75,413.85,NaN,NaN,NaN,416.78083973921264,NaN,NaN,418.5110000000001,423.63890366516534,413.3830963348348,411.4751211336853,413.9985766106256,415.50316022560264,412.49399299564857,122882,117050.13333333333,38.94952581086319,42.69164781123288,NaN,NaN,NaN,NaN,1.8669629474538574,36.22447734862623,103467266
2025-09-17T10:25:00-04:00,413.82,414.13,412.25,412.64,NaN,NaN,NaN,416.78083973921264,NaN,NaN,418.37280000000004,423.7477538267236,412.99784617327646,411.4751211336853,413.9344262266394,415.4098521711849,412.4590002820939,129347,119236.63333333333,36.035560508476124,40.346192298280606,NaN,NaN,NaN,NaN,1.8678941654928671,36.89512376048172,103337919
2025-09-17T10:30:00-04:00,412.705,414.89,411.93,414.5,NaN,NaN,NaN,416.78083973921264,NaN,NaN,418.28640000000007,423.7676549803193,412.8051450196808,411.4751211336853,413.9237544351427,415.3500352090475,412.4974736612379,141892,122525.86666666667,43.084517786658616,39.09273815179521,NaN,NaN,NaN,NaN,1.945901725100518,36.86510618710484,103479811
2025-09-17T10:35:00-04:00,414.47,414.8,413.51,414.08,NaN,NaN,NaN,416.78083973921264,NaN,NaN,418.19320000000005,423.7975246729192,412.58887532708087,411.4751211336853,413.92987201621725,415.33527628683265,412.52446774560184,65474,123692.13333333333,41.960059360220875,37.75896554627854,NaN,NaN,NaN,NaN,1.8990516018790538,36.837232726112035,103414337
2025-09-17T10:40:00-04:00,414.08,414.45,412.7,413.37,NaN,NaN,NaN,416.78083973921264,NaN,NaN,418.0590000000001,423.79595703307416,412.322042966926,411.4751211336853,413.9192773116989,415.30855252512174,412.5300020982761,56679,124327.36666666667,40.05682432290374,38.76706331229842,NaN,NaN,NaN,NaN,1.8884050588876928,37.138006575821045,103357658
2025-09-17T10:45:00-04:00,413.42,414.42,413.2,414.35,NaN,NaN,NaN,416.78083973921264,NaN,NaN,417.9434000000001,423.74138531900064,412.1454146809996,411.4751211336853,413.9209925895215,415.29336007484653,412.5486251041965,56276,124913.96666666666,43.84309701635212,40.431390099345016,NaN,NaN,NaN,NaN,1.8406618403957167,37.41729657912226,103413934
2025-09-17T10:50:00-04:00,414.36,415.07,413.67,414.79,NaN,NaN,NaN,416.78083973921264,NaN,NaN,417.8444000000001,423.6851809888088,412.00361901119146,411.4751211336853,413.9392375130282,415.2940314493267,412.5844435767297,74171,125222.13333333333,45.507357475335134,41.474659424074204,NaN,NaN,NaN,NaN,1.8091859946531639,37.044012464782384,103488105
2025-09-17T10:55:00-04:00,414.8,414.94,413.43,414.17,NaN,NaN,NaN,416.78083973921264,NaN,NaN,417.74840000000006,423.669261234598,411.8275387654021,411.4751211336853,413.9461580743915,415.2819445959765,412.61037155280655,70865,125725.16666666667,43.54887891355087,41.80702570835751,NaN,NaN,NaN,NaN,1.7878155664636515,36.815379140509805,103417240
2025-09-17T11:00:00-04:00,414.17,415.52,414.12,414.89,NaN,NaN,NaN,416.78083973921264,NaN,NaN,417.67440000000005,423.6436266299226,411.7051733700775,411.486806729968,413.9739148154933,415.2980199936977,412.64980963728885,78708,126677.96666666666,46.43203303649858,42.444650072964286,NaN,NaN,NaN,NaN,1.7601144545733889,36.033105924138276,103495948
2025-09-17T11:05:00-04:00,414.93,416.86,414.84,416.67,410.6979429038482,410.6979429038482,410.6979429038482,NaN,NaN,NaN,417.6324000000001,423.5997519218675,411.66504807813266,412.6234453839744,414.07525901680776,415.4457150530477,412.7048029805678,125887,129241.53333333334,52.84417103874049,43.06231985068607,NaN,NaN,NaN,NaN,1.7786777078181495,34.145396940452585,103621835
2025-09-17T11:10:00-04:00,416.7,418.6,416.7,418.38,412.46894549912776,NaN,NaN,NaN,NaN,NaN,417.62920000000014,423.59477301850444,411.66362698149584,414.24575630717953,414.26581987851205,415.8392470306526,412.6923927263715,140258,131508.2,58.04041648367178,44.102045501604834,NaN,NaN,NaN,NaN,1.7894864429739965,32.21817962538623,103762093
2025-09-17T11:15:00-04:00,418.35,418.47,417.88,418.15,413.1489934309856,NaN,NaN,NaN,NaN,NaN,417.6262000000001,423.5905714035414,411.6618285964588,414.69160504574364,414.37106378826246,416.0468752414804,412.69525233504453,77921,131823.1,57.12856523110661,45.27833871107536,NaN,NaN,NaN,NaN,1.7038088399044276,30.428620689967467,103684172
2025-09-17T11:20:00-04:00,418.13,418.13,416.89,417.06,413.1489934309856,NaN,NaN,NaN,NaN,NaN,417.5924000000001,423.5500647236403,411.63473527635995,414.69160504574364,414.4496429686006,416.1710395201723,412.72824641702886,77979,132959.93333333332,52.88790761476016,45.89395952759135,NaN,NaN,NaN,NaN,1.672108208482682,28.445342364629685,103606193
2025-09-17T11:25:00-04:00,417.01,417.72,416.85,417.18,413.1489934309856,NaN,NaN,NaN,NaN,NaN,417.5802000000001,423.5386944272327,411.6217055727675,414.69160504574364,414.5110410834895,416.2621562724121,412.7599258945669,66490,133112.06666666668,53.29891187521488,46.68698760531094,NaN,NaN,NaN,NaN,1.6148147650196336,26.631358329053477,103672683
2025-09-17T11:30:00-04:00,417.14,417.83,416.81,417.61,413.1489934309856,NaN,NaN,NaN,NaN,NaN,417.5706000000001,423.5273244824195,411.61387551758077,414.69160504574364,414.5648934408333,416.34341724211146,412.7863696395552,57267,128678.2,54.81992435513174,47.82058750133012,NaN,NaN,NaN,NaN,1.5723279960896586,24.861318139736305,103729950
2025-09-17T11:35:00-04:00,417.65,419.39,417.65,419.03,413.7143440358049,NaN,NaN,NaN,NaN,NaN,417.5928000000001,423.56282651915643,411.6227734808438,415.9434094267366,414.6964561301929,416.59056951862397,412.8023427417619,101792,125609.86666666667,59.50978978672348,49.497318164062065,NaN,NaN,NaN,NaN,1.5871617106546811,24.050849890762116,103831742
2025-09-17T11:40:00-04:00,419.02,419.48,418.25,419.31,414.11005567054104,NaN,NaN,NaN,NaN,NaN,417.60700000000014,423.58990531424763,411.62409468575265,416.1077275413893,414.78615559636773,416.7590452997426,412.8132658929929,67726,124496.36666666667,60.38306015530257,50.732928333250925,NaN,NaN,NaN,NaN,1.5616501598936339,23.355637456234764,103899468
2025-09-17T11:45:00-04:00,419.25,419.45,418.74,418.92,414.4593713218801,NaN,NaN,NaN,NaN,NaN,417.60700000000014,423.58990531424763,411.62409468575265,416.3971820331114,414.8551660049649,416.8843693913394,412.8259626185903,53792,122051,58.490814061078055,51.913696526169296,NaN,NaN,NaN,NaN,1.5008180056155158,22.71008305274508,103845676
2025-09-17T11:50:00-04:00,418.92,418.93,417.6,417.91,414.4593713218801,NaN,NaN,NaN,NaN,NaN,417.5848000000001,423.5547919463455,411.61480805365466,416.3971820331114,414.9213768608223,416.98253814029897,412.86021558134564,68015,118791.43333333333,53.78967727898684,52.89461459446094,NaN,NaN,NaN,NaN,1.4886167195001205,21.13043877599143,103777661
2025-09-17T11:55:00-04:00,417.84,418.45,417.77,418.04,414.4593713218801,NaN,NaN,NaN,NaN,NaN,417.5518000000001,423.4930519757463,411.61054802425394,416.3971820331114,414.9522235817979,417.0267527541982,412.87769440939763,33275,113815.46666666666,54.29883131371367,53.641452758558195,NaN,NaN,NaN,NaN,1.4308583823929695,19.663626233291605,103810936
2025-09-17T12:00:00-04:00,418.14,418.88,418.14,418.17,414.4593713218801,NaN,NaN,NaN,NaN,NaN,417.52720000000016,423.4477878626415,411.6066121373588,416.3971820331114,414.99789079037083,417.0959434214526,412.89983815928906,45878,105728.43333333333,54.83475047534705,54.3076951157019,NaN,NaN,NaN,NaN,1.3886542122220413,18.65583992377836,103856814
2025-09-17T12:05:00-04:00,418.14,419.05,418.1,418.9,414.4593713218801,NaN,NaN,NaN,NaN,NaN,417.5278000000002,423.4489381202574,411.60666187974294,416.43048576076245,415.07069598650986,417.21029558109814,412.9310963919216,69736,97688.33333333333,57.82553903670468,55.32745655307003,NaN,NaN,NaN,NaN,1.3573217684918948,17.860359719860085,103926550
2025-09-17T12:10:00-04:00,418.88,419.21,418.43,418.88,414.5807936868721,NaN,NaN,NaN,NaN,NaN,417.52980000000025,423.4526958997186,411.6069041002819,416.72438860860996,415.1316698814412,417.30651329691506,412.95682646596737,58043,90338.66666666667,57.71278161865256,56.13322430893817,NaN,NaN,NaN,NaN,1.3160844993139003,17.258091834753266,103868507
2025-09-17T12:15:00-04:00,418.89,419.21,418.28,419.09,414.5807936868721,NaN,NaN,NaN,NaN,NaN,417.5342000000002,423.4613970980387,411.6070029019618,416.75651088688795,415.1792138179967,417.38026501196686,412.97816262402654,46347,85866.5,58.625079338305255,56.54614633033566,NaN,NaN,NaN,NaN,1.2885070350771937,16.539231457273466,103914854
2025-09-17T12:20:00-04:00,419.12,419.95,419.1,419.36,415.424090941964,NaN,NaN,NaN,NaN,NaN,417.5416000000002,423.4769670281654,411.60623297183497,417.55720870951035,415.25032602234984,417.5007494379265,412.99990260677316,61250,83456.2,59.82516091730581,56.673628075595225,NaN,NaN,NaN,NaN,1.257899389714538,16.520506727281873,103976104
2025-09-17T12:25:00-04:00,419.43,419.62,418.91,419.53,415.424090941964,NaN,NaN,NaN,NaN,NaN,417.5518000000001,423.49903557960283,411.6045644203974,417.55720870951035,415.30021086972715,417.58166244804187,413.01875929141244,45486,80235.1,60.60004923798932,56.921591218943995,NaN,NaN,NaN,NaN,1.218763719020641,16.284277173859603,104021590
2025-09-17T12:30:00-04:00,419.53,419.53,418.331,418.331,415.424090941964,NaN,NaN,NaN,NaN,NaN,417.5244200000002,423.44438651454186,411.6044534854585,417.55720870951035,415.35679875890514,417.66115999712537,413.0524375206849,62749,78194.96666666666,52.85652718144503,56.919349759421486,NaN,NaN,NaN,NaN,1.2173520248048777,15.421306797918124,103958841
2025-09-17T12:35:00-04:00,418.33,418.62,417.03,417.16,415.424090941964,NaN,NaN,NaN,NaN,NaN,417.4652200000002,423.33920044644987,411.59123955355057,417.55720870951035,415.3925392098046,417.69571454732767,413.0893638722816,61496,76504.7,46.594402567963314,56.44045623747495,NaN,NaN,NaN,NaN,1.2439697373188174,15.221576150318764,103897345
2025-09-17T12:40:00-04:00,417.2,417.95,416.62,417.81,415.424090941964,NaN,NaN,NaN,NaN,NaN,417.4222200000002,423.25384464202295,411.59059535797746,417.55720870951035,415.4304245922139,417.72918576347325,413.13166342095457,72155,75447.26666666666,50.126510611926655,56.105212398674574,NaN,NaN,NaN,NaN,1.2501147560817578,15.360395199737473,103969500
2025-09-17T12:45:00-04:00,417.76,418.57,417.41,418.46,415.424090941964,NaN,NaN,NaN,NaN,NaN,417.39542000000023,423.1953187036966,411.59552129630384,417.55720870951035,415.46129919418365,417.7650239381777,413.1575744501896,45272,74503.6,53.442559910894424,55.67183883611536,NaN,NaN,NaN,NaN,1.2436779877902013,14.83639089636879,104014772
2025-09-17T12:50:00-04:00,418.5,420.42,418.5,419.95,415.424090941964,NaN,NaN,NaN,NaN,NaN,417.3900200000002,423.1798834247527,411.60015657524775,417.55720870951035,415.5973900185493,417.98098136759467,413.2137986695039,134635,74895.36666666667,60.00693654890593,55.64497286422989,NaN,NaN,NaN,NaN,1.2948438458051896,14.750119220885157,104149407
2025-09-17T12:55:00-04:00,419.97,419.97,418.91,418.98,415.424090941964,NaN,NaN,NaN,NaN,NaN,417.3604200000002,423.1021335572305,411.6187064427699,417.55720870951035,415.6422592585218,418.0455758453653,413.2389426716783,50694,72273.6,54.60887562260969,55.367691547196436,NaN,NaN,NaN,NaN,1.2780692853905333,14.670009807936072,104098713
2025-09-17T13:00:00-04:00,419.05,419.81,418.88,419.78,415.424090941964,NaN,NaN,NaN,NaN,NaN,417.35102000000023,423.07529259283126,411.6267474071692,417.55720870951035,415.67876412834937,418.0995617243033,413.2579665323954,39924,68874.66666666667,57.967235385635874,55.66608855481422,NaN,NaN,NaN,NaN,1.2532071935769244,14.565140789554153,104138637
2025-09-17T13:05:00-04:00,419.76,419.85,418.7,418.8,415.424090941964,NaN,NaN,NaN,NaN,NaN,417.31582000000014,422.98207977074094,411.64956022925935,417.55720870951035,415.7076499606719,418.1385951250344,413.27670479630945,35657,67880.76666666666,52.81241998260617,55.55991631687797,NaN,NaN,NaN,NaN,1.245835251178575,14.276192225086865,104102980
2025-09-17T13:10:00-04:00,418.84,419.26,418.63,419.09,415.424090941964,NaN,NaN,NaN,NaN,NaN,417.25142000000017,422.7601749240745,411.74266507592586,417.3507669676083,415.7287943780071,418.16610676885716,413.291481987157,27487,66907.7,54.11282447606675,55.508350174072234,NaN,NaN,NaN,NaN,1.2018470189515338,13.930322984304667,104130467
2025-09-17T13:15:00-04:00,419.09,419.27,418.82,419.22,415.424090941964,NaN,NaN,NaN,NaN,NaN,417.1796200000002,422.48659272474595,411.8726472752545,417.1542225199459,415.7538577697611,418.1993269805078,413.3083885590144,31961,66097.2,54.7152902536596,55.28618954671187,NaN,NaN,NaN,NaN,1.1481436604549948,13.618921895436698,104162428
2025-09-17T13:20:00-04:00,419.21,419.67,418.92,419.67,415.60828343905246,NaN,NaN,NaN,NaN,NaN,417.1268200000002,422.2788393739447,411.97480062605564,417.3987616282687,415.7803514143772,418.2366759043509,413.32402692440354,31324,64668.96666666667,56.82826544838008,55.22300982026383,NaN,NaN,NaN,NaN,1.1197048275653523,13.724063296191465,104193752
2025-09-17T13:25:00-04:00,419.69,419.91,419.29,419.72,415.99631601000465,NaN,NaN,NaN,NaN,NaN,417.0722200000002,422.05242541396024,412.09201458604014,417.78300930261497,415.81462794848034,418.2866854491668,413.3425704477939,38839,63601.433333333334,57.067964581351646,55.111787337624285,NaN,NaN,NaN,NaN,1.0840116255963987,14.051842072179173,104232591
2025-09-17T13:30:00-04:00,419.77,420.25,419.08,419.09,416.06557437318617,NaN,NaN,NaN,NaN,NaN,417.02102000000014,421.8626302194932,412.17940978050706,417.963407442092,415.85425380979245,418.34188141112577,413.36662620845914,47885,62574,53.06972314648027,54.62925606827961,NaN,NaN,NaN,NaN,1.0901536523395143,14.67552018206468,104184706
2025-09-17T13:35:00-04:00,419.1,420.15,419.02,420.12,416.06557437318617,NaN,NaN,NaN,NaN,NaN,416.99042000000014,421.73294483107,412.2478951689303,417.963407442092,415.8842718474741,418.3857139650496,413.3828297298986,34214,59518.23333333333,58.22312428726768,54.45947571465663,NaN,NaN,NaN,NaN,1.0929998200295488,15.164375329428717,104218920
2025-09-17T13:40:00-04:00,420.11,420.48,419.46,419.59,416.4041803689569,NaN,NaN,NaN,NaN,NaN,417.1034200000002,421.8189990835435,412.3878409164569,418.0545807629388,415.9193643418751,418.4371911001478,413.4015375836024,39846,56171.166666666664,54.88343947519902,54.604255164210485,NaN,NaN,NaN,NaN,1.087785547170298,15.940443403174179,104179074
2025-09-17T13:45:00-04:00,419.56,419.81,419.15,419.28,416.4041803689569,NaN,NaN,NaN,NaN,NaN,417.2760200000002,421.6537811535125,412.89825884648786,418.0545807629388,415.9413685136849,418.466427911406,413.41630911596377,28490,54523.46666666667,52.969592905347824,55.059625902595094,NaN,NaN,NaN,NaN,1.0572294366581356,16.166500668322254,104150584
2025-09-17T13:50:00-04:00,419.33,420.19,419.2,420.19,416.4041803689569,NaN,NaN,NaN,NaN,NaN,417.42282000000023,421.6878782492198,413.15776175078065,418.0545807629388,415.97185940629583,418.51053361403564,413.43318519855603,35476,53106.7,57.639335517621284,55.596256253001854,NaN,NaN,NaN,NaN,1.0524273340396981,16.76714525798131,104186060
2025-09-17T13:55:00-04:00,420.13,420.65,419.81,420.65,416.8032479711598,NaN,NaN,NaN,NaN,NaN,417.53782000000024,421.8345428755251,413.2410971244754,418.38098535062466,416.0183640751627,418.58333814141275,413.45339000891266,48724,52514.5,59.81161586509004,56.05118882115868,NaN,NaN,NaN,NaN,1.0372539530368607,17.76134370184843,104234784
2025-09-17T14:00:00-04:00,420.67,424.55,417.6,424.28,416.8562821542889,NaN,NaN,NaN,NaN,NaN,417.73762000000016,422.33053191090556,413.14470808909476,419.2597882804998,416.41145989314225,419.3114644405877,413.5114553456968,316022,61139.666666666664,72.00974919203031,56.90853258138185,NaN,NaN,NaN,NaN,1.4595929563913699,20.789618048939925,104550806
2025-09-17T14:05:00-04:00,424.28,424.64,418.51,418.63,416.8562821542889,NaN,NaN,NaN,NaN,NaN,417.78642000000013,422.3643465189945,413.20849348100575,419.2597882804998,416.5866354575827,419.5462996606081,413.6269712545573,215283,64922.7,47.727532907940684,56.41700810176263,NaN,NaN,NaN,NaN,1.7931934595062717,23.631344614129983,104335523
2025-09-17T14:10:00-04:00,418.66,418.82,412.14,412.24,NaN,NaN,NaN,421.03273671479053,421.03273671479053,421.03273671479053,417.71282000000014,422.52094681503456,412.9046931849657,419.2597882804998,416.46323791351193,419.3821217609813,413.54435406604256,307372,72910.9,33.83230428688634,54.69308445185196,NaN,NaN,NaN,NaN,2.142251069541538,22.703623099677213,104028151
2025-09-17T14:15:00-04:00,412.2,416.9,411.77,416.45,NaN,NaN,NaN,420.33488504593635,NaN,NaN,417.7450200000001,422.49699492389743,412.9930450761028,419.2597882804998,416.4099622238288,419.28640900168915,413.5335154459685,211814,78178.3,45.16040001282645,54.14651159686769,NaN,NaN,NaN,NaN,2.355661707431428,22.01446172533779,104239965
2025-09-17T14:20:00-04:00,416.33,419.21,414.88,418.39,NaN,NaN,NaN,420.33488504593635,NaN,NaN,417.7960200000001,422.51976994230785,413.0722700576924,419.2597882804998,416.442883307079,419.28138685390707,413.60437976025094,177338,81822.4,49.454732955024284,53.81379077393609,NaN,NaN,NaN,NaN,2.496685871186325,20.749976255888683,104417303
2025-09-17T14:25:00-04:00,418.38,419.07,416.84,418.91,NaN,NaN,NaN,420.33488504593635,NaN,NaN,417.87242000000015,422.5418887335197,413.20295126648057,419.2597882804998,416.47389930774017,419.2981497081393,413.64964890734103,100590,84066.23333333334,50.57200951041149,53.517842149418364,NaN,NaN,NaN,NaN,2.4776368803873035,19.575811177114513,104517893
2025-09-17T14:30:00-04:00,418.94,419.35,415.86,416.81,NaN,NaN,NaN,420.33488504593635,NaN,NaN,417.9316200000002,422.46878096046146,413.3944590395389,419.2597882804998,416.489812193661,419.2904137150255,413.6892106722965,111112,86240.7,46.13666812814458,52.7541566265444,NaN,NaN,NaN,NaN,2.549948531788211,18.393138199432062,104406781
2025-09-17T14:35:00-04:00,416.83,418.55,415.59,415.65,NaN,NaN,NaN,420.33488504593635,NaN,NaN,417.99182000000013,422.3216811096969,413.66195889030337,419.2597882804998,416.4914858512756,419.2700996288096,413.71287207374166,96230,87123.83333333333,43.8489654993219,51.80994240639942,NaN,NaN,NaN,NaN,2.57923792237477,17.436422276335488,104310551
2025-09-17T14:40:00-04:00,415.67,417.54,415.1,415.79,NaN,NaN,NaN,420.33488504593635,NaN,NaN,418.0176200000002,422.2787760662596,413.7564639337408,419.2597882804998,416.4863537160299,419.2447307339171,413.7279766981427,91921,88253.1,44.20852923488385,51.17699998414253,NaN,NaN,NaN,NaN,2.5692923564908576,16.808510456114817,104402472
2025-09-17T14:45:00-04:00,415.87,417.87,414.91,416.79,NaN,NaN,NaN,420.33488504593635,NaN,NaN,418.0718200000002,422.19806241035957,413.9455775896408,419.2597882804998,416.48708595137776,419.21802190060305,413.7561500021525,125968,90907.13333333333,46.827679315986124,50.36303962905099,NaN,NaN,NaN,NaN,2.597200045312938,16.015257940312274,104528440
2025-09-17T14:50:00-04:00,416.84,417.24,414.49,415.34,NaN,NaN,NaN,420.33488504593635,NaN,NaN,418.1112200000002,422.09219039993616,414.1302496000642,417.34283062439977,416.463313575445,419.1566323728078,413.7699947780822,195564,95384.26666666666,43.62934434573708,49.55917569123228,NaN,NaN,NaN,NaN,2.608114327790585,15.519762503920195,104332876
2025-09-17T14:55:00-04:00,415.36,419.71,415.36,419.65,NaN,NaN,NaN,420.33488504593635,NaN,NaN,418.21722000000017,422.0721994766177,414.36224052338264,411.2666760345406,416.51273796828804,419.18435583537666,413.8411201011994,187631,100122.43333333333,53.74270500404709,49.61439798399651,NaN,NaN,NaN,NaN,2.7339633043769718,15.202630692726057,104520507
2025-09-17T15:00:00-04:00,419.71,422.28,419.45,422.23,413.6874697207759,413.6874697207759,413.6874697207759,NaN,NaN,NaN,418.36602000000016,422.25457067052383,414.4774693294765,414.11034082763246,416.6506130454008,419.4031800742805,413.8980460165211,199159,104669.43333333333,58.538044004595754,49.67859144735183,NaN,NaN,NaN,NaN,2.740823068350044,15.997761720736174,104719666
2025-09-17T15:05:00-04:00,422.23,424.42,421.93,423.81,415.9841756425588,NaN,NaN,NaN,NaN,NaN,418.5588200000002,422.5506323338872,414.56700766611317,416.639272662106,416.8109123249133,419.7178714565618,413.90395319326484,169277,108262.13333333333,61.19136340036808,49.77714484272883,NaN,NaN,NaN,NaN,2.72290713489647,17.43764364056158,104888943
2025-09-17T15:10:00-04:00,423.92,424.6,421.09,421.95,415.9841756425588,NaN,NaN,NaN,NaN,NaN,418.70002000000017,422.662090781447,414.73794921855335,416.639272662106,416.9244635017137,419.91135582051044,413.937571182917,143667,110645.86666666667,56.59946165809075,48.676410018876005,NaN,NaN,NaN,NaN,2.7791280538324403,18.25579651304691,104745276
2025-09-17T15:15:00-04:00,422,424.21,422,423,415.9841756425588,NaN,NaN,NaN,NaN,NaN,418.82662000000016,422.92337510388813,414.7298648961122,416.6963345037478,417.0212307404218,420.0816834241081,413.9607780567355,116096,113006.66666666667,58.49304476923543,49.44537515182562,NaN,NaN,NaN,NaN,2.742047478558694,19.015509894640427,104861372
2025-09-17T15:20:00-04:00,422.84,426.13,422.61,425.79,416.9055602578641,NaN,NaN,NaN,NaN,NaN,418.9748200000002,423.5089885841156,414.44065141588476,418.35906760299827,417.28851664157685,420.61501813076546,413.96201515238823,260856,117214.03333333334,63.10001147452351,51.535925665228284,NaN,NaN,NaN,NaN,2.7976155158045004,20.350306122965037,105122228
2025-09-17T15:25:00-04:00,425.95,427.92,425.81,427.13,419.4493984279612,NaN,NaN,NaN,NaN,NaN,419.1544200000002,424.2235215706036,414.08531842939675,420.63825408239865,417.54776351122655,421.18192850459076,413.91359851786234,210415,122538.06666666667,65.10338869619153,52.96042485689723,NaN,NaN,NaN,NaN,2.749928693247036,22.082087854133285,105332643
2025-09-17T15:30:00-04:00,427.09,427.94,425.61,426.17,419.4493984279612,NaN,NaN,NaN,NaN,NaN,419.3366200000002,424.7356518373723,413.9375881626281,420.9496032659189,417.71457721587547,421.5146848344808,413.9144695972701,147712,126131,62.48598773405403,53.891228769685064,NaN,NaN,NaN,NaN,2.7199337865865325,23.554477976321607,105184931
2025-09-17T15:35:00-04:00,426.14,427.69,425.88,426.87,419.4781192287828,NaN,NaN,NaN,NaN,NaN,419.53042000000016,425.2895323771976,413.77130762280274,421.1926826127351,417.8411711102753,421.7623595993505,413.9199826212001,112765,128701.26666666666,63.63406959840614,54.82423306168469,NaN,NaN,NaN,NaN,2.654938516116066,24.92169737549648,105297696
2025-09-17T15:40:00-04:00,427,428.08,426.38,427.33,420.0234319911109,NaN,NaN,NaN,NaN,NaN,419.7248200000002,425.8557126551509,413.5939273448495,422.03214609018806,418.0750638441727,422.21548733880576,413.9346403495396,206313,134662.13333333333,64.40499590041898,56.129113616847164,NaN,NaN,NaN,NaN,2.5867286221077745,26.309366324346612,105504009
2025-09-17T15:45:00-04:00,427.31,427.6,426.36,427.47,420.0234319911109,NaN,NaN,NaN,NaN,NaN,419.89362000000017,426.39241019982046,413.3948298001799,422.1417168721505,418.22461490515343,422.4900799173575,413.95914989294937,139363,138242.2,64.65061094182764,57.614945434168995,NaN,NaN,NaN,NaN,2.4905337205286484,27.581511533544635,105643372
2025-09-17T15:50:00-04:00,427.7,428.3,425.95,426.65,420.07682542991716,NaN,NaN,NaN,NaN,NaN,420.04042000000015,426.80597376692117,413.27486623307914,422.75837349772036,418.4411305325994,422.86713160186844,414.01512946333037,214610,144351.73333333334,61.95407454778147,58.88248438509025,NaN,NaN,NaN,NaN,2.480495597633747,28.988613290170484,105428762
2025-09-17T15:55:00-04:00,426.63,427.26,425.3,425.63,420.07682542991716,NaN,NaN,NaN,NaN,NaN,420.17462000000023,427.1100164775484,413.23922352245205,422.75837349772036,418.6126160929166,423.1321789534848,414.0930532323484,199436,149704.96666666667,58.675668788165495,59.728769347388784,NaN,NaN,NaN,NaN,2.4433173406599065,29.73188841628765,105229326