time,open,high,low,close,Long Stop,Long Stop Start,Buy Label,Short Stop,Short Stop Start,Sell Label,Basis,Upper,Lower,ATR Trailing Stoploss,VWAP,Upper Band #1,Lower Band #1,Volume,Volume MA,RSI,RSI-based MA,Regular Bullish,Regular Bullish Label,Regular Bearish,Regular Bearish Label,ATR,ADX,OnBalanceVolume,Histogram,MACD,Signal
2025-08-08T10:55:00-04:00,333.94,334,332.84,333.11,329.5576866780127,NaN,NaN,NaN,NaN,NaN,323.16179999999963,336.0777435985726,310.24585640142664,330.2767945890183,330.563451221754,333.4301194194638,327.69678302404424,122199,188116.33333333334,70.31277048765644,78.87556547661593,NaN,NaN,NaN,NaN,1.7057047776025327,53.166553071893354,88883569,-0.04878169852983394,3.263552745095808,3.312334443625642
2025-08-08T11:00:00-04:00,333.09,334.18,332.88,333.31,329.5576866780127,NaN,NaN,NaN,NaN,NaN,323.4437999999996,336.6154757567721,310.2721242432271,330.2767945890183,330.6667810858869,333.5325393750248,327.801022796749,169305,192673.06666666668,70.8539993618109,77.573252972109,NaN,NaN,NaN,NaN,1.6767258649166383,52.78677167864109,89052874,-0.1612399423223203,3.1107845157227416,3.272024458045062
2025-08-08T11:05:00-04:00,333.29,333.29,331.65,331.65,329.5576866780127,NaN,NaN,NaN,NaN,NaN,323.70839999999964,336.9967874778485,310.4200125221508,330.2767945890183,330.7079680990945,333.54571189212464,327.87022430606436,131153,196278.06666666668,60.92570535615935,75.44008993110819,NaN,NaN,NaN,NaN,1.6755311602797374,51.16578159499083,88921721,-0.3590418709871832,2.823222119311083,3.1822639902982663
2025-08-08T11:10:00-04:00,331.65,332.82,331.14,332.82,329.5576866780127,NaN,NaN,NaN,NaN,NaN,324.0003999999996,337.43438985266545,310.5664101473338,330.2767945890183,330.7499921536932,333.5603662785483,327.9396180288381,135580,199889.86666666667,64.68207167841334,73.7394996509876,NaN,NaN,NaN,NaN,1.6758503631168995,49.18761025482981,89057301,-0.4185441463406159,2.6590838073724967,3.0776279537131126
2025-08-08T11:15:00-04:00,332.84,333.38,332.72,333.16,329.5576866780127,NaN,NaN,NaN,NaN,NaN,324.3069999999996,337.86288521644747,310.75111478355177,330.2767945890183,330.7880178947698,333.59106616184556,327.984969627694,82833,201319.96666666667,65.71358907265278,72.90438033979234,NaN,NaN,NaN,NaN,1.6032896228942615,47.66106432858694,89140134,-0.44025838490749214,2.5273049725787473,2.9675633574862395
2025-08-08T11:20:00-04:00,333.17,333.72,333.05,333.48,329.5576866780127,NaN,NaN,NaN,NaN,NaN,324.61279999999965,338.29220308059826,310.93339691940105,330.55311460074364,330.8426935691511,333.64169101554097,328.0436961227612,108122,203741.3,66.69939010191811,72.53538857988299,NaN,NaN,NaN,NaN,1.5366260784018153,46.42809477032272,89248256,-0.4374224331877352,2.42078531600157,2.8582077491893054
2025-08-08T11:25:00-04:00,333.52,333.52,333.01,333.19,329.5576866780127,NaN,NaN,NaN,NaN,NaN,324.9253999999996,338.6600752186391,311.19072478136013,330.7314916805949,330.86689306086487,333.66201932917863,328.0717667925511,53008,203219.36666666667,64.87883842890886,71.8705559003136,NaN,NaN,NaN,NaN,1.4632956442302565,45.24114892430104,89195248,-0.45727936380998324,2.2866085444268265,2.7438879082368097
2025-08-08T11:30:00-04:00,333.18,333.35,332.58,332.72,329.5576866780127,NaN,NaN,NaN,NaN,NaN,325.2189999999996,338.97996886129937,311.4580311386998,330.7341933444759,330.8933339099821,333.67953250796614,328.1071353119981,69772,202189.6,61.9286010555398,71.03255756042742,NaN,NaN,NaN,NaN,1.413774526785241,43.67848946113164,89125476,-0.5007637676537078,2.117933198669675,2.618696966323383
2025-08-08T11:35:00-04:00,332.74,333.35,332,332.21,329.5576866780127,NaN,NaN,NaN,NaN,NaN,325.4957999999996,339.2513448253305,311.7402551746687,330.7341933444759,330.9174312881381,333.6898888525596,328.14497372371665,80010,201719,58.80384157131752,69.85180137394126,NaN,NaN,NaN,NaN,1.4092192034434399,41.63453069004934,89045466,-0.5581892543005202,1.9209603984477326,2.479149652748253
2025-08-08T11:40:00-04:00,332.19,332.365,331.18,331.7,329.5576866780127,NaN,NaN,NaN,NaN,NaN,325.7572999999996,339.4775121281584,312.03708787184075,330.7341933444759,330.9320257205063,333.68219373385875,328.1818577071539,96562,202343.46666666667,55.77319341113076,68.22744068037733,NaN,NaN,NaN,NaN,1.393203546054623,38.97281302337199,88948904,-0.6200701764428498,1.7040619321946906,2.3241321086375404
2025-08-08T11:45:00-04:00,331.69,331.715,330.88,331.375,329.5576866780127,NaN,NaN,NaN,NaN,NaN,326.02279999999956,339.6535081489438,312.39209185105534,330.7341933444759,330.9377973855436,333.66801553497044,328.20757923611677,82301,202391.03333333333,53.86791750224169,66.42506031337403,NaN,NaN,NaN,NaN,1.3533318641935772,36.23790543023967,88866603,-0.6682802458799175,1.4887818012876437,2.1570620471675612
2025-08-08T11:50:00-04:00,331.39,332.18,331.06,331.69,329.5576866780127,NaN,NaN,NaN,NaN,NaN,326.3071999999996,339.80497806312854,312.8094219368707,330.7341933444759,330.9455210536643,333.66174621430645,328.2292958930222,61760,197325.56666666668,55.456213256652944,64.71999277635291,NaN,NaN,NaN,NaN,1.3366653024654649,34.093306107424134,88928363,-0.6630279874835914,1.328277062813072,1.9913050502966634
2025-08-08T11:55:00-04:00,331.73,331.87,330.5,330.91,329.5576866780127,NaN,NaN,NaN,NaN,NaN,326.5915999999996,339.86420704464757,313.3189929553516,330.7341933444759,330.94762360910994,333.6445179082565,328.2507293099634,81407,190767.13333333333,50.79284623661849,62.60653330780722,NaN,NaN,NaN,NaN,1.3390463522893605,31.725167270048555,88846956,-0.6929110767829143,1.1251662043180204,1.8180772811009347
2025-08-08T12:00:00-04:00,330.91,331.75,330.81,330.98,329.5576866780127,NaN,NaN,NaN,NaN,NaN,326.8841999999996,339.8830096932578,313.88539030674144,330.7341933444759,330.9505581958815,333.6304950248287,328.27062136693434,73198,178433.56666666668,51.1895355008696,60.84846521584934,NaN,NaN,NaN,NaN,1.3105430414115489,29.52618120677123,88920154,-0.6874255016620121,0.9587954040234195,1.6462209056854316
2025-08-08T12:05:00-04:00,331.03,331.78,330.96,331.57,329.5576866780127,NaN,NaN,NaN,NaN,NaN,327.16899999999964,339.9400034062131,314.39799659378616,330.7341933444759,330.9545427263153,333.62383337649095,328.28525207613967,47903,167106.36666666667,54.51768922830472,59.720245125895644,NaN,NaN,NaN,NaN,1.2755042527392948,27.454223997100442,88968057,-0.6253071288444114,0.8645869946299172,1.4898941234743286
2025-08-08T12:10:00-04:00,331.65,331.9,331.2,331.2,329.5576866780127,NaN,NaN,NaN,NaN,NaN,327.4463999999996,339.9502461347559,314.94255386524327,330.7341933444759,330.959261288951,333.61578727619445,328.3027353017075,58168,157655.36666666667,52.117695866047214,58.3819377333411,NaN,NaN,NaN,NaN,1.2343968061150588,25.582750648357273,88909889,-0.5907885191706324,0.7514084745110381,1.3421969936816704
2025-08-08T12:15:00-04:00,331.23,331.66,330.85,331,329.5576866780127,NaN,NaN,NaN,NaN,NaN,327.71479999999957,339.932843699452,315.49675630054713,330.7341933444759,330.9614159066787,333.6044117064079,328.31842010694953,60969,151672.46666666667,50.81548407632223,57.659779070495595,NaN,NaN,NaN,NaN,1.2040827485354118,24.045404330394355,88848920,-0.5631828995091288,0.6382183692952594,1.2014012688043882
2025-08-08T12:20:00-04:00,330.97,331.1,330.09,330.61,329.5576866780127,NaN,NaN,NaN,NaN,NaN,327.9881999999996,339.8357512677341,316.1406487322651,330.58235467558075,330.95624763682247,333.58062869629947,328.33186657734547,86512,139796.9,48.28209542610253,56.48835219533054,NaN,NaN,NaN,NaN,1.1902196950686001,23.366904470240453,88762408,-0.5521990886364272,0.5111524080088543,1.0633514966452815
2025-08-08T12:25:00-04:00,330.61,330.77,329.91,330.32,329.5576866780127,NaN,NaN,NaN,NaN,NaN,328.24419999999964,339.72333992603967,316.7650600739596,329.5583837404646,330.9481799250663,333.55646175225337,328.33989809787926,79382,125677.83333333333,46.42852654833537,55.11084772930787,NaN,NaN,NaN,NaN,1.1666325739922685,22.902420932573005,88683026,-0.5445689552072503,0.3826403026362186,0.927209257843469
2025-08-08T12:30:00-04:00,330.31,330.77,330.04,330.67,329.5576866780127,NaN,NaN,NaN,NaN,NaN,328.49899999999957,339.6107552169643,317.3872447830348,329.48976559389735,330.94431091069623,333.54181165855107,328.3468101628414,52583,117569.83333333333,48.97456000872375,53.84478843693684,NaN,NaN,NaN,NaN,1.135444532992818,22.471114790453232,88735609,-0.4973563383835058,0.3055138348640867,0.8028701732475925
2025-08-08T12:35:00-04:00,330.74,331.17,330.58,330.76,329.5576866780127,NaN,NaN,NaN,NaN,NaN,328.7447999999996,339.49616902174085,317.99343097825835,329.48976559389735,330.94315488919517,333.5266941704611,328.35961560792924,67108,111914.6,49.637383585719725,52.75611309099475,NaN,NaN,NaN,NaN,1.096484209207619,21.525237297804818,88802717,-0.4432681680898055,0.2487849631353356,0.6920531312251411
2025-08-08T12:40:00-04:00,330.78,331.74,330.53,331.6,329.5576866780127,NaN,NaN,NaN,NaN,NaN,329.0087999999996,339.3723965881359,318.6452034118633,329.46855998726033,330.9476740492651,333.51462860375136,328.3807194947789,82493,108900.76666666666,55.4536557286148,52.293616996214396,NaN,NaN,NaN,NaN,1.1045924799785058,20.039497689914377,88885210,-0.33883237966371427,0.2685126566454983,0.6073450363092125
2025-08-08T12:45:00-04:00,331.605,331.75,330.82,330.85,329.5576866780127,NaN,NaN,NaN,NaN,NaN,329.25679999999966,339.1820334502237,319.33156654977563,329.46855998726033,330.949868955867,333.50221563691287,328.3975222748211,73090,105747.1,49.91121293186386,51.658429236253426,NaN,NaN,NaN,NaN,1.0921215885514701,18.67207007289977,88812120,-0.3090121941271381,0.22107979365028996,0.530091987777428
2025-08-08T12:50:00-04:00,330.8,330.82,329.22,329.569,NaN,NaN,NaN,333.6010940793375,333.6010940793375,333.6010940793375,329.4809799999996,338.9053001261457,320.0566598738535,329.46855998726033,330.9321462531485,333.4671850467227,328.39710745957433,106829,105555.83333333333,42.16038409893135,50.68608571395347,NaN,NaN,NaN,NaN,1.1305414750835077,18.921042071038535,88705291,-0.36070572452853444,0.07920983211676003,0.43991555664529447
2025-08-08T12:55:00-04:00,329.52,329.87,328.65,329.62,NaN,NaN,NaN,332.8446807120949,NaN,NaN,329.6979799999996,338.6116208139525,320.7843391860466,329.46855998726033,330.8916962841495,333.4056757803798,328.37771678791916,174228,106479.6,42.54294371563044,49.87715901490981,NaN,NaN,NaN,NaN,1.136931369720402,19.600349537273907,88879519,-0.37495336309902294,-0.028776147228484206,0.34617721587053873
2025-08-08T13:00:00-04:00,329.62,330.36,329.58,330.19,NaN,NaN,NaN,332.8446807120949,NaN,NaN,329.92457999999965,338.28340911512737,321.56575088487193,329.46829418930037,330.87838856438225,333.3747992652103,328.3819778635542,106542,99495.13333333333,46.77976255160586,49.25741253597787,NaN,NaN,NaN,NaN,1.1114362718832325,19.594188767682827,88986061,-0.33100779527928703,-0.06758252822857003,0.263425267050717
2025-08-08T13:05:00-04:00,330.16,330.34,329.79,330,NaN,NaN,NaN,332.8446807120949,NaN,NaN,330.14617999999956,337.8912423310674,322.4011176689317,329.46829418930037,330.87190880997963,333.35969428384664,328.3841233361126,53116,95071.9,45.5734174974081,48.88459619746284,NaN,NaN,NaN,NaN,1.071333681034427,19.58846805306254,88932945,-0.30063854314563204,-0.11237291188132303,0.188265631264309
2025-08-08T13:10:00-04:00,330,330,329.27,329.3,NaN,NaN,NaN,332.8446807120949,NaN,NaN,330.3373799999996,337.4951698700677,323.1795901299315,329.46829418930037,330.8625806327064,333.34426536031026,328.38089590510253,47678,90955.2,41.34334095038197,48.18129658671372,NaN,NaN,NaN,NaN,1.0469527038176836,20.03575795803,88885267,-0.3122324615409591,-0.2020249456618899,0.11020751587906923
2025-08-08T13:15:00-04:00,329.26,329.58,329.06,329.4,NaN,NaN,NaN,332.62280278656226,NaN,NaN,330.53277999999955,337.0119533090106,324.0536066909885,329.46829418930037,330.8488801092978,333.3234868619655,328.3742733566301,62864,88320.9,42.16915601894377,47.2992585003308,NaN,NaN,NaN,NaN,1.009313224973562,20.626439918767968,88948131,-0.29775453790973716,-0.26198565650810224,0.03576888140163492
2025-08-08T13:20:00-04:00,329.365,329.73,329.1,329.46,NaN,NaN,NaN,332.62280278656226,NaN,NaN,330.71597999999955,336.5091417826653,324.92281821733377,329.46829418930037,330.8384959182002,333.3069950622961,328.36999677410427,51281,85265.2,42.690504365278514,46.62588767884733,NaN,NaN,NaN,NaN,0.9822194231897357,20.947338710384262,88999412,-0.2695683092034057,-0.30119150510262216,-0.0316231958992165
2025-08-08T13:25:00-04:00,329.47,329.71,328.53,328.68,NaN,NaN,NaN,332.3722851836239,NaN,NaN,330.8815799999996,335.9084171463642,325.854742853635,329.46829418930037,330.81899844480074,333.2818779720621,328.3561189175394,74021,83659.26666666666,37.90631782185687,45.70380437495694,NaN,NaN,NaN,NaN,0.9963466072476121,21.738736370085782,88925391,-0.28725998603640485,-0.39069817844472254,-0.10343819240831771
2025-08-08T13:30:00-04:00,328.7,329.06,328.22,328.99,NaN,NaN,NaN,331.8589994934591,NaN,NaN,331.0285799999996,335.3455647829298,326.7115952170694,329.46763535144026,330.79734631133397,333.2562641429934,328.3384284796745,75131,80520.13333333333,40.74835032404234,45.165679724809785,NaN,NaN,NaN,NaN,0.9851789924442096,22.722491647707105,89000522,-0.2625636411488711,-0.4316427438444066,-0.1690791026955355
2025-08-08T13:35:00-04:00,329.01,329.44,328.2,328.37,NaN,NaN,NaN,331.8589994934591,NaN,NaN,331.14977999999957,334.76391235620196,327.5356476437972,328.1791082811522,330.77970039516543,333.235988617302,328.3234121730289,59855,78143.53333333334,37.09177961800735,44.498769229786355,NaN,NaN,NaN,NaN,1.0033804929839094,23.022487350318073,88940667,-0.2713459203482317,-0.5082615031308251,-0.23691558278259342
2025-08-08T13:40:00-04:00,328.4,330.25,328.4,330.12,NaN,NaN,NaN,331.8589994934591,NaN,NaN,331.23747999999955,334.5193142249675,327.9556457750316,328.01046343994994,330.7651086858681,333.2097966909459,328.3204206807903,89603,76610.96666666666,50.5737324336332,44.612995831565605,NaN,NaN,NaN,NaN,1.065996172056487,22.149553799281765,89030270,-0.1487852554608879,-0.42289715210870327,-0.2741118966478154
2025-08-08T13:45:00-04:00,330.19,330.34,329.33,329.33,NaN,NaN,NaN,331.8589994934591,NaN,NaN,331.25527999999963,334.485477419334,328.02508258066524,328.01046343994994,330.75813013762536,333.1966023594944,328.3196579157563,46710,75406.86666666667,45.80172646669467,44.339020323063814,NaN,NaN,NaN,NaN,1.061996445481023,21.220487876305615,88983560,-0.11208396473447924,-0.41421685256591445,-0.3021328878314352
2025-08-08T13:50:00-04:00,329.33,329.42,328.62,328.99,NaN,NaN,NaN,331.8589994934591,NaN,NaN,331.2742799999996,334.4391194600756,328.1094405399236,328.01046343994994,330.7472523999387,333.1820099364324,328.312494863445,46036,73337.33333333333,43.88259476293969,43.512515968372725,NaN,NaN,NaN,NaN,1.0432824136609506,21.090071223238237,88937524,-0.10214819791971064,-0.4298181352310735,-0.32766993731136285
2025-08-08T13:55:00-04:00,328.99,329.66,328.82,329.63,NaN,NaN,NaN,331.8589994934591,NaN,NaN,331.27407999999957,334.4393337806916,328.10882621930756,327.7806772812544,330.7375740539914,333.1664878145609,328.3086602934219,52358,73315.66666666667,48.275995442095365,43.395714719103545,NaN,NaN,NaN,NaN,1.0287622412565993,20.632488317970076,88989882,-0.046735265326077635,-0.38608901896895986,-0.3393537536428822
2025-08-08T14:00:00-04:00,329.61,330.43,329.14,330.41,NaN,NaN,NaN,331.8589994934591,NaN,NaN,331.26507999999956,334.4375429637134,328.09261703628573,327.78537986893895,330.7304384319365,333.1487679040535,328.31210895981945,72127,73394.16666666667,53.09564751469004,44.1768049630863,NaN,NaN,NaN,NaN,1.0474220811668438,19.224843410768152,89062009,0.04331802830427012,-0.28520621826254455,-0.32852424656681467
2025-08-08T14:05:00-04:00,330.38,330.445,329.55,329.61,NaN,NaN,NaN,331.8589994934591,NaN,NaN,331.19867999999957,334.3679499336267,328.02941006637246,327.88180389515117,330.7254695750653,333.1377027460464,328.3132364040842,43610,72180.83333333333,48.14093836588201,44.57666172381856,NaN,NaN,NaN,NaN,1.036534789654925,17.89964645537353,89018399,0.04943184729827399,-0.2667344374439722,-0.3161662847422462
2025-08-08T14:10:00-04:00,329.65,330.14,329.45,329.64,NaN,NaN,NaN,331.8589994934591,NaN,NaN,331.1392799999996,334.31184539856497,327.9667146014342,327.88180389515117,330.72000009795704,333.1266171596611,328.31338303625296,42373,70374.53333333334,48.335638504924425,44.687795720484175,NaN,NaN,NaN,NaN,1.011782304679573,16.794720768469553,89060772,0.05546952906344804,-0.2468293734129361,-0.30229890247638413
2025-08-08T14:15:00-04:00,329.63,329.63,328.91,329.18,NaN,NaN,NaN,331.8589994934591,NaN,NaN,331.10427999999956,334.32357644616036,327.88498355383877,327.88180389515117,330.70871351517076,333.1095912148779,328.3078358154636,58471,69580.2,45.513960235225944,44.68354877318545,NaN,NaN,NaN,NaN,0.991654997202458,16.41929623253733,89002301,0.029745902685923198,-0.2651165241189801,-0.2948624268049033
2025-08-08T14:20:00-04:00,329.13,329.37,328.97,329,NaN,NaN,NaN,331.8589994934591,NaN,NaN,331.0848799999996,334.3427437823085,327.8270162176907,327.88180389515117,330.69760702174665,333.0937875161101,328.30142652738317,53751,69313.23333333334,44.42118822708714,44.903395007235815,NaN,NaN,NaN,NaN,0.9493939259737093,16.07068773488598,88948550,0.0032645276240989007,-0.29078176727477967,-0.29404629489887857
2025-08-08T14:25:00-04:00,328.98,329.58,328.9,329.52,NaN,NaN,NaN,331.8589994934591,NaN,NaN,331.05347999999964,334.340673094421,327.7662869055783,327.88180389515117,330.68892464037293,333.0799307173662,328.29791856337965,49452,68248.06666666667,48.28418074461784,45.34018248764111,NaN,NaN,NaN,NaN,0.9301515026898733,15.425098097907961,88998002,0.02236133195971357,-0.2660946299492366,-0.2884559619089502
2025-08-08T14:30:00-04:00,329.53,330.06,329.32,330.05,NaN,NaN,NaN,331.8589994934591,NaN,NaN,331.0344799999996,334.3336501077939,327.73530989220524,328.12189990036313,330.68087040244,333.0623690846615,328.2993717202185,71865,68203.63333333333,51.94995421926653,46.00157176292596,NaN,NaN,NaN,NaN,0.9165692524977401,14.512528224872781,89069867,0.06961178074567337,-0.20144123597685848,-0.27105301672253185
2025-08-08T14:35:00-04:00,330.04,330.12,329.78,329.96,NaN,NaN,NaN,331.8589994934591,NaN,NaN,330.9976799999996,334.30291605088456,327.69244394911465,328.3995199202905,330.67709558581987,333.0529830731799,328.3012080984598,40902,67970.26666666666,51.2851629935601,46.957203560904766,NaN,NaN,NaN,NaN,0.8753857344621895,13.74879459964433,89028965,0.09230583094713354,-0.15567072803861493,-0.24797655898574847
2025-08-08T14:40:00-04:00,329.92,330.07,329.47,329.51,NaN,NaN,NaN,331.8589994934591,NaN,NaN,330.9172799999996,334.1673219209762,327.66723807902304,328.3995199202905,330.672012990568,333.0428769428358,328.30114903830025,40526,67382.2,47.97913012432133,47.47368783235327,NaN,NaN,NaN,NaN,0.8557153248577449,12.959104026455623,88988439,0.07523400400593278,-0.15393405397833249,-0.22916805798426526
2025-08-08T14:45:00-04:00,329.5,329.97,329.34,329.91,NaN,NaN,NaN,331.8589994934591,NaN,NaN,330.8378799999996,333.98692863476566,327.6888313652335,328.3995199202905,330.6673548859491,333.0331998596736,328.3015099122247,39801,66676.6,51.002698209935296,48.46732487463384,NaN,NaN,NaN,NaN,0.839592801653624,12.417321643792773,89028240,0.08820616977453519,-0.11891034576609627,-0.20711651554063146
2025-08-08T14:50:00-04:00,329.88,330.88,329.74,330.87,NaN,NaN,NaN,331.8589994934591,NaN,NaN,330.7750799999996,333.791008854604,327.7591511453952,328.98511419918873,330.66560244940064,333.01933404885256,328.3118708499487,82609,66546.5,57.401931912112985,48.95505340881096,NaN,NaN,NaN,NaN,0.8610504586783642,12.440955287243227,89110849,0.15486615779441154,-0.013533818297617017,-0.16839997609202856
2025-08-08T14:55:00-04:00,330.81,330.83,330.3,330.48,NaN,NaN,NaN,331.8589994934591,NaN,NaN,330.69247999999953,333.50299110657966,327.8819688934194,329.02909135935096,330.664703851717,333.0102436554616,328.3191640479724,56470,65782.76666666666,54.29931460064749,49.562023989807585,NaN,NaN,NaN,NaN,0.8402611402013377,12.462900813304364,89054379,0.16517538851931807,0.03806925955711904,-0.12710612896219903
2025-08-08T15:00:00-04:00,330.48,330.48,329.59,329.79,NaN,NaN,NaN,331.8589994934591,NaN,NaN,330.60927999999956,333.2715208621679,327.9470391378312,329.02909135935096,330.65841974134315,332.99452507187067,328.32231441081564,72215,66437.16666666667,49.22945537536354,49.94394260498073,NaN,NaN,NaN,NaN,0.8438139159012452,11.746616859204204,88982164,0.12010286209026791,0.02302244865063585,-0.09708041343963206
2025-08-08T15:05:00-04:00,329.765,330.135,329.63,329.65,NaN,NaN,NaN,331.8589994934591,NaN,NaN,330.5400799999996,333.11722983190685,327.9629301680923,329.02909135935096,330.6527856702699,332.98219251352344,328.32337882701637,54327,66011.13333333333,48.2451744648806,49.941741106608234,NaN,NaN,NaN,NaN,0.8196129219082987,11.081496044682627,88927837,0.07750687589699876,-0.00019681856838360545,-0.07770369446538236
2025-08-08T15:10:00-04:00,329.63,329.71,329.06,329.16,NaN,NaN,NaN,331.8589994934591,NaN,NaN,330.4570799999996,332.937547370492,327.97661262950726,329.02909135935096,330.6424819403086,332.9658908298715,328.31907305074566,63634,65382.5,44.86416527889277,49.35377808976558,NaN,NaN,NaN,NaN,0.8074977132005614,11.240315823617854,88864203,0.016183252943322457,-0.05747462828622929,-0.07365788122955175
2025-08-08T15:15:00-04:00,329.15,329.48,328.93,329,NaN,NaN,NaN,331.8414687903707,NaN,NaN,330.40407999999957,332.8935547028565,327.91460529714266,329.02909135935096,330.6284042687918,332.9454631198271,328.31134541775657,78260,65554.83333333333,43.785149265334454,49.042650296869326,NaN,NaN,NaN,NaN,0.7891050194005221,11.552733525568094,88785943,-0.03264086011659986,-0.11445895637530157,-0.0818180962587017
2025-08-08T15:20:00-04:00,328.97,329.22,328.59,329.14,NaN,NaN,NaN,331.50753839080835,NaN,NaN,330.33047999999957,332.74640937814115,327.914550621858,329.02909135935096,330.61360901353754,332.9254474798766,328.3017705471985,75970,64526.2,45.03092386690556,48.806599251296554,NaN,NaN,NaN,NaN,0.7777403751576315,12.26347534606633,88861913,-0.051851387578152885,-0.1466323307313928,-0.09478094315323993
2025-08-08T15:25:00-04:00,329.12,329.22,328.47,328.63,NaN,NaN,NaN,331.4315139184989,NaN,NaN,330.2398799999995,332.56253305724886,327.9172269427502,329.02909135935096,330.5968485880321,332.90476620673275,328.2889309693315,77639,61306.566666666666,41.429113263816234,48.51482446762442,NaN,NaN,NaN,NaN,0.7757589197892293,13.068330595716793,88784274,-0.0928569473844612,-0.21085212738381642,-0.11799517999935523
2025-08-08T15:30:00-04:00,328.62,328.62,327.5,327.75,NaN,NaN,NaN,330.6830360131126,NaN,NaN,330.1252799999995,332.3609621259498,327.88959787404923,329.02909135935096,330.5609183167604,332.8733990224544,328.24843761106644,117613,61675.6,36.0682764833403,47.91818791449965,NaN,NaN,NaN,NaN,0.8010618540899983,14.818699431321741,88666661,-0.1687745278673896,-0.32896333983359227,-0.16018881196620266
2025-08-08T15:35:00-04:00,327.73,327.78,327.23,327.425,NaN,NaN,NaN,330.0838071034256,NaN,NaN,330.0099799999996,332.19561914683453,327.82434085316464,329.02909135935096,330.53348578297715,332.85378501581016,328.21318655014414,77600,62491.73333333333,34.30287750317946,46.91952339725406,NaN,NaN,NaN,NaN,0.783128864512138,16.67668701711338,88589061,-0.22679108682807922,-0.4436776705013017,-0.21688658367322247
2025-08-08T15:40:00-04:00,327.45,328.32,327.27,328.08,NaN,NaN,NaN,330.0838071034256,NaN,NaN,329.9171799999996,332.02739806268363,327.8069619373155,329.02909135935096,330.50512836702165,332.8289599870109,328.18129674703243,94555,64054.3,40.61186662833019,46.10965999790147,NaN,NaN,NaN,NaN,0.8021910884755575,17.385746794962852,88683616,-0.20748809510714056,-0.4762467025571482,-0.2687586074500076
2025-08-08T15:45:00-04:00,328.06,328.4,327.715,327.82,NaN,NaN,NaN,330.0838071034256,NaN,NaN,329.8293799999995,331.9158785368726,327.7428814631264,328.5942730874808,330.48009947181134,332.8058937035322,328.1543052400905,88184,64898.3,39.010425955093,45.23289306658239,NaN,NaN,NaN,NaN,0.7938202964415894,17.9007190996098,88595432,-0.19865485672418337,-0.5170771783552368,-0.31842232163105344
2025-08-08T15:50:00-04:00,327.83,329.1,327.7,329.07,NaN,NaN,NaN,330.0838071034256,NaN,NaN,329.7767799999996,331.8037492173679,327.74981078263124,328.37391846998463,330.44870939402574,332.76715041271683,328.13026837533465,153094,68292.06666666667,49.351108318369775,45.33089150901442,NaN,NaN,NaN,NaN,0.8371188466957641,17.221667506402717,88748526,-0.10002946288603376,-0.4434591502385956,-0.34342968735256185
2025-08-08T15:55:00-04:00,329.08,329.72,328.63,329.7,NaN,NaN,NaN,330.0838071034256,NaN,NaN,329.7432799999995,331.71818309846213,327.7683769015369,327.9761347759877,330.41766709800703,332.71036086393207,328.124973332082,263294,74601.16666666667,53.61931981268982,45.51779305206831,NaN,NaN,NaN,NaN,0.8551817862174975,16.24631014267745,89011820,0.010366844125423491,-0.3304711321957825,-0.340837976321206
2025-08-11T09:30:00-04:00,334.995,341.42,334.2,340.15,333.65224920407434,333.65224920407434,333.65224920407434,NaN,NaN,NaN,329.91247999999956,333.3976680695541,326.42729193044505,333.6928029735799,338.59,338.59,338.59,568798,91056.73333333334,81.48731739860693,47.23817772967502,NaN,NaN,NaN,NaN,1.6312402300591067,20.104388019042194,89580618,0.7490196051933213,0.5954365301704456,-0.15358307502287566
2025-08-11T09:35:00-04:00,340.14,341.35,338.2,340.66,335.37669242207096,NaN,NaN,NaN,NaN,NaN,330.1074799999995,334.706998135664,325.507961864335,333.6928029735799,339.1486125464486,339.8660375193063,338.4311875735909,344847,100556.46666666666,82.05404427846779,49.220658420947906,NaN,NaN,NaN,NaN,1.7397230707691729,23.68688890423802,89925465,1.2066751964738582,1.354760920569447,0.1480857240955889
2025-08-11T09:40:00-04:00,340.65,341.24,338.4,339.99,335.37669242207096,NaN,NaN,NaN,NaN,NaN,330.2876799999995,335.65218480029057,324.92317519970845,333.6928029735799,339.33285617894427,340.0290177911098,338.6366945667787,309544,107887.83333333333,78.64776575719591,51.32196630536449,NaN,NaN,NaN,NaN,1.8183142799999483,27.01349686906272,89615921,1.386161043053623,1.8807870279126178,0.4946259848589947
2025-08-11T09:45:00-04:00,340.02,343.26,340.02,342.12,336.8168726407713,NaN,NaN,NaN,NaN,NaN,330.4986799999995,336.79698008115247,324.2003799188466,335.52467512247284,339.9132286781503,341.1238747533755,338.7025826029251,376254,118872.63333333333,81.3048139963462,53.68336912904061,NaN,NaN,NaN,NaN,1.9220061171428078,30.37818102495125,89992175,1.557416655315186,2.441396804002977,0.8839801486877912
2025-08-11T09:50:00-04:00,342.11,342.95,340.53,340.67,336.8168726407713,NaN,NaN,NaN,NaN,NaN,330.68807999999956,337.59910065806827,323.77705934193085,335.55174009797827,340.07295838537,341.3041052139603,338.84181155677965,194966,123836.96666666666,74.50761681695349,55.80075852461638,NaN,NaN,NaN,NaN,1.9575771087754654,33.502530598276316,89797209,1.4825193099132712,2.73712928607938,1.254609976166109
2025-08-11T09:55:00-04:00,340.62,341.67,339.82,340.24,336.8168726407713,NaN,NaN,NaN,NaN,NaN,330.8728799999995,338.2834773378954,323.4622826621036,335.55174009797827,340.11734664112913,341.30163587980655,338.9330574024517,173410,127872.03333333334,72.57005226452105,57.856823024558274,NaN,NaN,NaN,NaN,1.9498930295772197,35.77881680534848,89623799,1.318979357735065,2.9033341733349403,1.5843548155998752
2025-08-11T10:00:00-04:00,340.35,341.51,339.28,339.83,336.8168726407713,NaN,NaN,NaN,NaN,NaN,331.05727999999954,338.8799273069075,323.23463269309156,335.55174009797827,340.1242726462604,341.26197057903386,338.98657471348696,165414,130981.6,70.68263330401125,59.689087984351545,NaN,NaN,NaN,NaN,1.9699006703217052,37.425610525019245,89458385,1.1067231039702887,2.967758695562736,1.8610355915924475
2025-08-11T10:05:00-04:00,339.86,339.92,338.85,339.8,336.8168726407713,NaN,NaN,NaN,NaN,NaN,331.2468799999995,339.4396416799387,323.05411832006035,335.55174009797827,340.0860935493222,341.1967729474814,338.97541415116297,144724,134352.06666666668,70.53807050949284,61.76829921618558,NaN,NaN,NaN,NaN,1.9056220510130115,38.582819805323815,89313661,0.8967875061514348,2.982019974281741,2.085232468130306
2025-08-11T10:10:00-04:00,339.77,341.22,339.5,340.99,336.8168726407713,NaN,NaN,NaN,NaN,NaN,331.4532799999995,340.08569494880413,322.82086505119486,335.7144727441319,340.12111511362156,341.19817124725324,339.04405897998987,177724,138863.76666666666,72.90529091802433,64.39951453294873,NaN,NaN,NaN,NaN,1.8923633330835126,39.97684214222001,89491385,0.7751252111903293,3.054138982118218,2.2790137709278886
2025-08-11T10:15:00-04:00,341.08,341.95,340.4,341.9,336.8168726407713,NaN,NaN,NaN,NaN,NaN,331.6760799999995,340.78718828694093,322.56497171305807,336.7705781953055,340.2011023122939,341.28998162556303,339.1122229990248,161590,142301.06666666668,74.58686087227255,67.27694191645539,NaN,NaN,NaN,NaN,1.867908809291834,41.43623295892692,89652975,0.6955330378447124,3.148430068233779,2.4528970303890665
2025-08-11T10:20:00-04:00,341.85,343.16,341.56,341.9,337.41483437024317,NaN,NaN,NaN,NaN,NaN,331.88207999999946,341.4321779249645,322.33198207503443,338.21646255624444,340.33913546794724,341.5061129094642,339.1721580264303,193448,146957.63333333333,74.58686087227255,69.70372721959413,NaN,NaN,NaN,NaN,1.8487724657709903,43.04466555452606,89652975,0.586822620381418,3.186425305865839,2.599602685484421
2025-08-11T10:25:00-04:00,341.84,342.03,340.83,341.35,337.41483437024317,NaN,NaN,NaN,NaN,NaN,332.0920799999995,341.99733496775815,322.18682503224085,338.21646255624444,340.37994615560507,341.54243345603385,339.2174588551763,112086,149045.43333333332,71.47736733413451,72.02279446095422,NaN,NaN,NaN,NaN,1.8024315753587759,43.89421181257575,89540889,0.42912302878456154,3.136006471465123,2.7068834426805615
2025-08-11T10:30:00-04:00,341.36,341.46,340.3,341.02,337.41483437024317,NaN,NaN,NaN,NaN,NaN,332.3210999999995,342.5079356795398,322.1342643204592,338.21646255624444,340.39677017719725,341.54511956374506,339.24842079064945,92798,149743.2,69.60242618175809,73.46931716548195,NaN,NaN,NaN,NaN,1.7565436056902897,44.22685461515484,89448091,0.26204667295115947,3.034441783869511,2.7723951109183513
2025-08-11T10:35:00-04:00,341.01,342.86,340.71,342.28,337.41483437024317,NaN,NaN,NaN,NaN,NaN,332.5742999999995,343.10358677745535,322.0450132225436,338.4059088287971,340.4567320837374,341.6217802793956,339.2916838880792,121091,152416.16666666666,72.56189947217322,74.82235856973078,NaN,NaN,NaN,NaN,1.7846476338552715,44.921456542358776,89569182,0.1987243897016029,3.020800598045355,2.822076208343752
2025-08-11T10:40:00-04:00,342.25,342.84,341.66,342.55,337.417274106786,NaN,NaN,NaN,NaN,NaN,332.8214999999995,343.6901625212961,321.9528374787029,338.6867270630377,340.50928359026256,341.6994071375405,339.3191600429846,89551,154050.33333333334,73.16481707730836,74.2278942610666,NaN,NaN,NaN,NaN,1.74145851715132,45.566444046191,89658733,0.14012018755882405,2.9972264427922823,2.8571062552334583
2025-08-11T10:45:00-04:00,342.5,343.14,341.78,341.825,337.66148892011387,NaN,NaN,NaN,NaN,NaN,333.0579999999994,344.1823996692858,321.93360033071303,339.13738165043014,340.5890364277732,341.80713816799255,339.3709346875538,155067,157892.53333333333,68.79351945541775,73.28071391656303,NaN,NaN,NaN,NaN,1.7142114802119408,46.24897773588481,89503666,0.023727378615162387,2.8867654785024115,2.863038099887249
2025-08-11T10:50:00-04:00,341.835,342.18,341.06,342.13,337.66148892011387,NaN,NaN,NaN,NaN,NaN,333.3145999999995,344.66991520310853,321.9592847968904,339.13738165043014,340.6165195729253,341.8339216360161,339.3991175098345,79191,157778.6,69.6159519034298,72.63558435557972,NaN,NaN,NaN,NaN,1.6717678030539453,46.199622345030946,89582857,-0.0571065919083944,2.7916548600017563,2.8487614519101507
2025-08-11T10:55:00-04:00,342.11,343.14,341.52,342.6,337.66148892011387,NaN,NaN,NaN,NaN,NaN,333.5785999999995,345.1689392599997,321.98826073999925,339.3203242562753,340.6759765832476,341.91569489788765,339.4362582686075,117975,159828.76666666666,70.889141720854,71.89160776447315,NaN,NaN,NaN,NaN,1.668070102835807,46.47005788593316,89700832,-0.10075544908841128,2.722817140549637,2.823572589638048
2025-08-11T11:00:00-04:00,342.6,343.71,342.1,342.31,338.16196740131244,NaN,NaN,NaN,NaN,NaN,333.8355999999995,345.6175237207635,322.0536762792355,339.84925940502023,340.7528241891792,342.0291033517322,339.4765450266262,140747,162113.16666666666,68.96877204826164,71.49597599528087,NaN,NaN,NaN,NaN,1.6639222383475318,46.8977734287633,89560085,-0.16708103485257286,2.6147212960723323,2.781802330924905
2025-08-11T11:05:00-04:00,342.26,342.65,341.88,342.08,338.16196740131244,NaN,NaN,NaN,NaN,NaN,334.1035999999995,346.0131602001855,322.19403979981354,339.84925940502023,340.78864568670133,342.0690120446694,339.50827932873324,94175,163441.43333333332,67.4090828644662,71.12733532384838,NaN,NaN,NaN,NaN,1.6000706498941355,47.07568827444318,89465910,-0.23993318666393915,2.481885847594981,2.72181903425892
2025-08-11T11:10:00-04:00,342.1,342.98,341.96,342.76,338.16196740131244,NaN,NaN,NaN,NaN,NaN,334.3789999999995,346.43872603344806,322.31927396655095,339.84925940502023,340.8211677004035,342.11195033373014,339.5303850670769,71051,163688.66666666666,69.59811359650223,71.0498696304549,NaN,NaN,NaN,NaN,1.558637032044557,47.35476588564181,89536961,-0.25443610311270337,2.403773905368041,2.6582100084807445
2025-08-11T11:15:00-04:00,342.74,343.33,342,343.01,338.16196740131244,NaN,NaN,NaN,NaN,NaN,334.6717999999995,346.84410261872637,322.49949738127265,340.0339008153704,340.887123192168,342.20426623884543,339.5699801454906,135350,165591.66666666666,70.38565463301708,71.0389827821352,NaN,NaN,NaN,NaN,1.5423058154699447,47.735500451419874,89672311,-0.25846826649898924,2.335124675357008,2.5935929418559973
2025-08-11T11:20:00-04:00,343.03,343.88,342.72,343,338.8129424525931,NaN,NaN,NaN,NaN,NaN,334.92939999999953,347.2497377616774,322.60906223832166,340.6631206522963,340.9737955064564,342.33864130843324,339.6089497044795,156502,168276.06666666668,70.30720026294841,70.8534048782012,NaN,NaN,NaN,NaN,1.5149982572220893,48.276637943403244,89515809,-0.2717296831808613,2.2539308378799205,2.525660521060782
2025-08-11T11:25:00-04:00,343.02,344.3,342.94,344.07,339.1514450683843,NaN,NaN,NaN,NaN,NaN,335.2241999999995,347.6989295538581,322.7494704461409,341.04649652183707,341.0705335884595,342.50562916121316,339.63543801570586,149662,170676.83333333334,73.68686789686988,70.78911966567243,NaN,NaN,NaN,NaN,1.503926953134798,48.918474476052594,89665471,-0.2205382278158563,2.2499877362909615,2.470525964106818
2025-08-11T11:30:00-04:00,344.03,344.4,343.53,344.2,339.58092483800317,NaN,NaN,NaN,NaN,NaN,335.52839999999946,348.12144195823674,322.9353580417622,341.3621972174696,341.1301525908087,342.6106516005706,339.6496535810468,88532,169707.46666666667,74.07298550911038,70.75241428258943,NaN,NaN,NaN,NaN,1.458646456482313,49.54825859639885,89754003,-0.19111845434869545,2.2316278961709486,2.422746350519644
2025-08-11T11:35:00-04:00,344.19,344.79,344.06,344.7,340.1406555271849,NaN,NaN,NaN,NaN,NaN,335.82979999999947,348.5643006907173,323.09529930928164,341.9947577739757,341.20821618682663,342.7572872663657,339.65914510728754,104161,170592.83333333334,75.55853019501221,71.04392591550926,NaN,NaN,NaN,NaN,1.406600281019292,50.267181890782794,89858164,-0.15283884921725432,2.2316977889980762,2.3845366382153306
2025-08-11T11:40:00-04:00,344.7,345.55,344.1,344.1,340.53767118504015,NaN,NaN,NaN,NaN,NaN,336.1035999999994,348.9484199739083,323.2587800260905,342.5888062191806,341.37191294575194,343.0479010562221,339.6959248352818,230331,175118.7,70.34946337859535,71.09728571528335,NaN,NaN,NaN,NaN,1.4097002609464846,51.18078358681883,89627833,-0.18086383294314068,2.1584568470364047,2.3393206799795454
2025-08-11T11:45:00-04:00,344.18,344.65,343.42,344.6,340.53767118504015,NaN,NaN,NaN,NaN,NaN,336.40339999999946,349.3274720271113,323.47932797288763,342.5888062191806,341.4349629088684,343.14453368472516,339.7253921330116,107383,175758.66666666666,72.07705498518212,71.06265396621257,NaN,NaN,NaN,NaN,1.396864528021733,51.14468296280715,89735216,-0.1783664770157385,2.116362583709872,2.2947290607256106
2025-08-11T11:50:00-04:00,344.6,345.4,344.07,345.26,340.53767118504015,NaN,NaN,NaN,NaN,NaN,336.71579999999943,349.72567799489326,323.7059220051056,342.5888062191806,341.51851989575346,343.28932187212814,339.7477179193788,119648,174643.8,74.21289959690013,71.13751700332627,NaN,NaN,NaN,NaN,1.392088490305894,51.40265213133854,89854864,-0.1462518659422094,2.1119142282978487,2.258166094240058
2025-08-11T11:55:00-04:00,345.28,345.42,344.85,345.24,341.0024622318423,NaN,NaN,NaN,NaN,NaN,337.03699999999947,350.0797812985536,323.99421870144533,342.6932687842205,341.5894520218388,343.4139524884824,339.7649515551952,98577,169153.23333333334,74.02811071332818,71.5114163788913,NaN,NaN,NaN,NaN,1.3333678838554728,51.64985518106614,89756287,-0.14031990791387816,2.08276620934771,2.2230861172615883
2025-08-11T12:00:00-04:00,345.26,345.37,344.75,345.28,341.03075940312215,NaN,NaN,NaN,NaN,NaN,337.3625999999994,350.3994085420488,324.32579145795006,342.8786150273764,341.64691955413247,343.5111024156024,339.7827366926625,83646,152981.5,74.16665599738658,71.83646667131678,NaN,NaN,NaN,NaN,1.2824130350086536,51.739995302227115,89839933,-0.14696081533098848,2.0393850980978527,2.186345913428841
2025-08-11T12:05:00-04:00,345.23,346.21,344.95,346.21,341.5620885211621,NaN,NaN,NaN,NaN,NaN,337.6963999999994,350.7675245178833,324.6252754821155,343.58689202190106,341.7622637085729,343.72262182963885,339.80190558750695,147719,146410.56666666668,77.21055101552182,72.2879959066502,NaN,NaN,NaN,NaN,1.2808121039366063,52.167904012795596,89987652,-0.10400134966897934,2.056344226342617,2.160345576011596
2025-08-11T12:10:00-04:00,346.2,346.38,345.22,345.27,341.80653904292745,NaN,NaN,NaN,NaN,NaN,338.00079999999946,351.05434424828263,324.9472557517163,343.7015136175209,341.8654772994802,343.89725856627933,339.833696032681,145734,140950.23333333334,68.4335221969601,72.24976377441438,NaN,NaN,NaN,NaN,1.272182667941132,52.63112074077073,89841918,-0.15130732848288275,1.9712114154079927,2.1225187438908755
2025-08-11T12:15:00-04:00,345.22,345.92,344.87,345.73,341.80653904292745,NaN,NaN,NaN,NaN,NaN,338.31619999999947,351.33940982868285,325.2929901713161,343.7015136175209,341.9351544956203,344.0083145861302,339.86199440511035,106358,131953.7,70.21772184518812,72.45038084446593,NaN,NaN,NaN,NaN,1.2563124773739092,52.53835173281216,89948276,-0.16302049223051807,1.9187431286027277,2.0817636208332457
2025-08-11T12:20:00-04:00,345.8,346.33,345.63,346.04,342.10920189655167,NaN,NaN,NaN,NaN,NaN,338.6467999999994,351.59807186966793,325.6955281303309,343.84576871521335,342.0046596592773,344.12649796021367,339.88282135834095,96691,128677.86666666667,71.39127917102692,72.57846409978913,NaN,NaN,NaN,NaN,1.2165758718472006,52.64343136197592,90044967,-0.1610118385385042,1.8804988226601154,2.0415106611986196
2025-08-11T12:25:00-04:00,346.05,346.45,345.86,346.38,342.37969271943564,NaN,NaN,NaN,NaN,NaN,338.97619999999944,351.85948693470687,326.092913065292,344.1676149721707,342.0630489762612,344.22713955498733,339.89895839753507,79237,125538.76666666666,72.66358035890347,72.74117308020958,NaN,NaN,NaN,NaN,1.1718204524295415,52.79699179467416,90124204,-0.14822640399292286,1.8562276562074658,2.0044540602003886
2025-08-11T12:30:00-04:00,346.4,346.64,346.16,346.26,342.7308430503704,NaN,NaN,NaN,NaN,NaN,339.2839999999994,352.1131691080138,326.45483089198507,344.5740919777366,342.1208439697216,344.3264766521013,339.9152112873419,78298,122634.9,71.45572334602744,72.82321044328667,NaN,NaN,NaN,NaN,1.1224047058274287,53.03077085999591,90045906,-0.15837481299332756,1.806485543958729,1.9648603569520566
2025-08-11T12:35:00-04:00,346.3,346.4,344.78,345.24,342.7308430503704,NaN,NaN,NaN,NaN,NaN,339.5791999999994,352.2628938406032,326.89550615939555,344.5740919777366,342.18178452443095,344.4126976042682,339.9508714445937,107610,121397.76666666666,62.01888915596767,71.98978339036508,NaN,NaN,NaN,NaN,1.1579472268397555,51.23094828914741,89938296,-0.23944064365788154,1.6655595523797047,1.9050001960375862
2025-08-11T12:40:00-04:00,345.2,345.34,344.3,344.7,342.7308430503704,NaN,NaN,NaN,NaN,NaN,339.8773999999994,352.325368868941,327.4294311310578,344.5740919777366,342.21993666369684,344.4563541778116,339.9835191495821,88223,118414.4,57.676149126184626,70.81858079158467,NaN,NaN,NaN,NaN,1.1495224249226277,48.98015083335911,89850073,-0.32952832323113257,1.4930897919986705,1.822618115229803
2025-08-11T12:45:00-04:00,344.72,345.18,344.44,345.18,342.7308430503704,NaN,NaN,NaN,NaN,NaN,340.1879999999994,352.37190200231765,328.0040979976812,344.5740919777366,342.2492435317721,344.4911633906741,340.0073236728701,65601,115214.76666666666,60.33491673921958,69.73117983045663,NaN,NaN,NaN,NaN,1.1202708231424405,46.89012462441283,89915674,-0.35470309909267295,1.3792392413639618,1.7339423404566348
2025-08-11T12:50:00-04:00,345.18,345.33,344.24,344.375,342.7308430503704,NaN,NaN,NaN,NaN,NaN,340.49229999999943,352.31389925061035,328.6707007493885,344.5740919777366,342.2763720176955,344.51996666332315,340.03277737206787,69466,111082.03333333334,54.18697888269214,68.57671665217782,NaN,NaN,NaN,NaN,1.1181086214894074,44.6949145874238,89846208,-0.4190692790234256,1.2101057416773529,1.6291750207007785
2025-08-11T12:55:00-04:00,344.375,344.66,344,344.36,342.7308430503704,NaN,NaN,NaN,NaN,NaN,340.7994999999994,352.2014126905172,329.3975873094816,344.5740919777366,342.30391192862544,344.54503078426455,340.0627930729863,83092,110115.56666666667,54.07640599966979,67.29095601035552,NaN,NaN,NaN,NaN,1.0853865770973086,42.34925174137974,89763116,-0.4532545921771718,1.0626067804793138,1.5158613726564856
2025-08-11T13:00:00-04:00,344.37,344.9,344,344.6,342.7308430503704,NaN,NaN,NaN,NaN,NaN,341.10869999999943,352.05863987389995,330.1587601260989,344.5740919777366,342.3248384719394,344.5654347775904,340.08424216628845,59901,109019,55.63626888756932,65.96405381683188,NaN,NaN,NaN,NaN,1.0721446787332136,40.41259696173773,89823017,-0.4494245089585869,0.954080736458252,1.4035052454168389
2025-08-11T13:05:00-04:00,344.62,344.62,343.73,343.81,342.7308430503704,NaN,NaN,NaN,NaN,NaN,341.4122999999994,351.78817667824626,331.0364233217525,344.5740919777366,342.34086322052906,344.5771930570276,340.1045333840305,58824,106943.43333333333,49.65720294865498,64.22327469078381,NaN,NaN,NaN,NaN,1.059134344537983,38.24880333184303,89764193,-0.48667575543266883,0.7951605511260027,1.2818363065586715
2025-08-11T13:10:00-04:00,343.83,344,343.3,343.36,342.7308430503704,NaN,NaN,NaN,NaN,NaN,341.7244999999994,351.3494544935084,332.0995455064904,344.5740919777366,342.35149696764813,344.5808666781023,340.12212725719394,56140,105829.73333333334,46.58605070102702,62.253231455329555,NaN,NaN,NaN,NaN,1.0334818913566977,35.682964478815435,89708053,-0.5249159733965922,0.6256913398129313,1.1506073132095236
2025-08-11T13:15:00-04:00,343.39,343.5,342.81,342.93,342.7308430503704,NaN,NaN,NaN,NaN,NaN,342.0345999999994,350.75316085384344,333.31603914615533,344.5740919777366,342.36254714159537,344.57673532988036,340.1483589533104,98590,103947.16666666667,43.79852305036077,59.866658029246615,NaN,NaN,NaN,NaN,1.0089474705455048,33.55196919376247,89609463,-0.559298701156766,0.4514839367635659,1.010782637920332
2025-08-11T13:20:00-04:00,343,344.13,342.87,343.62,342.7308430503704,NaN,NaN,NaN,NaN,NaN,342.34539999999936,350.10745690279475,334.58334309720397,343.9372735821892,342.37902633667613,344.5820120053167,340.17604066803557,92259,104382.76666666666,49.06527179700544,58.483211572107,NaN,NaN,NaN,NaN,1.0268797940779681,31.490746722761482,89701722,-0.5167106910351347,0.3648942741264136,0.8816049651615483
2025-08-11T13:25:00-04:00,343.62,343.63,342.23,342.39,NaN,NaN,NaN,346.32820379926255,346.32820379926255,346.32820379926255,342.63679999999937,349.19660571680214,336.0769942831966,342.8952840740809,342.38398251928123,344.5726173017812,340.1953477367813,89261,103425.63333333333,41.58419848134522,56.43795990326108,NaN,NaN,NaN,NaN,1.0535312373581116,29.640934017192944,89612461,-0.549463673789289,0.19477537292493707,0.744239046714226
2025-08-11T13:30:00-04:00,342.39,342.77,341.99,342.29,NaN,NaN,NaN,345.7301036265688,NaN,NaN,342.9011999999994,348.1961408157375,337.60625918426126,342.8952840740809,342.3835998889799,344.55988114490805,340.2073186330518,76085,101270.23333333334,41.03637796227139,54.26975267406426,NaN,NaN,NaN,NaN,1.0339932918325303,28.18064780855405,89536376,-0.55435566683111,0.05129446317533848,0.6056501300064485
2025-08-11T13:35:00-04:00,342.29,343.13,342.29,342.84,NaN,NaN,NaN,345.7301036265688,NaN,NaN,343.16399999999936,346.8813522838536,339.44664771614515,342.8952840740809,342.3868851252896,344.5537540310731,340.22001621950614,60580,100150.4,45.30424567105974,52.315514482075415,NaN,NaN,NaN,NaN,1.020136628130205,26.37166397322817,89596956,-0.4987835147385876,-0.017829263416786034,0.4809542513218016
2025-08-11T13:40:00-04:00,342.85,343.3,342.34,342.95,NaN,NaN,NaN,345.7301036265688,NaN,NaN,343.21999999999935,346.8370557090415,339.60294429095717,342.6277818074118,342.3898977780732,344.550235237977,340.2295603181694,43385,99228.2,46.14385401520579,50.507523815588165,NaN,NaN,NaN,NaN,1.0158411546923358,24.49482269931795,89640341,-0.43516973545851867,-0.06300791800134675,0.3721618174571719
2025-08-11T13:45:00-04:00,342.95,343.119,342.4,342.57,NaN,NaN,NaN,345.7301036265688,NaN,NaN,343.25819999999936,346.8059833984289,339.7104166015698,342.6277818074118,342.39214876173395,344.54469605450015,340.23960146896775,50774,96409,43.651021308932435,49.19553325508564,NaN,NaN,NaN,NaN,0.9946382150714583,22.752041516401317,89589567,-0.40012917489387084,-0.12799965116016665,0.2721295237337042
2025-08-11T13:50:00-04:00,342.57,342.75,342.05,342.27,NaN,NaN,NaN,345.5892268774278,NaN,NaN,343.3037999999994,346.7392158761651,339.8683841238337,342.35722544592943,342.3918883724576,344.53652490617185,340.2472518387433,51100,92895.6,41.73414904481406,48.056818963559174,NaN,NaN,NaN,NaN,0.9735926282806391,21.578410954836365,89538467,-0.3788172499186041,-0.2013920386645509,0.17742521125405317
2025-08-11T13:55:00-04:00,342.23,342.62,341.95,342.6,NaN,NaN,NaN,345.4206256557265,NaN,NaN,343.3133999999994,346.73819630959485,339.8886036904039,341.8414594283159,342.391871674563,344.5270052091896,340.2567381399364,62121,89977.56666666667,44.61529953902306,46.93398916354513,NaN,NaN,NaN,NaN,0.9519074405463088,20.618051273755825,89600588,-0.3261588447417632,-0.23027334467315086,0.09588550006861235
2025-08-11T14:00:00-04:00,342.59,342.75,342,342.08,NaN,NaN,NaN,345.4206256557265,NaN,NaN,343.3415999999994,346.7014728788742,339.9817271211246,341.8414594283159,342.390805668717,344.5160665470854,340.2655447903486,65613,89213.6,41.16135323420193,46.00358733151012,NaN,NaN,NaN,NaN,0.9374854805072868,19.522626588261073,89534975,-0.3101151459329181,-0.2917584323475353,0.018356713585382822
2025-08-11T14:05:00-04:00,342.13,342.45,341.88,342.03,NaN,NaN,NaN,345.197398583007,NaN,NaN,343.37739999999934,346.64108640686294,340.11371359313574,341.8414594283159,342.3881478271742,344.50312222173955,340.2731734326088,70284,88084.36666666667,40.83400867313264,45.05770180818603,NaN,NaN,NaN,NaN,0.9112365176139087,18.67825618021458,89464691,-0.28716075579146094,-0.3405942311539434,-0.05343347536248243
2025-08-11T14:10:00-04:00,342.05,342.6,341.61,342.36,NaN,NaN,NaN,345.1345622837795,NaN,NaN,343.4279999999994,346.5452892073549,340.3107107926438,341.0991675426527,342.3860466707839,344.48987550330384,340.282217838264,76751,82965.03333333334,43.99946468252728,44.22650150782589,NaN,NaN,NaN,NaN,0.9168624806414873,18.278451539886493,89541442,-0.23617297556686437,-0.3486496948210629,-0.11247671925419853
2025-08-11T14:15:00-04:00,342.4,342.52,341.91,342.06,NaN,NaN,NaN,345.1345622837795,NaN,NaN,343.47319999999934,346.4406977746128,340.5057022253859,340.9386137818382,342.3845973154897,344.48164587706896,340.28754875391047,47411,80965.96666666666,41.80952875914035,43.66595335143198,NaN,NaN,NaN,NaN,0.8949437320242352,17.907204373867554,89494031,-0.2099541154487539,-0.3749193635651409,-0.164965248116387
2025-08-11T14:20:00-04:00,342.06,342.31,341.87,342.04,NaN,NaN,NaN,344.9898077833611,NaN,NaN,343.49419999999935,346.40543709827506,340.58296290172365,340.9386137818382,342.3818240393225,344.4697145260268,340.2939335526182,65494,79160.83333333333,41.66065999425262,43.314139729519525,NaN,NaN,NaN,NaN,0.8624477511653611,17.62403164259989,89428537,-0.1822868968042382,-0.39282386912168477,-0.21053697231744656
2025-08-11T14:25:00-04:00,342.03,343.07,342,342.15,NaN,NaN,NaN,344.9898077833611,NaN,NaN,343.49919999999935,346.4003090021341,340.5980909978646,341.1322714553478,342.3820639368937,344.4598503318246,340.3042775419628,71677,78264.16666666667,42.86562155450176,43.24750390838674,NaN,NaN,NaN,NaN,0.8772729117964062,16.741928280420602,89500214,-0.14645047140708897,-0.3936000615763078,-0.2471495901692188
2025-08-11T14:30:00-04:00,342.17,342.41,340.8,341.56,NaN,NaN,NaN,344.60600254640957,NaN,NaN,343.4923999999994,346.4100176860888,340.57478231391,341.1322714553478,342.36979247185,344.4337399217612,340.30584502193886,116807,79369.53333333334,38.29666858844527,42.478317964918155,NaN,NaN,NaN,NaN,0.9296105609538067,16.845221003766504,89383407,-0.15171092454151835,-0.43678824584611675,-0.2850773213045984
2025-08-11T14:35:00-04:00,341.52,342.46,340.65,342.36,NaN,NaN,NaN,344.60600254640957,NaN,NaN,343.51259999999934,346.38422967011735,340.6409703298813,341.1322714553478,342.3627457168303,344.414268994908,340.3112224387526,98492,77728.63333333333,46.60693708621573,42.83708500812319,NaN,NaN,NaN,NaN,0.9924955208856777,17.111350877477097,89481899,-0.09340201072340043,-0.4018298347088489,-0.3084278239854485
2025-08-11T14:40:00-04:00,342.43,343.22,342.22,342.28,NaN,NaN,NaN,344.60600254640957,NaN,NaN,343.5377999999993,346.3428341606386,340.73276583936007,341.1322714553478,342.36508751475384,344.4052916426151,340.32488338689257,85890,75733.83333333333,45.940609370477056,43.18738725156645,NaN,NaN,NaN,NaN,0.9930315551081293,16.177409108533112,89396009,-0.05425236093981761,-0.3762432751602205,-0.3219909142204029
2025-08-11T14:45:00-04:00,342.27,343.31,342.04,343.15,NaN,NaN,NaN,344.60600254640957,NaN,NaN,343.5551999999994,346.3395261019786,340.77087389802017,341.1322714553478,342.3685401952461,344.4016032402326,340.33547715025963,57375,74101.06666666667,53.69395208148068,43.78665199516794,NaN,NaN,NaN,NaN,1.0128150154575475,15.541836731903267,89453384,0.031586776721720555,-0.28250744331825217,-0.3140942200399727
2025-08-11T14:50:00-04:00,343.17,343.76,343.15,343.7,NaN,NaN,NaN,344.60600254640957,NaN,NaN,343.57819999999936,346.34789295090417,340.80850704909454,341.1989571104884,342.37814416765764,344.405578182271,340.3507101530443,64504,73028.16666666667,57.81323982215082,44.620179552806874,NaN,NaN,NaN,NaN,0.9840425143534379,14.550838998837728,89517888,0.12169650634559442,-0.1619735871079797,-0.28367009345357413
2025-08-11T14:55:00-04:00,343.68,344.08,343.61,343.79,NaN,NaN,NaN,344.60600254640957,NaN,NaN,343.6174999999993,346.3419656361024,340.8930343638963,341.7961656883907,342.3903305947621,344.4135485579066,340.36711263161754,66565,72605.76666666666,58.46437279571935,45.67827608757737,NaN,NaN,NaN,NaN,0.9473251918996188,14.052299047610422,89584453,0.18012576303945704,-0.05851288965425283,-0.23863865269370987
2025-08-11T15:00:00-04:00,343.78,343.87,342.42,342.46,NaN,NaN,NaN,344.60600254640957,NaN,NaN,343.6240999999993,346.3356882361355,340.9125117638631,341.7961656883907,342.3963018482272,344.40878256547677,340.38382113097765,90793,73022.26666666666,46.93545885101926,46.04979821659203,NaN,NaN,NaN,NaN,0.9832305353353595,13.997067938455077,89493660,0.12460372919715698,-0.08288399119726364,-0.20748772039442062
2025-08-11T15:05:00-04:00,342.42,342.66,341.99,342.2,NaN,NaN,NaN,344.60600254640957,NaN,NaN,343.6160999999993,346.34204885543767,340.8901511445609,341.7961656883907,342.39532184790227,344.39908181585525,340.3915618799493,70033,71769.7,45.064608311209184,46.081891700319616,NaN,NaN,NaN,NaN,0.9608569256685493,14.380230409855743,89423627,0.06857069399126955,-0.12177435290533367,-0.19034504689660323
2025-08-11T15:10:00-04:00,342.2,342.99,341.98,342.05,NaN,NaN,NaN,344.60600254640957,NaN,NaN,343.61089999999933,346.3477651340961,340.87403486590256,341.7961656883907,342.39486179738344,344.3902791703606,340.3994444244063,67697,71085.5,43.975548125053166,46.2829056210947,NaN,NaN,NaN,NaN,0.9643671452636522,14.268895445948719,89355930,0.022018373863972207,-0.16282207956663797,-0.18484045343061017
2025-08-11T15:15:00-04:00,342.07,342.45,341.9,342.07,NaN,NaN,NaN,344.60600254640957,NaN,NaN,343.6106999999993,346.34801401967184,340.8733859803268,341.7961656883907,342.3925119567686,344.37885846152966,340.40616545200754,75756,71424,44.16928526687534,46.52113966350489,NaN,NaN,NaN,NaN,0.9347694920305349,14.253329164615797,89431686,-0.005352449657743563,-0.19153101550278961,-0.18617856584504605
2025-08-11T15:20:00-04:00,342.12,342.28,341.94,342.04,NaN,NaN,NaN,344.60600254640957,NaN,NaN,343.5962999999993,346.3588226229651,340.8337773770335,341.7961656883907,342.39055707856704,344.37069533178885,340.41041882534523,52855,70870.3,43.92392043765014,46.51574364601367,NaN,NaN,NaN,NaN,0.892285956885495,14.23887476052094,89378831,-0.022444542792681904,-0.21423424433589844,-0.19178970154321653
2025-08-11T15:25:00-04:00,342.03,342.19,341.62,341.945,NaN,NaN,NaN,344.60600254640957,NaN,NaN,343.57499999999925,346.37149065838827,340.77850934161023,341.7961656883907,342.3868437435037,344.35962219965916,340.4140652873482,65541,70285.26666666666,43.10728237630702,46.608440332954146,NaN,NaN,NaN,NaN,0.8692655313936734,14.602429187720055,89313290,-0.036295123582918504,-0.23715860602186467,-0.20086348243894617
2025-08-11T15:30:00-04:00,342.01,342.08,341.06,341.13,NaN,NaN,NaN,344.39544051579463,NaN,NaN,343.5375999999993,346.41276207583695,340.6624379241617,341.7961656883907,342.3747065532763,344.3379632219146,340.41144988463805,106332,71832.96666666666,36.7881785186336,46.26040594183849,NaN,NaN,NaN,NaN,0.8800322791512668,15.53768129572391,89206958,-0.09325391092228405,-0.31743087109180124,-0.2241769601695172
2025-08-11T15:35:00-04:00,341.12,341.25,340.295,340.7,NaN,NaN,NaN,343.59973867416767,NaN,NaN,343.4701999999993,346.44843233519606,340.49196766480253,341.7961656883907,342.3544749985474,344.31379230180187,340.39515769529294,106328,73416.43333333333,33.959631826121296,45.624263818382744,NaN,NaN,NaN,NaN,0.8853871163547467,17.089860228986584,89100630,-0.149463868133499,-0.41100679533639095,-0.26154292720289196
2025-08-11T15:40:00-04:00,340.7,341.08,340.5,340.89,NaN,NaN,NaN,343.5678187344327,NaN,NaN,343.40399999999937,346.4605215527093,340.34747844728946,341.7961656883907,342.34241263284514,344.298685839709,340.3861394259813,67872,73807.5,36.290558924287865,45.480970270942926,NaN,NaN,NaN,NaN,0.8635737509008351,18.531169238444782,89168502,-0.16235024433229112,-0.46448073261825584,-0.3021304882859647
2025-08-11T15:45:00-04:00,340.88,340.88,340.1,340.48,NaN,NaN,NaN,343.24928151923126,NaN,NaN,343.3195999999994,346.46021194068913,340.1789880593097,341.31793255071256,342.3198504190709,344.27480226157195,340.3648985765699,106035,74055.66666666667,33.53955365142802,44.547585739886664,NaN,NaN,NaN,NaN,0.8583184829793443,20.20252514363312,89062467,-0.18532728337927706,-0.5337895925100611,-0.348462309130784
2025-08-11T15:50:00-04:00,340.52,341.3,339.54,340.08,NaN,NaN,NaN,343.24928151923126,NaN,NaN,343.2391999999994,346.49933273379827,339.97906726620056,340.58367683245604,342.27903393189996,344.23475774026326,340.32331012353666,180482,76996.43333333333,31.06535321201494,43.485067442853655,NaN,NaN,NaN,NaN,0.9227243056236762,22.1724193752923,88881985,-0.21236388505151116,-0.6139171654451729,-0.4015532803936618
2025-08-11T15:55:00-04:00,340.03,340.03,338.8,339.23,NaN,NaN,NaN,342.33277510326644,NaN,NaN,343.1317999999994,346.55526009792305,339.7083399020757,340.58367683245604,342.2029847857648,344.1884690738986,340.21750049763097,237566,81939.93333333333,26.57841316131021,41.548243234270046,NaN,NaN,NaN,NaN,0.948243998079126,24.469350579564036,88644419,-0.2687615670619906,-0.7375052392211501,-0.46874367215915946
2025-08-12T09:30:00-04:00,345.12,345.24,341.57,343.04,339.80030558324563,339.80030558324563,339.80030558324563,NaN,NaN,NaN,343.0873999999993,346.4564546095787,339.7183453904199,340.3609625382175,343.2833333333333,343.2833333333333,343.2833333333333,321769,90129.4,56.73987859144138,41.471574574933655,NaN,NaN,NaN,NaN,1.3097979982163306,24.21368068901664,88966188,-0.04260287035960236,-0.5219972601086624,-0.47939438974906007
2025-08-12T09:35:00-04:00,343.19,343.54,341.02,341.69,339.80030558324563,NaN,NaN,NaN,NaN,NaN,343.0163999999993,346.35044981401546,339.6823501859831,340.3609625382175,342.77267707613635,343.36598786788727,342.1793662843854,238362,96055.46666666666,49.050892703652615,40.79918313978603,NaN,NaN,NaN,NaN,1.3962409983437385,23.52292488856604,88727826,0.019599033162728097,-0.45489559829564996,-0.47449463145837806
2025-08-12T09:40:00-04:00,341.7,342.09,339.65,340.11,NaN,NaN,NaN,344.8151864417121,344.8151864417121,344.8151864417121,342.91299999999933,346.28034079093527,339.5456592090634,340.3609625382175,342.1902522639911,343.27349688322136,341.10700764476087,207319,101519.93333333333,41.895182413809145,40.43916339427103,NaN,NaN,NaN,NaN,1.4707952127477568,21.87148885757513,88520507,-0.038947464314769975,-0.5231789618518405,-0.48423149753707057
2025-08-12T09:45:00-04:00,340.08,340.98,336.86,337.39,NaN,NaN,NaN,343.24767796708886,NaN,NaN,342.7365999999993,346.31223725261617,339.1609627473825,340.1650384028948,341.33743713055816,343.18277214679705,339.49210211431927,223572,107279.86666666667,32.976399879735425,39.57571993488005,NaN,NaN,NaN,NaN,1.6600241261229172,21.808446136424177,88296935,-0.24277098371520367,-0.7876952271810751,-0.5449242434658714
2025-08-12T09:50:00-04:00,337.37,339.29,336.76,338.58,NaN,NaN,NaN,342.50096533222114,NaN,NaN,342.6027999999993,346.28821838091505,338.9173816190836,340.1650384028948,340.7866409946893,342.8420580842125,338.73122390516613,211846,112638.06666666667,39.0861094773129,39.226474317184305,NaN,NaN,NaN,NaN,1.7221652599712822,21.79594094349408,88508781,-0.2768861705774157,-0.891031956687641,-0.6141457861102253
2025-08-12T09:55:00-04:00,338.56,338.78,335.76,335.92,NaN,NaN,NaN,341.9543305443929,NaN,NaN,342.4065999999994,346.4338528803275,338.3793471196713,340.1650384028948,340.2699817932821,342.60598852610667,337.93397506045756,180138,116571.96666666666,32.052555353821205,38.360993609109016,NaN,NaN,NaN,NaN,1.8148677414019037,22.236335412359004,88328643,-0.447910014040408,-1.1740333036607353,-0.7261232896203274
2025-08-12T10:00:00-04:00,335.94,336.1,334.2,334.9,NaN,NaN,NaN,339.8804973378296,NaN,NaN,342.1837999999994,346.5965091726243,337.7710908273745,340.1650384028948,339.5524284409703,342.3672416803637,336.7376152015769,221229,121759.16666666667,29.83544111385838,37.3546736574096,NaN,NaN,NaN,NaN,1.8209486170160558,23.2599394591025,88107414,-0.5900983524356815,-1.4637462301649293,-0.8736478777292478
2025-08-12T10:05:00-04:00,334.8,336.17,334.65,335.08,NaN,NaN,NaN,339.8804973378296,NaN,NaN,341.95779999999934,346.63713420929344,337.27846579070524,340.1650384028948,339.1459599544927,342.1004647076094,336.191455201376,169547,125067.93333333333,30.74583291852977,36.47171298185408,NaN,NaN,NaN,NaN,1.7994522872291974,24.154443112236095,88276961,-0.6288332571462374,-1.6596894491620446,-1.0308561920158072
2025-08-12T10:10:00-04:00,335.09,335.8,332.96,335.47,NaN,NaN,NaN,339.27534984707205,NaN,NaN,341.7419999999994,346.5996228756657,336.88437712433307,340.1650384028948,338.69313342484605,341.79472210818,335.5915447415121,203356,129288.1,32.780905865714715,36.185479220931306,NaN,NaN,NaN,NaN,1.8737771238556855,25.580650276183427,88480317,-0.585860058543344,-1.7631812651949872,-1.1773212066516432
2025-08-12T10:15:00-04:00,335.49,335.86,333.8,334.21,NaN,NaN,NaN,339.27534984707205,NaN,NaN,341.5213999999994,346.7138410600579,336.3289589399409,340.1650384028948,338.4675167986271,341.62249229660046,335.3125413006538,116039,131575.7,29.740237063384143,35.8840938807358,NaN,NaN,NaN,NaN,1.887078757865994,26.85413105177262,88364278,-0.597890381531577,-1.9246841835661144,-1.3267938020345373
2025-08-12T10:20:00-04:00,334.13,334.72,333.24,333.85,NaN,NaN,NaN,338.9103910796669,NaN,NaN,341.30439999999936,346.8427064705936,335.7660935294051,338.22003072231587,338.1778633079487,341.42532464365894,334.9304019722385,142954,134157.7,28.914982858686386,35.357267018907116,NaN,NaN,NaN,NaN,1.85800170373271,28.227863306322238,88221324,-0.584966586291483,-2.058002034898891,-1.473035448607408
2025-08-12T10:25:00-04:00,333.88,335.17,333.72,334.97,NaN,NaN,NaN,338.9103910796669,NaN,NaN,341.1001999999994,346.802339584595,335.3980604154038,336.61402457785266,338.0067760124621,341.26535127943987,334.7482007454844,112961,135533.83333333334,34.96161150063074,35.45884257956446,NaN,NaN,NaN,NaN,1.8288587248946584,29.09310646508733,88334285,-0.46129612026264555,-2.049655598935715,-1.5883594786730693
2025-08-12T10:30:00-04:00,335,335.74,333.92,334.48,NaN,NaN,NaN,338.9103910796669,NaN,NaN,340.90229999999946,346.8188832067145,334.98571679328444,334.53921966228216,337.8447283353085,341.1009982671729,334.5884584034441,121564,135692.4,33.61443714007332,35.6409200029972,NaN,NaN,NaN,NaN,1.8282259588307537,29.386160572331644,88212721,-0.37638984826566046,-2.0588467890051447,-1.6824569407394843
2025-08-12T10:35:00-04:00,334.5,335.07,333.97,334.94,NaN,NaN,NaN,338.9103910796669,NaN,NaN,340.7138999999994,346.77619702028056,334.65160297971823,332.8723757298257,337.7535236683983,341.0064883388523,334.5005589979443,72841,134837.36666666667,36.1036103657626,36.32129123188666,NaN,NaN,NaN,NaN,1.776209818914269,29.658282243344214,88285562,-0.2587464999528497,-2.0058900656805463,-1.7471435657276966
2025-08-12T10:40:00-04:00,334.94,335.4,334.45,334.58,NaN,NaN,NaN,338.9103910796669,NaN,NaN,340.5134999999994,346.70967954889386,334.31732045110493,332.1359005838605,337.68037445616255,340.9251823152569,334.4355665970682,64819,134135,34.997624939680804,34.76827311390376,NaN,NaN,NaN,NaN,1.7171948318489634,29.596471600089462,88220743,-0.17849199386087133,-1.9702585580537857,-1.7917665641929144
2025-08-12T10:45:00-04:00,334.54,334.63,333.12,333.6,NaN,NaN,NaN,338.62843728245605,NaN,NaN,340.3092999999995,346.7264813159558,333.89211868404317,331.30801808775965,337.51918098781795,340.7895739327731,334.24878804286277,112543,135973.93333333332,32.11361821431697,33.55846779323693,NaN,NaN,NaN,NaN,1.7023952010026082,30.177254589321638,88108200,-0.16503929576207188,-1.9980656838955042,-1.8330263881334323
2025-08-12T10:50:00-04:00,333.62,334.54,333.28,334.07,NaN,NaN,NaN,338.6191901332535,NaN,NaN,340.12349999999947,346.7122705227921,333.53472947720684,331.30801808775965,337.4206604826413,340.6978166205286,334.14350434475404,77534,136408.26666666666,34.88499295101768,33.05773997446611,NaN,NaN,NaN,NaN,1.6707955437881397,30.71655307932294,88185734,-0.10125011893645786,-1.9595890368040045,-1.8583389178675467
2025-08-12T10:55:00-04:00,334.05,335.02,333.63,334.78,NaN,NaN,NaN,338.6191901332535,NaN,NaN,339.96049999999946,346.6657028307897,333.2552971692092,331.30801808775965,337.34648137091455,340.61481820682286,334.07814453500623,72333,136600.53333333333,38.94020096269887,33.48372576610636,NaN,NaN,NaN,NaN,1.650738719231843,30.726457277098447,88258067,0.006292062337733384,-1.85047383994538,-1.8567659022831133
2025-08-12T11:00:00-04:00,334.83,335.56,334.61,335.2,NaN,NaN,NaN,338.6191901332535,NaN,NaN,339.7920999999995,346.5439845044845,333.0402154955145,332.06316420874634,337.29509032073724,340.54265944046136,334.0475212010131,67931,135838.46666666667,41.2702539240073,33.639736083727385,NaN,NaN,NaN,NaN,1.600685953572425,30.202827679673224,88325998,0.1170987769263987,-1.7103924311251149,-1.8274912080515135
2025-08-12T11:05:00-04:00,335.19,336.83,335.19,336.36,NaN,NaN,NaN,338.6191901332535,NaN,NaN,339.6714999999995,346.44882875119123,332.8941712488078,333.2125313669971,337.2529167412887,340.4487774906873,334.0570559918901,110041,137172.06666666668,47.256725106751595,34.7257482089367,NaN,NaN,NaN,NaN,1.603494099745822,28.604567439596373,88436039,0.2711011460996713,-1.4886147754269246,-1.7597159215265958
2025-08-12T11:10:00-04:00,336.34,337.56,336.04,336.88,NaN,NaN,NaN,338.6191901332535,NaN,NaN,339.5632999999995,346.3426974984414,332.78390250155763,333.9060250935977,337.2380603029722,340.3787063353394,334.097414270605,110096,138585.36666666667,49.730430505469165,36.14681887976604,NaN,NaN,NaN,NaN,1.597530235478262,26.562524275708533,88546135,0.4026434568654085,-1.2564116004448351,-1.6590550573102436
2025-08-12T11:15:00-04:00,336.89,338.18,336.89,337.2,NaN,NaN,NaN,338.6191901332535,NaN,NaN,339.45049999999947,346.19566189590046,332.7053381040985,334.60682007487816,337.24486758530304,340.3274740950065,334.1622610755996,120487,140076.4,51.2458192792617,37.611103619818316,NaN,NaN,NaN,NaN,1.576278075801244,25.107999380092235,88666622,0.4995313342030865,-1.0346408895563854,-1.534172223759472
2025-08-12T11:20:00-04:00,337.2,337.78,336.72,337.38,NaN,NaN,NaN,338.6191901332535,NaN,NaN,339.33909999999946,346.03318744804045,332.6450125519585,334.60682007487816,337.2461766429409,340.2868778016072,334.2054754842746,91032,141348.96666666667,52.12015623347806,38.99247864608713,NaN,NaN,NaN,NaN,1.5394010703868657,23.62068448349815,88757654,0.5595464555164218,-0.8347391543639446,-1.3942856098803664
2025-08-12T11:25:00-04:00,337.41,337.63,336.72,337.3,NaN,NaN,NaN,338.6191901332535,NaN,NaN,339.23369999999943,345.8868125980277,332.5805874019712,334.60682007487816,337.2457002520814,340.26176023958004,334.22964026458277,55301,141007.63333333333,51.6765854361126,40.55936067271058,NaN,NaN,NaN,NaN,1.4944438510735158,22.23960636523221,88702353,0.5754364437188284,-0.6749900552318309,-1.2504264989506593
2025-08-12T11:30:00-04:00,337.31,337.83,337.06,337.47,NaN,NaN,NaN,338.6191901332535,NaN,NaN,339.1376999999995,345.75119868389635,332.5242013161026,334.9123318783376,337.24861350563555,340.2435394860862,334.2536875251849,48748,139088.16666666666,52.599754925132,42.251130106028135,NaN,NaN,NaN,NaN,1.4426978617111206,21.121227412197477,88751101,0.5774795537950808,-0.5285770567068084,-1.1060566105018892
2025-08-12T11:35:00-04:00,337.5,337.59,337.04,337.53,NaN,NaN,NaN,338.6191901332535,NaN,NaN,339.0362999999994,345.58954432950344,332.4830556704954,334.9808655026701,337.2500894784006,340.2289963919092,334.27118256489194,37547,136795.46666666667,52.94145832902222,43.53540487948466,NaN,NaN,NaN,NaN,1.3789337287317516,20.06311037551192,88788648,0.5624004699789292,-0.40305602302822763,-0.9654564930071569
2025-08-12T11:40:00-04:00,337.51,338.72,337.38,338.7,333.8419173251661,333.8419173251661,333.8419173251661,NaN,NaN,NaN,338.9686999999994,345.46444100793906,332.4729589920597,335.9626924021361,337.27951970044154,340.21993406157725,334.33910533930583,104702,138023.13333333333,59.128816120938794,45.35786052097506,NaN,NaN,NaN,NaN,1.3761527481080573,19.987836017429057,88893350,0.6069357796384028,-0.20678676845915334,-0.8137225480975562
2025-08-12T11:45:00-04:00,338.7,338.99,337.2,337.2,333.8419173251661,NaN,NaN,NaN,NaN,NaN,338.8720999999994,345.3263903840909,332.4178096159079,335.9626924021361,337.29155185999497,340.1986039580112,334.38449976197876,86150,137360.3,50.04412887800243,46.3536118432779,NaN,NaN,NaN,NaN,1.4057132661003404,20.11294188008766,88807200,0.5147251298767267,-0.17031613575164783,-0.6850412656283745
2025-08-12T11:50:00-04:00,337.18,337.3,336.25,337.14,333.8419173251661,NaN,NaN,NaN,NaN,NaN,338.76769999999937,345.1615286528726,332.3738713471261,335.9626924021361,337.2839996861775,340.1636268789911,334.40437249336384,72196,133750.76666666666,49.715092644864974,47.40485953650534,NaN,NaN,NaN,NaN,1.3803051756646028,19.244241834847216,88735004,0.43236286979893357,-0.14458767837970754,-0.5769505481786411
2025-08-12T11:55:00-04:00,337.14,338.49,337.11,337.97,333.8419173251661,NaN,NaN,NaN,NaN,NaN,338.6858999999994,345.0134624660908,332.35833753390796,335.9626924021361,337.2948918428055,340.1480747351799,334.4417089504311,73192,128271.63333333333,54.20107348936225,48.98253491329429,NaN,NaN,NaN,NaN,1.3802833774028451,19.30900801029097,88808196,0.41630323370993444,-0.056571506041223074,-0.4728747397511575
2025-08-12T12:00:00-04:00,338,338.03,337.11,337.3,333.8419173251661,NaN,NaN,NaN,NaN,NaN,338.59109999999936,344.8565414977988,332.32565850219993,335.9626924021361,337.29681351270943,340.13520985472564,334.4584171706932,40368,118891.6,50.300124976470066,50.08361577225518,NaN,NaN,NaN,NaN,1.347405993302639,19.369148030345887,88767828,0.3459673354972966,-0.0404155703795368,-0.3863829058768334
2025-08-12T12:05:00-04:00,337.36,337.84,337.05,337.05,333.8419173251661,NaN,NaN,NaN,NaN,NaN,338.4890999999994,344.685137343524,332.2930626564748,335.9626924021361,337.2969892221696,340.12025072819614,334.47372771614306,41804,112339.66666666667,48.886288171637055,50.79405057289362,NaN,NaN,NaN,NaN,1.307591279495305,19.35899060786563,88726024,0.27131414096417433,-0.04724022967161545,-0.3185543706357898
2025-08-12T12:10:00-04:00,337.11,337.57,336.87,337.29,333.8419173251661,NaN,NaN,NaN,NaN,NaN,338.4036999999994,344.545548194336,332.2618518056628,335.9626924021361,337.2965697184993,340.1087768318947,334.4843626051039,30971,106461.4,50.329676288983435,51.44115217039191,NaN,NaN,NaN,NaN,1.2641919023884967,19.14309219933479,88756995,0.22852066801545623,-0.032903535616469526,-0.26142420363192576
2025-08-12T12:15:00-04:00,337.25,337.9,337.2,337.49,333.8419173251661,NaN,NaN,NaN,NaN,NaN,338.30629999999934,344.3477365214232,332.2648634785755,335.9626924021361,337.29913544233057,340.09595071312225,334.5023201715389,44024,100476.46666666666,51.55733367737428,51.74833849686496,NaN,NaN,NaN,NaN,1.2238924807893174,19.215595819654823,88801019,0.20486600451527606,-0.005341697987830685,-0.21020770250310675
2025-08-12T12:20:00-04:00,337.51,338.17,337.5,338.05,334.03225192039173,NaN,NaN,NaN,NaN,NaN,338.2216999999993,344.1557002058035,332.28769979419513,335.9626924021361,337.304692257283,340.08928824154617,334.5200962730199,36973,94647.36666666667,54.917284878627484,52.118828094947695,NaN,NaN,NaN,NaN,1.1850430178757954,19.503580400367575,88837992,0.2169546204551309,0.060985573065806875,-0.15596904738932402
2025-08-12T12:25:00-04:00,338.08,339.01,337.93,338.08,334.6928313785557,NaN,NaN,NaN,NaN,NaN,338.12029999999936,343.8848282237394,332.3557717762593,336.67105971561756,337.32671447616093,340.08558261112773,334.5678463411941,87853,91571.2,55.09696438421231,52.39390988815846,NaN,NaN,NaN,NaN,1.1775399451703803,20.400135690864207,88925845,0.21649488097374722,0.11464955382786002,-0.1018453271458872
2025-08-12T12:30:00-04:00,337.99,338.34,337.64,338.21,334.6928313785557,NaN,NaN,NaN,NaN,NaN,338.0104999999993,343.55049648035924,332.47050351963935,336.67105971561756,337.3310472268471,340.08236630080296,334.5797281528912,24437,85011.46666666666,55.916877085566995,52.66510423473624,NaN,NaN,NaN,NaN,1.1434299490867808,20.846667740728503,88950282,0.2140825064752725,0.16575780594820344,-0.04832470052706907
2025-08-12T12:35:00-04:00,338.22,338.63,338.05,338.43,334.72819966517164,NaN,NaN,NaN,NaN,NaN,337.9032999999994,343.1936178016302,332.61298219836857,336.67105971561756,337.3426044343905,340.08074709846096,334.6044617703201,46735,80917.73333333334,57.336624662122,53.06939275087977,NaN,NaN,NaN,NaN,1.103184952723438,21.482440595591257,88997017,0.21582837124132706,0.22146076352458977,0.005632392283262698
2025-08-12T12:40:00-04:00,338.43,338.74,338.04,338.45,334.84691786220924,NaN,NaN,NaN,NaN,NaN,337.82309999999933,342.9538468815309,332.69235311846774,336.7364625743962,337.3530600870087,340.07978621211566,334.62633396190176,41561,75524.56666666667,57.47072157983784,53.41731894050161,NaN,NaN,NaN,NaN,1.074386027528906,22.157853344683836,89038578,0.20683356942475756,0.26417435406420964,0.057340784639452094
2025-08-12T12:45:00-04:00,338.48,339.37,338.48,339.08,335.4175125048361,NaN,NaN,NaN,NaN,NaN,337.7606999999994,342.75096973642025,332.7704302635786,337.307170059517,337.37923494443277,340.09161111999725,334.6668587688683,69522,73974,61.56848026334907,54.033534792953525,NaN,NaN,NaN,NaN,1.0633584541339853,23.251910191044626,89108100,0.23003560763586245,0.34488529418428016,0.1148496865484177
2025-08-12T12:50:00-04:00,339.06,339.83,338.97,339.76,335.93467102734354,NaN,NaN,NaN,NaN,NaN,337.7148999999994,342.587510179597,332.84228982040173,337.74973604761357,337.42244154621164,340.1241314711793,334.720751621244,88829,72169.83333333333,65.43922782433054,54.484278486052936,NaN,NaN,NaN,NaN,1.048832850267269,24.577175577448827,89196929,0.27486829774690585,0.45843505873205004,0.18356676098514418
2025-08-12T12:55:00-04:00,339.77,340.08,339.15,339.44,336.18036779882794,NaN,NaN,NaN,NaN,NaN,337.66229999999945,342.4006529672345,332.9239470327644,337.9507888380909,337.4657159695427,340.1567404986046,334.7746914404808,91088,71440.73333333334,62.26124991325503,55.35692998857098,NaN,NaN,NaN,NaN,1.040344789533893,25.969732610586497,89105841,0.2664643134469997,0.5166471527938938,0.2501828393468941
2025-08-12T13:00:00-04:00,339.45,339.55,338.18,338.32,336.18036779882794,NaN,NaN,NaN,NaN,NaN,337.5878999999994,342.16297512092797,333.0128248790709,337.9507888380909,337.484411911624,340.1588906306851,334.80993319256294,70053,69723.7,52.627822353630854,55.56498211062569,NaN,NaN,NaN,NaN,1.0638915902814725,25.822022822111656,89035788,0.17347170661138078,0.46702247261112007,0.2935507659997393
2025-08-12T13:05:00-04:00,338.31,338.88,337.81,338.57,336.18036779882794,NaN,NaN,NaN,NaN,NaN,337.52039999999937,341.93305264464436,333.1077473553544,337.9507888380909,337.4995123837341,340.15493868134985,334.84408608611835,74845,69790.5,54.326586706447934,55.573947340417526,NaN,NaN,NaN,NaN,1.0643279052613668,25.203550929082947,89110633,0.1193702383587042,0.44276356394811955,0.32339332558941536
2025-08-12T13:10:00-04:00,338.6,339.33,338.25,338.94,336.18036779882794,NaN,NaN,NaN,NaN,NaN,337.4765999999994,341.7873671895259,333.16583281047286,337.9507888380909,337.5170063700775,340.15943151727816,334.8745812228769,61318,69673.8,56.79592665995044,56.03793317495183,NaN,NaN,NaN,NaN,1.0654473405998395,25.022700617855065,89171951,0.09986712142629617,0.4482272273722856,0.34836010594598943
2025-08-12T13:15:00-04:00,338.94,339.85,338.94,339.81,336.18036779882794,NaN,NaN,NaN,NaN,NaN,337.45879999999937,341.7232814740322,333.19431852596654,337.9507888380909,337.5388040565525,340.17516571523134,334.9024423978737,51349,67634,61.998522704544904,56.974521355873826,NaN,NaN,NaN,NaN,1.0543439591284243,25.2769000659006,89223300,0.13475318097501648,0.51680158216476,0.38204840118974354
2025-08-12T13:20:00-04:00,339.79,339.99,339.12,339.15,336.18036779882794,NaN,NaN,NaN,NaN,NaN,337.4239999999994,341.6034640807373,333.2445359192615,337.9507888380909,337.5605627666802,340.18934013354936,334.9317853998111,55582,66902.26666666666,56.44544582993263,57.41136203737019,NaN,NaN,NaN,NaN,1.0411765334763943,25.623531211161797,89167718,0.10395238236239257,0.5119888791427343,0.4080364967803417
2025-08-12T13:25:00-04:00,339.17,339.36,338.67,338.79,336.18036779882794,NaN,NaN,NaN,NaN,NaN,337.39019999999937,341.4969622091317,333.283437790867,337.9507888380909,337.5714579365136,340.1926790585863,334.95023681444087,38257,65766.4,53.62410440843779,57.55898851816045,NaN,NaN,NaN,NaN,1.0160924953709374,25.29658760998596,89129461,0.052503333017806575,0.47366566305259994,0.42116233003479336
2025-08-12T13:30:00-04:00,338.79,339.45,338.45,339.35,336.18036779882794,NaN,NaN,NaN,NaN,NaN,337.3755999999994,341.4490637057751,333.3021362942237,337.9507888380909,337.5822047708998,340.19717952719213,334.9672300146075,34677,64657.933333333334,57.20727046847616,57.72255891743536,NaN,NaN,NaN,NaN,1.0149430314158703,24.686506898644286,89164138,0.04940198931568296,0.48291481667939706,0.4335128273637141
2025-08-12T13:35:00-04:00,339.34,339.37,338.65,339.03,336.18036779882794,NaN,NaN,NaN,NaN,NaN,337.3715999999994,341.438158958426,333.30504104157274,337.9507888380909,337.59004354426605,340.20000684803836,334.98008024049375,26805,61883.4,54.61070633076744,57.68782619933215,NaN,NaN,NaN,NaN,0.9938756720290244,24.120003380969873,89137333,0.020494487134953776,0.4591309362824063,0.43863644914745253
2025-08-12T13:40:00-04:00,339.04,339.1,338.47,338.67,336.18036779882794,NaN,NaN,NaN,NaN,NaN,337.2841999999994,341.03530029756735,333.5330997024314,337.9507888380909,337.5976645958792,340.2006976387092,334.99463155304926,32535,59298.03333333333,51.76418517589274,57.39120534864112,NaN,NaN,NaN,NaN,0.9678845525983795,23.322574594077256,89104798,-0.025671853834592306,0.40654663185421214,0.43221848568880444
2025-08-12T13:45:00-04:00,338.69,338.75,338.03,338.2,336.18036779882794,NaN,NaN,NaN,NaN,NaN,337.2143999999994,340.7591813137544,333.66961868624435,337.5932040864656,337.6045466027042,340.19622273447135,335.01287047093706,47058,56850.4,48.229661641637534,56.7407079900351,NaN,NaN,NaN,NaN,0.9501785131270687,21.945464590270465,89057740,-0.08719701639002786,0.3232222152012696,0.41041923159129745
2025-08-12T13:50:00-04:00,338.17,338.33,337.88,338.2,336.18036779882794,NaN,NaN,NaN,NaN,NaN,337.17619999999937,340.63547597084363,333.7169240291551,337.5932040864656,337.6089527994843,340.19032691784935,335.0275786811193,41621,55203.36666666667,48.22966164163754,56.08063228016364,NaN,NaN,NaN,NaN,0.9144514764751345,20.45749206593345,89057740,-0.12493049844617243,0.25425610853358194,0.37918660697975437
2025-08-12T13:55:00-04:00,338.27,338.48,338.14,338.22,336.18036779882794,NaN,NaN,NaN,NaN,NaN,337.19279999999935,340.66396589094063,333.7216341090581,337.5932040864656,337.6131579628575,340.186975999603,335.03933992611195,31697,54416.566666666666,48.40353097221095,55.140278759368066,NaN,NaN,NaN,NaN,0.8734192281554842,19.283655259887347,89089437,-0.1442126694526764,0.19892077016390886,0.34313343961658527
2025-08-12T14:00:00-04:00,338.21,338.25,337.12,337.18,336.18036779882794,NaN,NaN,NaN,NaN,NaN,337.16479999999933,340.61326688290336,333.7163331170953,337.5932040864656,337.612017417215,340.17059997640706,335.0534348580229,60503,54808.4,40.74115671198994,53.3761308227723,NaN,NaN,NaN,NaN,0.8917464261443779,18.936158285024636,89028934,-0.2182371466899145,0.07033700625419215,0.28857415294410665
2025-08-12T14:05:00-04:00,337.2,337.51,337.02,337.36,336.18036779882794,NaN,NaN,NaN,NaN,NaN,337.19359999999926,340.6240069966563,333.7631930033422,337.5932040864656,337.6095373677668,340.1581914183828,335.0608833171508,40574,54909.3,42.43953511584696,51.96029405152888,NaN,NaN,NaN,NaN,0.8630502528483516,18.725805277117942,89069508,-0.2443375990617588,-0.01684784588309185,0.22748975317866696
2025-08-12T14:10:00-04:00,337.4,338.28,337.15,338.16,336.18036779882794,NaN,NaN,NaN,NaN,NaN,337.2587999999993,340.6358629609995,333.8817370389992,337.16204049227036,337.6117363109601,340.14943430480025,335.07403831711997,45091,52922.26666666667,49.383050785617684,51.72852465381364,NaN,NaN,NaN,NaN,0.8821180919306119,17.43501283171241,89114599,-0.1989081258687013,-0.02114540415720967,0.17776272171149163
2025-08-12T14:15:00-04:00,338.14,339.17,338.1,339.14,336.18036779882794,NaN,NaN,NaN,NaN,NaN,337.33999999999935,340.69879740419975,333.98120259579895,337.16204049227036,337.62537423649445,340.15168987714657,335.09905859584234,60253,52059.03333333333,56.33227695395831,51.87178824292153,NaN,NaN,NaN,NaN,0.8955382282212819,17.158953197307966,89174852,-0.099086037808925,0.05390517445033538,0.15299121225926038
2025-08-12T14:20:00-04:00,339.13,339.42,338.52,339.12,336.18036779882794,NaN,NaN,NaN,NaN,NaN,337.41299999999933,340.764704641298,334.06129535870065,337.2841549889565,337.63860895545986,340.15654195071477,335.12067596020495,50438,51333.76666666667,56.16281276631879,51.826565821947845,NaN,NaN,NaN,NaN,0.8958569262054785,17.155719193363623,89124414,-0.033996378009471584,0.11049573974742088,0.14449211775689247
2025-08-12T14:25:00-04:00,339.08,339.67,338.9,339.43,336.373974756228,NaN,NaN,NaN,NaN,NaN,337.5173999999993,340.787729182592,334.24707081740667,337.5763239911652,337.6514693542904,340.16413827121374,335.138800437367,40641,50248.73333333333,58.25886115218799,51.55944713963663,NaN,NaN,NaN,NaN,0.8868671457622328,17.403064340400768,89165055,0.027048874795131406,0.17830321125080673,0.15125433645567532
2025-08-12T14:30:00-04:00,339.51,339.87,338.94,339.62,336.4994759036722,NaN,NaN,NaN,NaN,NaN,337.6327999999994,340.7823194303638,334.483280569635,337.7300591929322,337.6728073667724,340.17843821504164,335.1671765185032,63352,51014.86666666667,59.53590282336363,51.780194067738854,NaN,NaN,NaN,NaN,0.8899480639220737,17.832045535324788,89228407,0.0746393091089006,0.24455347284180107,0.16991416373290047
2025-08-12T14:35:00-04:00,339.6,339.86,339.3,339.63,336.73018154441445,NaN,NaN,NaN,NaN,NaN,337.7259999999993,340.83028606969833,334.6217139303003,337.8680473543457,337.68798709095114,340.189511174856,335.18646300704626,43097,51057.96666666667,59.605949777976406,52.20746873699161,NaN,NaN,NaN,NaN,0.8663803450704971,18.230385216325665,89271504,0.09964445707894143,0.29446973508157726,0.19482527800263583
2025-08-12T14:40:00-04:00,339.64,339.91,339.36,339.82,336.839718746941,NaN,NaN,NaN,NaN,NaN,337.83279999999934,340.84922713196937,334.8163728680293,338.0414378834766,337.7088638858819,340.20567873447186,335.21204903729193,57365,51937.76666666667,60.987791264097346,52.47750593667883,NaN,NaN,NaN,NaN,0.8437817489940338,18.655464632370492,89328869,0.12044284355627327,0.3453788324479774,0.22493598889170413
2025-08-12T14:45:00-04:00,339.81,340.8,339.74,340.74,337.457231531171,NaN,NaN,NaN,NaN,NaN,337.9487999999993,340.9574027059983,334.94019729400037,338.77515030678126,337.7608275653225,340.26151089815625,335.2601442324887,107587,54056.53333333333,66.89351132533469,53.3548491505765,NaN,NaN,NaN,NaN,0.8592259097801743,19.927786391935516,89436456,0.18382660862500644,0.4547192496729622,0.27089264104795574
2025-08-12T14:50:00-04:00,340.77,341.05,340.36,340.94,337.9259937342996,NaN,NaN,NaN,NaN,NaN,338.07599999999934,341.0416108987002,335.1103891012985,339.085120245425,337.7934279322628,340.30010712471125,335.2867487398143,61354,54869.23333333333,68.02666070603783,54.51645454558685,NaN,NaN,NaN,NaN,0.8471383447958759,21.321292046804654,89497810,0.22421168630326793,0.5511572489270407,0.3269455626237727
2025-08-12T14:55:00-04:00,340.9,340.91,340.21,340.61,337.9259937342996,NaN,NaN,NaN,NaN,NaN,338.2161999999993,340.9779295745019,335.45447042549665,339.085120245425,337.8142125082772,340.3229838704119,335.30544114614247,42799,53367.433333333334,64.12651941535226,55.65194438656648,NaN,NaN,NaN,NaN,0.8387713201676004,22.323338613579228,89455011,0.21373019416888966,0.5941083053348848,0.3803781111659951
2025-08-12T15:00:00-04:00,340.58,340.93,340.28,340.76,337.9259937342996,NaN,NaN,NaN,NaN,NaN,338.34999999999934,340.93803709450054,335.76196290549814,339.085120245425,337.83291593099784,340.3439582051172,335.3218736568785,37961,53818.23333333333,65.10582038053181,56.8573842964875,NaN,NaN,NaN,NaN,0.8252876544413457,23.273163903782528,89492972,0.20206132294953305,0.6329547648529115,0.4308934419033784
2025-08-12T15:05:00-04:00,340.73,341.24,340.73,341.13,338.32313044452934,NaN,NaN,NaN,NaN,NaN,338.4769999999993,340.97341743355963,335.98058256643895,339.4853815656576,337.86092206329295,340.3786598812009,335.343184245385,50930,53958.066666666666,67.46513989027929,58.218927790635234,NaN,NaN,NaN,NaN,0.8027671076955346,24.455810938874883,89543902,0.20383927444636402,0.6856925349613334,0.4818532605149694
2025-08-12T15:10:00-04:00,341.13,341.3,340.52,340.8,338.32313044452934,NaN,NaN,NaN,NaN,NaN,338.5889999999994,340.98786056335786,336.1901394366409,339.5063052525261,337.8864209147673,340.40862420462884,335.3642176249058,49685,54228.86666666667,63.35095475827197,59.83391336536967,NaN,NaN,NaN,NaN,0.8011408857172843,25.09926039995807,89494217,0.16881527514675365,0.6928723544484114,0.5240570793016578
2025-08-12T15:15:00-04:00,340.83,341.42,340.79,341.36,338.4921808389203,NaN,NaN,NaN,NaN,NaN,338.68899999999934,341.1244326109558,336.25356738904287,339.67004420202085,337.921185483596,340.45262860194407,335.3897423652479,62426,53992.333333333336,67.02578773521338,61.590074266752985,NaN,NaN,NaN,NaN,0.788916536737478,25.8262725313616,89556643,0.1689734986157858,0.73527395257139,0.5663004539556042
2025-08-12T15:20:00-04:00,341.34,341.45,340.61,340.87,338.4921808389203,NaN,NaN,NaN,NaN,NaN,338.7687999999994,341.223306517081,336.3142934829177,339.67004420202085,337.9373148063066,340.4717573915207,335.4028722210924,31481,52080.73333333333,61.23950868770997,62.43696411690244,NaN,NaN,NaN,NaN,0.7925653555419421,26.09389748505766,89525162,0.12378129159582263,0.7210270684503826,0.5972457768545599
2025-08-12T15:25:00-04:00,340.88,341.08,340.7,340.89,338.4921808389203,NaN,NaN,NaN,NaN,NaN,338.8425999999994,341.3257200056301,336.35947999436866,339.67004420202085,337.95395338580914,340.49089141746555,335.41701535415274,33796,50171,61.386036621808685,62.797946950320316,NaN,NaN,NaN,NaN,0.7630964015746601,26.34240637063257,89558958,0.08479824944287517,0.7032435886581538,0.6184453392152787
2025-08-12T15:30:00-04:00,340.9,341.23,340.4,341.15,338.4921808389203,NaN,NaN,NaN,NaN,NaN,338.9179999999994,341.4474141618858,336.388585838113,339.67004420202085,337.990972117731,340.53352655932497,335.44841767613707,75627,50356.8,63.32695027975078,63.30967105842261,NaN,NaN,NaN,NaN,0.7678752300336159,25.875639332538235,89634585,0.06687351397594532,0.7020372316852104,0.635163717709265
2025-08-12T15:35:00-04:00,341.13,341.44,340.89,341.07,338.66594237387324,NaN,NaN,NaN,NaN,NaN,338.9933999999994,341.5500090358907,336.43679096410807,339.7795781051477,338.0187029281625,340.5670171656216,335.4703886907034,54071,49664.333333333336,62.289474832706205,63.597572035602475,NaN,NaN,NaN,NaN,0.7523127136026442,25.75015012628964,89580514,0.041236937461539336,0.6867098895361892,0.6454729520746498
2025-08-12T15:40:00-04:00,341.06,341.61,340.98,341.09,338.8236268114245,NaN,NaN,NaN,NaN,NaN,339.06579999999934,341.65061748726276,336.4809825127359,339.9666624841182,338.07515063684826,340.6359188388828,335.51438243481374,109745,51278.566666666666,62.455076676398804,63.80608445367642,NaN,NaN,NaN,NaN,0.743576091202455,25.876277806359187,89690259,0.01839841914499396,0.6684709760058922,0.6500725568608983
2025-08-12T15:45:00-04:00,341.08,341.37,340.82,341.34,338.8236268114245,NaN,NaN,NaN,NaN,NaN,339.14199999999937,341.76557008717856,336.5184299128202,339.9666624841182,338.10747930715814,340.6742679699459,335.5406906443704,65695,51756.76666666667,64.55066229413305,64.15927820483047,NaN,NaN,NaN,NaN,0.7297492275451376,25.598030334408044,89755954,0.013147031327747749,0.6665063460205829,0.6533593146928351
2025-08-12T15:50:00-04:00,341.29,342.5,341.17,341.83,339.3302364128889,NaN,NaN,NaN,NaN,NaN,339.2045999999994,341.93037390153717,336.47882609846164,340.56326398983566,338.2145335250416,340.8196263311007,335.60944071898246,186448,56118.96666666667,68.28689338252343,64.6806426418609,NaN,NaN,NaN,NaN,0.7726242827204838,26.722842233481764,89942402,0.03448047718741254,0.6964599111771008,0.6619794339896883
2025-08-12T15:55:00-04:00,341.8,341.81,340.61,340.765,339.3302364128889,NaN,NaN,NaN,NaN,NaN,339.2758999999994,341.9745705546105,336.5772294453883,340.56326398983566,338.2703653161549,340.8798230409348,335.66090759137495,129794,59170.2,54.77425150852443,63.81498122637446,NaN,NaN,NaN,NaN,0.80457969109759,26.586364875968744,89812608,-0.02795660794044108,0.6270336740641369,0.654990282004578
2025-08-13T09:30:00-04:00,341.59,346.59,340.24,346.38,340.1080563183553,NaN,NaN,NaN,NaN,NaN,339.4606999999994,342.7498810595179,336.1715189404809,341.68748895349484,344.40333333333336,344.40333333333336,344.40333333333336,324516,68831.5,78.70264177456491,64.57755130269781,NaN,NaN,NaN,NaN,1.200681141733474,29.242259306410617,90137124,0.2867393292548951,1.0134144435731969,0.7266751143183018
2025-08-13T09:35:00-04:00,346.44,347.12,344.58,345.58,342.34700830388465,NaN,NaN,NaN,NaN,NaN,339.61289999999934,343.2931098258779,335.9326901741208,341.9279911627959,344.9914392401329,345.6637450653421,344.31913341492367,248321,76215.36666666667,72.79323796482711,65.19660262766031,NaN,NaN,NaN,NaN,1.2963467744667985,31.859229351949114,89888803,0.41127420720041163,1.2407678733188163,0.8294936661184047
2025-08-13T09:40:00-04:00,345.53,347.8,344.34,347.6,342.34700830388465,NaN,NaN,NaN,NaN,NaN,339.8188999999994,344.0673986951008,335.57040130489804,341.9279911627959,345.51135763063166,346.4385409631963,344.584174298067,278698,84420.8,77.40628664723347,66.07520736099613,NaN,NaN,NaN,NaN,1.4508934334334584,34.47085441525216,90167501,0.5891199280093741,1.5658935761301223,0.9767736481207482
2025-08-13T09:45:00-04:00,347.6,348.98,346.27,347.56,343.6133071529197,NaN,NaN,NaN,NaN,NaN,340.02909999999946,344.7252293383049,335.332970661694,342.91811434418935,346.0460621565531,347.25957743611343,344.83254687699275,292383,92598.3,77.12740930634466,66.76536946214365,NaN,NaN,NaN,NaN,1.5408296167596427,37.171605168315125,89875118,0.6582497748145155,1.7995858666388926,1.1413360918243771
2025-08-13T09:50:00-04:00,347.6,348.65,346.81,348.06,343.6497477368779,NaN,NaN,NaN,NaN,NaN,340.2444999999994,345.3852642430164,335.10373575698236,342.91811434418935,346.2500195636947,347.5265311153478,344.97350801204163,146738,96102.2,78.18539325680541,67.8249722120389,NaN,NaN,NaN,NaN,1.562198929848238,39.67944515330216,90021856,0.6885759712438764,2.0020560558792226,1.3134800846353463
2025-08-13T09:55:00-04:00,348.11,348.12,345.75,345.85,343.6497477368779,NaN,NaN,NaN,NaN,NaN,340.4116999999994,345.7241742297921,335.0992257702068,342.91811434418935,346.28037216530834,347.49914146606363,345.06160286455304,133720,99502.96666666666,64.07712545820527,67.6143534779669,NaN,NaN,NaN,NaN,1.6198990062876497,40.618245569117,89888136,0.5184757691718784,1.9615747961001944,1.443099026928316
2025-08-13T10:00:00-04:00,345.84,346.2,344.52,345,343.6497477368779,NaN,NaN,NaN,NaN,NaN,340.55069999999944,345.9713169429554,335.13008305704346,342.91811434418935,346.1793292596219,347.37768081637444,344.9809777028694,153219,102593.5,59.620988049989066,67.49874486098683,NaN,NaN,NaN,NaN,1.624191934409961,40.13984717283306,89734917,0.31727942873096127,1.8396983128420175,1.5224188841110562
2025-08-13T10:05:00-04:00,345.02,345.95,344.24,345.405,343.6497477368779,NaN,NaN,NaN,NaN,NaN,340.69719999999944,346.237419187198,335.1569808128009,342.91811434418935,346.11961126925956,347.30436617750627,344.93485636101286,102261,104649.73333333334,61.01223638778722,67.47204484427102,NaN,NaN,NaN,NaN,1.6303210819521052,39.41410358873568,89837178,0.18650769991382266,1.7555535090033345,1.5690458090895119
2025-08-13T10:10:00-04:00,345.38,345.51,343.8,344.31,343.6497477368779,NaN,NaN,NaN,NaN,NaN,340.81919999999946,346.40344439312435,335.23495560687456,342.91811434418935,346.03300258612666,347.2396469479527,344.82635822430063,97448,106394.96666666666,55.44947782772381,66.90936824055481,NaN,NaN,NaN,NaN,1.6360124332412391,38.29974333351223,89739730,0.010580438924447488,1.5822713577450713,1.5716909188206238
2025-08-13T10:15:00-04:00,344.36,345.25,343.89,344.96,343.6497477368779,NaN,NaN,NaN,NaN,NaN,340.94979999999947,346.6093579193169,335.29024208068205,342.91811434418935,345.97734447249854,347.1882498573004,344.7664390876967,77443,106967.96666666666,57.90309794744451,66.59605560589326,NaN,NaN,NaN,NaN,1.6162972594382945,37.26498023937617,89817173,-0.07308932869407458,1.4803292579530307,1.5534185866471053
2025-08-13T10:20:00-04:00,344.9,346.15,344.87,345.3,343.6497477368779,NaN,NaN,NaN,NaN,NaN,341.08679999999947,346.8287107483564,335.34488925164254,342.91811434418935,345.94144578938636,347.1188725116311,344.76401906714165,132782,109712.76666666666,59.16983338804673,66.36139537101096,NaN,NaN,NaN,NaN,1.5922760266212717,36.85462040012068,89949955,-0.11416466973499295,1.410712749478364,1.524877419213357
2025-08-13T10:25:00-04:00,345.3,345.64,344.321,345.08,343.6497477368779,NaN,NaN,NaN,NaN,NaN,341.2067999999995,347.0261995430898,335.3874004569092,342.91811434418935,345.90749692505506,347.0762356160011,344.738758234109,75489,110874.36666666667,57.95462068882237,65.8902495420602,NaN,NaN,NaN,NaN,1.5727563104340352,35.888196271766866,89874466,-0.1618670994995821,1.3225435448388794,1.4844106443384615
2025-08-13T10:30:00-04:00,345.1,345.21,343.91,344.11,343.6497477368779,NaN,NaN,NaN,NaN,NaN,341.2937999999995,347.1540015530258,335.43359844697324,342.91811434418935,345.85512744831584,347.035746602527,344.67450829410467,74761,111254.66666666667,52.805156698636694,64.78441120749686,NaN,NaN,NaN,NaN,1.5532737168316009,34.569436077477384,89799705,-0.2587169398964144,1.1610144694679434,1.4197314093643578
2025-08-13T10:35:00-04:00,344.15,344.87,344,344.69,343.6497477368779,NaN,NaN,NaN,NaN,NaN,341.3987999999995,347.31028629720697,335.487313702792,342.88049147535145,345.8250889839259,347.0090250284164,344.6411529394355,49204,111458.23333333334,55.3593035412619,64.82620063840668,NaN,NaN,NaN,NaN,1.5044684513436297,33.34487303992287,89848909,-0.28178734930719274,1.067497222730367,1.3492845720375597
2025-08-13T10:40:00-04:00,344.62,345.57,344.2,345.33,343.6497477368779,NaN,NaN,NaN,NaN,NaN,341.53899999999953,347.48417215915316,335.5938278408459,342.31939318028117,345.7945659970029,346.96542145923144,344.6237105347744,87691,112469.1,58.05673379525618,63.351492925598905,NaN,NaN,NaN,NaN,1.4948635619619421,32.716958682574536,89936600,-0.2529335415397769,1.0331176451128385,1.2860511866526154
2025-08-13T10:45:00-04:00,345.35,345.35,343.31,343.935,NaN,NaN,NaN,348.60545643195087,348.60545643195087,348.60545643195087,341.64629999999954,347.5668647739046,335.72573522609446,341.97545710123603,345.73253425404596,346.92114544345293,344.543923064639,91971,111948.56666666667,50.844901923605796,61.78375463694023,NaN,NaN,NaN,NaN,1.533801878964662,31.193437546385866,89844629,-0.32233966383072477,0.8831266068642094,1.2054662706949342
2025-08-13T10:50:00-04:00,343.92,344.07,342.85,343.39,NaN,NaN,NaN,347.70748113958945,NaN,NaN,341.73529999999954,347.6241638668276,335.8464361331715,341.97545710123603,345.6635753564342,346.8980496720262,344.42910104084217,73286,112346.3,48.31954477786067,59.70613021769931,NaN,NaN,NaN,NaN,1.5113874590386125,29.33661824911794,89771343,-0.3947151315109123,0.7120723563062938,1.1067874878172062
2025-08-13T10:55:00-04:00,343.41,343.94,343.3,343.32,NaN,NaN,NaN,347.70748113958945,NaN,NaN,341.80549999999954,347.68456157494893,335.92643842505015,341.97545710123603,345.6288084193863,346.8828127539291,344.3748040848435,40226,112260.53333333334,47.98985080089077,57.62487603873832,NaN,NaN,NaN,NaN,1.4491454976787106,27.612428901654866,89731117,-0.43394465980396024,0.5643566630622558,0.9983013228662161
2025-08-13T11:00:00-04:00,343.345,343.76,342.72,342.99,NaN,NaN,NaN,347.33524624495647,NaN,NaN,341.88229999999953,347.7207827517165,336.04381724828255,341.97545710123603,345.5697575953286,346.8649254259391,344.27458976471814,60692,113018.23333333334,46.38309996938951,55.35328366106575,NaN,NaN,NaN,NaN,1.4199208192730859,25.833533699518714,89670425,-0.46594602367077087,0.4158687932777525,0.8818148169485234
2025-08-13T11:05:00-04:00,343,343.05,341.02,341.11,NaN,NaN,NaN,346.22091687018565,NaN,NaN,341.92869999999954,347.7046846989146,336.15271530108447,341.97545710123603,345.4185834356059,346.89153847580496,343.94562839540686,104041,114788.6,38.479013907696604,53.52484712174371,NaN,NaN,NaN,NaN,1.4634979036107247,25.514152420058316,89566384,-0.589594743412593,0.1448213876827822,0.7344161310953752
2025-08-13T11:10:00-04:00,341.15,341.33,339.04,339.77,NaN,NaN,NaN,344.49292064881365,NaN,NaN,341.9370999999995,347.6992645552856,336.17493544471336,341.97545710123603,345.11781809562757,347.0081489574796,343.22748723377555,156866,118361.3,34.0279909846132,51.69677590278828,NaN,NaN,NaN,NaN,1.5225337676385275,26.30654266082107,89409518,-0.7283990359594122,-0.17608266385389015,0.5523163721055221
2025-08-13T11:15:00-04:00,339.75,339.94,338.55,339.88,NaN,NaN,NaN,343.546651528413,NaN,NaN,341.95409999999947,347.6867973374053,336.2214026625936,341.97545710123603,344.91413098431855,347.0487029446341,342.779559024003,104569,119766.06666666667,34.69579589484964,49.81703015329275,NaN,NaN,NaN,NaN,1.5130670699500601,27.26479459811507,89514087,-0.7752304162710171,-0.4167216482332492,0.3585087680377678
2025-08-13T11:20:00-04:00,339.86,341.44,339.8,341.27,NaN,NaN,NaN,343.546651528413,NaN,NaN,342.00609999999944,347.66539475839335,336.3468052416055,341.97545710123603,344.7501260878988,346.98953567156246,342.5107165042352,121798,122776.63333333333,42.60240698599928,48.89938223602671,NaN,NaN,NaN,NaN,1.522133707810769,26.76346863260462,89635885,-0.6785064620455974,-0.489624309519229,0.18888215252636845
2025-08-13T11:25:00-04:00,341.29,341.49,340.52,340.77,NaN,NaN,NaN,343.546651528413,NaN,NaN,342.05749999999944,347.62350152733984,336.49149847265903,341.97545710123603,344.64587578153385,346.9406407768226,342.3511107862451,84879,124479.4,40.693796385222704,47.67014641015373,NaN,NaN,NaN,NaN,1.4826955858242876,26.25518844975261,89551006,-0.615944165911316,-0.5810480548627766,0.03489611104853943
2025-08-13T11:30:00-04:00,340.85,342.13,340.5,342.02,NaN,NaN,NaN,343.546651528413,NaN,NaN,342.1338999999994,347.58978793528183,336.678012064717,341.4543656809889,344.5594439870455,346.8787200394124,342.24016793467854,89406,124938.7,47.077178948598906,46.806385378764595,NaN,NaN,NaN,NaN,1.4932173296939812,25.23434401768364,89640412,-0.46498858116212916,-0.546339615404122,-0.08135103424199286
2025-08-13T11:35:00-04:00,342.01,342.24,341.67,341.88,NaN,NaN,NaN,343.546651528413,NaN,NaN,342.2070999999994,347.54797524310663,336.86622475689217,340.63879403583286,344.52018527519874,346.84406508688164,342.19630546351584,48538,124754.26666666666,46.473839107144336,45.986329551501875,NaN,NaN,NaN,NaN,1.4272732347158392,24.192464881812974,89591874,-0.35418988643910804,-0.5240883922908779,-0.16989850585176985
2025-08-13T11:40:00-04:00,341.91,342.32,341.63,341.81,NaN,NaN,NaN,343.546651528413,NaN,NaN,342.2996999999994,347.4457203694214,337.1536796305774,340.63879403583286,344.47919574075996,346.8073248174116,342.1510666641083,52069,122831.73333333334,46.15532543455021,45.511341604067134,NaN,NaN,NaN,NaN,1.374610860807565,23.15294824797041,89539805,-0.2690944962161377,-0.506266626121942,-0.23717212990580427
2025-08-13T11:45:00-04:00,341.91,341.92,341.07,341.57,NaN,NaN,NaN,343.546651528413,NaN,NaN,342.38389999999936,347.3380611966639,337.4297388033348,340.5990352286663,344.4355596413567,346.7738245895734,342.09729469314,49435,122289.73333333334,45.016162400672634,44.77254580831076,NaN,NaN,NaN,NaN,1.3371386564641692,22.60276084846714,89490370,-0.21480596232689508,-0.5056795828144232,-0.2908736204875281
2025-08-13T11:50:00-04:00,341.63,341.63,340.45,340.65,NaN,NaN,NaN,343.546651528413,NaN,NaN,342.43369999999936,347.26557326433596,337.60182673566277,339.50622818293306,344.3814059365528,346.7418063692293,342.0210055038763,52298,117818.06666666667,40.853644270698624,43.54375369941379,NaN,NaN,NaN,NaN,1.3259144667167289,22.521967778079464,89438072,-0.22557888897074702,-0.5728472317009619,-0.34726834273021484
2025-08-13T11:55:00-04:00,340.68,341.56,340.65,341.26,NaN,NaN,NaN,343.546651528413,NaN,NaN,342.47609999999935,347.2281666201848,337.7240333798139,339.37013270462944,344.3582615351178,346.7258767573941,341.9906463128415,24613,114312.03333333334,44.516962043219124,43.091757993671884,NaN,NaN,NaN,NaN,1.2962062905226788,22.44694564129091,89462685,-0.17841117845178095,-0.570282315794941,-0.3918711373431601
2025-08-13T12:00:00-04:00,341.26,341.98,341.12,341.92,NaN,NaN,NaN,343.546651528413,NaN,NaN,342.5320999999994,347.1897024264081,337.8744975735907,339.38253435581623,344.32641552205104,346.69782938746476,341.9550016566373,41164,104866.96666666666,48.251550317454864,43.086901246500034,NaN,NaN,NaN,NaN,1.2650486983424885,21.917543754028674,89503849,-0.09380249002675706,-0.5091242498766064,-0.41532175984984937
2025-08-13T12:05:00-04:00,341.9,342.08,341.39,341.64,NaN,NaN,NaN,343.546651528413,NaN,NaN,342.5762999999994,347.1566134437027,337.99598655629603,339.65702748465293,344.29179284138365,346.66644983887943,341.9171358438879,46421,98136.96666666666,46.81196262402682,43.00276637672405,NaN,NaN,NaN,NaN,1.2239737913180249,21.31581712221175,89457428,-0.04993665839848227,-0.47774258284795224,-0.42780592444946997
2025-08-13T12:10:00-04:00,341.65,341.75,341.05,341.23,NaN,NaN,NaN,343.546651528413,NaN,NaN,342.6084999999993,347.1274544147712,338.0895455852274,339.65702748465293,344.26223241351846,346.6431450055598,341.8813198214771,35617,90034.26666666666,44.7085339433107,42.88315451771842,NaN,NaN,NaN,NaN,1.186547091938165,21.046148982769214,89421811,-0.042089660019589636,-0.480417999473957,-0.4383283394543674
2025-08-13T12:15:00-04:00,341.23,341.76,341.21,341.21,NaN,NaN,NaN,343.546651528413,NaN,NaN,342.6400999999994,347.09697131994085,338.18322868005794,339.65702748465293,344.24096274247484,346.62576577903315,341.8561597059165,26535,81172.66666666667,44.60324851840218,43.32059984705453,NaN,NaN,NaN,NaN,1.1410794425140112,20.78332015983694,89395276,-0.03224510140429804,-0.47863471620973996,-0.4463896148054419
2025-08-13T12:20:00-04:00,341.2,341.28,340.22,340.65,NaN,NaN,NaN,343.546651528413,NaN,NaN,342.6566999999994,347.07746944010626,338.2359305598925,339.65702748465293,344.2067648127221,346.6049835692026,341.8085460562416,35070,77450.4,41.645961777391314,43.86474061796725,NaN,NaN,NaN,NaN,1.1352880537630063,21.343509928135486,89360206,-0.05605262411488504,-0.5164553949490482,-0.4604027708341632
2025-08-13T12:25:00-04:00,340.66,341.67,340.63,341.365,NaN,NaN,NaN,343.546651528413,NaN,NaN,342.6691999999994,347.0717171711699,338.26668282882895,339.65702748465293,344.1658134231914,346.57270315396005,341.7589236924228,50271,74668.76666666666,46.52135901015756,44.70942369763211,NaN,NaN,NaN,NaN,1.1284817642085074,21.361610469702853,89410477,-0.018209313134674443,-0.4831644122525063,-0.46495509911783184
2025-08-13T12:30:00-04:00,341.3,341.5,340.49,340.92,NaN,NaN,NaN,343.546651528413,NaN,NaN,342.6687999999994,347.0719491278906,338.2656508721082,339.65702748465293,344.1387696919826,346.55326566253865,341.7242737214265,31274,70603.93333333333,44.054372562131256,44.81313552449867,NaN,NaN,NaN,NaN,1.1200187810507563,21.4942804887686,89379203,-0.017695250187408473,-0.4870741618520924,-0.46937891166468393
2025-08-13T12:35:00-04:00,340.94,341.6,340.71,341,NaN,NaN,NaN,343.546651528413,NaN,NaN,342.67659999999944,347.06649496029416,338.2867050397047,339.65702748465293,344.11013613258103,346.5310643199223,341.6892079452398,35194,68368.36666666667,44.622910119707,45.09378650553327,NaN,NaN,NaN,NaN,1.1035888681185624,21.47959879916994,89414397,-0.007060780189766636,-0.4782048869018922,-0.4711441067121256
2025-08-13T12:40:00-04:00,341,341.1,340.66,340.91,NaN,NaN,NaN,343.546651528413,NaN,NaN,342.6795999999995,347.0644538587193,338.2947461412797,339.65702748465293,344.09019424818774,346.5167999932341,341.6635885031414,23249,65895.06666666667,44.08019277486937,44.87971606455259,NaN,NaN,NaN,NaN,1.0561896632529506,21.512993352572376,89391148,-0.001473421510359063,-0.47298588360007443,-0.47151246208971537
2025-08-13T12:45:00-04:00,340.91,340.98,339.85,339.94,NaN,NaN,NaN,343.546651528413,NaN,NaN,342.6557999999995,347.0867151924065,338.2248848075925,339.65702748465293,344.0372372413896,346.4882124684802,341.58626201429905,52587,65066.53333333333,38.62733174561386,44.31925125301469,NaN,NaN,NaN,NaN,1.0614618301634537,22.253982689011906,89338561,-0.055498578935070375,-0.5408856857585533,-0.48538710682348296
2025-08-13T12:50:00-04:00,339.92,340.53,339.25,340.3,NaN,NaN,NaN,343.3206541129828,NaN,NaN,342.64579999999944,347.095639709747,338.1959602902519,339.65702748465293,343.9760728182421,346.45744882230366,341.4946968141805,58955,62605.63333333333,41.51876346532452,43.98806825521286,NaN,NaN,NaN,NaN,1.0770716994374907,23.390707525909527,89397516,-0.05905163317772644,-0.559201648295641,-0.5001500151179146
2025-08-13T12:55:00-04:00,340.29,340.35,339.6,339.8,NaN,NaN,NaN,343.3206541129828,NaN,NaN,342.6145999999995,347.1215727492252,338.10762725077376,339.65429759017786,343.94590950530164,346.4425094072349,341.44930960336836,28939,61053.96666666667,38.7856292176224,43.543030170709265,NaN,NaN,NaN,NaN,1.0537094351919556,24.446237731600174,89368577,-0.08553209424486208,-0.6070651329239922,-0.5215330386791301
2025-08-13T13:00:00-04:00,339.78,341.63,339.69,341.36,NaN,NaN,NaN,343.3206541129828,NaN,NaN,342.62439999999947,347.1182681069173,338.13053189308164,339.65429759017786,343.89887514438436,346.4045359411246,341.3932143476441,60948,60593.53333333333,49.87297853529011,44.187268332465806,NaN,NaN,NaN,NaN,1.1170159041068157,23.59292142420508,89429525,0.006664472202776883,-0.513202448425659,-0.5198669206284359
2025-08-13T13:05:00-04:00,341.35,341.41,340.59,340.7,NaN,NaN,NaN,343.3206541129828,NaN,NaN,342.6205999999994,347.1206451733866,338.1205548266122,339.37835045771385,343.8594916696271,346.3719484915828,341.3470348476714,52639,60708.03333333333,46.07102960048935,44.298273157985115,NaN,NaN,NaN,NaN,1.095800482384904,22.800556281623923,89376886,0.02672200062429919,-0.4864644198480619,-0.5131864204723611
2025-08-13T13:10:00-04:00,340.705,341.07,340.29,340.74,NaN,NaN,NaN,343.3206541129828,NaN,NaN,342.61239999999947,347.1246119811026,338.10018801889635,339.37835045771385,343.83352504837995,346.3518433127763,341.3152067839836,33215,58892.166666666664,46.33802780591953,44.16159297858974,NaN,NaN,NaN,NaN,1.0732433050716945,22.365227543653223,89410101,0.04512418862076051,-0.4567811846964105,-0.501905373317171
2025-08-13T13:15:00-04:00,340.7,340.96,340.5,340.93,NaN,NaN,NaN,343.3206541129828,NaN,NaN,342.6095999999995,347.12580895910816,338.0933910408908,339.28434429293685,343.8149394071222,346.33668695212907,341.29319186211535,24886,56656,47.66349571612048,44.22241677088214,NaN,NaN,NaN,NaN,1.0294402118522863,21.960993715537576,89434987,0.07099397062423751,-0.4131629100368741,-0.4841568806611116
2025-08-13T13:20:00-04:00,340.95,341.54,340.9,341.49,NaN,NaN,NaN,343.3206541129828,NaN,NaN,342.6175999999995,347.1244207155647,338.11077928443433,339.4223148289678,343.7849165526506,346.30628456751145,341.26354853778975,49328,55857.4,51.46842088494916,44.70526583814204,NaN,NaN,NaN,NaN,1.0016230538628403,20.774557867439817,89484315,0.12363888515244026,-0.32960827422056127,-0.45324715937300153
2025-08-13T13:25:00-04:00,341.46,341.6,341.15,341.5,NaN,NaN,NaN,343.3206541129828,NaN,NaN,342.6207999999995,347.1242135322307,338.1173864677683,339.6808518631742,343.763675359626,346.28362186132006,341.24372885793196,37248,55758.13333333333,51.536178127660996,45.20047509594623,NaN,NaN,NaN,NaN,0.9622214071583549,19.59217506740603,89521563,0.15492468748688737,-0.25959130001439235,-0.4145159875012797
2025-08-13T13:30:00-04:00,341.48,341.81,340.1,340.1,NaN,NaN,NaN,343.3206541129828,NaN,NaN,342.5861999999995,347.1396898970209,338.0327101029781,339.6808518631742,343.7246473195225,346.25234145731594,341.19695318172904,53060,55503.73333333333,42.57442779142495,45.26679409694865,NaN,NaN,NaN,NaN,1.0156341637898996,19.644384625983204,89468503,0.08084694795362929,-0.3134573025592431,-0.3943042505128724
2025-08-13T13:35:00-04:00,340.08,340.5,339.74,340.14,NaN,NaN,NaN,343.3175742911672,NaN,NaN,342.5736999999995,347.1504909327713,337.99690906722776,339.6808518631742,343.6716441054613,346.2178197819236,341.12546842899906,62886,54131.9,42.88005012604097,45.00670060522602,NaN,NaN,NaN,NaN,0.997374580662049,20.025490537428592,89531389,0.03632582847205701,-0.3488969649228011,-0.3852227933948581
2025-08-13T13:40:00-04:00,340.14,340.23,339.36,339.65,NaN,NaN,NaN,342.96586636884143,NaN,NaN,342.43909999999954,346.9556644866603,337.9225355133388,339.6808518631742,343.6187097736198,346.1878616305238,341.0495579167158,58359,50848.333333333336,40.06694017361286,44.72188400604614,NaN,NaN,NaN,NaN,0.9882763963290458,20.713209131248966,89473030,-0.021242059251473155,-0.4117753674591995,-0.39053330820772636
2025-08-13T13:45:00-04:00,339.69,340.25,339.45,340.05,NaN,NaN,NaN,342.96586636884143,NaN,NaN,342.32849999999956,346.8026288539905,337.85437114600865,339.6808518631742,343.58395062779186,346.1658180251645,341.0020832304192,41014,48729.833333333336,43.3350349496444,44.62989292247024,NaN,NaN,NaN,NaN,0.9748280823055434,21.319218440740478,89514044,-0.027123469002727885,-0.4244376444611362,-0.3973141754584083
2025-08-13T13:50:00-04:00,340.08,340.59,340.06,340.53,NaN,NaN,NaN,342.96586636884143,NaN,NaN,342.1870999999995,346.4266193551119,337.94758064488707,339.6808518631742,343.5670359643927,346.15245318135436,340.981618747431,23281,45445.933333333334,47.065258968422505,44.84311193629547,NaN,NaN,NaN,NaN,0.9437689335694305,21.323434981181475,89537325,0.004866750501062611,-0.39123073733208,-0.39609748783314264
2025-08-13T13:55:00-04:00,340.54,341.09,340.49,340.95,NaN,NaN,NaN,342.96586636884143,NaN,NaN,342.05489999999946,346.0193174808517,338.0904825191472,339.6808518631742,343.5472921132048,346.13366299142837,340.9609212349812,32066,43685.5,50.15709444830819,45.66666641505935,NaN,NaN,NaN,NaN,0.9192140097430401,20.569049901010274,89569391,0.05507704122098622,-0.32725118630690986,-0.3823282275278961
2025-08-13T14:00:00-04:00,340.98,341.43,340.31,341.32,NaN,NaN,NaN,342.96586636884143,NaN,NaN,341.92009999999954,345.49812039712606,338.342079602873,339.6808518631742,343.50847230815407,346.0936544832294,340.92329013307875,69007,43005.53333333333,52.77403320011806,46.47061425325889,NaN,NaN,NaN,NaN,0.9335558661899661,19.392312857007866,89638398,0.11075879828083812,-0.24387972967684846,-0.3546385279576866
2025-08-13T14:05:00-04:00,341.33,341.57,340.77,340.85,NaN,NaN,NaN,342.96586636884143,NaN,NaN,341.8200999999995,345.22866420831565,338.4115357916834,339.6808518631742,343.47116427234556,346.0539972659909,340.8883312787002,69610,43707.933333333334,49.23758145436036,47.21718227016874,NaN,NaN,NaN,NaN,0.9240161614621122,18.106318661616072,89568788,0.11309175541548244,-0.21327383368833353,-0.32636558910381597
2025-08-13T14:10:00-04:00,340.84,341.08,338.2,340.02,NaN,NaN,NaN,342.89336225778493,NaN,NaN,341.7204999999995,345.0414813312291,338.39951866876993,339.6808518631742,343.32374933615756,345.95622533500074,340.6912733373144,189069,48274.6,43.671944228609526,46.774251248262985,NaN,NaN,NaN,NaN,1.0637292927862467,19.303425233737542,89379719,0.05863230286594251,-0.2530752105213878,-0.3117075133873303
2025-08-13T14:15:00-04:00,339.96,340.72,339.69,340.41,NaN,NaN,NaN,342.89336225778493,NaN,NaN,341.62059999999946,344.789250590149,338.45194940984993,339.4844783557248,343.2960053439135,345.9324351493399,340.65957553848716,43610,48080.433333333334,46.71953989552135,46.82057341219384,NaN,NaN,NaN,NaN,1.0613200575872312,20.415024193564623,89423329,0.049155237649993355,-0.25026346632483865,-0.299418703974832
2025-08-13T14:20:00-04:00,340.46,340.64,339.97,340.12,NaN,NaN,NaN,342.89336225778493,NaN,NaN,341.5367999999995,344.63740817297474,338.4361918270243,339.4844783557248,343.27485992083905,345.9143140489899,340.6354057926882,33445,47452,44.779417622777736,46.70924411339799,NaN,NaN,NaN,NaN,1.033368624902426,21.44722322768977,89389884,0.024861018654163014,-0.26834243065712826,-0.2932034493112913
2025-08-13T14:25:00-04:00,340.11,340.28,339.89,340.23,NaN,NaN,NaN,342.89336225778493,NaN,NaN,341.4421999999995,344.4048219202334,338.4795780797656,339.4844783557248,343.2575020905018,345.8999353974236,340.61506878358006,26826,47525.76666666667,45.700515166545244,46.56903121699976,NaN,NaN,NaN,NaN,0.9874137231236804,22.466300527199696,89416710,0.018023640065791047,-0.2706738992290525,-0.28869753929484354
2025-08-13T14:30:00-04:00,340.25,340.68,340.15,340.27,NaN,NaN,NaN,342.89336225778493,NaN,NaN,341.34159999999946,344.10854086716944,338.5746591328295,339.4844783557248,343.23150623293503,345.87614949410755,340.5868629717625,44056,47622.166666666664,46.05290606739541,46.18220873003164,NaN,NaN,NaN,NaN,0.9547413143291339,22.777182620608514,89460766,0.01797798154461755,-0.2662250623640716,-0.28420304390868917
2025-08-13T14:35:00-04:00,340.3,340.48,339.75,339.95,NaN,NaN,NaN,342.89336225778493,NaN,NaN,341.2389999999995,343.81790054135246,338.6600994586466,339.4844783557248,343.2093631920419,345.85795570543917,340.56077067864464,34446,47223,43.61434837243043,45.61636374751517,NaN,NaN,NaN,NaN,0.9386883633056257,23.41051546748496,89426320,-0.0008236993515770563,-0.2852326680981605,-0.28440896874658345
2025-08-13T14:40:00-04:00,339.98,340.34,339.56,340.18,NaN,NaN,NaN,342.89336225778493,NaN,NaN,341.1603999999995,343.6213598457267,338.69944015427234,339.4844783557248,343.1899078873538,345.8420206893416,340.537795085366,30344,47047.23333333333,45.83439518668287,45.849218561462166,NaN,NaN,NaN,NaN,0.9273534802123647,24.15791759712978,89456664,0.004705915950143746,-0.2785265738089038,-0.2832324897590475
2025-08-13T14:45:00-04:00,340.18,340.35,339.84,339.9,NaN,NaN,NaN,342.89336225778493,NaN,NaN,341.0645999999995,343.33397334135066,338.7952266586483,339.4844783557248,343.1736777307288,345.8285972521945,340.51875820926307,25628,47017,43.584607444520344,45.89954408421069,NaN,NaN,NaN,NaN,0.8975425173400564,24.834282282649514,89431036,-0.0073616895195612875,-0.2924346016584991,-0.2850729121389378
2025-08-13T14:50:00-04:00,339.9,339.9,339.48,339.63,NaN,NaN,NaN,342.5121853301892,NaN,NaN,340.95059999999944,342.9018115627274,338.9993884372715,339.4844783557248,343.15565081971636,345.8155694582675,340.49573218116524,25805,46708.166666666664,41.470719195509346,45.99981401434616,NaN,NaN,NaN,NaN,0.8634323375300494,25.77896128724248,89405231,-0.029171332816865736,-0.32153707816002,-0.29236574534315424
2025-08-13T14:55:00-04:00,339.67,340.23,339.62,339.9,NaN,NaN,NaN,342.5121853301892,NaN,NaN,340.86989999999946,342.64667966063803,339.0931203393609,338.5328007558485,343.1295425076442,345.794503951022,340.4645810642664,40756,46391,44.37604876856844,46.074172144269305,NaN,NaN,NaN,NaN,0.8453300277064754,26.04621881801442,89445987,-0.021415773319626186,-0.31913546199268694,-0.29771968867306076
2025-08-13T15:00:00-04:00,339.85,340.15,339.22,339.98,NaN,NaN,NaN,342.4626729971352,NaN,NaN,340.80169999999947,342.44292589622097,339.160474103778,338.5328007558485,343.09643812228006,345.76878480564875,340.4240914389114,50521,47032.566666666666,45.243350060058425,45.94403579367186,NaN,NaN,NaN,NaN,0.851377882870295,26.67047972111814,89496508,-0.007612421974222516,-0.30723521614083893,-0.2996227941666164
2025-08-13T15:05:00-04:00,339.95,340.26,339.83,340.02,NaN,NaN,NaN,342.4626729971352,NaN,NaN,340.7356999999995,342.22490651435396,339.24649348564503,338.586792483743,343.08019564520544,345.75469778106435,340.4056935093465,27253,46767.86666666667,45.6992491029574,45.62561826900395,NaN,NaN,NaN,NaN,0.8212794626652745,27.041753822870163,89523761,0.006722617346662296,-0.29121952248328853,-0.2979421398299508
2025-08-13T15:10:00-04:00,340.04,340.86,340.02,340.85,NaN,NaN,NaN,342.4626729971352,NaN,NaN,340.6928999999995,342.0363672911389,339.3494327088601,339.10143398699444,343.0541824062693,345.72683766236844,340.3815271501702,53905,47789.73333333333,54.21722997783472,45.72870375312657,NaN,NaN,NaN,NaN,0.8226166439034716,26.323960792853633,89577666,0.07104007415259284,-0.2091420471392098,-0.28018212129180264
2025-08-13T15:15:00-04:00,340.86,341.46,340.7,341.15,NaN,NaN,NaN,342.4626729971352,NaN,NaN,340.6936999999995,342.0382070629254,339.34919293707367,339.6731471895955,343.0298440843635,345.69458773796646,340.36510043076055,65540,48221.5,56.851866368456925,46.272581246990605,NaN,NaN,NaN,NaN,0.8181440264817944,24.75221079776107,89643206,0.1293286380301434,-0.11852132375412339,-0.2478499617842668
2025-08-13T15:20:00-04:00,341.1,341.16,340.56,340.61,NaN,NaN,NaN,342.4626729971352,NaN,NaN,340.7104999999995,342.0291633392761,339.3918366607229,339.6731471895955,343.0042480833379,345.6645507837748,340.34394538290104,60364,48268.46666666667,51.14640318854231,46.806471172700086,NaN,NaN,NaN,NaN,0.8025623103045251,23.473829698482582,89582842,0.12688122205014302,-0.08924843422158801,-0.21612965627173103
2025-08-13T15:25:00-04:00,340.6,340.9,340.43,340.72,NaN,NaN,NaN,342.4626729971352,NaN,NaN,340.7272999999995,342.02444025550744,339.43015974449156,339.6731471895955,342.9914585442869,345.64997898345376,340.33293810512004,29444,48285.3,52.19877407268295,47.19784504249735,NaN,NaN,NaN,NaN,0.7788078595684854,22.458512438977525,89612286,0.12768626164774893,-0.05652182921204485,-0.18420809085979378
2025-08-13T15:30:00-04:00,340.78,341.03,340.1,340.14,NaN,NaN,NaN,342.4626729971352,NaN,NaN,340.70469999999955,342.00260663851185,339.40679336148725,339.6731471895955,342.97651559335725,345.6344769446685,340.318554242046,31272,47296.1,46.509767442932926,47.32144145822273,NaN,NaN,NaN,NaN,0.7896072981707328,21.942966463596452,89581014,0.08616246503207453,-0.07650500956970063,-0.16266747460177516
2025-08-13T15:35:00-04:00,340.13,340.38,340,340.29,NaN,NaN,NaN,342.4626729971352,NaN,NaN,340.69509999999957,341.9980236210139,339.39217637898525,339.6731471895955,342.95461187444033,345.6132540129994,340.2959697358813,43101,46978.166666666664,48.0856065343871,47.49180512735428,NaN,NaN,NaN,NaN,0.7603496340156802,21.591740096736505,89624115,0.06667503285738091,-0.07932368353004904,-0.14599871638742995
2025-08-13T15:40:00-04:00,340.21,340.49,339.99,340.37,NaN,NaN,NaN,342.4626729971352,NaN,NaN,340.66209999999955,341.911612049638,339.4125879503611,339.6731471895955,342.9348176399238,345.5934799505217,340.27615532932583,40444,47219.13333333333,48.94942294513383,47.69869919004989,NaN,NaN,NaN,NaN,0.7417532315859888,21.062148358331783,89664559,0.057401928040944517,-0.07424630633624929,-0.1316482343771938
2025-08-13T15:45:00-04:00,340.38,340.63,340.32,340.49,NaN,NaN,NaN,342.4626729971352,NaN,NaN,340.6342999999995,341.8350897577752,339.43351024222375,339.6731471895955,342.9059784343817,345.56218023105725,340.2497766377062,64883,48552.36666666667,50.285683298629,48.17522311334978,NaN,NaN,NaN,NaN,0.7109137150441327,20.30709662371156,89729442,0.05743895315329044,-0.05984954293558076,-0.1172884960888712
2025-08-13T15:50:00-04:00,340.5,341.25,340.5,340.805,NaN,NaN,NaN,342.4626729971352,NaN,NaN,340.6141999999995,341.76833579889967,339.4600642010994,339.76787780549546,342.87192098013037,345.51904101181526,340.2248009484455,93105,50011.6,53.71086403672146,48.73782803120968,NaN,NaN,NaN,NaN,0.7144198782552654,19.160216583374563,89822547,0.07562297587179184,-0.02275977624913139,-0.09838275212092323
2025-08-13T15:55:00-04:00,340.8,340.8,339.2,339.34,NaN,NaN,NaN,342.4626729971352,NaN,NaN,340.56959999999947,341.74470653240013,339.3944934675988,339.76787780549546,342.8207161096326,345.4753155035581,340.1661167157071,94572,51922.4,39.93149473344997,48.47689140899037,NaN,NaN,NaN,NaN,0.7780327440941763,19.2120559156523,89727975,-0.009539853048957214,-0.11030756843211975,-0.10076771538316254
2025-08-14T09:30:00-04:00,335.69,337.95,334.82,336.22,NaN,NaN,NaN,339.4024421103983,NaN,NaN,340.4809999999995,342.17288652174244,338.7891134782565,339.76787780549546,336.33,336.33,336.33,193904,56617.2,25.13952689006321,47.31037767288707,NaN,NaN,NaN,NaN,1.0453161195160197,21.87272270641876,89534071,-0.260610600562479,-0.4265309660862613,-0.1659203655237823
2025-08-14T09:35:00-04:00,336.2,337.82,336.2,336.99,NaN,NaN,NaN,339.4024421103983,NaN,NaN,340.39559999999955,342.334601434337,338.4565985656621,339.76787780549546,336.6323520876369,336.9672654407853,336.2974387344885,158033,59788.76666666667,31.84921121531616,46.415603561940486,NaN,NaN,NaN,NaN,1.0863649681220184,24.34334186927333,89692104,-0.3536629772945214,-0.6079990871419341,-0.2543361098474127
2025-08-14T09:40:00-04:00,337,337.11,335.6,335.96,NaN,NaN,NaN,339.4024421103983,NaN,NaN,340.2763999999995,342.53271384394895,338.02008615605007,339.76787780549546,336.5211507008782,336.8599565873793,336.1823448143771,131409,62223.76666666667,28.207204437152186,45.19873601744718,NaN,NaN,NaN,NaN,1.1166246132561592,26.847800061446215,89560695,-0.4568602666031571,-0.825411443101359,-0.36855117649820196
2025-08-14T09:45:00-04:00,335.92,336.89,335.12,336.77,NaN,NaN,NaN,339.26858859733267,NaN,NaN,340.1789999999995,342.60548717334825,337.7525128266508,339.76787780549546,336.47288002540995,336.7951342696955,336.1506257811244,109599,64509.933333333334,34.5460531373199,44.402079162758795,NaN,NaN,NaN,NaN,1.1632942837378608,29.33300580637246,89670294,-0.4425406397586918,-0.9217269761965667,-0.47918633643787495
2025-08-14T09:50:00-04:00,336.8,338.25,336.2,337.62,NaN,NaN,NaN,339.26858859733267,NaN,NaN,340.1067999999995,342.61727785140874,337.5963221485903,339.76787780549546,336.65756586849386,337.11719684270224,336.1979348942855,156642,68955.3,40.48456618299226,43.42117460598433,NaN,NaN,NaN,NaN,1.2266304063280145,29.980098672255913,89826936,-0.3517529988642667,-0.9188775850182083,-0.5671245861539416
2025-08-14T09:55:00-04:00,337.58,338.21,336.72,337.8,NaN,NaN,NaN,339.26858859733267,NaN,NaN,340.0385999999995,342.61002687283815,337.4671731271609,339.76787780549546,336.78609504662523,337.3183816032188,336.25380849003164,121866,71948.63333333333,41.69103328344566,42.33825795705496,NaN,NaN,NaN,NaN,1.2454425201617243,30.580970619147692,89948802,-0.2597520448711943,-0.8918146422429345,-0.6320625973717402
2025-08-14T10:00:00-04:00,337.91,338.38,337.13,337.66,NaN,NaN,NaN,339.26858859733267,NaN,NaN,339.97879999999947,342.62845021134495,337.329149788654,339.76787780549546,336.87920068308443,337.4569345914512,336.30146677471765,96119,72852.36666666667,40.99495748504331,41.61315469251931,NaN,NaN,NaN,NaN,1.245768054435887,30.93702004955704,89852683,-0.1916430767352969,-0.8716164432908613,-0.6799733665555644
2025-08-14T10:05:00-04:00,337.64,337.95,336.4,336.6,NaN,NaN,NaN,339.26858859733267,NaN,NaN,339.88349999999946,342.6662858348416,337.10071416515734,339.76787780549546,336.8899039487199,337.4380547330216,336.3417531644182,110845,74226.86666666667,36.08275681951323,40.46201060300719,NaN,NaN,NaN,NaN,1.267498907690467,31.664837826179586,89741838,-0.20035498449941014,-0.9304170971798271,-0.730062112680417
2025-08-14T10:10:00-04:00,336.6,336.73,335.77,336.22,NaN,NaN,NaN,339.26858859733267,NaN,NaN,339.7894999999995,342.73844981347156,336.8405501865275,338.8118022443964,336.83253340006587,337.3874560922649,336.2776107078668,104415,71405.06666666667,34.487362448846625,39.60326738914388,NaN,NaN,NaN,NaN,1.2455346999982935,32.65292193091264,89637423,-0.2129073754758659,-0.9961963320252494,-0.7832889565493835
2025-08-14T10:15:00-04:00,336.26,336.68,335.85,336.64,NaN,NaN,NaN,339.26858859733267,NaN,NaN,339.7022999999995,342.758803368617,336.64579663138204,334.46581047004406,336.8094245415205,337.35856131496854,336.2602877680725,65170,72123.73333333334,37.76279601103973,38.86592378033335,NaN,NaN,NaN,NaN,1.215853649998414,33.570428599593335,89702593,-0.175669499820868,-1.0028758313254684,-0.8272063315046004
2025-08-14T10:20:00-04:00,336.68,337.06,336,336.84,NaN,NaN,NaN,339.26858859733267,NaN,NaN,339.6208999999996,342.76007931348,336.4817206865192,334.46581047004406,336.79699274104945,337.3283087219919,336.265676760107,94800,74168.9,39.31863426552892,38.178010303218706,NaN,NaN,NaN,NaN,1.2047212464270989,33.90922557333374,89797393,-0.12281562032909332,-0.9807258569159671,-0.8579102365868738
2025-08-14T10:25:00-04:00,336.79,337.53,336.69,337.19,NaN,NaN,NaN,339.26858859733267,NaN,NaN,339.56589999999954,342.77634276733573,336.35545723266335,334.574598374824,336.8121207908008,337.33617591905,336.2880656625516,62592,75361.1,42.048863192500356,37.5896660099238,NaN,NaN,NaN,NaN,1.1786697288251615,33.614135583536246,89859985,-0.05309204865014949,-0.9242752973995607,-0.8711832487494112
2025-08-14T10:30:00-04:00,337.2,338.55,337.05,338.51,NaN,NaN,NaN,339.26858859733267,NaN,NaN,339.5300999999996,342.7469148784381,336.31328512156114,335.43567869985924,336.8867449264343,337.47301230689874,336.30047754596984,91203,76932.66666666667,51.002652262090486,37.396222311735876,NaN,NaN,NaN,NaN,1.2016218910519356,32.171655936933455,89951188,0.08557423585281798,-0.7642154539333887,-0.8497896897862067
2025-08-14T10:35:00-04:00,338.46,339.97,338.15,339.94,335.53229010143247,335.53229010143247,335.53229010143247,NaN,NaN,NaN,339.5328999999995,342.7508932197787,336.31490678022027,336.5685429598874,337.09694001005295,337.9850291735816,336.2088508465243,139416,80431.66666666667,58.485859021614445,38.721534046604766,NaN,NaN,NaN,NaN,1.245791755976801,30.20281074252268,90090604,0.26700826336925765,-0.5160293605746347,-0.7830376239438923
2025-08-14T10:40:00-04:00,339.91,340.45,338.84,339.04,336.0580950968219,NaN,NaN,NaN,NaN,NaN,339.4864999999995,342.66443030169035,336.3085696983087,336.9238343679099,337.25154681316917,338.28865764625095,336.2144359800874,115403,83266.96666666666,52.99957009767009,40.711537132862404,NaN,NaN,NaN,NaN,1.2718066305498876,28.747277233045192,89975201,0.3164334895921641,-0.3874957619536872,-0.7039292515458513
2025-08-14T10:45:00-04:00,339,339.17,338.45,338.57,336.0580950968219,NaN,NaN,NaN,NaN,NaN,339.44389999999953,342.61271257925887,336.2750874207402,336.9238343679099,337.3273389893646,338.3888330131139,336.26584496561526,94637,85567.26666666666,50.34366435980564,42.03256950032594,NaN,NaN,NaN,NaN,1.2323918712248978,27.037423312548675,89880564,0.307247584080784,-0.3198697714448713,-0.6271173555256553
2025-08-14T10:50:00-04:00,338.5,338.83,338.06,338.06,336.0580950968219,NaN,NaN,NaN,NaN,NaN,339.39029999999957,342.56026934406054,336.2203306559386,336.9238343679099,337.36219632106616,338.42065745954653,336.3037351825858,67418,86954.36666666667,47.55865368735459,43.4148158753404,NaN,NaN,NaN,NaN,1.199363880423118,25.113618265999705,89813146,0.25855391108386816,-0.30392496667082014,-0.5624788777546883
2025-08-14T10:55:00-04:00,338.1,338.32,337.76,338.23,336.0580950968219,NaN,NaN,NaN,NaN,NaN,339.33629999999954,342.4914689720905,336.1811310279086,336.9238343679099,337.3953229049707,338.4411327052098,336.34951310473167,89528,88580.1,48.5797798436663,44.41722492579372,NaN,NaN,NaN,NaN,1.1536950318214667,23.5939768281434,89902674,0.2304568523532362,-0.27440781231314304,-0.5048646646663792
2025-08-14T11:00:00-04:00,338.26,338.43,337.66,337.95,336.0580950968219,NaN,NaN,NaN,NaN,NaN,339.2654999999995,342.382824654655,336.14817534534404,336.9238343679099,337.4172893535316,338.45069933612376,336.38387937093944,73818,89356.66666666667,46.95793843851857,44.879608658331314,NaN,NaN,NaN,NaN,1.1262882438342179,22.07498497256027,89828856,0.18749904016775149,-0.2704908644566899,-0.4579899046244414
2025-08-14T11:05:00-04:00,337.94,337.94,336.8,336.94,336.0580950968219,NaN,NaN,NaN,NaN,NaN,339.1742999999995,342.2916129522932,336.05698704770583,336.9238343679099,337.40874494774357,338.4194986952464,336.39799120024077,97459,91696.86666666667,41.567162882889335,44.870760772577285,NaN,NaN,NaN,NaN,1.1279819407032006,21.425745072806045,89731397,0.09046447229000082,-0.3449093142619404,-0.4353737865519412
2025-08-14T11:10:00-04:00,336.98,337.17,336.18,336.44,336.0580950968219,NaN,NaN,NaN,NaN,NaN,339.1010999999995,342.2988750331275,335.90332496687154,336.9238343679099,337.37979346451965,338.38372266160354,336.37586426743576,80381,92579.4,39.16983579224089,44.74039493737711,NaN,NaN,NaN,NaN,1.1181260877958297,21.308293098685404,89651016,-0.003036824309055608,-0.43916981693826074,-0.43613299262920513
2025-08-14T11:15:00-04:00,336.43,336.97,336.3,336.34,336.0580950968219,NaN,NaN,NaN,NaN,NaN,339.0250999999995,342.3001893060438,335.7500106939552,336.9238343679099,337.3478700057112,338.34567206236204,336.3500679490603,88728,93352.33333333333,38.68923800694395,44.926572165050736,NaN,NaN,NaN,NaN,1.0861170815247,21.199230551287666,89562288,-0.06388805538627418,-0.5159930618620479,-0.4521050064757737
2025-08-14T11:20:00-04:00,336.3,336.31,333.78,333.88,NaN,NaN,NaN,338.5109597106752,338.5109597106752,338.5109597106752,338.9096999999995,342.4817394234413,335.33766057655765,336.9238343679099,337.123982362732,338.3344299454067,335.9135347800573,212642,98428.26666666666,29.19832911807066,44.54878406999531,NaN,NaN,NaN,NaN,1.1913944328443644,22.639799989117783,89349646,-0.25154900865451457,-0.7665412672939169,-0.5149922586394023
2025-08-14T11:25:00-04:00,333.86,333.88,331.28,332.51,NaN,NaN,NaN,336.2429615420082,NaN,NaN,338.7588999999996,342.7389720046728,334.77882799532637,336.9238343679099,336.71734838791843,338.4570640956226,334.97763268021424,249807,105773.7,25.453475381244644,43.66954688215281,NaN,NaN,NaN,NaN,1.2920091162126257,24.912633955729454,89099839,-0.43871975717909806,-1.063391955113275,-0.6246721979341768
2025-08-14T11:30:00-04:00,332.53,332.74,331.2,331.21,NaN,NaN,NaN,335.67646329009875,NaN,NaN,338.57249999999954,343.0457450192707,334.09925498072835,335.9890674943279,336.450594500138,338.4823312877009,334.41885771257506,158107,110001.53333333334,22.50400436720328,42.468501889415265,NaN,NaN,NaN,NaN,1.3097227507688682,27.047962546815757,88941732,-0.6103042874068116,-1.3875525571926914,-0.7772482697858798
2025-08-14T11:35:00-04:00,331.24,331.88,330.53,331.26,NaN,NaN,NaN,334.92707859509426,NaN,NaN,338.3786999999996,343.2454544875737,333.5119455124255,335.9459625570959,336.1837286238486,338.473045406286,333.89441184141117,159458,113880.1,22.874180293706758,41.098881682358574,NaN,NaN,NaN,NaN,1.3125996971425222,29.238768097341854,89101190,-0.6755800802800133,-1.6217233701358964,-0.9461432898558831
2025-08-14T11:40:00-04:00,331.21,331.54,330.4,331.3,NaN,NaN,NaN,334.6783477498627,NaN,NaN,338.1782999999996,343.35914920088635,332.9974507991128,335.9459625570959,335.9816775620298,338.4360361615905,333.5273189624691,128749,116823.6,23.190276861204737,39.112283439438166,NaN,NaN,NaN,NaN,1.3002711473466309,31.313209573626644,89229939,-0.6699001441757668,-1.7835184700755917,-1.113618325899825
2025-08-14T11:45:00-04:00,331.34,333.08,330.93,333,NaN,NaN,NaN,334.6783477498627,NaN,NaN,338.0212999999996,343.3426482541714,332.6999517458278,335.9459625570959,335.82148808330413,338.3349265579905,333.30804960861775,149494,119643.96666666666,35.32265138841552,37.45776860849538,NaN,NaN,NaN,NaN,1.3609660653932985,31.60101466750693,89379433,-0.5125801235528429,-1.7543434803408786,-1.2417633567880357
2025-08-14T11:50:00-04:00,333.02,333.29,331.61,331.69,NaN,NaN,NaN,334.6783477498627,NaN,NaN,337.8546999999996,343.43080703289553,332.27859296710363,335.3777700456767,335.7198709537502,338.26904563986466,333.1706962676358,98111,119810.83333333333,31.229134265313704,35.90273747761278,NaN,NaN,NaN,NaN,1.383754203579492,31.66680667433697,89281322,-0.45938490545556077,-1.8159944886074868,-1.356609583151926
2025-08-14T11:55:00-04:00,331.66,332.65,331.54,332.04,NaN,NaN,NaN,334.6783477498627,NaN,NaN,337.6872999999996,343.44606487124116,331.928535128758,334.6252160365414,335.6480784692141,338.2223041126539,333.07385282577434,70352,119003.5,33.44827114105972,34.69592367627378,NaN,NaN,NaN,NaN,1.3642003318952394,31.763686923788192,89351674,-0.3672573245214916,-1.8156812388037906,-1.448423914282299
2025-08-14T12:00:00-04:00,332.04,332.04,331.39,331.6,NaN,NaN,NaN,334.6783477498627,NaN,NaN,337.5168999999997,343.4782927535454,331.55550724645394,334.5991728292331,335.5797792870829,338.1834793621412,332.97607921202456,62472,114622.43333333333,32.0481924244026,33.58803358606293,NaN,NaN,NaN,NaN,1.3131860224741534,31.93423993973071,89289202,-0.3051360735175215,-1.8298440061792007,-1.5247079326616793
2025-08-14T12:05:00-04:00,331.51,331.79,331.1,331.65,NaN,NaN,NaN,334.6783477498627,NaN,NaN,337.3452999999996,343.475975790002,331.2146242099972,333.13333826338646,335.48591889513176,338.1308472431083,332.84099054715523,85827,112215.56666666667,32.394500656079416,32.431942215521005,NaN,NaN,NaN,NaN,1.2686727351545708,32.25199194838845,89375029,-0.23311258531779622,-1.8160986643089245,-1.5829860789911283
2025-08-14T12:10:00-04:00,331.64,332.27,331.32,331.49,NaN,NaN,NaN,334.6783477498627,NaN,NaN,337.1696999999996,343.4562171313111,330.88318286868804,330.0386706107092,335.42080942884473,338.0888127506374,332.7528061070521,64951,110000.3,31.835378780715686,31.3517593828208,NaN,NaN,NaN,NaN,1.2459103969292435,31.992155625403118,89310078,-0.17152855561246128,-1.797396773506705,-1.6258682178942436
2025-08-14T12:15:00-04:00,331.4,332.32,331.35,331.95,NaN,NaN,NaN,334.6783477498627,NaN,NaN,337.00969999999955,343.4111930791414,330.6082069208577,329.5348248749358,335.36731942475706,338.0501917437494,332.6844471057647,57920,108277.66666666667,35.293238654899994,30.90362193796442,NaN,NaN,NaN,NaN,1.2262025114342954,31.692549952338396,89367998,-0.07975821300362318,-1.7255659841487727,-1.6458077711451495
2025-08-14T12:20:00-04:00,331.92,332.17,331.23,331.93,NaN,NaN,NaN,334.6783477498627,NaN,NaN,336.8446999999996,343.3354948390146,330.3539051609846,329.5348248749358,335.3113029924607,338.01010112256955,332.61250486235184,60876,105085.46666666666,35.20960782635596,30.62074851182978,NaN,NaN,NaN,NaN,1.205759474903274,31.497611885698852,89307122,-0.004329120807365028,-1.6512191721543559,-1.6468900513469908
2025-08-14T12:25:00-04:00,331.94,331.94,331.19,331.45,NaN,NaN,NaN,334.6783477498627,NaN,NaN,336.67569999999955,343.278548479433,330.0728515205661,329.5348248749358,335.2689796649099,337.98199412852875,332.5559652012911,44131,102494.3,33.17764231488381,30.227063105254057,NaN,NaN,NaN,NaN,1.1732052266958972,31.345836693694373,89262991,0.027557216145127406,-1.6124435311655816,-1.640000747310709
2025-08-14T12:30:00-04:00,331.47,331.82,331.34,331.5,NaN,NaN,NaN,334.6783477498627,NaN,NaN,336.5130999999996,343.2165805558172,329.80961944418203,329.55319033596714,335.2282198352303,337.95392941707047,332.5025102533901,43770,100749.33333333333,33.60746353800205,30.542001278106294,NaN,NaN,NaN,NaN,1.1236905676461917,31.20490258683307,89306761,0.06424081655505987,-1.5596997266168842,-1.623940543171944
2025-08-14T12:35:00-04:00,331.56,331.87,331.25,331.7,NaN,NaN,NaN,334.6783477498627,NaN,NaN,336.3490999999996,343.11405785368726,329.584142146312,329.7465522687737,335.1827928692217,337.9211780535208,332.4444076849226,50685,98744,35.39749271270965,31.2522882303538,NaN,NaN,NaN,NaN,1.0877126699571782,31.148769286885774,89357446,0.11143446556851866,-1.4846474612112956,-1.5960819267798143
2025-08-14T12:40:00-04:00,331.7,331.8,330.86,331.22,NaN,NaN,NaN,334.6669207015995,NaN,NaN,336.1738999999996,343.0070407977803,329.3407592022189,329.7465522687737,335.11260017577973,337.8751187330629,332.3500816184966,74263,97738.93333333333,33.09152334558689,32.008539585952626,NaN,NaN,NaN,NaN,1.0771617649602367,31.418020613850523,89283183,0.11909164728415123,-1.4472173676746252,-1.5663090149587764
2025-08-14T12:45:00-04:00,331.2,331.69,331.09,331.63,NaN,NaN,NaN,334.6570606697085,NaN,NaN,336.00609999999966,342.86522160280845,329.1469783971909,329.7465522687737,335.07730035302984,337.84946380067544,332.30513690538424,40268,96908.86666666667,36.87433157580359,33.008550391816684,NaN,NaN,NaN,NaN,1.043078781748793,31.668039703174927,89323451,0.15809302197156994,-1.3686927374943139,-1.5267857594658838
2025-08-14T12:50:00-04:00,331.64,332.18,331.64,332.08,NaN,NaN,NaN,334.6570606697085,NaN,NaN,335.83069999999964,342.63368170232155,329.0277182976777,330.2769947616121,335.0286442097457,337.8059933248109,332.25129509468053,66029,95949.83333333333,40.82853361394046,34.26842587415494,NaN,NaN,NaN,NaN,1.0078588687667371,31.0703721534634,89389480,0.2168881936446181,-1.2556755174101113,-1.4725637110547294
2025-08-14T12:55:00-04:00,332.11,332.45,331.87,332.3,NaN,NaN,NaN,334.6570606697085,NaN,NaN,335.6536999999996,342.3536190474374,328.95378095256183,330.6375958092897,334.9813923973581,337.75909280812465,332.20369198659154,71886,96259.63333333333,42.71769138463056,34.79664301674173,NaN,NaN,NaN,NaN,0.9772975209976833,30.087248728496007,89461366,0.2698351990018384,-1.1352697123024313,-1.4051049113042697
2025-08-14T13:00:00-04:00,332.3,332.47,332.03,332.19,NaN,NaN,NaN,334.6570606697085,NaN,NaN,335.48529999999954,342.1011949237698,328.86940507622927,330.80007664743175,334.9580149475914,337.7353944963211,332.1806353988617,36790,94445.86666666667,41.995727139481176,35.56568536489655,NaN,NaN,NaN,NaN,0.9389191266407099,29.141980142809366,89424576,0.2946662794381316,-1.0367720620066052,-1.3314383414447368
2025-08-14T13:05:00-04:00,332.17,332.48,331.8,332.44,NaN,NaN,NaN,334.6570606697085,NaN,NaN,335.31969999999967,341.8166310941469,328.82276890585246,330.8040613179454,334.9306072446474,337.70725924736433,332.1539552419304,44107,91268.9,44.29980238989245,36.34079473981318,NaN,NaN,NaN,NaN,0.920424903309231,28.535391988245067,89468683,0.32287591148067274,-0.9278434520938958,-1.2507193635745686
2025-08-14T13:10:00-04:00,332.49,332.88,332.43,332.57,NaN,NaN,NaN,334.6570606697085,NaN,NaN,335.16829999999965,341.56083239664156,328.77576760335774,331.3142490543563,334.8956247423461,337.6654814906269,332.1257679940653,67439,89670.1,45.51186933571421,37.302485947764005,NaN,NaN,NaN,NaN,0.8868231245014279,27.293252987568923,89536122,0.34333033951931546,-0.8215564391754242,-1.1648867786947397
2025-08-14T13:15:00-04:00,332.595,333.5,332.48,333.15,NaN,NaN,NaN,334.6570606697085,NaN,NaN,335.02549999999957,341.2713178809795,328.77968211901964,331.7373992434851,334.85962017389176,337.6143201125376,332.1049202352459,88045,89450.36666666667,50.66954810963196,38.60784648016062,NaN,NaN,NaN,NaN,0.8963357584656102,25.47024767806975,89624167,0.3857871304399991,-0.6826528656447408,-1.06843999608474
2025-08-14T13:20:00-04:00,333.16,333.58,332.9,333.42,NaN,NaN,NaN,334.6570606697085,NaN,NaN,334.88649999999956,340.95725555448803,328.8157444455111,331.829919394788,334.83752252467946,337.57884167962567,332.09620336973325,65100,89373.1,52.904421730277186,40.112778119415005,NaN,NaN,NaN,NaN,0.8808832042894956,23.88896192879362,89689267,0.41914615833156166,-0.5445072981702879,-0.9636534565018495
2025-08-14T13:25:00-04:00,333.39,334.13,333.34,333.96,NaN,NaN,NaN,334.6570606697085,NaN,NaN,334.7558999999996,340.616154496371,328.8956455036282,332.3349355158304,334.81817834740576,337.537159518263,332.0991971765485,88159,89327.46666666666,57.091366555552796,41.669787255175926,NaN,NaN,NaN,NaN,0.8743915468402473,23.147539244461466,89777426,0.4613295995955049,-0.3869914570074684,-0.8483210566029733
2025-08-14T13:30:00-04:00,333.99,334.01,332.99,333.16,NaN,NaN,NaN,334.6570606697085,NaN,NaN,334.60299999999967,340.21775662892685,328.9882433710725,332.3349355158304,334.79506565544835,337.4980358669139,332.0920954439828,76848,89428.46666666666,49.99945536740518,42.72620493667944,NaN,NaN,NaN,NaN,0.8847921506373712,21.91348388554563,89700578,0.420265553517541,-0.3229891147060471,-0.7432546682235881
2025-08-14T13:35:00-04:00,333.12,333.77,332.77,333.65,NaN,NaN,NaN,334.6570606697085,NaN,NaN,334.48919999999964,339.94366729224595,329.03473270775334,332.3349355158304,334.78147756846784,337.474779044716,332.08817609221967,46703,87736.6,53.78611367485452,44.198238605248775,NaN,NaN,NaN,NaN,0.8930212827347017,20.43811211627722,89747281,0.41054315641340744,-0.23007572270682886,-0.6406188791202363
2025-08-14T13:40:00-04:00,333.72,333.92,333.4,333.81,NaN,NaN,NaN,334.6570606697085,NaN,NaN,334.4409999999997,339.8759951243817,329.0060048756177,332.3349355158304,334.7655080476365,337.4418143819814,332.08920171329163,72719,87481.2,54.98491722951128,45.72519958321372,NaN,NaN,NaN,NaN,0.8663769053965115,19.286753876766262,89820000,0.39897922186148393,-0.14189485179338135,-0.5408740736548653
2025-08-14T13:45:00-04:00,333.79,334.5,333.63,334.42,NaN,NaN,NaN,334.6570606697085,NaN,NaN,334.38959999999963,339.77558620145294,329.0036137985463,332.54062158728414,334.75355809873463,337.403540563922,332.1035756335473,102249,87931.9,59.31777797740554,47.43379138783485,NaN,NaN,NaN,NaN,0.8666356978681895,18.998958832422865,89922249,0.4146758422375821,-0.022529270857887695,-0.4372051130954698
2025-08-14T13:50:00-04:00,334.42,334.53,333.86,334.26,NaN,NaN,NaN,334.6570606697085,NaN,NaN,334.3555999999997,339.7229340274294,328.98826597257,332.6274972698273,334.74766043258626,337.3836419719758,332.1116788931967,55327,82688.06666666667,57.74768247526905,49.194945611383574,NaN,NaN,NaN,NaN,0.8525902908776016,18.770023086859098,89866922,0.39655127627599734,0.05848398224952689,-0.33806729402647046
2025-08-14T13:55:00-04:00,334.28,334.57,334,334.51,NaN,NaN,NaN,334.6570606697085,NaN,NaN,334.3103999999996,339.6335253378281,328.98727466217116,332.76299781586187,334.74420434951554,337.36866237455763,332.11974632447345,45307,75871.4,59.549337127986256,50.81458886511091,NaN,NaN,NaN,NaN,0.8324052701006296,18.611598260499022,89912229,0.38343978723282607,0.14123244001456214,-0.24220734721826392
2025-08-14T14:00:00-04:00,334.49,334.49,333.48,333.49,NaN,NaN,NaN,334.6570606697085,NaN,NaN,334.2277999999996,339.4705035623086,328.98509643769063,332.76299781586187,334.73653245689275,337.35141973240894,332.12164518137655,42539,72019.13333333333,50.15292373694343,51.48061673103969,NaN,NaN,NaN,NaN,0.8465191793791541,17.53250596193901,89869690,0.29223535371862286,0.12308684493001465,-0.1691485087886082
2025-08-14T14:05:00-04:00,333.54,333.72,333.24,333.57,NaN,NaN,NaN,334.6570606697085,NaN,NaN,334.14319999999964,339.28820525191526,328.998194748084,332.76299781586187,334.7257681537979,337.33166797043003,332.11986833716577,45372,68216.26666666666,50.808539518461735,52.05853445488477,NaN,NaN,NaN,NaN,0.8203392379949301,16.419569205799096,89915062,0.22639822934992165,0.11384927789879384,-0.1125489514511278
2025-08-14T14:10:00-04:00,333.57,333.76,333.17,333.33,NaN,NaN,NaN,334.6570606697085,NaN,NaN,334.0565999999996,339.1068033387101,329.0063966612891,332.76299781586187,334.7156115402197,337.31389037309697,332.1173327073424,40528,65275.566666666666,48.737543414087405,52.54009276021379,NaN,NaN,NaN,NaN,0.8038864352810047,15.500191067433121,89874534,0.15897447397524883,0.08616914101793327,-0.07280533295731557
2025-08-14T14:15:00-04:00,333.34,333.4,332.94,333.16,NaN,NaN,NaN,334.6570606697085,NaN,NaN,333.98779999999965,338.99104101380345,328.98455898619585,332.76299781586187,334.70137640027104,337.29190840320547,332.1108443973366,48329,61903.4,47.267836759343695,52.7520952151746,NaN,NaN,NaN,NaN,0.7793231184752172,15.021883175733928,89826205,0.09819561517718954,0.049939186014171355,-0.048256429163018186
2025-08-14T14:20:00-04:00,333.16,333.52,332.85,333.38,NaN,NaN,NaN,334.6570606697085,NaN,NaN,333.93099999999964,338.895922154695,328.9660778453043,332.76299781586187,334.6877267633262,337.26985137028765,332.1056021563648,49926,60297.23333333333,49.3946149686495,53.02943418895569,NaN,NaN,NaN,NaN,0.771514324298413,14.34686868026121,89876131,0.06943285824982003,0.03853464364925685,-0.03089821460056318
2025-08-14T14:25:00-04:00,333.33,333.46,332.85,332.96,NaN,NaN,NaN,334.6570606697085,NaN,NaN,333.85739999999964,338.7683181384143,328.94648186158497,332.76299781586187,334.6777560880521,337.25488443627484,332.10062773982935,33337,59063.4,45.61244324811025,52.66821241313271,NaN,NaN,NaN,NaN,0.7599775868485233,13.72006950589369,89842794,0.021243408594245842,-0.004343953857755878,-0.02558736245200172
2025-08-14T14:30:00-04:00,333,333.31,332.96,333.08,NaN,NaN,NaN,334.6570606697085,NaN,NaN,333.78219999999965,338.6227756519461,328.9416243480532,332.76299781586187,334.6663418258677,337.2374733694375,332.09521028229784,39347,58292.566666666666,46.86432829668634,52.23677716787622,NaN,NaN,NaN,NaN,0.7306934735022018,13.138041701123848,89882141,-0.0021830246892696505,-0.028316143313588782,-0.02613311862431913
2025-08-14T14:35:00-04:00,333.03,333.58,333,333.51,NaN,NaN,NaN,334.6570606697085,NaN,NaN,333.7085999999996,338.4505810377504,328.9666189622488,332.76299781586187,334.6547757649853,337.21738669135146,332.0921648386191,48195,57038.166666666664,51.19908531289795,51.81589993625802,NaN,NaN,NaN,NaN,0.719929653966329,12.382649318302285,89930336,0.010928024631303511,-0.012473087835189745,-0.023401112466493255
2025-08-14T14:40:00-04:00,333.54,334.09,333.44,333.96,NaN,NaN,NaN,334.6570606697085,NaN,NaN,333.6175999999996,338.15786882050133,329.07733117949783,332.76299781586187,334.64861738137745,337.2026303506624,332.0946044120925,40846,56234.666666666664,55.30808656579934,52.19508787900047,NaN,NaN,NaN,NaN,0.7149346786830181,12.624242094230906,89971182,0.04750420342674497,0.035979141816937954,-0.011525061609807014
2025-08-14T14:45:00-04:00,333.94,334.12,333.65,334.06,NaN,NaN,NaN,334.6570606697085,NaN,NaN,333.49999999999955,337.6685201213984,329.3314798786007,332.6895272655632,334.64245203420097,337.18612475704157,332.0987793113604,48242,55912.066666666666,56.19085193773615,52.36685489777772,NaN,NaN,NaN,NaN,0.6974393444913759,12.89978363508692,90019424,0.07442603302534197,0.08150747967187044,0.007081446646528478
2025-08-14T14:50:00-04:00,334.05,334.41,333.91,333.93,NaN,NaN,NaN,334.6570606697085,NaN,NaN,333.3977999999996,337.2571062384689,329.53849376153033,333.01562181245055,334.636546826008,337.1673967061022,332.1056969459138,58908,55846.46666666667,54.678811378790776,52.344990194154825,NaN,NaN,NaN,NaN,0.6833365341705634,13.641154205867547,89960516,0.07903772212719856,0.10587859930552668,0.02684087717832812
2025-08-14T14:55:00-04:00,333.93,334.18,333.68,334.17,NaN,NaN,NaN,334.6570606697085,NaN,NaN,333.3097999999996,336.8834311844291,329.73616881557007,333.01562181245055,334.6320545742741,337.15436921746436,332.1097399310838,40279,55718.066666666666,56.98034498278268,52.17803069453891,NaN,NaN,NaN,NaN,0.6702410674440946,13.75725422250061,90000795,0.0928564876778879,0.142911486775688,0.05005499909780009
2025-08-14T15:00:00-04:00,334.115,334.82,334.05,334.7,332.15094892901243,332.15094892901243,332.15094892901243,NaN,NaN,NaN,333.2425999999996,336.5746019451301,329.91059805486907,333.3425979599684,334.63109299346235,337.14224923839964,332.11993674852505,50130,55930.066666666666,61.61604249726011,52.45434212468113,NaN,NaN,NaN,NaN,0.677366705483801,14.851694380531914,90050925,0.13001715164020541,0.21257643864805686,0.08255928700785145
2025-08-14T15:05:00-04:00,334.7,334.87,334.19,334.77,332.2570421595118,NaN,NaN,NaN,NaN,NaN,333.1733999999996,336.2196740786488,330.12712592135045,333.34807836797467,334.6308764592137,337.1291109756601,332.1326419427673,58789,56200.2,62.195469682186804,52.643351592838314,NaN,NaN,NaN,NaN,0.6775547979492442,15.936498301588125,90109714,0.15020758116468372,0.2703187634637061,0.12011118229902237
2025-08-14T15:10:00-04:00,334.78,334.8,334.22,334.62,332.26126751589766,NaN,NaN,NaN,NaN,NaN,333.10679999999957,335.8643683205352,330.3492316794639,333.34807836797467,334.630393738628,337.1214656904874,332.1393217867686,33017,54825.333333333336,60.10177049017347,53.35398350378331,NaN,NaN,NaN,NaN,0.6705865980957257,16.943816228283183,90076697,0.14432074133168646,0.30051210896363045,0.156191367631944
2025-08-14T15:15:00-04:00,334.59,334.77,333.8,334.73,332.26126751589766,NaN,NaN,NaN,NaN,NaN,333.0625999999996,335.63780425644694,330.4873957435522,333.34807836797467,334.6286774537113,337.10894535453474,332.14840955288787,50605,55169.9,61.13500814290923,54.09158840552957,NaN,NaN,NaN,NaN,0.6919732696603146,16.79747622003161,90127302,0.13866142856755076,0.32951815334138246,0.1908567247738317
2025-08-14T15:20:00-04:00,334.73,334.75,334.28,334.33,332.27570036055965,NaN,NaN,NaN,NaN,NaN,333.0203999999996,335.4371149940396,330.6036850059596,333.34807836797467,334.62718716219706,337.09694483076356,332.15742949363056,49807,54629.166666666664,55.505921815297015,54.57504400561597,NaN,NaN,NaN,NaN,0.6761180361131512,16.661589069512285,90077495,0.1005783498979714,0.31657966214629596,0.21600131224832456
2025-08-14T15:25:00-04:00,334.31,334.53,334.07,334.37,332.27570036055965,NaN,NaN,NaN,NaN,NaN,332.98099999999954,335.238971656709,330.7230283432901,333.34807836797467,334.62504343582737,337.0862048620876,332.16388200956715,41638,53620.9,55.94278919445642,55.194683465266884,NaN,NaN,NaN,NaN,0.660681033533639,16.016254090174357,90119133,0.07201959450019249,0.30602580537356516,0.23400621087337267
2025-08-14T15:30:00-04:00,334.38,334.7,334.33,334.47,332.3643158243942,NaN,NaN,NaN,NaN,NaN,332.99279999999953,335.27547225910394,330.71012774089513,333.34807836797467,334.6239402855732,337.07424921026325,332.1736313608832,52530,54145.566666666666,57.077428510930396,55.743455861144085,NaN,NaN,NaN,NaN,0.6399181025669509,15.761872993018075,90171663,0.054592510166539154,0.3022468485815466,0.24765433841500745
2025-08-14T15:35:00-04:00,334.48,334.91,334.23,334.6,332.42434692328544,NaN,NaN,NaN,NaN,NaN,333.03459999999956,335.3565826361348,330.7126173638643,333.4618341756944,334.6234296624299,337.059464207096,332.18739511776374,70008,55008.933333333334,58.571157017880246,56.66907827327051,NaN,NaN,NaN,NaN,0.6427810952407407,15.932188485027229,90241671,0.046846200698174856,0.30621208928772603,0.2593658885895512
2025-08-14T15:40:00-04:00,334.61,335.06,334.3,334.44,332.52824024495425,NaN,NaN,NaN,NaN,NaN,333.0991999999995,335.3941051053743,330.80429489462466,333.5214673405555,334.6231096824009,337.04245404892663,332.2037653158752,83414,55541.433333333334,55.9886173952315,57.320813208880885,NaN,NaN,NaN,NaN,0.6511538741521157,16.368796405921753,90158257,0.02695979323558928,0.29306563013403775,0.26610583689844847
2025-08-14T15:45:00-04:00,334.42,334.65,334.01,334.07,332.52824024495425,NaN,NaN,NaN,NaN,NaN,333.1553999999995,335.40456414757745,330.9062358524215,333.5214673405555,334.61905489332645,337.0257657210725,332.2123440655804,65915,54803.76666666667,50.44897233842414,57.26723371070418,NaN,NaN,NaN,NaN,0.6503571688555351,15.987769851397685,90092342,-0.012956470341010828,0.24991024897218495,0.2628667193131958
2025-08-14T15:50:00-04:00,334.07,335.09,334.07,334.52,332.52824024495425,NaN,NaN,NaN,NaN,NaN,333.2197999999995,335.4369422693626,331.00265773063643,333.5214673405555,334.618200357272,337.00744534920824,332.2289553653357,90646,55655.3,56.133688524536446,57.3262052791854,NaN,NaN,NaN,NaN,0.6767602282229956,16.450344437315096,90182988,-0.010974568444681643,0.24914850875734373,0.2601230772020254
2025-08-14T15:55:00-04:00,334.5,336.03,334.355,335.58,332.8803299125208,NaN,NaN,NaN,NaN,NaN,333.2713999999996,335.5837252717459,330.95907472825326,333.79197127836443,334.64035152852466,336.99488569344527,332.28581736360405,203668,59505.6,66.02217336542994,58.02844252402067,NaN,NaN,NaN,NaN,0.7480630690642069,18.14338101527777,90386656,0.05611818548559239,0.33027080905901585,0.27415262357342346
2025-08-15T09:30:00-04:00,337.65,339.31,336.81,336.9,335.3442921892244,NaN,NaN,NaN,NaN,NaN,333.37559999999957,335.85686793443045,330.8943320655687,335.65457702269157,337.67333333333335,337.67333333333335,337.67333333333335,248048,65212.26666666667,73.90955520942752,59.40206708335187,NaN,NaN,NaN,NaN,0.9610585641310506,21.688658386028983,90634704,0.1769687349337158,0.4953635422405682,0.31839480730685243
2025-08-15T09:35:00-04:00,336.93,337.13,334.85,334.86,NaN,NaN,NaN,338.89317563755856,338.89317563755856,338.89317563755856,333.43199999999956,335.91746494694144,330.9465350530577,335.65457702269157,336.8772753132776,337.88035614254596,335.87419448400925,156226,68863.03333333334,53.312427978431785,59.140073011612515,NaN,NaN,NaN,NaN,1.0552686666931164,22.23617272447193,90478478,0.11034774568142297,0.45632948940863116,0.3459817437272082
2025-08-15T09:40:00-04:00,334.9,335.92,334.28,334.83,NaN,NaN,NaN,338.094849472215,NaN,NaN,333.49659999999955,335.95601004358366,331.03718995641543,335.65457702269157,336.4570298246253,337.63509260271945,335.27896704653114,117409,70352.7,53.07816818289835,58.53022484630095,NaN,NaN,NaN,NaN,1.097035190500754,22.126228714794266,90361069,0.05773760968147579,0.4181537558290529,0.3604161461475771
2025-08-15T09:45:00-04:00,334.82,334.92,332.36,332.51,NaN,NaN,NaN,336.84781085984156,NaN,NaN,333.5137999999995,335.93301273199177,331.0945872680072,335.65457702269157,335.6477334064163,337.36989361290705,333.92557319992557,177066,72846.6,38.85808575087017,56.86326885120691,NaN,NaN,NaN,NaN,1.2015326768935577,20.751545284380075,90184003,-0.12960693050597927,0.19840748301510303,0.3280144135210823
2025-08-15T09:50:00-04:00,332.55,333.39,332.15,332.48,NaN,NaN,NaN,336.0010921843942,NaN,NaN,333.5335999999995,335.90190322436763,331.1652967756314,335.65457702269157,335.1299673766192,337.0590921067639,333.20084264647454,147270,75911.36666666667,38.71365213486285,55.335546111541866,NaN,NaN,NaN,NaN,1.2042803428297328,19.631082187859125,90036733,-0.24514162407635387,0.021587383425639928,0.2667290075019938
2025-08-15T09:55:00-04:00,332.45,333.64,332.45,333.11,NaN,NaN,NaN,336.0010921843942,NaN,NaN,333.5567999999995,335.88498363593044,331.22861636406856,335.65457702269157,334.920923269708,336.8527866657859,332.9890598736301,95378,77580.4,43.465922797958505,54.073468586902536,NaN,NaN,NaN,NaN,1.2032603183418946,18.38031486321313,90132111,-0.266932391958085,-0.06693648244561246,0.19999590951247254
2025-08-15T10:00:00-04:00,333.11,334.07,332.25,333.82,NaN,NaN,NaN,336.0010921843942,NaN,NaN,333.5945999999994,335.87682421396806,331.3123757860307,335.65457702269157,334.73063945749243,336.60899940165774,332.8522795133271,132628,80583.36666666667,48.32875039744952,53.560813485627705,NaN,NaN,NaN,NaN,1.2473131527460446,17.27598232271053,90264739,-0.22311016925835267,-0.07889180206046831,0.14421836719788436
2025-08-15T10:05:00-04:00,333.91,334.32,333.33,333.74,NaN,NaN,NaN,336.0010921843942,NaN,NaN,333.64039999999943,335.8390139640231,331.4417860359758,335.65457702269157,334.64927591418063,336.46317866808135,332.8353731602799,102493,82487.4,47.82953150337579,52.98129507912195,NaN,NaN,NaN,NaN,1.2289336418356136,16.45838577046519,90162246,-0.19036766973336322,-0.09374121996881968,0.09662644976454354
2025-08-15T10:10:00-04:00,333.79,333.85,332.26,332.96,NaN,NaN,NaN,336.0010921843942,NaN,NaN,333.66959999999943,335.7911615387581,331.54803846124076,335.65457702269157,334.50549863143465,336.2978151343482,332.7131821285211,114128,84940.73333333334,43.14948310350591,51.98644183573448,NaN,NaN,NaN,NaN,1.2547240959902148,15.784001413503827,90048118,-0.21052462021958793,-0.16652932550994137,0.043995294709646554
2025-08-15T10:15:00-04:00,333.01,333.51,332.24,332.78,NaN,NaN,NaN,336.0010921843942,NaN,NaN,333.69119999999947,335.7532674680281,331.6291325319708,335.65457702269157,334.41339664280025,336.19637243560584,332.63042084999466,75711,85853.46666666666,42.12511072675965,50.81172424351159,NaN,NaN,NaN,NaN,1.2558152319909124,15.173976687808183,89972407,-0.224010834003048,-0.23601824779416347,-0.01200741379111546
2025-08-15T10:20:00-04:00,332.84,333.57,332.5,332.59,NaN,NaN,NaN,336.0010921843942,NaN,NaN,333.71859999999947,335.68267335981363,331.7545266401853,333.06566161815323,334.3346354300067,336.10354682065724,332.56572403935616,74322,86666.66666666667,41.01817011241153,49.742406580453014,NaN,NaN,NaN,NaN,1.2425427154201325,14.547670784054048,89898085,-0.232736600278186,-0.30292816413884793,-0.07019156386066196
2025-08-15T10:25:00-04:00,332.59,333.05,331.86,332.88,NaN,NaN,NaN,335.8674853958877,NaN,NaN,333.7435999999995,335.6310226242796,331.8561773757194,331.8485292945226,334.2068349145491,335.96886078369795,332.4448090454003,114348,89367.03333333334,43.4602843046428,49.24321457804006,NaN,NaN,NaN,NaN,1.2387896643186944,14.51672821352632,90012433,-0.20685825877125025,-0.3287643873247248,-0.12190612855347453
2025-08-15T10:30:00-04:00,332.92,333.13,332.33,332.9,NaN,NaN,NaN,335.8674853958877,NaN,NaN,333.7599999999995,335.6030453067325,331.91695469326646,330.54033247922916,334.1627942856181,335.91466762672184,332.4109209445143,49766,89714.33333333333,43.63361862469102,48.35035244233681,NaN,NaN,NaN,NaN,1.2074475454387883,14.398612821710675,90062199,-0.17740661573906358,-0.343664398227304,-0.1662577824882404
2025-08-15T10:35:00-04:00,332.85,333.34,332.6,332.97,NaN,NaN,NaN,335.8674853958877,NaN,NaN,333.7733999999995,335.58323362843134,331.9635663715677,330.54033247922916,334.1191772062606,335.85323521941297,332.3851191931082,60910,90138.16666666667,44.27751230929042,46.797162366898284,NaN,NaN,NaN,NaN,1.1740584350503,14.04654032003381,90123109,-0.14366397157772673,-0.3458377469603988,-0.2021737753826721
2025-08-15T10:40:00-04:00,332.99,333.13,332.3,332.39,NaN,NaN,NaN,335.8674853958877,NaN,NaN,333.7773999999995,335.57405382382257,331.9807461761764,330.54033247922916,334.067775766658,335.7940061427665,332.34154539054947,58599,90729.93333333333,40.181726466087255,44.388031742373975,NaN,NaN,NaN,NaN,1.1494828325467061,14.005514511196631,90064510,-0.15015469843310988,-0.38986714842405945,-0.23971244999094957
2025-08-15T10:45:00-04:00,332.44,332.67,331.98,332.47,NaN,NaN,NaN,335.54702262600586,NaN,NaN,333.77799999999945,335.5728860695842,331.98311393041473,330.54033247922916,333.9904035078494,335.7134588448878,332.26734817081103,82503,91871.96666666666,40.99251538902082,43.50803798598748,NaN,NaN,NaN,NaN,1.1166626302219413,14.266144297571984,90147013,-0.13906077711414805,-0.4135384213836346,-0.27447764426948656
2025-08-15T10:50:00-04:00,332.49,332.74,331.88,332.29,NaN,NaN,NaN,335.5028397793692,NaN,NaN,333.7723999999995,335.5839962471585,331.9608037528405,330.54033247922916,333.92241619504154,335.6426929652998,332.2021394247833,75870,92437.36666666667,39.68901415881108,42.55166984140982,NaN,NaN,NaN,NaN,1.0983295852060893,14.60229983193287,90071143,-0.1338023456306091,-0.4417305763077479,-0.3079282306771388
2025-08-15T10:55:00-04:00,332.24,332.73,331.98,332.22,NaN,NaN,NaN,335.5028397793692,NaN,NaN,333.75379999999956,335.6091442382598,331.89845576173934,330.48386123743506,333.86168164427386,335.5769435897529,332.14641969879483,73690,93551.06666666667,39.1674089284943,42.57376435409725,NaN,NaN,NaN,NaN,1.0734489005485115,14.91444425669655,89997453,-0.12515223616009863,-0.4643685258772621,-0.33921628971716344
2025-08-15T11:00:00-04:00,332.18,332.59,331.9,332.32,NaN,NaN,NaN,335.34589327004505,NaN,NaN,333.7317999999995,335.6280898097651,331.83551019023395,330.48386123743506,333.81257295109043,335.523450780944,332.10169512123684,62282,93956.13333333333,40.37300328079316,42.69228943594941,NaN,NaN,NaN,NaN,1.0460596933664748,15.288983060846489,90059735,-0.10369549155621566,-0.468835654162433,-0.36514016260621734
2025-08-15T11:05:00-04:00,332.33,332.68,332.2,332.35,NaN,NaN,NaN,335.34589327004505,NaN,NaN,333.69959999999946,335.63359880112006,331.76560119887887,330.6778211602262,333.77866229475853,335.48240677698334,332.0749178125337,50015,93663.66666666667,40.75235488182756,42.498463156225775,NaN,NaN,NaN,NaN,1.0056268581260135,15.487263012301591,90109750,-0.07956748763077093,-0.46459952214468103,-0.3850320345139101
2025-08-15T11:10:00-04:00,332.345,333.64,332.31,333.31,NaN,NaN,NaN,335.34589327004505,NaN,NaN,333.7025999999995,335.63370459650815,331.77149540349086,331.3732569281809,333.7474121363181,335.41843194851214,332.076392324124,97838,95824.36666666667,51.406363590204066,42.71829266999396,NaN,NaN,NaN,NaN,1.0287963682598684,14.496801438411477,90207588,0.004501757800731365,-0.3794048372629959,-0.38390659506372726
2025-08-15T11:15:00-04:00,333.33,333.76,333.06,333.42,NaN,NaN,NaN,335.34589327004505,NaN,NaN,333.6979999999995,335.6306789703857,331.76532102961335,331.59660554254475,333.73432631976834,335.3735741393006,332.09507850023607,88321,97081.56666666667,52.46122659502787,43.049128033683395,NaN,NaN,NaN,NaN,1.0053109133841627,13.731349489077804,90295909,0.06747868872832291,-0.2995582341533236,-0.3670369228816465
2025-08-15T11:20:00-04:00,333.38,333.79,332.97,332.97,NaN,NaN,NaN,335.34589327004505,NaN,NaN,333.68119999999954,335.62426825472716,331.7381317452719,331.64928443403585,333.7239309461349,335.34727226365663,332.10058962861314,48772,97047.06666666667,47.88198728225815,43.38716404645141,NaN,NaN,NaN,NaN,0.9920744195710077,12.891425372431325,90247137,0.07804232144826045,-0.26948402107132097,-0.3475263425195814
2025-08-15T11:25:00-04:00,333,333.43,332.75,332.94,NaN,NaN,NaN,335.34589327004505,NaN,NaN,333.6515999999995,335.5938393679809,331.70936063201816,331.64928443403585,333.71338349984495,335.3263619283767,332.1004050713132,36082,96861.86666666667,47.58378749345239,43.77706952978661,NaN,NaN,NaN,NaN,0.9697833896016504,12.149128252693243,90211055,0.08182609574968935,-0.24524372283246976,-0.3270698185821591
2025-08-15T11:30:00-04:00,332.89,333.47,332.81,333.41,NaN,NaN,NaN,335.34589327004505,NaN,NaN,333.6345999999996,335.5701090705949,331.69909092940424,331.64928443403585,333.7061037976398,335.3079727056799,332.1042348895997,35774,96303.33333333333,52.56770234418076,44.602036117770126,NaN,NaN,NaN,NaN,0.9476560046301057,11.397523464165552,90246829,0.11288436812568453,-0.18596435842505343,-0.29884872655073796
2025-08-15T11:35:00-04:00,333.41,333.56,332.5,332.5,NaN,NaN,NaN,335.34589327004505,NaN,NaN,333.5943999999996,335.5389849331769,331.6498150668223,331.64928443403585,333.6861264994594,335.2743674510301,332.0978855478887,56983,95869.16666666667,43.87006203121232,44.63130595538223,NaN,NaN,NaN,NaN,0.9556805757279554,11.16575017408833,90189846,0.07108397916319453,-0.2099937525967448,-0.28107773175993933
2025-08-15T11:40:00-04:00,332.5,332.56,331.2,331.47,NaN,NaN,NaN,334.8562861935145,NaN,NaN,333.5539999999996,335.5874837108797,331.5205162891194,331.64928443403585,333.6027409176546,335.20564136249584,331.9998404728134,109083,96724.8,36.50727298370419,44.12228126674032,NaN,NaN,NaN,NaN,0.9845605346045311,12.462936267947661,90080763,-0.02201169618359433,-0.30859235198943225,-0.2865806558058379
2025-08-15T11:45:00-04:00,331.46,331.95,330.76,331.81,NaN,NaN,NaN,334.3582731847184,NaN,NaN,333.5187999999996,335.6100680943184,331.4275319056808,331.64928443403585,333.52057489766696,335.14355013148503,331.8975996638489,103692,97984.03333333334,40.082115825227696,43.82261008930727,NaN,NaN,NaN,NaN,0.9992347821327787,14.058768592834634,90184455,-0.05489766560790271,-0.3552027378157163,-0.3003050722078136
2025-08-15T11:50:00-04:00,331.77,331.98,331.41,331.64,NaN,NaN,NaN,334.3582731847184,NaN,NaN,333.48499999999956,335.64100834933674,331.3289916506624,331.64928443403585,333.47746331902533,335.1053755725203,331.84955106553036,63327,97073.4,38.902698801913104,43.73125097043768,NaN,NaN,NaN,NaN,0.9685751548375797,15.486118967417712,90121128,-0.08074330661954093,-0.40123420548223976,-0.3204908988626988
2025-08-15T11:55:00-04:00,331.64,331.97,329.42,329.65,NaN,NaN,NaN,333.85337494723314,NaN,NaN,333.4147999999996,335.8224519354411,331.0071480645581,331.64928443403585,333.25029789844154,335.0159185175194,331.48467727936367,211902,97347.86666666667,28.37662637950133,42.83011604118629,NaN,NaN,NaN,NaN,1.081534072349182,18.167873345478572,89909226,-0.21678545278592948,-0.5914727148451107,-0.3746872620591812
2025-08-15T12:00:00-04:00,329.62,329.88,327.02,327.72,NaN,NaN,NaN,331.8548124496316,NaN,NaN,333.3015999999996,336.18948742201854,330.4137125779807,331.64928443403585,332.86281879197446,335.0266304791194,330.69900710482955,243035,97180.76666666666,22.12426142042598,41.57549084558735,NaN,NaN,NaN,NaN,1.20856735289567,21.57113765569759,89666191,-0.4104419216940656,-0.8877396641767632,-0.4772977424826976
2025-08-15T12:05:00-04:00,327.7,328.58,327.38,328.48,NaN,NaN,NaN,331.393684611012,NaN,NaN,333.21199999999953,336.39920441806447,330.0247955819346,331.64928443403585,332.6908936043366,334.99147286736786,330.3903143413054,119686,95962.76666666666,28.77902231854364,40.83346323059088,NaN,NaN,NaN,NaN,1.207955399117407,24.731311658043825,89785877,-0.457453143986578,-1.04911417246592,-0.5916610284793421
2025-08-15T12:10:00-04:00,328.445,328.52,327.7,328.51,NaN,NaN,NaN,331.393684611012,NaN,NaN,333.1205999999995,336.5691020751842,329.6720979248148,331.49794203778293,332.54624255924085,334.9426874885964,330.1497976298853,110370,95728.13333333333,29.036806210702423,40.023734868441544,NaN,NaN,NaN,NaN,1.180244299180449,27.66575894593676,89896247,-0.45562982707455835,-1.16119831232254,-0.7055684852479817
2025-08-15T12:15:00-04:00,328.48,328.7,327.6,327.88,NaN,NaN,NaN,331.393684611012,NaN,NaN,333.0079999999996,336.7531878460723,329.26281215392686,331.49794203778293,332.39788636418456,334.88718068961066,329.90859203875846,116059,93694.56666666667,26.83980086845898,39.029981010343796,NaN,NaN,NaN,NaN,1.1745125635247002,30.096167930296396,89780188,-0.46437473393606166,-1.2860369026680587,-0.821662168731997
2025-08-15T12:20:00-04:00,327.84,328.25,327.62,327.75,NaN,NaN,NaN,331.2349956031726,NaN,NaN,332.88379999999955,336.8967727437961,328.87082725620303,331.4523536302263,332.26663872129683,334.834409632345,329.69886781024866,104847,92280.46666666666,26.3959801761213,37.243525052195025,NaN,NaN,NaN,NaN,1.1356188089872215,32.35297627291606,89675341,-0.44631794038952544,-1.3795595942189038,-0.9332416538293784
2025-08-15T12:25:00-04:00,327.7,328.04,327.13,327.91,NaN,NaN,NaN,330.85908671211934,NaN,NaN,332.76079999999956,336.9930397666451,328.528560233354,330.19388290418107,332.12150899048,334.7723334417668,329.47068453919314,118460,93049.86666666667,27.974591810220645,35.49447971042308,NaN,NaN,NaN,NaN,1.1195031797738504,34.64771697486365,89793801,-0.3928845558434706,-1.4243473486337166,-1.031462792790246
2025-08-15T12:30:00-04:00,327.97,328.35,327.97,328.15,NaN,NaN,NaN,330.85908671211934,NaN,NaN,332.64519999999953,337.0553922681962,328.23500773180285,329.7046850586759,332.0507315757637,334.72973207213164,329.3717310793957,67848,90890.53333333334,30.386405559908454,34.24479530168382,NaN,NaN,NaN,NaN,1.0709672383614324,36.22354758879299,89861649,-0.3140779992492335,-1.424060291851788,-1.1099822926025544
2025-08-15T12:35:00-04:00,328.1,328.92,327.95,328.9,NaN,NaN,NaN,330.85908671211934,NaN,NaN,332.5397999999995,337.04995297329776,328.02964702670124,329.7046850586759,331.97702032158975,334.67402587852825,329.28001476465124,82715,90231.26666666666,37.43677494835679,33.52000869131985,NaN,NaN,NaN,NaN,1.0637552927641891,36.729318742604065,89944364,-0.19023634405477718,-1.347777722671026,-1.1575413786162487
2025-08-15T12:40:00-04:00,328.92,329.54,328.72,329.25,NaN,NaN,NaN,330.85908671211934,NaN,NaN,332.4307999999996,336.99001719623163,327.8715828037675,328.87474804694074,331.89582443703443,334.5948541879092,329.19679468615965,115679,90282.96666666666,40.466947953507315,32.655669091986034,NaN,NaN,NaN,NaN,1.0463442004238894,36.266712831614704,90060043,-0.06975302415463247,-1.2447326588095393,-1.1749796346549068
2025-08-15T12:45:00-04:00,329.26,329.94,329.05,329.915,NaN,NaN,NaN,330.85908671211934,NaN,NaN,332.33369999999957,336.89630224460035,327.7710977553988,327.59926557317823,331.8566302908232,334.5483855323911,329.16487504925533,70553,90111.03333333334,45.83487192023898,32.79601265548793,NaN,NaN,NaN,NaN,1.0351767575364677,35.28346036961567,90130596,0.06257096688059671,-1.096765926054161,-1.1593368929347576
2025-08-15T12:50:00-04:00,329.95,330.22,329.63,329.93,NaN,NaN,NaN,330.85908671211934,NaN,NaN,332.2398999999995,336.8034724999755,327.67632750002355,328.0524124585426,331.8180933519015,334.49648077061,329.139705933193,82918,90397.56666666667,45.953250216948945,33.47072531500542,NaN,NaN,NaN,NaN,1.0033784177124365,33.994738733639835,90213514,0.153755725554513,-0.9671422359916164,-1.1208979615461294
2025-08-15T12:55:00-04:00,329.92,330.3,329.4,330.01,NaN,NaN,NaN,330.85908671211934,NaN,NaN,332.1454999999996,336.6943786532961,327.59662134670305,328.1159299668341,331.78561602208754,334.45267666738255,329.11855537679253,71650,88974.3,46.6232700945276,33.93795061995541,NaN,NaN,NaN,NaN,0.9959942450186935,33.01438054185644,90285164,0.2181728624063981,-0.8481818835381318,-1.06635474594453
2025-08-15T13:00:00-04:00,330.09,330.85,329.79,330.5,NaN,NaN,NaN,330.85908671211934,NaN,NaN,332.06889999999953,336.5969986255284,327.5408013744707,328.57274397346725,331.7626501675079,334.41382839769227,329.11147193732353,70165,89654.26666666666,50.65809587270346,34.77762183929758,NaN,NaN,NaN,NaN,1.0005660846602156,31.364217667949557,90355329,0.2881037017971779,-0.7062251186980575,-0.9943288204952354
2025-08-15T13:05:00-04:00,330.49,331.3,330.35,331.14,327.78628569219785,327.78628569219785,327.78628569219785,NaN,NaN,NaN,332.00429999999955,336.49121520339247,327.5173847966066,329.0031951787738,331.74752832798515,334.37687402801134,329.11818262795896,79434,90271.73333333334,55.400231838709985,36.7078793720982,NaN,NaN,NaN,NaN,0.9969542214701993,29.278202328449943,90434763,0.36674053592391387,-0.5359031505903431,-0.902643686514257
2025-08-15T13:10:00-04:00,331.09,331.42,330.5,331.3,327.9339545243707,NaN,NaN,NaN,NaN,NaN,331.9408999999996,336.3759466471397,327.5058533528595,329.12255614301904,331.7361137018488,334.34455656407965,329.12767083961796,75328,90829.36666666667,56.52514988063937,39.16508569068487,NaN,NaN,NaN,NaN,0.9914574913651862,27.19632045309795,90510091,0.4152434916040566,-0.38358932200918616,-0.7988328136132428
2025-08-15T13:15:00-04:00,331.27,331.31,330.32,330.32,327.9339545243707,NaN,NaN,NaN,NaN,NaN,331.8552999999996,336.24675188318906,327.46384811681014,329.12255614301904,331.7217146788467,334.3157854051346,329.1276439525588,59777,90071.83333333333,48.462387459783145,40.57104034363054,NaN,NaN,NaN,NaN,0.9913533848391022,25.48480291591519,90450314,0.36861795031538613,-0.33806037571901015,-0.7066783260343963
2025-08-15T13:20:00-04:00,330.31,330.38,329.78,330.06,327.9339545243707,NaN,NaN,NaN,NaN,NaN,331.7676999999996,336.1240228579061,327.4113771420931,329.12255614301904,331.6968670827317,334.2791351293519,329.11459903611154,69008,89843.1,46.564673895289474,41.823030892529616,NaN,NaN,NaN,NaN,0.9633995716363107,24.526108477440346,90381306,0.3099204610675118,-0.31927774970000655,-0.6291982107675184
2025-08-15T13:25:00-04:00,330.1,331.1,329.86,330.88,327.9339545243707,NaN,NaN,NaN,NaN,NaN,331.7038999999996,336.0167020082518,327.39109799174736,329.12255614301904,331.68333559648653,334.2522485377915,329.11442265518156,57894,89316.56666666667,52.83730386174239,43.67999539204986,NaN,NaN,NaN,NaN,0.9831567450908606,22.839724370448838,90439200,0.3149502335925196,-0.23551041877686885,-0.5504606523693885
2025-08-15T13:30:00-04:00,330.87,331.69,330.79,331.33,328.25165903906037,NaN,NaN,NaN,NaN,NaN,331.64009999999956,335.8781101418524,327.4020898581467,329.3575269961806,331.6758818912363,334.2221209235866,329.12964285888603,85134,90078.3,55.89696299489921,45.787208450534,NaN,NaN,NaN,NaN,0.977216977584369,21.93011747498807,90524334,0.3353289793047171,-0.13129942823849206,-0.46662840754320917
2025-08-15T13:35:00-04:00,331.3,331.59,330.91,331.36,328.30476544637577,NaN,NaN,NaN,NaN,NaN,331.55569999999955,335.64185810296493,327.46954189703416,329.3840215969445,331.67191685475063,334.2054545677555,329.13837914174576,48589,90030.76666666666,56.10142764909285,47.796268153310585,NaN,NaN,NaN,NaN,0.9559871934711962,21.08548250063164,90572923,0.33669217514978783,-0.04576318860597439,-0.3824553637557622
2025-08-15T13:40:00-04:00,331.35,331.66,331.01,331.1,328.4350033806315,NaN,NaN,NaN,NaN,NaN,331.43969999999956,335.2310788576726,327.6483211423265,329.5702172775556,331.6691813933269,334.19458389905066,329.1437788876031,31628,87823.76666666666,53.77460259299938,49.46685365567422,NaN,NaN,NaN,NaN,0.9341309653661132,20.382080601451694,90541295,0.3067908196716492,0.0010331608337992293,-0.30575765883784994
2025-08-15T13:45:00-04:00,331.13,331.41,330.81,331.05,328.4350033806315,NaN,NaN,NaN,NaN,NaN,331.36349999999965,335.02786911379764,327.69913088620166,329.5702172775556,331.66500729621947,334.181770071737,329.14824452070195,34853,86041.5,53.31663589616842,50.60112943766077,NaN,NaN,NaN,NaN,0.9102644678399638,19.43238688497689,90506442,0.2715633986492563,0.03369658947372045,-0.23786680917553588
2025-08-15T13:50:00-04:00,331.06,331.43,330.46,331.39,328.4350033806315,NaN,NaN,NaN,NaN,NaN,331.2946999999996,334.82278639949874,327.7666136005004,329.5702172775556,331.6588902200519,334.1628426521312,329.1549377879726,52307,86159.33333333333,56.05718838940696,51.71471804022502,NaN,NaN,NaN,NaN,0.9145312915656827,18.047884882846137,90558749,0.25911432351902597,0.08602609522324656,-0.17308822829577938
2025-08-15T13:55:00-04:00,331.37,331.68,331.19,331.38,328.64512690721523,NaN,NaN,NaN,NaN,NaN,331.27209999999957,334.7831933286314,327.76100667136774,329.7850312461084,331.6567213967736,334.1495430971113,329.1638996964359,44165,86428.76666666666,55.95314697101824,52.437451972423545,NaN,NaN,NaN,NaN,0.8842076278824204,17.105795809025945,90514584,0.23866811910059826,0.12524692057996845,-0.11342119852062982
2025-08-15T14:00:00-04:00,331.37,331.41,330.71,330.9,328.64512690721523,NaN,NaN,NaN,NaN,NaN,331.2404999999996,334.7359451794177,327.7450548205815,329.7850312461084,331.65064927183835,334.13258888646516,329.16870965721154,46509,86786.6,51.05492444316017,52.80185727429578,NaN,NaN,NaN,NaN,0.8710499401765365,16.21465080408628,90468075,0.18374301788055894,0.11625757383006885,-0.06748544405049009
2025-08-15T14:05:00-04:00,330.94,331.35,330.87,331.21,328.64512690721523,NaN,NaN,NaN,NaN,NaN,331.2024999999996,334.6568932900432,327.748106709956,329.7850312461084,331.6482895189525,334.1246906980842,329.1718883398208,23268,85662.76666666666,53.863973486446596,53.319050373718554,NaN,NaN,NaN,NaN,0.8431178015924995,15.387159013785165,90491343,0.16008364358868896,0.1326191104353711,-0.027464533153317844
2025-08-15T14:10:00-04:00,331.21,331.33,330.08,330.28,328.64512690721523,NaN,NaN,NaN,NaN,NaN,331.13169999999957,334.5129362298952,327.7504637701039,329.7850312461084,331.63739434780524,334.1037036249346,329.1710850706759,50743,83718.1,45.43873032338778,52.94623854876744,NaN,NaN,NaN,NaN,0.8721808157644638,15.622082102423299,90440600,0.07776251857399978,0.06973861506418189,-0.008023903509817895
2025-08-15T14:15:00-04:00,330.28,330.39,329.82,329.92,328.64512690721523,NaN,NaN,NaN,NaN,NaN,331.05529999999953,334.36930205831135,327.7412979416877,329.7850312461084,331.6263571674091,334.08766524603914,329.165049088779,35231,81436.06666666667,42.65721901068919,52.03602334676595,NaN,NaN,NaN,NaN,0.8505964717812874,16.12841038868231,90405369,-0.0008124140577747789,-0.00903942108203637,-0.00822700702426159
2025-08-15T14:20:00-04:00,329.95,330.09,329.52,329.64,328.64512690721523,NaN,NaN,NaN,NaN,NaN,330.98889999999955,334.28055447191076,327.69724552808833,329.7850312461084,331.60539581314663,334.0608495177519,329.1499421085414,57485,81241.33333333333,40.576700489595915,50.896848390262846,NaN,NaN,NaN,NaN,0.8305538666540521,16.919144320606456,90347884,-0.06781301331090948,-0.09299327366289845,-0.02518026035198896
2025-08-15T14:25:00-04:00,329.61,329.91,329.33,329.83,328.64512690721523,NaN,NaN,NaN,NaN,NaN,330.9298999999995,334.1966822030926,327.6631177969064,329.7850312461084,331.5870811346152,334.0378660433363,329.13629622589406,49678,75833.86666666667,42.621762605281035,50.47966090065555,NaN,NaN,NaN,NaN,0.8126571618930513,17.851501544952672,90397562,-0.0938979009395088,-0.14255263652637495,-0.04865473558686616
2025-08-15T14:30:00-04:00,329.81,330.11,329.37,329.83,328.64512690721523,NaN,NaN,NaN,NaN,NaN,330.8746999999995,334.12061830497555,327.62878169502346,329.7850312461084,331.5727994857358,334.0192020989029,329.1263968725687,41158,69104.63333333333,42.621762605281035,50.19802437994066,NaN,NaN,NaN,NaN,0.8074673646149769,18.332931867907394,90397562,-0.1048815440937225,-0.17975666570401927,-0.07487512161029677
2025-08-15T14:35:00-04:00,329.83,329.84,328.79,329.08,328.64512690721523,NaN,NaN,NaN,NaN,NaN,330.79869999999954,334.0311695269321,327.566230473067,329.7850312461084,331.541238104379,333.9859803844221,329.0964958243359,71716,67505.63333333333,36.82057008316134,49.05397196718487,NaN,NaN,NaN,NaN,0.8247911242853325,19.396642194294557,90325846,-0.1534484406562745,-0.2666856724306399,-0.1132372317743654
2025-08-15T14:40:00-04:00,329.14,329.6,328.82,329.18,328.64512690721523,NaN,NaN,NaN,NaN,NaN,330.7242999999996,333.93102668658537,327.5175733134138,329.7850312461084,331.51695867182735,333.96052945677377,329.07338788688094,55626,65680.83333333333,38.03166756767938,47.777879436669174,NaN,NaN,NaN,NaN,0.8215917582649538,20.384373211654058,90381472,-0.16843108109504595,-0.32377608314317285,-0.1553450020481269
2025-08-15T14:45:00-04:00,329.18,329.48,329.04,329.18,328.64512690721523,NaN,NaN,NaN,NaN,NaN,330.64849999999956,333.8182711277888,327.4787288722103,329.6172199975094,331.50632458794024,333.9491516840147,329.0634974918658,25095,62648.7,38.03166756767938,46.48718228799678,NaN,NaN,NaN,NaN,0.7943352041031712,21.301552013487886,90381472,-0.16757622353898874,-0.3648152814718628,-0.19723905793287408
2025-08-15T14:50:00-04:00,329.13,329.61,329.02,329.52,328.64512690721523,NaN,NaN,NaN,NaN,NaN,330.5910999999996,333.7364974569866,327.44570254301254,329.6172199975094,331.4931015576817,333.9340304447227,329.05217267064074,33776,60279.666666666664,42.38654189320039,45.67374938086828,NaN,NaN,NaN,NaN,0.7797398323815183,21.857699214677243,90415248,-0.13475959630011555,-0.3656885533080185,-0.23092895700790297
2025-08-15T14:55:00-04:00,329.54,329.64,328.6,328.75,NaN,NaN,NaN,331.6610372132895,331.6610372132895,331.6610372132895,330.51669999999956,333.6567851011478,327.3766148988513,329.3187759980075,331.4685875798387,333.9099445772997,329.0272305823777,53778,58123.6,36.184619606573456,44.45003393161149,NaN,NaN,NaN,NaN,0.7983298443542645,22.868038432139315,90361470,-0.15416071531181053,-0.42362985114766616,-0.26946913583585563
2025-08-15T15:00:00-04:00,328.75,329.02,327.99,328.41,NaN,NaN,NaN,331.07099006723087,NaN,NaN,330.43909999999954,333.5918027710398,327.2863972289593,328.496020798406,331.4200522241417,333.8709018849406,328.96920256334283,90205,58868.833333333336,33.830747802193756,42.862431032524846,NaN,NaN,NaN,NaN,0.8148777126146722,24.411150234517116,90271265,-0.177480908434819,-0.4913202713793794,-0.3138393629445604
2025-08-15T15:05:00-04:00,328.45,328.79,328.13,328.58,NaN,NaN,NaN,330.99935415508406,NaN,NaN,330.3662999999995,333.5192521472195,327.2133478527795,328.35588264878385,331.382941922067,333.84003645255706,328.92584739157695,71658,58500.26666666667,36.07007561337964,41.44221164983637,NaN,NaN,NaN,NaN,0.8038150188564831,25.844039765296507,90342923,-0.16908349478932438,-0.5251937314312158,-0.35611023664189145
2025-08-15T15:10:00-04:00,328.6,328.81,328.27,328.81,NaN,NaN,NaN,330.99935415508406,NaN,NaN,330.2960999999995,333.4281608491304,327.16403915086863,328.35588264878385,331.36086432796935,333.820373910126,328.9013547458127,45584,56163.76666666667,39.07425521009484,40.58644956176027,NaN,NaN,NaN,NaN,0.7849710889381643,27.12291214401364,90388507,-0.13703187067712125,-0.527400074988293,-0.39036820431117175
2025-08-15T15:15:00-04:00,328.77,328.83,328.18,328.7,NaN,NaN,NaN,330.97767599667776,NaN,NaN,330.22309999999953,333.33031926528525,327.1158807347138,328.35588264878385,331.33622209138076,333.79872921495354,328.873714967808,50635,55499.833333333336,38.15088501724691,39.46408609967458,NaN,NaN,NaN,NaN,0.775330296871151,28.405619539986404,90337872,-0.11322012714737278,-0.5318933632453877,-0.41867323609801493
2025-08-15T15:20:00-04:00,328.72,329.29,328.47,329.05,NaN,NaN,NaN,330.97767599667776,NaN,NaN,330.1378999999995,333.1334888173612,327.1423111826378,327.9117061190271,331.3176028470484,333.77955729041247,328.85564840368437,44846,54230.76666666667,42.78389735551848,39.2744551733982,NaN,NaN,NaN,NaN,0.7785209899517825,28.40132929227421,90382718,-0.06620705514860747,-0.5014320550337743,-0.43522499988516683
2025-08-15T15:25:00-04:00,329.05,329.38,328.9,329.07,NaN,NaN,NaN,330.97767599667776,NaN,NaN,330.0508999999995,332.9096995317363,327.1921004682627,327.9021135329419,331.29680123488174,333.7563304283719,328.8372720413916,55145,53680.6,43.046438569185895,39.30225657043367,NaN,NaN,NaN,NaN,0.757198062098085,28.179817361926357,90437863,-0.028025272658315448,-0.47025659070806114,-0.4422313180497457
2025-08-15T15:30:00-04:00,329.075,329.37,328.79,329.3,NaN,NaN,NaN,330.97767599667776,NaN,NaN,329.9774999999995,332.7187772575454,327.2362227424536,327.9021135329419,331.2736271455159,333.72984740001414,328.81740689101764,63771,53467.46666666667,46.108954453048256,39.69741756782313,NaN,NaN,NaN,NaN,0.7445410576625064,28.1357245265634,90501634,0.016085261195049938,-0.42212474155593327,-0.4382100027509832
2025-08-15T15:35:00-04:00,329.33,329.8,329.2,329.45,NaN,NaN,NaN,330.97767599667776,NaN,NaN,329.9076999999995,332.51830545519095,327.2970945448081,328.1719053875095,331.2571125164233,333.70796123776137,328.8062637950853,54917,52650.23333333333,48.07015756846424,40.086588636621926,NaN,NaN,NaN,NaN,0.7342166964009005,27.064439923829248,90556551,0.05645739980065373,-0.36763825300016606,-0.4240956528008198
2025-08-15T15:40:00-04:00,329.45,330.07,329.44,329.72,NaN,NaN,NaN,330.97767599667776,NaN,NaN,329.83389999999946,332.2453321808391,327.4224678191598,328.4525243100076,331.2434170531834,333.68736065851454,328.7994734478523,54353,51951.066666666666,51.49212155089432,40.720185704165736,NaN,NaN,NaN,NaN,0.7267726466579786,25.495631430856708,90610904,0.09989945229595265,-0.299221337430879,-0.3991207897268316
2025-08-15T15:45:00-04:00,329.75,329.92,329.32,329.52,NaN,NaN,NaN,330.97767599667776,NaN,NaN,329.77429999999947,332.0634116274183,327.48518837258064,328.4525243100076,331.2261587249739,333.66315197446625,328.7891654754816,63241,52066.53333333333,48.920538396513514,41.584469155119464,NaN,NaN,NaN,NaN,0.7177174576109817,24.26176572458101,90547663,0.11276637011317964,-0.2581628270853571,-0.37092919719853673
2025-08-15T15:50:00-04:00,329.52,329.69,328.59,328.93,NaN,NaN,NaN,330.97767599667776,NaN,NaN,329.7234999999995,331.9722118540909,327.47478814590806,328.4525243100076,331.1906055769299,333.6229711960156,328.7582399578442,101783,53159.03333333333,42.22166405064564,41.88375461818848,NaN,NaN,NaN,NaN,0.7450233534959132,24.27791723490231,90445880,0.0806489745027888,-0.27011797907005075,-0.35076695357283955
2025-08-15T15:55:00-04:00,328.91,330.66,328.83,330.63,NaN,NaN,NaN,330.97767599667776,NaN,NaN,329.69989999999945,331.88437658786034,327.51542341213855,328.4525243100076,331.1347658988,333.5202232568892,328.74930854071084,314847,61724.13333333333,59.45110595899455,43.41371450328243,NaN,NaN,NaN,NaN,0.8225216853890652,22.593585201867565,90760727,0.16797856449222415,-0.1407937479575594,-0.30877231244978354
2025-08-18T09:30:00-04:00,329.66,333.63,329.59,332.84,328.6659231162111,328.6659231162111,328.6659231162111,NaN,NaN,NaN,329.7238999999995,332.01678751637803,327.431012483621,329.7098819573791,332.02,332.02,332.02,277457,68134.9,71.39364636210087,45.48565053677532,NaN,NaN,NaN,NaN,1.0523415650041335,23.867874046609685,91038184,0.35776140099042725,0.13842943878825054,-0.2193319622021767
2025-08-18T09:35:00-04:00,332.8,332.8,330.82,332.52,328.7242902472924,NaN,NaN,NaN,NaN,NaN,329.7812999999995,332.20393724952976,327.3586627504692,329.7098819573791,332.0306883889744,332.04375675011585,332.01762002783295,185600,72701.93333333333,68.25878287241268,47.77666219862097,NaN,NaN,NaN,NaN,1.1214600246466941,25.051142259584513,90852584,0.4395371176012991,0.3300894347994472,-0.10944768280185191
2025-08-18T09:40:00-04:00,332.53,332.53,330.61,331.58,328.7242902472924,NaN,NaN,NaN,NaN,NaN,329.8584999999995,332.2593833796727,327.45761662032623,329.7098819573791,331.9395528664058,332.1226166788506,331.756489053961,115234,75488.8,59.933630098740686,49.64115379123147,NaN,NaN,NaN,NaN,1.1784985943147845,25.831192775750385,90737350,0.408760500152603,0.40150294238890183,-0.007257557763701156
2025-08-18T09:45:00-04:00,331.53,333.36,331,332.675,328.7966983451569,NaN,NaN,NaN,NaN,NaN,329.94239999999945,332.43612752377413,327.4486724762248,329.7098819573791,332.0139010058189,332.2419003149005,331.78590169673737,129855,78655.53333333334,65.25046970887972,51.72546765519575,NaN,NaN,NaN,NaN,1.2628915518637294,27.10032734116639,90867205,0.4379889193643124,0.5402285914416893,0.10223967207737696
2025-08-18T09:50:00-04:00,332.65,332.7,331.2,331.64,328.7966983451569,NaN,NaN,NaN,NaN,NaN,330.0049999999995,332.50887859185025,327.5011214081487,329.7098819573791,331.9948766880589,332.21598683361333,331.7737665425045,90898,79941.9,57.485452359362974,53.040553165857766,NaN,NaN,NaN,NaN,1.2798278695877487,28.278809437624115,90776307,0.36636524175640717,0.560196224272886,0.19383098251647876
2025-08-18T09:55:00-04:00,331.64,332.39,331.3,332.24,328.7966983451569,NaN,NaN,NaN,NaN,NaN,330.0921999999995,332.59766615278147,327.5867338472175,329.7098819573791,331.99331633155134,332.20480268925076,331.7818299738519,74884,80965.86666666667,60.42559730254712,54.631604043379205,NaN,NaN,NaN,NaN,1.266268736045765,29.37311424147771,90851191,0.338790915072339,0.6173196263569025,0.2785287112845635
2025-08-18T10:00:00-04:00,332.25,332.65,330.65,332.08,328.7966983451569,NaN,NaN,NaN,NaN,NaN,330.1787999999995,332.6535925655879,327.7040074344111,329.7098819573791,331.9683375305991,332.1769312277349,331.75974383346335,124738,83573.5,59.2488996604788,55.80767563659066,NaN,NaN,NaN,NaN,1.3186781120424962,29.318860193339464,90726453,0.2909977624115767,0.6422759142990344,0.3512781518874577
2025-08-18T10:05:00-04:00,332.08,333.32,331.87,333.11,329.0147684194406,NaN,NaN,NaN,NaN,NaN,330.28279999999955,332.8040878936295,327.7615121063696,329.7098819573791,332.0574036065834,332.37650898103465,331.7382982321322,125408,86978.16666666667,64.09606570347614,57.311220431897105,NaN,NaN,NaN,NaN,1.328058246896603,29.79784159091386,90851861,0.3083170145489122,0.736674420073598,0.42835740552468576
2025-08-18T10:10:00-04:00,333.105,334.14,331.59,331.87,329.0997789458296,NaN,NaN,NaN,NaN,NaN,330.3571999999995,332.8416276287854,327.87277237121367,329.7098819573791,332.11742771267296,332.4549926068558,331.77986281849013,162228,90694.33333333333,55.53232416889653,57.984318268743415,NaN,NaN,NaN,NaN,1.4153398006897036,30.792626905248515,90689633,0.2199707430527441,0.7033208343406159,0.48335009128787176
2025-08-18T10:15:00-04:00,332,333.1,331.64,332.91,329.0997789458296,NaN,NaN,NaN,NaN,NaN,330.43739999999957,332.9865412205924,327.8882587794067,329.7098819573791,332.1407170022322,332.48327649039686,331.7981575140675,73194,91959.76666666666,60.320742185392035,58.859360027095406,NaN,NaN,NaN,NaN,1.418529814926156,31.716356125702124,90762827,0.21502954164690447,0.7521370183465024,0.5371074766995979
2025-08-18T10:20:00-04:00,332.94,333.83,332.67,333.83,329.4710692460968,NaN,NaN,NaN,NaN,NaN,330.5289999999995,333.2257654704846,327.8322345295144,329.7290018153821,332.22026904418885,332.67576632118266,331.76477176719504,88426,92991.13333333333,64.01254064279917,59.753675676517176,NaN,NaN,NaN,NaN,1.4000633995742855,33.01841580403778,90851253,0.25447583281206065,0.8552022677146738,0.6007264349026131
2025-08-18T10:25:00-04:00,333.8,334.26,333.45,333.71,330.13738428036515,NaN,NaN,NaN,NaN,NaN,330.60489999999953,333.4384211244365,327.77137887556256,330.57420145230566,332.32025414941563,332.9059334828845,331.73457481594676,97396,94581.73333333334,63.18673384625342,60.772689637212885,NaN,NaN,NaN,NaN,1.357916013890408,34.46174024716374,90753857,0.2527251323588404,0.9166328503511636,0.6639077179923232
2025-08-18T10:30:00-04:00,333.67,333.67,332.9,333.13,330.13738428036515,NaN,NaN,NaN,NaN,NaN,330.6688999999995,333.58199271439787,327.7558072856011,330.57420145230566,332.36095290663087,332.9636432153375,331.7582625979242,72093,95612.9,59.210743393535516,61.98619530456216,NaN,NaN,NaN,NaN,1.3187791557553792,34.895926649297486,90681764,0.19531259323436545,0.90804845953528,0.7127358663009146
2025-08-18T10:35:00-04:00,333.14,333.46,332.5,332.69,330.13738428036515,NaN,NaN,NaN,NaN,NaN,330.7224999999995,333.68335680212334,327.7616431978757,330.57420145230566,332.37449825962614,332.9750890019682,331.7739075172841,43056,94657.56666666667,56.315679704138326,61.762236286358146,NaN,NaN,NaN,NaN,1.2931520732014221,34.6878495742495,90638708,0.11451126817720714,0.8558749515224235,0.7413636833452164
2025-08-18T10:40:00-04:00,332.67,333.2,332.45,332.53,330.13738428036515,NaN,NaN,NaN,NaN,NaN,330.76309999999955,333.7660125132976,327.7601874867015,330.57420145230566,332.3860403963267,332.98002586473103,331.7920549279223,56265,94678.86666666667,55.25764008254328,60.60966440924689,NaN,NaN,NaN,NaN,1.2543554965441779,34.41798996485484,90582443,0.04089399571641672,0.7924811779907373,0.7515871822743205
2025-08-18T10:45:00-04:00,332.54,332.66,331.8,332.34,330.13738428036515,NaN,NaN,NaN,NaN,NaN,330.78709999999955,333.82070253865334,327.7534974613458,330.57420145230566,332.3830835428105,332.9699598023761,331.7962072832449,43603,95295.8,53.961141544056225,59.58840431436429,NaN,NaN,NaN,NaN,1.2261872467910233,33.21185892757888,90538840,-0.02636904828879083,0.718625871913332,0.7449949202021229
2025-08-18T10:50:00-04:00,332.39,332.88,332.11,332.75,330.13738428036515,NaN,NaN,NaN,NaN,NaN,330.8160999999995,333.89612811069316,327.73607188930583,330.57420145230566,332.3862736958801,332.9689072940686,331.80364009769164,28988,95136.2,56.341609597230146,59.33183142139925,NaN,NaN,NaN,NaN,1.1936024434488062,32.30341205957612,90567828,-0.047772646400726315,0.685279112201215,0.7330517586019413
2025-08-18T10:55:00-04:00,332.85,333.45,332.5,333.32,330.13738428036515,NaN,NaN,NaN,NaN,NaN,330.8760999999995,334.0311031953377,327.7210968046613,330.9042716255132,332.40300846104464,332.988573208495,331.8174437135943,43587,94796.5,59.47849772759292,58.91954770845019,NaN,NaN,NaN,NaN,1.1762022689167477,31.97705563070064,90611415,-0.028990710555657495,0.6968133704073693,0.7258040809630268
2025-08-18T11:00:00-04:00,333.28,333.97,333.28,333.56,330.2530211224662,NaN,NaN,NaN,NaN,NaN,330.9460999999995,334.17989485475357,327.7123051452454,331.5884173004106,332.4399116231256,333.05251117994845,331.8273120663028,58139,93727.63333333333,60.75703728079248,59.15323234569515,NaN,NaN,NaN,NaN,1.1414735354226981,32.09793165679851,90669554,-0.006999594028408884,0.7170545884275157,0.7240541824559246
2025-08-18T11:05:00-04:00,333.47,333.73,332.84,333.6,330.2530211224662,NaN,NaN,NaN,NaN,NaN,331.00049999999953,334.3184356537762,327.6825643462229,331.5884173004106,332.4578855380558,333.07831473892844,331.83745633718314,36465,92554.53333333334,60.978026603922146,59.19269158150767,NaN,NaN,NaN,NaN,1.1235111400353657,31.54539524081509,90706019,0.0031025848384091947,0.727932413503936,0.7248298286655268
2025-08-18T11:10:00-04:00,333.61,333.94,333.1,333.86,330.2530211224662,NaN,NaN,NaN,NaN,NaN,331.0510999999995,334.46341727168,327.63878272831903,331.6397870722628,332.47979218757456,333.11463759068226,331.84494678446686,36605,92255.23333333334,62.45790505918527,59.42190625284384,NaN,NaN,NaN,NaN,1.103260344318552,31.218991046853752,90742624,0.01925624961886019,0.748900140689102,0.7296438910702419
2025-08-18T11:15:00-04:00,333.83,333.91,332.99,333.14,330.2530211224662,NaN,NaN,NaN,NaN,NaN,331.0866999999995,334.5479550386632,327.6254449613358,331.6397870722628,332.4999075341319,333.1407737290432,331.85904133922065,46659,92122.7,56.11170030784981,58.85159443887053,NaN,NaN,NaN,NaN,1.0901703197243708,30.74251229615524,90695965,-0.02422913269657767,0.6993574751995197,0.7235866078960974
2025-08-18T11:20:00-04:00,333.08,333.63,333.05,333.07,330.2530211224662,NaN,NaN,NaN,NaN,NaN,331.1260999999995,334.63163008297255,327.62056991702644,331.6397870722628,332.50806565421544,333.1501679282465,331.8659633801844,22110,91364.83333333333,55.521044442487494,58.85078874412703,NaN,NaN,NaN,NaN,1.0537295826012003,30.300067741935194,90673855,-0.061278834158203455,0.6469880651983431,0.7082668993565465
2025-08-18T11:25:00-04:00,333.06,333.48,332.77,332.99,330.2530211224662,NaN,NaN,NaN,NaN,NaN,331.16489999999953,334.70893526541,327.6208647345891,331.6397870722628,332.5198277158484,333.16045638419257,331.87919904750424,42685,90949.5,54.810935572462995,58.45723112891782,NaN,NaN,NaN,NaN,1.02917746955826,29.413967718554684,90631170,-0.09285107874789122,0.5922030509216825,0.6850541296695737
2025-08-18T11:30:00-04:00,333.05,333.1,332.72,332.88,330.2530211224662,NaN,NaN,NaN,NaN,NaN,331.1946999999995,334.7707181267055,327.6186818732935,331.6397870722628,332.5261382017906,333.1632818429855,331.88899456059573,35034,89991.6,53.79217116096138,57.72720473735797,NaN,NaN,NaN,NaN,0.9828076503040982,28.5055269664179,90596136,-0.1210379937784466,0.5337566374465155,0.6547946312249621
2025-08-18T11:35:00-04:00,332.89,333.42,332.7,333.21,330.2530211224662,NaN,NaN,NaN,NaN,NaN,331.2312999999995,334.85134354151364,327.6112564584854,331.6397870722628,332.537755225636,333.173776156954,331.901734294318,42847,89589.26666666666,56.40976180938227,57.243135306152894,NaN,NaN,NaN,NaN,0.9640356752823788,28.051703297074297,90638983,-0.11726980301238199,0.5082073774594846,0.6254771804718666
2025-08-18T11:40:00-04:00,333.21,333.45,333.04,333.31,330.3004738221282,NaN,NaN,NaN,NaN,NaN,331.27949999999953,334.94451309717584,327.6144869028232,331.7811361822712,332.54403805107347,333.1808865468916,331.90718955525534,18723,88401.6,57.20097011245844,57.09958007179024,NaN,NaN,NaN,NaN,0.9244616984764923,27.666824474471678,90657706,-0.10808108686864393,0.49037582188606166,0.5984569087547056
2025-08-18T11:45:00-04:00,333.28,333.42,332.97,333.2,330.3229522847588,NaN,NaN,NaN,NaN,NaN,331.3192999999995,335.02344147172704,327.61515852827193,331.85990894581704,332.5491666560091,333.18612003516733,331.9122132768509,17205,86867.06666666667,55.996923962218936,57.076811804510285,NaN,NaN,NaN,NaN,0.8905715771567421,27.167153448335945,90640501,-0.10913194885728772,0.462041972683096,0.5711739215403837
2025-08-18T11:50:00-04:00,333.17,333.41,332.96,333.28,330.38213627181517,NaN,NaN,NaN,NaN,NaN,331.3792999999995,335.11124319926387,327.6473568007351,331.9369271566536,332.55497756355544,333.1921766884743,331.91777843863656,19227,84115.2,56.710603517009154,57.18059490697213,NaN,NaN,NaN,NaN,0.8591021787884066,26.681692574437633,90659728,-0.10417160221186794,0.4409594187755488,0.5451310209874167
2025-08-18T11:55:00-04:00,333.25,333.27,332.9,333.19,330.38213627181517,NaN,NaN,NaN,NaN,NaN,331.4446999999995,335.18665371999066,327.70274628000834,331.9369271566536,332.56035254922557,333.1968809303045,331.92382416814667,21212,74327.36666666667,55.61772807079248,57.298922516024724,NaN,NaN,NaN,NaN,0.8248805945892344,26.09464958831232,90638516,-0.10631515071463937,0.4122370825941175,0.5185522333087569
2025-08-18T12:00:00-04:00,333.2,333.84,333.2,333.65,330.8280518509721,NaN,NaN,NaN,NaN,NaN,331.52489999999955,335.28056265291593,327.76923734708316,332.42023338025825,332.58302241049955,333.2297326076297,331.9363122133694,51565,66797.63333333333,59.87402575963378,57.55123795619641,NaN,NaN,NaN,NaN,0.8123891235471445,26.362082005710025,90690081,-0.07745688588284166,0.4217311259552048,0.49918801183804645
2025-08-18T12:05:00-04:00,333.64,334.73,333.63,334.04,331.46041313047334,NaN,NaN,NaN,NaN,NaN,331.6090999999995,335.397620392254,327.820579607745,333.04418670420665,332.64517965855663,333.34800622795973,331.9423530891535,95289,63787.26666666667,63.1046439201115,57.81024839851916,NaN,NaN,NaN,NaN,0.832932757579493,27.56269313461015,90785370,-0.03497077954280259,0.45547453740954325,0.49044531695234583
2025-08-18T12:10:00-04:00,334.04,334.67,333.86,334.49,331.55857616999725,NaN,NaN,NaN,NaN,NaN,331.7022999999995,335.540123972323,327.86447602767606,333.04418670420665,332.6845447601708,333.4245847347397,331.9445047856019,56515,61829.96666666667,66.46011991151045,58.217611443570426,NaN,NaN,NaN,NaN,0.8312947034666722,28.6775463257317,90841885,0.017738567249614756,0.5126185260143643,0.49487995876474955
2025-08-18T12:15:00-04:00,334.54,335.28,334.5,335.18,332.1988681622701,NaN,NaN,NaN,NaN,NaN,331.8242999999995,335.70847198931654,327.94012801068243,333.48207949069223,332.7735054389018,333.6240231328812,331.9229877449224,97805,60761.63333333333,70.83937740828283,58.9219936438819,NaN,NaN,NaN,NaN,0.8283450817904787,30.245436129846354,90939690,0.08936834157696505,0.6065903857359558,0.5172220441589908
2025-08-18T12:20:00-04:00,335.2,335.33,334.87,335.33,332.46846506398515,NaN,NaN,NaN,NaN,NaN,331.94729999999953,335.8779595938294,328.01664040616964,333.6616635925538,332.81951423947555,333.7239372063429,331.9150912726082,49402,59378.433333333334,71.70431744958782,59.5824516717678,NaN,NaN,NaN,NaN,0.802034718805443,31.74171586403625,90989092,0.13443689521140578,0.685268163173248,0.5508312679618422
2025-08-18T12:25:00-04:00,335.34,335.34,334.81,334.84,332.49080756107674,NaN,NaN,NaN,NaN,NaN,332.06049999999954,335.99186223242714,328.12913776757193,333.740330874043,332.8448467696374,333.77381083030343,331.91588270897137,30378,57894.9,64.9291726157071,60.212271122329035,NaN,NaN,NaN,NaN,0.782603667462195,32.97363796461591,90958714,0.11934510851686853,0.7000126536079279,0.5806675450910593
2025-08-18T12:30:00-04:00,334.9,335.28,334.82,334.94,332.52054358102777,NaN,NaN,NaN,NaN,NaN,332.1688999999995,336.1129584633812,328.2248415366178,333.7702646992344,332.8650380422869,333.8128332165157,331.91724286805817,24538,54554.9,65.64265213813178,60.93524310058935,NaN,NaN,NaN,NaN,0.759560548357751,34.11756562943988,90983252,0.10471753240916626,0.7115644606025171,0.6068469281933508
2025-08-18T12:35:00-04:00,334.88,334.89,333.6,333.73,332.52054358102777,NaN,NaN,NaN,NaN,NaN,332.26849999999956,336.1124262483093,328.4245737516898,333.7702646992344,332.8960476818301,333.85091341052294,331.9411819531373,69414,52688.433333333334,51.88742732207119,60.72642108270422,NaN,NaN,NaN,NaN,0.8010205091893384,32.4566663718265,90913838,0.007307904174886692,0.6159818084119593,0.6086739042370726
2025-08-18T12:40:00-04:00,333.79,334.1,333.45,333.96,332.52054358102777,NaN,NaN,NaN,NaN,NaN,332.37949999999955,336.0895319408885,328.6694680591106,333.7702646992344,332.91021306295056,333.86476071709,331.9556654088111,41355,48659.333333333336,53.86634001034183,60.73171885765996,NaN,NaN,NaN,NaN,0.790233329961531,30.654893311380064,90955193,-0.04500075719814178,0.5524229577393953,0.5974237149375371
2025-08-18T12:45:00-04:00,333.94,334.15,333.29,333.6,332.52054358102777,NaN,NaN,NaN,NaN,NaN,332.47989999999953,336.04196259946013,328.91783740053893,333.7702646992344,332.9207968025493,333.87298845841167,331.96860514668697,38282,47495.6,50.37386975492917,60.30058371091331,NaN,NaN,NaN,NaN,0.7952166635357043,28.703944610009422,90916911,-0.10384875565233886,0.4676127703721136,0.5714615260244524
2025-08-18T12:50:00-04:00,333.58,334.03,333.4,333.53,332.52054358102777,NaN,NaN,NaN,NaN,NaN,332.5742999999995,335.98947320828216,329.1591267917168,333.7702646992344,332.9263134933195,333.8770246066898,331.97560237994924,21128,45252.333333333336,49.6991178018689,59.764737117299774,NaN,NaN,NaN,NaN,0.7834154732831536,26.892349387308112,90895783,-0.14496675975260787,0.39025307633369266,0.5352198360863005
2025-08-18T12:55:00-04:00,333.55,333.62,333.17,333.38,332.52054358102777,NaN,NaN,NaN,NaN,NaN,332.6678999999995,335.905102551972,329.43069744802705,333.7702646992344,332.9303342488707,333.87789019665695,331.9827783010844,24540,42823.8,48.20891926233256,59.2084510673079,NaN,NaN,NaN,NaN,0.7596000823343562,25.153771630926396,90871243,-0.17759147769584321,0.3132304889664965,0.49082196666233974
2025-08-18T13:00:00-04:00,333.4,334.33,333.33,334.18,332.52054358102777,NaN,NaN,NaN,NaN,NaN,332.7704999999995,335.864551228169,329.67644877183005,333.7702646992344,332.9436885914549,333.8920865623104,331.99529062059935,37681,41676.73333333333,55.817881087235484,59.14468517946692,NaN,NaN,NaN,NaN,0.7767715050247592,24.34226843002165,90908924,-0.1421509792663086,0.31313324257945396,0.45528422184576256
2025-08-18T13:05:00-04:00,334.15,334.15,333.86,333.93,332.52054358102777,NaN,NaN,NaN,NaN,NaN,332.86769999999956,335.79129724354334,329.9441027564558,333.7702646992344,332.95001137194515,333.89894935372774,332.00107339016256,17604,40828.333333333336,53.188099910521835,58.97114031087615,NaN,NaN,NaN,NaN,0.7441449689515617,23.588729743467244,90891320,-0.1325909275196328,0.28954556244622154,0.42213648996585434
2025-08-18T13:10:00-04:00,333.96,334.57,333.88,334.52,332.52054358102777,NaN,NaN,NaN,NaN,NaN,332.97209999999956,335.7476994600207,330.1965005399784,333.7702646992344,332.9653466985389,333.91994249359595,332.01075090348183,32583,40038.933333333334,58.193993735577315,58.851138023443546,NaN,NaN,NaN,NaN,0.7402774711693071,23.495959545682155,90923903,-0.08584435292491699,0.31483104880970814,0.4006754017346251
2025-08-18T13:15:00-04:00,334.55,334.77,334.27,334.66,332.52054358102777,NaN,NaN,NaN,NaN,NaN,333.07629999999955,335.7023287969616,330.4502712030375,333.7702646992344,332.98087204042446,333.94370028394667,332.01804379690225,28567,39537.73333333333,59.306022977186515,58.57980795609176,NaN,NaN,NaN,NaN,0.7231147946572137,23.67688996288177,90952470,-0.04676281099016916,0.34222188799691367,0.3889846989870828
2025-08-18T13:20:00-04:00,334.61,334.61,334.12,334.25,332.52054358102777,NaN,NaN,NaN,NaN,NaN,333.1668999999995,335.63108740411474,330.70271259588424,333.19430085084986,332.99134940190316,333.9576886768377,332.02501012696865,23119,39342.1,54.715829239776504,57.74093005096791,NaN,NaN,NaN,NaN,0.7100351664674143,23.50814253302003,90929351,-0.0495274152320197,0.3270754299470582,0.3766028451790779
2025-08-18T13:25:00-04:00,334.23,334.9,334.18,334.75,332.52054358102777,NaN,NaN,NaN,NaN,NaN,333.2714999999995,335.5441550557733,330.9988449442257,333.3155525445439,333.0102442356207,333.9865321762475,332.03395629499386,35074,39058.333333333336,58.89419281023405,56.88770257967871,NaN,NaN,NaN,NaN,0.7107469402911682,23.757570152087844,90964425,-0.0201884910083997,0.3513672314185783,0.371555722426978
2025-08-18T13:30:00-04:00,334.79,335.75,334.79,335.31,332.9044025183157,NaN,NaN,NaN,NaN,NaN,333.3990999999995,335.38010549280307,331.418094507196,333.98244203563513,333.07214465474374,334.1036755243666,332.04061378512085,84113,39924.13333333333,63.010783140136596,56.26673584328933,NaN,NaN,NaN,NaN,0.7314078731275133,24.957594692050815,91048538,0.03160938150436837,0.41106744930743844,0.37945806780307006
2025-08-18T13:35:00-04:00,335.36,335.4,334.61,334.67,332.9044025183157,NaN,NaN,NaN,NaN,NaN,333.47989999999953,335.327614794679,331.63218520532007,333.98244203563513,333.0934217673732,334.13741477216655,332.0494287625798,36513,39925.73333333333,56.09650418818285,55.63583095560903,NaN,NaN,NaN,NaN,0.735593025046974,25.663944208747147,91012025,0.01811551687805013,0.40210246390063276,0.3839869470225826
2025-08-18T13:40:00-04:00,334.66,334.87,334.34,334.69,332.9044025183157,NaN,NaN,NaN,NaN,NaN,333.5168999999995,335.3858471802599,331.64795281973915,333.98244203563513,333.10968455926024,334.1600129215858,332.0593561969347,33358,39817.5,56.258038571439506,54.96550141513101,NaN,NaN,NaN,NaN,0.7209078089721922,25.726550941230634,91045383,0.0064837961976270675,0.3920916922696165,0.3856078960719894
2025-08-18T13:45:00-04:00,334.67,334.8,334.38,334.59,332.9044025183157,NaN,NaN,NaN,NaN,NaN,333.5582999999995,335.428788289878,331.687811710121,333.98244203563513,333.1197489313787,334.1735451422396,332.06595272051777,21622,38982.933333333334,55.16512660155817,55.19962279223722,NaN,NaN,NaN,NaN,0.6994143940456082,25.78468576425102,91023761,-0.011043912255775834,0.37180300575226966,0.3828469180080455
2025-08-18T13:50:00-04:00,334.56,334.83,334.34,334.8,332.9044025183157,NaN,NaN,NaN,NaN,NaN,333.62269999999944,335.43719410104586,331.808205898953,333.98244203563513,333.1296621072369,334.1872353861781,332.07208882829576,20646,38934.13333333333,57.05201979725311,55.42717134844518,NaN,NaN,NaN,NaN,0.6844562230423511,25.74401177124627,91044407,-0.011539633087332468,0.3684223766488799,0.37996200973621236
2025-08-18T13:55:00-04:00,334.8,334.93,334.5,334.62,332.9044025183157,NaN,NaN,NaN,NaN,NaN,333.6615999999995,335.4765528265405,331.8466471734585,333.98244203563513,333.13881943016685,334.1999568639424,332.0776819963913,18978,38143.9,54.9185413585255,55.75179074870205,NaN,NaN,NaN,NaN,0.6662807785393265,25.85272448512968,91025429,-0.02619663526764504,0.34721621565165606,0.3734128509193011
2025-08-18T14:00:00-04:00,334.6,334.6,333.97,334.18,332.9044025183157,NaN,NaN,NaN,NaN,NaN,333.7123999999995,335.4381696725112,331.9866303274878,333.98244203563513,333.14960774366455,334.2111875633855,332.08802792394357,31568,38028.36666666667,49.99674315408328,55.77304970243165,NaN,NaN,NaN,NaN,0.6651178657865159,24.723429141196007,90993861,-0.06549419513572141,0.2915451069996493,0.3570393021353707
2025-08-18T14:05:00-04:00,334.17,334.64,334.07,334.57,332.9044025183157,NaN,NaN,NaN,NaN,NaN,333.7589999999995,335.44867334195413,332.0693266580449,333.98244203563513,333.1558748236033,334.21860029553494,332.0931493516717,16035,37134.63333333333,53.93724330942559,56.182215705795436,NaN,NaN,NaN,NaN,0.6583237325160499,23.744706780683938,91009896,-0.06505800068361606,0.27571680128085063,0.3407748019644667
2025-08-18T14:10:00-04:00,334.58,334.85,334.1,334.12,332.9044025183157,NaN,NaN,NaN,NaN,NaN,333.79979999999955,335.42252605279697,332.17707394720213,333.98244203563513,333.1652016354946,334.2290276627403,332.10137560824893,25578,37363.13333333333,49.12660808796663,55.70426763441909,NaN,NaN,NaN,NaN,0.664872037336332,23.204192463138558,90984318,-0.09319888209169752,0.22427619934984477,0.3174750814415423
2025-08-18T14:15:00-04:00,334.12,334.18,333.66,333.83,332.9044025183157,NaN,NaN,NaN,NaN,NaN,333.81419999999946,335.4249195419074,332.2034804580915,333.98244203563513,333.1712353740083,334.2326690088571,332.1098017391595,27644,37711.1,46.26297479328796,55.209615840330954,NaN,NaN,NaN,NaN,0.6545240346694499,21.74269522745857,90956674,-0.12735288419970553,0.15828397619191037,0.2856368603916159
2025-08-18T14:20:00-04:00,333.82,334.17,333.7,334,332.9044025183157,NaN,NaN,NaN,NaN,NaN,333.8567999999995,335.369257286173,332.344342713826,333.5909536285081,333.17497093384526,334.2352553562334,332.11468651145714,15869,37599.166666666664,48.17025839191949,54.4936347443554,NaN,NaN,NaN,NaN,0.6413437464787768,20.38559065147001,90972543,-0.13383899630153728,0.11833811501469427,0.25217711131623155
2025-08-18T14:25:00-04:00,334.06,334.48,334.06,334.22,332.9044025183157,NaN,NaN,NaN,NaN,NaN,333.88299999999947,335.3741807411177,332.39181925888124,333.5079346062369,333.1819921917376,334.2423720720833,332.1216123113919,21867,37621,50.61318872637202,53.87271801215436,NaN,NaN,NaN,NaN,0.6298191931588655,19.72514676067303,90994410,-0.119147468913095,0.1032427751748628,0.2223902440879578
2025-08-18T14:30:00-04:00,334.23,334.58,334.05,334.53,332.9044025183157,NaN,NaN,NaN,NaN,NaN,333.8969999999995,335.39903195794057,332.3949680420584,333.5079346062369,333.1915285261636,334.2530848417647,332.1299722105625,26798,36795.433333333334,53.90977583037258,53.815142768625506,NaN,NaN,NaN,NaN,0.6226892507903731,19.296689875181563,91021208,-0.08593721058725529,0.1149687308538887,0.200905941441144
2025-08-18T14:35:00-04:00,334.5,334.67,334.17,334.27,332.9044025183157,NaN,NaN,NaN,NaN,NaN,333.9081999999995,335.41283651509974,332.4035634848993,333.5079346062369,333.2011513960301,334.26367090836,332.13863188370027,27870,34548.13333333333,50.84433805953668,53.24015314357569,NaN,NaN,NaN,NaN,0.613925732876775,19.067974043456264,90993338,-0.07904090718585172,0.10210480745882933,0.18114571464468104
2025-08-18T14:40:00-04:00,334.33,334.96,334.2,334.94,332.9044025183157,NaN,NaN,NaN,NaN,NaN,333.94439999999946,335.45946124058156,332.42933875941736,333.5079346062369,333.2144352679438,334.28152299673843,332.1473475391492,30520,33681.63333333333,57.54396405130489,52.849666065802,NaN,NaN,NaN,NaN,0.6243596090998619,19.376768042904928,91023858,-0.029468618998767904,0.14430994089622118,0.17377855989498908
2025-08-18T14:45:00-04:00,334.92,335.06,334.8,334.93,332.9435292555058,NaN,NaN,NaN,NaN,NaN,333.98919999999947,335.4856001612741,332.49279983872486,333.76408162382535,333.23353189497794,334.30982088308167,332.1572429068742,38764,31713.6,57.41817689772724,52.94407125934088,NaN,NaN,NaN,NaN,0.5983339227355854,19.834686251864326,90985094,0.0009246419672155337,0.1749343623540085,0.17400972038679297
2025-08-18T14:50:00-04:00,334.92,335.41,334.85,335.31,333.1574597438918,NaN,NaN,NaN,NaN,NaN,334.0447999999995,335.52671357460383,332.56288642539516,334.0932652990603,333.25588219978647,334.34601650285947,332.16574789671347,40242,31408.266666666666,60.91456581070096,53.27668034785956,NaN,NaN,NaN,NaN,0.5955957853973295,20.819006528532444,91025336,0.042590376711029,0.2272476912755792,0.1846573145645502
2025-08-18T14:55:00-04:00,335.33,335.52,335.13,335.39,333.3889388464422,NaN,NaN,NaN,NaN,NaN,334.10579999999953,335.5526729876768,332.6589270123223,334.2716122392482,333.28155883142995,334.38917940099674,332.17393826186316,43799,31855.633333333335,61.628882834542765,53.738377221644164,NaN,NaN,NaN,NaN,0.5809103721546621,21.89646103071585,91069135,0.06989492174107839,0.2720259667408982,0.2021310449998198
2025-08-18T15:00:00-04:00,335.39,335.66,335.26,335.55,333.55739617160395,NaN,NaN,NaN,NaN,NaN,334.1617999999995,335.6111788471448,332.71242115285423,334.4612897913986,333.3039814270006,334.4279847351949,332.17997811880633,36582,32257.1,63.082091013723534,54.1690965942492,NaN,NaN,NaN,NaN,0.5679882027150459,23.10349461275152,91105717,0.0917129103524052,0.3167721829403263,0.22505927258792108
2025-08-18T15:05:00-04:00,335.51,336.26,335.43,335.95,333.91569634562194,NaN,NaN,NaN,NaN,NaN,334.2143999999995,335.7272630349813,332.7015369650177,334.88603183311886,333.34559724388896,334.50682271822564,332.1843717695523,59163,31915.4,66.49808940264603,54.996207168829265,NaN,NaN,NaN,NaN,0.5867033310925416,24.977704309444196,91164880,0.12405550371919882,0.3801286522369196,0.2560731485177208
2025-08-18T15:10:00-04:00,335.98,336,335.22,335.35,333.91569634562194,NaN,NaN,NaN,NaN,NaN,334.25019999999955,335.7839978492783,332.7164021507208,334.88603183311886,333.3696150795292,334.54660297884965,332.1926271802087,40840,31898.233333333334,57.85104458394631,55.55722869953377,NaN,NaN,NaN,NaN,0.600510236014501,26.067405086175448,91124040,0.09719885185876986,0.3775717133411831,0.28037286148241325
2025-08-18T15:15:00-04:00,335.33,335.47,335.02,335.31,333.91569634562194,NaN,NaN,NaN,NaN,NaN,334.2843999999995,335.83484850372656,332.7339514962724,334.88603183311886,333.3826423720681,334.5659982853154,332.19928645882084,25605,31475.666666666668,57.31595377595055,55.798565161428414,NaN,NaN,NaN,NaN,0.5897595048706114,26.489544189792447,91098435,0.07016148593216298,0.368074718897617,0.297913232965454
2025-08-18T15:20:00-04:00,335.29,335.29,334.6,334.675,333.91569634562194,NaN,NaN,NaN,NaN,NaN,334.3006999999995,335.85009473427795,332.75130526572104,334.88603183311886,333.40289209426305,334.59052708663785,332.21525710188826,51996,32504.6,49.49007969341218,55.82452741896024,NaN,NaN,NaN,NaN,0.5983481116655662,25.773847126941675,91046439,0.00629677313874194,0.30578419938888146,0.2994874262501395
2025-08-18T15:25:00-04:00,334.66,335,334.49,334.84,333.91569634562194,NaN,NaN,NaN,NaN,NaN,334.3346999999995,335.8550583928319,332.8143416071671,334.88603183311886,333.4202190803176,334.61025694647753,332.2301812141577,48293,33296.36666666667,51.348930879391894,56.187809996539094,NaN,NaN,NaN,NaN,0.5920375322608822,24.84240250602075,91094732,-0.026262933996020865,0.26665875875511347,0.29292169275113433
2025-08-18T15:30:00-04:00,334.85,334.94,334.52,334.81,333.91569634562194,NaN,NaN,NaN,NaN,NaN,334.36949999999945,335.85164742947666,332.88735257052224,334.88603183311886,333.43018125881747,334.621335409266,332.23902710836893,28756,32998.86666666667,50.98156140588094,56.3886173546792,NaN,NaN,NaN,NaN,0.5797491370993918,23.977489643737034,91065976,-0.049879022317746435,0.23057291485395126,0.2804519371716977
2025-08-18T15:35:00-04:00,334.81,335.09,334.79,334.82,333.91569634562194,NaN,NaN,NaN,NaN,NaN,334.40609999999947,335.8397656383823,332.97243436161665,334.88603183311886,333.44155602686317,334.63506235671827,332.24804969700807,30087,33414.96666666667,51.107129881162145,56.42389886573564,NaN,NaN,NaN,NaN,0.5597670558780034,23.47531538163691,91096063,-0.06398503832653535,0.20047063926352848,0.26445567759006383
2025-08-18T15:40:00-04:00,334.85,335.04,334.55,334.97,333.91569634562194,NaN,NaN,NaN,NaN,NaN,334.4478999999995,335.8217734885805,333.0740265114185,334.88603183311886,333.45652732563497,334.652463609102,332.2605910421679,41670,33717.86666666667,53.04995239218344,56.36248290586498,NaN,NaN,NaN,NaN,0.5547836947438609,22.367434662835173,91137733,-0.062310556802390143,0.18656748158707614,0.2488780383894663
2025-08-18T15:45:00-04:00,334.93,335.06,334.74,335,333.91569634562194,NaN,NaN,NaN,NaN,NaN,334.48369999999954,335.819437714713,333.1479622852861,334.88603183311886,333.467441394363,334.6656451892562,332.26923759946976,29256,33740.833333333336,53.44836876538227,56.54848509913967,NaN,NaN,NaN,NaN,0.5380134308335847,21.383690320392155,91166989,-0.058349045527065685,0.1759417314806342,0.23429077700769987
2025-08-18T15:50:00-04:00,335.04,335.07,333.87,334.13,NaN,NaN,NaN,336.3345864460294,336.3345864460294,336.3345864460294,334.5000999999995,335.79737482150864,333.2028251784904,334.88603183311886,333.4872117759543,334.6792527400941,332.29517081181444,90016,35970.73333333333,42.25090149210743,55.456123487768416,NaN,NaN,NaN,NaN,0.5852981857740421,21.125843344219028,91076973,-0.1104646454362973,0.09620997021232824,0.20667461564862555
2025-08-18T15:55:00-04:00,334.05,335.33,334,335.155,NaN,NaN,NaN,336.3345864460294,NaN,NaN,334.5391999999995,335.7945475385889,333.28385246141005,334.51082546649513,333.5286558278219,334.7248641077427,332.33244754790115,129105,39105.1,54.37782479387445,55.238955480350356,NaN,NaN,NaN,NaN,0.6384911725044665,20.276649334869035,91206078,-0.07381006217159625,0.11441203793413024,0.1882221001057265
2025-08-19T09:30:00-04:00,335.85,337.36,333.92,334.7,333.29885821756415,333.29885821756415,333.29885821756415,NaN,NaN,NaN,334.5675999999995,335.77088424015466,333.3643157598444,334.13439138041406,335.32666666666665,335.32666666666665,335.32666666666665,262055,45036.5,49.41699871007521,54.41770068744852,NaN,NaN,NaN,NaN,0.8385989458970045,21.123196126139273,90944023,-0.07771945606949124,0.09107278001886243,0.16879223608835367
2025-08-19T09:35:00-04:00,334.71,335,333.3,334.18,333.29885821756415,NaN,NaN,NaN,NaN,NaN,334.5873999999995,335.7304314792782,333.4443685207208,334.13439138041406,334.8478176833283,335.42171732473673,334.27391804191984,182439,49900.7,44.42849393134378,53.18910148007716,NaN,NaN,NaN,NaN,0.9001275926186462,20.863986602720345,90761584,-0.11081963789662524,0.030267688717572128,0.14108732661419737
2025-08-19T09:40:00-04:00,334.18,336.07,334.08,334.7,333.29885821756415,NaN,NaN,NaN,NaN,NaN,334.60839999999945,335.7199186740098,333.4968813259891,334.13439138041406,334.87198334066215,335.3753259455926,334.36864073573173,137682,53378.166666666664,49.87743372441687,52.24591167369812,NaN,NaN,NaN,NaN,0.9779756217173149,21.62931754779105,90899266,-0.09385792310982857,0.023764922726911664,0.11762284583674024
2025-08-19T09:45:00-04:00,334.73,335.17,334.1,334.63,333.29885821756415,NaN,NaN,NaN,NaN,NaN,334.62019999999944,335.71979439917754,333.52060560082134,334.13439138041406,334.83478752306064,335.3052760931282,334.36429895299307,107491,56240.46666666667,49.17837541874334,51.00878924627649,NaN,NaN,NaN,NaN,0.984548791594649,22.339981996785273,90791775,-0.08384604296273193,0.012815292133325329,0.09666133509605726
2025-08-19T09:50:00-04:00,334.69,337.61,334.5,337.45,333.29885821756415,NaN,NaN,NaN,NaN,NaN,334.67939999999953,336.0337834621151,333.325016537884,334.13439138041406,335.19444869224316,336.0012112807922,334.38768610369414,187127,61789.833333333336,68.395653266507,51.761975580745116,NaN,NaN,NaN,NaN,1.1363667350521751,24.520026883556483,90978902,0.10590912669702097,0.22904774346733348,0.1231386167703125
2025-08-19T09:55:00-04:00,337.48,339.54,337.48,338.99,335.40348107610555,NaN,NaN,NaN,NaN,NaN,334.75559999999956,336.56600950130365,332.94519049869547,334.9940325675341,335.9169054581997,337.4994866736388,334.33432424276066,230085,68826.73333333334,74.14527793296597,52.96407016338908,NaN,NaN,NaN,NaN,1.204483396834165,27.24962089651758,91208987,0.31644863045842697,0.5186994048433462,0.20225077438491923
2025-08-19T10:00:00-04:00,338.9,339.08,337.03,338.33,335.40348107610555,NaN,NaN,NaN,NaN,NaN,334.81559999999956,336.8793089335535,332.75189106644564,334.9940325675341,336.16490358071417,337.8133800632887,334.5164270981396,138515,72391.63333333333,68.40188358645597,54.3149132986065,NaN,NaN,NaN,NaN,1.2648774399174398,29.203442672416564,91070472,0.3878584126494068,0.6870737901966777,0.2992153775472709
2025-08-19T10:05:00-04:00,338.28,339.37,338,339.37,335.40348107610555,NaN,NaN,NaN,NaN,NaN,334.9061999999995,337.33218809612487,332.48021190387414,334.9940325675341,336.4564043934873,338.22994711968676,334.6828616672878,147759,76782.43333333333,72.07289058563737,55.79519613476689,NaN,NaN,NaN,NaN,1.2723861942090515,31.126383208282395,91218231,0.4759269826810503,0.8941241058985838,0.4181971232175335
2025-08-19T10:10:00-04:00,339.37,340.29,338.86,339.75,336.24509750618085,NaN,NaN,NaN,NaN,NaN,335.00239999999957,337.7818425632479,332.22295743675124,336.0434646745774,336.88153007071503,338.85495406076177,334.9081060806683,215228,83104.1,73.29376669972189,57.38892508432696,NaN,NaN,NaN,NaN,1.2836443231941197,33.233950082414246,91433459,0.5266158662461562,1.0764669560252287,0.5498510897790725
2025-08-19T10:15:00-04:00,339.74,340.02,338.79,339.15,336.24509750618085,NaN,NaN,NaN,NaN,NaN,335.11079999999953,338.09827141283097,332.1233285871681,336.0434646745774,337.02295752196704,339.0213063037546,335.0246087401795,99027,85483.53333333334,68.22240079930245,58.61144443562269,NaN,NaN,NaN,NaN,1.2798125858231084,35.09519225209455,91334432,0.4874771168390304,1.1591974858278604,0.67172036898883
2025-08-19T10:20:00-04:00,339.19,339.8,338.7,339.7,336.24509750618085,NaN,NaN,NaN,NaN,NaN,335.22559999999953,338.45842887924886,331.9927711207502,336.0434646745774,337.1449093573783,339.1607300171159,335.1290886976407,92334,88032.36666666667,70.2541951635985,59.8403189192952,NaN,NaN,NaN,NaN,1.2669688296928878,36.69347424959676,91426766,0.46636711968752653,1.2546792685982382,0.7883121489107117
2025-08-19T10:25:00-04:00,339.77,340.55,338.06,338.78,336.24509750618085,NaN,NaN,NaN,NaN,NaN,335.32919999999956,338.6769672324171,331.981432767582,336.29717391338363,337.3214006935751,339.3267566763514,335.31604471079874,175627,93157.7,62.9982053076546,60.52245010088608,NaN,NaN,NaN,NaN,1.3543281990005394,38.4601387077089,91251139,0.3627889052941278,1.2417982805283714,0.8790093752342436
2025-08-19T10:30:00-04:00,338.83,339.25,338.22,338.3,336.24509750618085,NaN,NaN,NaN,NaN,NaN,335.42459999999954,338.8331515050359,332.0160484949632,336.29717391338363,337.3789137839183,339.3559797306979,335.40184783713863,93808,95391.36666666667,59.542854482208696,61.757589600179024,NaN,NaN,NaN,NaN,1.3311618990719276,40.10061284738446,91157331,0.24020385394166222,1.1792641926613214,0.9390603387196592
2025-08-19T10:35:00-04:00,338.32,338.37,334.66,334.95,NaN,NaN,NaN,340.372917343518,340.372917343518,340.372917343518,335.45599999999956,338.817230132323,332.0947698676761,336.29717391338363,337.24813618518664,339.172703643863,335.3235687265103,215653,101650.8,42.1619346995157,60.88502602201054,NaN,NaN,NaN,NaN,1.5010789062810743,37.71928422278838,90941678,-0.07157237196709276,0.8495948737607932,0.921167245727886
2025-08-19T10:40:00-04:00,334.99,335.46,331.72,332.565,NaN,NaN,NaN,337.7825574642672,NaN,NaN,335.4236999999996,338.86347778967297,331.9839222103262,336.29717391338363,336.9017198098938,339.0578178832214,334.7456217365662,216649,107855.1,34.45149077039311,59.81606116917611,NaN,NaN,NaN,NaN,1.6610018415467085,36.30714376529136,90725029,-0.4238389624003157,0.39136854272749133,0.815207505127807
2025-08-19T10:45:00-04:00,332.6,333.66,332.51,333.43,NaN,NaN,NaN,337.24380485225504,NaN,NaN,335.4136999999996,338.87363746219876,331.95376253780046,336.29717391338363,336.7151704057704,338.96688888095173,334.46345193058903,132753,110988.06666666667,38.82138476623816,59.415553371668565,NaN,NaN,NaN,NaN,1.6245017100076602,34.995870483329846,90857782,-0.5746443099887798,0.09690211764183232,0.6715464276306121
2025-08-19T10:50:00-04:00,333.43,334.47,333.35,334.47,NaN,NaN,NaN,337.24380485225504,NaN,NaN,335.41269999999963,338.8736988214852,331.95170117851404,336.29717391338363,336.61623305068446,338.880728997521,334.35173710384794,103440,113094.66666666667,43.682679801081356,58.97307094857318,NaN,NaN,NaN,NaN,1.588465873578542,33.19807465785463,90961222,-0.5787943662112263,-0.051946530133420765,0.5268478360778055
2025-08-19T10:55:00-04:00,334.38,334.54,332.3,332.35,NaN,NaN,NaN,337.24380485225504,NaN,NaN,335.3664999999996,338.92670519104877,331.8062948089504,336.29717391338363,336.4714145704589,338.7978876145761,334.14494152634165,116331,115512.4,37.194558638976815,58.11708403573271,NaN,NaN,NaN,NaN,1.6350040254657896,32.09359490621217,90844891,-0.6911508024109816,-0.3370906669359215,0.3540601354750601
2025-08-19T11:00:00-04:00,332.27,332.38,330.65,331.12,NaN,NaN,NaN,335.7987201105122,NaN,NaN,335.30389999999954,339.0458622075159,331.5619377924832,336.29717391338363,336.1219139046101,338.7097374047299,333.5340904044903,210501,121309.7,34.0359122618394,55.66281682111359,NaN,NaN,NaN,NaN,1.6417894522182344,31.827433186800896,90634390,-0.8070659979468651,-0.6547723619585213,0.1522936359883438
2025-08-19T11:05:00-04:00,331.12,331.72,330.84,331.35,NaN,NaN,NaN,335.48900556003434,NaN,NaN,335.2358999999996,339.1358880464214,331.3359119535778,336.29717391338363,335.9794323095452,338.65619687856076,333.3026677405296,93376,122450.13333333333,35.1450164857512,52.87708386059825,NaN,NaN,NaN,NaN,1.5873759199169355,31.580283018776147,90727766,-0.8241220329635104,-0.8778589052160441,-0.05373687225253379
2025-08-19T11:10:00-04:00,331.35,331.99,330.76,331.99,NaN,NaN,NaN,335.48900556003434,NaN,NaN,335.16949999999963,339.1738352759522,331.1651647240471,336.29717391338363,335.8741867406882,338.60285053240955,333.1455229489668,77396,123668.66666666667,38.25599093981648,50.72380581440971,NaN,NaN,NaN,NaN,1.5618490684942985,31.131277214446257,90805162,-0.750277372866431,-0.9915835883355726,-0.24130621546914158
2025-08-19T11:15:00-04:00,331.95,332.46,331.59,332.07,NaN,NaN,NaN,335.48900556003434,NaN,NaN,335.11749999999955,339.2129214682327,331.0220785317664,335.3327391307069,335.8141266680683,338.5628808900538,333.0653724460828,51485,124531.33333333333,38.65212964626981,48.33660860445489,NaN,NaN,NaN,NaN,1.5124312778875633,30.329944541494875,90856647,-0.6573568350555855,-1.0630022592886235,-0.40564542423303795
2025-08-19T11:20:00-04:00,332.01,332.44,331.11,331.38,NaN,NaN,NaN,335.48900556003434,NaN,NaN,335.0512999999996,339.27715367023075,330.8254463297685,333.38119130456556,335.7298709798232,338.51327347151766,332.94646848812874,67766,125057,36.47827484657383,45.70693061494431,NaN,NaN,NaN,NaN,1.4994004723241647,29.84389584226652,90788881,-0.6049923067337815,-1.1618858076502647,-0.5568935009164833
2025-08-19T11:25:00-04:00,331.35,332.33,331.24,332.18,NaN,NaN,NaN,335.48900556003434,NaN,NaN,335.0030999999996,339.30322459845985,330.7029754015394,329.6989299479376,335.67220773893456,338.4734094552103,332.87100602265883,51506,125164.1,40.646301350366194,43.73720922573458,NaN,NaN,NaN,NaN,1.4701575814438654,29.392564907268763,90840387,-0.4843253156294429,-1.1623001454532869,-0.6779748298238439
2025-08-19T11:30:00-04:00,332.14,332.73,332.02,332.66,NaN,NaN,NaN,335.48900556003434,NaN,NaN,334.96029999999956,339.309972820155,330.61062717984413,329.6989299479376,335.6021992577217,338.4119077630251,332.79249075241825,76129,126743.2,43.06041877126565,41.79479662628223,NaN,NaN,NaN,NaN,1.4158606113407348,28.6048812426065,90916516,-0.34649100421641654,-1.1110885850943646,-0.764597580877948
2025-08-19T11:35:00-04:00,332.64,332.78,332.17,332.48,NaN,NaN,NaN,335.48900556003434,NaN,NaN,334.91749999999956,339.3214996596657,330.51350034033345,329.9970067902833,335.5640310310503,338.37755122868674,332.7505108334139,43049,127175.26666666666,42.36454715542434,40.32096390112292,NaN,NaN,NaN,NaN,1.3582991391021078,27.82618139353349,90873467,-0.24645198641791144,-1.0726625639003373,-0.8262105774824259
2025-08-19T11:40:00-04:00,332.47,333.35,332.15,333.14,NaN,NaN,NaN,335.48900556003434,NaN,NaN,334.89669999999956,339.32419708553454,330.4692029144646,330.5236054322267,335.5202607493696,338.33137637710297,332.7091451216362,58441,127734.3,45.82180311598858,39.340888803535776,NaN,NaN,NaN,NaN,1.3469920577376746,26.56298567287587,90931908,-0.12117798552416315,-0.9776830593876298,-0.8565050738634666
2025-08-19T11:45:00-04:00,333.18,333.87,333.05,333.53,NaN,NaN,NaN,335.48900556003434,NaN,NaN,334.8758999999996,339.31908475446915,330.43271524553006,331.1988843457813,335.49380399906977,338.29611040384304,332.6914975942965,47159,128331.06666666667,47.81386273232822,39.74459794873667,NaN,NaN,NaN,NaN,1.3093497678992687,24.922946689642657,90979067,-0.0036088363315059935,-0.8610161192778492,-0.8574072829463432
2025-08-19T11:50:00-04:00,333.5,333.52,332.3,332.76,NaN,NaN,NaN,335.48900556003434,NaN,NaN,334.8486999999996,339.3265770910284,330.3708229089708,331.1988843457813,335.449236995707,338.2484217396107,332.6500522518033,62495,127413.7,44.34688016350723,40.451411476816254,NaN,NaN,NaN,NaN,1.3036819273350326,23.981397091860075,90916572,0.028947627247694063,-0.8212227488867256,-0.8501703761344197
2025-08-19T11:55:00-04:00,332.79,333.33,332.72,332.97,NaN,NaN,NaN,335.48900556003434,NaN,NaN,334.83149999999955,339.33144899998837,330.33155100001073,331.1988843457813,335.42624796438434,338.2221938432919,332.6303020854768,35091,124279.9,45.507389644979995,40.92898325386924,NaN,NaN,NaN,NaN,1.25413321823967,23.10710103677625,90951663,0.06898845587933644,-0.7639348062852491,-0.8329232621645856
2025-08-19T12:00:00-04:00,332.93,333.99,332.84,333.36,NaN,NaN,NaN,335.48900556003434,NaN,NaN,334.8186999999996,339.3316590339802,330.30574096601896,331.40978878504006,335.399783102273,338.1869664786707,332.61259972587527,49259,117186.7,47.68902415639431,41.21515070782016,NaN,NaN,NaN,NaN,1.2466951312225532,21.662062655309803,91000922,0.12295127396965977,-0.6792341697025108,-0.8021854436721706
2025-08-19T12:05:00-04:00,333.36,333.84,332.86,332.97,NaN,NaN,NaN,335.48900556003434,NaN,NaN,334.7936999999996,339.33341796946877,330.25398203053044,331.40978878504006,335.37355855283334,338.15405791613216,332.59305918953453,46073,112641.16666666667,45.717894086169096,41.8239603826196,NaN,NaN,NaN,NaN,1.227645478992368,20.32024130109096,90954849,0.1327532966437146,-0.6362438228675273,-0.7689971195112419
2025-08-19T12:10:00-04:00,332.96,333.03,331.92,332.09,NaN,NaN,NaN,335.48900556003434,NaN,NaN,334.74489999999963,339.34693758810147,330.1428624118978,331.40978878504006,335.334367207493,338.1179202624982,332.5508141524878,50158,109723.7,41.545165915880695,42.360335643622555,NaN,NaN,NaN,NaN,1.21924223049291,19.87801500446338,90904691,0.08278912317499698,-0.6655107155424957,-0.7482998387174927
2025-08-19T12:15:00-04:00,332.129,333.45,332.07,333.2,NaN,NaN,NaN,335.48900556003434,NaN,NaN,334.72349999999955,339.34408578564523,330.10291421435386,331.40978878504006,335.30955851729175,338.089594780746,332.5295222538375,39996,107473.86666666667,47.99309002516948,43.27805518215244,NaN,NaN,NaN,NaN,1.2307249283148447,19.03690982016766,90944687,0.12479231820164471,-0.5923094409654368,-0.7171017591670815
2025-08-19T12:20:00-04:00,333.22,333.93,333.05,333.85,NaN,NaN,NaN,335.48900556003434,NaN,NaN,334.70169999999956,339.3282756713175,330.0751243286816,331.40978878504006,335.2868513687783,338.055139515192,332.51856322236455,53000,103002.96666666666,51.37552511132576,44.21516476583167,NaN,NaN,NaN,NaN,1.2056731477209268,17.78467847398662,90997687,0.19259644891468697,-0.47635619802372275,-0.6689526469384097
2025-08-19T12:25:00-04:00,333.87,333.9,332.86,333.16,NaN,NaN,NaN,335.48900556003434,NaN,NaN,334.6662999999995,339.31239160935814,330.0202083906409,331.40978878504006,335.2688793056216,338.03096754434637,332.5067910668969,36333,96544.56666666667,47.82004070015122,44.87001555539462,NaN,NaN,NaN,NaN,1.193839351455144,16.80026528528163,90961354,0.1870630659148007,-0.4351238145449088,-0.6221868804597095
2025-08-19T12:30:00-04:00,333.13,333.37,332.45,332.9,NaN,NaN,NaN,335.48900556003434,NaN,NaN,334.6180999999995,339.28643070406963,329.9497692959294,331.40978878504006,335.2514126810639,338.01070155115576,332.4921238109721,29821,92921.43333333333,46.51377058224436,45.58683667937108,NaN,NaN,NaN,NaN,1.1742793977797776,16.26769677342051,90931533,0.16286846005914535,-0.4186013053857778,-0.5814697654449231
2025-08-19T12:35:00-04:00,332.9,333.16,332.19,332.3,NaN,NaN,NaN,335.48900556003434,NaN,NaN,334.5562999999995,339.2637680288514,329.8488319711476,331.40978878504006,335.2278592887814,337.98654824185274,332.4691703357101,35473,89178.56666666667,43.55683443978994,45.79473190004421,NaN,NaN,NaN,NaN,1.1596880122240811,16.010220120275395,90896060,0.10617646660075575,-0.4487491821939784,-0.5549256487947342
2025-08-19T12:40:00-04:00,332.27,332.36,331.29,331.97,NaN,NaN,NaN,335.34488777630196,NaN,NaN,334.4846999999996,339.23821129613106,329.7311887038681,331.40978878504006,335.18718579006094,337.95356886774493,332.42080271237694,49936,83668.83333333333,41.97627206952173,45.71729284991965,NaN,NaN,NaN,NaN,1.153281725636646,16.52023873985945,90846124,0.04907639973417721,-0.49358014912701265,-0.5426565488611899
2025-08-19T12:45:00-04:00,331.94,332.33,331.37,332.24,NaN,NaN,NaN,335.3408019682882,NaN,NaN,334.4104999999996,339.18597620686717,329.63502379313206,331.40978878504006,335.15630233289806,337.9270923821048,332.38551228369136,40044,81702.73333333334,43.77401226989653,45.8179689295248,NaN,NaN,NaN,NaN,1.13947588809117,16.993827458044645,90886168,0.0328925834681183,-0.501540819526042,-0.5344334029941603
2025-08-19T12:50:00-04:00,332.21,332.8,331.92,331.95,NaN,NaN,NaN,335.3408019682882,NaN,NaN,334.3424999999996,339.15917821247217,329.525821787527,331.285831028032,335.1162384399952,337.88901829784857,332.3434585821418,57591,80544.63333333333,42.25952768271305,45.563520684290836,NaN,NaN,NaN,NaN,1.1209418960846576,16.83721873362426,90828577,0.007389802200969742,-0.5251961502429481,-0.5325859524439178
2025-08-19T12:55:00-04:00,331.93,332.02,330.05,330.385,NaN,NaN,NaN,334.59885055375014,NaN,NaN,334.2439999999996,339.1775220687112,329.31047793128795,331.27506548635245,335.0173989555663,337.83280880068924,332.2019891104434,99240,77998.4,35.18486932268472,44.66144972645916,NaN,NaN,NaN,NaN,1.1815889035071798,18.061684493636637,90729337,-0.10400139207668446,-0.6625876925397733,-0.5585863004630889
2025-08-19T13:00:00-04:00,330.41,331.02,328.7,328.87,NaN,NaN,NaN,333.57822098312516,NaN,NaN,334.12789999999956,339.2836009574313,328.9721990425678,331.27506548635245,334.85992527452925,337.78197682308877,331.9378737259697,127497,79121.36666666667,29.956616633968025,43.6335737600635,NaN,NaN,NaN,NaN,1.2629039818280952,19.901057761644505,90601840,-0.25995854582421474,-0.8835344827433573,-0.6235759369191426
2025-08-19T13:05:00-04:00,328.87,329.25,328.44,328.85,NaN,NaN,NaN,332.5046654838922,NaN,NaN,334.00809999999956,339.36643701463714,328.649762985362,331.27506548635245,334.74350994446274,337.75342140440887,331.7335984845166,87710,74856.6,29.893465821413216,42.518293486951585,NaN,NaN,NaN,NaN,1.230553697411803,21.729311353607457,90514130,-0.33967334235741997,-1.0481676148659176,-0.7084942725084976
2025-08-19T13:10:00-04:00,328.9,329.42,328.6,329.32,NaN,NaN,NaN,332.5046654838922,NaN,NaN,333.8982999999996,339.40923190325685,328.38736809674236,331.25605238908196,334.68252761325704,337.73229190548847,331.6327633210256,49609,69288.6,33.444250253174346,41.50080963672159,NaN,NaN,NaN,NaN,1.2012284333109595,23.212219896396995,90563739,-0.3353772855650887,-1.1277158794648585,-0.7923385938997698
2025-08-19T13:15:00-04:00,329.26,329.38,328.12,328.73,NaN,NaN,NaN,332.36308363305056,NaN,NaN,333.7764999999996,339.46684032395376,328.08615967604544,330.79484191126556,334.56589053435806,337.69599102141194,331.4357900473042,91749,67921.8,31.30104630097854,40.47103479492227,NaN,NaN,NaN,NaN,1.2054264023601762,24.832060830422044,90471990,-0.34553239083808296,-1.2242540824473735,-0.8787216916092906
2025-08-19T13:20:00-04:00,328.7,329.24,327.85,329.12,NaN,NaN,NaN,332.18339801336646,NaN,NaN,333.6594999999995,339.48581109729787,327.8331889027012,330.61487352901247,334.3819842677462,337.62646203149166,331.1375065040007,152195,69546.96666666666,34.29824995519667,39.95339794058769,NaN,NaN,NaN,NaN,1.2186102307630198,26.46982959734775,90624185,-0.3008840083750973,-1.2548267020781623,-0.953942693703065
2025-08-19T13:25:00-04:00,329.1,329.78,328.85,329.72,NaN,NaN,NaN,332.18339801336646,NaN,NaN,333.55389999999966,339.46990483115735,327.63789516884196,330.3304952468544,334.31948750425113,337.5902018757465,331.04877313275574,61914,67733.06666666667,38.72724187059556,39.291551643832406,NaN,NaN,NaN,NaN,1.1979952142799435,27.25912351430782,90686099,-0.21013891858644151,-1.216616341936117,-1.0064774233496754
2025-08-19T13:30:00-04:00,329.62,330.2,329.42,330.15,NaN,NaN,NaN,332.18339801336646,NaN,NaN,333.47429999999963,339.46380248704696,327.4847975129523,330.3304952468544,334.27835982556854,337.561133775857,330.9955858752801,46142,62254.433333333334,41.75743514801995,38.60454521788199,NaN,NaN,NaN,NaN,1.1681384132599457,27.453088968952876,90732241,-0.10562836699037081,-1.138512882087639,-1.032884515097268
2025-08-19T13:35:00-04:00,330.16,330.87,330.03,330.2,NaN,NaN,NaN,332.18339801336646,NaN,NaN,333.3751999999996,339.4139548254868,327.3364451745124,330.3304952468544,334.2353264945525,337.525391920823,330.94526106828204,54863,60970.666666666664,42.11590150830016,38.19710670417834,NaN,NaN,NaN,NaN,1.1446999551699517,26.833490948882243,90787104,-0.02197847026088562,-1.060357602923375,-1.0383791326624894
2025-08-19T13:40:00-04:00,330.17,330.36,329.96,330.12,NaN,NaN,NaN,332.18339801336646,NaN,NaN,333.28359999999964,339.37788389249107,327.1893161075082,329.0593961974835,334.1993271350004,337.4970713814722,330.90158288852854,44299,59867.433333333334,41.67394735549138,37.85140504512456,NaN,NaN,NaN,NaN,1.0915071012292432,26.31383799743312,90742805,0.03596510340811787,-0.9934227534023421,-1.02938785681046
2025-08-19T13:45:00-04:00,330.13,330.33,329.86,329.91,NaN,NaN,NaN,332.18339801336646,NaN,NaN,333.19819999999964,339.3591524460391,327.0372475539602,328.25565174601445,334.1625870856658,337.4687809777933,330.8563931935383,44766,59643.46666666667,40.47330468167553,37.63115291954496,NaN,NaN,NaN,NaN,1.0471137368557237,25.91491987936273,90698039,0.0663806858760958,-0.9464119994653402,-1.012792685341436
2025-08-19T13:50:00-04:00,329.98,330.13,329.6,329.84,NaN,NaN,NaN,332.18339801336646,NaN,NaN,333.1009999999996,339.317213638738,326.8847863612612,328.25565174601445,334.1321729251913,337.4463463130005,330.8179995373821,36109,58588.23333333333,40.059006771877286,37.49420539828464,NaN,NaN,NaN,NaN,1.0101770413660272,25.766182576179386,90661930,0.08673099959665775,-0.9043789358456138,-0.9911099354422716
2025-08-19T13:55:00-04:00,329.84,330.64,329.82,330.41,NaN,NaN,NaN,332.18339801336646,NaN,NaN,333.0165999999997,339.2620070933917,326.7711929066077,328.6904171174493,334.11140260462474,337.428591204584,330.7942140046655,27786,57797.566666666666,44.9963892853102,37.58151804224276,NaN,NaN,NaN,NaN,0.996592966982739,24.952404598218667,90689716,0.1403514281418926,-0.8156706502649058,-0.9560220784067984
2025-08-19T14:00:00-04:00,330.4,330.47,329,329.38,NaN,NaN,NaN,332.18339801336646,NaN,NaN,332.8551999999997,339.0508836460659,326.65951635393344,328.6904171174493,334.0656290041891,337.3965935907217,330.73466441765646,52883,57022.7,38.78012960937315,37.332989608432776,NaN,NaN,NaN,NaN,1.0304077550554025,24.91122512751444,90636833,0.10958589723889678,-0.8190397068581774,-0.9286256040970742
2025-08-19T14:05:00-04:00,329.36,330.33,329.22,330.3,NaN,NaN,NaN,332.18339801336646,NaN,NaN,332.68139999999966,338.6627988466158,326.70000115338354,328.6904171174493,334.0442833687362,337.37972553642203,330.7088412010504,27073,56490.166666666664,45.9612478941853,38.10273093496853,NaN,NaN,NaN,NaN,1.036092915408585,24.872987047574803,90663906,0.1517363377666664,-0.7389551818887412,-0.8906915196554076
2025-08-19T14:10:00-04:00,330.32,330.32,329.4,329.4,NaN,NaN,NaN,332.18339801336646,NaN,NaN,332.50279999999964,338.3301847172034,326.6754152827959,328.6904171174493,334.01299843744397,337.3565979586354,330.66939891625253,37922,55806.2,40.906169929529405,38.884841884651486,NaN,NaN,NaN,NaN,1.0278005643079728,24.837480259059426,90625984,0.12088551487234056,-0.7395846260649819,-0.8604701409373224
2025-08-19T14:15:00-04:00,329.4,329.46,329.09,329.15,NaN,NaN,NaN,332.18339801336646,NaN,NaN,332.2983999999997,337.85878863409846,326.7380113659009,328.6904171174493,333.98492540512194,337.3386377376713,330.63121307257256,31064,55269.7,39.603159000392715,39.57839139743573,NaN,NaN,NaN,NaN,0.9808148097145466,25.086880918950445,90594920,0.08710212438974085,-0.7515924854501463,-0.8386946098398872
2025-08-19T14:20:00-04:00,329.15,329.65,329.1,329.62,NaN,NaN,NaN,332.18339801336646,NaN,NaN,332.09579999999966,337.2809261741882,326.9106738258111,328.6904171174493,333.9627371336863,337.32313244056405,330.6023418268085,26043,54054.63333333333,43.26225531873004,40.27967747354685,NaN,NaN,NaN,NaN,0.9500423233063614,25.012742992646665,90620963,0.09900183309783572,-0.7149423184675925,-0.8139441515654282
2025-08-19T14:25:00-04:00,329.53,329.9,329.34,329.72,NaN,NaN,NaN,332.18339801336646,NaN,NaN,331.90719999999965,336.7252772764893,327.08912272351,328.6904171174493,333.9490368094827,337.31284553671,330.58522808225547,16951,53449.96666666667,44.03909459606704,41.189538066053174,NaN,NaN,NaN,NaN,0.9221821573559071,24.54403508418168,90637914,0.11507284013998054,-0.6701031013904526,-0.7851759415304331
2025-08-19T14:30:00-04:00,329.64,330.13,329.61,330.02,NaN,NaN,NaN,332.18339801336646,NaN,NaN,331.71359999999964,336.01367536704385,327.41352463295544,328.6904171174493,333.92757721293276,337.2952088260044,330.5599455998611,28551,52759.7,46.40965798966893,42.05463863994405,NaN,NaN,NaN,NaN,0.8934548604019125,23.746700869007288,90666465,0.14541712590520905,-0.6034045341489218,-0.7488216600541309
2025-08-19T14:35:00-04:00,330.07,330.22,329.01,329.09,NaN,NaN,NaN,332.18339801336646,NaN,NaN,331.5197999999997,335.37937974942605,327.66022025057333,328.6904171174493,333.87824313368145,337.25984377854263,330.49664248882027,59585,53210.1,40.65955249104866,42.19266082711927,NaN,NaN,NaN,NaN,0.9160652275160642,23.670378675649133,90606880,0.10428976711280957,-0.618459451163119,-0.7227492182759285
2025-08-19T14:40:00-04:00,329.1,329.36,328.78,329.08,NaN,NaN,NaN,331.9803917198623,NaN,NaN,331.33539999999965,334.7352328432959,327.9355671567034,328.6904171174493,333.8452982808886,337.2385311088687,330.45206545290847,37419,52785.46666666667,40.6013007209547,42.11007979661461,NaN,NaN,NaN,NaN,0.8920605684077768,23.833839323268087,90569461,0.07899588349252384,-0.6240043639102737,-0.7030002474027975
2025-08-19T14:45:00-04:00,329.115,329.3,328.06,328.21,NaN,NaN,NaN,331.6271920962322,NaN,NaN,331.2005999999996,334.55058545704946,327.85061454294976,328.4034685958693,333.7889272163359,337.2078302283764,330.37002420429536,58425,53399.76666666667,35.79634730574783,41.65868306786088,NaN,NaN,NaN,NaN,0.9169133849500791,24.647430516555154,90511036,0.009888824059384627,-0.6906392173285667,-0.7005280413879513
2025-08-19T14:50:00-04:00,328.33,329.17,327.99,329.17,NaN,NaN,NaN,331.55413791003986,NaN,NaN,331.1326999999996,334.50685187010004,327.75854812989917,328.4034685958693,333.749071360921,337.1833297901377,330.3148129317043,44212,53106.833333333336,43.71223945440311,41.80427536064029,NaN,NaN,NaN,NaN,0.935705286025074,25.462744809075748,90555248,0.03370700723449738,-0.6583942823448297,-0.692101289579327
2025-08-19T14:55:00-04:00,329.17,329.38,328.85,329.07,NaN,NaN,NaN,331.55413791003986,NaN,NaN,331.0454999999996,334.40297777393897,327.68802222606024,328.4034685958693,333.7282404465228,337.16883573402464,330.287645159021,25025,52729.9,43.11590339363218,41.993032411494326,NaN,NaN,NaN,NaN,0.9067263370232811,25.830041862790903,90530223,0.04679679496115363,-0.633605295877885,-0.6804020908390387
2025-08-19T15:00:00-04:00,329.05,329.05,328.11,328.46,NaN,NaN,NaN,331.48980334365206,NaN,NaN,330.92529999999965,334.2133805407434,327.6372194592559,328.4034685958693,333.68910893232913,337.14597229976914,330.2322455648891,42445,53150.7,39.56968763217688,41.958081044372875,NaN,NaN,NaN,NaN,0.9105315986644739,26.825864072150036,90487778,0.019822376053071133,-0.6556241207726998,-0.675446496825771
2025-08-19T15:05:00-04:00,328.44,328.55,327.99,328.05,NaN,NaN,NaN,331.1239031916678,NaN,NaN,330.83929999999964,334.19800451846464,327.48059548153464,328.4034685958693,333.65384780829066,337.1274069440267,330.18028867255464,36362,53180.333333333336,37.346305959313725,41.411646521087405,NaN,NaN,NaN,NaN,0.8854936273312973,27.847559093729412,90451416,-0.018131114229890777,-0.6981103896131344,-0.6799792753832437
2025-08-19T15:10:00-04:00,328.09,328.78,328,328.7,NaN,NaN,NaN,331.1239031916678,NaN,NaN,330.7908999999996,334.2013766180757,327.38042338192355,328.4034685958693,333.63058201957006,337.11350296456993,330.1476610745702,25651,52370.833333333336,42.83069777851802,41.70097281888347,NaN,NaN,NaN,NaN,0.8779583682362028,28.347968223509245,90477067,0.006711559048799387,-0.6715898265722444,-0.6783013856210438
2025-08-19T15:15:00-04:00,328.68,328.8,328.45,328.47,NaN,NaN,NaN,331.1239031916678,NaN,NaN,330.7332999999996,334.2008637618438,327.2657362381554,328.4034685958693,333.6037807104131,337.096812778685,330.11074864214123,30313,52046.46666666667,41.448131647005496,41.37860737265635,NaN,NaN,NaN,NaN,0.8402470562193328,28.77268524481359,90446754,0.013436515939954985,-0.6615057406961,-0.674942256636055
2025-08-19T15:20:00-04:00,328.47,329.59,328.27,329.55,NaN,NaN,NaN,331.1239031916678,NaN,NaN,330.6844999999996,334.148622544374,327.2203774556252,328.23377487669546,333.567021189538,337.0689817045463,330.0650606745298,47459,51708.73333333333,49.664595189440526,42.00420917693571,NaN,NaN,NaN,NaN,0.8745151236322372,27.728545922728472,90494213,0.09202362090856919,-0.5599127305003435,-0.6519363514089127
2025-08-19T15:25:00-04:00,329.55,330.09,329.51,329.94,NaN,NaN,NaN,331.1239031916678,NaN,NaN,330.64189999999957,334.08916842044783,327.1946315795513,328.1389342930028,333.5305505447735,337.0345282441661,330.02657284538094,57097,50303.96666666667,52.26935119249506,42.908937190657305,NaN,NaN,NaN,NaN,0.8534783290870763,26.002826942652025,90551310,0.1672889337087945,-0.4428251842729196,-0.6101141179817141
2025-08-19T15:30:00-04:00,329.92,330.26,329.73,329.87,NaN,NaN,NaN,331.1239031916678,NaN,NaN,330.61169999999964,334.0590314958525,327.1643685041468,328.4341474344023,333.50402297137595,337.00844902435114,329.99959691840075,43515,47504.566666666666,51.75170118007815,43.515326180753604,NaN,NaN,NaN,NaN,0.8303727341522833,24.157427655203435,90507795,0.20678926878959314,-0.35162753199472263,-0.5584168007843158
2025-08-19T15:35:00-04:00,329.85,330.21,329.64,330.04,NaN,NaN,NaN,331.1239031916678,NaN,NaN,330.56889999999964,333.9903250192449,327.1474749807544,328.4643179475218,333.4802565868866,336.9848467200214,329.9756664537518,39654,45902.7,52.96985191179899,44.15323741759159,NaN,NaN,NaN,NaN,0.8117746817128341,22.574904687324246,90547449,0.23664706062592222,-0.262607975001913,-0.49925503562783524
2025-08-19T15:40:00-04:00,330.04,330.38,329.98,330.28,NaN,NaN,NaN,331.1239031916678,NaN,NaN,330.5212999999996,333.8908618769339,327.1517381230653,328.7834543580175,333.4559403645217,336.95873667182025,329.9531440572232,44301,45725.76666666667,54.70838837384115,44.7460038736039,NaN,NaN,NaN,NaN,0.78236220444763,21.081984932000704,90591750,0.26282376832534354,-0.1707253252211558,-0.43354909354649934
2025-08-19T15:45:00-04:00,330.27,330.45,330.145,330.3,NaN,NaN,NaN,331.1239031916678,NaN,NaN,330.47769999999963,333.800852244844,327.15454775515525,329.02026348641397,333.4288112495122,336.92868165805464,329.92894084096974,51580,44386.8,54.85814646021405,45.760189157115704,NaN,NaN,NaN,NaN,0.7482649041299426,19.806178942332924,90643330,0.2706821029579229,-0.09519646484909572,-0.3658785678070186
2025-08-19T15:50:00-04:00,330.31,330.58,329.04,329.22,NaN,NaN,NaN,331.1239031916678,NaN,NaN,330.3992999999996,333.6517255629546,327.1468744370446,329.02026348641397,333.37758820467343,336.88150952027564,329.8736668890712,81694,42036.76666666667,46.01083928852014,46.14658476908467,NaN,NaN,NaN,NaN,0.8048174109778012,19.71701093569778,90561636,0.19583051988586458,-0.12109041794968789,-0.3169209378355525
2025-08-19T15:55:00-04:00,329.27,329.85,329.13,329.32,NaN,NaN,NaN,331.1239031916678,NaN,NaN,330.3150999999996,333.4550047696769,327.17519523032223,329.02026348641397,333.3173296798566,336.8278765003152,329.80678285939797,94409,43119.933333333334,46.86533299297422,46.93722660388655,NaN,NaN,NaN,NaN,0.7987590244793888,19.634212072393716,90656045,0.14792031236260467,-0.13202054738229663,-0.2799408597449013
2025-08-20T09:30:00-04:00,329.23,331.37,327.53,329,327.7819161846485,327.7819161846485,327.7819161846485,NaN,NaN,NaN,330.23989999999964,333.3215453336493,327.15825466635,329.02026348641397,329.3,329.3,329.3,227065,49150.7,44.441378435013775,46.98930795964446,NaN,NaN,NaN,NaN,1.0159905227308632,21.07924317152769,90428980,0.09226741022180562,-0.16460659696764424,-0.25687400718944986
2025-08-20T09:35:00-04:00,329.07,330.75,328.94,329.82,326.73778688275485,NaN,NaN,NaN,NaN,NaN,330.1768999999996,333.15993395262547,327.1938660473737,329.02026348641397,329.52265817685503,329.7870755701367,329.25824078357334,161008,52688.86666666667,51.38088195686939,47.57966357130426,NaN,NaN,NaN,NaN,1.0727054853929445,22.421057763580663,90589988,0.10722079484846542,-0.1228480136288681,-0.23006880847733352
2025-08-20T09:40:00-04:00,329.84,329.86,327.19,327.34,326.73778688275485,NaN,NaN,NaN,NaN,NaN,330.0564999999996,333.0016276716889,327.11137232831027,329.02026348641397,329.18211187552396,329.8232925754793,328.54093117556863,125611,55399.26666666667,36.52278137981712,47.36202741042142,NaN,NaN,NaN,NaN,1.186797950722021,24.737313668449783,90464377,-0.04519771745984308,-0.28656595530213735,-0.24136823784229428
2025-08-20T09:45:00-04:00,327.32,327.32,323.6,323.65,NaN,NaN,NaN,329.1487003816222,329.1487003816222,329.1487003816222,329.8700999999995,333.20764070576956,326.5325592942295,329.02026348641397,327.5060642645464,329.6722426894711,325.33988583962173,324964,64739.2,24.95811899094481,46.477156912680776,NaN,NaN,NaN,NaN,1.3691695256704446,28.033151472410882,90139413,-0.37164802043837464,-0.7059282633902626,-0.33428024295188796
2025-08-20T09:50:00-04:00,323.68,323.68,319.3,319.855,NaN,NaN,NaN,325.60830490973024,NaN,NaN,329.62539999999956,333.93000304356093,325.3207969564382,329.02026348641397,325.5730465825013,329.0738997759271,322.07219338907555,350282,75211.63333333333,18.477876332405316,44.73766966652987,NaN,NaN,NaN,NaN,1.5842288452654125,31.746947716317646,89789131,-0.7959188076229023,-1.3291787524805159,-0.5332599448576135
2025-08-20T09:55:00-04:00,319.855,322.03,319.68,321.46,NaN,NaN,NaN,325.1065637774698,NaN,NaN,329.3905999999996,334.1467289472103,324.6344710527889,329.02026348641397,324.92538667558136,328.5314997435808,321.3192736075819,199038,80920.03333333334,27.098946183958518,43.712727847740794,NaN,NaN,NaN,NaN,1.6389267848893092,35.19547279994536,89988169,-0.912831158895817,-1.6742988934773848,-0.7614677345815678
2025-08-20T10:00:00-04:00,321.43,322.81,321.18,321.81,NaN,NaN,NaN,325.1065637774698,NaN,NaN,329.1497999999996,334.1891614518638,324.11043854813533,329.02026348641397,324.6733939908182,328.2229456529024,321.12384232873404,127646,83412.13333333333,28.86556660739477,42.227082949023234,NaN,NaN,NaN,NaN,1.6382891573972154,37.600601546464155,90115815,-0.9089790996527916,-1.8976916091475573,-0.9887125094947657
2025-08-20T10:05:00-04:00,321.8,322.12,318,319.19,NaN,NaN,NaN,324.7078298055045,NaN,NaN,328.87039999999956,334.5035322869797,323.23726771301943,328.6662107891312,324.03397033670984,327.73299661387324,320.33494405954644,227281,90085.73333333334,24.14808635187792,40.21842117469344,NaN,NaN,NaN,NaN,1.815554217583129,40.3096630503605,89888534,-1.017102893107297,-2.260091125878887,-1.24298823277159
2025-08-20T10:10:00-04:00,319.3,319.69,318.08,319,NaN,NaN,NaN,323.54111026889063,NaN,NaN,328.5923999999996,334.7501603852778,322.4346396147214,327.95896863130497,323.65495115998675,327.4577678531882,319.8521344667853,139612,93475.4,23.84375849215735,38.22499669698482,NaN,NaN,NaN,NaN,1.8008717734700492,42.82522016112139,89748922,-1.0323478474718435,-2.5334230421113944,-1.5010751946395509
2025-08-20T10:15:00-04:00,318.95,319.23,316.66,318.35,NaN,NaN,NaN,322.7399234384866,NaN,NaN,328.3133999999996,335.01410785533267,321.61269214466654,327.93717490504395,323.15003908892555,327.1138248547011,319.18625332315,187474,98689.06666666667,22.78580213543883,36.06899314153052,NaN,NaN,NaN,NaN,1.8558095039364737,45.335443425922115,89561448,-1.0155821749472609,-2.770552913323627,-1.754970738376366
2025-08-20T10:20:00-04:00,318.3,319.32,318.03,318.74,NaN,NaN,NaN,322.7399234384866,NaN,NaN,328.04879999999963,335.18194616718995,320.9156538328093,327.09873992403516,322.9453766454516,326.92772460624246,318.9630286846607,99712,101144.7,24.937840582975724,33.94252544218299,NaN,NaN,NaN,NaN,1.8153945393695843,47.5804092631198,89661160,-0.9109466583169639,-2.8936540612725707,-1.9827074029556069
2025-08-20T10:25:00-04:00,318.7,319.15,316.99,317.32,NaN,NaN,NaN,322.7399234384866,NaN,NaN,327.75039999999956,335.38773483373853,320.1130651662606,325.60399193922814,322.70808618385763,326.7435242259578,318.67264814175746,105327,104090.56666666667,22.481000352554176,31.62987214877871,NaN,NaN,NaN,NaN,1.8400092151288976,49.79383441936633,89555833,-0.8701549322167956,-3.0704010682266016,-2.200246136009806
2025-08-20T10:30:00-04:00,317.36,318.19,316.9,317.72,NaN,NaN,NaN,322.3326874496453,NaN,NaN,327.4657999999996,335.5058670048486,319.4257329951506,322.0451935513825,322.50953036166885,326.58696801544045,318.43209270789725,92071,106207.9,24.73053773380647,30.109850609156304,NaN,NaN,NaN,NaN,1.800722842619692,51.86015135334283,89647904,-0.7533862195955434,-3.1419789105042355,-2.388592690908692
2025-08-20T10:35:00-04:00,317.7,318.2,316.06,316.29,NaN,NaN,NaN,321.99188347466145,NaN,NaN,327.1838999999996,335.7649808854443,318.6028191145549,317.27015484110603,322.1769539771691,326.3506977303873,318.0032102239509,147784,109147.86666666667,22.245217062483476,28.351270899835534,NaN,NaN,NaN,NaN,1.824956925289713,53.88119444515962,89500120,-0.7101870178059948,-3.2763264631661855,-2.5661394453601907
2025-08-20T10:40:00-04:00,316.32,316.62,315.35,315.72,NaN,NaN,NaN,320.79907058944957,NaN,NaN,326.9208999999996,336.06663773746385,317.7751622625354,316.95269909830785,321.7965310501597,326.1103890674105,317.48267303290885,162159,113305.86666666667,21.325261724084413,26.700119706197718,NaN,NaN,NaN,NaN,1.7853171449118752,55.83972868113117,89337961,-0.6588624829157217,-3.3897175490048426,-2.730855066089121
2025-08-20T10:45:00-04:00,315.69,316.52,314.6,316.08,NaN,NaN,NaN,320.4170673808382,NaN,NaN,326.6654999999996,336.28256280537255,317.0484371946267,316.95269909830785,321.4312476594208,325.8549999525971,317.00749536624454,171620,117079.03333333334,23.477698713858757,24.707035188839818,NaN,NaN,NaN,NaN,1.7949373488467384,57.74069664360422,89509581,-0.5442835553572984,-3.411209510285744,-2.8669259549284454
2025-08-20T10:50:00-04:00,316.06,316.92,316.06,316.68,NaN,NaN,NaN,320.4170673808382,NaN,NaN,326.41269999999963,336.3949528941332,316.43044710586605,315.3741592786463,321.2803159703783,325.7162506744441,316.8443812663125,90957,118637.2,27.059467147005122,24.031084172210388,NaN,NaN,NaN,NaN,1.7281561096434008,59.0602734083194,89600538,-0.37950764499490974,-3.3413105111720824,-2.9618028661771727
2025-08-20T10:55:00-04:00,316.67,316.91,314.92,316.09,NaN,NaN,NaN,320.4170673808382,NaN,NaN,326.1598999999996,336.527387736308,315.7924122636912,313.6779295506669,321.0855361377736,325.5521965823872,316.61887569316,112002,121536.43333333333,25.781546486379227,24.08990042188427,NaN,NaN,NaN,NaN,1.7468592446688729,60.44695532248422,89488536,-0.2669851090422357,-3.2955342524799676,-3.028549143437732
2025-08-20T11:00:00-04:00,316.1,316.66,315.62,316.36,NaN,NaN,NaN,320.4170673808382,NaN,NaN,325.9046999999996,336.5914376519921,315.21796234800706,313.6779295506669,320.97126427030497,325.44639826905023,316.4961302715597,73291,122564.63333333333,27.469656786590065,24.73217045432604,NaN,NaN,NaN,NaN,1.6963692986210979,61.73458852849441,89561827,-0.1376208891704982,-3.200575254900855,-3.0629543657303566
2025-08-20T11:05:00-04:00,316.35,318.22,316.3,317.87,NaN,NaN,NaN,320.4170673808382,NaN,NaN,325.6676999999996,336.52963706676525,314.805762933234,314.0315270062746,320.82762247473767,325.2649667166542,316.3902782328211,133421,125799.93333333333,36.20842305637844,25.38284737378461,NaN,NaN,NaN,NaN,1.7123429201481635,61.26039030264454,89695248,0.07496545471224803,-2.9692475473400464,-3.0442130020522944
2025-08-20T11:10:00-04:00,317.9,318.69,317.38,318.44,NaN,NaN,NaN,320.4170673808382,NaN,NaN,325.43349999999964,336.40319320457127,314.463806795428,314.6842216050197,320.76597618191073,325.1697615794367,316.3621907843848,77375,127524.06666666667,39.18700384347201,26.120092890647268,NaN,NaN,NaN,NaN,1.6836041401375805,60.36842920153492,89772623,0.26841022079220744,-2.708700226062035,-2.9771104468542426
2025-08-20T11:15:00-04:00,318.47,319.65,318.46,319.48,NaN,NaN,NaN,320.4170673808382,NaN,NaN,325.21909999999957,336.2267460136849,314.21145398631427,315.8403772840157,320.72086259606505,325.0688023220032,316.3729228701269,98731,129804.66666666667,44.297508989004434,27.559337364727735,NaN,NaN,NaN,NaN,1.649775272984895,58.665655857149744,89871354,0.46909926325644324,-2.3907363677836884,-2.8598356310401316
2025-08-20T11:20:00-04:00,319.49,320.28,319.38,320.26,NaN,NaN,NaN,320.4170673808382,NaN,NaN,325.02189999999956,336.02456456648514,314.019235433514,316.78230182721256,320.68975974082923,324.94890163394166,316.4306178477168,149102,133192.76666666666,47.83803141035723,29.273214001742016,NaN,NaN,NaN,NaN,1.5962198963431151,56.54849426995635,90020456,0.6461466618819407,-2.0521523036877056,-2.6982989655696463
2025-08-20T11:25:00-04:00,320.23,320.4,319.3,320.03,NaN,NaN,NaN,320.4170673808382,NaN,NaN,324.82429999999954,335.82359488843,313.82500511156906,317.0518414617701,320.6721748996875,324.88460882430155,316.45974097507343,82679,134045.5,46.891564636132415,30.995054180362985,NaN,NaN,NaN,NaN,1.5607756180328902,54.47980859034818,89937777,0.733166279570808,-1.7818411161061363,-2.5150073956769443
2025-08-20T11:30:00-04:00,320,320.65,319.6,320.57,315.64793149074825,315.64793149074825,315.64793149074825,NaN,NaN,NaN,324.6388999999996,335.60623063067527,313.6715693693239,317.4464731694161,320.66362725445725,324.831078269571,316.4961762393435,80292,135271.4,49.42171748507027,32.74390253051259,NaN,NaN,NaN,NaN,1.524291645316252,52.33649059577598,90018069,0.8066650830284274,-1.50667604189141,-2.3133411249198375
2025-08-20T11:35:00-04:00,320.55,321.03,319.98,320.17,316.08825278662334,NaN,NaN,NaN,NaN,NaN,324.4340999999996,335.3450031139727,313.5231968860265,317.9421785355329,320.6576733485796,324.77916040227683,316.5361862948823,84385,136762.43333333332,47.61224161905723,34.53899119240567,NaN,NaN,NaN,NaN,1.4904136706508022,50.00474854991992,89933684,0.8060092164549304,-1.3058296043511746,-2.111838820806105
2025-08-20T11:40:00-04:00,320.21,320.99,320.13,320.46,316.2267412963223,NaN,NaN,NaN,NaN,NaN,324.2556999999996,335.128925098496,313.3824749015032,318.0897428284263,320.6560555522326,324.75204106485194,316.56007003961327,47899,136882.36666666667,49.06819255429081,36.27739510815455,NaN,NaN,NaN,NaN,1.4453841227471744,47.8395595073393,89981583,0.8011061509211277,-1.1104561321546953,-1.911562283075823
2025-08-20T11:45:00-04:00,320.46,320.83,319.57,319.65,316.2267412963223,NaN,NaN,NaN,NaN,NaN,324.04269999999957,334.85102368328194,313.2343763167172,318.0897428284263,320.64325905764235,324.6990382472424,316.5874798680423,79214,137803.5,45.28271169674218,37.92293043917302,NaN,NaN,NaN,NaN,1.432142399693804,46.182417129572286,89902369,0.7217727369936475,-1.0093463618337637,-1.7311190988274112
2025-08-20T11:50:00-04:00,319.67,319.67,317.87,318.26,316.2267412963223,NaN,NaN,NaN,NaN,NaN,323.81989999999956,334.6365731467002,313.00322685329894,318.0897428284263,320.5971273564233,324.6183324586952,316.5759222541514,91426,138127.9,39.63224713323326,39.23057225411223,NaN,NaN,NaN,NaN,1.4584179425728188,45.546035542480816,89810943,0.561287300217354,-1.0295099735557187,-1.5907972737730727
2025-08-20T11:55:00-04:00,318.1,318.54,317.49,318.17,316.2267412963223,NaN,NaN,NaN,NaN,NaN,323.60029999999955,334.42104090081773,312.77955909918137,318.0897428284263,320.54788206025245,324.54508014470525,316.55068397579964,80370,137659.93333333332,39.29038546186458,40.36004987896979,NaN,NaN,NaN,NaN,1.4292452323890468,45.12890757549651,89730573,0.44003393514979816,-1.040754854835825,-1.4807887899856231
2025-08-20T12:00:00-04:00,318.15,319.75,317.96,319.71,316.2267412963223,NaN,NaN,NaN,NaN,NaN,323.40209999999956,334.1372344827423,312.6669655172568,318.0897428284263,320.51858453758297,324.4790761290435,316.55809294612243,87766,133016.63333333333,47.61677692860136,41.82842914908381,NaN,NaN,NaN,NaN,1.4550134300755448,43.57003644554785,89818339,0.45274664001116127,-0.9148554899716714,-1.3676021299828327
2025-08-20T12:05:00-04:00,319.66,319.9,319.21,319.75,316.2267412963223,NaN,NaN,NaN,NaN,NaN,323.20269999999954,333.8308620632431,312.574537936756,318.0897428284263,320.5074436330141,324.4445628077512,316.57032445827696,52947,129414.6,47.81697163199923,43.40238808805667,NaN,NaN,NaN,NaN,1.4003696136415773,41.98660156813197,89871286,0.45200186425402467,-0.8025997996653018,-1.2546016639193265
2025-08-20T12:10:00-04:00,319.8,320.55,319.65,320.41,316.2267412963223,NaN,NaN,NaN,NaN,NaN,323.0104999999995,333.48503831930907,312.53596168069,318.0897428284263,320.5041641941149,324.42012340992255,316.5882049783072,46554,126779.36666666667,51.13533485269194,45.092793664206795,NaN,NaN,NaN,NaN,1.3646289269528957,39.93375105989714,89917840,0.4813979906235395,-0.6528541756399022,-1.1342521662634417
2025-08-20T12:15:00-04:00,320.36,321.41,320.28,321.41,316.7034807112481,NaN,NaN,NaN,NaN,NaN,322.85689999999954,333.19467943093446,312.5191205690646,318.522629267212,320.5145699478767,324.39253171470847,316.6366081810449,86595,118833.73333333334,55.72895579896459,46.48711743153438,NaN,NaN,NaN,NaN,1.3478697178848356,37.32092017419552,90004435,0.548745659301191,-0.448320092136953,-0.997065751438144
2025-08-20T12:20:00-04:00,321.44,321.85,321.095,321.44,317.416277042555,NaN,NaN,NaN,NaN,NaN,322.7040999999995,332.8942296734967,312.5139703265024,319.1626034137696,320.52808168699687,324.3799194394453,316.67624393454844,63734,109282.13333333333,55.86300644577674,47.67826047455615,NaN,NaN,NaN,NaN,1.305521880893061,34.75456599177814,90068169,0.5731963071147342,-0.2805703675447262,-0.8537666746594604
2025-08-20T12:25:00-04:00,321.44,322.08,321.09,321.76,317.5781508133479,NaN,NaN,NaN,NaN,NaN,322.57509999999957,332.6457648222729,312.50443517772624,319.4350827310156,320.5455660273357,324.36960138215943,316.721530672512,71153,105019.3,57.34660420228895,48.61033870407647,NaN,NaN,NaN,NaN,1.2829846036864143,32.549010166193945,90139322,0.5866788821203325,-0.12041807200904486,-0.7070969541293773
2025-08-20T12:30:00-04:00,321.77,321.9,320.84,321.16,317.5781508133479,NaN,NaN,NaN,NaN,NaN,322.41489999999953,332.31421401475393,312.51558598524514,319.4350827310156,320.55548421674115,324.3552718009899,316.7556966324924,60461,102779.8,53.70168984797215,49.02917144962039,NaN,NaN,NaN,NaN,1.2670571319945279,30.288402845089873,90078861,0.5325306921586113,-0.04143358893111326,-0.5739642810897245
2025-08-20T12:35:00-04:00,321.14,321.35,320.61,321.28,317.5781508133479,NaN,NaN,NaN,NaN,NaN,322.25909999999953,331.9781089393256,312.5400910606735,319.4350827310156,320.56042239840247,324.3426198751956,316.7782249216093,43710,96660.76666666666,54.32694085833499,49.56026975120629,NaN,NaN,NaN,NaN,1.2294101939949194,28.25956981428647,90122571,0.4835663593158149,0.030493668055044054,-0.4530726912607708
2025-08-20T12:40:00-04:00,321.29,321.38,320.68,321.21,317.5781508133479,NaN,NaN,NaN,NaN,NaN,322.11409999999955,331.67375432234115,312.55444567765795,319.4350827310156,320.5639898093186,324.333675590531,316.79430402810624,31487,93056.6,53.86991890585305,49.877998424119355,NaN,NaN,NaN,NaN,1.1915951801381386,26.347544193021623,90091084,0.4271904572509234,0.08091538030288348,-0.34627507694803994
2025-08-20T12:45:00-04:00,321.21,321.35,320.65,320.88,317.5781508133479,NaN,NaN,NaN,NaN,NaN,321.9706999999995,331.38387077518644,312.5575292248126,319.4350827310156,320.5665636155092,324.32411393439395,316.80901329662447,30578,87826.73333333334,51.66341108518715,50.167367671700056,NaN,NaN,NaN,NaN,1.1564812386997032,24.601239028018956,90060506,0.3515581990701041,0.09317267188959022,-0.2583855271805139
2025-08-20T12:50:00-04:00,320.86,321.46,320.65,321.15,317.5781508133479,NaN,NaN,NaN,NaN,NaN,321.8196999999995,331.03641230118126,312.60298769881774,319.4350827310156,320.5705174678179,324.3140305707616,316.82700436487426,36040,85704.33333333333,53.34713910064753,50.473006710725535,NaN,NaN,NaN,NaN,1.1317325787925818,22.86253062581301,90096546,0.3053105239257142,0.12325262772662882,-0.18205789619908536
2025-08-20T12:55:00-04:00,321.08,321.11,320.07,320.36,317.5781508133479,NaN,NaN,NaN,NaN,NaN,321.6574999999995,330.6838441659838,312.6311558340152,319.4350827310156,320.5699062404268,324.29336348393184,316.84644899692177,51221,83900.8,48.07088101045771,50.67216166170522,NaN,NaN,NaN,NaN,1.1280373945931106,21.844563899519258,90045325,0.2115623276175159,0.08239501332280952,-0.12916731429470638
2025-08-20T13:00:00-04:00,320.35,322.36,320.145,322.1,317.5781508133479,NaN,NaN,NaN,NaN,NaN,321.5084999999995,330.250263266231,312.766736733768,319.4350827310156,320.58729834423735,324.27928543398855,316.89531125448616,87943,83763.2,57.93839182023901,51.97974342506277,NaN,NaN,NaN,NaN,1.205677580693605,20.931531362890638,90133268,0.2539326563633508,0.18824850615948208,-0.06568415020386868
2025-08-20T13:05:00-04:00,322.1,322.21,321.42,321.86,318.0914092239434,NaN,NaN,NaN,NaN,NaN,321.3468999999995,329.75146040271017,312.9423395972888,319.4661061807612,320.5962757346815,324.2764081202756,316.9161433490874,35510,80020.73333333334,56.3479369404138,53.19813995924485,NaN,NaN,NaN,NaN,1.1759863249297737,20.08371543602121,90097758,0.2524605786643325,0.24989157312654697,-0.0025690055377855514
2025-08-20T13:10:00-04:00,321.86,321.99,321.125,321.23,318.0914092239434,NaN,NaN,NaN,NaN,NaN,321.1740999999995,329.2181556165931,313.1300443834059,319.4661061807612,320.60386623666574,324.2684445205373,316.9392879527942,44183,76088.2,52.29015385658114,53.531952596957694,NaN,NaN,NaN,NaN,1.1537730160062192,18.96430150548502,90053575,0.1981218011045193,0.24508324584286356,0.04696144473834427
2025-08-20T13:15:00-04:00,321.17,321.55,320.81,321.27,318.0914092239434,NaN,NaN,NaN,NaN,NaN,320.99869999999953,328.63389294076916,313.3635070592299,319.4661061807612,320.60816671004227,324.260076275305,316.95625714477956,35440,71548.86666666667,52.52392437803474,53.868163507388815,NaN,NaN,NaN,NaN,1.124217800577204,17.64315228676539,90089015,0.155802003877647,0.24171394958540304,0.08591194570775604
2025-08-20T13:20:00-04:00,321.29,321.89,320.89,320.99,318.0914092239434,NaN,NaN,NaN,NaN,NaN,320.81289999999956,327.9729760025777,313.6528239974214,319.4661061807612,320.6121417654229,324.25319356737384,316.97108996347197,30807,69543.86666666667,50.65294436495039,53.8337070439787,NaN,NaN,NaN,NaN,1.1153451005359751,16.71927659893698,90058208,0.10245718767384411,0.21398343030006117,0.11152624262621706
2025-08-20T13:25:00-04:00,320.96,321.28,320.8,321.06,318.0914092239434,NaN,NaN,NaN,NaN,NaN,320.62809999999956,327.2564152884224,313.99978471157675,319.4661061807612,320.61477175661105,324.2449444325704,316.9845990806517,30605,66830.63333333333,51.121706696731025,53.504617822390586,NaN,NaN,NaN,NaN,1.0699633076405457,15.753116841985577,90088813,0.06710118825948991,0.19540272795057945,0.12830153969108954
2025-08-20T13:30:00-04:00,321.06,322.8,321,322.62,318.33129036627304,NaN,NaN,NaN,NaN,NaN,320.49609999999956,326.6829102575327,314.30928974246643,320.12228887331185,320.6410139988785,324.24528290016656,317.0367450975905,88523,67338.36666666667,60.19628258686434,53.81413754675399,NaN,NaN,NaN,NaN,1.122108785666222,16.29718590495683,90177336,0.13980903252692448,0.3030628303497451,0.16325379782282065
2025-08-20T13:35:00-04:00,322.62,322.85,322.34,322.56,319.11895898598794,NaN,NaN,NaN,NaN,NaN,320.3608999999995,326.0455620623325,314.6762379376665,320.4528310986495,320.66210065573716,324.25239778164683,317.0718035298275,56470,64773.333333333336,59.73691071546102,53.98487372626628,NaN,NaN,NaN,NaN,1.0783867295472096,16.84251073148133,90120866,0.17273446667879686,0.3791718811713167,0.20643741449251987
2025-08-20T13:40:00-04:00,322.55,323.7,322.45,323.56,319.5865063048066,NaN,NaN,NaN,NaN,NaN,320.25209999999953,325.45940720841395,315.0447927915851,321.15726487891953,320.6875869201114,324.2691503176065,317.10602352261634,52006,63927.7,64.58740416252272,54.762424748734176,NaN,NaN,NaN,NaN,1.0906448202938375,17.99170881987661,90172872,0.24625207807522975,0.5142525120865571,0.26800043401132734
2025-08-20T13:45:00-04:00,323.54,324.06,323.5,323.71,320.373710563679,NaN,NaN,NaN,NaN,NaN,320.1298999999995,324.67844987473285,315.58135012526617,321.74581190313563,320.73118844856356,324.3057197315014,317.1566571656257,75711,63160.36666666667,65.26339703251095,55.54360018974675,NaN,NaN,NaN,NaN,1.0527416188442777,19.304095993462425,90248583,0.28655189255325675,0.6261902997028983,0.33963840714964155
2025-08-20T13:50:00-04:00,323.7,323.71,322.69,322.98,320.373710563679,NaN,NaN,NaN,NaN,NaN,320.0426999999995,324.1839429103834,315.90145708961563,321.74581190313563,320.7563661328604,324.3204448326189,317.19228743310197,56608,60077.23333333333,59.327868682187685,55.93345374519922,NaN,NaN,NaN,NaN,1.050402931783971,19.4477271374578,90191975,0.2471061987051324,0.648521155531057,0.40141495682592465
2025-08-20T13:55:00-04:00,322.91,323.08,322.45,322.75,320.373710563679,NaN,NaN,NaN,NaN,NaN,320.02469999999954,324.1105225172895,315.9388774827096,321.74581190313563,320.76706927557774,324.32461501869597,317.2095235324595,28925,58285.433333333334,57.55188520262247,56.35405903930174,NaN,NaN,NaN,NaN,1.0203741509422584,19.286314385913045,90163050,0.1910910005153763,0.640278707470145,0.44918770695476873
2025-08-20T14:00:00-04:00,322.72,323,320.55,321.23,320.373710563679,NaN,NaN,NaN,NaN,NaN,320.0521999999995,324.1515702739404,315.9528297260586,321.74581190313563,320.7814021434651,324.30960681823615,317.253197468694,95586,58795.23333333333,47.44396917909099,55.93240404490485,NaN,NaN,NaN,NaN,1.1224902830178105,18.56292500116942,90067464,0.04486644589006089,0.5052707643173449,0.46040431842728397
2025-08-20T14:05:00-04:00,321.24,322.03,320.95,321.99,320.373710563679,NaN,NaN,NaN,NaN,NaN,320.0627999999995,324.17938118379834,315.9462188162007,321.74581190313563,320.7885795406377,324.30317483993645,317.273984241339,45560,57501.066666666666,51.98480171258631,56.21196980934261,NaN,NaN,NaN,NaN,1.1194552628022516,17.89120628676462,90113024,-0.004832239126805027,0.4543640195187777,0.4591962586455827
2025-08-20T14:10:00-04:00,321.94,322.13,321.24,321.46,320.373710563679,NaN,NaN,NaN,NaN,NaN,320.0557999999995,324.1616496614948,315.94995033850427,321.74581190313563,320.79465771324544,324.29693317226315,317.29238225422773,41418,57285.03333333333,48.817185038884126,55.56045503924583,NaN,NaN,NaN,NaN,1.1030656011735185,17.16191404150332,90071606,-0.07373886457252687,0.36702267792992416,0.44076154250245103
2025-08-20T14:15:00-04:00,321.48,321.56,320.32,320.35,NaN,NaN,NaN,324.40793128063086,324.40793128063086,324.40793128063086,320.07899999999955,324.1781223454256,315.9798776545735,321.74581190313563,320.79419488030027,324.2806465447466,317.3077432158539,50935,56342.4,42.91877047699342,54.60122886328723,NaN,NaN,NaN,NaN,1.112846629661125,17.264571191681497,90020671,-0.1879186350167351,0.20586324873153217,0.3937818837482673
2025-08-20T14:20:00-04:00,320.32,321.04,320.03,320.5,NaN,NaN,NaN,323.98302531332945,NaN,NaN,320.1089999999995,324.19803949636287,316.0199605036362,321.74581190313563,320.79251027088407,324.2681683559364,317.31685218583175,35349,54473.166666666664,43.905137650502986,54.00229913428165,NaN,NaN,NaN,NaN,1.1055004418281908,17.584311762273746,90056020,-0.24365068242814736,0.08921853071308306,0.3328692131412304
2025-08-20T14:25:00-04:00,320.5,320.63,319.58,319.83,NaN,NaN,NaN,323.53947870817814,NaN,NaN,320.13859999999954,324.1975949695404,316.0796050304587,321.74581190313563,320.7859417125033,324.2476517621878,317.3242316628188,48321,53404.86666666667,40.53574461837455,53.14600058002021,NaN,NaN,NaN,NaN,1.1015361245547495,18.219912364686138,90007699,-0.3116024184848306,-0.056633809964807824,0.2549686085200228
2025-08-20T14:30:00-04:00,319.81,320.71,319.8,320.66,NaN,NaN,NaN,323.53947870817814,NaN,NaN,320.1769999999995,324.21863382841,316.135366171589,321.74581190313563,320.78366779860187,324.2355528103358,317.33178278686796,33109,51582.96666666667,46.058402121055174,52.81781899117055,NaN,NaN,NaN,NaN,1.0878549728008367,18.70651209452536,90040808,-0.28721437569170627,-0.10404936109461005,0.18316501459709622
2025-08-20T14:35:00-04:00,320.64,321.37,320.3,321.37,NaN,NaN,NaN,323.53947870817814,NaN,NaN,320.2579999999995,324.2290734068748,316.28692659312424,321.3486495225085,320.7852802555139,324.2250797192025,317.3454807918253,40762,51176.8,50.309764456953594,52.75982311690073,NaN,NaN,NaN,NaN,1.0865796176007765,18.33258733766147,90081570,-0.2132315099352713,-0.08337437282199289,0.1298571371132784
2025-08-20T14:40:00-04:00,321.36,322.1,321.36,321.99,NaN,NaN,NaN,323.53947870817814,NaN,NaN,320.3433999999995,324.2759464730721,316.4108535269269,320.87591961800683,320.79456938427626,324.2202296795345,317.368909089018,52765,51383.833333333336,53.73855923278382,52.298557163037835,NaN,NaN,NaN,NaN,1.0618239306292931,17.18127132964445,90134335,-0.11729946603081913,-0.016767195425245518,0.10053227060557361
2025-08-20T14:45:00-04:00,321.96,322.29,321.71,322.12,NaN,NaN,NaN,323.53947870817814,NaN,NaN,320.4599999999995,324.24795987344515,316.6720401265539,320.01173569440544,320.80471822879036,324.21822918002334,317.3912072775574,48133,50101.76666666667,54.44831869990462,51.92080059049808,NaN,NaN,NaN,NaN,1.0274079355843466,15.993415254809035,90182468,-0.04364232481142721,0.045979364591289595,0.08962168940271681
2025-08-20T14:50:00-04:00,322.09,322.22,321.77,321.85,NaN,NaN,NaN,323.53947870817814,NaN,NaN,320.58259999999956,324.1386760625635,317.0265239374356,320.16347523507164,320.8113379378267,324.216044574226,317.4066313014274,34440,49125.3,52.641858697658144,51.06754734300775,NaN,NaN,NaN,NaN,0.9861645116140394,14.890406042461862,90148028,-0.013235485954713105,0.07307733195932542,0.08631281791403853
2025-08-20T14:55:00-04:00,321.9,322,321.05,321.22,NaN,NaN,NaN,323.53947870817814,NaN,NaN,320.68539999999956,324.00414002638763,317.3666599736115,320.16347523507164,320.8141547905366,324.2112694802228,317.41704010085033,27472,47669.26666666667,48.59087870936849,49.87665317706901,NaN,NaN,NaN,NaN,0.9835813322130358,14.550681864056239,90120556,-0.03447526808375041,0.04321873280935051,0.07769400089310093
2025-08-20T15:00:00-04:00,321.19,321.89,321.19,321.69,NaN,NaN,NaN,323.53947870817814,NaN,NaN,320.7855999999995,323.91148460485687,317.6597153951421,320.16347523507164,320.8178415644745,324.2072951628937,317.42838796605537,28498,46603.833333333336,51.58423019764754,49.323536142459,NaN,NaN,NaN,NaN,0.9633255227692467,14.235223698393876,90149054,-0.01669472089999792,0.05682559976810353,0.07352032066810145
2025-08-20T15:05:00-04:00,321.65,321.85,321.26,321.43,NaN,NaN,NaN,323.53947870817814,NaN,NaN,320.8923999999995,323.71991780947053,318.06488219052846,320.16347523507164,320.8219291470412,324.2018258370274,317.442032457055,35455,46328.666666666664,49.85487062502357,48.77374938691622,NaN,NaN,NaN,NaN,0.9366594140000171,13.942298258850252,90113599,-0.02193791685764898,0.04609792459604023,0.06803584145368921
2025-08-20T15:10:00-04:00,321.42,322.94,321.41,322.7,NaN,NaN,NaN,323.53947870817814,NaN,NaN,321.0191999999995,323.5782086836294,318.4601913163696,320.62944745628533,320.8378689206286,324.20367351130506,317.4720643299521,63591,47398.8,57.37238753378792,49.482922126537424,NaN,NaN,NaN,NaN,0.9790408844285853,13.538774437650469,90177190,0.056353934614813125,0.13847825972220562,0.0821243251073925
2025-08-20T15:15:00-04:00,322.68,322.91,322.38,322.63,NaN,NaN,NaN,323.53947870817814,NaN,NaN,321.11439999999953,323.54883023370513,318.67996976629394,320.7965579650283,320.8536499597399,324.20888877351837,317.4984111459615,53855,48174.7,56.86635313777846,49.83160437119402,NaN,NaN,NaN,NaN,0.9469665355408312,13.164073746536383,90123335,0.09725563571649433,0.2036938697530104,0.10643823403651607
2025-08-20T15:20:00-04:00,322.62,323.63,322.58,323.57,320.0449986457795,320.0449986457795,320.0449986457795,NaN,NaN,NaN,321.2169999999995,323.62418674036735,318.8098132596316,321.4142463720226,320.87998903199286,324.22619474824984,317.5337833157359,68061,49242.066666666666,61.74580141998757,50.755076969844254,NaN,NaN,NaN,NaN,0.954326068716487,13.560372329185565,90191396,0.1768119553639516,0.3274531782414556,0.15064122287750398
2025-08-20T15:25:00-04:00,323.55,323.67,322.71,322.99,320.1381805255168,NaN,NaN,NaN,NaN,NaN,321.28719999999953,323.6923911863177,318.88200881368135,321.4173970976181,320.8972955411492,324.2363427887395,317.55824829355896,48343,49146.13333333333,57.42892097996,51.79151629148473,NaN,NaN,NaN,NaN,0.9547313495224549,13.967565357421915,90143053,0.17901992810055228,0.3744161330031943,0.19539620490264203
2025-08-20T15:30:00-04:00,322.94,323.65,322.65,323.59,320.1381805255168,NaN,NaN,NaN,NaN,NaN,321.3537999999995,323.82503900963354,318.8825609903655,321.4173970976181,320.9224744299003,324.2529423362881,317.59200652351257,66457,48429.933333333334,60.505099616418164,52.97722786047867,NaN,NaN,NaN,NaN,0.9579648245565652,14.253767738284301,90209510,0.2075285305771964,0.4548068681241375,0.24727833754694112
2025-08-20T15:35:00-04:00,323.6,323.95,323.3,323.36,320.6255115945308,NaN,NaN,NaN,NaN,NaN,321.4203999999995,323.92461072652253,318.9161892734765,321.78333414247555,320.9480200493689,324.27213722616176,317.623902872576,62495,49329.433333333334,58.75249294053124,54.27842416920414,NaN,NaN,NaN,NaN,0.9359673370882374,14.841206048517147,90147015,0.1975857297284762,0.4942604997075364,0.29667476997906017
2025-08-20T15:40:00-04:00,323.4,323.74,323.375,323.6,320.6425337947794,NaN,NaN,NaN,NaN,NaN,321.4809999999995,324.04587426648555,318.9161257335134,321.8166673139805,320.96138252237284,324.28227960601237,317.6404854387333,32739,48947.96666666667,60.05280288213781,55.27802422356719,NaN,NaN,NaN,NaN,0.8962553844390773,15.386684479447647,90179754,0.1936075164018371,0.5386841654813566,0.34507664907951946
2025-08-20T15:45:00-04:00,323.59,323.96,323.26,323.88,320.7320777131985,NaN,NaN,NaN,NaN,NaN,321.5551999999995,324.17807549130106,318.93232450869795,322.07133385118436,320.98078764359497,324.29786166343825,317.6637136237517,45873,49295.73333333333,61.57474254922563,56.08266551587234,NaN,NaN,NaN,NaN,0.882237142693428,16.14022994042159,90225627,0.19568777135707205,0.5896863632758595,0.3939985919187875
2025-08-20T15:50:00-04:00,323.88,324,323.22,323.85,320.756528726235,NaN,NaN,NaN,NaN,NaN,321.62299999999954,324.30374989558123,318.94225010441784,322.0990670809475,321.0165558433506,324.3261386282243,317.7069730584769,86616,51156.03333333333,61.305243861443834,56.62314298934806,NaN,NaN,NaN,NaN,0.8749344896438955,16.839950725611683,90139011,0.18122681865914964,0.6205321152427246,0.4393052965835749
2025-08-20T15:55:00-04:00,323.84,324.77,323.71,323.94,321.3716865114061,NaN,NaN,NaN,NaN,NaN,321.7087999999995,324.40602713963295,319.011572860366,322.719253664758,321.100013351446,324.40370491525437,317.7963217876377,180110,56139.53333333333,61.84477192841916,57.1514610770991,NaN,NaN,NaN,NaN,0.8881534546693317,18.300809938704855,90319121,0.16440129157674171,0.644806911054502,0.48040561947776034
2025-08-21T09:30:00-04:00,322.11,323.92,321.6,323.38,321.3716865114061,NaN,NaN,NaN,NaN,NaN,321.81119999999953,324.3616874519746,319.26071254802446,322.719253664758,322.96666666666664,322.96666666666664,322.96666666666664,163321,58632.8,56.560275092533644,57.431347962447354,NaN,NaN,NaN,NaN,0.9918567793358062,17.38478512465191,90155800,0.10511953173210353,0.6118050341428898,0.5066855024107862
2025-08-21T09:35:00-04:00,323.3,324.9,323.03,324.36,321.3716865114061,NaN,NaN,NaN,NaN,NaN,321.93499999999955,324.3645522226778,319.5054477773213,322.719253664758,323.59503791266087,324.15647275766065,323.0336030676611,204586,63570,62.5853812851562,58.43095528928933,NaN,NaN,NaN,NaN,1.0545812950975346,16.7674936641885,90360386,0.12037428911840187,0.6571533638087885,0.5367790746903867
2025-08-21T09:40:00-04:00,324.38,324.38,322.29,323.35,321.3716865114061,NaN,NaN,NaN,NaN,NaN,322.0077999999995,324.3838582153563,319.6317417846427,322.719253664758,323.54584479593996,324.0601753983025,323.03151419357744,87923,64767.23333333333,54.23615029453296,58.620378153352576,NaN,NaN,NaN,NaN,1.1285397740191374,15.712706719264311,90272463,0.05427590355203604,0.6046239541304317,0.5503480505783956
2025-08-21T09:45:00-04:00,323.4,323.63,321.07,322.71,NaN,NaN,NaN,325.81702651183963,325.81702651183963,325.81702651183963,322.0669999999995,324.3611813360828,319.7728186639162,322.719253664758,323.26678546902446,323.91352297169163,322.6200479663573,159646,67565.06666666667,49.710652846210806,58.61007688343737,NaN,NaN,NaN,NaN,1.2307869330177705,15.777869872781643,90112817,-0.035859239501578655,0.5055240012014224,0.541383240703001
2025-08-21T09:50:00-04:00,322.68,323.15,321.64,322.25,NaN,NaN,NaN,325.81702651183963,NaN,NaN,322.1037999999995,324.34899002375136,319.8586099762477,322.719253664758,323.15327988301505,323.83020448205536,322.4763552839747,86609,68565.1,46.69481055097411,57.84739281323639,NaN,NaN,NaN,NaN,1.2507307235165006,15.838378515333451,90026208,-0.12476621339105998,0.38542547396417604,0.510191687355236
2025-08-21T09:55:00-04:00,322.32,322.51,320.5,320.77,NaN,NaN,NaN,325.1758992073999,NaN,NaN,322.0909999999995,324.35904673736286,319.82295326263613,322.719253664758,322.90164723356725,323.80187875169634,322.00141571543816,107616,71188.13333333333,38.58414321545322,56.54152067592744,NaN,NaN,NaN,NaN,1.3049642432653212,16.723608265629796,89918592,-0.2730523938150706,0.16887619508639773,0.44192858890146836
2025-08-21T10:00:00-04:00,320.72,323,319.66,322.96,NaN,NaN,NaN,325.1758992073999,NaN,NaN,322.12139999999954,324.39447020630007,319.848329793699,322.719253664758,322.75151677066145,323.65922855012957,321.84380499119334,138423,72616.03333333334,51.898343521240555,55.83813082601694,NaN,NaN,NaN,NaN,1.4503239401749395,18.055558277782254,90057015,-0.2159497360702911,0.17199141881360447,0.3879411548838956
2025-08-21T10:05:00-04:00,322.96,323.49,322.25,323.37,NaN,NaN,NaN,325.1758992073999,NaN,NaN,322.15359999999947,324.4507661156486,319.85643388435034,322.719253664758,322.7760238844456,323.6475254434228,321.90452232546835,89148,74068.96666666666,53.91271747853564,55.586973433058056,NaN,NaN,NaN,NaN,1.4353008015910158,18.723651941292047,90146163,-0.14620999774570437,0.20517865770176513,0.3513886554474695
2025-08-21T10:10:00-04:00,323.38,323.77,322.75,322.75,NaN,NaN,NaN,325.1758992073999,NaN,NaN,322.1853999999995,324.4706578328929,319.9001421671061,322.719253664758,322.79872840622454,323.6420583675728,321.95539844487627,80855,75383.53333333334,50.47070861699829,54.87023121881378,NaN,NaN,NaN,NaN,1.4056364586202277,19.026135391932293,90065308,-0.1376044060291895,0.17938314791098264,0.31698755394017214
2025-08-21T10:15:00-04:00,322.76,323.96,322.65,323.77,NaN,NaN,NaN,325.1758992073999,NaN,NaN,322.2351999999995,324.54772672261095,319.92267327738807,321.7165223454451,322.839855198881,323.67200761171955,322.0077027860425,74152,76157.43333333333,55.50382118255041,54.638183236100865,NaN,NaN,NaN,NaN,1.3988052830044972,19.088403914975842,90139460,-0.0627930354424216,0.23849625963714516,0.30128929507956675
2025-08-21T10:20:00-04:00,323.73,324.48,323.54,324.13,NaN,NaN,NaN,325.1758992073999,NaN,NaN,322.2935999999995,324.6467417642725,319.9404582357265,321.7165223454451,322.8995653800961,323.75220980456885,322.0469209556233,61882,77041.86666666667,57.158545863592494,54.43145059191905,NaN,NaN,NaN,NaN,1.3660334770756044,18.56088307831112,90201342,0.007616558964914977,0.3108099937857105,0.3031934348207955
2025-08-21T10:25:00-04:00,324.2,324.48,323.29,324.19,NaN,NaN,NaN,325.1758992073999,NaN,NaN,322.3597999999995,324.7362662511633,319.9833337488357,320.90888350309353,322.9539247675498,323.8180941460744,322.0897553890252,66014,77631.63333333333,57.44260677686563,54.13629803675048,NaN,NaN,NaN,NaN,1.3534596572844895,18.286599115907244,90267356,0.05241355923053781,0.3687103838589678,0.31629682462843
2025-08-21T10:30:00-04:00,324.27,324.27,322.96,323.37,NaN,NaN,NaN,325.1758992073999,NaN,NaN,322.4041999999995,324.7715312913214,320.03686870867756,320.90888350309353,322.97821592411105,323.8320102480466,322.12442160017554,57769,78453.63333333333,52.335328565281095,53.49558980131029,NaN,NaN,NaN,NaN,1.3503553960498833,18.31414381285432,90209587,0.022529743645856748,0.3444590041857509,0.3219292605398942
2025-08-21T10:35:00-04:00,323.42,323.8,322.38,322.55,NaN,NaN,NaN,325.1758992073999,NaN,NaN,322.44799999999947,324.74233737774705,320.1536626222519,320.90888350309353,322.97591793532547,323.8152984223535,322.1365374482974,48037,78696.13333333333,47.76209456761176,52.48968427553833,NaN,NaN,NaN,NaN,1.35533001061775,18.80810273309407,90161550,-0.052647351355385064,0.25612007134566284,0.3087674227010479
2025-08-21T10:40:00-04:00,322.5,323.18,322.33,323.12,NaN,NaN,NaN,325.1758992073999,NaN,NaN,322.4683999999995,324.7681299325815,320.16867006741757,320.90888350309353,322.9719936983181,323.7948402963577,322.1491471002785,58702,78894.03333333334,50.96940722980198,52.090336571057506,NaN,NaN,NaN,NaN,1.3192350098593408,19.30645952917189,90220252,-0.06344594220434696,0.2294599949456142,0.29290593714996116
2025-08-21T10:45:00-04:00,323.12,323.6,322.45,322.63,NaN,NaN,NaN,325.1758992073999,NaN,NaN,322.4837999999995,324.77733139127355,320.1902686087255,320.90888350309353,322.96950345525084,323.7793375145267,322.159669395975,48539,78907.56666666667,48.228076748649755,51.064814818449904,NaN,NaN,NaN,NaN,1.3071467948693904,19.20338183296067,90171713,-0.10082937140401266,0.16686922289494532,0.267698594298958
2025-08-21T10:50:00-04:00,322.65,323.24,322.1,323.12,NaN,NaN,NaN,325.1758992073999,NaN,NaN,322.5215999999995,324.7934252051376,320.2497747948614,320.90888350309353,322.9645900845863,323.7614514280207,322.1677287411519,52101,79496.26666666666,51.062583736121354,50.83813149284907,NaN,NaN,NaN,NaN,1.2952077380930045,19.421519343660947,90223814,-0.09014484004178072,0.1550175442467321,0.2451623842885128
2025-08-21T10:55:00-04:00,323.07,323.53,322.86,323.27,NaN,NaN,NaN,325.1758992073999,NaN,NaN,322.56159999999954,324.81421576010445,320.30898423989464,320.90888350309353,322.9712495886486,323.7587062619558,322.1837929153414,42442,79995.26666666666,51.930215161895944,50.996671658255146,NaN,NaN,NaN,NaN,1.2505500425149296,19.226218604279754,90266256,-0.07138489039294324,0.15593127129733375,0.227316161690277
2025-08-21T11:00:00-04:00,323.31,323.6,322.72,322.84,NaN,NaN,NaN,325.1758992073999,NaN,NaN,322.5985999999995,324.8070854907259,320.39011450927313,320.90888350309353,322.9728986391048,323.75249031136644,322.1933069668432,33372,80157.73333333334,49.23537290330422,51.1781403977073,NaN,NaN,NaN,NaN,1.2240821823352914,19.18256071506348,90232884,-0.08539839697823035,0.12056816546748905,0.2059665624457194
2025-08-21T11:05:00-04:00,322.8,323,322.4,322.95,NaN,NaN,NaN,325.1758992073999,NaN,NaN,322.6363999999995,324.8025459237,320.47025407629906,320.90888350309353,322.9687698083904,323.74032111192923,322.19721850485155,36986,80208.76666666666,49.95088753700326,51.99005070638945,NaN,NaN,NaN,NaN,1.1795048835970579,19.455273611823685,90269870,-0.08456288114971,0.1002629610085819,0.1848258421582919
2025-08-21T11:10:00-04:00,322.97,323.01,321.24,321.44,NaN,NaN,NaN,325.1758992073999,NaN,NaN,322.61279999999954,324.8047052540312,320.42089474596787,320.90888350309353,322.925182199981,323.7099877025741,322.1403766973879,71965,80487.9,41.33755767758655,51.23570886041416,NaN,NaN,NaN,NaN,1.2216831061972668,20.664411540515083,90197905,-0.17765596433912548,-0.03724411326561494,0.14041185107351054
2025-08-21T11:15:00-04:00,321.37,322.23,321.11,322.1,NaN,NaN,NaN,325.1758992073999,NaN,NaN,322.6035999999995,324.800171001048,320.40702899895103,320.905445469628,322.8945504593909,323.6895790650306,322.09952185375124,50148,80364.33333333333,45.741553486682584,50.652054289567516,NaN,NaN,NaN,NaN,1.2144200271831767,21.880540809828304,90248053,-0.18585233608059887,-0.09190356902723806,0.0939487670533608
2025-08-21T11:20:00-04:00,322.08,322.64,321.49,322.48,NaN,NaN,NaN,325.1758992073999,NaN,NaN,322.5819999999995,324.7617027326583,320.40229726734066,320.905445469628,322.8755114516758,323.6676340596793,322.08338884367225,51557,79814.2,48.15489540411923,50.48663906007615,NaN,NaN,NaN,NaN,1.2098185966700912,22.36827677495821,90299610,-0.1578527772595509,-0.10336720452107784,0.05448557273847307
2025-08-21T11:25:00-04:00,322.5,322.61,321.57,321.87,NaN,NaN,NaN,325.1758992073999,NaN,NaN,322.5451999999995,324.70955945321856,320.38084054678046,320.905445469628,322.85895982080865,323.65224866822956,322.06567097338774,36782,79428.83333333333,44.71654110615503,49.71611905461934,NaN,NaN,NaN,NaN,1.1976886969079434,22.821174456864547,90262828,-0.17145380230389395,-0.15983168014139437,0.011622122162499582
2025-08-21T11:30:00-04:00,321.89,323.1,321.87,322.85,NaN,NaN,NaN,325.1758992073999,NaN,NaN,322.54259999999954,324.7051755391796,320.38002446081947,320.905445469628,322.85326054129195,323.63843352239326,322.06808756019063,44111,78683.96666666666,50.79508543064411,49.261586166551595,NaN,NaN,NaN,NaN,1.199996647128806,22.47944754902752,90306939,-0.1085554158032493,-0.12407214759156204,-0.015516731788312744
2025-08-21T11:35:00-04:00,322.81,323.08,322.73,322.9,NaN,NaN,NaN,325.1758992073999,NaN,NaN,322.5455999999995,324.7097336748576,320.38146632514145,320.905445469628,322.85388848798675,323.6341425327459,322.0736344432276,24799,77427.43333333333,51.090563769786144,48.80786880890306,NaN,NaN,NaN,NaN,1.1392826009053174,22.16212970603599,90331738,-0.06010892514044364,-0.0906528882138673,-0.030543963073423656
2025-08-21T11:40:00-04:00,322.94,323.19,322.7,322.76,NaN,NaN,NaN,325.1758992073999,NaN,NaN,322.5761999999995,324.70808701450505,320.444312985494,320.9791559662017,322.8543456827737,323.62852702421105,322.0801643413364,31189,77375.76666666666,50.1818922518344,48.65405192937116,NaN,NaN,NaN,NaN,1.0929052722692238,21.68931676339001,90300549,-0.0352486036298414,-0.0746047176107254,-0.039356113980884004
2025-08-21T11:45:00-04:00,322.8,322.86,322.01,322.05,NaN,NaN,NaN,325.1758992073999,NaN,NaN,322.5773999999995,324.7080329957606,320.4467670042384,320.9791559662017,322.8471564592962,323.61876184372824,322.0755510748641,26718,76737.26666666666,45.738980407605034,48.50954377508496,NaN,NaN,NaN,NaN,1.0755548956785665,22.003843615873397,90273831,-0.06277058481541858,-0.11781934500015723,-0.05504876018473864
2025-08-21T11:50:00-04:00,322.01,322.13,320.84,320.94,NaN,NaN,NaN,324.86533228355773,NaN,NaN,322.5669999999995,324.7242584459729,320.4097415540261,320.9791559662017,322.7903713156125,323.60149236896444,321.97925026226056,77725,76440.9,39.805457828725714,47.712118817865225,NaN,NaN,NaN,NaN,1.090872403130099,23.27642897227377,90196106,-0.14706602945255498,-0.23888129700043237,-0.09181526754787739
2025-08-21T11:55:00-04:00,321.01,321.48,320.66,321.24,NaN,NaN,NaN,324.4084989979415,NaN,NaN,322.58479999999946,324.6824567504647,320.4871432495342,320.9791559662017,322.75792701187146,323.5933982949785,321.9224557287644,42028,71838.16666666667,41.99558887427093,47.266941112552445,NaN,NaN,NaN,NaN,1.0715243743350913,24.58644630383325,90238134,-0.17220897538440613,-0.30707648677838506,-0.13486751139397893
2025-08-21T12:00:00-04:00,321.3,321.3,320.49,320.72,NaN,NaN,NaN,324.1922035889441,NaN,NaN,322.5891999999995,324.67020298958965,320.50819701040933,320.9791559662017,322.7100040930012,323.5877154393219,321.8322927466805,55132,68231.86666666667,39.32476128909506,46.42852522347914,NaN,NaN,NaN,NaN,1.052844061882585,25.925787160454654,90183002,-0.2108962315709381,-0.39848780085765156,-0.18759156928671347
2025-08-21T12:05:00-04:00,320.8,321.04,320.15,320.2,NaN,NaN,NaN,323.8636943349012,NaN,NaN,322.5965999999995,324.64060630200674,320.5525936979923,320.9791559662017,322.66594541379436,323.5891538338814,321.7427369937073,44212,62886.066666666666,36.80405344017446,45.34808510049903,NaN,NaN,NaN,NaN,1.041212343176689,27.41102663159745,90138790,-0.2555640739595757,-0.5070466617361831,-0.25148258777660737
2025-08-21T12:10:00-04:00,320.16,321.04,320.04,320.73,NaN,NaN,NaN,323.79648095604205,NaN,NaN,322.5979999999995,324.6367878758424,320.5592121241566,320.9791559662017,322.6345858572179,323.584877681261,321.68429403317487,34806,61115.5,40.95812317126868,44.75685297678221,NaN,NaN,NaN,NaN,1.0382686043783542,28.867707363281802,90173596,-0.23404784057996703,-0.5440423885015662,-0.30999454792159914
2025-08-21T12:15:00-04:00,320.77,321.4,320.74,321.3,NaN,NaN,NaN,323.79648095604205,NaN,NaN,322.5965999999995,324.63885213002783,320.5543478699712,320.9791559662017,322.6138322095771,323.5734715642938,321.65419285486036,32383,56873.4,45.13510674402929,44.41286863442692,NaN,NaN,NaN,NaN,1.0119637040656118,29.51310035154276,90205979,-0.16909047829074536,-0.5213576457850309,-0.3522671674942855
2025-08-21T12:20:00-04:00,321.32,321.37,320.9,321.15,NaN,NaN,NaN,323.79648095604205,NaN,NaN,322.5797999999995,324.65528544745996,320.5043145525391,320.9791559662017,322.601302415529,323.5663870785262,321.6362177525318,19907,54650,44.247957017138596,44.62075430153779,NaN,NaN,NaN,NaN,0.9732520109180699,30.11239384064222,90186072,-0.1258735568087594,-0.5096091135052347,-0.38373555669647536
2025-08-21T12:25:00-04:00,321.12,321.12,320.05,320.21,NaN,NaN,NaN,323.7117186451827,NaN,NaN,322.5415999999995,324.7174138161767,320.3657861838223,320.9791559662017,322.5693600356857,323.56176752090084,321.57695255047054,35459,52244.76666666667,39.06590659361174,44.14392238060416,NaN,NaN,NaN,NaN,0.9823054387096339,31.35640396336166,90150613,-0.1486776879975451,-0.5695826666934067,-0.42090497869586163
2025-08-21T12:30:00-04:00,320.2,320.8,320.09,320.25,NaN,NaN,NaN,323.52641325221987,NaN,NaN,322.5095999999995,324.7705554092506,320.2486445907484,320.6663247729614,322.53670073296195,323.5568072644159,321.516594201508,35996,48830.53333333333,39.39118931452074,43.517943374204265,NaN,NaN,NaN,NaN,0.9628550502303769,32.51155622017257,90186609,-0.1487869286543832,-0.6068886395138406,-0.45810171085945744
2025-08-21T12:35:00-04:00,320.26,320.8,319.8,320.57,NaN,NaN,NaN,323.3777126498462,NaN,NaN,322.49659999999955,324.7942426533773,320.1989573466218,319.73005981836906,322.4856936288461,323.5453099774217,321.4260772802705,58731,47816.63333333333,42.056102199510214,43.32791202372963,NaN,NaN,NaN,NaN,0.9655082609282071,33.80078749961719,90245340,-0.1164576636472775,-0.6036737904185543,-0.4872161267712768
2025-08-21T12:40:00-04:00,320.55,320.87,320.32,320.56,NaN,NaN,NaN,323.3777126498462,NaN,NaN,322.4739999999995,324.8245539778511,320.12344602214785,319.3897932810265,322.4747504000956,323.54106472666297,321.40843607352826,14301,45598.166666666664,41.993962547578896,42.69926038922497,NaN,NaN,NaN,NaN,0.935829099433336,34.83877000670864,90231039,-0.08628572370898513,-0.5950732814075081,-0.508787557698523
2025-08-21T12:45:00-04:00,320.55,320.79,320.03,320.3,NaN,NaN,NaN,323.3777126498462,NaN,NaN,322.4513999999995,324.8626171537815,320.04018284621753,319.3897932810265,322.4581403531455,323.5364110466732,321.3798696596178,19807,43786.666666666664,40.325643402694766,41.9303375058613,NaN,NaN,NaN,NaN,0.923269878045244,36.03120071002009,90211232,-0.07480536961413886,-0.6022942697161966,-0.5274889001020577
2025-08-21T12:50:00-04:00,320.31,321.06,320.24,320.95,NaN,NaN,NaN,323.3777126498462,NaN,NaN,322.4163999999995,324.8627156302393,319.9700843697597,319.3897932810265,322.4351297568557,323.5240655083534,321.34619400535803,34218,42864.53333333333,46.091624494729786,41.638175523210975,NaN,NaN,NaN,NaN,0.9158934581848689,36.50556537032155,90245450,-0.017397787898755013,-0.5492361349755015,-0.5318383470767465
2025-08-21T12:55:00-04:00,320.94,321.05,319.26,319.61,NaN,NaN,NaN,323.2206249737669,NaN,NaN,322.35599999999954,324.9243239676134,319.78767603238566,319.3897932810265,322.3952084812341,323.5191463853649,321.2712705771033,41870,42059.73333333333,37.95058180501748,41.08186133731186,NaN,NaN,NaN,NaN,0.978329639743094,37.707842873637965,90203580,-0.06117080788345386,-0.6083018569310639,-0.54713104904761
2025-08-21T13:00:00-04:00,319.64,320.13,319.27,320.09,NaN,NaN,NaN,322.743551111323,NaN,NaN,322.2863999999995,324.907428073619,319.66537192638003,319.3897932810265,322.3460943161294,323.5134100502123,321.17877858204645,50400,41814.1,41.90871259550717,41.2320938206534,NaN,NaN,NaN,NaN,0.9698775226185882,38.82424341243178,90253980,-0.04977964598783502,-0.6093556065324037,-0.5595759605445687
2025-08-21T13:05:00-04:00,320.05,320.45,320,320.37,NaN,NaN,NaN,322.743551111323,NaN,NaN,322.2339999999995,324.90102231012224,319.5669776898768,319.3897932810265,322.3240136251801,323.5044333342782,321.143593916082,28344,41157.666666666664,44.14692348514092,41.38576057857268,NaN,NaN,NaN,NaN,0.9327434138601168,39.14004525507275,90282324,-0.017059862007870796,-0.5809007880544073,-0.5638409260465365
2025-08-21T13:10:00-04:00,320.3,320.3,319.54,319.68,NaN,NaN,NaN,322.743551111323,NaN,NaN,322.15579999999954,324.88770070145006,319.42389929854903,319.0692686898614,322.2944007982235,323.4983365607112,321.09046503573575,32102,40271,40.05162220787446,41.43767921562835,NaN,NaN,NaN,NaN,0.9254045985843931,39.80813850994318,90250222,-0.03455118707941107,-0.6070299098958003,-0.5724787228163892
2025-08-21T13:15:00-04:00,319.65,319.8,318.85,318.98,NaN,NaN,NaN,322.26559512039466,NaN,NaN,322.06819999999954,324.91836403784436,319.2180359621547,319.0692686898614,322.2235675308203,323.50013921869913,320.9469958429414,63294,40762.833333333336,36.36597099676769,41.406387612527865,NaN,NaN,NaN,NaN,0.9271614129712213,40.906629101210676,90186928,-0.08315636588415243,-0.6764241801715798,-0.5932678142874274
2025-08-21T13:20:00-04:00,318.98,319.29,318.69,318.98,NaN,NaN,NaN,321.8787498876494,NaN,NaN,321.97579999999954,324.9193572769372,319.03224272306187,319.0692686898614,322.17235006464506,323.50164017412715,320.84305995516297,44311,40503.166666666664,36.36597099676769,41.07837674292066,NaN,NaN,NaN,NaN,0.9037927406161357,42.02727073931359,90186928,-0.10385324679316621,-0.7230843727788852,-0.6192311259857189
2025-08-21T13:25:00-04:00,319,319.41,318.68,319.41,NaN,NaN,NaN,321.8787498876494,NaN,NaN,321.8863999999996,324.8645115094201,318.9082884905791,319.0692686898614,322.1335385780732,323.4971162278647,320.76996092828176,36634,40309.566666666666,40.28109685280912,40.73166175069065,NaN,NaN,NaN,NaN,0.8913789734292702,42.79092089590516,90223562,-0.07829448455909316,-0.7170992316845854,-0.6388047471254923
2025-08-21T13:30:00-04:00,319.3,320.18,319.17,320.12,NaN,NaN,NaN,321.8787498876494,NaN,NaN,321.81179999999955,324.7762633650363,318.8473366349628,319.0692686898614,322.1009429451907,323.4820113312278,320.7198745591536,40602,40550.566666666666,46.170254852597516,40.86896873893771,NaN,NaN,NaN,NaN,0.8998519038986074,41.906318246771065,90264164,-0.007036019037160335,-0.6475997709219428,-0.6405637518847824
2025-08-21T13:35:00-04:00,320.16,320.89,320.09,320.52,NaN,NaN,NaN,321.8787498876494,NaN,NaN,321.74339999999955,324.6658116347068,318.8209883652923,319.0692686898614,322.07164125534524,323.4567375862996,320.6865449243909,53651,41106.066666666666,49.20913332879855,41.593484934308194,NaN,NaN,NaN,NaN,0.8927196250487076,39.90476030181099,90317815,0.0693632093706229,-0.5538597401715037,-0.6232229495421266
2025-08-21T13:40:00-04:00,320.65,321.05,320.57,321.05,NaN,NaN,NaN,321.8787498876494,NaN,NaN,321.69679999999954,324.5874731123778,318.8061268876213,319.1143962778358,322.04949254493766,323.43087332375956,320.66811176611577,55994,40573.7,52.995567289607145,42.565226218242934,NaN,NaN,NaN,NaN,0.8668110804023735,37.803513414787176,90373809,0.15311779807669956,-0.43182570194625214,-0.5849435000229517
2025-08-21T13:45:00-04:00,321.02,321.31,320.83,320.92,NaN,NaN,NaN,321.8787498876494,NaN,NaN,321.62799999999953,324.4240543633159,318.83194563668314,319.5215170222686,322.03565289687424,323.4128299719409,320.6584758218076,40706,40258.96666666667,51.972115651431594,43.27351289338018,NaN,NaN,NaN,NaN,0.839181717516491,35.46081233319124,90333103,0.19462338562882997,-0.3416642679869142,-0.5362876536157442
2025-08-21T13:50:00-04:00,320.88,321,320.33,320.63,NaN,NaN,NaN,321.8787498876494,NaN,NaN,321.57359999999954,324.33919942194336,318.8080005780557,319.5215170222686,322.0200440749383,323.39719087122035,320.6428972786563,34582,39693.13333333333,49.66779968041128,43.821644117153916,NaN,NaN,NaN,NaN,0.8270973091224569,33.91766914689139,90298521,0.1968179139976881,-0.29026526111863404,-0.48708317511632215
2025-08-21T13:55:00-04:00,320.66,321.11,320.59,320.86,NaN,NaN,NaN,321.8787498876494,NaN,NaN,321.53659999999957,324.28986892303175,318.7833310769674,319.5215170222686,322.0110832506288,323.38670730053354,320.6354592007241,23704,39257.2,51.50429339691872,44.62011911674133,NaN,NaN,NaN,NaN,0.8051617870422841,32.309097472312246,90322225,0.20699458859586217,-0.22833993937149444,-0.4353345279673566
2025-08-21T14:00:00-04:00,320.84,321.17,320.7,320.85,NaN,NaN,NaN,321.8787498876494,NaN,NaN,321.50859999999955,324.2607540949948,318.7564459050043,319.5968967154015,322.0031309041097,323.37697048491935,320.62929132330004,22384,38532.96666666667,51.41645134399582,45.000463891688916,NaN,NaN,NaN,NaN,0.7812216593964086,30.715736306599567,90299841,0.20585281785778342,-0.17801850564512733,-0.38387132350291076
2025-08-21T14:05:00-04:00,320.85,321.02,320.23,320.34,NaN,NaN,NaN,321.8787498876494,NaN,NaN,321.49999999999955,324.2639942117478,318.7360057882513,319.5968967154015,321.9888255049627,323.3635893450758,320.61406166484954,30484,38722.46666666667,47.01264151149771,45.647753870723214,NaN,NaN,NaN,NaN,0.781848683725234,29.850650036879227,90269357,0.16529870624596726,-0.1772479406954517,-0.34254664694141895
2025-08-21T14:10:00-04:00,320.28,320.58,319.86,320.47,NaN,NaN,NaN,321.8787498876494,NaN,NaN,321.45019999999954,324.1968502949068,318.70354970509226,319.5968967154015,321.97178309279525,323.34993403940996,320.59363214618054,32065,38751.666666666664,48.22984662659578,46.0992634443724,NaN,NaN,NaN,NaN,0.7774309206020008,29.483180342836278,90301422,0.14263417211688306,-0.1642539317953151,-0.3068881039121982
2025-08-21T14:15:00-04:00,320.38,320.63,320.17,320.51,NaN,NaN,NaN,321.8787498876494,NaN,NaN,321.3929999999996,324.0961218992966,318.6898781007026,319.5968967154015,321.9639315504882,323.3429084220314,320.584954678945,16303,38404.5,48.620938675857744,46.41883595799503,NaN,NaN,NaN,NaN,0.7547572834161421,29.04583267191786,90317725,0.12630190903189303,-0.14901071762233187,-0.2753126266542249
2025-08-21T14:20:00-04:00,320.5,320.92,320.36,320.88,NaN,NaN,NaN,321.8787498876494,NaN,NaN,321.3555999999995,324.0342210188417,318.67697898115733,319.5968967154015,321.9546028733649,323.33258467012206,320.5766210766077,24085,36616.5,52.21678650591514,47.28777626499794,NaN,NaN,NaN,NaN,0.7408460488864178,28.083293198319225,90341810,0.13556671644041524,-0.10585423110370584,-0.24142094754412108
2025-08-21T14:25:00-04:00,320.87,320.93,320.39,320.5,NaN,NaN,NaN,321.8787498876494,NaN,NaN,321.2901999999995,323.88829927495624,318.6921007250428,319.5968967154015,321.9467844361914,323.3245716653978,320.56899720698505,18737,35840.13333333333,48.4652261426485,48.15200877541799,NaN,NaN,NaN,NaN,0.7264999025373894,27.170193470508824,90323073,0.11221736339059016,-0.10114924330588337,-0.21336660669647353
2025-08-21T14:30:00-04:00,320.56,320.8,320.14,320.61,NaN,NaN,NaN,321.8787498876494,NaN,NaN,321.2197999999995,323.69409825254985,318.74550174744917,319.5968967154015,321.9373272889846,323.3154346496177,320.55921992835147,21504,34719.2,49.594180157250705,49.09688085830963,NaN,NaN,NaN,NaN,0.7217499094990062,26.68081212529611,90344577,0.10066498727688208,-0.08753537260037092,-0.188200359877253
2025-08-21T14:35:00-04:00,320.57,321.54,320.56,321.48,NaN,NaN,NaN,321.8787498876494,NaN,NaN,321.16559999999953,323.49155153916035,318.8396484608387,319.8242166500498,321.9271735681597,323.29856406214844,320.5557830741709,44994,34745.26666666667,57.52042204561152,50.32826122922409,NaN,NaN,NaN,NaN,0.7401963445347928,24.86095345384356,90389571,0.1453843110395464,-0.0064699710778199915,-0.1518542821173664
2025-08-21T14:40:00-04:00,321.45,321.6,320.97,321.09,NaN,NaN,NaN,321.8787498876494,NaN,NaN,321.11999999999955,323.35907123656085,318.88092876343825,319.9123733200398,321.9198146659002,323.2859372529754,320.55369207882507,34668,34740.666666666664,53.461959440198136,50.84909727119556,NaN,NaN,NaN,NaN,0.7323251770680216,23.09816965280328,90354903,0.14228776861059228,0.026005428645873963,-0.11628233996471832
2025-08-21T14:45:00-04:00,321.08,321.13,320.41,320.93,NaN,NaN,NaN,321.8787498876494,NaN,NaN,321.08759999999955,323.2895393639396,318.8856606360595,319.9123733200398,321.90779788275313,323.2712014399899,320.54439432551635,36916,34891.76666666667,51.84576780639626,51.03742830530968,NaN,NaN,NaN,NaN,0.7314448072774465,22.30047785877884,90317987,0.12373725354247447,0.03838922696337477,-0.0853480265790997
2025-08-21T14:50:00-04:00,320.97,321.59,320.83,321.52,NaN,NaN,NaN,321.8787498876494,NaN,NaN,321.0555999999995,323.18373217693204,318.927467823067,319.9123733200398,321.9006224695119,323.25732657987834,320.5439183591455,41155,35600.03333333333,57.00709600117821,51.32396607042191,NaN,NaN,NaN,NaN,0.7334844639004855,20.787282453805776,90359142,0.14405416210339733,0.09471967605014697,-0.049334486053250366
2025-08-21T14:55:00-04:00,321.46,322.14,321.17,321.91,319.2411059814255,319.2411059814255,319.2411059814255,NaN,NaN,NaN,321.0411999999995,323.1360074476225,318.9463925523765,320.2565351398604,321.8983225666134,323.24541370482694,320.55123142839983,49530,36069.066666666666,60.05490502039142,51.90130816820475,NaN,NaN,NaN,NaN,0.7503784307647344,20.021921205016675,90408672,0.17457551155091217,0.16888490338538986,-0.005690608165522318
2025-08-21T15:00:00-04:00,321.9,322.37,321.8,321.95,319.703101164088,NaN,NaN,NaN,NaN,NaN,321.0177999999995,323.04422262191906,318.99137737807996,320.57822811188834,321.9000933636473,323.2388320565941,320.56135467070044,43782,36328.6,60.365251726893504,52.66541188581062,NaN,NaN,NaN,NaN,0.7374942571386816,19.616109001020703,90452454,0.18715875204105675,0.22825783188579862,0.04109907984474187
2025-08-21T15:05:00-04:00,321.94,322.35,321.71,322.2,319.703101164088,NaN,NaN,NaN,NaN,NaN,320.99639999999954,322.94846868795685,319.04433131204223,320.59658248951064,321.9016961013231,323.2347834447337,320.56860875791256,30352,35382.63333333333,62.33489495156655,53.439026282571184,NaN,NaN,NaN,NaN,0.7305303816287788,19.07913061463851,90482806,0.2008142358437905,0.29211687464948,0.0913026388056895
2025-08-21T15:10:00-04:00,322.22,322.46,322,322.44,319.9136830854603,NaN,NaN,NaN,NaN,NaN,320.9883999999995,322.91327032358373,319.06352967641527,320.8272659916085,321.90507380588974,323.2329990392115,320.577148572568,30219,35913.23333333333,64.17544722405049,54.35038313114651,NaN,NaN,NaN,NaN,0.7112067829410075,18.73848654980275,90513025,0.21333006505434216,0.3579652201236172,0.14463515506927505
2025-08-21T15:15:00-04:00,322.46,322.59,322.1,322.21,320.0671520361213,NaN,NaN,NaN,NaN,NaN,320.9735999999995,322.84864777606816,319.0985522239309,321.0388127932868,321.90977808235743,323.23046580720097,320.5890903575139,42959,36684.96666666667,61.09431017449999,55.35621660707524,NaN,NaN,NaN,NaN,0.6954062984452178,18.612097095886764,90470066,0.1939949560318544,0.38712885010909304,0.19313389407723863
2025-08-21T15:20:00-04:00,322.23,322.46,321.87,322.35,320.0671520361213,NaN,NaN,NaN,NaN,NaN,320.9917999999995,322.90194005835656,319.08165994164244,321.0388127932868,321.91295501448,323.2273850271662,320.59852500179386,36522,36761.76666666667,62.28139729017901,56.35989879733119,NaN,NaN,NaN,NaN,0.6878772771277005,18.028353157163806,90506588,0.17888025621139989,0.4167342143414885,0.2378539581300886
2025-08-21T15:25:00-04:00,322.38,322.47,321.92,322.04,320.0671520361213,NaN,NaN,NaN,NaN,NaN,320.9905999999995,322.89802721027974,319.0831727897193,321.0388127932868,321.9145302164922,323.22459640343095,320.60446402955347,25080,36202.1,58.0572026670493,57.03391765384487,NaN,NaN,NaN,NaN,0.6780289001900084,17.5029819095126,90481508,0.13807751165071513,0.4104508476934825,0.27237333604276737
2025-08-21T15:30:00-04:00,322.04,322.1,321.73,321.84,320.0671520361213,NaN,NaN,NaN,NaN,NaN,320.9777999999995,322.8534003419273,319.1021996580717,321.0388127932868,321.9142029319209,323.21550329924054,320.61290256460126,49601,36175.46666666667,55.44445955367335,57.26446572868473,NaN,NaN,NaN,NaN,0.6560268358907224,16.614818382640653,90431907,0.09001818204084877,0.38489606359382833,0.29487788155297956
2025-08-21T15:35:00-04:00,321.86,322.07,321.5,321.64,320.0671520361213,NaN,NaN,NaN,NaN,NaN,320.9731999999995,322.841137644181,319.105262355818,321.0388127932868,321.91259490745,323.20809783193556,320.61709198296444,33980,36363.333333333336,52.88157147501747,57.57991896671109,NaN,NaN,NaN,NaN,0.6498820618985274,15.53075979214713,90397927,0.03972474533232884,0.3445338132183906,0.30480906788606177
2025-08-21T15:40:00-04:00,321.61,321.9,321.31,321.51,320.0671520361213,NaN,NaN,NaN,NaN,NaN,320.9463999999995,322.7429467326291,319.14985326736996,321.0388127932868,321.9097255928266,323.2001125643113,320.61933862134185,32000,36359.933333333334,51.22410813258926,57.696342393520986,NaN,NaN,NaN,NaN,0.6456047717629164,14.891744513758292,90365927,-0.004955825628468358,0.29861428585047634,0.3035701114789447
2025-08-21T15:45:00-04:00,321.53,321.55,321.11,321.47,320.0671520361213,NaN,NaN,NaN,NaN,NaN,320.9177999999995,322.6327100975279,319.2028899024711,321.0388127932868,321.90535868435296,323.1913472217374,320.61937014696855,31252,35291.86666666667,50.69757213998939,57.20899597169084,NaN,NaN,NaN,NaN,0.6309187166369936,14.671265400335143,90334675,-0.038021246644243556,0.25604355317364025,0.2940647998178838
2025-08-21T15:50:00-04:00,321.46,321.98,320.96,321.13,320.0671520361213,NaN,NaN,NaN,NaN,NaN,320.8851999999995,322.5188376105696,319.25156238942935,321.0388127932868,321.89664037891646,323.1742150585359,320.61906569929704,61594,35867.96666666667,46.33753494873827,56.700108508015134,NaN,NaN,NaN,NaN,0.6587102368772112,13.69506375194712,90273081,-0.0811318137229664,0.1926500326641758,0.2737818463871422
2025-08-21T15:55:00-04:00,321.1,321.13,320,320.13,NaN,NaN,NaN,322.76583683036785,322.76583683036785,322.76583683036785,320.8467999999995,322.4592388492473,319.23436115075174,321.0388127932868,321.8364049570383,323.1212916795273,320.55151823454935,164854,40141.96666666667,36.41739722615949,55.598082037998225,NaN,NaN,NaN,NaN,0.6923737913859815,14.203227897760778,90108227,-0.1702132988889538,0.06101522277594995,0.23122852166490376
2025-08-22T09:30:00-04:00,321.67,322.61,319.69,321.38,NaN,NaN,NaN,322.76583683036785,NaN,NaN,320.85559999999947,322.47476600838036,319.2364339916186,321.0388127932868,321.22666666666663,321.22666666666663,321.22666666666663,147921,43719.26666666667,50.64192060958311,55.14342665288429,NaN,NaN,NaN,NaN,0.8514899491441269,13.979830313955786,90256148,-0.13946097212621056,0.056902306507140565,0.19636327863335112
2025-08-22T09:35:00-04:00,321.58,323.36,321.295,322.87,319.6605185078673,319.6605185078673,319.6605185078673,NaN,NaN,NaN,320.8881999999995,322.5999976056491,319.17640239434985,320.9662401877036,321.9006624528159,322.54063714981993,321.26068775581183,164066,47399.76666666667,61.65421855531865,55.25766333395052,NaN,NaN,NaN,NaN,0.9381692384909748,14.572082862976648,90420214,-0.01957712231625966,0.17189187573802656,0.19146899805428622
2025-08-22T09:40:00-04:00,322.87,324.95,322.6,324.74,320.90879039387335,NaN,NaN,NaN,NaN,NaN,320.96859999999947,322.9907375231868,318.94646247681214,321.07436401293586,322.8154800987861,324.00333567015804,321.6276245274142,222771,52959,70.53837849006072,55.98431524560532,NaN,NaN,NaN,NaN,1.0390142928844741,16.361616917833246,90642985,0.17418346234194687,0.4091983259817198,0.23501486363977292
2025-08-22T09:45:00-04:00,324.8,325.93,324.14,325.77,322.0549817396063,NaN,NaN,NaN,NaN,NaN,321.0799999999995,323.4958675465989,318.66413245340004,321.9344912103487,323.4721190181261,324.96281793089736,321.9814201053548,194229,58076.433333333334,74.09806163881457,56.824541437551616,NaN,NaN,NaN,NaN,1.0926561291070132,18.579930722159183,90837214,0.3500874661996958,0.6726241963893926,0.32253673018969686
2025-08-22T09:50:00-04:00,325.82,326.63,325.58,326.511,323.117255296897,NaN,NaN,NaN,NaN,NaN,321.1956199999995,324.04742731203777,318.34381268796125,322.9085929682789,324.1691212909031,325.9315923898754,322.4066501919308,245318,65100.96666666667,76.31518734461078,57.69166573187734,NaN,NaN,NaN,NaN,1.0896092627422274,20.97900991674246,91082532,0.48633690760717607,0.930457864698667,0.4441209570914909
2025-08-22T09:55:00-04:00,326.53,326.63,324.62,325.72,323.117255296897,NaN,NaN,NaN,NaN,NaN,321.2840199999995,324.4046411306583,318.16339886934065,322.9085929682789,324.3619902749689,326.08049448240786,322.6434860675299,145143,69148.93333333333,69.47841794799204,58.29053057284107,NaN,NaN,NaN,NaN,1.1553514582606392,21.927525877116736,90937389,0.49171209549032924,1.0587610764544024,0.5670489809640732
2025-08-22T10:00:00-04:00,325.75,334.04,325.68,332.23,325.7360631940735,NaN,NaN,NaN,NaN,NaN,321.50561999999957,325.87889924387605,317.1323407561231,326.6742994996985,326.25759315204436,329.4808241178548,323.0343621862339,483113,84506.56666666667,82.9870048916587,59.76950254437533,NaN,NaN,NaN,NaN,1.669969211242023,25.13047182965335,91420502,0.8795881126931143,1.6665341218304661,0.7869460091373518
2025-08-22T10:05:00-04:00,332.33,335.28,331.85,334.26,329.1607875943429,NaN,NaN,NaN,NaN,NaN,321.7866199999996,327.41595153978415,316.157288460215,327.67243959975883,327.6028440761295,331.7098674281965,323.49582072406247,348064,95092.56666666667,85.18842909046285,61.707447288904866,NaN,NaN,NaN,NaN,1.7956856961533034,28.298864861313866,91768566,1.198967244550159,2.2856550648250504,1.0866878202748915
2025-08-22T10:10:00-04:00,334.27,335.68,333.6,335.23,330.1523427036909,NaN,NaN,NaN,NaN,NaN,322.08621999999957,328.8389523454159,315.3334876545832,328.5539516798071,328.5516682030469,333.0924341498862,324.01090225620766,294479,103839.7,86.11310289855189,63.89806467068191,NaN,NaN,NaN,NaN,1.8159938607137804,31.30118458236346,92063045,1.3882920613135508,2.82205289691683,1.4337608356032792
2025-08-22T10:15:00-04:00,335.18,337.45,334.75,335.09,331.44814530806866,NaN,NaN,NaN,NaN,NaN,322.37661999999955,330.032076562798,314.7211634372011,330.39916134384566,329.4918863512326,334.3731717550663,324.6106009473989,336587,114515.83333333333,85.28553469608444,66.2126334721867,NaN,NaN,NaN,NaN,1.879137156377081,34.33569954498193,91726458,1.4121748279398967,3.19897937052815,1.7868045425882533
2025-08-22T10:20:00-04:00,335.14,335.62,332.39,334.09,331.44814530806866,NaN,NaN,NaN,NaN,NaN,322.64721999999955,330.9553708633934,314.3390691366057,330.39916134384566,329.84675809687184,334.6893597376326,325.00415645611105,218835,121007.5,79.414797524705,68.2262541430521,NaN,NaN,NaN,NaN,1.975627359493005,35.37601938899308,91507623,1.2730079256248161,3.3780644496192735,2.1050565239944574
2025-08-22T10:25:00-04:00,334.15,335.48,333.44,334.72,331.44814530806866,NaN,NaN,NaN,NaN,NaN,322.9356199999995,331.87497560009524,313.9962643999038,330.39916134384566,330.06238281591055,334.89372074433453,325.2310448874866,134662,124871.66666666667,80.3332871815701,70.34309093173644,NaN,NaN,NaN,NaN,1.980225405243506,36.342030672717726,91642285,1.1400613580533379,3.5301332215611296,2.3900718635077918
2025-08-22T10:30:00-04:00,334.81,336.12,334.63,335.86,331.44814530806866,NaN,NaN,NaN,NaN,NaN,323.2338199999995,332.8569244114107,313.61071558858833,330.39916134384566,330.32099937395753,335.177743928879,325.46425481903606,145540,129006.2,81.9065107334759,72.8837320592177,NaN,NaN,NaN,NaN,1.9452093048689705,37.39633474729007,91787825,1.0479314326484146,3.69998615431831,2.6520547216698955
2025-08-22T10:35:00-04:00,335.9,336.81,335.6,336.65,331.44814530806866,NaN,NaN,NaN,NaN,NaN,323.57461999999947,333.845379714117,313.30386028588197,331.2412964864392,330.58363646503653,335.4903997481352,325.6768731819379,140235,132180.9,82.92581882564924,76.20576217346697,NaN,NaN,NaN,NaN,1.8926943545211856,38.54176086031793,91928060,0.9614895606850178,3.853916672526168,2.89242711184115
2025-08-22T10:40:00-04:00,336.68,337.7,336.07,337.21,332.0260248366256,NaN,NaN,NaN,NaN,NaN,323.9170199999995,334.82215800742506,313.011881992574,332.43003718915134,330.9404665507229,335.93003901059603,325.9508940908497,189883,137354.73333333334,83.6298337316378,78.56204168218515,NaN,NaN,NaN,NaN,1.8739304720553864,39.81186950827444,92117943,0.8662747843133567,3.975270592232846,3.1089958079194893
2025-08-22T10:45:00-04:00,337.28,337.65,336.19,336.34,332.08279643496076,NaN,NaN,NaN,NaN,NaN,324.2364199999995,335.6317653662863,312.8410746337127,332.70402975132106,331.1294322040644,336.14345958491356,326.1154048232153,115152,139962.6,78.23289742006811,79.74623302966725,NaN,NaN,NaN,NaN,1.8443640097657144,40.99125610994835,92002791,0.6773189626083385,3.955644511179912,3.2783255485715737
2025-08-22T10:50:00-04:00,336.32,336.73,335.76,336.23,332.08279643496076,NaN,NaN,NaN,NaN,NaN,324.5674199999995,336.3683713115243,312.76646868847473,332.70402975132106,331.27292524316454,336.28763604170604,326.25821444462304,101862,141986.16666666666,77.55144728374336,80.24716651493031,NaN,NaN,NaN,NaN,1.7819094376395939,41.71103621166531,91900929,0.4864711237407269,3.8864144532474825,3.3999433295067556
2025-08-22T10:55:00-04:00,336.26,336.72,335.84,336.18,332.08279643496076,NaN,NaN,NaN,NaN,NaN,324.9114199999995,337.03906313529325,312.78377686470577,332.7265790408455,331.41580081777937,336.42730315749037,326.40429847806837,107296,143911.7,77.222179889036,80.47031781851754,NaN,NaN,NaN,NaN,1.7174873349510553,42.37940344897391,91793633,0.30716225797968866,3.7838961519813665,3.476733894001678
2025-08-22T11:00:00-04:00,336.19,337.19,336.045,337.05,332.08279643496076,NaN,NaN,NaN,NaN,NaN,325.2728199999995,337.7440011258221,312.80163887417694,333.4227632326764,331.6264249254505,336.6471059949592,326.60574385594185,153199,147558.93333333332,78.90082262346235,80.65500605272123,NaN,NaN,NaN,NaN,1.67659538245455,43.142885380244344,91946832,0.20249762984561048,3.729855931308691,3.5273583014630807
2025-08-22T11:05:00-04:00,337.02,337.13,336.24,336.36,332.17433441819037,NaN,NaN,NaN,NaN,NaN,325.6118199999995,338.34582592244834,312.8778140775507,333.6712105861411,331.73967459559594,336.757477395702,326.7218717954899,91039,149581.83333333334,74.22851519076326,80.99429871291917,NaN,NaN,NaN,NaN,1.6204099979935098,43.8518328878526,91855793,0.05008816789874171,3.589968511336508,3.5398803434377664
2025-08-22T11:10:00-04:00,336.36,336.909,336.26,336.41,332.190364671909,NaN,NaN,NaN,NaN,NaN,325.9376199999995,338.9239810232032,312.9512589767958,333.81746846891286,331.84356204618354,336.8553847521389,326.8317393402282,88283,151517.3,74.34706273885095,80.37715998771863,NaN,NaN,NaN,NaN,1.551023569565402,44.510141287774545,91944076,-0.0771463649121591,3.4434473872975673,3.5205937522097264
2025-08-22T11:15:00-04:00,336.42,336.69,336.07,336.41,332.190364671909,NaN,NaN,NaN,NaN,NaN,326.2554199999995,339.47159176708107,313.03924823291794,333.9067747751303,331.96709464244833,336.96531845907055,326.9688708258261,113611,153872.36666666667,74.34706273885095,79.6027766768892,NaN,NaN,NaN,NaN,1.4845218860250164,44.90035853194718,91944076,-0.18494694642523024,3.2894100691781887,3.474357015603419
2025-08-22T11:20:00-04:00,336.41,336.54,335.24,335.35,332.190364671909,NaN,NaN,NaN,NaN,NaN,326.5414199999995,339.91262829308295,313.17021170691606,333.9067747751303,332.0526314601729,337.02497099813036,327.08029192221545,97790,155914.63333333333,66.79286365053137,78.22275958774489,NaN,NaN,NaN,NaN,1.4713417513089446,44.33223052473309,91846286,-0.34214081129304263,3.0466810014871157,3.3888218127801584
2025-08-22T11:25:00-04:00,335.35,335.78,335.1,335.53,332.190364671909,NaN,NaN,NaN,NaN,NaN,326.8336199999995,340.3385533380434,313.32868666195554,333.9067747751303,332.12615868199356,337.0696458287872,327.1826715351999,94092,158215.03333333333,67.39863909338953,76.9451241875524,NaN,NaN,NaN,NaN,1.4148173405011593,43.65274140458241,91940378,-0.4421393558628841,2.8361476179515535,3.2782869738144376
2025-08-22T11:30:00-04:00,335.53,336.33,335.52,336.1,332.190364671909,NaN,NaN,NaN,NaN,NaN,327.14301999999947,340.7735292641851,313.51251073581386,333.9067747751303,332.230698911108,337.1467976149195,327.3146002072965,121827,160622.56666666668,69.30801835862955,76.22321138997556,NaN,NaN,NaN,NaN,1.371616101893934,43.3088798117113,92062205,-0.4751502788648443,2.684349125233382,3.1594994040982263
2025-08-22T11:35:00-04:00,336.12,336.12,335.04,335.36,332.190364671909,NaN,NaN,NaN,NaN,NaN,327.43301999999943,341.1333038073219,313.73273619267695,333.9067747751303,332.28226851340935,337.17653652360013,327.38800050321856,71891,161886.26666666666,64.06234937933597,75.06100154695885,NaN,NaN,NaN,NaN,1.3507863803300804,42.44631715572537,91990314,-0.546962347304838,2.475796469967179,3.022758817272017
2025-08-22T11:40:00-04:00,335.34,335.45,335.05,335.26,332.190364671909,NaN,NaN,NaN,NaN,NaN,327.72121999999945,341.4616558202049,313.980784179794,333.9067747751303,332.3347324026492,337.2013530575031,327.46811174779526,82093,163556.03333333333,63.36441309016826,73.73656600100831,NaN,NaN,NaN,NaN,1.2828730674493587,41.64536611802414,91908221,-0.5972397720389013,2.2762091022233903,2.8734488742622917
2025-08-22T11:45:00-04:00,335.29,335.81,334.89,335.25,332.190364671909,NaN,NaN,NaN,NaN,NaN,328.0194199999995,341.7533157742151,314.28552422578394,333.9067747751303,332.3821401282704,337.2243070218744,327.53997323466643,75105,165017.8,63.29015671029843,72.33401870705468,NaN,NaN,NaN,NaN,1.2569535626315484,41.12503145910759,91833116,-0.6242792536161668,2.0930998072420834,2.71737906085825
2025-08-22T11:50:00-04:00,335.22,335.82,334.99,335.37,332.190364671909,NaN,NaN,NaN,NaN,NaN,328.31741999999946,342.02973781491033,314.6051021850886,333.9067747751303,332.4111433547938,337.2389006459663,327.58338606362133,45944,164496.13333333333,63.83781410987235,70.92030301978572,NaN,NaN,NaN,NaN,1.2264568795864366,40.64823400600181,91879060,-0.625617033317611,1.9353577692112367,2.5609748025288477
2025-08-22T11:55:00-04:00,335.37,336,335.03,335.08,332.190364671909,NaN,NaN,NaN,NaN,NaN,328.60881999999947,342.26422693326924,314.9534130667297,333.9067747751303,332.4560490721076,337.26066833133126,327.6514298128839,73509,161451.3,61.45185571288352,69.72165718355825,NaN,NaN,NaN,NaN,1.2081385310445503,40.32564961131665,91805551,-0.6355146899824837,1.766581440050743,2.4020961300332266
2025-08-22T12:00:00-04:00,335.09,335.75,335.06,335.58,332.190364671909,NaN,NaN,NaN,NaN,NaN,328.9028199999995,342.5128681216298,315.2927718783692,333.9067747751303,332.4898623251157,337.2779050712335,327.70181957899797,55079,158356.56666666668,63.9533873968713,68.7503671916388,NaN,NaN,NaN,NaN,1.1711286359699393,40.02610695910901,91860630,-0.5983942392323209,1.6541033309928252,2.252497570225146
2025-08-22T12:05:00-04:00,335.52,335.84,335.27,335.47,332.190364671909,NaN,NaN,NaN,NaN,NaN,329.2022199999995,342.7180065464438,315.6864334535552,333.8325449934445,332.5252976614527,337.29648204982976,327.7541132730757,57835,154815.53333333333,62.98500460881969,67.73342610019479,NaN,NaN,NaN,NaN,1.1281908762578003,39.814853004709555,91802795,-0.571314578428372,1.5383543471896814,2.1096689256180534
2025-08-22T12:10:00-04:00,335.47,335.74,334.22,334.57,332.190364671909,NaN,NaN,NaN,NaN,NaN,329.4814199999995,342.8516713370928,316.1111686629062,333.8325449934445,332.5594913372219,337.303592457912,327.81539021653185,74208,149863.43333333332,55.57079851244761,66.06699580655088,NaN,NaN,NaN,NaN,1.1561772422393848,38.09558198534154,91728587,-0.6010616637332995,1.3583418459514291,1.9594035096847287
2025-08-22T12:15:00-04:00,334.62,334.69,333.76,334.18,332.190364671909,NaN,NaN,NaN,NaN,NaN,329.7354199999995,342.9698399486382,316.50100005136085,333.8325449934445,332.58865812016387,337.2956809268276,327.88163531350017,90498,146405.73333333334,52.67708202064134,64.52760772297074,NaN,NaN,NaN,NaN,1.140021724936572,35.93380417870118,91638089,-0.6309503115549167,1.1707156202410829,1.8016659317959995
2025-08-22T12:20:00-04:00,334.255,335.27,334.21,334.9,332.190364671909,NaN,NaN,NaN,NaN,NaN,330.01161999999954,343.08828217292773,316.93495782707134,333.8325449934445,332.61715241442755,337.300283493465,327.9340213353901,67055,140463.63333333333,57.11674179365785,63.2968705125998,NaN,NaN,NaN,NaN,1.136448744583958,34.48576813691851,91705144,-0.587085205486225,1.0678094249382184,1.6548946304244434
2025-08-22T12:25:00-04:00,334.89,335.15,334.48,335.13,332.190364671909,NaN,NaN,NaN,NaN,NaN,330.29561999999953,343.1864783478727,317.40476165212635,333.8325449934445,332.6442267700864,337.306359622289,327.9820939178838,61723,137682.96666666667,58.45750108175969,62.161901822807565,NaN,NaN,NaN,NaN,1.1031309771136724,33.141163240977455,91766867,-0.5292247260027518,0.9933637229210035,1.5225884489237553
2025-08-22T12:30:00-04:00,335.09,336.66,335.08,336.52,332.3023367174067,NaN,NaN,NaN,NaN,NaN,330.59561999999954,343.3530782478211,317.838161752178,334.0460211434519,332.7253238208764,337.36170526489377,328.088942376859,126662,125801.26666666666,65.48152910880134,62.06823506982685,NaN,NaN,NaN,NaN,1.1371930501769845,33.122461390041586,91893529,-0.39039065931253814,1.0346001247830827,1.4249907840956209
2025-08-22T12:35:00-04:00,336.525,337.38,336.34,337.02,333.3126850484337,NaN,NaN,NaN,NaN,NaN,330.89781999999957,343.53324855121247,318.2623914487867,334.76881691476154,332.82924455255267,337.45385854526,328.2046305598453,136809,118759.43333333333,67.60346412733449,62.082865429394346,NaN,NaN,NaN,NaN,1.1302506894500586,33.56000869512125,92030338,-0.2639897695857778,1.0950035721133986,1.3589933416991764
2025-08-22T12:40:00-04:00,337.03,338.25,336.91,337.18,334.01119936441404,NaN,NaN,NaN,NaN,NaN,331.20241999999956,343.6938216129828,318.71101838701634,335.49105353180926,332.9551270704943,337.5778314845315,328.33242265645714,154522,114094.2,68.27552655333494,62.009116014730445,NaN,NaN,NaN,NaN,1.145232783060767,34.44321754897178,92184860,-0.17310421742956872,1.1426130699122155,1.3157172873417842
2025-08-22T12:45:00-04:00,337.18,337.26,336.73,337.12,334.01119936441404,NaN,NaN,NaN,NaN,NaN,331.5008199999995,343.8295214317376,319.17211856826145,335.49105353180926,332.99412156554166,337.61179118249214,328.3764519485912,54673,104697.06666666667,67.70828400478212,62.26953991654803,NaN,NaN,NaN,NaN,1.1012875842707102,35.014200934749276,92130187,-0.122888708154415,1.1621064021487655,1.2849951103031805
2025-08-22T12:50:00-04:00,337.13,337.37,336.49,336.94,334.01119936441404,NaN,NaN,NaN,NaN,NaN,331.7908199999995,343.93410524712283,319.64753475287614,335.49105353180926,333.03968577746997,337.64985340207204,328.4295181528679,66967,99634.8,65.93838698283342,62.45339519459554,NaN,NaN,NaN,NaN,1.0854813282513736,35.206799242807946,92063220,-0.10817480525526713,1.1497766037340966,1.2579514089893638
2025-08-22T12:55:00-04:00,336.94,336.94,335.96,336.52,334.01119936441404,NaN,NaN,NaN,NaN,NaN,332.07701999999955,343.975657626251,320.1783823737481,335.49105353180926,333.0798792154421,337.6778407356581,328.48191769522606,68574,97431.86666666667,61.87416859565884,62.352253186407,NaN,NaN,NaN,NaN,1.077946947661991,34.66617517176194,91994646,-0.13155363560927658,1.093509364477768,1.2250630000870446
2025-08-22T13:00:00-04:00,336.57,337.11,336.5,336.95,334.01119936441404,NaN,NaN,NaN,NaN,NaN,332.3690199999995,344.012344380988,320.72569561901105,335.49105353180926,333.12690057738195,337.7152585630707,328.5385425916932,73920,95044.53333333334,64.3002624057523,62.38528520754134,NaN,NaN,NaN,NaN,1.0445221656861354,34.291539161049464,92068566,-0.12303784467752399,1.0712656942401395,1.1943035389176635
2025-08-22T13:05:00-04:00,336.95,337.75,336.89,337.4,334.01119936441404,NaN,NaN,NaN,NaN,NaN,332.67621999999955,344.01990915868515,321.33253084131394,335.5245244213032,333.18128518302507,337.76475863639615,328.597811729654,77451,92951.73333333334,66.68918596904544,62.759380225838605,NaN,NaN,NaN,NaN,1.0313420109942695,34.4015901256287,92146017,-0.09342075344529621,1.0775275971110432,1.1709483505563394
2025-08-22T13:10:00-04:00,337.41,337.95,337.15,337.9,334.2804315314418,NaN,NaN,NaN,NaN,NaN,332.99741999999947,343.9999534835707,321.9948865164282,335.76961953704256,333.2355919802958,337.81756852423837,328.6536154363532,73652,89077.36666666667,69.15870306402377,63.13118848777807,NaN,NaN,NaN,NaN,1.0148175816375367,34.639735864372845,92219669,-0.04872654486208239,1.1100401694787365,1.158766714340819
2025-08-22T13:15:00-04:00,337.895,338.08,337.55,337.59,334.62177555273996,NaN,NaN,NaN,NaN,NaN,333.3164199999995,343.9002172021905,322.73262279780846,336.0706956296341,333.30682616519175,337.88703233152245,328.72661999886105,97747,88497.2,65.89682548728504,63.33917569338274,NaN,NaN,NaN,NaN,0.9801877543777107,34.95133868679318,92121922,-0.04850648552339121,1.09813360743658,1.1466400929599712
2025-08-22T13:20:00-04:00,337.57,337.93,337.23,337.71,334.62177555273996,NaN,NaN,NaN,NaN,NaN,333.6404199999995,343.739420870232,323.541419129767,336.0706956296341,333.35178960875504,337.9291063819464,328.7744728355637,65062,87270.53333333334,66.5544283213112,64.12372067973014,NaN,NaN,NaN,NaN,0.9601743433507305,34.73269192685822,92186984,-0.0486213456638902,1.0858634108801084,1.1344847565439986
2025-08-22T13:25:00-04:00,337.72,338.32,337.68,338.02,334.912082683385,NaN,NaN,NaN,NaN,NaN,333.9714199999995,343.5232000653598,324.41963993463924,336.4340452029658,333.4164664108929,337.99441298906186,328.83851983272393,88007,86627.56666666667,68.25728489862414,65.23659231387177,NaN,NaN,NaN,NaN,0.9373047473971059,34.83580085844821,92274991,-0.036703931679995305,1.0886048419440044,1.1253087736239997
2025-08-22T13:30:00-04:00,338.02,338.22,337.67,337.82,334.922442561413,NaN,NaN,NaN,NaN,NaN,334.3052199999995,343.181231079814,325.42920892018503,336.43623616237267,333.45722137663967,338.03416737363176,328.88027537964757,58060,83456.26666666666,65.92520242719667,65.86576807341025,NaN,NaN,NaN,NaN,0.9096401225830277,34.91467251464639,92216931,-0.0503330047746664,1.0623925176556668,1.1127255224303332
2025-08-22T13:35:00-04:00,337.81,338.07,337.53,337.91,334.922442561413,NaN,NaN,NaN,NaN,NaN,334.6608199999995,342.6133273651627,326.70831263483626,336.43623616237267,333.49262790867533,338.0678743556189,328.91738146173174,52099,82158.26666666666,66.48020305173682,66.4388182141229,NaN,NaN,NaN,NaN,0.8832372566842415,34.740440573465754,92269030,-0.060637820913525875,1.0369282462884257,1.0975660672019516
2025-08-22T13:40:00-04:00,337.9,338.61,337.77,338.45,335.2511408462461,NaN,NaN,NaN,NaN,NaN,335.0022199999995,342.0601498642675,327.94429013573153,336.83239114391847,333.55159034116656,338.1290883472525,328.9740923350806,80414,81895.96666666666,69.6720308364162,66.73813976609539,NaN,NaN,NaN,NaN,0.880148881206798,35.04038065111384,92349444,-0.03946270712661892,1.048237683293678,1.0877003904202969
2025-08-22T13:45:00-04:00,338.46,338.58,338.13,338.21,335.4883617168713,NaN,NaN,NaN,NaN,NaN,335.3090199999995,341.5127121458798,329.10532785411925,336.93291291513475,333.60795566513156,338.18725208153114,329.02865924873197,78268,80717.86666666667,66.63504389070015,66.66896689205008,NaN,NaN,NaN,NaN,0.8494239611205974,35.318896437501344,92271176,-0.04935445187046672,1.0260073255822135,1.0753617774526802
2025-08-22T13:50:00-04:00,338.21,338.53,338.19,338.46,335.57729982064984,NaN,NaN,NaN,NaN,NaN,335.58341999999953,341.06453066271,330.10230933728906,337.04233033210784,333.64046791629727,338.22108036579203,329.0598554668025,45167,78963.76666666666,68.1904897130741,66.66289283203146,NaN,NaN,NaN,NaN,0.8130365353262672,35.57751823914689,92316343,-0.04681661602168896,1.016841007425569,1.063657623447258
2025-08-22T13:55:00-04:00,338.47,338.67,337.86,337.93,335.57729982064984,NaN,NaN,NaN,NaN,NaN,335.82661999999954,340.5744876461015,331.0787523538976,337.0748642656863,333.68619433333816,338.2658970905646,329.10649157611175,68050,78095.7,61.63080841535455,66.22878743278663,NaN,NaN,NaN,NaN,0.8128196399458197,35.14190088040042,92248293,-0.0862922706470517,0.9557922851384433,1.042084555785495
2025-08-22T14:00:00-04:00,337.99,338.15,337.65,337.75,335.57729982064984,NaN,NaN,NaN,NaN,NaN,336.0513999999995,340.0129189211437,332.0898810788553,337.0748642656863,333.71859820356894,338.2950955410932,329.1421008660447,52676,75790.66666666667,59.53611372688109,65.7714822002186,NaN,NaN,NaN,NaN,0.7904753799496899,34.32506254834112,92195617,-0.1274989282430412,0.8827108954816936,1.0102098237247348
2025-08-22T14:05:00-04:00,337.73,337.81,337.13,337.49,335.57729982064984,NaN,NaN,NaN,NaN,NaN,336.2867999999995,338.95110460768643,333.6224953923126,337.0748642656863,333.75571962420685,338.32469883131387,329.1867404170998,67527,75645.2,56.54650625461051,65.39093489014373,NaN,NaN,NaN,NaN,0.7825842813818554,32.62765738978138,92128090,-0.17244524114149617,0.7946532722978645,0.9670985134393607
2025-08-22T14:10:00-04:00,337.54,338.1,337.33,338.03,335.57729982064984,NaN,NaN,NaN,NaN,NaN,336.40279999999956,338.84640075347863,333.9591992465205,337.0748642656863,333.7911855980239,338.355864242496,329.2265069535518,60180,74914.76666666666,60.93419272251992,65.15050134134141,NaN,NaN,NaN,NaN,0.7816854041402971,31.434735526881465,92188270,-0.16593216890120766,0.7596833023128511,0.9256154712140587
2025-08-22T14:15:00-04:00,338.02,338.5,338.02,338.28,335.65362079108786,NaN,NaN,NaN,NaN,NaN,336.4831999999995,338.9039253133333,334.0624746866657,337.0748642656863,333.8316634467857,338.39536366265173,329.26796323091963,62943,74509.36666666667,62.80663028822538,64.87317593556854,NaN,NaN,NaN,NaN,0.7601364467017058,30.81835896298489,92251213,-0.14563570652869673,0.7435708380531878,0.8892065445818845
2025-08-22T14:20:00-04:00,338.26,338.42,337.79,338.4,335.65362079108786,NaN,NaN,NaN,NaN,NaN,336.5465999999995,338.9985628387503,334.0946371612487,337.0748642656863,333.8639059553769,338.4261055380098,329.301706372744,51709,74701.53333333334,63.70586469776312,64.48368748083564,NaN,NaN,NaN,NaN,0.7508409862230121,29.823021796965065,92302922,-0.12572841940781487,0.732046020322116,0.8577744397299308
2025-08-22T14:25:00-04:00,338.38,338.75,338.19,338.31,335.93681150592926,NaN,NaN,NaN,NaN,NaN,336.61099999999954,339.07566306063364,334.1463369393654,337.22794073806404,333.9063077587491,338.46822247065955,329.34439304683866,65911,74448.26666666666,62.4856572295474,64.24003260528295,NaN,NaN,NaN,NaN,0.7372094872070828,29.31045761382241,92237011,-0.12022378158288316,0.7074947127513269,0.8277184943342101
2025-08-22T14:30:00-04:00,338.34,338.739,338.21,338.71,335.9843200738415,NaN,NaN,NaN,NaN,NaN,336.70339999999953,339.1291868336934,334.2776131663057,337.2568525904512,333.953276758417,338.51581453189897,329.39073898493507,72265,75021.13333333333,65.63601548275777,64.17443168824342,NaN,NaN,NaN,NaN,0.7223373809780052,28.83450515804708,92309276,-0.09249033793404648,0.712105571916652,0.8045959098506985
2025-08-22T14:35:00-04:00,338.67,339.06,338.4,338.53,336.2630100704851,NaN,NaN,NaN,NaN,NaN,336.77959999999956,339.1907041790935,334.36849582090565,337.544282072361,334.0213189278074,338.58551456582205,329.4571232897927,104793,76586.4,63.06929955033166,63.80386130622253,NaN,NaN,NaN,NaN,0.7178847109081493,28.793413375400945,92204483,-0.08908158320694626,0.6932439308420157,0.782325514048962
2025-08-22T14:40:00-04:00,338.54,338.55,338.03,338.36,336.2630100704851,NaN,NaN,NaN,NaN,NaN,336.8295999999996,339.26590526872394,334.3932947312752,337.544282072361,334.06023738720603,338.6218719267315,329.49860284768056,66379,76325.43333333333,60.65675217765311,63.42754343125513,NaN,NaN,NaN,NaN,0.7037500887004271,27.998353448880138,92138104,-0.10025655321831994,0.6570048225260621,0.757261375744382
2025-08-22T14:45:00-04:00,338.36,339.03,338.19,338.72,336.2630100704851,NaN,NaN,NaN,NaN,NaN,336.8709999999995,339.36339563525894,334.3786043647401,337.544282072361,334.1158053068894,338.6774026164175,329.5542079973613,89780,76301.5,63.813518686255414,63.23706597657789,NaN,NaN,NaN,NaN,0.7134822252218234,27.868684242441688,92227884,-0.08593464218031743,0.6498430730189853,0.7357777151993027
2025-08-22T14:50:00-04:00,338.77,339.09,338.54,338.67,336.42041005472976,NaN,NaN,NaN,NaN,NaN,336.90019999999953,339.44152718133427,334.3588728186648,337.544282072361,334.1644028808179,338.7266831290106,329.60212263262514,78248,76674.6,63.05676227947076,62.764546793938926,NaN,NaN,NaN,NaN,0.7018049234202614,27.8207170974527,92149636,-0.08235193803263718,0.6328377926585063,0.7151897306911434
2025-08-22T14:55:00-04:00,338.67,338.89,338.56,338.74,336.42041005472976,NaN,NaN,NaN,NaN,NaN,336.9481999999995,339.5356332924241,334.36076670757484,337.544282072361,334.19176638985357,338.75398446420553,329.6295483155016,45152,76122.23333333334,63.7056875792953,62.55530705741001,NaN,NaN,NaN,NaN,0.6752474288902415,27.776176177105782,92194788,-0.07784235559935815,0.6178867861919457,0.6957291417913039
2025-08-22T15:00:00-04:00,338.75,339.23,338.63,339.07,336.6233798225947,NaN,NaN,NaN,NaN,NaN,337.0049999999995,339.6509032489275,334.3590967510715,337.80379354947127,334.23704368170246,338.80119523447763,329.6728921289273,71968,74299.1,66.67735247825408,62.44722582635144,NaN,NaN,NaN,NaN,0.6698726125409402,28.165466930989012,92266756,-0.05621821250931569,0.6254563761546592,0.6816745886639749
2025-08-22T15:05:00-04:00,339.06,339.57,339.02,339.35,337.01822619429487,NaN,NaN,NaN,NaN,NaN,337.06839999999943,339.7832108152854,334.3535891847135,338.154034839577,334.31253137292003,338.8840957547814,329.74096699105866,114807,73565.7,68.99685966319035,62.97337234405399,NaN,NaN,NaN,NaN,0.661310283073731,28.917490978721,92381563,-0.02806331818948804,0.6465954409271149,0.6746587591166029
2025-08-22T15:10:00-04:00,339.33,339.48,338.97,339.26,337.01822619429487,NaN,NaN,NaN,NaN,NaN,337.11259999999953,339.89587234789605,334.329327652103,338.154034839577,334.3730427201683,338.94870450735505,329.7973809329816,96054,71616.76666666666,67.37350093813775,63.5331857162866,NaN,NaN,NaN,NaN,0.650502405711321,29.488976405485495,92285509,-0.020839575238238317,0.648609290068805,0.6694488653070433
2025-08-22T15:15:00-04:00,339.26,339.3,338.51,338.63,337.01822619429487,NaN,NaN,NaN,NaN,NaN,337.1579999999995,339.96464354749213,334.3513564525069,338.154034839577,334.4300608000731,339.00365426728166,329.8564673328645,101677,73183.56666666667,57.22397176792905,63.58157611009507,NaN,NaN,NaN,NaN,0.6604665195890852,28.91882940385629,92183832,-0.061527793857371504,0.592539122985329,0.6540669168427005
2025-08-22T15:20:00-04:00,338.6,338.65,338.37,338.5,337.01822619429487,NaN,NaN,NaN,NaN,NaN,337.1997999999995,340.0228437195706,334.3767562804285,338.154034839577,334.46135761048276,339.03123432908154,329.891480891884,61259,72993.3,55.37034828664085,63.18415865038942,NaN,NaN,NaN,NaN,0.6332903396184343,28.080609530050015,92122573,-0.098064291929011,0.5314865519314367,0.6295508438604477
2025-08-22T15:25:00-04:00,338.5,338.55,338.03,338.52,337.01822619429487,NaN,NaN,NaN,NaN,NaN,337.2419999999995,340.07960180480563,334.4043981951934,338.154034839577,334.4977558850165,339.0617403160657,329.93377145396727,75069,73209.8,55.60858781049967,62.6700127591233,NaN,NaN,NaN,NaN,0.6251981725028346,26.589681562758283,92197642,-0.12028711046068952,0.47919195578458584,0.5994790662452754
2025-08-22T15:30:00-04:00,338.51,338.66,338.08,338.35,337.01822619429487,NaN,NaN,NaN,NaN,NaN,337.3019999999995,340.10368235219,334.500317647809,338.154034839577,334.53096681181677,339.08928566441614,329.9726479592174,69799,73072.43333333333,53.01789224344962,61.90658615524376,NaN,NaN,NaN,NaN,0.621969731609778,25.396182375892458,92127843,-0.14422463255894713,0.4191982755465915,0.5634229081055386
2025-08-22T15:35:00-04:00,338.36,338.36,337.455,337.68,337.01822619429487,NaN,NaN,NaN,NaN,NaN,337.3449999999995,340.10221961448747,334.58778038551156,338.154034839577,334.57025436294504,339.1154808901556,330.0250278357345,97866,73752.93333333333,44.26510151505219,60.605117889922674,NaN,NaN,NaN,NaN,0.6421861793519389,24.05254361057731,92029977,-0.1995621679677031,0.31397019814590976,0.5135323661136129
2025-08-22T15:40:00-04:00,337.68,338.32,337.34,338.28,337.01822619429487,NaN,NaN,NaN,NaN,NaN,337.38859999999954,340.13461386785644,334.64258613214264,338.154034839577,334.60484658384354,339.13984930688656,330.0698438608005,84269,74106.83333333333,51.92015572127885,59.62541362124561,NaN,NaN,NaN,NaN,0.6663157379696588,22.997297519703956,92114246,-0.19017646275650935,0.2758117876679762,0.46598825042448555
2025-08-22T15:45:00-04:00,338.28,338.48,338.11,338.31,337.01822619429487,NaN,NaN,NaN,NaN,NaN,337.44759999999957,340.14303483734386,334.7521651626553,338.154034839577,334.6492778296827,339.17488974765496,330.1236659117105,101093,74218.36666666667,52.27312648061869,58.8542584019804,NaN,NaN,NaN,NaN,0.6451503281146834,21.694127264359665,92215339,-0.17665811614735788,0.2451656052402882,0.42182372138764607
2025-08-22T15:50:00-04:00,338.4,339.4,338.31,339.17,337.01822619429487,NaN,NaN,NaN,NaN,NaN,337.5257999999996,340.18951797348285,334.86208202651636,338.154034839577,334.74803632713656,339.2677606203567,330.22831203391644,197131,78620.66666666667,61.09139330870248,58.885304197055355,NaN,NaN,NaN,NaN,0.6769253046779184,21.33237752568142,92412470,-0.10788686349007415,0.2869651420250534,0.39485200551512756
2025-08-22T15:55:00-04:00,339.17,340.22,339.1,339.97,337.4070097011677,NaN,NaN,NaN,NaN,NaN,337.62019999999956,340.28915781953333,334.9512421804658,338.2242976067527,334.9360840462881,339.47146935915566,330.40069873342054,335196,86860.3,67.16838586316379,59.12493756683453,NaN,NaN,NaN,NaN,0.7085734972009246,21.972088674984228,92747666,-0.011672426295894933,0.3802614726452589,0.3919338989411538
2025-08-25T09:30:00-04:00,338.92,341.45,336.64,337.59,NaN,NaN,NaN,341.8514907397945,341.8514907397945,341.8514907397945,337.66459999999955,340.25505389120855,335.07414610879056,338.2242976067527,338.55999999999995,338.55999999999995,338.55999999999995,254040,93392.96666666666,44.76707620021662,57.81853141831637,NaN,NaN,NaN,NaN,1.0015325331151443,21.460180105862406,92493626,-0.10621441960084288,0.2591658744401002,0.3653802940409431
2025-08-25T09:35:00-04:00,337.58,340.11,337.57,338.74,NaN,NaN,NaN,341.8514907397945,NaN,NaN,337.73779999999954,340.2372248623395,335.2383751376596,338.2242976067527,338.6614892933486,338.7828727726029,338.5401058140943,177592,97576.06666666667,52.93500721074645,57.04919710627717,NaN,NaN,NaN,NaN,1.111423066464064,20.984836434534998,92671218,-0.08984436304066062,0.2530748402401173,0.3429192032807779
2025-08-25T09:40:00-04:00,338.75,338.99,337.34,337.71,NaN,NaN,NaN,341.2777735872921,NaN,NaN,337.7803999999996,340.20267978613845,335.35812021386073,338.2242976067527,338.5053642682274,338.80201766990933,338.2087108665455,136960,99460.93333333333,46.32697650637468,55.595598822571496,NaN,NaN,NaN,NaN,1.1498928474309191,20.76356421271725,92534258,-0.14373266140902863,0.16325337651949212,0.30698603792852075
2025-08-25T09:45:00-04:00,337.71,337.73,335.02,336.9,NaN,NaN,NaN,339.7158293333243,NaN,NaN,337.80899999999957,340.15402452061744,335.4639754793817,338.2242976067527,337.8858908125735,338.8280543225458,336.9437273026012,263665,105640.83333333333,41.89752527090374,53.659932080265314,NaN,NaN,NaN,NaN,1.2613290726144275,22.21261264428809,92270593,-0.22446514002016027,0.026404612903320412,0.2508697529234807
2025-08-25T09:50:00-04:00,336.9,337.93,336.07,337.64,NaN,NaN,NaN,339.7158293333243,NaN,NaN,337.87039999999956,340.0261029856521,335.71469701434705,338.2242976067527,337.81818178641913,338.73429330472106,336.9020702681172,93166,107240.8,46.893235029501,52.19705594393412,NaN,NaN,NaN,NaN,1.3040912817133978,23.301039688362618,92363759,-0.218361920440136,-0.022082647626689322,0.19627927281344668
2025-08-25T09:55:00-04:00,337.65,339.52,337.06,339.17,NaN,NaN,NaN,339.7158293333243,NaN,NaN,337.9701999999995,339.8814320221298,336.05896797786926,338.2242976067527,337.89345453411744,338.7926909300227,336.9942181382122,100973,108338.23333333334,55.426639658305994,52.06867507896105,NaN,NaN,NaN,NaN,1.3866561901624392,22.551231151227395,92464732,-0.1072380629737762,0.06223169409622642,0.1694697570700026
2025-08-25T10:00:00-04:00,339.25,339.91,338.32,339.59,335.4412170871604,335.4412170871604,335.4412170871604,NaN,NaN,NaN,338.06399999999957,339.8171183651792,336.3108816348199,338.2242976067527,338.0013035943043,338.9407781390766,337.06182904953204,87023,109483.13333333333,57.4479612178734,52.217076002620516,NaN,NaN,NaN,NaN,1.4011807480079814,21.490592226203223,92551755,-0.006707790099993394,0.16108501944501086,0.16779280954500425
2025-08-25T10:05:00-04:00,339.6,341.31,339.05,340.94,336.36502540138036,NaN,NaN,NaN,NaN,NaN,338.18019999999956,339.91007162596566,336.45032837403346,338.2242976067527,338.3335336149746,339.5416969778972,337.12537025205205,176165,113104.4,63.221283050890285,52.76083994836271,NaN,NaN,NaN,NaN,1.462524980293125,20.550210474516504,92727920,0.14127838192148484,0.3443907869468603,0.20311240502537548
2025-08-25T10:10:00-04:00,340.9,341.76,340.31,341.44,337.1957060649539,NaN,NaN,NaN,NaN,NaN,338.2785999999996,340.17156808273677,336.3856319172624,338.2242976067527,338.6445343856275,340.08850046205214,337.2005683092028,158807,116391.96666666666,65.10942417320283,53.62452080048793,NaN,NaN,NaN,NaN,1.4616303388436154,19.99778698227417,92886727,0.2566842962270957,0.5239677753092451,0.2672834790821494
2025-08-25T10:15:00-04:00,341.4,342.15,340.34,340.38,337.3334012438197,NaN,NaN,NaN,NaN,NaN,338.3457999999996,340.2930569019569,336.3985430980423,337.44843808540213,338.86636675007804,340.39891035099316,337.3338231491629,153710,119417.53333333334,58.27867849434665,54.62549058472325,NaN,NaN,NaN,NaN,1.4865138860690714,19.757107559905222,92733017,0.24547917646528072,0.5741324496637503,0.3286532731984696
2025-08-25T10:20:00-04:00,340.41,340.99,339.33,340.9,337.3334012438197,NaN,NaN,NaN,NaN,NaN,338.4201999999996,340.4654031298201,336.37499687017913,337.4478382481713,338.9569016715536,340.48722654409255,337.4265767990147,100048,121028.83333333333,60.46965168956682,55.23616886817239,NaN,NaN,NaN,NaN,1.4989057513498538,18.628172407785012,92833065,0.2557765164401755,0.648373918748689,0.3925974023085135
2025-08-25T10:25:00-04:00,340.76,341.1,340.03,340.75,337.3334012438197,NaN,NaN,NaN,NaN,NaN,338.49279999999965,340.60485318164035,336.38074681835894,337.4478382481713,339.01327812490007,340.54748206035777,337.4790741894424,59478,120814.4,59.49900470868242,55.75230302731979,NaN,NaN,NaN,NaN,1.4682696262534394,17.666233382099563,92773587,0.235670576852144,0.6871856233736935,0.4515150465215495
2025-08-25T10:30:00-04:00,340.77,341.38,340.24,340.76,337.3334012438197,NaN,NaN,NaN,NaN,NaN,338.56919999999957,340.72691671964276,336.4114832803564,337.4478382481713,339.0723292694617,340.6141869667863,337.5304715721371,60445,120420.4,59.54562583402113,55.64189106484255,NaN,NaN,NaN,NaN,1.4448217958067642,16.998957112382897,92834032,0.20723612251507606,0.7105601996653945,0.5033240771503185
2025-08-25T10:35:00-04:00,340.745,341.09,340.32,340.43,337.3334012438197,NaN,NaN,NaN,NaN,NaN,338.64739999999955,340.78570516117395,336.50909483882515,337.55563454645096,339.11446537311633,340.6557238686605,337.57320687757215,51222,118634.7,57.205426209672225,54.93025108959315,NaN,NaN,NaN,NaN,1.3966202389634226,16.37934343336028,92782810,0.15290175882471913,0.6944512756812173,0.5415495168564982
2025-08-25T10:40:00-04:00,340.4,340.75,339.61,340.53,337.3334012438197,NaN,NaN,NaN,NaN,NaN,338.7189999999996,340.8648993457712,336.57310065422797,337.55563454645096,339.15439648129234,340.6843813058127,337.624411656772,65486,118604.93333333333,57.7473370885567,55.857412581617446,NaN,NaN,NaN,NaN,1.3782902218946056,15.305968520981322,92848296,0.11227523224865243,0.6818935571673137,0.5696183249186613
2025-08-25T10:45:00-04:00,340.5,341.11,340.14,340.84,337.3334012438197,NaN,NaN,NaN,NaN,NaN,338.78779999999955,340.9802097797583,336.5953902202408,337.9070061097286,339.2006494166439,340.7303049892574,337.6709938440304,59942,117610.33333333333,59.46112560053395,56.323563895173706,NaN,NaN,NaN,NaN,1.3491266346164215,14.4528048724031,92908238,0.09551603350265891,0.6890133667969849,0.593497333294326
2025-08-25T10:50:00-04:00,340.82,341.38,340.31,340.55,337.3334012438197,NaN,NaN,NaN,NaN,NaN,338.8407999999996,341.07257002448694,336.60902997551227,338.2826048877829,339.2452971472901,340.7747761577482,337.715818136832,59438,116983.33333333333,57.12678660320848,57.0949789020904,NaN,NaN,NaN,NaN,1.3291890178581052,13.910493933925473,92848800,0.056086659693230456,0.663605657910864,0.6075189982176336
2025-08-25T10:55:00-04:00,340.55,341.22,340.35,340.82,337.3334012438197,NaN,NaN,NaN,NaN,NaN,338.9053999999996,341.17527298373705,336.63552701626213,338.30708391022637,339.2852632431815,340.81478806025706,337.7557384261059,54424,117292.4,58.750466056319524,58.29876038676296,NaN,NaN,NaN,NaN,1.296389802296812,13.40691949105339,92903224,0.040125071172640636,0.6576753371834343,0.6175502660107937
2025-08-25T11:00:00-04:00,340.84,340.86,340.02,340.17,337.3334012438197,NaN,NaN,NaN,NaN,NaN,338.9545999999996,341.2253398270812,336.68386017291795,338.30708391022637,339.3090703893114,340.8295698207895,337.78857095783326,48317,116504.03333333334,53.49774860001183,58.77051135608516,NaN,NaN,NaN,NaN,1.263790530704185,12.566716961680099,92854907,-0.019094335195835477,0.5936823470159993,0.6127766822118348
2025-08-25T11:05:00-04:00,340.15,340.6,339.94,340.21,337.3334012438197,NaN,NaN,NaN,NaN,NaN,338.9983999999996,341.2798008333314,336.7169991666678,338.30708391022637,339.32966994648604,340.8397237893242,337.8196161036479,48367,114289.36666666667,53.77166140055579,58.65229862338872,NaN,NaN,NaN,NaN,1.2206626356538879,11.695166765191347,92903274,-0.0582448167244628,0.5399706613062563,0.5982154780307191
2025-08-25T11:10:00-04:00,340.25,341.05,339.71,340.97,337.3334012438197,NaN,NaN,NaN,NaN,NaN,339.06139999999954,341.38277893554937,336.7400210644497,338.35578696203584,339.3680748705877,340.8702236996154,337.86592604156,70203,113427.66666666667,58.74403122873816,58.7448750527362,NaN,NaN,NaN,NaN,1.229186733107184,11.389949112579274,92973477,-0.03668268236054528,0.5523621250800375,0.5890448074405827
2025-08-25T11:15:00-04:00,340.99,341.85,340.99,341.41,337.87727067650593,NaN,NaN,NaN,NaN,NaN,339.13139999999953,341.5197919616324,336.74300803836667,339.2546295696287,339.45075130907907,340.9765038526034,337.92499876555473,95863,113233.86666666667,61.33687224953029,58.610274281210486,NaN,NaN,NaN,NaN,1.2042448235995276,11.896171842911262,93069340,0.0014645755645265046,0.5908755268962409,0.5894109513317144
2025-08-25T11:20:00-04:00,341.45,343.3,341.34,343.25,338.6710311003011,NaN,NaN,NaN,NaN,NaN,339.2273999999996,341.8707760539072,336.584023946092,340.2437036557029,339.65299265463295,341.3208982021451,337.9850871071208,161367,116570.8,69.86586367590755,58.950019959975116,NaN,NaN,NaN,NaN,1.258227336199564,13.466941750918258,93230707,0.1373487166153725,0.7610968471009301,0.6237481304855576
2025-08-25T11:25:00-04:00,343.27,343.44,342.78,343.39,339.5368933230147,NaN,NaN,NaN,NaN,NaN,339.33099999999956,342.20291155895353,336.4590884410456,340.6649629245623,339.8072623353104,341.59190234949546,338.0226223211253,115232,117909.56666666667,70.40088890081162,59.815892131865475,NaN,NaN,NaN,NaN,1.2154968121853111,15.0165408313637,93345939,0.21856609732169108,0.8969557521376714,0.6783896548159803
2025-08-25T11:30:00-04:00,343.4,344.47,343.15,344.13,340.21930726287763,NaN,NaN,NaN,NaN,NaN,339.4443999999996,342.60322550362645,336.2855744963727,341.5899703396499,339.9627669381,341.8809086904875,338.0446251857125,104299,119059.56666666667,73.11776168808107,60.71932856033077,NaN,NaN,NaN,NaN,1.2229613256006497,17.069055305039015,93450238,0.2990543043566105,1.0522075352617435,0.753153230905133
2025-08-25T11:35:00-04:00,344.18,345.52,344.18,345.05,341.2329751145651,NaN,NaN,NaN,NaN,NaN,339.5867999999996,343.08357208897405,336.0900279110251,342.52097627171986,340.27236703062744,342.48306895246134,338.06166510879353,183737,121921.93333333333,76.05986561651767,61.90224719660472,NaN,NaN,NaN,NaN,1.2348926594863165,19.485139079834994,93633975,0.3856717288826029,1.2352428920083867,0.8495711631257837
2025-08-25T11:40:00-04:00,345.05,345.37,343.68,344.4,341.2329751145651,NaN,NaN,NaN,NaN,NaN,339.7197999999996,343.42656460571266,336.0130353942866,342.52097627171986,340.42006560576283,342.7256944647992,338.1144367467265,106867,122675.2,70.21303463464648,62.66420496807796,NaN,NaN,NaN,NaN,1.267400326665865,21.06969579659496,93527108,0.3705174435899298,1.312717967613196,0.9422005240232662
2025-08-25T11:45:00-04:00,344.35,345.05,344.02,344.9,341.2329751145651,NaN,NaN,NaN,NaN,NaN,339.8679999999996,343.7924423810584,335.9435576189408,342.52097627171986,340.5255946199724,342.89613435574745,338.1550548841974,77832,121899.83333333333,71.99632222998835,63.72069754095769,NaN,NaN,NaN,NaN,1.2504431604754482,22.54106989072921,93604940,0.36491486409333707,1.3983441041399374,1.0334292400466003
2025-08-25T11:50:00-04:00,344.89,345.94,344.89,345.8,341.7818935514638,NaN,NaN,NaN,NaN,NaN,340.0233999999996,344.2482647034343,335.79853529656486,342.92669985112053,340.68044843892636,343.17024185853955,338.19065501931317,99502,118645.53333333334,74.9082660425563,64.94647818052908,NaN,NaN,NaN,NaN,1.2361257918700599,24.3742730070464,93704442,0.3902881559545115,1.5212894349897397,1.1310012790352282
2025-08-25T11:55:00-04:00,345.78,345.88,344.72,345.08,341.7818935514638,NaN,NaN,NaN,NaN,NaN,340.1593999999996,344.58408965716967,335.73471034282954,342.92669985112053,340.7804135287675,343.33134126399773,338.22948579353726,72489,109888.63333333333,68.74926016715486,65.60991636385916,NaN,NaN,NaN,NaN,1.2306882353079105,25.837993505726974,93631953,0.3294722529544658,1.5428415952283103,1.2133693422738445
2025-08-25T12:00:00-04:00,345.07,345.09,344.32,344.72,341.7818935514638,NaN,NaN,NaN,NaN,NaN,340.2857999999996,344.8607598295818,335.7108401704174,342.92669985112053,340.86218999172877,343.4480117508771,338.27636823258047,70063,103756.06666666667,65.8345881922834,66.23190219165022,NaN,NaN,NaN,NaN,1.1977819327859156,26.63825108166894,93561890,0.24004612757084276,1.5134270017373979,1.273380874166555
2025-08-25T12:05:00-04:00,344.7,345.19,344.54,344.93,341.7818935514638,NaN,NaN,NaN,NaN,NaN,340.41819999999956,345.1376621560483,335.6987378439508,342.92669985112053,340.93523011779484,343.5531940102162,338.3172662253735,62232,99910.73333333334,66.72091624324557,66.80122006214494,NaN,NaN,NaN,NaN,1.1586546518726344,27.44580643047656,93624122,0.17320448902659713,1.4898864854498015,1.3166819964232044
2025-08-25T12:10:00-04:00,345,346.13,344.75,345.74,341.9177312204692,NaN,NaN,NaN,NaN,NaN,340.5587999999996,345.4808461438557,335.63675385614357,343.402392259019,341.0498170896726,343.73267009891487,338.36696408043036,87505,98262.23333333334,69.95822304271154,67.97696823662349,NaN,NaN,NaN,NaN,1.1744650338817315,28.757350742681364,93711627,0.16191814866651422,1.519079682256347,1.3571615335898328
2025-08-25T12:15:00-04:00,345.75,345.78,345.2,345.62,342.04874343772065,NaN,NaN,NaN,NaN,NaN,340.70059999999955,345.7864712687594,335.6147287312397,343.402392259019,341.11942992159015,343.8384757593283,338.40038408385203,55459,91322.03333333334,68.88906065517382,69.0567824690962,NaN,NaN,NaN,NaN,1.132003245747321,29.975213318300113,93656168,0.12632496997092524,1.5150677460534894,1.3887427760825641
2025-08-25T12:20:00-04:00,345.61,346.42,345.58,346.3,342.600618736006,NaN,NaN,NaN,NaN,NaN,340.8593999999996,346.13530812678175,335.58349187321744,344.02233104577215,341.2250116013816,344.00910807654867,338.4409151262145,77360,90795.16666666667,71.54308593256016,69.97100066222636,NaN,NaN,NaN,NaN,1.1111458710510862,31.458168484345585,93733528,0.12812880004511418,1.5489037761389568,1.4207749760938426
2025-08-25T12:25:00-04:00,346.29,346.29,345.65,345.81,342.63649970255125,NaN,NaN,NaN,NaN,NaN,341.0011999999996,346.4186985225984,335.5837014774008,344.0468648366177,341.2945570821767,344.11550413932946,338.47361002502396,54908,89259.66666666667,67.1009441852939,70.38272008620947,NaN,NaN,NaN,NaN,1.0782068802617253,32.835198281387804,93678620,0.07831909284279504,1.5186738421473365,1.4403547493045414
2025-08-25T12:30:00-04:00,345.725,345.87,345.03,345.45,342.63649970255125,NaN,NaN,NaN,NaN,NaN,341.13679999999954,346.6526251461112,335.6209748538879,344.0468648366177,341.35948196096757,344.2053537895054,338.51361013242973,58793,88318.66666666667,63.95886865348699,69.9607918703223,NaN,NaN,NaN,NaN,1.0611921031001759,33.11559939577822,93619827,0.006887918795534409,1.4489646477989595,1.442076729003425
2025-08-25T12:35:00-04:00,345.43,345.65,344.7,345.33,342.63649970255125,NaN,NaN,NaN,NaN,NaN,341.2685999999996,346.86341046706565,335.67378953293354,344.0468648366177,341.4237379691768,344.2888343193013,338.55864161905225,63581,84565.86666666667,62.901533547774015,69.42512363081961,NaN,NaN,NaN,NaN,1.053249810021591,32.883014394736136,93556246,-0.059050091258729065,1.3682641149300139,1.427314206188743
2025-08-25T12:40:00-04:00,345.3,345.92,345.24,345.87,342.63649970255125,NaN,NaN,NaN,NaN,NaN,341.40459999999956,347.10854980363666,335.70065019636246,344.0468648366177,341.4802010144627,344.3675424134782,338.5928596154472,51486,80988.5,65.6531974670459,68.8919404721742,NaN,NaN,NaN,NaN,1.0265891093057635,32.880326543261,93607732,-0.07583426787579373,1.3325213713440007,1.4083556392197945
2025-08-25T12:45:00-04:00,345.85,346.34,345.81,345.94,342.92905807600175,NaN,NaN,NaN,NaN,NaN,341.53639999999956,347.34789173297537,335.72490826702375,344.3651718370786,341.5497207681674,344.4687659927538,338.630675543581,60175,77870.66666666667,66.00519606696281,68.17374979006313,NaN,NaN,NaN,NaN,0.9911184586410642,33.19714413138826,93667907,-0.09075138004773375,1.2949164141601273,1.385667794207861
2025-08-25T12:50:00-04:00,345.91,346.72,345.82,346.67,343.1443281634562,NaN,NaN,NaN,NaN,NaN,341.68459999999953,347.6326527370297,335.7365472629694,344.6901374696629,341.62081693632626,344.5764944857122,338.6651393869403,58545,76487.23333333334,69.51403963584954,68.12382157586335,NaN,NaN,NaN,NaN,0.984609997309562,33.76405717507505,93726452,-0.061389773855136553,1.3089305768889403,1.3703203507440769
2025-08-25T12:55:00-04:00,346.63,347.15,346.48,346.9,343.7400405196627,NaN,NaN,NaN,NaN,NaN,341.84999999999957,347.90801023458977,335.79198976540937,345.1911099757303,341.7314520946095,344.7508091814508,338.7120950077682,86501,77388,70.54559233303809,68.02019801179549,NaN,NaN,NaN,NaN,0.9621378546445903,34.58101612553636,93812953,-0.03758322092372457,1.3233413245894212,1.3609245455131458
2025-08-25T13:00:00-04:00,346.9,346.97,346.19,346.41,343.7400405196627,NaN,NaN,NaN,NaN,NaN,342.00819999999953,348.1208971986612,335.89550280133784,345.1911099757303,341.7914227922158,344.8387493915238,338.7440961929079,51750,77098.16666666667,65.46348766860558,67.34557098508472,NaN,NaN,NaN,NaN,0.9491280078842645,34.84398872869229,93761203,-0.06436950478621606,1.2804626645303756,1.3448321693165917
2025-08-25T13:05:00-04:00,346.4,347.45,346.19,347.42,343.74488196109763,NaN,NaN,NaN,NaN,NaN,342.1861999999996,348.39972832474433,335.97267167525484,345.2543103844674,341.89441258783864,344.9978248831541,338.79100029252317,83086,78160.3,70.2249107196892,67.45097459598003,NaN,NaN,NaN,NaN,0.9713331501782451,35.434325814424504,93844289,-0.025589010494151854,1.312845906198902,1.3384349166930538
2025-08-25T13:10:00-04:00,347.42,347.49,347.04,347.08,344.2682964174114,NaN,NaN,NaN,NaN,NaN,342.3607999999996,348.62375628616184,336.09784371383734,345.50844830757393,341.95704315616786,345.09489670450523,338.8191896078305,50356,77655.96666666666,66.88211001962222,67.52579758364709,NaN,NaN,NaN,NaN,0.9340950680226553,36.010921891813894,93793933,-0.033840991109747476,1.2961336778058694,1.3299746689156169
2025-08-25T13:15:00-04:00,347.05,348.1,347.03,347.96,344.5586011257109,NaN,NaN,NaN,NaN,NaN,342.56639999999965,348.8759822494232,336.2568177505761,345.9797586460591,342.1106282970854,345.34181807844766,338.8794385157231,117359,79569.86666666667,70.7614950790051,67.81441035762991,NaN,NaN,NaN,NaN,0.9438025631638978,36.96213942571717,93911292,0.006795246954192979,1.3384687276083582,1.3316734806541652
2025-08-25T13:20:00-04:00,347.99,348.65,347.8,348.63,345.2393465290877,NaN,NaN,NaN,NaN,NaN,342.7733999999996,349.1851824169589,336.36161758304024,346.52880691684726,342.2642012655856,345.5988929751644,338.9295095560068,110493,81271.7,73.32363958304815,68.05479725336825,NaN,NaN,NaN,NaN,0.9371023800807599,38.17461742408707,94021785,0.06252625747274188,1.4098313024950926,1.3473050450223507
2025-08-25T13:25:00-04:00,348.6,348.7,348,348.35,345.40460350503827,NaN,NaN,NaN,NaN,NaN,342.9741999999996,349.442877874369,336.5055221256302,346.65304553347784,342.3482058882276,345.7350704082371,338.9613413682181,62933,81555.33333333333,70.54161003568848,68.17283649483358,NaN,NaN,NaN,NaN,0.9201664957892762,39.3295296238087,93958852,0.06402757665371306,1.427339515839492,1.3633119391857789
2025-08-25T13:30:00-04:00,348.35,348.68,347.45,347.52,345.40460350503827,NaN,NaN,NaN,NaN,NaN,343.14119999999957,349.6394787138162,336.64292128618297,346.65304553347784,342.4369430148279,345.86772307729694,339.0061629523588,74283,82420.86666666667,62.9205563233946,67.55694152275034,NaN,NaN,NaN,NaN,0.9422974603757578,39.35838801924234,93884569,-0.003785572622690525,1.3585799734074158,1.3623655460301063
2025-08-25T13:35:00-04:00,347.55,347.69,347.09,347.54,345.40460350503827,NaN,NaN,NaN,NaN,NaN,343.2925999999996,349.84083433929175,336.74436566070744,346.65304553347784,342.49489016472387,345.9474949348108,339.04228539463696,54296,82618.5,63.02421928064015,67.26574688670362,NaN,NaN,NaN,NaN,0.917847641777491,38.76087186065183,93938865,-0.05723516821199248,1.2908215857651157,1.3480567539771082
2025-08-25T13:40:00-04:00,347.53,347.63,347.16,347.45,345.40460350503827,NaN,NaN,NaN,NaN,NaN,343.4897999999996,349.9322349311612,337.047365068838,346.65304553347784,342.54529618964307,346.01569856036025,339.0748938189259,48540,81896.4,62.18175679820138,67.1388103256118,NaN,NaN,NaN,NaN,0.8858585245076681,38.20603542767493,93890325,-0.10576954299052965,1.2158448252389462,1.3216143682294759
2025-08-25T13:45:00-04:00,347.49,348.28,347.32,347.95,345.40460350503827,NaN,NaN,NaN,NaN,NaN,343.6739999999996,350.0892842495323,337.2587157504669,346.65304553347784,342.61365095650973,346.1131410261903,339.11416088682915,61828,80761.9,64.9823036684432,67.28743676280246,NaN,NaN,NaN,NaN,0.8911543441856903,38.261675815369586,93952153,-0.11078540862750996,1.1831326074450885,1.2939180160725985
2025-08-25T13:50:00-04:00,347.94,348.37,347.9,348.1,345.40460350503827,NaN,NaN,NaN,NaN,NaN,343.88179999999966,350.18297156107,337.5806284389293,346.65304553347784,342.6774541890398,346.20620457756587,339.1487038005137,56215,77256.83333333333,65.80051777752398,67.29795964212232,NaN,NaN,NaN,NaN,0.8610718910295715,38.387326463897956,94008368,-0.11034545584351707,1.155986196268202,1.2663316521117192
2025-08-25T13:55:00-04:00,348.075,348.43,347.74,347.81,345.40460350503827,NaN,NaN,NaN,NaN,NaN,344.0999999999996,350.170348919316,338.02965108068327,346.65304553347784,342.73364064801797,346.28554012814527,339.18174116789066,51857,75144.33333333333,62.74791621607069,67.06529679563002,NaN,NaN,NaN,NaN,0.8488524702417448,38.189177354223865,93956511,-0.13433723728731106,1.0984101055025803,1.2327473427898914
2025-08-25T14:00:00-04:00,347.8,348.18,347.25,347.5,345.40460350503827,NaN,NaN,NaN,NaN,NaN,344.29719999999963,350.1521002247794,338.44229977521985,346.65304553347784,342.7808309537161,346.3479295312965,339.2137323761357,47615,73254.86666666667,59.56670317411826,66.35477276264922,NaN,NaN,NaN,NaN,0.8546487223673349,37.09413133176382,93908896,-0.1733548391348101,1.0160537938713787,1.1894086330061888
2025-08-25T14:05:00-04:00,347.49,347.52,347.14,347.37,345.40460350503827,NaN,NaN,NaN,NaN,NaN,344.4611999999997,350.19047449526414,338.7319255047352,346.65304553347784,342.82331596619844,346.4007089267096,339.24592300568725,46563,68682.4,58.23339092831479,65.47532980516898,NaN,NaN,NaN,NaN,0.8207452421982392,35.88220048588592,93862333,-0.20786267671880454,0.929580287107683,1.1374429638264876
2025-08-25T14:10:00-04:00,347.38,348.03,347.3,347.81,345.40460350503827,NaN,NaN,NaN,NaN,NaN,344.6255999999997,350.25723799991533,338.993962000084,346.65304553347784,342.8642560244506,346.454397670562,339.27411437833916,42218,66527.43333333333,61.3839669878169,65.18393547082694,NaN,NaN,NaN,NaN,0.8142634391840764,35.326872282290395,93904551,-0.20088509410090905,0.8863365962003513,1.0872216903012604
2025-08-25T14:15:00-04:00,347.84,347.84,346.42,346.64,345.40460350503827,NaN,NaN,NaN,NaN,NaN,344.7395999999997,350.29849335767284,339.1807066423266,346.608479968328,342.9133031903599,346.50966589343466,339.31694048728514,61018,65966.96666666666,50.479722536567515,63.77356488631824,NaN,NaN,NaN,NaN,0.8575303363852109,33.37831879026819,93843533,-0.27055961119936933,0.7490221763020486,1.019581787501418
2025-08-25T14:20:00-04:00,346.59,347,346.08,346.61,345.40460350503827,NaN,NaN,NaN,NaN,NaN,344.8429999999997,350.3445826815634,339.34141731843596,346.608479968328,342.96134938552757,346.5581028348357,339.3645959362194,68077,64919.46666666667,50.23331581538918,62.5843653003016,NaN,NaN,NaN,NaN,0.8619924552148398,31.096863161330994,93775456,-0.3112569292494829,0.6305106259395643,0.9417675551890472
2025-08-25T14:25:00-04:00,346.6,346.99,346.51,346.82,345.40460350503827,NaN,NaN,NaN,NaN,NaN,344.9717999999997,350.3495566923341,339.5940433076653,346.608479968328,342.9856489904224,346.58373315309404,339.3875648277508,33179,63609.13333333333,51.99961016085958,61.2442306632912,NaN,NaN,NaN,NaN,0.8347072798423526,28.978368648746454,93808635,-0.3156328228376666,0.547226526641964,0.8628593494796306
2025-08-25T14:30:00-04:00,346.9,347.18,346.76,347.07,345.40460350503827,NaN,NaN,NaN,NaN,NaN,345.0951999999997,350.3758427489415,339.81455725105786,346.608479968328,343.01283532679065,346.6138204641233,339.411850189458,35460,62455.7,54.08866431286042,59.870303858277786,NaN,NaN,NaN,NaN,0.8050853312821857,27.279652761836388,93844095,-0.293741662061367,0.4956822719029219,0.7894239339642889
2025-08-25T14:35:00-04:00,347.06,347.08,346.57,346.62,345.40460350503827,NaN,NaN,NaN,NaN,NaN,345.2125999999997,350.3609586667927,340.0642413332067,346.608479968328,343.0405164423115,346.6424721789868,339.43856070563623,39035,61682.46666666667,49.88049793684879,58.39451013693209,NaN,NaN,NaN,NaN,0.7840078076191718,25.40587717799962,93805060,-0.30053725931482134,0.4137523598207622,0.7142896191355835
2025-08-25T14:40:00-04:00,346.65,346.89,346.42,346.46,345.40460350503827,NaN,NaN,NaN,NaN,NaN,345.32659999999976,350.3258041128374,340.32739588716214,346.608479968328,343.06907040696933,346.6704938857231,339.4676469282156,42815,60192.8,48.437516755247565,57.36000731063588,NaN,NaN,NaN,NaN,0.7615786785035146,23.750603044470015,93762245,-0.3057648165957395,0.3320835983909092,0.6378484149866487
2025-08-25T14:45:00-04:00,346.43,347.08,346.28,347.06,345.40460350503827,NaN,NaN,NaN,NaN,NaN,345.45919999999967,350.2803979260459,340.63800207395343,346.2827817437839,343.11313194512263,346.71592128390785,339.5103426063374,63491,60460.53333333333,53.831299937855576,56.7033702147227,NaN,NaN,NaN,NaN,0.7643230586104072,22.204222978287277,93825736,-0.2605371952407489,0.3121769209357126,0.5727141161764615
2025-08-25T14:50:00-04:00,347.07,347.61,346.87,347.45,345.40460350503827,NaN,NaN,NaN,NaN,NaN,345.59759999999966,350.23878874450605,340.95641125549326,346.2827817437839,343.14272677220043,346.74992648189584,339.535527062505,38248,59156.8,56.98132987077832,56.33191114847819,NaN,NaN,NaN,NaN,0.762585697281093,21.558135852593946,93863984,-0.19886404447504857,0.3241340605826508,0.5229981050576994
2025-08-25T14:55:00-04:00,347.46,347.6,347.19,347.22,345.40460350503827,NaN,NaN,NaN,NaN,NaN,345.7251999999997,350.18337225351127,341.2670277464881,346.2827817437839,343.1839546723268,346.79715075073784,339.5707585939158,53849,59121.5,54.61473051757265,55.5913702091303,NaN,NaN,NaN,NaN,0.7374010046181596,20.958197807307283,93810135,-0.16922986313425425,0.31146077613988155,0.4806906392741358
2025-08-25T15:00:00-04:00,347.25,347.93,347.17,347.75,345.40460350503827,NaN,NaN,NaN,NaN,NaN,345.8691999999997,350.1092147926665,341.6291852073329,346.29912779978446,343.21483514011305,346.8342505107162,339.59541976950993,38429,58442.7,58.85542918744147,55.09529245269584,NaN,NaN,NaN,NaN,0.7390152185740047,20.868891554148586,93848564,-0.11234342629390348,0.3402613564067565,0.45260478270065996
2025-08-25T15:05:00-04:00,347.76,349.2,347.66,349.18,345.90062156619655,NaN,NaN,NaN,NaN,NaN,346.03639999999973,350.12336221683705,341.9494377831624,347.12530223982753,343.3512499286343,347.0254978123655,339.6770020449031,141215,61030.5,67.64087996380621,55.44478986324838,NaN,NaN,NaN,NaN,0.7962284172472874,22.151640079700037,93989779,0.016334066139257364,0.47302236537473163,0.45668829923547427
2025-08-25T15:10:00-04:00,349.18,349.45,348.94,349.27,346.71104785864213,NaN,NaN,NaN,NaN,NaN,346.2183999999997,350.04646553783783,342.39033446216155,347.53524179186206,343.45446142323897,347.17706081617337,339.73186203030457,101277,62690.2,68.10251536462604,56.05449073399894,NaN,NaN,NaN,NaN,0.775783530301052,23.552737435394437,94091056,0.09771041645488421,0.5788263198040795,0.4811159033491953
2025-08-25T15:15:00-04:00,349.29,349.54,348.7,349.03,346.71104785864213,NaN,NaN,NaN,NaN,NaN,346.3947999999997,349.89822059166045,342.89137940833893,347.58819343348966,343.5412089782112,347.29963667081614,339.7827812856063,90030,63685.36666666667,65.42222924844893,56.56797918543709,NaN,NaN,NaN,NaN,0.7803704209938361,24.374485048593915,94001026,0.12389091365133431,0.6359795454133632,0.5120886317620289
2025-08-25T15:20:00-04:00,349.03,349.4,348.93,348.93,346.72829980508504,NaN,NaN,NaN,NaN,NaN,346.55399999999963,349.76841752145714,343.3395824785421,347.6035547467917,343.59056205958166,347.368301170281,339.81282294888234,52520,63484.53333333333,64.28692028531268,56.77533299240107,NaN,NaN,NaN,NaN,0.75820110520856,25.137536403707717,93948506,0.12275539499146138,0.6655328755013556,0.5427774805098943
2025-08-25T15:25:00-04:00,348.95,349.14,348.42,348.505,346.72829980508504,NaN,NaN,NaN,NaN,NaN,346.69589999999965,349.6009973756817,343.7908026243176,347.6035547467917,343.6443954984721,347.438092576159,339.85069842078514,62984,62700.63333333333,59.55658294069325,57.423680164124335,NaN,NaN,NaN,NaN,0.7554724548365179,24.838369349219988,93885522,0.08353772743974153,0.6471996398095712,0.5636619123698297
2025-08-25T15:30:00-04:00,348.49,348.7,348.03,348.15,346.72829980508504,NaN,NaN,NaN,NaN,NaN,346.7938999999997,349.5544052367343,344.03339476326516,347.6035547467917,343.6800508115151,347.48087232414366,339.87922929888657,46097,62512.2,55.859248888681776,57.82553252650238,NaN,NaN,NaN,NaN,0.7493672794910535,23.876247079111288,93839425,0.026783598762115113,0.5971414108224735,0.5703578120603584
2025-08-25T15:35:00-04:00,348.17,348.43,347.76,347.84,346.72829980508504,NaN,NaN,NaN,NaN,NaN,346.8828999999997,349.48084695133275,344.2849530486667,347.6035547467917,343.7220408826586,347.52811525515114,339.915966510166,58857,61704.566666666666,52.77797927670549,57.88113032049137,NaN,NaN,NaN,NaN,0.7436981880988365,22.539252989271716,93780568,-0.0351761491720427,0.526387625595305,0.5615637747673478
2025-08-25T15:40:00-04:00,347.85,348.6,347.77,348.27,346.72829980508504,NaN,NaN,NaN,NaN,NaN,346.96569999999963,349.4696073549751,344.46179264502416,347.6035547467917,343.7821670007536,347.5977535016363,339.9665804998709,82353,62771.13333333333,56.37284709585268,58.044286233562254,NaN,NaN,NaN,NaN,0.7498626032346368,21.544574953336035,93862921,-0.04984540125181891,0.49925702320257415,0.5491024244543931
2025-08-25T15:45:00-04:00,348.29,348.44,348.05,348.3,346.72829980508504,NaN,NaN,NaN,NaN,NaN,347.0306999999996,349.5008190340289,344.56058096597036,347.6035547467917,343.8312509496676,347.6544403737462,340.008061525589,68127,61130.066666666666,56.62096365022996,58.52574807023233,NaN,NaN,NaN,NaN,0.7241581315750188,20.62094534853862,93931048,-0.05951835804033023,0.4747044769039803,0.5342228349443106
2025-08-25T15:50:00-04:00,348.31,348.54,347.31,348.21,346.72829980508504,NaN,NaN,NaN,NaN,NaN,347.10689999999965,349.4808999077936,344.7329000922057,347.6035547467917,343.91865894607315,347.74883574388195,340.08848214826435,132555,61865.46666666667,55.59937810005621,59.037309594861526,NaN,NaN,NaN,NaN,0.7602896936053759,19.738025393107243,93798493,-0.0730751266368157,0.44287892664829087,0.5159540532851066
2025-08-25T15:55:00-04:00,348.18,348.18,346.5,346.68,NaN,NaN,NaN,349.8621601603522,349.8621601603522,349.8621601603522,347.14249999999964,349.43504291175634,344.84995708824295,347.6035547467917,343.98887310290826,347.80572324076553,340.172022965051,142447,64515.933333333334,41.79407831556279,58.17750805041204,NaN,NaN,NaN,NaN,0.8281261440621333,19.93246435076953,93656046,-0.1800864079234598,0.2908460433807818,0.4709324513042416
2025-08-26T09:30:00-04:00,344.93,348.66,344.29,347.93,NaN,NaN,NaN,349.47842560760887,NaN,NaN,347.1850999999996,349.45532509068255,344.9148749093166,347.6035547467917,346.96000000000004,346.96000000000004,346.96000000000004,270453,71054.93333333333,52.230071066324925,57.838132421522516,NaN,NaN,NaN,NaN,1.0811171337719812,21.844493442903094,93926499,-0.16223990029225643,0.26813257593892104,0.43037247623117747
2025-08-26T09:35:00-04:00,347.92,348.09,344.59,346.02,NaN,NaN,NaN,349.47842560760887,NaN,NaN,347.2038999999996,349.41898220215444,344.9888177978447,347.6035547467917,346.6440045609431,347.0042409206674,346.2837682012187,208103,76181.83333333333,40.3309879871658,56.817865097922024,NaN,NaN,NaN,NaN,1.2538944813596966,23.619949028455693,93718396,-0.2683645329979698,0.09491680998371521,0.363281342981685
2025-08-26T09:40:00-04:00,345.99,347.67,345.05,347.37,NaN,NaN,NaN,349.47842560760887,NaN,NaN,347.2568999999996,349.3554660729025,345.15833392709663,347.3428437974334,346.6577298053654,346.9683466659982,346.34711294473266,168691,80186.86666666667,49.149117256441116,56.124557102850574,NaN,NaN,NaN,NaN,1.3514734469768614,25.268586357897387,93887087,-0.2379714050368012,0.06581708668568353,0.30378849172248473
2025-08-26T09:45:00-04:00,347.42,348.26,346.17,347.58,NaN,NaN,NaN,349.47842560760887,NaN,NaN,347.3098999999995,349.30186836382995,345.3179316361691,346.9272750379467,346.8160403525815,347.21152254549474,346.4205581596683,196813,84686.36666666667,50.377618021345604,54.89146696410338,NaN,NaN,NaN,NaN,1.4042253436213696,25.810283870490657,94083900,-0.19581459925154748,0.05902024265805039,0.2548348419095979
2025-08-26T09:50:00-04:00,347.61,349.13,346.82,348.5,NaN,NaN,NaN,349.47842560760887,NaN,NaN,347.36509999999953,349.3328118596135,345.39738814038554,346.7909648194287,347.081185107205,347.720488419351,346.441881795059,209389,89792.16666666667,55.45488746269947,53.98806497110862,NaN,NaN,NaN,NaN,1.4689235333627004,25.076199549001903,94293289,-0.10273763513509881,0.12641279799072436,0.22915043312582317
2025-08-26T09:55:00-04:00,348.45,348.67,347.16,347.51,NaN,NaN,NaN,349.47842560760887,NaN,NaN,347.4028999999995,349.30663957320894,345.49916042679,346.7909648194287,347.147716441767,347.78948267033894,346.50595021319504,110848,91758.53333333334,49.5764720570486,52.85622517172289,NaN,NaN,NaN,NaN,1.4718575666939355,24.394549821905205,94182441,-0.10428172856500115,0.09879827241957173,0.20308000098457288
2025-08-26T10:00:00-04:00,347.505,348.47,346.4,346.54,NaN,NaN,NaN,349.47842560760887,NaN,NaN,347.4076999999995,349.30147634436906,345.51392365563,346.7909648194287,347.1467236618458,347.7589895233413,346.53445780035025,114934,94002.5,44.589114394673025,51.44923903667719,NaN,NaN,NaN,NaN,1.5145820262158007,24.465482063551086,94067507,-0.16353749139156165,-0.001341863254879172,0.16219562813668248
2025-08-26T10:05:00-04:00,346.58,346.64,345.49,346.17,NaN,NaN,NaN,349.47842560760887,NaN,NaN,347.41489999999953,349.2869368486076,345.5428631513915,346.60577185554297,347.0557236702797,347.7108953675664,346.40055197299296,121803,96510.5,42.81960753164006,50.25374079317339,NaN,NaN,NaN,NaN,1.4885404529146704,25.2282627196987,93945704,-0.2171961922185998,-0.10929961213656725,0.10789658008203254
2025-08-26T10:10:00-04:00,346.15,346.99,345.68,346.15,NaN,NaN,NaN,349.47842560760887,NaN,NaN,347.4288999999995,349.251773874572,345.606026125427,345.77761748443436,347.00601153626263,347.66812854105274,346.34389453147253,95060,98271.9,42.72091667412259,49.315288492133455,NaN,NaN,NaN,NaN,1.4757875634207653,25.44057216464154,93850644,-0.24170266886073233,-0.19423175599388287,0.04747091286684946
2025-08-26T10:15:00-04:00,346.13,347.18,345.85,347.18,NaN,NaN,NaN,349.47842560760887,NaN,NaN,347.4658999999995,349.18924522439596,345.7425547756031,344.5530939875475,346.99017296324513,347.6356452455973,346.34470068089297,93473,99353.73333333334,49.212928783835764,49.060642028357044,NaN,NaN,NaN,NaN,1.4653741660335666,25.37067490925932,93944117,-0.1790929898732828,-0.17639532447475403,0.0026976653985287535
2025-08-26T10:20:00-04:00,347.19,347.47,346.33,346.61,NaN,NaN,NaN,349.47842560760887,NaN,NaN,347.48069999999956,349.16114519171583,345.8002548082833,343.72241129729946,346.98050109245673,347.61040637589974,346.3505958090137,86777,99977.06666666667,46.09907787462096,48.32680136969764,NaN,NaN,NaN,NaN,1.4421331541740294,24.899120149640723,93857340,-0.16686276804528014,-0.2058807946580714,-0.03901802661279128
2025-08-26T10:25:00-04:00,346.615,346.63,345.7,346.109,NaN,NaN,NaN,349.47842560760887,NaN,NaN,347.4840799999995,349.15275453294646,345.8154054670525,343.72241129729946,346.94150127054564,347.58122105190733,346.30178148918395,82218,101611.7,43.49414263487273,47.38917129717212,NaN,NaN,NaN,NaN,1.4055522145901709,25.0221417087094,93775122,-0.18206680958554902,-0.26660153859472757,-0.08453472900917855
2025-08-26T10:30:00-04:00,346.04,346.42,345.58,345.99,NaN,NaN,NaN,349.47842560760887,NaN,NaN,347.4704799999995,349.1761466617112,345.7648133382878,343.72241129729946,346.90723936514473,347.55961909135567,346.2548596389338,66169,102635.33333333333,42.87442068795132,46.48024576773606,NaN,NaN,NaN,NaN,1.3651556278337325,25.23828804945997,93708953,-0.18887578026830126,-0.32062945434455514,-0.13175367407625388
2025-08-26T10:35:00-04:00,346.06,346.3,345.54,345.86,NaN,NaN,NaN,349.47842560760887,NaN,NaN,347.4496799999995,349.2072419684434,345.6921180315556,343.72241129729946,346.87108826884474,347.5384936288676,346.20368290882186,67930,103598.5,42.16757309577709,46.506923966322795,NaN,NaN,NaN,NaN,1.3219302258456083,25.4746191905041,93641023,-0.19033745387583587,-0.3696754914210487,-0.17933803754521285
2025-08-26T10:40:00-04:00,345.83,346.6,345.23,346.54,NaN,NaN,NaN,349.47842560760887,NaN,NaN,347.45227999999946,349.2040572943351,345.70050270566384,343.5889290378396,346.8387717266224,347.50907000219553,346.16847345104924,85492,105021.06666666667,47.082085980877146,46.13921074593367,NaN,NaN,NaN,NaN,1.3253637811423509,25.973183463460455,93726515,-0.13624479667410713,-0.3496440333878468,-0.21339923671373964
2025-08-26T10:45:00-04:00,346.48,346.6,345.58,345.68,NaN,NaN,NaN,349.47842560760887,NaN,NaN,347.4174799999994,349.23821454441907,345.5967454555797,343.61386900324163,346.8087300776606,347.4867811176562,346.13067903766495,69473,105220.46666666666,42.19808215288234,46.272574614913424,NaN,NaN,NaN,NaN,1.3035520824893285,26.436136002634214,93657042,-0.1481360604898565,-0.3985693123260603,-0.2504332518362038
2025-08-26T10:50:00-04:00,345.67,346.17,345.15,346.01,NaN,NaN,NaN,349.3498824212151,NaN,NaN,347.3960799999994,349.256889237146,345.5352707628528,343.61386900324163,346.7742666419305,347.46620703766587,346.0823262461952,70738,106303.46666666666,44.574013582542975,45.945781495349266,NaN,NaN,NaN,NaN,1.283298362311522,27.25615436602176,93727780,-0.1244807559900627,-0.40603419682378217,-0.28155344083371947
2025-08-26T10:55:00-04:00,346.01,346.26,345.52,345.62,NaN,NaN,NaN,349.3498824212151,NaN,NaN,347.3492799999994,349.26781235813274,345.43074764186605,343.61386900324163,346.74336882831307,347.4453271655922,346.04141049103396,69382,106821.23333333334,42.358048329561285,45.372955088793255,NaN,NaN,NaN,NaN,1.2444913364321282,27.841261317013682,93658398,-0.12545060239793815,-0.43836669383114213,-0.312916091433204
2025-08-26T11:00:00-04:00,345.59,346.46,345.47,346.32,NaN,NaN,NaN,349.3498824212151,NaN,NaN,347.3030799999994,349.2072235180095,345.39893648198927,343.8137009296597,346.7259151836525,347.4265798607305,346.0252505065745,59423,107521.03333333334,47.41152110843492,44.7984289206315,NaN,NaN,NaN,NaN,1.22631338382983,27.987147001177547,93717821,-0.07195699451479359,-0.40286233457669596,-0.33090534006190236
2025-08-26T11:05:00-04:00,346.3,346.47,346.01,346.09,NaN,NaN,NaN,349.3498824212151,NaN,NaN,347.25787999999943,349.1677575104962,345.3480024895027,344.1229607437278,346.7155474524692,347.41331693476354,346.01777797017485,44331,104291.56666666667,45.98498814363169,44.541894355387434,NaN,NaN,NaN,NaN,1.1715767135562731,28.102136684315,93673490,-0.04631739473826524,-0.3888020834847339,-0.34248468874646865
2025-08-26T11:10:00-04:00,346.09,346.47,345.74,346.07,NaN,NaN,NaN,349.3498824212151,NaN,NaN,347.22887999999944,349.16579927169255,345.2919607283063,344.22736859498224,346.7042031088955,347.400576014471,346.00783020332,42555,102334.16666666667,45.855783274047276,44.632370703914155,NaN,NaN,NaN,NaN,1.1400355197308263,28.512168538103488,93630935,-0.025972941695509566,-0.3749508658658556,-0.348977924170346
2025-08-26T11:15:00-04:00,346.03,346.47,345.63,346.42,NaN,NaN,NaN,349.3498824212151,NaN,NaN,347.2064799999994,349.15436308715107,345.2585969128477,344.25589487598575,346.69306520994445,347.38628218493074,345.99984823495816,50019,101000.46666666666,48.578665628672155,45.04373199655931,NaN,NaN,NaN,NaN,1.1186044111786266,29.01471842160433,93680954,0.013657859312880938,-0.33190560002924485,-0.3455634593421258
2025-08-26T11:20:00-04:00,346.42,347.53,346.3,347.36,NaN,NaN,NaN,349.3498824212151,NaN,NaN,347.20467999999937,349.1518258273971,345.25753417260165,345.1437159007886,346.7068243257669,347.3906355974843,346.0230130540495,92011,102316.83333333333,55.1082800909129,45.92854366918719,NaN,NaN,NaN,NaN,1.1265612389515791,27.438061175981165,93772965,0.10092075014020618,-0.2194125216668681,-0.32033327180707427
2025-08-26T11:25:00-04:00,347.37,347.78,346.96,347.07,NaN,NaN,NaN,349.3498824212151,NaN,NaN,347.1870799999994,349.1228353505195,345.25132464947933,345.4609727206309,346.7252401410532,347.4051957474702,346.04528453463615,83705,103007.53333333334,52.8774350458645,46.19029411647495,NaN,NaN,NaN,NaN,1.1046640075978944,25.585398036077844,93689260,0.13473830184737057,-0.15191039449786103,-0.2866486963452316
2025-08-26T11:30:00-04:00,347.02,347.1,343.72,343.87,NaN,NaN,NaN,349.0806605999896,NaN,NaN,347.1024799999994,349.2313500949503,344.9736099050485,345.4609727206309,346.63383002800407,347.40714861531995,345.8605114406882,134697,105960.86666666667,35.702693949150344,45.44769526465562,NaN,NaN,NaN,NaN,1.2671880070551873,26.78647536101572,93554563,-0.052731919093111035,-0.3525635952116204,-0.29983167611850936
2025-08-26T11:35:00-04:00,343.83,345.15,343.81,344.835,NaN,NaN,NaN,348.16653966362645,NaN,NaN,347.04297999999943,349.25413294836676,344.8318270516321,345.4609727206309,346.5642115566774,347.4094508226301,345.71897229072465,95421,107179.66666666667,41.83780751469123,45.329385613214086,NaN,NaN,NaN,NaN,1.2723888636941008,27.901761448458036,93649984,-0.10315277360028186,-0.42877264311886165,-0.3256198695185798
2025-08-26T11:40:00-04:00,344.84,345.43,344.72,345.31,NaN,NaN,NaN,348.16653966362645,NaN,NaN,346.9991799999994,349.258620592951,344.7397394070478,345.4609727206309,346.5293368550665,347.39233022228314,345.6663434878499,70710,106791.56666666667,44.63802880857495,45.45535762183006,NaN,NaN,NaN,NaN,1.2322182305730922,28.530992250085973,93720694,-0.09606614503871613,-0.44570255081697496,-0.34963640577825883
2025-08-26T11:45:00-04:00,345.33,345.47,344.7,344.79,NaN,NaN,NaN,348.16653966362645,NaN,NaN,346.94757999999945,349.28720797403474,344.60795202596415,345.4609727206309,346.5032185666737,347.3817162163698,345.6247209169776,49266,106162.86666666667,42.24044139746737,45.46056250052224,NaN,NaN,NaN,NaN,1.1992026426750169,29.055620855340354,93671428,-0.11658605429579189,-0.4953689736479987,-0.3787829193522068
2025-08-26T11:50:00-04:00,344.78,345.6,344.78,345.36,NaN,NaN,NaN,348.16653966362645,NaN,NaN,346.8985799999994,349.2663609056153,344.53079909438355,345.4609727206309,346.47944407848235,347.3662725769401,345.5926155800246,56118,103614.96666666666,45.68434254874341,45.36072368394125,NaN,NaN,NaN,NaN,1.172116739626805,29.33959607106948,93727546,-0.08350654231739807,-0.48316609724895443,-0.39965955493155636
2025-08-26T11:55:00-04:00,345.33,345.52,344.91,345.02,NaN,NaN,NaN,348.16653966362645,NaN,NaN,346.86617999999936,349.29087860253395,344.44148139746477,345.4609727206309,346.45622447869295,347.35235989238146,345.56008906500443,52724,100624.2,43.999111457883146,45.48936863429845,NaN,NaN,NaN,NaN,1.1319655439391731,29.603287342817953,93674822,-0.07644977995367136,-0.4952217798736456,-0.4187719999199742
2025-08-26T12:00:00-04:00,345.04,345.23,344.36,344.51,NaN,NaN,NaN,348.16653966362645,NaN,NaN,346.8241799999994,349.3363471506988,344.31201284929995,345.4609727206309,346.4179370135835,347.3406106524704,345.49526337469666,67278,93851.7,41.52468595770925,45.2715595182389,NaN,NaN,NaN,NaN,1.1132537193720897,30.293732194975814,93607544,-0.09674825838413431,-0.5397073229001421,-0.4429590645160078
2025-08-26T12:05:00-04:00,344.5,344.76,344.33,344.6,NaN,NaN,NaN,347.842501429635,NaN,NaN,346.77977999999945,349.36799465277636,344.19156534722254,345.4609727206309,346.3940792103564,347.33431996117423,345.45383845953853,40216,88255.46666666666,42.14304831111901,45.25620237406445,NaN,NaN,NaN,NaN,1.0644498822740838,30.958466633085912,93647760,-0.09461728486275756,-0.5612306705944548,-0.4666133857316972
2025-08-26T12:10:00-04:00,344.61,345.09,344.32,345.03,NaN,NaN,NaN,347.842501429635,NaN,NaN,346.7389799999994,349.3715446660728,344.106415333926,345.4609727206309,346.367680535692,347.3217882727129,345.41357279867105,53095,84402.26666666666,45.128616654811246,45.093137770234186,NaN,NaN,NaN,NaN,1.0434177478259337,30.97181887997641,93700855,-0.05662601691256608,-0.5373959068724048,-0.4807698899598387
2025-08-26T12:15:00-04:00,345.01,345.25,344.37,345.11,NaN,NaN,NaN,347.842501429635,NaN,NaN,346.7087799999995,349.3804652600665,344.03709473993246,343.5547781765047,346.3381456896345,347.30461199734754,345.3716793819214,65750,80033.5,45.69012534785098,45.07207614196414,NaN,NaN,NaN,NaN,1.0317450515526523,30.697071054109532,93766605,-0.020356896376647893,-0.5062160104306486,-0.4858591140540007
2025-08-26T12:20:00-04:00,345.11,345.4,345.03,345.19,NaN,NaN,NaN,347.842501429635,NaN,NaN,346.68337999999943,349.3879882128292,343.97877178716965,343.5100319187155,346.32282860859056,347.2915953140527,345.3540619031284,44532,74538.26666666666,46.28211506485918,45.102528412736426,NaN,NaN,NaN,NaN,0.9844775478703204,30.169363332437854,93811137,0.012977925777800547,-0.46963670683174996,-0.4826146326095505
2025-08-26T12:25:00-04:00,345.19,346.35,345.19,346.28,NaN,NaN,NaN,347.842501429635,NaN,NaN,346.6677799999994,349.3725169500489,343.96304304994993,344.25802553497243,346.3137025601811,347.27263255762546,345.3547725627368,80334,73521.13333333333,53.68907524850473,45.46755767129589,NaN,NaN,NaN,NaN,0.997014865879585,28.18247092275285,93891471,0.10715238123083004,-0.34867415607101293,-0.45582653730184297
2025-08-26T12:30:00-04:00,346.3,346.93,346.01,346.61,NaN,NaN,NaN,347.842501429635,NaN,NaN,346.6509799999994,349.34649305711395,343.9554669428848,344.7964204279779,346.3171026790305,347.2683233388752,345.3658820191858,57416,71603.86666666667,55.68148399908691,45.50850080759404,NaN,NaN,NaN,NaN,0.9915138040310444,26.736188448454506,93948887,0.18577751315219537,-0.22360464586159878,-0.40938215901379416
2025-08-26T12:35:00-04:00,346.62,346.66,345.95,346.59,NaN,NaN,NaN,347.842501429635,NaN,NaN,346.63837999999936,349.32902125910783,343.9477387408909,344.7964204279779,346.31835918194986,347.2623976608104,345.3743207030893,52749,69302.06666666667,55.52556869655765,45.69765321121498,NaN,NaN,NaN,NaN,0.9714056751716866,25.307841062633468,93896138,0.2277753641195141,-0.12466295386440152,-0.3524383179839156
2025-08-26T12:40:00-04:00,346.59,346.8,346.2,346.35,NaN,NaN,NaN,347.842501429635,NaN,NaN,346.61037999999934,349.28324578511626,343.9375142148824,344.85050907390587,346.31982665885846,347.25869025587883,345.3809630618381,39232,67441.13333333333,53.5864738598498,46.97506606197923,NaN,NaN,NaN,NaN,0.9448766983737107,24.161857536944034,93856906,0.23005531605845542,-0.06486917291084637,-0.2949244889693018
2025-08-26T12:45:00-04:00,346.34,346.62,345.87,346.02,NaN,NaN,NaN,347.842501429635,NaN,NaN,346.54717999999934,349.12164745430687,343.9727125456918,344.85050907390587,346.3184337303284,347.2530334794063,345.3838339812505,33026,65426.23333333333,50.95164953155655,47.626054777469605,NaN,NaN,NaN,NaN,0.93095693420416,22.595878950899834,93823880,0.20105340715755443,-0.04360773002235874,-0.24466113717991317
2025-08-26T12:50:00-04:00,346.04,346.4,345.72,346.13,NaN,NaN,NaN,347.842501429635,NaN,NaN,346.48437999999936,348.9405824641911,344.02817753580763,344.85050907390587,346.31616937638756,347.2465408511796,345.38579790159554,34547,63685.23333333333,51.802367525641834,48.13779325726009,NaN,NaN,NaN,NaN,0.9130314389038593,21.044869444393054,93858427,0.18158649259655327,-0.01767802143422159,-0.19926451403077486
2025-08-26T12:55:00-04:00,346.04,346.54,345.8,346.47,NaN,NaN,NaN,347.842501429635,NaN,NaN,346.4331799999994,348.7792505089625,344.08710949103636,344.85050907390587,346.31572968613256,347.24167126238325,345.38978810988186,34488,62094.23333333333,54.43312820921109,49.00869945809893,NaN,NaN,NaN,NaN,0.9006720504107272,19.693126399555048,93892915,0.1833806059233454,0.029961243373406887,-0.15341936254993851
2025-08-26T13:00:00-04:00,346.45,346.89,346.23,346.62,NaN,NaN,NaN,347.842501429635,NaN,NaN,346.38697999999937,348.6229523614493,344.15100763854946,345.05588851667187,346.3195961351152,347.23928672682,345.3999055434104,53770,61680.933333333334,55.58494360777577,49.715885248029814,NaN,NaN,NaN,NaN,0.8834811896671015,18.956550704761334,93946685,0.18586335163005183,0.07890982698762627,-0.10695352464242555
2025-08-26T13:05:00-04:00,346.66,346.74,346.28,346.32,NaN,NaN,NaN,347.842501429635,NaN,NaN,346.34327999999937,348.4958161435307,344.19074385646803,345.05588851667187,346.32077582683274,347.236268487032,345.40528316663347,34439,60564.566666666666,52.71494239202999,50.33844460046888,NaN,NaN,NaN,NaN,0.8532325332623112,18.272587559595742,93912246,0.15950600024641887,0.09242897566559805,-0.06707702458082082
2025-08-26T13:10:00-04:00,346.32,346.7,345.97,346.65,NaN,NaN,NaN,347.842501429635,NaN,NaN,346.31327999999934,348.4052166742882,344.22134332571045,345.05588851667187,346.32218000587324,347.2323564161696,345.4120035955769,44211,59188.53333333333,55.440424436923934,51.33242592041279,NaN,NaN,NaN,NaN,0.8444302094578576,17.08430007951383,93956457,0.15629551241089143,0.12829236593279347,-0.028003146478097957
2025-08-26T13:15:00-04:00,346.6,346.73,346.04,346.44,NaN,NaN,NaN,347.842501429635,NaN,NaN,346.2852799999994,348.3317104945577,344.23884950544107,345.05588851667187,346.32309315309504,347.2281748471344,345.41801145905566,42719,58296.73333333333,53.33368403151711,52.131757043298364,NaN,NaN,NaN,NaN,0.8333994802108676,16.032354860936866,93913738,0.13294356174577532,0.1381763057041212,0.00523274395834588
2025-08-26T13:20:00-04:00,346.47,346.97,346.45,346.93,NaN,NaN,NaN,347.842501429635,NaN,NaN,346.25847999999945,348.23411378209585,344.28284621790306,345.32638793642883,346.3275609262556,347.22936858584353,345.4257532666677,37216,57179.333333333336,57.4013200840984,53.008378716818875,NaN,NaN,NaN,NaN,0.8117280887672363,15.469560926342323,93950954,0.14256083962864002,0.1834337934941459,0.040872953865505886
2025-08-26T13:25:00-04:00,346.94,347.28,346.54,347.11,NaN,NaN,NaN,347.842501429635,NaN,NaN,346.2346799999994,348.13874031233445,344.33061968766435,345.595110349143,346.33662725419344,347.2353489936489,345.43790551473796,54306,56676.8,58.821268739454545,53.946317530504835,NaN,NaN,NaN,NaN,0.8066046538552875,15.447363262150112,94005260,0.1522300368727969,0.231160499956502,0.0789304630837051
2025-08-26T13:30:00-04:00,347.12,347.19,346.11,346.31,NaN,NaN,NaN,347.842501429635,NaN,NaN,346.19667999999945,348.0154632176546,344.3778967823443,345.595110349143,346.3386288468187,347.23306459585615,345.4441930977813,39297,56005.933333333334,50.72796072639889,54.26387793490053,NaN,NaN,NaN,NaN,0.8261328928656229,14.58539866642754,93965963,0.09853662728126214,0.20210124718528277,0.10356461990402063
2025-08-26T13:35:00-04:00,346.22,346.47,345.79,345.96,NaN,NaN,NaN,347.842501429635,NaN,NaN,346.1822799999994,347.9969250035546,344.3676349964442,345.595110349143,346.3354595160249,347.2250036449738,345.445915387076,47485,56111.066666666666,47.63963668195595,53.831775180147055,NaN,NaN,NaN,NaN,0.8156948290895075,13.86162240593915,93918478,0.03643682433026882,0.14911065031685666,0.11267382598658784
2025-08-26T13:40:00-04:00,345.95,346.24,345.79,345.92,NaN,NaN,NaN,347.842501429635,NaN,NaN,346.14207999999945,347.8878215549873,344.3963384450116,345.595110349143,346.3330211869207,347.2199609041285,345.44608146971285,27716,55616.433333333334,47.2853306716906,53.23204994247589,NaN,NaN,NaN,NaN,0.7895737698688275,13.18954444977136,93890762,-0.007976139943330393,0.10270365105742485,0.11067979100075524
2025-08-26T13:45:00-04:00,345.91,346.13,345.69,346.01,NaN,NaN,NaN,347.842501429635,NaN,NaN,346.14187999999945,347.8876797436215,344.3960802563774,345.595110349143,346.329341686587,347.2128882785351,345.44579509463887,38153,55220.9,48.218481956802606,52.71011517535053,NaN,NaN,NaN,NaN,0.7646042148781967,12.747863560306458,93928915,-0.030660659876246693,0.07235396615544687,0.10301462603169356
2025-08-26T13:50:00-04:00,346,346.14,345.08,345.14,NaN,NaN,NaN,347.842501429635,NaN,NaN,346.0972799999994,347.82918614323194,344.36537385676684,345.595110349143,346.31954999151253,347.2029584154046,345.43614156762044,45676,53676.4,40.715385208635645,51.790751700263804,NaN,NaN,NaN,NaN,0.7857039138154686,13.32972666056586,93883239,-0.09973212724610188,-0.021650533025933782,0.0780815942201681
2025-08-26T13:55:00-04:00,345.1,345.8,345.08,345.76,NaN,NaN,NaN,347.842501429635,NaN,NaN,346.0608799999994,347.74237427148836,344.3793857285104,345.595110349143,346.3139543404101,347.1965945673977,345.43131411342245,29801,51879.6,47.03997437437339,51.511346331893584,NaN,NaN,NaN,NaN,0.7810107771143656,13.870028110806738,93913040,-0.09894156537015052,-0.04559536249252005,0.053346202877630464
2025-08-26T14:00:00-04:00,345.74,346.09,345.57,345.93,NaN,NaN,NaN,347.842501429635,NaN,NaN,346.00947999999937,347.5399312409861,344.47902875901264,345.595110349143,346.31011399468656,347.1899606864108,345.4302673029623,35381,48569.066666666666,48.65734862587452,51.28670212476735,NaN,NaN,NaN,NaN,0.762367150177624,13.714786440031885,93948421,-0.08289672045191016,-0.05027469768725723,0.032622022764652925
2025-08-26T14:05:00-04:00,345.96,346.38,345.85,346.33,NaN,NaN,NaN,347.842501429635,NaN,NaN,345.98587999999944,347.45834289762524,344.51341710237364,345.595110349143,346.3090258197883,347.1850620489245,345.4329895906521,36921,46619.066666666666,52.345131688947134,51.13755951617707,NaN,NaN,NaN,NaN,0.7457694965935061,12.966471060317849,93985342,-0.04326488265851132,-0.02145908055848622,0.021805802100025095
2025-08-26T14:10:00-04:00,346.33,346.89,346.33,346.74,NaN,NaN,NaN,347.842501429635,NaN,NaN,345.98987999999946,347.4694119614,344.5103480385989,345.595110349143,346.3125912429479,347.1847765809218,345.44040590497406,43827,45722.96666666667,55.845924570032565,51.15620101348112,NaN,NaN,NaN,NaN,0.7325002468368272,12.733908781571252,94029169,0.00981004494477208,0.034068358280990196,0.024258313336218116
2025-08-26T14:15:00-04:00,346.73,346.96,346.6,346.93,NaN,NaN,NaN,347.842501429635,NaN,NaN,346.00507999999945,347.5071456632856,344.5030143367133,345.516862243785,346.31681549271633,347.1866801292734,345.4469508561593,34838,45242.03333333333,57.40744358926325,51.491379670426355,NaN,NaN,NaN,NaN,0.7058930863484794,12.635349780188152,94064007,0.05446632028113131,0.09234121368763226,0.03787489340650095
2025-08-26T14:20:00-04:00,346.95,347.04,346.36,346.97,NaN,NaN,NaN,347.842501429635,NaN,NaN,346.0214799999994,347.54723585231454,344.4957241476843,345.54548979502806,346.32274397845157,347.18874306962834,345.4567448872748,54141,45176.13333333333,57.74623544740176,51.656080456889065,NaN,NaN,NaN,NaN,0.7040435801807313,12.042925923569973,94118148,0.08180820239487777,0.14013514640009817,0.0583269440052204
2025-08-26T14:25:00-04:00,347,347.07,346.79,346.92,NaN,NaN,NaN,347.842501429635,NaN,NaN,346.0162799999995,347.5279136622055,344.5046463377935,345.73439183602244,346.3275918517933,347.1917900638317,345.4633936397548,34969,44584.3,57.134459947517776,51.92756445088911,NaN,NaN,NaN,NaN,0.6737547530249629,11.550256337610797,94083179,0.09093440444653098,0.17199494956338413,0.08106054511685315
2025-08-26T14:30:00-04:00,346.94,347.53,346.91,347.5,NaN,NaN,NaN,347.842501429635,NaN,NaN,346.03407999999945,347.59346535869537,344.47469464130353,346.15151346881794,346.34367179873385,347.2098402709658,345.4775033265019,72240,44749.7,62.144488435376196,52.26636219026609,NaN,NaN,NaN,NaN,0.6699151278088904,11.918633649415558,94155419,0.12816283084305463,0.24126408367067143,0.11310125282761681
2025-08-26T14:35:00-04:00,347.48,347.7,347.36,347.62,NaN,NaN,NaN,347.842501429635,NaN,NaN,346.0642999999995,347.6856550019408,344.4429449980582,346.4272107750544,346.35628304824644,347.22671363505737,345.4858524614355,46397,44955.73333333333,63.105290497988975,52.57236374444712,NaN,NaN,NaN,NaN,0.6463497615368251,12.535965669186286,94201816,0.1514053770273237,0.30235797411177145,0.15095259708444775
2025-08-26T14:40:00-04:00,347.61,348.08,347.58,347.88,345.65060936294685,345.65060936294685,345.65060936294685,NaN,NaN,NaN,346.1020999999995,347.80103388992933,344.40316611006966,346.8117686200435,346.3834626774302,347.26867550418723,345.4982498506732,83123,45956.666666666664,65.16809835962741,53.60380214682059,NaN,NaN,NaN,NaN,0.6358962071413377,13.6778448036179,94284939,0.17325282122267832,0.36751862361279564,0.19426580239011731
2025-08-26T14:45:00-04:00,347.89,347.97,347.63,347.745,345.6733089373584,NaN,NaN,NaN,NaN,NaN,346.1397999999995,347.8981889906007,344.38141100939833,346.8117686200435,346.3940016510504,347.2841251870141,345.5038781150867,34617,44918.9,63.192470591896296,54.71471885467348,NaN,NaN,NaN,NaN,0.6147607637741015,14.73816114273297,94250322,0.16747770796006542,0.4036129373401991,0.23613522938013368
2025-08-26T14:50:00-04:00,347.73,348.25,347.7,348.22,345.869976712933,NaN,NaN,NaN,NaN,NaN,346.1733999999995,348.02293555312656,344.32386444687245,347.02733191682785,346.4140854517001,347.3172678955299,345.5109030078703,56154,45306.3,66.98497605033472,56.12183638171948,NaN,NaN,NaN,NaN,0.6101349949330951,16.125490494733473,94306476,0.18323911115589187,0.4651841183249985,0.28194500716910664
2025-08-26T14:55:00-04:00,348.22,348.66,347.94,348.28,346.1924777714361,NaN,NaN,NaN,NaN,NaN,346.2253999999995,348.16073236477683,344.2900676352222,347.3218655334623,346.4431610398372,347.36885663051027,345.51746544916415,73056,45063.7,67.44132659402491,57.49489671294964,NaN,NaN,NaN,NaN,0.6179824952950188,17.934009529168655,94379532,0.18477097735216708,0.5129087288593155,0.3281377515071484
2025-08-26T15:00:00-04:00,348.27,348.48,347.73,348.15,346.1924777714361,NaN,NaN,NaN,NaN,NaN,346.2681999999996,348.2758849957018,344.26051500429736,347.3218655334623,346.46142807062455,347.39837766354316,345.52447847770594,52005,44883.333333333336,65.334135651687,59.25337888745331,NaN,NaN,NaN,NaN,0.6274123170596603,19.03226609617155,94327527,0.16475725591362328,0.5340843213991775,0.3693270654855542
2025-08-26T15:05:00-04:00,348.13,348.43,347.85,348.4,346.1924777714361,NaN,NaN,NaN,NaN,NaN,346.32379999999955,348.409078456746,344.2385215432531,347.3218655334623,346.4783198977034,347.4264795892699,345.5301602061369,46123,44662.46666666667,67.4409708833077,60.710592923805756,NaN,NaN,NaN,NaN,0.6240257229839691,20.052075765531377,94373650,0.15616352703945807,0.5645314742848768,0.40836794724541875
2025-08-26T15:10:00-04:00,348.41,348.88,348.34,348.7,346.5346831932071,NaN,NaN,NaN,NaN,NaN,346.3713999999995,348.560241739904,344.182558260095,347.45287515313265,346.52656569386767,347.5169729319744,345.5361584557609,110031,47022.433333333334,69.81195911274372,62.221636530010706,NaN,NaN,NaN,NaN,0.6180238856279727,21.594779416614056,94483681,0.15801308065471564,0.6058842980638133,0.44787121740909763
2025-08-26T15:15:00-04:00,348.7,348.82,348.32,348.78,346.5346831932071,NaN,NaN,NaN,NaN,NaN,346.4251999999995,348.71369816303996,344.13670183695905,347.45287515313265,346.5472402878526,347.5545028021174,345.53997777358785,48704,47545.03333333333,70.43034228782022,63.51343728707307,NaN,NaN,NaN,NaN,0.6095936080831176,22.96708692402614,94532385,0.15191129494419642,0.6377603360893431,0.4858490411451467
2025-08-26T15:20:00-04:00,348.82,350,348.67,349.55,347.1976142318272,NaN,NaN,NaN,NaN,NaN,346.49479999999954,348.9420237008597,344.0475762991394,348.2216400980049,346.6915481960991,347.8556734918989,345.5274229002993,264617,55214.03333333333,75.60920219217142,64.92509997436869,NaN,NaN,NaN,NaN,0.661051207505751,25.401320751527084,94797002,0.18483358094147007,0.7168910173219842,0.5320574363805142
2025-08-26T15:25:00-04:00,349.54,349.99,349.15,349.75,347.41522267583497,NaN,NaN,NaN,NaN,NaN,346.56139999999954,349.17261047831704,343.95018952168203,348.2216400980049,346.7455424966501,347.96457091344513,345.5265140798551,98150,57336.1,76.74831378788126,66.3065907028414,NaN,NaN,NaN,NaN,0.6738332641124852,27.661680734206534,94895152,0.20369221693481288,0.7866727075490303,0.5829804906142174
2025-08-26T15:30:00-04:00,349.7,349.96,349.48,349.52,347.59771255420617,NaN,NaN,NaN,NaN,NaN,346.60459999999955,349.33593655231533,343.87326344768377,348.2458496627231,346.78916188744887,348.049587191954,345.52873658294374,81347,58255.333333333336,72.55196142293727,67.36414255823681,NaN,NaN,NaN,NaN,0.6599880309615906,29.760586432408875,94813805,0.18484157749597996,0.8140324624841924,0.6291908849882124
2025-08-26T15:35:00-04:00,349.54,349.97,349.12,349.72,347.59771255420617,NaN,NaN,NaN,NaN,NaN,346.6575999999996,349.522576956613,343.7926230433862,348.2458496627231,346.83987505237064,348.1437871589734,345.5359629457679,99516,60424.566666666666,73.88891072429993,68.56088904229267,NaN,NaN,NaN,NaN,0.6735603144643357,30.647896957806086,94913321,0.17036398053176605,0.84214586065292,0.6717818801211539
2025-08-26T15:40:00-04:00,349.725,349.94,349.24,349.33,347.59771255420617,NaN,NaN,NaN,NaN,NaN,346.7667999999996,349.6146193485438,343.9189806514554,348.2458496627231,346.8825776798741,348.2185571789319,345.54659818081626,89981,61950.23333333333,67.03233515694748,68.91002095097633,NaN,NaN,NaN,NaN,0.6754488634311681,31.47182815996064,94823340,0.12134554580157297,0.8234638123731202,0.7021182665715472
2025-08-26T15:45:00-04:00,349.32,349.86,349.27,349.73,347.59771255420617,NaN,NaN,NaN,NaN,NaN,346.8646999999995,349.77599415246345,343.9534058475356,348.2458496627231,346.9108718011205,348.2684598917579,345.5532837104831,58615,62480.1,70.09725504302193,69.40944698990725,NaN,NaN,NaN,NaN,0.6693453731860869,32.23690713338986,94881955,0.1033865938459928,0.8313515088790382,0.7279649150330454
2025-08-26T15:50:00-04:00,349.72,350.85,349.64,350.74,348.05347937834915,NaN,NaN,NaN,NaN,NaN,346.9732999999996,350.045192973703,343.90140702629617,348.8652840218514,347.1109844559861,348.6594733080172,345.562495603955,343989,72705.86666666667,76.13126928870453,70.19253062769847,NaN,NaN,NaN,NaN,0.7079635608156547,33.960471354279804,95225944,0.14452969787704117,0.9086270373793468,0.7640973395023056
2025-08-26T15:55:00-04:00,350.9,351.9,350.78,351.7,349.0899121338787,NaN,NaN,NaN,NaN,NaN,347.1114999999996,350.3926767709116,343.8303232290876,349.73222721748107,347.24391588648876,348.9424377261021,345.5453940468754,189648,77217.26666666666,80.21740726495159,71.40859753291672,NaN,NaN,NaN,NaN,0.7402518779002485,36.24308445104483,95415592,0.21703974049665453,1.0353970151231238,0.8183572746264692
2025-08-27T09:30:00-04:00,351.94,354.66,351.68,354.25,350.61582521870247,NaN,NaN,NaN,NaN,NaN,347.28929999999957,351.09336414798827,343.4852358520109,351.4357817739849,353.53000000000003,353.53000000000003,353.53000000000003,273015,85007.86666666667,86.7204910486268,72.81827717565186,NaN,NaN,NaN,NaN,0.9002338866216606,39.29399105480291,95688607,0.406384284292604,1.3263376299922243,0.9199533456996203
2025-08-27T09:35:00-04:00,354.18,355.4,352.79,353.37,351.3010149814887,NaN,NaN,NaN,NaN,NaN,347.4562999999996,351.5679132164696,343.3446867835296,351.5156254191879,353.6894303848391,353.85108158396406,353.52777918571417,265565,92277.2,77.27930566054292,73.52098996611744,NaN,NaN,NaN,NaN,1.022360037577253,42.27649846784258,95423042,0.43921185722107703,1.4689681672259667,1.0297563100048897
2025-08-27T09:40:00-04:00,353.37,353.38,351.15,351.97,NaN,NaN,NaN,355.23607660857897,355.23607660857897,355.23607660857897,347.6054999999996,351.8187819751067,343.39221802489254,351.5156254191879,353.3150846683909,353.985616232238,352.64455310454383,175559,97205.3,65.13083780664192,73.50646869147135,NaN,NaN,NaN,NaN,1.1086200348931647,42.56481524162526,95247483,0.3380305115782296,1.4522944494776766,1.114263937899447
2025-08-27T09:45:00-04:00,351.96,352.74,349.78,351.52,NaN,NaN,NaN,354.49966403546176,NaN,NaN,347.74389999999966,352.00750752904065,343.48029247095866,351.5156254191879,352.8485342876231,353.87017181692954,351.8268967583167,221845,103328.36666666667,61.76957791971688,73.101369194072,NaN,NaN,NaN,NaN,1.2408614609722268,41.29420350545184,95025638,0.21801540600633107,1.3867831954073608,1.1687677894010298
2025-08-27T09:50:00-04:00,351.56,352,350.44,351.44,NaN,NaN,NaN,354.49966403546176,NaN,NaN,347.87209999999965,352.18675877697365,343.55744122302565,351.5156254191879,352.6367675442968,353.72585649740864,351.54767859118493,147540,106723.83333333333,61.1652366607259,72.48374616178502,NaN,NaN,NaN,NaN,1.2636570709027823,40.11434975043366,94878098,0.11560268913332328,1.313271150817684,1.1976684616843607
2025-08-27T09:55:00-04:00,351.48,351.48,350,350.76,NaN,NaN,NaN,354.09671867693936,NaN,NaN,347.98509999999965,352.30042918347664,343.66977081652266,351.5156254191879,352.43567759371757,353.61871005072396,351.2526451367112,129002,110030.53333333334,56.13758748760297,71.46283510462665,NaN,NaN,NaN,NaN,1.2791101372668707,38.55551632182188,94749096,-0.008962627873770002,1.1864651768421481,1.1954278047159181
2025-08-27T10:00:00-04:00,350.75,351.03,350.02,350.52,NaN,NaN,NaN,353.8668678279875,NaN,NaN,348.0916999999996,352.38886911953807,343.79453088046114,351.5156254191879,352.2589517678164,353.5147208793576,351.00318265627527,123463,112966.6,54.43683853416626,69.95052341476914,NaN,NaN,NaN,NaN,1.2598879846049509,37.108028138110924,94625633,-0.11278264600419918,1.054449497210669,1.1672321432148682
2025-08-27T10:05:00-04:00,350.45,351.65,350.41,351.53,NaN,NaN,NaN,353.8668678279875,NaN,NaN,348.1966999999996,352.567596297304,343.8258037026952,351.5156254191879,352.1799601218677,353.41986551763523,350.94005472610013,107325,115313.4,59.937549139102515,68.74975451128493,NaN,NaN,NaN,NaN,1.2584674142760224,36.220874318504386,94732958,-0.1181283615612021,1.0195716912633657,1.1377000528245678
2025-08-27T10:10:00-04:00,351.52,352.4,350.79,352.01,NaN,NaN,NaN,353.8668678279875,NaN,NaN,348.3046999999996,352.7790680717851,343.83033192821415,351.5156254191879,352.15043094902865,353.35377524779204,350.94708665026525,102182,117258.56666666667,62.2689066824518,68.01525060125026,NaN,NaN,NaN,NaN,1.2835768846848747,35.89497471297212,94835140,-0.09502618417903741,1.018917322600771,1.1139435067798085
2025-08-27T10:15:00-04:00,352.02,352.64,351.89,352.53,NaN,NaN,NaN,353.8668678279875,NaN,NaN,348.42349999999965,353.02312531101416,343.82387468898514,351.5156254191879,352.1630735619756,353.3293571208595,350.99679000309163,102697,119520.53333333334,64.667685712353,67.35659167182548,NaN,NaN,NaN,NaN,1.2454642500645268,35.74324001135784,94937837,-0.052535182494446664,1.04827452866175,1.1008097111561967
2025-08-27T10:20:00-04:00,352.65,353.11,352.14,352.64,NaN,NaN,NaN,353.8668678279875,NaN,NaN,348.5492999999996,353.2579737030561,343.8406262969431,351.5156254191879,352.1856546101354,353.3277884022851,351.04352081798567,83759,120507.8,65.17210548167806,67.22371812359196,NaN,NaN,NaN,NaN,1.2257882322027769,35.89185086311672,95021596,-0.026164593740015896,1.0681039689811769,1.0942685627211928
2025-08-27T10:25:00-04:00,352.63,353.2,352.5,352.77,NaN,NaN,NaN,353.8668678279875,NaN,NaN,348.68429999999967,353.48138912172783,343.8872108782715,350.21780807573,352.21580525432364,353.3387964371268,351.0928140715205,85954,122207.3,65.79363574627521,66.9163167452529,NaN,NaN,NaN,NaN,1.1882319299025776,36.08519649102754,95107550,-0.009944369665705555,1.081838100639061,1.0917824703047665
2025-08-27T10:30:00-04:00,352.81,352.82,351.82,352.04,NaN,NaN,NaN,353.8668678279875,NaN,NaN,348.8024999999996,353.6331398128817,343.9718601871175,350.21780807573,352.21622643990236,353.3172305727452,351.1152223070595,73339,122243.93333333333,59.38486115333951,65.72014473558397,NaN,NaN,NaN,NaN,1.1747867920523933,35.35323693098892,95034211,-0.055797014129463474,1.022036202642937,1.0778332167724005
2025-08-27T10:35:00-04:00,352.01,352.96,351.96,352.51,NaN,NaN,NaN,353.8668678279875,NaN,NaN,348.92329999999964,353.8162654036942,344.03033459630507,350.21780807573,352.2241636989209,353.3091847043231,351.1391426935187,59450,122679.03333333334,61.95440023189739,64.41564423322296,NaN,NaN,NaN,NaN,1.162302021191508,34.779535656472845,95093661,-0.06144368938791689,1.0010286050375043,1.0624722944254212
2025-08-27T10:40:00-04:00,352.59,352.95,351.88,352.05,NaN,NaN,NaN,353.8668678279875,NaN,NaN,349.03189999999967,353.9564933397334,344.1073066602659,350.21780807573,352.2262616749647,353.2947670054838,351.1577563444456,61017,121942.16666666667,58.08138750142577,62.36999397985146,NaN,NaN,NaN,NaN,1.1557090196778286,34.13621267210814,95032644,-0.10080441877337498,0.9364667709587025,1.0372711897320774
2025-08-27T10:45:00-04:00,352.05,352.09,351.2,351.83,NaN,NaN,NaN,353.8668678279875,NaN,NaN,349.1420999999997,354.06561910341503,344.21858089658434,350.21780807573,352.210348362703,353.26616683199074,351.1545298934152,63558,122906.86666666667,56.269628822639575,60.86930277714407,NaN,NaN,NaN,NaN,1.136729803986554,32.638917594236176,94969086,-0.14368711668364242,0.8576622938775245,1.0013494105611669
2025-08-27T10:50:00-04:00,351.82,352.05,351.42,351.94,NaN,NaN,NaN,353.8668678279875,NaN,NaN,349.24789999999973,354.18000709145616,344.3157929085433,350.21780807573,352.1988679164881,353.2418685621382,351.155867270838,60235,123042.9,56.99201127629017,60.28795802497609,NaN,NaN,NaN,NaN,1.1005348179875143,31.24857216478364,95029321,-0.16514201328501932,0.7949218939548928,0.9600639072399121
2025-08-27T10:55:00-04:00,351.91,352.34,351.53,352.34,NaN,NaN,NaN,353.8668678279875,NaN,NaN,349.3658999999997,354.30595331566906,344.4258466843304,350.21780807573,352.1945670811085,353.2202766855729,351.1688574766441,73731,123065.4,59.605147449046164,60.13335584849961,NaN,NaN,NaN,NaN,1.0797823309884063,30.250305915426672,95103052,-0.15315816345885103,0.7686162029163484,0.9217743663751994
2025-08-27T11:00:00-04:00,352.35,352.9,352.26,352.56,NaN,NaN,NaN,353.8668678279875,NaN,NaN,349.47849999999977,354.44789684483874,344.5091031551608,350.6871010241633,352.2062981594817,353.21812871729503,351.1944676016684,70611,123685.6,61.00838595794022,60.12215222687206,NaN,NaN,NaN,NaN,1.0483693073463762,29.851581231950853,95173663,-0.13198186945029122,0.7567970295623354,0.8887788990126266
2025-08-27T11:05:00-04:00,352.58,353.58,352.395,353.51,NaN,NaN,NaN,353.8668678279875,NaN,NaN,349.6064999999997,354.65435350438383,344.55864649561556,351.2171808193307,352.2466168368342,353.2553229349699,351.23791073869853,100454,125496.63333333333,66.43122343197452,60.8574119371843,NaN,NaN,NaN,NaN,1.0581286425359209,30.044521099301686,95274117,-0.059266317874987484,0.8146960016688922,0.8739623195438797
2025-08-27T11:10:00-04:00,353.56,354.13,353.06,353.25,350.4813958587419,350.4813958587419,350.4813958587419,NaN,NaN,NaN,349.7452999999997,354.8045902310235,344.6860097689759,351.70474465546454,352.31215971708133,353.33194477027695,351.2923746638857,133590,126281.93333333333,63.81536024077584,61.52730634479928,NaN,NaN,NaN,NaN,1.0589765966404976,30.62619577408575,95140527,-0.035143120801161665,0.8300334185424276,0.8651765393435893
2025-08-27T11:15:00-04:00,353.29,353.78,352.91,352.91,350.4813958587419,NaN,NaN,NaN,NaN,NaN,349.8842999999997,354.9016778053523,344.86692219464715,351.70474465546454,352.3320593450016,353.3488799040936,351.31523878590957,57637,126579.7,60.462473096276945,61.56480091316888,NaN,NaN,NaN,NaN,1.0454782683090298,30.929907829729032,95082890,-0.04776656281516911,0.805468335824628,0.8532348986397971
2025-08-27T11:20:00-04:00,352.94,353.43,352.35,353.37,350.4813958587419,NaN,NaN,NaN,NaN,NaN,350.03329999999966,355.0132628956283,345.053337104371,351.70474465546454,352.35114786933644,353.3609865943014,351.3413091443715,70239,120100.43333333333,63.27393201719974,61.63658843707945,NaN,NaN,NaN,NaN,1.047944106286955,30.365676361208006,95153129,-0.031597343906139,0.8137382187571234,0.8453355626632624
2025-08-27T11:25:00-04:00,353.38,353.44,352.7,353.02,350.4813958587419,NaN,NaN,NaN,NaN,NaN,350.17349999999965,355.0867556418114,345.2602443581879,351.70474465546454,352.36419261208135,353.36909022584354,351.35929499831917,50006,118495.63333333333,59.79018177700317,61.28819529884017,NaN,NaN,NaN,NaN,1.0259480986950302,29.85101839104368,95103123,-0.049849351064685465,0.7830238738324056,0.832873224897091
2025-08-27T11:30:00-04:00,352.98,353.32,352.42,352.62,350.4813958587419,NaN,NaN,NaN,NaN,NaN,350.3230999999996,355.06677995989696,345.57942004010226,351.70474465546454,352.3717773119269,353.3691923136683,351.3743623101855,49209,117424.36666666667,55.99569161196856,60.6327371652895,NaN,NaN,NaN,NaN,1.0169518059310978,28.947431276122654,95053914,-0.09179638193351614,0.7181277474801959,0.8099241294137121
2025-08-27T11:35:00-04:00,352.58,352.88,352.485,352.66,350.4813958587419,NaN,NaN,NaN,NaN,NaN,350.46109999999965,355.065170064825,345.8570299351743,351.70474465546454,352.3765736139761,353.3667917446374,351.38635548331484,44053,115575.6,56.29439857198393,59.95422022426869,NaN,NaN,NaN,NaN,0.972526676936018,28.108386097981704,95097967,-0.1181070673400283,0.6622902952386767,0.780397362578705
2025-08-27T11:40:00-04:00,352.66,352.66,351.36,352.44,350.4813958587419,NaN,NaN,NaN,NaN,NaN,350.5912999999996,355.0410715943584,346.14152840564077,351.70474465546454,352.37042231707954,353.347586151032,351.3932584831271,78915,115206.73333333334,54.11847775299196,59.578049981386734,NaN,NaN,NaN,NaN,0.9959176285834461,26.41233088827945,95019052,-0.14956134742729532,0.5934456782945858,0.7430070257218812
2025-08-27T11:45:00-04:00,352.43,353.22,352.35,353.15,350.4813958587419,NaN,NaN,NaN,NaN,NaN,350.72769999999963,355.06326326696797,346.3921367330313,351.70474465546454,352.3837715298549,353.3523062365844,351.41523682312544,73115,115690.06666666667,59.552152846556275,59.40646088243379,NaN,NaN,NaN,NaN,0.9869235122560573,24.88330970858965,95092167,-0.12289933976023881,0.5893828510215826,0.7122821907818214
2025-08-27T11:50:00-04:00,353.17,353.18,352.51,352.78,350.4813958587419,NaN,NaN,NaN,NaN,NaN,350.8484999999996,355.06792567205656,346.62907432794265,351.70474465546454,352.3899308150975,353.35304271333683,351.42681891685817,41740,105615.1,55.84077361700921,59.24641703354689,NaN,NaN,NaN,NaN,0.964286118523483,23.46350432744912,95050427,-0.12985179979486994,0.549967441038234,0.679819240833104
2025-08-27T11:55:00-04:00,352.76,353.1,352.55,352.59,350.4813958587419,NaN,NaN,NaN,NaN,NaN,350.9616999999996,355.05639784501466,346.86700215498456,351.70474465546454,352.39354887938356,353.35243074956844,351.4346670091987,30521,100310.86666666667,53.98035712593032,59.08289762663909,NaN,NaN,NaN,NaN,0.9346942529146636,22.14511361639006,95019906,-0.14572555951579536,0.4976622914383597,0.6433878509541551
2025-08-27T12:00:00-04:00,352.57,352.65,352.28,352.29,350.4813958587419,NaN,NaN,NaN,NaN,NaN,351.06809999999956,355.0162291217518,347.11997087824733,351.40479572437164,352.3937335040251,353.3458448857808,351.44162212226934,42959,92642.33333333333,51.08624676423355,58.661057304349335,NaN,NaN,NaN,NaN,0.894358949135045,20.59044697190929,94976947,-0.17304669332372613,0.4270794842994974,0.6001261776232235
2025-08-27T12:05:00-04:00,352.28,352.3,351.7,351.84,350.4813958587419,NaN,NaN,NaN,NaN,NaN,351.16649999999953,354.9374575709775,347.3955424290216,351.11786926359787,352.38429287265114,353.3284881973027,351.4400975479996,65845,85985,47.014445305602166,57.76172143696048,NaN,NaN,NaN,NaN,0.8733333099111149,19.9015888038192,94911102,-0.2152888416113906,0.3310151256089853,0.5463039672203759
2025-08-27T12:10:00-04:00,351.84,351.84,350.85,351.1,350.4813958587419,NaN,NaN,NaN,NaN,NaN,351.2384999999995,354.86124495408126,347.6157550459177,351.11786926359787,352.35515184772856,353.3039118366384,351.4063918588187,83224,82907.16666666667,41.19911516632312,56.34677352327354,NaN,NaN,NaN,NaN,0.8816666449174605,20.17408776706183,94827878,-0.2826852251804845,0.19294743574477025,0.47563266092525475
2025-08-27T12:15:00-04:00,351.09,351.32,350.61,351.14,350.4813958587419,NaN,NaN,NaN,NaN,NaN,351.30889999999954,354.78132698442084,347.83647301557824,351.1087153602366,352.32883749065843,353.28628918663105,351.3713857946858,64528,77663.26666666666,41.619477688854985,54.57450597019357,NaN,NaN,NaN,NaN,0.869404741709069,20.654783192384503,94892406,-0.31189269172422035,0.0857667962699793,0.39765948799419965
2025-08-27T12:20:00-04:00,351.13,351.13,349.82,350,NaN,NaN,NaN,353.2653050936678,353.2653050936678,353.2653050936678,351.3512999999995,354.70495878440306,347.997641215596,351.1087153602366,352.27041727948875,353.2725335069778,351.2683010519997,97655,76000.43333333333,34.13064444544075,52.45416912766963,NaN,NaN,NaN,NaN,0.9015901173012778,21.77469233201437,94794751,-0.3902269580303787,-0.09012420954377376,0.30010274848660495
2025-08-27T12:25:00-04:00,350,350.67,349.15,350.67,NaN,NaN,NaN,352.7807457712283,NaN,NaN,351.4097999999996,354.6082433466767,348.2113566533225,351.1087153602366,352.1987707901819,353.2551429499547,351.14239863040916,118395,75646.86666666667,40.865288564069154,51.05437023251193,NaN,NaN,NaN,NaN,0.9457622517797607,23.293948691507,94913146,-0.3788471613202517,-0.1734562031637097,0.20539095815654201
2025-08-27T12:30:00-04:00,350.66,351.15,350.53,350.83,NaN,NaN,NaN,352.7807457712283,NaN,NaN,351.46199999999953,354.53316394907216,348.3908360509269,351.1087153602366,352.17515194510463,353.2373127425166,351.11299114769264,61442,73579.5,42.38035500347282,49.56197187438858,NaN,NaN,NaN,NaN,0.9224935195097782,23.936264950022863,94974588,-0.34351641494303065,-0.22400456052224627,0.11951185442078435
2025-08-27T12:35:00-04:00,350.83,351.14,350,350.75,NaN,NaN,NaN,352.7807457712283,NaN,NaN,351.5113999999996,354.4529696765373,348.5698303234619,351.1087153602366,352.1573187280255,353.2261506721959,351.08848678385505,41373,71381.1,41.803644279147576,48.277219195970325,NaN,NaN,NaN,NaN,0.9380296966876502,24.929733705405017,94933215,-0.3095590693481699,-0.267436982264428,0.04212208708374186
2025-08-27T12:40:00-04:00,350.77,351.16,350.61,350.75,NaN,NaN,NaN,352.7807457712283,NaN,NaN,351.56339999999955,354.35346698164904,348.77333301835006,351.1087153602366,352.13653010408007,353.20952896019463,351.0635312479655,57478,69890.96666666666,41.803644279147576,47.26350152934026,NaN,NaN,NaN,NaN,0.9103132897813904,25.819503878046117,94933215,-0.27243168408259766,-0.2984175180195052,-0.025985833936907565
2025-08-27T12:45:00-04:00,350.75,351.49,350.68,351.41,NaN,NaN,NaN,352.7807457712283,NaN,NaN,351.62359999999956,354.26392046578076,348.98327953421835,350.8719722881892,352.124359516423,353.19571449035493,351.05300454249107,47612,68054.8,48.50799267814199,46.707329679780116,NaN,NaN,NaN,NaN,0.9031480547970056,26.09829203350983,94980827,-0.1925230732161082,-0.2666396754570428,-0.07411660224093461
2025-08-27T12:50:00-04:00,351.39,351.49,351.11,351.4,NaN,NaN,NaN,352.7807457712283,NaN,NaN,351.67759999999953,354.18355948932566,349.1716405106734,350.57757783055143,352.1188392309925,353.18847823822955,351.0492002237554,25931,66127.2,48.41698055730801,46.300079880088404,NaN,NaN,NaN,NaN,0.8657803365972192,26.357166749297566,94954896,-0.13230799610794286,-0.23950159737586318,-0.10719360126792032
2025-08-27T12:55:00-04:00,351.42,351.42,350.87,350.92,NaN,NaN,NaN,352.7807457712283,NaN,NaN,351.7203999999996,354.0966860437982,349.344113956201,349.9670622644411,352.11052292870005,353.1799662699343,351.0410795874658,29698,64252,44.13634533064518,45.198950771809045,NaN,NaN,NaN,NaN,0.8432245982688472,26.823128366660175,94925198,-0.117285763582995,-0.2538008057466641,-0.13651504216366908
2025-08-27T13:00:00-04:00,350.88,351.36,350.52,351.17,NaN,NaN,NaN,352.7807457712283,NaN,NaN,351.7527999999995,354.05278274821717,349.4528172517819,349.60936516364785,352.1006232518879,353.17024422341876,351.03100228035703,34207,62947.6,46.775735776508164,44.55144806891611,NaN,NaN,NaN,NaN,0.8429942698210747,27.57185490304871,94959405,-0.08452280819744551,-0.24216855241047597,-0.15764574421303046
2025-08-27T13:05:00-04:00,351.15,351.4,350.78,350.87,NaN,NaN,NaN,352.7807457712283,NaN,NaN,351.7751999999996,354.0178243202825,349.5325756797167,349.60936516364785,352.09348118873754,353.1631734020828,351.0237889753923,25069,61801.566666666666,44.08406546726265,43.84457009329699,NaN,NaN,NaN,NaN,0.8270661076909983,28.188167808615262,94934336,-0.07726487019990377,-0.2542268319629102,-0.1769619617630064
2025-08-27T13:10:00-04:00,350.84,350.96,350.45,350.86,NaN,NaN,NaN,352.7807457712283,NaN,NaN,351.8019999999996,353.9668611969095,349.6371388030897,349.60936516364785,352.0810013163754,353.15342234295576,351.0085802897951,35854,60962.8,43.993189276978015,43.33792312992159,NaN,NaN,NaN,NaN,0.804418528570212,29.064571759644352,94898482,-0.06769023131448015,-0.2615747509061066,-0.19388451959162645
2025-08-27T13:15:00-04:00,350.85,350.9,350.48,350.65,NaN,NaN,NaN,352.7807457712283,NaN,NaN,351.8205999999996,353.9288292479516,349.7123707520476,349.60936516364785,352.07437198072006,353.14858033501014,351.00016362643,18216,59451.4,42.03358282238047,42.9821472382629,NaN,NaN,NaN,NaN,0.7769600622437653,29.878375428457076,94880266,-0.06977470062024116,-0.2811028953669279,-0.21132819474668674
2025-08-27T13:20:00-04:00,350.64,350.98,350.46,350.96,NaN,NaN,NaN,352.7807457712283,NaN,NaN,351.85319999999956,353.8540455817619,349.8523544182372,349.60936516364785,352.0638769349324,353.1398346187909,350.9879192510739,32043,58511.666666666664,45.86688878549847,43.31555963963257,NaN,NaN,NaN,NaN,0.7586057720834992,30.44927880540457,94912309,-0.04571338589852125,-0.2684699271198383,-0.22275654122131705
2025-08-27T13:25:00-04:00,350.98,351.2,350.54,351.01,NaN,NaN,NaN,352.7807457712283,NaN,NaN,351.87879999999956,353.801559018204,349.9560409817951,349.6577913414593,352.0519693803098,353.1286250073812,350.9753137532384,40809,57414.26666666667,46.48163079413695,43.66285629000985,NaN,NaN,NaN,NaN,0.7515625026489613,30.470054583798678,94953118,-0.023014136692789566,-0.251524212087304,-0.22851007539451446
2025-08-27T13:30:00-04:00,350.97,351.25,350.86,350.92,NaN,NaN,NaN,352.7807457712283,NaN,NaN,351.88239999999956,353.79727465963185,349.9675253403673,349.82123307316743,352.04461853997964,353.1210082791055,350.96822880085375,27934,55991.7,45.480451499212265,44.47355679385067,NaN,NaN,NaN,NaN,0.725736609602606,30.372606303449157,94925184,-0.0112405549785842,-0.2425607691177447,-0.2313202141391605
2025-08-27T13:35:00-04:00,350.93,350.97,350.36,350.52,NaN,NaN,NaN,352.7807457712283,NaN,NaN,351.8587999999995,353.81081082020904,349.90678917979,349.82123307316743,352.0307915657282,353.11104569182794,350.9505374396284,38716,53933.76666666667,41.22990295381071,44.49960067883221,NaN,NaN,NaN,NaN,0.7174697089167065,30.882952513998557,94886468,-0.026690016876079414,-0.2646827352342598,-0.23799271835818037
2025-08-27T13:40:00-04:00,350.59,350.76,350.33,350.58,NaN,NaN,NaN,352.7807457712283,NaN,NaN,351.7853999999995,353.64609754722625,349.9247024527728,349.82123307316743,352.0167484205606,353.1013387861809,350.93215805494026,38456,50762.63333333333,42.10397038338274,44.479858920254344,NaN,NaN,NaN,NaN,0.6969361582797993,31.39080180087127,94924924,-0.028975511486286992,-0.2742121077160391,-0.2452365962297521
2025-08-27T13:45:00-04:00,350.57,350.94,350.39,350.41,NaN,NaN,NaN,352.7807457712283,NaN,NaN,351.7261999999996,353.5697395959737,349.8826604040255,349.82123307316743,352.00596809512047,353.09357201253727,350.91836417770367,30518,49858.666666666664,40.276209111399666,44.37075640827235,NaN,NaN,NaN,NaN,0.6864407184026716,31.400513635219575,94894406,-0.03750229865144655,-0.2921144695440603,-0.25461217089261373
2025-08-27T13:50:00-04:00,350.4,350.7,350.3,350.65,NaN,NaN,NaN,352.7312252293179,NaN,NaN,351.6997999999995,353.56628113898006,349.833318861019,349.82123307316743,351.9932533198313,353.0845383282352,350.90196831142737,35832,48711.76666666667,43.973925655127324,44.52577650655662,NaN,NaN,NaN,NaN,0.6659806670881935,31.529899429125585,94930238,-0.023243301313254916,-0.2836662975341824,-0.26042299622092746
2025-08-27T13:55:00-04:00,350.64,350.74,350.45,350.59,NaN,NaN,NaN,352.7312252293179,NaN,NaN,351.68119999999954,353.57284326504345,349.7895567349556,349.82123307316743,351.9852032348635,353.0784824694587,350.89192400026826,23731,47835.933333333334,43.252940080061215,44.1504156066937,NaN,NaN,NaN,NaN,0.639124905153324,31.539266675462326,94906507,-0.014542418844675886,-0.2786010197767723,-0.26405860093209643
2025-08-27T14:00:00-04:00,350.57,350.94,350.38,350.85,NaN,NaN,NaN,352.7312252293179,NaN,NaN,351.66939999999954,353.57422927376433,349.76457072623475,349.82123307316743,351.9761285656112,353.0706752951529,350.8815818360695,29893,47192.066666666666,47.28625376942196,44.069649407558984,NaN,NaN,NaN,NaN,0.6334731262138009,30.993196898086282,94936400,0.010673427801550173,-0.25071681618015873,-0.2613902439817089
2025-08-27T14:05:00-04:00,350.82,351.63,350.7,351.45,NaN,NaN,NaN,352.7312252293179,NaN,NaN,351.6831999999995,353.5714010068725,349.79499899312646,350.1831207381859,351.96568975777836,353.0556143947221,350.8757651208346,61488,47773.23333333333,55.19964559871408,44.85988514099248,NaN,NaN,NaN,NaN,0.65465361719853,28.895227971199926,94997888,0.0665923564948804,-0.1781497983631084,-0.2447421548579888
2025-08-27T14:10:00-04:00,351.44,351.85,351.4,351.71,NaN,NaN,NaN,352.7312252293179,NaN,NaN,351.70699999999954,353.56572321828867,349.8482767817104,350.4674965905487,351.96268238738986,353.0477762017409,350.87758857303885,41008,46509.666666666664,58.13270256151031,45.67109705420692,NaN,NaN,NaN,NaN,0.6400355016843525,27.137463556824194,95038896,0.11697423640530408,-0.09852435935135873,-0.2154985957566628
2025-08-27T14:15:00-04:00,351.74,352.01,351.42,351.52,NaN,NaN,NaN,352.7312252293179,NaN,NaN,351.7067999999995,353.56560150698573,349.8479984930132,350.60899727243896,351.958750981614,353.0375644098658,350.8799375533622,54234,45880.3,55.284272358477125,46.47111183215082,NaN,NaN,NaN,NaN,0.6364615372783256,25.803005466152268,94984662,0.1322599433479176,-0.05017366657176581,-0.1824336099196834
2025-08-27T14:20:00-04:00,351.55,351.56,351.15,351.43,NaN,NaN,NaN,352.7312252293179,NaN,NaN,351.69519999999955,353.5535271623048,349.8368728376943,350.60899727243896,351.9544100216624,353.03032937600017,350.8784906673246,32598,45575.566666666666,53.93612185946487,47.18132130232844,NaN,NaN,NaN,NaN,0.6202857131870184,23.99569541241466,94952064,0.1308270662012313,-0.018899777168144283,-0.14972684336937558
2025-08-27T14:25:00-04:00,351.38,351.39,351.13,351.35,NaN,NaN,NaN,352.7312252293179,NaN,NaN,351.6715999999995,353.5168462606187,349.8263537393803,350.60899727243896,351.95121612379626,353.02552966338493,350.8769025842076,20993,45257.96666666667,52.705776166770804,47.94362082692775,NaN,NaN,NaN,NaN,0.5974081622450893,22.28771104390801,94931071,0.11933041351863674,-0.0005638264710796648,-0.1198942399897164
2025-08-27T14:30:00-04:00,351.31,351.51,351.18,351.31,NaN,NaN,NaN,352.7312252293179,NaN,NaN,351.6449999999996,353.47189353878997,349.8181064612092,350.60899727243896,351.9486398216029,353.02145038064646,350.87582926255936,18285,44435.5,52.06624984708901,48.38643233132708,NaN,NaN,NaN,NaN,0.5783075792275818,20.948691976170906,94912786,0.1044093832310842,0.01061748904913884,-0.09379189418194536
2025-08-27T14:35:00-04:00,351.3,351.77,351.29,351.76,NaN,NaN,NaN,352.7312252293179,NaN,NaN,351.62479999999954,353.4236095625062,349.82599043749286,350.62318928279103,351.9464491934026,353.01616607075175,350.87673231605345,28273,43183.1,58.20970696885241,49.224152058092464,NaN,NaN,NaN,NaN,0.5712856092827517,20.242272621698294,94941059,0.11915688963181134,0.05515421785781882,-0.06400267177399252
2025-08-27T14:40:00-04:00,351.78,351.8,351.44,351.47,NaN,NaN,NaN,352.7312252293179,NaN,NaN,351.6133999999995,353.40876117878366,349.81803882121534,350.70255142623284,351.94486661833906,353.0126104510014,350.8771227856767,18633,41030.066666666666,53.45493798424005,49.79375823559445,NaN,NaN,NaN,NaN,0.5561937800482705,19.647244082522594,94922426,0.10423031751960339,0.06628522512551172,-0.037945092394091676
2025-08-27T14:45:00-04:00,351.5,351.65,351.31,351.47,NaN,NaN,NaN,352.7312252293179,NaN,NaN,351.5925999999995,353.36993647977357,349.8152635202254,350.70255142623284,351.94303167483,353.00908257370384,350.8769807759562,17439,39460.433333333334,53.45493798424005,50.666975023482266,NaN,NaN,NaN,NaN,0.5407513671876779,18.752256296036666,94922426,0.08975664398291952,0.07425071258455773,-0.015505931398361792
2025-08-27T14:50:00-04:00,351.49,351.66,351.2,351.2,NaN,NaN,NaN,352.7312252293179,NaN,NaN,351.57559999999955,353.3513709768215,349.7998290231776,350.70255142623284,351.9400840066078,353.0042801021284,350.87588791108715,22354,36950.4,49.12234188353549,51.16828727349317,NaN,NaN,NaN,NaN,0.5349834123885607,17.633722839452965,94900072,0.05889022960431849,0.05810685560703632,-0.0007833739972821687
2025-08-27T14:55:00-04:00,351.25,351.44,350.75,350.78,NaN,NaN,NaN,352.7312252293179,NaN,NaN,351.55459999999954,353.3426322597977,349.76656774020137,350.70255142623284,351.93352225257127,352.9969519816677,350.87009252347485,31101,34040.6,43.24993614136436,51.38069634706209,NaN,NaN,NaN,NaN,0.5460560257893776,17.19905580990532,94868971,0.009660358974067355,0.011292074720302026,0.0016317157462346701
2025-08-27T15:00:00-04:00,350.78,351.1,350.46,351.1,NaN,NaN,NaN,352.6454060263612,NaN,NaN,351.5377999999995,353.3268166690855,349.7487833309135,350.70255142623284,351.9230792989109,352.986293683282,350.85986491453986,45374,33505,48.31927114725674,51.691078167928474,NaN,NaN,NaN,NaN,0.552766309661568,17.36228904632146,94914345,-0.0012956057956381938,0.000012208501686927775,0.0013078142973251216
2025-08-27T15:05:00-04:00,351.09,351.36,350.65,350.92,NaN,NaN,NaN,352.6454060263612,NaN,NaN,351.5093999999995,353.2916476152909,349.7271523847081,350.70255142623284,351.91279989612474,352.9747649038866,350.8508348883629,49946,33790.76666666667,45.83884926180813,51.87578596662468,NaN,NaN,NaN,NaN,0.5639972875428871,16.83347747482081,94864399,-0.019593777044796784,-0.02318440700867086,-0.0035906299638740744
2025-08-27T15:10:00-04:00,350.93,350.93,349.37,349.38,NaN,NaN,NaN,352.1548224331101,NaN,NaN,351.4457999999995,353.2990871990634,349.5925128009356,350.70255142623284,351.8733187677445,352.96138748273177,350.7852500527572,91694,34931.3,31.119912343978427,50.72104729337872,NaN,NaN,NaN,NaN,0.635140338432681,18.253189580675006,94772705,-0.1282820453106011,-0.16394318660212548,-0.03566114129152436
2025-08-27T15:15:00-04:00,349.49,350.08,349.33,350,NaN,NaN,NaN,351.72096686796874,NaN,NaN,351.37559999999957,353.17596511909,349.57523488090914,350.70255142623284,351.8447057338274,352.9519268681815,350.73748459947336,65740,35535.566666666666,39.53744627615054,49.602318770338464,NaN,NaN,NaN,NaN,0.6433445999732038,19.61624609452972,94838445,-0.14978892204177546,-0.22289729384374368,-0.07310837180196822
2025-08-27T15:20:00-04:00,349.97,350.4,349.85,349.88,NaN,NaN,NaN,351.72096686796874,NaN,NaN,351.3081999999995,353.07484060925526,349.5415593907437,350.70255142623284,351.82578572167654,352.94238166159903,350.70918978175405,50482,36353.933333333334,38.555358798258624,48.20393707296334,NaN,NaN,NaN,NaN,0.6366771285465431,20.111051816403354,94787963,-0.16240843749908157,-0.27611891867582017,-0.11371048117673861
2025-08-27T15:25:00-04:00,349.87,350.14,349.65,349.92,NaN,NaN,NaN,351.72096686796874,NaN,NaN,351.24839999999955,352.9964336844918,349.5003663155073,350.70255142623284,351.81063291569046,352.93573746146717,350.68552836991375,38185,36636.833333333336,39.09840112563853,47.04780341347487,NaN,NaN,NaN,NaN,0.6262001907932193,20.834097807928767,94826148,-0.15821500334194527,-0.3114792353541702,-0.15326423201222494
2025-08-27T15:30:00-04:00,349.92,350.37,349.78,350.3,NaN,NaN,NaN,351.72096686796874,NaN,NaN,351.18699999999956,352.84603707076735,349.52796292923176,350.6020411409862,351.7979927634245,352.9280617155505,350.66792381129846,37158,36735.2,44.14842448154014,46.34868217219453,NaN,NaN,NaN,NaN,0.6236144628794202,20.960642022229862,94863306,-0.12164475514111475,-0.3053201759386184,-0.18367542079750362
2025-08-27T15:35:00-04:00,350.33,350.78,350.24,350.67,NaN,NaN,NaN,351.72096686796874,NaN,NaN,351.1399999999996,352.7199240494456,349.5600759505536,350.591632912789,351.7836968189645,352.91494181400685,350.6524518239221,57187,37805.8,48.61622250281995,46.05657119619804,NaN,NaN,NaN,NaN,0.6176420012451734,20.192965911614632,94920493,-0.0670593436159343,-0.2674996003174215,-0.20044025670148718
2025-08-27T15:40:00-04:00,350.72,351.1,350.66,350.89,NaN,NaN,NaN,351.72096686796874,NaN,NaN,351.1053999999996,352.6289285891828,349.58187141081635,350.2403063302312,351.77023132715124,352.8982910884053,350.6421715658972,74986,39110.2,51.11999565807454,45.98898161126844,NaN,NaN,NaN,NaN,0.604953286870518,18.86368029912451,94995479,-0.013463641964923972,-0.21726980915764216,-0.20380616719271819
2025-08-27T15:45:00-04:00,350.9,350.91,350.03,350.22,NaN,NaN,NaN,351.72096686796874,NaN,NaN,351.05659999999955,352.5334160894628,349.5797839105363,349.9811960513479,351.7549895389359,352.88607576042983,350.62390331744194,55850,40364.666666666664,44.07615592034761,44.97944225066095,NaN,NaN,NaN,NaN,0.6245994806654848,18.63026260469684,94939629,-0.020064880966644938,-0.22888726840102436,-0.20882238743437942
2025-08-27T15:50:00-04:00,350.25,351.1,349.44,349.51,NaN,NaN,NaN,351.72096686796874,NaN,NaN,350.9979999999996,352.4830939371125,349.51290606288666,349.9811960513479,351.71911711960746,352.86542684204335,350.5728073971716,106825,42857.4,38.08702343074885,43.88173406826872,NaN,NaN,NaN,NaN,0.698556660617952,19.17055046995125,94832804,-0.06655732293476282,-0.29201904110283294,-0.22546171816807012
2025-08-27T15:55:00-04:00,349.5,350,349.47,349.94,NaN,NaN,NaN,351.72096686796874,NaN,NaN,350.93379999999956,352.31513205352377,349.55246794647536,349.62061153414766,351.6611093611493,352.83669610305645,350.4855226192421,161635,46884.933333333334,43.12734775034676,43.14404905156206,NaN,NaN,NaN,NaN,0.6865168991452392,19.67224634483035,94994439,-0.06271175311383664,-0.30385140956036594,-0.2411396564465293
2025-08-28T09:30:00-04:00,351,353.55,350.7,352.02,349.65781672313,349.65781672313,349.65781672313,NaN,NaN,NaN,350.9185999999995,352.233462792168,349.60373720783105,350.1705624843869,352.09,352.09,352.09,203946,52752,60.06381800305712,43.92558306009932,NaN,NaN,NaN,NaN,0.8953371206348659,20.605726422909868,95198385,0.07792519423241634,-0.14373316365600886,-0.2216583578884252
2025-08-28T09:35:00-04:00,351.91,352.18,349.62,350.69,NaN,NaN,NaN,353.60412949155767,353.60412949155767,353.60412949155767,350.88059999999956,352.1068881235816,349.6543118764175,350.1705624843869,351.61019710475824,352.2220310934123,350.9983631161042,125422,55642.2,49.8427865374966,44.39650094553734,NaN,NaN,NaN,NaN,1.01424161201809,20.214299432580727,95072963,0.07913206485222513,-0.12274327682314379,-0.2018753416753689
2025-08-28T09:40:00-04:00,350.67,350.94,349.54,350,NaN,NaN,NaN,353.0121236055778,NaN,NaN,350.8347999999995,352.01738861915516,349.6522113808439,350.1705624843869,351.2418104442084,352.0650803569996,350.4185405314172,112159,58098.96666666667,45.515430959342346,44.196226646400596,NaN,NaN,NaN,NaN,1.0417957825882247,19.764691464436407,94960804,0.03354654529790135,-0.15994216005299222,-0.19348870535089358
2025-08-28T09:45:00-04:00,350,351.52,349.01,350.8,NaN,NaN,NaN,353.0121236055778,NaN,NaN,350.81399999999957,351.96119135376824,349.6668086462309,350.1705624843869,351.0532863835957,351.8487351996808,350.25783756751065,136467,61630.6,50.84413047085912,44.55374673276138,NaN,NaN,NaN,NaN,1.1466675124033507,19.812052781180885,95097271,0.0560339900890135,-0.12344621773962672,-0.17948020782864021
2025-08-28T09:50:00-04:00,350.72,351.42,349.6,351.24,NaN,NaN,NaN,353.0121236055778,NaN,NaN,350.81679999999955,351.9674480966263,349.6661519033728,350.1705624843869,351.00441671059673,351.7405692656861,350.2682641555074,112498,64186.13333333333,53.535752017099526,46.15487813798432,NaN,NaN,NaN,NaN,1.1947626900888253,19.85603114672933,95209769,0.09690734935247236,-0.058346021138049764,-0.15525337049052212
2025-08-28T09:55:00-04:00,351.34,352.07,350.22,350.59,NaN,NaN,NaN,353.0121236055778,NaN,NaN,350.8057999999996,351.9543928095215,349.65720719047766,350.1705624843869,350.99730741751733,351.67217522798785,350.3224396070468,131580,67781.1,49.2457932837106,46.84833149566718,NaN,NaN,NaN,NaN,1.2415653550824781,20.40540582472653,95078189,0.07737986956739906,-0.0585285335312733,-0.13590840309867236
2025-08-28T10:00:00-04:00,350.58,351.45,350.07,350.21,NaN,NaN,NaN,353.0121236055778,NaN,NaN,350.8099999999995,351.94826534792963,349.67173465206935,350.1705624843869,350.9455758076848,351.5925060177937,350.2986455975759,115278,70627.26666666666,46.88064845075538,47.44299504227409,NaN,NaN,NaN,NaN,1.2514535440051577,20.71736660427606,94962911,0.03807238163910043,-0.08831792604979682,-0.12639030768889725
2025-08-28T10:05:00-04:00,350.17,351.14,348.3,348.35,NaN,NaN,NaN,353.0121236055778,NaN,NaN,350.7635999999995,352.093861689387,349.433338310612,350.1705624843869,350.72907837663905,351.55490351677633,349.90325323650177,138451,73192.7,37.40981508928556,47.322381753963164,NaN,NaN,NaN,NaN,1.3649211480047876,19.398106037602886,94824460,-0.1061091858303797,-0.2590267899768719,-0.1529176041464922
2025-08-28T10:10:00-04:00,348.25,349.44,348.06,348.95,NaN,NaN,NaN,352.2729799149675,NaN,NaN,350.7259999999995,352.1496291660022,349.30237083399675,350.1705624843869,350.5887315604999,351.5271566248563,349.65030649614357,85203,74665.86666666667,41.5143759792823,47.134235432373316,NaN,NaN,NaN,NaN,1.3659982088615883,18.387108621664712,94909663,-0.15123226130256398,-0.34195793077469716,-0.19072566947213318
2025-08-28T10:15:00-04:00,348.98,349.37,347.01,347.24,NaN,NaN,NaN,351.8746626461053,NaN,NaN,350.6557999999995,352.3818177989708,348.92978220102816,350.1705624843869,350.3409099343433,351.5290969692312,349.1527228994554,116601,76744.76666666666,34.55859246044632,46.1301190007752,NaN,NaN,NaN,NaN,1.4369983368000472,18.30246746151846,94793062,-0.27897608139830665,-0.5394457712200165,-0.2604696898217098
2025-08-28T10:20:00-04:00,347.26,347.5,346.34,346.62,NaN,NaN,NaN,350.5953597985551,NaN,NaN,350.5731999999995,352.6357593427521,348.5106406572468,348.1964499875095,350.0780366720553,351.5486944098124,348.6073789342982,103083,79094.26666666666,32.43651151409149,44.79558441906213,NaN,NaN,NaN,NaN,1.4172127413143314,18.69582159295681,94689979,-0.38161134497637034,-0.7374838710421727,-0.3558725260658024
2025-08-28T10:25:00-04:00,346.6,346.6,344.91,345.1,NaN,NaN,NaN,349.4964798077117,NaN,NaN,350.44699999999943,353.00256256086845,347.8914374391304,347.6237379148839,349.63722370201987,351.57641814256687,347.69802926147287,148425,83342,27.911446473951713,43.64096231574814,NaN,NaN,NaN,NaN,1.4381261169347348,19.9045770298578,94541554,-0.5196948696379023,-1.0054911131131803,-0.48579624347527794
2025-08-28T10:30:00-04:00,345.12,345.86,344.06,344.3,NaN,NaN,NaN,348.77686708917935,NaN,NaN,350.3049999999995,353.37101304667,347.238986953329,347.6237379148839,349.1934123580607,351.5163752517953,346.8704494643261,152386,87812.03333333334,25.8661618279572,42.768043629834445,NaN,NaN,NaN,NaN,1.4639742514393974,21.442070520281696,94389168,-0.6256249033845733,-1.2678273727059945,-0.6422024693214212
2025-08-28T10:35:00-04:00,344.19,345.48,343.55,345.4,NaN,NaN,NaN,348.4215549487621,NaN,NaN,350.1945999999994,353.54812759979245,346.8410724002064,347.6237379148839,348.8756596505338,351.3850150711175,346.3663042299501,131418,91250.2,33.1228212342196,42.05343459296822,NaN,NaN,NaN,NaN,1.4972618049080124,23.100292894282916,94520586,-0.5831692375730745,-1.3711640162877643,-0.7879947787146898
2025-08-28T10:40:00-04:00,345.39,346.12,345.26,345.5,NaN,NaN,NaN,348.4215549487621,NaN,NaN,350.08119999999946,353.67031385196935,346.49208614802956,347.6237379148839,348.69790747447746,351.2470805454566,346.14873440349834,104925,94126.6,33.75763752782147,40.174421701879965,NaN,NaN,NaN,NaN,1.451743104557441,23.92388761752439,94625511,-0.512422389305937,-1.428522765347111,-0.9161003760411741
2025-08-28T10:45:00-04:00,345.54,345.71,345,345.22,NaN,NaN,NaN,348.4215549487621,NaN,NaN,349.9681999999995,353.7985246653784,346.1378753346206,347.20299033190713,348.58688240474896,351.1654758756629,346.00828893383505,64979,95711.26666666666,32.81828476947919,38.95838586130729,NaN,NaN,NaN,NaN,1.398761454231908,24.826078158636573,94560532,-0.45073464062980784,-1.4795186768284339,-1.028784036198626
2025-08-28T10:50:00-04:00,345.23,345.27,344.31,345.18,NaN,NaN,NaN,348.4215549487621,NaN,NaN,349.8545999999995,353.9030924802077,345.8061075197913,346.3223922655257,348.45701771856244,351.07865744012094,345.83537799700395,72801,97392.83333333333,32.67838920221112,38.04145430722649,NaN,NaN,NaN,NaN,1.367421350358199,26.015446476504707,94487731,-0.381615179056624,-1.505803010019406,-1.124187830962782
2025-08-28T10:55:00-04:00,345.19,345.8,345.02,345.52,NaN,NaN,NaN,348.4215549487621,NaN,NaN,349.75199999999955,353.97108426108474,345.53291573891437,344.8959138124206,348.3820725643805,351.0130192464073,345.75112588235373,52483,98105.56666666667,35.20665138765321,36.924491515568924,NaN,NaN,NaN,NaN,1.3254626824754727,26.510385851968383,94540214,-0.28634052976941593,-1.4821134931745519,-1.195772963405136
2025-08-28T11:00:00-04:00,345.49,345.88,344.92,345.18,NaN,NaN,NaN,348.4215549487621,NaN,NaN,349.63639999999947,354.0298874715137,345.24291252848525,344.55473104993644,348.3158945260822,350.9559283139353,345.6758607382291,46671,98148.8,33.83810862002353,35.517516987206356,NaN,NaN,NaN,NaN,1.2993582051557946,27.027958183157804,94493543,-0.22241015349064597,-1.4737856552684434,-1.2513755017777974
2025-08-28T11:05:00-04:00,345.15,345.315,344.75,345.25,NaN,NaN,NaN,348.4215549487621,NaN,NaN,349.5211999999995,354.06410064189953,344.9782993580995,343.0677848399491,348.25899809692874,350.9096068018909,345.60838939196657,38871,97779.63333333333,34.40345991747705,34.457350318189675,NaN,NaN,NaN,NaN,1.2469040476446662,27.61116040471191,94532414,-0.1548049363645787,-1.444881672233521,-1.2900767358689422
2025-08-28T11:10:00-04:00,345.26,345.32,344.65,344.97,NaN,NaN,NaN,348.4215549487621,NaN,NaN,349.4021999999995,354.1013323286632,344.70306767133576,342.9478623930135,348.1983919228537,350.8612707139167,345.5355131317907,41309,96100.13333333333,33.18205833479878,33.478879595621336,NaN,NaN,NaN,NaN,1.2056966156700484,28.215429478102195,94491105,-0.11042372795539679,-1.428106395813188,-1.3176826678577913
2025-08-28T11:15:00-04:00,344.93,345.39,344.45,344.61,NaN,NaN,NaN,348.3619810787109,NaN,NaN,349.2839999999995,354.1587529170529,344.4092470829461,342.9699455452229,348.097535871179,350.78274356595136,345.4123281764066,68704,96198.93333333333,31.627352088971165,33.06584652417031,NaN,NaN,NaN,NaN,1.1867182859793304,28.906024995534025,94422401,-0.08777914966036948,-1.4274066049332532,-1.3396274552728837
2025-08-28T11:20:00-04:00,344.61,344.61,343.77,344.09,NaN,NaN,NaN,347.5900728478605,NaN,NaN,349.15419999999955,354.2256559489483,344.0827440510508,342.9699455452229,347.97863745031384,350.70759811337405,345.24967678725363,71665,96905.03333333334,29.478825542879477,32.20616435014154,NaN,NaN,NaN,NaN,1.1619526941236662,29.964641120172033,94350736,-0.0899564959979604,-1.4520730752703344,-1.362116579272374
2025-08-28T11:25:00-04:00,344.11,344.11,341.6,341.945,NaN,NaN,NaN,346.44279680932135,NaN,NaN,348.9848999999995,354.42885609480487,343.5409439051942,342.9699455452229,347.5100994001922,350.53127197033496,344.4889268300494,224452,103113.93333333333,22.645060871206027,31.355197808052946,NaN,NaN,NaN,NaN,1.2582417874005465,31.929583752042213,94126284,-0.21107627837467957,-1.6259619272407235,-1.414885648866044
2025-08-28T11:30:00-04:00,341.95,343.1,341.93,342.41,NaN,NaN,NaN,346.0992605907158,NaN,NaN,348.8200999999995,354.5441337142851,343.0960662857139,342.9699455452229,347.36096560081813,350.45689622725257,344.2650349743837,79434,104523.13333333333,26.61659276502104,30.939489325976485,NaN,NaN,NaN,NaN,1.2519388025862228,33.754173338778806,94205718,-0.2333523881308477,-1.7065761340296035,-1.4732237458987558
2025-08-28T11:35:00-04:00,342.4,343.19,342.15,342.27,NaN,NaN,NaN,346.0992605907158,NaN,NaN,348.6536999999995,354.63997657582206,342.66742342417695,342.9699455452229,347.21742661223965,350.37519142579157,344.0596617986877,82160,105355.56666666667,26.18076775368519,30.815869417386015,NaN,NaN,NaN,NaN,1.2368003166872084,35.317796925911644,94123558,-0.2305852776404047,-1.7614553429492616,-1.530870065308857
2025-08-28T11:40:00-04:00,342.27,342.42,341.31,341.4,NaN,NaN,NaN,345.41755975311094,NaN,NaN,348.4646999999996,354.75087671100516,342.17852328899403,342.9699455452229,346.9893972354302,350.27001872930725,343.70877574155315,119270,106831.7,23.595182129178,30.653656581758927,NaN,NaN,NaN,NaN,1.2277431512095516,37.10092179665553,94004288,-0.2583279624681525,-1.8537800183940476,-1.5954520559258951
2025-08-28T11:45:00-04:00,341.35,341.69,340.91,341.27,NaN,NaN,NaN,344.7974434006968,NaN,NaN,348.2610999999995,354.8016153590755,341.72058464092345,342.9699455452229,346.8135812660453,350.19020805310635,343.4369544789842,91691,108026.4,23.226067704743485,29.946745615367774,NaN,NaN,NaN,NaN,1.1957614975517246,38.90102863117466,93912597,-0.2559254256411647,-1.915358837977351,-1.6594334123361862
2025-08-28T11:50:00-04:00,341.22,341.43,340.26,340.96,NaN,NaN,NaN,344.3430141552106,NaN,NaN,348.0460999999995,354.8215212534961,341.27067874650294,342.9699455452229,346.60610208595375,350.0975287821871,343.1146753897204,107762,108057.63333333333,22.32903026347327,29.13041652505719,NaN,NaN,NaN,NaN,1.1939213905837451,40.79271024736624,93804835,-0.2456582665152256,-1.9665062454802182,-1.7208479789649926
2025-08-28T11:55:00-04:00,340.95,341.56,340.61,341.25,NaN,NaN,NaN,344.3430141552106,NaN,NaN,347.8406999999995,354.8025313712866,340.87886862871244,342.9699455452229,346.4089221150079,349.9851284015126,342.8327158285032,115267,106512.03333333334,25.23798438427866,28.588966497542867,NaN,NaN,NaN,NaN,1.1764984341134768,42.34484339090698,93920102,-0.19214943277086505,-1.961034769928574,-1.768885337157709
2025-08-28T12:00:00-04:00,341.27,342.15,341.16,342.13,NaN,NaN,NaN,344.3430141552106,NaN,NaN,347.6546999999995,354.7191910391577,340.59020896084127,342.9699455452229,346.2939644924767,349.89735371015286,342.6905752748005,81982,102446.56666666667,33.390366808126274,28.63982204082252,NaN,NaN,NaN,NaN,1.1631771173910823,42.8808117941021,94002084,-0.07625220751260997,-1.8642005965484714,-1.7879483890358614
2025-08-28T12:05:00-04:00,342.13,342.28,341.57,342.17,NaN,NaN,NaN,344.3430141552106,NaN,NaN,347.4710999999995,354.6185704030309,340.32362959696815,342.2539564361783,346.213728041416,349.83021407283735,342.59724200999466,62505,100349.33333333333,33.74403056639213,28.535349125018154,NaN,NaN,NaN,NaN,1.130807323291718,43.184031039909286,94064589,0.01924028542179035,-1.7638980322586235,-1.7831383176804139
2025-08-28T12:10:00-04:00,342.15,342.75,342.13,342.72,NaN,NaN,NaN,344.3430141552106,NaN,NaN,347.2992999999995,354.4822754309904,340.1163245690086,340.97016514894267,346.162381196655,349.77940217428875,342.5453602190213,47255,98185.86666666667,38.57347160699414,28.8735893383732,NaN,NaN,NaN,NaN,1.0943210859137384,42.77131026475148,94111844,0.12944076921206937,-1.621337356165327,-1.7507781253773964
2025-08-28T12:15:00-04:00,342.68,343.09,342.05,342.07,NaN,NaN,NaN,344.3430141552106,NaN,NaN,347.1054999999995,354.3194254918706,339.8915745081284,340.7335830099167,346.08831712433715,349.70743248662,342.4692017620543,68077,95906.2,35.29880418521668,28.9375425003546,NaN,NaN,NaN,NaN,1.0904410083484688,41.90764901104451,94043767,0.16620682699431377,-1.5430195916345042,-1.709226418628818
2025-08-28T12:20:00-04:00,342.06,342.28,341.86,342.2,NaN,NaN,NaN,344.3430141552106,NaN,NaN,346.92009999999954,354.1522804431449,339.6879195568542,340.7335830099167,346.03408869685506,349.6578883525844,342.41028904112574,47789,93749.23333333334,36.46061695284176,29.171725258786243,NaN,NaN,NaN,NaN,1.042552364895004,41.247363216013014,94091556,0.20441723051285554,-1.4537048804877486,-1.6581221110006041
2025-08-28T12:25:00-04:00,342.23,343.25,342.2,343.2,NaN,NaN,NaN,344.3430141552106,NaN,NaN,346.75469999999956,353.9412158207646,339.5681841792345,341.04889312634674,345.98052788836526,349.59640647512737,342.36464930160315,60578,91382.5,44.68837622501498,30.104655554217942,NaN,NaN,NaN,NaN,1.043084338831076,39.34609135719448,94152134,0.29658532876880717,-1.2873904500395952,-1.5839757788084023
2025-08-28T12:30:00-04:00,343.17,343.37,342.43,342.861,NaN,NaN,NaN,344.3430141552106,NaN,NaN,346.5879199999995,353.74101471325054,339.43482528674843,341.13911450107736,345.93175856550783,349.53965943112695,342.3238576998887,57079,89442.53333333334,42.67113799672405,31.04696358663541,NaN,NaN,NaN,NaN,1.0357211717717132,37.434974773636256,94095055,0.33161363093163976,-1.1694587401438525,-1.5010723710754923
2025-08-28T12:35:00-04:00,342.92,343.36,342.54,343.31,NaN,NaN,NaN,344.3430141552106,NaN,NaN,346.4385199999995,353.5470487170086,339.3299912829905,341.1652916008619,345.8957451293646,349.49503718692563,342.2964530718036,46144,86365.63333333333,46.13904911213183,32.7251056038444,NaN,NaN,NaN,NaN,1.0203125166451616,35.66036651747505,94141199,0.37852407894905404,-1.0279172723891747,-1.4064413513382288
2025-08-28T12:40:00-04:00,343.32,343.39,342.95,343.18,NaN,NaN,NaN,344.3430141552106,NaN,NaN,346.2801199999995,353.31872091386816,339.24151908613084,341.41423328068953,345.873799793394,349.46681198446123,342.2807876023268,29798,84518.8,45.28490762347157,34.05855666516229,NaN,NaN,NaN,NaN,0.9788616225990785,33.97125019684344,94111401,0.3926097422979169,-0.9156791734658327,-1.3082889157637496
2025-08-28T12:45:00-04:00,343.18,343.22,342.68,342.9,NaN,NaN,NaN,344.3430141552106,NaN,NaN,346.1197199999995,353.09329355797746,339.1461464420216,341.41423328068953,345.85238721151785,349.44101256419856,342.26376185883714,27116,81535.96666666666,43.42044035400994,35.28996185089978,NaN,NaN,NaN,NaN,0.9475143638420029,32.70053851143186,94084285,0.37491558619800225,-0.8396444330162467,-1.214560019214249
2025-08-28T12:50:00-04:00,342.88,343.98,342.72,343.82,NaN,NaN,NaN,344.3430141552106,NaN,NaN,346.00851999999946,352.94782899446824,339.0692110055307,341.8695092996413,345.8074586440446,349.3760635595425,342.23885372854664,72714,80523.66666666667,50.61509539978484,37.21995565594312,NaN,NaN,NaN,NaN,0.9698347664247163,30.478447530121016,94156999,0.4139566999685276,-0.6971141442535895,-1.111070844222117
2025-08-28T12:55:00-04:00,343.82,344.07,343.42,343.57,NaN,NaN,NaN,344.3430141552106,NaN,NaN,345.8799199999996,352.75662087006725,339.0032191299319,342.05660743971305,345.7735611578488,349.3235095722781,342.2236127434195,61665,77631.66666666667,48.79916310688988,39.04660532752501,NaN,NaN,NaN,NaN,0.9469894259658064,28.302136791094018,94095334,0.41090162433205624,-0.5974438138070468,-1.008345438139103
2025-08-28T13:00:00-04:00,343.53,344.29,343.42,343.93,NaN,NaN,NaN,344.3430141552106,NaN,NaN,345.76091999999954,352.5621327371873,338.9597072628118,342.24428595177045,345.7491243786518,349.282561248055,342.2156875092486,50440,74233.46666666666,51.497704362404235,41.13008204887722,NaN,NaN,NaN,NaN,0.9414901812539634,26.565833526577578,94145774,0.41961387183724885,-0.48382809834254203,-0.9034419701797909
2025-08-28T13:05:00-04:00,343.98,344.26,343.63,344.2,NaN,NaN,NaN,344.3430141552106,NaN,NaN,345.64651999999955,352.3558588079934,338.9371811920057,342.30842876141634,345.7338306737405,349.2552172113943,342.2124441360867,35083,71022.3,53.47811500874167,43.14723423633886,NaN,NaN,NaN,NaN,0.9192408825929658,24.953551923812306,94180857,0.428544964469466,-0.36776076459295837,-0.7963057290624244
2025-08-28T13:10:00-04:00,344.16,344.3,343.67,343.8,NaN,NaN,NaN,344.3430141552106,NaN,NaN,345.51651999999956,352.11106380836196,338.92197619163716,342.4237430091331,345.7164374655363,349.2253153852933,342.20755954577925,38253,68799.9,50.2074078021967,44.34845145020103,NaN,NaN,NaN,NaN,0.8985808195506108,23.513566002316413,94142604,0.3934104669362791,-0.30454264539207543,-0.6979531123283546
2025-08-28T13:15:00-04:00,343.78,344.05,343.67,343.93,NaN,NaN,NaN,344.3430141552106,NaN,NaN,345.3817199999996,351.82314989159727,338.9402901084019,342.4237430091331,345.7017398359037,349.20034419272184,342.2031354790856,32184,67706.73333333334,51.25092591724398,45.59894397526188,NaN,NaN,NaN,NaN,0.8615393324398525,22.17643621807023,94174788,0.36542501938791205,-0.24117183809346443,-0.6065968574813765
2025-08-28T13:20:00-04:00,343.94,344.09,343.62,343.66,NaN,NaN,NaN,344.3430141552106,NaN,NaN,345.2371199999996,351.49956649512853,338.9746735048707,342.50219552584514,345.68117682159647,349.1664978427448,342.19585580044816,43645,66734.86666666667,48.956113028237084,46.34056121963638,NaN,NaN,NaN,NaN,0.8335722372655752,20.845487881885827,94131143,0.3170275582100418,-0.21031240971882426,-0.5273399679288661
2025-08-28T13:25:00-04:00,343.66,343.67,342.91,343.43,NaN,NaN,NaN,344.3430141552106,NaN,NaN,345.1013199999996,351.218459585818,338.9841804141812,342.50219552584514,345.65809734955036,349.13393678800554,342.1822579110952,40341,66330.13333333333,47.02450691952681,47.17811141494424,NaN,NaN,NaN,NaN,0.8283170774608906,20.244863722645302,94090802,0.2602034538429952,-0.20208565062512207,-0.4622891044681173
2025-08-28T13:30:00-04:00,343.46,344.4,343.46,344.11,341.2029829553122,341.2029829553122,341.2029829553122,NaN,NaN,NaN,344.9933199999996,350.98468388416023,339.00195611583894,342.5948051365409,345.6319815658898,349.08671653824,342.1772465935396,65179,66947.06666666667,52.936835074302095,48.354984137905696,NaN,NaN,NaN,NaN,0.838437286213682,19.082572745752987,94155981,0.25855752399350346,-0.13909219947623797,-0.3976497234697414
2025-08-28T13:35:00-04:00,344.15,344.49,344.09,344.13,341.6323928209799,NaN,NaN,NaN,NaN,NaN,344.87711999999965,350.7033096385354,339.0509303614639,342.84584410923276,345.61990082535874,349.06207578083627,342.1777258698812,36360,66863.36666666667,53.10261727315797,48.95600135563019,NaN,NaN,NaN,NaN,0.8071203371984215,18.133686397094724,94192341,0.24887352429760845,-0.08655781809773089,-0.33543134239533934
2025-08-28T13:40:00-04:00,344.11,344.27,344.01,344.21,341.6323928209799,NaN,NaN,NaN,NaN,NaN,344.7209199999996,350.1799342971423,339.26190570285684,342.84584410923276,345.61197521150865,349.046444346695,342.1775060763223,22976,66252.26666666666,53.80360358925545,49.751177469382434,NaN,NaN,NaN,NaN,0.7680403131128193,17.117523433776043,94215317,0.23792089613662093,-0.038030222224563204,-0.27595111836118413
2025-08-28T13:45:00-04:00,344.19,344.24,343.68,343.79,341.6323928209799,NaN,NaN,NaN,NaN,NaN,344.5829199999996,349.7736421825424,339.3921978174568,342.84584410923276,345.6041308436582,349.0326533345476,342.1756083527688,19475,64611.3,49.61100800908151,49.99917453345028,NaN,NaN,NaN,NaN,0.7531802907476182,16.161634775165336,94195842,0.19429616934010535,-0.03308090668605246,-0.2273770760261578
2025-08-28T13:50:00-04:00,343.82,345,343.771,344.99,341.8012824863913,NaN,NaN,NaN,NaN,NaN,344.48271999999963,349.43944404801675,339.5259959519825,343.23649218392717,345.58362576875834,348.9804227208984,342.1868288166183,87277,65131.7,59.35605797336948,51.00425670130012,NaN,NaN,NaN,NaN,0.7871674128370729,15.883577989756636,94283119,0.23542185946027935,0.06690024829919139,-0.16852161116108796
2025-08-28T13:55:00-04:00,344.98,345.01,344.62,344.8,342.29506510064624,NaN,NaN,NaN,NaN,NaN,344.3627199999996,348.980828323571,339.74461167642824,343.40419374714173,345.5762213811193,348.9575628766685,342.1948798855701,41836,59044.5,57.46118536150386,52.00716705897826,NaN,NaN,NaN,NaN,0.7587983119201381,15.63905179913418,94241283,0.23826846563722898,0.12931397088544827,-0.1089544947517807
2025-08-28T14:00:00-04:00,344.78,344.93,344.45,344.71,342.29506510064624,NaN,NaN,NaN,NaN,NaN,344.2321199999996,348.4135777487167,340.0506622512825,343.4053549977134,345.5697145349318,348.9393684606287,342.20006060923487,32578,57482.63333333333,56.54042288457433,52.43040473646323,NaN,NaN,NaN,NaN,0.7388841467829866,15.103515594143383,94208705,0.2228119641398131,0.16956046042298567,-0.05325150371682743
2025-08-28T14:05:00-04:00,344.72,344.91,344.5,344.82,342.29506510064624,NaN,NaN,NaN,NaN,NaN,344.1167199999997,347.88834530589776,340.34509469410165,343.4852839981707,345.56435940506157,348.9237319972886,342.20498681283453,28723,55701.4,57.438117700607314,53.047472921728755,NaN,NaN,NaN,NaN,0.7153924220127751,14.606231975223357,94237428,0.20894938391840417,0.20793522618117777,-0.0010141577372263927
2025-08-28T14:10:00-04:00,344.84,345.2,344.42,344.54,342.3989390399216,NaN,NaN,NaN,NaN,NaN,344.00331999999963,347.352619567408,340.65402043259127,343.67022719853657,345.5533530998136,348.8921328610672,342.21457333856,58540,53677.066666666666,54.36008400425941,53.2519286104327,NaN,NaN,NaN,NaN,0.7200072490118606,14.607764274580578,94178888,0.17144741523446422,0.21329511130585388,0.04184769607138967
2025-08-28T14:15:00-04:00,344.55,344.83,344.32,344.7,342.3989390399216,NaN,NaN,NaN,NaN,NaN,343.93031999999965,347.04862570538074,340.81201429461856,343.67022719853657,345.54664089758813,348.8743745023565,342.2189072928198,32414,51701.166666666664,55.81713151572623,53.419001218074456,NaN,NaN,NaN,NaN,0.7050067312252984,14.399981052425858,94211302,0.14878365974099944,0.22782727074763898,0.07904361100663954
2025-08-28T14:20:00-04:00,344.71,344.86,344.61,344.76,342.4376696624079,NaN,NaN,NaN,NaN,NaN,343.84651999999966,346.62771313248516,341.06532686751416,343.67022719853657,345.5423456934738,348.8616878453024,342.2230035416452,24316,48919.63333333333,56.37951852869691,53.85986626996733,NaN,NaN,NaN,NaN,0.6725062504234913,14.25867957012074,94235618,0.1298874058862452,0.24140286836444602,0.11151546247820084
2025-08-28T14:25:00-04:00,344.74,345.05,344.58,344.98,342.55800285957116,NaN,NaN,NaN,NaN,NaN,343.80131999999963,346.42970138637963,341.17293861361964,343.7685563256507,345.5380388342268,348.84716727294347,342.2289103955102,29319,46054.7,58.46703735212119,54.37530280102999,NaN,NaN,NaN,NaN,0.6580415182503867,14.458323520431698,94264937,0.12425790846093146,0.26683784805436517,0.1425799395934337
2025-08-28T14:30:00-04:00,345.04,345.2,344.14,344.24,342.55800285957116,NaN,NaN,NaN,NaN,NaN,343.7537199999996,346.2595380956208,341.24790190437835,343.7685563256507,345.5258368260005,348.8167955457817,342.2348781062193,55895,45185.13333333333,49.82898709094236,54.43765094836608,NaN,NaN,NaN,NaN,0.6867528383753593,13.669394423025352,94209042,0.0656906983300232,0.2246933125059627,0.1590026141759395
2025-08-28T14:35:00-04:00,344.25,344.41,343.97,344.06,342.55800285957116,NaN,NaN,NaN,NaN,NaN,343.73291999999964,346.21080231687154,341.25503768312774,343.7685563256507,345.518158609429,348.8015477219049,342.2347694969531,25937,43966.2,47.972374369679336,54.505355766234125,NaN,NaN,NaN,NaN,0.669127635634262,12.790792857653779,94183105,0.012601514730539554,0.17475450758911393,0.16215299285857437
2025-08-28T14:40:00-04:00,344.04,344.56,344,344.3,342.55800285957116,NaN,NaN,NaN,NaN,NaN,343.73291999999964,346.21080231687154,341.25503768312774,343.7685563256507,345.51242059271215,348.7892248437836,342.2356163416407,21809,43118,50.61455009008054,54.33947826736115,NaN,NaN,NaN,NaN,0.6613328045175292,12.08416121579773,94204914,-0.007496427833798391,0.1527824580663264,0.1602788859001248
2025-08-28T14:45:00-04:00,344.3,344.45,344.01,344.03,342.55800285957116,NaN,NaN,NaN,NaN,NaN,343.7055199999997,346.1389590890545,341.2720809109449,343.7685563256507,345.503962043944,348.7722129375525,342.2357111503355,29532,41833.166666666664,47.6808934540588,53.95221228028264,NaN,NaN,NaN,NaN,0.6455233184805627,11.428003262645683,94175382,-0.03839245497596128,0.11228831718017318,0.15068077215613446
2025-08-28T14:50:00-04:00,344.04,344.1,343.68,343.88,342.55800285957116,NaN,NaN,NaN,NaN,NaN,343.6731199999997,346.0526681806536,341.2935718193458,343.7685563256507,345.48876310140236,348.7453613749664,342.2321648278383,44685,41729.7,46.08286129268326,53.40073068767033,NaN,NaN,NaN,NaN,0.6294145100176666,11.117534794025755,94130697,-0.0666912677127573,0.06731668751518782,0.13400795522794512
2025-08-28T14:55:00-04:00,343.86,344.28,343.77,344.26,342.55800285957116,NaN,NaN,NaN,NaN,NaN,343.65391999999963,345.99846733718095,341.3093726628183,343.7685563256507,345.4779588913198,348.72412248615274,342.2317952964869,37372,40956.166666666664,50.59982536233178,53.47136049861679,NaN,NaN,NaN,NaN,0.6208849021592612,10.416988963031256,94168069,-0.05790336153871886,0.061628753304546535,0.1195321148432654
2025-08-28T15:00:00-04:00,344.24,344.81,344.2,344.59,342.55800285957116,NaN,NaN,NaN,NaN,NaN,343.64211999999964,345.9616310054195,341.32260899457975,343.7685563256507,345.4689976835399,348.70102457671953,342.23697079036026,45897,40583.433333333334,54.18907669784956,53.10229040750822,NaN,NaN,NaN,NaN,0.6201074091478863,10.635604878814243,94213966,-0.029389804720732354,0.08279485894234995,0.1121846636630823
2025-08-28T15:05:00-04:00,344.61,345.1,344.41,345.08,342.6526210582081,NaN,NaN,NaN,NaN,NaN,343.6333199999997,345.9274662011206,341.3391737988788,343.7685563256507,345.4631625841268,348.6801268258255,342.2461983424281,47065,40614.13333333333,58.95751195372306,53.20917087838102,NaN,NaN,NaN,NaN,0.6250997370658943,11.32806449045335,94261031,0.020270491527381668,0.1375227780723094,0.11725228654492773
2025-08-28T15:10:00-04:00,345.07,346,345.06,345.77,343.39500191919865,NaN,NaN,NaN,NaN,NaN,343.64511999999974,345.97672983528975,341.3135101647097,344.38968503266887,345.46614415420214,348.6503476191911,342.2819406892132,101251,42995.9,64.55284479984644,53.78148672947189,NaN,NaN,NaN,NaN,0.6475926129897588,13.162101865817624,94362282,0.09329921179384912,0.23387630128723913,0.14057708949339
2025-08-28T15:15:00-04:00,345.77,345.89,345.56,345.74,343.6420472865079,NaN,NaN,NaN,NaN,NaN,343.6549199999997,346.0173447831492,341.2924952168502,344.4367480261351,345.4688181225356,348.6369560442664,342.3006802008048,51051,43793.73333333333,64.1433946508139,54.26043508305806,NaN,NaN,NaN,NaN,0.6249074263476321,14.865136571513023,94311231,0.13098515559798968,0.3043085339908771,0.17332337839288742
2025-08-28T15:20:00-04:00,345.74,346,345.45,345.72,343.661726955303,NaN,NaN,NaN,NaN,NaN,343.6699199999996,346.0746986709771,341.2651413290221,344.5623984209081,345.4708645869538,348.62632174858453,342.31540742532303,40833,42731.03333333333,63.85261916632702,54.93847330892004,NaN,NaN,NaN,NaN,0.6195568958942307,16.446525941087323,94270398,0.14488300734454299,0.35442713757356614,0.20954413022902316
2025-08-28T15:25:00-04:00,345.7,346.5,345.64,346.42,343.98323936642555,NaN,NaN,NaN,NaN,NaN,343.70611999999966,346.2185001193765,341.19373988062284,344.91991873672646,345.4820897758894,348.61397018783344,342.35020936394534,80907,43372.433333333334,69.12768384021491,55.88922704638351,NaN,NaN,NaN,NaN,0.636731403330358,18.485558094889456,94351305,0.18876089575586275,0.4454952499238516,0.25673435416798884
2025-08-28T15:30:00-04:00,346.46,346.86,346.31,346.47,344.51809212249714,NaN,NaN,NaN,NaN,NaN,343.75371999999965,346.38094749838217,341.1264925016171,345.32093498938116,345.4965015589435,348.60954252454405,342.383460593343,70802,44051.166666666664,69.4703954215782,56.82428968158932,NaN,NaN,NaN,NaN,0.6305363030924761,20.73068882103382,94422107,0.20721783317820847,0.5157566456407494,0.30853881246254095
2025-08-28T15:35:00-04:00,346.47,346.6,345.99,346.06,344.51809212249714,NaN,NaN,NaN,NaN,NaN,343.8360199999996,346.48913664279615,341.1829033572031,345.32093498938116,345.50207627988647,348.60368723495003,342.4004653248229,40801,44241.76666666667,63.268224239420746,57.167231602110725,NaN,NaN,NaN,NaN,0.6290694243001573,21.97020629242076,94381306,0.17894545113421378,0.5322206263803082,0.3532751752460944
2025-08-28T15:40:00-04:00,346.08,346.67,346.07,346.26,344.51809212249714,NaN,NaN,NaN,NaN,NaN,343.9130199999996,346.61906574985335,341.2069742501459,345.32093498938116,345.5097617762897,348.5980262056055,342.42149734697387,49187,44606.23333333333,64.91377558160028,58.24471649430056,NaN,NaN,NaN,NaN,0.6277073225644328,23.201922600817518,94430493,0.16138704397940462,0.5550089802203502,0.39362193624094555
2025-08-28T15:45:00-04:00,346.26,346.57,346.2,346.23,344.51809212249714,NaN,NaN,NaN,NaN,NaN,343.9922199999996,346.7328592627308,341.25158073726834,345.32093498938116,345.5176806215293,348.59211259517656,342.443248647882,51650,45255.1,64.44738395111798,59.42150289297474,NaN,NaN,NaN,NaN,0.6092996566669736,24.345659172900223,94378843,0.13641849304135728,0.5641450525426421,0.42772655950128485
2025-08-28T15:50:00-04:00,346.26,346.68,346.03,346.4,344.51809212249714,NaN,NaN,NaN,NaN,NaN,344.0922199999996,346.8120228547007,341.3724171452985,345.32093498938116,345.5323285918664,348.5822396891475,342.4824174945853,93932,46931.333333333336,65.94073364576454,60.516230289809315,NaN,NaN,NaN,NaN,0.6122068240479065,24.921414601403374,94472775,0.12056690766036932,0.5784351940767465,0.45786828641637717
2025-08-28T15:55:00-04:00,346.32,346.54,345.8,345.8,344.51809212249714,NaN,NaN,NaN,NaN,NaN,344.18281999999954,346.8211188975018,341.5445211024973,345.32093498938116,345.5443028231758,348.559500258264,342.52910538808766,130277,49929.2,56.862471861121655,61.172057318885244,NaN,NaN,NaN,NaN,0.6213349080444852,24.826990450171895,94342498,0.06184622845435761,0.5351760719843242,0.47332984352996654
2025-08-29T09:30:00-04:00,347.21,348.72,346.27,346.73,345.17736406967,NaN,NaN,NaN,NaN,NaN,344.29821999999956,346.8663860788488,341.73005392115033,346.0329529418563,347.24,347.24,347.24,199545,54408.066666666666,64.92336603606589,62.51780765769828,NaN,NaN,NaN,NaN,0.7855252717555946,26.946087261381322,94542043,0.07683433236272841,0.569372758983377,0.4925384266206486
2025-08-29T09:35:00-04:00,346.72,346.84,344.67,345.7,NaN,NaN,NaN,348.2631979334968,348.2631979334968,348.2631979334968,344.38721999999956,346.83214543207913,341.94229456792,346.0329529418563,346.5199418602121,347.2709436437053,345.7689400767189,183440,59310.73333333333,53.09063832982696,62.69572286966223,NaN,NaN,NaN,NaN,0.8844163237730492,26.240980794418533,94358603,0.01197823030909656,0.5075112145070193,0.49553298419792274
2025-08-29T09:40:00-04:00,345.64,346.86,344.99,345.87,NaN,NaN,NaN,348.2631979334968,NaN,NaN,344.46201999999954,346.8544179101498,342.0696220898493,346.0329529418563,346.3484578686575,347.0427611925131,345.6541545448018,148658,63500.13333333333,54.562590787003295,62.722402447458926,NaN,NaN,NaN,NaN,0.9548151577892604,25.605488990465762,94507261,-0.02296891339153767,0.46682184245850067,0.48979075585003834
2025-08-29T09:45:00-04:00,345.75,345.785,343.38,344.87,NaN,NaN,NaN,347.45081671213245,NaN,NaN,344.51601999999957,346.8192679502774,342.21277204972176,346.0329529418563,345.98396047773934,346.90740399724706,345.06051695823163,148421,67798.33333333333,45.51514564626439,61.76223342549759,NaN,NaN,NaN,NaN,1.0644712179471711,24.380056792569185,94358840,-0.11195203027605244,0.3498507180049728,0.46180274828102524
2025-08-29T09:50:00-04:00,344.9,346.13,344.26,344.74,NaN,NaN,NaN,347.45081671213245,NaN,NaN,344.5564199999995,346.80238990556126,342.3104500944377,346.0329529418563,345.8401557658204,346.75501377041144,344.92529776122933,122733,68980.2,44.48250725137845,60.32863788632131,NaN,NaN,NaN,NaN,1.122008988093802,22.868184877144877,94236107,-0.17436267743280076,0.24384940149002432,0.4182120789228251
2025-08-29T09:55:00-04:00,344.82,345.1,343.15,343.44,NaN,NaN,NaN,347.2478051034099,NaN,NaN,344.58381999999955,346.73939568007614,342.42824431992295,346.0329529418563,345.5776380601973,346.6570807208267,344.49819539956786,125373,71764.76666666666,35.74815589248627,58.30040654644076,NaN,NaN,NaN,NaN,1.1811512032299623,22.454997406283983,94110734,-0.29111580496061495,0.05431732272205636,0.3454331276826713
2025-08-29T10:00:00-04:00,343.51,344.5,342.11,342.13,NaN,NaN,NaN,346.6117685078004,NaN,NaN,344.5824199999995,346.7442686201975,342.4205713798015,346.0329529418563,345.2021508587405,346.56611715672096,343.83818456076,152269,75754.46666666666,29.468783550478662,55.844418288165876,NaN,NaN,NaN,NaN,1.2674975458563924,22.819510911476673,93958465,-0.4357840193578368,-0.19929689651462468,0.2364871228432121
2025-08-29T10:05:00-04:00,342.11,342.36,340.13,340.46,NaN,NaN,NaN,344.70555175744585,NaN,NaN,344.5276199999995,346.95006467937776,342.10517532062124,346.0329529418563,344.5569543028414,346.5271255567118,342.58678304897103,195067,81299.26666666666,23.74307310908887,52.60266037879973,NaN,NaN,NaN,NaN,1.3362477211523658,24.222490896496033,93763398,-0.6123462415923062,-0.5289456791471707,0.08340056244513552
2025-08-29T10:10:00-04:00,340.4,340.51,338.54,339.35,NaN,NaN,NaN,343.09689031392554,NaN,NaN,344.45739999999955,347.24503788218294,341.66976211781616,346.0329529418563,343.747358612787,346.3415542788874,341.1531629466867,241233,87389.03333333334,20.844115678219865,49.12935468284557,NaN,NaN,NaN,NaN,1.3815157410700518,26.146016168829732,93522165,-0.7625097739174069,-0.8697366549516232,-0.10722688103421624
2025-08-29T10:15:00-04:00,339.33,339.36,337.48,337.93,NaN,NaN,NaN,342.0858952996562,NaN,NaN,344.3497999999995,347.67062035681727,341.02897964318174,346.0329529418563,342.94139166044596,346.0264725657112,339.85631075518074,260942,95006.63333333333,17.842762802481573,45.88467886592134,NaN,NaN,NaN,NaN,1.4171217595650478,28.273490457890095,93261223,-0.9063008601058575,-1.2401029561665382,-0.3338020960606806
2025-08-29T10:20:00-04:00,337.88,339.15,337.86,338.86,NaN,NaN,NaN,342.0858952996562,NaN,NaN,344.26339999999954,347.91025422826084,340.61654577173823,343.605362353485,342.61958404591473,345.7967573475424,339.4424107442871,143152,98967.83333333333,25.41721879177814,43.0634962380769,NaN,NaN,NaN,NaN,1.4080416338818276,30.249002297731852,93404375,-0.8865229012115599,-1.4419557225751305,-0.5554328213635706
2025-08-29T10:25:00-04:00,338.83,339.85,337.94,339.7,NaN,NaN,NaN,342.0858952996562,NaN,NaN,344.19939999999946,348.0465317318749,340.352268268124,343.33728988278807,342.3371023104377,345.5255090083609,339.1486956125144,170964,103689.33333333333,31.55522004423146,40.71405595901358,NaN,NaN,NaN,NaN,1.4438958028902704,31.307055130226537,93575339,-0.7689828517317977,-1.5166613860283178,-0.7476785342965201
2025-08-29T10:30:00-04:00,339.67,340.16,339.14,339.21,NaN,NaN,NaN,342.0858952996562,NaN,NaN,344.1071999999994,348.19944054065303,340.0149594593458,341.94446552498437,342.1820555752886,345.3482908284855,339.01582032209166,121075,105862,30.00401485947073,38.1471474742783,NaN,NaN,NaN,NaN,1.413617531255254,31.956163704664732,93454264,-0.6794538868680934,-1.5969958928816368,-0.9175420060135434
2025-08-29T10:35:00-04:00,339.19,339.87,338.78,339.74,NaN,NaN,NaN,342.0858952996562,NaN,NaN,344.0305999999995,348.29975337770315,339.7614466222958,341.94446552498437,342.07575128525343,345.22388872351394,338.9276138469929,90046,107998.96666666666,33.79501003458111,36.49947162952541,NaN,NaN,NaN,NaN,1.3905019933084524,32.72359136491698,93544310,-0.5455323535130483,-1.5994574479048538,-1.0539250943918055
2025-08-29T10:40:00-04:00,339.67,339.92,338.62,338.62,NaN,NaN,NaN,342.0858952996562,NaN,NaN,343.9243999999994,348.45448990666705,339.3943100933318,340.7765724199875,341.95097342823414,345.0915423717339,338.81040448473436,99168,110577.6,30.08665851598704,34.0111353780912,NaN,NaN,NaN,NaN,1.3840375652149923,33.510599571073016,93445142,-0.49486257304350434,-1.672503310696186,-1.1776407376526816
2025-08-29T10:45:00-04:00,338.61,339.41,338.51,338.65,NaN,NaN,NaN,342.0858952996562,NaN,NaN,343.81339999999943,348.5770013437745,339.04979865622437,339.84625793598997,341.8689511804086,345.007230940467,338.7306714203502,65407,111773.43333333333,30.307257640423742,32.38375104313383,NaN,NaN,NaN,NaN,1.3494634534139238,34.29475574498811,93510549,-0.4245113667535283,-1.708279946094592,-1.2837685793410638
2025-08-29T10:50:00-04:00,338.68,338.94,338.19,338.53,NaN,NaN,NaN,342.0858952996562,NaN,NaN,343.7079999999994,348.6960449078357,338.7199550921631,337.522006348792,341.7915769518849,344.9331564874339,338.6499974163359,58958,112249.2,29.90084070308508,30.6221974657111,NaN,NaN,NaN,NaN,1.3066446353129293,35.1812707741063,93451591,-0.3541172528334475,-1.726415145382873,-1.3722978925494256
2025-08-29T10:55:00-04:00,338.54,339.05,337.7,338.18,NaN,NaN,NaN,342.0070786676357,NaN,NaN,343.59299999999945,348.81492033666046,338.37107966333843,336.17361615383817,341.66629754466425,344.8182583257836,338.5143367635449,94304,114146.93333333333,28.692298075259558,29.420565496353607,NaN,NaN,NaN,NaN,1.3097414470762931,36.23969704639981,93357287,-0.30125737884275194,-1.7488696161028656,-1.4476122372601137
2025-08-29T11:00:00-04:00,338.09,338.83,338.03,338.595,NaN,NaN,NaN,342.006075091834,NaN,NaN,343.49169999999947,348.89775645941916,338.0856435405798,336.17361615383817,341.59003983125757,344.74178461877875,338.4382950437364,64364,114762.5,32.19194780558705,28.54266839308279,NaN,NaN,NaN,NaN,1.2733313437137015,37.22252144210093,93421651,-0.21265148936162426,-1.713426598962144,-1.5007751096005197
2025-08-29T11:05:00-04:00,338.61,339.51,338.6,339.38,NaN,NaN,NaN,342.006075091834,NaN,NaN,343.4106999999994,348.9380306435017,337.8833693564971,336.6965649412897,341.5378660974246,344.67535158188406,338.4003806129652,58998,115160.26666666666,38.35495347122427,28.728868220135503,NaN,NaN,NaN,NaN,1.247736247734149,37.165941864451185,93480649,-0.08218834565554256,-1.603510541669948,-1.5213221960144054
2025-08-29T11:10:00-04:00,339.38,339.67,339.16,339.18,NaN,NaN,NaN,342.006075091834,NaN,NaN,343.3120999999995,348.96057593269944,337.6636240672995,337.1642519530318,341.49360977569677,344.6147246776159,338.3724948737776,56304,113662.03333333334,37.421741472508714,29.296936643137652,NaN,NaN,NaN,NaN,1.1950408014674232,36.89503526302488,93424345,0.004997945520059499,-1.5150747641143312,-1.5200727096343907
2025-08-29T11:15:00-04:00,339.19,339.47,338.66,338.89,NaN,NaN,NaN,342.006075091834,NaN,NaN,343.20729999999946,348.98417015972655,337.4304298402724,337.1642519530318,341.44282524526324,344.5518692064207,338.3337812841058,58378,113906.26666666666,36.051993022136145,30.17614520835531,NaN,NaN,NaN,NaN,1.167537887076893,36.97720283612414,93365967,0.054733713417215,-1.451655567862872,-1.506389281280087
2025-08-29T11:20:00-04:00,338.89,339.43,338.88,339.27,NaN,NaN,NaN,342.006075091834,NaN,NaN,343.1084999999995,348.9815687891702,337.2354312108288,337.2273212499403,341.40147395875357,344.4965952357814,338.30635268172574,53536,114329.7,39.19280594469,31.48676594167461,NaN,NaN,NaN,NaN,1.123428037999973,37.05350129685918,93419503,0.12102207327645353,-1.3551116896845201,-1.4761337629609736
2025-08-29T11:25:00-04:00,339.28,339.63,338.83,338.93,NaN,NaN,NaN,342.006075091834,NaN,NaN,343.0112999999994,348.9958450322102,337.0267549677886,337.46785699995223,341.3435668105059,344.41988569636214,338.2672479246496,76187,114172.36666666667,37.42180111503696,32.885268678285705,NaN,NaN,NaN,NaN,1.10032603528569,36.813688957169305,93343316,0.14798578000642548,-1.291151537952942,-1.4391373179593674
2025-08-29T11:30:00-04:00,338.93,339.09,336.81,337.25,NaN,NaN,NaN,341.3911793692851,NaN,NaN,342.8564999999994,349.02586893065006,336.68713106934877,337.46785699995223,341.16442980910347,344.2650643142513,338.06379530395566,155276,116988.16666666667,30.167874615420047,33.22460123711728,NaN,NaN,NaN,NaN,1.1845884613367104,37.79975077898335,93188040,0.06303511489514024,-1.3603434243404422,-1.4233785392355824
2025-08-29T11:35:00-04:00,337.29,337.29,335.71,335.89,NaN,NaN,NaN,340.00021667068125,NaN,NaN,342.6782999999994,349.121473631254,336.23512636874483,337.46785699995223,340.88839157229125,344.1033946317461,337.6733885128364,188994,121927.93333333333,25.806770679086796,32.81399771103551,NaN,NaN,NaN,NaN,1.2128321426698054,39.17458856796969,92999046,-0.06733007346095077,-1.507541131061771,-1.4402110576008202
2025-08-29T11:40:00-04:00,335.88,336.68,334.78,335.28,NaN,NaN,NaN,339.33020682201396,NaN,NaN,342.4896999999995,349.229193277848,335.750206722151,337.46785699995223,340.631989744256,343.9685045088529,337.29547497965905,169148,125926.63333333333,24.122363113543017,32.39387972918353,NaN,NaN,NaN,NaN,1.261915561050536,40.776356063957806,92829898,-0.17130953984939157,-1.6543479824125598,-1.4830384425631682
2025-08-29T11:45:00-04:00,335.29,335.71,334.83,335.38,NaN,NaN,NaN,338.8265610573769,NaN,NaN,342.30089999999944,349.29286615856034,335.30893384143855,337.46785699995223,340.4645072831011,343.8771403744952,337.05187419170704,113713,127995.4,24.986746421739056,31.764718042551955,NaN,NaN,NaN,NaN,1.2346358781183544,42.26371159594676,92943611,-0.20759918103466557,-1.7425374188565002,-1.5349382378218346
2025-08-29T11:50:00-04:00,335.35,336.25,335,335.65,NaN,NaN,NaN,338.8265610573769,NaN,NaN,342.1230999999994,349.32718297860043,334.91901702139836,337.46785699995223,340.28934660340593,343.7591263371531,336.8195668696588,136022,129398.4,27.391810383763826,31.5722288902503,NaN,NaN,NaN,NaN,1.235733315395615,42.87595506838019,93079633,-0.1882376248200779,-1.7702352688469318,-1.581997644026854
2025-08-29T11:55:00-04:00,335.64,336.39,335.58,335.7,NaN,NaN,NaN,338.8265610573769,NaN,NaN,341.94309999999945,349.32811696425966,334.55808303573923,337.46785699995223,340.2039005166861,343.69304700783516,336.714754025537,74310,127532.83333333333,27.853124853638136,31.396933691194185,NaN,NaN,NaN,NaN,1.205323792867357,43.24775371499135,93153943,-0.14862079540479445,-1.767773638282847,-1.6191528428780526
2025-08-29T12:00:00-04:00,335.65,336.09,335.59,335.7,NaN,NaN,NaN,338.8265610573769,NaN,NaN,341.76189999999946,349.30447592354284,334.2193240764561,337.46785699995223,340.10760262650416,343.6181289034974,336.5970763495109,85399,123727.96666666666,27.853124853638136,31.250668273376544,NaN,NaN,NaN,NaN,1.1549435219482602,43.59299531541598,93153943,-0.10123727915398506,-1.745699441820534,-1.644462162666549
2025-08-29T12:05:00-04:00,335.74,335.9,335.31,335.7,NaN,NaN,NaN,338.8265610573769,NaN,NaN,341.5762999999994,349.2485812280696,333.90401877192915,337.46785699995223,340.0292833676159,343.558014038678,336.5005526965538,69739,119937.93333333333,27.853124853638136,31.190727328975015,NaN,NaN,NaN,NaN,1.1145904132376685,44.06425197159906,93153943,-0.051238936042472316,-1.7085108327196394,-1.6572718966771671
2025-08-29T12:10:00-04:00,335.68,336.6,335.67,336.53,NaN,NaN,NaN,338.8265610573769,NaN,NaN,341.42209999999943,349.1834385676966,333.66076143230225,337.46785699995223,339.93300826703637,343.46660506969516,336.3994114643776,104541,118467.36666666667,36.2506167677933,31.48063225484689,NaN,NaN,NaN,NaN,1.1014053837206927,43.444054895471965,93258484,0.05086277899194536,-1.5936934229372355,-1.6445562019291808
2025-08-29T12:15:00-04:00,336.57,336.93,336.2,336.42,NaN,NaN,NaN,338.8265610573769,NaN,NaN,341.2692999999994,349.1172286466278,333.42137135337106,336.2202855999618,339.87058382960385,343.40152126197756,336.3396463972301,76044,116054.8,35.65824908204324,31.288010512762533,NaN,NaN,NaN,NaN,1.0748764277406446,42.407154600765956,93182440,0.12016500697001531,-1.4943499432166618,-1.6145149501866771
2025-08-29T12:20:00-04:00,336.36,336.39,335.69,336.12,NaN,NaN,NaN,338.8265610573769,NaN,NaN,341.1056999999994,349.034718605259,333.1766813947398,334.673232646818,339.8156779501599,343.35027909958393,336.2810768007359,60950,113995.36666666667,34.02523350829715,31.045402801033138,NaN,NaN,NaN,NaN,1.0502423971877428,41.81750641682376,93121490,0.15287697810254275,-1.4234187275584986,-1.5762957056610414
2025-08-29T12:25:00-04:00,336.1,336.2,335.66,335.87,NaN,NaN,NaN,338.8265610573769,NaN,NaN,340.9424999999994,348.95946208063816,332.9255379193607,334.673232646818,339.7728945065839,343.3115126524939,336.2342763606739,46768,111375.2,32.682027158773906,30.80469095365012,NaN,NaN,NaN,NaN,1.01379651167433,41.29177742319271,93074722,0.16378251516857945,-1.3715675617003171,-1.5353500768688966
2025-08-29T12:30:00-04:00,335.9,336.59,335.79,335.98,NaN,NaN,NaN,338.8265610573769,NaN,NaN,340.7844999999994,348.8747178587774,332.69428214122144,334.673232646818,339.7355167239124,343.2751255232614,336.19590792456336,44138,107770.83333333333,33.91814872304502,30.42792972353262,NaN,NaN,NaN,NaN,0.9985253322690174,40.21833905340487,93118860,0.1830495810415429,-1.3065381005669678,-1.4895876816085107
2025-08-29T12:35:00-04:00,335.99,336.3,335.71,336.26,NaN,NaN,NaN,338.8265610573769,NaN,NaN,340.6244999999994,348.74980522518905,332.4991947748097,334.673232646818,339.6898761293511,343.2305362886074,336.14921597009476,54689,103091.56666666667,37.08504662238793,30.403875831200548,NaN,NaN,NaN,NaN,0.9693449513926613,39.29153486816116,93173549,0.21697927557726082,-1.2183635871369347,-1.4353428627141955
2025-08-29T12:40:00-04:00,336.21,336.21,335.66,335.709,NaN,NaN,NaN,338.8265610573769,NaN,NaN,340.44687999999934,348.60588395545136,332.2878760445473,334.673232646818,339.6447403534823,343.18866292892596,336.1008177780386,52090,96786.8,33.6658813049216,30.653733451879226,NaN,NaN,NaN,NaN,0.9429631691503259,38.47698225681694,93121459,0.20479355275082445,-1.179350921775665,-1.3841444745264895
2025-08-29T12:45:00-04:00,335.71,335.93,335.39,335.43,NaN,NaN,NaN,338.59379195199136,NaN,NaN,340.2538799999994,348.42190376740257,332.08585623259626,334.673232646818,339.5835784557297,343.13532652892474,336.0318303825347,67585,90341.56666666667,32.05432602334028,31.099987405040192,NaN,NaN,NaN,NaN,0.9141800856395897,37.97303688787724,93053874,0.18123401407858308,-1.1576019569282607,-1.3388359710068438
2025-08-29T12:50:00-04:00,335.42,335.9,335.3,335.69,NaN,NaN,NaN,338.4822559541736,NaN,NaN,340.0522799999994,348.1631465189855,331.94141348101334,334.673232646818,339.5345137300215,343.0911883814517,335.97783907859133,56396,87449.7,35.168857491172005,31.889022717727975,NaN,NaN,NaN,NaN,0.8917386509510452,37.58977127801039,93110270,0.18576526974892404,-1.1066293838206889,-1.292394653569613
2025-08-29T12:55:00-04:00,335.73,335.88,335.41,335.58,NaN,NaN,NaN,338.46033522898387,NaN,NaN,339.8490799999994,347.88855044878125,331.80960955121753,334.673232646818,339.48013617792446,343.0415663266005,335.9187060292484,64071,83886.6,34.44938140965036,32.564925216864495,NaN,NaN,NaN,NaN,0.861614461597397,37.23388178313402,93046199,0.18362982295553576,-1.0628573748751933,-1.246487197830729
2025-08-29T13:00:00-04:00,335.56,335.56,333.76,333.88,NaN,NaN,NaN,337.59554726403,NaN,NaN,339.61227999999943,347.64357910342983,331.58098089656903,334.673232646818,339.3108376270232,342.9291919146126,335.6924833394338,158872,85146.5,25.699176437241434,32.4440227921129,NaN,NaN,NaN,NaN,0.9300705714832967,38.197263059861704,92887327,0.07553914488180258,-1.1520632667284758,-1.2276024116102784
2025-08-29T13:05:00-04:00,333.95,334.35,333.69,334.19,NaN,NaN,NaN,336.91211329748324,NaN,NaN,339.36767999999944,347.29906916916184,331.43629083083704,334.5849351151708,339.234886099019,342.881018450911,335.588753747127,70195,84484.8,29.229283266267856,32.542319821586446,NaN,NaN,NaN,NaN,0.9107798163773487,39.13453152843259,92957522,0.03480540777385466,-1.1840956518929602,-1.2189010596668148
2025-08-29T13:10:00-04:00,334.19,334.26,333.19,333.21,NaN,NaN,NaN,336.6315626930522,NaN,NaN,339.1024799999994,346.95254597939584,331.25241402060294,334.5849351151708,339.1039356057759,342.80727515398326,335.4005960575686,114126,84983.4,25.15970963494391,32.34993302025115,NaN,NaN,NaN,NaN,0.922152686636109,40.301635761308546,92843396,-0.04397908873855094,-1.2738749205900035,-1.2298958318514526
2025-08-29T13:15:00-04:00,333.21,333.5,332.67,333.27,NaN,NaN,NaN,335.9726280251862,NaN,NaN,338.8466799999994,346.60623284747885,331.08712715252,334.5849351151708,338.96800452155446,342.73537579768004,335.2006332454289,115622,86657.23333333334,25.84049067221126,32.20617343586351,NaN,NaN,NaN,NaN,0.9155703518763858,41.66287540088324,92959018,-0.07601244297786569,-1.3249113855737846,-1.248898942595919
2025-08-29T13:20:00-04:00,333.28,334.07,333.28,333.84,NaN,NaN,NaN,335.9726280251862,NaN,NaN,338.5982799999994,346.185941869691,331.0106181303078,334.4009480921367,338.889774101871,342.682498934162,335.09704926958,76827,87252.86666666667,32.154448172311106,31.91358996475764,NaN,NaN,NaN,NaN,0.907315326742359,41.86394837601411,93035845,-0.044343589318494914,-1.3043284292440376,-1.2599848399255427
2025-08-29T13:25:00-04:00,333.86,334.17,333.69,333.74,NaN,NaN,NaN,335.9726280251862,NaN,NaN,338.3484799999994,345.7343984426003,330.96256155739854,334.3907584737093,338.8410077302765,342.6472774391782,335.0347380213748,50430,85790.4,31.645404220449464,31.62695818892951,NaN,NaN,NaN,NaN,0.8767928034036204,41.87174426110126,92985415,-0.01706432625215437,-1.2813152477407357,-1.2642509214885813
2025-08-29T13:30:00-04:00,333.73,334.35,333.72,333.93,NaN,NaN,NaN,335.9726280251862,NaN,NaN,338.0990799999994,345.2179752160396,330.9801847839592,334.3007483385392,338.7945973575215,342.6118366445536,334.97735807048946,50281,85320.96666666666,33.79014659174007,31.61016626631829,NaN,NaN,NaN,NaN,0.8591647460176473,41.54925784314082,93035696,0.024579617982567026,-1.2335263990103726,-1.2581060169929397
2025-08-29T13:35:00-04:00,333.92,334.32,333.71,333.96,NaN,NaN,NaN,335.9726280251862,NaN,NaN,337.8622799999994,344.723810243973,331.00074975602575,334.3007483385392,338.7467671176479,342.57472398487045,334.91881025042534,52811,85114.73333333334,34.14152206126744,31.714415902210686,NaN,NaN,NaN,NaN,0.8413672641592448,41.258493525074236,93088507,0.06277717358129808,-1.179634550016317,-1.242411723597615
2025-08-29T13:40:00-04:00,333.94,334.11,333.46,334.04,NaN,NaN,NaN,335.9726280251862,NaN,NaN,337.6084799999994,344.06609634357415,331.1508636564247,334.3007483385392,338.70091881183333,342.5397965799639,334.8620410437028,50277,84913.83333333333,35.13017745073938,31.80098938276028,NaN,NaN,NaN,NaN,0.8276981738621583,41.21033834423932,93138784,0.09986002188137677,-1.117586696245894,-1.2174467181272708
2025-08-29T13:45:00-04:00,334.06,334.4,333.59,333.98,NaN,NaN,NaN,335.9726280251862,NaN,NaN,337.37407999999937,343.48116515553346,331.2669948444653,333.38659867083135,338.6401682567937,342.4910693517432,334.7892671618442,69865,85296.73333333334,34.70932930571328,31.631295288712092,NaN,NaN,NaN,NaN,0.82643401858629,40.57888563417482,93068919,0.1251381749338012,-1.0610239994600192,-1.1861621743938204
2025-08-29T13:50:00-04:00,333.96,334.26,333.75,333.86,NaN,NaN,NaN,335.9726280251862,NaN,NaN,337.1338799999994,342.8153545502218,331.452405449777,332.58108280676674,338.60077771257914,342.45922953308775,334.74232589207054,45952,85043.93333333333,33.836272961424754,31.64346612131946,NaN,NaN,NaN,NaN,0.8038315886872686,39.99253668911492,93022967,0.13757797610419886,-1.014189704263572,-1.1517676803677708
2025-08-29T13:55:00-04:00,333.81,333.97,333.35,333.56,NaN,NaN,NaN,335.9726280251862,NaN,NaN,336.9076799999994,342.22825257753635,331.58710742246245,332.58108280676674,338.5526096771497,342.4231077330535,334.6821116212459,53426,84285.23333333334,31.690194260962002,31.61745670972101,NaN,NaN,NaN,NaN,0.7907007609238926,39.86099475799702,92969541,0.1295180845781163,-0.9898700746451254,-1.1193881592232418
2025-08-29T14:00:00-04:00,333.55,333.59,332.99,333.33,NaN,NaN,NaN,335.8387111566355,NaN,NaN,336.6794799999994,341.60051202599493,331.75844797400384,332.58108280676674,338.4842251383342,342.3752259704667,334.59322430620165,72822,81536.76666666666,30.1132649197676,31.256342954620695,NaN,NaN,NaN,NaN,0.777079278000755,40.07685442913685,92896719,0.11320393420076602,-0.9778832414722842,-1.0910871756730502
2025-08-29T14:05:00-04:00,333.35,333.99,333.27,333.89,NaN,NaN,NaN,335.8387111566355,NaN,NaN,336.4884799999993,341.0750645289405,331.9018954710581,332.58108280676674,338.4541555351242,342.35118679912915,334.5571242711192,35480,76419.63333333333,38.17939888299643,31.52277277414542,NaN,NaN,NaN,NaN,0.7730021867149889,39.421302972305206,92932199,0.14272932875872835,-0.9126755147246399,-1.0554048434833683
2025-08-29T14:10:00-04:00,333.79,333.95,333.43,333.71,NaN,NaN,NaN,335.8387111566355,NaN,NaN,336.32007999999934,340.6783800879913,331.9617799120074,332.58108280676674,338.4168389124304,342.32117899267405,334.5124988321868,44473,72263.8,36.71265062370739,32.30944950175013,NaN,NaN,NaN,NaN,0.7549306019496312,38.812576619532955,92887726,0.15188791181495453,-0.8655449537146751,-1.0174328655296296
2025-08-29T14:15:00-04:00,333.68,333.73,333.26,333.46,NaN,NaN,NaN,335.8387111566355,NaN,NaN,336.1800799999994,340.44618703767026,331.91397296232856,332.58108280676674,338.38551429345694,342.2971177416365,334.4739108452774,36230,69681.03333333334,34.717710959616866,32.70148005127506,NaN,NaN,NaN,NaN,0.7345784160960881,38.44327761166313,92851496,0.1429874441929101,-0.838698560288492,-0.9816860044814021
2025-08-29T14:20:00-04:00,333.45,333.51,332.77,332.92,NaN,NaN,NaN,335.56804698472456,NaN,NaN,336.05147999999934,340.31526889264245,331.78769110735624,332.58108280676674,338.31088862468874,342.2450112297882,334.3767660195893,81198,67853.56666666667,30.821788581101913,33.105914261714915,NaN,NaN,NaN,NaN,0.7349656720892253,38.62036381967556,92770298,0.10440147087193619,-0.8511841658914818,-0.955585636763418
2025-08-29T14:25:00-04:00,332.89,333.1,332.46,332.68,NaN,NaN,NaN,335.1849539399643,NaN,NaN,335.9464799999994,340.2780892761146,331.61487072388417,332.58108280676674,338.2385617930521,342.19751989837744,334.27960368772676,76217,67917.13333333333,29.25071040529535,33.349501385506635,NaN,NaN,NaN,NaN,0.7281824097971408,39.07828492816566,92694081,0.06813928523942103,-0.8704115302141417,-0.9385508154535628
2025-08-29T14:30:00-04:00,332.7,333.04,332.62,332.92,NaN,NaN,NaN,335.1829105790569,NaN,NaN,335.82767999999936,340.15896892514115,331.49639107485757,332.58108280676674,338.1806395416418,342.1571637637192,334.20411531956444,63832,67198.23333333334,32.93232154618717,33.405063769354925,NaN,NaN,NaN,NaN,0.7061693805259176,39.50349738604931,92757913,0.0657117038203261,-0.8564111856781551,-0.9221228894984812
2025-08-29T14:35:00-04:00,332.93,333.02,332.2,332.361,NaN,NaN,NaN,334.9677782800089,NaN,NaN,335.6808999999994,339.97458453924855,331.3872154607502,332.5498662454134,338.1230750346132,342.119808350781,334.12634171844536,60972,66906,29.1300563333119,33.225396063130816,NaN,NaN,NaN,NaN,0.7143001390597802,40.28514336293876,92696941,0.033478171010926316,-0.8802751757348233,-0.9137533467457496
2025-08-29T14:40:00-04:00,332.4,332.48,331.94,332.16,NaN,NaN,NaN,334.53424290364484,NaN,NaN,335.5398999999994,339.82377419544594,331.2560258045529,332.35080921412134,338.0434816780168,342.07152053203805,334.01544282399556,81473,66137.06666666667,27.883433045459157,32.803487952682175,NaN,NaN,NaN,NaN,0.7018501291269402,41.22909698352545,92615468,0.00702300048360438,-0.9049745961412441,-0.9119975966248485
2025-08-29T14:45:00-04:00,332.15,332.4,331.85,331.95,NaN,NaN,NaN,334.41859549893366,NaN,NaN,335.3840999999995,339.61188983894016,331.1563101610588,332.35080921412134,337.9682804813201,342.0259594717421,333.9106014908981,77344,66180.4,26.602506038957074,32.26498680823144,NaN,NaN,NaN,NaN,0.6910036913321556,42.180218298259625,92538124,-0.015013946569679693,-0.9307650298369481,-0.9157510832672684
2025-08-29T14:50:00-04:00,331.96,332.27,331.71,331.74,NaN,NaN,NaN,334.2557047944367,NaN,NaN,335.24649999999946,339.49186749437115,331.00113250562777,332.35080921412134,337.9004719464981,341.98544515648234,333.81549873651386,69543,66466.83333333333,25.348457466206057,31.566292523621915,NaN,NaN,NaN,NaN,0.6816462848084303,43.18112607657119,92468581,-0.033092203744569226,-0.9571163379479799,-0.9240241342034107
2025-08-29T14:55:00-04:00,331.77,332.5,331.74,332.5,NaN,NaN,NaN,334.2557047944367,NaN,NaN,335.12349999999947,339.32342680438694,330.923573195612,332.35080921412134,337.84733344939036,341.94950126030886,333.74516563847186,58983,66874,36.935120095821624,31.725277580058226,NaN,NaN,NaN,NaN,0.6872429787506845,43.43799208174614,92527564,0.014237019047087296,-0.9062278603945515,-0.9204648794416388
2025-08-29T15:00:00-04:00,332.48,332.77,332.4,332.465,NaN,NaN,NaN,334.2557047944367,NaN,NaN,335.00219999999945,339.151609693234,330.8527903067649,332.2156473712971,337.79054281532626,341.90702730238786,333.67405832826466,67943,67667.5,36.65297794244625,31.926470792988336,NaN,NaN,NaN,NaN,0.6645827659827788,42.93409921814742,92459621,0.049313815280459194,-0.8588226103410648,-0.908136425621524
2025-08-29T15:05:00-04:00,332.48,332.57,331.9,332.18,NaN,NaN,NaN,334.2557047944367,NaN,NaN,334.88219999999944,339.0040094087816,330.7603905912173,331.92851789703764,337.7241852451134,341.8605088323985,333.5878616578283,76431,68392.23333333334,34.351853352683705,32.11658929953988,NaN,NaN,NaN,NaN,0.6649697112697243,43.028509132220435,92383190,0.058805432181216144,-0.8346296353950038,-0.8934350675762199
2025-08-29T15:10:00-04:00,332.17,332.4,331.96,332.3,NaN,NaN,NaN,334.2557047944367,NaN,NaN,334.75629999999944,338.80062187175145,330.71197812824744,331.5618514541041,337.6742156104741,341.82468458397426,333.52374663697395,58818,68616.5,36.16897399697807,32.54913994791206,NaN,NaN,NaN,NaN,0.6489004461790294,43.11617548100252,92442008,0.07747531247260864,-0.7965909269854592,-0.8740662394580678
2025-08-29T15:15:00-04:00,332.3,332.48,332.15,332.39,NaN,NaN,NaN,334.2557047944367,NaN,NaN,334.6164999999994,338.4915516335083,330.7414483664905,331.5618514541041,337.629690148922,341.7911955770871,333.46818472075694,54535,68181.5,37.56481717135499,32.505241254223385,NaN,NaN,NaN,NaN,0.6261218428805302,42.96628334970977,92496543,0.09882813264604895,-0.7505310736505066,-0.8493592062965556
2025-08-29T15:20:00-04:00,332.41,332.58,332.2,332.21,NaN,NaN,NaN,334.2557047944367,NaN,NaN,334.4770999999995,338.18325063403734,330.77094936596166,331.42748116328323,337.56933656587273,341.7451142183071,333.39355891343837,75260,68810.3,35.875105262030615,32.445416585532186,NaN,NaN,NaN,NaN,0.6085417112462063,42.53165378055455,92421283,0.10328719890706073,-0.7202502076627297,-0.8235374065697905
2025-08-29T15:25:00-04:00,332.21,332.43,331.88,332.13,NaN,NaN,NaN,334.2028655741997,NaN,NaN,334.3418999999995,337.88382768448946,330.79997231550954,331.3552708567386,337.4870851896884,341.68373725153367,333.29043312784313,101784,70067.4,35.119011194811165,32.47408088804606,NaN,NaN,NaN,NaN,0.6043601604429066,42.54194911437664,92319499,0.10307018984311134,-0.6946996692659013,-0.7977698591090127
2025-08-29T15:30:00-04:00,332.14,332.97,332.12,332.85,NaN,NaN,NaN,334.2028655741997,NaN,NaN,334.21349999999956,337.48679698652876,330.94020301347035,331.5411733483128,337.4190456773963,341.6248793333303,333.2132120214623,95670,67960.66666666667,46.124327798866695,33.56711940360069,NaN,NaN,NaN,NaN,0.6219058632684149,41.09441136617365,92415169,0.1507528965723982,-0.6093287383935149,-0.7600816349659131
2025-08-29T15:35:00-04:00,332.86,333.02,332.29,332.89,NaN,NaN,NaN,334.2028655741997,NaN,NaN,334.0926999999995,337.0954662250172,331.08993377498183,331.5411733483128,337.34919153148115,341.56200141640795,333.13638164655436,103000,69054.16666666667,46.66558636658044,34.811039115121055,NaN,NaN,NaN,NaN,0.6296268730349539,39.627498668647156,92518169,0.18221900316899486,-0.5323078810046695,-0.7145268841736644
2025-08-29T15:40:00-04:00,332.92,333.25,332.63,333.14,NaN,NaN,NaN,334.2028655741997,NaN,NaN,334.0104999999995,336.88534002373785,331.1356599762612,331.73355094292015,337.2912814347815,341.5054495350263,333.07711333453676,93382,68362.7,50.043647495739926,36.03327668294625,NaN,NaN,NaN,NaN,0.6289392392467432,37.70476516543741,92611551,0.21485774910147426,-0.4459546977968216,-0.6608124468982959
2025-08-29T15:45:00-04:00,333.14,333.85,333.14,333.53,NaN,NaN,NaN,334.2028655741997,NaN,NaN,333.9632999999995,336.790252882906,331.136347117093,332.28184075433614,337.2442804333557,341.45312033417434,333.03544053253705,88057,67443.86666666667,54.84811386886881,37.87028079262888,NaN,NaN,NaN,NaN,0.6347292935862642,35.34851251308246,92699608,0.25496527432012905,-0.34210585399813453,-0.5970711283182636
2025-08-29T15:50:00-04:00,333.71,334.48,332.8,333.2,331.43577732956976,331.43577732956976,331.43577732956976,NaN,NaN,NaN,333.9216999999995,336.7310868730199,331.1123131269791,332.3854726034689,337.153943382616,341.35137040503275,332.9565163601992,174981,70715.66666666667,50.42868548621179,39.480655966968364,NaN,NaN,NaN,NaN,0.7093914869015315,34.17338718390433,92524627,0.25112174757147254,-0.2831689438539229,-0.5342906914253954
2025-08-29T15:55:00-04:00,333.19,334.37,333.09,333.86,331.45142381458936,NaN,NaN,NaN,NaN,NaN,333.8912999999995,336.6696324858992,331.11296751409975,332.3854726034689,337.0925375919379,341.27609940428835,332.9089757795875,134413,73515.1,57.75944104599042,41.7061513246136,NaN,NaN,NaN,NaN,0.7501492378371386,33.082199378238926,92659040,0.2825391668665005,-0.1811167328422698,-0.4636558997087703
2025-09-02T09:30:00-04:00,328.24,328.88,325.59,327.96,NaN,NaN,NaN,330.53773181334657,330.53773181334657,330.53773181334657,333.7374999999995,336.92991243610754,330.54508756389146,332.3854726034689,327.4766666666667,327.4766666666667,327.4766666666667,220393,79185.5,23.831340894701427,41.597785855220415,NaN,NaN,NaN,NaN,1.2872814351344886,35.0818121997002,92438647,-0.08487732756762972,-0.5697525591683075,-0.48487523160067775
2025-09-02T09:35:00-04:00,327.96,330.7,327.87,329.83,325.7464832690783,325.7464832690783,325.7464832690783,NaN,NaN,NaN,333.6200999999995,336.9442146373266,330.29598536267247,332.3854726034689,328.4153119793652,329.4087147925399,327.42190916619046,196766,83984,36.552467497074964,41.57045352673851,NaN,NaN,NaN,NaN,1.3974756183391668,35.218511417450856,92635413,-0.18695791220336933,-0.7185726218548893,-0.53161470965152
2025-09-02T09:40:00-04:00,329.8,331.7,329.72,331.11,327.0623249386657,NaN,NaN,NaN,NaN,NaN,333.5282999999996,336.87105314701915,330.18554685298005,332.3854726034689,329.0516275996752,330.418490535828,327.6847646635224,148152,87246.5,43.507413610899434,42.06005607448516,NaN,NaN,NaN,NaN,1.439084502743509,34.55016049585605,92783565,-0.15460616281426454,-0.7248724131693507,-0.5702662503550862
2025-09-02T09:45:00-04:00,331.11,332.41,330.84,332.12,327.92903744145354,NaN,NaN,NaN,NaN,NaN,333.45669999999956,336.76348916807365,330.14991083192547,332.3854726034689,329.5490734800232,331.17500725849806,327.92313970154834,125489,89100.63333333333,48.3212073623419,43.05786707517503,NaN,NaN,NaN,NaN,1.4484356096904047,33.403567738019504,92909054,-0.056569153519367865,-0.640977692254296,-0.5844085387349282
2025-09-02T09:50:00-04:00,332.1,332.77,331.5,332.43,328.4338539213875,NaN,NaN,NaN,NaN,NaN,333.3746999999995,336.57418023938146,330.17521976061755,332.3854726034689,329.93112993312144,331.7050956699886,328.15716419625426,114640,91390.23333333334,49.73690418737526,44.02700494591769,NaN,NaN,NaN,NaN,1.4356902089982317,32.076839761640386,93023694,0.032955409995117924,-0.5432142762410308,-0.5761696862361487
2025-09-02T09:55:00-04:00,332.5,332.66,331.37,332.06,328.4338539213875,NaN,NaN,NaN,NaN,NaN,333.2874999999995,336.3863102817406,330.18868971825844,332.3854726034689,330.11577654026445,331.91120356907226,328.32034951145664,77693,92199.13333333333,48.0451691665484,44.77560151700294,NaN,NaN,NaN,NaN,1.4252837654983597,30.917249352494853,92946001,0.06898038841459864,-0.48994420071790046,-0.5589245891324991
2025-09-02T10:00:00-04:00,332.02,333.32,330.94,331.05,328.4338539213875,NaN,NaN,NaN,NaN,NaN,333.1860999999995,336.23899458093064,330.13320541906836,332.3854726034689,330.32447384400245,332.0904156897549,328.55853199825003,127502,94021.8,43.67781120004711,45.33293765543268,NaN,NaN,NaN,NaN,1.4934777822484764,29.335170389164674,92818499,0.02858384935669611,-0.523194777436629,-0.5517786267933251
2025-09-02T10:05:00-04:00,331.12,332,330.42,331.29,328.4338539213875,NaN,NaN,NaN,NaN,NaN,333.09449999999947,336.09415884097416,330.0948411590248,332.3854726034689,330.3790757014931,332.10496882603206,328.6531825769541,64346,94984,44.95818379561881,46.03573569834752,NaN,NaN,NaN,NaN,1.4996579406592985,28.187127264742738,92882845,0.022112368401829285,-0.5241381662910385,-0.5462505346928678
2025-09-02T10:10:00-04:00,331.26,332.17,330.9,331.46,328.4338539213875,NaN,NaN,NaN,NaN,NaN,333.0040999999994,335.9217879412304,330.0864120587685,332.0543780827751,330.4358507392355,332.1358960029985,328.7358054754725,56819,95395.53333333334,45.896405188013226,46.019455511857984,NaN,NaN,NaN,NaN,1.48325380204078,26.983160609595817,92939664,0.03272606732592276,-0.5053429505354643,-0.5380690178613871
2025-09-02T10:15:00-04:00,331.48,333.25,331.14,331.93,328.4338539213875,NaN,NaN,NaN,NaN,NaN,332.9174999999995,335.6972714226584,330.1377285773406,328.6454241902104,330.54042420131304,332.2354320454106,328.84541635721547,75567,96706.76666666666,48.509603856966145,46.15117104688553,NaN,NaN,NaN,NaN,1.5280213876092965,25.07705806706421,93015231,0.07256274818531516,-0.44736558262974313,-0.5199283308150583
2025-09-02T10:20:00-04:00,331.94,332.67,331.43,331.69,328.4338539213875,NaN,NaN,NaN,NaN,NaN,332.83711999999946,335.5201086516135,330.1541313483854,328.6454241902104,330.59814219106823,332.2805771820176,328.91570720011885,52323,95744.26666666666,47.25447781149217,45.95194464086784,NaN,NaN,NaN,NaN,1.5074484313514902,23.30710570614201,92962908,0.08315159684935558,-0.4159888347533638,-0.49914043160271937
2025-09-02T10:25:00-04:00,331.62,332.86,331.3,332.77,328.4338539213875,NaN,NaN,NaN,NaN,NaN,332.7839199999995,335.36260676200726,330.20523323799176,328.6454241902104,330.67430636317533,332.35633785213827,328.9922748742124,58656,95158.9,53.13126594547973,45.82931264634005,NaN,NaN,NaN,NaN,1.511202114826384,21.81219036479631,93021564,0.15890318290399313,-0.30051145297272797,-0.4594146358767211
2025-09-02T10:30:00-04:00,332.76,332.79,331.58,331.62,328.4338539213875,NaN,NaN,NaN,NaN,NaN,332.7025199999995,335.16338860287766,330.2416513971213,328.80665718538773,330.7206033039643,332.3907093043272,329.05049730360145,47831,94625.53333333334,47.11198506216843,45.5924054731941,NaN,NaN,NaN,NaN,1.4896876780530732,20.42405469068959,92973733,0.12885092421851874,-0.2983509806035727,-0.4272019048220914
2025-09-02T10:35:00-04:00,331.64,332.53,331.5,332.44,328.4338539213875,NaN,NaN,NaN,NaN,NaN,332.6397199999995,334.9598969261522,330.3195430738468,328.82832574831014,330.76962177974417,332.4315594128996,329.1076841465887,48281,94202.5,51.34475626348635,45.134213703015234,NaN,NaN,NaN,NaN,1.4568528439064232,19.061305119125457,93022014,0.1594853748709797,-0.2278451862333668,-0.3873305611043465
2025-09-02T10:40:00-04:00,332.41,332.55,330.85,330.945,328.4338539213875,NaN,NaN,NaN,NaN,NaN,332.58101999999946,334.9211355357732,330.2409044642257,328.82832574831014,330.80123907168013,332.4302966403657,329.17218150299453,69111,93790.43333333333,44.3722210204786,46.601419426285034,NaN,NaN,NaN,NaN,1.4742204979131066,18.19079501942695,92952903,0.07844977954745003,-0.28926833667003393,-0.36771811621748396
2025-09-02T10:45:00-04:00,331,331.23,330.5,330.87,328.4338539213875,NaN,NaN,NaN,NaN,NaN,332.51461999999947,334.85675720878555,330.1724827912134,328.82832574831014,330.8038618498753,332.3999852730002,329.20773842675044,61955,93277.46666666666,44.04904740528204,47.1368894197284,NaN,NaN,NaN,NaN,1.4210618909193147,17.68125978850064,92890948,0.022111862331037735,-0.3400782883036868,-0.36219015063472454
2025-09-02T10:50:00-04:00,330.8,331.64,330.71,331.46,328.4338539213875,NaN,NaN,NaN,NaN,NaN,332.4796199999995,334.8314278800518,330.1278121199472,328.82832574831014,330.8141286044928,332.39405861992395,329.23419858906163,34807,92119.6,47.30070611830914,47.407838884543374,NaN,NaN,NaN,NaN,1.3859860415679355,16.78270441737936,92925755,0.02659564702485706,-0.32894559185365324,-0.3555412388785103
2025-09-02T10:55:00-04:00,331.43,331.46,330.3,330.76,328.4338539213875,NaN,NaN,NaN,NaN,NaN,332.4294199999994,334.81845987761454,330.0403801223843,328.82832574831014,330.8148511174139,332.37256932041714,329.2571329144107,45402,91666.9,44.03115409305992,47.101406508166086,NaN,NaN,NaN,NaN,1.3698441814559377,16.318437297520376,92880353,-0.013419154422995017,-0.3723151819072541,-0.3588960274842591
2025-09-02T11:00:00-04:00,330.74,331.31,329.76,329.81,328.4338539213875,NaN,NaN,NaN,NaN,NaN,332.3488199999995,334.81281190596354,329.8848280940354,328.82832574831014,330.790841050578,332.3161995741037,329.26548252705237,78459,92017.43333333333,39.991040460172385,46.405273384794455,NaN,NaN,NaN,NaN,1.3827124542090858,16.347950309749667,92801894,-0.09515099655746218,-0.4778347731810868,-0.3826837766236246
2025-09-02T11:05:00-04:00,329.83,329.9,328.82,329.589,328.4338539213875,NaN,NaN,NaN,NaN,NaN,332.2657999999995,334.8149537423818,329.7166462576172,328.82832574831014,330.7358576897144,332.2536596024602,329.21805577696864,72105,91873.23333333334,39.09241369582277,45.7657908511712,NaN,NaN,NaN,NaN,1.361090136051293,17.08161873596783,92729789,-0.15200580808943692,-0.5726910367354208,-0.42068522864598384
2025-09-02T11:10:00-04:00,329.62,329.98,328.94,329.13,328.4338539213875,NaN,NaN,NaN,NaN,NaN,332.1697999999995,334.82053861448054,329.51906138551846,328.82832574831014,330.6924924573147,332.2057187328459,329.1792661817835,57378,91825.23333333334,37.2216564442838,45.304636940045256,NaN,NaN,NaN,NaN,1.3381551263333449,17.66551066312754,92672411,-0.20512990762368505,-0.6770976131755901,-0.4719677055519051
2025-09-02T11:15:00-04:00,329.15,329.3,328.16,328.33,NaN,NaN,NaN,332.548670007195,332.548670007195,332.548670007195,332.0571999999995,334.86768750258545,329.24671249741357,328.82832574831014,330.6163796212938,332.15274566153016,329.0800135810574,69102,92310.8,34.153858766902374,44.53289943799407,NaN,NaN,NaN,NaN,1.324001188738105,18.74992769595,92603309,-0.27442510688150534,-0.8149990891537868,-0.5405739822722815
2025-09-02T11:20:00-04:00,328.36,328.73,327.9,328.46,NaN,NaN,NaN,332.0732759159589,NaN,NaN,331.94559999999944,334.8730032729333,329.0181967270656,328.82832574831014,330.5206224018574,332.09118785832095,328.95005694539384,84460,92617.46666666666,35.09008351505882,43.76101931849733,NaN,NaN,NaN,NaN,1.288715389542529,19.925613051886973,92687769,-0.29024757163034276,-0.90338344681021,-0.6131358751798672
2025-09-02T11:25:00-04:00,328.5,328.82,328.13,328.42,NaN,NaN,NaN,332.0732759159589,NaN,NaN,331.8343999999995,334.8648313096004,328.8039686903986,328.73866059864815,330.4707704109426,332.05428037214506,328.8872604497401,49187,90864.23333333334,34.92553492067256,42.79072868019064,NaN,NaN,NaN,NaN,1.2459500045752052,20.89231690338501,92638582,-0.28191239250258826,-0.9655263658081026,-0.6836139733055143
2025-09-02T11:30:00-04:00,328.35,328.48,327.88,328.26,NaN,NaN,NaN,331.7760117333427,NaN,NaN,331.72239999999954,334.85723657023135,328.5875634297677,328.4437427831348,330.4272073702165,332.02595408671215,328.8284606537208,39951,89006.93333333333,34.23400315236768,41.86069477596747,NaN,NaN,NaN,NaN,1.1998107185341207,21.967139115737734,92598631,-0.26588819835805944,-1.0159742212530887,-0.7500860228950292
2025-09-02T11:35:00-04:00,328.22,328.38,327.47,327.62,NaN,NaN,NaN,331.4816475636453,NaN,NaN,331.6035999999995,334.8970752955201,328.31012470447894,328.4437427831348,330.3336776621337,331.97653281626975,328.69082250799767,77361,88152.3,31.543556402466123,40.31871552289506,NaN,NaN,NaN,NaN,1.1791099529245384,23.24782413388453,92521270,-0.27591115894254314,-1.0949749715732082,-0.8190638126306651
2025-09-02T11:40:00-04:00,327.67,327.89,327.4,327.61,NaN,NaN,NaN,331.106799947116,NaN,NaN,331.48919999999947,334.928982086443,328.04941791355594,328.32299422650783,330.26887145406744,331.94368457518203,328.59405833295284,52959,86804.86666666667,31.50189746992335,39.20370926630613,NaN,NaN,NaN,NaN,1.129887813429929,24.48524103254924,92468311,-0.2609005657904915,-1.1451895198687794,-0.8842889540782879
2025-09-02T11:45:00-04:00,327.57,327.96,327.42,327.65,NaN,NaN,NaN,331.0680817677016,NaN,NaN,331.3643999999994,334.8982152077296,327.83058479226924,328.0253953812063,330.2321699569079,331.92305004218315,328.54128987163267,31692,84926.03333333334,31.88938431376684,37.814039841326164,NaN,NaN,NaN,NaN,1.0877529696135029,25.514294741484893,92500003,-0.22720077787865756,-1.1682899264266098,-0.9410891485479522
2025-09-02T11:50:00-04:00,327.58,327.58,327.04,327.41,NaN,NaN,NaN,330.61771441462423,NaN,NaN,331.23839999999944,334.876418845797,327.6003811542019,326.92585304397204,330.17356594810076,331.8960461880349,328.4510857081666,46349,80638.3,30.764858882390243,36.84208540289128,NaN,NaN,NaN,NaN,1.0536277574982496,26.75484216053424,92453654,-0.20090467266806533,-1.1922199893830339,-0.9913153167149685
2025-09-02T11:55:00-04:00,327.39,328.48,327.29,328.47,NaN,NaN,NaN,330.61771441462423,NaN,NaN,331.1385999999994,334.8010614021694,327.47613859782945,326.92585304397204,330.11044858173034,331.84412869245864,328.37676847100204,71022,78525.26666666666,40.70946964302207,36.603544134158426,NaN,NaN,NaN,NaN,1.06336863196266,26.44976104723081,92524676,-0.09720667227803026,-1.1128236570625063,-1.015616984784476
2025-09-02T12:00:00-04:00,328.43,329.34,328.43,329.17,NaN,NaN,NaN,330.61771441462423,NaN,NaN,331.0635999999995,334.730653793192,327.396546206807,327.20105257230705,330.07638998195915,331.7946544919963,328.358125471922,73180,73618.16666666667,46.2046597820727,36.525255110141536,NaN,NaN,NaN,NaN,1.0524137296796108,25.04580462904102,92597856,0.026816510648055347,-0.9820963464744068,-1.0089128571224621
2025-09-02T12:05:00-04:00,329.21,329.75,328.79,328.79,NaN,NaN,NaN,330.61771441462423,NaN,NaN,330.9857999999994,334.6773569618163,327.2942430381825,327.55884205784565,330.0548196157529,331.7597867923782,328.3498524391276,55453,68907.73333333334,43.8298044353284,36.51087299173214,NaN,NaN,NaN,NaN,1.0458127489882085,23.2714190000449,92542403,0.0880934268605712,-0.8987960735467482,-0.9868895004073194
2025-09-02T12:10:00-04:00,328.85,329.73,328.85,329.35,NaN,NaN,NaN,330.61771441462423,NaN,NaN,330.91439999999943,334.5916242143159,327.23717578568295,327.55884205784565,330.04080876896353,331.7326923954742,328.34892514245286,47630,65557,48.06614674499626,37.08766629779099,NaN,NaN,NaN,NaN,1.0382546954890506,21.623775201691366,92590033,0.16661778274039185,-0.7786172719818296,-0.9452350547222215
2025-09-02T12:15:00-04:00,329.41,329.86,329.41,329.69,NaN,NaN,NaN,330.61771441462423,NaN,NaN,330.8609799999994,334.530187467659,327.1917725323398,327.82665891702123,330.03549656300964,331.7163464898753,328.35464663614397,35196,62547.23333333333,50.50680071506567,37.90297965630834,NaN,NaN,NaN,NaN,1.000522217239832,20.223429381902072,92625229,0.2374164815046269,-0.6484644528414378,-0.8858809343460647
2025-09-02T12:20:00-04:00,329.68,329.83,329.24,329.46,NaN,NaN,NaN,330.61771441462423,NaN,NaN,330.80697999999944,334.4775988579977,327.1363611420012,327.908327133617,330.0312104918696,331.7058588067693,328.35656217696993,21111,59429.6,48.83486618039638,38.73249463745925,NaN,NaN,NaN,NaN,0.9711992017226994,18.855489250635014,92604118,0.2627443147193411,-0.5574505409468884,-0.8201948556662295
2025-09-02T12:25:00-04:00,329.42,329.53,329.07,329.24,NaN,NaN,NaN,330.61771441462423,NaN,NaN,330.75277999999946,334.4343023439111,327.0712576560878,327.908327133617,330.0256502247827,331.69533139102293,328.3559690585424,19301,57483.2,47.224529889721545,39.6661140033749,NaN,NaN,NaN,NaN,0.9346849730282194,17.80855259798226,92584817,0.25828349265249195,-0.49734048985061463,-0.7556239825031066
2025-09-02T12:30:00-04:00,329.24,329.53,328.84,328.86,NaN,NaN,NaN,330.61771441462423,NaN,NaN,330.6951799999995,334.4031412663249,326.98721873367407,327.908327133617,330.0176739809734,331.682579094519,328.35276886742787,22103,53969.9,44.49526330152856,40.337912559551306,NaN,NaN,NaN,NaN,0.9172074749547751,17.137590578832253,92562714,0.22458605568523082,-0.474891412896568,-0.6994774685817988
2025-09-02T12:35:00-04:00,328.91,329.41,328.89,329.06,NaN,NaN,NaN,330.61771441462423,NaN,NaN,330.62637999999953,334.3254823322479,326.9272776677512,327.908327133617,330.00814019217484,331.66673513598187,328.3495452483678,28229,52766,46.25578397722741,41.14721606359094,NaN,NaN,NaN,NaN,0.8909783696008634,16.51455441819296,92590943,0.21083251819819238,-0.4359368208340584,-0.6467693390322508
2025-09-02T12:40:00-04:00,329.1,329.63,328.83,328.94,NaN,NaN,NaN,330.61771441462423,NaN,NaN,330.55587999999955,334.2464823064552,326.8652776935439,327.908327133617,329.99884218525983,331.6510364760976,328.34664789442206,28554,51823.833333333336,45.326812884850284,41.93955961591113,NaN,NaN,NaN,NaN,0.8844799146293739,15.575506551448616,92562389,0.18939823131187594,-0.4100215498924058,-0.5994197812042817
2025-09-02T12:45:00-04:00,328.96,329.23,328.45,328.7,NaN,NaN,NaN,330.61771441462423,NaN,NaN,330.48627999999945,334.1829935037265,326.7895664962724,327.908327133617,329.98914929747207,331.6382061115386,328.34009248340556,21776,50030.8,43.44743142075537,42.78983640293178,NaN,NaN,NaN,NaN,0.8770170635844208,15.253620141457592,92540613,0.15618362370145666,-0.4041902515774609,-0.5603738752789176
2025-09-02T12:50:00-04:00,328.68,329.44,328.65,329.19,NaN,NaN,NaN,330.61771441462423,NaN,NaN,330.42407999999944,334.1012360065768,326.74692399342206,327.908327133617,329.97882307239917,331.62113403068366,328.33651211411467,31583,49339.46666666667,48.17231476394701,43.980580495362055,NaN,NaN,NaN,NaN,0.870801559042678,14.595474625113397,92572196,0.1635574244151069,-0.3559270947600339,-0.5194845191751408
2025-09-02T12:55:00-04:00,329.23,329.7,329.22,329.52,NaN,NaN,NaN,330.61771441462423,NaN,NaN,330.36667999999946,334.0087259624641,326.7246340375348,327.9856132704919,329.97398771987594,331.6090500009599,328.338925438792,26819,48278.23333333333,51.13341615276262,45.35515419814747,NaN,NaN,NaN,NaN,0.8450300191110575,13.553067578903258,92599015,0.18540109965479445,-0.2877331446066478,-0.47313424426144224
2025-09-02T13:00:00-04:00,329.46,329.94,329.27,329.7,NaN,NaN,NaN,330.61771441462423,NaN,NaN,330.31647999999944,333.9245472555639,326.708412744435,328.2334906163935,329.9694731031948,331.594019405116,328.3449268012736,37531,47934.9,52.72017374858666,46.923390974304354,NaN,NaN,NaN,NaN,0.8325278748888402,12.967514654074593,92636546,0.20517391418677355,-0.21666685152797527,-0.4218407657147488
2025-09-02T13:05:00-04:00,329.73,330.36,329.48,329.98,NaN,NaN,NaN,330.61771441462423,NaN,NaN,330.2734799999995,333.8451326203642,326.7018273796348,328.5547924931148,329.9691121578833,331.58368348539454,328.354540830372,34768,47484.46666666667,55.159336856428126,47.955524346690495,NaN,NaN,NaN,NaN,0.8359187409682084,13.043715982864196,92671314,0.22852636326446207,-0.13618281163417123,-0.3647091748986333
2025-09-02T13:10:00-04:00,329.94,329.98,328.85,328.94,NaN,NaN,NaN,330.61771441462423,NaN,NaN,330.19527999999946,333.7086001631223,326.6819598368766,328.5547924931148,329.9578188586133,331.56201232300543,328.3536253942211,45727,46705,45.723788055354454,47.92117636621062,NaN,NaN,NaN,NaN,0.8569245451847646,12.160479403983828,92625587,0.1681381099103515,-0.15453653751069396,-0.32267464742104546
2025-09-02T13:15:00-04:00,328.92,329.18,328.76,328.97,NaN,NaN,NaN,330.61771441462423,NaN,NaN,330.1168799999995,333.5604270004749,326.6733329995242,328.5547924931148,329.9494329415711,331.54937149348683,328.3494943896554,24699,45463.13333333333,46.010686722808856,48.076953672459226,NaN,NaN,NaN,NaN,0.8257156491001396,11.47840904713429,92650286,0.12633013814822192,-0.16476197473576804,-0.29109211288398995
2025-09-02T13:20:00-04:00,328.94,329.62,328.88,329.47,NaN,NaN,NaN,330.61771441462423,NaN,NaN,330.0434799999995,333.38096432815087,326.7059956718481,328.5547924931148,329.941512293769,331.53283760334716,328.3501869841908,37278,45545.5,50.68906831956121,48.26430521349958,NaN,NaN,NaN,NaN,0.8195931027358446,11.153233324057197,92687564,0.12806593994775062,-0.13100968794930168,-0.2590756278970523
2025-09-02T13:25:00-04:00,329.45,329.91,329.37,329.81,NaN,NaN,NaN,330.61771441462423,NaN,NaN,329.9690799999995,333.15475975423294,326.7834002457661,328.5547924931148,329.9388640398051,331.521762669129,328.3559654104812,32220,45106.1,53.63148785851108,48.48749715231711,NaN,NaN,NaN,NaN,0.7996221668261428,11.262737554973814,92719784,0.14650042744100739,-0.07595009359579308,-0.22245052103680046
2025-09-02T13:30:00-04:00,329.85,330.23,329.8,330.14,NaN,NaN,NaN,330.61771441462423,NaN,NaN,329.9078799999995,332.95760184049857,326.8581581595005,328.63172560414387,329.9399669013138,331.5154794491205,328.36445435350714,28152,43429.2,56.353738708724286,49.024559475769095,NaN,NaN,NaN,NaN,0.7732205834814189,11.791678203012058,92747936,0.1734628805775023,-0.0056219203149225905,-0.1790848008924249
2025-09-02T13:35:00-04:00,330.12,330.42,329.93,330.26,NaN,NaN,NaN,330.61771441462423,NaN,NaN,329.8358799999995,332.6714480532123,327.0003119467867,328.8963804833151,329.942686168999,331.51027008843255,328.37510224956543,31372,42071.433333333334,57.334655630049,49.746711314363914,NaN,NaN,NaN,NaN,0.7529905418041754,12.526640229267857,92779308,0.19056001462384917,0.059115217387386565,-0.1314447972364626
2025-09-02T13:40:00-04:00,330.19,330.63,329.92,330.44,327.76274241428854,327.76274241428854,327.76274241428854,NaN,NaN,NaN,329.8854799999995,332.6744382930534,327.0965217069456,329.05610438665207,329.946327749557,331.50697263120026,328.3856828679137,28839,41120.13333333333,58.82933819543222,50.770573806785606,NaN,NaN,NaN,NaN,0.7499197888181613,13.473894130347466,92808147,0.20397223277847787,0.12352049373663476,-0.08045173904184312
2025-09-02T13:45:00-04:00,330.47,330.47,329.65,329.81,327.76274241428854,NaN,NaN,NaN,NaN,NaN,329.8850799999995,332.67407574336545,327.09608425663356,329.05610438665207,329.94674938201393,331.4965159286164,328.39698283541145,43228,40257.666666666664,51.96725166059103,51.17853578416872,NaN,NaN,NaN,NaN,0.7549255181882962,13.798195863172197,92764919,0.16221452473236742,0.12231641687361616,-0.03989810785875127
2025-09-02T13:50:00-04:00,329.77,329.78,328.88,328.9,327.76274241428854,NaN,NaN,NaN,NaN,NaN,329.8408799999995,332.6208582345244,327.0609017654746,329.05610438665207,329.93973056626675,331.4840373017209,328.3954238308126,28991,38408.7,43.98613659061559,51.08277319172339,NaN,NaN,NaN,NaN,0.7674308383177041,12.87065966935656,92735928,0.0698277182364258,0.04738653993678099,-0.022441178299644815
2025-09-02T13:55:00-04:00,328.91,329.12,328.65,328.8,327.76274241428854,NaN,NaN,NaN,NaN,NaN,329.7744799999995,332.4914206692637,327.0575393307354,329.05610438665207,329.92764735835254,331.46752307182123,328.38777164488386,35421,37949.833333333336,43.200954373202336,51.065167688326746,NaN,NaN,NaN,NaN,0.74618577843787,12.355202939760542,92700507,0.002083798937031256,-0.019836429628355745,-0.021920228565387
2025-09-02T14:00:00-04:00,328.74,329.29,328.725,328.88,327.76274241428854,NaN,NaN,NaN,NaN,NaN,329.70347999999956,332.32292025324455,327.08403974675457,329.05610438665207,329.92101649963195,331.45764369094206,328.38438930832183,22021,37352.166666666664,44.061238976198105,50.771519417773256,NaN,NaN,NaN,NaN,0.7332439371208792,11.594310037596756,92722528,-0.03518075780055323,-0.06589617581607854,-0.03071541801552531
2025-09-02T14:05:00-04:00,328.85,328.87,327.99,328.14,327.76274241428854,NaN,NaN,NaN,NaN,NaN,329.6250799999995,332.1918257327111,327.05833426728793,329.05610438665207,329.89803979538937,331.43524624485804,328.3608333459207,46945,36338.3,38.28487256889772,49.85376630464004,NaN,NaN,NaN,NaN,0.7444407987551012,11.929118962657212,92675583,-0.10363827119398919,-0.1602632570080118,-0.056624985814022616
2025-09-02T14:10:00-04:00,328.15,328.5,328,328.19,327.76274241428854,NaN,NaN,NaN,NaN,NaN,329.5678799999995,332.13252830035844,327.00323169964054,329.05610438665207,329.8877937150894,331.4258036627658,328.349783767413,20049,35241.3,38.86803475333788,48.86432780497942,NaN,NaN,NaN,NaN,0.7269807417011653,12.240012964499062,92695632,-0.1374061025386844,-0.22838261398737814,-0.09097651144869373
2025-09-02T14:15:00-04:00,328.25,328.44,328,328.02,327.76274241428854,NaN,NaN,NaN,NaN,NaN,329.5024799999995,332.0548771243718,326.9500828756272,329.05610438665207,329.87611718475483,331.41548918883257,328.3367451806771,22122,34922.3,37.568218608947205,47.60781935873077,NaN,NaN,NaN,NaN,0.7064821172939391,12.528700251923638,92673510,-0.16138765744602268,-0.2927110832562221,-0.1313234258101994
2025-09-02T14:20:00-04:00,328.01,328.59,327.95,328.21,327.76274241428854,NaN,NaN,NaN,NaN,NaN,329.4374799999995,331.9524194983868,326.92254050161216,329.05610438665207,329.86756579276636,331.40738300720307,328.32774857832965,17372,33956.4,39.98393648910202,47.19782996114132,NaN,NaN,NaN,NaN,0.7017333946300852,12.494208269384668,92690882,-0.1546360170472285,-0.32461844711923504,-0.16998243007200653
2025-09-02T14:25:00-04:00,328.18,328.36,328.08,328.19,327.76274241428854,NaN,NaN,NaN,NaN,NaN,329.3626799999995,331.7978441736248,326.9275158263742,329.05610438665207,329.8583768954965,331.3988442650143,328.31790952597873,18415,32202.833333333332,39.80931957076721,46.75487516456691,NaN,NaN,NaN,NaN,0.6716095807279384,12.462179999884196,92672467,-0.1420246000169449,-0.34751318009318766,-0.20548858007624277
2025-09-02T14:30:00-04:00,328.2,328.44,327.88,328.13,327.76274241428854,NaN,NaN,NaN,NaN,NaN,329.2914799999995,331.65748788680725,326.9254721131918,328.80088350932164,329.842749561274,331.38475655193076,328.3007425706172,30667,30785.733333333334,39.255451052772116,45.938188216939125,NaN,NaN,NaN,NaN,0.6636374678188002,12.767454165088818,92641800,-0.12863050359746295,-0.36627670957307146,-0.2376462059756085
2025-09-02T14:35:00-04:00,328.12,328.32,327.96,328.305,327.76274241428854,NaN,NaN,NaN,NaN,NaN,329.2021799999995,331.36457188687945,327.0397881131195,327.97970680745726,329.8266848746194,331.36967415324676,328.283695595992,33007,30037.533333333333,41.79890884138898,45.0930040014304,NaN,NaN,NaN,NaN,0.6419490772603155,13.050923032778822,92674807,-0.10015765363284523,-0.3628432730166651,-0.26268561938381985
2025-09-02T14:40:00-04:00,328.3,328.36,328.01,328.25,327.76274241428854,NaN,NaN,NaN,NaN,NaN,329.1347799999995,331.1993940289112,327.0701659710879,327.6673123567727,329.81737795510764,331.3607926796511,328.27396323056416,19562,29101.933333333334,41.21481861411113,44.01165256610089,NaN,NaN,NaN,NaN,0.6210955717417231,13.212267922932174,92655245,-0.07817611003993952,-0.3604057569337442,-0.2822296468938047
2025-09-02T14:45:00-04:00,328.24,328.94,328.08,328.61,327.76274241428854,NaN,NaN,NaN,NaN,NaN,329.0581799999995,330.89862397700705,327.2177360229919,327.6673123567727,329.80804382822043,331.34962795276795,328.2664597036729,25131,28766.433333333334,46.48598832384587,43.236747758514944,NaN,NaN,NaN,NaN,0.6381601737601724,12.494611898056318,92680376,-0.03475299070884619,-0.32567088527986243,-0.29091789457101624
2025-09-02T14:50:00-04:00,328.56,329.37,328.56,328.98,327.76274241428854,NaN,NaN,NaN,NaN,NaN,329.01887999999946,330.778635058126,327.2591249418729,327.85034868805786,329.79496520251587,331.3279959685582,328.26193443647355,54381,29875.433333333334,51.31763037556505,42.700197199953,NaN,NaN,NaN,NaN,0.6504344470630175,12.61266687584716,92734757,0.020550366967841793,-0.265229935861214,-0.2857803028290558
2025-09-02T14:55:00-04:00,328.99,329,328.38,328.59,327.76274241428854,NaN,NaN,NaN,NaN,NaN,328.9732799999995,330.65524428279537,327.2913157172036,327.85034868805786,329.7881330708224,331.3190830128053,328.25718312883953,21041,29933.433333333334,46.54709230068664,42.31304295995983,NaN,NaN,NaN,NaN,0.6482605579870879,12.325707611714867,92713716,0.03185267154255117,-0.24596446340086686,-0.27781713494341803
2025-09-02T15:00:00-04:00,328.52,329.15,328.43,329.13,327.76274241428854,NaN,NaN,NaN,NaN,NaN,328.92667999999946,330.45232097761954,327.4010390223794,327.85034868805786,329.7773751937285,331.30207623622397,328.25267415123307,43148,30634.933333333334,53.054507374199545,42.96078373021583,NaN,NaN,NaN,NaN,0.653384803845151,12.332321458119567,92756864,0.07426131166185929,-0.1849904953660939,-0.2592518070279532
2025-09-02T15:05:00-04:00,329.1,329.32,328.96,329.08,327.76274241428854,NaN,NaN,NaN,NaN,NaN,328.8930799999995,330.32697683608245,327.4591831639165,327.87553852828563,329.77187842861554,331.2913710967785,328.25238576045257,29924,30691.433333333334,52.418180820192575,43.61915704785799,NaN,NaN,NaN,NaN,0.6324287464276412,12.642304734081316,92726940,0.09612199107540564,-0.13909931818369614,-0.23522130925910179
2025-09-02T15:10:00-04:00,329.12,329.22,328.74,329.1,327.76274241428854,NaN,NaN,NaN,NaN,NaN,328.87887999999947,330.29005662418257,327.46770337581637,327.87553852828563,329.7660854165448,331.28114018400083,328.25103064908876,27787,30665.866666666665,52.66275209116773,44.23355084178439,NaN,NaN,NaN,NaN,0.6215409788256682,12.401804876383824,92754727,0.10820578886692739,-0.09996407317544254,-0.20816986204236992
2025-09-02T15:15:00-04:00,329.08,329.37,328.96,329.16,327.76274241428854,NaN,NaN,NaN,NaN,NaN,328.8702999999995,330.26926591885757,327.4713340811414,328.0485446581028,329.76070335840996,331.2700443271574,328.2513623896625,32493,31023.1,53.4360032623152,45.31577446274279,NaN,NaN,NaN,NaN,0.6064309089095508,12.466731449364184,92787220,0.11583425769175776,-0.06337703992767274,-0.1792112976194305
2025-09-02T15:20:00-04:00,329.12,329.48,328.97,329.11,327.76274241428854,NaN,NaN,NaN,NaN,NaN,328.8698999999995,330.26858007850126,327.4712199214978,328.1678357264822,329.75358945103835,331.25489258173144,328.25228632034526,45663,31492.433333333334,52.66397245062906,46.30119858397787,NaN,NaN,NaN,NaN,0.5995429868445823,12.73715508205338,92741557,0.11298636296902384,-0.03797834390815069,-0.15096470687717453
2025-09-02T15:25:00-04:00,329.06,329.34,328.91,329.3,327.76274241428854,NaN,NaN,NaN,NaN,NaN,328.8892999999995,330.28439140994976,327.4942085900492,328.1678357264822,329.74655092591354,331.23988808289454,328.25321376893254,46047,32133.366666666665,55.30646431271053,47.568216134246676,NaN,NaN,NaN,NaN,0.5874327734985371,12.825967229885379,92787604,0.1187800984230299,-0.0024895838483871557,-0.12126968227141706
2025-09-02T15:30:00-04:00,329.27,329.74,329.21,329.44,327.76274241428854,NaN,NaN,NaN,NaN,NaN,328.9088999999995,330.3068489125236,327.5109510874754,328.46321486494867,329.74326960263784,331.2282400670217,328.25829913825396,43730,32340,57.20230294085372,48.798099452228946,NaN,NaN,NaN,NaN,0.5833304325343579,13.664513294093231,92831334,0.12622491600759467,0.03651146273807626,-0.0897134532695184
2025-09-02T15:35:00-04:00,329.42,329.68,329.27,329.61,327.76274241428854,NaN,NaN,NaN,NaN,NaN,328.93269999999956,330.33704925923087,327.52835074076825,328.46321486494867,329.7416865484972,331.22150176701956,328.2618713299749,26953,32079.5,59.45154666489958,50.201115673238405,NaN,NaN,NaN,NaN,0.5709496873533342,14.443163210857666,92858287,0.13594116804326353,0.080213006784561,-0.05572816125870252
2025-09-02T15:40:00-04:00,329.63,329.87,329.33,329.6,327.76274241428854,NaN,NaN,NaN,NaN,NaN,328.95949999999954,330.3626197390094,327.55638026098967,328.6188575135671,329.74007374145657,331.21151931108005,328.2686281718331,43769,32014.233333333334,59.25427189520966,51.62960287626966,NaN,NaN,NaN,NaN,0.568738995399526,15.508266407980667,92814518,0.1347747522936202,0.11274027910832274,-0.02203447318529747
2025-09-02T15:45:00-04:00,329.55,329.8,329.2,329.77,327.76274241428854,NaN,NaN,NaN,NaN,NaN,329.0024999999995,330.3701114222105,327.63488857778844,328.6188575135671,329.7384754800139,331.2021458125628,328.27480514746503,41391,32570.633333333335,61.5877905674189,53.04309442812894,NaN,NaN,NaN,NaN,0.5709719242995615,16.084387409963124,92855909,0.13802843721407265,0.15050107333229334,0.012472636118220692
2025-09-02T15:50:00-04:00,329.36,329.75,329.04,329.17,327.76274241428854,NaN,NaN,NaN,NaN,NaN,329.0336999999995,330.34274058077625,327.72465941922275,328.6188575135671,329.73182916208776,331.18477204773086,328.27888627644467,62723,33418.8,50.578024894166106,53.711894876704285,NaN,NaN,NaN,NaN,0.5823310725638757,16.12576985288097,92793186,0.09442779619466632,0.1305073813615536,0.03607958516688728
2025-09-02T15:55:00-04:00,329.17,329.55,328.94,329.34,327.76274241428854,NaN,NaN,NaN,NaN,NaN,329.0674999999995,330.31784115427354,327.81715884572543,328.6188575135671,329.71874999877036,331.15268304026836,328.28481695727237,116840,36239.46666666667,53.13437436641156,54.18677959403042,NaN,NaN,NaN,NaN,0.5843074245235998,15.861928927972603,92910026,0.07266977013540632,0.12691679783614518,0.05424702770073886
2025-09-03T09:30:00-04:00,335.12,335.15,330.77,331.02,330.33568980815414,NaN,NaN,NaN,NaN,NaN,329.1396999999995,330.4155125419028,327.8638874580962,331.1013320375571,332.31333333333333,332.31333333333333,332.31333333333333,252418,43715,69.77356257085734,55.50506046512272,NaN,NaN,NaN,NaN,0.9575711799147715,19.909508404646033,93162444,0.16194190690985186,0.2566744113380537,0.09473250442820183
2025-09-03T09:35:00-04:00,331.04,331.26,328.96,329.28,NaN,NaN,NaN,332.9286597285801,332.9286597285801,332.9286597285801,329.15589999999946,330.4177806449735,327.8940193550254,331.1013320375571,331.0669093237957,332.30689268340893,329.82692596418246,255047,51170.833333333336,49.98082764595681,55.75032727549916,NaN,NaN,NaN,NaN,1.053458952778003,21.291797541058404,92907397,0.09750029719210082,0.21660787591832786,0.11910757872622704
2025-09-03T09:40:00-04:00,329.2,330.44,328.51,330.27,NaN,NaN,NaN,332.4287206500083,NaN,NaN,329.1778999999995,330.4777801337291,327.87801986626994,331.1013320375571,330.69472925283105,331.9037063245188,329.4857521811433,197824,56803.666666666664,57.38749158392603,56.05982614762247,NaN,NaN,NaN,NaN,1.1160690275795746,22.087027962063964,93105221,0.11409202409191896,0.26172260884112575,0.1476305847492068
2025-09-03T09:45:00-04:00,330.28,330.47,329.12,330.4,NaN,NaN,NaN,332.4287206500083,NaN,NaN,329.21009999999944,330.5491242575236,327.8710757424753,331.1013320375571,330.6030498701435,331.7542480292072,329.45185171107977,106633,58917.166666666664,58.26150039880646,56.477206117523465,NaN,NaN,NaN,NaN,1.1327783827524638,22.842408484523745,93211854,0.12546088108183678,0.3044566861015028,0.178995805019666
2025-09-03T09:50:00-04:00,330.35,331.1,330.01,330.85,NaN,NaN,NaN,332.4287206500083,NaN,NaN,329.2400999999994,330.65536038675134,327.8248396132475,331.1013320375571,330.6081756485215,331.699227918984,329.51712337805907,92160,61022.8,61.22613803361751,57.08887654198417,NaN,NaN,NaN,NaN,1.1297227839844328,23.89775745329011,93304014,0.15309587182209836,0.37036564479728895,0.2172697729751906
2025-09-03T09:55:00-04:00,330.92,331.04,330.12,330.92,NaN,NaN,NaN,332.4287206500083,NaN,NaN,329.26469999999944,330.7513450962525,327.77805490374635,331.1013320375571,330.6154974155635,331.65886506610644,329.5721297650205,85044,62676.9,61.682077253109334,57.677881827040885,NaN,NaN,NaN,NaN,1.114742585128403,24.87772435285888,93389058,0.16487783947965995,0.42336707232476556,0.2584892328451056
2025-09-03T10:00:00-04:00,330.92,333.61,330.69,333.13,328.8843237495122,328.8843237495122,328.8843237495122,NaN,NaN,NaN,329.3380999999995,331.17678310538884,327.49941689461014,331.1013320375571,330.8924951251121,332.0610024121157,329.7239878381084,172952,67707.93333333333,72.62621697793286,59.10375643613402,NaN,NaN,NaN,NaN,1.2436895433335182,26.938352219575464,93562010,0.30229981980198933,0.6363640075975923,0.33406418779560293
2025-09-03T10:05:00-04:00,333.14,334.12,332.84,333.3,330.1882181245344,NaN,NaN,NaN,NaN,NaN,329.4192999999994,331.5662382949473,327.2723617050515,331.1013320375571,331.17064190948525,332.5274029341611,329.8138808848094,143698,70933.03333333334,73.25892005275037,60.38607470327973,NaN,NaN,NaN,NaN,1.2462831473811262,29.024657371401837,93705708,0.38038960209714917,0.8095511904170394,0.4291615883198902
2025-09-03T10:10:00-04:00,333.32,333.79,331.92,332.22,330.1882181245344,NaN,NaN,NaN,NaN,NaN,329.4864999999994,331.7654842040291,327.2075157959697,331.1013320375571,331.27944381400084,332.64076544696417,329.9181221810375,104166,73736.93333333333,63.25600855067026,60.81848224683806,NaN,NaN,NaN,NaN,1.2908343511396174,29.933250109422833,93601542,0.33655845207929014,0.8498596534190028,0.5133012013397127
2025-09-03T10:15:00-04:00,332.24,333.88,332.05,333.78,330.1882181245344,NaN,NaN,NaN,NaN,NaN,329.5808999999995,332.1535062197666,327.00829378023235,331.1013320375571,331.39359724939203,332.79199029361524,329.9952042051688,87327,75910.43333333333,69.69314006863337,61.55002463281904,NaN,NaN,NaN,NaN,1.329346183201072,30.81698626723299,93688869,0.386318872687595,0.9961997921992065,0.6098809195116115
2025-09-03T10:20:00-04:00,333.8,335.45,333.75,335.26,331.0346373075989,NaN,NaN,NaN,NaN,NaN,329.70729999999946,332.72420385031256,326.69039614968636,331.1577720261236,331.73581998873397,333.4138151084892,330.05782486897874,166138,80869.3,74.29420975378248,62.62430590843139,NaN,NaN,NaN,NaN,1.355821455829566,32.26855149865305,93855007,0.4861462411603602,1.2175637209620618,0.7314174798017016
2025-09-03T10:25:00-04:00,335.21,337.31,335.15,336.06,332.53215379361717,NaN,NaN,NaN,NaN,NaN,329.85449999999946,333.34196455208854,326.3670354479104,332.79621762089886,332.2727185685363,334.4102947864098,330.13514235066276,228959,87887.43333333333,76.38150129244234,63.680999531647345,NaN,NaN,NaN,NaN,1.4132627804131703,34.18677265332634,94083966,0.5676174499674554,1.440939292261021,0.8733218422935655
2025-09-03T10:30:00-04:00,336.05,337.58,336.02,337.49,333.05751043936175,NaN,NaN,NaN,NaN,NaN,330.02049999999946,334.10472930331497,325.93627069668395,333.1889740967191,332.661230666525,335.08886266552986,330.23359866752014,168287,92474.76666666666,79.57422559433569,65.75215672451661,NaN,NaN,NaN,NaN,1.4237440103836583,36.04070944879524,94252253,0.6722239313429994,1.7136017564723147,1.0413778251293153
2025-09-03T10:35:00-04:00,337.48,339.6,337.32,339.52,334.57671451029995,NaN,NaN,NaN,NaN,NaN,330.22049999999945,335.090831508441,325.3501684915579,334.9471792773753,333.2880593690195,336.2471686704654,330.3289500675736,233776,99167.06666666667,83.07245168994795,67.8905908190549,NaN,NaN,NaN,NaN,1.4849051524991133,38.23810940694503,94486029,0.8226059727261952,2.0696352910370592,1.247029318310864
2025-09-03T10:40:00-04:00,339.53,340.47,339.02,339.99,335.8405002143772,NaN,NaN,NaN,NaN,NaN,330.42629999999946,336.0088165689088,324.8437834310901,336.0227434219002,333.91119945276114,337.3182509748174,330.5041479307049,241697,106571.56666666667,83.76570091118371,68.89002927193538,NaN,NaN,NaN,NaN,1.4824119273206084,40.449157463456345,94727726,0.8923655322348631,2.362486233604443,1.4701207013695798
2025-09-03T10:45:00-04:00,339.98,340.15,338.95,339.13,335.8405002143772,NaN,NaN,NaN,NaN,NaN,330.6092999999994,336.69822043323813,324.52037956676065,336.0227434219002,334.12642966410385,337.6322579258227,330.620601402385,103311,109177.56666666667,77.51050159692451,70.85643455414736,NaN,NaN,NaN,NaN,1.462239646797707,42.42739508377266,94624415,0.8210241962075095,2.4964009466289667,1.6753767504214572
2025-09-03T10:50:00-04:00,339.15,339.95,338.9,339.89,335.8405002143772,NaN,NaN,NaN,NaN,NaN,330.82829999999944,337.4275949958396,324.22900500415926,336.0987557900161,334.360639119632,337.964166898461,330.7571113408031,118440,111312.86666666667,79.00273731679971,72.40038067792405,NaN,NaN,NaN,NaN,1.432793957740729,44.20735962250166,94742855,0.7664967183226332,2.6334976483247488,1.8670009300021155
2025-09-03T10:55:00-04:00,339.86,341.48,339.52,341.27,336.5510525437028,NaN,NaN,NaN,NaN,NaN,331.0742999999995,338.26837367504925,323.8802263249497,337.4190046320129,334.8407942806108,338.69450979805174,330.98707876316985,223840,118072.83333333333,81.41424204023767,74.05414793802628,NaN,NaN,NaN,NaN,1.4704515321878222,46.17548166259967,94966695,0.7631862119756119,2.8209836949716305,2.0577974829960186
2025-09-03T11:00:00-04:00,341.28,342.08,341.05,341.23,337.65509560989807,NaN,NaN,NaN,NaN,NaN,331.30949999999945,339.0282160203038,323.5907839796951,338.3162037056103,335.2623330326284,339.3260917059549,331.1985743593019,203022,123401.96666666666,81.12341335527725,75.4753818895734,NaN,NaN,NaN,NaN,1.4389907084601188,48.11196091899748,94763673,0.6997905149890391,2.9325356267323173,2.232745111743278
2025-09-03T11:05:00-04:00,341.21,342.31,340.9,341.49,337.6805458094482,NaN,NaN,NaN,NaN,NaN,331.54309999999947,339.75722366366716,323.3289763363318,338.59396296448824,335.52999465816464,339.7047740812114,331.3552152351179,141209,127111.46666666666,81.58391605590518,76.89694180405881,NaN,NaN,NaN,NaN,1.436919943570112,49.95173516221523,94904882,0.6196082267541834,3.0072553951860073,2.387647168431824
2025-09-03T11:10:00-04:00,341.5,342.52,341.17,341.3,337.914839181746,NaN,NaN,NaN,NaN,NaN,331.7662999999995,340.41099937256416,323.1216006274348,338.8721703715906,335.7769980674333,340.0408967085334,331.51309942633316,139564,130837.36666666667,80.04710914716014,77.4270055304322,NaN,NaN,NaN,NaN,1.4307113761722445,51.69928324301559,94765318,0.5029775551789628,3.0163691124055276,2.513391557226565
2025-09-03T11:15:00-04:00,341.29,341.78,340.89,341.32,337.914839181746,NaN,NaN,NaN,NaN,NaN,331.98749999999944,341.0238404651527,322.95115953484617,338.8721703715906,335.92737767991696,340.2286478188109,331.62610754102303,96461,132969.63333333333,80.08962542779405,77.91491305722104,NaN,NaN,NaN,NaN,1.3920891350170834,52.95742943394981,94861779,0.38187103738700134,2.9907303539603163,2.608859316573315
2025-09-03T11:20:00-04:00,341.31,341.69,340.79,341.15,337.914839181746,NaN,NaN,NaN,NaN,NaN,332.20169999999945,341.5823425388745,322.8210574611244,338.8721703715906,336.1003524663357,340.43382320134634,331.7668817313251,120582,135466.93333333332,78.55733949694252,79.00786526766906,NaN,NaN,NaN,NaN,1.3569399110872902,53.99110449571366,94741197,0.2513120322155493,2.9229993568427517,2.6716873246272024
2025-09-03T11:25:00-04:00,341.11,341.32,340.06,340.15,337.914839181746,NaN,NaN,NaN,NaN,NaN,332.4084999999995,342.0221262150163,322.79487378498266,338.8721703715906,336.2362729451703,340.56998075062563,331.90256513971497,117119,137836,70.0654692714596,79.03446021072807,NaN,NaN,NaN,NaN,1.3500156317239116,53.98872520653937,94624078,0.0681310579440475,2.7568511470572616,2.688720089113214
2025-09-03T11:30:00-04:00,340.14,340.5,339.33,340.03,337.914839181746,NaN,NaN,NaN,NaN,NaN,332.6310999999995,342.42323057317316,322.8389694268258,338.8721703715906,336.34214034857166,340.65820563006923,332.0260750670741,111393,140091.43333333332,69.10017077022846,78.6634574261885,NaN,NaN,NaN,NaN,1.3371573723150618,53.1096325557963,94512685,-0.08242543804187452,2.5856882915608708,2.6681137296027453
2025-09-03T11:35:00-04:00,340.06,341.09,340.06,340.63,337.914839181746,NaN,NaN,NaN,NaN,NaN,332.86769999999945,342.8479960297929,322.887403970206,338.8721703715906,336.4226802411617,340.7367738301769,332.10858665214647,75527,141710.56666666668,71.23414683415889,78.29578925059683,NaN,NaN,NaN,NaN,1.3173604171497004,52.56367776993136,94588212,-0.15850454058223207,2.469983053874955,2.6284875944571873
2025-09-03T11:40:00-04:00,340.59,341.67,340.27,341.45,337.914839181746,NaN,NaN,NaN,NaN,NaN,333.11909999999943,343.31585589402374,322.9223441059751,338.8721703715906,336.517896841167,340.8392499765889,332.19654370574506,82303,142995.03333333333,73.88824405826342,77.88964771230594,NaN,NaN,NaN,NaN,1.3232632444961527,52.30714584013415,94670515,-0.16951331355777777,2.416595952509965,2.586109266067743
2025-09-03T11:45:00-04:00,341.46,341.95,341.04,341.72,337.914839181746,NaN,NaN,NaN,NaN,NaN,333.39069999999947,343.7643921123673,323.0170078876316,339.0091165999122,336.6309148079264,340.96848900172347,332.2933406141293,93106,144718.86666666667,74.71547904397804,77.29272109473665,NaN,NaN,NaN,NaN,1.2937444413178538,52.18682223484421,94763621,-0.17387352648251397,2.3687673579646003,2.5426408844471142
2025-09-03T11:50:00-04:00,341.7,342.15,341.41,341.8,338.10305004541215,NaN,NaN,NaN,NaN,NaN,333.6628999999994,344.1895633062074,323.13623669379143,339.42729327992976,336.72926909004707,341.08277902006387,332.37575916003027,80941,145326.13333333333,74.96851967140609,76.66435100618112,NaN,NaN,NaN,NaN,1.2541912669380035,52.1607106895679,94844562,-0.18556704439247707,2.3106820789565177,2.4962491233489947
2025-09-03T11:55:00-04:00,341.78,341.87,341.19,341.53,338.10305004541215,NaN,NaN,NaN,NaN,NaN,333.93309999999946,344.5596010027828,323.3065989972161,339.42729327992976,336.78158405152834,341.1399008162991,332.4232672867576,46746,142989.66666666666,72.33730483024898,76.29483695141857,NaN,NaN,NaN,NaN,1.213177605013861,51.833332241088925,94797816,-0.22315717977161764,2.2173026486344725,2.44045982840609
2025-09-03T12:00:00-04:00,341.5,341.75,340.97,341.15,338.10305004541215,NaN,NaN,NaN,NaN,NaN,334.19189999999946,344.8783865864408,323.50541341355813,339.42729327992976,336.8497392168218,341.2098308873274,332.4896475463161,65844,136770.53333333333,68.68358816541411,75.55775486917675,NaN,NaN,NaN,NaN,1.182236347512869,51.22128664970141,94731972,-0.2815195989355055,2.0885603297367084,2.370079928672214
2025-09-03T12:05:00-04:00,341.19,341.85,340.891,341.64,338.10305004541215,NaN,NaN,NaN,NaN,NaN,334.46089999999947,345.2064880603223,323.71531193967667,339.44687415932407,336.91046597028446,341.27352791450056,332.54740402606836,58133,130206.73333333334,70.73617173726971,74.79503556182189,NaN,NaN,NaN,NaN,1.166290894119093,50.71011303639366,94790105,-0.29367922106479405,2.0029809023412213,2.2966601234060153
2025-09-03T12:10:00-04:00,341.67,341.7,340.74,341.33,338.10305004541215,NaN,NaN,NaN,NaN,NaN,334.7248999999995,345.48395283759527,323.9658471624037,339.44687415932407,336.95160513646067,341.31431382392253,332.5888964489988,42177,125018.5,67.71241097121381,73.83710682010307,NaN,NaN,NaN,NaN,1.1515558302534419,50.004740738053776,94747928,-0.3266271743290887,1.8883761554946545,2.2150033298237433
2025-09-03T12:15:00-04:00,341.29,342.19,341.25,342.17,338.264339243764,NaN,NaN,NaN,NaN,NaN,335.0021999999995,345.799736230182,324.204663769817,339.7979994619674,337.03019605089605,341.401632911598,332.6587591901941,72356,123875.93333333333,71.29330410179426,73.10206310909516,NaN,NaN,NaN,NaN,1.136444699521053,49.65680977213877,94820284,-0.29674290186732044,1.8440747024895927,2.140817604356913
2025-09-03T12:20:00-04:00,342.15,343.33,342.06,342.76,339.223232914502,NaN,NaN,NaN,NaN,NaN,335.2923999999995,346.1283228938811,324.45647710611786,340.7813995695739,337.21446077306837,341.63080525859294,332.7981162875438,151646,125858.8,73.51513459287725,72.63549349807496,NaN,NaN,NaN,NaN,1.1459843638409768,49.937290080789644,94971930,-0.24432126938294374,1.8354160176282335,2.079737287011177
2025-09-03T12:25:00-04:00,342.78,342.8,341.62,341.715,339.223232914502,NaN,NaN,NaN,NaN,NaN,335.55449999999945,346.365145910498,324.7438540895009,340.7813995695739,337.27649213516776,341.6979663011321,332.8550179692034,60878,125053.26666666666,64.05818061367845,71.4903902970667,NaN,NaN,NaN,NaN,1.1484140521380506,49.53773598736903,94911052,-0.2843067076030197,1.7243539025074028,2.0086606101104225
2025-09-03T12:30:00-04:00,341.75,341.81,341.38,341.57,339.223232914502,NaN,NaN,NaN,NaN,NaN,335.80629999999945,346.579109626193,325.03349037380593,340.7813995695739,337.3080820398129,341.728637796496,332.88752628312983,35002,120454.93333333333,62.8500427610356,70.3684405302162,NaN,NaN,NaN,NaN,1.097098762699619,48.814791068697986,94876050,-0.32203111484194347,1.6061217165579933,1.9281528313999368
2025-09-03T12:35:00-04:00,341.56,342.11,341.56,341.79,339.223232914502,NaN,NaN,NaN,NaN,NaN,336.07029999999946,346.76950640244894,325.37109359755,340.7813995695739,337.35335246376445,341.77460251863585,332.93210240889306,48403,117278.43333333333,63.960644302923235,69.93238160389217,NaN,NaN,NaN,NaN,1.058020279649647,48.33359188683442,94924453,-0.33233335455689317,1.5127361382038202,1.8450694927607134
2025-09-03T12:40:00-04:00,341.79,341.79,341.06,341.37,339.223232914502,NaN,NaN,NaN,NaN,NaN,336.31509999999946,346.9276790438587,325.70252095614023,340.7813995695739,337.39693715775974,341.814178830148,332.97969548537145,52437,115554.13333333333,60.257084501336394,69.3007325846856,NaN,NaN,NaN,NaN,1.0345902596746734,47.145040035284325,94872016,-0.3649937003981327,1.3888273672630476,1.7538210676611803
2025-09-03T12:45:00-04:00,341.36,341.49,340.88,341.03,339.223232914502,NaN,NaN,NaN,NaN,NaN,336.55409999999944,347.0416659121779,326.06653408782097,340.7813995695739,337.42306050308645,341.83582932594385,333.01029168022905,34335,113787.73333333334,57.361467643786284,68.30982692823041,NaN,NaN,NaN,NaN,1.0042623839836262,45.78218568663913,94837681,-0.4040182571339659,1.248798246243723,1.652816503377689
2025-09-03T12:50:00-04:00,341.05,341.2,340.52,340.73,339.223232914502,NaN,NaN,NaN,NaN,NaN,336.7866999999994,347.1173626332617,326.4560373667372,340.7813995695739,337.46313772316586,341.8650652007164,333.0612102456153,58689,110206.1,54.85657735016447,66.9504221633662,NaN,NaN,NaN,NaN,0.9811007851276534,44.004201087651055,94778992,-0.4415125003288918,1.1009258779665743,1.542438378295466
2025-09-03T12:55:00-04:00,340.74,341.48,340.73,341.25,339.223232914502,NaN,NaN,NaN,NaN,NaN,337.0284999999995,347.1985088988251,326.8584911011739,340.7813995695739,337.5048244583752,341.8991578249962,333.11049109175417,56781,104466.83333333333,58.259071107591154,65.77496445362428,NaN,NaN,NaN,NaN,0.9645935861899639,42.606493192121704,94835773,-0.4227452818313915,1.0140067760062266,1.436752057837618
2025-09-03T13:00:00-04:00,341.27,341.83,341.2,341.48,339.223232914502,NaN,NaN,NaN,NaN,NaN,337.27589999999947,347.26355792176327,327.28824207823567,340.7813995695739,337.5400451290162,341.9309064057185,333.14918385231397,44668,100346.2,59.70569521103373,64.68476270645483,NaN,NaN,NaN,NaN,0.9406940443192519,41.61575819644675,94880441,-0.38724187821298584,0.9526997100713857,1.3399415882843715
2025-09-03T13:05:00-04:00,341.49,341.93,341.41,341.84,339.223232914502,NaN,NaN,NaN,NaN,NaN,337.5266999999994,347.3286891064229,327.72471089357583,340.7813995695739,337.56523754277487,341.95482596335603,333.1756491221937,30699,93576.96666666666,61.929717014626505,63.941363576767515,NaN,NaN,NaN,NaN,0.9106444697250183,40.78338222788407,94911140,-0.33393080621107996,0.9225280805205216,1.2564588867316016
2025-09-03T13:10:00-04:00,341.805,342.47,341.75,342.1,339.223232914502,NaN,NaN,NaN,NaN,NaN,337.7798999999994,347.3853244030353,328.1744755969634,340.72692599859874,337.62982426874396,342.02113397718625,333.23851456030167,73602,87973.8,63.49676487181348,63.57087619865318,NaN,NaN,NaN,NaN,0.8970270076018048,40.46553937280028,94984742,-0.27787355767214406,0.9091169396414216,1.1869904973135657
2025-09-03T13:15:00-04:00,342.15,342.56,342.04,342.17,339.43033056055486,NaN,NaN,NaN,NaN,NaN,338.0310999999994,347.42332173728585,328.638878262713,340.905540798879,337.68799922620116,342.0819636460457,333.2940348063566,65900,86726.76666666666,63.927276085498995,63.08452650924098,NaN,NaN,NaN,NaN,0.8700965070588174,40.24345712776235,95050642,-0.2345256985601334,0.8938333741133988,1.1283590726735322
2025-09-03T13:20:00-04:00,342.17,342.32,341.92,342,339.43033056055486,NaN,NaN,NaN,NaN,NaN,338.27909999999946,347.4191935860788,329.13900641392013,340.905540798879,337.7190585903745,342.1128993512931,333.32521782945594,37329,84023.06666666667,62.01442398919568,62.677527439096835,NaN,NaN,NaN,NaN,0.8365181851260431,39.816018836500064,95013313,-0.21619791273217248,0.8581116817583165,1.074309594490489
2025-09-03T13:25:00-04:00,341.99,342.01,341.45,341.76,339.43033056055486,NaN,NaN,NaN,NaN,NaN,338.5188999999994,347.37825918463324,329.6595408153656,340.905540798879,337.756630140273,342.14697236864976,333.3662879118962,49788,78221.33333333333,59.31597704445279,61.82200407785815,NaN,NaN,NaN,NaN,0.8167668861884688,38.58626778336337,94963525,-0.21848747462949136,0.8012002512036247,1.019687725833116
2025-09-03T13:30:00-04:00,341.74,342.01,341.14,341.18,339.43033056055486,NaN,NaN,NaN,NaN,NaN,338.7590999999995,347.2344656417997,330.28373435819924,340.905540798879,337.7818308318253,342.16767409005115,333.3959875735994,36673,72676.36666666667,53.282006623736635,60.37678065149097,NaN,NaN,NaN,NaN,0.8205692514607213,36.935541146992875,94926852,-0.2547795965864512,0.701213230100052,0.9559928266865032
2025-09-03T13:35:00-04:00,341.17,341.27,340.98,341.12,339.43033056055486,NaN,NaN,NaN,NaN,NaN,338.99469999999945,347.0543616332348,330.9350383667641,340.905540798879,337.80723515412427,342.18600465478374,333.4284656534648,41101,69339.43333333333,52.68493575351434,59.56440601862211,NaN,NaN,NaN,NaN,0.7826714477849529,35.14467456398474,94885751,-0.2767154920244186,0.6100984616559799,0.8868139536803985
2025-09-03T13:40:00-04:00,341.11,341.28,340.53,340.67,339.43033056055486,NaN,NaN,NaN,NaN,NaN,339.18769999999944,346.93018105210643,331.44521894789244,340.905540798879,337.83966756471244,342.2059645792881,333.4733705501368,58699,66643.93333333333,48.31224765135441,58.52599208221631,NaN,NaN,NaN,NaN,0.7803377729431705,32.790123393095804,94827052,-0.3127614652292179,0.49586212214387615,0.808623587373094
2025-09-03T13:45:00-04:00,340.72,340.77,339.69,340.54,339.43033056055486,NaN,NaN,NaN,NaN,NaN,339.4128999999994,346.6265293474459,332.1992706525529,340.905540798879,337.86978821451476,342.2181758577987,333.5214005712308,66816,65655.76666666666,47.096164947020036,57.32138641393751,NaN,NaN,NaN,NaN,0.8017422177329429,31.373928334690692,94760236,-0.3346272732760347,0.3903394957780506,0.7249667690540853
2025-09-03T13:50:00-04:00,340.6,340.96,340.17,340.21,339.43033056055486,NaN,NaN,NaN,NaN,NaN,339.6116999999994,346.3379011895504,332.88549881044844,340.905540798879,337.8958572916749,342.22987207258404,333.5618425107657,56533,63520.8,44.06405071870762,56.164741143749744,NaN,NaN,NaN,NaN,0.8009034878948729,29.77773457341579,94703703,-0.3584598362475224,0.2768919737446822,0.6353518099922046
2025-09-03T13:55:00-04:00,340.24,340.35,339.21,339.28,NaN,NaN,NaN,342.4633238261469,342.4633238261469,342.4633238261469,339.7892999999994,345.9809059340346,333.5976940659642,340.905540798879,337.9179862025537,342.22834360483125,333.6076288002762,72941,62048.2,36.86149465415101,54.70045735877579,NaN,NaN,NaN,NaN,0.8251246673309565,29.331225030293407,94630762,-0.41974937658584666,0.11066508925989638,0.530414465845743
2025-09-03T14:00:00-04:00,339.28,339.28,338.52,338.95,NaN,NaN,NaN,341.5649909249584,NaN,NaN,339.9512999999994,345.5988193884099,334.3037806115889,340.905540798879,337.93275413675525,342.21282103363285,333.65268723987765,84970,61167.433333333334,34.694402798214654,53.26030203363653,NaN,NaN,NaN,NaN,0.8204729053787447,29.516484575317932,94545792,-0.46205603366837966,-0.047155576239731545,0.4149004574286481
2025-09-03T14:05:00-04:00,338.97,339.4,338.62,338.7,NaN,NaN,NaN,341.5649909249584,NaN,NaN,340.1068999999994,345.14651700551906,335.0672829944798,340.79643263910316,337.94063208756046,342.20424573856326,333.67701843655766,46859,60211.833333333336,33.106484344907045,51.4636886934448,NaN,NaN,NaN,NaN,0.8175819835659752,29.498599375856273,94498933,-0.4840882701425052,-0.19020988024948338,0.29387838989302184
2025-09-03T14:10:00-04:00,338.72,338.87,338.26,338.81,NaN,NaN,NaN,341.17793594608816,NaN,NaN,340.22049999999945,344.866627958012,335.5743720419869,340.5111461112825,337.9477894590642,342.1903265934263,333.70525232470214,59327,59445.96666666667,34.52643140149435,49.66516984990627,NaN,NaN,NaN,NaN,0.8027546990255494,29.790853343862487,94558260,-0.46818023225457467,-0.2913469004251965,0.17683333182937816
2025-09-03T14:15:00-04:00,338.77,338.77,337.9,337.94,NaN,NaN,NaN,340.95325703944775,NaN,NaN,340.31329999999946,344.5720141770994,336.0545858228995,340.37591688902603,337.9506260210013,342.16963611264725,333.73161592935537,65690,58532.1,29.239854145027138,47.33017964493489,NaN,NaN,NaN,NaN,0.8104150776665834,30.35522957978367,94492570,-0.49080012414357815,-0.43666682335009455,0.05413330079348361
2025-09-03T14:20:00-04:00,337.99,338.19,337.05,337.21,NaN,NaN,NaN,340.27469990129106,NaN,NaN,340.4130999999994,344.1045934054366,336.7216065945622,339.8177335112208,337.9453447890784,342.1407368104266,333.7499527677302,67648,58089,25.685942061488632,44.62940658705454,NaN,NaN,NaN,NaN,0.833956857833255,31.483409300721675,94424922,-0.526329698200211,-0.6037788219567801,-0.07744912375656915
2025-09-03T14:25:00-04:00,337.19,337.35,336.39,336.83,NaN,NaN,NaN,339.5349408148687,NaN,NaN,340.4740999999994,343.80868944436037,337.1395105556384,339.74318680897665,337.93277867226175,342.10550832932586,333.76004901519764,69896,58860.666666666664,24.047444395115235,41.78084718059856,NaN,NaN,NaN,NaN,0.8429599394165965,32.923091974309145,94355026,-0.5445524977715848,-0.7581397459710502,-0.21358724819946537
2025-09-03T14:30:00-04:00,336.8,336.8,335.65,336.01,NaN,NaN,NaN,338.92971623237474,NaN,NaN,340.4890999999994,343.7353123717444,337.2428876282544,339.1494395577451,337.90786097300736,342.05654446229846,333.75917748371626,86000,59532.53333333333,20.942873777168643,38.84716502259663,NaN,NaN,NaN,NaN,0.8670342294582687,34.63851470960399,94269026,-0.5778111039039754,-0.9358511280794346,-0.3580400241754592
2025-09-03T14:35:00-04:00,336.01,336.14,334.72,334.84,NaN,NaN,NaN,338.2054109490849,NaN,NaN,340.46469999999937,343.8586866886185,337.07071331138025,339.1494395577451,337.85799231978206,341.9837091875225,333.7322754520416,116689,61484.4,17.47604454730913,35.858598415657795,NaN,NaN,NaN,NaN,0.9065317844969609,36.628699624416605,94152337,-0.6397696251573106,-1.1577520556220975,-0.5179824304647869
2025-09-03T14:40:00-04:00,334.87,336.04,334.78,336.02,NaN,NaN,NaN,338.2054109490849,NaN,NaN,340.4352999999994,343.9549888559037,336.9156111440951,338.3315516461961,337.83008928674116,341.93761914976835,333.72255942371396,78774,62704.3,30.052277705363366,34.19933206434541,NaN,NaN,NaN,NaN,0.9317795141757529,38.476728473885466,94231111,-0.5650390547736922,-1.2242812489319022,-0.65924219415821
2025-09-03T14:45:00-04:00,336,336.17,335.74,335.92,NaN,NaN,NaN,338.2054109490849,NaN,NaN,340.36329999999936,344.09579064869075,336.63080935130796,337.4141930535655,337.8114245089702,341.90285022469004,333.7199987932504,63315,62402.933333333334,29.640035980095846,32.55326779481552,NaN,NaN,NaN,NaN,0.8959381203060568,39.95468128017095,94167796,-0.4889506812308698,-1.2704305456967973,-0.7814798644659274
2025-09-03T14:50:00-04:00,335.92,336,335.11,335.62,NaN,NaN,NaN,338.2054109490849,NaN,NaN,340.2758999999994,344.23692193409727,336.31487806590155,337.4141930535655,337.7884889440541,341.86509191003336,333.71188597807486,66368,59560.333333333336,28.38219297140192,31.129692460533196,NaN,NaN,NaN,NaN,0.8955139688556232,41.60908105068323,94101428,-0.42764905650048624,-1.3160411850915352,-0.888392128591049
2025-09-03T14:55:00-04:00,335.61,335.68,334.89,335.02,NaN,NaN,NaN,338.0156045385774,NaN,NaN,340.19369999999935,344.4088606425525,335.9785393574462,336.97635444285237,337.7672852806966,341.83388594701375,333.7006846143795,53340,59309.066666666666,26.005226611701815,29.62319686515332,NaN,NaN,NaN,NaN,0.8879772567945087,43.23774978494693,94048088,-0.3969996123643579,-1.3846416440464964,-0.9876420316821385
2025-09-03T15:00:00-04:00,335,335.29,334.63,334.85,NaN,NaN,NaN,337.6564861504603,NaN,NaN,340.0928999999994,344.5654796093912,335.6203203906076,336.80008355428185,337.7187159074145,341.7672447578707,333.6701870569583,113284,61918.46666666667,25.35724670757324,28.286996578643727,NaN,NaN,NaN,NaN,0.8716931670234741,44.85875540657207,93934804,-0.3588226178377598,-1.4361703039793383,-1.0773476861415785
2025-09-03T15:05:00-04:00,334.87,335.55,334.84,335.47,NaN,NaN,NaN,337.6564861504603,NaN,NaN,339.9768999999994,344.6189895685536,335.33481043144513,336.0440668434255,337.6957904287323,341.7320401589187,333.6595406985459,63123,62409.13333333333,32.01100426423777,27.940532979364207,NaN,NaN,NaN,NaN,0.8601436550932285,45.84235261285935,93997927,-0.26669501795255446,-1.4107164585822716,-1.1440214406297171
2025-09-03T15:10:00-04:00,335.48,335.66,335.1,335.2,NaN,NaN,NaN,337.6564861504603,NaN,NaN,339.8562999999994,344.67197225238584,335.040627747613,335.15325347474044,337.6786395440976,341.7053202232125,333.65195886498276,48693,62284.333333333336,30.7264613239891,27.657108588348102,NaN,NaN,NaN,NaN,0.8387048225865695,46.532956551687896,93949234,-0.201771573749975,-1.3962359078171858,-1.1944643340672108
2025-09-03T15:15:00-04:00,335.2,335.38,334.91,335.29,NaN,NaN,NaN,337.6564861504603,NaN,NaN,339.7322999999994,344.69050177508666,334.7740982249121,334.45260277979236,337.6565411051876,341.6720634807351,333.6410187296401,60513,63156.933333333334,31.710175104151517,27.55737221400842,NaN,NaN,NaN,NaN,0.8123687638303839,47.28633306733489,94009747,-0.1338683243181169,-1.3617997394648569,-1.22793141514674
2025-09-03T15:20:00-04:00,335.27,335.81,335.01,335.64,NaN,NaN,NaN,337.6564861504603,NaN,NaN,339.6190999999994,344.6862142440659,334.55198575593283,333.98165464703214,337.64142212280973,341.64699922504707,333.6358450205724,47752,62792.36666666667,35.54352241200881,27.630021571902315,NaN,NaN,NaN,NaN,0.8114852806996431,47.097602600630104,94057499,-0.050759285654545794,-1.2913805222149222,-1.2406212365603764
2025-09-03T15:25:00-04:00,335.63,335.96,335.51,335.63,NaN,NaN,NaN,337.6564861504603,NaN,NaN,339.5052999999994,344.6691584065009,334.3414415934979,334.2723237176257,337.62670258679816,341.62061799252064,333.6327871810757,52358,62644.933333333334,35.482238029617065,28.075906135087312,NaN,NaN,NaN,NaN,0.7856649035068106,46.6239416457548,94005141,0.014665065681700673,-1.2222899044582505,-1.2369549701399511
2025-09-03T15:30:00-04:00,335.63,336.31,335.61,336.19,NaN,NaN,NaN,337.6564861504603,NaN,NaN,339.40609999999936,344.62998410691364,334.1822158930851,334.6098589741006,337.61365932660215,341.59374455479474,333.63357409840955,57117,63059.9,41.55909471415698,29.209702753135048,NaN,NaN,NaN,NaN,0.7795459818277519,45.505192402413556,94062258,0.10191798872984048,-1.1095574842276505,-1.211475472957491
2025-09-03T15:35:00-04:00,336.21,336.46,335.82,336.35,NaN,NaN,NaN,337.6564861504603,NaN,NaN,339.3300999999994,344.61865083764627,334.0415491623525,334.7798871792805,337.6017772704878,341.56706666328074,333.63648787769483,59444,64018.066666666666,43.20507956847317,30.57810526551776,NaN,NaN,NaN,NaN,0.7695784116971972,44.18305641758865,94121702,0.17251933799316466,-0.9958263004660353,-1.1683456384592
2025-09-03T15:40:00-04:00,336.36,337.07,336.3,336.86,NaN,NaN,NaN,337.6564861504603,NaN,NaN,339.2666999999994,344.5960165079964,333.93738349200237,335.3409097434244,337.58992248106557,341.5290112309947,333.65083373113646,98333,64842.433333333334,48.21202340355254,32.52590166740232,NaN,NaN,NaN,NaN,0.7696085251473962,41.8931229860522,94220035,0.250925739879005,-0.8546884636104437,-1.1056142034894487
2025-09-03T15:45:00-04:00,336.89,337.13,336.7,336.98,NaN,NaN,NaN,337.6564861504603,NaN,NaN,339.19369999999935,344.5462630535761,333.8411369464226,335.5317277947395,337.5815477188565,341.4959952993129,333.6671001384001,92472,65728.16666666667,49.34362381324224,34.80215732925469,NaN,NaN,NaN,NaN,0.7453507733511541,39.668630247277676,94312507,0.3046532049852062,-0.7247976972579409,-1.029450902243147
2025-09-03T15:50:00-04:00,336.97,337.13,335.96,336.47,NaN,NaN,NaN,337.6564861504603,NaN,NaN,339.0940999999994,344.460333573224,333.7278664267748,335.5317277947395,337.56469676881756,341.45021721330073,333.6791763243344,116347,68362.1,44.857485194814956,35.8596721499298,NaN,NaN,NaN,NaN,0.7756828609689299,38.495260901782956,94196160,0.2991964136427828,-0.6554553851896685,-0.9546517988324513
2025-09-03T15:55:00-04:00,336.4,336.47,334.01,334.05,NaN,NaN,NaN,337.6564861504603,NaN,NaN,338.94069999999937,344.43489184616465,333.4465081538341,335.5317277947395,337.4852202722987,341.3409078136073,333.6295327309901,220493,74052.26666666666,30.627978270485954,35.93023945638624,NaN,NaN,NaN,NaN,0.8959912280425805,38.964296108341806,93975667,0.13435646392740097,-0.7867062189232001,-0.9210626828506011
2025-09-04T09:30:00-04:00,336.16,337.63,334.17,337.39,NaN,NaN,NaN,337.6564861504603,NaN,NaN,338.85249999999934,344.30166076130394,333.40333923869474,335.5317277947395,336.39666666666665,336.39666666666665,336.39666666666665,221916,80227.03333333334,52.8558722964698,37.6783594081768,NaN,NaN,NaN,NaN,1.0877061403252521,37.80355385521595,94197583,0.2455429388888526,-0.6141340092395353,-0.8596769481283879
2025-09-04T09:35:00-04:00,337.48,337.48,334.73,335.53,NaN,NaN,NaN,337.6564861504603,NaN,NaN,338.73249999999933,344.2047347356866,333.26026526431207,335.5317277947395,336.18608104156334,336.4257406891087,335.946421394018,171339,84568.3,44.33618841239369,38.987713822511935,NaN,NaN,NaN,NaN,1.2064414160163055,36.72572176302765,94026244,0.1914973566950886,-0.6203052522595272,-0.8118026089546158
2025-09-04T09:40:00-04:00,335.51,335.51,333,335.2,NaN,NaN,NaN,337.6564861504603,NaN,NaN,338.6134999999993,344.1288829425155,333.09811705748314,335.5317277947395,335.6720587781375,336.4502944448029,334.8938231114721,183422,88725.73333333334,43.011539157913795,40.248734711821974,NaN,NaN,NaN,NaN,1.3009813148722817,36.88638085991304,93842822,0.1339252453071772,-0.6443960523206442,-0.7783212976278214
2025-09-04T09:45:00-04:00,335.16,336.04,334.04,334.67,NaN,NaN,NaN,337.6564861504603,NaN,NaN,338.4740999999993,344.02865117562436,332.9195488243742,335.5317277947395,335.5113935982467,336.2679556491361,334.75483154735724,155789,91691.5,40.89808824138972,40.88352642447569,NaN,NaN,NaN,NaN,1.3509112209528331,36.39121226756378,93687033,0.06409202346503262,-0.6982062682965307,-0.7622982917615633
2025-09-04T09:50:00-04:00,334.68,335,333.45,334.1,NaN,NaN,NaN,337.6564861504603,NaN,NaN,338.3294999999993,343.9551136556383,332.70388634436034,335.5317277947395,335.3597372530714,336.18764562116763,334.53182888497514,94426,92954.6,38.69589345480725,41.45277157667699,NaN,NaN,NaN,NaN,1.3651318480276315,36.29264436125857,93592607,-0.012464237228417496,-0.7778785882970851,-0.7654143510686676
2025-09-04T09:55:00-04:00,334.1,334.82,333.61,334.45,NaN,NaN,NaN,337.6564861504603,NaN,NaN,338.1750999999993,343.79437557274895,332.55582442724966,335.5317277947395,335.266675044594,336.1129597252097,334.42039036397836,79060,93158.56666666667,40.80367379450041,42.10230719741619,NaN,NaN,NaN,NaN,1.354051001739942,36.201117019689434,93671667,-0.030480503507990586,-0.8035149804536559,-0.7730344769456653
2025-09-04T10:00:00-04:00,334.55,334.75,332.15,332.43,NaN,NaN,NaN,337.27800771593917,NaN,NaN,337.96849999999927,343.6574641414519,332.27953585854664,335.5317277947395,334.98068107225197,336.0559611217586,333.9054010227453,138504,94943.03333333334,33.619251791410406,41.96485929594488,NaN,NaN,NaN,NaN,1.4430473587585193,36.91289119845778,93533163,-0.1620389849631031,-0.9755832081495441,-0.813544223186441
2025-09-04T10:05:00-04:00,332.46,332.86,331.86,332.11,NaN,NaN,NaN,336.1503710015783,NaN,NaN,337.7763999999993,343.59357836778685,331.9592216322117,335.2663822357916,334.60510747710424,335.972635942616,333.23757901159246,168469,98996.7,32.638835509230276,41.76175911591725,NaN,NaN,NaN,NaN,1.4114011188471964,37.71000606778141,93364694,-0.24900766611009373,-1.1248038058240581,-0.8757961397139644
2025-09-04T10:10:00-04:00,332.12,333.22,331.86,332.145,NaN,NaN,NaN,336.1503710015783,NaN,NaN,337.5878999999993,343.5110019206611,331.6647980793375,333.7491057886333,334.3675913130117,335.82816991107984,332.90701271494356,147040,101920.46666666666,32.86942821589017,41.14106865175533,NaN,NaN,NaN,NaN,1.407729610358112,37.972065864674185,93511734,-0.28024647280192716,-1.2261042307163734,-0.9458577579144463
2025-09-04T10:15:00-04:00,332.1,333.04,331.49,332.91,NaN,NaN,NaN,336.1070115944133,NaN,NaN,337.41029999999927,343.35125763683305,331.4693423631655,333.6632846309066,334.2118272691517,335.7041433121879,332.71951122611546,122318,103808.06666666667,37.87528546765752,40.76036907312564,NaN,NaN,NaN,NaN,1.4178917810468192,38.41493127766961,93634052,-0.22769165099938937,-1.230472321663683,-1.0027806706642937
2025-09-04T10:20:00-04:00,332.88,334.18,332.875,334.06,NaN,NaN,NaN,336.1070115944133,NaN,NaN,337.2640999999993,343.16775164643684,331.36044835356176,332.9316277047253,334.17964349051766,335.62908026126246,332.73020671977287,100508,104903.4,44.56713996863459,40.50002025634579,NaN,NaN,NaN,NaN,1.4098280824006184,37.42024241949608,93734560,-0.10028286091089722,-1.1281342468029152,-1.027851385892018
2025-09-04T10:25:00-04:00,334.07,334.22,333.29,333.73,NaN,NaN,NaN,336.1070115944133,NaN,NaN,337.11809999999934,343.00303564640967,331.233164353589,331.11704173102424,334.1604965591259,335.5803158469371,332.74067727131467,73232,105014.6,43.13139798134401,40.056289839781634,NaN,NaN,NaN,NaN,1.3755546479434317,36.45096581802413,93661328,-0.02685761049755442,-1.061423399013961,-1.0345657885164066
2025-09-04T10:30:00-04:00,333.73,334.86,333.62,333.94,NaN,NaN,NaN,336.1070115944133,NaN,NaN,336.9822999999993,342.84088863911757,331.1237113608811,331.35279540609923,334.15931529808984,335.5376221250598,332.7810084711199,101277,105523.83333333333,44.35979954510831,40.02074086480258,NaN,NaN,NaN,NaN,1.3658721730903303,34.83216203258579,93762605,0.04340548251482512,-0.9803089353728751,-1.0237144178877002
2025-09-04T10:35:00-04:00,333.92,334.86,333.83,334.66,NaN,NaN,NaN,336.1070115944133,NaN,NaN,336.8504999999994,342.61486995709504,331.08613004290373,331.53923632487937,334.172425568295,335.5206423258755,332.82420881071454,83000,104400.86666666667,48.469674243682576,41.29514772003091,NaN,NaN,NaN,NaN,1.3418813035838804,33.328987088964475,93845605,0.14045136776182743,-0.848150208185416,-0.9886015759472434
2025-09-04T10:40:00-04:00,334.69,334.96,332.98,333.1,NaN,NaN,NaN,336.1070115944133,NaN,NaN,336.6828999999993,342.38608510681286,330.9797148931857,331.53923632487937,334.1518302042369,335.4752282394787,332.82843216899505,80329,104452.7,41.343955097894394,40.47286792013267,NaN,NaN,NaN,NaN,1.3874612104707433,32.61812598184503,93765276,0.10337249206539856,-0.8593859608654952,-0.9627584529308938
2025-09-04T10:45:00-04:00,333.1,333.25,332.4,333.15,NaN,NaN,NaN,336.1070115944133,NaN,NaN,336.5090999999993,342.10162633096286,330.91657366903576,331.53923632487937,334.1106629097249,335.4300107930104,332.7913150264394,67158,104580.8,41.64009929948276,40.280290126353314,NaN,NaN,NaN,NaN,1.3490711240085491,32.371581552765306,93832434,0.08668138249892798,-0.8544067248072338,-0.9410881073061618
2025-09-04T10:50:00-04:00,333.13,333.45,332.47,332.89,NaN,NaN,NaN,336.1070115944133,NaN,NaN,336.3248999999993,341.77355212347027,330.8762478765283,331.53923632487937,334.07516076820866,335.3898694635806,332.7604520728367,61986,104434.73333333334,40.495162200679594,40.1005489151223,NaN,NaN,NaN,NaN,1.3227089008650785,31.890834858905787,93770448,0.06366286512222019,-0.8615095259033865,-0.9251723910256067
2025-09-04T10:55:00-04:00,332.84,333.19,332.75,333.05,NaN,NaN,NaN,336.1070115944133,NaN,NaN,336.14249999999925,341.403632292832,330.8813677071665,331.53923632487937,334.0583236140239,335.369563488409,332.74708373963875,32508,103740.33333333333,41.56006727549611,40.14783313184419,NaN,NaN,NaN,NaN,1.2596582650890014,31.444427214607668,93802956,0.06454343808557772,-0.8444930934186345,-0.9090365315042123
2025-09-04T11:00:00-04:00,333.05,333.68,332.83,333.45,NaN,NaN,NaN,336.1070115944133,NaN,NaN,335.97149999999937,341.0111119892691,330.9318880107296,331.53923632487937,334.0382669400079,335.3371316934895,332.73940218652626,58145,101902.36666666667,44.24637890527625,40.54429637830625,NaN,NaN,NaN,NaN,1.2303969604397886,30.384018592892335,93861101,0.09552646854711966,-0.7896284458203127,-0.8851549143674323
2025-09-04T11:05:00-04:00,333.43,333.91,333.34,333.78,NaN,NaN,NaN,336.1070115944133,NaN,NaN,335.81189999999935,340.60767684660317,331.01612315339554,331.53923632487937,334.02930929343773,335.31321602964414,332.74540255723133,54370,101610.6,46.434011766555,40.946463376310156,NaN,NaN,NaN,NaN,1.183225748979807,29.106994899131074,93915471,0.1390679939210251,-0.711319921966151,-0.8503879158871761
2025-09-04T11:10:00-04:00,333.82,333.93,332.63,333.21,NaN,NaN,NaN,336.1070115944133,NaN,NaN,335.65249999999935,340.2496853347941,331.0553146652046,331.53923632487937,334.00850590357487,335.2811699303425,332.7358418768072,60730,102011.83333333333,43.27545557919266,41.6361922182946,NaN,NaN,NaN,NaN,1.1915667669098216,28.574289383667956,93854741,0.13044556037386368,-0.6873309654198465,-0.8177765257937102
2025-09-04T11:15:00-04:00,333.21,334.76,333.14,334.46,NaN,NaN,NaN,336.1070115944133,NaN,NaN,335.51929999999936,339.8535155048372,331.1850844951615,331.90316385737543,334.01266986508784,335.26152166275585,332.76381806741983,87505,102911.56666666667,51.12678421956271,42.956759983318356,NaN,NaN,NaN,NaN,1.2221691407019775,27.06936771854102,93942246,0.2054306065028918,-0.5609882676650955,-0.7664188741679873
2025-09-04T11:20:00-04:00,334.5,334.59,334,334.4,NaN,NaN,NaN,336.1070115944133,NaN,NaN,335.39389999999935,339.4805090053238,331.3072909946749,332.00953108590033,334.01939439411217,335.2557881099298,332.7830006782945,50726,103010.7,50.76358048368604,44.23491371673235,NaN,NaN,NaN,NaN,1.1770142020804057,25.67194045806601,93891520,0.24481900361420628,-0.4603951196502294,-0.7052141232644357
2025-09-04T11:25:00-04:00,334.37,334.95,334,334.8,NaN,NaN,NaN,336.1070115944133,NaN,NaN,335.2790999999994,339.0945012583655,331.4636987416333,332.4106248687203,334.03961180377524,335.2581595968878,332.82106401066267,89008,104232.36666666667,53.15291955270002,45.32617329423538,NaN,NaN,NaN,NaN,1.1607989019318043,23.95003624267765,93980528,0.2886294392051545,-0.3444273242579925,-0.633056763463147
2025-09-04T11:30:00-04:00,334.82,335.13,334.32,334.99,NaN,NaN,NaN,336.1070115944133,NaN,NaN,335.17469999999935,338.72086322839607,331.6285367716026,332.69349989497624,334.05874218095715,335.26811432792914,332.84937003398517,62943,104426.56666666667,54.28767665362106,46.020497343162994,NaN,NaN,NaN,NaN,1.1357418375081043,22.33711924989363,94043471,0.31885535314170443,-0.23448757203601645,-0.5533429251777209
2025-09-04T11:35:00-04:00,335.02,335.55,334.58,335.49,NaN,NaN,NaN,336.1070115944133,NaN,NaN,335.0988999999994,338.44732726699584,331.75047273300294,333.115799915981,334.088567151334,335.2960140486209,332.8811202540471,67906,104708.63333333333,57.22411235607087,47.02711979850062,NaN,NaN,NaN,NaN,1.1239031348289559,21.316273283099484,94111377,0.35803899966248665,-0.10579417559961257,-0.4638331752620992
2025-09-04T11:40:00-04:00,335.5,336.08,335.4,335.505,NaN,NaN,NaN,336.1070115944133,NaN,NaN,335.02999999999935,338.1953897078218,331.8646102921769,333.79263993278477,334.131969216116,335.3502038293582,332.9137346028738,74156,103902.73333333334,57.31270380126812,47.952327245369176,NaN,NaN,NaN,NaN,1.0921957680554595,20.92163019854569,94185533,0.3690154976727655,-0.0025638031711423537,-0.37157930084390783
2025-09-04T11:45:00-04:00,335.51,335.57,334.88,335.28,NaN,NaN,NaN,336.1070115944133,NaN,NaN,334.9615999999994,337.9496538419229,331.9735461580759,333.79263993278477,334.15427931092603,335.37025627357474,332.9383023482773,55061,102655.7,55.45734556310951,48.451446625328245,NaN,NaN,NaN,NaN,1.0634674989086408,19.87919702978601,94130472,0.34557959501689994,0.06039519292721707,-0.2851844020896829
2025-09-04T11:50:00-04:00,335.3,335.78,335.08,335.18,NaN,NaN,NaN,336.1070115944133,NaN,NaN,334.8889999999994,337.6686373868374,332.10936261316135,333.79263993278477,334.168127887399,335.3837546239885,332.9525011508095,32230,99851.8,54.61116991020916,49.399104826207875,NaN,NaN,NaN,NaN,1.03750553470088,19.1408913872447,94098242,0.30899277722229457,0.1010565694381853,-0.20793620778410923
2025-09-04T11:55:00-04:00,335.17,335.26,334.34,334.43,NaN,NaN,NaN,336.1070115944133,NaN,NaN,334.8187999999994,337.4605490876872,332.1770509123116,333.79263993278477,334.1779540178867,335.3838127597897,332.9720952759837,54677,94324.6,48.619377143851466,49.89762467223421,NaN,NaN,NaN,NaN,1.0291122822222467,17.993808849102,94043565,0.22389542351631425,0.0719330716112836,-0.15196235190503066
2025-09-04T12:00:00-04:00,334.42,334.66,334.05,334.43,NaN,NaN,NaN,336.1070115944133,NaN,NaN,334.76319999999936,337.3168520989227,332.209547901076,333.79263993278477,334.18080967209306,335.3783539925718,332.9832653516143,40568,88279.66666666667,48.61937714385147,50.47792573960363,NaN,NaN,NaN,NaN,0.9991756906349443,17.249758816622034,94043565,0.16020649450803437,0.048295766230012305,-0.11191072827802206
2025-09-04T12:05:00-04:00,334.425,334.67,333.98,334.06,NaN,NaN,NaN,336.1070115944133,NaN,NaN,334.7077999999994,337.1991226692277,332.2164773307711,333.79263993278477,334.18150668919947,335.37157186878204,332.9914415096169,36270,83777.36666666667,45.747583126784896,50.77703401469569,NaN,NaN,NaN,NaN,0.9770917127324481,16.637503863570448,94007295,0.08929695162969668,-0.00028953874090120735,-0.08958649037059789
2025-09-04T12:10:00-04:00,334.14,334.43,333.8,334.19,NaN,NaN,NaN,336.1070115944133,NaN,NaN,334.67139999999944,337.1386211417173,332.2041788582816,333.79263993278477,334.180932077845,335.36274097231274,332.99912318337726,40803,79023.4,46.933597237291785,50.96897818126822,NaN,NaN,NaN,NaN,0.9522994475372729,16.2773099264262,94048098,0.049284169367494565,-0.02798127866122968,-0.07726544802872425
2025-09-04T12:15:00-04:00,334.21,334.46,333.98,334.3,NaN,NaN,NaN,336.1070115944133,NaN,NaN,334.6605999999994,337.1295014889499,332.1916985110489,333.79263993278477,334.1816266171353,335.3571947605185,333.0060584737521,31474,74879.56666666667,47.97007030383663,51.07869664821691,NaN,NaN,NaN,NaN,0.9185637727131792,15.897411367237593,94079572,0.029345732386421894,-0.040583282545696875,-0.06992901493211877
2025-09-04T12:20:00-04:00,334.31,334.63,334.16,334.16,NaN,NaN,NaN,336.1070115944133,NaN,NaN,334.62339999999944,337.06515137188046,332.1816486281184,333.79263993278477,334.1834067691276,335.35130236660035,333.01551117165485,39793,73058.46666666666,46.71936402988544,51.324690108980676,NaN,NaN,NaN,NaN,0.8865235032336642,15.278238862004123,94039779,0.007013411121560148,-0.06116225103016859,-0.06817566215172874
2025-09-04T12:25:00-04:00,334.2,334.241,332.87,333.2,NaN,NaN,NaN,336.1070115944133,NaN,NaN,334.56899999999945,337.0139752559085,332.1240247440904,333.79263993278477,334.16760672577533,335.32805957770415,333.0071538738465,65281,72599.16666666667,39.176467828441645,50.471096081043456,NaN,NaN,NaN,NaN,0.9211289672884011,16.13127153981317,93974498,-0.06799512256509559,-0.15316956535809823,-0.08517444279300264
2025-09-04T12:30:00-04:00,333.17,333.59,333.06,333.4,NaN,NaN,NaN,336.1070115944133,NaN,NaN,334.5245999999994,336.9722469030862,332.0769530969126,333.69008955698223,334.15906490739894,335.31642949267075,333.00170032212714,32559,69067.66666666667,41.30266265044987,49.7953162358123,NaN,NaN,NaN,NaN,0.8931911839106562,16.923373312064424,94007057,-0.09790454974149862,-0.2075551299698759,-0.10965058022837729
2025-09-04T12:35:00-04:00,333.37,333.67,333.34,333.49,NaN,NaN,NaN,336.1070115944133,NaN,NaN,334.4939999999995,336.9543308724484,332.03366912755064,333.69008955698223,334.1527673965026,335.3063723736786,332.99916241932664,30066,64454.23333333333,42.28046580457512,49.01871239666052,NaN,NaN,NaN,NaN,0.8529632422027552,17.520202507021505,94037123,-0.10477562782362948,-0.24062011500791414,-0.13584448718428466
2025-09-04T12:40:00-04:00,333.5,334.06,333.28,333.62,NaN,NaN,NaN,336.1070115944133,NaN,NaN,334.46939999999944,336.93957784019244,331.99922215980644,333.1280716455858,334.14494255688663,335.2911541185869,332.99873099518635,50083,61222.333333333336,43.73837616338983,48.26519093307257,NaN,NaN,NaN,NaN,0.8477515820454177,17.41056377453849,94087206,-0.09405501035111136,-0.25341325012317384,-0.15935823977206248
2025-09-04T12:45:00-04:00,333.63,334.38,333.63,334.15,NaN,NaN,NaN,336.1070115944133,NaN,NaN,334.44299999999953,336.8980063140443,331.98799368595473,333.0012417168256,334.14332859459887,335.27946229154816,333.0071948976496,57328,59056,49.35484215843133,47.70310020466974,NaN,NaN,NaN,NaN,0.8414836118993158,16.799094799658906,94144534,-0.04712881547448994,-0.21826925911517492,-0.17114044364068498
2025-09-04T12:50:00-04:00,334.15,334.29,333.81,334.17,NaN,NaN,NaN,336.1070115944133,NaN,NaN,334.42239999999947,336.8689234440147,331.97587655598426,333.0012417168256,334.1423889793591,335.2684910831596,333.01628687555865,58361,57651.1,49.55947215791783,47.14929794443044,NaN,NaN,NaN,NaN,0.8156633539065087,16.23130218012787,94202895,-0.012409207220261065,-0.1866519526660113,-0.17424274544575025
2025-09-04T12:55:00-04:00,334.16,334.32,333.46,333.58,NaN,NaN,NaN,336.1070115944133,NaN,NaN,334.3881999999995,336.8330621724237,331.94333782757525,333.0012417168256,334.1378894832355,335.2575528826274,333.01822608384356,42434,56624.5,43.92158846988472,46.325315294914375,NaN,NaN,NaN,NaN,0.8188302571989018,16.17535807837711,94160461,-0.026061002051598864,-0.20681899801024883,-0.18075799595864997
2025-09-04T13:00:00-04:00,333.6,334.77,333.5,334.44,NaN,NaN,NaN,336.1070115944133,NaN,NaN,334.36419999999947,336.7828569500701,331.94554304992886,333.0012417168256,334.1396689061259,335.24927915439076,333.03005865786105,61543,55300.03333333333,52.418460081200486,46.1686931642709,NaN,NaN,NaN,NaN,0.8510566673989789,15.372191338891007,94222004,0.023279605247324336,-0.15165848939949456,-0.1749380946468189
2025-09-04T13:05:00-04:00,334.4,334.7,334.18,334.34,NaN,NaN,NaN,336.1070115944133,NaN,NaN,334.33839999999947,336.7298651914958,331.94693480850316,333.0012417168256,334.142272755477,335.2467708044208,333.0377747065332,33645,53654.86666666667,51.442412670195914,46.37033855900979,NaN,NaN,NaN,NaN,0.8274097625847647,14.626393652225337,94188359,0.04819809747552847,-0.1146904728024083,-0.16288857027793677
2025-09-04T13:10:00-04:00,334.34,334.4,333.89,333.98,NaN,NaN,NaN,336.1070115944133,NaN,NaN,334.2941999999995,336.62814375298325,331.9602562470157,332.81803246009116,334.14179189399204,335.24120934668605,333.042374441298,32031,52044.933333333334,47.97884536177387,46.32458628886138,NaN,NaN,NaN,NaN,0.8047376366858524,14.366746482885198,94156328,0.03980056676766225,-0.11313786181835894,-0.1529384285860212
2025-09-04T13:15:00-04:00,333.96,334.22,333.93,334.05,NaN,NaN,NaN,336.1070115944133,NaN,NaN,334.2481999999995,336.5077342533342,331.98866574666476,332.81803246009116,334.14134749508736,335.2375234928775,333.04517149729725,20720,50497,48.70208503083611,46.53562213915076,NaN,NaN,NaN,NaN,0.7679706626368644,14.125645539926495,94177048,0.038312292657197544,-0.10504806276452427,-0.14336035542172182
2025-09-04T13:20:00-04:00,334.04,334.49,334.04,334.24,NaN,NaN,NaN,336.1070115944133,NaN,NaN,334.1957999999995,336.32859099818415,332.06300900181486,333.0222326195667,334.1422193045859,335.2342895955799,333.0501490135919,26682,49320.2,50.70536722715161,46.80503428128361,NaN,NaN,NaN,NaN,0.7452584724485162,13.391210942770556,94203730,0.04880342270887614,-0.08235607703562664,-0.13115949974450278
2025-09-04T13:25:00-04:00,334.24,335.11,334.2,335.04,NaN,NaN,NaN,336.1070115944133,NaN,NaN,334.15699999999947,336.15190551206615,332.1620944879328,333.48078609565334,334.15137535476754,335.23828447203215,333.0644662375029,51135,49941.1,58.12116791671217,47.53011268220329,NaN,NaN,NaN,NaN,0.7570257244164811,13.179138085357698,94254865,0.1050705908932662,0.0001787388720799754,-0.10489185202118623
2025-09-04T13:30:00-04:00,335.12,335.23,334.77,335.08,NaN,NaN,NaN,336.1070115944133,NaN,NaN,334.12919999999946,336.03096587467564,332.22743412532327,333.69662887652265,334.1614223474109,335.24609013652963,333.0767545582922,41576,49388.8,58.45768244776804,48.36856399776633,NaN,NaN,NaN,NaN,0.7358096012438778,13.160328357394244,94296441,0.13833877338497863,0.06803161471003705,-0.07030715867494157
2025-09-04T13:35:00-04:00,335.12,335.59,335.09,335.19,NaN,NaN,NaN,336.1070115944133,NaN,NaN,334.1519999999995,336.0766184042478,332.2273815957511,334.1083031012181,334.1774228488835,335.2626076354064,333.0922380623606,52091,49312.833333333336,59.42329611376543,49.8147660181466,NaN,NaN,NaN,NaN,0.7196803440121716,13.656130515288071,94348532,0.15959959852929606,0.12919233948667852,-0.030407259042617547
2025-09-04T13:40:00-04:00,335.18,335.4,334.88,334.99,NaN,NaN,NaN,336.1070115944133,NaN,NaN,334.10399999999953,335.81056028370017,332.3974397162989,334.1083031012181,334.1881999818008,335.27145322855534,333.1049467350462,43909,48752.13333333333,56.8365011246711,50.9243259091624,NaN,NaN,NaN,NaN,0.7054174622970153,13.693745422951615,94304623,0.15207268157130233,0.15968359292151035,0.007610911350208034
2025-09-04T13:45:00-04:00,334.99,335.18,334.83,334.9,NaN,NaN,NaN,336.1070115944133,NaN,NaN,334.0913999999995,335.76463762864523,332.4181623713538,334.1083031012181,334.1917526639667,335.273820169774,333.10968515815944,16973,46401.066666666666,55.66224406022448,51.88016721313736,NaN,NaN,NaN,NaN,0.6800305007043729,13.626898638277135,94287650,0.13357007761690431,0.17457350837133845,0.04100343075443412
2025-09-04T13:50:00-04:00,334.89,335.59,334.81,335.44,NaN,NaN,NaN,336.1070115944133,NaN,NaN,334.09619999999944,335.7834493123896,332.40895068760926,334.1349711878237,334.20349230833074,335.2855629871137,333.1214216295478,40732,46067.933333333334,60.88410234895893,53.104861940678006,NaN,NaN,NaN,NaN,0.6871711792254871,14.183362960280427,94328382,0.14905875774077987,0.22732687793040895,0.07826812018962909
2025-09-04T13:55:00-04:00,335.38,335.38,334.8,334.84,NaN,NaN,NaN,336.1070115944133,NaN,NaN,334.0995999999995,335.79213755112113,332.40706244887787,334.1349711878237,334.20884997210936,335.2892854966787,333.12841444754,25356,43946.2,53.36372421114492,53.39121065872897,NaN,NaN,NaN,NaN,0.6838018092808085,14.677527573861395,94303026,0.1119487021857973,0.21820399792187573,0.10625529573607842
2025-09-04T14:00:00-04:00,334.86,335.36,334.86,335.26,NaN,NaN,NaN,336.1070115944133,NaN,NaN,334.1227999999994,335.84624209133153,332.3993579086673,334.1349711878237,334.2151245312056,335.2947396800725,333.13550938233874,25242,42689.5,57.33634033123245,53.946701242537166,NaN,NaN,NaN,NaN,0.6721016800464678,15.136394715043725,94328268,0.10865501190471452,0.24207406061697156,0.13341904871225704
2025-09-04T14:05:00-04:00,335.25,335.41,334.9,335.3,NaN,NaN,NaN,336.1070115944133,NaN,NaN,334.13979999999947,335.8923398260997,332.3872601738992,334.1349711878237,334.2238306122444,335.3026391603262,333.1450220641626,34010,41559.63333333333,57.7058522076296,54.931291509518935,NaN,NaN,NaN,NaN,0.6605229886145806,15.646203156174842,94362278,0.10223106593102663,0.2612078811260403,0.1589768151950137
2025-09-04T14:10:00-04:00,335.29,335.45,335.18,335.45,NaN,NaN,NaN,336.1070115944133,NaN,NaN,334.20019999999937,335.92074056689603,332.4796594331027,334.18478019853256,334.2301471765089,335.3092645653892,333.15102978762866,21582,39807.166666666664,59.13519271417432,55.411058126159936,NaN,NaN,NaN,NaN,0.6326284894278235,16.189753253913196,94383860,0.10096882793680281,0.2851878501160172,0.1842190221792144
2025-09-04T14:15:00-04:00,335.4,336.06,335.35,335.99,NaN,NaN,NaN,336.1070115944133,NaN,NaN,334.2777999999994,335.96389864547973,332.59170135451905,334.69282415882606,334.2563257189162,335.34512625793735,333.167525179895,65833,40166.23333333333,63.86911579447136,56.298679777893895,NaN,NaN,NaN,NaN,0.6381550258972631,17.636588113260373,94449693,0.12766677761273343,0.3438024941951312,0.21613571658239777
2025-09-04T14:20:00-04:00,335.97,336.33,335.75,335.98,333.88910790498187,333.88910790498187,333.88910790498187,NaN,NaN,NaN,334.3544999999994,335.9937952761145,332.7152047238843,334.94625932706083,334.2793019640109,335.3793189666643,333.17928496135755,52109,40828.86666666667,63.72190102303387,57.42318375369818,NaN,NaN,NaN,NaN,0.634001095476029,19.323814167575197,94397584,0.13509938709300012,0.38500995044864794,0.24991056335564782
2025-09-04T14:25:00-04:00,335.98,336.15,335.3,335.4,333.88910790498187,NaN,NaN,NaN,NaN,NaN,334.40429999999935,336.01609652636165,332.79250347363705,334.94625932706083,334.2904838782613,335.3926405628712,333.1883271936514,33726,40130.5,55.70240447683795,57.923206571269745,NaN,NaN,NaN,NaN,0.6494295886563102,19.683316062547593,94363858,0.0933832376924616,0.36663961047122484,0.27325637277876325
2025-09-04T14:30:00-04:00,335.41,336.04,335.41,335.93,333.88910790498187,NaN,NaN,NaN,NaN,NaN,334.4416999999994,336.1057403968308,332.777659603168,334.94625932706083,334.30326872761236,335.40937254191465,333.1971649133101,34609,39931.86666666667,60.58401697941278,58.628824410716966,NaN,NaN,NaN,NaN,0.648756046609434,20.017139250736246,94398467,0.09367319542878727,0.39034786706474733,0.29667467163596006
2025-09-04T14:35:00-04:00,335.94,336,335.65,335.92,333.88910790498187,NaN,NaN,NaN,NaN,NaN,334.4854999999994,336.18716536146286,332.7838346385359,334.94625932706083,334.31059839780113,335.419212363877,333.20198443172524,19287,39365.76666666667,60.44866062602866,58.79507388995386,NaN,NaN,NaN,NaN,0.6274163289944761,20.327117925482856,94379180,0.0856015286392523,0.40367658243502547,0.31807505379577317
2025-09-04T14:40:00-04:00,335.9,336.3,335.8,335.875,333.9702443671402,NaN,NaN,NaN,NaN,NaN,334.5241999999994,336.2621083527116,332.78629164728716,334.94625932706083,334.3268666085846,335.4423102847507,333.21142293241854,39943,39337.1,59.801178889619,58.891037921514645,NaN,NaN,NaN,NaN,0.6183151626377278,21.104461648230636,94339237,0.07028336626659126,0.4059292616290122,0.33564589536242095
2025-09-04T14:45:00-04:00,335.9,336.07,335.6,336.07,333.9702443671402,NaN,NaN,NaN,NaN,NaN,334.55239999999947,336.34316211770147,332.76163788229746,334.94625932706083,334.338476123593,335.45802645991125,333.21892578727477,30427,39302.2,61.71489479320113,59.05472354147434,NaN,NaN,NaN,NaN,0.6077212224493166,21.253905236216355,94369664,0.06638229354165126,0.41862376228948506,0.3522414687478338
2025-09-04T14:50:00-04:00,336.09,336.37,336.06,336.18,334.21656563204306,NaN,NaN,NaN,NaN,NaN,334.6139999999994,336.4125605361896,332.81543946380924,335.14432468503304,334.355124550785,335.48338565388934,333.2268634476806,37454,39224.23333333333,62.791000413939905,59.48004491927925,NaN,NaN,NaN,NaN,0.586455420845794,21.885290954330824,94407118,0.06426593200134284,0.43257388374951233,0.3683079517481695
2025-09-04T14:55:00-04:00,336.2,336.62,336.17,336.33,334.4260399214956,NaN,NaN,NaN,NaN,NaN,334.6775999999994,336.4894357989301,332.8657642010687,335.41445974802645,334.37499611651896,335.5152370274553,333.2347552055826,41719,38438.833333333336,64.26599362948812,60.09459845994094,NaN,NaN,NaN,NaN,0.5767086050710937,22.843962423880846,94448837,0.06578536751905684,0.4505396611469905,0.3847542936279337
2025-09-04T15:00:00-04:00,336.39,336.61,336.02,336.6,334.4260399214956,NaN,NaN,NaN,NaN,NaN,334.75179999999943,336.5685925148997,332.93500748509916,335.41445974802645,334.3931893810217,335.54437058233833,333.2420081797051,38222,38627.6,66.81592740993068,60.51830025001034,NaN,NaN,NaN,NaN,0.5776579904231607,23.289844169279483,94487059,0.07701218037357327,0.48101951909490026,0.404007338721327
2025-09-04T15:05:00-04:00,336.61,337.25,336.54,336.86,334.92735249045364,NaN,NaN,NaN,NaN,NaN,334.82799999999935,336.67228305922777,332.98371694077093,335.8874542387369,334.4478133695218,335.643298997076,333.2523277419676,95887,40821.63333333333,69.10240101002165,61.64249144993011,NaN,NaN,NaN,NaN,0.5871109911072192,24.5872501047374,94582946,0.09292115822318114,0.5201587865003034,0.4272376282771223
2025-09-04T15:10:00-04:00,336.94,337.42,336.9,337.32,335.20542737725117,NaN,NaN,NaN,NaN,NaN,334.9053999999994,336.8347292519394,332.97607074805944,336.04996339098955,334.48015109976023,335.70524663225143,333.25505556726904,51718,40876.13333333333,72.68798146737956,62.73903724536918,NaN,NaN,NaN,NaN,0.585174491742418,25.99069677472563,94634664,0.1234825981237836,0.5815908759318518,0.4581082778080682
2025-09-04T15:15:00-04:00,337.3,337.3,336.93,337.2,335.20542737725117,NaN,NaN,NaN,NaN,NaN,334.9737999999994,336.979663964073,332.96793603592585,336.04996339098955,334.5003049338685,335.74238719947823,333.2582226682588,33726,40089.4,70.39303516218598,63.64526459926607,NaN,NaN,NaN,NaN,0.5712334566179585,27.293897254000417,94600938,0.1243301493593415,0.613520964507245,0.4891908151479035
2025-09-04T15:20:00-04:00,337.22,337.72,337,337.53,335.4301311433219,NaN,NaN,NaN,NaN,NaN,335.0601999999994,337.12598891526704,332.9944110847317,336.32717657023335,334.5557357925345,335.8488054110034,333.2626661740656,86348,41022.3,72.92466996007545,64.63022725968759,NaN,NaN,NaN,NaN,0.5818596382881063,28.981338895102688,94687286,0.13494375595517183,0.6578705100918683,0.5229267541366964
2025-09-04T15:25:00-04:00,337.58,337.58,336.74,336.88,335.4301311433219,NaN,NaN,NaN,NaN,NaN,335.10859999999934,337.2285594719162,332.9886405280825,336.32717657023335,334.5814181918137,335.89243088072175,333.2704055029057,46947,41172.73333333333,61.72833611550186,64.47731442547548,NaN,NaN,NaN,NaN,0.6002982355532398,29.750753119294693,94640339,0.08827327939755614,0.6332683533836416,0.5449950739860855
2025-09-04T15:30:00-04:00,336.86,336.99,336.75,336.765,335.4301311433219,NaN,NaN,NaN,NaN,NaN,335.1558999999994,337.3156691456345,332.9961308543643,336.32717657023335,334.59874911908855,335.9194658479646,333.2780323902125,35572,40307.03333333333,59.97391857796558,64.20960139368489,NaN,NaN,NaN,NaN,0.5745626472994376,30.465209184615844,94604767,0.04208605027972778,0.5976026368357452,0.5555165865560174
2025-09-04T15:35:00-04:00,336.75,337.5,336.74,337.35,335.4301311433219,NaN,NaN,NaN,NaN,NaN,335.2068999999994,337.4494859097247,332.9643140902741,336.32717657023335,334.6313524560808,335.9752423188332,333.28746259332837,58787,41145.1,65.36640083328645,64.89988684771693,NaN,NaN,NaN,NaN,0.5878081724923343,31.74855005244862,94663554,0.04319936421691717,0.6095157918271639,0.5663164276102467
2025-09-04T15:40:00-04:00,337.32,337.5,337.09,337.44,335.4301311433219,NaN,NaN,NaN,NaN,NaN,335.2558999999994,337.58286428046216,332.9289357195366,336.32717657023335,334.65941718482384,336.0242152189922,333.2946191506555,48982,41710.13333333333,66.12258442349936,65.29549880800882,NaN,NaN,NaN,NaN,0.5751075887428837,32.9402237154362,94712536,0.04221317674180203,0.6190828985374992,0.5768697217956972
2025-09-04T15:45:00-04:00,337.4,337.71,337.12,337.69,335.5338239735728,NaN,NaN,NaN,NaN,NaN,335.2998999999994,337.7240744909396,332.87572550905924,336.32717657023335,334.69420925219674,336.08624512602023,333.30217337837325,58554,42971.26666666667,68.199620804055,65.84913882072497,NaN,NaN,NaN,NaN,0.5761713324041045,34.283863118374114,94771090,0.050077373874801046,0.6394664391391984,0.5893890652643974
2025-09-04T15:50:00-04:00,337.68,338.71,337.66,338.7,336.24615015659225,NaN,NaN,NaN,NaN,NaN,335.3637999999994,337.9679847558294,332.7596152441694,337.07134209482723,334.79307336783376,336.28899031520547,333.29715642046204,132939,46513.166666666664,74.89603369369574,66.92734273530189,NaN,NaN,NaN,NaN,0.6100162372323794,36.386789785741364,94904029,0.11146385444777829,0.7287188833241203,0.617255028876342
2025-09-04T15:55:00-04:00,338.63,338.88,338.35,338.63,336.69200696765625,NaN,NaN,NaN,NaN,NaN,335.4307999999994,338.1906379377105,332.6709620622883,337.30407367586184,334.90517496040127,336.51410464362704,333.2962452771755,148614,49762.46666666667,73.73710331398337,67.78607191535777,NaN,NaN,NaN,NaN,0.6043007917157789,38.45211271324785,94755415,0.13400195903987067,0.7847574776761803,0.6507555186363096
2025-09-05T09:30:00-04:00,348.08,353.04,347.57,349.41,346.5044157418537,NaN,NaN,NaN,NaN,NaN,335.7153999999994,340.5030014205867,330.9277985794121,344.57425894068945,350.0066666666666,350.00667206146323,350.00666127187,840933,76407.7,92.63577135376062,69.91784126820211,NaN,NaN,NaN,NaN,1.5904221637360823,42.342404216902416,95596348,0.8231254043512134,1.6796622740753264,0.856536869724113
2025-09-05T09:35:00-04:00,349.31,350.82,348.13,350.445,346.5044157418537,NaN,NaN,NaN,NaN,NaN,336.0356999999995,342.3393075418916,329.7320924581074,344.57425894068945,349.95066858512064,350.0430291926346,349.85830797760667,309125,84975.5,93.14575305221535,71.98068122696834,NaN,NaN,NaN,NaN,1.6689634377549332,45.954817756010236,95905473,1.2701474343948436,2.4442211627176675,1.174073728322824
2025-09-05T09:40:00-04:00,350.4,354.6,349.72,354.13,347.6814717813171,NaN,NaN,NaN,NaN,NaN,336.42969999999946,344.49819165843786,328.36120834156105,345.66592572204127,350.8962202987704,352.24588598129134,349.54655461624947,566243,102386.63333333333,94.58388054029137,73.96410645056554,NaN,NaN,NaN,NaN,1.8983231922010089,49.409227491282856,96471716,1.708213240338171,3.3093402787455375,1.6011270384073666
2025-09-05T09:45:00-04:00,354.14,354.7,352.96,354.51,349.31776851852993,NaN,NaN,NaN,NaN,NaN,336.83869999999945,346.33259146990076,327.34480853009813,346.682740577633,351.4440026072322,353.1577824681835,349.73022274628096,359847,113815.76666666666,94.7072061876029,75.79302110610706,NaN,NaN,NaN,NaN,1.8870143927580805,52.61916725587227,96831563,1.902890582681212,3.9797402667588813,2.0768496840776693
2025-09-05T09:50:00-04:00,354.59,355.87,353.74,355.74,350.2074154040513,NaN,NaN,NaN,NaN,NaN,337.26969999999943,348.105308595842,326.43409140415685,348.3911924621064,352.1483707611404,354.2613139718996,350.03542755038126,492664,128880.16666666667,95.09641700105834,77.39362364422698,NaN,NaN,NaN,NaN,1.9043705075610744,55.62643460289117,97324227,1.9847193849748712,4.5577489152962585,2.5730295303213873
2025-09-05T09:55:00-04:00,355.7,355.82,353.58,354.49,350.2074154040513,NaN,NaN,NaN,NaN,NaN,337.6734999999994,349.49618011080156,325.8508198891973,348.7169539696851,352.3943016524829,354.53250624858657,350.25609705637925,282574,137454.1,88.01309778711115,78.65219954600734,NaN,NaN,NaN,NaN,1.928344042735284,58.28517858095731,97041653,1.8287359243596182,4.85894943577091,3.030213511411292
2025-09-05T10:00:00-04:00,354.49,354.74,352.41,354.67,350.2074154040513,NaN,NaN,NaN,NaN,NaN,338.08369999999945,350.78116491399953,325.3862350859994,348.7169539696851,352.5296677964558,354.6183131861848,350.44102240672674,273681,145735.4,88.14997747654334,79.73972151146934,NaN,NaN,NaN,NaN,1.9570337539684768,59.784504730623375,97315334,1.6189644554704712,5.053919080749381,3.43495462527891
2025-09-05T10:05:00-04:00,354.6,354.7,350.77,350.87,350.2074154040513,NaN,NaN,NaN,NaN,NaN,338.4370999999994,351.54805589049136,325.3261441095075,348.7169539696851,352.50078532643005,354.51845565978925,350.48311499307084,232957,152366.96666666667,69.98174790042812,80.32925092467836,NaN,NaN,NaN,NaN,2.0979599143993,59.94689966711143,97082377,1.1287920226010635,4.845944653530239,3.7171526309291756
2025-09-05T10:10:00-04:00,350.89,351.55,349.05,349.07,NaN,NaN,NaN,355.5245718777948,355.5245718777948,355.5245718777948,338.75049999999936,352.11160702758184,325.3893929724169,348.7169539696851,352.31139106642706,354.36912500519793,350.2536571276562,262655,160402.73333333334,63.32393079219079,80.56853751140873,NaN,NaN,NaN,NaN,2.1266770633707788,58.96492840428468,96819722,0.6136279289654585,4.484187542135999,3.87055961317054
2025-09-05T10:15:00-04:00,349.05,349.63,346.24,346.37,NaN,NaN,NaN,353.38436406516774,NaN,NaN,339.0080999999994,352.44999211243817,325.5662078875606,348.7169539696851,351.9404901492026,354.3053917232893,349.57558857511594,296635,168096.13333333333,54.888548594289404,79.82011949433752,NaN,NaN,NaN,NaN,2.2169144159871506,56.51923458976243,96523087,0.05097081997701158,3.934273138141805,3.883302318164793
2025-09-05T10:20:00-04:00,346.38,348.56,346.26,347.14,NaN,NaN,NaN,352.92530206220556,NaN,NaN,339.2784999999994,352.819537368035,325.73746263196375,348.7169539696851,351.79222665562367,354.2572551500536,349.32719816119373,129867,170688.06666666668,56.661600353218105,79.14433491788886,NaN,NaN,NaN,NaN,2.2228491005594977,54.24823319056321,96652954,-0.29062745490382325,3.520017999535014,3.8106454544388373
2025-09-05T10:25:00-04:00,347.07,348.29,346.64,347.87,NaN,NaN,NaN,352.92530206220556,NaN,NaN,339.55289999999945,353.22255619034905,325.88324380964985,348.7169539696851,351.5801839001644,354.1517577710874,349.0086100292414,215612,176750.93333333332,58.33360454995316,78.43961947116729,NaN,NaN,NaN,NaN,2.181931307662393,52.13944617702108,96868566,-0.47765349694869563,3.2135785832529677,3.6912320802016634
2025-09-05T10:30:00-04:00,347.84,348.57,347.16,348.01,NaN,NaN,NaN,352.92530206220556,NaN,NaN,339.8296999999994,353.6121809683363,326.04721903166245,348.7169539696851,351.4669357697975,354.0767620743667,348.8571094652283,135849,180125.6,58.6629817238033,77.28011575903213,NaN,NaN,NaN,NaN,2.1267933571150768,50.277809507555595,97004415,-0.5945561965574298,2.948036834504876,3.5425930310623057
2025-09-05T10:35:00-04:00,348.04,348.46,347.03,347.57,NaN,NaN,NaN,352.92530206220556,NaN,NaN,340.1094999999994,353.94105482953626,326.27794517046254,348.7169539696851,351.38335474128974,354.02334946597205,348.7433600166074,99452,182797.76666666666,57.13431121316182,76.09420203754486,NaN,NaN,NaN,NaN,2.077022403035429,48.46903380980495,96904963,-0.6970378421319614,2.6712957283973537,3.368333570529315
2025-09-05T10:40:00-04:00,347.56,348.38,346.66,347.2,NaN,NaN,NaN,352.89040720562036,NaN,NaN,340.3646999999994,354.2392074738681,326.4901925261307,348.7169539696851,351.27992095602957,353.9609514912493,348.5988904208098,120327,185477.23333333334,55.81711382312539,73.46429792821378,NaN,NaN,NaN,NaN,2.0515208028186107,46.552546996000316,96784636,-0.7790524665104721,2.3945179873912252,3.1735704539016973
2025-09-05T10:45:00-04:00,347.2,347.21,344.77,345.34,NaN,NaN,NaN,351.44902505991035,NaN,NaN,340.58469999999943,354.41889262705166,326.7505073729472,347.89256317574814,351.04406412933133,353.89418537594673,348.19394288271593,206667,191351.9,49.623588269801665,70.35557187232709,NaN,NaN,NaN,NaN,2.0792693169029954,43.66593894810421,96577969,-0.9372521173138191,2.0020053072594237,2.939257424573243
2025-09-05T10:50:00-04:00,345.27,348.25,344.7,348.21,NaN,NaN,NaN,351.44902505991035,NaN,NaN,340.86929999999944,354.7337418583085,327.00485814169036,347.25705054059847,350.91077573601206,353.80318527466204,348.01836619736207,166724,195660.9,57.46616437255278,67.70430643177433,NaN,NaN,NaN,NaN,2.1843215085527823,41.45617743543956,96744693,-0.8309162426038035,1.9006121213184883,2.731528363922292
2025-09-05T10:55:00-04:00,348.18,349.17,346.62,346.64,NaN,NaN,NaN,351.44902505991035,NaN,NaN,341.1210999999995,354.93822651611083,327.30397348388817,344.3456404324788,350.8108467556901,353.718727659687,347.9029658516932,149610,199257.26666666666,52.638496066129065,64.69939856595477,NaN,NaN,NaN,NaN,2.210441400799013,39.795024411532815,96595083,-0.8458055288273139,1.6742714528881493,2.520076981715463
2025-09-05T11:00:00-04:00,346.62,347.08,345.28,345.91,NaN,NaN,NaN,351.44902505991035,NaN,NaN,341.35449999999946,355.09283341429415,327.6161665857048,343.15936276553174,350.7302656483338,353.67735841753523,347.78317287913234,89284,200959.33333333334,50.51358247637907,61.51491038562053,NaN,NaN,NaN,NaN,2.1811241578847986,37.496671460621215,96505799,-0.8803612769191096,1.419625385566576,2.2999866624856855
2025-09-05T11:05:00-04:00,345.93,346.83,345.63,345.85,NaN,NaN,NaN,351.44902505991035,NaN,NaN,341.5706999999994,355.2448275422764,327.8965724577224,343.15936276553174,350.648096473667,353.63214623235007,347.66404671498395,94571,200915.46666666667,50.333732654038556,58.82352716182964,NaN,NaN,NaN,NaN,2.111043860893026,35.36248657763188,96411228,-0.8806677567050252,1.1991519666044042,2.0798197233094293
2025-09-05T11:10:00-04:00,345.8,347.25,344.94,347.19,NaN,NaN,NaN,351.44902505991035,NaN,NaN,341.81289999999944,355.44752168020716,328.17827831979173,343.15936276553174,350.5622291508982,353.57457590049,347.5498824013064,111468,202907.13333333333,54.25131961627496,56.40219445752475,NaN,NaN,NaN,NaN,2.1252550136863815,32.99062246341537,96522696,-0.7681394431555095,1.1196454193650425,1.887784862520552
2025-09-05T11:15:00-04:00,347.22,347.79,346.48,346.85,NaN,NaN,NaN,351.44902505991035,NaN,NaN,342.0460999999994,355.61835645066077,328.473843549338,343.15936276553174,350.5088659578026,353.52910840048196,347.4886235151232,83636,204570.8,53.106689533248776,55.19683314558337,NaN,NaN,NaN,NaN,2.067022512708783,31.074849732532616,96439060,-0.6962503173011023,1.017471965894174,1.7137222831952763
2025-09-05T11:20:00-04:00,346.8,348.26,346.58,348.22,NaN,NaN,NaN,351.44902505991035,NaN,NaN,342.31069999999943,355.838167318106,328.78323268189285,343.4661322705968,350.46001074445184,353.47653983297164,347.44348165593203,97247,204934.1,57.039894027976906,54.74797337671095,NaN,NaN,NaN,NaN,2.039378047515299,29.544059959038645,96536307,-0.5428864933122288,1.0351141665549903,1.5780006598672192
2025-09-05T11:25:00-04:00,348.24,348.79,347.77,348.56,NaN,NaN,NaN,351.44902505991035,NaN,NaN,342.5838999999994,356.0532964661558,329.114503533843,344.44490581647744,350.421832763227,353.42369406018355,347.4199714662704,104696,206859.06666666668,57.981818158882746,54.968921202753336,NaN,NaN,NaN,NaN,1.9665653298356374,28.400313544474713,96641003,-0.41099033763440884,1.0642627378242082,1.475253075458617
2025-09-05T11:30:00-04:00,348.6,349.17,348.06,348.15,NaN,NaN,NaN,351.44902505991035,NaN,NaN,342.8380999999994,356.23816953573527,329.4380304642635,345.13892465318196,350.38708357415635,353.3734734394841,347.4006937088286,103185,209112.83333333334,56.37658196338427,54.948562746336634,NaN,NaN,NaN,NaN,1.9053820919902356,27.53686158395873,96537818,-0.34639043273377257,1.0422650345414013,1.3886554672751739
2025-09-05T11:35:00-04:00,348.22,349.47,347.92,348.77,NaN,NaN,NaN,351.44902505991035,NaN,NaN,343.1166999999994,356.4189110358562,329.81448896414264,345.4701397225456,350.3609939098975,353.33113928289157,347.39084853690343,92618,210240.53333333333,58.258528930636565,54.94320020209974,NaN,NaN,NaN,NaN,1.8799976568480765,26.894155509570123,96630436,-0.26083526024046,1.062611391974599,1.323446652215059
2025-09-05T11:40:00-04:00,348.81,349.5,348.76,349.06,NaN,NaN,NaN,351.44902505991035,NaN,NaN,343.39269999999937,356.603745410664,330.18165458933476,345.93011177803646,350.34474133823767,353.2989891376805,347.39049353879483,77689,211197.43333333332,59.14631818457835,54.977724235012246,NaN,NaN,NaN,NaN,1.7985692527875001,26.313984199592884,96708125,-0.18709600824653694,1.0895766419068877,1.2766726501534247
2025-09-05T11:45:00-04:00,349.02,349.02,347.74,348.82,NaN,NaN,NaN,351.44902505991035,NaN,NaN,343.6630999999994,356.7534154875028,330.572784512496,345.93011177803646,350.3230258766724,353.26621204146034,347.3798397118844,72481,211661.66666666666,58.04601475061083,55.04284591625861,NaN,NaN,NaN,NaN,1.7643857347312495,24.971674893126966,96635644,-0.15802521192197982,1.07914113525095,1.2371663471729297
2025-09-05T11:50:00-04:00,348.84,349.05,347.61,348.15,NaN,NaN,NaN,351.44902505991035,NaN,NaN,343.91709999999944,356.8520324065617,330.98216759343717,345.93011177803646,350.30481038645763,353.2412288066716,347.3683919662437,54323,209041.13333333333,54.97154019846091,54.98244780021115,NaN,NaN,NaN,NaN,1.7412153251075888,23.626678333438893,96581321,-0.18555710143817739,1.005219970375208,1.1907770718133854
2025-09-05T11:55:00-04:00,348.15,348.5,346.93,346.96,NaN,NaN,NaN,351.44902505991035,NaN,NaN,344.13649999999944,356.89712525906737,331.3758747409315,345.93011177803646,350.2737819889214,353.20901625392656,347.3385477239163,67596,206340.53333333333,49.914651656815145,55.00323804214067,NaN,NaN,NaN,NaN,1.7289856590284747,22.01152201844915,96513725,-0.2798854537370512,0.8409202546420715,1.1208057083791227
2025-09-05T12:00:00-04:00,346.97,347.42,346.18,346.44,NaN,NaN,NaN,351.44902505991035,NaN,NaN,344.3456999999994,356.9059829602865,331.7854170397123,345.93011177803646,350.2230844518209,353.1681965792585,347.2779723243833,88575,181261.93333333332,47.843511042353356,54.315905661412145,NaN,NaN,NaN,NaN,1.6940581119550129,21.035963051377614,96425150,-0.3677399364259597,0.6611307878466732,1.028870724272633
2025-09-05T12:05:00-04:00,346.48,347.04,345.81,346.96,NaN,NaN,NaN,351.4094508244258,NaN,NaN,344.57689999999945,356.8932150155488,332.26058498445013,345.93011177803646,350.16418579875284,353.120920702222,347.20745089528367,103855,174419.6,50.07445685669364,54.13276000359533,NaN,NaN,NaN,NaN,1.6609111039582276,20.378177508765464,96529005,-0.3797227218362057,0.5542173219773758,0.9339400438135815
2025-09-05T12:10:00-04:00,346.94,347.62,346.91,347.38,NaN,NaN,NaN,351.4094508244258,NaN,NaN,344.80589999999944,356.8942799891606,332.71752001083826,345.93011177803646,350.1380857983208,353.09384477747517,347.1823268191664,58766,157503.7,51.865347808552684,54.229314670179164,NaN,NaN,NaN,NaN,1.5929888822469243,19.28706839652187,96587771,-0.3490387413480929,0.49764161712846544,0.8466803584765583
2025-09-05T12:15:00-04:00,347.34,347.55,346.68,347.24,NaN,NaN,NaN,351.4094508244258,NaN,NaN,345.0322999999995,356.86788840286937,333.19671159712965,345.93011177803646,350.1182530365519,353.07411691158387,347.1623891615199,43136,146946.66666666666,51.205975931013356,54.29161776139165,NaN,NaN,NaN,NaN,1.5413468192292872,18.443602922652683,96544635,-0.32816292539061787,0.436476701738286,0.7646396271289039
2025-09-05T12:20:00-04:00,347.33,347.8,346.43,347.78,NaN,NaN,NaN,351.4094508244258,NaN,NaN,345.2703999999995,356.8354284635248,333.70537153647416,345.93011177803646,350.0992277394321,353.0538732651225,347.14458221374167,44658,132013.13333333333,53.65346523040336,54.24891387668653,NaN,NaN,NaN,NaN,1.5291077607129098,17.660384982631292,96589293,-0.27038506062988543,0.42665830134154703,0.6970433619714325
2025-09-05T12:25:00-04:00,347.79,348,347.42,347.77,NaN,NaN,NaN,351.4094508244258,NaN,NaN,345.50439999999946,356.78530911949247,334.22349088050646,345.93011177803646,350.0807388918884,353.031207751626,347.1302700321508,51353,124305.76666666666,53.59984747329253,54.28413944383251,NaN,NaN,NaN,NaN,1.461314349233415,16.744046544284103,96537940,-0.22698997058817638,0.41330589873621193,0.6402958693243883
2025-09-05T12:30:00-04:00,347.8,347.98,347.16,347.32,NaN,NaN,NaN,351.4094508244258,NaN,NaN,345.7271999999994,356.6984582980445,334.7559417019543,345.5172715379433,350.06054388587415,353.0083354223686,347.1127523493797,51632,116904.13333333333,51.12395104033001,53.86157208757202,NaN,NaN,NaN,NaN,1.4155061814310277,16.119723204478223,96486308,-0.2224469834481495,0.3622371400142015,0.584684123462351
2025-09-05T12:35:00-04:00,347.32,347.53,346.86,347.31,NaN,NaN,NaN,351.4094508244258,NaN,NaN,345.9467999999994,356.591584781401,335.30201521859783,345.5172715379433,350.03481969937155,352.9814240533796,347.0882153453635,60899,111168.86666666667,51.06749821628951,53.36769209167251,NaN,NaN,NaN,NaN,1.362255739900237,15.80131594687027,96425409,-0.21390711885787694,0.31730022489000476,0.5312073437478817
2025-09-05T12:40:00-04:00,347.32,348.51,347.24,348.2,NaN,NaN,NaN,351.4094508244258,NaN,NaN,346.1787999999994,356.4993274207514,335.8582725792474,345.9622637460655,350.0155462724882,352.95494659737557,347.0761459476009,63477,104529.6,55.75069499096845,53.32298587935709,NaN,NaN,NaN,NaN,1.355666044193076,14.818534244595153,96488886,-0.14538632769876025,0.34947443412443135,0.4948607618231916
2025-09-05T12:45:00-04:00,348.18,348.52,347.76,348.235,NaN,NaN,NaN,351.4094508244258,NaN,NaN,346.4062999999994,356.39115329098246,336.4214467090164,346.10181099685235,350.00259562376544,352.93570006699684,347.06949118053404,47791,96234.8,55.92932622429589,53.15661425747561,NaN,NaN,NaN,NaN,1.3131184696078555,13.915375290889385,96536677,-0.09709536460236545,0.37349155607023476,0.4705869206726002
2025-09-05T12:50:00-04:00,348.22,348.59,347.97,348.34,NaN,NaN,NaN,351.4094508244258,NaN,NaN,346.6266999999994,356.28057271733536,336.97282728266345,346.34544879748194,349.99205762357286,352.91911839663163,347.0649968505141,42377,93318.46666666666,56.49671266982775,52.967356720707706,NaN,NaN,NaN,NaN,1.263610007493005,13.1469617725474,96579054,-0.059327021457839524,0.3964281438503008,0.4557551653081403
2025-09-05T12:55:00-04:00,348.34,349.07,348.18,349.03,NaN,NaN,NaN,351.4094508244258,NaN,NaN,346.8632999999994,356.15449983868916,337.57210016130966,346.82935903798557,349.97810729120016,352.8914674915627,347.0647470908376,78412,88745.13333333333,60.12938845027948,53.11616912782689,NaN,NaN,NaN,NaN,1.2369235783863608,12.911396710588402,96657466,0.007334620016882898,0.46492344032924393,0.45758882031236103
2025-09-05T13:00:00-04:00,349.04,349.1,348.61,348.88,NaN,NaN,NaN,351.4094508244258,NaN,NaN,347.0902999999994,356.0052764801972,338.17532351980157,347.06248723038846,349.9705524597774,352.87546408044653,347.0656408391083,47252,85791.9,58.97643979646306,53.402233384827056,NaN,NaN,NaN,NaN,1.183571894215907,12.722466728385603,96610214,0.034987953040085895,0.5013237616124684,0.4663358085723825
2025-09-05T13:05:00-04:00,348.85,349.62,348.54,349.59,NaN,NaN,NaN,351.4094508244258,NaN,NaN,347.3444999999994,355.7930618304176,338.8959381695812,347.4499897843108,349.9629189782114,352.85334396188495,347.07249399453787,74656,84965.36666666667,62.62909415317915,54.31040784885305,NaN,NaN,NaN,NaN,1.1761739017719124,13.056837516646826,96684870,0.09154544689115396,0.580767617186325,0.489222170295171
2025-09-05T13:10:00-04:00,349.55,350.54,349.25,350.38,NaN,NaN,NaN,351.4094508244258,NaN,NaN,347.61679999999944,355.54552518393643,339.68807481606245,348.15899182744863,349.9649372313227,352.8241119572294,347.10576250541607,155051,86122.83333333333,66.23185819085214,55.623861216602926,NaN,NaN,NaN,NaN,1.1843043373596345,14.143746864359413,96839921,0.1681514340122423,0.699411462810474,0.5312600287982316
2025-09-05T13:15:00-04:00,350.37,351.55,350.3,351.49,347.0053786055791,347.0053786055791,347.0053786055791,NaN,NaN,NaN,347.8995999999994,355.33682659076936,340.46237340922943,349.0201934619589,349.98753232832246,352.8229289595273,347.1521356971176,144548,84052.2,70.53070968187231,57.08502213268712,NaN,NaN,NaN,NaN,1.1889968846910892,15.842831555988553,96984469,0.2733460171707842,0.8729425502617119,0.5995965330909276
2025-09-05T13:20:00-04:00,351.48,353,351.46,352.2,348.27854321441646,NaN,NaN,NaN,NaN,NaN,348.1947999999995,355.10066590096983,341.2889340990291,350.2061547695671,350.04379723931174,352.8650201912335,347.22257428739,189945,84826.23333333334,72.90661234060696,58.58796959926242,NaN,NaN,NaN,NaN,1.2140685357845844,18.18444356613583,97174414,0.36479482820512055,1.0555900683473283,0.6907952401422077
2025-09-05T13:25:00-04:00,352.3,352.88,351.81,352.08,348.4272457955793,NaN,NaN,NaN,NaN,NaN,348.4825999999994,354.7865023598406,342.17869764015825,350.2061547695671,350.07345023881726,352.8872343952455,347.259666082389,102364,83251.36666666667,71.85220924347122,60.06270055015227,NaN,NaN,NaN,NaN,1.2037779260856851,20.358797575558302,97072050,0.3890340556128764,1.1770878096583033,0.7880537540454269
2025-09-05T13:30:00-04:00,352.04,352.27,351.25,351.89,348.4272457955793,NaN,NaN,NaN,NaN,NaN,348.7463999999994,354.4677383191654,343.02506168083346,350.2061547695671,350.09523038976425,352.89788983485454,347.29257094467397,97405,83522.06666666667,70.12296218383162,61.23909318968286,NaN,NaN,NaN,NaN,1.1906509313652778,21.61724763704689,96974645,0.3645230339418687,1.2437075464727627,0.879184512530894
2025-09-05T13:35:00-04:00,351.93,352.28,350.87,351.26,348.4272457955793,NaN,NaN,NaN,NaN,NaN,348.99899999999946,353.9786200660564,344.0193799339425,350.2061547695671,350.11282580045497,352.90177661665314,347.3238749842568,100300,83713.03333333334,64.5735943447003,62.02293225192627,NaN,NaN,NaN,NaN,1.2063187219820415,22.295483694580387,96874345,0.2818306150466161,1.2314727813391642,0.949642166292548
2025-09-05T13:40:00-04:00,351.3,351.4,349.56,350.42,348.4272457955793,NaN,NaN,NaN,NaN,NaN,349.0191999999994,354.01349769261594,344.02490230738283,350.2061547695671,350.11686789883794,352.88978561159445,347.34395018608143,92316,83074.63333333333,57.98459713766265,62.512978401735744,NaN,NaN,NaN,NaN,1.2515816704118936,21.465171511155987,96782029,0.15296203839144518,1.1408447142818545,0.9878826758904093
2025-09-05T13:45:00-04:00,350.43,351.02,349.81,350.34,348.4272457955793,NaN,NaN,NaN,NaN,NaN,349.0170999999994,354.0090856132072,344.0251143867916,350.2061547695671,350.1192233090554,352.8802742231753,347.35817239493554,68972,82585.83333333333,57.38404474290186,62.96416029649377,NaN,NaN,NaN,NaN,1.2486115510967568,20.69416734083333,96713057,0.05005943744160524,1.050456972692416,1.0003975352508108
2025-09-05T13:50:00-04:00,350.27,350.77,349.98,349.995,348.4272457955793,NaN,NaN,NaN,NaN,NaN,348.9343999999994,353.7174666483368,344.151333351662,350.2061547695671,350.11993017250506,352.8734289667285,347.3664313782816,44029,80811.9,54.75050324682054,62.89271802905464,NaN,NaN,NaN,NaN,1.2158535831612716,19.97823489696229,96669028,-0.048199645095950316,0.9401479788808729,0.9883476239768232
2025-09-05T13:55:00-04:00,349.98,350.31,349.25,350.14,348.4272457955793,NaN,NaN,NaN,NaN,NaN,348.8469999999994,353.37209270650294,344.3219072934959,350.2061547695671,350.11812439102437,352.86036762347544,347.3758811585733,66577,79541.26666666666,55.67130792580947,62.87428815059132,NaN,NaN,NaN,NaN,1.2047211843640382,18.562814313878295,96735605,-0.10701684476893125,0.8545765680156592,0.9615934127845904
2025-09-05T14:00:00-04:00,350.17,350.3,349.6,349.81,348.4272457955793,NaN,NaN,NaN,NaN,NaN,348.7283999999994,352.8141451905965,344.6426548094023,350.2061547695671,350.11661711996624,352.84928054974796,347.3839536901845,57303,78011.86666666667,53.026597391021106,62.626422773533704,NaN,NaN,NaN,NaN,1.1686696711951774,17.248495201014585,96678302,-0.16809881885785338,0.7514698892122738,0.9195687080701271
2025-09-05T14:05:00-04:00,349.83,350.23,349.42,349.91,348.4272457955793,NaN,NaN,NaN,NaN,NaN,348.63679999999937,352.3938950270898,344.87970497290894,350.2061547695671,350.1145576174626,352.83661093798736,347.39250429693783,64380,77070.6,53.743711467299896,62.170302989035164,NaN,NaN,NaN,NaN,1.1430504089669509,16.22224654092283,96742682,-0.19957356500721934,0.670101751811103,0.8696753168183223
2025-09-05T14:10:00-04:00,349.91,351.19,349.83,351.17,348.4272457955793,NaN,NaN,NaN,NaN,NaN,348.5667999999994,351.9869712007693,345.14662879922946,350.1099238156537,350.1210708933187,352.8294143514202,347.41272743521716,88033,77415.4,61.68150652194874,62.363522040855564,NaN,NaN,NaN,NaN,1.1585468083264554,15.851628840266695,96830715,-0.13635775751587764,0.6992281199234753,0.835585877439353
2025-09-05T14:15:00-04:00,351.17,352.04,351,351.87,348.4272457955793,NaN,NaN,NaN,NaN,NaN,348.58679999999936,352.0716935482346,345.10190645176414,349.54393905252294,350.1394446386827,352.8364261534606,347.44246312390476,102081,78402.06666666667,65.24933819447175,62.55068232951931,NaN,NaN,NaN,NaN,1.1500791791602814,16.233399522618946,96932796,-0.05253272737744208,0.7699199682175504,0.8224526955949925
2025-09-05T14:20:00-04:00,351.82,351.95,351.06,351.18,348.4272457955793,NaN,NaN,NaN,NaN,NaN,348.6289999999993,352.1866194291682,345.07138057083034,349.3941512420183,350.1487549672307,352.8378928353274,347.45961709913394,62822,78685.36666666667,59.3802124829475,62.06127906466899,NaN,NaN,NaN,NaN,1.131502094934546,16.587900870517466,96869974,-0.04877130233956206,0.7614885676705399,0.8102598700101019
2025-09-05T14:25:00-04:00,351.2,351.37,350.93,351.18,348.4272457955793,NaN,NaN,NaN,NaN,NaN,348.7251999999993,352.2933927978732,345.1570072021254,349.3573025731521,350.15465512425715,352.83704246691303,347.47226778160126,49786,78091.7,59.3802124829475,61.26481497903149,NaN,NaN,NaN,NaN,1.082109088153507,16.745158464310677,96869974,-0.05124402630726932,0.7462048371260153,0.7974488634332846
2025-09-05T14:30:00-04:00,351.15,351.54,351.09,351.17,348.4272457955793,NaN,NaN,NaN,NaN,NaN,348.8057999999993,352.40901376589824,345.20258623410035,349.47967364681733,350.1655167142754,352.83701121163375,347.494022216917,84168,77944.8,59.290572200070855,60.29224068327892,NaN,NaN,NaN,NaN,1.0369584389996882,17.04900447601195,96785806,-0.05801595095633405,0.724928924737867,0.782944875694201
2025-09-05T14:35:00-04:00,351.22,351.24,350.2,350.36,348.4272457955793,NaN,NaN,NaN,NaN,NaN,348.8555999999993,352.47449687097816,345.23670312902044,349.47967364681733,350.16917107823156,352.82970301090864,347.50863914555447,73092,76919.36666666667,52.391481525736914,58.90218870344075,NaN,NaN,NaN,NaN,1.0371756933568548,16.181715903829627,96712714,-0.11804943678942181,0.6353830797074238,0.7534325164968456
2025-09-05T14:40:00-04:00,350.36,350.44,349.72,349.87,348.4272457955793,NaN,NaN,NaN,NaN,NaN,348.89279999999934,352.51440139201094,345.27119860798774,349.47967364681733,350.1679354158194,352.81815704722095,347.5177137844178,67991,77226.86666666667,48.69976124159217,57.371960064709356,NaN,NaN,NaN,NaN,1.014520286688506,15.212694591842407,96644723,-0.18762847182970455,0.518896926709715,0.7065253985394195
2025-09-05T14:45:00-04:00,349.89,349.98,349.4,349.65,348.4272457955793,NaN,NaN,NaN,NaN,NaN,348.9343999999993,352.542025058502,345.3267749414966,349.47967364681733,350.162408753522,352.7981903219572,347.52662718508685,99649,79110.63333333333,47.09520092762117,56.12350339206085,NaN,NaN,NaN,NaN,0.9834831233536155,14.653458273393879,96545074,-0.24188461172291809,0.4041696338857719,0.64605424560869
2025-09-05T14:50:00-04:00,349.66,350.06,348.14,348.29,NaN,NaN,NaN,352.51081807575446,352.51081807575446,352.51081807575446,348.9561999999993,352.534694968937,345.37770503106157,349.47967364681733,350.14186599791583,352.7623967349636,347.52133526086806,138707,82245.6,38.623321846743586,54.74055515699519,NaN,NaN,NaN,NaN,1.0503771859712157,15.271487113841179,96406367,-0.35589329407834625,0.20118762801075718,0.5570809220891034
2025-09-05T14:55:00-04:00,348.31,348.89,347.87,348.75,NaN,NaN,NaN,351.77487179958376,NaN,NaN,349.0243999999992,352.45139147401125,345.5974085259872,349.47967364681733,350.1255594819798,352.7380855941891,347.5130333697705,90433,83548.26666666666,42.39770910206589,53.670102611221196,NaN,NaN,NaN,NaN,1.0482073869732704,16.054414600085856,96496800,-0.3844178879753291,0.07655856211994205,0.46097645009527116
2025-09-05T15:00:00-04:00,348.7,349.3,348,349.17,NaN,NaN,NaN,351.77487179958376,NaN,NaN,349.0435999999993,352.46287363086185,345.6243263691367,349.47967364681733,350.11136842770384,352.7131355965607,347.509601258847,100117,85164.43333333333,45.682152421649356,53.02236326656611,NaN,NaN,NaN,NaN,1.0661925736180378,16.251802706369,96596917,-0.35954394540806145,0.011546518335194378,0.3710904637432558
2025-09-05T15:05:00-04:00,349.12,349.57,348.55,349.13,NaN,NaN,NaN,351.77487179958376,NaN,NaN,349.09339999999924,352.44301576346413,345.74378423653434,349.47967364681733,350.10301419427856,352.695831547702,347.5101968408551,75270,85643.46666666666,45.4165502979528,52.289880578862075,NaN,NaN,NaN,NaN,1.062893104073891,16.09569172973304,96521647,-0.33104141983449004,-0.042711311049856704,0.28833010878463333
2025-09-05T15:10:00-04:00,349.11,349.73,348.95,349.68,NaN,NaN,NaN,351.77487179958376,NaN,NaN,349.16879999999924,352.3958714654106,345.94172853458787,349.47967364681733,350.0972888514704,352.67937029320234,347.5152074097385,82351,86272.6,49.743341847040035,52.055362325720566,NaN,NaN,NaN,NaN,1.0426864537829008,15.747970949887907,96603998,-0.26335178620761207,-0.04085962397488174,0.22249216223273033
2025-09-05T15:15:00-04:00,349.68,349.88,349.3,349.54,NaN,NaN,NaN,351.77487179958376,NaN,NaN,349.24259999999924,352.3283856313798,346.1568143686187,349.47967364681733,350.0912130614692,352.65889272776167,347.52353339517674,109633,88334,48.685419147311364,51.69405573143566,NaN,NaN,NaN,NaN,1.0096374213698354,15.230364042633354,96494365,-0.21808279092272548,-0.050111326420676505,0.16797146450204897
2025-09-05T15:20:00-04:00,349.64,349.68,349,349.24,NaN,NaN,NaN,351.77487179958376,NaN,NaN,349.2835999999993,352.313170293415,346.2540297065836,349.07173891745384,350.08726810215114,352.64908515778836,347.5254510465139,47780,88514.1,46.40776622943795,50.60307428197061,NaN,NaN,NaN,NaN,0.9860918912719905,15.077441258706228,96446585,-0.19895346434373384,-0.08072036592761833,0.11823309841611551
2025-09-05T15:25:00-04:00,349.21,349.4,348.47,348.8,NaN,NaN,NaN,351.77487179958376,NaN,NaN,349.3225999999993,352.2750784440672,346.37012155593135,348.34539113396306,350.0806821180576,352.63697766429726,347.52438657181796,52559,87652.33333333333,43.21450615778573,49.02915770792161,NaN,NaN,NaN,NaN,0.9820853276097018,15.476093537492824,96394026,-0.20569178435403276,-0.13888163202642545,0.06681015232760731
2025-09-05T15:30:00-04:00,348.82,349.18,348.1,348.38,NaN,NaN,NaN,351.77487179958376,NaN,NaN,349.3257999999993,352.2738348442175,346.37776515578105,348.01431290717045,350.07041172504756,352.62115412812625,347.5196693219689,64684,88233.4,40.35972315894687,47.67055132763585,NaN,NaN,NaN,NaN,0.9890792327804362,16.19453744319084,96329342,-0.22654504377737977,-0.21637115239411742,0.010173891383262357
2025-09-05T15:35:00-04:00,348.35,348.97,348.04,348.3,NaN,NaN,NaN,351.6916607281916,NaN,NaN,349.32059999999933,352.2749301377153,346.3662698622834,347.5800381227373,350.06198976304194,352.6088378705921,347.5151416554918,49845,87406.36666666667,39.8201236673993,46.27340212652526,NaN,NaN,NaN,NaN,0.984859287581834,16.91814026731992,96279497,-0.23293776377759207,-0.2809983133387277,-0.04806054956113566
2025-09-05T15:40:00-04:00,348.31,348.75,348.1,348.52,NaN,NaN,NaN,351.5554488769102,NaN,NaN,349.3279999999993,352.27240146764865,346.38359853234994,347.5800381227373,350.0521658697873,352.59429393048686,347.51003780908775,59536,84222.53333333334,42.11219339178743,45.04637506879074,NaN,NaN,NaN,NaN,0.9609407670402729,17.590057175439778,96339033,-0.21025556944121607,-0.31088001136265575,-0.10062444192143968
2025-09-05T15:45:00-04:00,348.5,348.83,348.32,348.63,NaN,NaN,NaN,351.5554488769102,NaN,NaN,349.3251999999993,352.27198398303756,346.37841601696107,347.5800381227373,350.0423467926082,352.5787115089229,347.50598207629355,65926,81601.8,43.27552021826786,44.39523497540009,NaN,NaN,NaN,NaN,0.9287307122516814,18.068221187186644,96404959,-0.17707954822792546,-0.3219738772063465,-0.14489432897842106
2025-09-05T15:50:00-04:00,348.62,350.835,348.55,350.6,NaN,NaN,NaN,351.5554488769102,NaN,NaN,349.3559999999993,352.3231744139217,346.3888255860769,348.0973988749175,350.04113920482575,352.54496093138596,347.53731747826555,256354,83815.43333333333,59.1201518573668,45.139548590812566,NaN,NaN,NaN,NaN,1.0256070899479874,17.73840408332955,96661313,-0.01996088666936885,-0.16984543731513213,-0.14988455064576328
2025-09-05T15:55:00-04:00,350.6,351.28,350.46,350.79,NaN,NaN,NaN,351.5554488769102,NaN,NaN,349.39539999999926,352.3852895235081,346.4055104764904,348.679919099934,350.06264516322375,352.5360727972821,347.5892175291654,276881,89632.66666666667,60.27273522551021,46.08080104066179,NaN,NaN,NaN,NaN,1.0109208692374163,17.850427231098266,96938194,0.0930562541273939,-0.03356423298652089,-0.1266204871139148
2025-09-08T09:30:00-04:00,354.7,358.48,353.85,354.34,352.0663123760742,352.0663123760742,352.0663123760742,NaN,NaN,NaN,349.51919999999933,352.7918101880039,346.24658981199474,352.55493527994724,355.55666666666673,355.55666666666673,355.55666666666673,422574,100471.63333333333,74.6526237949046,48.654322608387574,NaN,NaN,NaN,NaN,1.487997950006172,21.073018392162084,97360768,0.386722127227384,0.35678217192031525,-0.029939955307068777
2025-09-08T09:35:00-04:00,354.37,354.89,352.51,353.65,352.0663123760742,NaN,NaN,NaN,NaN,NaN,349.6529999999993,353.04113931276646,346.2648606872321,352.55493527994724,354.92173259494496,355.808469244456,354.03499594543393,216656,104350.16666666667,69.39487677623325,50.58269172797095,NaN,NaN,NaN,NaN,1.551712382148588,22.926590357949962,97144112,0.5067523631191059,0.6035004985918135,0.09674813547270769
2025-09-08T09:40:00-04:00,353.68,355.12,351.89,352.07,NaN,NaN,NaN,357.9369290955655,357.9369290955655,357.9369290955655,349.7655999999993,353.0927992069383,346.43840079306034,352.55493527994724,354.4972806734278,355.60831306813674,353.3862482787188,184496,107422.83333333333,59.12594267227297,51.54296246015836,NaN,NaN,NaN,NaN,1.671590069137976,24.15962121119771,96959616,0.45370625024528466,0.6638809482793135,0.21017469803402888
2025-09-08T09:45:00-04:00,352.08,352.55,350.76,352.14,NaN,NaN,NaN,356.18003250236444,NaN,NaN,349.8691999999994,353.1629263763825,346.57547362361635,352.55493527994724,354.06679731082477,355.48270831794684,352.6508863037027,157591,110376.8,59.41250286819485,52.542673358032786,NaN,NaN,NaN,NaN,1.6800479213424075,24.46737888499543,97117207,0.39922505688211507,0.7092060191366727,0.3099809622545576
2025-09-08T09:50:00-04:00,352.15,354.79,351.51,354.63,NaN,NaN,NaN,356.18003250236444,NaN,NaN,350.01419999999933,353.4901259834755,346.5382740165232,352.55493527994724,354.0064032506459,355.32580003153714,352.6870064697547,163235,114350.33333333333,68.00526241013227,53.84709625539652,NaN,NaN,NaN,NaN,1.7943302126750946,25.526982564096766,97280442,0.5002292088316029,0.9352674732940613,0.4350382644624584
2025-09-08T09:55:00-04:00,354.57,354.98,353.31,353.83,NaN,NaN,NaN,356.18003250236444,NaN,NaN,350.14599999999933,353.690249991555,346.6017500084437,352.55493527994724,354.0098073591102,355.2606181140908,352.7589966041296,129044,116432.56666666667,63.36377920777992,54.89555054542999,NaN,NaN,NaN,NaN,1.7854494831983032,26.570062509920707,97151398,0.48229352091164324,1.0379051656020124,0.5556116446903692
2025-09-08T10:00:00-04:00,353.83,353.98,351.75,352.45,NaN,NaN,NaN,356.18003250236444,NaN,NaN,350.23939999999936,353.7754501357424,346.7033498642563,352.55493527994724,353.9178061361093,355.16758098170163,352.6680312905169,98370,117801.46666666666,56.23384059671003,55.597413000235136,NaN,NaN,NaN,NaN,1.8172030915412827,26.46097261770683,97053028,0.35263537450091764,0.9964058628165162,0.6437704883155986
2025-09-08T10:05:00-04:00,352.4,352.72,351.43,351.76,NaN,NaN,NaN,356.18003250236444,NaN,NaN,350.3191999999994,353.8085153257449,346.8298846742539,352.55493527994724,353.7743367660192,355.0803830009304,352.468290531108,109090,119291.8,53.02129195468755,56.29789770001384,NaN,NaN,NaN,NaN,1.779545727859764,26.15217763333516,96943938,0.20297911050153983,0.8974943764425234,0.6945152659409836
2025-09-08T10:10:00-04:00,351.81,352.3,350.2,350.93,NaN,NaN,NaN,356.1366986133157,NaN,NaN,350.39139999999935,353.77735631434297,347.00544368565573,352.55493527994724,353.5605673494893,355.00413739776667,352.11699730121194,130978,120723.3,49.36779004970254,56.941331049353536,NaN,NaN,NaN,NaN,1.8024353187269253,25.100076654909753,96812960,0.03923653909378855,0.7435609398082192,0.7043244007144307
2025-09-08T10:15:00-04:00,350.92,352.13,350.55,351.52,NaN,NaN,NaN,356.1366986133157,NaN,NaN,350.4755999999993,353.75868369719154,347.19251630280706,352.55493527994724,353.43645724652174,354.92539433105526,351.9475201619882,98244,120595.4,51.90478445964466,57.80452110594249,NaN,NaN,NaN,NaN,1.786547081675001,24.123125746371873,96911204,-0.03421974612361145,0.6615497180599164,0.6957694641835278
2025-09-08T10:20:00-04:00,351.57,352.07,351.02,351.36,NaN,NaN,NaN,356.1366986133157,NaN,NaN,350.5387999999993,353.7654028951257,347.3121971048729,349.0043707925331,353.3653569291618,354.87202286187244,351.8586909964512,64612,120655.06666666667,51.15619532701448,58.450521244173,NaN,NaN,NaN,NaN,1.7339365758410732,23.2159570455867,96846592,-0.09502089058097485,0.5769933509573093,0.6720142415382842
2025-09-08T10:25:00-04:00,351.42,352.5,350.98,352.35,NaN,NaN,NaN,356.1366986133157,NaN,NaN,350.62109999999933,353.8182407792953,347.42395922070335,349.0043707925331,353.29381284072747,354.79462992179094,351.792995759664,94028,122129.8,55.438664268072685,59.31931724773049,NaN,NaN,NaN,NaN,1.7186553918524239,22.607002530028247,96940620,-0.07109585629853454,0.583144421165116,0.6542402774636505
2025-09-08T10:30:00-04:00,352.38,352.45,351.06,351.54,NaN,NaN,NaN,356.1366986133157,NaN,NaN,350.68509999999935,353.82462256921985,347.54557743077885,349.0043707925331,353.235667124997,354.7394588654559,351.7318753845381,70004,121657.66666666667,51.462960563838344,58.772375012478456,NaN,NaN,NaN,NaN,1.695180006720107,22.041544765581115,96870616,-0.11003003746618034,0.5167027306309251,0.6267327680971054
2025-09-08T10:35:00-04:00,351.565,351.69,350.65,350.65,NaN,NaN,NaN,355.8575730850284,NaN,NaN,350.71749999999935,353.82126432783076,347.61373567216793,349.0043707925331,353.1341749430285,354.6755454088861,351.5928044771709,92063,122290.03333333334,47.437524430830955,57.85557424142994,NaN,NaN,NaN,NaN,1.6483814348115295,21.19536519360273,96778553,-0.19117679537339916,0.3877617738803565,0.5789385692537556
2025-09-08T10:40:00-04:00,350.64,351.67,350.55,350.81,NaN,NaN,NaN,355.73722885389077,NaN,NaN,350.7560999999994,353.81517913636503,347.6970208636337,349.0043707925331,353.0443148560836,354.6121544332732,351.476475278894,89713,123014.1,48.22164186178619,55.9676469604929,NaN,NaN,NaN,NaN,1.6106399037535635,20.32941442256863,96868266,-0.22708345385295092,0.29508425193756693,0.5221677057905179
2025-09-08T10:45:00-04:00,350.8,350.85,349.74,350.3,NaN,NaN,NaN,354.8632639059867,NaN,NaN,350.77029999999934,353.8141491491452,347.7264508508535,348.21961556563025,352.8788581649668,354.5333489436062,351.2243673863274,135886,124222,45.87258572852758,54.28748331422821,NaN,NaN,NaN,NaN,1.57487991062831,18.889287162060004,96732380,-0.2749924737194155,0.17842711364124852,0.453419587360664
2025-09-08T10:50:00-04:00,350.25,351.04,349.81,349.92,NaN,NaN,NaN,354.8632639059867,NaN,NaN,350.7610999999994,353.8123838548061,347.70981614519263,348.21961556563025,352.7903265260333,354.48420653051824,351.0964465215484,78850,122226.76666666666,44.146945846921824,53.217554969560275,NaN,NaN,NaN,NaN,1.5502456312977178,17.696112736182116,96653530,-0.318989811422404,0.05468232308265897,0.373672134505063
2025-09-08T10:55:00-04:00,349.92,349.94,347.75,347.98,NaN,NaN,NaN,353.46614541847134,NaN,NaN,350.6908999999994,353.8320588247977,347.54974117520106,348.21961556563025,352.5190622981636,354.45819738485585,350.57992721147133,159883,124541.76666666666,36.58111389720289,51.58674147163227,NaN,NaN,NaN,NaN,1.595942371919309,17.6693423567216,96493647,-0.45705748263290424,-0.1976497187860673,0.25940776384683695
2025-09-08T11:00:00-04:00,347.92,349.22,347.82,348.68,NaN,NaN,NaN,353.1220024449044,NaN,NaN,350.62049999999937,353.7809368372939,347.46006316270484,348.21961556563025,352.38810756934294,354.42157970071224,350.3546354379736,85660,124059.86666666667,40.54076001646721,49.62499130065621,NaN,NaN,NaN,NaN,1.5819464882107894,17.644484147222546,96579307,-0.47732852203514475,-0.337252888697094,0.14007563333805073
2025-09-08T11:05:00-04:00,348.72,349.48,348.71,349.11,NaN,NaN,NaN,353.1220024449044,NaN,NaN,350.5610999999993,353.72122106771985,347.4009789322788,348.21961556563025,352.31824204173824,354.3851219721784,350.2513621112981,56031,123418.56666666667,42.899253335731224,48.163239452652725,NaN,NaN,NaN,NaN,1.5260931676243052,17.39360804353138,96635338,-0.4388471143135752,-0.4084832595539183,0.030363854759656916
2025-09-08T11:10:00-04:00,349.15,349.59,348.75,349.19,NaN,NaN,NaN,353.1220024449044,NaN,NaN,350.50709999999935,353.6668177662922,347.3473822337065,348.21961556563025,352.24455137218683,354.3416590738284,350.1474436705453,63341,122784.9,43.34947403467431,47.24292755536446,NaN,NaN,NaN,NaN,1.4770865127939958,17.060920495554218,96698679,-0.38689403093214925,-0.45325368390552967,-0.06635965297338041
2025-09-08T11:15:00-04:00,349.21,349.39,347.8,348.28,NaN,NaN,NaN,353.02310524438957,NaN,NaN,350.44749999999937,353.6601401918951,347.23485980810364,348.21961556563025,352.0961853712104,354.27772354526,349.91464719716083,111098,122833.73333333334,39.53125882361292,46.27935376028771,NaN,NaN,NaN,NaN,1.4851517618801373,17.38875373343713,96587581,-0.39151830613847816,-0.5557575356464781,-0.16423922950799996
2025-09-08T11:20:00-04:00,348.28,348.62,347.45,348.39,NaN,NaN,NaN,352.42137318782636,NaN,NaN,350.40689999999927,353.6708037306331,347.1429962693654,347.98655396200337,351.97238017474984,354.22681825649005,349.71794209300964,91141,124279.1,40.21673470586518,45.6257069500136,NaN,NaN,NaN,NaN,1.462640921745843,17.911166201675496,96678722,-0.3653753949647001,-0.6209584732138751,-0.255583078249175
2025-09-08T11:25:00-04:00,348.42,349.49,348.2,349.28,NaN,NaN,NaN,352.42137318782636,NaN,NaN,350.38569999999936,353.6648011028207,347.106598897178,347.98655396200337,351.89868666110914,354.1727262222772,349.62464709994106,73539,124978.43333333333,45.59094255470971,45.174718242518246,NaN,NaN,NaN,NaN,1.450309427335427,17.55516508000145,96752261,-0.27070811981948195,-0.5939682280235274,-0.3232601082040455
2025-09-08T11:30:00-04:00,349.28,349.73,348.84,349.28,NaN,NaN,NaN,352.42137318782636,NaN,NaN,350.37139999999926,353.66340245486515,347.07939754513336,347.6235945356821,351.8428913651187,354.1240631996875,349.5617195305499,64876,124984.83333333333,45.59094255470971,44.77720018735362,NaN,NaN,NaN,NaN,1.4102873253828996,17.004486967515543,96752261,-0.19423443810189311,-0.5660531558314119,-0.3718187177295188
2025-09-08T11:35:00-04:00,349.31,350.3,349.31,349.58,NaN,NaN,NaN,352.42137318782636,NaN,NaN,350.36019999999934,353.6590785734697,347.061321426529,347.6235945356821,351.78520642076387,354.061218230177,349.5091946113507,85354,126168.46666666666,47.43811061128953,44.205732069011965,NaN,NaN,NaN,NaN,1.3824096592841237,15.981267347652448,96837615,-0.11358502631929274,-0.5138000006286347,-0.400214974309342
2025-09-08T11:40:00-04:00,349.55,349.55,347.66,348,NaN,NaN,NaN,352.42137318782636,NaN,NaN,350.3239999999993,353.6853663892317,346.96263361076683,347.36451146545244,351.68672434033965,354.00032190205775,349.37312677862155,93772,127309.66666666667,39.778537963581115,43.37113045470788,NaN,NaN,NaN,NaN,1.4208089693352548,16.205973056874896,96743843,-0.1542644479881749,-0.5930455342945606,-0.43878108630638574
2025-09-08T11:45:00-04:00,348.03,348.36,346.63,346.92,NaN,NaN,NaN,351.83522706564514,NaN,NaN,350.2641999999993,353.756727085469,346.7716729145296,347.36451146545244,351.5204029669988,353.939291311773,349.1015146222246,127002,129345.53333333334,35.55280213274732,42.52222171913048,NaN,NaN,NaN,NaN,1.4428940429541666,17.003985596277385,96616841,-0.23659751764053494,-0.7345279833570544,-0.49793046571651944
2025-09-08T11:50:00-04:00,346.885,347.84,346.72,347.78,NaN,NaN,NaN,351.575671289934,NaN,NaN,350.19639999999924,353.74709291305464,346.64570708694384,347.36451146545244,351.42560058225956,353.89381260699975,348.9573885575194,79749,123458.7,40.93367642739536,42.00165275953113,NaN,NaN,NaN,NaN,1.419830182743151,17.744997240008264,96696590,-0.21637672991588652,-0.7684013781113777,-0.5520246481954911
2025-09-08T11:55:00-04:00,347.81,348.64,347.73,348.515,NaN,NaN,NaN,351.575671289934,NaN,NaN,350.1292999999992,353.6777509356766,346.5808490643218,347.36451146545244,351.3716306232055,353.8521733127184,348.8910879336926,60114,116233.13333333333,45.1487837811678,41.94995262043401,NaN,NaN,NaN,NaN,1.3834137411186378,17.66729040018915,96756704,-0.14042121993268797,-0.7275511731113511,-0.5871299531786631
2025-09-08T12:00:00-04:00,348.49,348.49,347.44,347.7,NaN,NaN,NaN,351.575671289934,NaN,NaN,350.0596999999992,353.65913462821993,346.4602653717785,347.36451146545244,351.32067462540135,353.8184484001608,348.82290085064193,51592,103867.06666666667,41.60348106395741,41.76827656450798,NaN,NaN,NaN,NaN,1.3613841881815916,17.78451448399099,96705112,-0.1321113096955152,-0.7522690902980571,-0.6201577806025419
2025-09-08T12:05:00-04:00,347.67,348.3,347.24,347.29,NaN,NaN,NaN,351.575671289934,NaN,NaN,349.9818999999992,353.6486440001932,346.3151559998052,347.36451146545244,351.2642110276928,353.78418517646304,348.74423687892255,54677,98467.76666666666,39.905807063395635,42.005754647807464,NaN,NaN,NaN,NaN,1.339856746168621,18.026401540593803,96650435,-0.14048870784795153,-0.7957686654124814,-0.6552799575645298
2025-09-08T12:10:00-04:00,347.29,347.86,347.11,347.62,NaN,NaN,NaN,351.53303910310797,NaN,NaN,349.91089999999923,353.62010567814394,346.2016943218545,347.36451146545244,351.241993382705,353.77081898077205,348.71316778463796,21507,93034.8,41.95874667893362,42.1070394094122,NaN,NaN,NaN,NaN,1.297724121442291,18.34054019101577,96671942,-0.11134095714977632,-0.7944561540017503,-0.683115196851974
2025-09-08T12:15:00-04:00,347.67,347.75,346.94,347.57,NaN,NaN,NaN,351.3194918711485,NaN,NaN,349.8550999999992,353.61914064310366,346.09105935689473,347.36451146545244,351.19170083839083,353.74130823118963,348.642093445592,48200,89388.43333333333,41.72615574051175,42.02324672403939,NaN,NaN,NaN,NaN,1.2628866841964133,18.7536006841564,96623742,-0.08419808707832155,-0.7883628056998759,-0.7041647186215544
2025-09-08T12:20:00-04:00,347.6,348.14,347.42,348.11,NaN,NaN,NaN,351.3194918711485,NaN,NaN,349.8198999999993,353.6155103544441,346.02428964555446,347.36451146545244,351.15277788644096,353.7122430666364,348.5933127062455,43697,85403.83333333333,45.25569234468246,42.15940517475426,NaN,NaN,NaN,NaN,1.2241090638966674,18.682043914072224,96667439,-0.021890385318864558,-0.731527700270135,-0.7096373149512705
2025-09-08T12:25:00-04:00,348.1,348.24,347.71,347.99,NaN,NaN,NaN,351.3194918711485,NaN,NaN,349.7866999999992,353.61655932417904,345.95684067581936,346.24160917236196,351.117682962099,353.6844938161089,348.55087210808915,41459,82484.33333333333,44.60908665424829,42.52210716265678,NaN,NaN,NaN,NaN,1.1745298450469075,18.498043519092317,96625980,0.017121913498184815,-0.6882349230785394,-0.7053568365767242
2025-09-08T12:30:00-04:00,348.01,348.06,346.95,347.47,NaN,NaN,NaN,351.2715880182857,NaN,NaN,349.7702999999993,353.6325410130354,345.90805898696317,346.0167003493784,351.06214636653436,353.6478301403549,348.4764625927138,58327,81149.56666666667,41.82063142719585,42.6366712141804,NaN,NaN,NaN,NaN,1.1699205704007007,18.942311189161515,96567653,0.01392192605778586,-0.6879544290044919,-0.7018763550622777
2025-09-08T12:35:00-04:00,347.48,347.58,346.54,347.44,NaN,NaN,NaN,350.79719765381816,NaN,NaN,349.74409999999915,353.6511836647148,345.8370163352835,346.0167003493784,350.989520110258,353.6042202529533,348.3748199675627,72695,79936.4,41.65884200191028,42.355806888980446,NaN,NaN,NaN,NaN,1.1606405296577909,19.657483128019777,96494958,0.015670768393564294,-0.6822878945703224,-0.6979586629638866
2025-09-08T12:40:00-04:00,347.4,347.87,347.18,347.58,NaN,NaN,NaN,350.79719765381816,NaN,NaN,349.7122999999992,353.6631931702766,345.76140682972175,346.0167003493784,350.95785752616985,353.5812058135227,348.334509238817,35971,76769.5,42.77150422130385,42.15441843659431,NaN,NaN,NaN,NaN,1.1270233489679484,19.942922754804293,96530929,0.03124305015114881,-0.6589048502749506,-0.6901479004260994
2025-09-08T12:45:00-04:00,347.57,347.71,346.95,347.14,NaN,NaN,NaN,350.79719765381816,NaN,NaN,349.6724999999992,353.6856574854302,345.6593425145682,346.0167003493784,350.9249304155895,353.55951237384414,348.2903484573348,35239,74669.33333333333,40.178005743719474,41.63583951748217,NaN,NaN,NaN,NaN,1.100807395470237,20.39294972347636,96495690,0.017577816946733438,-0.6681756292426826,-0.685753446189416
2025-09-08T12:50:00-04:00,347.12,347.3,346.81,347.3,NaN,NaN,NaN,350.5568686581527,NaN,NaN,349.6248999999992,353.6926593295269,345.5571406704714,346.0167003493784,350.8901299378178,353.5373702851319,348.2428895905037,36626,73736.46666666666,41.565567412790024,41.763484478139944,NaN,NaN,NaN,NaN,1.0571782957937923,20.925426026702727,96532316,0.024553964784382654,-0.6550609902089377,-0.6796149549933204
2025-09-08T12:55:00-04:00,347.29,347.4,345.87,346.12,NaN,NaN,NaN,350.1863291736912,NaN,NaN,349.55649999999923,353.74100964902544,345.371990350973,346.0167003493784,350.769336716089,353.4779885296159,348.0606849025621,111844,74330.33333333333,35.09951487179832,41.73110681664359,NaN,NaN,NaN,NaN,1.0909512746656624,22.12028678352837,96420472,-0.04146960379617215,-0.7314519597385356,-0.6899823559423635
2025-09-08T13:00:00-04:00,346.11,346.12,344.84,345.27,NaN,NaN,NaN,349.0444505748871,NaN,NaN,349.4770999999992,353.8298940868873,345.12430591311113,346.0167003493784,350.59228332191134,353.4228228355941,347.7617438082286,140037,76664.76666666666,31.319900503624226,41.04440853637423,NaN,NaN,NaN,NaN,1.1044547550466886,23.84528312853366,96280435,-0.12863256914899834,-0.8507730673786114,-0.722140498229613
2025-09-08T13:05:00-04:00,345.33,346.08,345.3,345.55,NaN,NaN,NaN,349.0444505748871,NaN,NaN,349.41209999999927,353.8984134489987,344.9257865509998,346.0167003493784,350.5367227090436,353.39921907862225,347.67422633946495,48129,75200.3,33.84698525481325,40.237137213063185,NaN,NaN,NaN,NaN,1.0834222725433538,25.44706544889571,96328564,-0.15206893242809127,-0.9122266637647272,-0.7601577313366359
2025-09-08T13:10:00-04:00,345.5,346.15,345.5,345.99,NaN,NaN,NaN,349.0444505748871,NaN,NaN,349.3642999999993,353.94354797784973,344.7850520221488,346.0167003493784,350.49062606330557,353.37598722508386,347.6052649015273,42861,73638.56666666667,37.72476884313955,39.96008634014762,NaN,NaN,NaN,NaN,1.0524635387902554,26.821848726025532,96371425,-0.12377670115869055,-0.9148786077849991,-0.7911019066263085
2025-09-08T13:15:00-04:00,346,346.86,345.99,346.8,NaN,NaN,NaN,349.0444505748871,NaN,NaN,349.3342999999992,353.96045867031216,344.7081413296862,345.7263602795027,350.44341258361277,353.34330625238,347.54351891484555,52506,70859.23333333334,44.20841964814226,40.26741581048667,NaN,NaN,NaN,NaN,1.0394304288766663,27.010013921265713,96423931,-0.04065046673762329,-0.8419149900483376,-0.8012645233107143
2025-09-08T13:20:00-04:00,346.76,347.55,346.44,347.485,NaN,NaN,NaN,349.0444505748871,NaN,NaN,349.3135999999992,353.96335011832406,344.66384988167437,345.61547057888174,350.3912715482009,353.2972098898067,347.4853332065951,70679,70586.86666666667,49.04035279725668,40.773244818938316,NaN,NaN,NaN,NaN,1.044471112528334,26.26675321070145,96494610,0.06460248663904111,-0.720511415011913,-0.7851139016509541
2025-09-08T13:25:00-04:00,347.45,347.73,347.04,347.44,NaN,NaN,NaN,349.0444505748871,NaN,NaN,349.2897999999992,353.9654128842002,344.61418711579825,345.61547057888174,350.3560291558206,353.26273451650945,347.4493237951317,53150,67029.1,48.7417048083869,41.274355466643684,NaN,NaN,NaN,NaN,1.0191517473477385,25.350592482473992,96441460,0.13147236833128362,-0.6207734412368495,-0.7522458095681331
2025-09-08T13:30:00-04:00,347.42,347.6,346.49,347.07,NaN,NaN,NaN,349.0444505748871,NaN,NaN,349.2191999999992,353.9200817729104,344.518318227088,345.5263764631054,350.3192489302394,353.23042845413084,347.4080694063479,50748,65865.36666666667,46.247848448578274,41.3452237597791,NaN,NaN,NaN,NaN,1.0256409082514726,25.0066555831635,96390712,0.1497386617375891,-0.5650724823961468,-0.7148111441337359
2025-09-08T13:35:00-04:00,347.1,347.25,346.75,346.83,NaN,NaN,NaN,349.0444505748871,NaN,NaN,349.1399999999992,353.8657240718066,344.4142759281918,345.50232517858836,350.28795787947774,353.20361721406454,347.37229854489095,42633,65418.76666666667,44.651949650149675,41.348285402343485,NaN,NaN,NaN,NaN,0.9880951290906531,24.687285605232333,96348079,0.14453862992748068,-0.5341378567243851,-0.6786764866518658
2025-09-08T13:40:00-04:00,346.825,346.95,346.47,346.91,NaN,NaN,NaN,349.0444505748871,NaN,NaN,348.9913999999992,353.5167477394406,344.46605226055783,345.50232517858836,350.26499269415103,353.18485213757197,347.3451332507301,30281,64316.76666666667,45.3291744833003,41.598895620636654,NaN,NaN,NaN,NaN,0.9518026198698895,24.652739672920696,96378360,0.14499517399695994,-0.4974325191556659,-0.6424276931526258
2025-09-08T13:45:00-04:00,346.93,347.23,346.69,346.75,NaN,NaN,NaN,349.0444505748871,NaN,NaN,348.8533999999992,353.22012666453907,344.4866733354594,345.50232517858836,350.2418374895643,353.16496923828515,347.3187057408435,31984,61679.63333333333,44.165247085963955,41.77792455521192,NaN,NaN,NaN,NaN,0.9223881470220416,24.20051879508747,96346376,0.13332650479992425,-0.4757695621527205,-0.6090960669526447
2025-09-08T13:50:00-04:00,346.77,347,345.43,346.26,NaN,NaN,NaN,349.0444505748871,NaN,NaN,348.73719999999923,353.06439639521676,344.4100036047817,345.50232517858836,350.19141645231326,353.13030188823245,347.2525310163941,59336,60619.46666666667,40.71710060449719,41.63118143972572,NaN,NaN,NaN,NaN,0.9686461365204667,24.869622342977756,96287040,0.09330597061921209,-0.4924636036786296,-0.5857695742978417
2025-09-08T13:55:00-04:00,346.27,346.35,345.4,345.63,NaN,NaN,NaN,349.03616243195046,NaN,NaN,348.6069999999992,352.9084964841255,344.30550351587283,345.50232517858836,350.14427118254713,353.1022415808776,347.18630078421666,51157,59873.4,36.744899241767186,41.38595954672913,NaN,NaN,NaN,NaN,0.9673142696261509,25.513535948068927,96235883,0.028465843150888404,-0.5501872703592312,-0.5786531135101196
2025-09-08T14:00:00-04:00,345.68,345.76,344.9,345.37,NaN,NaN,NaN,348.4647459577709,NaN,NaN,348.4217999999992,352.45934963348384,344.3842503665146,345.50232517858836,350.0468349872411,353.051881602492,347.04178837199015,98862,61006.26666666667,35.217911702224626,40.932555567403035,NaN,NaN,NaN,NaN,0.9596489646528553,26.48341916219502,96137021,-0.024984041731677564,-0.6098831656747166,-0.584899123943039
2025-09-08T14:05:00-04:00,345.41,345.93,345.35,345.7,NaN,NaN,NaN,348.4647459577709,NaN,NaN,348.25919999999917,352.0603600128092,344.4580399871891,345.50232517858836,350.0078734633451,353.0277248820914,346.98802204459884,43651,59616.166666666664,38.69988166603077,41.18972462413393,NaN,NaN,NaN,NaN,0.9325311814633644,27.105532058326364,96180672,-0.030783446602578146,-0.6233784321962617,-0.5925949855936835
2025-09-08T14:10:00-04:00,345.67,346.36,345.66,346.22,NaN,NaN,NaN,348.4647459577709,NaN,NaN,348.1345999999992,351.78348467384046,344.4857153261579,345.50232517858836,349.98088229976986,353.00778260669523,346.9539819928445,34007,57624,43.8237386198552,42.08285591815042,NaN,NaN,NaN,NaN,0.9159218113588377,26.998170197982656,96214679,0.005783078468043601,-0.585366137508629,-0.5911492159766726
2025-09-08T14:15:00-04:00,346.21,346.48,345.77,345.9,NaN,NaN,NaN,348.4647459577709,NaN,NaN,348.01739999999916,351.5680913359262,344.4667086640721,345.41138439314983,349.95351662227733,352.98751789944686,346.9195153451078,34694,54547.066666666666,41.52355989965793,42.63118267849648,NaN,NaN,NaN,NaN,0.9012131105474948,26.71119576452334,96179985,0.01336685158158979,-0.5744406514996854,-0.5878075030812752
2025-09-08T14:20:00-04:00,345.89,346.33,345.77,346.17,NaN,NaN,NaN,348.4647459577709,NaN,NaN,347.9221999999991,351.41011178832173,344.4342882116765,345.41138439314983,349.93719542155674,352.9751335251063,346.8992573180072,21142,52593.5,44.18549640688274,43.092663218763846,NaN,NaN,NaN,NaN,0.8768407455083881,26.444719504882546,96201127,0.04000919923325563,-0.5377960040397056,-0.5778052032729613
2025-09-08T14:25:00-04:00,346.2,346.71,345.95,346.53,NaN,NaN,NaN,348.4647459577709,NaN,NaN,347.8223999999991,351.1757882809982,344.46901171900004,345.41138439314983,349.91438190115224,352.9557387642176,346.8730250380869,32457,51671.6,47.60993308176545,43.33562846402265,NaN,NaN,NaN,NaN,0.868494977972074,25.571782386452195,96233584,0.0828528569767304,-0.47423913205204826,-0.5570919890287787
2025-09-08T14:30:00-04:00,346.535,346.855,345.95,346.83,NaN,NaN,NaN,348.4647459577709,NaN,NaN,347.73179999999905,350.939602837353,344.5239971626451,345.41138439314983,349.8858682584361,352.93001581425784,346.8417207026144,42991,51384.9,50.34404834844337,43.42874957482169,NaN,NaN,NaN,NaN,0.8711024795454995,24.529251885682893,96276575,0.12958734842996056,-0.395107803491328,-0.5246951519212886
2025-09-08T14:35:00-04:00,346.85,346.89,346.45,346.47,NaN,NaN,NaN,348.4647459577709,NaN,NaN,347.61419999999913,350.55627910210916,344.6721208978891,345.11481964763453,349.8734684624088,352.9185263971729,346.82841052764473,19263,50204.433333333334,47.16324050785109,43.316002124783424,NaN,NaN,NaN,NaN,0.8403094452922494,23.50303799115938,96257312,0.13389562590784526,-0.357325619536482,-0.49122124544432727
2025-09-08T14:40:00-04:00,346.475,346.72,345.96,346.72,NaN,NaN,NaN,348.4647459577709,NaN,NaN,347.5177999999991,350.24720884499715,344.7883911550011,345.11481964763453,349.85326468047543,352.90052751360815,346.8060018473427,30422,50501.6,49.547188942829315,43.55166930294421,NaN,NaN,NaN,NaN,0.8345730563428064,23.18917047109215,96287734,0.15000972708696014,-0.3037090865856271,-0.45371881367258726
2025-09-08T14:45:00-04:00,346.72,347.22,346.63,346.79,NaN,NaN,NaN,348.4647459577709,NaN,NaN,347.4405999999991,350.02581847494395,344.85538152505427,345.4848845744861,349.826555760914,352.8730447889247,346.7800667329033,46499,50444.9,50.22439363277494,43.94970101598887,NaN,NaN,NaN,NaN,0.8171035523183224,22.05850659238287,96334233,0.16084968003496547,-0.2526567136288804,-0.4135063936638459
2025-09-08T14:50:00-04:00,346.85,346.93,346.46,346.7,NaN,NaN,NaN,348.4647459577709,NaN,NaN,347.3583999999991,349.7650528131768,344.9517471868214,345.4848845744861,349.8112731016714,352.8581365749758,346.76440962836705,25399,49834.96666666667,49.30800193567083,44.23390297687248,NaN,NaN,NaN,NaN,0.7923104414384442,21.239270054347266,96308834,0.1572382156351022,-0.21695862411996814,-0.37419683975507034
2025-09-08T14:55:00-04:00,346.65,346.95,346.35,346.471,NaN,NaN,NaN,348.4647459577709,NaN,NaN,347.2818199999991,349.54881740488116,345.014822595117,345.4848845744861,349.79001332129434,352.83798423365215,346.7420424089365,34562,49605.066666666666,46.9601352229956,44.433537843803315,NaN,NaN,NaN,NaN,0.7785739813356958,20.630003798013288,96274272,0.13552916877341514,-0.2047853787883014,-0.34031454756171653
2025-09-08T15:00:00-04:00,346.47,346.82,346.38,346.8,NaN,NaN,NaN,348.4647459577709,NaN,NaN,347.219419999999,349.36079216241683,345.07804783758115,345.4848845744861,349.7692162038087,352.8176242355408,346.7208081720766,35100,48830.833333333336,50.59955377862788,45.13942735624122,NaN,NaN,NaN,NaN,0.754390125526003,20.064256559988877,96309372,0.13891628996202482,-0.1666691851091855,-0.3055854750712103
2025-09-08T15:05:00-04:00,346.8,346.98,346.48,346.54,NaN,NaN,NaN,348.4647459577709,NaN,NaN,347.19061999999906,349.32903234230207,345.05220765769604,345.5309767217095,349.752969632042,352.80162039176395,346.70431887232,27749,47332.63333333333,47.807718755254754,45.92962875006175,NaN,NaN,NaN,NaN,0.7362194022741457,19.229241428330106,96281623,0.11995042228800135,-0.1556474472112086,-0.27559786949920995
2025-09-08T15:10:00-04:00,346.57,346.66,345.48,346.22,NaN,NaN,NaN,348.4647459577709,NaN,NaN,347.1414199999991,349.2535357207076,345.02930427929056,345.5309767217095,349.7089396334199,352.7650237238923,346.6528555429475,65011,48300.63333333333,44.54973088671245,46.596187263239464,NaN,NaN,NaN,NaN,0.7679180163974214,19.79985448391143,96216612,0.08386590526237264,-0.17076548792124413,-0.25463139318361677
2025-09-08T15:15:00-04:00,346.22,346.3,345.71,345.86,NaN,NaN,NaN,348.4647459577709,NaN,NaN,347.0764199999991,349.1417217255661,345.0111182744321,345.5309767217095,349.6742335327344,352.7372853589269,346.61118170654186,50078,48795.26666666667,41.15206781257351,46.771343416563944,NaN,NaN,NaN,NaN,0.7552095866547507,20.32970946409409,96166534,0.036199506560752825,-0.20938200998267575,-0.24558151654342858
2025-09-08T15:20:00-04:00,345.83,346.14,345.67,345.97,NaN,NaN,NaN,348.398454277323,NaN,NaN,347.01201999999904,349.00937759488033,345.01466240511775,345.5309767217095,349.65362114400267,352.72078651589527,346.58645577211007,29944,48572.53333333333,42.592777991521906,46.68341765739728,NaN,NaN,NaN,NaN,0.7348374733222663,20.870848256308875,96196478,0.013684356184277074,-0.22847607131308223,-0.2421604274973593
2025-09-08T15:25:00-04:00,346.02,346.23,345.77,346.11,NaN,NaN,NaN,348.398454277323,NaN,NaN,346.9686199999991,348.9481079301732,344.98913206982496,345.5309767217095,349.63121857934675,352.70201045415575,346.56042670453775,33930,45975.4,44.456572912995355,46.89291858692138,NaN,NaN,NaN,NaN,0.7152062252278214,21.168807084594985,96230408,0.0099971428833604,-0.2296639988931588,-0.2396611417765192
2025-09-08T15:30:00-04:00,346.14,346.83,345.75,345.77,NaN,NaN,NaN,348.398454277323,NaN,NaN,346.916219999999,348.88108613538526,344.9513538646127,345.5309767217095,349.6014855094788,352.6761564533737,346.52681456558383,46740,42865.5,40.97713753666545,46.66375009619157,NaN,NaN,NaN,NaN,0.7412629234258331,20.20873190535025,96183668,-0.012351058545587629,-0.25509996495850373,-0.2427489064129161
2025-09-08T15:35:00-04:00,345.82,346.79,345.77,346.35,NaN,NaN,NaN,348.398454277323,NaN,NaN,346.85761999999903,348.7084617073853,345.00677829261275,345.5309767217095,349.57133673290593,352.64797634352186,346.49469712229,50969,42960.166666666664,48.39678564750566,46.71995385088731,NaN,NaN,NaN,NaN,0.7611727146097049,19.317233524622992,96234637,0.013516325110756428,-0.22585350002447058,-0.239369825135227
2025-09-08T15:40:00-04:00,346.36,346.89,346.24,346.65,NaN,NaN,NaN,348.398454277323,NaN,NaN,346.805019999999,348.5221578750248,345.0878821249732,345.5309767217095,349.5412124042524,352.61672255760044,346.46570225090437,56979,43430.76666666667,51.77373548232078,46.822074360449975,NaN,NaN,NaN,NaN,0.7532318064232958,18.288827862006688,96291616,0.05034854010447082,-0.17643415000463847,-0.2267826901091093
2025-09-08T15:45:00-04:00,346.65,346.94,346.6,346.86,NaN,NaN,NaN,348.398454277323,NaN,NaN,346.75061999999895,348.27407848189296,345.22716151810494,345.5309767217095,349.5065045479309,352.57781331879505,346.4351957770667,72234,44088.36666666667,54.04099481117048,47.31334252497278,NaN,NaN,NaN,NaN,0.7237152488216301,17.230143619641073,96363850,0.08626414913313013,-0.11895250369269661,-0.20521665282582674
2025-09-08T15:50:00-04:00,346.87,346.87,345.93,346.1,NaN,NaN,NaN,348.398454277323,NaN,NaN,346.712619999999,348.2039744937041,345.2212655062939,345.5309767217095,349.44954835670586,352.5227827061235,346.3763140072882,103169,45171.36666666667,45.672435057037376,47.036574390273366,NaN,NaN,NaN,NaN,0.7391641596200849,17.395091294710372,96260681,0.05762274437894449,-0.1331882223521461,-0.1908109667310906
2025-09-08T15:55:00-04:00,346.15,346.72,346.15,346.44,NaN,NaN,NaN,348.398454277323,NaN,NaN,346.70301999999896,348.19509064242857,345.21094935756935,345.29173698671093,349.3870044652321,352.4583612720607,346.3156476584035,123127,47503.933333333334,49.44423040397734,46.98084844535925,NaN,NaN,NaN,NaN,0.7306524339329362,17.54825699298901,96383808,0.0600877801369378,-0.11570124155991834,-0.17578902169685615
2025-09-09T09:30:00-04:00,348.44,350.2,346.9,348.94,345.74034460839573,345.74034460839573,345.74034460839573,NaN,NaN,NaN,346.726219999999,348.31733826396777,345.1351017360302,346.927289337196,348.67999999999995,348.6800066072494,348.6799933927505,208295,52755.5,67.37833715763,48.27158667549919,NaN,NaN,NaN,NaN,0.9470344029377259,19.17466170046348,96592103,0.2196297105690507,0.09874811651445725,-0.12088159405459345
2025-09-09T09:35:00-04:00,348.96,349.94,348.4,348.81,346.278056217105,NaN,NaN,NaN,NaN,NaN,346.732119999999,348.3516602143553,345.11257978564265,346.927289337196,348.837483386185,349.0204255517741,348.6545412205959,154355,56479.566666666666,66.06591217921587,49.636285029514916,NaN,NaN,NaN,NaN,0.9893890884421755,20.68489464311835,96437748,0.30091990749660813,0.2552682903161667,-0.04565161718044142
2025-09-09T09:40:00-04:00,348.87,349.95,347.96,349.19,346.278056217105,NaN,NaN,NaN,NaN,NaN,346.76191999999895,348.50195130375596,345.02188869624194,346.927289337196,348.90570143202933,349.08039312592285,348.7310097381358,193833,61931.3,68.02642771174678,50.881061739023416,NaN,NaN,NaN,NaN,1.0608612964105923,21.401667530539363,96631581,0.36076321861086325,0.4053024060831376,0.044539187472274394
2025-09-09T09:45:00-04:00,349.14,350.54,348.79,350.31,346.5323198176515,NaN,NaN,NaN,NaN,NaN,346.82231999999897,348.82179907065324,344.8228409293447,346.927289337196,349.1582242909784,349.61085270206996,348.70559587988686,194693,67354.93333333333,72.98115733002999,52.6791644943645,NaN,NaN,NaN,NaN,1.1100854895241214,22.512111846322288,96826274,0.450429770812508,0.6075764009879094,0.15714663017540142
2025-09-09T09:50:00-04:00,350.27,350.77,348.84,348.91,346.5515325532128,NaN,NaN,NaN,NaN,NaN,346.84811999999897,348.92008118352743,344.7761588164705,346.927289337196,349.2032478052863,349.64149561123196,348.76499999934066,111465,69092.56666666667,60.384652284735594,53.810230308509006,NaN,NaN,NaN,NaN,1.1686508117009704,23.707031281452156,96714809,0.39224135054143067,0.6474483183521897,0.2552069678107591
2025-09-09T09:55:00-04:00,348.85,348.88,347.72,348.38,346.5515325532128,NaN,NaN,NaN,NaN,NaN,346.86431999999894,348.9709801610192,344.75765983897867,346.927289337196,349.1116984811347,349.60553203966487,348.6178649226045,100600,70740.66666666667,56.414880772890704,54.90043123424595,NaN,NaN,NaN,NaN,1.1701757537223294,23.22355937324789,96614209,0.2990580012348728,0.6290294693543501,0.3299714681194773
2025-09-09T10:00:00-04:00,348.34,349,345.7,345.7,NaN,NaN,NaN,350.91931641329165,350.91931641329165,350.91931641329165,346.816119999999,348.91684317689464,344.71539682310333,346.927289337196,348.7675753719964,349.7081372394836,347.8270135045091,168468,73060.86666666667,41.542634122039196,54.82542095785432,NaN,NaN,NaN,NaN,1.3223060570278782,22.336819071364324,96445741,0.05093574263615086,0.39364114641466585,0.342705403778515
2025-09-09T10:05:00-04:00,345.68,347.37,345.5,346.44,NaN,NaN,NaN,350.097074758142,NaN,NaN,346.7851199999989,348.86123936698846,344.7090006330094,346.927289337196,348.5768427057785,349.6815909937248,347.47209441783224,100858,74967.76666666666,45.79203422415309,54.920811051508444,NaN,NaN,NaN,NaN,1.3614270529544588,21.670624628966454,96546599,-0.06315192644735096,0.2637654957193263,0.32691742216667724
2025-09-09T10:10:00-04:00,346.5,347.89,346.12,347.36,NaN,NaN,NaN,350.097074758142,NaN,NaN,346.78291999999897,348.8563631214578,344.70947687854016,346.927289337196,348.50203872123575,349.6248881080355,347.379189334436,66875,76063.36666666667,50.59994707824849,55.608154590192946,NaN,NaN,NaN,NaN,1.3906108348862818,20.53032608073893,96613474,-0.07561753186805953,0.23239550733160286,0.3080130391996624
2025-09-09T10:15:00-04:00,347.39,347.75,346.74,346.74,NaN,NaN,NaN,350.097074758142,NaN,NaN,346.76891999999896,348.8338629575477,344.7039770424502,346.927289337196,348.40422321707166,349.54620621672797,347.26224021741535,95744,78098.36666666667,47.53981937884923,55.546942713860346,NaN,NaN,NaN,NaN,1.3634243466801181,19.471477428813376,96517730,-0.12184178352510838,0.1557108097932769,0.2775525933183853
2025-09-09T10:20:00-04:00,346.75,347.11,345.65,346.26,NaN,NaN,NaN,350.097074758142,NaN,NaN,346.742519999999,348.7990446125077,344.68599538749027,346.7334577125155,348.28410077368676,349.4931354787364,347.0750660686371,86206,80267.16666666667,45.25781085787978,55.08151952640028,NaN,NaN,NaN,NaN,1.370322607631541,19.402780608008218,96431524,-0.1775899739704149,0.05556512585536666,0.23315509982578156
2025-09-09T10:25:00-04:00,346.3,346.94,345.59,346.63,NaN,NaN,NaN,350.0148277569762,NaN,NaN,346.732319999999,348.7859146420298,344.6787253579682,346.7334577125155,348.1976606146511,349.44333908797347,346.95198214132876,70708,81542.2,47.355577942272326,54.60398975005041,NaN,NaN,NaN,NaN,1.3688709928007181,19.385468403680232,96502232,-0.18173539475772185,0.005985856378629251,0.1877212511363511
2025-09-09T10:30:00-04:00,346.58,347.36,344.85,345,NaN,NaN,NaN,350.0148277569762,NaN,NaN,346.68631999999906,348.7894321495399,344.5832078504582,346.7334577125155,348.009553290165,349.3736117074688,346.6454948728612,128454,84390.96666666666,40.07055353180221,54.20385535539076,NaN,NaN,NaN,NaN,1.4503802076006662,19.923063157467364,96373778,-0.2805410053369645,-0.16295500553485454,0.11758599980210997
2025-09-09T10:35:00-04:00,345.09,345.37,344.12,345.18,NaN,NaN,NaN,348.6588513240217,NaN,NaN,346.667519999999,348.80703617936916,344.52800382062884,346.7334577125155,347.81832033925,349.33706519814695,346.2995754803531,109748,87407.13333333333,41.1472571250639,53.611214406896934,NaN,NaN,NaN,NaN,1.43606733562919,20.90489610872522,96483526,-0.31734885442130606,-0.2791000682245226,0.038248786196783444
2025-09-09T10:40:00-04:00,345.14,345.44,344.5,345.09,NaN,NaN,NaN,348.6588513240217,NaN,NaN,346.663919999999,348.81341254890094,344.51442745109705,345.05576617001236,347.7253423759387,349.30099666097,346.1496880909074,61303,88436.5,40.75300843580728,51.70940521248103,NaN,NaN,NaN,NaN,1.4006339545128192,21.726308638975876,96422223,-0.32987564642425715,-0.37409577183353804,-0.04422012540928086
2025-09-09T10:45:00-04:00,345.01,345.43,344.81,344.91,NaN,NaN,NaN,348.6588513240217,NaN,NaN,346.6511199999989,348.834350694636,344.46788930536184,344.2906129360099,347.6640487730742,349.27216293162445,346.055934614524,43416,88333.73333333334,39.92899847090422,49.84248280474448,NaN,NaN,NaN,NaN,1.3448743863333326,22.4890488456372,96378807,-0.33151860353289175,-0.45861837982539555,-0.1270997762925038
2025-09-09T10:50:00-04:00,344.92,345.66,343.83,345.25,NaN,NaN,NaN,348.5960778654926,NaN,NaN,346.63631999999893,348.84713539573573,344.42550460426213,343.52739382323705,347.50256708988854,349.1914516733321,345.813682506445,118186,91426.63333333333,42.3021397419504,48.00503366404474,NaN,NaN,NaN,NaN,1.3795262158809545,23.839976596878756,96496993,-0.2923128741162427,-0.49249086893780714,-0.20017799482156445
2025-09-09T10:55:00-04:00,345.25,346.17,345.24,345.8,NaN,NaN,NaN,348.5960778654926,NaN,NaN,346.6163199999989,348.83891216097453,344.39372783902326,343.52739382323705,347.44656579492886,349.1370192439453,345.7561123459124,65935,92472.4,46.01733381837666,46.079046270355214,NaN,NaN,NaN,NaN,1.3474172004608869,24.39326253654842,96562928,-0.215491258905872,-0.46954206845390445,-0.25405080954803244
2025-09-09T11:00:00-04:00,345.85,346.29,345.44,345.53,NaN,NaN,NaN,348.5960778654926,NaN,NaN,346.5772199999989,348.8060850856592,344.34835491433853,343.52739382323705,347.38485546816645,349.0742835977264,345.6954273386065,78641,93923.76666666666,44.50240901206929,44.94460032230762,NaN,NaN,NaN,NaN,1.3118874004279681,24.744553352911538,96484287,-0.17095918739389693,-0.4677497937904036,-0.2967906063965067
2025-09-09T11:05:00-04:00,345.5,345.73,344.95,345.55,NaN,NaN,NaN,348.5960778654926,NaN,NaN,346.5394199999989,348.77257640695683,344.306263593041,343.1915972359161,347.3368220537348,349.03308228484224,345.6405618226274,53791,94791.83333333333,44.647772602401524,44.10409259584411,NaN,NaN,NaN,NaN,1.273895443254544,25.427454992426547,96538078,-0.13010324801742235,-0.4594196664182846,-0.32931641840086223
2025-09-09T11:10:00-04:00,345.53,346.72,345.39,346.42,NaN,NaN,NaN,348.5960778654926,NaN,NaN,346.5264199999989,348.7546325612394,344.29820743875837,343.7600222309863,347.30805859778576,348.99284503262965,345.6232721629419,56225,94498.96666666666,50.69735837693543,44.758001471193836,NaN,NaN,NaN,NaN,1.2779029115935079,24.78344507646752,96594303,-0.03915162703384756,-0.37825595219317165,-0.3391043251593241
2025-09-09T11:15:00-04:00,346.41,346.89,346.41,346.8,NaN,NaN,NaN,348.5960778654926,NaN,NaN,346.5258199999989,348.7537213878803,344.2979186121174,344.282017784789,347.29807788192795,348.97076528659534,345.62539047726057,37845,94091.2,53.108029932366115,45.28057259320905,NaN,NaN,NaN,NaN,1.2209098464796833,23.98549282426396,96632148,0.04724974161090206,-0.2800421481456965,-0.32729188975659856
2025-09-09T11:20:00-04:00,346.82,347.03,346.4,346.615,NaN,NaN,NaN,348.5960778654926,NaN,NaN,346.5199199999988,348.7452815567296,344.29455844326804,344.6286142278312,347.2855799752609,348.94350125101005,345.6276586995117,47715,94683.56666666667,51.780611498959644,45.36490576611699,NaN,NaN,NaN,NaN,1.1787020003025626,23.07508961482537,96584433,0.0901051259511666,-0.21466048231764034,-0.30476560826880694
2025-09-09T11:25:00-04:00,346.66,346.86,346.31,346.38,NaN,NaN,NaN,348.5960778654926,NaN,NaN,346.51251999999886,348.7372326291198,344.28780737087794,344.663891382265,347.27612418683316,348.9259974475158,345.62625092615053,29301,94529.26666666666,50.06864863392631,45.54553642719393,NaN,NaN,NaN,NaN,1.133794714566666,22.320058261143785,96555132,0.10002392989369852,-0.1797356959016838,-0.2797596257953823
2025-09-09T11:30:00-04:00,346.37,346.91,346.21,346.79,NaN,NaN,NaN,348.5960778654926,NaN,NaN,346.5231199999988,348.7479694659708,344.2982705340268,344.803113105812,347.2688554984568,348.91072490978956,345.626986087124,27395,93884.43333333333,52.988950776295454,46.09776070708076,NaN,NaN,NaN,NaN,1.1028093778119075,21.723733569220425,96582527,0.12971318163115791,-0.11761814875643495,-0.24733133038759286
2025-09-09T11:35:00-04:00,346.77,347.14,346.53,346.59,NaN,NaN,NaN,348.5960778654926,NaN,NaN,346.5423199999988,348.75252934626786,344.3321106537298,345.14949048464956,347.25923786405264,348.88721478553714,345.63126094256813,45817,93712.7,51.409420349040005,46.38732087899273,NaN,NaN,NaN,NaN,1.0676087079682008,20.845428491703206,96536710,0.13101338988601374,-0.08356459303007568,-0.21457798291608943
2025-09-09T11:40:00-04:00,346.62,346.63,346.09,346.39,NaN,NaN,NaN,348.5960778654926,NaN,NaN,346.5627199999989,348.74795913797607,344.3774808620217,345.14949048464956,347.2504827704426,348.87280322135797,345.62816231952723,24420,92627.4,49.81042355070556,47.08302588034297,NaN,NaN,NaN,NaN,1.0299223716847594,20.520927053650333,96512290,0.11415313059116503,-0.07188656967713314,-0.18603970026829816
2025-09-09T11:45:00-04:00,346.37,346.81,346.31,346.74,NaN,NaN,NaN,348.5960778654926,NaN,NaN,346.5835199999989,348.75527296064286,344.4117670393549,345.14949048464956,347.24269497842823,348.856467966257,345.62892199059945,31020,91253.6,52.58951003833637,47.900329659862436,NaN,NaN,NaN,NaN,0.9920707737072766,19.950790025844984,96543310,0.12163362173966064,-0.03399767309372237,-0.155631294833383
2025-09-09T11:50:00-04:00,346.74,347.7,346.58,347.61,NaN,NaN,NaN,348.5960778654926,NaN,NaN,346.6113199999989,348.7992735447669,344.4233664552309,345.74805912814054,347.2438496163476,348.8402863345049,345.6474128981902,54900,89644.63333333333,58.709792781183104,49.18295711310356,NaN,NaN,NaN,NaN,1.0012085755853286,18.811576856660263,96598210,0.17688624155767832,0.06547650711371489,-0.11140973444396343
2025-09-09T11:55:00-04:00,347.61,347.93,347.34,347.73,NaN,NaN,NaN,348.5960778654926,NaN,NaN,346.64791999999886,348.8482426986332,344.4475973013645,346.0734473025124,347.2548709024601,348.831803309245,345.67793849567516,68682,87829.8,59.48665117509023,50.57993230625971,NaN,NaN,NaN,NaN,0.9718365344720931,18.023199745857692,96666892,0.2109186651061548,0.1522385969387301,-0.05868006816742473
2025-09-09T12:00:00-04:00,347.75,348.28,347.62,347.88,NaN,NaN,NaN,348.5960778654926,NaN,NaN,346.6821199999988,348.9047109444386,344.459529055559,346.46475784200993,347.2673319540317,348.8321980996576,345.7024658084058,49798,82546.56666666667,60.487400035349815,51.878879470073954,NaN,NaN,NaN,NaN,0.9495624962955127,17.689709252413046,96716690,0.23130044847040832,0.23044549242058565,-0.0008549560498226499
2025-09-09T12:05:00-04:00,347.85,348.1,347.71,348.06,NaN,NaN,NaN,348.5960778654926,NaN,NaN,346.71271999999885,348.9679800936839,344.45745990631383,346.46475784200993,347.27902184787894,348.83311330053664,345.72493039522124,46313,78945.16666666667,61.709710527842375,52.99976352075007,NaN,NaN,NaN,NaN,0.909593746560122,17.380039508500165,96763003,0.24344517766595702,0.30345151603262366,0.06000633836666662
2025-09-09T12:10:00-04:00,348.07,348.45,348.07,348.33,NaN,NaN,NaN,348.5960778654926,NaN,NaN,346.7427199999989,349.04288201386976,344.442557986128,346.93724501888636,347.2933942437197,348.8409293303909,345.7458591570485,39650,73805.73333333334,63.53206575855394,54.35902471692754,NaN,NaN,NaN,NaN,0.8724799075201124,17.498296664859165,96802653,0.2549791630539595,0.378730292184116,0.1237511291301565
2025-09-09T12:15:00-04:00,348.32,348.5,347.56,347.59,NaN,NaN,NaN,348.5960778654926,NaN,NaN,346.7651199999989,349.07601134882526,344.4542286511725,346.93724501888636,347.3019438940067,348.839841196334,345.76404659167935,40744,68674.1,55.70670294698292,55.148948312969075,NaN,NaN,NaN,NaN,0.8773027712686756,16.81486874770142,96761909,0.2004887259370543,0.3743620365514744,0.17387331061442007
2025-09-09T12:20:00-04:00,347.6,347.6,346.88,347.285,NaN,NaN,NaN,348.5960778654926,NaN,NaN,346.77641999999884,349.09183944756916,344.4610005524285,346.93724501888636,347.30124933125876,348.82773770746087,345.77476095505665,42221,66365.96666666666,52.81898759949105,55.30049325743733,NaN,NaN,NaN,NaN,0.8660668590352006,15.958098193817616,96719688,0.1347756680540256,0.3423428956819521,0.20756722762792648
2025-09-09T12:25:00-04:00,347.17,347.9,347.09,347.71,NaN,NaN,NaN,348.5960778654926,NaN,NaN,346.7948199999989,349.1249538918711,344.46468610812667,346.93724501888636,347.3038592441229,348.82304967777515,345.7846688104707,28339,63957.26666666667,56.224277007634555,55.523082334242225,NaN,NaN,NaN,NaN,0.8620620833898293,14.871845355069526,96748027,0.11175298955012625,0.3472584645655843,0.23550547501545804
2025-09-09T12:30:00-04:00,347.68,348.18,347.55,348.05,NaN,NaN,NaN,348.5960778654926,NaN,NaN,346.82181999999887,349.1780727101514,344.4655672898463,346.93724501888636,347.31055215578203,348.82292156446647,345.7981827470976,31307,59385.23333333333,58.78696670102021,56.02353627724654,NaN,NaN,NaN,NaN,0.8454862202905554,14.222667692502444,96779334,0.11101549154834622,0.3742748394508908,0.26325934790254457
2025-09-09T12:35:00-04:00,348.02,348.06,347.19,347.39,NaN,NaN,NaN,348.5960778654926,NaN,NaN,346.8401999999988,349.1995549635385,344.4808450364591,346.93724501888636,347.31293133690343,348.8178466163579,345.808016057449,29654,57011.76666666667,52.37703625681047,56.188421107452555,NaN,NaN,NaN,NaN,0.8472372045555161,13.289378795906643,96749680,0.060213883234464416,0.33852670194562506,0.27831281871116065
2025-09-09T12:40:00-04:00,347.36,347.62,347.18,347.24,NaN,NaN,NaN,348.5960778654926,NaN,NaN,346.84899999999885,349.21097036471093,344.4870296352868,346.93724501888636,347.31318593616805,348.81241453398894,345.81395733834717,22379,55528.566666666666,51.015569593380974,56.04746530867295,NaN,NaN,NaN,NaN,0.8181488328015505,12.436582404534754,96727301,0.013105933660583102,0.2946952357868895,0.2815893021263064
2025-09-09T12:45:00-04:00,347.33,347.85,347.07,347.4,NaN,NaN,NaN,348.5960778654926,NaN,NaN,346.8661999999988,349.23144211106364,344.50095788893395,346.93724501888636,347.3142261275444,348.8073371707179,345.82111508437083,24524,53154.566666666666,52.43580282132527,56.12077834240761,NaN,NaN,NaN,NaN,0.8154239161728704,11.78678007461937,96751825,-0.009463820904704712,0.2697595259954255,0.27922334690013023
2025-09-09T12:50:00-04:00,347.36,347.41,346.28,346.38,NaN,NaN,NaN,348.5960778654926,NaN,NaN,346.8693999999988,349.23156734461026,344.5072326553873,346.93724501888636,347.30400329165894,348.78695551220113,345.82105107111676,49779,51940.333333333336,43.731050988333145,55.686537445095304,NaN,NaN,NaN,NaN,0.8378936364462405,11.785079966554395,96702046,-0.090753639736049,0.16578129723006896,0.25653493696611795
2025-09-09T12:55:00-04:00,346.37,346.64,346.19,346.27,NaN,NaN,NaN,348.5960778654926,NaN,NaN,346.8775999999987,349.22851406992385,344.5266859300736,346.93724501888636,347.2905861632005,348.7670904215187,345.8140819048823,44141,51054.76666666667,42.903867023069374,54.99470580114765,NaN,NaN,NaN,NaN,0.8101869481286511,11.89451669024967,96657905,-0.14630579064785154,0.07365269865630353,0.21995848930415507
2025-09-09T13:00:00-04:00,346.31,346.91,346.295,346.49,NaN,NaN,NaN,348.5960778654926,NaN,NaN,346.8879999999988,349.2273340941344,344.5486659058632,346.8197960151091,347.28292463568806,348.75348430117214,345.812364970204,32909,47869.933333333334,45.13893682601387,54.025358947207,NaN,NaN,NaN,NaN,0.7980307375480363,11.560326384227624,96690814,-0.16142064483148638,0.018182683264797106,0.1796033280962835
2025-09-09T13:05:00-04:00,346.49,347.22,346.25,347.2,NaN,NaN,NaN,348.5960778654926,NaN,NaN,346.9097999999987,349.2400248484038,344.57957515159364,346.45033555973583,347.27665496491255,348.73626568004806,345.81704424977704,50537,45896.23333333333,51.70901864753651,53.46981376666746,NaN,NaN,NaN,NaN,0.8103142562946071,10.771980664596914,96741351,-0.11875927362180422,0.03115423606902823,0.14991350969083245
2025-09-09T13:10:00-04:00,347.23,347.42,346.9,346.91,NaN,NaN,NaN,348.5960778654926,NaN,NaN,346.9325999999988,349.2399658062635,344.62523419373406,346.45033555973583,347.2745810806039,348.72674530175,345.82241685945786,33188,44959.066666666666,49.121392331513256,52.65795607353626,NaN,NaN,NaN,NaN,0.789577523702138,10.263614278916771,96708163,-0.1056682506310374,0.0178281964020357,0.1234964470330731
2025-09-09T13:15:00-04:00,346.93,347.6,346.93,347.54,NaN,NaN,NaN,348.5960778654926,NaN,NaN,346.95639999999884,349.26378643574986,344.6490135642478,346.45033555973583,347.2752234140351,348.7217128456333,345.8287339824369,25241,44353.23333333333,54.45370440871491,52.13966992217002,NaN,NaN,NaN,NaN,0.7824648434376994,10.058068782663783,96733404,-0.05284451205817223,0.057440806960357804,0.11028531901853003
2025-09-09T13:20:00-04:00,347.57,347.6,346.76,346.83,NaN,NaN,NaN,348.5960778654926,NaN,NaN,346.95999999999884,349.26602428518584,344.65397571481185,346.2412684477887,347.2731472719462,348.71268406832047,345.8336104755719,31918,41477.63333333333,48.30887604442465,51.052299228303646,NaN,NaN,NaN,NaN,0.786574497477866,9.576526723844877,96701486,-0.06328141095549429,0.03118355532416217,0.09446496627965646
2025-09-09T13:25:00-04:00,346.84,347.19,346.84,346.91,NaN,NaN,NaN,348.5960778654926,NaN,NaN,346.9609999999988,349.2668933201525,344.6551066798451,346.1200118065848,347.2709839651804,348.7054187668456,345.8365491635152,24218,40087.066666666666,49.00712159394562,50.5737577030867,NaN,NaN,NaN,NaN,0.7561048905151623,9.129380526370177,96725704,-0.062261546818499505,0.016638032756532084,0.07889957957503159
2025-09-09T13:30:00-04:00,346.91,347.15,346.55,346.72,NaN,NaN,NaN,348.5960778654926,NaN,NaN,346.9733999999988,349.26727657994235,344.6795234200552,346.1200118065848,347.2680952507127,348.69852697403996,345.8376635273854,20545,38150.53333333333,47.370499308307714,50.184579968002176,NaN,NaN,NaN,NaN,0.7449545411926483,8.755091690580311,96705159,-0.07120313110072676,-0.010104334300876872,0.06109879679984989
2025-09-09T13:35:00-04:00,346.71,347.18,346.66,347.09,NaN,NaN,NaN,348.5960778654926,NaN,NaN,346.98639999999875,349.27539981740597,344.69740018259154,345.84195477502533,347.26491796505167,348.68785256914634,345.841983360957,36400,37570.833333333336,50.81521104011773,49.798218113179544,NaN,NaN,NaN,NaN,0.7288863596788863,8.350323672658929,96741559,-0.05001944756677077,-0.0014255126586135702,0.0485939349081572
2025-09-09T13:40:00-04:00,347.04,347.09,346.62,346.79,NaN,NaN,NaN,348.5960778654926,NaN,NaN,346.9433999999988,349.163734606293,344.7230653937046,345.84195477502533,347.26206131856765,348.6807106395264,345.8434119976089,22246,36438.2,48.06804860052586,49.03258110600137,NaN,NaN,NaN,NaN,0.710394476844678,8.050264291167855,96719313,-0.0537081438032393,-0.018541244845891924,0.03516689895734738
2025-09-09T13:45:00-04:00,346.78,346.98,346.53,346.91,NaN,NaN,NaN,348.5960778654926,NaN,NaN,346.90539999999885,349.06073370125984,344.75006629873786,345.84195477502533,347.258616706348,348.67244116815607,345.8447922445399,25616,36030.566666666666,49.249924758168675,48.80921599895554,NaN,NaN,NaN,NaN,0.6917948713557758,7.948592804838646,96744929,-0.045867167742600676,-0.022167060720903464,0.023700107021697208
2025-09-09T13:50:00-04:00,346.88,347.69,346.785,347.55,NaN,NaN,NaN,348.5960778654926,NaN,NaN,346.87259999999884,348.93581326184324,344.80938673815444,346.1133283140354,347.2592692316706,348.66754760545695,345.85099085788426,26819,35334.03333333333,55.116772529269326,49.102159065804706,NaN,NaN,NaN,NaN,0.7070238091160755,8.278764211602699,96771748,0.0020790723637552563,0.026298947476391277,0.02421987511263602
2025-09-09T13:55:00-04:00,347.58,347.83,347.25,347.27,NaN,NaN,NaN,348.5960778654926,NaN,NaN,346.8117999999988,348.6309863686438,344.99261363135383,346.27866265122833,347.2608426153737,348.66340644939925,345.85827878134813,28392,35303.73333333333,52.26980975042031,49.090302417882924,NaN,NaN,NaN,NaN,0.6979506798934976,8.815322945775844,96743356,0.01393210453338662,0.041635005779369294,0.027702901245982674
2025-09-09T14:00:00-04:00,347.32,347.41,346.76,346.76,NaN,NaN,NaN,348.5960778654926,NaN,NaN,346.7687999999988,348.48637452350334,345.05122547649427,346.27866265122833,347.25904575480035,348.65734975627686,345.86074175332385,21901,35120.6,47.46105904022085,49.35673156444632,NaN,NaN,NaN,NaN,0.6945256313296788,8.305476118022304,96721455,-0.012168559085076185,0.012492202389637441,0.024660761474713626
2025-09-09T14:05:00-04:00,346.75,346.765,346.41,346.57,NaN,NaN,NaN,348.5960778654926,NaN,NaN,346.73259999999885,348.3879866508214,345.0772133491763,346.27866265122833,347.2516043729568,348.643997924138,345.85921082177566,38473,34875.8,45.771607956442004,49.561570202544374,NaN,NaN,NaN,NaN,0.6702738005204133,8.214969867385925,96682982,-0.040240236992809916,-0.025639534766298766,0.014600702226511147
2025-09-09T14:10:00-04:00,346.615,346.7,345.98,346.67,NaN,NaN,NaN,348.5833473034758,NaN,NaN,346.7519999999989,348.3810524864858,345.1229475135119,346.27866265122833,347.2394506755881,348.62471585657175,345.85418549460445,53916,35859,46.844091954091745,49.68336699740708,NaN,NaN,NaN,NaN,0.6738256719118103,8.807305560302483,96736898,-0.049476906582999754,-0.04724543100223855,0.0022314755807612066
2025-09-09T14:15:00-04:00,346.65,346.97,346.6,346.89,NaN,NaN,NaN,348.5833473034758,NaN,NaN,346.76099999999883,348.3880291957413,345.13397080425636,346.27866265122833,347.2365889608219,348.61755225543925,345.85562566620456,24428,35639.26666666667,49.223318371232324,49.50581697767107,NaN,NaN,NaN,NaN,0.6521238382038241,8.821052467668725,96761326,-0.03865306883537061,-0.04608486046345206,-0.007431791628081448
2025-09-09T14:20:00-04:00,346.92,346.94,346.3,346.31,NaN,NaN,NaN,348.5833473034758,NaN,NaN,346.7399999999988,348.3626607790444,345.1173392209532,346.27866265122833,347.23345334815656,348.6122212807095,345.8546854156036,15663,34331.36666666667,43.6733474384766,49.11667091388273,NaN,NaN,NaN,NaN,0.6512578497606929,9.299147707911253,96745663,-0.06678913007674318,-0.09091820422401042,-0.024129074147267244
2025-09-09T14:25:00-04:00,346.34,346.63,346.28,346.59,NaN,NaN,NaN,348.58313574168756,NaN,NaN,346.73699999999883,348.36020423971695,345.1137957602807,346.27866265122833,347.22966860692753,348.605878306565,345.8534589072901,18653,32663.733333333334,46.79230175317403,48.56942786705838,NaN,NaN,NaN,NaN,0.629739431920645,9.773951340675561,96764316,-0.06283414558223586,-0.10267175612506207,-0.03983761054282621
2025-09-09T14:30:00-04:00,346.62,346.75,346.19,346.19,NaN,NaN,NaN,348.57776593524727,NaN,NaN,346.7355999999989,348.36056725001504,345.11063274998276,346.27866265122833,347.224604399412,348.59828668240937,345.8509221164146,21589,31723.433333333334,43.11904841141951,48.1987258932723,NaN,NaN,NaN,NaN,0.6247580439263133,9.949952907658023,96742727,-0.08222524181799659,-0.14261916281532194,-0.06039392099732536
2025-09-09T14:35:00-04:00,346.21,346.36,346.02,346.295,NaN,NaN,NaN,348.24832202909965,NaN,NaN,346.72889999999893,348.3583100661244,345.0994899338735,346.27866265122833,347.21818544756854,348.58977607492085,345.84659482021624,23502,30963.066666666666,44.35392901697009,47.8663549949169,NaN,NaN,NaN,NaN,0.6044181836458646,10.405039794405457,96766229,-0.08281736767336453,-0.16391563058903103,-0.08109826291566649
2025-09-09T14:40:00-04:00,346.28,346.64,346.25,346.36,NaN,NaN,NaN,348.24832202909965,NaN,NaN,346.7560999999989,348.31294847160837,345.1992515283895,346.27866265122833,347.2142193635277,348.5835677978014,345.84487092925406,18200,30248.066666666666,45.147819785060754,47.70759217182784,NaN,NaN,NaN,NaN,0.5891025990997305,10.194217601626377,96784429,-0.07395957189458532,-0.17354772778389815,-0.09958815588931283
2025-09-09T14:45:00-04:00,346.41,346.87,346.41,346.8,NaN,NaN,NaN,348.24832202909965,NaN,NaN,346.7884999999989,348.2788036615223,345.2981963384755,345.8439301209827,347.2107491955336,348.5761863220379,345.84531206902926,24668,29712.2,50.31523640020767,47.67187969754855,NaN,NaN,NaN,NaN,0.5834524134497491,9.513552289946723,96809097,-0.03554289584607913,-0.14401677569691174,-0.10847387985083261
2025-09-09T14:50:00-04:00,346.79,346.99,346.6,346.87,NaN,NaN,NaN,348.24832202909965,NaN,NaN,346.82409999999885,348.2332397247028,345.4149602752949,345.83206751083924,347.2087450837674,348.5709621102513,345.8465280572835,19089,28941.133333333335,51.10442211126089,47.88876351974391,NaN,NaN,NaN,NaN,0.5696343839176231,9.033010272708063,96828186,-0.004144678097487697,-0.11365472747269223,-0.10951004937520453
2025-09-09T14:55:00-04:00,346.86,346.96,346.55,346.84,NaN,NaN,NaN,348.24832202909965,NaN,NaN,346.8626999999989,348.161404294166,345.56399570583176,345.83206751083924,347.20603500772614,348.5643278694548,345.8477421459975,23862,28791.9,50.73250157348192,47.99466186369485,NaN,NaN,NaN,NaN,0.558231927923505,8.475568361848765,96804324,0.014836239679415497,-0.09096474977593516,-0.10580098945535066
2025-09-09T15:00:00-04:00,346.86,347.16,346.85,346.85,NaN,NaN,NaN,348.24832202909965,NaN,NaN,346.8946999999989,348.1089840045116,345.6804159954862,346.09492320693715,347.20312609517873,348.55384750633135,345.8524046840261,43620,29202.333333333332,50.8608771798031,47.690669338732974,NaN,NaN,NaN,NaN,0.5412153616432581,8.390144718324425,96847944,0.027558115084221943,-0.07135334560007323,-0.09891146068429517
2025-09-09T15:05:00-04:00,346.83,346.87,345.91,345.93,NaN,NaN,NaN,348.24832202909965,NaN,NaN,346.8972999999989,348.10272143819174,345.69187856180605,346.09492320693715,347.19358378299665,348.54101314626143,345.8461544197319,37787,29473.433333333334,40.42470250178557,46.84459024954479,NaN,NaN,NaN,NaN,0.5711285500973097,9.084549127501127,96810157,-0.023723195611816697,-0.12856545519906604,-0.10484225958724934
2025-09-09T15:10:00-04:00,345.9,346.21,345.7,346.16,NaN,NaN,NaN,347.863626412109,NaN,NaN,346.9098999999989,348.0702163205003,345.7495836794975,346.09492320693715,347.17980836287774,348.5252172852823,345.8343994404732,45587,30247.033333333333,43.54356097078299,46.56476895887066,NaN,NaN,NaN,NaN,0.5667622250903583,10.04448165875903,96855744,-0.03898782901124617,-0.15357704585130705,-0.11458921684006088
2025-09-09T15:15:00-04:00,346.19,346.58,346.19,346.5,NaN,NaN,NaN,347.863626412109,NaN,NaN,346.9288999999989,348.02907506043505,345.8287249395628,346.09492320693715,347.1752634370076,348.5178979166228,345.83262895739233,23408,30209.833333333332,47.886792821648044,46.715853592099656,NaN,NaN,NaN,NaN,0.5562792090124727,10.124171919813604,96879152,-0.023768905365055715,-0.14430034854638052,-0.1205314431813248
2025-09-09T15:20:00-04:00,346.52,346.81,346.46,346.62,NaN,NaN,NaN,347.863626412109,NaN,NaN,346.93289999999894,348.0270829661819,345.83871703381595,346.09492320693715,347.17134671208623,348.5099425322001,345.83275089197235,28189,29490.166666666668,49.36732356156006,46.896084421204534,NaN,NaN,NaN,NaN,0.5415449797972978,9.734015575342433,96907341,-0.004226991749473094,-0.12581518286816618,-0.12158819111869308
2025-09-09T15:25:00-04:00,346.6,346.83,346.3,346.32,NaN,NaN,NaN,347.863626412109,NaN,NaN,346.92329999999885,348.0303259453873,345.8162740546104,346.09492320693715,347.16669554572917,348.50194977645,345.83144131500836,26710,28909.133333333335,45.8596058381982,46.65581924027352,NaN,NaN,NaN,NaN,0.5407203383832031,9.65744804126956,96880631,-0.009793715808743497,-0.13383033587962245,-0.12403662007087896
2025-09-09T15:30:00-04:00,346.35,346.6,346.1,346.49,NaN,NaN,NaN,347.863626412109,NaN,NaN,346.92079999999885,348.0311591507942,345.8104408492035,346.09492320693715,347.15654806663076,348.48587855412995,345.82721757913157,52762,29570.9,48.109615054097716,46.972695498532175,NaN,NaN,NaN,NaN,0.5378117427844028,9.935136135544031,96933393,-0.0007896068000060874,-0.12502362857088656,-0.12423402177088047
2025-09-09T15:35:00-04:00,346.5,346.72,346.2,346.5,NaN,NaN,NaN,347.863626412109,NaN,NaN,346.92319999999893,348.029384000762,345.8170159992359,346.09492320693715,347.1503021603334,348.47513910601526,345.82546521465156,36940,29117.666666666668,48.245867303460535,47.076521609266926,NaN,NaN,NaN,NaN,0.5365394754426626,9.922179910740907,96970333,0.006666181281814579,-0.11590129516861225,-0.12256747645042683
2025-09-09T15:40:00-04:00,346.49,346.57,346.18,346.55,NaN,NaN,NaN,347.863626412109,NaN,NaN,346.91839999999894,348.0289285964605,345.8078714035374,346.09492320693715,347.1460083518981,348.46803008421847,345.82398661957774,24345,28822.9,48.9674051687255,47.49426137764592,NaN,NaN,NaN,NaN,0.5260723700539,9.948551946071529,96994678,0.0152981800483524,-0.10344475138998632,-0.11874293143833872
2025-09-09T15:45:00-04:00,346.55,347.03,346.54,346.89,NaN,NaN,NaN,347.863626412109,NaN,NaN,346.9243999999989,348.03100135713464,345.8177986428632,346.09492320693715,347.14229116046926,348.4572099768075,345.827372344131,46885,29544.366666666665,53.694953849925774,48.16147743714276,NaN,NaN,NaN,NaN,0.5234957721929037,9.515847579531062,97041563,0.04268715610631209,-0.06538398630544862,-0.1080711424117607
2025-09-09T15:50:00-04:00,346.87,346.91,346.32,346.62,NaN,NaN,NaN,347.863626412109,NaN,NaN,346.92899999999895,348.02856718918764,345.82943281081026,345.83670155988955,347.13482353521727,348.441849384926,345.82779768550853,59261,30455.8,49.75328908494111,48.49043952999135,NaN,NaN,NaN,NaN,0.5282460741791272,9.019179358923262,96982302,0.041370799172149,-0.05635764344657446,-0.09772844261872346
2025-09-09T15:55:00-04:00,346.65,347.15,346.6,347.005,NaN,NaN,NaN,347.863626412109,NaN,NaN,346.9342999999989,348.0327261666493,345.83587383334856,345.8752889983293,347.12611516986004,348.4072898679853,345.8449404717348,174820,35475.86666666667,54.84363014784023,48.81389622625081,NaN,NaN,NaN,NaN,0.529799926023472,8.69016073921921,97157122,0.06383777861977327,-0.017931219344006877,-0.08176899796378015
2025-09-10T09:30:00-04:00,350.37,352.2,348.36,351.16,347.8952602082666,347.8952602082666,347.8952602082666,NaN,NaN,NaN,347.0052999999989,348.6110314980222,345.3995685019756,348.58273119866345,350.5733333333334,350.5733333333334,350.5733333333334,240138,42795.63333333333,79.2615979050875,50.825123068667025,NaN,NaN,NaN,NaN,0.8630285027360808,12.525462273988158,97397260,0.3404810297461287,0.34383228921888076,0.0033512594727520273
2025-09-10T09:35:00-04:00,351.18,351.26,346.96,347.84,NaN,NaN,NaN,351.9727061648364,351.9727061648364,351.9727061648364,347.00749999999897,348.6174928582132,345.39750714178473,348.58273119866345,349.7636688631732,350.69748384097744,348.829853885369,180530,47599.96666666667,54.092039740298674,51.0650900805825,NaN,NaN,NaN,NaN,1.1085264668263615,14.30862217390844,97216730,0.28412188521666554,0.35850361599358394,0.07438173077691841
2025-09-10T09:40:00-04:00,347.8,347.8,346.08,346.9,NaN,NaN,NaN,349.9125831573438,NaN,NaN,346.987899999999,348.5786747682819,345.3971252317161,348.58273119866345,348.99136703118756,350.4844174615239,347.49831660085124,157351,52103.46666666667,49.31693101664888,50.95480821178577,NaN,NaN,NaN,NaN,1.1550602906244778,15.04107196543652,97059379,0.17323619854154404,0.29092697895384845,0.11769078041230442
2025-09-10T09:45:00-04:00,346.93,348.03,346.21,347.83,NaN,NaN,NaN,349.9125831573438,NaN,NaN,346.983299999999,348.56293870660465,345.4036612933934,348.58273119866345,348.71835315338683,350.2112217905982,347.22548451617547,115891,55112.63333333333,53.67418387398731,51.90119973837161,NaN,NaN,NaN,NaN,1.2025559841513005,15.860123458007758,97175270,0.1529313335301699,0.30885494732501684,0.15592361379484693
2025-09-10T09:50:00-04:00,347.87,348.5,346.66,348.13,NaN,NaN,NaN,349.9125831573438,NaN,NaN,346.979299999999,348.5462397063678,345.4123602936302,348.58273119866345,348.58268655689164,350.00508624160136,347.1602868721819,114896,58048.53333333333,55.01761476083177,52.72077500908939,NaN,NaN,NaN,NaN,1.2480876995690628,16.902514648162224,97290166,0.1499114976224693,0.34331298582293357,0.19340148820046427
2025-09-10T09:55:00-04:00,348.2,349.19,347.57,347.74,NaN,NaN,NaN,349.9125831573438,NaN,NaN,346.98229999999893,348.55447074253686,345.410129257461,348.58273119866345,348.5358497656394,349.88222706189384,347.18947246938495,102610,60522.46666666667,52.87107742749935,53.07679533807876,NaN,NaN,NaN,NaN,1.2746528638855585,18.259130441835435,97187556,0.11350802121735373,0.3352865147221564,0.2217784935048027
2025-09-10T10:00:00-04:00,347.68,350.27,347.6,349.8,345.4477101759469,345.4477101759469,345.4477101759469,NaN,NaN,NaN,347.0325999999989,348.79027601215,345.27492398784784,348.58273119866345,348.6108863121431,349.8996198297674,347.32215279451884,111666,63514.63333333333,61.43087946785903,53.938477902814405,NaN,NaN,NaN,NaN,1.3743205164651584,20.052383360416627,97299222,0.2141832246967263,0.48950752437571055,0.27532429967898425
2025-09-10T10:05:00-04:00,349.88,351.41,349.73,350.37,347.0121324406766,NaN,NaN,NaN,NaN,NaN,347.0857999999989,349.06884146293,345.10275853706787,348.58273119866345,348.9092504108443,350.2784119432786,347.54008887841,191490,68615.2,63.41111869616184,55.19215739266895,NaN,NaN,NaN,NaN,1.396154765289076,22.190705478927537,97490712,0.29992264256587825,0.6502276028863321,0.35030496032045383
2025-09-10T10:10:00-04:00,350.43,350.5,349,349.1,347.0121324406766,NaN,NaN,NaN,NaN,NaN,347.1067999999989,349.1515188177952,345.0620811822026,348.58273119866345,348.945450610457,350.282293009235,347.608608211679,74790,69311,56.4560423386892,55.78833077013977,NaN,NaN,NaN,NaN,1.403572282054142,23.37665360292353,97415922,0.25369791161137123,0.6674273498346679,0.41372943822329666
2025-09-10T10:15:00-04:00,349.17,350.06,349.13,349.895,347.0121324406766,NaN,NaN,NaN,NaN,NaN,347.1568999999989,349.3446713691546,344.9691286308433,348.58273119866345,348.9824822873337,350.2959657651342,347.6689988095332,67012,70730.46666666666,59.45404563216893,56.58891493647609,NaN,NaN,NaN,NaN,1.3718885476217018,24.477891146634093,97482934,0.25838903244912437,0.7367157287847022,0.4783266963355778
2025-09-10T10:20:00-04:00,349.84,350.57,349.5,349.81,347.0121324406766,NaN,NaN,NaN,NaN,NaN,347.20829999999887,349.5187844608375,344.89781553916026,346.6720609919355,349.0239722173589,350.32429842224576,347.72364601247205,60122,72212.43333333333,58.98642596364642,57.30455927897043,NaN,NaN,NaN,NaN,1.3503250799344368,25.749781261306616,97422812,0.23799884144903616,0.775825248146873,0.5378264066978369
2025-09-10T10:25:00-04:00,349.8,350.34,348.86,349.16,347.0121324406766,NaN,NaN,NaN,NaN,NaN,347.24349999999885,349.61735193388273,344.86964806611496,346.6720609919355,349.0436677450738,350.316992025246,347.77034346490154,68101,73860.7,55.39815079303376,57.42621620347814,NaN,NaN,NaN,NaN,1.3595875742248313,26.203614565708342,97354711,0.16635763004132564,0.7457734442494939,0.5794158142081682
2025-09-10T10:30:00-04:00,349.12,350.53,349.07,350.06,347.0121324406766,NaN,NaN,NaN,NaN,NaN,347.31709999999885,349.80476323362814,344.82943676636955,346.7133190348387,349.07599633415623,350.3351168223684,347.8168758459441,59204,75114.53333333334,59.107448591498425,58.09437045394652,NaN,NaN,NaN,NaN,1.3667598903516276,26.733494825232828,97413915,0.16488703885061695,0.7855246127714395,0.6206375739208225
2025-09-10T10:35:00-04:00,350.12,351.25,350.12,350.92,347.0597713762846,NaN,NaN,NaN,NaN,NaN,347.41009999999886,350.0755511745521,344.7446488254456,347.601655227871,349.1612034767078,350.4425459642809,347.87986098913467,82105,77067.96666666666,62.33119796405546,58.62919672653333,NaN,NaN,NaN,NaN,1.35413418389794,27.622071337554882,97496020,0.2045466063339474,0.8763208318382567,0.6717742255043093
2025-09-10T10:40:00-04:00,350.86,351.99,350.32,351.93,347.4668272228171,NaN,NaN,NaN,NaN,NaN,347.5188999999989,350.45554999001183,344.58225000998596,348.2363241822968,349.381077294611,350.769741021366,347.992413567856,175910,82324.96666666666,65.74650361267925,57.663832848504164,NaN,NaN,NaN,NaN,1.3766960279052312,28.815301929684782,97671930,0.2770131868700775,1.0180407090919061,0.7410275222218287
2025-09-10T10:45:00-04:00,352,353.32,351.47,353.28,348.62219871268906,NaN,NaN,NaN,NaN,NaN,347.64049999999884,350.98891051902785,344.2920894809698,349.3920593458374,349.7736012097223,351.46013214366747,348.08707027577714,242510,89586.36666666667,69.70085468371994,58.77874820160569,NaN,NaN,NaN,NaN,1.4105034544834265,30.48357108933501,97914440,0.3873103863242695,1.2251655051271655,0.837855118802896
2025-09-10T10:50:00-04:00,353.28,353.85,352.65,353.83,349.48505331665774,NaN,NaN,NaN,NaN,NaN,347.7788999999989,351.54152370744134,344.0162762925564,350.10764747666997,349.993437907547,351.8461133107019,348.14076250439206,130270,93292.4,71.16153782759542,60.33907725953044,NaN,NaN,NaN,NaN,1.3954674934488993,32.227464511599365,98044710,0.46360023359316904,1.4173554107943573,0.9537551772011883
2025-09-10T10:55:00-04:00,353.76,355.49,353.74,355.38,350.7825508931733,NaN,NaN,NaN,NaN,NaN,347.9356999999989,352.25733904597195,343.6140609540259,351.62111798133594,350.4691462605897,352.7475443843473,348.1907481368321,235062,100332.4,74.84239248362645,61.851092160218954,NaN,NaN,NaN,NaN,1.420791243916835,34.36115673069165,98279772,0.5773367165960166,1.675426072946209,1.0980893563501923
2025-09-10T11:00:00-04:00,355.41,355.87,354.31,355.02,351.21902585257453,NaN,NaN,NaN,NaN,NaN,348.0994999999989,352.8414849223517,343.3575150776461,351.99489438506873,350.92134465897783,353.48162297614846,348.3610663418072,262861,107640.43333333333,72.52696304962174,63.10175989513251,NaN,NaN,NaN,NaN,1.4307347264942043,36.446166746885815,98016911,0.5853741659833485,1.829807063829378,1.2444328978460295
2025-09-10T11:05:00-04:00,354.97,355.22,354.06,355.02,351.21902585257453,NaN,NaN,NaN,NaN,NaN,348.2616999999989,353.370462907384,343.15293709261374,351.99489438506873,351.07577012017714,353.69526400428134,348.45627623607294,111817,110108.1,72.52696304962174,64.50575172528411,NaN,NaN,NaN,NaN,1.41139653174462,38.07350597410886,98016911,0.5483803452938862,1.9299083294633874,1.3815279841695012
2025-09-10T11:10:00-04:00,355.07,356.05,354.64,355.99,351.4746702499698,NaN,NaN,NaN,NaN,NaN,348.4470999999989,353.97430077107623,342.91989922892157,352.400932406444,351.3173034108253,354.05900133952184,348.5756054821287,158510,113872.2,74.948831125501,65.47131970082997,NaN,NaN,NaN,NaN,1.411296779477149,39.836028949172146,98175421,0.5457543383011914,2.0637209070459903,1.517966568744799
2025-09-10T11:15:00-04:00,356,356.33,354.76,354.86,351.63650342042564,NaN,NaN,NaN,NaN,NaN,348.6024999999989,354.39870884749513,342.80629115250264,352.6257459251552,351.46533801423953,354.25976148688017,348.6709145415989,113115,116862.43333333333,67.48529939044354,65.76233260756437,NaN,NaN,NaN,NaN,1.4226327238002092,41.55357515539362,98062306,0.4295460921954466,2.0548991839891073,1.6253530917936607
2025-09-10T11:20:00-04:00,354.77,355,354.18,354.73,351.63650342042564,NaN,NaN,NaN,NaN,NaN,348.761299999999,354.78093912901056,342.7416608709874,352.6257459251552,351.5476852844645,354.35132702456343,348.7440435443655,81467,118638.36666666667,66.66284288081353,66.49138978914469,NaN,NaN,NaN,NaN,1.3795875292430508,42.40476555170511,97980839,0.31107716873849145,2.014199552716775,1.7031223839782836
2025-09-10T11:25:00-04:00,354.7,354.9,354.03,354.67,351.63650342042564,NaN,NaN,NaN,NaN,NaN,348.9164999999989,355.13409929584986,342.69890070414795,352.6257459251552,351.61704118323865,354.424188075073,348.8098942914043,74615,120235.2,66.2614613779218,66.97763377098418,NaN,NaN,NaN,NaN,1.3431884200114046,43.00456359377972,97906224,0.2011598619178463,1.9545722113755915,1.7534123494577452
2025-09-10T11:30:00-04:00,354.73,354.73,353.5,353.85,351.63650342042564,NaN,NaN,NaN,NaN,NaN,349.042499999999,355.39803341613026,342.68696658386773,352.6257459251552,351.66810138205784,354.46694452801455,348.86925823610113,69537,120794.36666666667,60.86751778001342,67.11199747215325,NaN,NaN,NaN,NaN,1.335103532867734,42.89311706514371,97836687,0.053404681068595306,1.8201682007934892,1.7667635197248939
2025-09-10T11:35:00-04:00,353.85,354.72,353.63,354.67,351.63650342042564,NaN,NaN,NaN,NaN,NaN,349.19049999999896,355.7163983292398,342.66460167075815,352.6257459251552,351.71314152100894,354.5095298156467,348.91675322637116,56266,121438.56666666667,64.02159272203397,67.72795760993897,NaN,NaN,NaN,NaN,1.3175961376628982,42.789631002838846,97892953,-0.005781726856301628,1.7595363611545167,1.7653180880108184
2025-09-10T11:40:00-04:00,354.7,355.15,354.37,355.15,351.63650342042564,NaN,NaN,NaN,NaN,NaN,349.358299999999,356.0548204728645,342.66177952713355,352.6257459251552,351.76523979933785,354.56779988311484,348.96267971556085,55651,122482.1,65.76125336411474,68.20322937941157,NaN,NaN,NaN,NaN,1.2791964135441176,42.92427368104937,97948604,-0.028037122443040685,1.7302716849570174,1.7583088074000581
2025-09-10T11:45:00-04:00,355.14,355.16,354.55,354.77,351.63650342042564,NaN,NaN,NaN,NaN,NaN,349.522299999999,356.33821907548065,342.70638092451736,352.6257459251552,351.7996603745732,354.60505259268876,348.9942681564576,38588,122205.53333333334,63.157645479040085,68.26226134476762,NaN,NaN,NaN,NaN,1.2313966697195387,43.05475143971453,97910016,-0.08079749896674193,1.6573119336916307,1.7381094326583726
2025-09-10T11:50:00-04:00,354.82,355.8,354.68,355.15,351.64164526933797,NaN,NaN,NaN,NaN,NaN,349.691899999999,356.63628820656913,342.7475117934289,353.1885977758431,351.8764733388416,354.6958736515005,349.0570730261827,79084,122866.3,64.66426739105312,68.18495875750861,NaN,NaN,NaN,NaN,1.2234397647395718,43.51859992788892,97989100,-0.10122644209702392,1.6115763800370928,1.7128028221341167
2025-09-10T11:55:00-04:00,355.19,355.39,354.82,354.84,351.64164526933797,NaN,NaN,NaN,NaN,NaN,349.85089999999894,356.8947332435997,342.80706675639817,353.1885977758431,351.9110885637526,354.73401154688906,349.0881655806162,39136,118343.5,62.42165128968133,67.66501565793442,NaN,NaN,NaN,NaN,1.1767654958296017,43.94931638119372,97949964,-0.14412322268081645,1.5326487937830962,1.6767720164639126
2025-09-10T12:00:00-04:00,354.84,355.09,354.24,354.65,351.64164526933797,NaN,NaN,NaN,NaN,NaN,350.01769999999897,357.1130343010467,342.92236569895124,353.1885977758431,351.9447796416867,354.7666061577495,349.1229531256239,44053,111807.33333333333,61.02472655623693,66.94095770998024,NaN,NaN,NaN,NaN,1.153425103270342,43.455868338261816,97905911,-0.19086708274856923,1.438188163028201,1.6290552457767702
2025-09-10T12:05:00-04:00,354.67,354.93,354.24,354.44,351.64164526933797,NaN,NaN,NaN,NaN,NaN,350.1746999999989,357.30700549288076,343.042394507117,353.1885977758431,351.9642014656011,354.784307811667,349.14409511953517,27137,106694.23333333334,59.4413763333441,65.84088512781722,NaN,NaN,NaN,NaN,1.120323310179603,42.99766658411077,97878774,-0.23841315590760925,1.3310388008922587,1.569451956799868
2025-09-10T12:10:00-04:00,354.47,354.705,354.02,354.27,351.64164526933797,NaN,NaN,NaN,NaN,NaN,350.33629999999886,357.4662940563693,343.2063059436284,353.1885977758431,351.9856085065883,354.80186657875197,349.1693504344246,33045,102550.7,58.12657484200988,64.81228597013066,NaN,NaN,NaN,NaN,1.0892287880239173,42.22482853073754,97845729,-0.28087349860861743,1.2183600835390962,1.4992335821477136
2025-09-10T12:15:00-04:00,354.295,354.85,354.04,354.18,351.64164526933797,NaN,NaN,NaN,NaN,NaN,350.49399999999895,357.6082597649824,343.3797402350155,353.1885977758431,352.00630713654374,354.81890749681344,349.19370677627404,32184,99760.46666666666,57.40266964669479,63.731979298493016,NaN,NaN,NaN,NaN,1.0692838745936377,41.626216747714956,97813545,-0.31217478203506355,1.109015104603884,1.4211898866389476
2025-09-10T12:20:00-04:00,354.1,354.2,353.58,353.83,351.64164526933797,NaN,NaN,NaN,NaN,NaN,350.64339999999885,357.71775691522356,343.56904308477414,353.1885977758431,352.0373262318523,354.83659462162916,349.2380578420755,62400,98010.6,54.55710475282458,62.27542741473042,NaN,NaN,NaN,NaN,1.037192169265521,40.33002284786847,97751145,-0.35072200141288934,0.9827873848728359,1.3335093862857252
2025-09-10T12:25:00-04:00,353.83,354.39,353.51,354.23,351.64164526933797,NaN,NaN,NaN,NaN,NaN,350.79199999999895,357.8493051516629,343.734694848335,353.1885977758431,352.07159929505497,354.85900001700224,349.2841985731077,65168,96762.53333333334,57.170221777566134,61.53863615666775,NaN,NaN,NaN,NaN,1.0259641571751263,39.30841862623943,97816313,-0.34312750988367413,0.9045999989311326,1.2477275088148068
2025-09-10T12:30:00-04:00,354.26,354.67,354.03,354.4,351.64164526933797,NaN,NaN,NaN,NaN,NaN,350.94259999999895,357.98004846970065,343.90515153029725,353.1885977758431,352.0916559102034,354.87505907337703,349.3082527470297,33627,94161.23333333334,58.26854460665053,60.93904342279897,NaN,NaN,NaN,NaN,0.9983952888054776,38.62500097758259,97849940,-0.320906409342105,0.8465944971371755,1.1675009064792805
2025-09-10T12:35:00-04:00,354.36,354.68,353.9,353.96,351.64164526933797,NaN,NaN,NaN,NaN,NaN,351.08499999999896,358.07259186012504,344.09740813987287,353.1885977758431,352.1079975046416,354.88658869282455,349.3294063164587,30348,88789.83333333333,54.381464234801896,60.0904721982904,NaN,NaN,NaN,NaN,0.9827956253193741,37.76351237767553,97819592,-0.328879864754382,0.7564010755363029,1.085280940290685
2025-09-10T12:40:00-04:00,353.96,354,352.7,352.76,351.64164526933797,NaN,NaN,NaN,NaN,NaN,351.2031999999989,358.0995894208375,344.3068105791603,353.01587822067444,352.12865117015207,354.8834996271214,349.3738027131827,78171,88902.53333333334,45.47208456497088,58.99079839721594,NaN,NaN,NaN,NaN,1.0054530806537054,35.19400978432897,97741421,-0.40311254192858814,0.5813902628799497,0.9845028048085378
2025-09-10T12:45:00-04:00,352.745,353.37,352.72,353.18,351.64164526933797,NaN,NaN,NaN,NaN,NaN,351.3481999999989,358.0983240761884,344.59807592380935,352.7657025765396,352.1405913735459,354.8803480109187,349.40083473617307,49758,88327.4,48.643442092375324,57.89235906652603,NaN,NaN,NaN,NaN,0.9800635748927249,32.808043090507155,97791179,-0.41068042563861895,0.47115227276026417,0.8818326983988831
2025-09-10T12:50:00-04:00,353.2,354.12,353.07,353.98,351.64164526933797,NaN,NaN,NaN,NaN,NaN,351.5045999999989,358.1278203167249,344.8813796832729,352.7601597191883,352.1557983793901,354.88672928977604,349.42486746900414,38865,87618.83333333333,54.11738036781287,57.060653852504466,NaN,NaN,NaN,NaN,0.9850590338289597,31.46413494914812,97830044,-0.3508806513347069,0.4432318842304994,0.7941125355652063
2025-09-10T12:55:00-04:00,353.97,354.3,353.93,354.23,351.64164526933797,NaN,NaN,NaN,NaN,NaN,351.6591999999989,358.16780856434343,345.1505914356544,352.7601597191883,352.1701798250621,354.89649781437004,349.4438618357542,29334,86326.6,55.70622484824935,56.52840952173371,NaN,NaN,NaN,NaN,0.94112624569832,30.407372685505518,97859378,-0.28629092421902114,0.43624888029142994,0.7225398045104511
2025-09-10T13:00:00-04:00,354.24,355.38,354.12,355.01,351.70745011592214,NaN,NaN,NaN,NaN,NaN,351.82699999999886,358.23918402761626,345.41481597238146,353.1969010480266,352.22027054119815,354.9450163058474,349.4955247765489,78004,86953.26666666666,60.32273875663562,56.21830033356103,NaN,NaN,NaN,NaN,0.9639029424341538,30.422474492122625,97937382,-0.18760897095225215,0.48802859082013583,0.675637561772388
2025-09-10T13:05:00-04:00,355.01,355.19,354.55,354.65,351.87847511065297,NaN,NaN,NaN,NaN,NaN,351.9935999999988,358.2559050200441,345.73129497995353,353.1969010480266,352.24461411929576,354.967887188028,349.52134105056354,39609,85536.73333333334,57.3516869165117,55.85616002119177,NaN,NaN,NaN,NaN,0.9407670179745704,30.43649759826709,97897773,-0.14505627982250446,0.4943172119942574,0.6393734918167618
2025-09-10T13:10:00-04:00,354.68,354.96,354.47,354.75,351.87847511065297,NaN,NaN,NaN,NaN,NaN,352.1587999999989,358.26551353870025,346.05208646129756,353.1969010480266,352.25641496998065,354.97856615644594,349.53426378351537,20026,80340.6,57.97092996756096,55.6380316934292,NaN,NaN,NaN,NaN,0.9085693738335262,30.317249004846953,97917799,-0.11022826722007106,0.501588157791673,0.611816425011744
2025-09-10T13:15:00-04:00,354.76,354.86,354.33,354.41,351.87847511065297,NaN,NaN,NaN,NaN,NaN,352.31699999999887,358.23608033430173,346.397919665696,353.1969010480266,352.27057856162213,354.990148596986,349.5510085262583,26365,73135.76666666666,55.044508444671,55.32396970138111,NaN,NaN,NaN,NaN,0.8815287042739907,29.96716898200174,97891434,-0.10989621499966651,0.4744461562621609,0.5843423712618274
2025-09-10T13:20:00-04:00,354.46,354.8,354.32,354.65,351.87847511065297,NaN,NaN,NaN,NaN,NaN,352.4789999999989,358.19785513051113,346.7601448694867,353.1969010480266,352.2884042037122,355.0050652126199,349.5717431948045,32826,69887.63333333333,56.70590125330639,55.22249301647373,NaN,NaN,NaN,NaN,0.8528480825401354,29.62419814340322,97924260,-0.09393824845707388,0.466919560690485,0.5608578091475589
2025-09-10T13:25:00-04:00,354.64,354.9,354.11,354.27,351.87847511065297,NaN,NaN,NaN,NaN,NaN,352.62659999999886,358.13802647270074,347.115173527297,353.1969010480266,352.3051844378646,355.0177346696121,349.59263420611717,33784,63178.36666666667,53.34438419209508,54.93261548400231,NaN,NaN,NaN,NaN,0.848358933787266,28.919257504985012,97890476,-0.10837565181402253,0.42538824438003076,0.5337638961940533
2025-09-10T13:30:00-04:00,354.29,354.69,353.85,354.65,351.87847511065297,NaN,NaN,NaN,NaN,NaN,352.78719999999885,358.0515940433833,347.5228059566144,353.1969010480266,352.3229853053443,355.0307921360929,349.61517847459567,36955,55648.166666666664,56.144135294596225,55.04597480841458,NaN,NaN,NaN,NaN,0.8477618670881738,27.79852102449427,97927431,-0.09235901709317362,0.41831512482758626,0.5106741419207599
2025-09-10T13:35:00-04:00,354.62,354.89,354.17,354.43,351.87847511065297,NaN,NaN,NaN,NaN,NaN,352.93569999999886,357.9523554639415,347.9190445360562,353.1969010480266,352.34511299438907,355.047923766873,349.64230222190514,44655,53409.433333333334,54.11929220637162,54.82805126761496,NaN,NaN,NaN,NaN,0.8386360194390164,27.025550989244163,97882776,-0.09617409316449577,0.3904565254651402,0.48663061862963597
2025-09-10T13:40:00-04:00,354.43,355.08,354.38,354.99,352.0205279324018,NaN,NaN,NaN,NaN,NaN,353.0122999999988,358.0351204073111,347.98947959268645,353.2882234293337,352.36936442383706,355.06989336340666,349.66883548426745,43469,49574.73333333333,58.24713619589247,54.82652209541796,NaN,NaN,NaN,NaN,0.828733446621943,26.558763842043103,97926245,-0.062222330774411916,0.4088527051616211,0.471075035936033
2025-09-10T13:45:00-04:00,354.94,355.66,354.83,355.61,352.54550393547447,NaN,NaN,NaN,NaN,NaN,353.16769999999883,358.0186542199399,348.3167457800578,353.81157874346695,352.4214812043496,355.12694654407505,349.7160158646242,78393,48417.333333333336,62.29209342770829,55.39156703776842,NaN,NaN,NaN,NaN,0.8288239147203785,26.818952261152766,98004638,-0.0024079760818788154,0.46806506583368446,0.4704730419155633
2025-09-10T13:50:00-04:00,355.65,356.26,355.01,355.03,352.88775375658923,NaN,NaN,NaN,NaN,NaN,353.33029999999883,357.86469407682654,348.7959059231711,354.15626299477356,352.4881107362885,355.1999100152608,349.7763114573162,101995,49101.6,56.753014109148566,56.19734771949539,NaN,NaN,NaN,NaN,0.85890792081178,27.657677208324387,97902643,-0.0060947252040439714,0.4628546354105083,0.4689493606145523
2025-09-10T13:55:00-04:00,355.01,355.02,354.32,354.68,352.88775375658923,NaN,NaN,NaN,NaN,NaN,353.4672999999988,357.7347494541986,349.19985054579894,354.15626299477356,352.50576495683015,355.2136628336503,349.79786708001,37551,47866.13333333333,53.65259689431536,56.555144491062535,NaN,NaN,NaN,NaN,0.8482716407537944,27.158073667885425,97865092,-0.034697516705734066,0.42557746473238467,0.46027498143811874
2025-09-10T14:00:00-04:00,354.65,354.86,354.46,354.71,352.88775375658923,NaN,NaN,NaN,NaN,NaN,353.5988999999988,357.59720628692554,349.6005937130721,354.15626299477356,352.51702495108907,355.22238912074624,349.8116607814319,24234,46356.03333333333,53.885143477920096,56.538556141784476,NaN,NaN,NaN,NaN,0.8162522378428115,26.694156094620674,97889326,-0.053088000362663756,0.39391498098478905,0.4470029813474528
2025-09-10T14:05:00-04:00,354.68,354.68,353.9,354.22,352.88775375658923,NaN,NaN,NaN,NaN,NaN,353.7284999999988,357.36222990247705,350.09477009752055,354.15626299477356,352.53032992867776,355.2296707065665,349.83098915078904,35802,45673.9,49.51513726508745,56.09633560013007,NaN,NaN,NaN,NaN,0.8158056494254681,25.32907971663051,97853524,-0.09717773465940832,0.3255308130231924,0.42270854768260074
2025-09-10T14:10:00-04:00,354.2,354.45,353.77,354.19,352.88775375658923,NaN,NaN,NaN,NaN,NaN,353.8162999999988,357.2739794594299,350.35862054056776,354.15626299477356,352.5411358789585,355.2345844894348,349.8476872684823,31886,44881.73333333333,49.25178030383224,55.30555285350125,NaN,NaN,NaN,NaN,0.806105245895078,23.858749621518307,97821638,-0.12548639158290842,0.2658505582039652,0.3913369497868736
2025-09-10T14:15:00-04:00,354.15,354.25,353.45,353.57,352.88775375658923,NaN,NaN,NaN,NaN,NaN,353.88029999999884,357.19599866605563,350.56460133394205,354.15626299477356,352.5515475590371,355.2357741869785,349.86732093109566,40951,44960.5,44.038678441273944,54.35462367669856,NaN,NaN,NaN,NaN,0.8056691569025733,22.304763123106177,97780687,-0.179786201148043,0.16660419835181983,0.34639039949986283
2025-09-10T14:20:00-04:00,353.56,354.2,353.46,354.12,352.88775375658923,NaN,NaN,NaN,NaN,NaN,353.9806999999988,357.0022942884629,350.95910571153473,354.15626299477356,352.5629835122488,355.23894087342427,349.88702615107337,40093,43660.8,49.17774123064224,53.726538766918644,NaN,NaN,NaN,NaN,0.8009785028381045,20.86177566029492,97820780,-0.1724538401269533,0.1308230993411712,0.3032769394681245
2025-09-10T14:25:00-04:00,354.16,354.26,353.22,353.65,352.88775375658923,NaN,NaN,NaN,NaN,NaN,354.05579999999884,356.8452059303138,351.2663940696839,354.15626299477356,352.5735883859963,355.23940791807547,349.9077688539171,44989,43855.9,45.34552302923919,53.03375409438781,NaN,NaN,NaN,NaN,0.8180514669210944,19.89808426058448,97775791,-0.1915769629854065,0.06380573573636639,0.2553826987217729
2025-09-10T14:30:00-04:00,353.65,354.35,353.42,354.22,352.88775375658923,NaN,NaN,NaN,NaN,NaN,354.14399999999887,356.6559076424137,351.63209235758404,354.15626299477356,352.58211381651296,355.24220385300003,349.9220237800259,29327,43365.03333333333,50.394181079512826,52.582916939116835,NaN,NaN,NaN,NaN,0.8260477907124454,18.840132248336076,97805118,-0.15947239189092527,0.05604220885811628,0.21551460074904155
2025-09-10T14:35:00-04:00,354.15,354.43,353.79,353.83,352.88775375658923,NaN,NaN,NaN,NaN,NaN,354.23739999999884,356.3099474576323,352.1648525423654,354.15626299477356,352.59042309112147,355.2450311041613,349.93581507808165,28520,43411.13333333333,47.18268566489521,52.14279561574541,NaN,NaN,NaN,NaN,0.8127586628044127,17.707991251516926,97776598,-0.15784375676508602,0.01820990479268403,0.17605366155777005
2025-09-10T14:40:00-04:00,353.88,353.9,352.58,352.7,NaN,NaN,NaN,355.88891736689106,355.88891736689106,355.88891736689106,354.2901999999989,356.0444336913841,352.5359663086137,353.02960831665507,352.59644127893534,355.2345122603451,349.95837029752556,63924,44440.433333333334,39.35662390919924,50.943687659645626,NaN,NaN,NaN,NaN,0.8489901868898112,18.35624402695494,97712674,-0.22226753700674362,-0.10178075970065947,0.12048677730608415
2025-09-10T14:45:00-04:00,352.75,352.95,351.49,351.77,NaN,NaN,NaN,354.9476029411233,NaN,NaN,354.30719999999883,355.94293611692353,352.6714638830741,353.02960831665507,352.58716696263053,355.2028142617244,349.97151966353664,89445,46349.13333333333,34.31233376183998,49.52890491360766,NaN,NaN,NaN,NaN,0.8926337449691089,19.96338136586764,97623229,-0.3114443650967929,-0.268818679064907,0.04262568603188592
2025-09-10T14:50:00-04:00,351.75,351.77,351,351.63,NaN,NaN,NaN,354.093620989254,NaN,NaN,354.30119999999886,355.97356187595346,352.62883812404425,352.81068665332407,352.56703663411344,355.1633510917353,349.97072217649156,92883,47365.23333333333,33.613891063851256,47.76938740417614,NaN,NaN,NaN,NaN,0.8838741917570284,21.815358195747944,97530346,-0.3603353282231092,-0.40779347424700063,-0.047458146023891395
2025-09-10T14:55:00-04:00,351.6,351.63,351.14,351.26,NaN,NaN,NaN,354.037320035197,NaN,NaN,354.2607999999989,356.1173423356334,352.40425766436437,352.61454932265923,352.55769395493974,355.1462706666054,349.96911724327407,39776,46518.833333333336,31.773124088347103,45.5894610227932,NaN,NaN,NaN,NaN,0.8557403209172413,23.535050966351086,97490570,-0.3952697321581418,-0.5415453112215687,-0.14627557906342686
2025-09-10T15:00:00-04:00,351.32,351.55,350.31,350.57,NaN,NaN,NaN,353.6308509426881,NaN,NaN,354.1955999999988,356.31801809361525,352.0731819063824,352.450479522049,352.52621164234296,355.1018776226794,349.9505456620065,95570,48583.6,28.62496258664538,43.58031448547155,NaN,NaN,NaN,NaN,0.8831874408517246,25.685658807006035,97395000,-0.4391458687422306,-0.6952079149912151,-0.25606204624898454
2025-09-10T15:05:00-04:00,350.59,350.76,349.44,349.6,NaN,NaN,NaN,352.8580849907477,NaN,NaN,354.07999999999885,356.5353093499858,351.62469065001187,352.450479522049,352.4799820480586,355.0555410597265,349.9044230363907,96310,50782.333333333336,24.89117348694397,41.52592709923073,NaN,NaN,NaN,NaN,0.9143883379337439,28.143623717598924,97298690,-0.5031944941428723,-0.885055163927575,-0.3818606697847027
2025-09-10T15:10:00-04:00,349.57,349.58,347.98,348.07,NaN,NaN,NaN,351.63362658207734,NaN,NaN,353.94099999999884,356.9024489703623,350.9795510296354,352.450479522049,352.3689777177414,354.99025945334756,349.74769598213527,156736,53401.166666666664,20.37639381138341,39.1324449801924,NaN,NaN,NaN,NaN,0.9647891709384767,30.998975133264032,97141954,-0.6111203196488626,-1.145761069345781,-0.5346407496969183
2025-09-10T15:15:00-04:00,348.1,348.53,347.65,348.43,NaN,NaN,NaN,350.93391628289197,NaN,NaN,353.8091999999987,357.1314350074041,350.48696499259336,352.450479522049,352.28691845306236,354.94602721130394,349.62780969482077,111697,55465.8,23.875147789977603,37.30101716054169,NaN,NaN,NaN,NaN,0.958732801585728,33.7566044940384,97253651,-0.6188816225855028,-1.3082427779287968,-0.689361155343294
2025-09-10T15:20:00-04:00,348.42,348.43,347.2,347.69,NaN,NaN,NaN,350.69737463366965,NaN,NaN,353.6431999999988,357.3231618264623,349.9632381735353,352.450479522049,352.2071589029777,354.90892687675637,349.50539092919905,102000,57570.3,21.75865181375093,35.33722226839303,NaN,NaN,NaN,NaN,0.9781090300438916,36.456451906029365,97151651,-0.6322437567546882,-1.4796658512866543,-0.847422094531966
2025-09-10T15:25:00-04:00,347.69,348.19,347.16,347.44,NaN,NaN,NaN,350.566812150321,NaN,NaN,353.49479999999875,357.546214054913,349.4433859450845,351.65638361763916,352.1284956717311,354.8728526337615,349.3841387097007,100193,59932.26666666667,21.078806106130685,33.69723138731137,NaN,NaN,NaN,NaN,0.9818155278978974,38.97584705967031,97051458,-0.615704251599253,-1.6170524090310323,-1.0013481574317793
2025-09-10T15:30:00-04:00,347.47,348.63,347.39,348.37,NaN,NaN,NaN,350.566812150321,NaN,NaN,353.36759999999873,357.64875229400246,349.086447705995,350.42510689411137,352.08029921523246,354.84274443160405,349.31785399886087,71647,59720.36666666667,29.85853010092454,32.31728773518867,NaN,NaN,NaN,NaN,1.000257275905191,40.48864818303695,97123105,-0.5045818485581992,-1.6320754681295284,-1.1274936195713292
2025-09-10T15:35:00-04:00,348.4,349,348.24,348.31,NaN,NaN,NaN,350.566812150321,NaN,NaN,353.2403999999988,357.731968920127,348.74883107987057,349.46106841223127,352.03458587329646,354.80839726299246,349.26077448360047,77239,60974.7,29.629514673116745,31.19471570975136,NaN,NaN,NaN,NaN,0.9830960419119625,41.235399384912036,97045866,-0.40203138056641263,-1.630032845279345,-1.2280014647129325
2025-09-10T15:40:00-04:00,348.33,349.5,348.13,349.47,NaN,NaN,NaN,350.566812150321,NaN,NaN,353.15279999999876,357.76268510098595,348.5429148990116,349.46106841223127,351.9856730067466,354.76290970785647,349.2084363056367,99757,63632.4,39.319764918825996,30.403685983988016,NaN,NaN,NaN,NaN,1.0107320389182513,41.09602223747179,97145623,-0.23145563968977245,-1.517321014325148,-1.2858653746353756
2025-09-10T15:45:00-04:00,349.45,349.72,349.09,349.44,NaN,NaN,NaN,350.566812150321,NaN,NaN,353.04819999999876,357.75201919766533,348.3443808023322,349.19485472978505,351.9586193641788,354.733612769843,349.1836259585146,65145,64925.066666666666,39.16954038299615,29.83131846385237,NaN,NaN,NaN,NaN,0.9835368932812371,40.615324123546074,97080478,-0.1026003235587174,-1.4141157790837724,-1.311515455525055
2025-09-10T15:50:00-04:00,349.5,350.26,348.76,349.34,NaN,NaN,NaN,350.566812150321,NaN,NaN,352.9319999999987,357.7088776417774,348.15512235822,348.215883783828,351.91723902637693,354.68768184450187,349.146796208252,103894,67294,38.63960121163231,29.7801025568833,NaN,NaN,NaN,NaN,1.0204271151897202,39.34966470679092,96976584,-0.010882759570187472,-1.3251189049877894,-1.314236145417602
2025-09-10T15:55:00-04:00,349.37,349.39,347.74,347.86,NaN,NaN,NaN,350.566812150321,NaN,NaN,352.7937999999987,357.7465687453025,347.84103125469494,347.4714786040974,351.8182645264643,354.6126936515548,349.0238354013738,178471,72116.9,31.7854678053521,29.599612131419878,NaN,NaN,NaN,NaN,1.0653966069618814,38.98926515188817,96798113,-0.035293977464988746,-1.358353617248838,-1.3230596397838492
2025-09-11T09:30:00-04:00,350.17,350.45,348.28,350.26,NaN,NaN,NaN,350.566812150321,NaN,NaN,352.6959999999988,357.65191928953516,347.7400807104624,347.4714786040974,349.66333333333336,349.66333333333336,349.66333333333336,184734,77042.86666666667,47.919112931610066,30.621413693402648,NaN,NaN,NaN,NaN,1.1742968493217454,37.29178484612666,96982847,0.11648018805010407,-1.177459404721219,-1.293939592771323
2025-09-11T09:35:00-04:00,350.26,351.43,348.8,349.38,346.6232994041423,346.6232994041423,346.6232994041423,NaN,NaN,NaN,352.5867999999987,357.5893360613049,347.58426393869246,347.4714786040974,349.7562432437265,349.8590495179139,349.6534369695391,150880,80583.7,43.8260877839243,31.48233967165816,NaN,NaN,NaN,NaN,1.2782756457987632,34.695680654238615,96831967,0.16114026682521354,-1.092514259239806,-1.2536545260650196
2025-09-11T09:40:00-04:00,349.34,349.83,347.6,348.99,346.6232994041423,NaN,NaN,NaN,NaN,NaN,352.4735999999988,357.54001136943543,347.40718863056213,347.4714786040974,349.4556463197337,349.9054292287053,349.0058634107621,155451,84316.43333333333,42.109437986952294,32.4455164859658,NaN,NaN,NaN,NaN,1.3462559568131345,33.27876883289472,96676516,0.16722554005700618,-1.0446226009937618,-1.211848141050768
2025-09-11T09:45:00-04:00,349.03,350.29,348.32,349.22,346.6232994041423,NaN,NaN,NaN,NaN,NaN,352.3691999999987,357.4841253605981,347.25427463939934,347.4714786040974,349.41588856204964,349.81949820223264,349.01227892186665,140234,86377.8,43.51462122283694,33.7757627528153,NaN,NaN,NaN,NaN,1.3908091027550553,31.513433494161262,96816750,0.1879996831490549,-0.9768485371144493,-1.1648482202635042
2025-09-11T09:50:00-04:00,349.27,351.47,349.27,350.91,346.6232994041423,NaN,NaN,NaN,NaN,NaN,352.3019999999987,357.4035385918967,347.20046140810075,347.4714786040974,349.63574815842054,350.21222689750323,349.05926941933785,151815,88038.46666666666,52.61588180523481,36.078583323804686,NaN,NaN,NaN,NaN,1.4521798811296942,29.670426137357726,96968565,0.309636810257754,-0.7778022074413116,-1.0874390176990656
2025-09-11T09:55:00-04:00,350.91,352.2,350.23,351.49,347.2454068472825,NaN,NaN,NaN,NaN,NaN,352.24819999999875,357.3260652054201,347.1703347945774,347.4714786040974,349.96680768850075,350.80945627308876,349.12415910391275,193496,93236.63333333333,55.279072577447366,38.32172080862396,NaN,NaN,NaN,NaN,1.489167032477571,28.501547734106207,97162061,0.4165731507472149,-0.566722579265047,-0.9832957300122619
2025-09-11T10:00:00-04:00,351.49,351.71,350.66,351.42,347.2526610814969,NaN,NaN,NaN,NaN,NaN,352.19999999999874,357.2626206656748,347.1373793343227,347.4714786040974,350.0885318072603,350.9753208210826,349.20174279343803,101189,95801.8,54.87818376752266,40.68740166246479,NaN,NaN,NaN,NaN,1.4577979587291698,27.416160645372656,97060872,0.4662586073568289,-0.4004724708162257,-0.8667310781730546
2025-09-11T10:05:00-04:00,351.37,353.68,351.34,353.57,348.43731285051973,NaN,NaN,NaN,NaN,NaN,352.18679999999875,357.2315904856767,347.1420095143208,348.9857992177626,350.52621589285775,351.82439603091746,349.22803575479804,201845,101336.56666666667,63.60782346900893,43.72518861695609,NaN,NaN,NaN,NaN,1.520812390248517,27.655085957124527,97262717,0.6180682413422639,-0.09414577649522471,-0.7122140178374886
2025-09-11T10:10:00-04:00,353.61,355.65,353.53,354.59,350.41334408458704,NaN,NaN,NaN,NaN,NaN,352.19059999999877,357.2423346094565,347.138865390541,350.83463937421004,351.2312442491561,353.17055106298915,349.291937435323,268607,109227.26666666666,66.8814385074582,46.36968207456564,NaN,NaN,NaN,NaN,1.5636115052307662,28.75821431079637,97531324,0.7524065567075066,0.22829417804689456,-0.524112378660612
2025-09-11T10:15:00-04:00,354.66,355.36,353.67,354.13,350.41334408458704,NaN,NaN,NaN,NaN,NaN,352.1939999999987,357.25071988590435,347.1372801140931,350.83463937421004,351.6127248328906,353.7018475293917,349.52360213638946,212920,114959.56666666667,64.08183295959348,48.830561952171124,NaN,NaN,NaN,NaN,1.57263925485714,29.78254778206309,97318404,0.772586922373143,0.44162127430581677,-0.3309656480673262
2025-09-11T10:20:00-04:00,354.21,357.34,353.84,357.1,351.0871585564109,NaN,NaN,NaN,NaN,NaN,352.2807999999987,357.51913536961985,347.04246463037754,351.83216919949444,352.24969243863063,354.7381169005872,349.76126797667405,291861,123351.83333333333,72.17920475980608,51.17766479795541,NaN,NaN,NaN,NaN,1.7103078795102014,31.43272780348953,97610265,0.9372911136796626,0.840648244032252,-0.09664286964741053
2025-09-11T10:25:00-04:00,357.12,359.25,356.76,358.9,353.3672877129377,NaN,NaN,NaN,NaN,NaN,352.39519999999874,357.9475173400376,346.84288265995986,353.59873535959554,353.15566323911645,356.3067233000712,350.0046031781617,361326,133896.4,75.74768899915473,53.790389699109596,NaN,NaN,NaN,NaN,1.766000173830902,33.475172364027536,97971591,1.1071430304278005,1.2872859183873402,0.18014288795953964
2025-09-11T10:30:00-04:00,358.86,358.94,357.88,358.45,353.8385473623496,NaN,NaN,NaN,NaN,NaN,352.48459999999875,358.27495226600587,346.69424773399163,353.88898828767645,353.495561709761,356.80666988674756,350.1844535327744,166533,138469.93333333332,73.21918398279315,56.26035989704966,NaN,NaN,NaN,NaN,1.7155715899858375,35.37172802738425,97805058,1.1252043771037457,1.5866483593392218,0.46144398223547606
2025-09-11T10:35:00-04:00,358.44,358.92,357.05,357.48,353.8385473623496,NaN,NaN,NaN,NaN,NaN,352.5495999999987,358.4879404554283,346.61125954456907,353.9441906301412,353.72455672084266,357.0890043273384,350.3601091143469,144427,142333.5,67.9535520461857,58.843794485680625,NaN,NaN,NaN,NaN,1.726602190701135,36.32155278854622,97660631,1.0114297759266861,1.7257312021438338,0.7143014262171477
2025-09-11T10:40:00-04:00,357.51,358.87,357.37,357.91,353.8385473623496,NaN,NaN,NaN,NaN,NaN,352.6075999999987,358.6956914057326,346.5195085942648,354.13935250411294,353.8789944768532,357.2789225871792,350.47906636652726,100909,143566.33333333334,69.01727050234953,60.35080574073345,NaN,NaN,NaN,NaN,1.7104163199367683,37.203532923910906,97761540,0.9080266856135608,1.8493347832340987,0.9413080976205379
2025-09-11T10:45:00-04:00,357.95,358.59,357.42,358.36,353.8385473623496,NaN,NaN,NaN,NaN,NaN,352.68179999999876,358.95526244464145,346.40833755535607,354.22048200329033,354.05063359855507,357.484448447638,350.61681874947215,119108,144555.1,70.13450727415447,62.22997856146417,NaN,NaN,NaN,NaN,1.6718151542269963,38.02251447817811,97880648,0.8157515950250489,1.9609975914018491,1.1452459963768002
2025-09-11T10:50:00-04:00,358.42,359.95,358.38,359.73,354.59247895284267,NaN,NaN,NaN,NaN,NaN,352.78139999999877,359.33491998275093,346.2278800172466,355.6593856026323,354.44161988687733,358.02520744990596,350.8580323238487,234457,149274.23333333334,73.2921124269976,64.45731245003884,NaN,NaN,NaN,NaN,1.665971214639352,39.24800589306643,98115105,0.7921415196224078,2.13542289590481,1.3432813762824023
2025-09-11T10:55:00-04:00,359.67,360.55,358.01,358.83,354.59247895284267,NaN,NaN,NaN,NaN,NaN,352.8697999999988,359.62494795131914,346.11465204867847,355.84750848210587,354.8303288255459,358.49757502662084,351.163082624471,287467,157530.6,68.1914706868924,66.21994455461423,NaN,NaN,NaN,NaN,1.728401842165114,40.567910115243905,97827638,0.6661354770191703,2.1759507225563652,1.509815245537195
2025-09-11T11:00:00-04:00,358.83,359.75,358.38,359.04,354.59247895284267,NaN,NaN,NaN,NaN,NaN,352.95759999999876,359.91413426386714,346.0010657361304,355.84750848210587,354.93112980586966,358.6113190004732,351.2509406112661,84717,157168.83333333334,68.73816371382586,67.37153611951359,NaN,NaN,NaN,NaN,1.7028017105818918,41.7935354644087,97912355,0.5518744202226136,2.199658270815462,1.6477838505928484
2025-09-11T11:05:00-04:00,359.03,360.38,358.81,359.935,354.9100828871409,NaN,NaN,NaN,NaN,NaN,353.07089999999874,360.2888608453068,345.8529391546907,356.03740542854774,355.126028716313,358.85219606607455,351.3998613665514,151076,158994.36666666667,71.02391062365513,68.49616740852844,NaN,NaN,NaN,NaN,1.693315874111756,43.127064644885365,98063431,0.49342191267489555,2.2645612414364678,1.7711393287615722
2025-09-11T11:10:00-04:00,359.92,362.69,359.56,362.08,356.22621548317994,NaN,NaN,NaN,NaN,NaN,353.2194999999988,360.85522242838863,345.58377757160895,357.6509243428382,355.65706276445036,359.63071479696833,351.6834107319324,339847,165098.06666666668,75.62398906581333,69.97801064412063,NaN,NaN,NaN,NaN,1.7959361688180588,44.94022170985876,98403278,0.5516607710630681,2.4607152925904074,1.9090545215273393
2025-09-11T11:15:00-04:00,362.01,363.3,361.83,363.15,357.6884329612172,NaN,NaN,NaN,NaN,NaN,353.3938999999988,361.51514110979275,345.2726588902048,358.53373947427053,356.0148562811995,360.1871338486321,351.84257871376695,214454,168523.3,77.53950574690978,70.97313080682783,NaN,NaN,NaN,NaN,1.772655013902485,46.746948300785604,98617732,0.6101252046498518,2.6717110273396543,2.0615858226898025
2025-09-11T11:20:00-04:00,363.15,363.23,361.88,362.46,357.7160041902528,NaN,NaN,NaN,NaN,NaN,353.5432999999988,362.04253563877455,345.04406436122304,358.74199157941644,356.26577997411977,360.5444404381745,351.98711951006504,170717,170813.86666666667,73.52696076920509,71.44781096838118,NaN,NaN,NaN,NaN,1.7424653700523092,48.42462299236053,98447015,0.5519565351083466,2.7515314915752356,2.199574956466889
2025-09-11T11:25:00-04:00,362.5,363,361.47,361.63,357.7160041902528,NaN,NaN,NaN,NaN,NaN,353.6636999999988,362.4425894083074,344.8848105916902,358.74199157941644,356.48870241809004,360.8286764199081,352.148728416272,178031,173408.46666666667,68.90764174172824,71.79251159567652,NaN,NaN,NaN,NaN,1.727289272191428,49.484996773642756,98268984,0.4135413003338848,2.716501581884245,2.30296028155036
2025-09-11T11:30:00-04:00,361.61,361.78,360.86,361.12,357.7160041902528,NaN,NaN,NaN,NaN,NaN,353.7854999999987,362.8025909390804,344.768409060917,358.74199157941644,356.5945553018337,360.94312580977993,352.24598479388743,104656,174508.76666666666,66.15730473040168,71.36237587929048,NaN,NaN,NaN,NaN,1.6696257527491802,49.7521994174352,98164328,0.251564136580392,2.61741545227585,2.365851315695458
2025-09-11T11:35:00-04:00,361.19,362.04,360.94,361.69,357.7160041902528,NaN,NaN,NaN,NaN,NaN,353.92569999999876,363.2081449388851,344.6432550611124,358.74199157941644,356.69013981134844,361.0502966777427,352.32998294495417,92525,175018.3,67.7086010060169,70.78815530835206,NaN,NaN,NaN,NaN,1.6289381989813834,50.09206790244644,98256853,0.1516596341613936,2.5554258583972,2.4037662242358064
2025-09-11T11:40:00-04:00,361.66,362.66,361.52,362.4,357.7160041902528,NaN,NaN,NaN,NaN,NaN,354.07949999999875,363.65890796727285,344.50009203272464,359.12563175092896,356.78450774780197,361.16576217830686,352.4032533172971,83803,174486.5,69.57915097229207,70.52815295045913,NaN,NaN,NaN,NaN,1.5940140419112878,50.62171599075621,98340656,0.1044870423713431,2.534375027199985,2.429887984828642
2025-09-11T11:45:00-04:00,362.42,362.78,362.1,362.5,357.9451252911375,NaN,NaN,NaN,NaN,NaN,354.24509999999873,364.11050267619885,344.3796973237986,359.61250540074315,356.87359602440085,361.277203998759,352.46998805004273,77936,174912.86666666667,69.8441113404734,70.6631929000511,NaN,NaN,NaN,NaN,1.5287273246319066,51.15464534044914,98418592,0.05367173375336476,2.496977652020348,2.4433059182669834
2025-09-11T11:50:00-04:00,362.56,363.56,362.2,362.23,358.40398323244943,NaN,NaN,NaN,NaN,NaN,354.40589999999867,364.52139261102116,344.2904073889762,360.34600432059455,357.03111263304754,361.47536237685233,352.58686288924275,138857,176078.3,68.11896447792722,70.59902818402095,NaN,NaN,NaN,NaN,1.5166753728724858,51.90881579909528,98279735,-0.0204978011055319,2.4176836668850683,2.4381814679906
2025-09-11T11:55:00-04:00,362.25,362.74,361.89,362.44,358.40398323244943,NaN,NaN,NaN,NaN,NaN,354.5832999999987,364.9421199348934,344.224480065104,360.34600432059455,357.1241176734437,361.58428282202345,352.663952524864,90718,173153.2,68.76517724857668,70.50121889647967,NaN,NaN,NaN,NaN,1.4690557033815956,52.19624867213633,98370453,-0.07473802568151555,2.3447589358887058,2.4194969615702213
2025-09-11T12:00:00-04:00,362.42,362.53,361.59,361.7,358.40398323244943,NaN,NaN,NaN,NaN,NaN,354.7348999999987,365.28230925363346,344.1874907463639,360.34600432059455,357.21509307664485,361.68131399889705,352.74887215439264,100019,170329.36666666667,63.853551335523186,69.82703596137436,NaN,NaN,NaN,NaN,1.43126601028291,52.06314644853003,98270434,-0.17410002001541036,2.2018719365509583,2.3759719565663686
2025-09-11T12:05:00-04:00,361.66,362.53,361.53,362.27,358.40398323244943,NaN,NaN,NaN,NaN,NaN,354.90729999999866,365.6579749948006,344.1566250051967,360.34600432059455,357.28240081185686,361.7542885338727,352.81051308984104,73819,167760.66666666666,65.87541520005715,69.66160342660041,NaN,NaN,NaN,NaN,1.400461295262702,51.85712843503039,98344253,-0.21253679678519122,2.1103009605848797,2.322837757370071
2025-09-11T12:10:00-04:00,362.26,362.73,362.02,362.58,358.40398323244943,NaN,NaN,NaN,NaN,NaN,355.07449999999875,366.0352036728298,344.1137963271677,360.34600432059455,357.34805417468874,361.8288918011418,352.86721654823566,69173,164884.73333333334,66.95790876451662,69.5344423587926,NaN,NaN,NaN,NaN,1.3511426313153687,51.76316747196883,98413426,-0.22688008639226265,2.039237649379743,2.2661177357720055
2025-09-11T12:15:00-04:00,362.52,362.8,362.2,362.75,358.44669130695206,NaN,NaN,NaN,NaN,NaN,355.2528999999987,366.41528685782635,344.09051314217106,360.4281178957724,357.39904181067277,361.88754903202914,352.9105345893164,53479,161992.9,67.56553510942163,69.28741553634735,NaN,NaN,NaN,NaN,1.2974895862214153,51.71126711387933,98466905,-0.23378751339627613,1.9738833440266603,2.2076708574229365
2025-09-11T12:20:00-04:00,362.73,362.88,361.66,361.81,358.44669130695206,NaN,NaN,NaN,NaN,NaN,355.4350999999987,366.7215677363482,344.14863226364923,360.4281178957724,357.4500550400232,361.94081256442564,352.95929751562073,60026,158933.26666666666,60.897025725455826,68.23548958346468,NaN,NaN,NaN,NaN,1.2919546157770263,50.83509029349155,98406879,-0.3059769448439824,1.8251996763679585,2.131176621211941
2025-09-11T12:25:00-04:00,361.79,361.87,360.32,360.38,358.44669130695206,NaN,NaN,NaN,NaN,NaN,355.6072999999987,366.9275150528906,344.2870849471068,360.4281178957724,357.509825487306,361.9834267725867,353.03622420202527,99136,155787.93333333332,52.42084126119487,66.44129926305648,NaN,NaN,NaN,NaN,1.310386428935811,48.32632083596729,98307743,-0.44587285459112325,1.573835552973037,2.0197084075641603
2025-09-11T12:30:00-04:00,360.43,361.05,360.31,360.96,358.44669130695206,NaN,NaN,NaN,NaN,NaN,355.79389999999876,367.1532392925637,344.43456070743383,360.4281178957724,357.5640525678244,362.01990228332386,353.1082028523249,95472,155597.36666666667,55.14771796465126,65.12849620558835,NaN,NaN,NaN,NaN,1.2696445411546822,45.98545959736416,98403215,-0.4915825597879977,1.4052302078291632,1.8968127676171609
2025-09-11T12:35:00-04:00,360.94,360.94,360.25,360.55,358.44669130695206,NaN,NaN,NaN,NaN,NaN,355.9796999999988,367.3402299895513,344.6191700104463,360.4281178957724,357.61323531083525,362.04908137333734,353.17738924833316,95252,152044.26666666666,52.84219150949791,63.98096404614332,NaN,NaN,NaN,NaN,1.2296699310722035,43.73959152811462,98307963,-0.5379210694734278,1.2244114307753762,1.762332500248804
2025-09-11T12:40:00-04:00,360.51,360.92,360.26,360.58,358.44669130695206,NaN,NaN,NaN,NaN,NaN,356.1798999999987,367.50479090294584,344.8550090970516,360.4281178957724,357.64286099386516,362.0664222407993,353.21929974693103,58782,145050.1,52.997033915196404,63.04094470220009,NaN,NaN,NaN,NaN,1.188979221709905,41.65414260666863,98366745,-0.5529187573745169,1.0711840535306578,1.6241028109051747
2025-09-11T12:45:00-04:00,360.54,361.33,360.2,361.22,358.44669130695206,NaN,NaN,NaN,NaN,NaN,356.4122999999987,367.6642205846696,345.16037941532784,360.4281178957724,357.67298015384125,362.087225922855,353.2587343848275,54782,139778.83333333334,56.29404433127713,62.225619225432965,NaN,NaN,NaN,NaN,1.1847664201591972,40.113433685741875,98421527,-0.5072974331507254,0.989981019466768,1.4972784526174934
2025-09-11T12:50:00-04:00,361.17,361.73,360.96,361.36,358.44669130695206,NaN,NaN,NaN,NaN,NaN,356.6780999999987,367.75573420427156,345.6004657957259,360.4281178957724,357.7091747941766,362.11661605367584,353.30173353467734,59196,132023.33333333334,57.004522240101814,61.32743145884795,NaN,NaN,NaN,NaN,1.1551402472906858,39.04684048657576,98480723,-0.45682543015687993,0.9262466649213934,1.3830720950782733
2025-09-11T12:55:00-04:00,361.32,361.83,361.11,361.82,358.44669130695206,NaN,NaN,NaN,NaN,NaN,356.94589999999874,367.85918322566556,346.0326167743319,360.4281178957724,357.75722641361943,362.15822848941656,353.3562243378223,75460,122494.46666666666,59.34313505091826,60.57736172387972,NaN,NaN,NaN,NaN,1.1240588010556347,38.14664949642322,98556183,-0.38449609149794006,0.9024519807058482,1.2869480722037883
2025-09-11T13:00:00-04:00,361.8,362.32,361.68,362.07,358.44669130695206,NaN,NaN,NaN,NaN,NaN,357.23349999999874,367.911312182449,346.55568781754846,360.4281178957724,357.80639112678165,362.20558744328156,353.40719481028174,70993,119309.8,60.597506363607074,60.04011471571399,NaN,NaN,NaN,NaN,1.0894831724088028,37.740506758020445,98627176,-0.31478398677579933,0.8934680887340392,1.2082520755098385
2025-09-11T13:05:00-04:00,362.1,362.58,361.93,362.44,358.7562752733359,NaN,NaN,NaN,NaN,NaN,357.53349999999875,367.9330804244007,347.1339195755968,360.59469071622937,357.8458801945185,362.2458840179003,353.44587637113665,54411,116309.26666666666,62.4442842603256,59.588622359410344,NaN,NaN,NaN,NaN,1.0580915172367438,37.57879008584041,98681587,-0.24199116126609832,0.9057631239272155,1.1477542851933138
2025-09-11T13:10:00-04:00,362.47,363.25,362.14,363.08,359.2039445790934,NaN,NaN,NaN,NaN,NaN,357.82769999999874,368.00358191969224,347.65181808030525,361.1067525729835,357.9330207638048,362.34292337067853,353.52311815693105,110738,116636.9,65.45990947033587,59.703362226182676,NaN,NaN,NaN,NaN,1.0617992660055486,37.93677277756009,98792325,-0.1533010038107694,0.9561280304298521,1.1094290342406214
2025-09-11T13:15:00-04:00,363.12,363.9,362.69,363.65,359.7976289164073,NaN,NaN,NaN,NaN,NaN,358.13449999999875,368.0661198579862,348.2028801420113,361.58040205838677,358.0117760078419,362.43819373866154,353.58535827702224,92224,115740.76666666666,67.92982561319066,59.850105827120785,NaN,NaN,NaN,NaN,1.0723850327194364,38.69275912699941,98884549,-0.06341382375175186,1.0301617545509316,1.0935755783026835
2025-09-11T13:20:00-04:00,363.67,364.27,363.28,364.09,360.30160032929786,NaN,NaN,NaN,NaN,NaN,358.4268999999988,368.18018844869357,348.673611551304,361.9193216467094,358.1282265218865,362.58627082746654,353.6701822163065,129930,112256.53333333334,69.72929231828311,60.048061795246966,NaN,NaN,NaN,NaN,1.0665003875251915,39.613718198968876,99014479,0.014359829010180736,1.1115253645654093,1.0971655355552286
2025-09-11T13:25:00-04:00,364.08,364.33,363.63,364.1,360.5690275870571,NaN,NaN,NaN,NaN,NaN,358.7200999999987,368.2540575184566,349.1861424815408,362.0994573173675,358.2372801192352,362.7246986766646,353.7498615618058,123476,106790.16666666667,69.77080693715055,60.20558121151332,NaN,NaN,NaN,NaN,1.0403217884162486,40.504487496316784,99137955,0.052989609751107336,1.1634025477441128,1.1104129379930054
2025-09-11T13:30:00-04:00,364.07,364.18,363.66,363.98,360.59316269673633,NaN,NaN,NaN,NaN,NaN,359.01289999999875,368.2718330035102,349.7539669964873,362.1355658538941,358.2987523762454,362.8006009182752,353.7969038342155,72693,106389.36666666667,68.55577290635561,60.75263458157759,NaN,NaN,NaN,NaN,1.0031559463865152,41.33163041528271,99065262,0.05664266257733663,1.1812162662146761,1.1245736036373395
2025-09-11T13:35:00-04:00,363.97,365.81,363.96,365.12,361.45710984688463,NaN,NaN,NaN,NaN,NaN,359.35809999999873,368.2059216281518,350.51027837184563,363.24945268311524,358.53972885699426,363.1312189296581,353.94823878433044,252983,109786.26666666666,73.31085153053701,62.244778172244885,NaN,NaN,NaN,NaN,1.0636448073589084,42.937790656609856,99318245,0.118462637217571,1.2726519001593033,1.1541892629417323
2025-09-11T13:40:00-04:00,365.15,366.66,365.02,366.19,362.34428667202627,NaN,NaN,NaN,NaN,NaN,359.67669999999873,368.3363696497945,351.01703035020296,363.7915621464922,358.75051325252196,363.4410991121971,354.0599273928468,204656,105279.9,76.8495236155736,63.79490714731077,NaN,NaN,NaN,NaN,1.1048130354047037,44.74166797981897,99522901,0.20876256956697348,1.415142474900449,1.2063799053334756
2025-09-11T13:45:00-04:00,366.18,366.26,365.46,365.84,362.4140918232978,NaN,NaN,NaN,NaN,NaN,360.00589999999875,368.3193545625479,351.6924454374496,363.7915621464922,358.8660056072192,363.6042364103271,354.12777480411137,119029,102099.06666666667,73.42033846231254,65.26477478679753,NaN,NaN,NaN,NaN,1.0830406757329398,46.41669692279886,99403872,0.22108262124718459,1.4827331818924563,1.2616505606452717
2025-09-11T13:50:00-04:00,365.86,366.56,365.55,366.47,362.6279967404206,NaN,NaN,NaN,NaN,NaN,360.3554999999987,368.2459631678853,352.4650368321121,363.899199773755,358.9612807065113,363.7412330164022,354.18132839662036,96438,99623.1,75.5363955928363,66.87472919234322,NaN,NaN,NaN,NaN,1.077823484609158,48.07920996718355,99500310,0.24591797550540972,1.5690480300270337,1.323130054521624
2025-09-11T13:55:00-04:00,366.4,366.46,365.9,366.09,362.83104234312873,NaN,NaN,NaN,NaN,NaN,360.6928999999987,368.07631820322325,353.30948179677415,364.04635981900395,359.02837704586665,363.83592592959076,354.22082816214254,69877,96017.96666666666,71.82220319889086,67.98388339717279,NaN,NaN,NaN,NaN,1.0415503785656501,49.622972079826475,99430433,0.212279431382981,1.5884793437503504,1.3761999123673694
2025-09-11T14:00:00-04:00,366.05,366.36,365.47,366.35,362.83104234312873,NaN,NaN,NaN,NaN,NaN,361.0016999999987,368.0043599548746,353.99904004512285,364.04635981900395,359.13066257548445,363.9768044190448,354.2845207319241,110512,96213.16666666667,72.80742258116015,69.11266199296267,NaN,NaN,NaN,NaN,1.0307253515252455,50.17546368994339,99540945,0.18411344573070165,1.6063417195307466,1.422228273800045
2025-09-11T14:05:00-04:00,366.34,366.5,365.88,366.35,362.9381811432227,NaN,NaN,NaN,NaN,NaN,361.29889999999875,367.912105362271,354.6856946377265,364.2892702841625,359.21053695508107,364.087328570555,354.33374533960716,86284,96005.13333333333,72.80742258116015,70.07439681655138,NaN,NaN,NaN,NaN,1.0013878264162996,50.76418703997252,99540945,0.14384183683869156,1.6020305698484094,1.4581887330097179
2025-09-11T14:10:00-04:00,366.38,367.44,366.24,367.44,363.5723547276217,NaN,NaN,NaN,NaN,NaN,361.61929999999876,367.82683542427037,355.41176457572715,365.07141622733,359.37115730508106,364.3236275703666,354.4186870397955,160926,98575.9,76.75847702467652,71.22875186377063,NaN,NaN,NaN,NaN,1.015574410243706,51.76329135138037,99701871,0.16732717102753636,1.6673476967941383,1.500020525766602
2025-09-11T14:15:00-04:00,367.43,367.64,366.76,366.81,363.9608840581843,NaN,NaN,NaN,NaN,NaN,361.88409999999874,367.8191813611641,355.94901863883337,365.305132981864,359.49276420230416,364.4988595658806,354.4866688387277,125894,100174.5,70.39219487601663,71.79645976489141,NaN,NaN,NaN,NaN,1.0058905237977267,52.77594332803475,99575977,0.119395227700408,1.649264560392112,1.5298693326917039
2025-09-11T14:20:00-04:00,366.84,366.85,365.22,365.29,363.9608840581843,NaN,NaN,NaN,NaN,NaN,362.09809999999874,367.7295924810112,356.4666075189863,365.305132981864,359.5932321597739,364.6214714449393,354.5649928746085,129291,99855.63333333333,57.91213117134476,71.2573327435349,NaN,NaN,NaN,NaN,1.0504697720978888,51.12588260622773,99446686,-0.027856856590915857,1.495048261953059,1.5229051185439748
2025-09-11T14:25:00-04:00,365.275,365.69,364.78,365.23,363.9608840581843,NaN,NaN,NaN,NaN,NaN,362.3200999999987,367.53757313971977,357.10262686027767,365.305132981864,359.6664517438578,364.70257819435545,354.63032529336016,106531,100382.73333333334,57.47892634316201,70.51083993853284,NaN,NaN,NaN,NaN,1.0404362169480414,49.01007609383107,99340155,-0.1364044029218352,1.3523996148916808,1.488804017813516
2025-09-11T14:30:00-04:00,365.225,365.59,364.95,365.25,363.9608840581843,NaN,NaN,NaN,NaN,NaN,362.48309999999873,367.54497115242873,357.4212288475687,365.305132981864,359.7238422431939,364.7657085299932,354.6819759563945,85017,99882.66666666667,57.59280091543858,69.64394769547253,NaN,NaN,NaN,NaN,1.0118336300231803,47.04539861803418,99425172,-0.20958614661428365,1.2268213345456616,1.4364074811599452
2025-09-11T14:35:00-04:00,365.26,366.36,364.98,366.36,363.9608840581843,NaN,NaN,NaN,NaN,NaN,362.63229999999874,367.7026882340224,357.5619117659751,365.305132981864,359.79913856400816,364.85580508830105,354.74247203971527,102328,100832.96666666666,63.44416256123053,69.19204452576396,NaN,NaN,NaN,NaN,1.0381312278786672,45.85675676052551,99527500,-0.18672603964663392,1.2029999316016529,1.3897259712482868
2025-09-11T14:40:00-04:00,366.37,366.55,366.02,366.34,363.9608840581843,NaN,NaN,NaN,NaN,NaN,362.7900999999987,367.82097129271415,357.7592287072832,365.305132981864,359.8762406461698,364.9518990188369,354.80058227350264,100691,101883.56666666667,63.27475238036219,68.81482877390728,NaN,NaN,NaN,NaN,1.0018361401730502,44.89841194641409,99426809,-0.1765554996056644,1.1690315967412062,1.3455870963468706
2025-09-11T14:45:00-04:00,366.32,366.51,366.02,366.13,363.9608840581843,NaN,NaN,NaN,NaN,NaN,362.96309999999875,367.84434692713984,358.08185307285765,365.305132981864,359.9271201270707,365.01395238200274,354.8402878721386,68677,102390.16666666667,61.420225113065854,67.96549831551648,NaN,NaN,NaN,NaN,0.9652764158749758,44.00852033331063,99358132,-0.18659464121977476,1.1123437948221522,1.298938436041927
2025-09-11T14:50:00-04:00,366.17,366.82,366.17,366.65,363.9608840581843,NaN,NaN,NaN,NaN,NaN,363.1378999999987,367.90750211797916,358.3682978820182,365.305132981864,359.98494332492726,365.0868303146904,354.8830563351641,75457,102904.53333333334,64.21694468078044,67.06317124874555,NaN,NaN,NaN,NaN,0.9456138147410488,43.435261119088764,99433589,-0.16176236985794867,1.096735473719491,1.2584978435774397
2025-09-11T14:55:00-04:00,366.675,367.38,366.47,367.38,363.9608840581843,NaN,NaN,NaN,NaN,NaN,363.3182999999987,368.0334134073176,358.60318659267983,365.305132981864,360.0804768824481,365.21340764582135,354.9475461190749,117956,103531.86666666667,67.75126652319628,66.65823753880868,NaN,NaN,NaN,NaN,0.9430699708309715,43.326266042487646,99551545,-0.10260472254870656,1.1302419403915565,1.232846662940263
2025-09-11T15:00:00-04:00,367.33,367.55,366.66,366.8,364.072329134401,NaN,NaN,NaN,NaN,NaN,363.4596999999987,368.15991548909204,358.75948451090534,365.4306954472437,360.1457531653467,365.29805239571397,354.99345393497947,83349,103127.76666666666,62.47166021209923,65.72504215447032,NaN,NaN,NaN,NaN,0.9392792586287584,43.34694761071973,99468196,-0.10840101889764497,1.0973453893182068,1.2057464082158518
2025-09-11T15:05:00-04:00,366.78,367.21,366.48,366.62,364.072329134401,NaN,NaN,NaN,NaN,NaN,363.61549999999875,368.20670910040496,359.02429089959253,365.4306954472437,360.22200413665587,365.3930686482217,355.05093962509005,102936,103383.9,60.88592658579002,64.94387953924883,NaN,NaN,NaN,NaN,0.9243307401552728,43.033670288953616,99365260,-0.12883120395557057,1.0447074032713886,1.1735386072269591
2025-09-11T15:10:00-04:00,366.64,366.75,365.77,366.11,364.072329134401,NaN,NaN,NaN,NaN,NaN,363.7568999999987,368.2091142315716,359.3046857684258,365.4306954472437,360.28308671171544,365.46277491083663,355.10339851259425,92161,104496.53333333334,56.50920669330574,63.779721261544935,NaN,NaN,NaN,NaN,0.9283071158584689,41.54158523463049,99273099,-0.17812883957687964,0.9508775577558595,1.129006397332739
2025-09-11T15:15:00-04:00,366.1,367.07,365.88,366.96,364.072329134401,NaN,NaN,NaN,NaN,NaN,363.89739999999875,368.3014305361854,359.4933694638121,365.4306954472437,360.3672342889854,365.56352129343605,355.17094728453475,121262,106712.53333333334,61.47924825127479,62.970565952267414,NaN,NaN,NaN,NaN,0.9469994647257209,40.464605108654965,99394361,-0.1557377559869746,0.9343342023490209,1.0900719583359955
2025-09-11T15:20:00-04:00,366.94,368.36,366.86,367.14,364.52447043997785,NaN,NaN,NaN,NaN,NaN,363.99859999999876,368.4630641519159,359.53413584808163,365.76545285519103,360.5286647196104,365.7731021874483,355.2842272517725,213446,111854.2,62.4576613894657,61.94907912118092,NaN,NaN,NaN,NaN,0.986499502959598,40.4841016634156,99607807,-0.13199022654751924,0.9250841751515964,1.0570744016991156
2025-09-11T15:25:00-04:00,367.13,367.33,366.4,367.06,364.52447043997785,NaN,NaN,NaN,NaN,NaN,364.07679999999874,368.61542788118254,359.53817211881494,365.76545285519103,360.61352299838967,365.8742763368937,355.35276965988567,125872,113534.6,61.70747793113795,61.32874219654673,NaN,NaN,NaN,NaN,0.9824638241767701,39.804860406591224,99481935,-0.12492914802976762,0.900912966661906,1.0258421146916736
2025-09-11T15:30:00-04:00,367.03,367.36,366.51,366.61,364.52447043997785,NaN,NaN,NaN,NaN,NaN,364.1597999999987,368.7288077526662,359.5907922473312,365.76545285519103,360.6655360857364,365.9347201344388,355.396352037034,80160,113840.16666666667,57.52219856892732,61.30088986780264,NaN,NaN,NaN,NaN,0.9730021224498596,39.19804108191393,99401775,-0.15202476389690944,0.8358111598205369,0.9878359237174463
2025-09-11T15:35:00-04:00,366.62,366.75,366.15,366.2,364.52447043997785,NaN,NaN,NaN,NaN,NaN,364.25119999999873,368.7969032727339,359.70549672726355,365.76545285519103,360.71869095744273,365.99179778862674,355.4455841262587,90117,115030.36666666667,53.93300175007196,61.04760953972477,NaN,NaN,NaN,NaN,0.9463591137034426,38.081542258344,99311658,-0.19620953538114227,0.7425740044910185,0.9387835398721608
2025-09-11T15:40:00-04:00,366.2,366.64,365.85,366.05,364.52447043997785,NaN,NaN,NaN,NaN,NaN,364.3497999999987,368.832994379437,359.8666056205604,365.76545285519103,360.7742091249842,366.04897078777344,355.499447462195,99266,114647.96666666666,52.63892249945262,60.69376108144006,NaN,NaN,NaN,NaN,0.9351906055817656,36.60122476083207,99212392,-0.23174942598827686,0.6490967573868147,0.8808461833750916
2025-09-11T15:45:00-04:00,366.07,366.73,366.02,366.73,364.52447043997785,NaN,NaN,NaN,NaN,NaN,364.45059999999876,368.9166558173528,359.9845441826447,365.76545285519103,360.8253740224556,366.10402894251246,355.54671910239875,88147,114512.06666666667,57.605099953641094,60.27668518089796,NaN,NaN,NaN,NaN,0.9191055623259279,35.32095793056228,99300539,-0.20651094815977478,0.6227074981753731,0.8292184463351479
2025-09-11T15:50:00-04:00,366.72,368.1,366.63,367.89,364.52447043997785,NaN,NaN,NaN,NaN,NaN,364.5603999999987,369.08890873510836,360.03189126488905,365.76545285519103,360.9565483406138,366.2653554977341,355.64774118349345,196318,116725,64.45273507006033,60.360826801590676,NaN,NaN,NaN,NaN,0.958455165016935,35.33776506882253,99496857,-0.11339765032460059,0.6874713834293971,0.8008690337539977
2025-09-11T15:55:00-04:00,367.91,368.99,367.32,368.88,365.07035340546815,NaN,NaN,NaN,NaN,NaN,364.68799999999874,369.33508080453373,360.04091919546374,366.2094030666169,361.13294158338005,366.4991806352801,355.76670253148,244037,120743.7,69.04769639314628,60.905646178739275,NaN,NaN,NaN,NaN,1.0092797960871551,35.937022738696896,99740894,0.006786570136091408,0.8093522464241119,0.8025656762880204
2025-09-12T09:30:00-04:00,370.78,374.72,370.25,374.39,368.7442009779469,NaN,NaN,NaN,NaN,NaN,364.93119999999874,370.26090339173015,359.6014966082673,369.57552245329356,373.12000000000006,373.12000000000006,373.12000000000006,587047,137888.83333333334,82.55989205740897,62.215856705641315,NaN,NaN,NaN,NaN,1.3543312392237892,38.37393456751549,100327941,0.426078437505639,1.3351637231700693,0.9090852856644303
2025-09-12T09:35:00-04:00,374.26,377.52,373.57,377.01,371.43560093349475,NaN,NaN,NaN,NaN,NaN,365.2225999999987,371.4868947698831,358.95830523011426,371.42941796263483,374.61403804729537,376.0702252460014,373.1578508485893,617962,150054.8,85.74626139823887,63.50121348243007,NaN,NaN,NaN,NaN,1.5397361507078033,41.05936211615647,100945903,0.8254610433662619,1.9409115898722575,1.1154505465059956
2025-09-12T09:40:00-04:00,376.985,379.53,376.85,378.2,373.90193725469953,NaN,NaN,NaN,NaN,NaN,365.55259999999873,372.7140331640923,358.39116683590515,373.31753437010786,375.55333887070645,377.56424919687095,373.54242854454196,428738,157524.2,86.91557732357222,65.247207561821,NaN,NaN,NaN,NaN,1.6211835685143854,43.78038835630309,101374641,1.0982879617211903,2.4883104986574835,1.3900225369362933
2025-09-12T09:45:00-04:00,378.17,381.28,377.68,381.14,374.8959401067587,NaN,NaN,NaN,NaN,NaN,365.9299999999987,374.2541653037323,357.6058346962651,374.5100274960863,376.5230105231992,379.0866738843346,373.95934716206386,451297,168599.8,89.25980723486995,67.27391332246957,NaN,NaN,NaN,NaN,1.7625275993347842,46.47159294721426,101825938,1.3866678803087151,3.123357387322187,1.736689507013472
2025-09-12T09:50:00-04:00,381.14,384.22,380.41,384.09,377.419761010997,NaN,NaN,NaN,NaN,NaN,366.36019999999866,376.05744124914133,356.662958750856,376.89902199686907,377.7144305050708,381.1102901893647,374.3185708207769,478438,181333.13333333333,91.0018480620609,69.7376734202378,NaN,NaN,NaN,NaN,1.9087756279537285,49.19124286303726,102304376,1.6671564463176263,3.8206350649105048,2.1534786185928785
2025-09-12T09:55:00-04:00,384.15,386.98,383.37,384.58,380.0099991468607,NaN,NaN,NaN,NaN,NaN,366.7967999999986,377.6958006442918,355.8977993557054,379.3182175974953,379.035768719362,383.1931256618171,374.87841177690694,570154,198009.03333333333,91.25555778585755,71.86455267270799,NaN,NaN,NaN,NaN,2.030291654528463,51.8757569318311,102874530,1.7672039515319335,4.362483558007796,2.595279606475862
2025-09-12T10:00:00-04:00,384.61,387.5,383.91,385.96,380.28522645836705,NaN,NaN,NaN,NaN,NaN,367.2797999999987,379.3315162198557,355.22808378014173,379.5755740779962,379.9241495723843,384.4209728954612,375.4273262493074,474588,210144.9,91.9444432801467,73.9707513791852,NaN,NaN,NaN,NaN,2.141699393490714,54.39536656416845,103349118,1.8016797455440106,4.847379288405875,3.0456995428618647
2025-09-12T10:05:00-04:00,386,387.9,384.9,387.85,380.8174888920776,NaN,NaN,NaN,NaN,NaN,367.82919999999865,381.0230839408312,354.6353160591661,380.06045926239693,380.6325040397991,385.38549731663454,375.8795107629636,408890,220898.43333333332,92.78301140108883,76.19043234132457,NaN,NaN,NaN,NaN,2.2030065796699487,56.75611482775711,103758008,1.8216897991835737,5.322811791841332,3.501121992657758
2025-09-12T10:10:00-04:00,387.89,388.49,386.16,386.685,381.678512124256,NaN,NaN,NaN,NaN,NaN,368.34369999999865,382.4038619921032,354.2835380078941,381.0533674099176,381.1282964258755,386.0097686888863,376.24682416286464,332865,226629.73333333334,86.78591746015609,78.28069797641231,NaN,NaN,NaN,NaN,2.212077538264951,58.97984573785047,103425143,1.632469084423485,5.5417083481871146,3.9092392637636295
2025-09-12T10:15:00-04:00,386.64,387.21,385.18,386.4,381.678512124256,NaN,NaN,NaN,NaN,NaN,368.8606999999986,383.6201734338436,354.10122656615357,381.0533674099176,381.47089978935634,386.3577033361053,376.58409624260736,310973,232799.03333333333,85.33282868457951,80.52354275744858,NaN,NaN,NaN,NaN,2.199071999817453,60.24874892000718,103114170,1.3744646569458565,5.62732008494595,4.252855428000093
2025-09-12T10:20:00-04:00,386.39,388.26,386.12,388.26,381.678512124256,NaN,NaN,NaN,NaN,NaN,369.4142999999986,384.94611225885194,353.88248774114527,381.61855514234725,381.9106861310213,386.873638128977,376.9477341330656,363703,240612.76666666666,86.87710595403225,82.96912728991855,NaN,NaN,NaN,NaN,2.1948525712590623,61.53341404207032,103477873,1.2206291552293767,5.778641872036815,4.558012716807438
2025-09-12T10:25:00-04:00,388.23,392.41,388.17,391.79,384.2700587699788,NaN,NaN,NaN,NaN,NaN,370.0256999999986,386.5914473131852,353.459952686812,384.97684411387786,382.9104758660612,388.3634915136046,377.4574602185178,637551,258313.43333333332,89.20096731316771,85.22597495845616,NaN,NaN,NaN,NaN,2.3409345304548443,63.059379141538685,104115424,1.2439424671164732,6.112940800703029,4.868998333586556
2025-09-12T10:30:00-04:00,391.8,394.19,391.34,393.06,386.6300560986161,NaN,NaN,NaN,NaN,NaN,370.6596999999986,388.2453455566533,353.0740544433439,386.81847529110223,383.6621203420548,389.5277652951771,377.79647538893244,462544,270897.6666666667,89.89432841184379,87.04323162572642,NaN,NaN,NaN,NaN,2.3772963497080712,64.58634827236122,104577968,1.2300039843607387,6.406503314037479,5.176499329676741
2025-09-12T10:35:00-04:00,393.08,393.74,389.45,390.01,386.6300560986161,NaN,NaN,NaN,NaN,NaN,371.2234999999986,389.43577478939085,353.0112252106063,386.81847529110223,384.0415658270552,389.9836455176558,378.0994861364546,330815,278513.9,77.0926126105264,87.61786849839642,NaN,NaN,NaN,NaN,2.5139180390146385,64.77443758014076,104247153,0.91495174113152,6.320189006091141,5.405237264959621
2025-09-12T10:40:00-04:00,390.05,390.62,386.9,387.87,386.6300560986161,NaN,NaN,NaN,NaN,NaN,371.73949999999866,390.3429265930805,353.1360734069168,386.81847529110223,384.2703514017586,390.1389735803183,378.4017292231989,352241,286898.9,69.60295156843254,86.69237274918382,NaN,NaN,NaN,NaN,2.600066750513595,63.52249717840074,103894912,0.4836714995499758,6.00982663939709,5.5261551398471145
2025-09-12T10:45:00-04:00,387.9,390.35,387.6,389.18,386.6300560986161,NaN,NaN,NaN,NaN,NaN,372.2742999999986,391.3100207387649,353.23857926123236,386.81847529110223,384.47869025033793,390.30006415493693,378.65731634573893,310721,294967.0333333333,71.43257890999323,85.66996685716627,NaN,NaN,NaN,NaN,2.6107762683340523,62.35998109107073,104205633,0.2212187782190016,5.802678612620866,5.581459834401865
2025-09-12T10:50:00-04:00,389.21,389.7,388.11,389.33,386.6300560986161,NaN,NaN,NaN,NaN,NaN,372.7992999999987,392.23548028430343,353.363119715694,386.81847529110223,384.62082280961397,390.40554522885,378.83610039037796,228606,300072,71.64305141439941,84.57907214936822,NaN,NaN,NaN,NaN,2.5378636777387613,61.28050186712144,104434239,0.003809388811218284,5.586221570415887,5.582412181604669
2025-09-12T10:55:00-04:00,389.4,389.85,388.5,389.63,386.6300560986161,NaN,NaN,NaN,NaN,NaN,373.3188999999987,393.13430282618657,353.5034971738108,386.81847529110223,384.7251005399655,390.48716100179763,378.9630400781334,166496,301690,72.08600779735258,83.35237218954555,NaN,NaN,NaN,NaN,2.4530162721859945,60.31090530145844,104600735,-0.1644067861317371,5.376903698939998,5.541310485071735
2025-09-12T11:00:00-04:00,389.65,390.64,389.01,390.07,386.6300560986161,NaN,NaN,NaN,NaN,NaN,373.8384999999987,394.0178060585347,353.6591939414627,386.81847529110223,384.8428419625567,390.59115686064115,379.09452706447223,174703,304735.13333333336,72.75813943633341,82.04925014485072,NaN,NaN,NaN,NaN,2.39422939560128,59.58618823742966,104775438,-0.283662248168322,5.186732674861332,5.470394923029654
2025-09-12T11:05:00-04:00,390.035,390.8,388.93,390.54,386.6300560986161,NaN,NaN,NaN,NaN,NaN,374.36729999999875,394.8810517983412,353.8535482016563,386.81847529110223,384.96286756461416,390.69895243331956,379.22678269590875,179983,307303.36666666664,73.49237113898151,80.78045109864529,NaN,NaN,NaN,NaN,2.356784438772617,58.9493703410629,104955421,-0.3634174619445467,5.016123095598971,5.379540557543518
2025-09-12T11:10:00-04:00,390.52,391.75,389.06,389.27,386.6300560986161,NaN,NaN,NaN,NaN,NaN,374.8730999999987,395.58363441039126,354.1625655896062,386.81847529110223,385.1139463961773,390.82912128477057,379.39877150758406,241971,312297.0333333333,68.14750453723637,79.08066975986597,NaN,NaN,NaN,NaN,2.3805855502888584,58.57280148582331,104713450,-0.5244482183979446,4.723980284546087,5.248428502944032
2025-09-12T11:15:00-04:00,389.265,389.96,388.14,388.14,386.6300560986161,NaN,NaN,NaN,NaN,NaN,375.33349999999876,396.17934795598075,354.4876520440168,386.81847529110223,385.19200635077334,390.86993138729173,379.51408131425495,178101,314191.6666666667,63.70787113972213,77.00387402691122,NaN,NaN,NaN,NaN,2.3405437252682253,57.56706505473821,104535349,-0.7178496155791958,4.351116483470037,5.0689660990492325
2025-09-12T11:20:00-04:00,388.16,389.34,387.2,389.02,386.6300560986161,NaN,NaN,NaN,NaN,NaN,375.7900999999987,396.81419993232004,354.76600006767734,385.83944443309485,385.2574757932787,390.8982394729481,379.61671211360925,166324,312620.93333333335,65.58803432873664,75.4897395175241,NaN,NaN,NaN,NaN,2.3262191734633513,55.99630407902799,104701673,-0.7914922536709001,4.0796007819606075,4.871093035631508
2025-09-12T11:25:00-04:00,389.04,389.2,387.95,388.19,386.6300560986161,NaN,NaN,NaN,NaN,NaN,376.2370999999987,397.34619245714356,355.1280075428538,385.83944443309485,385.30632125513876,390.917406763658,379.6952357466195,131506,312808.73333333334,62.30922935784047,73.84519670847132,NaN,NaN,NaN,NaN,2.2493463753588263,54.5377403158685,104570167,-0.893536187080171,3.7541728017812943,4.647708988861465
2025-09-12T11:30:00-04:00,388.225,389.25,387.8,388.8,386.6300560986161,NaN,NaN,NaN,NaN,NaN,376.68369999999874,397.89196242868775,355.4754375713097,385.83944443309485,385.3489970229614,390.9362903759536,379.76170366996917,112136,313874.6,63.74376104592393,72.19281492932072,NaN,NaN,NaN,NaN,2.192250205690338,53.074017917220814,104682303,-0.9140982049494353,3.505086232674671,4.419184437624106
2025-09-12T11:35:00-04:00,388.795,390.43,388.64,390.13,386.6300560986161,NaN,NaN,NaN,NaN,NaN,377.1644999999987,398.4800305119099,355.84896948808756,385.83944443309485,385.44564984932714,391.008388865274,379.88291083338027,196078,317406.63333333336,66.7180954133826,70.5868955079075,NaN,NaN,NaN,NaN,2.1635180481410297,52.12613634616344,104878381,-0.8344789091106204,3.3760858012358312,4.210564710346452
2025-09-12T11:40:00-04:00,390.17,390.22,389.09,389.78,386.6300560986161,NaN,NaN,NaN,NaN,NaN,377.63309999999876,399.0071331141324,356.25906688586514,385.8691225214692,385.5020136521416,391.0491036745161,379.9549236297671,119515,318081.6,65.20219612425812,68.82317177307995,NaN,NaN,NaN,NaN,2.089695330416674,51.24596060161017,104758866,-0.8015534107086904,3.2086229469605883,4.010176357669279
2025-09-12T11:45:00-04:00,389.68,390.24,389.43,389.9,386.6300560986161,NaN,NaN,NaN,NaN,NaN,378.1040999999987,399.5007213866634,356.70747861333405,386.3542980171754,385.5449213714387,391.081348618959,380.0084941239184,89701,318133.4,65.49169588623192,67.99453486420178,NaN,NaN,NaN,NaN,1.9982885211011971,50.43602080215419,104848567,-0.7677994846092346,3.0504270019077353,3.81822648651697
2025-09-12T11:50:00-04:00,389.9,390.85,389.4,390.83,386.6300560986161,NaN,NaN,NaN,NaN,NaN,378.5718999999987,400.03810831828713,357.1056916817103,387.0164384137403,385.6090023112211,391.136076217665,380.0819284047772,122789,315682.43333333335,67.73223073690937,67.8609119476644,NaN,NaN,NaN,NaN,1.9591250553082578,49.91260462272834,104971356,-0.6818534746325158,2.9659096432263254,3.647763117858841
2025-09-12T11:55:00-04:00,390.87,392.65,390.81,391.71,386.6300560986161,NaN,NaN,NaN,NaN,NaN,379.06989999999877,400.57681688652735,357.5629831134702,388.6631507309922,385.756766481416,391.2967961195552,380.21673684327675,228496,315164.4,69.73466375217596,67.7396322935346,NaN,NaN,NaN,NaN,1.9506161227862375,50.01492947532068,105199852,-0.5693367106696181,2.936092229521819,3.505428940191437
2025-09-12T12:00:00-04:00,391.72,391.89,389.77,389.92,386.6300560986161,NaN,NaN,NaN,NaN,NaN,379.5624999999987,400.91206620178025,358.21293379821714,388.6631507309922,385.8354592606979,391.3630938143653,380.30782470703053,158602,300882.9,61.389443674228275,67.00723174066523,NaN,NaN,NaN,NaN,1.9627149711586493,49.21655365556404,105041250,-0.6151597564259084,2.7364792446590513,3.3516390010849597
2025-09-12T12:05:00-04:00,389.94,390.91,389.43,390.67,386.6300560986161,NaN,NaN,NaN,NaN,NaN,380.07129999999876,401.2421513585064,358.9004486414911,388.6631507309922,385.89185981572024,391.4075265478314,380.37619308360905,121987,284350.4,63.36754279460354,66.38448424046888,NaN,NaN,NaN,NaN,1.9282353303616042,48.19481943870206,105163237,-0.5943260679690052,2.608731416123703,3.2030574840927084
2025-09-12T12:10:00-04:00,390.69,391.7,390.4,391.48,386.6300560986161,NaN,NaN,NaN,NaN,NaN,380.5958999999987,401.57072125702376,359.6210787429737,388.6631507309922,385.96051650342616,391.4730349853472,380.4479980215051,127734,274316.93333333335,65.42760303584049,65.86087449757653,NaN,NaN,NaN,NaN,1.883361378192919,47.553246196902435,105290971,-0.5276217170799087,2.5435303377428227,3.0711520548227313
2025-09-12T12:15:00-04:00,391.56,392.32,391.295,391.97,386.6300560986161,NaN,NaN,NaN,NaN,NaN,381.10809999999873,401.9174843148714,360.29871568512607,388.6631507309922,386.04931303981846,391.5671677693641,380.5314583102728,150683,264296.4666666667,66.64943860230849,65.3720936020999,NaN,NaN,NaN,NaN,1.8220498511791374,47.187143972115905,105441654,-0.45488237173967594,2.502549090148136,2.957431461887812
2025-09-12T12:20:00-04:00,391.9,392.07,391.21,391.77,386.6300560986161,NaN,NaN,NaN,NaN,NaN,381.6166999999987,402.19926850940436,361.034131490593,388.6945332315315,386.1084602816432,391.6272302984003,380.5896902648861,106244,251890,65.6299001398031,65.19226471656894,NaN,NaN,NaN,NaN,1.7533320046663428,46.76836541649972,105335410,-0.4251709445692349,2.4259677811762685,2.8511387257455034
2025-09-12T12:25:00-04:00,391.77,392.12,391.3,391.66,386.6300560986161,NaN,NaN,NaN,NaN,NaN,382.1272999999986,402.4123111373979,361.84228886259933,389.00962658522525,386.1563466950035,391.67547912658387,380.6372142634231,87524,235802.33333333334,65.04059665640982,65.28745939633235,NaN,NaN,NaN,NaN,1.6866654329044606,46.3999709112983,105247886,-0.41727346469688475,2.3295468948743974,2.746820359571282
2025-09-12T12:30:00-04:00,391.66,392.75,391.41,392.435,386.84062029753596,NaN,NaN,NaN,NaN,NaN,382.64299999999866,402.63685005456426,362.64914994543307,389.5917012681802,386.231472386214,391.75689900760113,380.7060457648269,128520,224266.73333333334,67.27042451894687,65.4076301242045,NaN,NaN,NaN,NaN,1.6619036162684258,46.31713125393971,105376406,-0.366032860219077,2.289279284297436,2.655312144516513
2025-09-12T12:35:00-04:00,392.47,392.83,391.82,392.11,387.1860466476479,NaN,NaN,NaN,NaN,NaN,383.13759999999866,402.817760491327,363.4574395086703,389.7983610145441,386.3171404133351,391.84927846639613,380.78500236027406,149167,215609.3,65.38692892825291,65.6274658078054,NaN,NaN,NaN,NaN,1.615339072249252,46.273176610526185,105227239,-0.35967690936239327,2.205716007813521,2.5653929171759144
2025-09-12T12:40:00-04:00,392.13,393.44,391.98,393.15,387.6055445273003,NaN,NaN,NaN,NaN,NaN,383.6645999999986,402.974293922083,364.35490607791417,390.2846888116353,386.4189688799477,391.9672606734961,380.8706770863993,165853,210042.23333333334,68.43279774087057,65.96239700030158,NaN,NaN,NaN,NaN,1.6042434242314467,46.483420624538006,105393092,-0.2938560917390882,2.198072802502054,2.491928894241142
2025-09-12T12:45:00-04:00,393.17,394.83,393.17,394.56,388.8984743215139,NaN,NaN,NaN,NaN,NaN,384.22339999999866,403.14086700180184,365.3059329981955,391.46575104930827,386.58063072244653,392.1817447628111,380.97951668208196,226386,207222.66666666666,72.0268390232669,66.34159297243617,NaN,NaN,NaN,NaN,1.6096546082149155,47.175873786433336,105619478,-0.16993199058938524,2.2795139060044107,2.449445896593796
2025-09-12T12:50:00-04:00,394.56,395.99,394.36,395.43,390.0830891250815,NaN,NaN,NaN,NaN,NaN,384.8097999999986,403.2568731511683,366.36272684882886,392.48360083944664,386.785674578049,392.4750448960184,381.0963042600796,263194,203872.36666666667,73.9942756264923,66.96959865116717,NaN,NaN,NaN,NaN,1.6111078504852785,48.162186911820676,105882672,-0.05016041221139922,2.386745381329547,2.436905793540946
2025-09-12T12:55:00-04:00,395.38,395.38,393.51,393.57,390.0830891250815,NaN,NaN,NaN,NaN,NaN,385.34199999999856,403.2252776639111,367.45872233608605,392.48360083944664,386.8976730862999,392.6151467924834,381.1801993801164,171970,188353,63.68200491544516,66.8403350103967,NaN,NaN,NaN,NaN,1.633171575450617,48.16207318358508,105710702,-0.11337807520706189,2.2951831995321186,2.4085612747391805
2025-09-12T13:00:00-04:00,393.63,393.64,391.78,392.62,390.0830891250815,NaN,NaN,NaN,NaN,NaN,385.8515999999986,403.07093128099314,368.63226871900406,392.48360083944664,386.98066233971724,392.69846980750987,381.2628548719246,164728,178425.8,59.147906869145025,66.2271690198421,NaN,NaN,NaN,NaN,1.6493736057755741,46.588869602729474,105545974,-0.2296433896070731,2.121507037730339,2.351150427337412
2025-09-12T13:05:00-04:00,392.63,392.73,391.4,391.45,390.0830891250815,NaN,NaN,NaN,NaN,NaN,386.3393999999986,402.76532470956977,369.9134752904274,392.48360083944664,387.0358182470825,392.7445694141262,381.3270670800388,131225,171772.8,54.04436655230666,65.10643350556572,NaN,NaN,NaN,NaN,1.626561205363036,44.82199629825553,105414749,-0.386579606606253,1.867925919079596,2.254505525685849
2025-09-12T13:10:00-04:00,391.44,393.2,391.08,393.09,390.0830891250815,NaN,NaN,NaN,NaN,NaN,386.86899999999855,402.3994477721865,371.3385522278106,392.48360083944664,387.1026191477304,392.8075198283539,381.3977184671069,144839,164859.4,59.34026213443339,64.96006339558038,NaN,NaN,NaN,NaN,1.6618068335513911,43.42294793695375,105559588,-0.3805719731602655,1.7787905592355173,2.159362532395783
2025-09-12T13:15:00-04:00,393.1,393.95,393.03,393.36,390.0830891250815,NaN,NaN,NaN,NaN,NaN,387.4121999999986,401.8762445465492,372.94815545344807,392.48360083944664,387.17241714875075,392.8843124467015,381.46052185080003,130753,158860.46666666667,60.15437735452293,64.73055157843176,NaN,NaN,NaN,NaN,1.6088206311548645,42.49357641112992,105690341,-0.35931201999614526,1.7102225074006014,2.0695345273967467
2025-09-12T13:20:00-04:00,393.36,394.18,392.97,394.13,390.0830891250815,NaN,NaN,NaN,NaN,NaN,387.9737999999986,401.2044396763178,374.74316032367943,392.48360083944664,387.2311580103387,392.9511524988654,381.51116352181197,106925,154804.43333333332,62.46269731186736,64.51877259814796,NaN,NaN,NaN,NaN,1.5803334432152298,41.741703944501936,105797266,-0.29687891351077766,1.6984358855082746,1.9953147990190523
2025-09-12T13:25:00-04:00,394.19,394.42,393.57,393.59,390.0830891250815,NaN,NaN,NaN,NaN,NaN,388.51099999999866,400.3564592145811,376.6655407854162,392.48360083944664,387.27068696691714,392.99639219776884,381.54498173606544,71935,151652.4,59.84435573132571,64.03269525022061,NaN,NaN,NaN,NaN,1.528166768699858,41.16261932536226,105725331,-0.29483661129282557,1.6267690349030204,1.921605646195846
2025-09-12T13:30:00-04:00,393.58,394.25,393.32,393.82,390.0830891250815,NaN,NaN,NaN,NaN,NaN,389.0295999999987,399.3966587614875,378.6625412385099,392.48360083944664,387.3104039773367,393.0411800386922,381.57962791598123,73866,148291.16666666666,60.60188560584872,63.67355135493817,NaN,NaN,NaN,NaN,1.4854405709355827,40.369518522912315,105799197,-0.28094156266627346,1.570428692863004,1.8513702555292775
2025-09-12T13:35:00-04:00,393.76,394.57,393.36,394.07,390.0830891250815,NaN,NaN,NaN,NaN,NaN,389.53339999999866,398.2519199296837,380.8148800703136,392.48360083944664,387.36894834976476,393.10851176782415,381.6293849317054,107156,145863.6,61.45310099840671,63.4173016650808,NaN,NaN,NaN,NaN,1.4657662444401824,39.810758149107954,105906353,-0.2584291676998436,1.528333795904473,1.7867629636043165
2025-09-12T13:40:00-04:00,394.08,394.26,393.22,393.85,390.0830891250815,NaN,NaN,NaN,NaN,NaN,389.9225999999986,397.57449655996857,382.2707034400287,391.6148806715573,387.4114397802147,393.15553274693866,381.6673468134908,81737,140522.46666666667,60.22007376109082,62.9137051823768,NaN,NaN,NaN,NaN,1.4353543698373097,39.135864916834294,105824616,-0.26110101358377635,1.460386696624596,1.7214877102083723
2025-09-12T13:45:00-04:00,393.83,394.95,393.78,394.59,390.0830891250815,NaN,NaN,NaN,NaN,NaN,390.2741999999987,397.090429268753,383.4579707312444,391.96784166503,387.4732678914012,393.22957750605286,381.7169582767495,109390,138232.1,62.915428057916735,62.73716940592421,NaN,NaN,NaN,NaN,1.416400486277503,38.90931409332442,105934006,-0.21755773186634464,1.4495405453754415,1.6670982772417862
2025-09-12T13:50:00-04:00,394.63,394.88,394.22,394.47,390.0830891250815,NaN,NaN,NaN,NaN,NaN,390.5995999999987,396.5814822593188,384.6177177406786,392.16427333202404,387.517375170937,393.28251274234583,381.75223759952814,78289,135297.6,62.17967086738197,62.29051748638932,NaN,NaN,NaN,NaN,1.362371880114822,38.69894547149383,105855717,-0.2017176470885218,1.414951218381134,1.6166688654696557
2025-09-12T13:55:00-04:00,394.48,395.37,394.45,394.93,390.5119612450485,NaN,NaN,NaN,NaN,NaN,390.8753999999987,396.3361801058356,385.41461989416183,392.7374186656192,387.5962957724477,393.3807608772143,381.81183066768114,134909,135411.03333333333,63.92142941717504,61.71155965738275,NaN,NaN,NaN,NaN,1.3307738886780502,38.78781477686846,105990626,-0.16659775253570497,1.4084216748000244,1.5750194273357294
2025-09-12T14:00:00-04:00,394.9,395.28,394.24,395.17,390.5119612450485,NaN,NaN,NaN,NaN,NaN,391.0969999999987,396.3330145152955,385.86098548470187,392.7374186656192,387.6663198592609,393.4667846008228,381.865855117699,122498,135756.43333333332,64.83145814545634,61.05707269445161,NaN,NaN,NaN,NaN,1.310004325201044,38.591660982387985,106113124,-0.1348948656958191,1.4064008452159555,1.5412957109117746
2025-09-12T14:05:00-04:00,395.17,395.5,394.8,395.02,390.91186964683135,NaN,NaN,NaN,NaN,NaN,391.3057999999986,396.31328933544614,386.2983106645511,393.0491479459963,387.7162344652792,393.5290278490383,381.90344108152004,86255,132095.66666666666,63.74916482015837,61.06186983050255,NaN,NaN,NaN,NaN,1.2664325876866829,38.548828302575934,106026869,-0.13157704701017603,1.3768244021490545,1.5084014491592306
2025-09-12T14:10:00-04:00,395.05,395.31,394.73,394.96,390.91186964683135,NaN,NaN,NaN,NaN,NaN,391.4857999999986,396.3568776471582,386.614722352839,393.05931835679706,387.7592398679468,393.581650151855,381.9368295840386,76364,130657.3,63.29400237249594,61.35801950931334,NaN,NaN,NaN,NaN,1.2174016885662042,38.407129072157005,105950505,-0.14018088422239483,1.333175343881237,1.4733562281036319
2025-09-12T14:15:00-04:00,395,395.41,394.16,394.93,390.91186964683135,NaN,NaN,NaN,NaN,NaN,391.62739999999866,396.47906702943857,386.77573297055875,393.05931835679706,387.83977600538213,393.6773911378716,382.00216087289266,148941,132631.96666666667,63.051596742816244,62.00139309434973,NaN,NaN,NaN,NaN,1.2197301393829039,37.46452648561501,105801564,-0.15357192652132245,1.2813913199519789,1.4349632464733013
2025-09-12T14:20:00-04:00,394.905,395.4,394.41,394.88,390.91186964683135,NaN,NaN,NaN,NaN,NaN,391.79129999999867,396.5160631945391,387.06653680545827,393.05931835679706,387.89237535750425,393.73978240328444,382.04496831172406,98245,131813.83333333334,62.62113504828357,62.235741159624745,NaN,NaN,NaN,NaN,1.203320843712693,36.589252655254576,105703319,-0.17018784745143822,1.2222284371590035,1.3924162846104418
2025-09-12T14:25:00-04:00,394.89,395.37,394.54,394.95,390.97032908777334,NaN,NaN,NaN,NaN,NaN,391.96229999999866,396.50975256649156,387.41484743350577,393.05931835679706,387.9290405446122,393.7832841079803,382.07479698124405,68801,126490.66666666667,63.00196387334905,62.43914019668375,NaN,NaN,NaN,NaN,1.1766550691617854,35.77649838420561,105772120,-0.1799080136118114,1.1675312675956775,1.347439281207489
2025-09-12T14:30:00-04:00,394.98,394.98,393.4,393.46,390.97032908777334,NaN,NaN,NaN,NaN,NaN,392.06629999999865,396.50690212635214,387.62569787364515,393.05931835679706,387.9926811098532,393.8483305860761,382.13703163363033,141622,125924.66666666667,51.07377351050405,61.62564563944351,NaN,NaN,NaN,NaN,1.2054654213645182,33.483763425272926,105630498,-0.2839420159043271,0.99251176132708,1.276453777231407
2025-09-12T14:35:00-04:00,393.43,394.1,392.84,393.95,390.97032908777334,NaN,NaN,NaN,NaN,NaN,392.10949999999866,396.5804329009235,387.63856709907384,393.05931835679706,388.05106768510626,393.904206410487,382.1979289597255,140147,126530,54.148248066513716,61.218780806242656,NaN,NaN,NaN,NaN,1.2093607484099134,31.446877187934163,105770645,-0.3146303335648759,0.8831658602753123,1.1977961938401882
2025-09-12T14:40:00-04:00,393.9,394.07,392.99,393.09,390.97032908777334,NaN,NaN,NaN,NaN,NaN,392.1100999999986,396.58155099096854,387.6386490090287,393.05931835679706,388.0856092902653,393.9354211449212,382.23579743560947,88226,125213.06666666667,48.39969125606659,60.34719549554393,NaN,NaN,NaN,NaN,1.200120694952061,29.555482824691033,105682419,-0.38317500469884,0.7188274379666382,1.1020024426654782
2025-09-12T14:45:00-04:00,393.09,393.74,392.72,392.87,390.97032908777334,NaN,NaN,NaN,NaN,NaN,392.16729999999865,396.60285507740116,387.73174492259614,393.05931835679706,388.13018708372357,393.97301822857065,382.2873559388765,121919,124254.26666666666,47.024363349704494,59.31657137777948,NaN,NaN,NaN,NaN,1.1872549310269125,28.101602997495924,105560500,-0.4301374416776056,0.5643306405684712,0.9944680822460767
2025-09-12T14:50:00-04:00,392.88,393.54,392.62,393.32,390.97032908777334,NaN,NaN,NaN,NaN,NaN,392.2762999999987,396.5489548239434,388.00364517605396,393.05931835679706,388.1659446607586,394.003286087815,382.3286032337022,98390,123992.46666666666,50.145024994119865,58.59692503728156,NaN,NaN,NaN,NaN,1.16816529309642,26.864807103201805,105658890,-0.41737249886180394,0.4727524586688219,0.8901249575306258
2025-09-12T14:55:00-04:00,393.34,394.28,393.06,393.7,390.97032908777334,NaN,NaN,NaN,NaN,NaN,392.3666999999987,396.5640894797371,388.16931052026024,393.05931835679706,388.20408626209996,394.0391283285141,382.36904419568583,96400,124288.33333333333,52.67998514653127,57.86582197218259,NaN,NaN,NaN,NaN,1.1718677721609592,25.14199020490074,105755290,-0.3713567110143986,0.4259290687626276,0.7972857797770262
2025-09-12T15:00:00-04:00,393.75,395.34,393.68,395.11,390.97032908777334,NaN,NaN,NaN,NaN,NaN,392.48229999999865,396.65710021613006,388.30749978386723,393.00665099868013,388.273249997539,394.11541976899935,382.4310802260786,149748,124995.93333333333,60.67090517814457,57.75805299437992,NaN,NaN,NaN,NaN,1.2067343598637454,24.643620650121118,105905038,-0.24033357051920246,0.49686881662802307,0.7372023871472255
2025-09-12T15:05:00-04:00,395.08,395.6,394.86,395.23,391.3881827682322,NaN,NaN,NaN,NaN,NaN,392.5942999999986,396.7574622650137,388.4311377349835,393.00665099868013,388.3383241394862,394.19154147709816,382.4851068018742,133007,124457.26666666666,61.270340605425496,57.56868950782638,NaN,NaN,NaN,NaN,1.17339619130205,24.415814807453476,106038045,-0.1446749352838006,0.5563587180424747,0.7010336533262753
2025-09-12T15:10:00-04:00,395.21,395.94,394.88,395.93,391.5982653696761,NaN,NaN,NaN,NaN,NaN,392.71149999999864,396.9135662779883,388.50943372200896,393.19152552417177,388.40622574029334,394.27362700830133,382.53882447228534,134525,123413,64.65459424434306,57.55605637203258,NaN,NaN,NaN,NaN,1.1652964633519038,24.50486285286501,106172570,-0.038852682091895296,0.6524678007114062,0.6913204828033015
2025-09-12T15:15:00-04:00,395.91,396.61,395.66,396.08,392.36698058014537,NaN,NaN,NaN,NaN,NaN,392.8222999999987,397.0812628836859,388.56333711631146,393.9362204193375,388.51579512970295,394.4124046145295,382.6191856448764,206913,122763.9,65.35324430812338,57.670633478315786,NaN,NaN,NaN,NaN,1.1499181445410527,25.12962900921351,106379483,0.03278139057974061,0.7322972210279772,0.6995158304482366
2025-09-12T15:20:00-04:00,396.08,396.2,394.57,394.92,392.36698058014537,NaN,NaN,NaN,NaN,NaN,392.9352999999987,397.11025025655516,388.7603497434422,393.9362204193375,388.5841046894712,394.48920718844965,382.6790021904927,149660,118979.43333333333,56.115590504121776,57.157889773431926,NaN,NaN,NaN,NaN,1.1842097056452627,24.265659872973373,106229823,-0.004444057444040306,0.6939607586431862,0.6984048160872265
2025-09-12T15:25:00-04:00,394.89,395.15,393.92,393.95,392.36698058014537,NaN,NaN,NaN,NaN,NaN,393.0514999999986,397.00358514644705,389.0994148535502,393.9362204193375,388.63788713765473,394.541367932486,382.73440634282343,138747,117872,49.77921375666728,56.20986241727843,NaN,NaN,NaN,NaN,1.1874804409563124,22.746552301930105,106091076,-0.09581363955156252,0.5786377666477733,0.6744514061993359
2025-09-12T15:30:00-04:00,393.94,393.94,392.83,393.44,392.36698058014537,NaN,NaN,NaN,NaN,NaN,393.13989999999865,396.9213751043399,389.3584248956574,393.9362204193375,388.70127689807816,394.590721700851,382.8118320953053,200183,119053.83333333333,46.787821249777735,55.07891143167087,NaN,NaN,NaN,NaN,1.1826604094594333,21.924269805767967,105890893,-0.18675546745965688,0.44100707187476473,0.6277625393344216
2025-09-12T15:35:00-04:00,393.48,393.5,391.98,392.38,NaN,NaN,NaN,396.5674399579637,396.5674399579637,396.5674399579637,393.22369999999864,396.73902918013164,389.70837081986565,393.9362204193375,388.75390047730275,394.62103130344366,382.88676965116184,204842,121507.73333333334,41.24065372205347,53.524532135149755,NaN,NaN,NaN,NaN,1.206756094498044,21.820001111560202,105686051,-0.30733592804195553,0.24359262928197722,0.5509285573239328
2025-09-12T15:40:00-04:00,392.39,393.64,392.23,393.31,NaN,NaN,NaN,396.5674399579637,NaN,NaN,393.3138999999986,396.5941532165739,390.03364678342336,393.9362204193375,388.7938940815007,394.6483052178722,382.9394829451292,143002,121446.5,47.159868718336284,53.24496750713778,NaN,NaN,NaN,NaN,1.2212735163196098,21.567353570328297,105829053,-0.312474650650453,0.16033524401086652,0.4728098946613195
2025-09-12T15:45:00-04:00,393.32,394.5,393.07,394.43,NaN,NaN,NaN,396.5674399579637,NaN,NaN,393.3998999999987,396.56520471907226,390.23459528092513,393.9362204193375,388.8421229815615,394.6906592098215,382.9935867533015,143970,121887.06666666667,53.26567337964372,53.18192645807564,NaN,NaN,NaN,NaN,1.2361825508682094,20.42885662648944,105973023,-0.2321497989832853,0.1826226459322129,0.4147724449154982
2025-09-12T15:50:00-04:00,394.46,396.38,394.46,396.24,NaN,NaN,NaN,396.5674399579637,NaN,NaN,393.52909999999866,396.61930756013595,390.4388924398614,393.9362204193375,388.95394188375167,394.8191528720024,383.08873089550093,257853,126918,61.09057770895153,54.08841834756742,NaN,NaN,NaN,NaN,1.2871695115204793,20.085594919554666,106230876,-0.057905491734424275,0.3423905802474678,0.4002960719818921
2025-09-12T15:55:00-04:00,396.1,396.5,394.54,396,NaN,NaN,NaN,396.5674399579637,NaN,NaN,393.6510999999986,396.6385144614935,390.6636855385037,393.9362204193375,389.0713258269709,394.95146929302666,383.19118236091515,280620,133874.16666666666,59.6640727276704,54.99125473170784,NaN,NaN,NaN,NaN,1.3352288321261578,19.84906647111008,105950256,0.03537730374226228,0.44451770165971993,0.40914039791745765
2025-09-15T09:30:00-04:00,423.2,425.69,418.96,424.06,414.4165960763672,414.4165960763672,414.4165960763672,NaN,NaN,NaN,394.3156999999987,403.287727643993,385.3436723560044,407.7617367811107,422.90333333333336,422.90333333333336,422.90333333333336,973235,163853.13333333333,89.76268083063867,57.821087291459186,NaN,NaN,NaN,NaN,3.3605696298314323,24.27431300671505,106923491,1.8789842078524859,2.757870657733065,0.8788864498805792
2025-09-15T09:35:00-04:00,424.07,425.23,417.6,419,414.4165960763672,NaN,NaN,NaN,NaN,NaN,394.8614999999986,406.15343026036066,383.56956973963656,407.7617367811107,421.92718620505144,423.0611031030282,420.7932693070747,721250,184322.93333333332,78.40143602278295,59.658333782620026,NaN,NaN,NaN,NaN,3.66552894198633,27.893573307555314,106202241,2.6050918227816307,4.1352512283576175,1.5301594055759868
2025-09-15T09:40:00-04:00,418.97,420.93,416.13,416.55,414.4165960763672,NaN,NaN,NaN,NaN,NaN,395.3940999999987,408.1240193542091,382.66418064578824,407.7617367811107,420.875977186693,422.90391653589256,418.8480378374934,592572,201350.76666666666,73.54745574074957,60.578087394234664,NaN,NaN,NaN,NaN,3.746562588987307,30.728657740008558,105609669,2.7533353431445557,4.971828584506682,2.218493241362126
2025-09-15T09:45:00-04:00,416.62,418.23,414.77,416.48,414.4165960763672,NaN,NaN,NaN,NaN,NaN,395.9102999999987,409.86626079260026,381.95433920739714,407.7617367811107,420.13347122851036,422.60705513819266,417.65988731882805,466508,213254.7,73.4076156338436,61.44503561055025,NaN,NaN,NaN,NaN,3.726093832631073,32.879717089950866,105143161,2.6772243055195757,5.565023623261595,2.8877993177420196
2025-09-15T09:50:00-04:00,416.5,420.33,415.05,419.5,414.4165960763672,NaN,NaN,NaN,NaN,NaN,396.4706999999987,411.847967639102,381.0934323608954,407.7617367811107,419.9213205596761,422.32102400981944,417.5216171095327,358830,222606.06666666668,75.56610714562757,62.22442938921342,NaN,NaN,NaN,NaN,3.8370871303002803,35.052488198083594,105501991,2.6555766892351493,6.207270179285956,3.551693490050807
2025-09-15T09:55:00-04:00,419.44,419.52,417.11,418.82,414.4165960763672,NaN,NaN,NaN,NaN,NaN,397.00769999999864,413.54993917263647,380.4654608273608,407.7617367811107,419.8152192677557,422.1550904765974,417.475348058914,247941,226373.8,74.10748832465086,62.8497325332511,NaN,NaN,NaN,NaN,3.7351523352788294,37.070061369921135,105254050,2.4270225415637485,6.585471667005493,4.158449125441744
2025-09-15T10:00:00-04:00,418.88,419.63,416.66,418.06,414.4165960763672,NaN,NaN,NaN,NaN,NaN,397.5334999999987,415.02066903917,380.0463309608274,407.7617367811107,419.7016364105574,422.00139890265643,417.40187391845836,240810,230317.53333333333,72.42484638660292,64.01467938199976,NaN,NaN,NaN,NaN,3.6804985970446253,38.76456312276865,105013240,2.0701274861395556,6.746108483116188,4.675980996976633
2025-09-15T10:05:00-04:00,418.04,422.6,417.52,421.75,414.4165960763672,NaN,NaN,NaN,NaN,NaN,398.1352999999986,416.8036608719389,379.4669391280583,410.494171333398,419.76913568799455,421.9960705699891,417.542200806,284565,236927.86666666667,75.35117620254353,65.84124812813377,NaN,NaN,NaN,NaN,3.780462982970012,40.61339569264904,105297805,1.9307702293628726,7.089443783680224,5.158673554317351
2025-09-15T10:10:00-04:00,421.76,422.84,421,421.94,414.4165960763672,NaN,NaN,NaN,NaN,NaN,398.72539999999856,418.4699803035941,378.980819696403,412.2353370667184,419.870124902981,422.0915651086167,417.6486846973453,190813,240742.83333333334,75.49537621214907,67.89178776830315,NaN,NaN,NaN,NaN,3.641858484186438,42.35159271928719,105488618,1.7073043487789352,7.29280399029102,5.585499641512085
2025-09-15T10:15:00-04:00,422.07,423.05,419.55,419.69,414.4165960763672,NaN,NaN,NaN,NaN,NaN,399.27699999999857,419.77801158491775,378.7759884150794,412.8162696533747,419.9204337112105,422.08821041441905,417.7526570080019,243309,243888.43333333332,70.2539055184609,69.96416289661796,NaN,NaN,NaN,NaN,3.631725735315978,43.34926360794064,105245309,1.2832288712893627,7.189535730623788,5.906306859334426
2025-09-15T10:20:00-04:00,419.77,419.77,415.85,416.36,414.4165960763672,NaN,NaN,NaN,NaN,NaN,399.7411999999986,420.711957026028,378.77044297396924,412.8162696533747,419.79467198154686,421.9814018954673,417.6079420676264,220125,247951.1,63.25436245478179,71.11376959207836,NaN,NaN,NaN,NaN,3.652316754221977,42.87224967801818,105025184,0.6837981071033221,6.761054493213578,6.077256386110256
2025-09-15T10:25:00-04:00,416.33,417.6,414.25,416.49,NaN,NaN,NaN,425.35975111043183,425.35975111043183,425.35975111043183,400.1797999999986,421.6110241331432,378.74857586685397,412.8162696533747,419.60058977106775,421.8823661974792,417.3188133446563,252670,254080.06666666668,63.40763820865758,71.83819565129365,NaN,NaN,NaN,NaN,3.63072270034898,41.889485041121155,105277854,0.22513180018828027,6.358671136345606,6.133539336157326
2025-09-15T10:30:00-04:00,416.61,418.32,415.82,415.82,NaN,NaN,NaN,425.35975111043183,NaN,NaN,400.5875999999986,422.4141110579973,378.7610889419999,412.8162696533747,419.50224390314077,421.8072272918289,417.19726051445264,165444,254874.13333333333,61.97285814437066,71.901215682395,NaN,NaN,NaN,NaN,3.5499567931811957,41.10906277647394,105112410,-0.17282927821763572,5.917502738385281,6.0903320166029165
2025-09-15T10:35:00-04:00,415.85,417.93,415.6,417.69,NaN,NaN,NaN,425.35975111043183,NaN,NaN,401.0699999999986,423.3169183485052,378.8230816514919,412.8162696533747,419.4522889595434,421.75934739236686,417.14523052671996,104113,253673,64.39451262632862,72.23910424658487,NaN,NaN,NaN,NaN,3.4628170222396806,40.3047325814105,105216523,-0.3493889391385334,5.653595842679749,6.002984781818283
2025-09-15T10:40:00-04:00,417.77,418.83,416.66,418.33,NaN,NaN,NaN,425.35975111043183,NaN,NaN,401.5841999999986,424.21135575243505,378.9570442475621,412.8162696533747,419.41898268041984,421.7112645533543,417.1267008074854,113999,254532.1,65.21106248868733,70.48541722215978,NaN,NaN,NaN,NaN,3.3704729492225574,39.73902883137036,105330522,-0.4556223300908737,5.43345686920469,5.889079199295564
2025-09-15T10:45:00-04:00,418.39,418.98,418.04,418.79,NaN,NaN,NaN,425.35975111043183,NaN,NaN,402.13099999999855,425.0713404509406,379.1906595490565,412.8162696533747,419.4048934699304,421.67977464678154,417.1300122930793,90983,253500.9,65.81783772458424,69.58658877228845,NaN,NaN,NaN,NaN,3.196867738563803,39.24487310645557,105421505,-0.5226563716110819,5.235758734781712,5.7584151063927935
2025-09-15T10:50:00-04:00,418.72,420.96,418.65,420.71,NaN,NaN,NaN,425.35975111043183,NaN,NaN,402.6833999999985,426.05247789719294,379.3143221028041,414.4172849536114,419.4264817788701,421.669374954307,417.1835886034332,167174,255793.7,68.30288416888172,69.21197651715502,NaN,NaN,NaN,NaN,3.133520042952103,39.18890739492774,105588679,-0.4672419563325807,5.174362660977067,5.641604617309648
2025-09-15T10:55:00-04:00,420.71,421.96,420.04,421.62,NaN,NaN,NaN,425.35975111043183,NaN,NaN,403.24859999999853,427.0513208563463,379.44587914365076,415.76582796288915,419.4814189312538,421.7107921128092,417.2520457496984,173046,258348.56666666668,69.43699595594481,68.92836082587654,NaN,NaN,NaN,NaN,3.0468400398840925,39.328907487040155,105761725,-0.4013750372944127,5.139885820691632,5.541260857986044
2025-09-15T11:00:00-04:00,421.68,422.58,421.04,421.74,NaN,NaN,NaN,425.35975111043183,NaN,NaN,403.80079999999856,428.00932043072913,379.592279569268,416.85466237031136,419.54855873271464,421.7791680138071,417.31794945162216,168213,258964.06666666668,69.59150559292661,68.50160357211219,NaN,NaN,NaN,NaN,2.9392086084637974,39.57801244038556,105929938,-0.38191068365039094,5.063872503423056,5.445783187073447
2025-09-15T11:05:00-04:00,421.78,421.82,419.05,419.29,NaN,NaN,NaN,425.35975111043183,NaN,NaN,404.31479999999857,428.72479934135663,379.9048006586405,416.85466237031136,419.5609881553489,421.7653518208074,417.35662448989046,145807,259390.73333333334,62.62988040402365,67.68177443492453,NaN,NaN,NaN,NaN,2.927122279287811,38.89936597615913,105784131,-0.5556918569203741,4.751168365922979,5.306860222843353
2025-09-15T11:10:00-04:00,419.315,421.24,418.86,421.08,NaN,NaN,NaN,425.35975111043183,NaN,NaN,404.8599999999986,429.52441939322364,380.19558060677355,416.85466237031136,419.57894594406434,421.7627514423266,417.3951404458021,130571,259258.93333333332,65.35663529460513,67.17690221406755,NaN,NaN,NaN,NaN,2.8880421164815386,38.18475121103986,105914702,-0.5696322576758677,4.594819900748519,5.164452158424386
2025-09-15T11:15:00-04:00,421.09,424.12,421.03,422.94,NaN,NaN,NaN,425.35975111043183,NaN,NaN,405.43739999999866,430.4141292687564,380.4606707312409,417.80522713359943,419.6993234873712,421.92321294832135,417.47543402642106,243056,260463.7,67.97179830258088,66.64980379264165,NaN,NaN,NaN,NaN,2.9024676795900026,38.17734203496432,106157758,-0.4768912363993234,4.5683381129252325,5.045229349324556
2025-09-15T11:20:00-04:00,422.93,423.36,421.27,421.32,NaN,NaN,NaN,425.35975111043183,NaN,NaN,405.9867999999986,431.1277780049408,380.8458219950564,417.80522713359943,419.7368964139617,421.96147074356827,417.5123220843551,105288,258984.63333333333,63.47727412438214,65.79136792922972,NaN,NaN,NaN,NaN,2.8444342739050046,38.17046208575131,106052470,-0.5431445426307828,4.366298671036077,4.90944321366686
2025-09-15T11:25:00-04:00,421.35,423,421.35,422.41,NaN,NaN,NaN,425.35975111043183,NaN,NaN,406.5431999999986,431.8812584703137,381.2051415296835,417.80522713359943,419.7763527298296,422.00544899479485,417.5472564648644,101952,257758.13333333333,65.14716920623555,65.42660104978506,NaN,NaN,NaN,NaN,2.7612603971975047,38.1640735614821,106154422,-0.5313955000958668,4.245198838547026,4.776594338642893
2025-09-15T11:30:00-04:00,422.41,422.74,421.02,421.2,NaN,NaN,NaN,425.35975111043183,NaN,NaN,407.07779999999866,432.5021739086088,381.6534260913885,417.80522713359943,419.80403220529985,422.02816863588055,417.57989577471915,97323,254329.46666666667,61.77077896916806,65.32063080081265,NaN,NaN,NaN,NaN,2.686884654540542,37.979096269865,106057099,-0.6169414696805671,4.005417501542183,4.62235897122275
2025-09-15T11:35:00-04:00,421.24,422.12,420.84,420.97,NaN,NaN,NaN,425.35975111043183,NaN,NaN,407.59859999999867,433.07305371670765,382.1241462832897,417.80522713359943,419.8215393754378,422.03859469208163,417.60448405879396,77624,250088.86666666667,61.122317688953174,65.15739362083377,NaN,NaN,NaN,NaN,2.586392893501934,37.7051570872773,105979475,-0.6950381619153614,3.7535612688285482,4.44859943074391
2025-09-15T11:40:00-04:00,420.99,421.86,420.54,421.32,NaN,NaN,NaN,425.35975111043183,NaN,NaN,408.12159999999864,433.62764269119083,382.61555730880644,417.80522713359943,419.8368832115599,422.0467911498864,417.62697527323337,73019,247756.1,61.77985171357737,65.14360744720568,NaN,NaN,NaN,NaN,2.4959362582517954,37.27270218440894,106052494,-0.7257734561911082,3.541382610505025,4.267156066696133
2025-09-15T11:45:00-04:00,421.33,422.08,421.03,421.44,NaN,NaN,NaN,425.35975111043183,NaN,NaN,408.6499999999986,434.14312879983436,383.15687120016287,417.8352105817102,419.85564422363126,422.0602555300579,417.65103291720465,76243,245498.53333333333,62.01704614286365,64.97378841267246,NaN,NaN,NaN,NaN,2.3926550969480966,36.94175929023558,106128737,-0.7382362270178318,3.344360782923843,4.082597009941675
2025-09-15T11:50:00-04:00,421.47,421.8,420.01,420.87,NaN,NaN,NaN,425.35975111043183,NaN,NaN,409.1681999999986,434.5803717892241,383.7560282107731,417.8352105817102,419.87410504478,422.06331958799393,417.68489050156603,123645,241024.93333333332,60.1088252326083,64.6093428943811,NaN,NaN,NaN,NaN,2.349608304308948,35.99625465816844,106005092,-0.780944413446806,3.1064164931331675,3.8873609065799735
2025-09-15T11:55:00-04:00,420.885,421.11,419.51,419.57,NaN,NaN,NaN,425.35975111043183,NaN,NaN,409.6609999999987,434.9047072555612,384.41729274443617,417.8352105817102,419.8760699004744,422.05397338276833,417.6981664181805,72924,234101.73333333334,55.88536105837869,63.89988027536642,NaN,NaN,NaN,NaN,2.2960648540011683,34.814862353423045,105932168,-0.8851779710194725,2.780888442805633,3.6660664138251056
2025-09-15T12:00:00-04:00,419.6,420.17,418.77,419.36,NaN,NaN,NaN,425.35975111043183,NaN,NaN,410.1505999999987,435.17725248419436,385.123947515803,417.8352105817102,419.86784899676155,422.02626529999543,417.7094326935277,132874,206089.7,55.21050228469984,62.964710140782,NaN,NaN,NaN,NaN,2.232060221572516,33.27508484931372,105799294,-0.950931590744414,2.477401925394588,3.428333516139002
2025-09-15T12:05:00-04:00,419.34,419.88,418.67,419.6,NaN,NaN,NaN,425.35975111043183,NaN,NaN,410.6435999999987,435.4230223533296,385.86417764666777,417.8352105817102,419.86286273734197,422.01070063668925,417.7150248379947,74409,184528.33333333334,55.866436764182,61.99538448422752,NaN,NaN,NaN,NaN,2.1590559200316206,31.784656617843428,105873703,-0.9582345033411541,2.2305403869625593,3.1887748903037134
2025-09-15T12:10:00-04:00,419.59,421.08,419.1,420.95,NaN,NaN,NaN,425.35975111043183,NaN,NaN,411.19339999999875,435.64102388790536,386.74577611209213,417.8352105817102,419.8687659143896,422.0049316326313,417.73260019614787,84036,167577.13333333333,59.46266063253669,61.27189555848538,NaN,NaN,NaN,NaN,2.1462662114579305,30.953180714052397,105957739,-0.8554971972407723,2.119403393752748,2.97490059099352
2025-09-15T12:15:00-04:00,420.99,421.2,420.4,420.62,NaN,NaN,NaN,425.35975111043183,NaN,NaN,411.7267999999987,435.8072968188899,387.64630318110756,417.8352105817102,419.878077597952,422.00468493073447,417.7514702651695,79020,154660.86666666667,58.21392793104619,60.956470381844134,NaN,NaN,NaN,NaN,2.0501043392109364,30.23482998876567,105878719,-0.7944382972973978,1.9818527193717728,2.7762910166691706
2025-09-15T12:20:00-04:00,420.64,420.9,418.92,419.1,NaN,NaN,NaN,425.35975111043183,NaN,NaN,412.24699999999865,435.8128777898239,388.6811222101734,417.8352105817102,419.8747223850942,421.98647794860966,417.7629668215787,105684,146222.66666666666,52.72192525774886,60.05399109349725,NaN,NaN,NaN,NaN,2.0450968864101524,28.60746066446242,105773035,-0.8368357576834975,1.7302463195647988,2.5670820772482963
2025-09-15T12:25:00-04:00,419.01,419.16,417.4,418.51,NaN,NaN,NaN,424.87726199531346,NaN,NaN,412.75979999999873,435.7249758940464,389.7946241059511,417.8352105817102,419.8391799829862,421.93865435049054,417.73970561548185,179786,143950.83333333334,50.72164754943882,58.82183746827282,NaN,NaN,NaN,NaN,2.024732823095145,26.87244445219184,105593249,-0.8805973701927501,1.4663353645073585,2.3469327347001085
2025-09-15T12:30:00-04:00,418.58,420.17,418.53,419.88,NaN,NaN,NaN,424.87726199531346,NaN,NaN,413.2909999999987,435.65377988097094,390.92822011902643,417.8352105817102,419.83586020938736,421.9243993812004,417.74732103757435,82447,138672.06666666668,54.991804825082724,58.21573251832286,NaN,NaN,NaN,NaN,1.998680478588351,25.18616538453947,105675696,-0.7958302701686231,1.35214489698933,2.147975167157953
2025-09-15T12:35:00-04:00,419.83,420.03,418.6,418.99,NaN,NaN,NaN,424.87726199531346,NaN,NaN,413.7967999999987,435.49851179987235,392.0950882001251,417.5287003227318,419.83068494657834,421.9113932161809,417.7499766769758,64368,131332.16666666666,51.84855792308846,57.26583171238378,NaN,NaN,NaN,NaN,1.958060444403465,23.620334821719414,105611328,-0.7773615566600831,1.176273221332849,1.9536347779929322
2025-09-15T12:40:00-04:00,418.96,418.96,417.6,417.66,NaN,NaN,NaN,424.5998425374341,NaN,NaN,414.2477999999987,435.30507704725403,393.1905229527433,417.5287003227318,419.8119835738161,421.88943153566504,417.7345356119672,84175,127777.56666666667,47.48092610048007,56.245127936048924,NaN,NaN,NaN,NaN,1.9174846983746452,22.268151314131526,105527153,-0.8277235557346108,0.9189803333246687,1.7467038890592794
2025-09-15T12:45:00-04:00,417.66,417.83,416.7,417.38,NaN,NaN,NaN,423.45166787664164,NaN,NaN,414.69079999999866,435.04945018720275,394.33214981279457,417.5287003227318,419.7727026910205,421.8572198173134,417.68818556472763,125824,123861.4,46.59110354382773,55.207184068539966,NaN,NaN,NaN,NaN,1.8612357913478843,21.48550670201304,105401329,-0.8496921563496385,0.6845886936222314,1.5342808499718699
2025-09-15T12:50:00-04:00,417.36,417.61,416.62,417.405,NaN,NaN,NaN,423.15545570043065,NaN,NaN,415.1202999999986,434.7714754774399,395.46912452255737,417.5287003227318,419.73721255886693,421.8287739040116,417.64565121372226,112921,120287.93333333333,46.68717239726785,54.12913554594643,NaN,NaN,NaN,NaN,1.7990046633944647,20.800615942661945,105514250,-0.8313116867723624,0.4951412415064169,1.3264529282787794
2025-09-15T12:55:00-04:00,417.39,417.74,415.79,416.38,NaN,NaN,NaN,422.79679862313833,NaN,NaN,415.52629999999857,434.4110467350018,396.64155326499537,417.5287003227318,419.69517244064116,421.80322686855885,417.58711801272347,112005,115599.1,43.25203517369518,52.78877761957726,NaN,NaN,NaN,NaN,1.8097900445805735,20.597227315767945,105402245,-0.8537185557948159,0.2593047335352594,1.1130232893300753
2025-09-15T13:00:00-04:00,416.33,417.19,416,416.78,NaN,NaN,NaN,422.514898685723,NaN,NaN,415.9634999999986,433.90856219005866,398.0184378099385,417.5287003227318,419.6749426933752,421.7904487563336,417.5594366304168,55366,111929.83333333333,44.95416161721188,51.70630164704894,NaN,NaN,NaN,NaN,1.7655193271105323,20.408366447937798,105457611,-0.8076295651514348,0.1034863328907818,0.9111158980422166
2025-09-15T13:05:00-04:00,416.78,417.87,416.78,417.62,NaN,NaN,NaN,422.514898685723,NaN,NaN,416.4368999999986,433.24704014114684,399.6267598588504,416.9729602581855,419.65505543714835,421.77170850939683,417.53840236489987,74105,110929.56666666667,48.450926033036914,51.17527057381024,NaN,NaN,NaN,NaN,1.7172679466026395,19.71644902374421,105531716,-0.6911042344773629,0.04723560494551293,0.7383398394228758
2025-09-15T13:10:00-04:00,417.64,418.07,417.25,418.06,NaN,NaN,NaN,422.514898685723,NaN,NaN,416.92929999999865,432.40551219952937,401.4530878004679,416.1226945652387,419.64472370832084,421.7600215747917,417.52942584184996,46821,108690.3,50.234251047829574,50.81982405689094,NaN,NaN,NaN,NaN,1.6531773789881647,18.923298822288924,105578537,-0.5604911200143519,0.03772593940493607,0.5982170594192879
2025-09-15T13:15:00-04:00,418,418.08,416.6,417.09,NaN,NaN,NaN,422.514898685723,NaN,NaN,417.4234999999986,431.2193263618018,403.62767363819546,416.1226945652387,419.62967179649473,421.7467454065508,417.51259818643865,53515,107441.36666666667,46.42154790532769,50.14518913840135,NaN,NaN,NaN,NaN,1.640807566203293,18.594818155020736,105525022,-0.5166004442309065,-0.04753349586934519,0.46906694836156126
2025-09-15T13:20:00-04:00,417.08,417.97,416.6,417.69,NaN,NaN,NaN,422.514898685723,NaN,NaN,417.9110999999986,429.8636152652101,405.9585847347871,416.0771556521909,419.61551232753646,421.7331448541253,417.4978798009476,54757,103694.13333333333,49.00004729842293,49.397859614536074,NaN,NaN,NaN,NaN,1.6214641686173439,18.289800392557417,105579779,-0.42799536556576906,-0.06592725859565007,0.362068106970119
2025-09-15T13:25:00-04:00,417.72,418.39,417.5,417.55,NaN,NaN,NaN,422.514898685723,NaN,NaN,418.3734999999986,428.2683892366256,408.47861076337165,415.3233729546395,419.60413774317806,421.7198961793825,417.4883793069736,54276,99735.13333333333,48.41456419447587,48.697905061923905,NaN,NaN,NaN,NaN,1.5692167280018183,17.641181927736774,105525503,-0.36225857328535527,-0.09075510963657507,0.2715034636487802
2025-09-15T13:30:00-04:00,417.49,418.19,416.95,417.19,NaN,NaN,NaN,422.514898685723,NaN,NaN,418.7924999999986,426.41662598303105,411.16837401696614,415.3233729546395,419.58506290722823,421.701137217732,417.46898859672444,76589,96681,46.86390800283592,48.27947525800156,NaN,NaN,NaN,NaN,1.5457012474302605,17.423821579624647,105448914,-0.32751543662874055,-0.13789083213714548,0.18962460449159507
2025-09-15T13:35:00-04:00,417.08,417.77,416.51,417.63,NaN,NaN,NaN,422.38943887107774,NaN,NaN,419.22509999999863,423.21596381187425,415.234236188123,415.3233729546395,419.5701605814238,421.68730641483774,417.4530147480099,57037,93722,49.01337421037967,48.157455733783046,NaN,NaN,NaN,NaN,1.5252940154709553,17.518757028281133,105505951,-0.2622192105203313,-0.13814940865881908,0.12406980186151224
2025-09-15T13:40:00-04:00,417.69,417.87,417.34,417.75,NaN,NaN,NaN,422.38943887107774,NaN,NaN,419.0988999999986,422.8628422372149,415.33495776278227,415.3233729546395,419.55989474500444,421.67599335052665,417.44379613948223,47023,90937.06666666667,49.61203536704815,47.773186486780574,NaN,NaN,NaN,NaN,1.4542015857944608,17.50709809744701,105552974,-0.20101983772413196,-0.1272049952936527,0.07381484243047925
2025-09-15T13:45:00-04:00,417.74,418.12,417.3,417.72,NaN,NaN,NaN,422.38943887107774,NaN,NaN,419.07329999999854,422.856944598183,415.28965540181406,415.52126956222037,419.5469758426214,421.6612686050415,417.4326830802013,61860,84897.2,49.45569690815419,47.6022678428567,NaN,NaN,NaN,NaN,1.4089014725234272,17.238861059718023,105491114,-0.15471095016424638,-0.11957384527482873,0.03513710488941765
2025-09-15T13:50:00-04:00,417.64,417.9,416.68,416.93,NaN,NaN,NaN,422.19460212106037,NaN,NaN,419.08089999999856,422.84572015045126,415.3160798495459,415.52126956222037,419.53065089623504,421.64679598833703,417.41450580413306,61146,83425.8,45.39863103625819,47.453532481126565,NaN,NaN,NaN,NaN,1.395408510200323,17.456740919530414,105429968,-0.16831152563276167,-0.17525230215153442,-0.0069407765187727635
2025-09-15T13:55:00-04:00,416.92,417.12,416.23,416.26,NaN,NaN,NaN,421.4780292973758,NaN,NaN,419.07649999999853,422.8539617146091,415.29903828538795,415.52126956222037,419.4929527610491,421.6220680298549,417.36383749224325,113531,83811.76666666666,42.234221931039905,47.142326651641724,NaN,NaN,NaN,NaN,1.3593079023288706,17.97751634736006,105316437,-0.21070749157743357,-0.2703251409905647,-0.05961764941313115
2025-09-15T14:00:00-04:00,416.25,416.48,411.84,413.255,NaN,NaN,NaN,419.377437056586,NaN,NaN,418.95159999999856,423.06300581372307,414.84019418627406,415.52126956222037,419.31092938746497,421.6302377653891,416.99162100954084,301001,90601.03333333334,31.596599516608492,46.064428588737485,NaN,NaN,NaN,NaN,1.5936430521625258,20.450596608019136,105015436,-0.4174633838414788,-0.5814468792149796,-0.16398349537350082
2025-09-15T14:05:00-04:00,413.23,413.73,410.4,410.55,NaN,NaN,NaN,417.49937173583214,NaN,NaN,418.7861999999986,423.5232659954409,414.04913400455627,415.52126956222037,419.1617134931967,421.6934976675955,416.6299293187979,182898,94110.16666666667,25.39577982777108,44.78898177831434,NaN,NaN,NaN,NaN,1.717668548436634,23.138511867448486,104832538,-0.6963016255799968,-1.0343605273484968,-0.3380589017685
2025-09-15T14:10:00-04:00,410.55,412.07,410.38,411.29,NaN,NaN,NaN,416.6428093842034,NaN,NaN,418.6507999999986,423.82957528428614,413.47202471571103,415.52126956222037,419.01522780218744,421.7408990960943,416.28955650828055,179144,97647.66666666667,29.47343611993034,43.68321567136565,NaN,NaN,NaN,NaN,1.7156922235483028,25.639602690835844,105011682,-0.7842636620077243,-1.3183884792781555,-0.5341248172704312
2025-09-15T14:15:00-04:00,411.33,411.84,409.3,409.67,NaN,NaN,NaN,416.08790895764866,NaN,NaN,418.4091999999986,424.0898874095602,412.72851259043694,415.52126956222037,418.85772724132426,421.7984848473124,415.9169696353361,177527,101023.8,26.10904700457317,42.08736716933252,NaN,NaN,NaN,NaN,1.7745713504377072,28.23476948012062,104834155,-0.8967992666171483,-1.6551239005418665,-0.7583246339247183
2025-09-15T14:20:00-04:00,409.69,410.27,408.03,408.055,NaN,NaN,NaN,414.7225494595737,NaN,NaN,418.13149999999854,424.419677240284,411.8433227597131,415.52126956222037,418.7030264273647,421.8731308267997,415.5329220279297,153752,102027.36666666667,23.258668740085483,40.16053986163651,NaN,NaN,NaN,NaN,1.8078162539778717,30.92591913174231,104680403,-1.0164747300921908,-2.0289180465399568,-1.012443316447766
2025-09-15T14:25:00-04:00,408.04,409.15,406.6,406.67,NaN,NaN,NaN,413.5419790295931,NaN,NaN,417.87109999999853,424.91275500187703,410.82944499812004,415.52126956222037,418.54985301378304,421.95706798370657,415.1426380438595,138438,104211.16666666667,21.128374942683138,38.35388465001904,NaN,NaN,NaN,NaN,1.8608293786937349,33.69654682854602,104541965,-1.1173569190328798,-2.409139465238866,-1.291782546205986
2025-09-15T14:30:00-04:00,406.65,407.76,406.58,407.23,NaN,NaN,NaN,412.74029816461154,NaN,NaN,417.6884999999986,425.3257443332083,410.0512556667889,415.52126956222037,418.3903503911968,422.02801401529746,414.7526867670962,144536,104599.9,24.153297702358145,36.579116821728704,NaN,NaN,NaN,NaN,1.8121987087870401,36.27290215401696,104686501,-1.0744993979756094,-2.6349067936754977,-1.5604073956998883
2025-09-15T14:35:00-04:00,407.25,407.79,403.87,404.39,NaN,NaN,NaN,411.6816482480384,NaN,NaN,417.44649999999854,425.9392228263553,408.95377717364175,415.2110156497763,418.11070247555205,422.1748542801091,414.046550670995,225589,109639.23333333334,19.970256518878173,34.547380559186,NaN,NaN,NaN,NaN,1.9627559438736812,39.089989788184354,104460912,-1.1583263289682195,-3.0083153069101627,-1.8499889779419432
2025-09-15T14:40:00-04:00,404.29,406.24,402.43,406.07,NaN,NaN,NaN,410.4402096913094,NaN,NaN,417.25149999999854,426.3133199609819,408.1896800390152,414.52381251982104,417.71109806536305,422.30797127406055,413.11422485666554,328467,117786.93333333333,27.922522710381983,33.194424466867865,NaN,NaN,NaN,NaN,2.094701947882704,41.88136072440978,104789379,-1.0260663735150652,-3.1325719448357745,-2.1065055713207093
2025-09-15T14:45:00-04:00,406.2,407.2,405.34,406.19,NaN,NaN,NaN,410.4402096913094,NaN,NaN,417.0214999999986,426.5963702865928,407.4466297134044,412.0830500158568,417.523151679598,422.3090603967257,412.7372429624703,180751,121177.96666666666,28.469272686583366,31.726988643739556,NaN,NaN,NaN,NaN,2.0779375230339405,43.61161429547884,104970130,-0.8625175720888487,-3.18465253643177,-2.322134964342921
2025-09-15T14:50:00-04:00,406.16,406.84,405.25,406.79,NaN,NaN,NaN,410.4402096913094,NaN,NaN,416.7906999999986,426.7758279433445,406.8055720566527,408.54744001268546,417.4218953301132,422.3030050490803,412.54078561114613,100348,121000.1,31.276323456982936,30.417294935877756,NaN,NaN,NaN,NaN,2.043084842817229,45.23471728643224,105070478,-0.6553326959461634,-3.1413008342756257,-2.4859681383294623
2025-09-15T14:55:00-04:00,406.73,407.5,406.52,407.14,NaN,NaN,NaN,410.4402096913094,NaN,NaN,416.5576999999986,426.88323770246484,406.23216229753234,407.0789520101483,417.3042678552952,422.28028385656546,412.328251854025,127704,119264.03333333334,32.92976532315505,29.236871251234955,NaN,NaN,NaN,NaN,1.9671502111874282,46.137209090314,105198182,-0.44611932728669723,-3.0436172974378337,-2.5974979701511365
2025-09-15T15:00:00-04:00,407.09,407.88,406.61,407.55,NaN,NaN,NaN,410.4402096913094,NaN,NaN,416.2944999999986,426.8515543716026,405.7374456283946,406.5771616081187,417.2142786108587,422.25659409579816,412.1719631259192,102658,119937.73333333334,34.905494320933784,28.487361485854642,NaN,NaN,NaN,NaN,1.917353767531182,46.63027762991573,105300840,-0.24175599329343145,-2.8996929617679257,-2.6579369684744942
2025-09-15T15:05:00-04:00,407.61,409.17,407.58,408.92,NaN,NaN,NaN,410.4402096913094,NaN,NaN,416.0404999999986,426.6835783613088,405.3974216386884,404.9397292864949,417.11003829083353,422.2100801979468,412.00999638372025,138438,122406.73333333334,41.14437809362824,28.409515497468096,NaN,NaN,NaN,NaN,1.8961142127075266,45.988552934879415,105439278,0.010670337345407788,-2.6445990467927345,-2.6552693841381423
2025-09-15T15:10:00-04:00,408.87,409.85,408.58,409.39,NaN,NaN,NaN,410.4402096913094,NaN,NaN,415.7934999999985,426.4692046139947,405.11779538600234,405.52647285056673,417.0278682145991,422.16351729341636,411.89221913578183,121836,123662.1,43.1571760433557,29.235270963664327,NaN,NaN,NaN,NaN,1.851391768942706,44.861573339305615,105561114,0.22252880048677515,-2.3771083835296736,-2.5996371840164487
2025-09-15T15:15:00-04:00,409.41,409.42,407.8,408.16,NaN,NaN,NaN,410.4402096913094,NaN,NaN,415.5708999999985,426.4086142777065,404.73318572229056,405.52647285056673,416.94776279895933,422.12542779143394,411.7700978064847,109664,123123.43333333333,39.36320017749218,30.232943845787258,NaN,NaN,NaN,NaN,1.8348637854467988,44.1269172955635,105451450,0.28885692285435116,-2.23856603044851,-2.527422953302861
2025-09-15T15:20:00-04:00,408.155,408.2,406.81,407.95,NaN,NaN,NaN,410.4402096913094,NaN,NaN,415.30829999999855,426.23525979882413,404.381340201173,405.52647285056673,416.860363589064,422.0911200982585,411.62960707986946,111343,123070.83333333333,38.73706639077109,30.894631722275882,NaN,NaN,NaN,NaN,1.8030878007720266,43.81282507748105,105340107,0.3249280709765694,-2.1212628645821496,-2.446190935558719
2025-09-15T15:25:00-04:00,407.99,408.42,407.44,407.71,NaN,NaN,NaN,410.4402096913094,NaN,NaN,415.0036999999985,425.91179934155366,404.09560065844335,405.52647285056673,416.80514636700246,422.06700225896213,411.5432904750428,73064,121772.8,37.99325995789671,31.743504076084708,NaN,NaN,NaN,NaN,1.7442958150025976,43.33651011074359,105267043,0.33748871791308455,-2.0243300381673635,-2.361818756080448
2025-09-15T15:30:00-04:00,407.72,408.17,406.43,407.25,NaN,NaN,NaN,410.4402096913094,NaN,NaN,414.7222999999985,425.68988062861894,403.75471937137803,405.52647285056673,416.69288680447266,422.0236481150222,411.36212549392314,142136,124665.13333333333,36.5448527037508,32.69251721634651,NaN,NaN,NaN,NaN,1.7439889710738412,43.27048265338037,105124907,0.31984589721762013,-1.9620113845584228,-2.281857281776043
2025-09-15T15:35:00-04:00,407.275,409.11,407.22,409.11,NaN,NaN,NaN,410.4402096913094,NaN,NaN,414.4562999999985,425.30971306894133,403.6028869310557,405.52647285056673,416.61151380255035,421.97781113059284,411.24521647450786,120645,126216.46666666666,45.57905849117327,34.43899461266724,NaN,NaN,NaN,NaN,1.7544183302828515,42.420929389705776,105245552,0.4315249805220689,-1.742451056123457,-2.173976036645526
2025-09-15T15:40:00-04:00,409.08,409.6,408.74,409.1,NaN,NaN,NaN,410.4402096913094,NaN,NaN,414.2142999999985,424.99480629818726,403.43379370180975,405.92284049893897,416.5529288315936,421.93856151267005,411.16729615051713,96319,127866.4,45.541517791542915,35.96672461903758,NaN,NaN,NaN,NaN,1.6905313066912202,41.24086522778242,105149233,0.4980835617261721,-1.5513715844878107,-2.0494551462139827
2025-09-15T15:45:00-04:00,409.08,409.44,408.55,409.21,NaN,NaN,NaN,410.4402096913094,NaN,NaN,413.9790999999985,424.67257103448014,403.2856289655168,406.0532723991512,416.4678526885978,421.88126951285574,411.0544358643399,141076,130785.1,46.06773259313735,37.830830052913235,NaN,NaN,NaN,NaN,1.6333504990704177,40.235651712253045,105290309,0.5393952620026166,-1.375211068710712,-1.9146063307133285
2025-09-15T15:50:00-04:00,409.02,411.23,408.85,411,404.7635178755037,404.7635178755037,404.7635178755037,NaN,NaN,NaN,413.7726999999985,424.28834628756994,403.2570537124271,407.33061791932096,416.32427999720903,421.7531414770857,410.89541851733236,298830,138920.86666666667,53.877765989446196,39.68477600141782,NaN,NaN,NaN,NaN,1.6866826062796731,37.9586574538471,105589139,0.668701363137213,-1.0787296267918123,-1.7474309899290252
2025-09-15T15:55:00-04:00,410.95,410.95,409.155,410.26,404.76426706298076,NaN,NaN,NaN,NaN,NaN,413.54909999999853,423.8768758866616,403.22132411333547,407.33061791932096,416.2050165296972,421.6484862172126,410.7615468421818,249233,145419.43333333332,50.614570162514205,41.26658296398431,NaN,NaN,NaN,NaN,1.6979909915454126,35.84430564247016,105339906,0.6833994153755809,-0.8931817207095492,-1.57658113608513
2025-09-16T09:30:00-04:00,414.47,417,413.18,413.64,409.1230503782998,NaN,NaN,NaN,NaN,NaN,413.4044999999985,423.51846722385426,403.29053277614275,410.39639546836537,414.6066666666668,414.6066666666668,414.6066666666668,420986,156899.33333333334,61.95039997335575,43.45758842943951,NaN,NaN,NaN,NaN,2.0581344921493123,35.527637381205025,105760892,0.8868640361305711,-0.46800109092191633,-1.3548651270524874
2025-09-16T09:35:00-04:00,413.61,414.34,411.5,412.5,409.1230503782998,NaN,NaN,NaN,NaN,NaN,413.26309999999853,423.2248636774365,403.3013363225606,410.39639546836537,413.68851759831927,414.6018382355678,412.7751969610707,425449,169179.73333333334,57.18287172252425,45.1899531722516,NaN,NaN,NaN,NaN,2.11398202842436,34.30527037095687,105335443,0.9075007503979886,-0.2204891890550016,-1.1279899394529902
2025-09-16T09:40:00-04:00,412.52,413.59,411.66,412.87,409.1230503782998,NaN,NaN,NaN,NaN,NaN,413.1332999999985,422.9418641377918,403.32473586220516,410.39639546836537,413.4467632833894,414.34547795683255,412.5480486099462,276490,176828.63333333333,58.30442694932833,46.86130550285121,NaN,NaN,NaN,NaN,2.1008404549654736,33.17021529001216,105611933,0.9067589587676841,0.005458759006614855,-0.9013001997610692
2025-09-16T09:45:00-04:00,412.86,415.64,412.83,413.11,409.1230503782998,NaN,NaN,NaN,NaN,NaN,413.00349999999844,422.63652263079996,403.3704773691969,410.39639546836537,413.526183838721,414.3501797157831,412.7021879616589,267163,183672.06666666668,59.053652359192235,48.14053937896292,NaN,NaN,NaN,NaN,2.1514947081822258,32.83172314648199,105879096,0.8822934363723578,0.20156659570437796,-0.6807268406679798
2025-09-16T09:50:00-04:00,413.2,417.93,412.99,416.55,409.1230503782998,NaN,NaN,NaN,NaN,NaN,412.9154999999985,422.3345558446807,403.4964441553162,410.39639546836537,413.96164528480676,415.12824422931124,412.7950463403023,325151,192472.23333333334,67.94472153385257,49.91107834256986,NaN,NaN,NaN,NaN,2.350673657597781,33.17529347636805,106204247,1.0464464612553288,0.6273312359011811,-0.41911522535414764
2025-09-16T09:55:00-04:00,416.57,417.84,414.85,416.05,409.66606968116173,NaN,NaN,NaN,NaN,NaN,412.8240999999985,422.0285803636725,403.6196196363245,410.39639546836537,414.22762075520916,415.546542833802,412.9086986766163,225954,196219.66666666666,65.711277991823,51.79308390073635,NaN,NaN,NaN,NaN,2.396339824912222,33.49432306840509,105978293,1.0663901060082255,0.9138724071561342,-0.15251769885209127
2025-09-16T10:00:00-04:00,415.99,419.57,415.62,418.98,410.68102105929074,NaN,NaN,NaN,NaN,NaN,412.82169999999854,422.0196938271833,403.6237061728138,411.5071750936592,414.6790213929008,416.428064852954,412.9299779328476,259428,194833.9,71.6022334569567,54.14059583403532,NaN,NaN,NaN,NaN,2.5073155517042056,34.241902328907095,106237721,1.211364694416816,1.3616881691689287,0.15032347475211277
2025-09-16T10:05:00-04:00,419.01,419.4,416.75,416.89,411.1139291929593,NaN,NaN,NaN,NaN,NaN,412.7892999999985,421.9180696895712,403.66053031042577,411.62474007492733,414.8956626831293,416.7507946299028,413.0405307363557,171224,194444.76666666666,63.25414945559823,55.94494508387114,NaN,NaN,NaN,NaN,2.5175072980110467,34.93608307080182,106066497,1.1039808310362678,1.5302995135474475,0.42631868251117977
2025-09-16T10:10:00-04:00,416.79,417,414.36,414.71,411.1139291929593,NaN,NaN,NaN,NaN,NaN,412.6858999999984,421.6057965669765,403.76600343302033,411.62474007492733,414.928096472552,416.7206611237256,413.1355318213784,179499,194456.6,55.92936244653934,57.32955292264175,NaN,NaN,NaN,NaN,2.526256776724542,34.144416328649015,105886998,0.8357930332618256,1.4710599740884618,0.6352669408266362
2025-09-16T10:15:00-04:00,414.74,415.14,413.28,413.945,411.1139291929593,NaN,NaN,NaN,NaN,NaN,412.58499999999844,421.3297883911078,403.8402116088891,411.62474007492733,414.88666272421824,416.64162380491,413.13170164352647,138186,193145.23333333334,53.58440990463477,57.90136373788901,NaN,NaN,NaN,NaN,2.478667006958504,32.84624686160525,105748812,0.5692723451335409,1.3468573722435622,0.7775850271100213
2025-09-16T10:20:00-04:00,413.97,415.3,413.44,415,411.1139291929593,NaN,NaN,NaN,NaN,NaN,412.5317999999984,421.18432165820525,403.8792783417915,411.62474007492733,414.87716621767515,416.60555700350386,413.14877543184645,85949,190885.13333333333,56.30522721607456,58.67020012535555,NaN,NaN,NaN,NaN,2.434476506461469,31.70113872828187,105834761,0.43261868523201186,1.318358383650036,0.8857396984180242
2025-09-16T10:25:00-04:00,415,417.42,414.81,416.19,411.1139291929593,NaN,NaN,NaN,NaN,NaN,412.50799999999845,421.11346663496,403.9025333650369,411.62474007492733,414.93640413733914,416.6447662676431,413.2280420070352,136602,190823.93333333332,59.20972671665867,59.60891399132135,NaN,NaN,NaN,NaN,2.4470138988570795,31.383189441168685,105971363,0.39215613246406966,1.3759348639981113,0.9837787315340416
2025-09-16T10:30:00-04:00,416.12,417.78,416.075,417.73,411.1139291929593,NaN,NaN,NaN,NaN,NaN,412.51449999999846,421.135229725796,403.8937702742009,411.7236708277522,415.007746283059,416.7346967752763,413.28079579084175,94984,189172.2,62.66816187548405,60.236799411752635,NaN,NaN,NaN,NaN,2.394012906081573,31.204486167457183,106066347,0.43554779517860687,1.5282134755073002,1.0926656803286934
2025-09-16T10:35:00-04:00,417.75,418.7,417.03,417.6,411.1139291929593,NaN,NaN,NaN,NaN,NaN,412.5388999999984,421.2100139518232,403.8677860481736,413.01993666220176,415.1044813869492,416.8755433155255,413.33341945837293,108858,185281.16666666666,62.18882297576123,61.06353175555599,NaN,NaN,NaN,NaN,2.3422976985043187,31.333850221187426,105957489,0.4216547928676957,1.619734171413313,1.1980793785456174
2025-09-16T10:40:00-04:00,417.6,418.82,417.2,418.72,411.34008488936985,NaN,NaN,NaN,NaN,NaN,412.57769999999834,421.3412449930734,403.8141550069233,413.4659493297614,415.2095566826162,417.0401016952526,413.37901166997983,107802,177925.66666666666,64.69435103451507,61.259528259924515,NaN,NaN,NaN,NaN,2.29070500575401,31.492726869189863,106065291,0.4513962096525208,1.7623246406112685,1.3109284309587477
2025-09-16T10:45:00-04:00,418.74,421.08,417.76,420.98,412.60053557621666,NaN,NaN,NaN,NaN,NaN,412.6448999999983,421.61125745248023,403.6785425475164,415.1367594638091,415.57846896625244,417.74609248789454,413.41084544461035,272673,180989.73333333334,69.13834433136167,62.11349058912718,NaN,NaN,NaN,NaN,2.3642260767715806,32.30987550742435,106337964,0.5786510542565044,2.0342422487793783,1.4555911945228739
2025-09-16T10:50:00-04:00,420.99,421.13,419.69,419.855,413.7041475954795,NaN,NaN,NaN,NaN,NaN,412.6807999999983,421.7474084863988,403.61419151359786,415.6554075710473,415.7479488313946,418.04707540622906,413.4488222565601,132357,182056.7,64.76797366137133,62.575172497130254,NaN,NaN,NaN,NaN,2.298209928430753,33.0823135949864,106205607,0.5430128622111117,2.1343572722867634,1.5913444100756517
2025-09-16T10:55:00-04:00,419.93,420.17,418.08,418.49,413.7041475954795,NaN,NaN,NaN,NaN,NaN,412.70879999999835,421.8381326287091,403.5794673712876,415.6554075710473,415.84625167420563,418.17505535848983,413.51744798992144,116305,181676.73333333334,59.82648716273035,62.63037498309726,NaN,NaN,NaN,NaN,2.2833377906857018,32.7354517944568,106089302,0.3905908080033762,2.079582920079872,1.688992112076496
2025-09-16T11:00:00-04:00,418.51,418.53,416.83,417.28,413.7041475954795,NaN,NaN,NaN,NaN,NaN,412.7005999999983,421.8127417112472,403.5884582887494,415.6554075710473,415.89373528456485,418.20682172477433,413.5806488443554,107584,181840.93333333332,55.764901259339624,61.76038782063205,NaN,NaN,NaN,NaN,2.2416708056367223,31.68006190141086,105981718,0.18196260985065082,1.9164453743898093,1.7344827645391585
2025-09-16T11:05:00-04:00,417.35,417.84,416.57,416.84,413.7041475954795,NaN,NaN,NaN,NaN,NaN,412.68639999999834,421.7704385383119,403.6023614616848,415.6554075710473,415.91682478081674,418.2132252297338,413.6204243318997,76258,179768.26666666666,54.320726665479974,60.946777011607544,NaN,NaN,NaN,NaN,2.172265748091241,30.55161044973414,105905460,-0.0022330039993843087,1.7316915095399281,1.7339245135393124
2025-09-16T11:10:00-04:00,416.86,419.65,416.75,419.63,413.7041475954795,NaN,NaN,NaN,NaN,NaN,412.7351999999984,421.94088975392896,403.5295102460678,415.6554075710473,416.00131528826154,418.311738174357,413.69089240216607,124079,179843.03333333333,61.18499993179906,60.20268890266771,NaN,NaN,NaN,NaN,2.2242467660847223,30.204792571116997,106029539,0.04467723469933427,1.7897710569134802,1.7450938222141459
2025-09-16T11:15:00-04:00,419.59,420.84,419.11,419.91,413.7041475954795,NaN,NaN,NaN,NaN,NaN,412.78079999999835,422.10484962693965,403.45675037305705,415.7514535528808,416.1474314304047,418.53422765304634,413.7606352077631,155602,181374.3,61.8053213123493,60.09920117814993,NaN,NaN,NaN,NaN,2.1889434256500966,30.287732420234597,106185141,0.07369686764567307,1.837214906771237,1.763518039125564
2025-09-16T11:20:00-04:00,419.96,420.97,419.38,419.48,413.7311045075127,NaN,NaN,NaN,NaN,NaN,412.81539999999836,422.2253957154875,403.40540428450925,416.1041628423047,416.2728532344973,418.71599147981397,413.8297149891806,143809,182456.5,60.21381483943368,60.405233491928094,NaN,NaN,NaN,NaN,2.1461617523893777,30.408366128775853,106041332,0.04450324701408048,1.8191470978931648,1.7746438508790843
2025-09-16T11:25:00-04:00,419.52,420.44,418.56,418.6,413.7311045075127,NaN,NaN,NaN,NaN,NaN,412.8329999999984,422.2828306865994,403.38316931339733,416.1041628423047,416.3316413818366,418.78473564383484,413.8785471198384,89204,182994.5,56.980079368069596,60.64778131074487,NaN,NaN,NaN,NaN,2.127150198647279,29.983111055006113,105952128,-0.04846631596832118,1.7140609559186828,1.762527271887004
2025-09-16T11:30:00-04:00,418.61,419.1,417.85,418.35,413.7311045075127,NaN,NaN,NaN,NaN,NaN,412.8613999999984,422.3686721726726,403.35412782732425,416.1041628423047,416.36663833582514,418.81404398804943,413.91923268360085,75213,180763.73333333334,56.05900279660464,60.63019385221131,NaN,NaN,NaN,NaN,2.064496613029616,29.139640535783055,105876915,-0.13622019321147283,1.5922520303726628,1.7284722235841357
2025-09-16T11:35:00-04:00,418.39,419.13,417.96,419.13,413.7311045075127,NaN,NaN,NaN,NaN,NaN,412.9187999999984,422.54141057329826,403.2961894266985,416.1041628423047,416.4024386418621,418.84848207368003,413.95639521004415,69176,179048.1,58.322666407168,60.56683240153341,NaN,NaN,NaN,NaN,2.000603997813216,28.369807855153045,105946091,-0.15006210931940234,1.5408945869348827,1.690956696254285
2025-09-16T11:40:00-04:00,419.17,419.36,417.46,417.82,413.7311045075127,NaN,NaN,NaN,NaN,NaN,413.0100999999984,422.72987314372506,403.2903268562717,416.1041628423047,416.4283674386218,418.86634666566715,413.9903882115765,66617,178058.03333333333,53.35158700958739,59.901362768255076,NaN,NaN,NaN,NaN,1.993417997969417,27.321048812102312,105879474,-0.24988871946263402,1.3785957969259925,1.6284845163886266
2025-09-16T11:45:00-04:00,417.83,418.43,417.07,418.15,413.7311045075127,NaN,NaN,NaN,NaN,NaN,413.1620999999984,422.9606148040632,403.36358519593364,416.1041628423047,416.448125825709,418.8753432189874,414.0209084324306,64052,175490.56666666668,54.40585194331944,59.345436265937806,NaN,NaN,NaN,NaN,1.9481738552573167,26.086442190056612,105943526,-0.293145278567569,1.2620529181791653,1.5551981967467343
2025-09-16T11:50:00-04:00,418.07,418.9,417.63,418.81,413.7311045075127,NaN,NaN,NaN,NaN,NaN,413.3124999999984,423.22168427548075,403.40331572451606,416.1041628423047,416.470714993825,418.8934056595235,414.04802432812653,53921,167326.93333333332,56.52223733298974,58.761713858685994,NaN,NaN,NaN,NaN,1.8997328655960786,25.197108419674187,105997447,-0.27694927887249965,1.2090115981561098,1.4859608770286095
2025-09-16T11:55:00-04:00,418.76,419.63,418.39,419.63,413.7311045075127,NaN,NaN,NaN,NaN,NaN,413.51169999999837,423.5199291363485,403.50347086364826,416.1041628423047,416.5121793677279,418.9397173105334,414.08464142492244,73141,161457.2,59.064609842097376,58.04216139516711,NaN,NaN,NaN,NaN,1.8526090894820737,24.758222349968282,106070588,-0.21349653853725892,1.2190902038570357,1.4325867423942946
2025-09-16T12:00:00-04:00,419.59,420.62,418.17,418.42,413.7311045075127,NaN,NaN,NaN,NaN,NaN,413.71899999999835,423.6958744607557,403.742125539241,416.38630290184517,416.57820600590406,419.0082979904051,414.14811402140305,128347,151702.56666666668,54.04273888774264,57.27607319705078,NaN,NaN,NaN,NaN,1.8952798688047818,24.835890729811585,105942241,-0.25281374193561024,1.1165695649747818,1.369383306910392
2025-09-16T12:05:00-04:00,418.32,420.2,418.1,419.98,413.7311045075127,NaN,NaN,NaN,NaN,NaN,413.9851999999984,423.9056592557852,404.0647407442115,416.38630290184517,416.6186350494123,419.05483223982515,414.1824378589995,71586,139907.13333333333,58.89512601152392,57.20954740053603,NaN,NaN,NaN,NaN,1.9099027353187237,24.850936816308685,106013827,-0.1771329398790491,1.1479671320615807,1.3251000719406298
2025-09-16T12:10:00-04:00,419.99,420.25,419.08,419.85,413.84572058750587,NaN,NaN,NaN,NaN,NaN,414.23759999999834,424.0997367342851,404.3754632657116,416.38630290184517,416.6548670236757,419.0996913546591,414.2100426926923,59490,132673.8,58.34230023023481,57.393647327028546,NaN,NaN,NaN,NaN,1.857052539938816,24.890929956575878,105954337,-0.1407890586368279,1.149113748644595,1.289902807281423
2025-09-16T12:15:00-04:00,419.82,420.55,419.44,420.48,414.2888696517102,NaN,NaN,NaN,NaN,NaN,414.5593999999983,424.1618427395393,404.9569572604573,416.68734708574476,416.70290968778943,419.16483788292743,414.24098149265143,70986,126134.56666666667,60.2877298666124,57.819861841395145,NaN,NaN,NaN,NaN,1.8036916442289017,25.090294996380415,106025323,-0.08218369234365452,1.1871731918518549,1.2693568841955094
2025-09-16T12:20:00-04:00,420.45,420.48,419.67,419.89,414.5177846675416,NaN,NaN,NaN,NaN,NaN,414.83579999999824,424.23840333344,405.4331966665565,416.9848776685958,416.7308393948686,419.2009877162413,414.26069107349593,44025,116763.7,57.57593170488364,57.56207125375833,NaN,NaN,NaN,NaN,1.7327136696411232,25.27541967619891,105981298,-0.09036768523768002,1.1563972776484093,1.2467649628860893
2025-09-16T12:25:00-04:00,419.85,420.4,419.77,420.18,414.6944762735624,NaN,NaN,NaN,NaN,NaN,415.1155999999983,424.30258245159513,405.9286175484015,417.2889021348766,416.7622560379787,419.2422562010215,414.2822558749359,48872,110860.96666666666,58.5625565638285,57.33044520029256,NaN,NaN,NaN,NaN,1.6539484075239,25.447321164601806,106030170,-0.08361942572075765,1.1422406807351422,1.2258601064558998
2025-09-16T12:30:00-04:00,420.16,421.66,420.09,421.02,415.5154091702186,NaN,NaN,NaN,NaN,NaN,415.4001999999983,424.41798042791635,406.3824195720802,418.3861217079013,416.85985321692465,419.39021458792126,414.32949184592803,126504,106430.16666666667,61.36529947131458,57.41269410256977,NaN,NaN,NaN,NaN,1.6479520927007678,26.31839446136951,106156674,-0.03257537390785692,1.1851408890710786,1.2177162629789355
2025-09-16T12:35:00-04:00,421.04,422.12,420.44,422.02,415.9349360261178,NaN,NaN,NaN,NaN,NaN,415.6977999999983,424.5867464305893,406.80885356940735,418.660897366321,416.95158430011617,419.5393543097088,414.3638142905235,108141,104327.4,64.44818555408737,57.94613025871389,NaN,NaN,NaN,NaN,1.6502412289364279,27.35604919003692,106264815,0.05384168089902075,1.2850183641027115,1.2311766832036908
2025-09-16T12:40:00-04:00,422.05,422.06,420.26,420.53,415.9349360261178,NaN,NaN,NaN,NaN,NaN,415.9573999999983,424.63500802099173,407.27979197900487,418.660897366321,417.0124003500614,419.6266245279973,414.3981761721255,84973,101176.53333333334,57.132812436305045,58.02283094726392,NaN,NaN,NaN,NaN,1.660938284012398,28.106423729917452,106179842,-0.001128975104590868,1.229765464322952,1.230894439427543
2025-09-16T12:45:00-04:00,420.6,420.98,419.34,419.55,415.9349360261178,NaN,NaN,NaN,NaN,NaN,416.16999999999825,424.66650681199786,407.67349318799864,418.660897366321,417.05418383340424,419.6730494212207,414.4353182455878,80424,99251.13333333333,52.881218930512475,57.63415612750281,NaN,NaN,NaN,NaN,1.6594426922972298,27.774707175627032,106099418,-0.10928747477707823,1.0942850959561952,1.2035725707332734
2025-09-16T12:50:00-04:00,419.66,419.79,418.62,418.82,415.9349360261178,NaN,NaN,NaN,NaN,NaN,416.35859999999826,424.661170455356,408.0560295446405,418.660897366321,417.07521386038167,419.688493885301,414.46193383546233,59546,98371.03333333334,49.902238650382664,57.38777410184533,NaN,NaN,NaN,NaN,1.624482499990286,26.753202223505205,106039872,-0.22890973294914962,0.9174354045468363,1.1463451374959859
2025-09-16T12:55:00-04:00,418.78,419.12,418.1,418.74,415.9349360261178,NaN,NaN,NaN,NaN,NaN,416.5701999999983,424.5595616670044,408.5808383329922,418.660897366321,417.0894652274165,419.69519884280066,414.48373161203233,52186,95557.16666666667,49.57265914546011,57.042546044855385,NaN,NaN,NaN,NaN,1.5813051785624073,25.324822452630002,105987686,-0.30744324335251005,0.7620410833053484,1.0694843266578584
2025-09-16T13:00:00-04:00,418.68,420.08,418.52,420.08,415.9349360261178,NaN,NaN,NaN,NaN,NaN,416.8127999999982,424.4701721763099,409.1554278236865,418.660897366321,417.1250453048945,419.7286385365229,414.5214520732661,84441,95205.73333333334,54.940791572903656,56.92958563342065,NaN,NaN,NaN,NaN,1.579783380093664,24.699843047314925,106072127,-0.26478445832790465,0.7385037537479775,1.0032882120758821
2025-09-16T13:05:00-04:00,420.05,420.26,419.65,420.13,415.9349360261178,NaN,NaN,NaN,NaN,NaN,417.0611999999983,424.3165405327511,409.80585946724545,418.660897366321,417.1494646234859,419.75548079068983,414.543448456282,49994,93243.6,55.13271889138923,56.64873627979865,NaN,NaN,NaN,NaN,1.5105131386584034,24.243576347264113,106122121,-0.23012222339914,0.7156354328269572,0.9457576562260972
2025-09-16T13:10:00-04:00,420.155,420.76,419.74,419.74,415.9349360261178,NaN,NaN,NaN,NaN,NaN,417.3109999999982,424.0388281790195,410.58317182097693,418.660897366321,417.1841289951862,419.7939894212272,414.5742685691452,70783,92009.63333333333,53.22824649212433,56.5905582515402,NaN,NaN,NaN,NaN,1.4754764858970877,24.162016948400332,106051338,-0.22984439976677695,0.658452156517626,0.888296556284403
2025-09-16T13:15:00-04:00,419.72,419.74,418.8,418.97,415.9349360261178,NaN,NaN,NaN,NaN,NaN,417.5081999999982,423.82862649243896,411.1877735075575,418.660897366321,417.20082841308874,419.8060112965155,414.59564552966197,50747,84612.1,49.58626705710789,55.925639754796194,NaN,NaN,NaN,NaN,1.437228165475867,23.153230965090277,106000591,-0.27485947334304295,0.5447222146055992,0.8195816879486422
2025-09-16T13:20:00-04:00,418.99,419.14,418.47,418.59,415.9349360261178,NaN,NaN,NaN,NaN,NaN,417.6979999999983,423.5496230232582,411.8463769767383,418.660897366321,417.21558647650807,419.81251121203337,414.61866174098276,58680,82156.2,47.84637647326758,55.17593091501283,NaN,NaN,NaN,NaN,1.382426153656159,21.913337873922963,105941911,-0.32038814365278134,0.41909650838266543,0.7394846520354468
2025-09-16T13:25:00-04:00,418.63,419.22,418.39,418.77,415.9349360261178,NaN,NaN,NaN,NaN,NaN,417.8891999999983,423.220569940857,412.55783005913963,418.39271789305684,417.2273363860306,419.8181265877595,414.63654618430166,45720,79803.36666666667,48.76347040654617,54.3527695250081,NaN,NaN,NaN,NaN,1.3429671426807221,20.762008574981884,105987631,-0.32738391718966375,0.33025475554836703,0.6576386727380308
2025-09-16T13:30:00-04:00,418.8,419.48,418.25,418.54,415.9349360261178,NaN,NaN,NaN,NaN,NaN,418.0399999999983,422.99676709218903,413.0832329078076,417.77601039935746,417.24388537034287,419.8254732089995,414.66229753168625,67159,78455.86666666667,47.611396689571606,53.64101702391438,NaN,NaN,NaN,NaN,1.3348980610606718,19.921999142114892,105920472,-0.33528035552182,0.23853822833575578,0.5738185838575758
2025-09-16T13:35:00-04:00,418.6,418.98,418.02,418.3,415.9349360261178,NaN,NaN,NaN,NaN,NaN,418.20079999999837,422.6312908809254,413.7703091190713,417.77601039935746,417.25414940349896,419.8269277749241,414.6813710320738,54022,77714.66666666667,46.38003724710835,52.770837072720084,NaN,NaN,NaN,NaN,1.3081196281277694,18.89740682181956,105866450,-0.34320137364092246,0.1448168668064227,0.48801824044734515
2025-09-16T13:40:00-04:00,418.22,419.06,417.85,418.75,415.9349360261178,NaN,NaN,NaN,NaN,NaN,418.30299999999835,422.5394522900688,414.0665477099279,417.77601039935746,417.2702360233144,419.8310698368875,414.7094022097413,78488,76194.96666666666,49.04124446238303,51.890547429224966,NaN,NaN,NaN,NaN,1.3011110832614985,17.762030393988937,105944938,-0.30590615164843427,0.10563555088680232,0.4115417025352366
2025-09-16T13:45:00-04:00,418.7,419.03,417.7,417.79,415.9349360261178,NaN,NaN,NaN,NaN,NaN,418.4087999999984,422.31134048612944,414.50625951386735,417.77601039935746,417.27727505449127,419.8293454011508,414.7252047078317,49795,72668.06666666667,44.02171980293073,50.4315141612852,NaN,NaN,NaN,NaN,1.3031745773142476,16.541068269012328,105895143,-0.3315110274873218,-0.002847081823915687,0.3286639456634061
2025-09-16T13:50:00-04:00,417.73,418.33,417.5,418.09,415.9349360261178,NaN,NaN,NaN,NaN,NaN,418.51319999999833,422.0825264134951,414.9438735865016,417.77601039935746,417.282113337498,419.8259559505922,414.73827072440383,44718,69365.03333333334,45.88572724216898,49.62815093313263,NaN,NaN,NaN,NaN,1.2693763932203717,15.538357898771654,105939861,-0.31403237906827014,-0.06387652817193157,0.25015585089633857
2025-09-16T13:55:00-04:00,418.12,418.27,417.6,417.92,415.9349360261178,NaN,NaN,NaN,NaN,NaN,418.60939999999835,421.83362991829426,415.3851700817024,417.77601039935746,417.2871289234961,419.8217420315649,414.7525158154273,50192,68064.63333333333,44.971863754524065,49.0631969919906,NaN,NaN,NaN,NaN,1.2265637937046279,14.607269697833885,105889669,-0.2997446306232895,-0.12452493738277326,0.1752196932405162
2025-09-16T14:00:00-04:00,417.94,418.68,417.75,418.6,415.9349360261178,NaN,NaN,NaN,NaN,NaN,418.6503999999984,421.82051850978263,415.48028149021417,416.882808319486,417.2966707987893,419.821787266466,414.7715543311126,59107,67527.76666666666,49.319832586761216,49.02159655887478,NaN,NaN,NaN,NaN,1.2053806655828692,13.895318967859465,105948776,-0.23327767095664337,-0.11637739545528802,0.11690027550135534
2025-09-16T14:05:00-04:00,418.61,419.08,418.2,418.92,415.9349360261178,NaN,NaN,NaN,NaN,NaN,418.7077999999984,421.7902212311133,415.6253787688834,416.8557178595768,417.30578075395636,419.8254605354446,414.7861009724681,41752,66613.63333333333,51.27108783227139,49.14291289364702,NaN,NaN,NaN,NaN,1.1821391894698066,13.698908742100649,105990528,-0.16003277240771827,-0.0831406900082925,0.07689208239942577
2025-09-16T14:10:00-04:00,418.95,419.25,418.7,419.02,415.9349360261178,NaN,NaN,NaN,NaN,NaN,418.7085999999984,421.7913241469101,415.6258758530867,417.0664469008518,417.3288667032059,419.83886887165926,414.81886453475255,91508,67443.33333333333,51.89440110332359,48.925313574391296,NaN,NaN,NaN,NaN,1.1369863902219641,13.708701286328715,106082036,-0.10005435067161048,-0.04817585594008733,0.051878494731523145
2025-09-16T14:15:00-04:00,419.02,419.77,419,419.69,415.9349360261178,NaN,NaN,NaN,NaN,NaN,418.7645999999984,421.8147002223046,415.71449977769214,417.63815752068143,417.3429369821862,419.8507633083193,414.8351106560531,43817,66768.83333333333,55.95915954535393,48.984345049674495,NaN,NaN,NaN,NaN,1.1107730766346797,14.275992243907416,106125853,-0.014931155084250823,0.033214550876209614,0.04814570596046044
2025-09-16T14:20:00-04:00,419.74,419.77,419.16,419.4,415.9349360261178,NaN,NaN,NaN,NaN,NaN,418.85839999999837,421.6841802048504,416.03261979514633,417.7595260165452,417.3525007631582,419.8586037990021,414.84639772731435,30737,65996.03333333334,53.8386456586384,49.02794499013977,NaN,NaN,NaN,NaN,1.075003571160771,14.802762418801924,106095116,0.020259072903483305,0.07346954708981457,0.053210474186331264
2025-09-16T14:25:00-04:00,419.385,420.14,418.8,418.87,415.9349360261178,NaN,NaN,NaN,NaN,NaN,418.9568999999984,421.40943248007767,416.5043675199192,417.86162081323613,417.3704403991874,419.8716142396486,414.86926655872617,63752,65683.06666666667,50.101954847736764,49.06477983232755,NaN,NaN,NaN,NaN,1.0939318875064286,15.681596179113935,106031364,0.006945140420542215,0.061891899712009035,0.05494675929146682
2025-09-16T14:30:00-04:00,418.9,419.01,418.41,418.78,415.9349360261178,NaN,NaN,NaN,NaN,NaN,419.0324999999984,421.2101117666101,416.85488823338665,417.86162081323613,417.37902925511025,419.8746410927268,414.8834174174937,43215,62845.333333333336,49.474010040114706,49.181039372816635,NaN,NaN,NaN,NaN,1.0586510383988241,15.832595570152645,105988149,-0.008008379122803846,0.044936285387962016,0.05294466451076586
2025-09-16T14:35:00-04:00,418.84,418.97,418.39,418.87,415.9349360261178,NaN,NaN,NaN,NaN,NaN,419.08609999999834,421.1075423479887,417.06465765200795,417.86162081323613,417.38506768769247,419.8767969387562,414.89333843662877,30486,61475.333333333336,50.1468993985978,49.27985572939175,NaN,NaN,NaN,NaN,1.0244616785131968,15.938907757312059,106018635,-0.011700239664450343,0.03831936493020294,0.05001960459465328
2025-09-16T14:40:00-04:00,418.89,419.29,418.68,418.99,415.9349360261178,NaN,NaN,NaN,NaN,NaN,419.1112999999984,421.09556491329647,417.1270350867003,417.86162081323613,417.39376815510605,419.8815072147547,414.90602909545737,37622,60746.4,51.082343607708324,49.52778050925866,NaN,NaN,NaN,NaN,0.9948572729051123,16.421015155588993,106056257,-0.006198779960880793,0.042271129643552285,0.04846990960443308
2025-09-16T14:45:00-04:00,419,419.43,418.66,419.02,415.9349360261178,NaN,NaN,NaN,NaN,NaN,419.1396999999984,421.07671462201984,417.202685377977,417.86162081323613,417.4028925263921,419.88671639765835,414.9190686551259,38678,59669.46666666667,51.328226086996594,49.881222569250674,NaN,NaN,NaN,NaN,0.9787960391261744,17.032581770357222,106094935,-0.0009529823103190532,0.047278681716534265,0.04823166402685332
2025-09-16T14:50:00-04:00,419.07,419.85,419.05,419.7,416.00910869200754,NaN,NaN,NaN,NaN,NaN,419.1592999999984,421.09876179286294,417.2198382071338,417.91386070808124,417.42257076558246,419.90328284124683,414.9418586899181,64926,60366.166666666664,56.647457180744034,50.42452347770503,NaN,NaN,NaN,NaN,0.9681677506171649,18.069303031030763,106159861,0.04534123145812509,0.10490820334950968,0.05956697189138459
2025-09-16T14:55:00-04:00,419.73,420.25,419.47,420.12,416.46914920600716,NaN,NaN,NaN,NaN,NaN,419.1420999999984,421.03127134374057,417.2529286562562,418.31108856646495,417.4424410172381,419.9234180130486,414.96146402142756,55774,60596.23333333333,59.585347597334334,51.53621117730529,NaN,NaN,NaN,NaN,0.9547271970016512,19.43462470527567,106215635,0.09824104359541998,0.18236827638565956,0.08412723279023958
2025-09-16T15:00:00-04:00,420.14,420.42,419.46,419.96,416.5723696966432,NaN,NaN,NaN,NaN,NaN,419.14419999999836,421.0367668934262,417.2516331065705,418.38887085317197,417.4600333404203,419.94111204988536,414.97895463095523,50124,58050.23333333333,57.9735652256468,52.399628176125134,NaN,NaN,NaN,NaN,0.9551038257872502,20.865395207079015,106165511,0.11526986502882261,0.22821456407626783,0.11294469904744522
2025-09-16T15:05:00-04:00,419.95,420.52,419.72,419.8,416.7963528922503,NaN,NaN,NaN,NaN,NaN,419.1703999999984,421.0622856641043,417.27851433589245,418.49509668253756,417.47744152629815,419.9589586910575,414.9959243615388,48980,56078.2,56.33255584518771,53.21110618260111,NaN,NaN,NaN,NaN,0.9440249810881577,22.291220277493085,106116531,0.10866004212815683,0.24876975170764126,0.14010970957948443
2025-09-16T15:10:00-04:00,419.86,420.3,419.51,420.22,416.7963528922503,NaN,NaN,NaN,NaN,NaN,419.2291999999984,421.0643145593593,417.3940854406375,418.49509668253756,417.50266076221044,419.9845632445858,415.0207582798351,72258,55654.36666666667,59.567905927644034,53.94311142123559,NaN,NaN,NaN,NaN,0.9330231967247193,23.128301188058035,106188789,0.12434705955277492,0.2955435340204531,0.17119647446767816
2025-09-16T15:15:00-04:00,420.23,420.95,420,420.46,417.2142595567818,NaN,NaN,NaN,NaN,NaN,419.3015999999984,421.0368826184454,417.5663173815514,418.863061876824,417.5304003745749,420.0171249636517,415.0436757854981,68474,55256.03333333333,61.33099067226249,54.661675909806384,NaN,NaN,NaN,NaN,0.9342358255300958,24.56044719134734,106257263,0.14141637356799458,0.3479669414276714,0.2065505678596768
2025-09-16T15:20:00-04:00,420.47,420.67,420.13,420.25,417.2142595567818,NaN,NaN,NaN,NaN,NaN,419.31399999999843,421.0672598227094,417.56074017728747,418.863061876824,417.54718874617697,420.0359704633487,415.05840702900525,43874,54733.63333333333,58.91034482913258,55.162814747364166,NaN,NaN,NaN,NaN,0.906076123706519,25.890297051544554,106213389,0.12941701742137385,0.3683218396363941,0.23890482221502024
2025-09-16T15:25:00-04:00,420.24,420.83,419.71,420.56,417.2142595567818,NaN,NaN,NaN,NaN,NaN,419.32699999999846,421.10717639741307,417.54682360258386,418.863061876824,417.57068621368495,420.06229451911025,415.07907790825965,61926,55058.3,61.33629473097414,55.54689583205133,NaN,NaN,NaN,NaN,0.9213564005846252,26.160796662398095,106275315,0.13271722567243321,0.40480135430556174,0.27208412863312853
2025-09-16T15:30:00-04:00,420.56,422.56,420.49,422.31,418.19384886883506,NaN,NaN,NaN,NaN,NaN,419.3835999999984,421.3498665551658,417.417333444831,419.8356876809339,417.67595422505264,420.2226833643963,415.129225085709,190283,58586.36666666667,71.54843081741757,56.811880486249834,NaN,NaN,NaN,NaN,1.0034023719714373,27.89338736250263,106465598,0.23702884861041584,0.5683701893961484,0.3313413407857325
2025-09-16T15:35:00-04:00,422.35,423.24,421.87,422.81,419.1884466475244,NaN,NaN,NaN,NaN,NaN,419.4677999999985,421.64218281950554,417.2934171804914,420.37555014474714,417.79908681556606,420.4298705832168,415.1683030479153,193842,63381.3,73.68689444979968,58.49651902925433,NaN,NaN,NaN,NaN,1.0295879168306208,29.895290888413268,106659440,0.31887196525259015,0.7299312973514702,0.41105933209888007
2025-09-16T15:40:00-04:00,422.81,423.17,422.25,422.31,419.3710172544552,NaN,NaN,NaN,NaN,NaN,419.54699999999843,421.83810017369404,417.2558998263028,420.4184401157977,417.8601244070772,420.5285486111044,415.19170020305,101131,64392.9,68.16907213663163,59.83188060757697,NaN,NaN,NaN,NaN,1.0217602084855775,31.75420130533028,106558309,0.31779746849452384,0.8083061677170349,0.49050869922251106
2025-09-16T15:45:00-04:00,422.29,422.9,421.88,422.45,419.3710172544552,NaN,NaN,NaN,NaN,NaN,419.6133999999984,422.04070009804934,417.1860999019475,420.4184401157977,417.9320544878991,420.63945493980617,415.22465403599205,127153,66939.76666666666,68.87193768980792,61.16938334266341,NaN,NaN,NaN,NaN,1.021634479308035,32.75137483653011,106685462,0.30492712506261777,0.8716676055507833,0.5667404804881655
2025-09-16T15:50:00-04:00,422.52,423.03,420.91,421.65,419.3710172544552,NaN,NaN,NaN,NaN,NaN,419.6899999999984,422.1277924452294,417.25220755476744,420.4184401157977,418.0114591985679,420.7478475280799,415.27507086905587,165802,70510.5,60.632875837454215,61.85156421621668,NaN,NaN,NaN,NaN,1.1000891593574573,32.05395705233119,106519660,0.22465446354205942,0.8475585599157398,0.6229040963736804
2025-09-16T15:55:00-04:00,421.83,421.88,421.16,421.65,419.3710172544552,NaN,NaN,NaN,NaN,NaN,419.7599999999984,422.21781040888334,417.30218959111346,420.4184401157977,418.08873066521585,420.8443449793968,415.3331163510349,182554,75071.63333333333,60.632875837454215,62.51618205553508,NaN,NaN,NaN,NaN,1.0729399336890653,31.406354824146476,106519660,0.15688545849331514,0.8190109194903243,0.6621254609970092
2025-09-17T09:30:00-04:00,415.78,417.2,413.13,413.94,NaN,NaN,NaN,419.5769647024465,419.5769647024465,419.5769647024465,419.6625999999984,422.6020688237704,416.7231311762264,420.4184401157977,414.75666666666666,414.75666666666666,414.75666666666666,288489,82449.3,25.94345559862552,60.32303908538376,NaN,NaN,NaN,NaN,1.6048727955684166,32.78839248973892,106231171,-0.39188569541602625,0.17226834172697636,0.5641540371430026
2025-09-17T09:35:00-04:00,413.9,414.39,410.2,410.65,NaN,NaN,NaN,417.0777844886989,NaN,NaN,419.4829999999984,423.3572126949767,415.60878730502014,420.4184401157977,413.19530084791944,414.69924496074185,411.69135673509703,310939,91013.2,20.542521997699723,57.534265828267,NaN,NaN,NaN,NaN,1.789524738742101,34.74244185646235,105920232,-0.9304049261375928,-0.5988521205289885,0.33155280560860434
2025-09-17T09:40:00-04:00,410.62,413.67,409.67,412.85,NaN,NaN,NaN,416.78083973921264,NaN,NaN,419.3715999999984,423.6598655894917,415.08333441050513,420.4184401157977,412.8361843179822,414.185932643244,411.48643599272043,278533,97681.36666666667,30.90158692912655,55.60055309280127,NaN,NaN,NaN,NaN,1.9474158288319507,36.65887370241022,106198765,-1.081788826695295,-1.0206832277605145,0.06110559893478057
2025-09-17T09:45:00-04:00,412.83,415.2,412.09,414.9,NaN,NaN,NaN,416.78083973921264,NaN,NaN,419.2699999999984,423.73295149044674,414.80704850955004,420.4184401157977,413.0454623279636,414.35852944723365,411.73239520869356,180512,102038.6,38.89575093358464,54.355067027686765,NaN,NaN,NaN,NaN,2.030457555343955,37.28215544339047,106379277,-0.9896950421599798,-1.1760132037651942,-0.18631816160521442
2025-09-17T09:50:00-04:00,414.93,415.8,414.28,414.29,NaN,NaN,NaN,416.78083973921264,NaN,NaN,419.15879999999845,423.8305870505612,414.4870129494357,420.4184401157977,413.2409257944977,414.5950875415096,411.88676404748577,133559,104999.96666666666,37.50529193200366,52.779166027998166,NaN,NaN,NaN,NaN,1.993996301390818,37.43936152710311,106245718,-0.9173211404771565,-1.33296958720166,-0.4156484467245035
2025-09-17T09:55:00-04:00,414.27,416.3,414.27,416.19,NaN,NaN,NaN,416.78083973921264,NaN,NaN,419.07299999999844,423.8018057695256,414.3441942304713,420.4184401157977,413.49080331736565,414.9612197559868,412.0203868787445,142119,108064.2,44.19679415063554,51.55529484788195,NaN,NaN,NaN,NaN,1.9965679941486187,37.235135234077475,106387837,-0.6988281422306956,-1.289183624512873,-0.5903554822821774
2025-09-17T10:00:00-04:00,416.18,416.43,414.87,415.92,NaN,NaN,NaN,416.78083973921264,NaN,NaN,418.9935999999984,423.7975879439824,414.1896120560144,420.18875209263814,413.68200687788163,415.2220778294152,412.1419359263481,123953,110225.73333333334,43.48425737080901,50.4534314580017,NaN,NaN,NaN,NaN,1.965384565995146,36.95180838623608,106263884,-0.5370958488558245,-1.261725293351958,-0.7246294444961335
2025-09-17T10:05:00-04:00,416.1,416.19,414.67,414.84,NaN,NaN,NaN,416.78083973921264,NaN,NaN,418.8867999999984,423.81632969826114,413.95727030173566,419.8010016741105,413.79285458012066,415.32974025053426,412.25596890970706,112204,112574.13333333333,40.66046029851939,48.97658614139779,NaN,NaN,NaN,NaN,1.9335713827097771,36.76446323645804,106151680,-0.4698864973350374,-1.3119875661649303,-0.8421010688298929
2025-09-17T10:10:00-04:00,414.77,416.31,414.74,415.84,NaN,NaN,NaN,416.78083973921264,NaN,NaN,418.7831999999984,423.74665918146314,413.8197408185336,418.9368013392885,413.9068437019543,415.45986747575455,412.35381992815405,103878,112986.46666666666,44.269216183536244,47.02807081040627,NaN,NaN,NaN,NaN,1.907601998230507,36.49298134222042,106255558,-0.33163381270314685,-1.2566433347088264,-0.9250095220056795
2025-09-17T10:15:00-04:00,415.78,416.49,414.95,415.09,NaN,NaN,NaN,416.78083973921264,NaN,NaN,418.6445999999985,423.625776102663,413.663423897334,411.4751211336853,413.97433746927516,415.5280391424212,412.4206357961291,73582,113978.63333333333,42.19651878714076,44.77875826307349,NaN,NaN,NaN,NaN,1.8813447126426153,36.08748082067718,106181976,-0.26702502853457966,-1.258790807673904,-0.9917657791393244
2025-09-17T10:20:00-04:00,415.12,415.43,413.75,413.85,NaN,NaN,NaN,416.78083973921264,NaN,NaN,418.5109999999984,423.63890366583337,413.3830963341634,411.4751211336853,413.9985766106256,415.50316022560264,412.49399299564857,122882,117050.13333333333,38.94952581086319,42.69164781123289,NaN,NaN,NaN,NaN,1.8669629474538574,36.22447734862623,106059094,-0.2826237649010097,-1.3450454852655866,-1.062421720364577
2025-09-17T10:25:00-04:00,413.82,414.13,412.25,412.64,NaN,NaN,NaN,416.78083973921264,NaN,NaN,418.37279999999845,423.74775382731764,412.99784617267926,411.4751211336853,413.9344262266394,415.4098521711849,412.4590002820939,129347,119236.63333333333,36.035560508476124,40.34619229828063,NaN,NaN,NaN,NaN,1.8678941654928671,36.89512376048172,105929747,-0.3451186230813097,-1.493819999216214,-1.1487013761349043
2025-09-17T10:30:00-04:00,412.705,414.89,411.93,414.5,NaN,NaN,NaN,416.78083973921264,NaN,NaN,418.2863999999985,423.767654980923,412.80514501907396,411.4751211336853,413.9237544351427,415.3500352090475,412.4974736612379,141892,122525.86666666667,43.084517786658616,39.092738151795224,NaN,NaN,NaN,NaN,1.945901725100518,36.86510618710484,106071639,-0.23702415507937458,-1.4449815699841224,-1.2079574149047478
2025-09-17T10:35:00-04:00,414.47,414.8,413.51,414.08,NaN,NaN,NaN,416.78083973921264,NaN,NaN,418.19319999999846,423.7975246734889,412.588875326508,411.4751211336853,413.92987201621725,415.33527628683265,412.52446774560184,65474,123692.13333333333,41.960059360220875,37.75896554627855,NaN,NaN,NaN,NaN,1.8990516018790538,36.837232726112035,106006165,-0.17263814043102998,-1.4237550904435352,-1.2511169500125052
2025-09-17T10:40:00-04:00,414.08,414.45,412.7,413.37,NaN,NaN,NaN,416.78083973921264,NaN,NaN,418.0589999999985,423.7959570336306,412.3220429663664,411.4751211336853,413.9192773116989,415.30855252512174,412.5300020982761,56679,124327.36666666667,40.05682432290374,38.76706331229843,NaN,NaN,NaN,NaN,1.8884050588876928,37.138006575821045,105949486,-0.1571366041158715,-1.4475377051573446,-1.290401101041473
2025-09-17T10:45:00-04:00,413.42,414.42,413.2,414.35,NaN,NaN,NaN,416.78083973921264,NaN,NaN,417.94339999999846,423.74138531956123,412.1454146804357,411.4751211336853,413.9209925895215,415.29336007484653,412.5486251041965,56276,124913.96666666666,43.84309701635212,40.43139009934503,NaN,NaN,NaN,NaN,1.8406618403957167,37.41729657912226,106005762,-0.06487752996091123,-1.3714980134926122,-1.306620483531701
2025-09-17T10:50:00-04:00,414.36,415.07,413.67,414.79,NaN,NaN,NaN,416.78083973921264,NaN,NaN,417.8443999999985,423.68518098937517,412.0036190106218,411.4751211336853,413.9392375130282,415.2940314493267,412.5844435767297,74171,125222.13333333333,45.507357475335134,41.47465942407422,NaN,NaN,NaN,NaN,1.8091859946531639,37.044012464782384,106079933,0.03634163930594125,-1.2611934343992743,-1.2975350737052156
2025-09-17T10:55:00-04:00,414.8,414.94,413.43,414.17,NaN,NaN,NaN,416.78083973921264,NaN,NaN,417.7483999999985,423.66926123512735,411.8275387648697,411.4751211336853,413.9461580743915,415.2819445959765,412.61037155280655,70865,125725.16666666667,43.54887891355087,41.80702570835752,NaN,NaN,NaN,NaN,1.7878155664636515,36.815379140509805,106009068,0.07014119289948129,-1.209858582580864,-1.2799997754803454
2025-09-17T11:00:00-04:00,414.17,415.52,414.12,414.89,NaN,NaN,NaN,416.78083973921264,NaN,NaN,417.6743999999985,423.64362663044767,411.70517336954936,411.486806729968,413.9739148154933,415.2980199936977,412.64980963728885,78708,126677.96666666666,46.43203303649858,42.44465007296429,NaN,NaN,NaN,NaN,1.7601144545733889,36.033105924138276,106087776,0.14526741262247667,-1.0984155097022494,-1.243682922324726
2025-09-17T11:05:00-04:00,414.93,416.86,414.84,416.67,410.6979429038482,410.6979429038482,410.6979429038482,NaN,NaN,NaN,417.63239999999854,423.59975192238295,411.66504807761413,412.6234453839744,414.07525901680776,415.4457150530477,412.7048029805678,125887,129241.53333333334,52.84417103874049,43.06231985068608,NaN,NaN,NaN,NaN,1.7786777078181495,34.145396940452585,106213663,0.3096737752955303,-0.8565907032053133,-1.1662644785008436
2025-09-17T11:10:00-04:00,416.7,418.6,416.7,418.38,412.46894549912776,NaN,NaN,NaN,NaN,NaN,417.62919999999855,423.59477301903945,411.66362698095764,414.24575630717953,414.26581987851205,415.8392470306526,412.6923927263715,140258,131508.2,58.04041648367178,44.10204550160485,NaN,NaN,NaN,NaN,1.7894864429739965,32.21817962538623,106353921,0.5162477030842476,-0.5209548496455341,-1.0372025527297817
2025-09-17T11:15:00-04:00,418.35,418.47,417.88,418.15,413.1489934309856,NaN,NaN,NaN,NaN,NaN,417.6261999999985,423.59057140407657,411.66182859592044,414.69160504574364,414.37106378826246,416.0468752414804,412.69525233504453,77921,131823.1,57.12856523110661,45.27833871107537,NaN,NaN,NaN,NaN,1.7038088399044276,30.428620689967467,106276000,0.6134395963763162,-0.2704030572593865,-0.8838426536357027
2025-09-17T11:20:00-04:00,418.13,418.13,416.89,417.06,413.1489934309856,NaN,NaN,NaN,NaN,NaN,417.5923999999985,423.55006472416625,411.6347352758308,414.69160504574364,414.4496429686006,416.1710395201723,412.72824641702886,77979,132959.93333333332,52.88790761476016,45.89395952759137,NaN,NaN,NaN,NaN,1.672108208482682,28.445342364629685,106198021,0.5806966460701739,-0.1579718460479853,-0.7386684921181592
2025-09-17T11:25:00-04:00,417.01,417.72,416.85,417.18,413.1489934309856,NaN,NaN,NaN,NaN,NaN,417.58019999999857,423.5386944277392,411.62170557225795,414.69160504574364,414.5110410834895,416.2621562724121,412.7599258945669,66490,133112.06666666668,53.29891187521488,46.68698760531094,NaN,NaN,NaN,NaN,1.6148147650196336,26.631358329053477,106264511,0.544125340713294,-0.05851181622654167,-0.6026371569398357
2025-09-17T11:30:00-04:00,417.14,417.83,416.81,417.61,413.1489934309856,NaN,NaN,NaN,NaN,NaN,417.5705999999986,423.5273244829066,411.6138755170906,414.69160504574364,414.5648934408333,416.34341724211146,412.7863696395552,57267,128678.2,54.81992435513174,47.820587501330124,NaN,NaN,NaN,NaN,1.5723279960896586,24.861318139736305,106321778,0.5256149289029741,0.05438150418888199,-0.47123342471409213
2025-09-17T11:35:00-04:00,417.65,419.39,417.65,419.03,413.7143440358049,NaN,NaN,NaN,NaN,NaN,417.5927999999986,423.5628265196424,411.6227734803548,415.9434094267366,414.6964561301929,416.59056951862397,412.8023427417619,101792,125609.86666666667,59.50978978672348,49.49731816406207,NaN,NaN,NaN,NaN,1.5871617106546811,24.050849890762116,106423570,0.5813765860796416,0.2554873078854598,-0.32588927819418173
2025-09-17T11:40:00-04:00,419.02,419.48,418.25,419.31,414.11005567054104,NaN,NaN,NaN,NaN,NaN,417.6069999999986,423.58990531473256,411.62409468526465,416.1077275413893,414.78615559636773,416.7590452997426,412.8132658929929,67726,124496.36666666667,60.38306015530257,50.73292833325093,NaN,NaN,NaN,NaN,1.5616501598936339,23.355637456234764,106491296,0.6066902074050398,0.432473481062118,-0.17421672634292176
2025-09-17T11:45:00-04:00,419.25,419.45,418.74,418.92,414.4593713218801,NaN,NaN,NaN,NaN,NaN,417.6069999999986,423.5899053147423,411.62409468525493,416.3971820331114,414.8551660049649,416.8843693913394,412.8259626185903,53792,122051,58.490814061078055,51.913696526169296,NaN,NaN,NaN,NaN,1.5008180056155158,22.71008305274508,106437504,0.5674520034153734,0.5350982779262949,-0.032353725489078416
2025-09-17T11:50:00-04:00,418.92,418.93,417.6,417.91,414.4593713218801,NaN,NaN,NaN,NaN,NaN,417.58479999999855,423.55479194685097,411.61480805314613,416.3971820331114,414.9213768608223,416.98253814029897,412.86021558134564,68015,118791.43333333333,53.78967727898684,52.89461459446095,NaN,NaN,NaN,NaN,1.4886167195001205,21.13043877599143,106369489,0.44895060791963404,0.5288345344104641,0.0798839264908301
2025-09-17T11:55:00-04:00,417.84,418.45,417.77,418.04,414.4593713218801,NaN,NaN,NaN,NaN,NaN,417.5517999999986,423.4930519762542,411.610548023743,416.3971820331114,414.9522235817979,417.0267527541982,412.87769440939763,33275,113815.46666666666,54.29883131371367,53.6414527585582,NaN,NaN,NaN,NaN,1.4308583823929695,19.663626233291605,106402764,0.3587095060405711,0.528270809041544,0.16956130300097288
2025-09-17T12:00:00-04:00,418.14,418.88,418.14,418.17,414.4593713218801,NaN,NaN,NaN,NaN,NaN,417.52719999999863,423.4477878631414,411.60661213685586,416.3971820331114,414.99789079037083,417.0959434214526,412.89983815928906,45878,105728.43333333333,54.83475047534705,54.307695115701904,NaN,NaN,NaN,NaN,1.3886542122220413,18.65583992377836,106448642,0.2900944248606398,0.5321793340767726,0.24208490921613285
2025-09-17T12:05:00-04:00,418.14,419.05,418.1,418.9,414.4593713218801,NaN,NaN,NaN,NaN,NaN,417.5277999999986,423.4489381207768,411.6066618792204,416.43048576076245,415.07069598650986,417.21029558109814,412.9310963919216,69736,97688.33333333333,57.82553903670468,55.327456553070036,NaN,NaN,NaN,NaN,1.3573217684918948,17.860359719860085,106518378,0.2762604448421477,0.5874104652688175,0.3111500204266698
2025-09-17T12:10:00-04:00,418.88,419.21,418.43,418.88,414.5807936868721,NaN,NaN,NaN,NaN,NaN,417.5297999999986,423.45269590024765,411.60690409974956,416.72438860860996,415.1316698814412,417.30651329691506,412.95682646596737,58043,90338.66666666667,57.71278161865256,56.133224308938175,NaN,NaN,NaN,NaN,1.3160844993139003,17.258091834753266,106460335,0.24899449653863426,0.6223931410999626,0.3733986445613283
2025-09-17T12:15:00-04:00,418.89,419.21,418.28,419.09,414.5807936868721,NaN,NaN,NaN,NaN,NaN,417.5341999999986,423.46139709855754,411.6070029014396,416.75651088688795,415.1792138179967,417.38026501196686,412.97816262402654,46347,85866.5,58.625079338305255,56.54614633033566,NaN,NaN,NaN,NaN,1.2885070350771937,16.539231457273466,106506682,0.22884953065351282,0.6594605578782193,0.4306110272247065
2025-09-17T12:20:00-04:00,419.12,419.95,419.1,419.36,415.424090941964,NaN,NaN,NaN,NaN,NaN,417.5415999999986,423.4769670286934,411.60623297130377,417.55720870951035,415.25032602234984,417.5007494379265,412.99990260677316,61250,83456.2,59.82516091730581,56.67362807559523,NaN,NaN,NaN,NaN,1.257899389714538,16.520506727281873,106567932,0.21753135644875693,0.7025252227856527,0.48499386633689573
2025-09-17T12:25:00-04:00,419.43,419.62,418.91,419.53,415.424090941964,NaN,NaN,NaN,NaN,NaN,417.55179999999854,423.49903558011994,411.60456441987714,417.55720870951035,415.30021086972715,417.58166244804187,413.01875929141244,45486,80235.1,60.60004923798932,56.921591218943995,NaN,NaN,NaN,NaN,1.218763719020641,16.284277173859603,106613418,0.2054613973148982,0.7418206129805185,0.5363592156656203
2025-09-17T12:30:00-04:00,419.53,419.53,418.331,418.331,415.424090941964,NaN,NaN,NaN,NaN,NaN,417.5244199999986,423.4443865150712,411.604453484926,417.55720870951035,415.35679875890514,417.66115999712537,413.0524375206849,62749,78194.96666666666,52.85652718144503,56.91934975942148,NaN,NaN,NaN,NaN,1.2173520248048777,15.421306797918124,106550669,0.10571829130300847,0.6685070797943808,0.5627887884913724
2025-09-17T12:35:00-04:00,418.33,418.62,417.03,417.16,415.424090941964,NaN,NaN,NaN,NaN,NaN,417.46521999999857,423.33920044698334,411.5912395530138,417.55720870951035,415.3925392098046,417.69571454732767,413.0893638722816,61496,76504.7,46.594402567963314,56.44045623747495,NaN,NaN,NaN,NaN,1.2439697373188174,15.221576150318764,106489173,-0.0422020050097085,0.5100362822292368,0.5522382872389453
2025-09-17T12:40:00-04:00,417.2,417.95,416.62,417.81,415.424090941964,NaN,NaN,NaN,NaN,NaN,417.42221999999856,423.2538446425503,411.59059535744683,417.55720870951035,415.4304245922139,417.72918576347325,413.13166342095457,72155,75447.26666666666,50.126510611926655,56.105212398674574,NaN,NaN,NaN,NaN,1.2501147560817578,15.360395199737473,106561328,-0.096256451778307,0.43191772251606153,0.5281741742943685
2025-09-17T12:45:00-04:00,417.76,418.57,417.41,418.46,415.424090941964,NaN,NaN,NaN,NaN,NaN,417.3954199999986,423.1953187042469,411.59552129575025,417.55720870951035,415.46129919418365,417.7650239381777,413.1575744501896,45272,74503.6,53.442559910894424,55.67183883611536,NaN,NaN,NaN,NaN,1.2436779877902013,14.83639089636879,106606600,-0.0884245911917485,0.41764343530468295,0.5060680264964315
2025-09-17T12:50:00-04:00,418.5,420.42,418.5,419.95,415.424090941964,NaN,NaN,NaN,NaN,NaN,417.3900199999986,423.17988342530396,411.6001565746932,417.55720870951035,415.5973900185493,417.98098136759467,413.2137986695039,134635,74895.36666666667,60.00693654890593,55.64497286422989,NaN,NaN,NaN,NaN,1.2948438458051896,14.750119220885157,106741235,0.011594223971193585,0.5205608064604235,0.5089665824892299
2025-09-17T12:55:00-04:00,419.97,419.97,418.91,418.98,415.424090941964,NaN,NaN,NaN,NaN,NaN,417.3604199999985,423.1021335577965,411.6187064422005,417.55720870951035,415.6422592585218,418.0455758453653,413.2389426716783,50694,72273.6,54.60887562260969,55.367691547196436,NaN,NaN,NaN,NaN,1.2780692853905333,14.670009807936072,106690541,0.0071330061672081335,0.51788284019824,0.5107498340310319
2025-09-17T13:00:00-04:00,419.05,419.81,418.88,419.78,415.424090941964,NaN,NaN,NaN,NaN,NaN,417.35101999999847,423.0752925934294,411.6267474065675,417.55720870951035,415.67876412834937,418.0995617243033,413.2579665323954,39924,68874.66666666667,57.967235385635874,55.66608855481422,NaN,NaN,NaN,NaN,1.2532071935769244,14.565140789554153,106730465,0.05036059961660122,0.5737005835517834,0.5233399839351822
2025-09-17T13:05:00-04:00,419.76,419.85,418.7,418.8,415.424090941964,NaN,NaN,NaN,NaN,NaN,417.3158199999985,422.982079771294,411.64956022870297,417.55720870951035,415.7076499606719,418.1385951250344,413.27670479630945,35657,67880.76666666666,52.81241998260617,55.55991631687798,NaN,NaN,NaN,NaN,1.245835251178575,14.276192225086865,106694808,0.007502330606148133,0.5327178971928674,0.5252155665867193
2025-09-17T13:10:00-04:00,418.84,419.26,418.63,419.09,415.424090941964,NaN,NaN,NaN,NaN,NaN,417.2514199999985,422.7601749246434,411.7426650753536,417.3507669676083,415.7287943780071,418.16610676885716,413.291481987157,27487,66907.7,54.11282447606675,55.50835017407224,NaN,NaN,NaN,NaN,1.2018470189515338,13.930322984304667,106722295,-0.006034854232935927,0.5176719987955494,0.5237068530284853
2025-09-17T13:15:00-04:00,419.09,419.27,418.82,419.22,415.424090941964,NaN,NaN,NaN,NaN,NaN,417.1796199999985,422.48659272535843,411.8726472746386,417.1542225199459,415.7538577697611,418.1993269805078,413.3083885590144,31961,66097.2,54.7152902536596,55.286189546711874,NaN,NaN,NaN,NaN,1.1481436604549948,13.618921895436698,106754256,-0.010681581516143512,0.5103548761333059,0.5210364576494494
2025-09-17T13:20:00-04:00,419.21,419.67,418.92,419.67,415.60828343905246,NaN,NaN,NaN,NaN,NaN,417.12681999999853,422.27883937454186,411.9748006254552,417.3987616282687,415.7803514143772,418.2366759043509,413.32402692440354,31324,64668.96666666667,56.82826544838008,55.22300982026385,NaN,NaN,NaN,NaN,1.1197048275653523,13.724063296191465,106785580,0.010933644788993169,0.5347035136356908,0.5237698688466976
2025-09-17T13:25:00-04:00,419.69,419.91,419.29,419.72,415.99631601000465,NaN,NaN,NaN,NaN,NaN,417.0722199999985,422.05242541462474,412.0920145853722,417.78300930261497,415.81462794848034,418.2866854491668,413.3425704477939,38839,63601.433333333334,57.067964581351646,55.11178733762431,NaN,NaN,NaN,NaN,1.0840116255963987,14.051842072179173,106824419,0.022324263429187696,0.5516751981331822,0.5293509347039945
2025-09-17T13:30:00-04:00,419.77,420.25,419.08,419.09,416.06557437318617,NaN,NaN,NaN,NaN,NaN,417.02101999999854,421.8626302201168,412.1794097798803,417.963407442092,415.85425380979245,418.34188141112577,413.36662620845914,47885,62574,53.06972314648027,54.62925606827962,NaN,NaN,NaN,NaN,1.0901536523395143,14.67552018206468,106776534,-0.01673771189076334,0.5084287948405404,0.5251665067313037
2025-09-17T13:35:00-04:00,419.1,420.15,419.02,420.12,416.06557437318617,NaN,NaN,NaN,NaN,NaN,416.9904199999985,421.7329448317556,412.24789516824137,417.963407442092,415.8842718474741,418.3857139650496,413.3828297298986,34214,59518.23333333333,58.22312428726768,54.45947571465665,NaN,NaN,NaN,NaN,1.0929998200295488,15.164375329428717,106810748,0.020600768185743523,0.5509174669634831,0.5303166987777396
2025-09-17T13:40:00-04:00,420.11,420.48,419.46,419.59,416.4041803689569,NaN,NaN,NaN,NaN,NaN,417.1034199999985,421.8189990842453,412.38784091575167,418.0545807629388,415.9193643418751,418.4371911001478,413.4015375836024,39846,56171.166666666664,54.88343947519902,54.6042551642105,NaN,NaN,NaN,NaN,1.087785547170298,15.940443403174179,106770902,0.004265719884119168,0.5356488486328885,0.5313831287487694
2025-09-17T13:45:00-04:00,419.56,419.81,419.15,419.28,416.4041803689569,NaN,NaN,NaN,NaN,NaN,417.27601999999854,421.65378115424215,412.8982588457549,418.0545807629388,415.9413685136849,418.466427911406,413.41630911596377,28490,54523.46666666667,52.969592905347824,55.0596259025951,NaN,NaN,NaN,NaN,1.0572294366581356,16.166500668322254,106742412,-0.0308243823501112,0.4928526508111304,0.5236770331612416
2025-09-17T13:50:00-04:00,419.33,420.19,419.2,420.19,416.4041803689569,NaN,NaN,NaN,NaN,NaN,417.4228199999985,421.68787824998236,413.1577617500147,418.0545807629388,415.97185940629583,418.51053361403564,413.43318519855603,35476,53106.7,57.639335517621284,55.59625625300186,NaN,NaN,NaN,NaN,1.0524273340396981,16.76714525798131,106777888,0.0020974969592603143,0.526298904360317,0.5242014074010567
2025-09-17T13:55:00-04:00,420.13,420.65,419.81,420.65,416.8032479711598,NaN,NaN,NaN,NaN,NaN,417.53781999999853,421.83454287629553,413.24109712370154,418.38098535062466,416.0183640751627,418.58333814141275,413.45339000891266,48724,52514.5,59.81161586509004,56.05118882115869,NaN,NaN,NaN,NaN,1.0372539530368607,17.76134370184843,106826612,0.04719942003711841,0.5832006824474547,0.5360012624103363
2025-09-17T14:00:00-04:00,420.67,424.55,417.6,424.28,416.8562821542889,NaN,NaN,NaN,NaN,NaN,417.7376199999985,422.33053191161366,413.14470808838337,419.2597882804998,416.41145989314225,419.3114644405877,413.5114553456968,316022,61139.666666666664,72.00974919203031,56.908532581381856,NaN,NaN,NaN,NaN,1.4595929563913699,20.789618048939925,107142634,0.29976565852355286,0.9107083355647774,0.6109426770412245
2025-09-17T14:05:00-04:00,424.28,424.64,418.51,418.63,416.8562821542889,NaN,NaN,NaN,NaN,NaN,417.78641999999854,422.3643465196923,413.2084934803048,419.2597882804998,416.5866354575827,419.5462996606081,413.6269712545573,215283,64922.7,47.727532907940684,56.41700810176264,NaN,NaN,NaN,NaN,1.7931934595062717,23.631344614129983,106927351,0.07621542428893091,0.7062119574023882,0.6299965331134573
2025-09-17T14:10:00-04:00,418.66,418.82,412.14,412.24,NaN,NaN,NaN,421.03273671479053,421.03273671479053,421.03273671479053,417.7128199999985,422.5209468157109,412.9046931842861,419.2597882804998,416.46323791351193,419.3821217609813,413.54435406604256,307372,72910.9,33.83230428688634,54.693084451851966,NaN,NaN,NaN,NaN,2.142251069541538,22.703623099677213,106619979,-0.4814353000543645,0.02820240804550167,0.5096377080998662
2025-09-17T14:15:00-04:00,412.2,416.9,411.77,416.45,NaN,NaN,NaN,420.33488504593635,NaN,NaN,417.7450199999985,422.496994924594,412.99304507540296,419.2597882804998,416.4099622238288,419.28640900168915,413.5335154459685,211814,78178.3,45.16040001282645,54.1465115968677,NaN,NaN,NaN,NaN,2.355661707431428,22.01446172533779,106831793,-0.5416962416510896,-0.1674825939639959,0.37421364768709375
2025-09-17T14:20:00-04:00,416.33,419.21,414.88,418.39,NaN,NaN,NaN,420.33488504593635,NaN,NaN,417.79601999999846,422.51976994300855,413.0722700569884,419.2597882804998,416.442883307079,419.28138685390707,413.60437976025094,177338,81822.4,49.454732955024284,53.81379077393609,NaN,NaN,NaN,NaN,2.496685871186325,20.749976255888683,107009131,-0.4306753868861459,-0.1641305859205886,0.26654480096555727
2025-09-17T14:25:00-04:00,418.38,419.07,416.84,418.91,NaN,NaN,NaN,420.33488504593635,NaN,NaN,417.87241999999856,422.5418887341913,413.20295126580584,419.2597882804998,416.47389930774017,419.2981497081393,413.64964890734103,100590,84066.23333333334,50.57200951041149,53.51784214941837,NaN,NaN,NaN,NaN,2.4776368803873035,19.575811177114513,107109721,-0.307757803399223,-0.11815245328347146,0.18960535011575153
2025-09-17T14:30:00-04:00,418.94,419.35,415.86,416.81,NaN,NaN,NaN,420.33488504593635,NaN,NaN,417.93161999999853,422.4687809611911,413.39445903880596,419.2597882804998,416.489812193661,419.2904137150255,413.6892106722965,111112,86240.7,46.13666812814458,52.75415662654441,NaN,NaN,NaN,NaN,2.549948531788211,18.393138199432062,106998609,-0.3503279605807135,-0.24830460061014037,0.10202335997057314
2025-09-17T14:35:00-04:00,416.83,418.55,415.59,415.65,NaN,NaN,NaN,420.33488504593635,NaN,NaN,417.9918199999985,422.3216811104749,413.66195888952205,419.2597882804998,416.4914858512756,419.2700996288096,413.71287207374166,96230,87123.83333333333,43.8489654993219,51.80994240639943,NaN,NaN,NaN,NaN,2.57923792237477,17.436422276335488,106902379,-0.43360395732469204,-0.43998158668529186,-0.006377629360599851
2025-09-17T14:40:00-04:00,415.67,417.54,415.1,415.79,NaN,NaN,NaN,420.33488504593635,NaN,NaN,418.0176199999985,422.27877606706386,413.7564639329331,419.2597882804998,416.4863537160299,419.2447307339171,413.7279766981427,91921,88253.1,44.20852923488385,51.17699998414254,NaN,NaN,NaN,NaN,2.5692923564908576,16.808510456114817,106994300,-0.4540768862561889,-0.573973737180836,-0.1198968509246471
2025-09-17T14:45:00-04:00,415.87,417.87,414.91,416.79,NaN,NaN,NaN,420.33488504593635,NaN,NaN,418.07181999999847,422.19806241120426,413.9455775887927,419.2597882804998,416.48708595137776,419.21802190060305,413.7561500021525,125968,90907.13333333333,46.827679315986124,50.363039629050995,NaN,NaN,NaN,NaN,2.597200045312938,16.015257940312274,107120268,-0.3781947202586251,-0.5926402512479285,-0.21444553098930338
2025-09-17T14:50:00-04:00,416.84,417.24,414.49,415.34,NaN,NaN,NaN,420.33488504593635,NaN,NaN,418.1112199999985,422.09219040078256,414.1302495992145,417.34283062439977,416.463313575445,419.1566323728078,413.7699947780822,195564,95384.26666666666,43.62934434573708,49.559175691232284,NaN,NaN,NaN,NaN,2.608114327790585,15.519762503920195,106924704,-0.40138821008370534,-0.716180793593935,-0.3147925835102297
2025-09-17T14:55:00-04:00,415.36,419.71,415.36,419.65,NaN,NaN,NaN,420.33488504593635,NaN,NaN,418.21721999999846,422.07219947750684,414.3622405224901,411.2666760345406,416.51273796828804,419.18435583537666,413.8411201011994,187631,100122.43333333333,53.74270500404709,49.61439798399652,NaN,NaN,NaN,NaN,2.7339633043769718,15.202630692726057,107112335,-0.11695997198902108,-0.46099254849650606,-0.344032576507485
2025-09-17T15:00:00-04:00,419.71,422.28,419.45,422.23,413.6874697207759,413.6874697207759,413.6874697207759,NaN,NaN,NaN,418.3660199999985,422.25457067140536,414.47746932859167,414.11034082763246,416.6506130454008,419.4031800742805,413.8980460165211,199159,104669.43333333333,58.538044004595754,49.67859144735184,NaN,NaN,NaN,NaN,2.740823068350044,15.997761720736174,107311494,0.235231424336528,-0.04999329608682501,-0.285224720423353
2025-09-17T15:05:00-04:00,422.23,424.42,421.93,423.81,415.9841756425588,NaN,NaN,NaN,NaN,NaN,418.55881999999843,422.5506323348041,414.56700766519276,416.639272662106,416.8109123249133,419.7178714565618,413.90395319326484,169277,108262.13333333333,61.19136340036808,49.77714484272884,NaN,NaN,NaN,NaN,2.72290713489647,17.43764364056158,107480771,0.5470791966704003,0.3986242754146474,-0.1484549212557529
2025-09-17T15:10:00-04:00,423.92,424.6,421.09,421.95,415.9841756425588,NaN,NaN,NaN,NaN,NaN,418.70001999999846,422.6620907823121,414.73794921768484,416.639272662106,416.9244635017137,419.91135582051044,413.937571182917,143667,110645.86666666667,56.59946165809075,48.67641001887601,NaN,NaN,NaN,NaN,2.7791280538324403,18.25579651304691,107337104,0.5965131238576455,0.5971864835663041,0.0006733597086585053
2025-09-17T15:15:00-04:00,422,424.21,422,423,415.9841756425588,NaN,NaN,NaN,NaN,NaN,418.82661999999846,422.9233751047247,414.7298648952722,416.6963345037478,417.0212307404218,420.0816834241081,413.9607780567355,116096,113006.66666666667,58.49304476923543,49.44537515182564,NaN,NaN,NaN,NaN,2.742047478558694,19.015509894640427,107453200,0.6632295561970962,0.8297103049550287,0.16648074875793256
2025-09-17T15:20:00-04:00,422.84,426.13,422.61,425.79,416.9055602578641,NaN,NaN,NaN,NaN,NaN,418.9748199999985,423.50898858487136,414.4406514151256,418.35906760299827,417.28851664157685,420.61501813076546,413.96201515238823,260856,117214.03333333334,63.10001147452351,51.535925665228284,NaN,NaN,NaN,NaN,2.7976155158045004,20.350306122965037,107714056,0.8468120430478745,1.2249958025677756,0.3781837595199012
2025-09-17T15:25:00-04:00,425.95,427.92,425.81,427.13,419.4493984279612,NaN,NaN,NaN,NaN,NaN,419.1544199999985,424.2235215712909,414.08531842870605,420.63825408239865,417.54776351122655,421.18192850459076,413.91359851786234,210415,122538.06666666667,65.10338869619153,52.96042485689723,NaN,NaN,NaN,NaN,2.749928693247036,22.082087854133285,107924471,0.9995545430040791,1.6276269382750002,0.6280723952709211
2025-09-17T15:30:00-04:00,427.09,427.94,425.61,426.17,419.4493984279612,NaN,NaN,NaN,NaN,NaN,419.3366199999985,424.7356518380175,413.93758816197953,420.9496032659189,417.71457721587547,421.5146848344808,413.9144695972701,147712,126131,62.48598773405403,53.891228769685064,NaN,NaN,NaN,NaN,2.7199337865865325,23.554477976321607,107776759,0.9759013086286801,1.8479490310567712,0.8720477224280911
2025-09-17T15:35:00-04:00,426.14,427.69,425.88,426.87,419.4781192287828,NaN,NaN,NaN,NaN,NaN,419.53041999999857,425.289532377762,413.77130762223516,421.1926826127351,417.8411711102753,421.7623595993505,413.9199826212001,112765,128701.26666666666,63.63406959840614,54.82423306168467,NaN,NaN,NaN,NaN,2.654938516116066,24.92169737549648,107889524,0.9466396324089046,2.0553472629392218,1.1087076305303172
2025-09-17T15:40:00-04:00,427,428.08,426.38,427.33,420.0234319911109,NaN,NaN,NaN,NaN,NaN,419.7248199999986,425.85571265568103,413.59392734431617,422.03214609018806,418.0750638441727,422.21548733880576,413.9346403495396,206313,134662.13333333333,64.40499590041898,56.129113616847135,NaN,NaN,NaN,NaN,2.5867286221077745,26.309366324346612,108095837,0.8979228163907931,2.2311111510188084,1.3331883346280153
2025-09-17T15:45:00-04:00,427.31,427.6,426.36,427.47,420.0234319911109,NaN,NaN,NaN,NaN,NaN,419.8936199999986,426.39241020030255,413.3948297996946,422.1417168721505,418.22461490515343,422.4900799173575,413.95914989294937,139363,138242.2,64.65061094182764,57.61494543416897,NaN,NaN,NaN,NaN,2.4905337205286484,27.581511533544635,108235200,0.8170975115007795,2.35456022400399,1.5374627125032103
2025-09-17T15:50:00-04:00,427.7,428.3,425.95,426.65,420.07682542991716,NaN,NaN,NaN,NaN,NaN,420.0404199999985,426.80597376740997,413.27486623258704,422.75837349772036,418.4411305325994,422.86713160186844,414.01512946333037,214610,144351.73333333334,61.95407454778147,58.88248438509022,NaN,NaN,NaN,NaN,2.480495597633747,28.988613290170484,108020590,0.6572569360950209,2.3590338826219863,1.7017769465269654
2025-09-17T15:55:00-04:00,426.63,427.26,425.3,425.63,420.07682542991716,NaN,NaN,NaN,NaN,NaN,420.17461999999847,427.1100164780502,413.2392235219467,422.75837349772036,418.6126160929166,423.1321789534848,414.0930532323484,199436,149704.96666666667,58.675668788165495,59.728769347388756,NaN,NaN,NaN,NaN,2.4433173406599065,29.73188841628765,107821154,0.44200867272663547,2.25428778743526,1.8122791147086244
2025-09-18T09:30:00-04:00,428.82,431.54,426.55,429.91,421.56197317064766,NaN,NaN,NaN,NaN,NaN,420.4146199999985,427.8335993036385,412.99564069635846,424.25435903854105,429.3333333333333,429.3333333333333,429.3333333333333,408974,161741.26666666666,66.65033606947327,61.373125899084194,NaN,NaN,NaN,NaN,2.6909375306127723,31.613445932230867,108230128,0.5405418046745287,2.4879563705517853,1.9474145658772566
2025-09-18T09:35:00-04:00,429.77,430.08,423.67,423.76,421.56197317064766,NaN,NaN,NaN,NaN,NaN,420.5290199999984,427.9743624531016,413.0836775468952,424.25435903854105,427.80051347686805,429.5355130116612,426.0655139420749,319212,171241.2,51.32386627468338,61.20035170412964,NaN,NaN,NaN,NaN,2.956584849854715,31.506977784729866,107910916,0.16373152892445808,2.1520789770328292,1.9883474481083712
2025-09-18T09:40:00-04:00,423.72,426.22,421.95,425.61,421.56197317064766,NaN,NaN,NaN,NaN,NaN,420.67781999999846,428.22531422496553,413.1303257750314,424.25435903854105,426.81460582023163,428.8821722753899,424.74703936507336,323204,180686.46666666667,54.69855081008876,60.926102190236286,NaN,NaN,NaN,NaN,3.0504002177222382,30.51018311136057,108234120,0.01890636473311802,2.0119804040247686,1.9930740392916506
2025-09-18T09:45:00-04:00,425.61,427.23,424.5,427.05,421.56197317064766,NaN,NaN,NaN,NaN,NaN,420.8408199999985,428.5773512508757,413.1042887491212,424.25435903854105,426.73667774350724,428.66315585995824,424.81019962705625,171883,185466.23333333334,57.18667205975346,60.64005280876381,NaN,NaN,NaN,NaN,3.027514487884937,29.923661911770473,108406003,0.0008686149925596354,1.9941598080323502,1.9932911930397905
2025-09-18T09:50:00-04:00,427.02,428.62,426.87,427.98,421.56197317064766,NaN,NaN,NaN,NaN,NaN,421.0228199999985,428.9909606787183,413.0546793212787,424.25435903854105,426.9019784655273,428.7183092184108,425.0856477126438,219468,191599.3,58.76196926612199,60.794517637908896,NaN,NaN,NaN,NaN,2.936263453036013,29.81540574744921,108625471,0.030695340700552798,2.0316603689154817,2.000965028214929
2025-09-18T09:55:00-04:00,427.985,428.99,427.1,428,421.56197317064766,NaN,NaN,NaN,NaN,NaN,421.20101999999844,429.3839207524117,413.01811924758516,424.25435903854105,427.03090065340217,428.7775581563074,425.28424315049693,186169,196180.8,58.79708026929229,60.81623445934154,NaN,NaN,NaN,NaN,2.8615303492477255,29.827597814486978,108811640,0.030814991118125246,2.0394837671125856,2.0086687759944604
2025-09-18T10:00:00-04:00,427.9,428.77,426.3,427.98,421.56197317064766,NaN,NaN,NaN,NaN,NaN,421.3734199999984,429.75472031080324,412.9921196891936,424.25435903854105,427.0877476740352,428.76669073177493,425.40880461629547,155475,190829.23333333334,58.74321761707177,60.50503489809498,NaN,NaN,NaN,NaN,2.833563895730029,29.385652743747002,108656165,0.00968560984211253,2.020775788297101,2.0110901784549884
2025-09-18T10:05:00-04:00,427.99,429.44,427.66,428.88,421.56197317064766,NaN,NaN,NaN,NaN,NaN,421.5604199999985,430.182621724603,412.938218275394,424.25435903854105,427.18722286879796,428.8566563433648,425.5177893942311,120522,187670.53333333333,60.49693638302061,60.17600259001135,NaN,NaN,NaN,NaN,2.758309331749311,29.205301025774926,108776687,0.035035559492055945,2.0548846278200585,2.0198490683280026
2025-09-18T10:10:00-04:00,428.94,429.47,427.96,428.15,421.56197317064766,NaN,NaN,NaN,NaN,NaN,421.75679999999846,430.5219340574742,412.99166594252273,424.25435903854105,427.25487608405575,428.90783749266234,425.60191467544917,101332,180802.53333333333,58.33108004295256,59.87922346921839,NaN,NaN,NaN,NaN,2.669144379481506,29.048434170837496,108675355,-0.01591367808721511,1.9999569707189835,2.0158706488061986
2025-09-18T10:15:00-04:00,428.22,429.23,426.92,428.95,421.56197317064766,NaN,NaN,NaN,NaN,NaN,421.9925999999985,430.8838368636369,413.10136313636013,424.25435903854105,427.33472000330636,428.9528842801151,425.71655572649763,155227,178916.3,60.02030523240189,59.62109744307522,NaN,NaN,NaN,NaN,2.643491209518541,28.263810419345813,108830582,-0.01433762870493549,1.997948612925029,2.0122862416299645
2025-09-18T10:20:00-04:00,428.95,429.4,428,429.35,421.56197317064766,NaN,NaN,NaN,NaN,NaN,422.2233999999985,431.26618683622183,413.18061316377515,423.9353180306634,427.39997894847033,429.0153475562466,425.7846103406941,93002,176105.1,60.8743710198975,59.3689099516094,NaN,NaN,NaN,NaN,2.5546704088386436,27.606905754624222,108923584,-0.005416753322969647,2.0055152999762527,2.0109320532992223
2025-09-18T10:25:00-04:00,429.39,429.68,427.8,428.94,421.56197317064766,NaN,NaN,NaN,NaN,NaN,422.4329999999986,431.60209090395625,413.2639090960409,424.36825442453073,427.4585620846685,429.06471269974764,425.8524114695893,97970,176017.76666666666,59.471968405285466,58.999006913284965,NaN,NaN,NaN,NaN,2.506479665350169,27.119829172139042,108825614,-0.04403989214176329,1.9558821881220183,1.9999220802637816
2025-09-18T10:30:00-04:00,428.98,429.7,428.01,428.14,421.56197317064766,NaN,NaN,NaN,NaN,NaN,422.59679999999855,431.8745837356321,413.319016264365,424.60560353962455,427.5127056993378,429.0998053741334,425.9256060245422,115375,176159.86666666667,56.725905529944974,58.625566269153786,NaN,NaN,NaN,NaN,2.4481596892537283,26.67678199228306,108710239,-0.1352265222887088,1.8308889274028957,1.9661154496916045
2025-09-18T10:35:00-04:00,428.12,428.18,427.21,428.1,421.56197317064766,NaN,NaN,NaN,NaN,NaN,422.7791999999986,432.12374436797904,413.4346556320181,424.60560353962455,427.52711962649715,429.079158314101,425.9750809388933,117442,176866.93333333332,56.58521792240177,58.47624835017067,NaN,NaN,NaN,NaN,2.3425768543070355,25.697824147898316,108592797,-0.20576914354575515,1.7089040202594106,1.9146731638051657
2025-09-18T10:40:00-04:00,428.1,430.78,427.74,430.42,422.06025189271776,NaN,NaN,NaN,NaN,NaN,422.9919999999986,432.5361240564574,413.44787594353977,425.61158626535973,427.6463243975259,429.23119048669173,426.0614583083601,154061,178938.26666666666,62.40860346721935,58.17326745000967,NaN,NaN,NaN,NaN,2.3923927932851017,25.951172674234446,108746858,-0.10859586308843361,1.7789283349446237,1.8875241980330573
2025-09-18T10:45:00-04:00,430.37,432.21,429.17,431.52,423.4029677157761,NaN,NaN,NaN,NaN,NaN,423.2463999999985,433.00568994165786,413.48711005833917,426.5552690122878,427.8466819850796,429.5744970582708,426.1188669118884,175912,180603.06666666668,64.81820533878046,59.13714881173088,NaN,NaN,NaN,NaN,2.4386504509075917,26.69035986249659,108922770,0.01099447351477223,1.9012672899265226,1.8902728164117504
2025-09-18T10:50:00-04:00,431.47,431.75,428.88,429,423.4029677157761,NaN,NaN,NaN,NaN,NaN,423.4445999999986,433.26054964151996,413.6286503584773,426.5552690122878,427.92809259061073,429.667131147636,426.1890540335855,121797,178144.16666666666,55.9673698485115,59.22777874304679,NaN,NaN,NaN,NaN,2.4694611329856215,27.16925592620979,108800973,-0.09267873808774874,1.7744243938020645,1.8671031318898133
2025-09-18T10:55:00-04:00,429.04,430.14,428.95,429.17,423.4029677157761,NaN,NaN,NaN,NaN,NaN,423.64359999999857,433.5121915998727,413.7750084001244,426.5552690122878,427.9680581909817,429.70047508753356,426.23564129442985,83596,174676.33333333334,56.399891547092274,59.171580134999566,NaN,NaN,NaN,NaN,2.378071052058077,27.613945128229194,108884569,-0.15897374604725778,1.668385949330741,1.8273596953779987
2025-09-18T11:00:00-04:00,429.2,430.29,428.92,429.59,423.4029677157761,NaN,NaN,NaN,NaN,NaN,423.8419999999985,433.78168128288127,413.90231871711575,426.5552690122878,428.00830924234,429.73784984788983,426.2787686367901,78915,170668.2,57.5103479172288,59.08217861007863,NaN,NaN,NaN,NaN,2.3060659769110714,28.086927190446158,108963484,-0.18204877695616695,1.59979872418279,1.781847501138957
2025-09-18T11:05:00-04:00,429.7,429.88,428.46,429.54,423.4029677157761,NaN,NaN,NaN,NaN,NaN,424.0383999999986,434.0324521193855,414.0443478806117,426.5552690122878,428.04599031225223,429.7637205017261,426.3282601227784,96655,168247.46666666667,57.32317218396019,58.97689946112633,NaN,NaN,NaN,NaN,2.242775549988853,28.142388885667692,108866829,-0.2064041083168504,1.523842365742894,1.7302464740597443
2025-09-18T11:10:00-04:00,429.55,429.99,427.92,428.21,423.4029677157761,NaN,NaN,NaN,NaN,NaN,424.2207999999986,434.1797781325703,414.2618218674269,426.5552690122878,428.0661112539328,429.7612882231066,426.37093428475896,103539,166909.86666666667,52.43454032938494,58.52627965486299,NaN,NaN,NaN,NaN,2.230434439275363,27.750608120764593,108763290,-0.31150133345449027,1.3408698072416314,1.6523711406961217
2025-09-18T11:15:00-04:00,428.19,428.65,426.68,428.63,423.4029677157761,NaN,NaN,NaN,NaN,NaN,424.39099999999854,434.3547007183618,414.42729928163527,426.5552690122878,428.06322994881594,429.7274488676545,426.3990110299774,127942,167304.73333333334,53.77518783825526,58.04615475880832,NaN,NaN,NaN,NaN,2.2118319793271204,26.454439206654907,108891232,-0.3493057569443889,1.2157389445156355,1.5650447014600244
2025-09-18T11:20:00-04:00,428.69,428.84,427.12,427.3,423.4029677157761,NaN,NaN,NaN,NaN,NaN,424.5451999999985,434.44536342517756,414.6450365748194,426.5552690122878,428.0566292952173,429.7036371418733,426.4096214485613,76773,161168.63333333333,49.05961876826746,57.383907524902256,NaN,NaN,NaN,NaN,2.1767011236608953,25.362283198142787,108814459,-0.45383535889501436,0.9977505028412565,1.451585861736271
2025-09-18T11:25:00-04:00,427.28,427.28,424.59,424.74,423.4029677157761,NaN,NaN,NaN,NaN,NaN,424.6543999999986,434.4396330869011,414.8691669130961,426.5552690122878,427.9445917643008,429.6362800016454,426.25290352695623,167710,159745.13333333333,41.513633853553834,56.062002426413095,NaN,NaN,NaN,NaN,2.2147939005422623,24.32844832252719,108646749,-0.6721687394734726,0.6113749373944302,1.2835436768679027
2025-09-18T11:30:00-04:00,424.79,426.83,424.7,425.82,423.4029677157761,NaN,NaN,NaN,NaN,NaN,424.7669999999985,434.473404689953,415.06059531004405,426.5552690122878,427.88024932905086,429.5865703338144,426.1739283242873,115746,158679.6,45.33377427780652,54.95195980197803,NaN,NaN,NaN,NaN,2.2087371933606716,23.368458795169854,108762495,-0.7165584223421737,0.3878456489401856,1.1044040712823593
2025-09-18T11:35:00-04:00,425.79,426.7,425.17,426.6,423.4029677157761,NaN,NaN,NaN,NaN,NaN,424.88599999999855,434.5333034577129,415.2386965422842,425.7912152098302,427.8523003182787,429.55867374896184,426.1459268875956,64084,157056.9,47.97666038090906,54.13086637166543,NaN,NaN,NaN,NaN,2.1602559652634787,22.47703994833804,108826579,-0.6671087023652824,0.27051819332575633,0.9376268956910387
2025-09-18T11:40:00-04:00,426.609,426.78,423.94,424.5,423.4029677157761,NaN,NaN,NaN,NaN,NaN,424.89039999999846,434.53679452673884,415.2440054732581,425.31537773429136,427.77741103985807,429.51975147395314,426.035070605763,109450,153828.13333333333,42.07835224066262,53.08461256528811,NaN,NaN,NaN,NaN,2.2088091106017997,22.33359554909186,108717129,-0.7437088948091054,0.007990777179657016,0.7516996719887624
2025-09-18T11:45:00-04:00,424.5,425.35,424.5,425.3,423.4029677157761,NaN,NaN,NaN,NaN,NaN,425.0237999999985,434.5032387093997,415.54436129059735,425.31537773429136,427.73935749559195,429.4988273591889,425.979887631995,57468,151098.3,44.85949668316307,52.247061048199626,NaN,NaN,NaN,NaN,2.111751316987387,22.200397178363268,108774597,-0.7085329336225545,-0.1339664950394308,0.5745664385831237
2025-09-18T11:50:00-04:00,425.25,425.32,423.9,424.48,423.4029677157761,NaN,NaN,NaN,NaN,NaN,425.26859999999857,434.0190093712877,416.5181906287094,425.20324174994647,427.6744567984939,429.47281868583394,425.87609491115387,86016,146811.83333333334,42.601535663839734,50.83227049081537,NaN,NaN,NaN,NaN,2.062340508631146,22.402418329952795,108688581,-0.7069115523227462,-0.30907300182030895,0.3978385505024372
2025-09-18T11:55:00-04:00,424.44,425.65,424.18,425.15,423.4029677157761,NaN,NaN,NaN,NaN,NaN,425.4425999999985,433.8228308420157,417.06236915798127,425.20324174994647,427.6233159422723,429.4418088283677,425.80482305617693,81766,142889.5,45.0359065562515,49.41924914920616,NaN,NaN,NaN,NaN,2.0200304723003475,22.29668989217505,108770347,-0.6297070136131272,-0.3892952165139718,0.2404117970991554
2025-09-18T12:00:00-04:00,425.13,425.83,424.54,424.92,423.4029677157761,NaN,NaN,NaN,NaN,NaN,425.57319999999856,433.70970779173945,417.4366922082577,424.12847471996577,427.5769792342223,429.4103367332601,425.74362173518443,80083,131926.46666666667,44.34067970660713,48.58877128192728,NaN,NaN,NaN,NaN,1.9678854385646058,22.035027126923822,108690264,-0.5651762733968886,-0.4660585446469554,0.09911772874993321
2025-09-18T12:05:00-04:00,424.88,425.15,420.84,421.13,NaN,NaN,NaN,429.57329435424197,429.57329435424197,429.57329435424197,425.61759999999856,433.63148650812326,417.60371349187386,424.12847471996577,427.33354561601993,429.4338886016342,425.2332026304057,214309,128429.7,34.80579851434561,47.04633606530251,NaN,NaN,NaN,NaN,2.1351793358099913,23.50819190876208,108475955,-0.7378747647186531,-0.8232257271483832,-0.08535096242973006
2025-09-18T12:10:00-04:00,421.14,422.77,420.91,422,NaN,NaN,NaN,428.3729173381401,NaN,NaN,425.72139999999854,433.40386940541066,418.0389305945864,422.1557797759726,427.21293630031414,429.4389715305127,424.9869010701156,103865,121118.4,38.09653153476673,45.65963489512666,NaN,NaN,NaN,NaN,2.1155236689664174,24.87613063475474,108579820,-0.751138722952793,-1.0242743661207214,-0.2731356431679284
2025-09-18T12:15:00-04:00,421.985,422.72,421.67,422.5,NaN,NaN,NaN,428.3729173381401,NaN,NaN,425.8583999999985,433.04594518352184,418.6708548164751,421.80349905662246,427.1297555921746,429.42614681757885,424.83336436677035,80631,118076.66666666667,39.97184599288556,44.42025445290704,NaN,NaN,NaN,NaN,2.039414835468817,26.14635945174793,108660451,-0.6856774245227181,-1.130232423821326,-0.44455499929860787
2025-09-18T12:20:00-04:00,422.55,424.3,422.33,424,NaN,NaN,NaN,428.3729173381401,NaN,NaN,426.0225999999984,432.6346675257829,419.41053247421394,421.80349905662246,427.06563378032143,429.39049621803923,424.74077134260364,86755,113652.9,45.32325010404559,43.91230515109709,NaN,NaN,NaN,NaN,2.034456632935332,25.939422368820324,108747206,-0.5089237884441293,-1.0807097348537695,-0.5717859464096402
2025-09-18T12:25:00-04:00,424.01,424.04,422.12,422.16,NaN,NaN,NaN,428.3729173381401,NaN,NaN,426.1299999999984,432.29827366495147,419.96172633504534,421.73888257087407,426.9823151062306,429.3594467641049,424.6051834483563,96054,110649.06666666667,40.548026340378684,42.967507901248766,NaN,NaN,NaN,NaN,2.0262811591542382,25.85199201015757,108651152,-0.48367104578551934,-1.1763747536415394,-0.6927037078560201
2025-09-18T12:30:00-04:00,422.3,423.11,421.79,423.11,NaN,NaN,NaN,428.3729173381401,NaN,NaN,426.2853999999985,431.7045057717452,420.86629422825183,421.73888257087407,426.92275195468505,429.33646529600554,424.50903861336457,69306,107776.76666666666,43.83809512017215,42.594541926384814,NaN,NaN,NaN,NaN,1.975832504928935,25.939204942488637,108720458,-0.3755462523596227,-1.1621365233055485,-0.7865902709459258
2025-09-18T12:35:00-04:00,423.05,424.81,422.95,424.36,NaN,NaN,NaN,428.3729173381401,NaN,NaN,426.3795999999984,431.4889544959936,421.2702455040032,421.73888257087407,426.88705768575176,429.30687131202023,424.4672440594833,62908,105856.3,47.92189946743013,43.05227518451884,NaN,NaN,NaN,NaN,1.9675587545768691,24.676695216648636,108783366,-0.2011456983307054,-1.0380223938593076,-0.8368766955286022
2025-09-18T12:40:00-04:00,424.38,425.31,424.14,425.1,NaN,NaN,NaN,428.3729173381401,NaN,NaN,426.43699999999836,431.4215541431401,421.4524458568566,421.73888257087407,426.86214330347553,429.27751350265504,424.446773104296,62908,104575.5,50.229199709470244,43.40194842963768,NaN,NaN,NaN,NaN,1.9105902721070938,23.15804744422902,108846274,-0.026435703569074875,-0.8699213249899458,-0.8434856214208709
2025-09-18T12:45:00-04:00,425.13,425.8,424.77,424.91,NaN,NaN,NaN,428.3729173381401,NaN,NaN,426.4589999999984,431.4065541437751,421.5114458562217,421.9245889728815,426.839101420824,429.2461178161455,424.43208502550254,70583,101754.03333333334,49.621311418115255,43.519423503723836,NaN,NaN,NaN,NaN,1.8476909669565893,21.59330108961541,108775691,0.08001948099439704,-0.7434612701778747,-0.8234807511722717
2025-09-18T12:50:00-04:00,424.89,425.44,424.55,424.9,NaN,NaN,NaN,428.3729173381401,NaN,NaN,426.51799999999844,431.31719993389055,421.7188000661063,421.9245889728815,426.8185622375507,429.22031013590197,424.4168143391994,57725,100578.13333333333,49.587296531029786,44.055776667321496,NaN,NaN,NaN,NaN,1.779284469316832,20.115970686908497,108717966,0.14941811506110037,-0.6367081073458962,-0.7861262224069966
2025-09-18T12:55:00-04:00,424.86,425.22,424.68,425.08,NaN,NaN,NaN,428.3729173381401,NaN,NaN,426.5595999999984,431.2713639335729,421.8478360664239,422.11373694264415,426.80151458247,429.1984587564488,424.4045704084912,49703,98969.23333333334,50.24839339051373,44.440697860703686,NaN,NaN,NaN,NaN,1.6907641500799167,18.744163884394933,108767669,0.20373723212450545,-0.5314546822513648,-0.7351919143758703
2025-09-18T13:00:00-04:00,425.08,425.85,425.07,425.67,NaN,NaN,NaN,428.3729173381401,NaN,NaN,426.55719999999843,431.2706514578493,421.8437485421476,422.9749895541153,426.78862023602403,429.17678005613413,424.4004604159139,54518,96940.66666666667,52.449516015227815,45.14412502865998,NaN,NaN,NaN,NaN,1.6257095679313533,17.817607088792954,108822187,0.2714581859959102,-0.3958691818809825,-0.6673273678768927
2025-09-18T13:05:00-04:00,425.65,426.31,425.05,425.07,NaN,NaN,NaN,428.3729173381401,NaN,NaN,426.51599999999837,431.2446919973432,421.78730800265356,423.37999164329227,426.7740133507168,429.15282790015186,424.39519880128177,60529,95043.56666666667,50.02562242094927,45.500533304709826,NaN,NaN,NaN,NaN,1.599587455936256,17.29038477403251,108761658,0.2674673791770481,-0.33299314390558266,-0.6004605230826308
2025-09-18T13:10:00-04:00,425.09,425.71,424.06,424.4,NaN,NaN,NaN,428.3729173381401,NaN,NaN,426.4805999999984,431.24548557739286,421.7157144226039,423.37999164329227,426.74212413512697,429.1159690056094,424.36827926464457,85877,92770.76666666666,47.391817147927654,45.71847169337558,NaN,NaN,NaN,NaN,1.6031883519408077,16.121734966114452,108675781,0.21366138600569629,-0.3333837905755104,-0.5470451765812067
2025-09-18T13:15:00-04:00,424.42,424.45,422.78,423.18,NaN,NaN,NaN,428.3729173381401,NaN,NaN,426.4067999999984,431.25878258918067,421.5548174108161,423.37999164329227,426.6888609425786,429.07943791140474,424.2982839737524,91381,89953.06666666667,42.95682321720756,46.300687743580006,NaN,NaN,NaN,NaN,1.6079606125164656,15.923518485118333,108584400,0.095866105563709,-0.42721254462657043,-0.5230786501902794
2025-09-18T13:20:00-04:00,423.28,424.48,422.9,423.92,NaN,NaN,NaN,428.3729173381401,NaN,NaN,426.3385999999984,431.232441044194,421.4447589558028,423.37999164329227,426.6557735863611,429.05280155535036,424.2587456173718,64292,88036.23333333334,46.24293113333905,46.882573429192306,NaN,NaN,NaN,NaN,1.6059634259081494,15.713927959788663,108648692,0.06900272562358589,-0.43682524316079707,-0.505827968784383
2025-09-18T13:25:00-04:00,423.91,423.97,423.29,423.43,NaN,NaN,NaN,428.3729173381401,NaN,NaN,426.2577999999984,431.2073410540667,421.30825894593005,423.37999164329227,426.6288662106222,429.0326621087552,424.22507031248927,49839,86911,44.41824344578556,47.20017324725659,NaN,NaN,NaN,NaN,1.539823181200425,15.519308186268255,108598853,0.021888924375157992,-0.4784668133154355,-0.5003557376905935
2025-09-18T13:30:00-04:00,423.44,423.76,422.56,423.4,NaN,NaN,NaN,428.25224344210557,NaN,NaN,426.1927999999984,431.2049963893954,421.1806036106014,423.37999164329227,426.5988241798191,429.0129320949424,424.18471626469574,51232,85988.23333333334,44.30298148600259,47.127296917396386,NaN,NaN,NaN,NaN,1.5155500968289652,15.84651397284141,108547621,-0.006141429250331787,-0.5080325242535082,-0.5018910950031764
2025-09-18T13:35:00-04:00,423.42,423.52,422.02,423.1,NaN,NaN,NaN,427.8353232856462,NaN,NaN,426.1421999999984,431.2266630636637,421.05773693633313,423.37999164329227,426.55205916911655,428.986469489322,424.1176488489111,73600,85219.73333333334,43.09857735180435,47.30947913249822,NaN,NaN,NaN,NaN,1.5144393756268963,16.499195049009778,108474021,-0.03795802182978403,-0.5493386222904064,-0.5113806004606224
2025-09-18T13:40:00-04:00,423.04,423.36,422.6,422.74,NaN,NaN,NaN,427.8353232856462,NaN,NaN,425.99879999999837,431.0544703062912,420.94312969370554,423.37999164329227,426.5293724250207,428.97311494304904,424.0856299069924,36585,82987.93333333333,41.6358198516716,47.15217375617675,NaN,NaN,NaN,NaN,1.4605508487964032,17.105256048308977,108437436,-0.07422242309569649,-0.604158629330243,-0.5299362062345465
2025-09-18T13:45:00-04:00,422.78,423.29,421.94,422.66,NaN,NaN,NaN,427.51332142349173,NaN,NaN,425.9767999999984,431.0805922220612,420.8730077779355,423.37999164329227,426.4812824667565,428.94774468553146,424.01482024798156,73539,81174.5,41.30036394198363,46.679206932930576,NaN,NaN,NaN,NaN,1.452654359596662,18.095270413988423,108363897,-0.09333547105465423,-0.6466055450528643,-0.55327007399821
2025-09-18T13:50:00-04:00,422.64,423.77,422.1,423.74,NaN,NaN,NaN,427.51332142349173,NaN,NaN,425.93939999999844,431.08066429642446,420.7981357035724,423.37999164329227,426.4539102524552,428.92809945096775,423.9797210539427,50212,80289.13333333333,47.45520040831097,46.48106412570491,NaN,NaN,NaN,NaN,1.4681790481968975,18.46470954464145,108414109,-0.026455225034063945,-0.58633910529079,-0.5598838802567261
2025-09-18T13:55:00-04:00,423.7,423.97,423.19,423.53,NaN,NaN,NaN,427.51332142349173,NaN,NaN,425.86899999999844,431.04379622842373,420.69420377157314,422.5409933146338,426.4319052634601,428.9094309063151,423.95437962060515,46127,76236.36666666667,46.4356404472502,46.25351619921455,NaN,NaN,NaN,NaN,1.4190234018971213,18.581498557816804,108367982,0.008553489159605965,-0.5491920188072186,-0.5577455079668245
2025-09-18T14:00:00-04:00,423.53,424.28,423.37,424.06,NaN,NaN,NaN,427.51332142349173,NaN,NaN,425.7905999999984,430.9538569726683,420.6273430273285,421.41812112085864,426.4106733954608,428.88854107859845,423.9328057123231,51309,74088.46666666666,49.39092059174292,46.23948934640835,NaN,NaN,NaN,NaN,1.382664587475896,18.337103334703944,108419291,0.06895610610425518,-0.47155037533650557,-0.5405064814407607
2025-09-18T14:05:00-04:00,424.09,424.84,424.07,424.65,NaN,NaN,NaN,427.51332142349173,NaN,NaN,425.7235999999984,430.85729537136206,420.5899046286347,422.16049689668694,426.3963913926521,428.8703047070902,423.922478078214,46510,73502.66666666667,52.5306813883863,46.40250991768496,NaN,NaN,NaN,NaN,1.3396171169419016,17.500739355211252,108465801,0.14578061925556296,-0.358280707371307,-0.50406132662687
2025-09-18T14:10:00-04:00,424.62,424.62,423.12,423.32,NaN,NaN,NaN,427.51332142349173,NaN,NaN,425.63039999999836,430.7660556899806,420.49474431001613,422.16049689668694,426.38125163492793,428.8564985808187,423.90600468903716,34594,71007.46666666666,45.65465543605897,45.91716273345862,NaN,NaN,NaN,NaN,1.3532158943031922,17.519221909977055,108431207,0.10600861282878382,-0.3715505605908902,-0.477559173419674
2025-09-18T14:15:00-04:00,423.389,423.71,422.72,422.96,NaN,NaN,NaN,427.51332142349173,NaN,NaN,425.51199999999835,430.6153886787222,420.4086113212745,422.16049689668694,426.3491956851465,428.8330704252381,423.865320945055,61655,71147.03333333334,43.97669169837574,45.48509625327479,NaN,NaN,NaN,NaN,1.3272719018529606,17.83765088434947,108369552,0.05690259990849106,-0.4064309235340602,-0.46333352344255124
2025-09-18T14:20:00-04:00,422.97,423.65,422.67,423.53,NaN,NaN,NaN,427.51332142349173,NaN,NaN,425.4195999999984,430.4958158509841,420.3433841490127,422.16049689668694,426.33024371405276,428.8180621159513,423.8424253121542,38896,69576.36666666667,47.28057862123782,45.47715064422552,NaN,NaN,NaN,NaN,1.3024667660063176,18.171546364377726,108408448,0.06374116570410221,-0.38365706631242347,-0.4473982320165257
2025-09-18T14:25:00-04:00,423.52,423.6,423,423.23,NaN,NaN,NaN,427.51332142349173,NaN,NaN,425.30519999999837,430.315396387953,420.29500361204373,422.16049689668694,426.3172515910503,428.80771551445025,423.82678766765036,26886,67747.03333333334,45.751285254002575,45.67675507542516,NaN,NaN,NaN,NaN,1.2522905684344394,18.481592167261105,108381562,0.049619574161466284,-0.38537376431469283,-0.4349933384761591
2025-09-18T14:30:00-04:00,423.24,423.82,423.22,423.51,NaN,NaN,NaN,427.51332142349173,NaN,NaN,425.18839999999835,430.08702080243074,420.28977919756596,422.16049689668694,426.30244912286,428.79460967563426,423.8102885700858,33577,66196.83333333333,47.45942844837602,45.763647740784954,NaN,NaN,NaN,NaN,1.2056983849748342,18.47366480339101,108415139,0.06000199119608679,-0.35999084948105065,-0.41999284067713744
2025-09-18T14:35:00-04:00,423.55,423.77,423,423.02,NaN,NaN,NaN,427.5056813125214,NaN,NaN,425.06999999999834,429.8856627795097,420.254337220487,422.16049689668694,426.2873582096916,428.7824852797796,423.7922311396036,31702,60109.933333333334,44.80088277837337,45.79097912168408,NaN,NaN,NaN,NaN,1.1745770717623447,18.67111782628808,108383437,0.035922424813678355,-0.37508980966003946,-0.4110122344737178
2025-09-18T14:40:00-04:00,423.18,423.33,422.6,423.12,NaN,NaN,NaN,426.9979230710432,NaN,NaN,424.9695999999983,429.7341036851814,420.2050963148152,422.16049689668694,426.2623374086098,428.764185138856,423.7604896783636,49217,58288.333333333336,45.47220062944367,45.87449477478702,NaN,NaN,NaN,NaN,1.1428215666364603,19.216513004903746,108432654,0.029075592704329023,-0.37466774359330657,-0.4037433362976356
2025-09-18T14:45:00-04:00,423.15,423.76,422.94,423.44,NaN,NaN,NaN,426.9979230710432,NaN,NaN,424.87639999999834,429.5741624637601,420.1786375362366,422.16049689668694,426.2370350139307,428.7423464875619,423.7317235402995,56977,57499.86666666667,47.665601260645396,46.20071076827566,NaN,NaN,NaN,NaN,1.1197628833052842,19.097405589479937,108489631,0.04736244371957676,-0.34454028164816464,-0.3919027253677414
2025-09-18T14:50:00-04:00,423.48,423.94,423.38,423.57,NaN,NaN,NaN,426.9979230710432,NaN,NaN,424.73939999999834,429.17470275922966,420.304097240767,422.16049689668694,426.2216148598161,428.72749270588713,423.71573701374507,38619,55895.333333333336,48.57068505748332,46.696058282976495,NaN,NaN,NaN,NaN,1.0797798202120499,18.73231415045426,108528250,0.06821066873403547,-0.3066393894501971,-0.37485005818423256
2025-09-18T14:55:00-04:00,423.55,424.76,423.47,424.28,NaN,NaN,NaN,426.9979230710432,NaN,NaN,424.59459999999825,428.5854399324578,420.6037600675387,422.53088311592353,426.2038292563004,428.7060602334957,423.70159827910516,57097,54596.76666666667,53.31901850802927,47.55453360912261,NaN,NaN,NaN,NaN,1.0947955473397581,17.449248109748552,108585347,0.12643019404650574,-0.21681231562610037,-0.3432425096726061
2025-09-18T15:00:00-04:00,424.35,424.4,423,423.6,NaN,NaN,NaN,426.9979230710432,NaN,NaN,424.4865999999983,428.28221349008805,420.69098650990856,422.53088311592353,426.1777288362507,428.68018553679065,423.67527213571077,68459,54568.53333333333,48.683020571071445,47.64223504931979,NaN,NaN,NaN,NaN,1.1165958653869166,16.680498649200512,108516888,0.11602664997025136,-0.1982091972097919,-0.31423584718004327
2025-09-18T15:05:00-04:00,423.615,423.93,422.91,423.45,NaN,NaN,NaN,426.9979230710432,NaN,NaN,424.3721999999983,427.9338789083182,420.8105210916784,422.53088311592353,426.1497116633334,428.65463378496827,423.6447895416985,68554,54756.73333333333,47.69781557076747,47.7323904152853,NaN,NaN,NaN,NaN,1.1096961607164213,16.066833546482968,108448334,0.09671578004072201,-0.19334112212914079,-0.2900569021698628
2025-09-18T15:10:00-04:00,423.51,423.68,422.47,422.66,NaN,NaN,NaN,426.90242314294767,NaN,NaN,424.2335999999983,427.4993636421112,420.96783635788546,422.53088311592353,426.1140376494776,428.62766410757416,423.60041119138106,75486,55176,42.786717809993746,47.26066164516037,NaN,NaN,NaN,NaN,1.116860720665247,15.978393390384296,108372848,0.03177053887180581,-0.25034372858010556,-0.28211426745191137
2025-09-18T15:15:00-04:00,422.61,422.67,420,421.85,NaN,NaN,NaN,425.35254027281366,NaN,NaN,424.0797999999984,427.0416385921323,421.11796140786447,422.53088311592353,425.96390161613573,428.5680560861889,423.35974714608255,229008,60456.833333333336,38.4188719007113,46.252675253183575,NaN,NaN,NaN,NaN,1.2277992406177307,17.76480205886732,108143840,-0.059721670007267746,-0.35676635496099607,-0.2970446849537283
2025-09-18T15:20:00-04:00,421.86,422.37,421.58,422.19,NaN,NaN,NaN,425.35254027281366,NaN,NaN,423.95939999999825,426.7226456579912,421.1961543420053,422.53088311592353,425.93164889675637,428.5491066302756,423.3141911632371,58344,60477.46666666667,41.13526196379001,45.9298614337358,NaN,NaN,NaN,NaN,1.1965278662878944,19.42361010817299,108202184,-0.08953040001697776,-0.40895768497495055,-0.3194272849579728
2025-09-18T15:25:00-04:00,422.2,422.71,421.45,422.44,NaN,NaN,NaN,425.35254027281366,NaN,NaN,423.8355999999983,426.2878941434768,421.38330585651977,422.53088311592353,425.89156858770446,428.5231952971478,423.2599418782611,76936,61385.23333333333,43.12197338195263,45.86881012541986,NaN,NaN,NaN,NaN,1.2010615901244728,20.49322360651029,108279120,-0.08465402944705869,-0.4252448217667961,-0.34059079231973743
2025-09-18T15:30:00-04:00,422.41,422.48,420.85,421.05,NaN,NaN,NaN,425.35254027281366,NaN,NaN,423.7105999999983,426.07953363479766,421.34166636519893,422.53088311592353,425.8523815551487,428.5049923026494,423.19977080764806,63906,61698.166666666664,35.87258009850163,45.05395308808156,NaN,NaN,NaN,NaN,1.2317000479727243,21.868716908597673,108215214,-0.16276136220313342,-0.5440424950736542,-0.3812811328705208
2025-09-18T15:35:00-04:00,421.12,421.51,420.33,420.35,NaN,NaN,NaN,424.87871721448784,NaN,NaN,423.62279999999834,426.15256849650547,421.0930315034912,422.53088311592353,425.7954523421178,428.4873875853298,423.1035170989058,81222,62387.933333333334,32.87521555180486,44.13423382363886,NaN,NaN,NaN,NaN,1.2280071874032445,23.45046222495839,108133992,-0.24438160299119327,-0.6867581366095123,-0.4423765336183191
2025-09-18T15:40:00-04:00,420.39,420.87,418.7,419.54,NaN,NaN,NaN,423.8596846138293,NaN,NaN,423.49719999999826,426.1960798873417,420.79832011265484,422.53088311592353,425.6556388892378,428.46854148719046,422.8427362912852,171662,65247.433333333334,29.774945083096085,42.87105644040458,NaN,NaN,NaN,NaN,1.295292388303014,25.690251034080617,107962330,-0.33038794649758896,-0.8553614667403053,-0.5249735202427164
2025-09-18T15:45:00-04:00,419.51,419.74,418.53,418.93,NaN,NaN,NaN,423.18947167683706,NaN,NaN,423.3437999999982,426.18780813051376,420.4997918694827,421.9167064927388,425.56940816417165,428.46243534524945,422.67638098309385,99188,65507.666666666664,27.65948622817767,41.64667097253346,NaN,NaN,NaN,NaN,1.2892000748528012,27.838476128498264,107863142,-0.40111826584539556,-1.0263713525494609,-0.6252530867040653
2025-09-18T15:50:00-04:00,418.87,419.15,417.5,418.77,NaN,NaN,NaN,422.42017750970814,NaN,NaN,423.22919999999823,426.32798644735385,420.1304135526426,421.4333651941911,425.404910726541,428.4570924418662,422.3527290112158,179863,69360.03333333334,27.11530575902033,40.33546419607465,NaN,NaN,NaN,NaN,1.3149714980775993,30.217142610546954,107683279,-0.42893389059612286,-1.161420449949219,-0.732486559353096
2025-09-18T15:55:00-04:00,418.71,419.08,416.57,416.66,NaN,NaN,NaN,422.07630580472136,NaN,NaN,423.05639999999823,426.60496762178406,419.5078323782124,421.0776921553529,425.20114175642846,428.4660678591081,421.93621565374883,203623,74486.16666666667,21.19355836015049,38.44460398889644,NaN,NaN,NaN,NaN,1.4003306767863415,32.719182172229374,107479656,-0.5518600925000179,-1.4223116749781184,-0.8704515824781005